,Year,Departement,Module_ID,Module,Chapter_ID,Chapter,Quiz_perChapter,Quizz_ID,Rank_onChapter,Quizz_Type,Slip,Guess,Success_Prct,Success_Attempts,Failure_Attempts,Number_Attempts,UniQ_Learner,Sucessful_Learners,Unsucessful_Learners,Avg_Attempts,Percent_Learners_Success,Predict_Difficulty,Correct_Difficulty,Score,Difficulty_String,Difficulty,Department
0,2015,Droit,1,Histoire du Droit,1,La Grèce,3,1,1,QCU,0.02,0.91,86.09,82,13,95,85,82,3,1.12,96.47,Facile,Facile,0,Meme Difficulté,Pas Adapte,Law
1111,2016,Droit,1,Histoire du Droit,1,La Grèce,3,1,1,QCU,0.47,0.25,34.26,33,63,96,57,33,24,1.68,57.89,Difficile,Difficile,0,Meme Difficulté,Pas Adapte,Law
2222,2017,Droit,1,Histoire du Droit,1,La Grèce,3,1,1,QCU,0.09,0.97,84.1,79,15,94,89,79,10,1.06,88.76,Facile,Facile,0,Meme Difficulté,Pas Adapte,Law
3333,2018,Droit,1,Histoire du Droit,1,La Grèce,3,1,1,QCM,0.79,0.25,5.31,5,93,98,73,5,68,1.34,6.85,Difficile,Difficile,0,Meme Difficulté,Pas Adapte,Law
4444,2019,Droit,1,Histoire du Droit,1,La Grèce,3,1,1,QCM,0.18,0.9,69.88,76,33,109,92,76,16,1.18,82.61,Facile,Facile,0,Meme Difficulté,Adapte,Law
5555,2020,Droit,1,Histoire du Droit,1,La Grèce,3,1,1,QCM,0.06,0.86,69.88,66,28,94,72,66,6,1.31,91.67,Facile,Facile,0,Meme Difficulté,Adapte,Law
1,2015,Droit,1,Histoire du Droit,1,La Grèce,3,2,2,QROC,0.96,0.2,15.86,5,25,30,29,5,24,1.03,17.24,Difficile,Difficile,0,Meme Difficulté,Pas Adapte,Law
1112,2016,Droit,1,Histoire du Droit,1,La Grèce,3,2,2,QO,0.62,0.23,43.15,12,16,28,17,12,5,1.65,70.59,Facile,Moyen,-1,Plus Difficile,Pas Adapte,Law
2223,2017,Droit,1,Histoire du Droit,1,La Grèce,3,2,2,QROC,0.76,0.05,34.0,9,17,26,17,9,8,1.53,52.94,Moyen,Difficile,-1,Plus Difficile,Pas Adapte,Law
3334,2018,Droit,1,Histoire du Droit,1,La Grèce,3,2,2,QROC,0.05,0.88,82.85,19,4,23,20,19,1,1.15,95.0,Difficile,Facile,2,Beaucoup plus Facile,Pas Adapte,Law
4445,2019,Droit,1,Histoire du Droit,1,La Grèce,3,2,2,QROC,0.57,0.3,64.02,13,8,21,21,13,8,1.0,61.9,Facile,Moyen,-1,Plus Difficile,Adapte,Law
5556,2020,Droit,1,Histoire du Droit,1,La Grèce,3,2,2,QROC,0.29,0.32,64.02,14,8,22,21,14,7,1.05,66.67,Moyen,Moyen,0,Meme Difficulté,Adapte,Law
2,2015,Droit,1,Histoire du Droit,1,La Grèce,3,3,3,QCU,0.0,0.88,95.91,89,4,93,89,89,0,1.04,100.0,Moyen,Facile,1,Plus Facile,Pas Adapte,Law
1113,2016,Droit,1,Histoire du Droit,1,La Grèce,3,3,3,QCU,0.63,0.37,13.06,14,90,104,71,14,57,1.46,19.72,Facile,Difficile,-2,Beaucoup plus Difficile,Pas Adapte,Law
2224,2017,Droit,1,Histoire du Droit,1,La Grèce,3,3,3,QCU,0.65,0.35,6.08,6,87,93,35,6,29,2.66,17.14,Facile,Difficile,-2,Beaucoup plus Difficile,Pas Adapte,Law
3335,2018,Droit,1,Histoire du Droit,1,La Grèce,3,3,3,QCU,0.72,0.3,30.32,27,63,90,32,27,5,2.81,84.38,Difficile,Difficile,0,Meme Difficulté,Pas Adapte,Law
4446,2019,Droit,1,Histoire du Droit,1,La Grèce,3,3,3,QCU,0.7,0.24,26.83,26,70,96,84,26,58,1.14,30.95,Difficile,Difficile,0,Meme Difficulté,Pas Adapte,Law
5557,2020,Droit,1,Histoire du Droit,1,La Grèce,3,3,3,QCM,0.64,0.18,7.9,7,81,88,82,7,75,1.07,8.54,Facile,Difficile,-2,Beaucoup plus Difficile,Pas Adapte,Law
3,2015,Droit,1,Histoire du Droit,2,L'Italie,7,4,1,QCM,0.53,0.21,19.8,10,43,53,52,10,42,1.02,19.23,Moyen,Difficile,-1,Plus Difficile,Pas Adapte,Law
1114,2016,Droit,1,Histoire du Droit,2,L'Italie,7,4,1,QCM,0.25,0.68,39.52,19,29,48,26,19,7,1.85,73.08,Moyen,Moyen,0,Meme Difficulté,Pas Adapte,Law
2225,2017,Droit,1,Histoire du Droit,2,L'Italie,7,4,1,QCM,0.38,0.4,46.2,25,29,54,37,25,12,1.46,67.57,Facile,Moyen,-1,Plus Difficile,Pas Adapte,Law
3336,2018,Droit,1,Histoire du Droit,2,L'Italie,7,4,1,QCU,0.74,0.25,14.81,7,39,46,29,7,22,1.59,24.14,Difficile,Difficile,0,Meme Difficulté,Pas Adapte,Law
4447,2019,Droit,1,Histoire du Droit,2,L'Italie,7,4,1,QCM,0.46,0.32,64.03,26,14,40,37,26,11,1.08,70.27,Facile,Moyen,-1,Plus Difficile,Adapte,Law
5558,2020,Droit,1,Histoire du Droit,2,L'Italie,7,4,1,QCM,0.3,0.41,64.03,28,16,44,36,28,8,1.22,77.78,Moyen,Moyen,0,Meme Difficulté,Adapte,Law
4,2015,Droit,1,Histoire du Droit,2,L'Italie,7,5,2,QROC,0.33,0.25,53.31,41,35,76,65,41,24,1.17,63.08,Moyen,Moyen,0,Meme Difficulté,Pas Adapte,Law
1115,2016,Droit,1,Histoire du Droit,2,L'Italie,7,5,2,QROC,0.46,0.26,59.26,50,35,85,51,50,1,1.67,98.04,Moyen,Moyen,0,Meme Difficulté,Pas Adapte,Law
2226,2017,Droit,1,Histoire du Droit,2,L'Italie,7,5,2,QCM,0.45,0.59,41.06,31,44,75,45,31,14,1.67,68.89,Difficile,Moyen,1,Plus Facile,Pas Adapte,Law
3337,2018,Droit,1,Histoire du Droit,2,L'Italie,7,5,2,QCM,0.69,0.22,28.83,24,59,83,43,24,19,1.93,55.81,Facile,Difficile,-2,Beaucoup plus Difficile,Pas Adapte,Law
4448,2019,Droit,1,Histoire du Droit,2,L'Italie,7,5,2,QCM,0.74,0.19,17.18,14,67,81,54,14,40,1.5,25.93,Facile,Difficile,-2,Beaucoup plus Difficile,Pas Adapte,Law
5559,2020,Droit,1,Histoire du Droit,2,L'Italie,7,5,2,QCM,0.5,0.6,59.46,45,31,76,46,45,1,1.65,97.83,Facile,Moyen,-1,Plus Difficile,Pas Adapte,Law
5,2015,Droit,1,Histoire du Droit,2,L'Italie,7,6,3,QROC,0.11,0.59,69.89,57,24,81,60,57,3,1.35,95.0,Facile,Facile,0,Meme Difficulté,Adapte,Law
1116,2016,Droit,1,Histoire du Droit,2,L'Italie,7,6,3,QROC,0.19,0.79,69.89,49,21,70,57,49,8,1.23,85.96,Facile,Facile,0,Meme Difficulté,Adapte,Law
2227,2017,Droit,1,Histoire du Droit,2,L'Italie,7,6,3,QROC,0.12,0.84,69.89,46,20,66,59,46,13,1.12,77.97,Facile,Facile,0,Meme Difficulté,Adapte,Law
3338,2018,Droit,1,Histoire du Droit,2,L'Italie,7,6,3,QROC,0.13,0.84,69.89,42,18,60,59,42,17,1.02,71.19,Facile,Facile,0,Meme Difficulté,Adapte,Law
4449,2019,Droit,1,Histoire du Droit,2,L'Italie,7,6,3,QROC,0.11,0.96,69.89,45,20,65,57,45,12,1.14,78.95,Facile,Facile,0,Meme Difficulté,Adapte,Law
5560,2020,Droit,1,Histoire du Droit,2,L'Italie,7,6,3,QROC,0.17,0.51,69.89,45,19,64,48,45,3,1.33,93.75,Facile,Facile,0,Meme Difficulté,Adapte,Law
6,2015,Droit,1,Histoire du Droit,2,L'Italie,7,7,4,QROC,0.52,0.33,57.39,14,11,25,25,14,11,1.0,56.0,Difficile,Moyen,1,Plus Facile,Pas Adapte,Law
1117,2016,Droit,1,Histoire du Droit,2,L'Italie,7,7,4,QROC,0.28,0.26,47.23,12,13,25,24,12,12,1.04,50.0,Difficile,Moyen,1,Plus Facile,Pas Adapte,Law
2228,2017,Droit,1,Histoire du Droit,2,L'Italie,7,7,4,QROC,1.0,0.09,21.3,5,19,24,14,5,9,1.71,35.71,Moyen,Difficile,-1,Plus Difficile,Pas Adapte,Law
3339,2018,Droit,1,Histoire du Droit,2,L'Italie,7,7,4,QROC,0.36,0.28,38.79,8,13,21,11,8,3,1.91,72.73,Difficile,Moyen,1,Plus Facile,Pas Adapte,Law
4450,2019,Droit,1,Histoire du Droit,2,L'Italie,7,7,4,QROC,0.44,0.37,54.25,10,9,19,18,10,8,1.06,55.56,Facile,Moyen,-1,Plus Difficile,Pas Adapte,Law
5561,2020,Droit,1,Histoire du Droit,2,L'Italie,7,7,4,QROC,0.68,0.12,24.55,5,17,22,21,5,16,1.05,23.81,Facile,Difficile,-2,Beaucoup plus Difficile,Pas Adapte,Law
7,2015,Droit,1,Histoire du Droit,2,L'Italie,7,8,5,QROC,0.48,0.3,40.85,30,44,74,39,30,9,1.9,76.92,Difficile,Moyen,1,Plus Facile,Pas Adapte,Law
1118,2016,Droit,1,Histoire du Droit,2,L'Italie,7,8,5,QROC,0.42,0.26,64.0,53,30,83,54,53,1,1.54,98.15,Moyen,Moyen,0,Meme Difficulté,Adapte,Law
2229,2017,Droit,1,Histoire du Droit,2,L'Italie,7,8,5,QROC,0.44,0.25,64.0,56,31,87,70,56,14,1.24,80.0,Moyen,Moyen,0,Meme Difficulté,Adapte,Law
3340,2018,Droit,1,Histoire du Droit,2,L'Italie,7,8,5,QROC,0.53,0.37,64.0,58,32,90,59,58,1,1.53,98.31,Moyen,Moyen,0,Meme Difficulté,Adapte,Law
4451,2019,Droit,1,Histoire du Droit,2,L'Italie,7,8,5,QROC,0.3,0.29,64.0,61,35,96,88,61,27,1.09,69.32,Moyen,Moyen,0,Meme Difficulté,Adapte,Law
5562,2020,Droit,1,Histoire du Droit,2,L'Italie,7,8,5,QROC,0.51,0.27,64.0,60,33,93,91,60,31,1.02,65.93,Moyen,Moyen,0,Meme Difficulté,Adapte,Law
8,2015,Droit,1,Histoire du Droit,2,L'Italie,7,9,6,QCM,0.59,0.29,31.95,25,52,77,67,25,42,1.15,37.31,Facile,Difficile,-2,Beaucoup plus Difficile,Pas Adapte,Law
1119,2016,Droit,1,Histoire du Droit,2,L'Italie,7,9,6,QCM,0.52,0.16,27.8,20,53,73,44,20,24,1.66,45.45,Facile,Difficile,-2,Beaucoup plus Difficile,Pas Adapte,Law
2230,2017,Droit,1,Histoire du Droit,2,L'Italie,7,9,6,QROC,0.18,0.56,79.87,55,14,69,59,55,4,1.17,93.22,Difficile,Facile,2,Beaucoup plus Facile,Pas Adapte,Law
3341,2018,Droit,1,Histoire du Droit,2,L'Italie,7,9,6,QROC,0.02,0.69,71.7,47,19,66,48,47,1,1.38,97.92,Moyen,Facile,1,Plus Facile,Adapte,Law
4452,2019,Droit,1,Histoire du Droit,2,L'Italie,7,9,6,QROC,0.2,0.74,71.7,51,20,71,62,51,11,1.15,82.26,Facile,Facile,0,Meme Difficulté,Adapte,Law
5563,2020,Droit,1,Histoire du Droit,2,L'Italie,7,9,6,QROC,0.02,0.96,71.7,57,22,79,63,57,6,1.25,90.48,Facile,Facile,0,Meme Difficulté,Adapte,Law
9,2015,Droit,1,Histoire du Droit,2,L'Italie,7,10,7,QROC,0.65,0.19,22.54,20,67,87,72,20,52,1.21,27.78,Moyen,Difficile,-1,Plus Difficile,Pas Adapte,Law
1120,2016,Droit,1,Histoire du Droit,2,L'Italie,7,10,7,QROC,0.08,0.46,91.17,88,9,97,96,88,8,1.01,91.67,Facile,Facile,0,Meme Difficulté,Pas Adapte,Law
2231,2017,Droit,1,Histoire du Droit,2,L'Italie,7,10,7,QROC,0.77,0.11,28.92,27,68,95,95,27,68,1.0,28.42,Difficile,Difficile,0,Meme Difficulté,Pas Adapte,Law
3342,2018,Droit,1,Histoire du Droit,2,L'Italie,7,10,7,QROC,0.62,0.11,11.28,9,75,84,45,9,36,1.87,20.0,Moyen,Difficile,-1,Plus Difficile,Pas Adapte,Law
4453,2019,Droit,1,Histoire du Droit,2,L'Italie,7,10,7,QO,0.8,0.13,13.08,11,73,84,49,11,38,1.71,22.45,Moyen,Difficile,-1,Plus Difficile,Pas Adapte,Law
5564,2020,Droit,1,Histoire du Droit,2,L'Italie,7,10,7,QO,0.18,0.31,81.42,68,15,83,77,68,9,1.08,88.31,Facile,Facile,0,Meme Difficulté,Pas Adapte,Law
10,2015,Droit,2,Introduction Historique au Droit,1,L'Ancien Regime,4,11,1,QCM,0.75,0.28,2.23,0,9,9,5,0,5,1.8,0.0,Difficile,Difficile,0,Meme Difficulté,Pas Adapte,Law
1121,2016,Droit,2,Introduction Historique au Droit,1,L'Ancien Regime,4,11,1,QCM,0.62,0.27,21.37,2,7,9,9,2,7,1.0,22.22,Difficile,Difficile,0,Meme Difficulté,Pas Adapte,Law
2232,2017,Droit,2,Introduction Historique au Droit,1,L'Ancien Regime,4,11,1,QCM,0.74,0.17,4.58,0,9,9,9,0,9,1.0,0.0,Facile,Difficile,-2,Beaucoup plus Difficile,Pas Adapte,Law
3343,2018,Droit,2,Introduction Historique au Droit,1,L'Ancien Regime,4,11,1,QCM,0.12,0.94,96.5,9,0,9,9,9,0,1.0,100.0,Difficile,Facile,2,Beaucoup plus Facile,Pas Adapte,Law
4454,2019,Droit,2,Introduction Historique au Droit,1,L'Ancien Regime,4,11,1,QCM,0.07,0.82,76.48,8,2,10,10,8,2,1.0,80.0,Difficile,Facile,2,Beaucoup plus Facile,Pas Adapte,Law
5565,2020,Droit,2,Introduction Historique au Droit,1,L'Ancien Regime,4,11,1,QCM,0.23,0.67,40.85,3,5,8,7,3,4,1.14,42.86,Moyen,Moyen,0,Meme Difficulté,Pas Adapte,Law
11,2015,Droit,2,Introduction Historique au Droit,1,L'Ancien Regime,4,12,2,QCU,0.31,0.57,54.15,50,42,92,56,50,6,1.64,89.29,Facile,Moyen,-1,Plus Difficile,Pas Adapte,Law
1122,2016,Droit,2,Introduction Historique au Droit,1,L'Ancien Regime,4,12,2,QCU,0.28,0.68,60.87,52,34,86,72,52,20,1.19,72.22,Facile,Moyen,-1,Plus Difficile,Adapte,Law
2233,2017,Droit,2,Introduction Historique au Droit,1,L'Ancien Regime,4,12,2,QCU,0.27,0.59,60.87,60,38,98,66,60,6,1.48,90.91,Moyen,Moyen,0,Meme Difficulté,Adapte,Law
3344,2018,Droit,2,Introduction Historique au Droit,1,L'Ancien Regime,4,12,2,QCU,0.25,0.68,60.87,55,36,91,73,55,18,1.25,75.34,Moyen,Moyen,0,Meme Difficulté,Adapte,Law
4455,2019,Droit,2,Introduction Historique au Droit,1,L'Ancien Regime,4,12,2,QCM,0.48,0.62,60.87,55,36,91,76,55,21,1.2,72.37,Moyen,Moyen,0,Meme Difficulté,Adapte,Law
5566,2020,Droit,2,Introduction Historique au Droit,1,L'Ancien Regime,4,12,2,QCM,0.35,0.65,60.87,52,34,86,65,52,13,1.32,80.0,Moyen,Moyen,0,Meme Difficulté,Adapte,Law
12,2015,Droit,2,Introduction Historique au Droit,1,L'Ancien Regime,4,13,3,QROC,0.16,0.61,81.77,44,10,54,54,44,10,1.0,81.48,Facile,Facile,0,Meme Difficulté,Pas Adapte,Law
1123,2016,Droit,2,Introduction Historique au Droit,1,L'Ancien Regime,4,13,3,QROC,0.44,0.25,59.12,28,19,47,40,28,12,1.18,70.0,Difficile,Moyen,1,Plus Facile,Pas Adapte,Law
2234,2017,Droit,2,Introduction Historique au Droit,1,L'Ancien Regime,4,13,3,QROC,0.87,0.11,12.13,6,43,49,29,6,23,1.69,20.69,Difficile,Difficile,0,Meme Difficulté,Pas Adapte,Law
3345,2018,Droit,2,Introduction Historique au Droit,1,L'Ancien Regime,4,13,3,QROC,0.08,0.87,71.62,34,13,47,41,34,7,1.15,82.93,Facile,Facile,0,Meme Difficulté,Adapte,Law
4456,2019,Droit,2,Introduction Historique au Droit,1,L'Ancien Regime,4,13,3,QROC,0.13,0.54,71.62,31,12,43,40,31,9,1.07,77.5,Facile,Facile,0,Meme Difficulté,Adapte,Law
5567,2020,Droit,2,Introduction Historique au Droit,1,L'Ancien Regime,4,13,3,QROC,0.19,0.44,71.62,27,11,38,31,27,4,1.23,87.1,Facile,Facile,0,Meme Difficulté,Adapte,Law
13,2015,Droit,2,Introduction Historique au Droit,1,L'Ancien Regime,4,14,4,QCU,0.16,0.94,73.4,65,24,89,78,65,13,1.14,83.33,Facile,Facile,0,Meme Difficulté,Adapte,Law
1124,2016,Droit,2,Introduction Historique au Droit,1,L'Ancien Regime,4,14,4,QCU,0.06,0.79,73.4,65,24,89,71,65,6,1.25,91.55,Facile,Facile,0,Meme Difficulté,Adapte,Law
2235,2017,Droit,2,Introduction Historique au Droit,1,L'Ancien Regime,4,14,4,QCU,0.0,0.96,73.4,69,25,94,74,69,5,1.27,93.24,Facile,Facile,0,Meme Difficulté,Adapte,Law
3346,2018,Droit,2,Introduction Historique au Droit,1,L'Ancien Regime,4,14,4,QCU,0.08,0.92,73.4,73,26,99,90,73,17,1.1,81.11,Facile,Facile,0,Meme Difficulté,Adapte,Law
4457,2019,Droit,2,Introduction Historique au Droit,1,L'Ancien Regime,4,14,4,QCU,0.06,0.91,73.4,82,30,112,109,82,27,1.03,75.23,Facile,Facile,0,Meme Difficulté,Adapte,Law
5568,2020,Droit,2,Introduction Historique au Droit,1,L'Ancien Regime,4,14,4,QCU,0.17,0.78,73.4,90,32,122,97,90,7,1.26,92.78,Facile,Facile,0,Meme Difficulté,Adapte,Law
14,2015,Droit,2,Introduction Historique au Droit,2,La Contestation du Regime Feodal,13,15,1,QCU,0.19,0.83,72.68,58,22,80,69,58,11,1.16,84.06,Difficile,Facile,2,Beaucoup plus Facile,Adapte,Law
1125,2016,Droit,2,Introduction Historique au Droit,2,La Contestation du Regime Feodal,13,15,1,QCU,0.01,0.82,72.68,52,20,72,60,52,8,1.2,86.67,Facile,Facile,0,Meme Difficulté,Adapte,Law
2236,2017,Droit,2,Introduction Historique au Droit,2,La Contestation du Regime Feodal,13,15,1,QCU,0.1,0.78,72.68,48,18,66,55,48,7,1.2,87.27,Facile,Facile,0,Meme Difficulté,Adapte,Law
3347,2018,Droit,2,Introduction Historique au Droit,2,La Contestation du Regime Feodal,13,15,1,QCU,0.11,0.94,72.68,42,16,58,46,42,4,1.26,91.3,Facile,Facile,0,Meme Difficulté,Adapte,Law
4458,2019,Droit,2,Introduction Historique au Droit,2,La Contestation du Regime Feodal,13,15,1,QCU,0.02,1.0,72.68,40,15,55,51,40,11,1.08,78.43,Facile,Facile,0,Meme Difficulté,Adapte,Law
5569,2020,Droit,2,Introduction Historique au Droit,2,La Contestation du Regime Feodal,13,15,1,QCU,0.18,0.86,72.68,39,15,54,54,39,15,1.0,72.22,Facile,Facile,0,Meme Difficulté,Adapte,Law
15,2015,Droit,2,Introduction Historique au Droit,2,La Contestation du Regime Feodal,13,16,2,QCU,0.14,0.84,68.44,14,6,20,18,14,4,1.11,77.78,Difficile,Facile,2,Beaucoup plus Facile,Adapte,Law
1126,2016,Droit,2,Introduction Historique au Droit,2,La Contestation du Regime Feodal,13,16,2,QCU,0.14,0.99,68.44,15,7,22,20,15,5,1.1,75.0,Facile,Facile,0,Meme Difficulté,Adapte,Law
2237,2017,Droit,2,Introduction Historique au Droit,2,La Contestation du Regime Feodal,13,16,2,QCU,0.08,0.95,68.44,16,8,24,21,16,5,1.14,76.19,Facile,Facile,0,Meme Difficulté,Adapte,Law
3348,2018,Droit,2,Introduction Historique au Droit,2,La Contestation du Regime Feodal,13,16,2,QCU,0.01,0.8,68.44,14,6,20,15,14,1,1.33,93.33,Facile,Facile,0,Meme Difficulté,Adapte,Law
4459,2019,Droit,2,Introduction Historique au Droit,2,La Contestation du Regime Feodal,13,16,2,QCU,0.08,0.77,68.44,15,7,22,22,15,7,1.0,68.18,Facile,Facile,0,Meme Difficulté,Adapte,Law
5570,2020,Droit,2,Introduction Historique au Droit,2,La Contestation du Regime Feodal,13,16,2,QCU,0.05,0.86,68.44,16,8,24,17,16,1,1.41,94.12,Facile,Facile,0,Meme Difficulté,Adapte,Law
16,2015,Droit,2,Introduction Historique au Droit,2,La Contestation du Regime Feodal,13,17,3,QCU,0.13,0.9,99.25,10,0,10,10,10,0,1.0,100.0,Difficile,Facile,2,Beaucoup plus Facile,Pas Adapte,Law
1127,2016,Droit,2,Introduction Historique au Droit,2,La Contestation du Regime Feodal,13,17,3,QO,0.99,0.04,33.0,4,7,11,8,4,4,1.38,50.0,Moyen,Difficile,-1,Plus Difficile,Pas Adapte,Law
2238,2017,Droit,2,Introduction Historique au Droit,2,La Contestation du Regime Feodal,13,17,3,QO,0.15,0.8,81.05,11,2,13,12,11,1,1.08,91.67,Moyen,Facile,1,Plus Facile,Pas Adapte,Law
3349,2018,Droit,2,Introduction Historique au Droit,2,La Contestation du Regime Feodal,13,17,3,QO,0.08,0.57,94.38,13,1,14,14,13,1,1.0,92.86,Facile,Facile,0,Meme Difficulté,Pas Adapte,Law
4460,2019,Droit,2,Introduction Historique au Droit,2,La Contestation du Regime Feodal,13,17,3,QO,0.0,0.46,65.68,11,5,16,15,11,4,1.07,73.33,Facile,Facile,0,Meme Difficulté,Adapte,Law
5571,2020,Droit,2,Introduction Historique au Droit,2,La Contestation du Regime Feodal,13,17,3,QO,0.18,0.5,65.68,10,5,15,10,10,0,1.5,100.0,Facile,Facile,0,Meme Difficulté,Adapte,Law
17,2015,Droit,2,Introduction Historique au Droit,2,La Contestation du Regime Feodal,13,18,4,QCU,0.74,0.24,19.7,19,75,94,77,19,58,1.22,24.68,Moyen,Difficile,-1,Plus Difficile,Pas Adapte,Law
1128,2016,Droit,2,Introduction Historique au Droit,2,La Contestation du Regime Feodal,13,18,4,QCU,0.46,0.3,33.21,31,63,94,56,31,25,1.68,55.36,Facile,Difficile,-2,Beaucoup plus Difficile,Pas Adapte,Law
2239,2017,Droit,2,Introduction Historique au Droit,2,La Contestation du Regime Feodal,13,18,4,QCU,0.32,0.48,63.47,61,35,96,91,61,30,1.05,67.03,Facile,Moyen,-1,Plus Difficile,Adapte,Law
3350,2018,Droit,2,Introduction Historique au Droit,2,La Contestation du Regime Feodal,13,18,4,QCU,0.36,0.57,63.47,53,31,84,83,53,30,1.01,63.86,Moyen,Moyen,0,Meme Difficulté,Adapte,Law
4461,2019,Droit,2,Introduction Historique au Droit,2,La Contestation du Regime Feodal,13,18,4,QCU,0.38,0.71,63.47,56,33,89,88,56,32,1.01,63.64,Moyen,Moyen,0,Meme Difficulté,Adapte,Law
5572,2020,Droit,2,Introduction Historique au Droit,2,La Contestation du Regime Feodal,13,18,4,QCM,0.37,0.4,63.47,53,31,84,70,53,17,1.2,75.71,Moyen,Moyen,0,Meme Difficulté,Adapte,Law
18,2015,Droit,2,Introduction Historique au Droit,2,La Contestation du Regime Feodal,13,19,5,QROC,0.74,0.07,32.34,2,5,7,4,2,2,1.75,50.0,Difficile,Difficile,0,Meme Difficulté,Pas Adapte,Law
1129,2016,Droit,2,Introduction Historique au Droit,2,La Contestation du Regime Feodal,13,19,5,QCM,0.69,0.18,17.18,1,7,8,3,1,2,2.67,33.33,Difficile,Difficile,0,Meme Difficulté,Pas Adapte,Law
2240,2017,Droit,2,Introduction Historique au Droit,2,La Contestation du Regime Feodal,13,19,5,QCU,0.19,0.97,67.74,6,3,9,9,6,3,1.0,66.67,Facile,Facile,0,Meme Difficulté,Adapte,Law
3351,2018,Droit,2,Introduction Historique au Droit,2,La Contestation du Regime Feodal,13,19,5,QCU,0.14,0.98,67.74,7,3,10,7,7,0,1.43,100.0,Facile,Facile,0,Meme Difficulté,Adapte,Law
4462,2019,Droit,2,Introduction Historique au Droit,2,La Contestation du Regime Feodal,13,19,5,QCU,0.16,0.91,67.74,7,4,11,10,7,3,1.1,70.0,Facile,Facile,0,Meme Difficulté,Adapte,Law
5573,2020,Droit,2,Introduction Historique au Droit,2,La Contestation du Regime Feodal,13,19,5,QCU,0.16,0.78,67.74,7,4,11,10,7,3,1.1,70.0,Facile,Facile,0,Meme Difficulté,Adapte,Law
19,2015,Droit,2,Introduction Historique au Droit,2,La Contestation du Regime Feodal,13,20,6,QCM,0.53,0.21,22.34,21,73,94,38,21,17,2.47,55.26,Difficile,Difficile,0,Meme Difficulté,Pas Adapte,Law
1130,2016,Droit,2,Introduction Historique au Droit,2,La Contestation du Regime Feodal,13,20,6,QCM,0.47,0.67,49.32,42,43,85,43,42,1,1.98,97.67,Facile,Moyen,-1,Plus Difficile,Pas Adapte,Law
2241,2017,Droit,2,Introduction Historique au Droit,2,La Contestation du Regime Feodal,13,20,6,QCU,0.35,0.59,63.76,53,30,83,75,53,22,1.11,70.67,Facile,Moyen,-1,Plus Difficile,Adapte,Law
3352,2018,Droit,2,Introduction Historique au Droit,2,La Contestation du Regime Feodal,13,20,6,QCM,0.49,0.68,63.76,49,28,77,65,49,16,1.18,75.38,Moyen,Moyen,0,Meme Difficulté,Adapte,Law
4463,2019,Droit,2,Introduction Historique au Droit,2,La Contestation du Regime Feodal,13,20,6,QCM,0.42,0.64,63.76,47,26,73,65,47,18,1.12,72.31,Moyen,Moyen,0,Meme Difficulté,Adapte,Law
5574,2020,Droit,2,Introduction Historique au Droit,2,La Contestation du Regime Feodal,13,20,6,QCM,0.37,0.39,63.76,50,29,79,74,50,24,1.07,67.57,Moyen,Moyen,0,Meme Difficulté,Adapte,Law
20,2015,Droit,2,Introduction Historique au Droit,2,La Contestation du Regime Feodal,13,21,7,QCM,0.14,0.94,94.28,62,4,66,63,62,1,1.05,98.41,Facile,Facile,0,Meme Difficulté,Pas Adapte,Law
1131,2016,Droit,2,Introduction Historique au Droit,2,La Contestation du Regime Feodal,13,21,7,QCM,0.66,0.17,18.49,11,50,61,18,11,7,3.39,61.11,Difficile,Difficile,0,Meme Difficulté,Pas Adapte,Law
2242,2017,Droit,2,Introduction Historique au Droit,2,La Contestation du Regime Feodal,13,21,7,QCM,0.09,0.75,87.78,51,7,58,54,51,3,1.07,94.44,Moyen,Facile,1,Plus Facile,Pas Adapte,Law
3353,2018,Droit,2,Introduction Historique au Droit,2,La Contestation du Regime Feodal,13,21,7,QCM,0.68,0.17,16.07,10,55,65,26,10,16,2.5,38.46,Difficile,Difficile,0,Meme Difficulté,Pas Adapte,Law
4464,2019,Droit,2,Introduction Historique au Droit,2,La Contestation du Regime Feodal,13,21,7,QCM,0.17,0.87,70.81,48,20,68,57,48,9,1.19,84.21,Difficile,Facile,2,Beaucoup plus Facile,Adapte,Law
5575,2020,Droit,2,Introduction Historique au Droit,2,La Contestation du Regime Feodal,13,21,7,QCM,0.13,0.73,70.81,55,22,77,77,55,22,1.0,71.43,Facile,Facile,0,Meme Difficulté,Adapte,Law
21,2015,Droit,2,Introduction Historique au Droit,2,La Contestation du Regime Feodal,13,22,8,QCU,0.31,0.63,36.46,32,57,89,65,32,33,1.37,49.23,Moyen,Moyen,0,Meme Difficulté,Pas Adapte,Law
1132,2016,Droit,2,Introduction Historique au Droit,2,La Contestation du Regime Feodal,13,22,8,QCU,0.67,0.32,6.29,6,93,99,34,6,28,2.91,17.65,Difficile,Difficile,0,Meme Difficulté,Pas Adapte,Law
2243,2017,Droit,2,Introduction Historique au Droit,2,La Contestation du Regime Feodal,13,22,8,QCU,0.18,0.97,82.98,88,18,106,89,88,1,1.19,98.88,Facile,Facile,0,Meme Difficulté,Pas Adapte,Law
3354,2018,Droit,2,Introduction Historique au Droit,2,La Contestation du Regime Feodal,13,22,8,QCU,0.1,0.99,76.76,70,21,91,74,70,4,1.23,94.59,Difficile,Facile,2,Beaucoup plus Facile,Pas Adapte,Law
4465,2019,Droit,2,Introduction Historique au Droit,2,La Contestation du Regime Feodal,13,22,8,QCM,0.05,0.83,82.2,63,14,77,65,63,2,1.18,96.92,Moyen,Facile,1,Plus Facile,Pas Adapte,Law
5576,2020,Droit,2,Introduction Historique au Droit,2,La Contestation du Regime Feodal,13,22,8,QCM,0.6,0.23,20.69,16,61,77,29,16,13,2.66,55.17,Difficile,Difficile,0,Meme Difficulté,Pas Adapte,Law
22,2015,Droit,2,Introduction Historique au Droit,2,La Contestation du Regime Feodal,13,23,9,QROC,0.23,0.39,44.59,10,12,22,16,10,6,1.38,62.5,Difficile,Moyen,1,Plus Facile,Pas Adapte,Law
1133,2016,Droit,2,Introduction Historique au Droit,2,La Contestation du Regime Feodal,13,23,9,QROC,0.58,0.33,53.21,10,9,19,15,10,5,1.27,66.67,Difficile,Moyen,1,Plus Facile,Pas Adapte,Law
2244,2017,Droit,2,Introduction Historique au Droit,2,La Contestation du Regime Feodal,13,23,9,QROC,0.2,0.27,62.66,14,8,22,15,14,1,1.47,93.33,Difficile,Moyen,1,Plus Facile,Adapte,Law
3355,2018,Droit,2,Introduction Historique au Droit,2,La Contestation du Regime Feodal,13,23,9,QROC,0.29,0.38,62.66,13,8,21,16,13,3,1.31,81.25,Moyen,Moyen,0,Meme Difficulté,Adapte,Law
4466,2019,Droit,2,Introduction Historique au Droit,2,La Contestation du Regime Feodal,13,23,9,QO,0.43,0.26,62.66,13,7,20,15,13,2,1.33,86.67,Moyen,Moyen,0,Meme Difficulté,Adapte,Law
5577,2020,Droit,2,Introduction Historique au Droit,2,La Contestation du Regime Feodal,13,23,9,QO,0.22,0.18,62.66,11,6,17,16,11,5,1.06,68.75,Moyen,Moyen,0,Meme Difficulté,Adapte,Law
23,2015,Droit,2,Introduction Historique au Droit,2,La Contestation du Regime Feodal,13,24,10,QCU,0.43,0.34,28.3,20,52,72,50,20,30,1.44,40.0,Facile,Difficile,-2,Beaucoup plus Difficile,Pas Adapte,Law
1134,2016,Droit,2,Introduction Historique au Droit,2,La Contestation du Regime Feodal,13,24,10,QCU,0.0,0.82,99.53,61,0,61,61,61,0,1.0,100.0,Facile,Facile,0,Meme Difficulté,Pas Adapte,Law
2245,2017,Droit,2,Introduction Historique au Droit,2,La Contestation du Regime Feodal,13,24,10,QCU,0.37,0.75,50.63,34,33,67,64,34,30,1.05,53.12,Difficile,Moyen,1,Plus Facile,Pas Adapte,Law
3356,2018,Droit,2,Introduction Historique au Droit,2,La Contestation du Regime Feodal,13,24,10,QCM,0.11,0.97,83.97,55,11,66,65,55,10,1.02,84.62,Difficile,Facile,2,Beaucoup plus Facile,Pas Adapte,Law
4467,2019,Droit,2,Introduction Historique au Droit,2,La Contestation du Regime Feodal,13,24,10,QCM,0.7,0.16,2.43,1,58,59,52,1,51,1.13,1.92,Difficile,Difficile,0,Meme Difficulté,Pas Adapte,Law
5578,2020,Droit,2,Introduction Historique au Droit,2,La Contestation du Regime Feodal,13,24,10,QCM,0.71,0.23,29.22,16,38,54,37,16,21,1.46,43.24,Facile,Difficile,-2,Beaucoup plus Difficile,Pas Adapte,Law
24,2015,Droit,2,Introduction Historique au Droit,2,La Contestation du Regime Feodal,13,25,11,QCU,0.4,0.38,2.91,2,76,78,74,2,72,1.05,2.7,Facile,Difficile,-2,Beaucoup plus Difficile,Pas Adapte,Law
1135,2016,Droit,2,Introduction Historique au Droit,2,La Contestation du Regime Feodal,13,25,11,QCU,0.04,0.91,71.51,58,23,81,70,58,12,1.16,82.86,Difficile,Facile,2,Beaucoup plus Facile,Adapte,Law
2246,2017,Droit,2,Introduction Historique au Droit,2,La Contestation du Regime Feodal,13,25,11,QCU,0.13,0.86,71.51,59,23,82,69,59,10,1.19,85.51,Facile,Facile,0,Meme Difficulté,Adapte,Law
3357,2018,Droit,2,Introduction Historique au Droit,2,La Contestation du Regime Feodal,13,25,11,QCU,0.13,0.93,71.51,54,22,76,75,54,21,1.01,72.0,Facile,Facile,0,Meme Difficulté,Adapte,Law
4468,2019,Droit,2,Introduction Historique au Droit,2,La Contestation du Regime Feodal,13,25,11,QCU,0.13,0.8,71.51,49,20,69,53,49,4,1.3,92.45,Facile,Facile,0,Meme Difficulté,Adapte,Law
5579,2020,Droit,2,Introduction Historique au Droit,2,La Contestation du Regime Feodal,13,25,11,QCU,0.18,1.0,71.51,54,22,76,63,54,9,1.21,85.71,Facile,Facile,0,Meme Difficulté,Adapte,Law
25,2015,Droit,2,Introduction Historique au Droit,2,La Contestation du Regime Feodal,13,26,12,QCU,0.13,0.76,78.48,47,13,60,49,47,2,1.22,95.92,Facile,Facile,0,Meme Difficulté,Pas Adapte,Law
1136,2016,Droit,2,Introduction Historique au Droit,2,La Contestation du Regime Feodal,13,26,12,QCU,0.09,0.9,93.27,63,5,68,67,63,4,1.01,94.03,Facile,Facile,0,Meme Difficulté,Pas Adapte,Law
2247,2017,Droit,2,Introduction Historique au Droit,2,La Contestation du Regime Feodal,13,26,12,QCU,0.41,0.22,15.28,9,51,60,59,9,50,1.02,15.25,Moyen,Difficile,-1,Plus Difficile,Pas Adapte,Law
3358,2018,Droit,2,Introduction Historique au Droit,2,La Contestation du Regime Feodal,13,26,12,QCM,0.37,0.65,64.48,40,22,62,43,40,3,1.44,93.02,Moyen,Moyen,0,Meme Difficulté,Adapte,Law
4469,2019,Droit,2,Introduction Historique au Droit,2,La Contestation du Regime Feodal,13,26,12,QCM,0.24,0.5,64.48,36,20,56,37,36,1,1.51,97.3,Moyen,Moyen,0,Meme Difficulté,Adapte,Law
5580,2020,Droit,2,Introduction Historique au Droit,2,La Contestation du Regime Feodal,13,26,12,QCM,0.29,0.31,64.48,31,17,48,39,31,8,1.23,79.49,Moyen,Moyen,0,Meme Difficulté,Adapte,Law
26,2015,Droit,2,Introduction Historique au Droit,2,La Contestation du Regime Feodal,13,27,13,QCU,0.15,0.81,89.24,86,10,96,90,86,4,1.07,95.56,Difficile,Facile,2,Beaucoup plus Facile,Pas Adapte,Law
1137,2016,Droit,2,Introduction Historique au Droit,2,La Contestation du Regime Feodal,13,27,13,QCU,0.11,0.83,79.92,87,22,109,90,87,3,1.21,96.67,Difficile,Facile,2,Beaucoup plus Facile,Pas Adapte,Law
2248,2017,Droit,2,Introduction Historique au Droit,2,La Contestation du Regime Feodal,13,27,13,QCU,0.02,0.96,91.97,95,8,103,101,95,6,1.02,94.06,Facile,Facile,0,Meme Difficulté,Pas Adapte,Law
3359,2018,Droit,2,Introduction Historique au Droit,2,La Contestation du Regime Feodal,13,27,13,QCU,0.15,0.83,94.18,102,6,108,102,102,0,1.06,100.0,Difficile,Facile,2,Beaucoup plus Facile,Pas Adapte,Law
4470,2019,Droit,2,Introduction Historique au Droit,2,La Contestation du Regime Feodal,13,27,13,QCU,0.18,0.81,99.01,95,1,96,95,95,0,1.01,100.0,Difficile,Facile,2,Beaucoup plus Facile,Pas Adapte,Law
5581,2020,Droit,2,Introduction Historique au Droit,2,La Contestation du Regime Feodal,13,27,13,QCM,0.45,0.5,42.28,46,63,109,109,46,63,1.0,42.2,Moyen,Moyen,0,Meme Difficulté,Pas Adapte,Law
27,2015,Droit,2,Introduction Historique au Droit,3,La Crise de l'Ancien Regime,2,28,1,QCU,0.31,0.44,56.76,27,21,48,44,27,17,1.09,61.36,Facile,Moyen,-1,Plus Difficile,Pas Adapte,Law
1138,2016,Droit,2,Introduction Historique au Droit,3,La Crise de l'Ancien Regime,2,28,1,QCU,0.62,0.4,28.28,12,30,42,17,12,5,2.47,70.59,Facile,Difficile,-2,Beaucoup plus Difficile,Pas Adapte,Law
2249,2017,Droit,2,Introduction Historique au Droit,3,La Crise de l'Ancien Regime,2,28,1,QCU,0.74,0.29,16.55,7,38,45,32,7,25,1.41,21.88,Facile,Difficile,-2,Beaucoup plus Difficile,Pas Adapte,Law
3360,2018,Droit,2,Introduction Historique au Droit,3,La Crise de l'Ancien Regime,2,28,1,QCU,0.13,0.76,87.93,37,5,42,39,37,2,1.08,94.87,Difficile,Facile,2,Beaucoup plus Facile,Pas Adapte,Law
4471,2019,Droit,2,Introduction Historique au Droit,3,La Crise de l'Ancien Regime,2,28,1,QCU,0.38,0.54,45.8,20,24,44,37,20,17,1.19,54.05,Difficile,Moyen,1,Plus Facile,Pas Adapte,Law
5582,2020,Droit,2,Introduction Historique au Droit,3,La Crise de l'Ancien Regime,2,28,1,QCU,0.47,0.24,24.7,10,32,42,25,10,15,1.68,40.0,Facile,Difficile,-2,Beaucoup plus Difficile,Pas Adapte,Law
28,2015,Droit,2,Introduction Historique au Droit,3,La Crise de l'Ancien Regime,2,29,2,QCM,0.4,0.34,48.36,38,41,79,45,38,7,1.76,84.44,Difficile,Moyen,1,Plus Facile,Pas Adapte,Law
1139,2016,Droit,2,Introduction Historique au Droit,3,La Crise de l'Ancien Regime,2,29,2,QCM,0.6,0.2,3.56,3,72,75,38,3,35,1.97,7.89,Facile,Difficile,-2,Beaucoup plus Difficile,Pas Adapte,Law
2250,2017,Droit,2,Introduction Historique au Droit,3,La Crise de l'Ancien Regime,2,29,2,QCM,0.14,0.78,97.11,80,2,82,80,80,0,1.02,100.0,Facile,Facile,0,Meme Difficulté,Pas Adapte,Law
3361,2018,Droit,2,Introduction Historique au Droit,3,La Crise de l'Ancien Regime,2,29,2,QCM,0.28,0.38,55.21,47,38,85,82,47,35,1.04,57.32,Facile,Moyen,-1,Plus Difficile,Pas Adapte,Law
4472,2019,Droit,2,Introduction Historique au Droit,3,La Crise de l'Ancien Regime,2,29,2,QCM,0.37,0.39,45.62,34,40,74,70,34,36,1.06,48.57,Facile,Moyen,-1,Plus Difficile,Pas Adapte,Law
5583,2020,Droit,2,Introduction Historique au Droit,3,La Crise de l'Ancien Regime,2,29,2,QCM,0.11,0.83,87.44,68,10,78,78,68,10,1.0,87.18,Facile,Facile,0,Meme Difficulté,Pas Adapte,Law
29,2015,Droit,2,Introduction Historique au Droit,4,"La Revolution Francaise, l'Affirmation du Liberalisme",1,30,1,QCM,0.56,0.28,25.19,11,33,44,40,11,29,1.1,27.5,Facile,Difficile,-2,Beaucoup plus Difficile,Pas Adapte,Law
1140,2016,Droit,2,Introduction Historique au Droit,4,"La Revolution Francaise, l'Affirmation du Liberalisme",1,30,1,QCM,0.45,0.56,41.77,18,25,43,21,18,3,2.05,85.71,Difficile,Moyen,1,Plus Facile,Pas Adapte,Law
2251,2017,Droit,2,Introduction Historique au Droit,4,"La Revolution Francaise, l'Affirmation du Liberalisme",1,30,1,QCM,0.18,0.8,79.15,38,10,48,40,38,2,1.2,95.0,Moyen,Facile,1,Plus Facile,Pas Adapte,Law
3362,2018,Droit,2,Introduction Historique au Droit,4,"La Revolution Francaise, l'Affirmation du Liberalisme",1,30,1,QCM,0.0,0.89,99.65,46,0,46,46,46,0,1.0,100.0,Moyen,Facile,1,Plus Facile,Pas Adapte,Law
4473,2019,Droit,2,Introduction Historique au Droit,4,"La Revolution Francaise, l'Affirmation du Liberalisme",1,30,1,QCM,0.06,0.91,88.38,44,6,50,47,44,3,1.06,93.62,Difficile,Facile,2,Beaucoup plus Facile,Pas Adapte,Law
5584,2020,Droit,2,Introduction Historique au Droit,4,"La Revolution Francaise, l'Affirmation du Liberalisme",1,30,1,QCM,0.72,0.19,23.64,12,40,52,49,12,37,1.06,24.49,Difficile,Difficile,0,Meme Difficulté,Pas Adapte,Law
30,2015,Droit,2,Introduction Historique au Droit,5,L'Amenagement du Liberalisme,13,31,1,QCM,0.03,0.9,93.12,6,0,6,6,6,0,1.0,100.0,Moyen,Facile,1,Plus Facile,Pas Adapte,Law
1141,2016,Droit,2,Introduction Historique au Droit,5,L'Amenagement du Liberalisme,13,31,1,QCM,0.36,0.62,45.92,3,3,6,6,3,3,1.0,50.0,Moyen,Moyen,0,Meme Difficulté,Pas Adapte,Law
2252,2017,Droit,2,Introduction Historique au Droit,5,L'Amenagement du Liberalisme,13,31,1,QCM,0.47,0.34,35.92,2,4,6,5,2,3,1.2,40.0,Facile,Moyen,-1,Plus Difficile,Pas Adapte,Law
3363,2018,Droit,2,Introduction Historique au Droit,5,L'Amenagement du Liberalisme,13,31,1,QCM,0.32,0.4,43.18,3,3,6,5,3,2,1.2,60.0,Facile,Moyen,-1,Plus Difficile,Pas Adapte,Law
4474,2019,Droit,2,Introduction Historique au Droit,5,L'Amenagement du Liberalisme,13,31,1,QCU,0.21,0.67,49.17,2,3,5,5,2,3,1.0,40.0,Moyen,Moyen,0,Meme Difficulté,Pas Adapte,Law
5585,2020,Droit,2,Introduction Historique au Droit,5,L'Amenagement du Liberalisme,13,31,1,QCU,0.27,0.75,53.29,3,2,5,4,3,1,1.25,75.0,Moyen,Moyen,0,Meme Difficulté,Pas Adapte,Law
31,2015,Droit,2,Introduction Historique au Droit,5,L'Amenagement du Liberalisme,13,32,2,QO,0.36,0.22,56.11,3,3,6,5,3,2,1.2,60.0,Facile,Moyen,-1,Plus Difficile,Pas Adapte,Law
1142,2016,Droit,2,Introduction Historique au Droit,5,L'Amenagement du Liberalisme,13,32,2,QO,0.04,0.76,93.95,7,0,7,7,7,0,1.0,100.0,Facile,Facile,0,Meme Difficulté,Pas Adapte,Law
2253,2017,Droit,2,Introduction Historique au Droit,5,L'Amenagement du Liberalisme,13,32,2,QCM,0.38,0.38,36.61,2,4,6,4,2,2,1.5,50.0,Moyen,Moyen,0,Meme Difficulté,Pas Adapte,Law
3364,2018,Droit,2,Introduction Historique au Droit,5,L'Amenagement du Liberalisme,13,32,2,QCM,0.79,0.29,8.25,1,6,7,2,1,1,3.5,50.0,Moyen,Difficile,-1,Plus Difficile,Pas Adapte,Law
4475,2019,Droit,2,Introduction Historique au Droit,5,L'Amenagement du Liberalisme,13,32,2,QCM,0.7,0.25,31.56,2,4,6,6,2,4,1.0,33.33,Moyen,Difficile,-1,Plus Difficile,Pas Adapte,Law
5586,2020,Droit,2,Introduction Historique au Droit,5,L'Amenagement du Liberalisme,13,32,2,QCM,0.02,0.91,88.01,4,1,5,4,4,0,1.25,100.0,Facile,Facile,0,Meme Difficulté,Pas Adapte,Law
32,2015,Droit,2,Introduction Historique au Droit,5,L'Amenagement du Liberalisme,13,33,3,QCM,0.02,0.92,81.93,48,10,58,54,48,6,1.07,88.89,Moyen,Facile,1,Plus Facile,Pas Adapte,Law
1143,2016,Droit,2,Introduction Historique au Droit,5,L'Amenagement du Liberalisme,13,33,3,QCM,0.36,0.39,49.05,30,32,62,45,30,15,1.38,66.67,Facile,Moyen,-1,Plus Difficile,Pas Adapte,Law
2254,2017,Droit,2,Introduction Historique au Droit,5,L'Amenagement du Liberalisme,13,33,3,QCM,0.56,0.23,12.2,9,61,70,29,9,20,2.41,31.03,Moyen,Difficile,-1,Plus Difficile,Pas Adapte,Law
3365,2018,Droit,2,Introduction Historique au Droit,5,L'Amenagement du Liberalisme,13,33,3,QCM,0.06,0.75,96.55,58,2,60,59,58,1,1.02,98.31,Moyen,Facile,1,Plus Facile,Pas Adapte,Law
4476,2019,Droit,2,Introduction Historique au Droit,5,L'Amenagement du Liberalisme,13,33,3,QCM,0.09,0.7,86.84,54,8,62,55,54,1,1.13,98.18,Facile,Facile,0,Meme Difficulté,Pas Adapte,Law
5587,2020,Droit,2,Introduction Historique au Droit,5,L'Amenagement du Liberalisme,13,33,3,QCM,0.55,0.29,2.66,2,55,57,37,2,35,1.54,5.41,Facile,Difficile,-2,Beaucoup plus Difficile,Pas Adapte,Law
33,2015,Droit,2,Introduction Historique au Droit,5,L'Amenagement du Liberalisme,13,34,4,QCM,0.25,0.52,64.3,26,15,41,32,26,6,1.28,81.25,Moyen,Moyen,0,Meme Difficulté,Adapte,Law
1144,2016,Droit,2,Introduction Historique au Droit,5,L'Amenagement du Liberalisme,13,34,4,QCM,0.36,0.33,64.3,25,14,39,30,25,5,1.3,83.33,Moyen,Moyen,0,Meme Difficulté,Adapte,Law
2255,2017,Droit,2,Introduction Historique au Droit,5,L'Amenagement du Liberalisme,13,34,4,QCM,0.32,0.59,64.3,28,16,44,29,28,1,1.52,96.55,Moyen,Moyen,0,Meme Difficulté,Adapte,Law
3366,2018,Droit,2,Introduction Historique au Droit,5,L'Amenagement du Liberalisme,13,34,4,QCM,0.41,0.35,64.3,30,16,46,44,30,14,1.05,68.18,Moyen,Moyen,0,Meme Difficulté,Adapte,Law
4477,2019,Droit,2,Introduction Historique au Droit,5,L'Amenagement du Liberalisme,13,34,4,QCU,0.27,0.73,64.3,25,14,39,27,25,2,1.44,92.59,Moyen,Moyen,0,Meme Difficulté,Adapte,Law
5588,2020,Droit,2,Introduction Historique au Droit,5,L'Amenagement du Liberalisme,13,34,4,QCU,0.39,0.42,64.3,27,15,42,37,27,10,1.14,72.97,Moyen,Moyen,0,Meme Difficulté,Adapte,Law
34,2015,Droit,2,Introduction Historique au Droit,5,L'Amenagement du Liberalisme,13,35,5,QCU,0.4,0.25,8.38,8,83,91,64,8,56,1.42,12.5,Facile,Difficile,-2,Beaucoup plus Difficile,Pas Adapte,Law
1145,2016,Droit,2,Introduction Historique au Droit,5,L'Amenagement du Liberalisme,13,35,5,QCU,0.41,0.25,22.12,22,79,101,98,22,76,1.03,22.45,Difficile,Difficile,0,Meme Difficulté,Pas Adapte,Law
2256,2017,Droit,2,Introduction Historique au Droit,5,L'Amenagement du Liberalisme,13,35,5,QCU,0.53,0.31,7.92,9,99,108,76,9,67,1.42,11.84,Facile,Difficile,-2,Beaucoup plus Difficile,Pas Adapte,Law
3367,2018,Droit,2,Introduction Historique au Droit,5,L'Amenagement du Liberalisme,13,35,5,QCU,0.74,0.33,21.26,20,72,92,43,20,23,2.14,46.51,Moyen,Difficile,-1,Plus Difficile,Pas Adapte,Law
4478,2019,Droit,2,Introduction Historique au Droit,5,L'Amenagement du Liberalisme,13,35,5,QCU,0.11,0.89,89.03,89,11,100,99,89,10,1.01,89.9,Difficile,Facile,2,Beaucoup plus Facile,Pas Adapte,Law
5589,2020,Droit,2,Introduction Historique au Droit,5,L'Amenagement du Liberalisme,13,35,5,QCU,0.19,0.8,73.26,62,23,85,66,62,4,1.29,93.94,Difficile,Facile,2,Beaucoup plus Facile,Adapte,Law
35,2015,Droit,2,Introduction Historique au Droit,5,L'Amenagement du Liberalisme,13,36,6,QCU,0.08,0.87,96.14,14,1,15,14,14,0,1.07,100.0,Facile,Facile,0,Meme Difficulté,Pas Adapte,Law
1146,2016,Droit,2,Introduction Historique au Droit,5,L'Amenagement du Liberalisme,13,36,6,QCU,0.3,0.59,41.3,6,8,14,7,6,1,2.0,85.71,Moyen,Moyen,0,Meme Difficulté,Pas Adapte,Law
2257,2017,Droit,2,Introduction Historique au Droit,5,L'Amenagement du Liberalisme,13,36,6,QCU,0.18,0.82,93.48,11,1,12,12,11,1,1.0,91.67,Facile,Facile,0,Meme Difficulté,Pas Adapte,Law
3368,2018,Droit,2,Introduction Historique au Droit,5,L'Amenagement du Liberalisme,13,36,6,QCU,0.45,0.24,6.14,1,12,13,11,1,10,1.18,9.09,Difficile,Difficile,0,Meme Difficulté,Pas Adapte,Law
4479,2019,Droit,2,Introduction Historique au Droit,5,L'Amenagement du Liberalisme,13,36,6,QCU,0.2,0.45,55.63,7,5,12,9,7,2,1.33,77.78,Difficile,Moyen,1,Plus Facile,Pas Adapte,Law
5590,2020,Droit,2,Introduction Historique au Droit,5,L'Amenagement du Liberalisme,13,36,6,QCU,0.65,0.38,27.03,4,10,14,9,4,5,1.56,44.44,Difficile,Difficile,0,Meme Difficulté,Pas Adapte,Law
36,2015,Droit,2,Introduction Historique au Droit,5,L'Amenagement du Liberalisme,13,37,7,QCM,0.24,0.65,49.82,41,42,83,75,41,34,1.11,54.67,Difficile,Moyen,1,Plus Facile,Pas Adapte,Law
1147,2016,Droit,2,Introduction Historique au Droit,5,L'Amenagement du Liberalisme,13,37,7,QCU,0.61,0.23,12.75,9,64,73,30,9,21,2.43,30.0,Difficile,Difficile,0,Meme Difficulté,Pas Adapte,Law
2258,2017,Droit,2,Introduction Historique au Droit,5,L'Amenagement du Liberalisme,13,37,7,QCU,0.68,0.3,2.92,2,73,75,28,2,26,2.68,7.14,Facile,Difficile,-2,Beaucoup plus Difficile,Pas Adapte,Law
3369,2018,Droit,2,Introduction Historique au Droit,5,L'Amenagement du Liberalisme,13,37,7,QCU,0.34,0.71,38.06,25,40,65,41,25,16,1.59,60.98,Difficile,Moyen,1,Plus Facile,Pas Adapte,Law
4480,2019,Droit,2,Introduction Historique au Droit,5,L'Amenagement du Liberalisme,13,37,7,QCU,0.21,0.75,43.51,32,42,74,35,32,3,2.11,91.43,Difficile,Moyen,1,Plus Facile,Pas Adapte,Law
5591,2020,Droit,2,Introduction Historique au Droit,5,L'Amenagement du Liberalisme,13,37,7,QCU,0.15,0.75,71.37,46,19,65,56,46,10,1.16,82.14,Difficile,Facile,2,Beaucoup plus Facile,Adapte,Law
37,2015,Droit,2,Introduction Historique au Droit,5,L'Amenagement du Liberalisme,13,38,8,QCU,0.08,0.98,83.57,32,6,38,33,32,1,1.15,96.97,Difficile,Facile,2,Beaucoup plus Facile,Pas Adapte,Law
1148,2016,Droit,2,Introduction Historique au Droit,5,L'Amenagement du Liberalisme,13,38,8,QCU,0.42,0.32,14.41,6,35,41,16,6,10,2.56,37.5,Facile,Difficile,-2,Beaucoup plus Difficile,Pas Adapte,Law
2259,2017,Droit,2,Introduction Historique au Droit,5,L'Amenagement du Liberalisme,13,38,8,QCU,0.51,0.2,9.67,3,33,36,20,3,17,1.8,15.0,Difficile,Difficile,0,Meme Difficulté,Pas Adapte,Law
3370,2018,Droit,2,Introduction Historique au Droit,5,L'Amenagement du Liberalisme,13,38,8,QCU,0.34,0.55,36.98,14,23,37,16,14,2,2.31,87.5,Facile,Moyen,-1,Plus Difficile,Pas Adapte,Law
4481,2019,Droit,2,Introduction Historique au Droit,5,L'Amenagement du Liberalisme,13,38,8,QCU,0.01,0.99,97.26,31,1,32,32,31,1,1.0,96.88,Facile,Facile,0,Meme Difficulté,Pas Adapte,Law
5592,2020,Droit,2,Introduction Historique au Droit,5,L'Amenagement du Liberalisme,13,38,8,QCU,0.16,0.94,81.86,29,6,35,35,29,6,1.0,82.86,Difficile,Facile,2,Beaucoup plus Facile,Pas Adapte,Law
38,2015,Droit,2,Introduction Historique au Droit,5,L'Amenagement du Liberalisme,13,39,9,QROC,0.93,0.21,21.97,5,19,24,13,5,8,1.85,38.46,Difficile,Difficile,0,Meme Difficulté,Pas Adapte,Law
1149,2016,Droit,2,Introduction Historique au Droit,5,L'Amenagement du Liberalisme,13,39,9,QO,0.85,0.05,28.76,8,19,27,18,8,10,1.5,44.44,Difficile,Difficile,0,Meme Difficulté,Pas Adapte,Law
2260,2017,Droit,2,Introduction Historique au Droit,5,L'Amenagement du Liberalisme,13,39,9,QO,0.95,0.14,32.81,10,20,30,24,10,14,1.25,41.67,Difficile,Difficile,0,Meme Difficulté,Pas Adapte,Law
3371,2018,Droit,2,Introduction Historique au Droit,5,L'Amenagement du Liberalisme,13,39,9,QCM,0.62,0.18,23.98,7,22,29,17,7,10,1.71,41.18,Facile,Difficile,-2,Beaucoup plus Difficile,Pas Adapte,Law
4482,2019,Droit,2,Introduction Historique au Droit,5,L'Amenagement du Liberalisme,13,39,9,QCM,0.04,0.99,87.19,23,3,26,25,23,2,1.04,92.0,Difficile,Facile,2,Beaucoup plus Facile,Pas Adapte,Law
5593,2020,Droit,2,Introduction Historique au Droit,5,L'Amenagement du Liberalisme,13,39,9,QCU,0.54,0.39,17.83,4,19,23,10,4,6,2.3,40.0,Difficile,Difficile,0,Meme Difficulté,Pas Adapte,Law
39,2015,Droit,2,Introduction Historique au Droit,5,L'Amenagement du Liberalisme,13,40,10,QCM,0.69,0.27,13.62,10,67,77,34,10,24,2.26,29.41,Difficile,Difficile,0,Meme Difficulté,Pas Adapte,Law
1150,2016,Droit,2,Introduction Historique au Droit,5,L'Amenagement du Liberalisme,13,40,10,QCM,0.16,0.85,78.76,65,17,82,76,65,11,1.08,85.53,Moyen,Facile,1,Plus Facile,Pas Adapte,Law
2261,2017,Droit,2,Introduction Historique au Droit,5,L'Amenagement du Liberalisme,13,40,10,QCU,0.25,0.72,43.35,41,53,94,54,41,13,1.74,75.93,Difficile,Moyen,1,Plus Facile,Pas Adapte,Law
3372,2018,Droit,2,Introduction Historique au Droit,5,L'Amenagement du Liberalisme,13,40,10,QCU,0.33,0.42,48.51,39,42,81,71,39,32,1.14,54.93,Moyen,Moyen,0,Meme Difficulté,Pas Adapte,Law
4483,2019,Droit,2,Introduction Historique au Droit,5,L'Amenagement du Liberalisme,13,40,10,QCU,0.08,0.82,68.79,57,26,83,72,57,15,1.15,79.17,Moyen,Facile,1,Plus Facile,Adapte,Law
5594,2020,Droit,2,Introduction Historique au Droit,5,L'Amenagement du Liberalisme,13,40,10,QCU,0.04,1.0,68.79,62,28,90,62,62,0,1.45,100.0,Facile,Facile,0,Meme Difficulté,Adapte,Law
40,2015,Droit,2,Introduction Historique au Droit,5,L'Amenagement du Liberalisme,13,41,11,QROC,0.2,0.27,40.39,25,38,63,34,25,9,1.85,73.53,Facile,Moyen,-1,Plus Difficile,Pas Adapte,Law
1151,2016,Droit,2,Introduction Historique au Droit,5,L'Amenagement du Liberalisme,13,41,11,QROC,0.34,0.39,58.11,31,23,54,46,31,15,1.17,67.39,Difficile,Moyen,1,Plus Facile,Pas Adapte,Law
2262,2017,Droit,2,Introduction Historique au Droit,5,L'Amenagement du Liberalisme,13,41,11,QROC,0.23,0.28,49.93,27,28,55,38,27,11,1.45,71.05,Difficile,Moyen,1,Plus Facile,Pas Adapte,Law
3373,2018,Droit,2,Introduction Historique au Droit,5,L'Amenagement du Liberalisme,13,41,11,QROC,0.12,0.53,79.04,48,13,61,57,48,9,1.07,84.21,Moyen,Facile,1,Plus Facile,Pas Adapte,Law
4484,2019,Droit,2,Introduction Historique au Droit,5,L'Amenagement du Liberalisme,13,41,11,QROC,0.38,0.25,47.04,26,30,56,27,26,1,2.07,96.3,Moyen,Moyen,0,Meme Difficulté,Pas Adapte,Law
5595,2020,Droit,2,Introduction Historique au Droit,5,L'Amenagement du Liberalisme,13,41,11,QROC,0.65,0.1,24.41,15,47,62,37,15,22,1.68,40.54,Moyen,Difficile,-1,Plus Difficile,Pas Adapte,Law
41,2015,Droit,2,Introduction Historique au Droit,5,L'Amenagement du Liberalisme,13,42,12,QROC,0.55,0.31,55.15,26,21,47,27,26,1,1.74,96.3,Facile,Moyen,-1,Plus Difficile,Pas Adapte,Law
1152,2016,Droit,2,Introduction Historique au Droit,5,L'Amenagement du Liberalisme,13,42,12,QROC,0.03,0.87,83.5,34,7,41,35,34,1,1.17,97.14,Facile,Facile,0,Meme Difficulté,Pas Adapte,Law
2263,2017,Droit,2,Introduction Historique au Droit,5,L'Amenagement du Liberalisme,13,42,12,QCM,0.4,0.69,37.72,17,29,46,45,17,28,1.02,37.78,Facile,Moyen,-1,Plus Difficile,Pas Adapte,Law
3374,2018,Droit,2,Introduction Historique au Droit,5,L'Amenagement du Liberalisme,13,42,12,QCU,0.07,0.83,90.25,47,5,52,49,47,2,1.06,95.92,Facile,Facile,0,Meme Difficulté,Pas Adapte,Law
4485,2019,Droit,2,Introduction Historique au Droit,5,L'Amenagement du Liberalisme,13,42,12,QCU,0.65,0.25,4.97,3,49,52,43,3,40,1.21,6.98,Facile,Difficile,-2,Beaucoup plus Difficile,Pas Adapte,Law
5596,2020,Droit,2,Introduction Historique au Droit,5,L'Amenagement du Liberalisme,13,42,12,QCU,0.42,0.35,0.5,0,53,53,36,0,36,1.47,0.0,Moyen,Difficile,-1,Plus Difficile,Pas Adapte,Law
42,2015,Droit,2,Introduction Historique au Droit,5,L'Amenagement du Liberalisme,13,43,13,QROC,0.52,0.34,58.78,16,11,27,23,16,7,1.17,69.57,Facile,Moyen,-1,Plus Difficile,Pas Adapte,Law
1153,2016,Droit,2,Introduction Historique au Droit,5,L'Amenagement du Liberalisme,13,43,13,QROC,0.12,0.83,88.32,20,3,23,23,20,3,1.0,86.96,Difficile,Facile,2,Beaucoup plus Facile,Pas Adapte,Law
2264,2017,Droit,2,Introduction Historique au Droit,5,L'Amenagement du Liberalisme,13,43,13,QROC,0.07,0.43,98.89,26,0,26,26,26,0,1.0,100.0,Facile,Facile,0,Meme Difficulté,Pas Adapte,Law
3375,2018,Droit,2,Introduction Historique au Droit,5,L'Amenagement du Liberalisme,13,43,13,QROC,0.29,0.39,49.06,12,12,24,15,12,3,1.6,80.0,Difficile,Moyen,1,Plus Facile,Pas Adapte,Law
4486,2019,Droit,2,Introduction Historique au Droit,5,L'Amenagement du Liberalisme,13,43,13,QROC,0.24,0.25,49.51,10,11,21,19,10,9,1.11,52.63,Difficile,Moyen,1,Plus Facile,Pas Adapte,Law
5597,2020,Droit,2,Introduction Historique au Droit,5,L'Amenagement du Liberalisme,13,43,13,QROC,0.31,0.31,54.11,13,11,24,22,13,9,1.09,59.09,Moyen,Moyen,0,Meme Difficulté,Pas Adapte,Law
43,2015,Droit,3,Relations Internationales,1,Introduction,12,44,1,QCM,0.73,0.26,16.98,11,54,65,54,11,43,1.2,20.37,Difficile,Difficile,0,Meme Difficulté,Pas Adapte,Law
1154,2016,Droit,3,Relations Internationales,1,Introduction,12,44,1,QCM,0.32,0.54,47.86,30,33,63,59,30,29,1.07,50.85,Difficile,Moyen,1,Plus Facile,Pas Adapte,Law
2265,2017,Droit,3,Relations Internationales,1,Introduction,12,44,1,QCM,0.22,0.63,37.42,26,44,70,53,26,27,1.32,49.06,Facile,Moyen,-1,Plus Difficile,Pas Adapte,Law
3376,2018,Droit,3,Relations Internationales,1,Introduction,12,44,1,QCM,0.7,0.24,7.59,5,62,67,26,5,21,2.58,19.23,Facile,Difficile,-2,Beaucoup plus Difficile,Pas Adapte,Law
4487,2019,Droit,3,Relations Internationales,1,Introduction,12,44,1,QCU,0.46,0.35,19.67,15,59,74,44,15,29,1.68,34.09,Difficile,Difficile,0,Meme Difficulté,Pas Adapte,Law
5598,2020,Droit,3,Relations Internationales,1,Introduction,12,44,1,QCU,0.05,0.77,79.45,62,16,78,68,62,6,1.15,91.18,Moyen,Facile,1,Plus Facile,Pas Adapte,Law
44,2015,Droit,3,Relations Internationales,1,Introduction,12,45,2,QCU,0.1,0.93,77.57,45,13,58,54,45,9,1.07,83.33,Moyen,Facile,1,Plus Facile,Pas Adapte,Law
1155,2016,Droit,3,Relations Internationales,1,Introduction,12,45,2,QCU,0.07,0.85,77.74,38,11,49,47,38,9,1.04,80.85,Difficile,Facile,2,Beaucoup plus Facile,Pas Adapte,Law
2266,2017,Droit,3,Relations Internationales,1,Introduction,12,45,2,QCM,0.14,0.97,92.29,42,3,45,44,42,2,1.02,95.45,Difficile,Facile,2,Beaucoup plus Facile,Pas Adapte,Law
3377,2018,Droit,3,Relations Internationales,1,Introduction,12,45,2,QROC,0.03,0.7,79.71,34,9,43,39,34,5,1.1,87.18,Moyen,Facile,1,Plus Facile,Pas Adapte,Law
4488,2019,Droit,3,Relations Internationales,1,Introduction,12,45,2,QROC,0.45,0.26,58.64,27,19,46,40,27,13,1.15,67.5,Moyen,Moyen,0,Meme Difficulté,Pas Adapte,Law
5599,2020,Droit,3,Relations Internationales,1,Introduction,12,45,2,QROC,0.77,0.23,6.52,3,41,44,30,3,27,1.47,10.0,Difficile,Difficile,0,Meme Difficulté,Pas Adapte,Law
45,2015,Droit,3,Relations Internationales,1,Introduction,12,46,3,QROC,0.04,0.55,71.06,7,3,10,8,7,1,1.25,87.5,Facile,Facile,0,Meme Difficulté,Adapte,Law
1156,2016,Droit,3,Relations Internationales,1,Introduction,12,46,3,QROC,0.11,0.52,71.06,8,3,11,9,8,1,1.22,88.89,Facile,Facile,0,Meme Difficulté,Adapte,Law
2267,2017,Droit,3,Relations Internationales,1,Introduction,12,46,3,QROC,0.18,1.0,71.06,7,3,10,9,7,2,1.11,77.78,Facile,Facile,0,Meme Difficulté,Adapte,Law
3378,2018,Droit,3,Relations Internationales,1,Introduction,12,46,3,QO,0.04,0.6,71.06,6,3,9,8,6,2,1.12,75.0,Facile,Facile,0,Meme Difficulté,Adapte,Law
4489,2019,Droit,3,Relations Internationales,1,Introduction,12,46,3,QCM,0.05,0.91,71.06,7,3,10,8,7,1,1.25,87.5,Facile,Facile,0,Meme Difficulté,Adapte,Law
5600,2020,Droit,3,Relations Internationales,1,Introduction,12,46,3,QCM,0.09,0.87,71.06,7,3,10,8,7,1,1.25,87.5,Facile,Facile,0,Meme Difficulté,Adapte,Law
46,2015,Droit,3,Relations Internationales,1,Introduction,12,47,4,QCU,0.01,0.88,85.62,56,9,65,59,56,3,1.1,94.92,Facile,Facile,0,Meme Difficulté,Pas Adapte,Law
1157,2016,Droit,3,Relations Internationales,1,Introduction,12,47,4,QCU,0.05,0.79,96.03,61,3,64,63,61,2,1.02,96.83,Difficile,Facile,2,Beaucoup plus Facile,Pas Adapte,Law
2268,2017,Droit,3,Relations Internationales,1,Introduction,12,47,4,QCU,0.06,0.8,78.19,43,12,55,53,43,10,1.04,81.13,Difficile,Facile,2,Beaucoup plus Facile,Pas Adapte,Law
3379,2018,Droit,3,Relations Internationales,1,Introduction,12,47,4,QCU,0.44,0.32,13.03,7,47,54,29,7,22,1.86,24.14,Moyen,Difficile,-1,Plus Difficile,Pas Adapte,Law
4490,2019,Droit,3,Relations Internationales,1,Introduction,12,47,4,QCU,0.47,0.38,25.07,14,43,57,29,14,15,1.97,48.28,Facile,Difficile,-2,Beaucoup plus Difficile,Pas Adapte,Law
5601,2020,Droit,3,Relations Internationales,1,Introduction,12,47,4,QCU,0.07,0.75,97.18,55,2,57,56,55,1,1.02,98.21,Moyen,Facile,1,Plus Facile,Pas Adapte,Law
47,2015,Droit,3,Relations Internationales,1,Introduction,12,48,5,QROC,0.46,0.31,55.11,51,42,93,73,51,22,1.27,69.86,Moyen,Moyen,0,Meme Difficulté,Pas Adapte,Law
1158,2016,Droit,3,Relations Internationales,1,Introduction,12,48,5,QROC,0.77,0.09,6.87,6,87,93,61,6,55,1.52,9.84,Facile,Difficile,-2,Beaucoup plus Difficile,Pas Adapte,Law
2269,2017,Droit,3,Relations Internationales,1,Introduction,12,48,5,QROC,0.27,0.4,40.7,33,49,82,49,33,16,1.67,67.35,Moyen,Moyen,0,Meme Difficulté,Pas Adapte,Law
3380,2018,Droit,3,Relations Internationales,1,Introduction,12,48,5,QO,0.4,0.19,37.15,35,59,94,58,35,23,1.62,60.34,Moyen,Moyen,0,Meme Difficulté,Pas Adapte,Law
4491,2019,Droit,3,Relations Internationales,1,Introduction,12,48,5,QO,0.5,0.16,54.12,49,42,91,90,49,41,1.01,54.44,Moyen,Moyen,0,Meme Difficulté,Pas Adapte,Law
5602,2020,Droit,3,Relations Internationales,1,Introduction,12,48,5,QO,0.2,0.59,74.38,68,24,92,84,68,16,1.1,80.95,Difficile,Facile,2,Beaucoup plus Facile,Adapte,Law
48,2015,Droit,3,Relations Internationales,1,Introduction,12,49,6,QO,0.77,0.11,31.92,7,14,21,19,7,12,1.11,36.84,Moyen,Difficile,-1,Plus Difficile,Pas Adapte,Law
1159,2016,Droit,3,Relations Internationales,1,Introduction,12,49,6,QO,0.74,0.23,62.44,15,9,24,15,15,0,1.6,100.0,Difficile,Moyen,1,Plus Facile,Adapte,Law
2270,2017,Droit,3,Relations Internationales,1,Introduction,12,49,6,QO,0.39,0.22,62.44,12,8,20,16,12,4,1.25,75.0,Moyen,Moyen,0,Meme Difficulté,Adapte,Law
3381,2018,Droit,3,Relations Internationales,1,Introduction,12,49,6,QO,0.47,0.24,62.44,11,6,17,16,11,5,1.06,68.75,Moyen,Moyen,0,Meme Difficulté,Adapte,Law
4492,2019,Droit,3,Relations Internationales,1,Introduction,12,49,6,QROC,0.53,0.25,62.44,9,5,14,12,9,3,1.17,75.0,Moyen,Moyen,0,Meme Difficulté,Adapte,Law
5603,2020,Droit,3,Relations Internationales,1,Introduction,12,49,6,QO,0.74,0.2,62.44,9,5,14,9,9,0,1.56,100.0,Moyen,Moyen,0,Meme Difficulté,Adapte,Law
49,2015,Droit,3,Relations Internationales,1,Introduction,12,50,7,QCM,0.16,0.81,73.73,62,22,84,66,62,4,1.27,93.94,Facile,Facile,0,Meme Difficulté,Adapte,Law
1160,2016,Droit,3,Relations Internationales,1,Introduction,12,50,7,QCU,0.19,0.98,73.73,63,22,85,77,63,14,1.1,81.82,Facile,Facile,0,Meme Difficulté,Adapte,Law
2271,2017,Droit,3,Relations Internationales,1,Introduction,12,50,7,QCU,0.06,0.8,73.73,63,23,86,76,63,13,1.13,82.89,Facile,Facile,0,Meme Difficulté,Adapte,Law
3382,2018,Droit,3,Relations Internationales,1,Introduction,12,50,7,QCU,0.08,0.82,73.73,73,26,99,90,73,17,1.1,81.11,Facile,Facile,0,Meme Difficulté,Adapte,Law
4493,2019,Droit,3,Relations Internationales,1,Introduction,12,50,7,QCU,0.19,0.8,73.73,71,25,96,83,71,12,1.16,85.54,Facile,Facile,0,Meme Difficulté,Adapte,Law
5604,2020,Droit,3,Relations Internationales,1,Introduction,12,50,7,QCU,0.17,0.98,73.73,74,27,101,89,74,15,1.13,83.15,Facile,Facile,0,Meme Difficulté,Adapte,Law
50,2015,Droit,3,Relations Internationales,1,Introduction,12,51,8,QROC,0.15,0.61,91.07,8,1,9,9,8,1,1.0,88.89,Moyen,Facile,1,Plus Facile,Pas Adapte,Law
1161,2016,Droit,3,Relations Internationales,1,Introduction,12,51,8,QO,0.12,0.71,72.78,6,2,8,7,6,1,1.14,85.71,Moyen,Facile,1,Plus Facile,Adapte,Law
2272,2017,Droit,3,Relations Internationales,1,Introduction,12,51,8,QO,0.2,0.55,72.78,7,2,9,9,7,2,1.0,77.78,Facile,Facile,0,Meme Difficulté,Adapte,Law
3383,2018,Droit,3,Relations Internationales,1,Introduction,12,51,8,QO,0.07,0.52,72.78,6,2,8,7,6,1,1.14,85.71,Facile,Facile,0,Meme Difficulté,Adapte,Law
4494,2019,Droit,3,Relations Internationales,1,Introduction,12,51,8,QO,0.08,0.74,72.78,6,2,8,8,6,2,1.0,75.0,Facile,Facile,0,Meme Difficulté,Adapte,Law
5605,2020,Droit,3,Relations Internationales,1,Introduction,12,51,8,QO,0.15,0.44,72.78,7,2,9,8,7,1,1.12,87.5,Facile,Facile,0,Meme Difficulté,Adapte,Law
51,2015,Droit,3,Relations Internationales,1,Introduction,12,52,9,QCU,0.28,0.47,46.44,42,49,91,46,42,4,1.98,91.3,Moyen,Moyen,0,Meme Difficulté,Pas Adapte,Law
1162,2016,Droit,3,Relations Internationales,1,Introduction,12,52,9,QCM,0.8,0.19,7.8,7,86,93,89,7,82,1.04,7.87,Difficile,Difficile,0,Meme Difficulté,Pas Adapte,Law
2273,2017,Droit,3,Relations Internationales,1,Introduction,12,52,9,QCM,0.31,0.48,52.73,45,41,86,53,45,8,1.62,84.91,Difficile,Moyen,1,Plus Facile,Pas Adapte,Law
3384,2018,Droit,3,Relations Internationales,1,Introduction,12,52,9,QCM,0.17,0.99,90.83,67,7,74,73,67,6,1.01,91.78,Moyen,Facile,1,Plus Facile,Pas Adapte,Law
4495,2019,Droit,3,Relations Internationales,1,Introduction,12,52,9,QCM,0.03,0.91,90.0,59,6,65,64,59,5,1.02,92.19,Difficile,Facile,2,Beaucoup plus Facile,Pas Adapte,Law
5606,2020,Droit,3,Relations Internationales,1,Introduction,12,52,9,QCM,0.58,0.25,31.95,19,42,61,19,19,0,3.21,100.0,Difficile,Difficile,0,Meme Difficulté,Pas Adapte,Law
52,2015,Droit,3,Relations Internationales,1,Introduction,12,53,10,QO,0.06,0.95,86.57,22,3,25,23,22,1,1.09,95.65,Difficile,Facile,2,Beaucoup plus Facile,Pas Adapte,Law
1163,2016,Droit,3,Relations Internationales,1,Introduction,12,53,10,QO,0.06,0.56,90.99,25,2,27,26,25,1,1.04,96.15,Moyen,Facile,1,Plus Facile,Pas Adapte,Law
2274,2017,Droit,3,Relations Internationales,1,Introduction,12,53,10,QO,0.21,0.23,41.95,10,13,23,18,10,8,1.28,55.56,Difficile,Moyen,1,Plus Facile,Pas Adapte,Law
3385,2018,Droit,3,Relations Internationales,1,Introduction,12,53,10,QO,0.66,0.18,39.3,9,14,23,15,9,6,1.53,60.0,Facile,Moyen,-1,Plus Difficile,Pas Adapte,Law
4496,2019,Droit,3,Relations Internationales,1,Introduction,12,53,10,QO,0.95,0.07,13.74,3,21,24,18,3,15,1.33,16.67,Facile,Difficile,-2,Beaucoup plus Difficile,Pas Adapte,Law
5607,2020,Droit,3,Relations Internationales,1,Introduction,12,53,10,QO,0.91,0.01,7.13,2,22,24,13,2,11,1.85,15.38,Moyen,Difficile,-1,Plus Difficile,Pas Adapte,Law
53,2015,Droit,3,Relations Internationales,1,Introduction,12,54,11,QROC,0.23,0.31,41.32,31,43,74,44,31,13,1.68,70.45,Difficile,Moyen,1,Plus Facile,Pas Adapte,Law
1164,2016,Droit,3,Relations Internationales,1,Introduction,12,54,11,QROC,0.01,0.91,92.87,67,5,72,68,67,1,1.06,98.53,Difficile,Facile,2,Beaucoup plus Facile,Pas Adapte,Law
2275,2017,Droit,3,Relations Internationales,1,Introduction,12,54,11,QCM,0.58,0.23,33.56,28,54,82,77,28,49,1.06,36.36,Difficile,Difficile,0,Meme Difficulté,Pas Adapte,Law
3386,2018,Droit,3,Relations Internationales,1,Introduction,12,54,11,QCM,0.74,0.28,11.03,10,78,88,63,10,53,1.4,15.87,Facile,Difficile,-2,Beaucoup plus Difficile,Pas Adapte,Law
4497,2019,Droit,3,Relations Internationales,1,Introduction,12,54,11,QCM,0.01,0.95,77.93,67,19,86,78,67,11,1.1,85.9,Difficile,Facile,2,Beaucoup plus Facile,Pas Adapte,Law
5608,2020,Droit,3,Relations Internationales,1,Introduction,12,54,11,QCM,0.47,0.52,57.3,51,38,89,62,51,11,1.44,82.26,Facile,Moyen,-1,Plus Difficile,Pas Adapte,Law
54,2015,Droit,3,Relations Internationales,1,Introduction,12,55,12,QCM,0.46,0.3,50.41,17,16,33,22,17,5,1.5,77.27,Facile,Moyen,-1,Plus Difficile,Pas Adapte,Law
1165,2016,Droit,3,Relations Internationales,1,Introduction,12,55,12,QCM,0.57,0.19,18.75,6,28,34,13,6,7,2.62,46.15,Difficile,Difficile,0,Meme Difficulté,Pas Adapte,Law
2276,2017,Droit,3,Relations Internationales,1,Introduction,12,55,12,QCU,0.33,0.69,49.94,16,16,32,28,16,12,1.14,57.14,Facile,Moyen,-1,Plus Difficile,Pas Adapte,Law
3387,2018,Droit,3,Relations Internationales,1,Introduction,12,55,12,QCU,0.22,0.63,54.66,19,15,34,26,19,7,1.31,73.08,Facile,Moyen,-1,Plus Difficile,Pas Adapte,Law
4498,2019,Droit,3,Relations Internationales,1,Introduction,12,55,12,QCU,0.59,0.4,7.1,2,28,30,13,2,11,2.31,15.38,Moyen,Difficile,-1,Plus Difficile,Pas Adapte,Law
5609,2020,Droit,3,Relations Internationales,1,Introduction,12,55,12,QCU,0.67,0.31,30.32,9,20,29,26,9,17,1.12,34.62,Difficile,Difficile,0,Meme Difficulté,Pas Adapte,Law
55,2015,Droit,3,Relations Internationales,2,Les Acteurs des Relations Internationales,9,56,1,QCU,0.58,0.36,12.39,4,27,31,25,4,21,1.24,16.0,Difficile,Difficile,0,Meme Difficulté,Pas Adapte,Law
1166,2016,Droit,3,Relations Internationales,2,Les Acteurs des Relations Internationales,9,56,1,QCU,0.73,0.34,16.94,5,24,29,23,5,18,1.26,21.74,Facile,Difficile,-2,Beaucoup plus Difficile,Pas Adapte,Law
2277,2017,Droit,3,Relations Internationales,2,Les Acteurs des Relations Internationales,9,56,1,QCU,0.41,0.39,23.11,6,21,27,13,6,7,2.08,46.15,Difficile,Difficile,0,Meme Difficulté,Pas Adapte,Law
3388,2018,Droit,3,Relations Internationales,2,Les Acteurs des Relations Internationales,9,56,1,QCU,0.38,0.5,43.45,10,13,23,16,10,6,1.44,62.5,Facile,Moyen,-1,Plus Difficile,Pas Adapte,Law
4499,2019,Droit,3,Relations Internationales,2,Les Acteurs des Relations Internationales,9,56,1,QCU,0.19,0.86,68.67,16,7,23,22,16,6,1.05,72.73,Facile,Facile,0,Meme Difficulté,Adapte,Law
5610,2020,Droit,3,Relations Internationales,2,Les Acteurs des Relations Internationales,9,56,1,QCU,0.11,0.9,68.67,16,8,24,17,16,1,1.41,94.12,Facile,Facile,0,Meme Difficulté,Adapte,Law
56,2015,Droit,3,Relations Internationales,2,Les Acteurs des Relations Internationales,9,57,2,QCM,0.59,0.28,26.49,18,49,67,34,18,16,1.97,52.94,Facile,Difficile,-2,Beaucoup plus Difficile,Pas Adapte,Law
1167,2016,Droit,3,Relations Internationales,2,Les Acteurs des Relations Internationales,9,57,2,QCM,0.4,0.3,61.1,41,26,67,57,41,16,1.18,71.93,Difficile,Moyen,1,Plus Facile,Adapte,Law
2278,2017,Droit,3,Relations Internationales,2,Les Acteurs des Relations Internationales,9,57,2,QCM,0.25,0.4,61.1,38,25,63,57,38,19,1.11,66.67,Moyen,Moyen,0,Meme Difficulté,Adapte,Law
3389,2018,Droit,3,Relations Internationales,2,Les Acteurs des Relations Internationales,9,57,2,QCM,0.37,0.66,61.1,39,25,64,43,39,4,1.49,90.7,Moyen,Moyen,0,Meme Difficulté,Adapte,Law
4500,2019,Droit,3,Relations Internationales,2,Les Acteurs des Relations Internationales,9,57,2,QCM,0.24,0.58,61.1,44,28,72,48,44,4,1.5,91.67,Moyen,Moyen,0,Meme Difficulté,Adapte,Law
5611,2020,Droit,3,Relations Internationales,2,Les Acteurs des Relations Internationales,9,57,2,QCM,0.48,0.5,61.1,44,28,72,46,44,2,1.57,95.65,Moyen,Moyen,0,Meme Difficulté,Adapte,Law
57,2015,Droit,3,Relations Internationales,2,Les Acteurs des Relations Internationales,9,58,3,QCM,0.78,0.22,21.46,17,63,80,70,17,53,1.14,24.29,Difficile,Difficile,0,Meme Difficulté,Pas Adapte,Law
1168,2016,Droit,3,Relations Internationales,2,Les Acteurs des Relations Internationales,9,58,3,QCM,0.65,0.24,10.57,7,61,68,42,7,35,1.62,16.67,Facile,Difficile,-2,Beaucoup plus Difficile,Pas Adapte,Law
2279,2017,Droit,3,Relations Internationales,2,Les Acteurs des Relations Internationales,9,58,3,QCM,0.49,0.62,38.03,25,40,65,29,25,4,2.24,86.21,Facile,Moyen,-1,Plus Difficile,Pas Adapte,Law
3390,2018,Droit,3,Relations Internationales,2,Les Acteurs des Relations Internationales,9,58,3,QCM,0.5,0.25,16.79,12,58,70,69,12,57,1.01,17.39,Moyen,Difficile,-1,Plus Difficile,Pas Adapte,Law
4501,2019,Droit,3,Relations Internationales,2,Les Acteurs des Relations Internationales,9,58,3,QCM,0.79,0.21,21.15,17,63,80,33,17,16,2.42,51.52,Moyen,Difficile,-1,Plus Difficile,Pas Adapte,Law
5612,2020,Droit,3,Relations Internationales,2,Les Acteurs des Relations Internationales,9,58,3,QROC,0.35,0.31,38.46,28,45,73,51,28,23,1.43,54.9,Difficile,Moyen,1,Plus Facile,Pas Adapte,Law
58,2015,Droit,3,Relations Internationales,2,Les Acteurs des Relations Internationales,9,59,4,QCU,0.64,0.29,31.95,19,41,60,31,19,12,1.94,61.29,Moyen,Difficile,-1,Plus Difficile,Pas Adapte,Law
1169,2016,Droit,3,Relations Internationales,2,Les Acteurs des Relations Internationales,9,59,4,QCU,0.62,0.3,32.33,21,43,64,50,21,29,1.28,42.0,Moyen,Difficile,-1,Plus Difficile,Pas Adapte,Law
2280,2017,Droit,3,Relations Internationales,2,Les Acteurs des Relations Internationales,9,59,4,QCU,0.44,0.35,1.85,1,61,62,40,1,39,1.55,2.5,Facile,Difficile,-2,Beaucoup plus Difficile,Pas Adapte,Law
3391,2018,Droit,3,Relations Internationales,2,Les Acteurs des Relations Internationales,9,59,4,QCU,0.24,0.61,35.43,21,39,60,54,21,33,1.11,38.89,Facile,Moyen,-1,Plus Difficile,Pas Adapte,Law
4502,2019,Droit,3,Relations Internationales,2,Les Acteurs des Relations Internationales,9,59,4,QCU,0.27,0.54,44.46,31,38,69,62,31,31,1.11,50.0,Moyen,Moyen,0,Meme Difficulté,Pas Adapte,Law
5613,2020,Droit,3,Relations Internationales,2,Les Acteurs des Relations Internationales,9,59,4,QCU,0.06,0.92,88.35,64,8,72,66,64,2,1.09,96.97,Difficile,Facile,2,Beaucoup plus Facile,Pas Adapte,Law
59,2015,Droit,3,Relations Internationales,2,Les Acteurs des Relations Internationales,9,60,5,QROC,0.56,0.39,46.3,10,11,21,18,10,8,1.17,55.56,Difficile,Moyen,1,Plus Facile,Pas Adapte,Law
1170,2016,Droit,3,Relations Internationales,2,Les Acteurs des Relations Internationales,9,60,5,QROC,0.57,0.33,60.16,14,9,23,19,14,5,1.21,73.68,Difficile,Moyen,1,Plus Facile,Adapte,Law
2281,2017,Droit,3,Relations Internationales,2,Les Acteurs des Relations Internationales,9,60,5,QROC,0.56,0.3,60.16,13,9,22,17,13,4,1.29,76.47,Moyen,Moyen,0,Meme Difficulté,Adapte,Law
3392,2018,Droit,3,Relations Internationales,2,Les Acteurs des Relations Internationales,9,60,5,QCM,0.31,0.57,60.16,13,8,21,20,13,7,1.05,65.0,Moyen,Moyen,0,Meme Difficulté,Adapte,Law
4503,2019,Droit,3,Relations Internationales,2,Les Acteurs des Relations Internationales,9,60,5,QCM,0.22,0.49,60.16,13,8,21,15,13,2,1.4,86.67,Moyen,Moyen,0,Meme Difficulté,Adapte,Law
5614,2020,Droit,3,Relations Internationales,2,Les Acteurs des Relations Internationales,9,60,5,QCM,0.39,0.43,60.16,12,8,20,16,12,4,1.25,75.0,Moyen,Moyen,0,Meme Difficulté,Adapte,Law
60,2015,Droit,3,Relations Internationales,2,Les Acteurs des Relations Internationales,9,61,6,QCU,0.1,0.94,79.16,75,20,95,84,75,9,1.13,89.29,Difficile,Facile,2,Beaucoup plus Facile,Pas Adapte,Law
1171,2016,Droit,3,Relations Internationales,2,Les Acteurs des Relations Internationales,9,61,6,QCU,0.03,0.98,66.62,54,27,81,61,54,7,1.33,88.52,Moyen,Facile,1,Plus Facile,Adapte,Law
2282,2017,Droit,3,Relations Internationales,2,Les Acteurs des Relations Internationales,9,61,6,QCU,0.01,0.91,66.62,51,26,77,62,51,11,1.24,82.26,Facile,Facile,0,Meme Difficulté,Adapte,Law
3393,2018,Droit,3,Relations Internationales,2,Les Acteurs des Relations Internationales,9,61,6,QCU,0.08,0.78,66.62,55,27,82,57,55,2,1.44,96.49,Facile,Facile,0,Meme Difficulté,Adapte,Law
4504,2019,Droit,3,Relations Internationales,2,Les Acteurs des Relations Internationales,9,61,6,QCU,0.04,0.8,66.62,50,25,75,59,50,9,1.27,84.75,Facile,Facile,0,Meme Difficulté,Adapte,Law
5615,2020,Droit,3,Relations Internationales,2,Les Acteurs des Relations Internationales,9,61,6,QCM,0.19,0.77,66.62,44,22,66,48,44,4,1.38,91.67,Facile,Facile,0,Meme Difficulté,Adapte,Law
61,2015,Droit,3,Relations Internationales,2,Les Acteurs des Relations Internationales,9,62,7,QROC,0.94,0.06,15.4,13,74,87,70,13,57,1.24,18.57,Difficile,Difficile,0,Meme Difficulté,Pas Adapte,Law
1172,2016,Droit,3,Relations Internationales,2,Les Acteurs des Relations Internationales,9,62,7,QROC,0.65,0.21,10.56,9,75,84,72,9,63,1.17,12.5,Moyen,Difficile,-1,Plus Difficile,Pas Adapte,Law
2283,2017,Droit,3,Relations Internationales,2,Les Acteurs des Relations Internationales,9,62,7,QROC,0.05,0.86,94.45,77,4,81,81,77,4,1.0,95.06,Difficile,Facile,2,Beaucoup plus Facile,Pas Adapte,Law
3394,2018,Droit,3,Relations Internationales,2,Les Acteurs des Relations Internationales,9,62,7,QROC,0.48,0.28,51.63,46,44,90,70,46,24,1.29,65.71,Moyen,Moyen,0,Meme Difficulté,Pas Adapte,Law
4505,2019,Droit,3,Relations Internationales,2,Les Acteurs des Relations Internationales,9,62,7,QROC,0.28,0.27,35.49,36,65,101,79,36,43,1.28,45.57,Moyen,Moyen,0,Meme Difficulté,Pas Adapte,Law
5616,2020,Droit,3,Relations Internationales,2,Les Acteurs des Relations Internationales,9,62,7,QROC,0.36,0.31,46.8,41,47,88,51,41,10,1.73,80.39,Difficile,Moyen,1,Plus Facile,Pas Adapte,Law
62,2015,Droit,3,Relations Internationales,2,Les Acteurs des Relations Internationales,9,63,8,QCU,0.14,0.86,76.46,18,6,24,21,18,3,1.14,85.71,Facile,Facile,0,Meme Difficulté,Pas Adapte,Law
1173,2016,Droit,3,Relations Internationales,2,Les Acteurs des Relations Internationales,9,63,8,QCU,0.26,0.58,44.82,12,14,26,22,12,10,1.18,54.55,Facile,Moyen,-1,Plus Difficile,Pas Adapte,Law
2284,2017,Droit,3,Relations Internationales,2,Les Acteurs des Relations Internationales,9,63,8,QROC,0.17,0.9,86.18,25,4,29,29,25,4,1.0,86.21,Difficile,Facile,2,Beaucoup plus Facile,Pas Adapte,Law
3395,2018,Droit,3,Relations Internationales,2,Les Acteurs des Relations Internationales,9,63,8,QROC,0.05,0.86,73.07,19,7,26,25,19,6,1.04,76.0,Facile,Facile,0,Meme Difficulté,Adapte,Law
4506,2019,Droit,3,Relations Internationales,2,Les Acteurs des Relations Internationales,9,63,8,QROC,0.02,0.78,73.07,17,6,23,19,17,2,1.21,89.47,Facile,Facile,0,Meme Difficulté,Adapte,Law
5617,2020,Droit,3,Relations Internationales,2,Les Acteurs des Relations Internationales,9,63,8,QROC,0.14,1.0,73.07,17,6,23,18,17,1,1.28,94.44,Facile,Facile,0,Meme Difficulté,Adapte,Law
63,2015,Droit,3,Relations Internationales,2,Les Acteurs des Relations Internationales,9,64,9,QCU,0.3,0.44,47.95,16,17,33,29,16,13,1.14,55.17,Facile,Moyen,-1,Plus Difficile,Pas Adapte,Law
1174,2016,Droit,3,Relations Internationales,2,Les Acteurs des Relations Internationales,9,64,9,QCM,0.01,0.87,66.34,21,11,32,22,21,1,1.45,95.45,Facile,Facile,0,Meme Difficulté,Adapte,Law
2285,2017,Droit,3,Relations Internationales,2,Les Acteurs des Relations Internationales,9,64,9,QCM,0.02,0.75,66.34,20,10,30,23,20,3,1.3,86.96,Facile,Facile,0,Meme Difficulté,Adapte,Law
3396,2018,Droit,3,Relations Internationales,2,Les Acteurs des Relations Internationales,9,64,9,QCM,0.18,0.88,66.34,19,10,29,24,19,5,1.21,79.17,Facile,Facile,0,Meme Difficulté,Adapte,Law
4507,2019,Droit,3,Relations Internationales,2,Les Acteurs des Relations Internationales,9,64,9,QROC,0.02,0.63,66.34,21,11,32,25,21,4,1.28,84.0,Facile,Facile,0,Meme Difficulté,Adapte,Law
5618,2020,Droit,3,Relations Internationales,2,Les Acteurs des Relations Internationales,9,64,9,QROC,0.18,0.57,66.34,21,10,31,27,21,6,1.15,77.78,Facile,Facile,0,Meme Difficulté,Adapte,Law
64,2015,Droit,3,Relations Internationales,3,Les Grands Principes regissant les Relations Internationales,10,65,1,QCM,0.27,0.44,37.91,25,41,66,28,25,3,2.36,89.29,Facile,Moyen,-1,Plus Difficile,Pas Adapte,Law
1175,2016,Droit,3,Relations Internationales,3,Les Grands Principes regissant les Relations Internationales,10,65,1,QCM,0.12,0.95,83.04,51,10,61,53,51,2,1.15,96.23,Moyen,Facile,1,Plus Facile,Pas Adapte,Law
2286,2017,Droit,3,Relations Internationales,3,Les Grands Principes regissant les Relations Internationales,10,65,1,QCU,0.14,0.98,88.16,50,7,57,51,50,1,1.12,98.04,Moyen,Facile,1,Plus Facile,Pas Adapte,Law
3397,2018,Droit,3,Relations Internationales,3,Les Grands Principes regissant les Relations Internationales,10,65,1,QCU,0.52,0.32,32.16,21,45,66,54,21,33,1.22,38.89,Difficile,Difficile,0,Meme Difficulté,Pas Adapte,Law
4508,2019,Droit,3,Relations Internationales,3,Les Grands Principes regissant les Relations Internationales,10,65,1,QCU,0.71,0.25,1.49,1,57,58,55,1,54,1.05,1.82,Difficile,Difficile,0,Meme Difficulté,Pas Adapte,Law
5619,2020,Droit,3,Relations Internationales,3,Les Grands Principes regissant les Relations Internationales,10,65,1,QCU,0.47,0.22,26.92,15,42,57,41,15,26,1.39,36.59,Moyen,Difficile,-1,Plus Difficile,Pas Adapte,Law
65,2015,Droit,3,Relations Internationales,3,Les Grands Principes regissant les Relations Internationales,10,66,2,QCU,0.64,0.21,15.08,6,33,39,30,6,24,1.3,20.0,Facile,Difficile,-2,Beaucoup plus Difficile,Pas Adapte,Law
1176,2016,Droit,3,Relations Internationales,3,Les Grands Principes regissant les Relations Internationales,10,66,2,QCU,0.3,0.62,55.02,24,19,43,27,24,3,1.59,88.89,Facile,Moyen,-1,Plus Difficile,Pas Adapte,Law
2287,2017,Droit,3,Relations Internationales,3,Les Grands Principes regissant les Relations Internationales,10,66,2,QCU,0.31,0.58,46.21,21,24,45,37,21,16,1.22,56.76,Facile,Moyen,-1,Plus Difficile,Pas Adapte,Law
3398,2018,Droit,3,Relations Internationales,3,Les Grands Principes regissant les Relations Internationales,10,66,2,QCU,0.01,0.76,96.9,41,1,42,42,41,1,1.0,97.62,Moyen,Facile,1,Plus Facile,Pas Adapte,Law
4509,2019,Droit,3,Relations Internationales,3,Les Grands Principes regissant les Relations Internationales,10,66,2,QCU,0.72,0.32,30.91,13,28,41,34,13,21,1.21,38.24,Facile,Difficile,-2,Beaucoup plus Difficile,Pas Adapte,Law
5620,2020,Droit,3,Relations Internationales,3,Les Grands Principes regissant les Relations Internationales,10,66,2,QCU,0.24,0.51,56.71,20,16,36,26,20,6,1.38,76.92,Facile,Moyen,-1,Plus Difficile,Pas Adapte,Law
66,2015,Droit,3,Relations Internationales,3,Les Grands Principes regissant les Relations Internationales,10,67,3,QROC,0.18,0.89,74.01,28,10,38,30,28,2,1.27,93.33,Moyen,Facile,1,Plus Facile,Adapte,Law
1177,2016,Droit,3,Relations Internationales,3,Les Grands Principes regissant les Relations Internationales,10,67,3,QROC,0.06,0.5,74.01,32,11,43,41,32,9,1.05,78.05,Facile,Facile,0,Meme Difficulté,Adapte,Law
2288,2017,Droit,3,Relations Internationales,3,Les Grands Principes regissant les Relations Internationales,10,67,3,QROC,0.01,0.67,74.01,28,10,38,32,28,4,1.19,87.5,Facile,Facile,0,Meme Difficulté,Adapte,Law
3399,2018,Droit,3,Relations Internationales,3,Les Grands Principes regissant les Relations Internationales,10,67,3,QROC,0.17,0.61,74.01,24,9,33,26,24,2,1.27,92.31,Facile,Facile,0,Meme Difficulté,Adapte,Law
4510,2019,Droit,3,Relations Internationales,3,Les Grands Principes regissant les Relations Internationales,10,67,3,QROC,0.12,0.91,74.01,27,10,37,30,27,3,1.23,90.0,Facile,Facile,0,Meme Difficulté,Adapte,Law
5621,2020,Droit,3,Relations Internationales,3,Les Grands Principes regissant les Relations Internationales,10,67,3,QROC,0.11,0.61,74.01,26,9,35,28,26,2,1.25,92.86,Facile,Facile,0,Meme Difficulté,Adapte,Law
67,2015,Droit,3,Relations Internationales,3,Les Grands Principes regissant les Relations Internationales,10,68,4,QCU,0.56,0.32,30.05,6,14,20,19,6,13,1.05,31.58,Moyen,Difficile,-1,Plus Difficile,Pas Adapte,Law
1178,2016,Droit,3,Relations Internationales,3,Les Grands Principes regissant les Relations Internationales,10,68,4,QCU,0.29,0.47,48.63,9,10,19,15,9,6,1.27,60.0,Difficile,Moyen,1,Plus Facile,Pas Adapte,Law
2289,2017,Droit,3,Relations Internationales,3,Les Grands Principes regissant les Relations Internationales,10,68,4,QCU,0.09,0.96,86.57,16,3,19,18,16,2,1.06,88.89,Facile,Facile,0,Meme Difficulté,Pas Adapte,Law
3400,2018,Droit,3,Relations Internationales,3,Les Grands Principes regissant les Relations Internationales,10,68,4,QCU,0.16,0.95,94.03,16,1,17,16,16,0,1.06,100.0,Difficile,Facile,2,Beaucoup plus Facile,Pas Adapte,Law
4511,2019,Droit,3,Relations Internationales,3,Les Grands Principes regissant les Relations Internationales,10,68,4,QCU,0.45,0.33,7.99,1,17,18,9,1,8,2.0,11.11,Moyen,Difficile,-1,Plus Difficile,Pas Adapte,Law
5622,2020,Droit,3,Relations Internationales,3,Les Grands Principes regissant les Relations Internationales,10,68,4,QCU,0.52,0.25,30.89,5,10,15,13,5,8,1.15,38.46,Moyen,Difficile,-1,Plus Difficile,Pas Adapte,Law
68,2015,Droit,3,Relations Internationales,3,Les Grands Principes regissant les Relations Internationales,10,69,5,QCM,0.1,0.85,78.25,64,18,82,70,64,6,1.17,91.43,Facile,Facile,0,Meme Difficulté,Pas Adapte,Law
1179,2016,Droit,3,Relations Internationales,3,Les Grands Principes regissant les Relations Internationales,10,69,5,QCM,0.01,0.96,73.5,61,22,83,72,61,11,1.15,84.72,Facile,Facile,0,Meme Difficulté,Adapte,Law
2290,2017,Droit,3,Relations Internationales,3,Les Grands Principes regissant les Relations Internationales,10,69,5,QCM,0.05,0.99,73.5,56,20,76,58,56,2,1.31,96.55,Facile,Facile,0,Meme Difficulté,Adapte,Law
3401,2018,Droit,3,Relations Internationales,3,Les Grands Principes regissant les Relations Internationales,10,69,5,QCM,0.0,0.9,73.5,58,21,79,65,58,7,1.22,89.23,Facile,Facile,0,Meme Difficulté,Adapte,Law
4512,2019,Droit,3,Relations Internationales,3,Les Grands Principes regissant les Relations Internationales,10,69,5,QCM,0.03,0.87,73.5,64,23,87,84,64,20,1.04,76.19,Facile,Facile,0,Meme Difficulté,Adapte,Law
5623,2020,Droit,3,Relations Internationales,3,Les Grands Principes regissant les Relations Internationales,10,69,5,QCU,0.14,0.99,73.5,55,20,75,69,55,14,1.09,79.71,Facile,Facile,0,Meme Difficulté,Adapte,Law
69,2015,Droit,3,Relations Internationales,3,Les Grands Principes regissant les Relations Internationales,10,70,6,QCU,0.71,0.34,10.48,6,56,62,48,6,42,1.29,12.5,Difficile,Difficile,0,Meme Difficulté,Pas Adapte,Law
1180,2016,Droit,3,Relations Internationales,3,Les Grands Principes regissant les Relations Internationales,10,70,6,QCU,0.21,0.6,38.08,21,34,55,29,21,8,1.9,72.41,Moyen,Moyen,0,Meme Difficulté,Pas Adapte,Law
2291,2017,Droit,3,Relations Internationales,3,Les Grands Principes regissant les Relations Internationales,10,70,6,QCU,0.1,0.94,74.92,35,12,47,40,35,5,1.18,87.5,Difficile,Facile,2,Beaucoup plus Facile,Adapte,Law
3402,2018,Droit,3,Relations Internationales,3,Les Grands Principes regissant les Relations Internationales,10,70,6,QCU,0.15,0.92,74.92,38,13,51,42,38,4,1.21,90.48,Facile,Facile,0,Meme Difficulté,Adapte,Law
4513,2019,Droit,3,Relations Internationales,3,Les Grands Principes regissant les Relations Internationales,10,70,6,QCU,0.16,0.83,74.92,43,15,58,45,43,2,1.29,95.56,Facile,Facile,0,Meme Difficulté,Adapte,Law
5624,2020,Droit,3,Relations Internationales,3,Les Grands Principes regissant les Relations Internationales,10,70,6,QCU,0.02,0.84,74.92,39,13,52,40,39,1,1.3,97.5,Facile,Facile,0,Meme Difficulté,Adapte,Law
70,2015,Droit,3,Relations Internationales,3,Les Grands Principes regissant les Relations Internationales,10,71,7,QCU,0.31,0.74,45.06,22,26,48,31,22,9,1.55,70.97,Facile,Moyen,-1,Plus Difficile,Pas Adapte,Law
1181,2016,Droit,3,Relations Internationales,3,Les Grands Principes regissant les Relations Internationales,10,71,7,QCU,0.04,0.81,74.85,32,11,43,37,32,5,1.16,86.49,Facile,Facile,0,Meme Difficulté,Adapte,Law
2292,2017,Droit,3,Relations Internationales,3,Les Grands Principes regissant les Relations Internationales,10,71,7,QCU,0.16,0.9,74.85,32,11,43,39,32,7,1.1,82.05,Facile,Facile,0,Meme Difficulté,Adapte,Law
3403,2018,Droit,3,Relations Internationales,3,Les Grands Principes regissant les Relations Internationales,10,71,7,QROC,0.15,0.48,74.85,28,9,37,37,28,9,1.0,75.68,Facile,Facile,0,Meme Difficulté,Adapte,Law
4514,2019,Droit,3,Relations Internationales,3,Les Grands Principes regissant les Relations Internationales,10,71,7,QO,0.19,0.43,74.85,25,9,34,29,25,4,1.17,86.21,Facile,Facile,0,Meme Difficulté,Adapte,Law
5625,2020,Droit,3,Relations Internationales,3,Les Grands Principes regissant les Relations Internationales,10,71,7,QROC,0.11,0.86,74.85,27,9,36,35,27,8,1.03,77.14,Facile,Facile,0,Meme Difficulté,Adapte,Law
71,2015,Droit,3,Relations Internationales,3,Les Grands Principes regissant les Relations Internationales,10,72,8,QROC,0.97,0.03,9.5,2,24,26,12,2,10,2.17,16.67,Moyen,Difficile,-1,Plus Difficile,Pas Adapte,Law
1182,2016,Droit,3,Relations Internationales,3,Les Grands Principes regissant les Relations Internationales,10,72,8,QROC,0.5,0.3,43.61,10,13,23,14,10,4,1.64,71.43,Facile,Moyen,-1,Plus Difficile,Pas Adapte,Law
2293,2017,Droit,3,Relations Internationales,3,Les Grands Principes regissant les Relations Internationales,10,72,8,QROC,0.2,0.39,47.81,11,12,23,12,11,1,1.92,91.67,Facile,Moyen,-1,Plus Difficile,Pas Adapte,Law
3404,2018,Droit,3,Relations Internationales,3,Les Grands Principes regissant les Relations Internationales,10,72,8,QROC,0.24,0.36,42.17,11,14,25,14,11,3,1.79,78.57,Facile,Moyen,-1,Plus Difficile,Pas Adapte,Law
4515,2019,Droit,3,Relations Internationales,3,Les Grands Principes regissant les Relations Internationales,10,72,8,QROC,0.94,0.03,10.3,3,26,29,27,3,24,1.07,11.11,Facile,Difficile,-2,Beaucoup plus Difficile,Pas Adapte,Law
5626,2020,Droit,3,Relations Internationales,3,Les Grands Principes regissant les Relations Internationales,10,72,8,QROC,0.13,0.47,97.75,26,1,27,26,26,0,1.04,100.0,Difficile,Facile,2,Beaucoup plus Facile,Pas Adapte,Law
72,2015,Droit,3,Relations Internationales,3,Les Grands Principes regissant les Relations Internationales,10,73,9,QCU,0.29,0.7,54.67,17,15,32,28,17,11,1.14,60.71,Facile,Moyen,-1,Plus Difficile,Pas Adapte,Law
1183,2016,Droit,3,Relations Internationales,3,Les Grands Principes regissant les Relations Internationales,10,73,9,QCU,0.27,0.54,37.43,11,18,29,16,11,5,1.81,68.75,Difficile,Moyen,1,Plus Facile,Pas Adapte,Law
2294,2017,Droit,3,Relations Internationales,3,Les Grands Principes regissant les Relations Internationales,10,73,9,QCU,0.11,0.98,80.21,25,6,31,28,25,3,1.11,89.29,Difficile,Facile,2,Beaucoup plus Facile,Pas Adapte,Law
3405,2018,Droit,3,Relations Internationales,3,Les Grands Principes regissant les Relations Internationales,10,73,9,QCU,0.02,0.85,65.82,24,12,36,30,24,6,1.2,80.0,Facile,Facile,0,Meme Difficulté,Adapte,Law
4516,2019,Droit,3,Relations Internationales,3,Les Grands Principes regissant les Relations Internationales,10,73,9,QCU,0.15,0.91,65.82,21,11,32,25,21,4,1.28,84.0,Facile,Facile,0,Meme Difficulté,Adapte,Law
5627,2020,Droit,3,Relations Internationales,3,Les Grands Principes regissant les Relations Internationales,10,73,9,QCU,0.06,0.87,65.82,20,10,30,28,20,8,1.07,71.43,Facile,Facile,0,Meme Difficulté,Adapte,Law
73,2015,Droit,3,Relations Internationales,3,Les Grands Principes regissant les Relations Internationales,10,74,10,QCM,0.77,0.23,20.54,8,29,37,33,8,25,1.12,24.24,Facile,Difficile,-2,Beaucoup plus Difficile,Pas Adapte,Law
1184,2016,Droit,3,Relations Internationales,3,Les Grands Principes regissant les Relations Internationales,10,74,10,QCM,0.71,0.28,27.87,10,25,35,11,10,1,3.18,90.91,Facile,Difficile,-2,Beaucoup plus Difficile,Pas Adapte,Law
2295,2017,Droit,3,Relations Internationales,3,Les Grands Principes regissant les Relations Internationales,10,74,10,QCM,0.13,0.76,71.47,28,11,39,39,28,11,1.0,71.79,Difficile,Facile,2,Beaucoup plus Facile,Adapte,Law
3406,2018,Droit,3,Relations Internationales,3,Les Grands Principes regissant les Relations Internationales,10,74,10,QCM,0.08,0.88,71.47,28,11,39,38,28,10,1.03,73.68,Facile,Facile,0,Meme Difficulté,Adapte,Law
4517,2019,Droit,3,Relations Internationales,3,Les Grands Principes regissant les Relations Internationales,10,74,10,QCM,0.14,0.73,71.47,28,11,39,32,28,4,1.22,87.5,Facile,Facile,0,Meme Difficulté,Adapte,Law
5628,2020,Droit,3,Relations Internationales,3,Les Grands Principes regissant les Relations Internationales,10,74,10,QCM,0.13,0.95,71.47,31,13,44,39,31,8,1.13,79.49,Facile,Facile,0,Meme Difficulté,Adapte,Law
74,2015,Droit,4,Proces et Institution Juridictionnelles,1,Introduction,6,75,1,QCM,0.25,0.3,59.87,50,34,84,63,50,13,1.33,79.37,Facile,Moyen,-1,Plus Difficile,Pas Adapte,Law
1185,2016,Droit,4,Proces et Institution Juridictionnelles,1,Introduction,6,75,1,QCM,0.35,0.42,62.5,47,28,75,47,47,0,1.6,100.0,Facile,Moyen,-1,Plus Difficile,Adapte,Law
2296,2017,Droit,4,Proces et Institution Juridictionnelles,1,Introduction,6,75,1,QCM,0.36,0.57,62.5,53,31,84,67,53,14,1.25,79.1,Moyen,Moyen,0,Meme Difficulté,Adapte,Law
3407,2018,Droit,4,Proces et Institution Juridictionnelles,1,Introduction,6,75,1,QCM,0.25,0.63,62.5,55,33,88,56,55,1,1.57,98.21,Moyen,Moyen,0,Meme Difficulté,Adapte,Law
4518,2019,Droit,4,Proces et Institution Juridictionnelles,1,Introduction,6,75,1,QCM,0.27,0.46,62.5,49,29,78,66,49,17,1.18,74.24,Moyen,Moyen,0,Meme Difficulté,Adapte,Law
5629,2020,Droit,4,Proces et Institution Juridictionnelles,1,Introduction,6,75,1,QROC,0.41,0.38,62.5,46,27,73,48,46,2,1.52,95.83,Moyen,Moyen,0,Meme Difficulté,Adapte,Law
75,2015,Droit,4,Proces et Institution Juridictionnelles,1,Introduction,6,76,2,QCM,0.46,0.58,50.55,36,36,72,46,36,10,1.57,78.26,Facile,Moyen,-1,Plus Difficile,Pas Adapte,Law
1186,2016,Droit,4,Proces et Institution Juridictionnelles,1,Introduction,6,76,2,QCM,0.74,0.18,13.21,9,60,69,60,9,51,1.15,15.0,Difficile,Difficile,0,Meme Difficulté,Pas Adapte,Law
2297,2017,Droit,4,Proces et Institution Juridictionnelles,1,Introduction,6,76,2,QCM,0.36,0.38,50.73,37,36,73,58,37,21,1.26,63.79,Difficile,Moyen,1,Plus Facile,Pas Adapte,Law
3408,2018,Droit,4,Proces et Institution Juridictionnelles,1,Introduction,6,76,2,QCM,0.57,0.22,12.58,10,70,80,59,10,49,1.36,16.95,Difficile,Difficile,0,Meme Difficulté,Pas Adapte,Law
4519,2019,Droit,4,Proces et Institution Juridictionnelles,1,Introduction,6,76,2,QCM,0.24,0.53,37.56,33,54,87,60,33,27,1.45,55.0,Difficile,Moyen,1,Plus Facile,Pas Adapte,Law
5630,2020,Droit,4,Proces et Institution Juridictionnelles,1,Introduction,6,76,2,QROC,0.76,0.21,17.06,15,73,88,43,15,28,2.05,34.88,Facile,Difficile,-2,Beaucoup plus Difficile,Pas Adapte,Law
76,2015,Droit,4,Proces et Institution Juridictionnelles,1,Introduction,6,77,3,QROC,0.59,0.34,58.52,28,19,47,34,28,6,1.38,82.35,Facile,Moyen,-1,Plus Difficile,Pas Adapte,Law
1187,2016,Droit,4,Proces et Institution Juridictionnelles,1,Introduction,6,77,3,QROC,0.22,0.32,50.81,21,21,42,39,21,18,1.08,53.85,Moyen,Moyen,0,Meme Difficulté,Pas Adapte,Law
2298,2017,Droit,4,Proces et Institution Juridictionnelles,1,Introduction,6,77,3,QROC,0.01,0.64,97.43,47,1,48,47,47,0,1.02,100.0,Difficile,Facile,2,Beaucoup plus Facile,Pas Adapte,Law
3409,2018,Droit,4,Proces et Institution Juridictionnelles,1,Introduction,6,77,3,QROC,0.92,0.06,30.94,16,36,52,31,16,15,1.68,51.61,Facile,Difficile,-2,Beaucoup plus Difficile,Pas Adapte,Law
4520,2019,Droit,4,Proces et Institution Juridictionnelles,1,Introduction,6,77,3,QROC,0.46,0.35,42.85,22,29,51,33,22,11,1.55,66.67,Difficile,Moyen,1,Plus Facile,Pas Adapte,Law
5631,2020,Droit,4,Proces et Institution Juridictionnelles,1,Introduction,6,77,3,QROC,0.37,0.4,39.95,22,33,55,28,22,6,1.96,78.57,Facile,Moyen,-1,Plus Difficile,Pas Adapte,Law
77,2015,Droit,4,Proces et Institution Juridictionnelles,1,Introduction,6,78,4,QCM,0.01,0.95,72.26,4,1,5,5,4,1,1.0,80.0,Moyen,Facile,1,Plus Facile,Adapte,Law
1188,2016,Droit,4,Proces et Institution Juridictionnelles,1,Introduction,6,78,4,QCM,0.09,0.93,72.26,3,1,4,3,3,0,1.33,100.0,Facile,Facile,0,Meme Difficulté,Adapte,Law
2299,2017,Droit,4,Proces et Institution Juridictionnelles,1,Introduction,6,78,4,QCM,0.08,0.91,72.26,4,1,5,4,4,0,1.25,100.0,Facile,Facile,0,Meme Difficulté,Adapte,Law
3410,2018,Droit,4,Proces et Institution Juridictionnelles,1,Introduction,6,78,4,QCM,0.13,0.99,72.26,4,1,5,5,4,1,1.0,80.0,Facile,Facile,0,Meme Difficulté,Adapte,Law
4521,2019,Droit,4,Proces et Institution Juridictionnelles,1,Introduction,6,78,4,QCM,0.1,0.9,72.26,4,1,5,5,4,1,1.0,80.0,Facile,Facile,0,Meme Difficulté,Adapte,Law
5632,2020,Droit,4,Proces et Institution Juridictionnelles,1,Introduction,6,78,4,QCM,0.13,0.83,72.26,4,2,6,4,4,0,1.5,100.0,Facile,Facile,0,Meme Difficulté,Adapte,Law
78,2015,Droit,4,Proces et Institution Juridictionnelles,1,Introduction,6,79,5,QCM,0.2,0.54,64.56,35,19,54,44,35,9,1.23,79.55,Difficile,Moyen,1,Plus Facile,Adapte,Law
1189,2016,Droit,4,Proces et Institution Juridictionnelles,1,Introduction,6,79,5,QCM,0.37,0.38,64.56,32,18,50,43,32,11,1.16,74.42,Moyen,Moyen,0,Meme Difficulté,Adapte,Law
2300,2017,Droit,4,Proces et Institution Juridictionnelles,1,Introduction,6,79,5,QCM,0.43,0.52,64.56,33,18,51,38,33,5,1.34,86.84,Moyen,Moyen,0,Meme Difficulté,Adapte,Law
3411,2018,Droit,4,Proces et Institution Juridictionnelles,1,Introduction,6,79,5,QCM,0.27,0.47,64.56,30,16,46,36,30,6,1.28,83.33,Moyen,Moyen,0,Meme Difficulté,Adapte,Law
4522,2019,Droit,4,Proces et Institution Juridictionnelles,1,Introduction,6,79,5,QCM,0.39,0.67,64.56,26,15,41,29,26,3,1.41,89.66,Moyen,Moyen,0,Meme Difficulté,Adapte,Law
5633,2020,Droit,4,Proces et Institution Juridictionnelles,1,Introduction,6,79,5,QCM,0.22,0.3,64.56,26,14,40,37,26,11,1.08,70.27,Moyen,Moyen,0,Meme Difficulté,Adapte,Law
79,2015,Droit,4,Proces et Institution Juridictionnelles,1,Introduction,6,80,6,QCM,0.55,0.18,34.58,20,37,57,38,20,18,1.5,52.63,Facile,Difficile,-2,Beaucoup plus Difficile,Pas Adapte,Law
1190,2016,Droit,4,Proces et Institution Juridictionnelles,1,Introduction,6,80,6,QCM,0.26,0.33,64.93,35,19,54,44,35,9,1.23,79.55,Moyen,Moyen,0,Meme Difficulté,Adapte,Law
2301,2017,Droit,4,Proces et Institution Juridictionnelles,1,Introduction,6,80,6,QO,0.49,0.18,64.93,31,16,47,41,31,10,1.15,75.61,Moyen,Moyen,0,Meme Difficulté,Adapte,Law
3412,2018,Droit,4,Proces et Institution Juridictionnelles,1,Introduction,6,80,6,QO,0.57,0.26,64.93,31,17,48,42,31,11,1.14,73.81,Moyen,Moyen,0,Meme Difficulté,Adapte,Law
4523,2019,Droit,4,Proces et Institution Juridictionnelles,1,Introduction,6,80,6,QO,0.35,0.21,64.93,29,15,44,37,29,8,1.19,78.38,Moyen,Moyen,0,Meme Difficulté,Adapte,Law
5634,2020,Droit,4,Proces et Institution Juridictionnelles,1,Introduction,6,80,6,QO,0.57,0.24,64.93,27,14,41,35,27,8,1.17,77.14,Moyen,Moyen,0,Meme Difficulté,Adapte,Law
80,2015,Droit,4,Proces et Institution Juridictionnelles,2,La Trame de la Scene Judiciaire,14,81,1,QO,0.97,0.11,21.66,10,35,45,34,10,24,1.32,29.41,Difficile,Difficile,0,Meme Difficulté,Pas Adapte,Law
1191,2016,Droit,4,Proces et Institution Juridictionnelles,2,La Trame de la Scene Judiciaire,14,81,1,QO,0.12,0.84,77.13,40,12,52,50,40,10,1.04,80.0,Moyen,Facile,1,Plus Facile,Pas Adapte,Law
2302,2017,Droit,4,Proces et Institution Juridictionnelles,2,La Trame de la Scene Judiciaire,14,81,1,QO,0.85,0.04,11.13,7,53,60,32,7,25,1.88,21.88,Moyen,Difficile,-1,Plus Difficile,Pas Adapte,Law
3413,2018,Droit,4,Proces et Institution Juridictionnelles,2,La Trame de la Scene Judiciaire,14,81,1,QCU,0.13,0.92,79.56,41,10,51,48,41,7,1.06,85.42,Difficile,Facile,2,Beaucoup plus Facile,Pas Adapte,Law
4524,2019,Droit,4,Proces et Institution Juridictionnelles,2,La Trame de la Scene Judiciaire,14,81,1,QCU,0.68,0.37,13.98,8,50,58,56,8,48,1.04,14.29,Facile,Difficile,-2,Beaucoup plus Difficile,Pas Adapte,Law
5635,2020,Droit,4,Proces et Institution Juridictionnelles,2,La Trame de la Scene Judiciaire,14,81,1,QCU,0.13,0.79,67.34,42,21,63,45,42,3,1.4,93.33,Difficile,Facile,2,Beaucoup plus Facile,Adapte,Law
81,2015,Droit,4,Proces et Institution Juridictionnelles,2,La Trame de la Scene Judiciaire,14,82,2,QCU,0.53,0.21,29.22,29,69,98,51,29,22,1.92,56.86,Facile,Difficile,-2,Beaucoup plus Difficile,Pas Adapte,Law
1192,2016,Droit,4,Proces et Institution Juridictionnelles,2,La Trame de la Scene Judiciaire,14,82,2,QCU,0.23,0.54,45.33,40,48,88,69,40,29,1.28,57.97,Difficile,Moyen,1,Plus Facile,Pas Adapte,Law
2303,2017,Droit,4,Proces et Institution Juridictionnelles,2,La Trame de la Scene Judiciaire,14,82,2,QCU,0.27,0.74,64.63,50,28,78,62,50,12,1.26,80.65,Difficile,Moyen,1,Plus Facile,Adapte,Law
3414,2018,Droit,4,Proces et Institution Juridictionnelles,2,La Trame de la Scene Judiciaire,14,82,2,QCU,0.22,0.48,64.63,57,31,88,81,57,24,1.09,70.37,Moyen,Moyen,0,Meme Difficulté,Adapte,Law
4525,2019,Droit,4,Proces et Institution Juridictionnelles,2,La Trame de la Scene Judiciaire,14,82,2,QCU,0.21,0.55,64.63,56,30,86,68,56,12,1.26,82.35,Moyen,Moyen,0,Meme Difficulté,Adapte,Law
5636,2020,Droit,4,Proces et Institution Juridictionnelles,2,La Trame de la Scene Judiciaire,14,82,2,QCU,0.28,0.66,64.63,50,28,78,58,50,8,1.34,86.21,Moyen,Moyen,0,Meme Difficulté,Adapte,Law
82,2015,Droit,4,Proces et Institution Juridictionnelles,2,La Trame de la Scene Judiciaire,14,83,3,QCM,0.33,0.48,59.14,48,34,82,80,48,32,1.02,60.0,Difficile,Moyen,1,Plus Facile,Pas Adapte,Law
1193,2016,Droit,4,Proces et Institution Juridictionnelles,2,La Trame de la Scene Judiciaire,14,83,3,QCU,0.54,0.25,29.86,21,49,70,26,21,5,2.69,80.77,Moyen,Difficile,-1,Plus Difficile,Pas Adapte,Law
2304,2017,Droit,4,Proces et Institution Juridictionnelles,2,La Trame de la Scene Judiciaire,14,83,3,QCU,0.53,0.23,30.8,19,44,63,22,19,3,2.86,86.36,Difficile,Difficile,0,Meme Difficulté,Pas Adapte,Law
3415,2018,Droit,4,Proces et Institution Juridictionnelles,2,La Trame de la Scene Judiciaire,14,83,3,QCU,0.71,0.34,28.46,16,40,56,56,16,40,1.0,28.57,Moyen,Difficile,-1,Plus Difficile,Pas Adapte,Law
4526,2019,Droit,4,Proces et Institution Juridictionnelles,2,La Trame de la Scene Judiciaire,14,83,3,QCU,0.17,0.78,91.31,57,5,62,59,57,2,1.05,96.61,Moyen,Facile,1,Plus Facile,Pas Adapte,Law
5637,2020,Droit,4,Proces et Institution Juridictionnelles,2,La Trame de la Scene Judiciaire,14,83,3,QCU,0.33,0.44,40.01,26,38,64,58,26,32,1.1,44.83,Moyen,Moyen,0,Meme Difficulté,Pas Adapte,Law
83,2015,Droit,4,Proces et Institution Juridictionnelles,2,La Trame de la Scene Judiciaire,14,84,4,QCU,0.64,0.32,2.22,2,71,73,72,2,70,1.01,2.78,Difficile,Difficile,0,Meme Difficulté,Pas Adapte,Law
1194,2016,Droit,4,Proces et Institution Juridictionnelles,2,La Trame de la Scene Judiciaire,14,84,4,QCU,0.15,0.84,87.2,64,9,73,65,64,1,1.12,98.46,Moyen,Facile,1,Plus Facile,Pas Adapte,Law
2305,2017,Droit,4,Proces et Institution Juridictionnelles,2,La Trame de la Scene Judiciaire,14,84,4,QCU,0.15,0.77,78.87,64,17,81,71,64,7,1.14,90.14,Difficile,Facile,2,Beaucoup plus Facile,Pas Adapte,Law
3416,2018,Droit,4,Proces et Institution Juridictionnelles,2,La Trame de la Scene Judiciaire,14,84,4,QCU,0.26,0.58,58.65,42,30,72,53,42,11,1.36,79.25,Facile,Moyen,-1,Plus Difficile,Pas Adapte,Law
4527,2019,Droit,4,Proces et Institution Juridictionnelles,2,La Trame de la Scene Judiciaire,14,84,4,QCM,0.78,0.18,24.61,16,51,67,24,16,8,2.79,66.67,Facile,Difficile,-2,Beaucoup plus Difficile,Pas Adapte,Law
5638,2020,Droit,4,Proces et Institution Juridictionnelles,2,La Trame de la Scene Judiciaire,14,84,4,QCM,0.1,0.78,82.43,61,13,74,67,61,6,1.1,91.04,Facile,Facile,0,Meme Difficulté,Pas Adapte,Law
84,2015,Droit,4,Proces et Institution Juridictionnelles,2,La Trame de la Scene Judiciaire,14,85,5,QCM,0.73,0.3,1.39,1,46,47,30,1,29,1.57,3.33,Difficile,Difficile,0,Meme Difficulté,Pas Adapte,Law
1195,2016,Droit,4,Proces et Institution Juridictionnelles,2,La Trame de la Scene Judiciaire,14,85,5,QCU,0.72,0.38,26.8,12,34,46,24,12,12,1.92,50.0,Facile,Difficile,-2,Beaucoup plus Difficile,Pas Adapte,Law
2306,2017,Droit,4,Proces et Institution Juridictionnelles,2,La Trame de la Scene Judiciaire,14,85,5,QCU,0.04,0.96,70.84,28,12,40,31,28,3,1.29,90.32,Difficile,Facile,2,Beaucoup plus Facile,Adapte,Law
3417,2018,Droit,4,Proces et Institution Juridictionnelles,2,La Trame de la Scene Judiciaire,14,85,5,QCU,0.07,0.79,70.84,25,10,35,31,25,6,1.13,80.65,Facile,Facile,0,Meme Difficulté,Adapte,Law
4528,2019,Droit,4,Proces et Institution Juridictionnelles,2,La Trame de la Scene Judiciaire,14,85,5,QCU,0.14,0.82,70.84,27,11,38,35,27,8,1.09,77.14,Facile,Facile,0,Meme Difficulté,Adapte,Law
5639,2020,Droit,4,Proces et Institution Juridictionnelles,2,La Trame de la Scene Judiciaire,14,85,5,QCU,0.19,0.93,70.84,29,12,41,40,29,11,1.02,72.5,Facile,Facile,0,Meme Difficulté,Adapte,Law
85,2015,Droit,4,Proces et Institution Juridictionnelles,2,La Trame de la Scene Judiciaire,14,86,6,QCM,0.73,0.25,31.69,4,10,14,9,4,5,1.56,44.44,Difficile,Difficile,0,Meme Difficulté,Pas Adapte,Law
1196,2016,Droit,4,Proces et Institution Juridictionnelles,2,La Trame de la Scene Judiciaire,14,86,6,QCM,0.67,0.19,30.48,4,8,12,11,4,7,1.09,36.36,Facile,Difficile,-2,Beaucoup plus Difficile,Pas Adapte,Law
2307,2017,Droit,4,Proces et Institution Juridictionnelles,2,La Trame de la Scene Judiciaire,14,86,6,QCM,0.65,0.23,25.1,3,9,12,4,3,1,3.0,75.0,Difficile,Difficile,0,Meme Difficulté,Pas Adapte,Law
3418,2018,Droit,4,Proces et Institution Juridictionnelles,2,La Trame de la Scene Judiciaire,14,86,6,QCU,0.42,0.28,26.72,4,10,14,6,4,2,2.33,66.67,Facile,Difficile,-2,Beaucoup plus Difficile,Pas Adapte,Law
4529,2019,Droit,4,Proces et Institution Juridictionnelles,2,La Trame de la Scene Judiciaire,14,86,6,QCU,0.14,0.81,73.18,12,4,16,15,12,3,1.07,80.0,Difficile,Facile,2,Beaucoup plus Facile,Adapte,Law
5640,2020,Droit,4,Proces et Institution Juridictionnelles,2,La Trame de la Scene Judiciaire,14,86,6,QCU,0.18,0.97,73.18,13,5,18,15,13,2,1.2,86.67,Facile,Facile,0,Meme Difficulté,Adapte,Law
86,2015,Droit,4,Proces et Institution Juridictionnelles,2,La Trame de la Scene Judiciaire,14,87,7,QO,0.74,0.24,59.61,52,36,88,68,52,16,1.29,76.47,Difficile,Moyen,1,Plus Facile,Pas Adapte,Law
1197,2016,Droit,4,Proces et Institution Juridictionnelles,2,La Trame de la Scene Judiciaire,14,87,7,QO,0.18,0.31,70.58,55,23,78,61,55,6,1.28,90.16,Moyen,Facile,1,Plus Facile,Adapte,Law
2308,2017,Droit,4,Proces et Institution Juridictionnelles,2,La Trame de la Scene Judiciaire,14,87,7,QO,0.19,0.87,70.58,49,20,69,58,49,9,1.19,84.48,Facile,Facile,0,Meme Difficulté,Adapte,Law
3419,2018,Droit,4,Proces et Institution Juridictionnelles,2,La Trame de la Scene Judiciaire,14,87,7,QO,0.01,0.65,70.58,49,20,69,62,49,13,1.11,79.03,Facile,Facile,0,Meme Difficulté,Adapte,Law
4530,2019,Droit,4,Proces et Institution Juridictionnelles,2,La Trame de la Scene Judiciaire,14,87,7,QO,0.2,0.47,70.58,47,19,66,55,47,8,1.2,85.45,Facile,Facile,0,Meme Difficulté,Adapte,Law
5641,2020,Droit,4,Proces et Institution Juridictionnelles,2,La Trame de la Scene Judiciaire,14,87,7,QO,0.04,0.44,70.58,48,20,68,60,48,12,1.13,80.0,Facile,Facile,0,Meme Difficulté,Adapte,Law
87,2015,Droit,4,Proces et Institution Juridictionnelles,2,La Trame de la Scene Judiciaire,14,88,8,QROC,0.63,0.17,30.02,5,12,17,9,5,4,1.89,55.56,Facile,Difficile,-2,Beaucoup plus Difficile,Pas Adapte,Law
1198,2016,Droit,4,Proces et Institution Juridictionnelles,2,La Trame de la Scene Judiciaire,14,88,8,QO,0.3,0.19,47.62,9,9,18,11,9,2,1.64,81.82,Facile,Moyen,-1,Plus Difficile,Pas Adapte,Law
2309,2017,Droit,4,Proces et Institution Juridictionnelles,2,La Trame de la Scene Judiciaire,14,88,8,QO,0.84,0.15,34.29,5,10,15,8,5,3,1.88,62.5,Facile,Difficile,-2,Beaucoup plus Difficile,Pas Adapte,Law
3420,2018,Droit,4,Proces et Institution Juridictionnelles,2,La Trame de la Scene Judiciaire,14,88,8,QO,1.0,0.01,28.2,4,10,14,12,4,8,1.17,33.33,Moyen,Difficile,-1,Plus Difficile,Pas Adapte,Law
4531,2019,Droit,4,Proces et Institution Juridictionnelles,2,La Trame de la Scene Judiciaire,14,88,8,QO,0.58,0.2,45.47,5,7,12,7,5,2,1.71,71.43,Facile,Moyen,-1,Plus Difficile,Pas Adapte,Law
5642,2020,Droit,4,Proces et Institution Juridictionnelles,2,La Trame de la Scene Judiciaire,14,88,8,QO,0.28,0.15,54.81,7,6,13,9,7,2,1.44,77.78,Facile,Moyen,-1,Plus Difficile,Pas Adapte,Law
88,2015,Droit,4,Proces et Institution Juridictionnelles,2,La Trame de la Scene Judiciaire,14,89,9,QCM,0.07,0.88,97.16,31,1,32,31,31,0,1.03,100.0,Difficile,Facile,2,Beaucoup plus Facile,Pas Adapte,Law
1199,2016,Droit,4,Proces et Institution Juridictionnelles,2,La Trame de la Scene Judiciaire,14,89,9,QCM,0.26,0.66,38.2,11,19,30,24,11,13,1.25,45.83,Difficile,Moyen,1,Plus Facile,Pas Adapte,Law
2310,2017,Droit,4,Proces et Institution Juridictionnelles,2,La Trame de la Scene Judiciaire,14,89,9,QCM,0.39,0.37,35.59,11,19,30,27,11,16,1.11,40.74,Difficile,Moyen,1,Plus Facile,Pas Adapte,Law
3421,2018,Droit,4,Proces et Institution Juridictionnelles,2,La Trame de la Scene Judiciaire,14,89,9,QCM,0.48,0.32,63.18,16,10,26,18,16,2,1.44,88.89,Moyen,Moyen,0,Meme Difficulté,Adapte,Law
4532,2019,Droit,4,Proces et Institution Juridictionnelles,2,La Trame de la Scene Judiciaire,14,89,9,QCM,0.33,0.43,63.18,16,10,26,16,16,0,1.62,100.0,Moyen,Moyen,0,Meme Difficulté,Adapte,Law
5643,2020,Droit,4,Proces et Institution Juridictionnelles,2,La Trame de la Scene Judiciaire,14,89,9,QCM,0.33,0.44,63.18,16,10,26,18,16,2,1.44,88.89,Moyen,Moyen,0,Meme Difficulté,Adapte,Law
89,2015,Droit,4,Proces et Institution Juridictionnelles,2,La Trame de la Scene Judiciaire,14,90,10,QO,0.28,0.21,51.43,40,37,77,62,40,22,1.24,64.52,Difficile,Moyen,1,Plus Facile,Pas Adapte,Law
1200,2016,Droit,4,Proces et Institution Juridictionnelles,2,La Trame de la Scene Judiciaire,14,90,10,QO,0.14,0.52,89.22,77,9,86,81,77,4,1.06,95.06,Moyen,Facile,1,Plus Facile,Pas Adapte,Law
2311,2017,Droit,4,Proces et Institution Juridictionnelles,2,La Trame de la Scene Judiciaire,14,90,10,QO,0.82,0.09,28.02,26,66,92,82,26,56,1.12,31.71,Moyen,Difficile,-1,Plus Difficile,Pas Adapte,Law
3422,2018,Droit,4,Proces et Institution Juridictionnelles,2,La Trame de la Scene Judiciaire,14,90,10,QO,0.9,0.04,6.95,7,90,97,96,7,89,1.01,7.29,Difficile,Difficile,0,Meme Difficulté,Pas Adapte,Law
4533,2019,Droit,4,Proces et Institution Juridictionnelles,2,La Trame de la Scene Judiciaire,14,90,10,QO,0.84,0.02,23.29,22,71,93,70,22,48,1.33,31.43,Difficile,Difficile,0,Meme Difficulté,Pas Adapte,Law
5644,2020,Droit,4,Proces et Institution Juridictionnelles,2,La Trame de la Scene Judiciaire,14,90,10,QO,0.14,0.89,93.06,91,7,98,93,91,2,1.05,97.85,Facile,Facile,0,Meme Difficulté,Pas Adapte,Law
90,2015,Droit,4,Proces et Institution Juridictionnelles,2,La Trame de la Scene Judiciaire,14,91,11,QCU,0.37,0.69,51.33,36,35,71,64,36,28,1.11,56.25,Difficile,Moyen,1,Plus Facile,Pas Adapte,Law
1201,2016,Droit,4,Proces et Institution Juridictionnelles,2,La Trame de la Scene Judiciaire,14,91,11,QCU,0.05,0.93,75.08,56,18,74,60,56,4,1.23,93.33,Facile,Facile,0,Meme Difficulté,Pas Adapte,Law
2312,2017,Droit,4,Proces et Institution Juridictionnelles,2,La Trame de la Scene Judiciaire,14,91,11,QCU,0.4,0.44,52.25,38,34,72,66,38,28,1.09,57.58,Moyen,Moyen,0,Meme Difficulté,Pas Adapte,Law
3423,2018,Droit,4,Proces et Institution Juridictionnelles,2,La Trame de la Scene Judiciaire,14,91,11,QCM,0.69,0.28,27.07,22,58,80,22,22,0,3.64,100.0,Facile,Difficile,-2,Beaucoup plus Difficile,Pas Adapte,Law
4534,2019,Droit,4,Proces et Institution Juridictionnelles,2,La Trame de la Scene Judiciaire,14,91,11,QCM,0.69,0.29,0.04,0,70,70,63,0,63,1.11,0.0,Difficile,Difficile,0,Meme Difficulté,Pas Adapte,Law
5645,2020,Droit,4,Proces et Institution Juridictionnelles,2,La Trame de la Scene Judiciaire,14,91,11,QCM,0.68,0.28,15.06,9,53,62,27,9,18,2.3,33.33,Difficile,Difficile,0,Meme Difficulté,Pas Adapte,Law
91,2015,Droit,4,Proces et Institution Juridictionnelles,2,La Trame de la Scene Judiciaire,14,92,12,QCM,0.05,0.93,94.63,9,0,9,9,9,0,1.0,100.0,Facile,Facile,0,Meme Difficulté,Pas Adapte,Law
1202,2016,Droit,4,Proces et Institution Juridictionnelles,2,La Trame de la Scene Judiciaire,14,92,12,QCM,0.62,0.18,19.32,2,7,9,7,2,5,1.29,28.57,Facile,Difficile,-2,Beaucoup plus Difficile,Pas Adapte,Law
2313,2017,Droit,4,Proces et Institution Juridictionnelles,2,La Trame de la Scene Judiciaire,14,92,12,QCM,0.21,0.65,61.93,6,4,10,6,6,0,1.67,100.0,Difficile,Moyen,1,Plus Facile,Adapte,Law
3424,2018,Droit,4,Proces et Institution Juridictionnelles,2,La Trame de la Scene Judiciaire,14,92,12,QCM,0.45,0.35,61.93,7,4,11,9,7,2,1.22,77.78,Moyen,Moyen,0,Meme Difficulté,Adapte,Law
4535,2019,Droit,4,Proces et Institution Juridictionnelles,2,La Trame de la Scene Judiciaire,14,92,12,QCM,0.4,0.62,61.93,6,3,9,7,6,1,1.29,85.71,Moyen,Moyen,0,Meme Difficulté,Adapte,Law
5646,2020,Droit,4,Proces et Institution Juridictionnelles,2,La Trame de la Scene Judiciaire,14,92,12,QCM,0.22,0.35,61.93,6,4,10,8,6,2,1.25,75.0,Moyen,Moyen,0,Meme Difficulté,Adapte,Law
92,2015,Droit,4,Proces et Institution Juridictionnelles,2,La Trame de la Scene Judiciaire,14,93,13,QCU,0.57,0.38,3.75,4,95,99,46,4,42,2.15,8.7,Difficile,Difficile,0,Meme Difficulté,Pas Adapte,Law
1203,2016,Droit,4,Proces et Institution Juridictionnelles,2,La Trame de la Scene Judiciaire,14,93,13,QCU,0.06,0.79,94.68,107,6,113,110,107,3,1.03,97.27,Facile,Facile,0,Meme Difficulté,Pas Adapte,Law
2314,2017,Droit,4,Proces et Institution Juridictionnelles,2,La Trame de la Scene Judiciaire,14,93,13,QCU,0.54,0.32,14.51,15,89,104,87,15,72,1.2,17.24,Difficile,Difficile,0,Meme Difficulté,Pas Adapte,Law
3425,2018,Droit,4,Proces et Institution Juridictionnelles,2,La Trame de la Scene Judiciaire,14,93,13,QCU,0.39,0.52,56.73,62,47,109,109,62,47,1.0,56.88,Difficile,Moyen,1,Plus Facile,Pas Adapte,Law
4536,2019,Droit,4,Proces et Institution Juridictionnelles,2,La Trame de la Scene Judiciaire,14,93,13,QCU,0.05,0.89,88.29,93,12,105,103,93,10,1.02,90.29,Difficile,Facile,2,Beaucoup plus Facile,Pas Adapte,Law
5647,2020,Droit,4,Proces et Institution Juridictionnelles,2,La Trame de la Scene Judiciaire,14,93,13,QCU,0.55,0.31,12.48,15,105,120,98,15,83,1.22,15.31,Facile,Difficile,-2,Beaucoup plus Difficile,Pas Adapte,Law
93,2015,Droit,4,Proces et Institution Juridictionnelles,2,La Trame de la Scene Judiciaire,14,94,14,QCM,0.63,0.24,33.06,6,13,19,17,6,11,1.12,35.29,Facile,Difficile,-2,Beaucoup plus Difficile,Pas Adapte,Law
1204,2016,Droit,4,Proces et Institution Juridictionnelles,2,La Trame de la Scene Judiciaire,14,94,14,QCM,0.01,0.81,93.21,17,1,18,17,17,0,1.06,100.0,Facile,Facile,0,Meme Difficulté,Pas Adapte,Law
2315,2017,Droit,4,Proces et Institution Juridictionnelles,2,La Trame de la Scene Judiciaire,14,94,14,QCM,0.68,0.25,21.71,3,13,16,15,3,12,1.07,20.0,Difficile,Difficile,0,Meme Difficulté,Pas Adapte,Law
3426,2018,Droit,4,Proces et Institution Juridictionnelles,2,La Trame de la Scene Judiciaire,14,94,14,QCM,0.03,0.7,92.44,14,1,15,15,14,1,1.0,93.33,Moyen,Facile,1,Plus Facile,Pas Adapte,Law
4537,2019,Droit,4,Proces et Institution Juridictionnelles,2,La Trame de la Scene Judiciaire,14,94,14,QCM,0.18,0.79,97.24,14,0,14,14,14,0,1.0,100.0,Difficile,Facile,2,Beaucoup plus Facile,Pas Adapte,Law
5648,2020,Droit,4,Proces et Institution Juridictionnelles,2,La Trame de la Scene Judiciaire,14,94,14,QCM,0.07,0.96,91.95,12,1,13,13,12,1,1.0,92.31,Difficile,Facile,2,Beaucoup plus Facile,Pas Adapte,Law
94,2015,Droit,4,Proces et Institution Juridictionnelles,3,Le Theatre de la Scene Judiciaire,7,95,1,QCM,0.09,0.89,97.76,72,2,74,73,72,1,1.01,98.63,Difficile,Facile,2,Beaucoup plus Facile,Pas Adapte,Law
1205,2016,Droit,4,Proces et Institution Juridictionnelles,3,Le Theatre de la Scene Judiciaire,7,95,1,QCM,0.49,0.55,56.82,39,29,68,65,39,26,1.05,60.0,Moyen,Moyen,0,Meme Difficulté,Pas Adapte,Law
2316,2017,Droit,4,Proces et Institution Juridictionnelles,3,Le Theatre de la Scene Judiciaire,7,95,1,QCM,0.47,0.32,59.23,36,24,60,38,36,2,1.58,94.74,Difficile,Moyen,1,Plus Facile,Pas Adapte,Law
3427,2018,Droit,4,Proces et Institution Juridictionnelles,3,Le Theatre de la Scene Judiciaire,7,95,1,QO,0.01,0.87,70.59,47,19,66,50,47,3,1.32,94.0,Difficile,Facile,2,Beaucoup plus Facile,Adapte,Law
4538,2019,Droit,4,Proces et Institution Juridictionnelles,3,Le Theatre de la Scene Judiciaire,7,95,1,QROC,0.03,0.52,70.59,44,18,62,60,44,16,1.03,73.33,Facile,Facile,0,Meme Difficulté,Adapte,Law
5649,2020,Droit,4,Proces et Institution Juridictionnelles,3,Le Theatre de la Scene Judiciaire,7,95,1,QROC,0.11,0.83,70.59,37,16,53,40,37,3,1.32,92.5,Facile,Facile,0,Meme Difficulté,Adapte,Law
95,2015,Droit,4,Proces et Institution Juridictionnelles,3,Le Theatre de la Scene Judiciaire,7,96,2,QCU,0.5,0.22,29.33,9,21,30,28,9,19,1.07,32.14,Facile,Difficile,-2,Beaucoup plus Difficile,Pas Adapte,Law
1206,2016,Droit,4,Proces et Institution Juridictionnelles,3,Le Theatre de la Scene Judiciaire,7,96,2,QCU,0.51,0.22,29.93,8,20,28,18,8,10,1.56,44.44,Difficile,Difficile,0,Meme Difficulté,Pas Adapte,Law
2317,2017,Droit,4,Proces et Institution Juridictionnelles,3,Le Theatre de la Scene Judiciaire,7,96,2,QCU,0.7,0.28,14.0,4,21,25,18,4,14,1.39,22.22,Difficile,Difficile,0,Meme Difficulté,Pas Adapte,Law
3428,2018,Droit,4,Proces et Institution Juridictionnelles,3,Le Theatre de la Scene Judiciaire,7,96,2,QCU,0.19,0.91,66.73,14,7,21,21,14,7,1.0,66.67,Difficile,Facile,2,Beaucoup plus Facile,Adapte,Law
4539,2019,Droit,4,Proces et Institution Juridictionnelles,3,Le Theatre de la Scene Judiciaire,7,96,2,QCU,0.13,0.94,66.73,13,6,19,17,13,4,1.12,76.47,Facile,Facile,0,Meme Difficulté,Adapte,Law
5650,2020,Droit,4,Proces et Institution Juridictionnelles,3,Le Theatre de la Scene Judiciaire,7,96,2,QCU,0.16,0.78,66.73,11,5,16,12,11,1,1.33,91.67,Facile,Facile,0,Meme Difficulté,Adapte,Law
96,2015,Droit,4,Proces et Institution Juridictionnelles,3,Le Theatre de la Scene Judiciaire,7,97,3,QCM,0.7,0.25,18.26,5,24,29,13,5,8,2.23,38.46,Facile,Difficile,-2,Beaucoup plus Difficile,Pas Adapte,Law
1207,2016,Droit,4,Proces et Institution Juridictionnelles,3,Le Theatre de la Scene Judiciaire,7,97,3,QCM,0.54,0.25,31.05,9,21,30,19,9,10,1.58,47.37,Facile,Difficile,-2,Beaucoup plus Difficile,Pas Adapte,Law
2318,2017,Droit,4,Proces et Institution Juridictionnelles,3,Le Theatre de la Scene Judiciaire,7,97,3,QCM,0.45,0.48,38.78,12,20,32,32,12,20,1.0,37.5,Difficile,Moyen,1,Plus Facile,Pas Adapte,Law
3429,2018,Droit,4,Proces et Institution Juridictionnelles,3,Le Theatre de la Scene Judiciaire,7,97,3,QCM,0.76,0.28,16.1,5,29,34,12,5,7,2.83,41.67,Difficile,Difficile,0,Meme Difficulté,Pas Adapte,Law
4540,2019,Droit,4,Proces et Institution Juridictionnelles,3,Le Theatre de la Scene Judiciaire,7,97,3,QCU,0.15,0.83,99.91,36,0,36,36,36,0,1.0,100.0,Moyen,Facile,1,Plus Facile,Pas Adapte,Law
5651,2020,Droit,4,Proces et Institution Juridictionnelles,3,Le Theatre de la Scene Judiciaire,7,97,3,QCU,0.55,0.33,22.47,9,31,40,22,9,13,1.82,40.91,Difficile,Difficile,0,Meme Difficulté,Pas Adapte,Law
97,2015,Droit,4,Proces et Institution Juridictionnelles,3,Le Theatre de la Scene Judiciaire,7,98,4,QCU,0.51,0.34,29.07,28,68,96,32,28,4,3.0,87.5,Facile,Difficile,-2,Beaucoup plus Difficile,Pas Adapte,Law
1208,2016,Droit,4,Proces et Institution Juridictionnelles,3,Le Theatre de la Scene Judiciaire,7,98,4,QCU,0.15,0.93,88.26,87,12,99,94,87,7,1.05,92.55,Facile,Facile,0,Meme Difficulté,Pas Adapte,Law
2319,2017,Droit,4,Proces et Institution Juridictionnelles,3,Le Theatre de la Scene Judiciaire,7,98,4,QCU,0.11,0.98,97.48,97,2,99,99,97,2,1.0,97.98,Difficile,Facile,2,Beaucoup plus Facile,Pas Adapte,Law
3430,2018,Droit,4,Proces et Institution Juridictionnelles,3,Le Theatre de la Scene Judiciaire,7,98,4,QCU,0.65,0.34,22.04,19,68,87,54,19,35,1.61,35.19,Facile,Difficile,-2,Beaucoup plus Difficile,Pas Adapte,Law
4541,2019,Droit,4,Proces et Institution Juridictionnelles,3,Le Theatre de la Scene Judiciaire,7,98,4,QCU,0.27,0.42,45.49,35,43,78,63,35,28,1.24,55.56,Difficile,Moyen,1,Plus Facile,Pas Adapte,Law
5652,2020,Droit,4,Proces et Institution Juridictionnelles,3,Le Theatre de la Scene Judiciaire,7,98,4,QCU,0.33,0.52,43.73,32,42,74,35,32,3,2.11,91.43,Moyen,Moyen,0,Meme Difficulté,Pas Adapte,Law
98,2015,Droit,4,Proces et Institution Juridictionnelles,3,Le Theatre de la Scene Judiciaire,7,99,5,QCM,0.3,0.39,39.66,3,5,8,4,3,1,2.0,75.0,Difficile,Moyen,1,Plus Facile,Pas Adapte,Law
1209,2016,Droit,4,Proces et Institution Juridictionnelles,3,Le Theatre de la Scene Judiciaire,7,99,5,QROC,0.91,0.02,34.1,3,5,8,4,3,1,2.0,75.0,Moyen,Difficile,-1,Plus Difficile,Pas Adapte,Law
2320,2017,Droit,4,Proces et Institution Juridictionnelles,3,Le Theatre de la Scene Judiciaire,7,99,5,QROC,0.71,0.14,30.66,3,6,9,5,3,2,1.8,60.0,Moyen,Difficile,-1,Plus Difficile,Pas Adapte,Law
3431,2018,Droit,4,Proces et Institution Juridictionnelles,3,Le Theatre de la Scene Judiciaire,7,99,5,QROC,0.64,0.07,31.0,3,6,9,7,3,4,1.29,42.86,Moyen,Difficile,-1,Plus Difficile,Pas Adapte,Law
4542,2019,Droit,4,Proces et Institution Juridictionnelles,3,Le Theatre de la Scene Judiciaire,7,99,5,QROC,0.12,0.87,97.12,8,0,8,8,8,0,1.0,100.0,Moyen,Facile,1,Plus Facile,Pas Adapte,Law
5653,2020,Droit,4,Proces et Institution Juridictionnelles,3,Le Theatre de la Scene Judiciaire,7,99,5,QROC,0.96,0.02,30.55,2,6,8,7,2,5,1.14,28.57,Facile,Difficile,-2,Beaucoup plus Difficile,Pas Adapte,Law
99,2015,Droit,4,Proces et Institution Juridictionnelles,3,Le Theatre de la Scene Judiciaire,7,100,6,QCM,0.11,0.84,71.29,6,2,8,7,6,1,1.14,85.71,Moyen,Facile,1,Plus Facile,Adapte,Law
1210,2016,Droit,4,Proces et Institution Juridictionnelles,3,Le Theatre de la Scene Judiciaire,7,100,6,QCM,0.2,0.74,71.29,6,2,8,7,6,1,1.14,85.71,Facile,Facile,0,Meme Difficulté,Adapte,Law
2321,2017,Droit,4,Proces et Institution Juridictionnelles,3,Le Theatre de la Scene Judiciaire,7,100,6,QCM,0.14,0.71,71.29,6,2,8,8,6,2,1.0,75.0,Facile,Facile,0,Meme Difficulté,Adapte,Law
3432,2018,Droit,4,Proces et Institution Juridictionnelles,3,Le Theatre de la Scene Judiciaire,7,100,6,QCM,0.01,0.94,71.29,6,3,9,8,6,2,1.12,75.0,Facile,Facile,0,Meme Difficulté,Adapte,Law
4543,2019,Droit,4,Proces et Institution Juridictionnelles,3,Le Theatre de la Scene Judiciaire,7,100,6,QCM,0.17,0.81,71.29,6,2,8,7,6,1,1.14,85.71,Facile,Facile,0,Meme Difficulté,Adapte,Law
5654,2020,Droit,4,Proces et Institution Juridictionnelles,3,Le Theatre de la Scene Judiciaire,7,100,6,QCM,0.13,0.87,71.29,5,2,7,6,5,1,1.17,83.33,Facile,Facile,0,Meme Difficulté,Adapte,Law
100,2015,Droit,4,Proces et Institution Juridictionnelles,3,Le Theatre de la Scene Judiciaire,7,101,7,QCU,0.08,0.98,83.79,71,14,85,85,71,14,1.0,83.53,Moyen,Facile,1,Plus Facile,Pas Adapte,Law
1211,2016,Droit,4,Proces et Institution Juridictionnelles,3,Le Theatre de la Scene Judiciaire,7,101,7,QCU,0.68,0.22,33.2,33,65,98,71,33,38,1.38,46.48,Difficile,Difficile,0,Meme Difficulté,Pas Adapte,Law
2322,2017,Droit,4,Proces et Institution Juridictionnelles,3,Le Theatre de la Scene Judiciaire,7,101,7,QCU,0.67,0.28,34.19,34,64,98,94,34,60,1.04,36.17,Difficile,Difficile,0,Meme Difficulté,Pas Adapte,Law
3433,2018,Droit,4,Proces et Institution Juridictionnelles,3,Le Theatre de la Scene Judiciaire,7,101,7,QCU,0.45,0.22,17.93,19,86,105,81,19,62,1.3,23.46,Facile,Difficile,-2,Beaucoup plus Difficile,Pas Adapte,Law
4544,2019,Droit,4,Proces et Institution Juridictionnelles,3,Le Theatre de la Scene Judiciaire,7,101,7,QROC,0.64,0.2,24.94,24,74,98,69,24,45,1.42,34.78,Moyen,Difficile,-1,Plus Difficile,Pas Adapte,Law
5655,2020,Droit,4,Proces et Institution Juridictionnelles,3,Le Theatre de la Scene Judiciaire,7,101,7,QROC,0.63,0.01,0.6,1,98,99,91,1,90,1.09,1.1,Facile,Difficile,-2,Beaucoup plus Difficile,Pas Adapte,Law
101,2015,Droit,5,Constitution de la Cinquieme Republique,1,"La Cinquieme Republique, une Conception du Pouvoir",6,102,1,QCM,0.47,0.42,35.82,30,55,85,36,30,6,2.36,83.33,Difficile,Moyen,1,Plus Facile,Pas Adapte,Law
1212,2016,Droit,5,Constitution de la Cinquieme Republique,1,"La Cinquieme Republique, une Conception du Pouvoir",6,102,1,QCM,0.73,0.29,28.55,26,65,91,81,26,55,1.12,32.1,Difficile,Difficile,0,Meme Difficulté,Pas Adapte,Law
2323,2017,Droit,5,Constitution de la Cinquieme Republique,1,"La Cinquieme Republique, une Conception du Pouvoir",6,102,1,QCM,0.77,0.23,4.89,5,93,98,72,5,67,1.36,6.94,Facile,Difficile,-2,Beaucoup plus Difficile,Pas Adapte,Law
3434,2018,Droit,5,Constitution de la Cinquieme Republique,1,"La Cinquieme Republique, une Conception du Pouvoir",6,102,1,QCM,0.76,0.2,20.64,21,80,101,34,21,13,2.97,61.76,Moyen,Difficile,-1,Plus Difficile,Pas Adapte,Law
4545,2019,Droit,5,Constitution de la Cinquieme Republique,1,"La Cinquieme Republique, une Conception du Pouvoir",6,102,1,QCM,0.03,0.77,94.65,89,5,94,93,89,4,1.01,95.7,Difficile,Facile,2,Beaucoup plus Facile,Pas Adapte,Law
5656,2020,Droit,5,Constitution de la Cinquieme Republique,1,"La Cinquieme Republique, une Conception du Pouvoir",6,102,1,QCM,0.29,0.56,63.29,63,37,100,87,63,24,1.15,72.41,Facile,Moyen,-1,Plus Difficile,Adapte,Law
102,2015,Droit,5,Constitution de la Cinquieme Republique,1,"La Cinquieme Republique, une Conception du Pouvoir",6,103,2,QCU,0.46,0.27,14.47,13,74,87,45,13,32,1.93,28.89,Moyen,Difficile,-1,Plus Difficile,Pas Adapte,Law
1213,2016,Droit,5,Constitution de la Cinquieme Republique,1,"La Cinquieme Republique, une Conception du Pouvoir",6,103,2,QCU,0.49,0.37,28.86,25,63,88,72,25,47,1.22,34.72,Facile,Difficile,-2,Beaucoup plus Difficile,Pas Adapte,Law
2324,2017,Droit,5,Constitution de la Cinquieme Republique,1,"La Cinquieme Republique, une Conception du Pouvoir",6,103,2,QCU,0.65,0.33,9.11,9,89,98,58,9,49,1.69,15.52,Facile,Difficile,-2,Beaucoup plus Difficile,Pas Adapte,Law
3435,2018,Droit,5,Constitution de la Cinquieme Republique,1,"La Cinquieme Republique, une Conception du Pouvoir",6,103,2,QCU,0.3,0.53,47.84,44,48,92,49,44,5,1.88,89.8,Difficile,Moyen,1,Plus Facile,Pas Adapte,Law
4546,2019,Droit,5,Constitution de la Cinquieme Republique,1,"La Cinquieme Republique, une Conception du Pouvoir",6,103,2,QCU,0.74,0.27,12.7,13,86,99,66,13,53,1.5,19.7,Moyen,Difficile,-1,Plus Difficile,Pas Adapte,Law
5657,2020,Droit,5,Constitution de la Cinquieme Republique,1,"La Cinquieme Republique, une Conception du Pouvoir",6,103,2,QCU,0.65,0.25,24.93,27,81,108,95,27,68,1.14,28.42,Moyen,Difficile,-1,Plus Difficile,Pas Adapte,Law
103,2015,Droit,5,Constitution de la Cinquieme Republique,1,"La Cinquieme Republique, une Conception du Pouvoir",6,104,3,QROC,0.93,0.12,16.55,5,28,33,19,5,14,1.74,26.32,Difficile,Difficile,0,Meme Difficulté,Pas Adapte,Law
1214,2016,Droit,5,Constitution de la Cinquieme Republique,1,"La Cinquieme Republique, une Conception du Pouvoir",6,104,3,QROC,0.5,0.37,39.44,14,22,36,20,14,6,1.8,70.0,Moyen,Moyen,0,Meme Difficulté,Pas Adapte,Law
2325,2017,Droit,5,Constitution de la Cinquieme Republique,1,"La Cinquieme Republique, une Conception du Pouvoir",6,104,3,QROC,0.88,0.24,10.42,4,36,40,39,4,35,1.03,10.26,Difficile,Difficile,0,Meme Difficulté,Pas Adapte,Law
3436,2018,Droit,5,Constitution de la Cinquieme Republique,1,"La Cinquieme Republique, une Conception du Pouvoir",6,104,3,QROC,0.08,0.93,74.57,34,11,45,39,34,5,1.15,87.18,Difficile,Facile,2,Beaucoup plus Facile,Adapte,Law
4547,2019,Droit,5,Constitution de la Cinquieme Republique,1,"La Cinquieme Republique, une Conception du Pouvoir",6,104,3,QROC,0.09,0.8,74.57,37,12,49,44,37,7,1.11,84.09,Facile,Facile,0,Meme Difficulté,Adapte,Law
5658,2020,Droit,5,Constitution de la Cinquieme Republique,1,"La Cinquieme Republique, une Conception du Pouvoir",6,104,3,QROC,0.09,0.93,74.57,37,12,49,41,37,4,1.2,90.24,Facile,Facile,0,Meme Difficulté,Adapte,Law
104,2015,Droit,5,Constitution de la Cinquieme Republique,1,"La Cinquieme Republique, une Conception du Pouvoir",6,105,4,QCM,0.57,0.15,13.44,3,23,26,14,3,11,1.86,21.43,Facile,Difficile,-2,Beaucoup plus Difficile,Pas Adapte,Law
1215,2016,Droit,5,Constitution de la Cinquieme Republique,1,"La Cinquieme Republique, une Conception du Pouvoir",6,105,4,QCM,0.05,0.71,94.46,27,2,29,29,27,2,1.0,93.1,Difficile,Facile,2,Beaucoup plus Facile,Pas Adapte,Law
2326,2017,Droit,5,Constitution de la Cinquieme Republique,1,"La Cinquieme Republique, une Conception du Pouvoir",6,105,4,QCM,0.71,0.3,18.71,5,24,29,24,5,19,1.21,20.83,Moyen,Difficile,-1,Plus Difficile,Pas Adapte,Law
3437,2018,Droit,5,Constitution de la Cinquieme Republique,1,"La Cinquieme Republique, une Conception du Pouvoir",6,105,4,QCM,0.3,0.49,59.07,17,12,29,28,17,11,1.04,60.71,Facile,Moyen,-1,Plus Difficile,Pas Adapte,Law
4548,2019,Droit,5,Constitution de la Cinquieme Republique,1,"La Cinquieme Republique, une Conception du Pouvoir",6,105,4,QCM,0.63,0.16,27.88,8,19,27,18,8,10,1.5,44.44,Moyen,Difficile,-1,Plus Difficile,Pas Adapte,Law
5659,2020,Droit,5,Constitution de la Cinquieme Republique,1,"La Cinquieme Republique, une Conception du Pouvoir",6,105,4,QCM,0.02,0.86,76.84,19,6,25,24,19,5,1.04,79.17,Difficile,Facile,2,Beaucoup plus Facile,Pas Adapte,Law
105,2015,Droit,5,Constitution de la Cinquieme Republique,1,"La Cinquieme Republique, une Conception du Pouvoir",6,106,5,QCU,0.01,0.79,68.78,20,9,29,28,20,8,1.04,71.43,Facile,Facile,0,Meme Difficulté,Adapte,Law
1216,2016,Droit,5,Constitution de la Cinquieme Republique,1,"La Cinquieme Republique, une Conception du Pouvoir",6,106,5,QCU,0.19,0.99,68.78,23,10,33,26,23,3,1.27,88.46,Facile,Facile,0,Meme Difficulté,Adapte,Law
2327,2017,Droit,5,Constitution de la Cinquieme Republique,1,"La Cinquieme Republique, une Conception du Pouvoir",6,106,5,QCU,0.1,0.93,68.78,19,9,28,25,19,6,1.12,76.0,Facile,Facile,0,Meme Difficulté,Adapte,Law
3438,2018,Droit,5,Constitution de la Cinquieme Republique,1,"La Cinquieme Republique, une Conception du Pouvoir",6,106,5,QCU,0.12,0.87,68.78,19,8,27,23,19,4,1.17,82.61,Facile,Facile,0,Meme Difficulté,Adapte,Law
4549,2019,Droit,5,Constitution de la Cinquieme Republique,1,"La Cinquieme Republique, une Conception du Pouvoir",6,106,5,QCU,0.15,0.93,68.78,21,10,31,23,21,2,1.35,91.3,Facile,Facile,0,Meme Difficulté,Adapte,Law
5660,2020,Droit,5,Constitution de la Cinquieme Republique,1,"La Cinquieme Republique, une Conception du Pouvoir",6,106,5,QCU,0.07,0.81,68.78,18,8,26,20,18,2,1.3,90.0,Facile,Facile,0,Meme Difficulté,Adapte,Law
106,2015,Droit,5,Constitution de la Cinquieme Republique,1,"La Cinquieme Republique, une Conception du Pouvoir",6,107,6,QCU,0.37,0.56,43.14,20,26,46,23,20,3,2.0,86.96,Moyen,Moyen,0,Meme Difficulté,Pas Adapte,Law
1217,2016,Droit,5,Constitution de la Cinquieme Republique,1,"La Cinquieme Republique, une Conception du Pouvoir",6,107,6,QCU,0.01,0.89,89.79,48,5,53,52,48,4,1.02,92.31,Moyen,Facile,1,Plus Facile,Pas Adapte,Law
2328,2017,Droit,5,Constitution de la Cinquieme Republique,1,"La Cinquieme Republique, une Conception du Pouvoir",6,107,6,QCU,0.12,0.79,74.81,38,13,51,48,38,10,1.06,79.17,Difficile,Facile,2,Beaucoup plus Facile,Adapte,Law
3439,2018,Droit,5,Constitution de la Cinquieme Republique,1,"La Cinquieme Republique, une Conception du Pouvoir",6,107,6,QCU,0.17,0.92,74.81,43,15,58,49,43,6,1.18,87.76,Facile,Facile,0,Meme Difficulté,Adapte,Law
4550,2019,Droit,5,Constitution de la Cinquieme Republique,1,"La Cinquieme Republique, une Conception du Pouvoir",6,107,6,QCU,0.06,0.92,74.81,40,13,53,47,40,7,1.13,85.11,Facile,Facile,0,Meme Difficulté,Adapte,Law
5661,2020,Droit,5,Constitution de la Cinquieme Republique,1,"La Cinquieme Republique, une Conception du Pouvoir",6,107,6,QCU,0.06,0.99,74.81,42,14,56,47,42,5,1.19,89.36,Facile,Facile,0,Meme Difficulté,Adapte,Law
107,2015,Droit,5,Constitution de la Cinquieme Republique,2,Le Pouvoir Gouvernant,13,108,1,QROC,0.16,0.78,95.85,11,0,11,11,11,0,1.0,100.0,Facile,Facile,0,Meme Difficulté,Pas Adapte,Law
1218,2016,Droit,5,Constitution de la Cinquieme Republique,2,Le Pouvoir Gouvernant,13,108,1,QROC,0.64,0.08,30.34,4,9,13,7,4,3,1.86,57.14,Facile,Difficile,-2,Beaucoup plus Difficile,Pas Adapte,Law
2329,2017,Droit,5,Constitution de la Cinquieme Republique,2,Le Pouvoir Gouvernant,13,108,1,QROC,0.54,0.26,61.72,7,5,12,9,7,2,1.33,77.78,Moyen,Moyen,0,Meme Difficulté,Adapte,Law
3440,2018,Droit,5,Constitution de la Cinquieme Republique,2,Le Pouvoir Gouvernant,13,108,1,QROC,0.41,0.3,61.72,7,5,12,10,7,3,1.2,70.0,Moyen,Moyen,0,Meme Difficulté,Adapte,Law
4551,2019,Droit,5,Constitution de la Cinquieme Republique,2,Le Pouvoir Gouvernant,13,108,1,QROC,0.24,0.31,61.72,7,5,12,9,7,2,1.33,77.78,Moyen,Moyen,0,Meme Difficulté,Adapte,Law
5662,2020,Droit,5,Constitution de la Cinquieme Republique,2,Le Pouvoir Gouvernant,13,108,1,QROC,0.33,0.27,61.72,9,5,14,9,9,0,1.56,100.0,Moyen,Moyen,0,Meme Difficulté,Adapte,Law
108,2015,Droit,5,Constitution de la Cinquieme Republique,2,Le Pouvoir Gouvernant,13,109,2,QROC,0.18,0.48,91.09,36,4,40,38,36,2,1.05,94.74,Difficile,Facile,2,Beaucoup plus Facile,Pas Adapte,Law
1219,2016,Droit,5,Constitution de la Cinquieme Republique,2,Le Pouvoir Gouvernant,13,109,2,QROC,0.12,0.42,71.9,27,10,37,27,27,0,1.37,100.0,Difficile,Facile,2,Beaucoup plus Facile,Adapte,Law
2330,2017,Droit,5,Constitution de la Cinquieme Republique,2,Le Pouvoir Gouvernant,13,109,2,QROC,0.05,0.52,71.9,23,9,32,30,23,7,1.07,76.67,Facile,Facile,0,Meme Difficulté,Adapte,Law
3441,2018,Droit,5,Constitution de la Cinquieme Republique,2,Le Pouvoir Gouvernant,13,109,2,QROC,0.1,0.43,71.9,24,9,33,24,24,0,1.38,100.0,Facile,Facile,0,Meme Difficulté,Adapte,Law
4552,2019,Droit,5,Constitution de la Cinquieme Republique,2,Le Pouvoir Gouvernant,13,109,2,QROC,0.16,0.66,71.9,27,10,37,34,27,7,1.09,79.41,Facile,Facile,0,Meme Difficulté,Adapte,Law
5663,2020,Droit,5,Constitution de la Cinquieme Republique,2,Le Pouvoir Gouvernant,13,109,2,QROC,0.18,0.44,71.9,28,11,39,36,28,8,1.08,77.78,Facile,Facile,0,Meme Difficulté,Adapte,Law
109,2015,Droit,5,Constitution de la Cinquieme Republique,2,Le Pouvoir Gouvernant,13,110,3,QCU,0.34,0.45,59.4,5,4,9,9,5,4,1.0,55.56,Difficile,Moyen,1,Plus Facile,Pas Adapte,Law
1220,2016,Droit,5,Constitution de la Cinquieme Republique,2,Le Pouvoir Gouvernant,13,110,3,QCU,0.42,0.35,12.45,1,7,8,7,1,6,1.14,14.29,Facile,Difficile,-2,Beaucoup plus Difficile,Pas Adapte,Law
2331,2017,Droit,5,Constitution de la Cinquieme Republique,2,Le Pouvoir Gouvernant,13,110,3,QCU,0.59,0.39,13.92,1,8,9,7,1,6,1.29,14.29,Moyen,Difficile,-1,Plus Difficile,Pas Adapte,Law
3442,2018,Droit,5,Constitution de la Cinquieme Republique,2,Le Pouvoir Gouvernant,13,110,3,QCU,0.0,0.83,79.06,8,2,10,10,8,2,1.0,80.0,Difficile,Facile,2,Beaucoup plus Facile,Pas Adapte,Law
4553,2019,Droit,5,Constitution de la Cinquieme Republique,2,Le Pouvoir Gouvernant,13,110,3,QCU,0.68,0.31,0.83,0,12,12,7,0,7,1.71,0.0,Facile,Difficile,-2,Beaucoup plus Difficile,Pas Adapte,Law
5664,2020,Droit,5,Constitution de la Cinquieme Republique,2,Le Pouvoir Gouvernant,13,110,3,QCU,0.17,0.92,85.68,11,2,13,13,11,2,1.0,84.62,Difficile,Facile,2,Beaucoup plus Facile,Pas Adapte,Law
110,2015,Droit,5,Constitution de la Cinquieme Republique,2,Le Pouvoir Gouvernant,13,111,4,QROC,0.69,0.05,22.61,13,46,59,27,13,14,2.19,48.15,Moyen,Difficile,-1,Plus Difficile,Pas Adapte,Law
1221,2016,Droit,5,Constitution de la Cinquieme Republique,2,Le Pouvoir Gouvernant,13,111,4,QROC,0.29,0.39,57.62,35,25,60,51,35,16,1.18,68.63,Difficile,Moyen,1,Plus Facile,Pas Adapte,Law
2332,2017,Droit,5,Constitution de la Cinquieme Republique,2,Le Pouvoir Gouvernant,13,111,4,QROC,0.44,0.28,60.67,31,20,51,45,31,14,1.13,68.89,Facile,Moyen,-1,Plus Difficile,Adapte,Law
3443,2018,Droit,5,Constitution de la Cinquieme Republique,2,Le Pouvoir Gouvernant,13,111,4,QROC,0.3,0.35,60.67,31,20,51,35,31,4,1.46,88.57,Moyen,Moyen,0,Meme Difficulté,Adapte,Law
4554,2019,Droit,5,Constitution de la Cinquieme Republique,2,Le Pouvoir Gouvernant,13,111,4,QROC,0.26,0.39,60.67,32,20,52,45,32,13,1.16,71.11,Moyen,Moyen,0,Meme Difficulté,Adapte,Law
5665,2020,Droit,5,Constitution de la Cinquieme Republique,2,Le Pouvoir Gouvernant,13,111,4,QROC,0.56,0.35,60.67,32,21,53,39,32,7,1.36,82.05,Moyen,Moyen,0,Meme Difficulté,Adapte,Law
111,2015,Droit,5,Constitution de la Cinquieme Republique,2,Le Pouvoir Gouvernant,13,112,5,QCM,0.42,0.59,63.25,4,3,7,5,4,1,1.4,80.0,Facile,Moyen,-1,Plus Difficile,Adapte,Law
1222,2016,Droit,5,Constitution de la Cinquieme Republique,2,Le Pouvoir Gouvernant,13,112,5,QCU,0.35,0.71,63.25,4,3,7,6,4,2,1.17,66.67,Moyen,Moyen,0,Meme Difficulté,Adapte,Law
2333,2017,Droit,5,Constitution de la Cinquieme Republique,2,Le Pouvoir Gouvernant,13,112,5,QCM,0.24,0.31,63.25,5,3,8,7,5,2,1.14,71.43,Moyen,Moyen,0,Meme Difficulté,Adapte,Law
3444,2018,Droit,5,Constitution de la Cinquieme Republique,2,Le Pouvoir Gouvernant,13,112,5,QCM,0.31,0.52,63.25,5,3,8,5,5,0,1.6,100.0,Moyen,Moyen,0,Meme Difficulté,Adapte,Law
4555,2019,Droit,5,Constitution de la Cinquieme Republique,2,Le Pouvoir Gouvernant,13,112,5,QCM,0.43,0.37,63.25,4,3,7,5,4,1,1.4,80.0,Moyen,Moyen,0,Meme Difficulté,Adapte,Law
5666,2020,Droit,5,Constitution de la Cinquieme Republique,2,Le Pouvoir Gouvernant,13,112,5,QCM,0.29,0.64,63.25,4,2,6,5,4,1,1.2,80.0,Moyen,Moyen,0,Meme Difficulté,Adapte,Law
112,2015,Droit,5,Constitution de la Cinquieme Republique,2,Le Pouvoir Gouvernant,13,113,6,QROC,0.55,0.25,38.31,17,28,45,34,17,17,1.32,50.0,Moyen,Moyen,0,Meme Difficulté,Pas Adapte,Law
1223,2016,Droit,5,Constitution de la Cinquieme Republique,2,Le Pouvoir Gouvernant,13,113,6,QROC,0.7,0.09,8.66,3,35,38,37,3,34,1.03,8.11,Difficile,Difficile,0,Meme Difficulté,Pas Adapte,Law
2334,2017,Droit,5,Constitution de la Cinquieme Republique,2,Le Pouvoir Gouvernant,13,113,6,QROC,0.41,0.33,50.38,18,17,35,31,18,13,1.13,58.06,Facile,Moyen,-1,Plus Difficile,Pas Adapte,Law
3445,2018,Droit,5,Constitution de la Cinquieme Republique,2,Le Pouvoir Gouvernant,13,113,6,QROC,0.49,0.31,46.27,14,16,30,24,14,10,1.25,58.33,Difficile,Moyen,1,Plus Facile,Pas Adapte,Law
4556,2019,Droit,5,Constitution de la Cinquieme Republique,2,Le Pouvoir Gouvernant,13,113,6,QROC,0.34,0.26,62.82,18,11,29,29,18,11,1.0,62.07,Facile,Moyen,-1,Plus Difficile,Adapte,Law
5667,2020,Droit,5,Constitution de la Cinquieme Republique,2,Le Pouvoir Gouvernant,13,113,6,QROC,0.41,0.32,62.82,19,11,30,22,19,3,1.36,86.36,Moyen,Moyen,0,Meme Difficulté,Adapte,Law
113,2015,Droit,5,Constitution de la Cinquieme Republique,2,Le Pouvoir Gouvernant,13,114,7,QCU,0.72,0.38,23.08,20,67,87,83,20,63,1.05,24.1,Moyen,Difficile,-1,Plus Difficile,Pas Adapte,Law
1224,2016,Droit,5,Constitution de la Cinquieme Republique,2,Le Pouvoir Gouvernant,13,114,7,QCU,0.62,0.25,15.96,15,80,95,72,15,57,1.32,20.83,Facile,Difficile,-2,Beaucoup plus Difficile,Pas Adapte,Law
2335,2017,Droit,5,Constitution de la Cinquieme Republique,2,Le Pouvoir Gouvernant,13,114,7,QCU,0.22,0.41,35.57,35,63,98,69,35,34,1.42,50.72,Facile,Moyen,-1,Plus Difficile,Pas Adapte,Law
3446,2018,Droit,5,Constitution de la Cinquieme Republique,2,Le Pouvoir Gouvernant,13,114,7,QCU,0.67,0.3,27.78,31,79,110,52,31,21,2.12,59.62,Facile,Difficile,-2,Beaucoup plus Difficile,Pas Adapte,Law
4557,2019,Droit,5,Constitution de la Cinquieme Republique,2,Le Pouvoir Gouvernant,13,114,7,QCU,0.53,0.36,11.33,13,100,113,113,13,100,1.0,11.5,Facile,Difficile,-2,Beaucoup plus Difficile,Pas Adapte,Law
5668,2020,Droit,5,Constitution de la Cinquieme Republique,2,Le Pouvoir Gouvernant,13,114,7,QCU,0.6,0.39,22.12,23,80,103,43,23,20,2.4,53.49,Moyen,Difficile,-1,Plus Difficile,Pas Adapte,Law
114,2015,Droit,5,Constitution de la Cinquieme Republique,2,Le Pouvoir Gouvernant,13,115,8,QCU,0.55,0.33,12.46,6,40,46,27,6,21,1.7,22.22,Facile,Difficile,-2,Beaucoup plus Difficile,Pas Adapte,Law
1225,2016,Droit,5,Constitution de la Cinquieme Republique,2,Le Pouvoir Gouvernant,13,115,8,QCU,0.38,0.65,39.94,19,28,47,30,19,11,1.57,63.33,Moyen,Moyen,0,Meme Difficulté,Pas Adapte,Law
2336,2017,Droit,5,Constitution de la Cinquieme Republique,2,Le Pouvoir Gouvernant,13,115,8,QCU,0.22,0.43,39.99,21,32,53,48,21,27,1.1,43.75,Facile,Moyen,-1,Plus Difficile,Pas Adapte,Law
3447,2018,Droit,5,Constitution de la Cinquieme Republique,2,Le Pouvoir Gouvernant,13,115,8,QCU,0.65,0.31,33.08,20,40,60,54,20,34,1.11,37.04,Facile,Difficile,-2,Beaucoup plus Difficile,Pas Adapte,Law
4558,2019,Droit,5,Constitution de la Cinquieme Republique,2,Le Pouvoir Gouvernant,13,115,8,QCU,0.08,0.77,74.26,48,17,65,52,48,4,1.25,92.31,Difficile,Facile,2,Beaucoup plus Facile,Adapte,Law
5669,2020,Droit,5,Constitution de la Cinquieme Republique,2,Le Pouvoir Gouvernant,13,115,8,QCU,0.17,0.89,74.26,54,19,73,72,54,18,1.01,75.0,Facile,Facile,0,Meme Difficulté,Adapte,Law
115,2015,Droit,5,Constitution de la Cinquieme Republique,2,Le Pouvoir Gouvernant,13,116,9,QCU,0.7,0.31,23.51,8,28,36,22,8,14,1.64,36.36,Moyen,Difficile,-1,Plus Difficile,Pas Adapte,Law
1226,2016,Droit,5,Constitution de la Cinquieme Republique,2,Le Pouvoir Gouvernant,13,116,9,QCU,0.16,0.93,65.89,22,12,34,31,22,9,1.1,70.97,Difficile,Facile,2,Beaucoup plus Facile,Adapte,Law
2337,2017,Droit,5,Constitution de la Cinquieme Republique,2,Le Pouvoir Gouvernant,13,116,9,QCU,0.19,0.75,65.89,19,10,29,21,19,2,1.38,90.48,Facile,Facile,0,Meme Difficulté,Adapte,Law
3448,2018,Droit,5,Constitution de la Cinquieme Republique,2,Le Pouvoir Gouvernant,13,116,9,QCU,0.14,0.96,65.89,20,10,30,24,20,4,1.25,83.33,Facile,Facile,0,Meme Difficulté,Adapte,Law
4559,2019,Droit,5,Constitution de la Cinquieme Republique,2,Le Pouvoir Gouvernant,13,116,9,QCU,0.05,0.91,65.89,19,10,29,29,19,10,1.0,65.52,Facile,Facile,0,Meme Difficulté,Adapte,Law
5670,2020,Droit,5,Constitution de la Cinquieme Republique,2,Le Pouvoir Gouvernant,13,116,9,QCU,0.12,0.92,65.89,19,10,29,23,19,4,1.26,82.61,Facile,Facile,0,Meme Difficulté,Adapte,Law
116,2015,Droit,5,Constitution de la Cinquieme Republique,2,Le Pouvoir Gouvernant,13,117,10,QCU,0.19,1.0,99.15,10,0,10,10,10,0,1.0,100.0,Moyen,Facile,1,Plus Facile,Pas Adapte,Law
1227,2016,Droit,5,Constitution de la Cinquieme Republique,2,Le Pouvoir Gouvernant,13,117,10,QCU,0.09,0.92,96.79,9,0,9,9,9,0,1.0,100.0,Moyen,Facile,1,Plus Facile,Pas Adapte,Law
2338,2017,Droit,5,Constitution de la Cinquieme Republique,2,Le Pouvoir Gouvernant,13,117,10,QCU,0.47,0.24,20.49,2,8,10,4,2,2,2.5,50.0,Facile,Difficile,-2,Beaucoup plus Difficile,Pas Adapte,Law
3449,2018,Droit,5,Constitution de la Cinquieme Republique,2,Le Pouvoir Gouvernant,13,117,10,QROC,0.06,0.64,85.7,9,2,11,10,9,1,1.1,90.0,Difficile,Facile,2,Beaucoup plus Facile,Pas Adapte,Law
4560,2019,Droit,5,Constitution de la Cinquieme Republique,2,Le Pouvoir Gouvernant,13,117,10,QROC,0.52,0.28,44.69,6,7,13,11,6,5,1.18,54.55,Moyen,Moyen,0,Meme Difficulté,Pas Adapte,Law
5671,2020,Droit,5,Constitution de la Cinquieme Republique,2,Le Pouvoir Gouvernant,13,117,10,QROC,0.24,0.4,56.76,6,5,11,6,6,0,1.83,100.0,Facile,Moyen,-1,Plus Difficile,Pas Adapte,Law
117,2015,Droit,5,Constitution de la Cinquieme Republique,2,Le Pouvoir Gouvernant,13,118,11,QROC,0.42,0.31,59.75,27,19,46,32,27,5,1.44,84.38,Moyen,Moyen,0,Meme Difficulté,Pas Adapte,Law
1228,2016,Droit,5,Constitution de la Cinquieme Republique,2,Le Pouvoir Gouvernant,13,118,11,QROC,0.31,0.33,54.5,24,20,44,32,24,8,1.38,75.0,Difficile,Moyen,1,Plus Facile,Pas Adapte,Law
2339,2017,Droit,5,Constitution de la Cinquieme Republique,2,Le Pouvoir Gouvernant,13,118,11,QO,0.78,0.0,28.58,14,36,50,42,14,28,1.19,33.33,Difficile,Difficile,0,Meme Difficulté,Pas Adapte,Law
3450,2018,Droit,5,Constitution de la Cinquieme Republique,2,Le Pouvoir Gouvernant,13,118,11,QO,0.16,0.73,73.36,38,14,52,39,38,1,1.33,97.44,Difficile,Facile,2,Beaucoup plus Facile,Adapte,Law
4561,2019,Droit,5,Constitution de la Cinquieme Republique,2,Le Pouvoir Gouvernant,13,118,11,QO,0.01,0.94,73.36,39,14,53,43,39,4,1.23,90.7,Facile,Facile,0,Meme Difficulté,Adapte,Law
5672,2020,Droit,5,Constitution de la Cinquieme Republique,2,Le Pouvoir Gouvernant,13,118,11,QO,0.08,0.54,73.36,43,15,58,52,43,9,1.12,82.69,Facile,Facile,0,Meme Difficulté,Adapte,Law
118,2015,Droit,5,Constitution de la Cinquieme Republique,2,Le Pouvoir Gouvernant,13,119,12,QO,0.08,0.5,80.33,62,15,77,65,62,3,1.18,95.38,Difficile,Facile,2,Beaucoup plus Facile,Pas Adapte,Law
1229,2016,Droit,5,Constitution de la Cinquieme Republique,2,Le Pouvoir Gouvernant,13,119,12,QO,0.09,0.45,81.82,56,13,69,57,56,1,1.21,98.25,Facile,Facile,0,Meme Difficulté,Pas Adapte,Law
2340,2017,Droit,5,Constitution de la Cinquieme Republique,2,Le Pouvoir Gouvernant,13,119,12,QCU,0.32,0.51,44.34,30,37,67,35,30,5,1.91,85.71,Moyen,Moyen,0,Meme Difficulté,Pas Adapte,Law
3451,2018,Droit,5,Constitution de la Cinquieme Republique,2,Le Pouvoir Gouvernant,13,119,12,QCU,0.35,0.74,53.12,36,31,67,67,36,31,1.0,53.73,Facile,Moyen,-1,Plus Difficile,Pas Adapte,Law
4562,2019,Droit,5,Constitution de la Cinquieme Republique,2,Le Pouvoir Gouvernant,13,119,12,QCU,0.6,0.26,4.93,4,68,72,63,4,59,1.14,6.35,Moyen,Difficile,-1,Plus Difficile,Pas Adapte,Law
5673,2020,Droit,5,Constitution de la Cinquieme Republique,2,Le Pouvoir Gouvernant,13,119,12,QCU,0.48,0.33,3.51,3,79,82,62,3,59,1.32,4.84,Difficile,Difficile,0,Meme Difficulté,Pas Adapte,Law
119,2015,Droit,5,Constitution de la Cinquieme Republique,2,Le Pouvoir Gouvernant,13,120,13,QCU,0.37,0.7,52.93,37,32,69,63,37,26,1.1,58.73,Moyen,Moyen,0,Meme Difficulté,Pas Adapte,Law
1230,2016,Droit,5,Constitution de la Cinquieme Republique,2,Le Pouvoir Gouvernant,13,120,13,QCU,0.71,0.2,33.1,22,43,65,31,22,9,2.1,70.97,Facile,Difficile,-2,Beaucoup plus Difficile,Pas Adapte,Law
2341,2017,Droit,5,Constitution de la Cinquieme Republique,2,Le Pouvoir Gouvernant,13,120,13,QCM,0.01,0.81,71.3,42,17,59,44,42,2,1.34,95.45,Difficile,Facile,2,Beaucoup plus Facile,Adapte,Law
3452,2018,Droit,5,Constitution de la Cinquieme Republique,2,Le Pouvoir Gouvernant,13,120,13,QCM,0.16,0.77,71.3,41,17,58,47,41,6,1.23,87.23,Facile,Facile,0,Meme Difficulté,Adapte,Law
4563,2019,Droit,5,Constitution de la Cinquieme Republique,2,Le Pouvoir Gouvernant,13,120,13,QCM,0.19,0.77,71.3,36,14,50,45,36,9,1.11,80.0,Facile,Facile,0,Meme Difficulté,Adapte,Law
5674,2020,Droit,5,Constitution de la Cinquieme Republique,2,Le Pouvoir Gouvernant,13,120,13,QCM,0.01,0.97,71.3,36,14,50,43,36,7,1.16,83.72,Facile,Facile,0,Meme Difficulté,Adapte,Law
120,2015,Droit,5,Constitution de la Cinquieme Republique,3,Le Pouvoir Legislatif,7,121,1,QCM,0.68,0.23,17.92,2,11,13,11,2,9,1.18,18.18,Facile,Difficile,-2,Beaucoup plus Difficile,Pas Adapte,Law
1231,2016,Droit,5,Constitution de la Cinquieme Republique,3,Le Pouvoir Legislatif,7,121,1,QCM,0.79,0.21,28.63,3,8,11,6,3,3,1.83,50.0,Difficile,Difficile,0,Meme Difficulté,Pas Adapte,Law
2342,2017,Droit,5,Constitution de la Cinquieme Republique,3,Le Pouvoir Legislatif,7,121,1,QCM,0.73,0.23,16.7,2,10,12,4,2,2,3.0,50.0,Difficile,Difficile,0,Meme Difficulté,Pas Adapte,Law
3453,2018,Droit,5,Constitution de la Cinquieme Republique,3,Le Pouvoir Legislatif,7,121,1,QCM,0.67,0.18,32.65,3,7,10,7,3,4,1.43,42.86,Moyen,Difficile,-1,Plus Difficile,Pas Adapte,Law
4564,2019,Droit,5,Constitution de la Cinquieme Republique,3,Le Pouvoir Legislatif,7,121,1,QCU,0.31,0.5,41.11,3,5,8,7,3,4,1.14,42.86,Moyen,Moyen,0,Meme Difficulté,Pas Adapte,Law
5675,2020,Droit,5,Constitution de la Cinquieme Republique,3,Le Pouvoir Legislatif,7,121,1,QROC,0.22,0.29,45.47,4,4,8,5,4,1,1.6,80.0,Difficile,Moyen,1,Plus Facile,Pas Adapte,Law
121,2015,Droit,5,Constitution de la Cinquieme Republique,3,Le Pouvoir Legislatif,7,122,2,QCM,0.38,0.38,53.73,52,44,96,81,52,29,1.19,64.2,Difficile,Moyen,1,Plus Facile,Pas Adapte,Law
1232,2016,Droit,5,Constitution de la Cinquieme Republique,3,Le Pouvoir Legislatif,7,122,2,QROC,0.73,0.06,25.3,24,72,96,91,24,67,1.05,26.37,Difficile,Difficile,0,Meme Difficulté,Pas Adapte,Law
2343,2017,Droit,5,Constitution de la Cinquieme Republique,3,Le Pouvoir Legislatif,7,122,2,QROC,0.2,0.66,77.02,78,23,101,99,78,21,1.02,78.79,Difficile,Facile,2,Beaucoup plus Facile,Pas Adapte,Law
3454,2018,Droit,5,Constitution de la Cinquieme Republique,3,Le Pouvoir Legislatif,7,122,2,QO,0.67,0.22,40.42,35,51,86,79,35,44,1.09,44.3,Difficile,Moyen,1,Plus Facile,Pas Adapte,Law
4565,2019,Droit,5,Constitution de la Cinquieme Republique,3,Le Pouvoir Legislatif,7,122,2,QO,0.52,0.26,58.07,52,37,89,63,52,11,1.41,82.54,Facile,Moyen,-1,Plus Difficile,Pas Adapte,Law
5676,2020,Droit,5,Constitution de la Cinquieme Republique,3,Le Pouvoir Legislatif,7,122,2,QO,0.97,0.05,26.6,25,69,94,73,25,48,1.29,34.25,Difficile,Difficile,0,Meme Difficulté,Pas Adapte,Law
122,2015,Droit,5,Constitution de la Cinquieme Republique,3,Le Pouvoir Legislatif,7,123,3,QCU,0.33,0.52,43.06,4,6,10,8,4,4,1.25,50.0,Difficile,Moyen,1,Plus Facile,Pas Adapte,Law
1233,2016,Droit,5,Constitution de la Cinquieme Republique,3,Le Pouvoir Legislatif,7,123,3,QCU,0.2,0.85,84.33,9,2,11,10,9,1,1.1,90.0,Difficile,Facile,2,Beaucoup plus Facile,Pas Adapte,Law
2344,2017,Droit,5,Constitution de la Cinquieme Republique,3,Le Pouvoir Legislatif,7,123,3,QCU,0.3,0.44,55.22,6,4,10,7,6,1,1.43,85.71,Facile,Moyen,-1,Plus Difficile,Pas Adapte,Law
3455,2018,Droit,5,Constitution de la Cinquieme Republique,3,Le Pouvoir Legislatif,7,123,3,QCU,0.27,0.55,57.78,6,5,11,9,6,3,1.22,66.67,Moyen,Moyen,0,Meme Difficulté,Pas Adapte,Law
4566,2019,Droit,5,Constitution de la Cinquieme Republique,3,Le Pouvoir Legislatif,7,123,3,QCU,0.48,0.35,29.08,3,6,9,7,3,4,1.29,42.86,Difficile,Difficile,0,Meme Difficulté,Pas Adapte,Law
5677,2020,Droit,5,Constitution de la Cinquieme Republique,3,Le Pouvoir Legislatif,7,123,3,QCU,0.19,0.82,77.45,8,2,10,8,8,0,1.25,100.0,Facile,Facile,0,Meme Difficulté,Pas Adapte,Law
123,2015,Droit,5,Constitution de la Cinquieme Republique,3,Le Pouvoir Legislatif,7,124,4,QCM,0.16,0.76,86.84,59,9,68,60,59,1,1.13,98.33,Facile,Facile,0,Meme Difficulté,Pas Adapte,Law
1234,2016,Droit,5,Constitution de la Cinquieme Republique,3,Le Pouvoir Legislatif,7,124,4,QCM,0.29,0.36,50.04,36,35,71,57,36,21,1.25,63.16,Difficile,Moyen,1,Plus Facile,Pas Adapte,Law
2345,2017,Droit,5,Constitution de la Cinquieme Republique,3,Le Pouvoir Legislatif,7,124,4,QCM,0.31,0.68,49.13,36,37,73,62,36,26,1.18,58.06,Moyen,Moyen,0,Meme Difficulté,Pas Adapte,Law
3456,2018,Droit,5,Constitution de la Cinquieme Republique,3,Le Pouvoir Legislatif,7,124,4,QCU,0.03,0.97,79.95,66,16,82,68,66,2,1.21,97.06,Facile,Facile,0,Meme Difficulté,Pas Adapte,Law
4567,2019,Droit,5,Constitution de la Cinquieme Republique,3,Le Pouvoir Legislatif,7,124,4,QCU,0.64,0.26,21.08,15,56,71,49,15,34,1.45,30.61,Difficile,Difficile,0,Meme Difficulté,Pas Adapte,Law
5678,2020,Droit,5,Constitution de la Cinquieme Republique,3,Le Pouvoir Legislatif,7,124,4,QCU,0.01,0.79,77.66,61,17,78,77,61,16,1.01,79.22,Facile,Facile,0,Meme Difficulté,Pas Adapte,Law
124,2015,Droit,5,Constitution de la Cinquieme Republique,3,Le Pouvoir Legislatif,7,125,5,QCM,0.55,0.26,28.39,7,17,24,19,7,12,1.26,36.84,Facile,Difficile,-2,Beaucoup plus Difficile,Pas Adapte,Law
1235,2016,Droit,5,Constitution de la Cinquieme Republique,3,Le Pouvoir Legislatif,7,125,5,QCM,0.39,0.4,62.67,14,8,22,17,14,3,1.29,82.35,Difficile,Moyen,1,Plus Facile,Adapte,Law
2346,2017,Droit,5,Constitution de la Cinquieme Republique,3,Le Pouvoir Legislatif,7,125,5,QCM,0.26,0.56,62.67,14,9,23,17,14,3,1.35,82.35,Moyen,Moyen,0,Meme Difficulté,Adapte,Law
3457,2018,Droit,5,Constitution de la Cinquieme Republique,3,Le Pouvoir Legislatif,7,125,5,QCM,0.41,0.32,62.67,14,8,22,21,14,7,1.05,66.67,Moyen,Moyen,0,Meme Difficulté,Adapte,Law
4568,2019,Droit,5,Constitution de la Cinquieme Republique,3,Le Pouvoir Legislatif,7,125,5,QCM,0.49,0.44,62.67,15,9,24,20,15,5,1.2,75.0,Moyen,Moyen,0,Meme Difficulté,Adapte,Law
5679,2020,Droit,5,Constitution de la Cinquieme Republique,3,Le Pouvoir Legislatif,7,125,5,QCM,0.33,0.36,62.67,18,10,28,22,18,4,1.27,81.82,Moyen,Moyen,0,Meme Difficulté,Adapte,Law
125,2015,Droit,5,Constitution de la Cinquieme Republique,3,Le Pouvoir Legislatif,7,126,6,QO,0.39,0.17,40.39,15,22,37,31,15,16,1.19,48.39,Difficile,Moyen,1,Plus Facile,Pas Adapte,Law
1236,2016,Droit,5,Constitution de la Cinquieme Republique,3,Le Pouvoir Legislatif,7,126,6,QO,0.4,0.3,63.52,23,13,36,31,23,8,1.16,74.19,Facile,Moyen,-1,Plus Difficile,Adapte,Law
2347,2017,Droit,5,Constitution de la Cinquieme Republique,3,Le Pouvoir Legislatif,7,126,6,QO,0.27,0.15,63.52,23,13,36,28,23,5,1.29,82.14,Moyen,Moyen,0,Meme Difficulté,Adapte,Law
3458,2018,Droit,5,Constitution de la Cinquieme Republique,3,Le Pouvoir Legislatif,7,126,6,QO,0.43,0.25,63.52,23,13,36,36,23,13,1.0,63.89,Moyen,Moyen,0,Meme Difficulté,Adapte,Law
4569,2019,Droit,5,Constitution de la Cinquieme Republique,3,Le Pouvoir Legislatif,7,126,6,QO,0.45,0.23,63.52,25,14,39,26,25,1,1.5,96.15,Moyen,Moyen,0,Meme Difficulté,Adapte,Law
5680,2020,Droit,5,Constitution de la Cinquieme Republique,3,Le Pouvoir Legislatif,7,126,6,QO,0.24,0.28,63.52,25,15,40,33,25,8,1.21,75.76,Moyen,Moyen,0,Meme Difficulté,Adapte,Law
126,2015,Droit,5,Constitution de la Cinquieme Republique,3,Le Pouvoir Legislatif,7,127,7,QCU,0.15,0.9,90.78,60,6,66,61,60,1,1.08,98.36,Facile,Facile,0,Meme Difficulté,Pas Adapte,Law
1237,2016,Droit,5,Constitution de la Cinquieme Republique,3,Le Pouvoir Legislatif,7,127,7,QCU,0.63,0.33,5.05,3,60,63,24,3,21,2.62,12.5,Facile,Difficile,-2,Beaucoup plus Difficile,Pas Adapte,Law
2348,2017,Droit,5,Constitution de la Cinquieme Republique,3,Le Pouvoir Legislatif,7,127,7,QCU,0.25,0.54,40.04,26,38,64,35,26,9,1.83,74.29,Facile,Moyen,-1,Plus Difficile,Pas Adapte,Law
3459,2018,Droit,5,Constitution de la Cinquieme Republique,3,Le Pouvoir Legislatif,7,127,7,QCU,0.17,0.84,94.95,66,4,70,69,66,3,1.01,95.65,Moyen,Facile,1,Plus Facile,Pas Adapte,Law
4570,2019,Droit,5,Constitution de la Cinquieme Republique,3,Le Pouvoir Legislatif,7,127,7,QCU,0.73,0.35,20.44,14,55,69,55,14,41,1.25,25.45,Moyen,Difficile,-1,Plus Difficile,Pas Adapte,Law
5681,2020,Droit,5,Constitution de la Cinquieme Republique,3,Le Pouvoir Legislatif,7,127,7,QCU,0.0,0.84,85.19,56,10,66,65,56,9,1.02,86.15,Difficile,Facile,2,Beaucoup plus Facile,Pas Adapte,Law
127,2015,Droit,5,Constitution de la Cinquieme Republique,4,Le Controle de Constitutionnalite,14,128,1,QCU,0.53,0.37,7.81,0,5,5,4,0,4,1.25,0.0,Moyen,Difficile,-1,Plus Difficile,Pas Adapte,Law
1238,2016,Droit,5,Constitution de la Cinquieme Republique,4,Le Controle de Constitutionnalite,14,128,1,QCU,0.31,0.62,55.19,3,3,6,4,3,1,1.5,75.0,Difficile,Moyen,1,Plus Facile,Pas Adapte,Law
2349,2017,Droit,5,Constitution de la Cinquieme Republique,4,Le Controle de Constitutionnalite,14,128,1,QCU,0.03,0.98,94.56,6,0,6,6,6,0,1.0,100.0,Moyen,Facile,1,Plus Facile,Pas Adapte,Law
3460,2018,Droit,5,Constitution de la Cinquieme Republique,4,Le Controle de Constitutionnalite,14,128,1,QCU,0.4,0.58,61.3,4,3,7,7,4,3,1.0,57.14,Difficile,Moyen,1,Plus Facile,Adapte,Law
4571,2019,Droit,5,Constitution de la Cinquieme Republique,4,Le Controle de Constitutionnalite,14,128,1,QCU,0.38,0.61,61.3,4,3,7,6,4,2,1.17,66.67,Moyen,Moyen,0,Meme Difficulté,Adapte,Law
5682,2020,Droit,5,Constitution de la Cinquieme Republique,4,Le Controle de Constitutionnalite,14,128,1,QCU,0.4,0.58,61.3,5,3,8,6,5,1,1.33,83.33,Moyen,Moyen,0,Meme Difficulté,Adapte,Law
128,2015,Droit,5,Constitution de la Cinquieme Republique,4,Le Controle de Constitutionnalite,14,129,2,QCU,0.7,0.38,13.5,3,16,19,15,3,12,1.27,20.0,Moyen,Difficile,-1,Plus Difficile,Pas Adapte,Law
1239,2016,Droit,5,Constitution de la Cinquieme Republique,4,Le Controle de Constitutionnalite,14,129,2,QCU,0.53,0.34,27.38,6,16,22,9,6,3,2.44,66.67,Difficile,Difficile,0,Meme Difficulté,Pas Adapte,Law
2350,2017,Droit,5,Constitution de la Cinquieme Republique,4,Le Controle de Constitutionnalite,14,129,2,QCU,0.31,0.67,64.15,14,8,22,19,14,5,1.16,73.68,Moyen,Moyen,0,Meme Difficulté,Adapte,Law
3461,2018,Droit,5,Constitution de la Cinquieme Republique,4,Le Controle de Constitutionnalite,14,129,2,QCU,0.39,0.46,64.15,14,8,22,22,14,8,1.0,63.64,Moyen,Moyen,0,Meme Difficulté,Adapte,Law
4572,2019,Droit,5,Constitution de la Cinquieme Republique,4,Le Controle de Constitutionnalite,14,129,2,QCU,0.23,0.47,64.15,13,8,21,20,13,7,1.05,65.0,Moyen,Moyen,0,Meme Difficulté,Adapte,Law
5683,2020,Droit,5,Constitution de la Cinquieme Republique,4,Le Controle de Constitutionnalite,14,129,2,QCU,0.23,0.55,64.15,15,8,23,22,15,7,1.05,68.18,Moyen,Moyen,0,Meme Difficulté,Adapte,Law
129,2015,Droit,5,Constitution de la Cinquieme Republique,4,Le Controle de Constitutionnalite,14,130,3,QCU,0.31,0.43,53.29,50,43,93,53,50,3,1.75,94.34,Facile,Moyen,-1,Plus Difficile,Pas Adapte,Law
1240,2016,Droit,5,Constitution de la Cinquieme Republique,4,Le Controle de Constitutionnalite,14,130,3,QCU,0.75,0.37,33.43,32,64,96,41,32,9,2.34,78.05,Facile,Difficile,-2,Beaucoup plus Difficile,Pas Adapte,Law
2351,2017,Droit,5,Constitution de la Cinquieme Republique,4,Le Controle de Constitutionnalite,14,130,3,QCU,0.71,0.29,15.26,16,87,103,77,16,61,1.34,20.78,Facile,Difficile,-2,Beaucoup plus Difficile,Pas Adapte,Law
3462,2018,Droit,5,Constitution de la Cinquieme Republique,4,Le Controle de Constitutionnalite,14,130,3,QCM,0.22,0.31,58.44,67,48,115,79,67,12,1.46,84.81,Moyen,Moyen,0,Meme Difficulté,Pas Adapte,Law
4573,2019,Droit,5,Constitution de la Cinquieme Republique,4,Le Controle de Constitutionnalite,14,130,3,QCM,0.48,0.62,37.27,37,62,99,74,37,37,1.34,50.0,Difficile,Moyen,1,Plus Facile,Pas Adapte,Law
5684,2020,Droit,5,Constitution de la Cinquieme Republique,4,Le Controle de Constitutionnalite,14,130,3,QCM,0.19,0.77,78.63,88,24,112,93,88,5,1.2,94.62,Difficile,Facile,2,Beaucoup plus Facile,Pas Adapte,Law
130,2015,Droit,5,Constitution de la Cinquieme Republique,4,Le Controle de Constitutionnalite,14,131,4,QCU,0.49,0.23,9.43,6,58,64,47,6,41,1.36,12.77,Facile,Difficile,-2,Beaucoup plus Difficile,Pas Adapte,Law
1241,2016,Droit,5,Constitution de la Cinquieme Republique,4,Le Controle de Constitutionnalite,14,131,4,QCU,0.43,0.35,16.1,12,61,73,72,12,60,1.01,16.67,Facile,Difficile,-2,Beaucoup plus Difficile,Pas Adapte,Law
2352,2017,Droit,5,Constitution de la Cinquieme Republique,4,Le Controle de Constitutionnalite,14,131,4,QCU,0.23,0.64,49.42,39,40,79,50,39,11,1.58,78.0,Moyen,Moyen,0,Meme Difficulté,Pas Adapte,Law
3463,2018,Droit,5,Constitution de la Cinquieme Republique,4,Le Controle de Constitutionnalite,14,131,4,QCU,0.1,0.91,72.02,53,20,73,59,53,6,1.24,89.83,Moyen,Facile,1,Plus Facile,Adapte,Law
4574,2019,Droit,5,Constitution de la Cinquieme Republique,4,Le Controle de Constitutionnalite,14,131,4,QCU,0.19,0.94,72.02,55,22,77,68,55,13,1.13,80.88,Facile,Facile,0,Meme Difficulté,Adapte,Law
5685,2020,Droit,5,Constitution de la Cinquieme Republique,4,Le Controle de Constitutionnalite,14,131,4,QCU,0.17,0.86,72.02,48,18,66,64,48,16,1.03,75.0,Facile,Facile,0,Meme Difficulté,Adapte,Law
131,2015,Droit,5,Constitution de la Cinquieme Republique,4,Le Controle de Constitutionnalite,14,132,5,QCM,0.0,0.99,81.86,8,2,10,8,8,0,1.25,100.0,Moyen,Facile,1,Plus Facile,Pas Adapte,Law
1242,2016,Droit,5,Constitution de la Cinquieme Republique,4,Le Controle de Constitutionnalite,14,132,5,QCM,0.75,0.19,22.67,2,8,10,5,2,3,2.0,40.0,Difficile,Difficile,0,Meme Difficulté,Pas Adapte,Law
2353,2017,Droit,5,Constitution de la Cinquieme Republique,4,Le Controle de Constitutionnalite,14,132,5,QCM,0.65,0.19,32.2,3,6,9,4,3,1,2.25,75.0,Difficile,Difficile,0,Meme Difficulté,Pas Adapte,Law
3464,2018,Droit,5,Constitution de la Cinquieme Republique,4,Le Controle de Constitutionnalite,14,132,5,QCM,0.57,0.22,31.47,3,5,8,5,3,2,1.6,60.0,Moyen,Difficile,-1,Plus Difficile,Pas Adapte,Law
4575,2019,Droit,5,Constitution de la Cinquieme Republique,4,Le Controle de Constitutionnalite,14,132,5,QCM,0.73,0.2,9.89,1,6,7,3,1,2,2.33,33.33,Facile,Difficile,-2,Beaucoup plus Difficile,Pas Adapte,Law
5686,2020,Droit,5,Constitution de la Cinquieme Republique,4,Le Controle de Constitutionnalite,14,132,5,QO,0.17,0.31,81.21,6,1,7,6,6,0,1.17,100.0,Difficile,Facile,2,Beaucoup plus Facile,Pas Adapte,Law
132,2015,Droit,5,Constitution de la Cinquieme Republique,4,Le Controle de Constitutionnalite,14,133,6,QCM,0.11,0.75,89.13,22,3,25,24,22,2,1.04,91.67,Facile,Facile,0,Meme Difficulté,Pas Adapte,Law
1243,2016,Droit,5,Constitution de la Cinquieme Republique,4,Le Controle de Constitutionnalite,14,133,6,QCM,0.01,0.86,79.32,19,5,24,20,19,1,1.2,95.0,Facile,Facile,0,Meme Difficulté,Pas Adapte,Law
2354,2017,Droit,5,Constitution de la Cinquieme Republique,4,Le Controle de Constitutionnalite,14,133,6,QROC,0.84,0.23,9.1,2,18,20,14,2,12,1.43,14.29,Moyen,Difficile,-1,Plus Difficile,Pas Adapte,Law
3465,2018,Droit,5,Constitution de la Cinquieme Republique,4,Le Controle de Constitutionnalite,14,133,6,QROC,0.06,0.63,96.71,19,1,20,19,19,0,1.05,100.0,Difficile,Facile,2,Beaucoup plus Facile,Pas Adapte,Law
4576,2019,Droit,5,Constitution de la Cinquieme Republique,4,Le Controle de Constitutionnalite,14,133,6,QROC,0.37,0.27,49.13,9,10,19,15,9,6,1.27,60.0,Difficile,Moyen,1,Plus Facile,Pas Adapte,Law
5687,2020,Droit,5,Constitution de la Cinquieme Republique,4,Le Controle de Constitutionnalite,14,133,6,QROC,0.16,0.78,72.8,12,5,17,13,12,1,1.31,92.31,Difficile,Facile,2,Beaucoup plus Facile,Adapte,Law
133,2015,Droit,5,Constitution de la Cinquieme Republique,4,Le Controle de Constitutionnalite,14,134,7,QROC,0.27,0.26,39.2,22,34,56,41,22,19,1.37,53.66,Difficile,Moyen,1,Plus Facile,Pas Adapte,Law
1244,2016,Droit,5,Constitution de la Cinquieme Republique,4,Le Controle de Constitutionnalite,14,134,7,QROC,0.1,0.82,93.83,48,3,51,50,48,2,1.02,96.0,Difficile,Facile,2,Beaucoup plus Facile,Pas Adapte,Law
2355,2017,Droit,5,Constitution de la Cinquieme Republique,4,Le Controle de Constitutionnalite,14,134,7,QROC,0.06,0.85,84.32,50,9,59,53,50,3,1.11,94.34,Facile,Facile,0,Meme Difficulté,Pas Adapte,Law
3466,2018,Droit,5,Constitution de la Cinquieme Republique,4,Le Controle de Constitutionnalite,14,134,7,QROC,0.34,0.34,36.78,22,37,59,57,22,35,1.04,38.6,Difficile,Moyen,1,Plus Facile,Pas Adapte,Law
4577,2019,Droit,5,Constitution de la Cinquieme Republique,4,Le Controle de Constitutionnalite,14,134,7,QO,0.05,1.0,77.55,42,12,54,47,42,5,1.15,89.36,Moyen,Facile,1,Plus Facile,Pas Adapte,Law
5688,2020,Droit,5,Constitution de la Cinquieme Republique,4,Le Controle de Constitutionnalite,14,134,7,QO,0.12,0.65,72.06,43,16,59,51,43,8,1.16,84.31,Moyen,Facile,1,Plus Facile,Adapte,Law
134,2015,Droit,5,Constitution de la Cinquieme Republique,4,Le Controle de Constitutionnalite,14,135,8,QCM,0.6,0.27,4.78,3,53,56,27,3,24,2.07,11.11,Difficile,Difficile,0,Meme Difficulté,Pas Adapte,Law
1245,2016,Droit,5,Constitution de la Cinquieme Republique,4,Le Controle de Constitutionnalite,14,135,8,QCM,0.37,0.46,54.34,33,27,60,40,33,7,1.5,82.5,Difficile,Moyen,1,Plus Facile,Pas Adapte,Law
2356,2017,Droit,5,Constitution de la Cinquieme Republique,4,Le Controle de Constitutionnalite,14,135,8,QCM,0.19,0.96,66.44,34,17,51,36,34,2,1.42,94.44,Moyen,Facile,1,Plus Facile,Adapte,Law
3467,2018,Droit,5,Constitution de la Cinquieme Republique,4,Le Controle de Constitutionnalite,14,135,8,QCM,0.18,0.75,66.44,34,17,51,49,34,15,1.04,69.39,Facile,Facile,0,Meme Difficulté,Adapte,Law
4578,2019,Droit,5,Constitution de la Cinquieme Republique,4,Le Controle de Constitutionnalite,14,135,8,QCM,0.02,0.84,66.44,34,17,51,35,34,1,1.46,97.14,Facile,Facile,0,Meme Difficulté,Adapte,Law
5689,2020,Droit,5,Constitution de la Cinquieme Republique,4,Le Controle de Constitutionnalite,14,135,8,QCM,0.04,0.99,66.44,35,18,53,37,35,2,1.43,94.59,Facile,Facile,0,Meme Difficulté,Adapte,Law
135,2015,Droit,5,Constitution de la Cinquieme Republique,4,Le Controle de Constitutionnalite,14,136,9,QCU,0.13,0.86,67.93,58,28,86,85,58,27,1.01,68.24,Moyen,Facile,1,Plus Facile,Adapte,Law
1246,2016,Droit,5,Constitution de la Cinquieme Republique,4,Le Controle de Constitutionnalite,14,136,9,QCU,0.13,0.86,67.93,58,28,86,70,58,12,1.23,82.86,Facile,Facile,0,Meme Difficulté,Adapte,Law
2357,2017,Droit,5,Constitution de la Cinquieme Republique,4,Le Controle de Constitutionnalite,14,136,9,QCU,0.08,0.77,67.93,56,27,83,56,56,0,1.48,100.0,Facile,Facile,0,Meme Difficulté,Adapte,Law
3468,2018,Droit,5,Constitution de la Cinquieme Republique,4,Le Controle de Constitutionnalite,14,136,9,QCU,0.04,0.99,67.93,57,27,84,57,57,0,1.47,100.0,Facile,Facile,0,Meme Difficulté,Adapte,Law
4579,2019,Droit,5,Constitution de la Cinquieme Republique,4,Le Controle de Constitutionnalite,14,136,9,QCU,0.11,0.77,67.93,52,24,76,70,52,18,1.09,74.29,Facile,Facile,0,Meme Difficulté,Adapte,Law
5690,2020,Droit,5,Constitution de la Cinquieme Republique,4,Le Controle de Constitutionnalite,14,136,9,QCU,0.11,0.93,67.93,50,23,73,56,50,6,1.3,89.29,Facile,Facile,0,Meme Difficulté,Adapte,Law
136,2015,Droit,5,Constitution de la Cinquieme Republique,4,Le Controle de Constitutionnalite,14,137,10,QROC,0.02,0.97,87.11,18,3,21,20,18,2,1.05,90.0,Facile,Facile,0,Meme Difficulté,Pas Adapte,Law
1247,2016,Droit,5,Constitution de la Cinquieme Republique,4,Le Controle de Constitutionnalite,14,137,10,QO,0.05,0.4,80.53,19,5,24,23,19,4,1.04,82.61,Facile,Facile,0,Meme Difficulté,Pas Adapte,Law
2358,2017,Droit,5,Constitution de la Cinquieme Republique,4,Le Controle de Constitutionnalite,14,137,10,QO,0.16,0.85,77.29,19,5,24,22,19,3,1.09,86.36,Difficile,Facile,2,Beaucoup plus Facile,Pas Adapte,Law
3469,2018,Droit,5,Constitution de la Cinquieme Republique,4,Le Controle de Constitutionnalite,14,137,10,QO,0.78,0.14,25.81,5,16,21,17,5,12,1.24,29.41,Moyen,Difficile,-1,Plus Difficile,Pas Adapte,Law
4580,2019,Droit,5,Constitution de la Cinquieme Republique,4,Le Controle de Constitutionnalite,14,137,10,QO,0.26,0.17,47.33,9,9,18,9,9,0,2.0,100.0,Difficile,Moyen,1,Plus Facile,Pas Adapte,Law
5691,2020,Droit,5,Constitution de la Cinquieme Republique,4,Le Controle de Constitutionnalite,14,137,10,QO,0.81,0.13,7.6,1,14,15,12,1,11,1.25,8.33,Facile,Difficile,-2,Beaucoup plus Difficile,Pas Adapte,Law
137,2015,Droit,5,Constitution de la Cinquieme Republique,4,Le Controle de Constitutionnalite,14,138,11,QROC,0.6,0.12,17.95,17,80,97,86,17,69,1.13,19.77,Facile,Difficile,-2,Beaucoup plus Difficile,Pas Adapte,Law
1248,2016,Droit,5,Constitution de la Cinquieme Republique,4,Le Controle de Constitutionnalite,14,138,11,QROC,0.91,0.05,17.42,17,81,98,77,17,60,1.27,22.08,Moyen,Difficile,-1,Plus Difficile,Pas Adapte,Law
2359,2017,Droit,5,Constitution de la Cinquieme Republique,4,Le Controle de Constitutionnalite,14,138,11,QROC,0.38,0.27,35.09,35,65,100,41,35,6,2.44,85.37,Moyen,Moyen,0,Meme Difficulté,Pas Adapte,Law
3470,2018,Droit,5,Constitution de la Cinquieme Republique,4,Le Controle de Constitutionnalite,14,138,11,QROC,0.67,0.04,33.1,34,69,103,63,34,29,1.63,53.97,Moyen,Difficile,-1,Plus Difficile,Pas Adapte,Law
4581,2019,Droit,5,Constitution de la Cinquieme Republique,4,Le Controle de Constitutionnalite,14,138,11,QROC,0.82,0.06,28.81,28,70,98,61,28,33,1.61,45.9,Moyen,Difficile,-1,Plus Difficile,Pas Adapte,Law
5692,2020,Droit,5,Constitution de la Cinquieme Republique,4,Le Controle de Constitutionnalite,14,138,11,QROC,0.81,0.04,21.89,20,73,93,49,20,29,1.9,40.82,Difficile,Difficile,0,Meme Difficulté,Pas Adapte,Law
138,2015,Droit,5,Constitution de la Cinquieme Republique,4,Le Controle de Constitutionnalite,14,139,12,QCU,0.18,0.82,82.35,16,4,20,17,16,1,1.18,94.12,Moyen,Facile,1,Plus Facile,Pas Adapte,Law
1249,2016,Droit,5,Constitution de la Cinquieme Republique,4,Le Controle de Constitutionnalite,14,139,12,QCM,0.32,0.43,38.13,8,14,22,9,8,1,2.44,88.89,Facile,Moyen,-1,Plus Difficile,Pas Adapte,Law
2360,2017,Droit,5,Constitution de la Cinquieme Republique,4,Le Controle de Constitutionnalite,14,139,12,QCM,0.69,0.3,16.6,3,16,19,11,3,8,1.73,27.27,Difficile,Difficile,0,Meme Difficulté,Pas Adapte,Law
3471,2018,Droit,5,Constitution de la Cinquieme Republique,4,Le Controle de Constitutionnalite,14,139,12,QCM,0.53,0.25,21.95,4,13,17,14,4,10,1.21,28.57,Facile,Difficile,-2,Beaucoup plus Difficile,Pas Adapte,Law
4582,2019,Droit,5,Constitution de la Cinquieme Republique,4,Le Controle de Constitutionnalite,14,139,12,QCM,0.32,0.64,37.49,7,12,19,12,7,5,1.58,58.33,Moyen,Moyen,0,Meme Difficulté,Pas Adapte,Law
5693,2020,Droit,5,Constitution de la Cinquieme Republique,4,Le Controle de Constitutionnalite,14,139,12,QCM,0.69,0.27,20.39,3,13,16,11,3,8,1.45,27.27,Facile,Difficile,-2,Beaucoup plus Difficile,Pas Adapte,Law
139,2015,Droit,5,Constitution de la Cinquieme Republique,4,Le Controle de Constitutionnalite,14,140,13,QROC,0.42,0.38,57.0,28,21,49,36,28,8,1.36,77.78,Difficile,Moyen,1,Plus Facile,Pas Adapte,Law
1250,2016,Droit,5,Constitution de la Cinquieme Republique,4,Le Controle de Constitutionnalite,14,140,13,QROC,0.41,0.37,37.87,18,29,47,20,18,2,2.35,90.0,Moyen,Moyen,0,Meme Difficulté,Pas Adapte,Law
2361,2017,Droit,5,Constitution de la Cinquieme Republique,4,Le Controle de Constitutionnalite,14,140,13,QROC,0.05,0.56,86.9,40,6,46,40,40,0,1.15,100.0,Moyen,Facile,1,Plus Facile,Pas Adapte,Law
3472,2018,Droit,5,Constitution de la Cinquieme Republique,4,Le Controle de Constitutionnalite,14,140,13,QO,0.71,0.28,62.9,28,16,44,38,28,10,1.16,73.68,Difficile,Moyen,1,Plus Facile,Adapte,Law
4583,2019,Droit,5,Constitution de la Cinquieme Republique,4,Le Controle de Constitutionnalite,14,140,13,QO,0.55,0.24,62.9,28,17,45,29,28,1,1.55,96.55,Moyen,Moyen,0,Meme Difficulté,Adapte,Law
5694,2020,Droit,5,Constitution de la Cinquieme Republique,4,Le Controle de Constitutionnalite,14,140,13,QO,0.53,0.25,62.9,27,16,43,38,27,11,1.13,71.05,Moyen,Moyen,0,Meme Difficulté,Adapte,Law
140,2015,Droit,5,Constitution de la Cinquieme Republique,4,Le Controle de Constitutionnalite,14,141,14,QCM,0.11,0.88,94.32,40,2,42,42,40,2,1.0,95.24,Difficile,Facile,2,Beaucoup plus Facile,Pas Adapte,Law
1251,2016,Droit,5,Constitution de la Cinquieme Republique,4,Le Controle de Constitutionnalite,14,141,14,QCM,0.02,0.72,75.42,33,11,44,42,33,9,1.05,78.57,Facile,Facile,0,Meme Difficulté,Pas Adapte,Law
2362,2017,Droit,5,Constitution de la Cinquieme Republique,4,Le Controle de Constitutionnalite,14,141,14,QCM,0.78,0.23,10.29,5,46,51,15,5,10,3.4,33.33,Moyen,Difficile,-1,Plus Difficile,Pas Adapte,Law
3473,2018,Droit,5,Constitution de la Cinquieme Republique,4,Le Controle de Constitutionnalite,14,141,14,QCM,0.78,0.28,8.85,5,46,51,32,5,27,1.59,15.62,Facile,Difficile,-2,Beaucoup plus Difficile,Pas Adapte,Law
4584,2019,Droit,5,Constitution de la Cinquieme Republique,4,Le Controle de Constitutionnalite,14,141,14,QCM,0.07,0.82,99.32,58,0,58,58,58,0,1.0,100.0,Difficile,Facile,2,Beaucoup plus Facile,Pas Adapte,Law
5695,2020,Droit,5,Constitution de la Cinquieme Republique,4,Le Controle de Constitutionnalite,14,141,14,QCM,0.2,0.31,42.09,23,32,55,43,23,20,1.28,53.49,Moyen,Moyen,0,Meme Difficulté,Pas Adapte,Law
141,2015,Economie,1,L'Economie et son Domaine,1,L'Objet de la Science Economique,9,142,1,QROC,0.51,0.29,62.84,57,33,90,89,57,32,1.01,64.04,Facile,Moyen,-1,Plus Difficile,Adapte,Economy
1252,2016,Economie,1,L'Economie et son Domaine,1,L'Objet de la Science Economique,9,142,1,QROC,0.49,0.31,62.84,52,31,83,68,52,16,1.22,76.47,Moyen,Moyen,0,Meme Difficulté,Adapte,Economy
2363,2017,Economie,1,L'Economie et son Domaine,1,L'Objet de la Science Economique,9,142,1,QROC,0.26,0.29,62.84,47,27,74,53,47,6,1.4,88.68,Moyen,Moyen,0,Meme Difficulté,Adapte,Economy
3474,2018,Economie,1,L'Economie et son Domaine,1,L'Objet de la Science Economique,9,142,1,QO,0.52,0.17,62.84,43,26,69,55,43,12,1.25,78.18,Moyen,Moyen,0,Meme Difficulté,Adapte,Economy
4585,2019,Economie,1,L'Economie et son Domaine,1,L'Objet de la Science Economique,9,142,1,QO,0.6,0.29,62.84,43,25,68,67,43,24,1.01,64.18,Moyen,Moyen,0,Meme Difficulté,Adapte,Economy
5696,2020,Economie,1,L'Economie et son Domaine,1,L'Objet de la Science Economique,9,142,1,QO,0.24,0.26,62.84,43,26,69,52,43,9,1.33,82.69,Moyen,Moyen,0,Meme Difficulté,Adapte,Economy
142,2015,Economie,1,L'Economie et son Domaine,1,L'Objet de la Science Economique,9,143,2,QCU,0.19,0.89,96.71,93,3,96,94,93,1,1.02,98.94,Difficile,Facile,2,Beaucoup plus Facile,Pas Adapte,Economy
1253,2016,Economie,1,L'Economie et son Domaine,1,L'Objet de la Science Economique,9,143,2,QCM,0.65,0.22,6.04,6,100,106,31,6,25,3.42,19.35,Facile,Difficile,-2,Beaucoup plus Difficile,Pas Adapte,Economy
2364,2017,Economie,1,L'Economie et son Domaine,1,L'Objet de la Science Economique,9,143,2,QCM,0.14,0.97,69.39,69,31,100,74,69,5,1.35,93.24,Moyen,Facile,1,Plus Facile,Adapte,Economy
3475,2018,Economie,1,L'Economie et son Domaine,1,L'Objet de la Science Economique,9,143,2,QCM,0.16,0.72,69.39,64,28,92,71,64,7,1.3,90.14,Facile,Facile,0,Meme Difficulté,Adapte,Economy
4586,2019,Economie,1,L'Economie et son Domaine,1,L'Objet de la Science Economique,9,143,2,QCM,0.11,0.76,69.39,60,27,87,73,60,13,1.19,82.19,Facile,Facile,0,Meme Difficulté,Adapte,Economy
5697,2020,Economie,1,L'Economie et son Domaine,1,L'Objet de la Science Economique,9,143,2,QCM,0.19,0.8,69.39,62,27,89,71,62,9,1.25,87.32,Facile,Facile,0,Meme Difficulté,Adapte,Economy
143,2015,Economie,1,L'Economie et son Domaine,1,L'Objet de la Science Economique,9,144,3,QCU,0.4,0.46,39.55,14,21,35,26,14,12,1.35,53.85,Moyen,Moyen,0,Meme Difficulté,Pas Adapte,Economy
1254,2016,Economie,1,L'Economie et son Domaine,1,L'Objet de la Science Economique,9,144,3,QCU,0.58,0.29,32.5,11,24,35,18,11,7,1.94,61.11,Facile,Difficile,-2,Beaucoup plus Difficile,Pas Adapte,Economy
2365,2017,Economie,1,L'Economie et son Domaine,1,L'Objet de la Science Economique,9,144,3,QCU,0.56,0.31,18.94,6,25,31,11,6,5,2.82,54.55,Difficile,Difficile,0,Meme Difficulté,Pas Adapte,Economy
3476,2018,Economie,1,L'Economie et son Domaine,1,L'Objet de la Science Economique,9,144,3,QCU,0.15,0.85,76.28,22,7,29,28,22,6,1.04,78.57,Moyen,Facile,1,Plus Facile,Pas Adapte,Economy
4587,2019,Economie,1,L'Economie et son Domaine,1,L'Objet de la Science Economique,9,144,3,QCU,0.51,0.32,15.24,4,21,25,20,4,16,1.25,20.0,Moyen,Difficile,-1,Plus Difficile,Pas Adapte,Economy
5698,2020,Economie,1,L'Economie et son Domaine,1,L'Objet de la Science Economique,9,144,3,QCU,0.57,0.22,2.46,1,21,22,18,1,17,1.22,5.56,Difficile,Difficile,0,Meme Difficulté,Pas Adapte,Economy
144,2015,Economie,1,L'Economie et son Domaine,1,L'Objet de la Science Economique,9,145,4,QCU,0.61,0.33,18.02,12,52,64,29,12,17,2.21,41.38,Difficile,Difficile,0,Meme Difficulté,Pas Adapte,Economy
1255,2016,Economie,1,L'Economie et son Domaine,1,L'Objet de la Science Economique,9,145,4,QCU,0.26,0.6,37.66,20,34,54,31,20,11,1.74,64.52,Difficile,Moyen,1,Plus Facile,Pas Adapte,Economy
2366,2017,Economie,1,L'Economie et son Domaine,1,L'Objet de la Science Economique,9,145,4,QCU,0.2,0.62,62.36,29,17,46,37,29,8,1.24,78.38,Facile,Moyen,-1,Plus Difficile,Adapte,Economy
3477,2018,Economie,1,L'Economie et son Domaine,1,L'Objet de la Science Economique,9,145,4,QCU,0.35,0.44,62.36,27,16,43,41,27,14,1.05,65.85,Moyen,Moyen,0,Meme Difficulté,Adapte,Economy
4588,2019,Economie,1,L'Economie et son Domaine,1,L'Objet de la Science Economique,9,145,4,QCU,0.34,0.53,62.36,24,15,39,28,24,4,1.39,85.71,Moyen,Moyen,0,Meme Difficulté,Adapte,Economy
5699,2020,Economie,1,L'Economie et son Domaine,1,L'Objet de la Science Economique,9,145,4,QCU,0.28,0.56,62.36,25,15,40,28,25,3,1.43,89.29,Moyen,Moyen,0,Meme Difficulté,Adapte,Economy
145,2015,Economie,1,L'Economie et son Domaine,1,L'Objet de la Science Economique,9,146,5,QCM,0.22,0.52,41.35,7,10,17,11,7,4,1.55,63.64,Facile,Moyen,-1,Plus Difficile,Pas Adapte,Economy
1256,2016,Economie,1,L'Economie et son Domaine,1,L'Objet de la Science Economique,9,146,5,QCM,0.55,0.16,27.62,4,12,16,6,4,2,2.67,66.67,Difficile,Difficile,0,Meme Difficulté,Pas Adapte,Economy
2367,2017,Economie,1,L'Economie et son Domaine,1,L'Objet de la Science Economique,9,146,5,QCM,0.43,0.4,50.33,8,8,16,10,8,2,1.6,80.0,Difficile,Moyen,1,Plus Facile,Pas Adapte,Economy
3478,2018,Economie,1,L'Economie et son Domaine,1,L'Objet de la Science Economique,9,146,5,QCM,0.3,0.31,52.48,8,7,15,9,8,1,1.67,88.89,Difficile,Moyen,1,Plus Facile,Pas Adapte,Economy
4589,2019,Economie,1,L'Economie et son Domaine,1,L'Objet de la Science Economique,9,146,5,QCM,0.24,0.66,63.17,8,5,13,12,8,4,1.08,66.67,Difficile,Moyen,1,Plus Facile,Adapte,Economy
5700,2020,Economie,1,L'Economie et son Domaine,1,L'Objet de la Science Economique,9,146,5,QCM,0.42,0.38,63.17,8,5,13,12,8,4,1.08,66.67,Moyen,Moyen,0,Meme Difficulté,Adapte,Economy
146,2015,Economie,1,L'Economie et son Domaine,1,L'Objet de la Science Economique,9,147,6,QCM,0.45,0.46,44.57,15,18,33,32,15,17,1.03,46.88,Facile,Moyen,-1,Plus Difficile,Pas Adapte,Economy
1257,2016,Economie,1,L'Economie et son Domaine,1,L'Objet de la Science Economique,9,147,6,QCM,0.14,0.73,74.24,28,10,38,36,28,8,1.06,77.78,Difficile,Facile,2,Beaucoup plus Facile,Adapte,Economy
2368,2017,Economie,1,L'Economie et son Domaine,1,L'Objet de la Science Economique,9,147,6,QCM,0.13,0.73,74.24,25,9,34,30,25,5,1.13,83.33,Facile,Facile,0,Meme Difficulté,Adapte,Economy
3479,2018,Economie,1,L'Economie et son Domaine,1,L'Objet de la Science Economique,9,147,6,QCM,0.18,0.75,74.24,22,8,30,28,22,6,1.07,78.57,Facile,Facile,0,Meme Difficulté,Adapte,Economy
4590,2019,Economie,1,L'Economie et son Domaine,1,L'Objet de la Science Economique,9,147,6,QCM,0.1,0.91,74.24,25,8,33,26,25,1,1.27,96.15,Facile,Facile,0,Meme Difficulté,Adapte,Economy
5701,2020,Economie,1,L'Economie et son Domaine,1,L'Objet de la Science Economique,9,147,6,QCM,0.13,0.91,74.24,24,8,32,30,24,6,1.07,80.0,Facile,Facile,0,Meme Difficulté,Adapte,Economy
147,2015,Economie,1,L'Economie et son Domaine,1,L'Objet de la Science Economique,9,148,7,QO,0.04,0.97,67.73,22,11,33,26,22,4,1.27,84.62,Difficile,Facile,2,Beaucoup plus Facile,Adapte,Economy
1258,2016,Economie,1,L'Economie et son Domaine,1,L'Objet de la Science Economique,9,148,7,QO,0.18,0.7,67.73,25,12,37,33,25,8,1.12,75.76,Facile,Facile,0,Meme Difficulté,Adapte,Economy
2369,2017,Economie,1,L'Economie et son Domaine,1,L'Objet de la Science Economique,9,148,7,QO,0.01,0.32,67.73,24,11,35,26,24,2,1.35,92.31,Facile,Facile,0,Meme Difficulté,Adapte,Economy
3480,2018,Economie,1,L'Economie et son Domaine,1,L'Objet de la Science Economique,9,148,7,QO,0.06,0.96,67.73,26,12,38,28,26,2,1.36,92.86,Facile,Facile,0,Meme Difficulté,Adapte,Economy
4591,2019,Economie,1,L'Economie et son Domaine,1,L'Objet de la Science Economique,9,148,7,QO,0.0,0.61,67.73,28,13,41,28,28,0,1.46,100.0,Facile,Facile,0,Meme Difficulté,Adapte,Economy
5702,2020,Economie,1,L'Economie et son Domaine,1,L'Objet de la Science Economique,9,148,7,QO,0.07,0.37,67.73,26,12,38,27,26,1,1.41,96.3,Facile,Facile,0,Meme Difficulté,Adapte,Economy
148,2015,Economie,1,L'Economie et son Domaine,1,L'Objet de la Science Economique,9,149,8,QROC,0.64,0.02,33.08,23,47,70,40,23,17,1.75,57.5,Facile,Difficile,-2,Beaucoup plus Difficile,Pas Adapte,Economy
1259,2016,Economie,1,L'Economie et son Domaine,1,L'Objet de la Science Economique,9,149,8,QROC,0.86,0.01,9.45,6,61,67,31,6,25,2.16,19.35,Difficile,Difficile,0,Meme Difficulté,Pas Adapte,Economy
2370,2017,Economie,1,L'Economie et son Domaine,1,L'Objet de la Science Economique,9,149,8,QROC,0.45,0.26,39.34,23,36,59,28,23,5,2.11,82.14,Difficile,Moyen,1,Plus Facile,Pas Adapte,Economy
3481,2018,Economie,1,L'Economie et son Domaine,1,L'Objet de la Science Economique,9,149,8,QO,0.11,0.91,78.76,45,12,57,55,45,10,1.04,81.82,Moyen,Facile,1,Plus Facile,Pas Adapte,Economy
4592,2019,Economie,1,L'Economie et son Domaine,1,L'Objet de la Science Economique,9,149,8,QO,0.14,0.48,75.72,45,15,60,51,45,6,1.18,88.24,Difficile,Facile,2,Beaucoup plus Facile,Pas Adapte,Economy
5703,2020,Economie,1,L'Economie et son Domaine,1,L'Objet de la Science Economique,9,149,8,QO,0.24,0.18,48.19,27,29,56,55,27,28,1.02,49.09,Moyen,Moyen,0,Meme Difficulté,Pas Adapte,Economy
149,2015,Economie,1,L'Economie et son Domaine,1,L'Objet de la Science Economique,9,150,9,QROC,0.62,0.18,3.88,1,25,26,11,1,10,2.36,9.09,Moyen,Difficile,-1,Plus Difficile,Pas Adapte,Economy
1260,2016,Economie,1,L'Economie et son Domaine,1,L'Objet de la Science Economique,9,150,9,QROC,0.38,0.31,37.54,9,16,25,18,9,9,1.39,50.0,Facile,Moyen,-1,Plus Difficile,Pas Adapte,Economy
2371,2017,Economie,1,L'Economie et son Domaine,1,L'Objet de la Science Economique,9,150,9,QROC,0.19,0.45,71.35,20,8,28,21,20,1,1.33,95.24,Moyen,Facile,1,Plus Facile,Adapte,Economy
3482,2018,Economie,1,L'Economie et son Domaine,1,L'Objet de la Science Economique,9,150,9,QROC,0.07,0.71,71.35,21,9,30,28,21,7,1.07,75.0,Facile,Facile,0,Meme Difficulté,Adapte,Economy
4593,2019,Economie,1,L'Economie et son Domaine,1,L'Objet de la Science Economique,9,150,9,QROC,0.18,0.56,71.35,20,8,28,20,20,0,1.4,100.0,Facile,Facile,0,Meme Difficulté,Adapte,Economy
5704,2020,Economie,1,L'Economie et son Domaine,1,L'Objet de la Science Economique,9,150,9,QROC,0.18,0.91,71.35,21,9,30,23,21,2,1.3,91.3,Facile,Facile,0,Meme Difficulté,Adapte,Economy
150,2015,Economie,1,L'Economie et son Domaine,2,Les Grands Courants de la Pensee Economique,8,151,1,QCM,0.5,0.36,57.2,7,6,13,8,7,1,1.62,87.5,Facile,Moyen,-1,Plus Difficile,Pas Adapte,Economy
1261,2016,Economie,1,L'Economie et son Domaine,2,Les Grands Courants de la Pensee Economique,8,151,1,QCM,0.73,0.27,6.46,1,13,14,5,1,4,2.8,20.0,Facile,Difficile,-2,Beaucoup plus Difficile,Pas Adapte,Economy
2372,2017,Economie,1,L'Economie et son Domaine,2,Les Grands Courants de la Pensee Economique,8,151,1,QCM,0.77,0.27,20.11,3,12,15,15,3,12,1.0,20.0,Facile,Difficile,-2,Beaucoup plus Difficile,Pas Adapte,Economy
3483,2018,Economie,1,L'Economie et son Domaine,2,Les Grands Courants de la Pensee Economique,8,151,1,QCM,0.8,0.16,26.06,4,11,15,8,4,4,1.88,50.0,Moyen,Difficile,-1,Plus Difficile,Pas Adapte,Economy
4594,2019,Economie,1,L'Economie et son Domaine,2,Les Grands Courants de la Pensee Economique,8,151,1,QCM,0.39,0.52,46.95,6,7,13,12,6,6,1.08,50.0,Facile,Moyen,-1,Plus Difficile,Pas Adapte,Economy
5705,2020,Economie,1,L'Economie et son Domaine,2,Les Grands Courants de la Pensee Economique,8,151,1,QCM,0.73,0.3,5.61,1,11,12,8,1,7,1.5,12.5,Moyen,Difficile,-1,Plus Difficile,Pas Adapte,Economy
151,2015,Economie,1,L'Economie et son Domaine,2,Les Grands Courants de la Pensee Economique,8,152,2,QCU,0.21,0.54,57.67,53,39,92,85,53,32,1.08,62.35,Moyen,Moyen,0,Meme Difficulté,Pas Adapte,Economy
1262,2016,Economie,1,L'Economie et son Domaine,2,Les Grands Courants de la Pensee Economique,8,152,2,QCM,0.62,0.24,21.77,22,80,102,85,22,63,1.2,25.88,Moyen,Difficile,-1,Plus Difficile,Pas Adapte,Economy
2373,2017,Economie,1,L'Economie et son Domaine,2,Les Grands Courants de la Pensee Economique,8,152,2,QCM,0.68,0.28,4.15,5,105,110,59,5,54,1.86,8.47,Difficile,Difficile,0,Meme Difficulté,Pas Adapte,Economy
3484,2018,Economie,1,L'Economie et son Domaine,2,Les Grands Courants de la Pensee Economique,8,152,2,QCM,0.69,0.22,7.69,9,108,117,60,9,51,1.95,15.0,Facile,Difficile,-2,Beaucoup plus Difficile,Pas Adapte,Economy
4595,2019,Economie,1,L'Economie et son Domaine,2,Les Grands Courants de la Pensee Economique,8,152,2,QCM,0.58,0.29,10.07,12,108,120,87,12,75,1.38,13.79,Moyen,Difficile,-1,Plus Difficile,Pas Adapte,Economy
5706,2020,Economie,1,L'Economie et son Domaine,2,Les Grands Courants de la Pensee Economique,8,152,2,QCM,0.08,0.81,84.26,107,20,127,115,107,8,1.1,93.04,Difficile,Facile,2,Beaucoup plus Facile,Pas Adapte,Economy
152,2015,Economie,1,L'Economie et son Domaine,2,Les Grands Courants de la Pensee Economique,8,153,3,QCU,0.17,0.99,72.24,59,22,81,64,59,5,1.27,92.19,Facile,Facile,0,Meme Difficulté,Adapte,Economy
1263,2016,Economie,1,L'Economie et son Domaine,2,Les Grands Courants de la Pensee Economique,8,153,3,QCU,0.08,0.87,72.24,61,23,84,69,61,8,1.22,88.41,Facile,Facile,0,Meme Difficulté,Adapte,Economy
2374,2017,Economie,1,L'Economie et son Domaine,2,Les Grands Courants de la Pensee Economique,8,153,3,QCU,0.18,0.94,72.24,53,21,74,55,53,2,1.35,96.36,Facile,Facile,0,Meme Difficulté,Adapte,Economy
3485,2018,Economie,1,L'Economie et son Domaine,2,Les Grands Courants de la Pensee Economique,8,153,3,QCU,0.01,0.89,72.24,61,23,84,75,61,14,1.12,81.33,Facile,Facile,0,Meme Difficulté,Adapte,Economy
4596,2019,Economie,1,L'Economie et son Domaine,2,Les Grands Courants de la Pensee Economique,8,153,3,QCU,0.02,0.82,72.24,59,23,82,80,59,21,1.02,73.75,Facile,Facile,0,Meme Difficulté,Adapte,Economy
5707,2020,Economie,1,L'Economie et son Domaine,2,Les Grands Courants de la Pensee Economique,8,153,3,QCU,0.01,0.91,72.24,67,26,93,69,67,2,1.35,97.1,Facile,Facile,0,Meme Difficulté,Adapte,Economy
153,2015,Economie,1,L'Economie et son Domaine,2,Les Grands Courants de la Pensee Economique,8,154,4,QCU,0.21,0.46,61.31,11,7,18,17,11,6,1.06,64.71,Difficile,Moyen,1,Plus Facile,Adapte,Economy
1264,2016,Economie,1,L'Economie et son Domaine,2,Les Grands Courants de la Pensee Economique,8,154,4,QROC,0.3,0.26,61.31,13,8,21,16,13,3,1.31,81.25,Moyen,Moyen,0,Meme Difficulté,Adapte,Economy
2375,2017,Economie,1,L'Economie et son Domaine,2,Les Grands Courants de la Pensee Economique,8,154,4,QROC,0.48,0.34,61.31,12,8,20,16,12,4,1.25,75.0,Moyen,Moyen,0,Meme Difficulté,Adapte,Economy
3486,2018,Economie,1,L'Economie et son Domaine,2,Les Grands Courants de la Pensee Economique,8,154,4,QROC,0.31,0.4,61.31,14,9,23,16,14,2,1.44,87.5,Moyen,Moyen,0,Meme Difficulté,Adapte,Economy
4597,2019,Economie,1,L'Economie et son Domaine,2,Les Grands Courants de la Pensee Economique,8,154,4,QO,0.61,0.25,61.31,14,9,23,22,14,8,1.05,63.64,Moyen,Moyen,0,Meme Difficulté,Adapte,Economy
5708,2020,Economie,1,L'Economie et son Domaine,2,Les Grands Courants de la Pensee Economique,8,154,4,QO,0.54,0.15,61.31,15,10,25,19,15,4,1.32,78.95,Moyen,Moyen,0,Meme Difficulté,Adapte,Economy
154,2015,Economie,1,L'Economie et son Domaine,2,Les Grands Courants de la Pensee Economique,8,155,5,QCU,0.49,0.37,21.32,10,38,48,24,10,14,2.0,41.67,Difficile,Difficile,0,Meme Difficulté,Pas Adapte,Economy
1265,2016,Economie,1,L'Economie et son Domaine,2,Les Grands Courants de la Pensee Economique,8,155,5,QCU,0.35,0.41,48.02,22,23,45,42,22,20,1.07,52.38,Moyen,Moyen,0,Meme Difficulté,Pas Adapte,Economy
2376,2017,Economie,1,L'Economie et son Domaine,2,Les Grands Courants de la Pensee Economique,8,155,5,QCU,0.6,0.36,23.7,10,32,42,17,10,7,2.47,58.82,Difficile,Difficile,0,Meme Difficulté,Pas Adapte,Economy
3487,2018,Economie,1,L'Economie et son Domaine,2,Les Grands Courants de la Pensee Economique,8,155,5,QCU,0.67,0.37,31.85,14,29,43,20,14,6,2.15,70.0,Facile,Difficile,-2,Beaucoup plus Difficile,Pas Adapte,Economy
4598,2019,Economie,1,L'Economie et son Domaine,2,Les Grands Courants de la Pensee Economique,8,155,5,QCU,0.17,0.89,65.23,29,16,45,44,29,15,1.02,65.91,Moyen,Facile,1,Plus Facile,Adapte,Economy
5709,2020,Economie,1,L'Economie et son Domaine,2,Les Grands Courants de la Pensee Economique,8,155,5,QCU,0.1,0.99,65.23,33,18,51,47,33,14,1.09,70.21,Facile,Facile,0,Meme Difficulté,Adapte,Economy
155,2015,Economie,1,L'Economie et son Domaine,2,Les Grands Courants de la Pensee Economique,8,156,6,QCU,0.23,0.63,51.46,4,4,8,8,4,4,1.0,50.0,Difficile,Moyen,1,Plus Facile,Pas Adapte,Economy
1266,2016,Economie,1,L'Economie et son Domaine,2,Les Grands Courants de la Pensee Economique,8,156,6,QCU,0.04,1.0,73.26,6,2,8,8,6,2,1.0,75.0,Difficile,Facile,2,Beaucoup plus Facile,Adapte,Economy
2377,2017,Economie,1,L'Economie et son Domaine,2,Les Grands Courants de la Pensee Economique,8,156,6,QCU,0.1,0.84,73.26,5,2,7,5,5,0,1.4,100.0,Facile,Facile,0,Meme Difficulté,Adapte,Economy
3488,2018,Economie,1,L'Economie et son Domaine,2,Les Grands Courants de la Pensee Economique,8,156,6,QCU,0.07,0.79,73.26,6,2,8,8,6,2,1.0,75.0,Facile,Facile,0,Meme Difficulté,Adapte,Economy
4599,2019,Economie,1,L'Economie et son Domaine,2,Les Grands Courants de la Pensee Economique,8,156,6,QCU,0.0,0.76,73.26,5,2,7,7,5,2,1.0,71.43,Facile,Facile,0,Meme Difficulté,Adapte,Economy
5710,2020,Economie,1,L'Economie et son Domaine,2,Les Grands Courants de la Pensee Economique,8,156,6,QCM,0.03,0.97,73.26,5,2,7,7,5,2,1.0,71.43,Facile,Facile,0,Meme Difficulté,Adapte,Economy
156,2015,Economie,1,L'Economie et son Domaine,2,Les Grands Courants de la Pensee Economique,8,157,7,QCM,0.32,0.63,61.63,38,24,62,58,38,20,1.07,65.52,Difficile,Moyen,1,Plus Facile,Adapte,Economy
1267,2016,Economie,1,L'Economie et son Domaine,2,Les Grands Courants de la Pensee Economique,8,157,7,QCM,0.24,0.65,61.63,38,23,61,48,38,10,1.27,79.17,Moyen,Moyen,0,Meme Difficulté,Adapte,Economy
2378,2017,Economie,1,L'Economie et son Domaine,2,Les Grands Courants de la Pensee Economique,8,157,7,QCU,0.35,0.68,61.63,34,21,55,41,34,7,1.34,82.93,Moyen,Moyen,0,Meme Difficulté,Adapte,Economy
3489,2018,Economie,1,L'Economie et son Domaine,2,Les Grands Courants de la Pensee Economique,8,157,7,QCM,0.45,0.69,61.63,29,18,47,40,29,11,1.18,72.5,Moyen,Moyen,0,Meme Difficulté,Adapte,Economy
4600,2019,Economie,1,L'Economie et son Domaine,2,Les Grands Courants de la Pensee Economique,8,157,7,QCM,0.41,0.65,61.63,30,19,49,41,30,11,1.2,73.17,Moyen,Moyen,0,Meme Difficulté,Adapte,Economy
5711,2020,Economie,1,L'Economie et son Domaine,2,Les Grands Courants de la Pensee Economique,8,157,7,QO,0.46,0.28,61.63,26,17,43,41,26,15,1.05,63.41,Moyen,Moyen,0,Meme Difficulté,Adapte,Economy
157,2015,Economie,1,L'Economie et son Domaine,2,Les Grands Courants de la Pensee Economique,8,158,8,QO,0.16,0.75,72.91,61,22,83,81,61,20,1.02,75.31,Facile,Facile,0,Meme Difficulté,Adapte,Economy
1268,2016,Economie,1,L'Economie et son Domaine,2,Les Grands Courants de la Pensee Economique,8,158,8,QO,0.15,0.56,72.91,66,24,90,78,66,12,1.15,84.62,Facile,Facile,0,Meme Difficulté,Adapte,Economy
2379,2017,Economie,1,L'Economie et son Domaine,2,Les Grands Courants de la Pensee Economique,8,158,8,QO,0.13,0.7,72.91,66,25,91,68,66,2,1.34,97.06,Facile,Facile,0,Meme Difficulté,Adapte,Economy
3490,2018,Economie,1,L'Economie et son Domaine,2,Les Grands Courants de la Pensee Economique,8,158,8,QO,0.03,0.77,72.91,68,25,93,91,68,23,1.02,74.73,Facile,Facile,0,Meme Difficulté,Adapte,Economy
4601,2019,Economie,1,L'Economie et son Domaine,2,Les Grands Courants de la Pensee Economique,8,158,8,QO,0.13,0.57,72.91,64,24,88,81,64,17,1.09,79.01,Facile,Facile,0,Meme Difficulté,Adapte,Economy
5712,2020,Economie,1,L'Economie et son Domaine,2,Les Grands Courants de la Pensee Economique,8,158,8,QO,0.04,0.91,72.91,73,27,100,84,73,11,1.19,86.9,Facile,Facile,0,Meme Difficulté,Adapte,Economy
158,2015,Economie,1,L'Economie et son Domaine,3,Modele d'Organisation de la Societe et Systeme Economique,10,159,1,QCU,0.23,0.5,60.62,6,4,10,9,6,3,1.11,66.67,Facile,Moyen,-1,Plus Difficile,Adapte,Economy
1269,2016,Economie,1,L'Economie et son Domaine,3,Modele d'Organisation de la Societe et Systeme Economique,10,159,1,QCU,0.34,0.54,60.62,6,4,10,9,6,3,1.11,66.67,Moyen,Moyen,0,Meme Difficulté,Adapte,Economy
2380,2017,Economie,1,L'Economie et son Domaine,3,Modele d'Organisation de la Societe et Systeme Economique,10,159,1,QCU,0.4,0.71,60.62,7,5,12,11,7,4,1.09,63.64,Moyen,Moyen,0,Meme Difficulté,Adapte,Economy
3491,2018,Economie,1,L'Economie et son Domaine,3,Modele d'Organisation de la Societe et Systeme Economique,10,159,1,QCU,0.38,0.56,60.62,8,5,13,10,8,2,1.3,80.0,Moyen,Moyen,0,Meme Difficulté,Adapte,Economy
4602,2019,Economie,1,L'Economie et son Domaine,3,Modele d'Organisation de la Societe et Systeme Economique,10,159,1,QCU,0.35,0.49,60.62,8,6,14,8,8,0,1.75,100.0,Moyen,Moyen,0,Meme Difficulté,Adapte,Economy
5713,2020,Economie,1,L'Economie et son Domaine,3,Modele d'Organisation de la Societe et Systeme Economique,10,159,1,QCM,0.32,0.58,60.62,9,6,15,13,9,4,1.15,69.23,Moyen,Moyen,0,Meme Difficulté,Adapte,Economy
159,2015,Economie,1,L'Economie et son Domaine,3,Modele d'Organisation de la Societe et Systeme Economique,10,160,2,QROC,0.09,0.81,71.51,16,7,23,17,16,1,1.35,94.12,Moyen,Facile,1,Plus Facile,Adapte,Economy
1270,2016,Economie,1,L'Economie et son Domaine,3,Modele d'Organisation de la Societe et Systeme Economique,10,160,2,QROC,0.15,0.71,71.51,16,7,23,20,16,4,1.15,80.0,Facile,Facile,0,Meme Difficulté,Adapte,Economy
2381,2017,Economie,1,L'Economie et son Domaine,3,Modele d'Organisation de la Societe et Systeme Economique,10,160,2,QROC,0.01,0.4,71.51,19,7,26,22,19,3,1.18,86.36,Facile,Facile,0,Meme Difficulté,Adapte,Economy
3492,2018,Economie,1,L'Economie et son Domaine,3,Modele d'Organisation de la Societe et Systeme Economique,10,160,2,QROC,0.16,0.7,71.51,16,7,23,20,16,4,1.15,80.0,Facile,Facile,0,Meme Difficulté,Adapte,Economy
4603,2019,Economie,1,L'Economie et son Domaine,3,Modele d'Organisation de la Societe et Systeme Economique,10,160,2,QROC,0.14,0.68,71.51,15,6,21,18,15,3,1.17,83.33,Facile,Facile,0,Meme Difficulté,Adapte,Economy
5714,2020,Economie,1,L'Economie et son Domaine,3,Modele d'Organisation de la Societe et Systeme Economique,10,160,2,QROC,0.16,0.41,71.51,17,7,24,22,17,5,1.09,77.27,Facile,Facile,0,Meme Difficulté,Adapte,Economy
160,2015,Economie,1,L'Economie et son Domaine,3,Modele d'Organisation de la Societe et Systeme Economique,10,161,3,QCU,0.26,0.64,42.15,19,26,45,41,19,22,1.1,46.34,Moyen,Moyen,0,Meme Difficulté,Pas Adapte,Economy
1271,2016,Economie,1,L'Economie et son Domaine,3,Modele d'Organisation de la Societe et Systeme Economique,10,161,3,QCU,0.7,0.28,18.96,8,32,40,27,8,19,1.48,29.63,Difficile,Difficile,0,Meme Difficulté,Pas Adapte,Economy
2382,2017,Economie,1,L'Economie et son Domaine,3,Modele d'Organisation de la Societe et Systeme Economique,10,161,3,QCU,0.33,0.5,46.33,16,18,34,22,16,6,1.55,72.73,Facile,Moyen,-1,Plus Difficile,Pas Adapte,Economy
3493,2018,Economie,1,L'Economie et son Domaine,3,Modele d'Organisation de la Societe et Systeme Economique,10,161,3,QCM,0.1,0.91,77.52,26,8,34,29,26,3,1.17,89.66,Moyen,Facile,1,Plus Facile,Pas Adapte,Economy
4604,2019,Economie,1,L'Economie et son Domaine,3,Modele d'Organisation de la Societe et Systeme Economique,10,161,3,QCM,0.37,0.5,50.58,17,16,33,20,17,3,1.65,85.0,Moyen,Moyen,0,Meme Difficulté,Pas Adapte,Economy
5715,2020,Economie,1,L'Economie et son Domaine,3,Modele d'Organisation de la Societe et Systeme Economique,10,161,3,QCM,0.71,0.19,12.71,4,25,29,23,4,19,1.26,17.39,Moyen,Difficile,-1,Plus Difficile,Pas Adapte,Economy
161,2015,Economie,1,L'Economie et son Domaine,3,Modele d'Organisation de la Societe et Systeme Economique,10,162,4,QCU,0.04,0.95,68.63,8,3,11,10,8,2,1.1,80.0,Moyen,Facile,1,Plus Facile,Adapte,Economy
1272,2016,Economie,1,L'Economie et son Domaine,3,Modele d'Organisation de la Societe et Systeme Economique,10,162,4,QCU,0.08,0.89,68.63,8,4,12,9,8,1,1.33,88.89,Facile,Facile,0,Meme Difficulté,Adapte,Economy
2383,2017,Economie,1,L'Economie et son Domaine,3,Modele d'Organisation de la Societe et Systeme Economique,10,162,4,QCU,0.13,0.87,68.63,8,3,11,9,8,1,1.22,88.89,Facile,Facile,0,Meme Difficulté,Adapte,Economy
3494,2018,Economie,1,L'Economie et son Domaine,3,Modele d'Organisation de la Societe et Systeme Economique,10,162,4,QCU,0.01,0.77,68.63,6,3,9,8,6,2,1.12,75.0,Facile,Facile,0,Meme Difficulté,Adapte,Economy
4605,2019,Economie,1,L'Economie et son Domaine,3,Modele d'Organisation de la Societe et Systeme Economique,10,162,4,QCU,0.03,0.9,68.63,7,3,10,8,7,1,1.25,87.5,Facile,Facile,0,Meme Difficulté,Adapte,Economy
5716,2020,Economie,1,L'Economie et son Domaine,3,Modele d'Organisation de la Societe et Systeme Economique,10,162,4,QCU,0.11,0.84,68.63,7,3,10,8,7,1,1.25,87.5,Facile,Facile,0,Meme Difficulté,Adapte,Economy
162,2015,Economie,1,L'Economie et son Domaine,3,Modele d'Organisation de la Societe et Systeme Economique,10,163,5,QCU,0.58,0.31,4.1,4,93,97,80,4,76,1.21,5.0,Facile,Difficile,-2,Beaucoup plus Difficile,Pas Adapte,Economy
1273,2016,Economie,1,L'Economie et son Domaine,3,Modele d'Organisation de la Societe et Systeme Economique,10,163,5,QCU,0.73,0.33,15.92,14,75,89,69,14,55,1.29,20.29,Difficile,Difficile,0,Meme Difficulté,Pas Adapte,Economy
2384,2017,Economie,1,L'Economie et son Domaine,3,Modele d'Organisation de la Societe et Systeme Economique,10,163,5,QCU,0.44,0.28,18.25,16,71,87,64,16,48,1.36,25.0,Difficile,Difficile,0,Meme Difficulté,Pas Adapte,Economy
3495,2018,Economie,1,L'Economie et son Domaine,3,Modele d'Organisation de la Societe et Systeme Economique,10,163,5,QCU,0.65,0.21,1.94,1,74,75,46,1,45,1.63,2.17,Facile,Difficile,-2,Beaucoup plus Difficile,Pas Adapte,Economy
4606,2019,Economie,1,L'Economie et son Domaine,3,Modele d'Organisation de la Societe et Systeme Economique,10,163,5,QCU,0.62,0.36,32.88,25,50,75,65,25,40,1.15,38.46,Difficile,Difficile,0,Meme Difficulté,Pas Adapte,Economy
5717,2020,Economie,1,L'Economie et son Domaine,3,Modele d'Organisation de la Societe et Systeme Economique,10,163,5,QCU,0.43,0.33,6.19,4,67,71,54,4,50,1.31,7.41,Moyen,Difficile,-1,Plus Difficile,Pas Adapte,Economy
163,2015,Economie,1,L'Economie et son Domaine,3,Modele d'Organisation de la Societe et Systeme Economique,10,164,6,QCM,0.06,0.79,92.43,35,3,38,38,35,3,1.0,92.11,Facile,Facile,0,Meme Difficulté,Pas Adapte,Economy
1274,2016,Economie,1,L'Economie et son Domaine,3,Modele d'Organisation de la Societe et Systeme Economique,10,164,6,QCM,0.03,0.98,68.69,23,11,34,33,23,10,1.03,69.7,Facile,Facile,0,Meme Difficulté,Adapte,Economy
2385,2017,Economie,1,L'Economie et son Domaine,3,Modele d'Organisation de la Societe et Systeme Economique,10,164,6,QCM,0.1,0.95,68.69,27,12,39,39,27,12,1.0,69.23,Facile,Facile,0,Meme Difficulté,Adapte,Economy
3496,2018,Economie,1,L'Economie et son Domaine,3,Modele d'Organisation de la Societe et Systeme Economique,10,164,6,QCM,0.15,0.87,68.69,24,11,35,35,24,11,1.0,68.57,Facile,Facile,0,Meme Difficulté,Adapte,Economy
4607,2019,Economie,1,L'Economie et son Domaine,3,Modele d'Organisation de la Societe et Systeme Economique,10,164,6,QCM,0.08,0.71,68.69,26,12,38,31,26,5,1.23,83.87,Facile,Facile,0,Meme Difficulté,Adapte,Economy
5718,2020,Economie,1,L'Economie et son Domaine,3,Modele d'Organisation de la Societe et Systeme Economique,10,164,6,QCU,0.02,0.79,68.69,27,13,40,39,27,12,1.03,69.23,Facile,Facile,0,Meme Difficulté,Adapte,Economy
164,2015,Economie,1,L'Economie et son Domaine,3,Modele d'Organisation de la Societe et Systeme Economique,10,165,7,QCM,0.34,0.66,64.51,25,14,39,32,25,7,1.22,78.12,Moyen,Moyen,0,Meme Difficulté,Adapte,Economy
1275,2016,Economie,1,L'Economie et son Domaine,3,Modele d'Organisation de la Societe et Systeme Economique,10,165,7,QCM,0.27,0.54,64.51,21,12,33,26,21,5,1.27,80.77,Moyen,Moyen,0,Meme Difficulté,Adapte,Economy
2386,2017,Economie,1,L'Economie et son Domaine,3,Modele d'Organisation de la Societe et Systeme Economique,10,165,7,QCM,0.49,0.41,64.51,22,12,34,32,22,10,1.06,68.75,Moyen,Moyen,0,Meme Difficulté,Adapte,Economy
3497,2018,Economie,1,L'Economie et son Domaine,3,Modele d'Organisation de la Societe et Systeme Economique,10,165,7,QCM,0.49,0.56,64.51,25,13,38,35,25,10,1.09,71.43,Moyen,Moyen,0,Meme Difficulté,Adapte,Economy
4608,2019,Economie,1,L'Economie et son Domaine,3,Modele d'Organisation de la Societe et Systeme Economique,10,165,7,QCM,0.45,0.51,64.51,23,13,36,29,23,6,1.24,79.31,Moyen,Moyen,0,Meme Difficulté,Adapte,Economy
5719,2020,Economie,1,L'Economie et son Domaine,3,Modele d'Organisation de la Societe et Systeme Economique,10,165,7,QCM,0.37,0.68,64.51,21,12,33,26,21,5,1.27,80.77,Moyen,Moyen,0,Meme Difficulté,Adapte,Economy
165,2015,Economie,1,L'Economie et son Domaine,3,Modele d'Organisation de la Societe et Systeme Economique,10,166,8,QO,0.57,0.28,49.28,44,46,90,87,44,43,1.03,50.57,Moyen,Moyen,0,Meme Difficulté,Pas Adapte,Economy
1276,2016,Economie,1,L'Economie et son Domaine,3,Modele d'Organisation de la Societe et Systeme Economique,10,166,8,QO,0.15,0.55,77.28,69,20,89,88,69,19,1.01,78.41,Difficile,Facile,2,Beaucoup plus Facile,Pas Adapte,Economy
2387,2017,Economie,1,L'Economie et son Domaine,3,Modele d'Organisation de la Societe et Systeme Economique,10,166,8,QROC,0.05,0.53,65.91,51,26,77,63,51,12,1.22,80.95,Moyen,Facile,1,Plus Facile,Adapte,Economy
3498,2018,Economie,1,L'Economie et son Domaine,3,Modele d'Organisation de la Societe et Systeme Economique,10,166,8,QROC,0.0,0.63,65.91,44,22,66,66,44,22,1.0,66.67,Facile,Facile,0,Meme Difficulté,Adapte,Economy
4609,2019,Economie,1,L'Economie et son Domaine,3,Modele d'Organisation de la Societe et Systeme Economique,10,166,8,QROC,0.18,0.61,65.91,49,26,75,65,49,16,1.15,75.38,Facile,Facile,0,Meme Difficulté,Adapte,Economy
5720,2020,Economie,1,L'Economie et son Domaine,3,Modele d'Organisation de la Societe et Systeme Economique,10,166,8,QROC,0.07,0.46,65.91,50,26,76,72,50,22,1.06,69.44,Facile,Facile,0,Meme Difficulté,Adapte,Economy
166,2015,Economie,1,L'Economie et son Domaine,3,Modele d'Organisation de la Societe et Systeme Economique,10,167,9,QCU,0.32,0.42,40.47,34,50,84,82,34,48,1.02,41.46,Facile,Moyen,-1,Plus Difficile,Pas Adapte,Economy
1277,2016,Economie,1,L'Economie et son Domaine,3,Modele d'Organisation de la Societe et Systeme Economique,10,167,9,QCU,0.31,0.46,39.51,34,52,86,84,34,50,1.02,40.48,Difficile,Moyen,1,Plus Facile,Pas Adapte,Economy
2388,2017,Economie,1,L'Economie et son Domaine,3,Modele d'Organisation de la Societe et Systeme Economique,10,167,9,QCU,0.28,0.44,50.3,47,47,94,85,47,38,1.11,55.29,Facile,Moyen,-1,Plus Difficile,Pas Adapte,Economy
3499,2018,Economie,1,L'Economie et son Domaine,3,Modele d'Organisation de la Societe et Systeme Economique,10,167,9,QCU,0.07,0.99,98.09,93,2,95,93,93,0,1.02,100.0,Moyen,Facile,1,Plus Facile,Pas Adapte,Economy
4610,2019,Economie,1,L'Economie et son Domaine,3,Modele d'Organisation de la Societe et Systeme Economique,10,167,9,QCU,0.38,0.62,38.32,34,54,88,78,34,44,1.13,43.59,Moyen,Moyen,0,Meme Difficulté,Pas Adapte,Economy
5721,2020,Economie,1,L'Economie et son Domaine,3,Modele d'Organisation de la Societe et Systeme Economique,10,167,9,QCU,0.2,0.94,93.01,83,6,89,88,83,5,1.01,94.32,Facile,Facile,0,Meme Difficulté,Pas Adapte,Economy
167,2015,Economie,1,L'Economie et son Domaine,3,Modele d'Organisation de la Societe et Systeme Economique,10,168,10,QCU,0.54,0.34,11.29,4,30,34,26,4,22,1.31,15.38,Facile,Difficile,-2,Beaucoup plus Difficile,Pas Adapte,Economy
1278,2016,Economie,1,L'Economie et son Domaine,3,Modele d'Organisation de la Societe et Systeme Economique,10,168,10,QCU,0.43,0.36,14.18,5,28,33,16,5,11,2.06,31.25,Moyen,Difficile,-1,Plus Difficile,Pas Adapte,Economy
2389,2017,Economie,1,L'Economie et son Domaine,3,Modele d'Organisation de la Societe et Systeme Economique,10,168,10,QCU,0.29,0.58,54.71,15,13,28,17,15,2,1.65,88.24,Moyen,Moyen,0,Meme Difficulté,Pas Adapte,Economy
3500,2018,Economie,1,L'Economie et son Domaine,3,Modele d'Organisation de la Societe et Systeme Economique,10,168,10,QCU,0.74,0.21,34.65,10,19,29,14,10,4,2.07,71.43,Facile,Difficile,-2,Beaucoup plus Difficile,Pas Adapte,Economy
4611,2019,Economie,1,L'Economie et son Domaine,3,Modele d'Organisation de la Societe et Systeme Economique,10,168,10,QCU,0.32,0.74,45.14,14,17,31,27,14,13,1.15,51.85,Moyen,Moyen,0,Meme Difficulté,Pas Adapte,Economy
5722,2020,Economie,1,L'Economie et son Domaine,3,Modele d'Organisation de la Societe et Systeme Economique,10,168,10,QCU,0.17,0.77,83.19,29,6,35,32,29,3,1.09,90.62,Facile,Facile,0,Meme Difficulté,Pas Adapte,Economy
168,2015,Economie,2,La Representation de l'Activite Economique: Le Circuit Economique,1,Les Agents Economiques et leurs Operations,8,169,1,QCM,0.12,0.71,86.51,24,4,28,26,24,2,1.08,92.31,Moyen,Facile,1,Plus Facile,Pas Adapte,Economy
1279,2016,Economie,2,La Representation de l'Activite Economique: Le Circuit Economique,1,Les Agents Economiques et leurs Operations,8,169,1,QCM,0.05,0.82,82.82,26,5,31,30,26,4,1.03,86.67,Moyen,Facile,1,Plus Facile,Pas Adapte,Economy
2390,2017,Economie,2,La Representation de l'Activite Economique: Le Circuit Economique,1,Les Agents Economiques et leurs Operations,8,169,1,QCM,0.07,0.77,67.78,22,10,32,29,22,7,1.1,75.86,Difficile,Facile,2,Beaucoup plus Facile,Adapte,Economy
3501,2018,Economie,2,La Representation de l'Activite Economique: Le Circuit Economique,1,Les Agents Economiques et leurs Operations,8,169,1,QCM,0.12,0.77,67.78,25,12,37,34,25,9,1.09,73.53,Facile,Facile,0,Meme Difficulté,Adapte,Economy
4612,2019,Economie,2,La Representation de l'Activite Economique: Le Circuit Economique,1,Les Agents Economiques et leurs Operations,8,169,1,QCM,0.01,0.83,67.78,23,11,34,28,23,5,1.21,82.14,Facile,Facile,0,Meme Difficulté,Adapte,Economy
5723,2020,Economie,2,La Representation de l'Activite Economique: Le Circuit Economique,1,Les Agents Economiques et leurs Operations,8,169,1,QCM,0.02,0.76,67.78,24,11,35,30,24,6,1.17,80.0,Facile,Facile,0,Meme Difficulté,Adapte,Economy
169,2015,Economie,2,La Representation de l'Activite Economique: Le Circuit Economique,1,Les Agents Economiques et leurs Operations,8,170,2,QO,0.02,0.61,72.18,40,15,55,55,40,15,1.0,72.73,Difficile,Facile,2,Beaucoup plus Facile,Adapte,Economy
1280,2016,Economie,2,La Representation de l'Activite Economique: Le Circuit Economique,1,Les Agents Economiques et leurs Operations,8,170,2,QO,0.16,0.43,72.18,35,14,49,36,35,1,1.36,97.22,Facile,Facile,0,Meme Difficulté,Adapte,Economy
2391,2017,Economie,2,La Representation de l'Activite Economique: Le Circuit Economique,1,Les Agents Economiques et leurs Operations,8,170,2,QCU,0.08,0.76,72.18,40,15,55,50,40,10,1.1,80.0,Facile,Facile,0,Meme Difficulté,Adapte,Economy
3502,2018,Economie,2,La Representation de l'Activite Economique: Le Circuit Economique,1,Les Agents Economiques et leurs Operations,8,170,2,QCU,0.08,0.75,72.18,42,16,58,43,42,1,1.35,97.67,Facile,Facile,0,Meme Difficulté,Adapte,Economy
4613,2019,Economie,2,La Representation de l'Activite Economique: Le Circuit Economique,1,Les Agents Economiques et leurs Operations,8,170,2,QCU,0.04,0.95,72.18,35,14,49,39,35,4,1.26,89.74,Facile,Facile,0,Meme Difficulté,Adapte,Economy
5724,2020,Economie,2,La Representation de l'Activite Economique: Le Circuit Economique,1,Les Agents Economiques et leurs Operations,8,170,2,QROC,0.01,0.69,72.18,38,15,53,38,38,0,1.39,100.0,Facile,Facile,0,Meme Difficulté,Adapte,Economy
170,2015,Economie,2,La Representation de l'Activite Economique: Le Circuit Economique,1,Les Agents Economiques et leurs Operations,8,171,3,QCU,0.3,0.64,56.85,38,29,67,66,38,28,1.02,57.58,Facile,Moyen,-1,Plus Difficile,Pas Adapte,Economy
1281,2016,Economie,2,La Representation de l'Activite Economique: Le Circuit Economique,1,Les Agents Economiques et leurs Operations,8,171,3,QCU,0.69,0.24,24.02,17,54,71,25,17,8,2.84,68.0,Difficile,Difficile,0,Meme Difficulté,Pas Adapte,Economy
2392,2017,Economie,2,La Representation de l'Activite Economique: Le Circuit Economique,1,Les Agents Economiques et leurs Operations,8,171,3,QCU,0.36,0.52,60.25,45,29,74,71,45,26,1.04,63.38,Facile,Moyen,-1,Plus Difficile,Adapte,Economy
3503,2018,Economie,2,La Representation de l'Activite Economique: Le Circuit Economique,1,Les Agents Economiques et leurs Operations,8,171,3,QROC,0.54,0.27,60.25,49,33,82,67,49,18,1.22,73.13,Moyen,Moyen,0,Meme Difficulté,Adapte,Economy
4614,2019,Economie,2,La Representation de l'Activite Economique: Le Circuit Economique,1,Les Agents Economiques et leurs Operations,8,171,3,QO,0.41,0.16,60.25,54,36,90,61,54,7,1.48,88.52,Moyen,Moyen,0,Meme Difficulté,Adapte,Economy
5725,2020,Economie,2,La Representation de l'Activite Economique: Le Circuit Economique,1,Les Agents Economiques et leurs Operations,8,171,3,QCM,0.42,0.31,60.25,56,37,93,81,56,25,1.15,69.14,Moyen,Moyen,0,Meme Difficulté,Adapte,Economy
171,2015,Economie,2,La Representation de l'Activite Economique: Le Circuit Economique,1,Les Agents Economiques et leurs Operations,8,172,4,QROC,0.08,0.63,92.91,58,4,62,59,58,1,1.05,98.31,Moyen,Facile,1,Plus Facile,Pas Adapte,Economy
1282,2016,Economie,2,La Representation de l'Activite Economique: Le Circuit Economique,1,Les Agents Economiques et leurs Operations,8,172,4,QO,0.13,0.65,74.25,43,15,58,45,43,2,1.29,95.56,Difficile,Facile,2,Beaucoup plus Facile,Adapte,Economy
2393,2017,Economie,2,La Representation de l'Activite Economique: Le Circuit Economique,1,Les Agents Economiques et leurs Operations,8,172,4,QO,0.15,0.84,74.25,48,16,64,54,48,6,1.19,88.89,Facile,Facile,0,Meme Difficulté,Adapte,Economy
3504,2018,Economie,2,La Representation de l'Activite Economique: Le Circuit Economique,1,Les Agents Economiques et leurs Operations,8,172,4,QO,0.02,0.72,74.25,50,17,67,54,50,4,1.24,92.59,Facile,Facile,0,Meme Difficulté,Adapte,Economy
4615,2019,Economie,2,La Representation de l'Activite Economique: Le Circuit Economique,1,Les Agents Economiques et leurs Operations,8,172,4,QO,0.16,0.42,74.25,52,18,70,58,52,6,1.21,89.66,Facile,Facile,0,Meme Difficulté,Adapte,Economy
5726,2020,Economie,2,La Representation de l'Activite Economique: Le Circuit Economique,1,Les Agents Economiques et leurs Operations,8,172,4,QCM,0.14,0.74,74.25,59,21,80,79,59,20,1.01,74.68,Facile,Facile,0,Meme Difficulté,Adapte,Economy
172,2015,Economie,2,La Representation de l'Activite Economique: Le Circuit Economique,1,Les Agents Economiques et leurs Operations,8,173,5,QCM,0.34,0.37,61.89,5,3,8,8,5,3,1.0,62.5,Difficile,Moyen,1,Plus Facile,Adapte,Economy
1283,2016,Economie,2,La Representation de l'Activite Economique: Le Circuit Economique,1,Les Agents Economiques et leurs Operations,8,173,5,QCM,0.43,0.51,61.89,5,3,8,7,5,2,1.14,71.43,Moyen,Moyen,0,Meme Difficulté,Adapte,Economy
2394,2017,Economie,2,La Representation de l'Activite Economique: Le Circuit Economique,1,Les Agents Economiques et leurs Operations,8,173,5,QCM,0.39,0.63,61.89,6,3,9,8,6,2,1.12,75.0,Moyen,Moyen,0,Meme Difficulté,Adapte,Economy
3505,2018,Economie,2,La Representation de l'Activite Economique: Le Circuit Economique,1,Les Agents Economiques et leurs Operations,8,173,5,QCM,0.32,0.41,61.89,5,3,8,6,5,1,1.33,83.33,Moyen,Moyen,0,Meme Difficulté,Adapte,Economy
4616,2019,Economie,2,La Representation de l'Activite Economique: Le Circuit Economique,1,Les Agents Economiques et leurs Operations,8,173,5,QCM,0.44,0.54,61.89,6,3,9,7,6,1,1.29,85.71,Moyen,Moyen,0,Meme Difficulté,Adapte,Economy
5727,2020,Economie,2,La Representation de l'Activite Economique: Le Circuit Economique,1,Les Agents Economiques et leurs Operations,8,173,5,QCM,0.4,0.41,61.89,6,4,10,9,6,3,1.11,66.67,Moyen,Moyen,0,Meme Difficulté,Adapte,Economy
173,2015,Economie,2,La Representation de l'Activite Economique: Le Circuit Economique,1,Les Agents Economiques et leurs Operations,8,174,6,QCU,0.7,0.31,22.74,13,46,59,31,13,18,1.9,41.94,Difficile,Difficile,0,Meme Difficulté,Pas Adapte,Economy
1284,2016,Economie,2,La Representation de l'Activite Economique: Le Circuit Economique,1,Les Agents Economiques et leurs Operations,8,174,6,QCU,0.17,0.99,78.62,51,14,65,60,51,9,1.08,85.0,Facile,Facile,0,Meme Difficulté,Pas Adapte,Economy
2395,2017,Economie,2,La Representation de l'Activite Economique: Le Circuit Economique,1,Les Agents Economiques et leurs Operations,8,174,6,QCU,0.47,0.31,31.79,19,40,59,58,19,39,1.02,32.76,Moyen,Difficile,-1,Plus Difficile,Pas Adapte,Economy
3506,2018,Economie,2,La Representation de l'Activite Economique: Le Circuit Economique,1,Les Agents Economiques et leurs Operations,8,174,6,QCU,0.05,0.96,79.98,46,12,58,48,46,2,1.21,95.83,Difficile,Facile,2,Beaucoup plus Facile,Pas Adapte,Economy
4617,2019,Economie,2,La Representation de l'Activite Economique: Le Circuit Economique,1,Les Agents Economiques et leurs Operations,8,174,6,QCU,0.08,0.91,82.36,51,11,62,61,51,10,1.02,83.61,Difficile,Facile,2,Beaucoup plus Facile,Pas Adapte,Economy
5728,2020,Economie,2,La Representation de l'Activite Economique: Le Circuit Economique,1,Les Agents Economiques et leurs Operations,8,174,6,QCU,0.05,0.82,92.45,65,5,70,69,65,4,1.01,94.2,Difficile,Facile,2,Beaucoup plus Facile,Pas Adapte,Economy
174,2015,Economie,2,La Representation de l'Activite Economique: Le Circuit Economique,1,Les Agents Economiques et leurs Operations,8,175,7,QCM,0.73,0.21,31.95,21,44,65,21,21,0,3.1,100.0,Difficile,Difficile,0,Meme Difficulté,Pas Adapte,Economy
1285,2016,Economie,2,La Representation de l'Activite Economique: Le Circuit Economique,1,Les Agents Economiques et leurs Operations,8,175,7,QCM,0.45,0.39,61.86,37,23,60,56,37,19,1.07,66.07,Facile,Moyen,-1,Plus Difficile,Adapte,Economy
2396,2017,Economie,2,La Representation de l'Activite Economique: Le Circuit Economique,1,Les Agents Economiques et leurs Operations,8,175,7,QCM,0.35,0.4,61.86,40,24,64,59,40,19,1.08,67.8,Moyen,Moyen,0,Meme Difficulté,Adapte,Economy
3507,2018,Economie,2,La Representation de l'Activite Economique: Le Circuit Economique,1,Les Agents Economiques et leurs Operations,8,175,7,QCM,0.21,0.44,61.86,33,21,54,49,33,16,1.1,67.35,Moyen,Moyen,0,Meme Difficulté,Adapte,Economy
4618,2019,Economie,2,La Representation de l'Activite Economique: Le Circuit Economique,1,Les Agents Economiques et leurs Operations,8,175,7,QCM,0.23,0.58,61.86,38,24,62,61,38,23,1.02,62.3,Moyen,Moyen,0,Meme Difficulté,Adapte,Economy
5729,2020,Economie,2,La Representation de l'Activite Economique: Le Circuit Economique,1,Les Agents Economiques et leurs Operations,8,175,7,QCM,0.21,0.68,61.86,40,25,65,45,40,5,1.44,88.89,Moyen,Moyen,0,Meme Difficulté,Adapte,Economy
175,2015,Economie,2,La Representation de l'Activite Economique: Le Circuit Economique,1,Les Agents Economiques et leurs Operations,8,176,8,QCU,0.48,0.26,18.99,9,39,48,25,9,16,1.92,36.0,Facile,Difficile,-2,Beaucoup plus Difficile,Pas Adapte,Economy
1286,2016,Economie,2,La Representation de l'Activite Economique: Le Circuit Economique,1,Les Agents Economiques et leurs Operations,8,176,8,QCU,0.33,0.54,45.81,22,27,49,30,22,8,1.63,73.33,Facile,Moyen,-1,Plus Difficile,Pas Adapte,Economy
2397,2017,Economie,2,La Representation de l'Activite Economique: Le Circuit Economique,1,Les Agents Economiques et leurs Operations,8,176,8,QCU,0.36,0.49,56.13,29,23,52,42,29,13,1.24,69.05,Facile,Moyen,-1,Plus Difficile,Pas Adapte,Economy
3508,2018,Economie,2,La Representation de l'Activite Economique: Le Circuit Economique,1,Les Agents Economiques et leurs Operations,8,176,8,QCU,0.31,0.66,49.76,25,25,50,49,25,24,1.02,51.02,Facile,Moyen,-1,Plus Difficile,Pas Adapte,Economy
4619,2019,Economie,2,La Representation de l'Activite Economique: Le Circuit Economique,1,Les Agents Economiques et leurs Operations,8,176,8,QCM,0.55,0.17,6.27,3,46,49,34,3,31,1.44,8.82,Difficile,Difficile,0,Meme Difficulté,Pas Adapte,Economy
5730,2020,Economie,2,La Representation de l'Activite Economique: Le Circuit Economique,1,Les Agents Economiques et leurs Operations,8,176,8,QCM,0.57,0.21,16.86,8,38,46,37,8,29,1.24,21.62,Facile,Difficile,-2,Beaucoup plus Difficile,Pas Adapte,Economy
176,2015,Economie,2,La Representation de l'Activite Economique: Le Circuit Economique,2,Le Circuit Economique dans le Cadre National,5,177,1,QROC,0.99,0.2,14.5,7,40,47,38,7,31,1.24,18.42,Facile,Difficile,-2,Beaucoup plus Difficile,Pas Adapte,Economy
1287,2016,Economie,2,La Representation de l'Activite Economique: Le Circuit Economique,2,Le Circuit Economique dans le Cadre National,5,177,1,QROC,0.99,0.07,19.83,10,41,51,23,10,13,2.22,43.48,Difficile,Difficile,0,Meme Difficulté,Pas Adapte,Economy
2398,2017,Economie,2,La Representation de l'Activite Economique: Le Circuit Economique,2,Le Circuit Economique dans le Cadre National,5,177,1,QROC,0.75,0.24,2.0,1,56,57,27,1,26,2.11,3.7,Facile,Difficile,-2,Beaucoup plus Difficile,Pas Adapte,Economy
3509,2018,Economie,2,La Representation de l'Activite Economique: Le Circuit Economique,2,Le Circuit Economique dans le Cadre National,5,177,1,QO,0.12,0.95,90.02,43,5,48,45,43,2,1.07,95.56,Difficile,Facile,2,Beaucoup plus Facile,Pas Adapte,Economy
4620,2019,Economie,2,La Representation de l'Activite Economique: Le Circuit Economique,2,Le Circuit Economique dans le Cadre National,5,177,1,QO,0.22,0.26,58.61,32,23,55,46,32,14,1.2,69.57,Moyen,Moyen,0,Meme Difficulté,Pas Adapte,Economy
5731,2020,Economie,2,La Representation de l'Activite Economique: Le Circuit Economique,2,Le Circuit Economique dans le Cadre National,5,177,1,QROC,0.23,0.34,45.21,23,28,51,32,23,9,1.59,71.88,Facile,Moyen,-1,Plus Difficile,Pas Adapte,Economy
177,2015,Economie,2,La Representation de l'Activite Economique: Le Circuit Economique,2,Le Circuit Economique dans le Cadre National,5,178,2,QROC,0.97,0.03,10.17,6,56,62,38,6,32,1.63,15.79,Moyen,Difficile,-1,Plus Difficile,Pas Adapte,Economy
1288,2016,Economie,2,La Representation de l'Activite Economique: Le Circuit Economique,2,Le Circuit Economique dans le Cadre National,5,178,2,QROC,0.26,0.31,56.21,40,31,71,44,40,4,1.61,90.91,Facile,Moyen,-1,Plus Difficile,Pas Adapte,Economy
2399,2017,Economie,2,La Representation de l'Activite Economique: Le Circuit Economique,2,Le Circuit Economique dans le Cadre National,5,178,2,QROC,0.07,0.43,66.64,53,27,80,61,53,8,1.31,86.89,Moyen,Facile,1,Plus Facile,Adapte,Economy
3510,2018,Economie,2,La Representation de l'Activite Economique: Le Circuit Economique,2,Le Circuit Economique dans le Cadre National,5,178,2,QROC,0.05,0.62,66.64,55,28,83,66,55,11,1.26,83.33,Facile,Facile,0,Meme Difficulté,Adapte,Economy
4621,2019,Economie,2,La Representation de l'Activite Economique: Le Circuit Economique,2,Le Circuit Economique dans le Cadre National,5,178,2,QROC,0.09,0.51,66.64,63,32,95,92,63,29,1.03,68.48,Facile,Facile,0,Meme Difficulté,Adapte,Economy
5732,2020,Economie,2,La Representation de l'Activite Economique: Le Circuit Economique,2,Le Circuit Economique dans le Cadre National,5,178,2,QROC,0.12,0.92,66.64,63,31,94,68,63,5,1.38,92.65,Facile,Facile,0,Meme Difficulté,Adapte,Economy
178,2015,Economie,2,La Representation de l'Activite Economique: Le Circuit Economique,2,Le Circuit Economique dans le Cadre National,5,179,3,QCU,0.7,0.29,1.44,1,41,42,30,1,29,1.4,3.33,Facile,Difficile,-2,Beaucoup plus Difficile,Pas Adapte,Economy
1289,2016,Economie,2,La Representation de l'Activite Economique: Le Circuit Economique,2,Le Circuit Economique dans le Cadre National,5,179,3,QCU,0.71,0.37,29.38,12,29,41,26,12,14,1.58,46.15,Facile,Difficile,-2,Beaucoup plus Difficile,Pas Adapte,Economy
2400,2017,Economie,2,La Representation de l'Activite Economique: Le Circuit Economique,2,Le Circuit Economique dans le Cadre National,5,179,3,QCU,0.35,0.55,47.25,17,18,35,20,17,3,1.75,85.0,Facile,Moyen,-1,Plus Difficile,Pas Adapte,Economy
3511,2018,Economie,2,La Representation de l'Activite Economique: Le Circuit Economique,2,Le Circuit Economique dans le Cadre National,5,179,3,QCU,0.06,0.81,71.54,24,10,34,30,24,6,1.13,80.0,Facile,Facile,0,Meme Difficulté,Adapte,Economy
4622,2019,Economie,2,La Representation de l'Activite Economique: Le Circuit Economique,2,Le Circuit Economique dans le Cadre National,5,179,3,QROC,0.09,0.77,71.54,23,9,32,28,23,5,1.14,82.14,Facile,Facile,0,Meme Difficulté,Adapte,Economy
5733,2020,Economie,2,La Representation de l'Activite Economique: Le Circuit Economique,2,Le Circuit Economique dans le Cadre National,5,179,3,QROC,0.12,0.83,71.54,21,8,29,29,21,8,1.0,72.41,Facile,Facile,0,Meme Difficulté,Adapte,Economy
179,2015,Economie,2,La Representation de l'Activite Economique: Le Circuit Economique,2,Le Circuit Economique dans le Cadre National,5,180,4,QCM,0.33,0.46,36.6,24,42,66,46,24,22,1.43,52.17,Moyen,Moyen,0,Meme Difficulté,Pas Adapte,Economy
1290,2016,Economie,2,La Representation de l'Activite Economique: Le Circuit Economique,2,Le Circuit Economique dans le Cadre National,5,180,4,QCM,0.03,0.96,70.72,41,17,58,58,41,17,1.0,70.69,Difficile,Facile,2,Beaucoup plus Facile,Adapte,Economy
2401,2017,Economie,2,La Representation de l'Activite Economique: Le Circuit Economique,2,Le Circuit Economique dans le Cadre National,5,180,4,QCU,0.01,0.93,70.72,36,15,51,39,36,3,1.31,92.31,Facile,Facile,0,Meme Difficulté,Adapte,Economy
3512,2018,Economie,2,La Representation de l'Activite Economique: Le Circuit Economique,2,Le Circuit Economique dans le Cadre National,5,180,4,QCU,0.07,0.83,70.72,30,13,43,34,30,4,1.26,88.24,Facile,Facile,0,Meme Difficulté,Adapte,Economy
4623,2019,Economie,2,La Representation de l'Activite Economique: Le Circuit Economique,2,Le Circuit Economique dans le Cadre National,5,180,4,QCU,0.07,0.86,70.72,33,13,46,39,33,6,1.18,84.62,Facile,Facile,0,Meme Difficulté,Adapte,Economy
5734,2020,Economie,2,La Representation de l'Activite Economique: Le Circuit Economique,2,Le Circuit Economique dans le Cadre National,5,180,4,QCU,0.09,0.93,70.72,32,13,45,41,32,9,1.1,78.05,Facile,Facile,0,Meme Difficulté,Adapte,Economy
180,2015,Economie,2,La Representation de l'Activite Economique: Le Circuit Economique,2,Le Circuit Economique dans le Cadre National,5,181,5,QCM,0.12,0.93,89.87,15,2,17,15,15,0,1.13,100.0,Facile,Facile,0,Meme Difficulté,Pas Adapte,Economy
1291,2016,Economie,2,La Representation de l'Activite Economique: Le Circuit Economique,2,Le Circuit Economique dans le Cadre National,5,181,5,QO,0.09,0.31,69.83,13,5,18,16,13,3,1.12,81.25,Facile,Facile,0,Meme Difficulté,Adapte,Economy
2402,2017,Economie,2,La Representation de l'Activite Economique: Le Circuit Economique,2,Le Circuit Economique dans le Cadre National,5,181,5,QROC,0.17,0.52,69.83,11,5,16,13,11,2,1.23,84.62,Facile,Facile,0,Meme Difficulté,Adapte,Economy
3513,2018,Economie,2,La Representation de l'Activite Economique: Le Circuit Economique,2,Le Circuit Economique dans le Cadre National,5,181,5,QROC,0.09,0.68,69.83,11,5,16,12,11,1,1.33,91.67,Facile,Facile,0,Meme Difficulté,Adapte,Economy
4624,2019,Economie,2,La Representation de l'Activite Economique: Le Circuit Economique,2,Le Circuit Economique dans le Cadre National,5,181,5,QROC,0.2,0.56,69.83,10,4,14,13,10,3,1.08,76.92,Facile,Facile,0,Meme Difficulté,Adapte,Economy
5735,2020,Economie,2,La Representation de l'Activite Economique: Le Circuit Economique,2,Le Circuit Economique dans le Cadre National,5,181,5,QROC,0.17,0.5,69.83,9,4,13,13,9,4,1.0,69.23,Facile,Facile,0,Meme Difficulté,Adapte,Economy
181,2015,Economie,2,La Representation de l'Activite Economique: Le Circuit Economique,3,Les Interdependances Economiques entre les Nations,7,182,1,QCM,0.28,0.6,57.27,5,3,8,8,5,3,1.0,62.5,Facile,Moyen,-1,Plus Difficile,Pas Adapte,Economy
1292,2016,Economie,2,La Representation de l'Activite Economique: Le Circuit Economique,3,Les Interdependances Economiques entre les Nations,7,182,1,QCM,0.1,0.86,82.34,7,2,9,7,7,0,1.29,100.0,Moyen,Facile,1,Plus Facile,Pas Adapte,Economy
2403,2017,Economie,2,La Representation de l'Activite Economique: Le Circuit Economique,3,Les Interdependances Economiques entre les Nations,7,182,1,QCM,0.16,0.95,75.83,6,2,8,7,6,1,1.14,85.71,Difficile,Facile,2,Beaucoup plus Facile,Pas Adapte,Economy
3514,2018,Economie,2,La Representation de l'Activite Economique: Le Circuit Economique,3,Les Interdependances Economiques entre les Nations,7,182,1,QCM,0.15,0.86,94.34,7,0,7,7,7,0,1.0,100.0,Moyen,Facile,1,Plus Facile,Pas Adapte,Economy
4625,2019,Economie,2,La Representation de l'Activite Economique: Le Circuit Economique,3,Les Interdependances Economiques entre les Nations,7,182,1,QCM,0.66,0.18,8.33,1,6,7,5,1,4,1.4,20.0,Facile,Difficile,-2,Beaucoup plus Difficile,Pas Adapte,Economy
5736,2020,Economie,2,La Representation de l'Activite Economique: Le Circuit Economique,3,Les Interdependances Economiques entre les Nations,7,182,1,QCM,0.6,0.28,15.89,1,7,8,5,1,4,1.6,20.0,Moyen,Difficile,-1,Plus Difficile,Pas Adapte,Economy
182,2015,Economie,2,La Representation de l'Activite Economique: Le Circuit Economique,3,Les Interdependances Economiques entre les Nations,7,183,2,QCU,0.06,0.9,72.97,39,14,53,43,39,4,1.23,90.7,Difficile,Facile,2,Beaucoup plus Facile,Adapte,Economy
1293,2016,Economie,2,La Representation de l'Activite Economique: Le Circuit Economique,3,Les Interdependances Economiques entre les Nations,7,183,2,QCU,0.12,0.99,72.97,34,12,46,40,34,6,1.15,85.0,Facile,Facile,0,Meme Difficulté,Adapte,Economy
2404,2017,Economie,2,La Representation de l'Activite Economique: Le Circuit Economique,3,Les Interdependances Economiques entre les Nations,7,183,2,QCU,0.07,0.86,72.97,34,12,46,41,34,7,1.12,82.93,Facile,Facile,0,Meme Difficulté,Adapte,Economy
3515,2018,Economie,2,La Representation de l'Activite Economique: Le Circuit Economique,3,Les Interdependances Economiques entre les Nations,7,183,2,QCU,0.06,0.85,72.97,38,14,52,42,38,4,1.24,90.48,Facile,Facile,0,Meme Difficulté,Adapte,Economy
4626,2019,Economie,2,La Representation de l'Activite Economique: Le Circuit Economique,3,Les Interdependances Economiques entre les Nations,7,183,2,QCU,0.16,0.9,72.97,39,15,54,47,39,8,1.15,82.98,Facile,Facile,0,Meme Difficulté,Adapte,Economy
5737,2020,Economie,2,La Representation de l'Activite Economique: Le Circuit Economique,3,Les Interdependances Economiques entre les Nations,7,183,2,QCU,0.12,0.94,72.97,34,13,47,37,34,3,1.27,91.89,Facile,Facile,0,Meme Difficulté,Adapte,Economy
183,2015,Economie,2,La Representation de l'Activite Economique: Le Circuit Economique,3,Les Interdependances Economiques entre les Nations,7,184,3,QCM,0.12,0.96,94.23,93,6,99,96,93,3,1.03,96.88,Moyen,Facile,1,Plus Facile,Pas Adapte,Economy
1294,2016,Economie,2,La Representation de l'Activite Economique: Le Circuit Economique,3,Les Interdependances Economiques entre les Nations,7,184,3,QCU,0.17,0.81,66.48,68,35,103,76,68,8,1.36,89.47,Facile,Facile,0,Meme Difficulté,Adapte,Economy
2405,2017,Economie,2,La Representation de l'Activite Economique: Le Circuit Economique,3,Les Interdependances Economiques entre les Nations,7,184,3,QROC,0.05,0.74,66.48,72,37,109,86,72,14,1.27,83.72,Facile,Facile,0,Meme Difficulté,Adapte,Economy
3516,2018,Economie,2,La Representation de l'Activite Economique: Le Circuit Economique,3,Les Interdependances Economiques entre les Nations,7,184,3,QROC,0.13,0.44,66.48,74,37,111,76,74,2,1.46,97.37,Facile,Facile,0,Meme Difficulté,Adapte,Economy
4627,2019,Economie,2,La Representation de l'Activite Economique: Le Circuit Economique,3,Les Interdependances Economiques entre les Nations,7,184,3,QROC,0.01,0.76,66.48,81,41,122,101,81,20,1.21,80.2,Facile,Facile,0,Meme Difficulté,Adapte,Economy
5738,2020,Economie,2,La Representation de l'Activite Economique: Le Circuit Economique,3,Les Interdependances Economiques entre les Nations,7,184,3,QROC,0.06,0.75,66.48,84,43,127,90,84,6,1.41,93.33,Facile,Facile,0,Meme Difficulté,Adapte,Economy
184,2015,Economie,2,La Representation de l'Activite Economique: Le Circuit Economique,3,Les Interdependances Economiques entre les Nations,7,185,4,QCU,0.59,0.29,27.51,10,26,36,36,10,26,1.0,27.78,Moyen,Difficile,-1,Plus Difficile,Pas Adapte,Economy
1295,2016,Economie,2,La Representation de l'Activite Economique: Le Circuit Economique,3,Les Interdependances Economiques entre les Nations,7,185,4,QCU,0.75,0.23,3.05,1,40,41,28,1,27,1.46,3.57,Moyen,Difficile,-1,Plus Difficile,Pas Adapte,Economy
2406,2017,Economie,2,La Representation de l'Activite Economique: Le Circuit Economique,3,Les Interdependances Economiques entre les Nations,7,185,4,QCU,0.44,0.31,33.06,12,24,36,25,12,13,1.44,48.0,Difficile,Difficile,0,Meme Difficulté,Pas Adapte,Economy
3517,2018,Economie,2,La Representation de l'Activite Economique: Le Circuit Economique,3,Les Interdependances Economiques entre les Nations,7,185,4,QCU,0.34,0.58,38.54,13,21,34,24,13,11,1.42,54.17,Facile,Moyen,-1,Plus Difficile,Pas Adapte,Economy
4628,2019,Economie,2,La Representation de l'Activite Economique: Le Circuit Economique,3,Les Interdependances Economiques entre les Nations,7,185,4,QCU,0.61,0.21,31.05,12,26,38,30,12,18,1.27,40.0,Facile,Difficile,-2,Beaucoup plus Difficile,Pas Adapte,Economy
5739,2020,Economie,2,La Representation de l'Activite Economique: Le Circuit Economique,3,Les Interdependances Economiques entre les Nations,7,185,4,QCU,0.1,0.81,93.61,33,2,35,34,33,1,1.03,97.06,Moyen,Facile,1,Plus Facile,Pas Adapte,Economy
185,2015,Economie,2,La Representation de l'Activite Economique: Le Circuit Economique,3,Les Interdependances Economiques entre les Nations,7,186,5,QCU,0.27,0.71,44.84,23,28,51,38,23,15,1.34,60.53,Facile,Moyen,-1,Plus Difficile,Pas Adapte,Economy
1296,2016,Economie,2,La Representation de l'Activite Economique: Le Circuit Economique,3,Les Interdependances Economiques entre les Nations,7,186,5,QCU,0.56,0.22,27.48,15,40,55,50,15,35,1.1,30.0,Difficile,Difficile,0,Meme Difficulté,Pas Adapte,Economy
2407,2017,Economie,2,La Representation de l'Activite Economique: Le Circuit Economique,3,Les Interdependances Economiques entre les Nations,7,186,5,QCU,0.1,0.99,67.51,35,17,52,45,35,10,1.16,77.78,Facile,Facile,0,Meme Difficulté,Adapte,Economy
3518,2018,Economie,2,La Representation de l'Activite Economique: Le Circuit Economique,3,Les Interdependances Economiques entre les Nations,7,186,5,QCU,0.17,0.95,67.51,32,16,48,44,32,12,1.09,72.73,Facile,Facile,0,Meme Difficulté,Adapte,Economy
4629,2019,Economie,2,La Representation de l'Activite Economique: Le Circuit Economique,3,Les Interdependances Economiques entre les Nations,7,186,5,QCU,0.08,0.78,67.51,37,18,55,52,37,15,1.06,71.15,Facile,Facile,0,Meme Difficulté,Adapte,Economy
5740,2020,Economie,2,La Representation de l'Activite Economique: Le Circuit Economique,3,Les Interdependances Economiques entre les Nations,7,186,5,QCU,0.18,0.99,67.51,41,20,61,55,41,14,1.11,74.55,Facile,Facile,0,Meme Difficulté,Adapte,Economy
186,2015,Economie,2,La Representation de l'Activite Economique: Le Circuit Economique,3,Les Interdependances Economiques entre les Nations,7,187,6,QCM,0.08,0.88,81.73,73,16,89,80,73,7,1.11,91.25,Moyen,Facile,1,Plus Facile,Pas Adapte,Economy
1297,2016,Economie,2,La Representation de l'Activite Economique: Le Circuit Economique,3,Les Interdependances Economiques entre les Nations,7,187,6,QCM,0.69,0.2,13.25,11,74,85,48,11,37,1.77,22.92,Moyen,Difficile,-1,Plus Difficile,Pas Adapte,Economy
2408,2017,Economie,2,La Representation de l'Activite Economique: Le Circuit Economique,3,Les Interdependances Economiques entre les Nations,7,187,6,QCM,0.09,0.75,79.17,71,19,90,82,71,11,1.1,86.59,Difficile,Facile,2,Beaucoup plus Facile,Pas Adapte,Economy
3519,2018,Economie,2,La Representation de l'Activite Economique: Le Circuit Economique,3,Les Interdependances Economiques entre les Nations,7,187,6,QCM,0.48,0.55,47.48,47,53,100,87,47,40,1.15,54.02,Difficile,Moyen,1,Plus Facile,Pas Adapte,Economy
4630,2019,Economie,2,La Representation de l'Activite Economique: Le Circuit Economique,3,Les Interdependances Economiques entre les Nations,7,187,6,QCM,0.33,0.63,59.99,61,40,101,76,61,15,1.33,80.26,Moyen,Moyen,0,Meme Difficulté,Pas Adapte,Economy
5741,2020,Economie,2,La Representation de l'Activite Economique: Le Circuit Economique,3,Les Interdependances Economiques entre les Nations,7,187,6,QCM,0.35,0.63,64.33,57,32,89,62,57,5,1.44,91.94,Facile,Moyen,-1,Plus Difficile,Adapte,Economy
187,2015,Economie,2,La Representation de l'Activite Economique: Le Circuit Economique,3,Les Interdependances Economiques entre les Nations,7,188,7,QCM,0.01,0.74,95.2,30,2,32,32,30,2,1.0,93.75,Facile,Facile,0,Meme Difficulté,Pas Adapte,Economy
1298,2016,Economie,2,La Representation de l'Activite Economique: Le Circuit Economique,3,Les Interdependances Economiques entre les Nations,7,188,7,QCM,0.78,0.28,1.53,0,30,30,29,0,29,1.03,0.0,Difficile,Difficile,0,Meme Difficulté,Pas Adapte,Economy
2409,2017,Economie,2,La Representation de l'Activite Economique: Le Circuit Economique,3,Les Interdependances Economiques entre les Nations,7,188,7,QCU,0.24,0.46,58.33,16,11,27,24,16,8,1.12,66.67,Facile,Moyen,-1,Plus Difficile,Pas Adapte,Economy
3520,2018,Economie,2,La Representation de l'Activite Economique: Le Circuit Economique,3,Les Interdependances Economiques entre les Nations,7,188,7,QCU,0.55,0.34,3.66,1,23,24,8,1,7,3.0,12.5,Facile,Difficile,-2,Beaucoup plus Difficile,Pas Adapte,Economy
4631,2019,Economie,2,La Representation de l'Activite Economique: Le Circuit Economique,3,Les Interdependances Economiques entre les Nations,7,188,7,QCU,0.45,0.35,21.11,4,16,20,10,4,6,2.0,40.0,Difficile,Difficile,0,Meme Difficulté,Pas Adapte,Economy
5742,2020,Economie,2,La Representation de l'Activite Economique: Le Circuit Economique,3,Les Interdependances Economiques entre les Nations,7,188,7,QO,0.76,0.01,21.79,5,17,22,19,5,14,1.16,26.32,Moyen,Difficile,-1,Plus Difficile,Pas Adapte,Economy
188,2015,Economie,3,La Production,1,La Notion de Production,9,189,1,QCU,0.22,0.51,50.41,13,12,25,17,13,4,1.47,76.47,Moyen,Moyen,0,Meme Difficulté,Pas Adapte,Economy
1299,2016,Economie,3,La Production,1,La Notion de Production,9,189,1,QCU,0.13,0.95,99.26,29,0,29,29,29,0,1.0,100.0,Difficile,Facile,2,Beaucoup plus Facile,Pas Adapte,Economy
2410,2017,Economie,3,La Production,1,La Notion de Production,9,189,1,QCU,0.13,0.84,69.79,23,10,33,26,23,3,1.27,88.46,Difficile,Facile,2,Beaucoup plus Facile,Adapte,Economy
3521,2018,Economie,3,La Production,1,La Notion de Production,9,189,1,QCU,0.16,0.85,69.79,21,9,30,28,21,7,1.07,75.0,Facile,Facile,0,Meme Difficulté,Adapte,Economy
4632,2019,Economie,3,La Production,1,La Notion de Production,9,189,1,QCU,0.04,0.91,69.79,19,8,27,24,19,5,1.12,79.17,Facile,Facile,0,Meme Difficulté,Adapte,Economy
5743,2020,Economie,3,La Production,1,La Notion de Production,9,189,1,QO,0.07,0.41,69.79,20,9,29,27,20,7,1.07,74.07,Facile,Facile,0,Meme Difficulté,Adapte,Economy
189,2015,Economie,3,La Production,1,La Notion de Production,9,190,2,QCU,0.32,0.74,46.27,39,46,85,82,39,43,1.04,47.56,Facile,Moyen,-1,Plus Difficile,Pas Adapte,Economy
1300,2016,Economie,3,La Production,1,La Notion de Production,9,190,2,QCU,0.62,0.3,0.13,0,93,93,52,0,52,1.79,0.0,Facile,Difficile,-2,Beaucoup plus Difficile,Pas Adapte,Economy
2411,2017,Economie,3,La Production,1,La Notion de Production,9,190,2,QCU,0.31,0.63,62.65,55,32,87,63,55,8,1.38,87.3,Facile,Moyen,-1,Plus Difficile,Adapte,Economy
3522,2018,Economie,3,La Production,1,La Notion de Production,9,190,2,QCU,0.29,0.58,62.65,54,32,86,61,54,7,1.41,88.52,Moyen,Moyen,0,Meme Difficulté,Adapte,Economy
4633,2019,Economie,3,La Production,1,La Notion de Production,9,190,2,QCU,0.37,0.5,62.65,48,28,76,51,48,3,1.49,94.12,Moyen,Moyen,0,Meme Difficulté,Adapte,Economy
5744,2020,Economie,3,La Production,1,La Notion de Production,9,190,2,QCU,0.22,0.74,62.65,46,28,74,69,46,23,1.07,66.67,Moyen,Moyen,0,Meme Difficulté,Adapte,Economy
190,2015,Economie,3,La Production,1,La Notion de Production,9,191,3,QCU,0.11,0.88,86.89,51,8,59,54,51,3,1.09,94.44,Moyen,Facile,1,Plus Facile,Pas Adapte,Economy
1301,2016,Economie,3,La Production,1,La Notion de Production,9,191,3,QCU,0.1,0.88,89.44,53,6,59,55,53,2,1.07,96.36,Difficile,Facile,2,Beaucoup plus Facile,Pas Adapte,Economy
2412,2017,Economie,3,La Production,1,La Notion de Production,9,191,3,QCU,0.55,0.3,5.37,3,50,53,45,3,42,1.18,6.67,Moyen,Difficile,-1,Plus Difficile,Pas Adapte,Economy
3523,2018,Economie,3,La Production,1,La Notion de Production,9,191,3,QCU,0.16,0.98,83.31,47,9,56,48,47,1,1.17,97.92,Moyen,Facile,1,Plus Facile,Pas Adapte,Economy
4634,2019,Economie,3,La Production,1,La Notion de Production,9,191,3,QCU,0.23,0.58,61.29,32,21,53,48,32,16,1.1,66.67,Facile,Moyen,-1,Plus Difficile,Adapte,Economy
5745,2020,Economie,3,La Production,1,La Notion de Production,9,191,3,QCU,0.27,0.59,61.29,30,19,49,43,30,13,1.14,69.77,Moyen,Moyen,0,Meme Difficulté,Adapte,Economy
191,2015,Economie,3,La Production,1,La Notion de Production,9,192,4,QCU,0.03,0.75,68.58,45,21,66,50,45,5,1.32,90.0,Moyen,Facile,1,Plus Facile,Adapte,Economy
1302,2016,Economie,3,La Production,1,La Notion de Production,9,192,4,QCU,0.01,0.97,68.58,39,18,57,40,39,1,1.43,97.5,Facile,Facile,0,Meme Difficulté,Adapte,Economy
2413,2017,Economie,3,La Production,1,La Notion de Production,9,192,4,QCM,0.18,0.98,68.58,38,17,55,43,38,5,1.28,88.37,Facile,Facile,0,Meme Difficulté,Adapte,Economy
3524,2018,Economie,3,La Production,1,La Notion de Production,9,192,4,QCM,0.06,0.97,68.58,34,15,49,37,34,3,1.32,91.89,Facile,Facile,0,Meme Difficulté,Adapte,Economy
4635,2019,Economie,3,La Production,1,La Notion de Production,9,192,4,QCM,0.09,0.81,68.58,29,14,43,33,29,4,1.3,87.88,Facile,Facile,0,Meme Difficulté,Adapte,Economy
5746,2020,Economie,3,La Production,1,La Notion de Production,9,192,4,QCM,0.18,0.8,68.58,32,14,46,41,32,9,1.12,78.05,Facile,Facile,0,Meme Difficulté,Adapte,Economy
192,2015,Economie,3,La Production,1,La Notion de Production,9,193,5,QCM,0.54,0.18,4.44,3,56,59,23,3,20,2.57,13.04,Facile,Difficile,-2,Beaucoup plus Difficile,Pas Adapte,Economy
1303,2016,Economie,3,La Production,1,La Notion de Production,9,193,5,QROC,0.75,0.12,30.31,16,36,52,27,16,11,1.93,59.26,Difficile,Difficile,0,Meme Difficulté,Pas Adapte,Economy
2414,2017,Economie,3,La Production,1,La Notion de Production,9,193,5,QROC,0.08,0.87,67.98,34,16,50,37,34,3,1.35,91.89,Difficile,Facile,2,Beaucoup plus Facile,Adapte,Economy
3525,2018,Economie,3,La Production,1,La Notion de Production,9,193,5,QROC,0.08,0.75,67.98,33,15,48,44,33,11,1.09,75.0,Facile,Facile,0,Meme Difficulté,Adapte,Economy
4636,2019,Economie,3,La Production,1,La Notion de Production,9,193,5,QROC,0.07,0.71,67.98,31,14,45,44,31,13,1.02,70.45,Facile,Facile,0,Meme Difficulté,Adapte,Economy
5747,2020,Economie,3,La Production,1,La Notion de Production,9,193,5,QROC,0.1,0.59,67.98,32,15,47,42,32,10,1.12,76.19,Facile,Facile,0,Meme Difficulté,Adapte,Economy
193,2015,Economie,3,La Production,1,La Notion de Production,9,194,6,QROC,0.86,0.24,13.98,11,66,77,66,11,55,1.17,16.67,Facile,Difficile,-2,Beaucoup plus Difficile,Pas Adapte,Economy
1304,2016,Economie,3,La Production,1,La Notion de Production,9,194,6,QROC,0.22,0.26,36.05,30,53,83,53,30,23,1.57,56.6,Facile,Moyen,-1,Plus Difficile,Pas Adapte,Economy
2415,2017,Economie,3,La Production,1,La Notion de Production,9,194,6,QROC,0.59,0.39,36.36,33,59,92,39,33,6,2.36,84.62,Difficile,Moyen,1,Plus Facile,Pas Adapte,Economy
3526,2018,Economie,3,La Production,1,La Notion de Production,9,194,6,QO,0.36,0.23,38.37,35,57,92,82,35,47,1.12,42.68,Difficile,Moyen,1,Plus Facile,Pas Adapte,Economy
4637,2019,Economie,3,La Production,1,La Notion de Production,9,194,6,QROC,0.15,0.42,92.35,83,7,90,87,83,4,1.03,95.4,Moyen,Facile,1,Plus Facile,Pas Adapte,Economy
5748,2020,Economie,3,La Production,1,La Notion de Production,9,194,6,QROC,0.11,0.94,80.97,62,14,76,72,62,10,1.06,86.11,Moyen,Facile,1,Plus Facile,Pas Adapte,Economy
194,2015,Economie,3,La Production,1,La Notion de Production,9,195,7,QCU,0.28,0.58,40.22,11,17,28,21,11,10,1.33,52.38,Moyen,Moyen,0,Meme Difficulté,Pas Adapte,Economy
1305,2016,Economie,3,La Production,1,La Notion de Production,9,195,7,QCU,0.55,0.39,7.14,2,22,24,15,2,13,1.6,13.33,Moyen,Difficile,-1,Plus Difficile,Pas Adapte,Economy
2416,2017,Economie,3,La Production,1,La Notion de Production,9,195,7,QCU,0.24,0.45,44.43,10,12,22,22,10,12,1.0,45.45,Moyen,Moyen,0,Meme Difficulté,Pas Adapte,Economy
3527,2018,Economie,3,La Production,1,La Notion de Production,9,195,7,QCU,0.34,0.58,60.96,12,8,20,12,12,0,1.67,100.0,Facile,Moyen,-1,Plus Difficile,Adapte,Economy
4638,2019,Economie,3,La Production,1,La Notion de Production,9,195,7,QCU,0.26,0.45,60.96,13,8,21,14,13,1,1.5,92.86,Moyen,Moyen,0,Meme Difficulté,Adapte,Economy
5749,2020,Economie,3,La Production,1,La Notion de Production,9,195,7,QCU,0.33,0.59,60.96,15,9,24,24,15,9,1.0,62.5,Moyen,Moyen,0,Meme Difficulté,Adapte,Economy
195,2015,Economie,3,La Production,1,La Notion de Production,9,196,8,QCM,0.3,0.34,36.26,12,21,33,24,12,12,1.38,50.0,Moyen,Moyen,0,Meme Difficulté,Pas Adapte,Economy
1306,2016,Economie,3,La Production,1,La Notion de Production,9,196,8,QCM,0.75,0.22,24.25,7,23,30,11,7,4,2.73,63.64,Facile,Difficile,-2,Beaucoup plus Difficile,Pas Adapte,Economy
2417,2017,Economie,3,La Production,1,La Notion de Production,9,196,8,QCU,0.2,0.64,51.18,14,13,27,14,14,0,1.93,100.0,Moyen,Moyen,0,Meme Difficulté,Pas Adapte,Economy
3528,2018,Economie,3,La Production,1,La Notion de Production,9,196,8,QCU,0.17,1.0,74.97,19,7,26,21,19,2,1.24,90.48,Facile,Facile,0,Meme Difficulté,Adapte,Economy
4639,2019,Economie,3,La Production,1,La Notion de Production,9,196,8,QCU,0.08,0.76,74.97,22,8,30,28,22,6,1.07,78.57,Facile,Facile,0,Meme Difficulté,Adapte,Economy
5750,2020,Economie,3,La Production,1,La Notion de Production,9,196,8,QCU,0.19,0.87,74.97,25,8,33,28,25,3,1.18,89.29,Facile,Facile,0,Meme Difficulté,Adapte,Economy
196,2015,Economie,3,La Production,1,La Notion de Production,9,197,9,QROC,0.21,0.34,42.67,6,8,14,9,6,3,1.56,66.67,Difficile,Moyen,1,Plus Facile,Pas Adapte,Economy
1307,2016,Economie,3,La Production,1,La Notion de Production,9,197,9,QROC,0.26,0.35,57.96,8,6,14,9,8,1,1.56,88.89,Facile,Moyen,-1,Plus Difficile,Pas Adapte,Economy
2418,2017,Economie,3,La Production,1,La Notion de Production,9,197,9,QROC,0.64,0.19,14.51,2,11,13,12,2,10,1.08,16.67,Facile,Difficile,-2,Beaucoup plus Difficile,Pas Adapte,Economy
3529,2018,Economie,3,La Production,1,La Notion de Production,9,197,9,QROC,0.3,0.38,54.34,8,7,15,11,8,3,1.36,72.73,Difficile,Moyen,1,Plus Facile,Pas Adapte,Economy
4640,2019,Economie,3,La Production,1,La Notion de Production,9,197,9,QROC,0.06,0.95,81.96,13,3,16,15,13,2,1.07,86.67,Difficile,Facile,2,Beaucoup plus Facile,Pas Adapte,Economy
5751,2020,Economie,3,La Production,1,La Notion de Production,9,197,9,QO,0.3,0.2,53.28,9,7,16,15,9,6,1.07,60.0,Facile,Moyen,-1,Plus Difficile,Pas Adapte,Economy
197,2015,Economie,3,La Production,2,L'Importance de la Production Marchande et de la Production Non-Marchande,7,198,1,QROC,0.64,0.12,34.82,27,51,78,37,27,10,2.11,72.97,Moyen,Difficile,-1,Plus Difficile,Pas Adapte,Economy
1308,2016,Economie,3,La Production,2,L'Importance de la Production Marchande et de la Production Non-Marchande,7,198,1,QROC,0.55,0.28,45.65,38,46,84,64,38,26,1.31,59.38,Moyen,Moyen,0,Meme Difficulté,Pas Adapte,Economy
2419,2017,Economie,3,La Production,2,L'Importance de la Production Marchande et de la Production Non-Marchande,7,198,1,QROC,0.13,0.73,99.5,73,0,73,73,73,0,1.0,100.0,Difficile,Facile,2,Beaucoup plus Facile,Pas Adapte,Economy
3530,2018,Economie,3,La Production,2,L'Importance de la Production Marchande et de la Production Non-Marchande,7,198,1,QROC,0.01,0.87,88.46,63,8,71,63,63,0,1.13,100.0,Moyen,Facile,1,Plus Facile,Pas Adapte,Economy
4641,2019,Economie,3,La Production,2,L'Importance de la Production Marchande et de la Production Non-Marchande,7,198,1,QROC,0.18,0.9,88.4,70,9,79,76,70,6,1.04,92.11,Facile,Facile,0,Meme Difficulté,Pas Adapte,Economy
5752,2020,Economie,3,La Production,2,L'Importance de la Production Marchande et de la Production Non-Marchande,7,198,1,QROC,0.01,0.57,70.05,61,26,87,63,61,2,1.38,96.83,Facile,Facile,0,Meme Difficulté,Adapte,Economy
198,2015,Economie,3,La Production,2,L'Importance de la Production Marchande et de la Production Non-Marchande,7,199,2,QCM,0.31,0.33,47.35,15,16,31,23,15,8,1.35,65.22,Difficile,Moyen,1,Plus Facile,Pas Adapte,Economy
1309,2016,Economie,3,La Production,2,L'Importance de la Production Marchande et de la Production Non-Marchande,7,199,2,QCM,0.5,0.18,31.2,10,21,31,25,10,15,1.24,40.0,Difficile,Difficile,0,Meme Difficulté,Pas Adapte,Economy
2420,2017,Economie,3,La Production,2,L'Importance de la Production Marchande et de la Production Non-Marchande,7,199,2,QCM,0.07,0.82,70.02,22,9,31,24,22,2,1.29,91.67,Difficile,Facile,2,Beaucoup plus Facile,Adapte,Economy
3531,2018,Economie,3,La Production,2,L'Importance de la Production Marchande et de la Production Non-Marchande,7,199,2,QCM,0.01,0.74,70.02,20,8,28,27,20,7,1.04,74.07,Facile,Facile,0,Meme Difficulté,Adapte,Economy
4642,2019,Economie,3,La Production,2,L'Importance de la Production Marchande et de la Production Non-Marchande,7,199,2,QCM,0.08,0.83,70.02,21,9,30,25,21,4,1.2,84.0,Facile,Facile,0,Meme Difficulté,Adapte,Economy
5753,2020,Economie,3,La Production,2,L'Importance de la Production Marchande et de la Production Non-Marchande,7,199,2,QCM,0.02,0.93,70.02,20,8,28,22,20,2,1.27,90.91,Facile,Facile,0,Meme Difficulté,Adapte,Economy
199,2015,Economie,3,La Production,2,L'Importance de la Production Marchande et de la Production Non-Marchande,7,200,3,QO,0.1,0.32,77.48,49,14,63,55,49,6,1.15,89.09,Moyen,Facile,1,Plus Facile,Pas Adapte,Economy
1310,2016,Economie,3,La Production,2,L'Importance de la Production Marchande et de la Production Non-Marchande,7,200,3,QO,0.31,0.18,37.7,25,41,66,49,25,24,1.35,51.02,Facile,Moyen,-1,Plus Difficile,Pas Adapte,Economy
2421,2017,Economie,3,La Production,2,L'Importance de la Production Marchande et de la Production Non-Marchande,7,200,3,QO,0.93,0.01,10.99,7,54,61,43,7,36,1.42,16.28,Moyen,Difficile,-1,Plus Difficile,Pas Adapte,Economy
3532,2018,Economie,3,La Production,2,L'Importance de la Production Marchande et de la Production Non-Marchande,7,200,3,QO,0.88,0.05,21.66,12,43,55,34,12,22,1.62,35.29,Facile,Difficile,-2,Beaucoup plus Difficile,Pas Adapte,Economy
4643,2019,Economie,3,La Production,2,L'Importance de la Production Marchande et de la Production Non-Marchande,7,200,3,QO,0.91,0.02,32.13,19,39,58,43,19,24,1.35,44.19,Facile,Difficile,-2,Beaucoup plus Difficile,Pas Adapte,Economy
5754,2020,Economie,3,La Production,2,L'Importance de la Production Marchande et de la Production Non-Marchande,7,200,3,QO,0.15,0.85,89.48,44,5,49,47,44,3,1.04,93.62,Moyen,Facile,1,Plus Facile,Pas Adapte,Economy
200,2015,Economie,3,La Production,2,L'Importance de la Production Marchande et de la Production Non-Marchande,7,201,4,QCM,0.65,0.2,6.51,1,11,12,11,1,10,1.09,9.09,Facile,Difficile,-2,Beaucoup plus Difficile,Pas Adapte,Economy
1311,2016,Economie,3,La Production,2,L'Importance de la Production Marchande et de la Production Non-Marchande,7,201,4,QCM,0.53,0.19,19.79,2,8,10,8,2,6,1.25,25.0,Facile,Difficile,-2,Beaucoup plus Difficile,Pas Adapte,Economy
2422,2017,Economie,3,La Production,2,L'Importance de la Production Marchande et de la Production Non-Marchande,7,201,4,QCM,0.36,0.33,39.76,4,6,10,5,4,1,2.0,80.0,Facile,Moyen,-1,Plus Difficile,Pas Adapte,Economy
3533,2018,Economie,3,La Production,2,L'Importance de la Production Marchande et de la Production Non-Marchande,7,201,4,QCM,0.25,0.3,56.95,7,5,12,8,7,1,1.5,87.5,Difficile,Moyen,1,Plus Facile,Pas Adapte,Economy
4644,2019,Economie,3,La Production,2,L'Importance de la Production Marchande et de la Production Non-Marchande,7,201,4,QCM,0.02,0.72,70.97,7,3,10,9,7,2,1.11,77.78,Difficile,Facile,2,Beaucoup plus Facile,Adapte,Economy
5755,2020,Economie,3,La Production,2,L'Importance de la Production Marchande et de la Production Non-Marchande,7,201,4,QCM,0.11,0.95,70.97,7,3,10,8,7,1,1.25,87.5,Facile,Facile,0,Meme Difficulté,Adapte,Economy
201,2015,Economie,3,La Production,2,L'Importance de la Production Marchande et de la Production Non-Marchande,7,202,5,QO,0.2,0.65,66.31,32,17,49,42,32,10,1.17,76.19,Difficile,Facile,2,Beaucoup plus Facile,Adapte,Economy
1312,2016,Economie,3,La Production,2,L'Importance de la Production Marchande et de la Production Non-Marchande,7,202,5,QO,0.08,0.47,66.31,29,14,43,41,29,12,1.05,70.73,Facile,Facile,0,Meme Difficulté,Adapte,Economy
2423,2017,Economie,3,La Production,2,L'Importance de la Production Marchande et de la Production Non-Marchande,7,202,5,QO,0.06,0.63,66.31,27,14,41,35,27,8,1.17,77.14,Facile,Facile,0,Meme Difficulté,Adapte,Economy
3534,2018,Economie,3,La Production,2,L'Importance de la Production Marchande et de la Production Non-Marchande,7,202,5,QO,0.18,0.8,66.31,23,12,35,32,23,9,1.09,71.88,Facile,Facile,0,Meme Difficulté,Adapte,Economy
4645,2019,Economie,3,La Production,2,L'Importance de la Production Marchande et de la Production Non-Marchande,7,202,5,QO,0.01,0.55,66.31,24,12,36,34,24,10,1.06,70.59,Facile,Facile,0,Meme Difficulté,Adapte,Economy
5756,2020,Economie,3,La Production,2,L'Importance de la Production Marchande et de la Production Non-Marchande,7,202,5,QO,0.14,0.7,66.31,21,11,32,32,21,11,1.0,65.62,Facile,Facile,0,Meme Difficulté,Adapte,Economy
202,2015,Economie,3,La Production,2,L'Importance de la Production Marchande et de la Production Non-Marchande,7,203,6,QCM,0.09,0.72,66.95,15,7,22,19,15,4,1.16,78.95,Facile,Facile,0,Meme Difficulté,Adapte,Economy
1313,2016,Economie,3,La Production,2,L'Importance de la Production Marchande et de la Production Non-Marchande,7,203,6,QCM,0.16,0.74,66.95,15,8,23,22,15,7,1.05,68.18,Facile,Facile,0,Meme Difficulté,Adapte,Economy
2424,2017,Economie,3,La Production,2,L'Importance de la Production Marchande et de la Production Non-Marchande,7,203,6,QCM,0.03,0.97,66.95,15,7,22,19,15,4,1.16,78.95,Facile,Facile,0,Meme Difficulté,Adapte,Economy
3535,2018,Economie,3,La Production,2,L'Importance de la Production Marchande et de la Production Non-Marchande,7,203,6,QCM,0.01,0.86,66.95,13,6,19,18,13,5,1.06,72.22,Facile,Facile,0,Meme Difficulté,Adapte,Economy
4646,2019,Economie,3,La Production,2,L'Importance de la Production Marchande et de la Production Non-Marchande,7,203,6,QROC,0.1,0.64,66.95,13,7,20,19,13,6,1.05,68.42,Facile,Facile,0,Meme Difficulté,Adapte,Economy
5757,2020,Economie,3,La Production,2,L'Importance de la Production Marchande et de la Production Non-Marchande,7,203,6,QROC,0.12,0.42,66.95,12,6,18,13,12,1,1.38,92.31,Facile,Facile,0,Meme Difficulté,Adapte,Economy
203,2015,Economie,3,La Production,2,L'Importance de la Production Marchande et de la Production Non-Marchande,7,204,7,QROC,0.33,0.29,43.53,25,32,57,36,25,11,1.58,69.44,Difficile,Moyen,1,Plus Facile,Pas Adapte,Economy
1314,2016,Economie,3,La Production,2,L'Importance de la Production Marchande et de la Production Non-Marchande,7,204,7,QROC,0.85,0.19,27.66,13,35,48,26,13,13,1.85,50.0,Facile,Difficile,-2,Beaucoup plus Difficile,Pas Adapte,Economy
2425,2017,Economie,3,La Production,2,L'Importance de la Production Marchande et de la Production Non-Marchande,7,204,7,QROC,0.98,0.14,9.79,5,42,47,21,5,16,2.24,23.81,Difficile,Difficile,0,Meme Difficulté,Pas Adapte,Economy
3536,2018,Economie,3,La Production,2,L'Importance de la Production Marchande et de la Production Non-Marchande,7,204,7,QROC,0.64,0.18,9.48,5,48,53,52,5,47,1.02,9.62,Moyen,Difficile,-1,Plus Difficile,Pas Adapte,Economy
4647,2019,Economie,3,La Production,2,L'Importance de la Production Marchande et de la Production Non-Marchande,7,204,7,QROC,0.05,0.67,95.56,48,2,50,49,48,1,1.02,97.96,Facile,Facile,0,Meme Difficulté,Pas Adapte,Economy
5758,2020,Economie,3,La Production,2,L'Importance de la Production Marchande et de la Production Non-Marchande,7,204,7,QO,0.76,0.0,4.93,2,47,49,28,2,26,1.75,7.14,Difficile,Difficile,0,Meme Difficulté,Pas Adapte,Economy
204,2015,Economie,3,La Production,3,Valeur Ajouee et Mesure de la Richesse,9,205,1,QROC,0.78,0.09,17.67,4,20,24,22,4,18,1.09,18.18,Moyen,Difficile,-1,Plus Difficile,Pas Adapte,Economy
1315,2016,Economie,3,La Production,3,Valeur Ajouee et Mesure de la Richesse,9,205,1,QO,0.08,0.78,97.79,23,1,24,23,23,0,1.04,100.0,Facile,Facile,0,Meme Difficulté,Pas Adapte,Economy
2426,2017,Economie,3,La Production,3,Valeur Ajouee et Mesure de la Richesse,9,205,1,QO,0.11,0.83,96.81,22,1,23,23,22,1,1.0,95.65,Facile,Facile,0,Meme Difficulté,Pas Adapte,Economy
3537,2018,Economie,3,La Production,3,Valeur Ajouee et Mesure de la Richesse,9,205,1,QO,0.51,0.26,56.73,11,9,20,17,11,6,1.18,64.71,Facile,Moyen,-1,Plus Difficile,Pas Adapte,Economy
4648,2019,Economie,3,La Production,3,Valeur Ajouee et Mesure de la Richesse,9,205,1,QO,0.77,0.12,29.77,7,16,23,13,7,6,1.77,53.85,Moyen,Difficile,-1,Plus Difficile,Pas Adapte,Economy
5759,2020,Economie,3,La Production,3,Valeur Ajouee et Mesure de la Richesse,9,205,1,QO,0.23,0.24,41.82,10,15,25,21,10,11,1.19,47.62,Moyen,Moyen,0,Meme Difficulté,Pas Adapte,Economy
205,2015,Economie,3,La Production,3,Valeur Ajouee et Mesure de la Richesse,9,206,2,QCM,0.23,0.38,63.66,7,4,11,10,7,3,1.1,70.0,Moyen,Moyen,0,Meme Difficulté,Adapte,Economy
1316,2016,Economie,3,La Production,3,Valeur Ajouee et Mesure de la Richesse,9,206,2,QCM,0.25,0.33,63.66,7,4,11,7,7,0,1.57,100.0,Moyen,Moyen,0,Meme Difficulté,Adapte,Economy
2427,2017,Economie,3,La Production,3,Valeur Ajouee et Mesure de la Richesse,9,206,2,QCM,0.39,0.52,63.66,6,4,10,9,6,3,1.11,66.67,Moyen,Moyen,0,Meme Difficulté,Adapte,Economy
3538,2018,Economie,3,La Production,3,Valeur Ajouee et Mesure de la Richesse,9,206,2,QCM,0.25,0.35,63.66,5,3,8,7,5,2,1.14,71.43,Moyen,Moyen,0,Meme Difficulté,Adapte,Economy
4649,2019,Economie,3,La Production,3,Valeur Ajouee et Mesure de la Richesse,9,206,2,QCM,0.34,0.42,63.66,6,3,9,6,6,0,1.5,100.0,Moyen,Moyen,0,Meme Difficulté,Adapte,Economy
5760,2020,Economie,3,La Production,3,Valeur Ajouee et Mesure de la Richesse,9,206,2,QCM,0.37,0.47,63.66,5,3,8,7,5,2,1.14,71.43,Moyen,Moyen,0,Meme Difficulté,Adapte,Economy
206,2015,Economie,3,La Production,3,Valeur Ajouee et Mesure de la Richesse,9,207,3,QCU,0.51,0.36,19.34,6,23,29,11,6,5,2.64,54.55,Difficile,Difficile,0,Meme Difficulté,Pas Adapte,Economy
1317,2016,Economie,3,La Production,3,Valeur Ajouee et Mesure de la Richesse,9,207,3,QCM,0.16,0.78,82.52,25,5,30,29,25,4,1.03,86.21,Moyen,Facile,1,Plus Facile,Pas Adapte,Economy
2428,2017,Economie,3,La Production,3,Valeur Ajouee et Mesure de la Richesse,9,207,3,QCM,0.75,0.28,25.68,8,22,30,30,8,22,1.0,26.67,Facile,Difficile,-2,Beaucoup plus Difficile,Pas Adapte,Economy
3539,2018,Economie,3,La Production,3,Valeur Ajouee et Mesure de la Richesse,9,207,3,QCM,0.6,0.3,26.34,8,24,32,21,8,13,1.52,38.1,Facile,Difficile,-2,Beaucoup plus Difficile,Pas Adapte,Economy
4650,2019,Economie,3,La Production,3,Valeur Ajouee et Mesure de la Richesse,9,207,3,QCM,0.36,0.62,58.81,17,12,29,19,17,2,1.53,89.47,Facile,Moyen,-1,Plus Difficile,Pas Adapte,Economy
5761,2020,Economie,3,La Production,3,Valeur Ajouee et Mesure de la Richesse,9,207,3,QCM,0.06,0.7,79.69,21,5,26,23,21,2,1.13,91.3,Moyen,Facile,1,Plus Facile,Pas Adapte,Economy
207,2015,Economie,3,La Production,3,Valeur Ajouee et Mesure de la Richesse,9,208,4,QO,0.11,0.35,90.65,86,9,95,87,86,1,1.09,98.85,Moyen,Facile,1,Plus Facile,Pas Adapte,Economy
1318,2016,Economie,3,La Production,3,Valeur Ajouee et Mesure de la Richesse,9,208,4,QO,0.31,0.27,57.68,55,41,96,71,55,16,1.35,77.46,Difficile,Moyen,1,Plus Facile,Pas Adapte,Economy
2429,2017,Economie,3,La Production,3,Valeur Ajouee et Mesure de la Richesse,9,208,4,QROC,0.14,0.58,82.23,88,19,107,101,88,13,1.06,87.13,Difficile,Facile,2,Beaucoup plus Facile,Pas Adapte,Economy
3540,2018,Economie,3,La Production,3,Valeur Ajouee et Mesure de la Richesse,9,208,4,QROC,0.04,1.0,73.07,80,30,110,108,80,28,1.02,74.07,Difficile,Facile,2,Beaucoup plus Facile,Adapte,Economy
4651,2019,Economie,3,La Production,3,Valeur Ajouee et Mesure de la Richesse,9,208,4,QROC,0.01,0.54,73.07,72,27,99,82,72,10,1.21,87.8,Facile,Facile,0,Meme Difficulté,Adapte,Economy
5762,2020,Economie,3,La Production,3,Valeur Ajouee et Mesure de la Richesse,9,208,4,QROC,0.19,0.9,73.07,82,30,112,93,82,11,1.2,88.17,Facile,Facile,0,Meme Difficulté,Adapte,Economy
208,2015,Economie,3,La Production,3,Valeur Ajouee et Mesure de la Richesse,9,209,5,QO,0.78,0.1,1.52,1,85,86,48,1,47,1.79,2.08,Difficile,Difficile,0,Meme Difficulté,Pas Adapte,Economy
1319,2016,Economie,3,La Production,3,Valeur Ajouee et Mesure de la Richesse,9,209,5,QO,0.61,0.15,52.56,39,35,74,46,39,7,1.61,84.78,Difficile,Moyen,1,Plus Facile,Pas Adapte,Economy
2430,2017,Economie,3,La Production,3,Valeur Ajouee et Mesure de la Richesse,9,209,5,QO,0.44,0.2,52.67,35,32,67,58,35,23,1.16,60.34,Moyen,Moyen,0,Meme Difficulté,Pas Adapte,Economy
3541,2018,Economie,3,La Production,3,Valeur Ajouee et Mesure de la Richesse,9,209,5,QO,1.0,0.13,25.2,16,46,62,43,16,27,1.44,37.21,Facile,Difficile,-2,Beaucoup plus Difficile,Pas Adapte,Economy
4652,2019,Economie,3,La Production,3,Valeur Ajouee et Mesure de la Richesse,9,209,5,QO,0.79,0.02,26.17,16,47,63,59,16,43,1.07,27.12,Moyen,Difficile,-1,Plus Difficile,Pas Adapte,Economy
5763,2020,Economie,3,La Production,3,Valeur Ajouee et Mesure de la Richesse,9,209,5,QO,0.6,0.29,45.79,27,31,58,33,27,6,1.76,81.82,Facile,Moyen,-1,Plus Difficile,Pas Adapte,Economy
209,2015,Economie,3,La Production,3,Valeur Ajouee et Mesure de la Richesse,9,210,6,QCU,0.5,0.29,17.85,13,61,74,29,13,16,2.55,44.83,Moyen,Difficile,-1,Plus Difficile,Pas Adapte,Economy
1320,2016,Economie,3,La Production,3,Valeur Ajouee et Mesure de la Richesse,9,210,6,QCU,0.17,0.95,88.95,71,9,80,77,71,6,1.04,92.21,Moyen,Facile,1,Plus Facile,Pas Adapte,Economy
2431,2017,Economie,3,La Production,3,Valeur Ajouee et Mesure de la Richesse,9,210,6,QCU,0.1,0.89,74.37,51,18,69,66,51,15,1.05,77.27,Moyen,Facile,1,Plus Facile,Adapte,Economy
3542,2018,Economie,3,La Production,3,Valeur Ajouee et Mesure de la Richesse,9,210,6,QCU,0.04,0.94,74.37,54,19,73,67,54,13,1.09,80.6,Facile,Facile,0,Meme Difficulté,Adapte,Economy
4653,2019,Economie,3,La Production,3,Valeur Ajouee et Mesure de la Richesse,9,210,6,QCU,0.03,0.97,74.37,62,22,84,84,62,22,1.0,73.81,Facile,Facile,0,Meme Difficulté,Adapte,Economy
5764,2020,Economie,3,La Production,3,Valeur Ajouee et Mesure de la Richesse,9,210,6,QCU,0.17,0.76,74.37,71,25,96,85,71,14,1.13,83.53,Facile,Facile,0,Meme Difficulté,Adapte,Economy
210,2015,Economie,3,La Production,3,Valeur Ajouee et Mesure de la Richesse,9,211,7,QCM,0.72,0.22,0.93,0,10,10,3,0,3,3.33,0.0,Moyen,Difficile,-1,Plus Difficile,Pas Adapte,Economy
1321,2016,Economie,3,La Production,3,Valeur Ajouee et Mesure de la Richesse,9,211,7,QCM,0.2,0.76,93.15,10,1,11,11,10,1,1.0,90.91,Moyen,Facile,1,Plus Facile,Pas Adapte,Economy
2432,2017,Economie,3,La Production,3,Valeur Ajouee et Mesure de la Richesse,9,211,7,QCM,0.47,0.37,63.2,7,4,11,11,7,4,1.0,63.64,Difficile,Moyen,1,Plus Facile,Adapte,Economy
3543,2018,Economie,3,La Production,3,Valeur Ajouee et Mesure de la Richesse,9,211,7,QCM,0.49,0.42,63.2,8,4,12,8,8,0,1.5,100.0,Moyen,Moyen,0,Meme Difficulté,Adapte,Economy
4654,2019,Economie,3,La Production,3,Valeur Ajouee et Mesure de la Richesse,9,211,7,QCM,0.36,0.56,63.2,8,4,12,12,8,4,1.0,66.67,Moyen,Moyen,0,Meme Difficulté,Adapte,Economy
5765,2020,Economie,3,La Production,3,Valeur Ajouee et Mesure de la Richesse,9,211,7,QCM,0.22,0.44,63.2,7,4,11,8,7,1,1.38,87.5,Moyen,Moyen,0,Meme Difficulté,Adapte,Economy
211,2015,Economie,3,La Production,3,Valeur Ajouee et Mesure de la Richesse,9,212,8,QCU,0.46,0.28,24.04,13,42,55,46,13,33,1.2,28.26,Moyen,Difficile,-1,Plus Difficile,Pas Adapte,Economy
1322,2016,Economie,3,La Production,3,Valeur Ajouee et Mesure de la Richesse,9,212,8,QCU,0.51,0.31,34.98,22,40,62,25,22,3,2.48,88.0,Difficile,Difficile,0,Meme Difficulté,Pas Adapte,Economy
2433,2017,Economie,3,La Production,3,Valeur Ajouee et Mesure de la Richesse,9,212,8,QCU,0.28,0.58,47.11,27,31,58,41,27,14,1.41,65.85,Facile,Moyen,-1,Plus Difficile,Pas Adapte,Economy
3544,2018,Economie,3,La Production,3,Valeur Ajouee et Mesure de la Richesse,9,212,8,QCU,0.3,0.54,39.74,24,37,61,39,24,15,1.56,61.54,Difficile,Moyen,1,Plus Facile,Pas Adapte,Economy
4655,2019,Economie,3,La Production,3,Valeur Ajouee et Mesure de la Richesse,9,212,8,QCU,0.22,0.54,47.03,26,30,56,54,26,28,1.04,48.15,Facile,Moyen,-1,Plus Difficile,Pas Adapte,Economy
5766,2020,Economie,3,La Production,3,Valeur Ajouee et Mesure de la Richesse,9,212,8,QCU,0.39,0.57,38.51,23,38,61,44,23,21,1.39,52.27,Difficile,Moyen,1,Plus Facile,Pas Adapte,Economy
212,2015,Economie,3,La Production,3,Valeur Ajouee et Mesure de la Richesse,9,213,9,QO,0.94,0.07,1.92,0,24,24,19,0,19,1.26,0.0,Difficile,Difficile,0,Meme Difficulté,Pas Adapte,Economy
1323,2016,Economie,3,La Production,3,Valeur Ajouee et Mesure de la Richesse,9,213,9,QO,0.17,0.52,73.2,16,6,22,19,16,3,1.16,84.21,Difficile,Facile,2,Beaucoup plus Facile,Adapte,Economy
2434,2017,Economie,3,La Production,3,Valeur Ajouee et Mesure de la Richesse,9,213,9,QO,0.07,0.64,73.2,15,6,21,15,15,0,1.4,100.0,Facile,Facile,0,Meme Difficulté,Adapte,Economy
3545,2018,Economie,3,La Production,3,Valeur Ajouee et Mesure de la Richesse,9,213,9,QO,0.13,0.39,73.2,16,6,22,16,16,0,1.38,100.0,Facile,Facile,0,Meme Difficulté,Adapte,Economy
4656,2019,Economie,3,La Production,3,Valeur Ajouee et Mesure de la Richesse,9,213,9,QO,0.15,0.32,73.2,18,6,24,23,18,5,1.04,78.26,Facile,Facile,0,Meme Difficulté,Adapte,Economy
5767,2020,Economie,3,La Production,3,Valeur Ajouee et Mesure de la Richesse,9,213,9,QO,0.19,0.9,73.2,15,6,21,19,15,4,1.11,78.95,Facile,Facile,0,Meme Difficulté,Adapte,Economy
213,2015,Economie,3,La Production,4,Les Limites de la Mesure de la Production,6,214,1,QCU,0.14,0.97,96.24,38,2,40,40,38,2,1.0,95.0,Difficile,Facile,2,Beaucoup plus Facile,Pas Adapte,Economy
1324,2016,Economie,3,La Production,4,Les Limites de la Mesure de la Production,6,214,1,QO,0.85,0.03,22.3,9,30,39,34,9,25,1.15,26.47,Facile,Difficile,-2,Beaucoup plus Difficile,Pas Adapte,Economy
2435,2017,Economie,3,La Production,4,Les Limites de la Mesure de la Production,6,214,1,QO,0.03,0.71,70.09,25,10,35,34,25,9,1.03,73.53,Moyen,Facile,1,Plus Facile,Adapte,Economy
3546,2018,Economie,3,La Production,4,Les Limites de la Mesure de la Production,6,214,1,QO,0.16,0.31,70.09,25,10,35,26,25,1,1.35,96.15,Facile,Facile,0,Meme Difficulté,Adapte,Economy
4657,2019,Economie,3,La Production,4,Les Limites de la Mesure de la Production,6,214,1,QO,0.07,0.46,70.09,22,9,31,22,22,0,1.41,100.0,Facile,Facile,0,Meme Difficulté,Adapte,Economy
5768,2020,Economie,3,La Production,4,Les Limites de la Mesure de la Production,6,214,1,QO,0.08,0.63,70.09,25,11,36,33,25,8,1.09,75.76,Facile,Facile,0,Meme Difficulté,Adapte,Economy
214,2015,Economie,3,La Production,4,Les Limites de la Mesure de la Production,6,215,2,QCM,0.11,0.76,74.94,43,15,58,52,43,9,1.12,82.69,Difficile,Facile,2,Beaucoup plus Facile,Adapte,Economy
1325,2016,Economie,3,La Production,4,Les Limites de la Mesure de la Production,6,215,2,QCM,0.11,0.8,74.94,44,15,59,45,44,1,1.31,97.78,Facile,Facile,0,Meme Difficulté,Adapte,Economy
2436,2017,Economie,3,La Production,4,Les Limites de la Mesure de la Production,6,215,2,QCM,0.13,0.93,74.94,38,13,51,48,38,10,1.06,79.17,Facile,Facile,0,Meme Difficulté,Adapte,Economy
3547,2018,Economie,3,La Production,4,Les Limites de la Mesure de la Production,6,215,2,QCM,0.17,0.77,74.94,37,12,49,45,37,8,1.09,82.22,Facile,Facile,0,Meme Difficulté,Adapte,Economy
4658,2019,Economie,3,La Production,4,Les Limites de la Mesure de la Production,6,215,2,QCM,0.08,0.75,74.94,31,11,42,35,31,4,1.2,88.57,Facile,Facile,0,Meme Difficulté,Adapte,Economy
5769,2020,Economie,3,La Production,4,Les Limites de la Mesure de la Production,6,215,2,QCM,0.17,0.85,74.94,33,11,44,40,33,7,1.1,82.5,Facile,Facile,0,Meme Difficulté,Adapte,Economy
215,2015,Economie,3,La Production,4,Les Limites de la Mesure de la Production,6,216,3,QCM,0.31,0.69,48.16,28,31,59,38,28,10,1.55,73.68,Facile,Moyen,-1,Plus Difficile,Pas Adapte,Economy
1326,2016,Economie,3,La Production,4,Les Limites de la Mesure de la Production,6,216,3,QCM,0.07,0.83,83.82,49,9,58,54,49,5,1.07,90.74,Difficile,Facile,2,Beaucoup plus Facile,Pas Adapte,Economy
2437,2017,Economie,3,La Production,4,Les Limites de la Mesure de la Production,6,216,3,QO,0.79,0.04,15.5,10,56,66,51,10,41,1.29,19.61,Difficile,Difficile,0,Meme Difficulté,Pas Adapte,Economy
3548,2018,Economie,3,La Production,4,Les Limites de la Mesure de la Production,6,216,3,QO,0.65,0.24,40.23,29,43,72,62,29,33,1.16,46.77,Moyen,Moyen,0,Meme Difficulté,Pas Adapte,Economy
4659,2019,Economie,3,La Production,4,Les Limites de la Mesure de la Production,6,216,3,QO,0.87,0.01,30.48,22,49,71,61,22,39,1.16,36.07,Difficile,Difficile,0,Meme Difficulté,Pas Adapte,Economy
5770,2020,Economie,3,La Production,4,Les Limites de la Mesure de la Production,6,216,3,QO,0.67,0.19,39.96,25,37,62,56,25,31,1.11,44.64,Moyen,Moyen,0,Meme Difficulté,Pas Adapte,Economy
216,2015,Economie,3,La Production,4,Les Limites de la Mesure de la Production,6,217,4,QCU,0.67,0.21,9.83,6,50,56,21,6,15,2.67,28.57,Difficile,Difficile,0,Meme Difficulté,Pas Adapte,Economy
1327,2016,Economie,3,La Production,4,Les Limites de la Mesure de la Production,6,217,4,QCU,0.53,0.21,20.12,12,48,60,28,12,16,2.14,42.86,Difficile,Difficile,0,Meme Difficulté,Pas Adapte,Economy
2438,2017,Economie,3,La Production,4,Les Limites de la Mesure de la Production,6,217,4,QCU,0.69,0.22,27.57,17,43,60,25,17,8,2.4,68.0,Difficile,Difficile,0,Meme Difficulté,Pas Adapte,Economy
3549,2018,Economie,3,La Production,4,Les Limites de la Mesure de la Production,6,217,4,QCU,0.22,0.63,62.7,33,19,52,36,33,3,1.44,91.67,Facile,Moyen,-1,Plus Difficile,Adapte,Economy
4660,2019,Economie,3,La Production,4,Les Limites de la Mesure de la Production,6,217,4,QCM,0.27,0.36,62.7,30,18,48,48,30,18,1.0,62.5,Moyen,Moyen,0,Meme Difficulté,Adapte,Economy
5771,2020,Economie,3,La Production,4,Les Limites de la Mesure de la Production,6,217,4,QCM,0.37,0.67,62.7,33,20,53,46,33,13,1.15,71.74,Moyen,Moyen,0,Meme Difficulté,Adapte,Economy
217,2015,Economie,3,La Production,4,Les Limites de la Mesure de la Production,6,218,5,QROC,0.79,0.21,13.44,3,19,22,20,3,17,1.1,15.0,Facile,Difficile,-2,Beaucoup plus Difficile,Pas Adapte,Economy
1328,2016,Economie,3,La Production,4,Les Limites de la Mesure de la Production,6,218,5,QROC,0.13,0.47,88.4,20,3,23,21,20,1,1.1,95.24,Facile,Facile,0,Meme Difficulté,Pas Adapte,Economy
2439,2017,Economie,3,La Production,4,Les Limites de la Mesure de la Production,6,218,5,QROC,0.06,0.53,95.38,25,1,26,26,25,1,1.0,96.15,Difficile,Facile,2,Beaucoup plus Facile,Pas Adapte,Economy
3550,2018,Economie,3,La Production,4,Les Limites de la Mesure de la Production,6,218,5,QROC,0.74,0.24,22.02,6,20,26,22,6,16,1.18,27.27,Facile,Difficile,-2,Beaucoup plus Difficile,Pas Adapte,Economy
4661,2019,Economie,3,La Production,4,Les Limites de la Mesure de la Production,6,218,5,QROC,0.42,0.36,57.21,17,13,30,22,17,5,1.36,77.27,Difficile,Moyen,1,Plus Facile,Pas Adapte,Economy
5772,2020,Economie,3,La Production,4,Les Limites de la Mesure de la Production,6,218,5,QROC,0.87,0.25,26.87,7,20,27,26,7,19,1.04,26.92,Moyen,Difficile,-1,Plus Difficile,Pas Adapte,Economy
218,2015,Economie,3,La Production,4,Les Limites de la Mesure de la Production,6,219,6,QROC,0.64,0.13,24.88,10,32,42,38,10,28,1.11,26.32,Difficile,Difficile,0,Meme Difficulté,Pas Adapte,Economy
1329,2016,Economie,3,La Production,4,Les Limites de la Mesure de la Production,6,219,6,QROC,0.24,0.34,42.08,18,24,42,25,18,7,1.68,72.0,Facile,Moyen,-1,Plus Difficile,Pas Adapte,Economy
2440,2017,Economie,3,La Production,4,Les Limites de la Mesure de la Production,6,219,6,QROC,0.9,0.08,26.4,11,29,40,39,11,28,1.03,28.21,Facile,Difficile,-2,Beaucoup plus Difficile,Pas Adapte,Economy
3551,2018,Economie,3,La Production,4,Les Limites de la Mesure de la Production,6,219,6,QROC,0.54,0.32,35.06,14,25,39,33,14,19,1.18,42.42,Facile,Moyen,-1,Plus Difficile,Pas Adapte,Economy
4662,2019,Economie,3,La Production,4,Les Limites de la Mesure de la Production,6,219,6,QROC,0.73,0.13,18.18,8,34,42,26,8,18,1.62,30.77,Facile,Difficile,-2,Beaucoup plus Difficile,Pas Adapte,Economy
5773,2020,Economie,3,La Production,4,Les Limites de la Mesure de la Production,6,219,6,QROC,0.16,0.79,80.68,35,8,43,41,35,6,1.05,85.37,Difficile,Facile,2,Beaucoup plus Facile,Pas Adapte,Economy
219,2015,Economie,4,Le Travail,1,Les Aspects Quantitatifs et Qualitatifs du Travail,8,220,1,QCU,0.67,0.3,8.3,2,27,29,25,2,23,1.16,8.0,Difficile,Difficile,0,Meme Difficulté,Pas Adapte,Economy
1330,2016,Economie,4,Le Travail,1,Les Aspects Quantitatifs et Qualitatifs du Travail,8,220,1,QCU,0.03,0.83,67.87,22,10,32,22,22,0,1.45,100.0,Difficile,Facile,2,Beaucoup plus Facile,Adapte,Economy
2441,2017,Economie,4,Le Travail,1,Les Aspects Quantitatifs et Qualitatifs du Travail,8,220,1,QCU,0.16,0.96,67.87,20,9,29,21,20,1,1.38,95.24,Facile,Facile,0,Meme Difficulté,Adapte,Economy
3552,2018,Economie,4,Le Travail,1,Les Aspects Quantitatifs et Qualitatifs du Travail,8,220,1,QCU,0.18,0.97,67.87,18,9,27,23,18,5,1.17,78.26,Facile,Facile,0,Meme Difficulté,Adapte,Economy
4663,2019,Economie,4,Le Travail,1,Les Aspects Quantitatifs et Qualitatifs du Travail,8,220,1,QCU,0.11,0.93,67.87,18,8,26,23,18,5,1.13,78.26,Facile,Facile,0,Meme Difficulté,Adapte,Economy
5774,2020,Economie,4,Le Travail,1,Les Aspects Quantitatifs et Qualitatifs du Travail,8,220,1,QCU,0.09,0.85,67.87,16,7,23,18,16,2,1.28,88.89,Facile,Facile,0,Meme Difficulté,Adapte,Economy
220,2015,Economie,4,Le Travail,1,Les Aspects Quantitatifs et Qualitatifs du Travail,8,221,2,QCU,0.04,0.98,97.89,83,2,85,85,83,2,1.0,97.65,Difficile,Facile,2,Beaucoup plus Facile,Pas Adapte,Economy
1331,2016,Economie,4,Le Travail,1,Les Aspects Quantitatifs et Qualitatifs du Travail,8,221,2,QCU,0.2,0.88,68.51,52,24,76,71,52,19,1.07,73.24,Moyen,Facile,1,Plus Facile,Adapte,Economy
2442,2017,Economie,4,Le Travail,1,Les Aspects Quantitatifs et Qualitatifs du Travail,8,221,2,QCU,0.04,0.94,68.51,58,26,84,80,58,22,1.05,72.5,Facile,Facile,0,Meme Difficulté,Adapte,Economy
3553,2018,Economie,4,Le Travail,1,Les Aspects Quantitatifs et Qualitatifs du Travail,8,221,2,QCU,0.07,0.84,68.51,58,27,85,73,58,15,1.16,79.45,Facile,Facile,0,Meme Difficulté,Adapte,Economy
4664,2019,Economie,4,Le Travail,1,Les Aspects Quantitatifs et Qualitatifs du Travail,8,221,2,QCU,0.16,0.81,68.51,59,27,86,73,59,14,1.18,80.82,Facile,Facile,0,Meme Difficulté,Adapte,Economy
5775,2020,Economie,4,Le Travail,1,Les Aspects Quantitatifs et Qualitatifs du Travail,8,221,2,QCU,0.0,0.99,68.51,66,30,96,91,66,25,1.05,72.53,Facile,Facile,0,Meme Difficulté,Adapte,Economy
221,2015,Economie,4,Le Travail,1,Les Aspects Quantitatifs et Qualitatifs du Travail,8,222,3,QCU,0.49,0.21,30.53,21,49,70,49,21,28,1.43,42.86,Facile,Difficile,-2,Beaucoup plus Difficile,Pas Adapte,Economy
1332,2016,Economie,4,Le Travail,1,Les Aspects Quantitatifs et Qualitatifs du Travail,8,222,3,QCU,0.01,0.81,72.79,52,19,71,61,52,9,1.16,85.25,Facile,Facile,0,Meme Difficulté,Adapte,Economy
2443,2017,Economie,4,Le Travail,1,Les Aspects Quantitatifs et Qualitatifs du Travail,8,222,3,QCU,0.04,0.77,72.79,55,21,76,61,55,6,1.25,90.16,Facile,Facile,0,Meme Difficulté,Adapte,Economy
3554,2018,Economie,4,Le Travail,1,Les Aspects Quantitatifs et Qualitatifs du Travail,8,222,3,QCU,0.08,0.87,72.79,47,18,65,50,47,3,1.3,94.0,Facile,Facile,0,Meme Difficulté,Adapte,Economy
4665,2019,Economie,4,Le Travail,1,Les Aspects Quantitatifs et Qualitatifs du Travail,8,222,3,QCU,0.16,0.94,72.79,44,17,61,58,44,14,1.05,75.86,Facile,Facile,0,Meme Difficulté,Adapte,Economy
5776,2020,Economie,4,Le Travail,1,Les Aspects Quantitatifs et Qualitatifs du Travail,8,222,3,QCU,0.16,0.95,72.79,47,17,64,62,47,15,1.03,75.81,Facile,Facile,0,Meme Difficulté,Adapte,Economy
222,2015,Economie,4,Le Travail,1,Les Aspects Quantitatifs et Qualitatifs du Travail,8,223,4,QROC,0.87,0.24,13.46,2,11,13,11,2,9,1.18,18.18,Moyen,Difficile,-1,Plus Difficile,Pas Adapte,Economy
1333,2016,Economie,4,Le Travail,1,Les Aspects Quantitatifs et Qualitatifs du Travail,8,223,4,QROC,0.78,0.04,20.39,2,10,12,9,2,7,1.33,22.22,Facile,Difficile,-2,Beaucoup plus Difficile,Pas Adapte,Economy
2444,2017,Economie,4,Le Travail,1,Les Aspects Quantitatifs et Qualitatifs du Travail,8,223,4,QROC,0.0,0.58,99.52,12,0,12,12,12,0,1.0,100.0,Moyen,Facile,1,Plus Facile,Pas Adapte,Economy
3555,2018,Economie,4,Le Travail,1,Les Aspects Quantitatifs et Qualitatifs du Travail,8,223,4,QROC,0.75,0.05,14.15,2,10,12,11,2,9,1.09,18.18,Facile,Difficile,-2,Beaucoup plus Difficile,Pas Adapte,Economy
4666,2019,Economie,4,Le Travail,1,Les Aspects Quantitatifs et Qualitatifs du Travail,8,223,4,QROC,0.96,0.19,33.52,4,9,13,11,4,7,1.18,36.36,Difficile,Difficile,0,Meme Difficulté,Pas Adapte,Economy
5777,2020,Economie,4,Le Travail,1,Les Aspects Quantitatifs et Qualitatifs du Travail,8,223,4,QROC,0.16,0.62,73.67,10,4,14,13,10,3,1.08,76.92,Moyen,Facile,1,Plus Facile,Adapte,Economy
223,2015,Economie,4,Le Travail,1,Les Aspects Quantitatifs et Qualitatifs du Travail,8,224,5,QCM,0.32,0.37,60.5,39,26,65,51,39,12,1.27,76.47,Moyen,Moyen,0,Meme Difficulté,Adapte,Economy
1334,2016,Economie,4,Le Travail,1,Les Aspects Quantitatifs et Qualitatifs du Travail,8,224,5,QCU,0.32,0.52,60.5,42,27,69,69,42,27,1.0,60.87,Moyen,Moyen,0,Meme Difficulté,Adapte,Economy
2445,2017,Economie,4,Le Travail,1,Les Aspects Quantitatifs et Qualitatifs du Travail,8,224,5,QCU,0.26,0.58,60.5,47,31,78,66,47,19,1.18,71.21,Moyen,Moyen,0,Meme Difficulté,Adapte,Economy
3556,2018,Economie,4,Le Travail,1,Les Aspects Quantitatifs et Qualitatifs du Travail,8,224,5,QCU,0.28,0.41,60.5,51,33,84,79,51,28,1.06,64.56,Moyen,Moyen,0,Meme Difficulté,Adapte,Economy
4667,2019,Economie,4,Le Travail,1,Les Aspects Quantitatifs et Qualitatifs du Travail,8,224,5,QCU,0.24,0.48,60.5,44,28,72,54,44,10,1.33,81.48,Moyen,Moyen,0,Meme Difficulté,Adapte,Economy
5778,2020,Economie,4,Le Travail,1,Les Aspects Quantitatifs et Qualitatifs du Travail,8,224,5,QCU,0.32,0.65,60.5,45,29,74,66,45,21,1.12,68.18,Moyen,Moyen,0,Meme Difficulté,Adapte,Economy
224,2015,Economie,4,Le Travail,1,Les Aspects Quantitatifs et Qualitatifs du Travail,8,225,6,QCU,0.17,0.75,86.23,53,8,61,57,53,4,1.07,92.98,Moyen,Facile,1,Plus Facile,Pas Adapte,Economy
1335,2016,Economie,4,Le Travail,1,Les Aspects Quantitatifs et Qualitatifs du Travail,8,225,6,QCU,0.17,1.0,100.0,58,0,58,58,58,0,1.0,100.0,Facile,Facile,0,Meme Difficulté,Pas Adapte,Economy
2446,2017,Economie,4,Le Travail,1,Les Aspects Quantitatifs et Qualitatifs du Travail,8,225,6,QCU,0.47,0.32,24.57,14,45,59,41,14,27,1.44,34.15,Facile,Difficile,-2,Beaucoup plus Difficile,Pas Adapte,Economy
3557,2018,Economie,4,Le Travail,1,Les Aspects Quantitatifs et Qualitatifs du Travail,8,225,6,QCU,0.14,0.99,99.64,58,0,58,58,58,0,1.0,100.0,Moyen,Facile,1,Plus Facile,Pas Adapte,Economy
4668,2019,Economie,4,Le Travail,1,Les Aspects Quantitatifs et Qualitatifs du Travail,8,225,6,QCU,0.21,0.73,43.08,25,34,59,48,25,23,1.23,52.08,Difficile,Moyen,1,Plus Facile,Pas Adapte,Economy
5779,2020,Economie,4,Le Travail,1,Les Aspects Quantitatifs et Qualitatifs du Travail,8,225,6,QCM,0.09,0.86,81.2,45,11,56,54,45,9,1.04,83.33,Facile,Facile,0,Meme Difficulté,Pas Adapte,Economy
225,2015,Economie,4,Le Travail,1,Les Aspects Quantitatifs et Qualitatifs du Travail,8,226,7,QCU,0.55,0.26,2.98,0,14,14,6,0,6,2.33,0.0,Difficile,Difficile,0,Meme Difficulté,Pas Adapte,Economy
1336,2016,Economie,4,Le Travail,1,Les Aspects Quantitatifs et Qualitatifs du Travail,8,226,7,QCU,0.34,0.74,62.5,8,5,13,10,8,2,1.3,80.0,Moyen,Moyen,0,Meme Difficulté,Adapte,Economy
2447,2017,Economie,4,Le Travail,1,Les Aspects Quantitatifs et Qualitatifs du Travail,8,226,7,QCU,0.2,0.41,62.5,9,6,15,11,9,2,1.36,81.82,Moyen,Moyen,0,Meme Difficulté,Adapte,Economy
3558,2018,Economie,4,Le Travail,1,Les Aspects Quantitatifs et Qualitatifs du Travail,8,226,7,QCU,0.4,0.5,62.5,9,6,15,11,9,2,1.36,81.82,Moyen,Moyen,0,Meme Difficulté,Adapte,Economy
4669,2019,Economie,4,Le Travail,1,Les Aspects Quantitatifs et Qualitatifs du Travail,8,226,7,QCU,0.27,0.7,62.5,8,5,13,12,8,4,1.08,66.67,Moyen,Moyen,0,Meme Difficulté,Adapte,Economy
5780,2020,Economie,4,Le Travail,1,Les Aspects Quantitatifs et Qualitatifs du Travail,8,226,7,QCU,0.23,0.61,62.5,9,5,14,14,9,5,1.0,64.29,Moyen,Moyen,0,Meme Difficulté,Adapte,Economy
226,2015,Economie,4,Le Travail,1,Les Aspects Quantitatifs et Qualitatifs du Travail,8,227,8,QCU,0.36,0.59,44.67,29,35,64,45,29,16,1.42,64.44,Difficile,Moyen,1,Plus Facile,Pas Adapte,Economy
1337,2016,Economie,4,Le Travail,1,Les Aspects Quantitatifs et Qualitatifs du Travail,8,227,8,QCU,0.62,0.23,13.85,10,64,74,69,10,59,1.07,14.49,Moyen,Difficile,-1,Plus Difficile,Pas Adapte,Economy
2448,2017,Economie,4,Le Travail,1,Les Aspects Quantitatifs et Qualitatifs du Travail,8,227,8,QCU,0.04,0.96,87.03,67,10,77,76,67,9,1.01,88.16,Moyen,Facile,1,Plus Facile,Pas Adapte,Economy
3559,2018,Economie,4,Le Travail,1,Les Aspects Quantitatifs et Qualitatifs du Travail,8,227,8,QROC,0.21,0.3,36.87,31,53,84,74,31,43,1.14,41.89,Facile,Moyen,-1,Plus Difficile,Pas Adapte,Economy
4670,2019,Economie,4,Le Travail,1,Les Aspects Quantitatifs et Qualitatifs du Travail,8,227,8,QO,0.41,0.22,46.14,34,39,73,52,34,18,1.4,65.38,Difficile,Moyen,1,Plus Facile,Pas Adapte,Economy
5781,2020,Economie,4,Le Travail,1,Les Aspects Quantitatifs et Qualitatifs du Travail,8,227,8,QO,0.99,0.14,6.63,5,77,82,54,5,49,1.52,9.26,Moyen,Difficile,-1,Plus Difficile,Pas Adapte,Economy
227,2015,Economie,4,Le Travail,2,La Productivite du Travail et la Notion de Capital Humain,10,228,1,QCM,0.51,0.21,18.11,5,23,28,7,5,2,4.0,71.43,Difficile,Difficile,0,Meme Difficulté,Pas Adapte,Economy
1338,2016,Economie,4,Le Travail,2,La Productivite du Travail et la Notion de Capital Humain,10,228,1,QCM,0.09,0.75,92.45,26,2,28,27,26,1,1.04,96.3,Difficile,Facile,2,Beaucoup plus Facile,Pas Adapte,Economy
2449,2017,Economie,4,Le Travail,2,La Productivite du Travail et la Notion de Capital Humain,10,228,1,QCM,0.76,0.19,25.57,8,24,32,19,8,11,1.68,42.11,Moyen,Difficile,-1,Plus Difficile,Pas Adapte,Economy
3560,2018,Economie,4,Le Travail,2,La Productivite du Travail et la Notion de Capital Humain,10,228,1,QCM,0.31,0.59,41.22,12,16,28,20,12,8,1.4,60.0,Moyen,Moyen,0,Meme Difficulté,Pas Adapte,Economy
4671,2019,Economie,4,Le Travail,2,La Productivite du Travail et la Notion de Capital Humain,10,228,1,QCM,0.18,0.77,70.89,21,9,30,24,21,3,1.25,87.5,Facile,Facile,0,Meme Difficulté,Adapte,Economy
5782,2020,Economie,4,Le Travail,2,La Productivite du Travail et la Notion de Capital Humain,10,228,1,QCM,0.11,0.89,70.89,23,9,32,26,23,3,1.23,88.46,Facile,Facile,0,Meme Difficulté,Adapte,Economy
228,2015,Economie,4,Le Travail,2,La Productivite du Travail et la Notion de Capital Humain,10,229,2,QCM,0.59,0.22,2.2,2,94,96,42,2,40,2.29,4.76,Difficile,Difficile,0,Meme Difficulté,Pas Adapte,Economy
1339,2016,Economie,4,Le Travail,2,La Productivite du Travail et la Notion de Capital Humain,10,229,2,QCM,0.8,0.22,34.1,35,69,104,46,35,11,2.26,76.09,Moyen,Difficile,-1,Plus Difficile,Pas Adapte,Economy
2450,2017,Economie,4,Le Travail,2,La Productivite du Travail et la Notion de Capital Humain,10,229,2,QCU,0.13,0.94,78.28,76,21,97,90,76,14,1.08,84.44,Difficile,Facile,2,Beaucoup plus Facile,Pas Adapte,Economy
3561,2018,Economie,4,Le Travail,2,La Productivite du Travail et la Notion de Capital Humain,10,229,2,QCU,0.34,0.56,58.82,57,40,97,70,57,13,1.39,81.43,Moyen,Moyen,0,Meme Difficulté,Pas Adapte,Economy
4672,2019,Economie,4,Le Travail,2,La Productivite du Travail et la Notion de Capital Humain,10,229,2,QCU,0.44,0.21,10.01,9,76,85,69,9,60,1.23,13.04,Facile,Difficile,-2,Beaucoup plus Difficile,Pas Adapte,Economy
5783,2020,Economie,4,Le Travail,2,La Productivite du Travail et la Notion de Capital Humain,10,229,2,QCU,0.4,0.4,46.59,34,39,73,55,34,21,1.33,61.82,Difficile,Moyen,1,Plus Facile,Pas Adapte,Economy
229,2015,Economie,4,Le Travail,2,La Productivite du Travail et la Notion de Capital Humain,10,230,3,QCM,0.46,0.67,42.23,36,50,86,40,36,4,2.15,90.0,Moyen,Moyen,0,Meme Difficulté,Pas Adapte,Economy
1340,2016,Economie,4,Le Travail,2,La Productivite du Travail et la Notion de Capital Humain,10,230,3,QCM,0.31,0.34,39.56,32,50,82,57,32,25,1.44,56.14,Moyen,Moyen,0,Meme Difficulté,Pas Adapte,Economy
2451,2017,Economie,4,Le Travail,2,La Productivite du Travail et la Notion de Capital Humain,10,230,3,QCU,0.14,0.96,82.0,76,17,93,84,76,8,1.11,90.48,Facile,Facile,0,Meme Difficulté,Pas Adapte,Economy
3562,2018,Economie,4,Le Travail,2,La Productivite du Travail et la Notion de Capital Humain,10,230,3,QCU,0.01,0.84,69.72,56,25,81,66,56,10,1.23,84.85,Moyen,Facile,1,Plus Facile,Adapte,Economy
4673,2019,Economie,4,Le Travail,2,La Productivite du Travail et la Notion de Capital Humain,10,230,3,QCU,0.17,0.78,69.72,51,22,73,71,51,20,1.03,71.83,Facile,Facile,0,Meme Difficulté,Adapte,Economy
5784,2020,Economie,4,Le Travail,2,La Productivite du Travail et la Notion de Capital Humain,10,230,3,QCU,0.09,0.97,69.72,50,22,72,65,50,15,1.11,76.92,Facile,Facile,0,Meme Difficulté,Adapte,Economy
230,2015,Economie,4,Le Travail,2,La Productivite du Travail et la Notion de Capital Humain,10,231,4,QCU,0.74,0.32,7.69,3,37,40,16,3,13,2.5,18.75,Moyen,Difficile,-1,Plus Difficile,Pas Adapte,Economy
1341,2016,Economie,4,Le Travail,2,La Productivite du Travail et la Notion de Capital Humain,10,231,4,QCU,0.01,0.91,74.17,34,12,46,39,34,5,1.18,87.18,Moyen,Facile,1,Plus Facile,Adapte,Economy
2452,2017,Economie,4,Le Travail,2,La Productivite du Travail et la Notion de Capital Humain,10,231,4,QCU,0.1,0.92,74.17,35,12,47,46,35,11,1.02,76.09,Facile,Facile,0,Meme Difficulté,Adapte,Economy
3563,2018,Economie,4,Le Travail,2,La Productivite du Travail et la Notion de Capital Humain,10,231,4,QCU,0.11,0.96,74.17,36,12,48,37,36,1,1.3,97.3,Facile,Facile,0,Meme Difficulté,Adapte,Economy
4674,2019,Economie,4,Le Travail,2,La Productivite du Travail et la Notion de Capital Humain,10,231,4,QCU,0.17,0.91,74.17,30,11,41,41,30,11,1.0,73.17,Facile,Facile,0,Meme Difficulté,Adapte,Economy
5785,2020,Economie,4,Le Travail,2,La Productivite du Travail et la Notion de Capital Humain,10,231,4,QCU,0.15,0.88,74.17,28,10,38,36,28,8,1.06,77.78,Facile,Facile,0,Meme Difficulté,Adapte,Economy
231,2015,Economie,4,Le Travail,2,La Productivite du Travail et la Notion de Capital Humain,10,232,5,QCU,0.51,0.26,30.17,9,20,29,21,9,12,1.38,42.86,Difficile,Difficile,0,Meme Difficulté,Pas Adapte,Economy
1342,2016,Economie,4,Le Travail,2,La Productivite du Travail et la Notion de Capital Humain,10,232,5,QCU,0.57,0.36,9.91,3,30,33,14,3,11,2.36,21.43,Moyen,Difficile,-1,Plus Difficile,Pas Adapte,Economy
2453,2017,Economie,4,Le Travail,2,La Productivite du Travail et la Notion de Capital Humain,10,232,5,QCM,0.08,0.99,85.36,29,5,34,31,29,2,1.1,93.55,Difficile,Facile,2,Beaucoup plus Facile,Pas Adapte,Economy
3564,2018,Economie,4,Le Travail,2,La Productivite du Travail et la Notion de Capital Humain,10,232,5,QCM,0.37,0.39,55.46,21,16,37,36,21,15,1.03,58.33,Moyen,Moyen,0,Meme Difficulté,Pas Adapte,Economy
4675,2019,Economie,4,Le Travail,2,La Productivite du Travail et la Notion de Capital Humain,10,232,5,QCM,0.56,0.27,2.67,1,39,40,19,1,18,2.11,5.26,Difficile,Difficile,0,Meme Difficulté,Pas Adapte,Economy
5786,2020,Economie,4,Le Travail,2,La Productivite du Travail et la Notion de Capital Humain,10,232,5,QCM,0.59,0.22,33.06,14,29,43,18,14,4,2.39,77.78,Difficile,Difficile,0,Meme Difficulté,Pas Adapte,Economy
232,2015,Economie,4,Le Travail,2,La Productivite du Travail et la Notion de Capital Humain,10,233,6,QCU,0.35,0.57,35.68,22,41,63,57,22,35,1.11,38.6,Facile,Moyen,-1,Plus Difficile,Pas Adapte,Economy
1343,2016,Economie,4,Le Travail,2,La Productivite du Travail et la Notion de Capital Humain,10,233,6,QCU,0.34,0.69,57.04,31,23,54,43,31,12,1.26,72.09,Difficile,Moyen,1,Plus Facile,Pas Adapte,Economy
2454,2017,Economie,4,Le Travail,2,La Productivite du Travail et la Notion de Capital Humain,10,233,6,QCU,0.75,0.25,29.04,17,40,57,31,17,14,1.84,54.84,Facile,Difficile,-2,Beaucoup plus Difficile,Pas Adapte,Economy
3565,2018,Economie,4,Le Travail,2,La Productivite du Travail et la Notion de Capital Humain,10,233,6,QCU,0.22,0.6,49.67,32,33,65,49,32,17,1.33,65.31,Facile,Moyen,-1,Plus Difficile,Pas Adapte,Economy
4676,2019,Economie,4,Le Travail,2,La Productivite du Travail et la Notion de Capital Humain,10,233,6,QCM,0.41,0.38,55.04,39,31,70,53,39,14,1.32,73.58,Facile,Moyen,-1,Plus Difficile,Pas Adapte,Economy
5787,2020,Economie,4,Le Travail,2,La Productivite du Travail et la Notion de Capital Humain,10,233,6,QCM,0.01,0.76,98.14,59,1,60,60,59,1,1.0,98.33,Facile,Facile,0,Meme Difficulté,Pas Adapte,Economy
233,2015,Economie,4,Le Travail,2,La Productivite du Travail et la Notion de Capital Humain,10,234,7,QCM,0.74,0.22,2.03,0,23,23,13,0,13,1.77,0.0,Difficile,Difficile,0,Meme Difficulté,Pas Adapte,Economy
1344,2016,Economie,4,Le Travail,2,La Productivite du Travail et la Notion de Capital Humain,10,234,7,QCM,0.35,0.4,39.11,9,15,24,14,9,5,1.71,64.29,Difficile,Moyen,1,Plus Facile,Pas Adapte,Economy
2455,2017,Economie,4,Le Travail,2,La Productivite du Travail et la Notion de Capital Humain,10,234,7,QCM,0.28,0.32,48.77,10,11,21,21,10,11,1.0,47.62,Facile,Moyen,-1,Plus Difficile,Pas Adapte,Economy
3566,2018,Economie,4,Le Travail,2,La Productivite du Travail et la Notion de Capital Humain,10,234,7,QCM,0.74,0.3,26.01,5,13,18,7,5,2,2.57,71.43,Difficile,Difficile,0,Meme Difficulté,Pas Adapte,Economy
4677,2019,Economie,4,Le Travail,2,La Productivite du Travail et la Notion de Capital Humain,10,234,7,QCM,0.68,0.2,26.71,4,12,16,14,4,10,1.14,28.57,Moyen,Difficile,-1,Plus Difficile,Pas Adapte,Economy
5788,2020,Economie,4,Le Travail,2,La Productivite du Travail et la Notion de Capital Humain,10,234,7,QROC,0.21,0.37,55.32,10,8,18,16,10,6,1.12,62.5,Moyen,Moyen,0,Meme Difficulté,Pas Adapte,Economy
234,2015,Economie,4,Le Travail,2,La Productivite du Travail et la Notion de Capital Humain,10,235,8,QCU,0.08,0.76,80.36,62,15,77,65,62,3,1.18,95.38,Facile,Facile,0,Meme Difficulté,Pas Adapte,Economy
1345,2016,Economie,4,Le Travail,2,La Productivite du Travail et la Notion de Capital Humain,10,235,8,QCU,0.11,0.96,83.9,65,13,78,76,65,11,1.03,85.53,Difficile,Facile,2,Beaucoup plus Facile,Pas Adapte,Economy
2456,2017,Economie,4,Le Travail,2,La Productivite du Travail et la Notion de Capital Humain,10,235,8,QO,0.57,0.21,53.57,41,36,77,42,41,1,1.83,97.62,Moyen,Moyen,0,Meme Difficulté,Pas Adapte,Economy
3567,2018,Economie,4,Le Travail,2,La Productivite du Travail et la Notion de Capital Humain,10,235,8,QO,0.91,0.1,12.89,9,64,73,57,9,48,1.28,15.79,Moyen,Difficile,-1,Plus Difficile,Pas Adapte,Economy
4678,2019,Economie,4,Le Travail,2,La Productivite du Travail et la Notion de Capital Humain,10,235,8,QCM,0.76,0.23,28.05,22,57,79,37,22,15,2.14,59.46,Difficile,Difficile,0,Meme Difficulté,Pas Adapte,Economy
5789,2020,Economie,4,Le Travail,2,La Productivite du Travail et la Notion de Capital Humain,10,235,8,QCM,0.05,0.77,88.89,70,9,79,76,70,6,1.04,92.11,Difficile,Facile,2,Beaucoup plus Facile,Pas Adapte,Economy
235,2015,Economie,4,Le Travail,2,La Productivite du Travail et la Notion de Capital Humain,10,236,9,QROC,0.0,0.67,79.56,10,2,12,11,10,1,1.09,90.91,Difficile,Facile,2,Beaucoup plus Facile,Pas Adapte,Economy
1346,2016,Economie,4,Le Travail,2,La Productivite du Travail et la Notion de Capital Humain,10,236,9,QO,0.2,0.88,81.69,11,2,13,13,11,2,1.0,84.62,Moyen,Facile,1,Plus Facile,Pas Adapte,Economy
2457,2017,Economie,4,Le Travail,2,La Productivite du Travail et la Notion de Capital Humain,10,236,9,QO,0.82,0.04,0.24,0,15,15,14,0,14,1.07,0.0,Moyen,Difficile,-1,Plus Difficile,Pas Adapte,Economy
3568,2018,Economie,4,Le Travail,2,La Productivite du Travail et la Notion de Capital Humain,10,236,9,QO,0.14,0.97,65.33,9,5,14,13,9,4,1.08,69.23,Difficile,Facile,2,Beaucoup plus Facile,Adapte,Economy
4679,2019,Economie,4,Le Travail,2,La Productivite du Travail et la Notion de Capital Humain,10,236,9,QO,0.08,0.72,65.33,10,6,16,12,10,2,1.33,83.33,Facile,Facile,0,Meme Difficulté,Adapte,Economy
5790,2020,Economie,4,Le Travail,2,La Productivite du Travail et la Notion de Capital Humain,10,236,9,QO,0.03,0.64,65.33,9,5,14,9,9,0,1.56,100.0,Facile,Facile,0,Meme Difficulté,Adapte,Economy
236,2015,Economie,4,Le Travail,2,La Productivite du Travail et la Notion de Capital Humain,10,237,10,QCM,0.51,0.27,16.48,5,24,29,23,5,18,1.26,21.74,Moyen,Difficile,-1,Plus Difficile,Pas Adapte,Economy
1347,2016,Economie,4,Le Travail,2,La Productivite du Travail et la Notion de Capital Humain,10,237,10,QCM,0.25,0.4,59.78,16,10,26,20,16,4,1.3,80.0,Moyen,Moyen,0,Meme Difficulté,Pas Adapte,Economy
2458,2017,Economie,4,Le Travail,2,La Productivite du Travail et la Notion de Capital Humain,10,237,10,QCM,0.04,0.77,89.58,23,3,26,23,23,0,1.13,100.0,Facile,Facile,0,Meme Difficulté,Pas Adapte,Economy
3569,2018,Economie,4,Le Travail,2,La Productivite du Travail et la Notion de Capital Humain,10,237,10,QCM,0.45,0.32,39.72,12,18,30,28,12,16,1.07,42.86,Facile,Moyen,-1,Plus Difficile,Pas Adapte,Economy
4680,2019,Economie,4,Le Travail,2,La Productivite du Travail et la Notion de Capital Humain,10,237,10,QO,0.73,0.23,44.22,14,17,31,25,14,11,1.24,56.0,Difficile,Moyen,1,Plus Facile,Pas Adapte,Economy
5791,2020,Economie,4,Le Travail,2,La Productivite du Travail et la Notion de Capital Humain,10,237,10,QO,0.89,0.05,24.8,8,23,31,24,8,16,1.29,33.33,Difficile,Difficile,0,Meme Difficulté,Pas Adapte,Economy
237,2015,Economie,5,Le Capital et le Progres Technique,1,Le Capital et l'Investissement,6,238,1,QROC,0.52,0.38,58.47,14,10,24,19,14,5,1.26,73.68,Facile,Moyen,-1,Plus Difficile,Pas Adapte,Economy
1348,2016,Economie,5,Le Capital et le Progres Technique,1,Le Capital et l'Investissement,6,238,1,QROC,0.86,0.12,31.98,7,16,23,15,7,8,1.53,46.67,Difficile,Difficile,0,Meme Difficulté,Pas Adapte,Economy
2459,2017,Economie,5,Le Capital et le Progres Technique,1,Le Capital et l'Investissement,6,238,1,QROC,0.12,0.56,97.37,23,1,24,24,23,1,1.0,95.83,Difficile,Facile,2,Beaucoup plus Facile,Pas Adapte,Economy
3570,2018,Economie,5,Le Capital et le Progres Technique,1,Le Capital et l'Investissement,6,238,1,QROC,0.17,0.66,87.68,18,2,20,19,18,1,1.05,94.74,Moyen,Facile,1,Plus Facile,Pas Adapte,Economy
4681,2019,Economie,5,Le Capital et le Progres Technique,1,Le Capital et l'Investissement,6,238,1,QROC,0.29,0.38,59.34,12,8,20,19,12,7,1.05,63.16,Moyen,Moyen,0,Meme Difficulté,Pas Adapte,Economy
5792,2020,Economie,5,Le Capital et le Progres Technique,1,Le Capital et l'Investissement,6,238,1,QROC,0.91,0.13,3.92,1,21,22,14,1,13,1.57,7.14,Facile,Difficile,-2,Beaucoup plus Difficile,Pas Adapte,Economy
238,2015,Economie,5,Le Capital et le Progres Technique,1,Le Capital et l'Investissement,6,239,2,QCM,0.11,0.75,82.96,80,17,97,96,80,16,1.01,83.33,Moyen,Facile,1,Plus Facile,Pas Adapte,Economy
1349,2016,Economie,5,Le Capital et le Progres Technique,1,Le Capital et l'Investissement,6,239,2,QCU,0.17,0.98,65.58,66,34,100,90,66,24,1.11,73.33,Moyen,Facile,1,Plus Facile,Adapte,Economy
2460,2017,Economie,5,Le Capital et le Progres Technique,1,Le Capital et l'Investissement,6,239,2,QCU,0.07,0.79,65.58,68,35,103,75,68,7,1.37,90.67,Facile,Facile,0,Meme Difficulté,Adapte,Economy
3571,2018,Economie,5,Le Capital et le Progres Technique,1,Le Capital et l'Investissement,6,239,2,QCU,0.15,0.99,65.58,65,34,99,80,65,15,1.24,81.25,Facile,Facile,0,Meme Difficulté,Adapte,Economy
4682,2019,Economie,5,Le Capital et le Progres Technique,1,Le Capital et l'Investissement,6,239,2,QCM,0.13,0.8,65.58,56,29,85,82,56,26,1.04,68.29,Facile,Facile,0,Meme Difficulté,Adapte,Economy
5793,2020,Economie,5,Le Capital et le Progres Technique,1,Le Capital et l'Investissement,6,239,2,QCM,0.17,0.96,65.58,49,26,75,60,49,11,1.25,81.67,Facile,Facile,0,Meme Difficulté,Adapte,Economy
239,2015,Economie,5,Le Capital et le Progres Technique,1,Le Capital et l'Investissement,6,240,3,QCU,0.11,0.87,76.8,65,19,84,72,65,7,1.17,90.28,Difficile,Facile,2,Beaucoup plus Facile,Pas Adapte,Economy
1350,2016,Economie,5,Le Capital et le Progres Technique,1,Le Capital et l'Investissement,6,240,3,QCU,0.09,0.88,83.99,60,11,71,69,60,9,1.03,86.96,Difficile,Facile,2,Beaucoup plus Facile,Pas Adapte,Economy
2461,2017,Economie,5,Le Capital et le Progres Technique,1,Le Capital et l'Investissement,6,240,3,QCU,0.36,0.56,40.33,28,41,69,51,28,23,1.35,54.9,Moyen,Moyen,0,Meme Difficulté,Pas Adapte,Economy
3572,2018,Economie,5,Le Capital et le Progres Technique,1,Le Capital et l'Investissement,6,240,3,QCU,0.09,0.78,98.65,70,1,71,70,70,0,1.01,100.0,Facile,Facile,0,Meme Difficulté,Pas Adapte,Economy
4683,2019,Economie,5,Le Capital et le Progres Technique,1,Le Capital et l'Investissement,6,240,3,QCU,0.14,0.97,92.57,68,5,73,70,68,2,1.04,97.14,Difficile,Facile,2,Beaucoup plus Facile,Pas Adapte,Economy
5794,2020,Economie,5,Le Capital et le Progres Technique,1,Le Capital et l'Investissement,6,240,3,QCU,0.15,0.93,84.18,65,12,77,65,65,0,1.18,100.0,Difficile,Facile,2,Beaucoup plus Facile,Pas Adapte,Economy
240,2015,Economie,5,Le Capital et le Progres Technique,1,Le Capital et l'Investissement,6,241,4,QCU,0.53,0.36,34.67,19,35,54,39,19,20,1.38,48.72,Moyen,Difficile,-1,Plus Difficile,Pas Adapte,Economy
1351,2016,Economie,5,Le Capital et le Progres Technique,1,Le Capital et l'Investissement,6,241,4,QCU,0.67,0.36,10.85,7,53,60,23,7,16,2.61,30.43,Difficile,Difficile,0,Meme Difficulté,Pas Adapte,Economy
2462,2017,Economie,5,Le Capital et le Progres Technique,1,Le Capital et l'Investissement,6,241,4,QCU,0.43,0.25,11.75,6,48,54,18,6,12,3.0,33.33,Facile,Difficile,-2,Beaucoup plus Difficile,Pas Adapte,Economy
3573,2018,Economie,5,Le Capital et le Progres Technique,1,Le Capital et l'Investissement,6,241,4,QCU,0.45,0.23,18.12,9,43,52,32,9,23,1.62,28.12,Moyen,Difficile,-1,Plus Difficile,Pas Adapte,Economy
4684,2019,Economie,5,Le Capital et le Progres Technique,1,Le Capital et l'Investissement,6,241,4,QCM,0.14,0.97,96.58,45,2,47,46,45,1,1.02,97.83,Moyen,Facile,1,Plus Facile,Pas Adapte,Economy
5795,2020,Economie,5,Le Capital et le Progres Technique,1,Le Capital et l'Investissement,6,241,4,QCM,0.38,0.47,40.52,18,27,45,31,18,13,1.45,58.06,Facile,Moyen,-1,Plus Difficile,Pas Adapte,Economy
241,2015,Economie,5,Le Capital et le Progres Technique,1,Le Capital et l'Investissement,6,242,5,QROC,0.79,0.11,6.52,6,83,89,43,6,37,2.07,13.95,Facile,Difficile,-2,Beaucoup plus Difficile,Pas Adapte,Economy
1352,2016,Economie,5,Le Capital et le Progres Technique,1,Le Capital et l'Investissement,6,242,5,QROC,0.75,0.12,13.77,12,73,85,51,12,39,1.67,23.53,Facile,Difficile,-2,Beaucoup plus Difficile,Pas Adapte,Economy
2463,2017,Economie,5,Le Capital et le Progres Technique,1,Le Capital et l'Investissement,6,242,5,QROC,0.98,0.17,6.03,4,68,72,43,4,39,1.67,9.3,Difficile,Difficile,0,Meme Difficulté,Pas Adapte,Economy
3574,2018,Economie,5,Le Capital et le Progres Technique,1,Le Capital et l'Investissement,6,242,5,QROC,0.46,0.33,45.39,36,44,80,55,36,19,1.45,65.45,Moyen,Moyen,0,Meme Difficulté,Pas Adapte,Economy
4685,2019,Economie,5,Le Capital et le Progres Technique,1,Le Capital et l'Investissement,6,242,5,QROC,0.36,0.34,51.34,44,42,86,58,44,14,1.48,75.86,Facile,Moyen,-1,Plus Difficile,Pas Adapte,Economy
5796,2020,Economie,5,Le Capital et le Progres Technique,1,Le Capital et l'Investissement,6,242,5,QROC,0.41,0.34,37.09,34,58,92,78,34,44,1.18,43.59,Difficile,Moyen,1,Plus Facile,Pas Adapte,Economy
242,2015,Economie,5,Le Capital et le Progres Technique,1,Le Capital et l'Investissement,6,243,6,QCM,0.34,0.53,62.45,9,6,15,14,9,5,1.07,64.29,Moyen,Moyen,0,Meme Difficulté,Adapte,Economy
1353,2016,Economie,5,Le Capital et le Progres Technique,1,Le Capital et l'Investissement,6,243,6,QCM,0.37,0.59,62.45,9,6,15,13,9,4,1.15,69.23,Moyen,Moyen,0,Meme Difficulté,Adapte,Economy
2464,2017,Economie,5,Le Capital et le Progres Technique,1,Le Capital et l'Investissement,6,243,6,QCM,0.33,0.4,62.45,11,6,17,13,11,2,1.31,84.62,Moyen,Moyen,0,Meme Difficulté,Adapte,Economy
3575,2018,Economie,5,Le Capital et le Progres Technique,1,Le Capital et l'Investissement,6,243,6,QCM,0.46,0.54,62.45,9,6,15,10,9,1,1.5,90.0,Moyen,Moyen,0,Meme Difficulté,Adapte,Economy
4686,2019,Economie,5,Le Capital et le Progres Technique,1,Le Capital et l'Investissement,6,243,6,QCM,0.42,0.38,62.45,9,6,15,13,9,4,1.15,69.23,Moyen,Moyen,0,Meme Difficulté,Adapte,Economy
5797,2020,Economie,5,Le Capital et le Progres Technique,1,Le Capital et l'Investissement,6,243,6,QCM,0.28,0.44,62.45,8,5,13,12,8,4,1.08,66.67,Moyen,Moyen,0,Meme Difficulté,Adapte,Economy
243,2015,Economie,5,Le Capital et le Progres Technique,2,Le Capital: Aspect Physiques et Financiers,10,244,1,QROC,0.1,0.48,78.87,54,15,69,61,54,7,1.13,88.52,Facile,Facile,0,Meme Difficulté,Pas Adapte,Economy
1354,2016,Economie,5,Le Capital et le Progres Technique,2,Le Capital: Aspect Physiques et Financiers,10,244,1,QROC,0.06,0.87,94.69,73,4,77,77,73,4,1.0,94.81,Difficile,Facile,2,Beaucoup plus Facile,Pas Adapte,Economy
2465,2017,Economie,5,Le Capital et le Progres Technique,2,Le Capital: Aspect Physiques et Financiers,10,244,1,QROC,0.02,0.66,68.98,51,23,74,55,51,4,1.35,92.73,Moyen,Facile,1,Plus Facile,Adapte,Economy
3576,2018,Economie,5,Le Capital et le Progres Technique,2,Le Capital: Aspect Physiques et Financiers,10,244,1,QO,0.15,0.42,68.98,44,20,64,58,44,14,1.1,75.86,Facile,Facile,0,Meme Difficulté,Adapte,Economy
4687,2019,Economie,5,Le Capital et le Progres Technique,2,Le Capital: Aspect Physiques et Financiers,10,244,1,QO,0.14,0.85,68.98,37,17,54,54,37,17,1.0,68.52,Facile,Facile,0,Meme Difficulté,Adapte,Economy
5798,2020,Economie,5,Le Capital et le Progres Technique,2,Le Capital: Aspect Physiques et Financiers,10,244,1,QO,0.19,0.78,68.98,32,15,47,42,32,10,1.12,76.19,Facile,Facile,0,Meme Difficulté,Adapte,Economy
244,2015,Economie,5,Le Capital et le Progres Technique,2,Le Capital: Aspect Physiques et Financiers,10,245,2,QCU,0.11,0.81,81.91,78,17,95,88,78,10,1.08,88.64,Moyen,Facile,1,Plus Facile,Pas Adapte,Economy
1355,2016,Economie,5,Le Capital et le Progres Technique,2,Le Capital: Aspect Physiques et Financiers,10,245,2,QCU,0.4,0.41,57.82,51,37,88,70,51,19,1.26,72.86,Moyen,Moyen,0,Meme Difficulté,Pas Adapte,Economy
2466,2017,Economie,5,Le Capital et le Progres Technique,2,Le Capital: Aspect Physiques et Financiers,10,245,2,QCU,0.71,0.24,20.83,16,59,75,26,16,10,2.88,61.54,Difficile,Difficile,0,Meme Difficulté,Pas Adapte,Economy
3577,2018,Economie,5,Le Capital et le Progres Technique,2,Le Capital: Aspect Physiques et Financiers,10,245,2,QCU,0.36,0.54,57.55,49,37,86,77,49,28,1.12,63.64,Difficile,Moyen,1,Plus Facile,Pas Adapte,Economy
4688,2019,Economie,5,Le Capital et le Progres Technique,2,Le Capital: Aspect Physiques et Financiers,10,245,2,QCU,0.53,0.27,30.27,28,63,91,79,28,51,1.15,35.44,Difficile,Difficile,0,Meme Difficulté,Pas Adapte,Economy
5799,2020,Economie,5,Le Capital et le Progres Technique,2,Le Capital: Aspect Physiques et Financiers,10,245,2,QCU,0.0,0.9,84.79,86,15,101,98,86,12,1.03,87.76,Facile,Facile,0,Meme Difficulté,Pas Adapte,Economy
245,2015,Economie,5,Le Capital et le Progres Technique,2,Le Capital: Aspect Physiques et Financiers,10,246,3,QROC,0.76,0.24,1.12,1,67,68,45,1,44,1.51,2.22,Facile,Difficile,-2,Beaucoup plus Difficile,Pas Adapte,Economy
1356,2016,Economie,5,Le Capital et le Progres Technique,2,Le Capital: Aspect Physiques et Financiers,10,246,3,QCM,0.11,0.91,95.58,68,3,71,71,68,3,1.0,95.77,Moyen,Facile,1,Plus Facile,Pas Adapte,Economy
2467,2017,Economie,5,Le Capital et le Progres Technique,2,Le Capital: Aspect Physiques et Financiers,10,246,3,QCM,0.06,0.71,79.43,55,14,69,62,55,7,1.11,88.71,Facile,Facile,0,Meme Difficulté,Pas Adapte,Economy
3578,2018,Economie,5,Le Capital et le Progres Technique,2,Le Capital: Aspect Physiques et Financiers,10,246,3,QCM,0.14,0.88,82.83,57,12,69,67,57,10,1.03,85.07,Facile,Facile,0,Meme Difficulté,Pas Adapte,Economy
4689,2019,Economie,5,Le Capital et le Progres Technique,2,Le Capital: Aspect Physiques et Financiers,10,246,3,QROC,0.46,0.32,54.38,36,30,66,50,36,14,1.32,72.0,Moyen,Moyen,0,Meme Difficulté,Pas Adapte,Economy
5800,2020,Economie,5,Le Capital et le Progres Technique,2,Le Capital: Aspect Physiques et Financiers,10,246,3,QROC,0.83,0.2,9.8,6,53,59,27,6,21,2.19,22.22,Moyen,Difficile,-1,Plus Difficile,Pas Adapte,Economy
246,2015,Economie,5,Le Capital et le Progres Technique,2,Le Capital: Aspect Physiques et Financiers,10,247,4,QCU,0.06,0.9,86.61,22,3,25,22,22,0,1.14,100.0,Facile,Facile,0,Meme Difficulté,Pas Adapte,Economy
1357,2016,Economie,5,Le Capital et le Progres Technique,2,Le Capital: Aspect Physiques et Financiers,10,247,4,QCU,0.13,0.84,67.75,15,7,22,21,15,6,1.05,71.43,Difficile,Facile,2,Beaucoup plus Facile,Adapte,Economy
2468,2017,Economie,5,Le Capital et le Progres Technique,2,Le Capital: Aspect Physiques et Financiers,10,247,4,QCU,0.01,0.91,67.75,16,8,24,19,16,3,1.26,84.21,Facile,Facile,0,Meme Difficulté,Adapte,Economy
3579,2018,Economie,5,Le Capital et le Progres Technique,2,Le Capital: Aspect Physiques et Financiers,10,247,4,QCU,0.19,0.84,67.75,17,8,25,23,17,6,1.09,73.91,Facile,Facile,0,Meme Difficulté,Adapte,Economy
4690,2019,Economie,5,Le Capital et le Progres Technique,2,Le Capital: Aspect Physiques et Financiers,10,247,4,QROC,0.14,0.59,67.75,19,9,28,24,19,5,1.17,79.17,Facile,Facile,0,Meme Difficulté,Adapte,Economy
5801,2020,Economie,5,Le Capital et le Progres Technique,2,Le Capital: Aspect Physiques et Financiers,10,247,4,QROC,0.08,0.65,67.75,18,9,27,21,18,3,1.29,85.71,Facile,Facile,0,Meme Difficulté,Adapte,Economy
247,2015,Economie,5,Le Capital et le Progres Technique,2,Le Capital: Aspect Physiques et Financiers,10,248,5,QCU,0.31,0.56,36.23,32,57,89,33,32,1,2.7,96.97,Moyen,Moyen,0,Meme Difficulté,Pas Adapte,Economy
1358,2016,Economie,5,Le Capital et le Progres Technique,2,Le Capital: Aspect Physiques et Financiers,10,248,5,QCU,0.74,0.32,32.87,31,63,94,83,31,52,1.13,37.35,Facile,Difficile,-2,Beaucoup plus Difficile,Pas Adapte,Economy
2469,2017,Economie,5,Le Capital et le Progres Technique,2,Le Capital: Aspect Physiques et Financiers,10,248,5,QCU,0.33,0.45,42.1,41,56,97,51,41,10,1.9,80.39,Difficile,Moyen,1,Plus Facile,Pas Adapte,Economy
3580,2018,Economie,5,Le Capital et le Progres Technique,2,Le Capital: Aspect Physiques et Financiers,10,248,5,QCU,0.49,0.39,25.29,28,81,109,58,28,30,1.88,48.28,Facile,Difficile,-2,Beaucoup plus Difficile,Pas Adapte,Economy
4691,2019,Economie,5,Le Capital et le Progres Technique,2,Le Capital: Aspect Physiques et Financiers,10,248,5,QCU,0.67,0.33,3.45,3,97,100,86,3,83,1.16,3.49,Difficile,Difficile,0,Meme Difficulté,Pas Adapte,Economy
5802,2020,Economie,5,Le Capital et le Progres Technique,2,Le Capital: Aspect Physiques et Financiers,10,248,5,QCU,0.4,0.52,60.52,61,39,100,86,61,25,1.16,70.93,Difficile,Moyen,1,Plus Facile,Adapte,Economy
248,2015,Economie,5,Le Capital et le Progres Technique,2,Le Capital: Aspect Physiques et Financiers,10,249,6,QO,0.06,0.85,74.99,51,17,68,61,51,10,1.11,83.61,Moyen,Facile,1,Plus Facile,Adapte,Economy
1359,2016,Economie,5,Le Capital et le Progres Technique,2,Le Capital: Aspect Physiques et Financiers,10,249,6,QO,0.19,0.71,74.99,43,15,58,49,43,6,1.18,87.76,Facile,Facile,0,Meme Difficulté,Adapte,Economy
2470,2017,Economie,5,Le Capital et le Progres Technique,2,Le Capital: Aspect Physiques et Financiers,10,249,6,QO,0.02,0.77,74.99,42,14,56,54,42,12,1.04,77.78,Facile,Facile,0,Meme Difficulté,Adapte,Economy
3581,2018,Economie,5,Le Capital et le Progres Technique,2,Le Capital: Aspect Physiques et Financiers,10,249,6,QO,0.09,0.56,74.99,37,13,50,43,37,6,1.16,86.05,Facile,Facile,0,Meme Difficulté,Adapte,Economy
4692,2019,Economie,5,Le Capital et le Progres Technique,2,Le Capital: Aspect Physiques et Financiers,10,249,6,QO,0.18,0.71,74.99,43,14,57,48,43,5,1.19,89.58,Facile,Facile,0,Meme Difficulté,Adapte,Economy
5803,2020,Economie,5,Le Capital et le Progres Technique,2,Le Capital: Aspect Physiques et Financiers,10,249,6,QO,0.18,0.4,74.99,44,15,59,47,44,3,1.26,93.62,Facile,Facile,0,Meme Difficulté,Adapte,Economy
249,2015,Economie,5,Le Capital et le Progres Technique,2,Le Capital: Aspect Physiques et Financiers,10,250,7,QCU,0.45,0.33,27.02,17,47,64,58,17,41,1.1,29.31,Difficile,Difficile,0,Meme Difficulté,Pas Adapte,Economy
1360,2016,Economie,5,Le Capital et le Progres Technique,2,Le Capital: Aspect Physiques et Financiers,10,250,7,QCU,0.5,0.4,22.78,14,48,62,62,14,48,1.0,22.58,Difficile,Difficile,0,Meme Difficulté,Pas Adapte,Economy
2471,2017,Economie,5,Le Capital et le Progres Technique,2,Le Capital: Aspect Physiques et Financiers,10,250,7,QCU,0.25,0.61,46.95,27,31,58,56,27,29,1.04,48.21,Difficile,Moyen,1,Plus Facile,Pas Adapte,Economy
3582,2018,Economie,5,Le Capital et le Progres Technique,2,Le Capital: Aspect Physiques et Financiers,10,250,7,QCM,0.25,0.31,64.37,39,21,60,45,39,6,1.33,86.67,Facile,Moyen,-1,Plus Difficile,Adapte,Economy
4693,2019,Economie,5,Le Capital et le Progres Technique,2,Le Capital: Aspect Physiques et Financiers,10,250,7,QCM,0.3,0.47,64.37,41,22,63,57,41,16,1.11,71.93,Moyen,Moyen,0,Meme Difficulté,Adapte,Economy
5804,2020,Economie,5,Le Capital et le Progres Technique,2,Le Capital: Aspect Physiques et Financiers,10,250,7,QCM,0.44,0.4,64.37,36,20,56,52,36,16,1.08,69.23,Moyen,Moyen,0,Meme Difficulté,Adapte,Economy
250,2015,Economie,5,Le Capital et le Progres Technique,2,Le Capital: Aspect Physiques et Financiers,10,251,8,QCU,0.0,0.99,65.57,45,24,69,68,45,23,1.01,66.18,Moyen,Facile,1,Plus Facile,Adapte,Economy
1361,2016,Economie,5,Le Capital et le Progres Technique,2,Le Capital: Aspect Physiques et Financiers,10,251,8,QCU,0.19,0.95,65.57,42,22,64,59,42,17,1.08,71.19,Facile,Facile,0,Meme Difficulté,Adapte,Economy
2472,2017,Economie,5,Le Capital et le Progres Technique,2,Le Capital: Aspect Physiques et Financiers,10,251,8,QCU,0.14,0.93,65.57,38,20,58,56,38,18,1.04,67.86,Facile,Facile,0,Meme Difficulté,Adapte,Economy
3583,2018,Economie,5,Le Capital et le Progres Technique,2,Le Capital: Aspect Physiques et Financiers,10,251,8,QCM,0.2,0.87,65.57,41,21,62,61,41,20,1.02,67.21,Facile,Facile,0,Meme Difficulté,Adapte,Economy
4694,2019,Economie,5,Le Capital et le Progres Technique,2,Le Capital: Aspect Physiques et Financiers,10,251,8,QCM,0.05,0.92,65.57,37,19,56,38,37,1,1.47,97.37,Facile,Facile,0,Meme Difficulté,Adapte,Economy
5805,2020,Economie,5,Le Capital et le Progres Technique,2,Le Capital: Aspect Physiques et Financiers,10,251,8,QCM,0.09,0.86,65.57,39,21,60,57,39,18,1.05,68.42,Facile,Facile,0,Meme Difficulté,Adapte,Economy
251,2015,Economie,5,Le Capital et le Progres Technique,2,Le Capital: Aspect Physiques et Financiers,10,252,9,QCM,0.57,0.2,5.17,5,88,93,44,5,39,2.11,11.36,Moyen,Difficile,-1,Plus Difficile,Pas Adapte,Economy
1362,2016,Economie,5,Le Capital et le Progres Technique,2,Le Capital: Aspect Physiques et Financiers,10,252,9,QCU,0.16,0.91,91.03,96,10,106,99,96,3,1.07,96.97,Moyen,Facile,1,Plus Facile,Pas Adapte,Economy
2473,2017,Economie,5,Le Capital et le Progres Technique,2,Le Capital: Aspect Physiques et Financiers,10,252,9,QCU,0.69,0.28,10.23,9,82,91,82,9,73,1.11,10.98,Facile,Difficile,-2,Beaucoup plus Difficile,Pas Adapte,Economy
3584,2018,Economie,5,Le Capital et le Progres Technique,2,Le Capital: Aspect Physiques et Financiers,10,252,9,QCU,0.19,0.95,84.87,81,15,96,86,81,5,1.12,94.19,Facile,Facile,0,Meme Difficulté,Pas Adapte,Economy
4695,2019,Economie,5,Le Capital et le Progres Technique,2,Le Capital: Aspect Physiques et Financiers,10,252,9,QCU,0.26,0.71,37.3,38,63,101,58,38,20,1.74,65.52,Difficile,Moyen,1,Plus Facile,Pas Adapte,Economy
5806,2020,Economie,5,Le Capital et le Progres Technique,2,Le Capital: Aspect Physiques et Financiers,10,252,9,QCM,0.45,0.42,63.52,74,42,116,116,74,42,1.0,63.79,Difficile,Moyen,1,Plus Facile,Adapte,Economy
252,2015,Economie,5,Le Capital et le Progres Technique,2,Le Capital: Aspect Physiques et Financiers,10,253,10,QCU,0.61,0.38,32.84,13,26,39,38,13,25,1.03,34.21,Difficile,Difficile,0,Meme Difficulté,Pas Adapte,Economy
1363,2016,Economie,5,Le Capital et le Progres Technique,2,Le Capital: Aspect Physiques et Financiers,10,253,10,QCU,0.05,0.93,91.59,38,4,42,39,38,1,1.08,97.44,Facile,Facile,0,Meme Difficulté,Pas Adapte,Economy
2474,2017,Economie,5,Le Capital et le Progres Technique,2,Le Capital: Aspect Physiques et Financiers,10,253,10,QCU,0.55,0.35,8.69,3,33,36,22,3,19,1.64,13.64,Difficile,Difficile,0,Meme Difficulté,Pas Adapte,Economy
3585,2018,Economie,5,Le Capital et le Progres Technique,2,Le Capital: Aspect Physiques et Financiers,10,253,10,QCU,0.48,0.31,0.53,0,40,40,26,0,26,1.54,0.0,Moyen,Difficile,-1,Plus Difficile,Pas Adapte,Economy
4696,2019,Economie,5,Le Capital et le Progres Technique,2,Le Capital: Aspect Physiques et Financiers,10,253,10,QCU,0.4,0.27,21.68,7,27,34,31,7,24,1.1,22.58,Facile,Difficile,-2,Beaucoup plus Difficile,Pas Adapte,Economy
5807,2020,Economie,5,Le Capital et le Progres Technique,2,Le Capital: Aspect Physiques et Financiers,10,253,10,QCU,0.4,0.41,59.64,18,13,31,23,18,5,1.35,78.26,Moyen,Moyen,0,Meme Difficulté,Pas Adapte,Economy
253,2015,Economie,5,Le Capital et le Progres Technique,3,Les Differents Types d'Investissement et le Poids de l'Investissement Immateriel,13,254,1,QCU,0.56,0.3,21.92,14,49,63,44,14,30,1.43,31.82,Difficile,Difficile,0,Meme Difficulté,Pas Adapte,Economy
1364,2016,Economie,5,Le Capital et le Progres Technique,3,Les Differents Types d'Investissement et le Poids de l'Investissement Immateriel,13,254,1,QCU,0.65,0.38,23.09,16,52,68,49,16,33,1.39,32.65,Difficile,Difficile,0,Meme Difficulté,Pas Adapte,Economy
2475,2017,Economie,5,Le Capital et le Progres Technique,3,Les Differents Types d'Investissement et le Poids de l'Investissement Immateriel,13,254,1,QCU,0.58,0.24,29.32,20,49,69,48,20,28,1.44,41.67,Facile,Difficile,-2,Beaucoup plus Difficile,Pas Adapte,Economy
3586,2018,Economie,5,Le Capital et le Progres Technique,3,Les Differents Types d'Investissement et le Poids de l'Investissement Immateriel,13,254,1,QCM,0.67,0.23,23.95,18,59,77,75,18,57,1.03,24.0,Facile,Difficile,-2,Beaucoup plus Difficile,Pas Adapte,Economy
4697,2019,Economie,5,Le Capital et le Progres Technique,3,Les Differents Types d'Investissement et le Poids de l'Investissement Immateriel,13,254,1,QCM,0.78,0.16,10.95,7,60,67,22,7,15,3.05,31.82,Difficile,Difficile,0,Meme Difficulté,Pas Adapte,Economy
5808,2020,Economie,5,Le Capital et le Progres Technique,3,Les Differents Types d'Investissement et le Poids de l'Investissement Immateriel,13,254,1,QCM,0.66,0.21,6.53,5,64,69,20,5,15,3.45,25.0,Difficile,Difficile,0,Meme Difficulté,Pas Adapte,Economy
254,2015,Economie,5,Le Capital et le Progres Technique,3,Les Differents Types d'Investissement et le Poids de l'Investissement Immateriel,13,255,2,QCM,0.49,0.68,42.13,40,54,94,66,40,26,1.42,60.61,Moyen,Moyen,0,Meme Difficulté,Pas Adapte,Economy
1365,2016,Economie,5,Le Capital et le Progres Technique,3,Les Differents Types d'Investissement et le Poids de l'Investissement Immateriel,13,255,2,QCM,0.21,0.47,40.21,41,62,103,43,41,2,2.4,95.35,Difficile,Moyen,1,Plus Facile,Pas Adapte,Economy
2476,2017,Economie,5,Le Capital et le Progres Technique,3,Les Differents Types d'Investissement et le Poids de l'Investissement Immateriel,13,255,2,QROC,0.1,0.83,68.43,79,37,116,109,79,30,1.06,72.48,Difficile,Facile,2,Beaucoup plus Facile,Adapte,Economy
3587,2018,Economie,5,Le Capital et le Progres Technique,3,Les Differents Types d'Investissement et le Poids de l'Investissement Immateriel,13,255,2,QROC,0.19,0.89,68.43,74,34,108,95,74,21,1.14,77.89,Facile,Facile,0,Meme Difficulté,Adapte,Economy
4698,2019,Economie,5,Le Capital et le Progres Technique,3,Les Differents Types d'Investissement et le Poids de l'Investissement Immateriel,13,255,2,QROC,0.13,0.63,68.43,84,39,123,101,84,17,1.22,83.17,Facile,Facile,0,Meme Difficulté,Adapte,Economy
5809,2020,Economie,5,Le Capital et le Progres Technique,3,Les Differents Types d'Investissement et le Poids de l'Investissement Immateriel,13,255,2,QROC,0.19,0.66,68.43,96,45,141,108,96,12,1.31,88.89,Facile,Facile,0,Meme Difficulté,Adapte,Economy
255,2015,Economie,5,Le Capital et le Progres Technique,3,Les Differents Types d'Investissement et le Poids de l'Investissement Immateriel,13,256,3,QCU,0.02,0.75,94.12,7,0,7,7,7,0,1.0,100.0,Moyen,Facile,1,Plus Facile,Pas Adapte,Economy
1366,2016,Economie,5,Le Capital et le Progres Technique,3,Les Differents Types d'Investissement et le Poids de l'Investissement Immateriel,13,256,3,QCU,0.14,0.94,67.35,5,3,8,6,5,1,1.33,83.33,Difficile,Facile,2,Beaucoup plus Facile,Adapte,Economy
2477,2017,Economie,5,Le Capital et le Progres Technique,3,Les Differents Types d'Investissement et le Poids de l'Investissement Immateriel,13,256,3,QCM,0.16,0.94,67.35,5,2,7,5,5,0,1.4,100.0,Facile,Facile,0,Meme Difficulté,Adapte,Economy
3588,2018,Economie,5,Le Capital et le Progres Technique,3,Les Differents Types d'Investissement et le Poids de l'Investissement Immateriel,13,256,3,QCU,0.14,0.97,67.35,5,3,8,7,5,2,1.14,71.43,Facile,Facile,0,Meme Difficulté,Adapte,Economy
4699,2019,Economie,5,Le Capital et le Progres Technique,3,Les Differents Types d'Investissement et le Poids de l'Investissement Immateriel,13,256,3,QCU,0.05,0.87,67.35,5,2,7,6,5,1,1.17,83.33,Facile,Facile,0,Meme Difficulté,Adapte,Economy
5810,2020,Economie,5,Le Capital et le Progres Technique,3,Les Differents Types d'Investissement et le Poids de l'Investissement Immateriel,13,256,3,QCU,0.03,0.87,67.35,5,3,8,5,5,0,1.6,100.0,Facile,Facile,0,Meme Difficulté,Adapte,Economy
256,2015,Economie,5,Le Capital et le Progres Technique,3,Les Differents Types d'Investissement et le Poids de l'Investissement Immateriel,13,257,4,QCU,0.15,0.87,87.85,73,10,83,82,73,9,1.01,89.02,Moyen,Facile,1,Plus Facile,Pas Adapte,Economy
1367,2016,Economie,5,Le Capital et le Progres Technique,3,Les Differents Types d'Investissement et le Poids de l'Investissement Immateriel,13,257,4,QCU,0.05,0.99,89.24,81,10,91,88,81,7,1.03,92.05,Difficile,Facile,2,Beaucoup plus Facile,Pas Adapte,Economy
2478,2017,Economie,5,Le Capital et le Progres Technique,3,Les Differents Types d'Investissement et le Poids de l'Investissement Immateriel,13,257,4,QCU,0.35,0.68,53.51,56,49,105,100,56,44,1.05,56.0,Facile,Moyen,-1,Plus Difficile,Pas Adapte,Economy
3589,2018,Economie,5,Le Capital et le Progres Technique,3,Les Differents Types d'Investissement et le Poids de l'Investissement Immateriel,13,257,4,QCU,0.74,0.29,11.86,13,99,112,47,13,34,2.38,27.66,Difficile,Difficile,0,Meme Difficulté,Pas Adapte,Economy
4700,2019,Economie,5,Le Capital et le Progres Technique,3,Les Differents Types d'Investissement et le Poids de l'Investissement Immateriel,13,257,4,QCU,0.08,0.83,67.9,73,35,108,79,73,6,1.37,92.41,Facile,Facile,0,Meme Difficulté,Adapte,Economy
5811,2020,Economie,5,Le Capital et le Progres Technique,3,Les Differents Types d'Investissement et le Poids de l'Investissement Immateriel,13,257,4,QROC,0.16,0.85,67.9,62,30,92,90,62,28,1.02,68.89,Facile,Facile,0,Meme Difficulté,Adapte,Economy
257,2015,Economie,5,Le Capital et le Progres Technique,3,Les Differents Types d'Investissement et le Poids de l'Investissement Immateriel,13,258,5,QCM,0.1,0.83,95.72,15,1,16,15,15,0,1.07,100.0,Difficile,Facile,2,Beaucoup plus Facile,Pas Adapte,Economy
1368,2016,Economie,5,Le Capital et le Progres Technique,3,Les Differents Types d'Investissement et le Poids de l'Investissement Immateriel,13,258,5,QCM,0.03,0.71,92.3,14,1,15,14,14,0,1.07,100.0,Facile,Facile,0,Meme Difficulté,Pas Adapte,Economy
2479,2017,Economie,5,Le Capital et le Progres Technique,3,Les Differents Types d'Investissement et le Poids de l'Investissement Immateriel,13,258,5,QCM,0.07,0.8,93.39,14,1,15,14,14,0,1.07,100.0,Facile,Facile,0,Meme Difficulté,Pas Adapte,Economy
3590,2018,Economie,5,Le Capital et le Progres Technique,3,Les Differents Types d'Investissement et le Poids de l'Investissement Immateriel,13,258,5,QROC,0.86,0.14,32.18,5,12,17,8,5,3,2.12,62.5,Difficile,Difficile,0,Meme Difficulté,Pas Adapte,Economy
4701,2019,Economie,5,Le Capital et le Progres Technique,3,Les Differents Types d'Investissement et le Poids de l'Investissement Immateriel,13,258,5,QO,0.82,0.1,23.94,4,13,17,16,4,12,1.06,25.0,Facile,Difficile,-2,Beaucoup plus Difficile,Pas Adapte,Economy
5812,2020,Economie,5,Le Capital et le Progres Technique,3,Les Differents Types d'Investissement et le Poids de l'Investissement Immateriel,13,258,5,QO,0.9,0.14,22.34,3,12,15,15,3,12,1.0,20.0,Difficile,Difficile,0,Meme Difficulté,Pas Adapte,Economy
258,2015,Economie,5,Le Capital et le Progres Technique,3,Les Differents Types d'Investissement et le Poids de l'Investissement Immateriel,13,259,6,QROC,0.7,0.14,18.08,2,7,9,5,2,3,1.8,40.0,Moyen,Difficile,-1,Plus Difficile,Pas Adapte,Economy
1369,2016,Economie,5,Le Capital et le Progres Technique,3,Les Differents Types d'Investissement et le Poids de l'Investissement Immateriel,13,259,6,QROC,0.15,0.67,75.85,7,2,9,8,7,1,1.12,87.5,Difficile,Facile,2,Beaucoup plus Facile,Pas Adapte,Economy
2480,2017,Economie,5,Le Capital et le Progres Technique,3,Les Differents Types d'Investissement et le Poids de l'Investissement Immateriel,13,259,6,QO,0.78,0.03,0.33,0,10,10,7,0,7,1.43,0.0,Facile,Difficile,-2,Beaucoup plus Difficile,Pas Adapte,Economy
3591,2018,Economie,5,Le Capital et le Progres Technique,3,Les Differents Types d'Investissement et le Poids de l'Investissement Immateriel,13,259,6,QO,0.89,0.11,11.85,1,9,10,7,1,6,1.43,14.29,Moyen,Difficile,-1,Plus Difficile,Pas Adapte,Economy
4702,2019,Economie,5,Le Capital et le Progres Technique,3,Les Differents Types d'Investissement et le Poids de l'Investissement Immateriel,13,259,6,QO,0.59,0.2,51.49,5,4,9,6,5,1,1.5,83.33,Moyen,Moyen,0,Meme Difficulté,Pas Adapte,Economy
5813,2020,Economie,5,Le Capital et le Progres Technique,3,Les Differents Types d'Investissement et le Poids de l'Investissement Immateriel,13,259,6,QCM,0.43,0.52,46.64,4,4,8,7,4,3,1.14,57.14,Difficile,Moyen,1,Plus Facile,Pas Adapte,Economy
259,2015,Economie,5,Le Capital et le Progres Technique,3,Les Differents Types d'Investissement et le Poids de l'Investissement Immateriel,13,260,7,QCM,0.57,0.17,15.05,10,57,67,59,10,49,1.14,16.95,Difficile,Difficile,0,Meme Difficulté,Pas Adapte,Economy
1370,2016,Economie,5,Le Capital et le Progres Technique,3,Les Differents Types d'Investissement et le Poids de l'Investissement Immateriel,13,260,7,QCM,0.15,0.91,68.17,39,18,57,49,39,10,1.16,79.59,Facile,Facile,0,Meme Difficulté,Adapte,Economy
2481,2017,Economie,5,Le Capital et le Progres Technique,3,Les Differents Types d'Investissement et le Poids de l'Investissement Immateriel,13,260,7,QCM,0.03,0.97,68.17,45,21,66,57,45,12,1.16,78.95,Facile,Facile,0,Meme Difficulté,Adapte,Economy
3592,2018,Economie,5,Le Capital et le Progres Technique,3,Les Differents Types d'Investissement et le Poids de l'Investissement Immateriel,13,260,7,QCU,0.18,0.94,68.17,48,22,70,61,48,13,1.15,78.69,Facile,Facile,0,Meme Difficulté,Adapte,Economy
4703,2019,Economie,5,Le Capital et le Progres Technique,3,Les Differents Types d'Investissement et le Poids de l'Investissement Immateriel,13,260,7,QCU,0.03,0.88,68.17,53,25,78,67,53,14,1.16,79.1,Facile,Facile,0,Meme Difficulté,Adapte,Economy
5814,2020,Economie,5,Le Capital et le Progres Technique,3,Les Differents Types d'Investissement et le Poids de l'Investissement Immateriel,13,260,7,QCU,0.17,0.91,68.17,54,25,79,70,54,16,1.13,77.14,Facile,Facile,0,Meme Difficulté,Adapte,Economy
260,2015,Economie,5,Le Capital et le Progres Technique,3,Les Differents Types d'Investissement et le Poids de l'Investissement Immateriel,13,261,8,QCU,0.23,0.48,36.2,28,50,78,36,28,8,2.17,77.78,Facile,Moyen,-1,Plus Difficile,Pas Adapte,Economy
1371,2016,Economie,5,Le Capital et le Progres Technique,3,Les Differents Types d'Investissement et le Poids de l'Investissement Immateriel,13,261,8,QCU,0.69,0.37,8.04,6,64,70,52,6,46,1.35,11.54,Facile,Difficile,-2,Beaucoup plus Difficile,Pas Adapte,Economy
2482,2017,Economie,5,Le Capital et le Progres Technique,3,Les Differents Types d'Investissement et le Poids de l'Investissement Immateriel,13,261,8,QCU,0.59,0.35,12.74,10,70,80,50,10,40,1.6,20.0,Facile,Difficile,-2,Beaucoup plus Difficile,Pas Adapte,Economy
3593,2018,Economie,5,Le Capital et le Progres Technique,3,Les Differents Types d'Investissement et le Poids de l'Investissement Immateriel,13,261,8,QCM,0.0,0.87,96.7,79,3,82,81,79,2,1.01,97.53,Difficile,Facile,2,Beaucoup plus Facile,Pas Adapte,Economy
4704,2019,Economie,5,Le Capital et le Progres Technique,3,Les Differents Types d'Investissement et le Poids de l'Investissement Immateriel,13,261,8,QCU,0.57,0.37,17.94,14,64,78,73,14,59,1.07,19.18,Difficile,Difficile,0,Meme Difficulté,Pas Adapte,Economy
5815,2020,Economie,5,Le Capital et le Progres Technique,3,Les Differents Types d'Investissement et le Poids de l'Investissement Immateriel,13,261,8,QCM,0.72,0.23,7.01,5,61,66,45,5,40,1.47,11.11,Difficile,Difficile,0,Meme Difficulté,Pas Adapte,Economy
261,2015,Economie,5,Le Capital et le Progres Technique,3,Les Differents Types d'Investissement et le Poids de l'Investissement Immateriel,13,262,9,QCM,0.37,0.54,53.29,20,17,37,37,20,17,1.0,54.05,Difficile,Moyen,1,Plus Facile,Pas Adapte,Economy
1372,2016,Economie,5,Le Capital et le Progres Technique,3,Les Differents Types d'Investissement et le Poids de l'Investissement Immateriel,13,262,9,QCU,0.34,0.51,41.28,14,19,33,28,14,14,1.18,50.0,Difficile,Moyen,1,Plus Facile,Pas Adapte,Economy
2483,2017,Economie,5,Le Capital et le Progres Technique,3,Les Differents Types d'Investissement et le Poids de l'Investissement Immateriel,13,262,9,QCU,0.34,0.42,40.29,15,22,37,32,15,17,1.16,46.88,Difficile,Moyen,1,Plus Facile,Pas Adapte,Economy
3594,2018,Economie,5,Le Capital et le Progres Technique,3,Les Differents Types d'Investissement et le Poids de l'Investissement Immateriel,13,262,9,QCM,0.17,0.81,89.3,29,3,32,31,29,2,1.03,93.55,Moyen,Facile,1,Plus Facile,Pas Adapte,Economy
4705,2019,Economie,5,Le Capital et le Progres Technique,3,Les Differents Types d'Investissement et le Poids de l'Investissement Immateriel,13,262,9,QCM,0.44,0.39,37.11,14,23,37,28,14,14,1.32,50.0,Difficile,Moyen,1,Plus Facile,Pas Adapte,Economy
5816,2020,Economie,5,Le Capital et le Progres Technique,3,Les Differents Types d'Investissement et le Poids de l'Investissement Immateriel,13,262,9,QCM,0.12,0.97,66.62,21,11,32,28,21,7,1.14,75.0,Facile,Facile,0,Meme Difficulté,Adapte,Economy
262,2015,Economie,5,Le Capital et le Progres Technique,3,Les Differents Types d'Investissement et le Poids de l'Investissement Immateriel,13,263,10,QCU,0.72,0.2,20.94,15,56,71,26,15,11,2.73,57.69,Difficile,Difficile,0,Meme Difficulté,Pas Adapte,Economy
1373,2016,Economie,5,Le Capital et le Progres Technique,3,Les Differents Types d'Investissement et le Poids de l'Investissement Immateriel,13,263,10,QCU,0.37,0.53,58.75,48,33,81,72,48,24,1.12,66.67,Difficile,Moyen,1,Plus Facile,Pas Adapte,Economy
2484,2017,Economie,5,Le Capital et le Progres Technique,3,Les Differents Types d'Investissement et le Poids de l'Investissement Immateriel,13,263,10,QCU,0.34,0.58,51.27,46,44,90,80,46,34,1.12,57.5,Moyen,Moyen,0,Meme Difficulté,Pas Adapte,Economy
3595,2018,Economie,5,Le Capital et le Progres Technique,3,Les Differents Types d'Investissement et le Poids de l'Investissement Immateriel,13,263,10,QCM,0.53,0.25,32.87,31,64,95,53,31,22,1.79,58.49,Moyen,Difficile,-1,Plus Difficile,Pas Adapte,Economy
4706,2019,Economie,5,Le Capital et le Progres Technique,3,Les Differents Types d'Investissement et le Poids de l'Investissement Immateriel,13,263,10,QCM,0.31,0.68,53.76,46,40,86,85,46,39,1.01,54.12,Moyen,Moyen,0,Meme Difficulté,Pas Adapte,Economy
5817,2020,Economie,5,Le Capital et le Progres Technique,3,Les Differents Types d'Investissement et le Poids de l'Investissement Immateriel,13,263,10,QCM,0.14,0.87,98.3,90,2,92,92,90,2,1.0,97.83,Facile,Facile,0,Meme Difficulté,Pas Adapte,Economy
263,2015,Economie,5,Le Capital et le Progres Technique,3,Les Differents Types d'Investissement et le Poids de l'Investissement Immateriel,13,264,11,QROC,0.22,0.4,63.35,62,36,98,64,62,2,1.53,96.88,Facile,Moyen,-1,Plus Difficile,Adapte,Economy
1374,2016,Economie,5,Le Capital et le Progres Technique,3,Les Differents Types d'Investissement et le Poids de l'Investissement Immateriel,13,264,11,QROC,0.53,0.3,63.35,60,34,94,84,60,24,1.12,71.43,Moyen,Moyen,0,Meme Difficulté,Adapte,Economy
2485,2017,Economie,5,Le Capital et le Progres Technique,3,Les Differents Types d'Investissement et le Poids de l'Investissement Immateriel,13,264,11,QROC,0.4,0.26,63.35,51,30,81,64,51,13,1.27,79.69,Moyen,Moyen,0,Meme Difficulté,Adapte,Economy
3596,2018,Economie,5,Le Capital et le Progres Technique,3,Les Differents Types d'Investissement et le Poids de l'Investissement Immateriel,13,264,11,QCM,0.31,0.43,63.35,48,28,76,50,48,2,1.52,96.0,Moyen,Moyen,0,Meme Difficulté,Adapte,Economy
4707,2019,Economie,5,Le Capital et le Progres Technique,3,Les Differents Types d'Investissement et le Poids de l'Investissement Immateriel,13,264,11,QCM,0.38,0.37,63.35,46,26,72,54,46,8,1.33,85.19,Moyen,Moyen,0,Meme Difficulté,Adapte,Economy
5818,2020,Economie,5,Le Capital et le Progres Technique,3,Les Differents Types d'Investissement et le Poids de l'Investissement Immateriel,13,264,11,QROC,0.36,0.26,63.35,49,29,78,51,49,2,1.53,96.08,Moyen,Moyen,0,Meme Difficulté,Adapte,Economy
264,2015,Economie,5,Le Capital et le Progres Technique,3,Les Differents Types d'Investissement et le Poids de l'Investissement Immateriel,13,265,12,QCM,0.08,0.99,91.13,11,1,12,12,11,1,1.0,91.67,Difficile,Facile,2,Beaucoup plus Facile,Pas Adapte,Economy
1375,2016,Economie,5,Le Capital et le Progres Technique,3,Les Differents Types d'Investissement et le Poids de l'Investissement Immateriel,13,265,12,QCM,0.23,0.64,36.48,4,8,12,6,4,2,2.0,66.67,Difficile,Moyen,1,Plus Facile,Pas Adapte,Economy
2486,2017,Economie,5,Le Capital et le Progres Technique,3,Les Differents Types d'Investissement et le Poids de l'Investissement Immateriel,13,265,12,QROC,0.09,0.87,72.43,10,4,14,12,10,2,1.17,83.33,Difficile,Facile,2,Beaucoup plus Facile,Adapte,Economy
3597,2018,Economie,5,Le Capital et le Progres Technique,3,Les Differents Types d'Investissement et le Poids de l'Investissement Immateriel,13,265,12,QROC,0.1,0.86,72.43,9,4,13,10,9,1,1.3,90.0,Facile,Facile,0,Meme Difficulté,Adapte,Economy
4708,2019,Economie,5,Le Capital et le Progres Technique,3,Les Differents Types d'Investissement et le Poids de l'Investissement Immateriel,13,265,12,QROC,0.15,0.99,72.43,10,4,14,13,10,3,1.08,76.92,Facile,Facile,0,Meme Difficulté,Adapte,Economy
5819,2020,Economie,5,Le Capital et le Progres Technique,3,Les Differents Types d'Investissement et le Poids de l'Investissement Immateriel,13,265,12,QROC,0.02,0.57,72.43,9,3,12,11,9,2,1.09,81.82,Facile,Facile,0,Meme Difficulté,Adapte,Economy
265,2015,Economie,5,Le Capital et le Progres Technique,3,Les Differents Types d'Investissement et le Poids de l'Investissement Immateriel,13,266,13,QCM,0.35,0.46,41.82,17,23,40,28,17,11,1.43,60.71,Moyen,Moyen,0,Meme Difficulté,Pas Adapte,Economy
1376,2016,Economie,5,Le Capital et le Progres Technique,3,Les Differents Types d'Investissement et le Poids de l'Investissement Immateriel,13,266,13,QCM,0.53,0.15,2.8,1,40,41,28,1,27,1.46,3.57,Difficile,Difficile,0,Meme Difficulté,Pas Adapte,Economy
2487,2017,Economie,5,Le Capital et le Progres Technique,3,Les Differents Types d'Investissement et le Poids de l'Investissement Immateriel,13,266,13,QCM,0.4,0.4,63.91,29,16,45,45,29,16,1.0,64.44,Moyen,Moyen,0,Meme Difficulté,Adapte,Economy
3598,2018,Economie,5,Le Capital et le Progres Technique,3,Les Differents Types d'Investissement et le Poids de l'Investissement Immateriel,13,266,13,QCM,0.45,0.49,63.91,27,16,43,30,27,3,1.43,90.0,Moyen,Moyen,0,Meme Difficulté,Adapte,Economy
4709,2019,Economie,5,Le Capital et le Progres Technique,3,Les Differents Types d'Investissement et le Poids de l'Investissement Immateriel,13,266,13,QCM,0.21,0.53,63.91,31,17,48,45,31,14,1.07,68.89,Moyen,Moyen,0,Meme Difficulté,Adapte,Economy
5820,2020,Economie,5,Le Capital et le Progres Technique,3,Les Differents Types d'Investissement et le Poids de l'Investissement Immateriel,13,266,13,QCM,0.45,0.6,63.91,35,19,54,53,35,18,1.02,66.04,Moyen,Moyen,0,Meme Difficulté,Adapte,Economy
266,2015,Economie,5,Le Capital et le Progres Technique,4,Le Progres Technique - Nature et Role,6,267,1,QROC,0.2,0.8,95.92,54,2,56,56,54,2,1.0,96.43,Facile,Facile,0,Meme Difficulté,Pas Adapte,Economy
1377,2016,Economie,5,Le Capital et le Progres Technique,4,Le Progres Technique - Nature et Role,6,267,1,QROC,0.68,0.05,9.08,5,52,57,36,5,31,1.58,13.89,Difficile,Difficile,0,Meme Difficulté,Pas Adapte,Economy
2488,2017,Economie,5,Le Capital et le Progres Technique,4,Le Progres Technique - Nature et Role,6,267,1,QROC,0.16,0.46,88.46,44,6,50,44,44,0,1.14,100.0,Facile,Facile,0,Meme Difficulté,Pas Adapte,Economy
3599,2018,Economie,5,Le Capital et le Progres Technique,4,Le Progres Technique - Nature et Role,6,267,1,QROC,0.88,0.23,1.94,1,43,44,26,1,25,1.69,3.85,Difficile,Difficile,0,Meme Difficulté,Pas Adapte,Economy
4710,2019,Economie,5,Le Capital et le Progres Technique,4,Le Progres Technique - Nature et Role,6,267,1,QROC,0.1,0.74,68.77,33,15,48,39,33,6,1.23,84.62,Difficile,Facile,2,Beaucoup plus Facile,Adapte,Economy
5821,2020,Economie,5,Le Capital et le Progres Technique,4,Le Progres Technique - Nature et Role,6,267,1,QROC,0.12,0.6,68.77,35,16,51,49,35,14,1.04,71.43,Facile,Facile,0,Meme Difficulté,Adapte,Economy
267,2015,Economie,5,Le Capital et le Progres Technique,4,Le Progres Technique - Nature et Role,6,268,2,QCM,0.11,0.85,78.24,73,20,93,92,73,19,1.01,79.35,Moyen,Facile,1,Plus Facile,Pas Adapte,Economy
1378,2016,Economie,5,Le Capital et le Progres Technique,4,Le Progres Technique - Nature et Role,6,268,2,QCM,0.51,0.26,12.84,11,76,87,56,11,45,1.55,19.64,Moyen,Difficile,-1,Plus Difficile,Pas Adapte,Economy
2489,2017,Economie,5,Le Capital et le Progres Technique,4,Le Progres Technique - Nature et Role,6,268,2,QROC,0.44,0.35,35.15,27,51,78,35,27,8,2.23,77.14,Difficile,Moyen,1,Plus Facile,Pas Adapte,Economy
3600,2018,Economie,5,Le Capital et le Progres Technique,4,Le Progres Technique - Nature et Role,6,268,2,QROC,0.82,0.14,29.6,22,54,76,33,22,11,2.3,66.67,Difficile,Difficile,0,Meme Difficulté,Pas Adapte,Economy
4711,2019,Economie,5,Le Capital et le Progres Technique,4,Le Progres Technique - Nature et Role,6,268,2,QO,0.16,0.54,79.79,57,14,71,66,57,9,1.08,86.36,Facile,Facile,0,Meme Difficulté,Pas Adapte,Economy
5822,2020,Economie,5,Le Capital et le Progres Technique,4,Le Progres Technique - Nature et Role,6,268,2,QO,0.85,0.04,16.84,12,58,70,55,12,43,1.27,21.82,Difficile,Difficile,0,Meme Difficulté,Pas Adapte,Economy
268,2015,Economie,5,Le Capital et le Progres Technique,4,Le Progres Technique - Nature et Role,6,269,3,QCM,0.46,0.32,57.57,47,34,81,75,47,28,1.08,62.67,Difficile,Moyen,1,Plus Facile,Pas Adapte,Economy
1379,2016,Economie,5,Le Capital et le Progres Technique,4,Le Progres Technique - Nature et Role,6,269,3,QROC,0.74,0.12,19.03,15,66,81,69,15,54,1.17,21.74,Moyen,Difficile,-1,Plus Difficile,Pas Adapte,Economy
2490,2017,Economie,5,Le Capital et le Progres Technique,4,Le Progres Technique - Nature et Role,6,269,3,QROC,0.24,0.26,41.05,36,52,88,73,36,37,1.21,49.32,Facile,Moyen,-1,Plus Difficile,Pas Adapte,Economy
3601,2018,Economie,5,Le Capital et le Progres Technique,4,Le Progres Technique - Nature et Role,6,269,3,QROC,0.01,0.89,66.15,63,32,95,77,63,14,1.23,81.82,Difficile,Facile,2,Beaucoup plus Facile,Adapte,Economy
4712,2019,Economie,5,Le Capital et le Progres Technique,4,Le Progres Technique - Nature et Role,6,269,3,QROC,0.11,0.48,66.15,62,32,94,78,62,16,1.21,79.49,Facile,Facile,0,Meme Difficulté,Adapte,Economy
5823,2020,Economie,5,Le Capital et le Progres Technique,4,Le Progres Technique - Nature et Role,6,269,3,QROC,0.06,0.63,66.15,60,30,90,75,60,15,1.2,80.0,Facile,Facile,0,Meme Difficulté,Adapte,Economy
269,2015,Economie,5,Le Capital et le Progres Technique,4,Le Progres Technique - Nature et Role,6,270,4,QCU,0.11,0.94,72.61,46,18,64,62,46,16,1.03,74.19,Facile,Facile,0,Meme Difficulté,Adapte,Economy
1380,2016,Economie,5,Le Capital et le Progres Technique,4,Le Progres Technique - Nature et Role,6,270,4,QCM,0.09,0.76,72.61,42,16,58,58,42,16,1.0,72.41,Facile,Facile,0,Meme Difficulté,Adapte,Economy
2491,2017,Economie,5,Le Capital et le Progres Technique,4,Le Progres Technique - Nature et Role,6,270,4,QCM,0.18,0.97,72.61,41,15,56,43,41,2,1.3,95.35,Facile,Facile,0,Meme Difficulté,Adapte,Economy
3602,2018,Economie,5,Le Capital et le Progres Technique,4,Le Progres Technique - Nature et Role,6,270,4,QCM,0.02,0.86,72.61,38,15,53,40,38,2,1.32,95.0,Facile,Facile,0,Meme Difficulté,Adapte,Economy
4713,2019,Economie,5,Le Capital et le Progres Technique,4,Le Progres Technique - Nature et Role,6,270,4,QCU,0.16,0.79,72.61,34,13,47,37,34,3,1.27,91.89,Facile,Facile,0,Meme Difficulté,Adapte,Economy
5824,2020,Economie,5,Le Capital et le Progres Technique,4,Le Progres Technique - Nature et Role,6,270,4,QCU,0.07,0.88,72.61,30,12,42,36,30,6,1.17,83.33,Facile,Facile,0,Meme Difficulté,Adapte,Economy
270,2015,Economie,5,Le Capital et le Progres Technique,4,Le Progres Technique - Nature et Role,6,271,5,QCM,0.23,0.59,53.63,41,36,77,65,41,24,1.18,63.08,Facile,Moyen,-1,Plus Difficile,Pas Adapte,Economy
1381,2016,Economie,5,Le Capital et le Progres Technique,4,Le Progres Technique - Nature et Role,6,271,5,QCM,0.66,0.27,16.46,13,63,76,37,13,24,2.05,35.14,Difficile,Difficile,0,Meme Difficulté,Pas Adapte,Economy
2492,2017,Economie,5,Le Capital et le Progres Technique,4,Le Progres Technique - Nature et Role,6,271,5,QCM,0.11,0.8,89.89,62,7,69,69,62,7,1.0,89.86,Moyen,Facile,1,Plus Facile,Pas Adapte,Economy
3603,2018,Economie,5,Le Capital et le Progres Technique,4,Le Progres Technique - Nature et Role,6,271,5,QCM,0.32,0.55,36.79,27,46,73,28,27,1,2.61,96.43,Facile,Moyen,-1,Plus Difficile,Pas Adapte,Economy
4714,2019,Economie,5,Le Capital et le Progres Technique,4,Le Progres Technique - Nature et Role,6,271,5,QCM,0.55,0.25,12.89,11,73,84,77,11,66,1.09,14.29,Difficile,Difficile,0,Meme Difficulté,Pas Adapte,Economy
5825,2020,Economie,5,Le Capital et le Progres Technique,4,Le Progres Technique - Nature et Role,6,271,5,QCU,0.3,0.49,52.22,41,38,79,68,41,27,1.16,60.29,Moyen,Moyen,0,Meme Difficulté,Pas Adapte,Economy
271,2015,Economie,5,Le Capital et le Progres Technique,4,Le Progres Technique - Nature et Role,6,272,6,QO,0.11,0.38,87.42,81,12,93,81,81,0,1.15,100.0,Moyen,Facile,1,Plus Facile,Pas Adapte,Economy
1382,2016,Economie,5,Le Capital et le Progres Technique,4,Le Progres Technique - Nature et Role,6,272,6,QROC,0.16,0.78,77.55,67,19,86,74,67,7,1.16,90.54,Moyen,Facile,1,Plus Facile,Pas Adapte,Economy
2493,2017,Economie,5,Le Capital et le Progres Technique,4,Le Progres Technique - Nature et Role,6,272,6,QO,0.5,0.29,46.02,41,49,90,62,41,21,1.45,66.13,Difficile,Moyen,1,Plus Facile,Pas Adapte,Economy
3604,2018,Economie,5,Le Capital et le Progres Technique,4,Le Progres Technique - Nature et Role,6,272,6,QO,0.38,0.21,49.8,42,43,85,75,42,33,1.13,56.0,Moyen,Moyen,0,Meme Difficulté,Pas Adapte,Economy
4715,2019,Economie,5,Le Capital et le Progres Technique,4,Le Progres Technique - Nature et Role,6,272,6,QCU,0.48,0.27,14.56,11,67,78,51,11,40,1.53,21.57,Moyen,Difficile,-1,Plus Difficile,Pas Adapte,Economy
5826,2020,Economie,5,Le Capital et le Progres Technique,4,Le Progres Technique - Nature et Role,6,272,6,QCU,0.24,0.53,64.03,47,27,74,51,47,4,1.45,92.16,Facile,Moyen,-1,Plus Difficile,Adapte,Economy
272,2015,Marketing,1,Introduction a l'Etude du Langage,1,La Nature du Langage,5,273,1,QROC,0.99,0.19,11.61,7,52,59,46,7,39,1.28,15.22,Difficile,Difficile,0,Meme Difficulté,Pas Adapte,Marketing
1383,2016,Marketing,1,Introduction a l'Etude du Langage,1,La Nature du Langage,5,273,1,QO,0.99,0.04,5.79,3,53,56,32,3,29,1.75,9.38,Difficile,Difficile,0,Meme Difficulté,Pas Adapte,Marketing
2494,2017,Marketing,1,Introduction a l'Etude du Langage,1,La Nature du Langage,5,273,1,QO,0.18,0.52,70.21,42,18,60,49,42,7,1.22,85.71,Moyen,Facile,1,Plus Facile,Adapte,Marketing
3605,2018,Marketing,1,Introduction a l'Etude du Langage,1,La Nature du Langage,5,273,1,QROC,0.11,0.61,70.21,46,20,66,56,46,10,1.18,82.14,Facile,Facile,0,Meme Difficulté,Adapte,Marketing
4716,2019,Marketing,1,Introduction a l'Etude du Langage,1,La Nature du Langage,5,273,1,QROC,0.17,0.49,70.21,47,20,67,57,47,10,1.18,82.46,Facile,Facile,0,Meme Difficulté,Adapte,Marketing
5827,2020,Marketing,1,Introduction a l'Etude du Langage,1,La Nature du Langage,5,273,1,QROC,0.13,0.7,70.21,48,20,68,67,48,19,1.01,71.64,Facile,Facile,0,Meme Difficulté,Adapte,Marketing
273,2015,Marketing,1,Introduction a l'Etude du Langage,1,La Nature du Langage,5,274,2,QO,0.74,0.2,49.26,46,47,93,62,46,16,1.5,74.19,Facile,Moyen,-1,Plus Difficile,Pas Adapte,Marketing
1384,2016,Marketing,1,Introduction a l'Etude du Langage,1,La Nature du Langage,5,274,2,QO,0.48,0.28,59.6,64,43,107,106,64,42,1.01,60.38,Facile,Moyen,-1,Plus Difficile,Pas Adapte,Marketing
2495,2017,Marketing,1,Introduction a l'Etude du Langage,1,La Nature du Langage,5,274,2,QROC,0.18,0.49,68.36,66,30,96,71,66,5,1.35,92.96,Difficile,Facile,2,Beaucoup plus Facile,Adapte,Marketing
3606,2018,Marketing,1,Introduction a l'Etude du Langage,1,La Nature du Langage,5,274,2,QROC,0.04,0.84,68.36,75,35,110,96,75,21,1.15,78.12,Facile,Facile,0,Meme Difficulté,Adapte,Marketing
4717,2019,Marketing,1,Introduction a l'Etude du Langage,1,La Nature du Langage,5,274,2,QROC,0.04,0.57,68.36,80,37,117,90,80,10,1.3,88.89,Facile,Facile,0,Meme Difficulté,Adapte,Marketing
5828,2020,Marketing,1,Introduction a l'Etude du Langage,1,La Nature du Langage,5,274,2,QO,0.09,0.73,68.36,75,35,110,79,75,4,1.39,94.94,Facile,Facile,0,Meme Difficulté,Adapte,Marketing
274,2015,Marketing,1,Introduction a l'Etude du Langage,1,La Nature du Langage,5,275,3,QCU,0.29,0.58,55.44,27,21,48,35,27,8,1.37,77.14,Moyen,Moyen,0,Meme Difficulté,Pas Adapte,Marketing
1385,2016,Marketing,1,Introduction a l'Etude du Langage,1,La Nature du Langage,5,275,3,QCU,0.07,0.93,85.69,39,6,45,41,39,2,1.1,95.12,Moyen,Facile,1,Plus Facile,Pas Adapte,Marketing
2496,2017,Marketing,1,Introduction a l'Etude du Langage,1,La Nature du Langage,5,275,3,QCU,0.28,0.56,55.08,26,21,47,30,26,4,1.57,86.67,Moyen,Moyen,0,Meme Difficulté,Pas Adapte,Marketing
3607,2018,Marketing,1,Introduction a l'Etude du Langage,1,La Nature du Langage,5,275,3,QCU,0.41,0.24,33.33,17,33,50,33,17,16,1.52,51.52,Facile,Difficile,-2,Beaucoup plus Difficile,Pas Adapte,Marketing
4718,2019,Marketing,1,Introduction a l'Etude du Langage,1,La Nature du Langage,5,275,3,QCU,0.38,0.54,51.78,27,26,53,42,27,15,1.26,64.29,Facile,Moyen,-1,Plus Difficile,Pas Adapte,Marketing
5829,2020,Marketing,1,Introduction a l'Etude du Langage,1,La Nature du Langage,5,275,3,QCU,0.69,0.37,1.0,1,50,51,26,1,25,1.96,3.85,Moyen,Difficile,-1,Plus Difficile,Pas Adapte,Marketing
275,2015,Marketing,1,Introduction a l'Etude du Langage,1,La Nature du Langage,5,276,4,QCU,0.18,0.94,98.75,24,0,24,24,24,0,1.0,100.0,Difficile,Facile,2,Beaucoup plus Facile,Pas Adapte,Marketing
1386,2016,Marketing,1,Introduction a l'Etude du Langage,1,La Nature du Langage,5,276,4,QCU,0.73,0.29,34.06,9,17,26,18,9,9,1.44,50.0,Facile,Difficile,-2,Beaucoup plus Difficile,Pas Adapte,Marketing
2497,2017,Marketing,1,Introduction a l'Etude du Langage,1,La Nature du Langage,5,276,4,QCU,0.31,0.69,58.13,17,12,29,24,17,7,1.21,70.83,Difficile,Moyen,1,Plus Facile,Pas Adapte,Marketing
3608,2018,Marketing,1,Introduction a l'Etude du Langage,1,La Nature du Langage,5,276,4,QCU,0.64,0.29,15.7,4,22,26,24,4,20,1.08,16.67,Moyen,Difficile,-1,Plus Difficile,Pas Adapte,Marketing
4719,2019,Marketing,1,Introduction a l'Etude du Langage,1,La Nature du Langage,5,276,4,QCM,0.41,0.62,58.3,17,12,29,24,17,7,1.21,70.83,Moyen,Moyen,0,Meme Difficulté,Pas Adapte,Marketing
5830,2020,Marketing,1,Introduction a l'Etude du Langage,1,La Nature du Langage,5,276,4,QCM,0.08,0.99,95.86,27,1,28,27,27,0,1.04,100.0,Difficile,Facile,2,Beaucoup plus Facile,Pas Adapte,Marketing
276,2015,Marketing,1,Introduction a l'Etude du Langage,1,La Nature du Langage,5,277,5,QCU,0.17,0.93,73.35,56,21,77,71,56,15,1.08,78.87,Facile,Facile,0,Meme Difficulté,Adapte,Marketing
1387,2016,Marketing,1,Introduction a l'Etude du Langage,1,La Nature du Langage,5,277,5,QCU,0.04,0.78,73.35,62,23,85,68,62,6,1.25,91.18,Facile,Facile,0,Meme Difficulté,Adapte,Marketing
2498,2017,Marketing,1,Introduction a l'Etude du Langage,1,La Nature du Langage,5,277,5,QCU,0.18,0.79,73.35,70,25,95,82,70,12,1.16,85.37,Facile,Facile,0,Meme Difficulté,Adapte,Marketing
3609,2018,Marketing,1,Introduction a l'Etude du Langage,1,La Nature du Langage,5,277,5,QROC,0.04,0.84,73.35,74,27,101,94,74,20,1.07,78.72,Facile,Facile,0,Meme Difficulté,Adapte,Marketing
4720,2019,Marketing,1,Introduction a l'Etude du Langage,1,La Nature du Langage,5,277,5,QROC,0.09,0.9,73.35,73,26,99,75,73,2,1.32,97.33,Facile,Facile,0,Meme Difficulté,Adapte,Marketing
5831,2020,Marketing,1,Introduction a l'Etude du Langage,1,La Nature du Langage,5,277,5,QROC,0.07,0.58,73.35,69,25,94,81,69,12,1.16,85.19,Facile,Facile,0,Meme Difficulté,Adapte,Marketing
277,2015,Marketing,1,Introduction a l'Etude du Langage,2,La Semiotique,9,278,1,QCM,0.72,0.25,32.53,27,56,83,33,27,6,2.52,81.82,Moyen,Difficile,-1,Plus Difficile,Pas Adapte,Marketing
1388,2016,Marketing,1,Introduction a l'Etude du Langage,2,La Semiotique,9,278,1,QCM,0.77,0.17,22.51,19,66,85,54,19,35,1.57,35.19,Difficile,Difficile,0,Meme Difficulté,Pas Adapte,Marketing
2499,2017,Marketing,1,Introduction a l'Etude du Langage,2,La Semiotique,9,278,1,QCM,0.65,0.27,19.3,18,73,91,66,18,48,1.38,27.27,Moyen,Difficile,-1,Plus Difficile,Pas Adapte,Marketing
3610,2018,Marketing,1,Introduction a l'Etude du Langage,2,La Semiotique,9,278,1,QCM,0.24,0.65,35.75,36,66,102,78,36,42,1.31,46.15,Facile,Moyen,-1,Plus Difficile,Pas Adapte,Marketing
4721,2019,Marketing,1,Introduction a l'Etude du Langage,2,La Semiotique,9,278,1,QCM,0.49,0.47,38.27,37,59,96,56,37,19,1.71,66.07,Facile,Moyen,-1,Plus Difficile,Pas Adapte,Marketing
5832,2020,Marketing,1,Introduction a l'Etude du Langage,2,La Semiotique,9,278,1,QCM,0.28,0.51,37.69,40,66,106,61,40,21,1.74,65.57,Facile,Moyen,-1,Plus Difficile,Pas Adapte,Marketing
278,2015,Marketing,1,Introduction a l'Etude du Langage,2,La Semiotique,9,279,2,QCM,0.69,0.21,31.08,16,36,52,19,16,3,2.74,84.21,Difficile,Difficile,0,Meme Difficulté,Pas Adapte,Marketing
1389,2016,Marketing,1,Introduction a l'Etude du Langage,2,La Semiotique,9,279,2,QCU,0.46,0.26,25.12,11,33,44,30,11,19,1.47,36.67,Facile,Difficile,-2,Beaucoup plus Difficile,Pas Adapte,Marketing
2500,2017,Marketing,1,Introduction a l'Etude du Langage,2,La Semiotique,9,279,2,QCU,0.65,0.28,5.08,2,44,46,18,2,16,2.56,11.11,Moyen,Difficile,-1,Plus Difficile,Pas Adapte,Marketing
3611,2018,Marketing,1,Introduction a l'Etude du Langage,2,La Semiotique,9,279,2,QCU,0.29,0.47,51.61,27,26,53,45,27,18,1.18,60.0,Facile,Moyen,-1,Plus Difficile,Pas Adapte,Marketing
4722,2019,Marketing,1,Introduction a l'Etude du Langage,2,La Semiotique,9,279,2,QCU,0.06,0.84,75.06,41,14,55,47,41,6,1.17,87.23,Facile,Facile,0,Meme Difficulté,Pas Adapte,Marketing
5833,2020,Marketing,1,Introduction a l'Etude du Langage,2,La Semiotique,9,279,2,QCU,0.04,0.8,71.38,36,14,50,47,36,11,1.06,76.6,Moyen,Facile,1,Plus Facile,Adapte,Marketing
279,2015,Marketing,1,Introduction a l'Etude du Langage,2,La Semiotique,9,280,3,QCU,0.34,0.49,64.21,19,11,30,21,19,2,1.43,90.48,Difficile,Moyen,1,Plus Facile,Adapte,Marketing
1390,2016,Marketing,1,Introduction a l'Etude du Langage,2,La Semiotique,9,280,3,QCU,0.38,0.44,64.21,18,10,28,24,18,6,1.17,75.0,Moyen,Moyen,0,Meme Difficulté,Adapte,Marketing
2501,2017,Marketing,1,Introduction a l'Etude du Langage,2,La Semiotique,9,280,3,QCU,0.35,0.44,64.21,20,11,31,25,20,5,1.24,80.0,Moyen,Moyen,0,Meme Difficulté,Adapte,Marketing
3612,2018,Marketing,1,Introduction a l'Etude du Langage,2,La Semiotique,9,280,3,QCU,0.22,0.69,64.21,20,11,31,29,20,9,1.07,68.97,Moyen,Moyen,0,Meme Difficulté,Adapte,Marketing
4723,2019,Marketing,1,Introduction a l'Etude du Langage,2,La Semiotique,9,280,3,QCU,0.26,0.73,64.21,23,13,36,31,23,8,1.16,74.19,Moyen,Moyen,0,Meme Difficulté,Adapte,Marketing
5834,2020,Marketing,1,Introduction a l'Etude du Langage,2,La Semiotique,9,280,3,QCU,0.37,0.48,64.21,23,13,36,29,23,6,1.24,79.31,Moyen,Moyen,0,Meme Difficulté,Adapte,Marketing
280,2015,Marketing,1,Introduction a l'Etude du Langage,2,La Semiotique,9,281,4,QCM,0.15,0.96,75.05,75,25,100,79,75,4,1.27,94.94,Difficile,Facile,2,Beaucoup plus Facile,Pas Adapte,Marketing
1391,2016,Marketing,1,Introduction a l'Etude du Langage,2,La Semiotique,9,281,4,QCM,0.27,0.61,58.07,65,47,112,81,65,16,1.38,80.25,Facile,Moyen,-1,Plus Difficile,Pas Adapte,Marketing
2502,2017,Marketing,1,Introduction a l'Etude du Langage,2,La Semiotique,9,281,4,QCM,0.16,0.98,81.04,81,19,100,95,81,14,1.05,85.26,Moyen,Facile,1,Plus Facile,Pas Adapte,Marketing
3613,2018,Marketing,1,Introduction a l'Etude du Langage,2,La Semiotique,9,281,4,QCM,0.25,0.33,61.99,61,37,98,94,61,33,1.04,64.89,Moyen,Moyen,0,Meme Difficulté,Adapte,Marketing
4724,2019,Marketing,1,Introduction a l'Etude du Langage,2,La Semiotique,9,281,4,QCM,0.39,0.7,61.99,68,42,110,106,68,38,1.04,64.15,Moyen,Moyen,0,Meme Difficulté,Adapte,Marketing
5835,2020,Marketing,1,Introduction a l'Etude du Langage,2,La Semiotique,9,281,4,QCM,0.25,0.4,61.99,61,37,98,74,61,13,1.32,82.43,Moyen,Moyen,0,Meme Difficulté,Adapte,Marketing
281,2015,Marketing,1,Introduction a l'Etude du Langage,2,La Semiotique,9,282,5,QCM,0.57,0.15,16.3,2,13,15,8,2,6,1.88,25.0,Facile,Difficile,-2,Beaucoup plus Difficile,Pas Adapte,Marketing
1392,2016,Marketing,1,Introduction a l'Etude du Langage,2,La Semiotique,9,282,5,QCM,0.61,0.18,29.43,4,9,13,10,4,6,1.3,40.0,Facile,Difficile,-2,Beaucoup plus Difficile,Pas Adapte,Marketing
2503,2017,Marketing,1,Introduction a l'Etude du Langage,2,La Semiotique,9,282,5,QCM,0.12,0.86,90.31,10,1,11,11,10,1,1.0,90.91,Difficile,Facile,2,Beaucoup plus Facile,Pas Adapte,Marketing
3614,2018,Marketing,1,Introduction a l'Etude du Langage,2,La Semiotique,9,282,5,QCM,0.44,0.7,50.31,5,5,10,8,5,3,1.25,62.5,Facile,Moyen,-1,Plus Difficile,Pas Adapte,Marketing
4725,2019,Marketing,1,Introduction a l'Etude du Langage,2,La Semiotique,9,282,5,QCM,0.54,0.16,6.37,1,8,9,6,1,5,1.5,16.67,Difficile,Difficile,0,Meme Difficulté,Pas Adapte,Marketing
5836,2020,Marketing,1,Introduction a l'Etude du Langage,2,La Semiotique,9,282,5,QCM,0.1,0.84,85.94,8,1,9,9,8,1,1.0,88.89,Facile,Facile,0,Meme Difficulté,Pas Adapte,Marketing
282,2015,Marketing,1,Introduction a l'Etude du Langage,2,La Semiotique,9,283,6,QCU,0.13,0.91,71.15,38,16,54,50,38,12,1.08,76.0,Moyen,Facile,1,Plus Facile,Adapte,Marketing
1393,2016,Marketing,1,Introduction a l'Etude du Langage,2,La Semiotique,9,283,6,QCU,0.18,1.0,71.15,41,16,57,50,41,9,1.14,82.0,Facile,Facile,0,Meme Difficulté,Adapte,Marketing
2504,2017,Marketing,1,Introduction a l'Etude du Langage,2,La Semiotique,9,283,6,QCU,0.08,0.88,71.15,38,16,54,38,38,0,1.42,100.0,Facile,Facile,0,Meme Difficulté,Adapte,Marketing
3615,2018,Marketing,1,Introduction a l'Etude du Langage,2,La Semiotique,9,283,6,QCU,0.14,0.8,71.15,43,17,60,50,43,7,1.2,86.0,Facile,Facile,0,Meme Difficulté,Adapte,Marketing
4726,2019,Marketing,1,Introduction a l'Etude du Langage,2,La Semiotique,9,283,6,QCM,0.14,0.71,71.15,38,16,54,49,38,11,1.1,77.55,Facile,Facile,0,Meme Difficulté,Adapte,Marketing
5837,2020,Marketing,1,Introduction a l'Etude du Langage,2,La Semiotique,9,283,6,QCM,0.0,0.76,71.15,35,14,49,49,35,14,1.0,71.43,Facile,Facile,0,Meme Difficulté,Adapte,Marketing
283,2015,Marketing,1,Introduction a l'Etude du Langage,2,La Semiotique,9,284,7,QCM,0.79,0.25,20.91,10,40,50,19,10,9,2.63,52.63,Moyen,Difficile,-1,Plus Difficile,Pas Adapte,Marketing
1394,2016,Marketing,1,Introduction a l'Etude du Langage,2,La Semiotique,9,284,7,QCM,0.49,0.65,54.37,30,25,55,40,30,10,1.38,75.0,Moyen,Moyen,0,Meme Difficulté,Pas Adapte,Marketing
2505,2017,Marketing,1,Introduction a l'Etude du Langage,2,La Semiotique,9,284,7,QCM,0.09,0.96,83.9,48,9,57,56,48,8,1.02,85.71,Facile,Facile,0,Meme Difficulté,Pas Adapte,Marketing
3616,2018,Marketing,1,Introduction a l'Etude du Langage,2,La Semiotique,9,284,7,QROC,0.28,0.29,37.28,19,31,50,34,19,15,1.47,55.88,Difficile,Moyen,1,Plus Facile,Pas Adapte,Marketing
4727,2019,Marketing,1,Introduction a l'Etude du Langage,2,La Semiotique,9,284,7,QROC,0.34,0.3,53.88,23,19,42,39,23,16,1.08,58.97,Difficile,Moyen,1,Plus Facile,Pas Adapte,Marketing
5838,2020,Marketing,1,Introduction a l'Etude du Langage,2,La Semiotique,9,284,7,QROC,0.03,0.58,88.72,39,5,44,42,39,3,1.05,92.86,Difficile,Facile,2,Beaucoup plus Facile,Pas Adapte,Marketing
284,2015,Marketing,1,Introduction a l'Etude du Langage,2,La Semiotique,9,285,8,QCU,0.35,0.4,59.22,38,27,65,64,38,26,1.02,59.38,Difficile,Moyen,1,Plus Facile,Pas Adapte,Marketing
1395,2016,Marketing,1,Introduction a l'Etude du Langage,2,La Semiotique,9,285,8,QCM,0.09,0.7,83.01,60,12,72,71,60,11,1.01,84.51,Difficile,Facile,2,Beaucoup plus Facile,Pas Adapte,Marketing
2506,2017,Marketing,1,Introduction a l'Etude du Langage,2,La Semiotique,9,285,8,QCM,0.51,0.21,18.84,12,53,65,39,12,27,1.67,30.77,Difficile,Difficile,0,Meme Difficulté,Pas Adapte,Marketing
3617,2018,Marketing,1,Introduction a l'Etude du Langage,2,La Semiotique,9,285,8,QCM,0.52,0.29,1.27,1,63,64,17,1,16,3.76,5.88,Moyen,Difficile,-1,Plus Difficile,Pas Adapte,Marketing
4728,2019,Marketing,1,Introduction a l'Etude du Langage,2,La Semiotique,9,285,8,QROC,0.24,0.33,37.58,27,46,73,56,27,29,1.3,48.21,Facile,Moyen,-1,Plus Difficile,Pas Adapte,Marketing
5839,2020,Marketing,1,Introduction a l'Etude du Langage,2,La Semiotique,9,285,8,QROC,0.95,0.19,16.49,12,62,74,38,12,26,1.95,31.58,Difficile,Difficile,0,Meme Difficulté,Pas Adapte,Marketing
285,2015,Marketing,1,Introduction a l'Etude du Langage,2,La Semiotique,9,286,9,QCM,0.12,0.8,77.48,60,17,77,61,60,1,1.26,98.36,Moyen,Facile,1,Plus Facile,Pas Adapte,Marketing
1396,2016,Marketing,1,Introduction a l'Etude du Langage,2,La Semiotique,9,286,9,QCM,0.23,0.46,41.0,31,44,75,70,31,39,1.07,44.29,Difficile,Moyen,1,Plus Facile,Pas Adapte,Marketing
2507,2017,Marketing,1,Introduction a l'Etude du Langage,2,La Semiotique,9,286,9,QCM,0.04,0.93,92.16,59,5,64,62,59,3,1.03,95.16,Moyen,Facile,1,Plus Facile,Pas Adapte,Marketing
3618,2018,Marketing,1,Introduction a l'Etude du Langage,2,La Semiotique,9,286,9,QCM,0.19,0.94,73.63,43,16,59,45,43,2,1.31,95.56,Difficile,Facile,2,Beaucoup plus Facile,Adapte,Marketing
4729,2019,Marketing,1,Introduction a l'Etude du Langage,2,La Semiotique,9,286,9,QCM,0.15,0.98,73.63,43,16,59,55,43,12,1.07,78.18,Facile,Facile,0,Meme Difficulté,Adapte,Marketing
5840,2020,Marketing,1,Introduction a l'Etude du Langage,2,La Semiotique,9,286,9,QCM,0.03,0.96,73.63,50,18,68,51,50,1,1.33,98.04,Facile,Facile,0,Meme Difficulté,Adapte,Marketing
286,2015,Marketing,1,Introduction a l'Etude du Langage,3,La Morphologie,2,287,1,QROC,0.68,0.12,10.14,1,10,11,7,1,6,1.57,14.29,Moyen,Difficile,-1,Plus Difficile,Pas Adapte,Marketing
1397,2016,Marketing,1,Introduction a l'Etude du Langage,3,La Morphologie,2,287,1,QROC,0.22,0.36,57.11,6,4,10,7,6,1,1.43,85.71,Difficile,Moyen,1,Plus Facile,Pas Adapte,Marketing
2508,2017,Marketing,1,Introduction a l'Etude du Langage,3,La Morphologie,2,287,1,QROC,0.74,0.12,0.1,0,9,9,5,0,5,1.8,0.0,Moyen,Difficile,-1,Plus Difficile,Pas Adapte,Marketing
3619,2018,Marketing,1,Introduction a l'Etude du Langage,3,La Morphologie,2,287,1,QROC,0.74,0.17,29.71,3,6,9,8,3,5,1.12,37.5,Facile,Difficile,-2,Beaucoup plus Difficile,Pas Adapte,Marketing
4730,2019,Marketing,1,Introduction a l'Etude du Langage,3,La Morphologie,2,287,1,QROC,0.25,0.3,56.71,6,4,10,7,6,1,1.43,85.71,Moyen,Moyen,0,Meme Difficulté,Pas Adapte,Marketing
5841,2020,Marketing,1,Introduction a l'Etude du Langage,3,La Morphologie,2,287,1,QROC,0.34,0.28,40.85,4,7,11,9,4,5,1.22,44.44,Facile,Moyen,-1,Plus Difficile,Pas Adapte,Marketing
287,2015,Marketing,1,Introduction a l'Etude du Langage,3,La Morphologie,2,288,2,QCM,0.7,0.19,21.8,12,43,55,53,12,41,1.04,22.64,Facile,Difficile,-2,Beaucoup plus Difficile,Pas Adapte,Marketing
1398,2016,Marketing,1,Introduction a l'Etude du Langage,3,La Morphologie,2,288,2,QCU,0.05,0.92,93.67,54,4,58,55,54,1,1.05,98.18,Facile,Facile,0,Meme Difficulté,Pas Adapte,Marketing
2509,2017,Marketing,1,Introduction a l'Etude du Langage,3,La Morphologie,2,288,2,QCU,0.59,0.3,18.83,9,41,50,50,9,41,1.0,18.0,Facile,Difficile,-2,Beaucoup plus Difficile,Pas Adapte,Marketing
3620,2018,Marketing,1,Introduction a l'Etude du Langage,3,La Morphologie,2,288,2,QCU,0.19,0.77,77.64,44,13,57,56,44,12,1.02,78.57,Moyen,Facile,1,Plus Facile,Pas Adapte,Marketing
4731,2019,Marketing,1,Introduction a l'Etude du Langage,3,La Morphologie,2,288,2,QCU,0.57,0.28,34.63,21,41,62,48,21,27,1.29,43.75,Difficile,Difficile,0,Meme Difficulté,Pas Adapte,Marketing
5842,2020,Marketing,1,Introduction a l'Etude du Langage,3,La Morphologie,2,288,2,QCU,0.0,0.79,83.1,44,9,53,53,44,9,1.0,83.02,Facile,Facile,0,Meme Difficulté,Pas Adapte,Marketing
288,2015,Marketing,1,Introduction a l'Etude du Langage,4,La Phonetique,8,289,1,QCU,0.18,0.84,69.49,24,10,34,30,24,6,1.13,80.0,Moyen,Facile,1,Plus Facile,Adapte,Marketing
1399,2016,Marketing,1,Introduction a l'Etude du Langage,4,La Phonetique,8,289,1,QCU,0.19,0.92,69.49,24,10,34,32,24,8,1.06,75.0,Facile,Facile,0,Meme Difficulté,Adapte,Marketing
2510,2017,Marketing,1,Introduction a l'Etude du Langage,4,La Phonetique,8,289,1,QCU,0.04,0.87,69.49,24,10,34,29,24,5,1.17,82.76,Facile,Facile,0,Meme Difficulté,Adapte,Marketing
3621,2018,Marketing,1,Introduction a l'Etude du Langage,4,La Phonetique,8,289,1,QCU,0.05,0.86,69.49,24,10,34,32,24,8,1.06,75.0,Facile,Facile,0,Meme Difficulté,Adapte,Marketing
4732,2019,Marketing,1,Introduction a l'Etude du Langage,4,La Phonetique,8,289,1,QCM,0.18,0.86,69.49,27,12,39,29,27,2,1.34,93.1,Facile,Facile,0,Meme Difficulté,Adapte,Marketing
5843,2020,Marketing,1,Introduction a l'Etude du Langage,4,La Phonetique,8,289,1,QCM,0.05,0.98,69.49,24,11,35,24,24,0,1.46,100.0,Facile,Facile,0,Meme Difficulté,Adapte,Marketing
289,2015,Marketing,1,Introduction a l'Etude du Langage,4,La Phonetique,8,290,2,QCM,0.09,0.84,95.97,43,2,45,44,43,1,1.02,97.73,Difficile,Facile,2,Beaucoup plus Facile,Pas Adapte,Marketing
1400,2016,Marketing,1,Introduction a l'Etude du Langage,4,La Phonetique,8,290,2,QCM,0.49,0.36,56.74,27,21,48,45,27,18,1.07,60.0,Facile,Moyen,-1,Plus Difficile,Pas Adapte,Marketing
2511,2017,Marketing,1,Introduction a l'Etude du Langage,4,La Phonetique,8,290,2,QCM,0.63,0.22,23.57,11,35,46,27,11,16,1.7,40.74,Facile,Difficile,-2,Beaucoup plus Difficile,Pas Adapte,Marketing
3622,2018,Marketing,1,Introduction a l'Etude du Langage,4,La Phonetique,8,290,2,QCM,0.02,0.83,90.35,44,5,49,48,44,4,1.02,91.67,Moyen,Facile,1,Plus Facile,Pas Adapte,Marketing
4733,2019,Marketing,1,Introduction a l'Etude du Langage,4,La Phonetique,8,290,2,QCM,0.61,0.27,7.08,3,46,49,41,3,38,1.2,7.32,Difficile,Difficile,0,Meme Difficulté,Pas Adapte,Marketing
5844,2020,Marketing,1,Introduction a l'Etude du Langage,4,La Phonetique,8,290,2,QCM,0.63,0.27,23.38,13,41,54,36,13,23,1.5,36.11,Facile,Difficile,-2,Beaucoup plus Difficile,Pas Adapte,Marketing
290,2015,Marketing,1,Introduction a l'Etude du Langage,4,La Phonetique,8,291,3,QCM,0.22,0.38,59.18,20,13,33,27,20,7,1.22,74.07,Facile,Moyen,-1,Plus Difficile,Pas Adapte,Marketing
1401,2016,Marketing,1,Introduction a l'Etude du Langage,4,La Phonetique,8,291,3,QCM,0.73,0.27,10.94,4,32,36,30,4,26,1.2,13.33,Facile,Difficile,-2,Beaucoup plus Difficile,Pas Adapte,Marketing
2512,2017,Marketing,1,Introduction a l'Etude du Langage,4,La Phonetique,8,291,3,QCU,0.45,0.34,14.73,5,28,33,18,5,13,1.83,27.78,Moyen,Difficile,-1,Plus Difficile,Pas Adapte,Marketing
3623,2018,Marketing,1,Introduction a l'Etude du Langage,4,La Phonetique,8,291,3,QCU,0.7,0.25,12.06,4,33,37,28,4,24,1.32,14.29,Moyen,Difficile,-1,Plus Difficile,Pas Adapte,Marketing
4734,2019,Marketing,1,Introduction a l'Etude du Langage,4,La Phonetique,8,291,3,QCU,0.24,0.41,60.88,21,13,34,28,21,7,1.21,75.0,Difficile,Moyen,1,Plus Facile,Adapte,Marketing
5845,2020,Marketing,1,Introduction a l'Etude du Langage,4,La Phonetique,8,291,3,QCU,0.32,0.52,60.88,22,14,36,33,22,11,1.09,66.67,Moyen,Moyen,0,Meme Difficulté,Adapte,Marketing
291,2015,Marketing,1,Introduction a l'Etude du Langage,4,La Phonetique,8,292,4,QCM,0.09,0.94,89.56,79,9,88,80,79,1,1.1,98.75,Moyen,Facile,1,Plus Facile,Pas Adapte,Marketing
1402,2016,Marketing,1,Introduction a l'Etude du Langage,4,La Phonetique,8,292,4,QCM,0.16,0.87,68.99,61,27,88,63,61,2,1.4,96.83,Facile,Facile,0,Meme Difficulté,Adapte,Marketing
2513,2017,Marketing,1,Introduction a l'Etude du Langage,4,La Phonetique,8,292,4,QCM,0.09,0.92,68.99,63,28,91,85,63,22,1.07,74.12,Facile,Facile,0,Meme Difficulté,Adapte,Marketing
3624,2018,Marketing,1,Introduction a l'Etude du Langage,4,La Phonetique,8,292,4,QCM,0.17,0.81,68.99,53,24,77,63,53,10,1.22,84.13,Facile,Facile,0,Meme Difficulté,Adapte,Marketing
4735,2019,Marketing,1,Introduction a l'Etude du Langage,4,La Phonetique,8,292,4,QCM,0.09,0.86,68.99,57,26,83,70,57,13,1.19,81.43,Facile,Facile,0,Meme Difficulté,Adapte,Marketing
5846,2020,Marketing,1,Introduction a l'Etude du Langage,4,La Phonetique,8,292,4,QCM,0.01,0.9,68.99,66,29,95,72,66,6,1.32,91.67,Facile,Facile,0,Meme Difficulté,Adapte,Marketing
292,2015,Marketing,1,Introduction a l'Etude du Langage,4,La Phonetique,8,293,5,QCM,0.13,0.76,68.25,68,31,99,86,68,18,1.15,79.07,Difficile,Facile,2,Beaucoup plus Facile,Adapte,Marketing
1403,2016,Marketing,1,Introduction a l'Etude du Langage,4,La Phonetique,8,293,5,QCM,0.12,0.97,68.25,72,34,106,72,72,0,1.47,100.0,Facile,Facile,0,Meme Difficulté,Adapte,Marketing
2514,2017,Marketing,1,Introduction a l'Etude du Langage,4,La Phonetique,8,293,5,QCM,0.0,0.78,68.25,80,37,117,106,80,26,1.1,75.47,Facile,Facile,0,Meme Difficulté,Adapte,Marketing
3625,2018,Marketing,1,Introduction a l'Etude du Langage,4,La Phonetique,8,293,5,QCM,0.12,0.85,68.25,87,40,127,117,87,30,1.09,74.36,Facile,Facile,0,Meme Difficulté,Adapte,Marketing
4736,2019,Marketing,1,Introduction a l'Etude du Langage,4,La Phonetique,8,293,5,QO,0.12,0.58,68.25,96,44,140,127,96,31,1.1,75.59,Facile,Facile,0,Meme Difficulté,Adapte,Marketing
5847,2020,Marketing,1,Introduction a l'Etude du Langage,4,La Phonetique,8,293,5,QO,0.1,0.88,68.25,93,43,136,135,93,42,1.01,68.89,Facile,Facile,0,Meme Difficulté,Adapte,Marketing
293,2015,Marketing,1,Introduction a l'Etude du Langage,4,La Phonetique,8,294,6,QO,0.71,0.27,49.32,49,50,99,53,49,4,1.87,92.45,Moyen,Moyen,0,Meme Difficulté,Pas Adapte,Marketing
1404,2016,Marketing,1,Introduction a l'Etude du Langage,4,La Phonetique,8,294,6,QO,0.82,0.02,32.75,36,73,109,72,36,36,1.51,50.0,Moyen,Difficile,-1,Plus Difficile,Pas Adapte,Marketing
2515,2017,Marketing,1,Introduction a l'Etude du Langage,4,La Phonetique,8,294,6,QO,0.82,0.11,24.82,31,94,125,94,31,63,1.33,32.98,Facile,Difficile,-2,Beaucoup plus Difficile,Pas Adapte,Marketing
3626,2018,Marketing,1,Introduction a l'Etude du Langage,4,La Phonetique,8,294,6,QO,0.93,0.02,18.84,22,96,118,85,22,63,1.39,25.88,Facile,Difficile,-2,Beaucoup plus Difficile,Pas Adapte,Marketing
4737,2019,Marketing,1,Introduction a l'Etude du Langage,4,La Phonetique,8,294,6,QO,0.85,0.08,19.81,26,104,130,108,26,82,1.2,24.07,Difficile,Difficile,0,Meme Difficulté,Pas Adapte,Marketing
5848,2020,Marketing,1,Introduction a l'Etude du Langage,4,La Phonetique,8,294,6,QO,0.69,0.23,37.25,42,70,112,83,42,41,1.35,50.6,Facile,Moyen,-1,Plus Difficile,Pas Adapte,Marketing
294,2015,Marketing,1,Introduction a l'Etude du Langage,4,La Phonetique,8,295,7,QCU,0.06,0.83,68.79,40,18,58,45,40,5,1.29,88.89,Moyen,Facile,1,Plus Facile,Adapte,Marketing
1405,2016,Marketing,1,Introduction a l'Etude du Langage,4,La Phonetique,8,295,7,QCU,0.12,0.79,68.79,34,15,49,34,34,0,1.44,100.0,Facile,Facile,0,Meme Difficulté,Adapte,Marketing
2516,2017,Marketing,1,Introduction a l'Etude du Langage,4,La Phonetique,8,295,7,QCU,0.06,0.86,68.79,36,17,53,47,36,11,1.13,76.6,Facile,Facile,0,Meme Difficulté,Adapte,Marketing
3627,2018,Marketing,1,Introduction a l'Etude du Langage,4,La Phonetique,8,295,7,QCU,0.15,0.9,68.79,31,14,45,39,31,8,1.15,79.49,Facile,Facile,0,Meme Difficulté,Adapte,Marketing
4738,2019,Marketing,1,Introduction a l'Etude du Langage,4,La Phonetique,8,295,7,QCU,0.1,0.88,68.79,36,16,52,42,36,6,1.24,85.71,Facile,Facile,0,Meme Difficulté,Adapte,Marketing
5849,2020,Marketing,1,Introduction a l'Etude du Langage,4,La Phonetique,8,295,7,QCU,0.15,0.86,68.79,38,17,55,52,38,14,1.06,73.08,Facile,Facile,0,Meme Difficulté,Adapte,Marketing
295,2015,Marketing,1,Introduction a l'Etude du Langage,4,La Phonetique,8,296,8,QCU,0.54,0.34,6.34,2,25,27,17,2,15,1.59,11.76,Facile,Difficile,-2,Beaucoup plus Difficile,Pas Adapte,Marketing
1406,2016,Marketing,1,Introduction a l'Etude du Langage,4,La Phonetique,8,296,8,QCU,0.6,0.39,31.49,9,20,29,14,9,5,2.07,64.29,Facile,Difficile,-2,Beaucoup plus Difficile,Pas Adapte,Marketing
2517,2017,Marketing,1,Introduction a l'Etude du Langage,4,La Phonetique,8,296,8,QCU,0.11,0.87,72.09,21,8,29,21,21,0,1.38,100.0,Moyen,Facile,1,Plus Facile,Adapte,Marketing
3628,2018,Marketing,1,Introduction a l'Etude du Langage,4,La Phonetique,8,296,8,QCU,0.16,0.95,72.09,21,8,29,26,21,5,1.12,80.77,Facile,Facile,0,Meme Difficulté,Adapte,Marketing
4739,2019,Marketing,1,Introduction a l'Etude du Langage,4,La Phonetique,8,296,8,QCU,0.07,0.92,72.09,19,8,27,21,19,2,1.29,90.48,Facile,Facile,0,Meme Difficulté,Adapte,Marketing
5850,2020,Marketing,1,Introduction a l'Etude du Langage,4,La Phonetique,8,296,8,QCU,0.1,0.94,72.09,17,7,24,21,17,4,1.14,80.95,Facile,Facile,0,Meme Difficulté,Adapte,Marketing
296,2015,Marketing,1,Introduction a l'Etude du Langage,5,La Phonologie,2,297,1,QCU,0.07,0.86,78.37,63,18,81,66,63,3,1.23,95.45,Moyen,Facile,1,Plus Facile,Pas Adapte,Marketing
1407,2016,Marketing,1,Introduction a l'Etude du Langage,5,La Phonologie,2,297,1,QROC,0.16,0.86,85.01,79,14,93,81,79,2,1.15,97.53,Moyen,Facile,1,Plus Facile,Pas Adapte,Marketing
2518,2017,Marketing,1,Introduction a l'Etude du Langage,5,La Phonologie,2,297,1,QO,0.78,0.08,34.44,37,69,106,65,37,28,1.63,56.92,Facile,Difficile,-2,Beaucoup plus Difficile,Pas Adapte,Marketing
3629,2018,Marketing,1,Introduction a l'Etude du Langage,5,La Phonologie,2,297,1,QO,0.43,0.24,46.03,53,62,115,113,53,60,1.02,46.9,Difficile,Moyen,1,Plus Facile,Pas Adapte,Marketing
4740,2019,Marketing,1,Introduction a l'Etude du Langage,5,La Phonologie,2,297,1,QO,0.79,0.12,34.81,45,83,128,107,45,62,1.2,42.06,Moyen,Difficile,-1,Plus Difficile,Pas Adapte,Marketing
5851,2020,Marketing,1,Introduction a l'Etude du Langage,5,La Phonologie,2,297,1,QO,0.71,0.28,45.05,50,60,110,63,50,13,1.75,79.37,Facile,Moyen,-1,Plus Difficile,Pas Adapte,Marketing
297,2015,Marketing,1,Introduction a l'Etude du Langage,5,La Phonologie,2,298,2,QROC,0.82,0.16,10.38,5,43,48,46,5,41,1.04,10.87,Facile,Difficile,-2,Beaucoup plus Difficile,Pas Adapte,Marketing
1408,2016,Marketing,1,Introduction a l'Etude du Langage,5,La Phonologie,2,298,2,QROC,0.05,0.86,87.99,43,6,49,46,43,3,1.07,93.48,Difficile,Facile,2,Beaucoup plus Facile,Pas Adapte,Marketing
2519,2017,Marketing,1,Introduction a l'Etude du Langage,5,La Phonologie,2,298,2,QROC,0.43,0.33,49.32,27,27,54,34,27,7,1.59,79.41,Moyen,Moyen,0,Meme Difficulté,Pas Adapte,Marketing
3630,2018,Marketing,1,Introduction a l'Etude du Langage,5,La Phonologie,2,298,2,QROC,0.25,0.28,61.8,29,18,47,32,29,3,1.47,90.62,Moyen,Moyen,0,Meme Difficulté,Adapte,Marketing
4741,2019,Marketing,1,Introduction a l'Etude du Langage,5,La Phonologie,2,298,2,QROC,0.26,0.34,61.8,26,16,42,36,26,10,1.17,72.22,Moyen,Moyen,0,Meme Difficulté,Adapte,Marketing
5852,2020,Marketing,1,Introduction a l'Etude du Langage,5,La Phonologie,2,298,2,QO,0.69,0.18,61.8,26,16,42,37,26,11,1.14,70.27,Moyen,Moyen,0,Meme Difficulté,Adapte,Marketing
298,2015,Marketing,1,Introduction a l'Etude du Langage,6,La Syntaxe,7,299,1,QCM,0.66,0.24,20.98,20,73,93,27,20,7,3.44,74.07,Moyen,Difficile,-1,Plus Difficile,Pas Adapte,Marketing
1409,2016,Marketing,1,Introduction a l'Etude du Langage,6,La Syntaxe,7,299,1,QCM,0.05,0.77,92.14,84,7,91,90,84,6,1.01,93.33,Moyen,Facile,1,Plus Facile,Pas Adapte,Marketing
2520,2017,Marketing,1,Introduction a l'Etude du Langage,6,La Syntaxe,7,299,1,QCM,0.74,0.26,19.98,21,83,104,78,21,57,1.33,26.92,Difficile,Difficile,0,Meme Difficulté,Pas Adapte,Marketing
3631,2018,Marketing,1,Introduction a l'Etude du Langage,6,La Syntaxe,7,299,1,QCM,0.78,0.18,11.09,10,84,94,67,10,57,1.4,14.93,Facile,Difficile,-2,Beaucoup plus Difficile,Pas Adapte,Marketing
4742,2019,Marketing,1,Introduction a l'Etude du Langage,6,La Syntaxe,7,299,1,QCM,0.03,0.87,76.88,71,22,93,91,71,20,1.02,78.02,Facile,Facile,0,Meme Difficulté,Pas Adapte,Marketing
5853,2020,Marketing,1,Introduction a l'Etude du Langage,6,La Syntaxe,7,299,1,QCM,0.29,0.51,53.41,48,41,89,69,48,21,1.29,69.57,Difficile,Moyen,1,Plus Facile,Pas Adapte,Marketing
299,2015,Marketing,1,Introduction a l'Etude du Langage,6,La Syntaxe,7,300,2,QROC,0.1,0.83,85.33,21,4,25,24,21,3,1.04,87.5,Facile,Facile,0,Meme Difficulté,Pas Adapte,Marketing
1410,2016,Marketing,1,Introduction a l'Etude du Langage,6,La Syntaxe,7,300,2,QROC,0.56,0.27,64.58,19,10,29,24,19,5,1.21,79.17,Moyen,Moyen,0,Meme Difficulté,Adapte,Marketing
2521,2017,Marketing,1,Introduction a l'Etude du Langage,6,La Syntaxe,7,300,2,QROC,0.53,0.37,64.58,20,11,31,22,20,2,1.41,90.91,Moyen,Moyen,0,Meme Difficulté,Adapte,Marketing
3632,2018,Marketing,1,Introduction a l'Etude du Langage,6,La Syntaxe,7,300,2,QROC,0.26,0.38,64.58,19,11,30,22,19,3,1.36,86.36,Moyen,Moyen,0,Meme Difficulté,Adapte,Marketing
4743,2019,Marketing,1,Introduction a l'Etude du Langage,6,La Syntaxe,7,300,2,QROC,0.4,0.32,64.58,22,12,34,23,22,1,1.48,95.65,Moyen,Moyen,0,Meme Difficulté,Adapte,Marketing
5854,2020,Marketing,1,Introduction a l'Etude du Langage,6,La Syntaxe,7,300,2,QROC,0.29,0.39,64.58,21,12,33,27,21,6,1.22,77.78,Moyen,Moyen,0,Meme Difficulté,Adapte,Marketing
300,2015,Marketing,1,Introduction a l'Etude du Langage,6,La Syntaxe,7,301,3,QROC,0.16,1.0,88.54,72,9,81,76,72,4,1.07,94.74,Moyen,Facile,1,Plus Facile,Pas Adapte,Marketing
1411,2016,Marketing,1,Introduction a l'Etude du Langage,6,La Syntaxe,7,301,3,QROC,0.17,0.92,73.05,66,24,90,70,66,4,1.29,94.29,Moyen,Facile,1,Plus Facile,Adapte,Marketing
2522,2017,Marketing,1,Introduction a l'Etude du Langage,6,La Syntaxe,7,301,3,QROC,0.18,0.7,73.05,69,25,94,90,69,21,1.04,76.67,Facile,Facile,0,Meme Difficulté,Adapte,Marketing
3633,2018,Marketing,1,Introduction a l'Etude du Langage,6,La Syntaxe,7,301,3,QCM,0.14,0.88,73.05,63,23,86,77,63,14,1.12,81.82,Facile,Facile,0,Meme Difficulté,Adapte,Marketing
4744,2019,Marketing,1,Introduction a l'Etude du Langage,6,La Syntaxe,7,301,3,QCM,0.03,0.79,73.05,67,25,92,82,67,15,1.12,81.71,Facile,Facile,0,Meme Difficulté,Adapte,Marketing
5855,2020,Marketing,1,Introduction a l'Etude du Langage,6,La Syntaxe,7,301,3,QCM,0.0,0.98,73.05,65,24,89,71,65,6,1.25,91.55,Facile,Facile,0,Meme Difficulté,Adapte,Marketing
301,2015,Marketing,1,Introduction a l'Etude du Langage,6,La Syntaxe,7,302,4,QCM,0.57,0.22,1.43,1,39,40,22,1,21,1.82,4.55,Moyen,Difficile,-1,Plus Difficile,Pas Adapte,Marketing
1412,2016,Marketing,1,Introduction a l'Etude du Langage,6,La Syntaxe,7,302,4,QO,0.25,0.24,58.53,23,17,40,36,23,13,1.11,63.89,Facile,Moyen,-1,Plus Difficile,Pas Adapte,Marketing
2523,2017,Marketing,1,Introduction a l'Etude du Langage,6,La Syntaxe,7,302,4,QO,0.34,0.16,41.06,15,22,37,24,15,9,1.54,62.5,Facile,Moyen,-1,Plus Difficile,Pas Adapte,Marketing
3634,2018,Marketing,1,Introduction a l'Etude du Langage,6,La Syntaxe,7,302,4,QO,0.09,0.99,84.26,34,6,40,40,34,6,1.0,85.0,Moyen,Facile,1,Plus Facile,Pas Adapte,Marketing
4745,2019,Marketing,1,Introduction a l'Etude du Langage,6,La Syntaxe,7,302,4,QO,0.02,0.5,82.67,37,8,45,42,37,5,1.07,88.1,Moyen,Facile,1,Plus Facile,Pas Adapte,Marketing
5856,2020,Marketing,1,Introduction a l'Etude du Langage,6,La Syntaxe,7,302,4,QO,0.92,0.05,19.19,8,34,42,25,8,17,1.68,32.0,Facile,Difficile,-2,Beaucoup plus Difficile,Pas Adapte,Marketing
302,2015,Marketing,1,Introduction a l'Etude du Langage,6,La Syntaxe,7,303,5,QCM,0.02,0.96,97.05,41,1,42,42,41,1,1.0,97.62,Moyen,Facile,1,Plus Facile,Pas Adapte,Marketing
1413,2016,Marketing,1,Introduction a l'Etude du Langage,6,La Syntaxe,7,303,5,QCM,0.16,0.72,97.29,38,1,39,38,38,0,1.03,100.0,Facile,Facile,0,Meme Difficulté,Pas Adapte,Marketing
2524,2017,Marketing,1,Introduction a l'Etude du Langage,6,La Syntaxe,7,303,5,QCM,0.12,1.0,73.8,26,9,35,31,26,5,1.13,83.87,Moyen,Facile,1,Plus Facile,Adapte,Marketing
3635,2018,Marketing,1,Introduction a l'Etude du Langage,6,La Syntaxe,7,303,5,QCM,0.17,0.94,73.8,25,9,34,30,25,5,1.13,83.33,Facile,Facile,0,Meme Difficulté,Adapte,Marketing
4746,2019,Marketing,1,Introduction a l'Etude du Langage,6,La Syntaxe,7,303,5,QCM,0.11,0.85,73.8,26,9,35,32,26,6,1.09,81.25,Facile,Facile,0,Meme Difficulté,Adapte,Marketing
5857,2020,Marketing,1,Introduction a l'Etude du Langage,6,La Syntaxe,7,303,5,QCM,0.11,0.76,73.8,26,9,35,27,26,1,1.3,96.3,Facile,Facile,0,Meme Difficulté,Adapte,Marketing
303,2015,Marketing,1,Introduction a l'Etude du Langage,6,La Syntaxe,7,304,6,QCM,0.05,0.87,86.9,17,3,20,19,17,2,1.05,89.47,Moyen,Facile,1,Plus Facile,Pas Adapte,Marketing
1414,2016,Marketing,1,Introduction a l'Etude du Langage,6,La Syntaxe,7,304,6,QCM,0.1,0.71,66.96,12,6,18,15,12,3,1.2,80.0,Difficile,Facile,2,Beaucoup plus Facile,Adapte,Marketing
2525,2017,Marketing,1,Introduction a l'Etude du Langage,6,La Syntaxe,7,304,6,QCU,0.18,0.81,66.96,10,5,15,13,10,3,1.15,76.92,Facile,Facile,0,Meme Difficulté,Adapte,Marketing
3636,2018,Marketing,1,Introduction a l'Etude du Langage,6,La Syntaxe,7,304,6,QCU,0.02,0.83,66.96,11,6,17,13,11,2,1.31,84.62,Facile,Facile,0,Meme Difficulté,Adapte,Marketing
4747,2019,Marketing,1,Introduction a l'Etude du Langage,6,La Syntaxe,7,304,6,QCU,0.14,0.9,66.96,13,6,19,15,13,2,1.27,86.67,Facile,Facile,0,Meme Difficulté,Adapte,Marketing
5858,2020,Marketing,1,Introduction a l'Etude du Langage,6,La Syntaxe,7,304,6,QCU,0.05,0.77,66.96,14,7,21,18,14,4,1.17,77.78,Facile,Facile,0,Meme Difficulté,Adapte,Marketing
304,2015,Marketing,1,Introduction a l'Etude du Langage,6,La Syntaxe,7,305,7,QCU,0.34,0.52,57.27,10,8,18,10,10,0,1.8,100.0,Facile,Moyen,-1,Plus Difficile,Pas Adapte,Marketing
1415,2016,Marketing,1,Introduction a l'Etude du Langage,6,La Syntaxe,7,305,7,QCU,0.49,0.32,11.02,2,16,18,10,2,8,1.8,20.0,Facile,Difficile,-2,Beaucoup plus Difficile,Pas Adapte,Marketing
2526,2017,Marketing,1,Introduction a l'Etude du Langage,6,La Syntaxe,7,305,7,QCU,0.3,0.65,41.74,8,11,19,8,8,0,2.38,100.0,Moyen,Moyen,0,Meme Difficulté,Pas Adapte,Marketing
3637,2018,Marketing,1,Introduction a l'Etude du Langage,6,La Syntaxe,7,305,7,QCU,0.32,0.64,55.37,12,9,21,16,12,4,1.31,75.0,Difficile,Moyen,1,Plus Facile,Pas Adapte,Marketing
4748,2019,Marketing,1,Introduction a l'Etude du Langage,6,La Syntaxe,7,305,7,QCU,0.62,0.28,6.68,1,17,18,9,1,8,2.0,11.11,Facile,Difficile,-2,Beaucoup plus Difficile,Pas Adapte,Marketing
5859,2020,Marketing,1,Introduction a l'Etude du Langage,6,La Syntaxe,7,305,7,QCM,0.72,0.2,17.3,3,17,20,10,3,7,2.0,30.0,Facile,Difficile,-2,Beaucoup plus Difficile,Pas Adapte,Marketing
305,2015,Marketing,1,Introduction a l'Etude du Langage,7,Le Developpement du Langage,7,306,1,QROC,0.96,0.15,23.91,7,24,31,20,7,13,1.55,35.0,Moyen,Difficile,-1,Plus Difficile,Pas Adapte,Marketing
1416,2016,Marketing,1,Introduction a l'Etude du Langage,7,Le Developpement du Langage,7,306,1,QROC,0.4,0.34,53.58,17,15,32,18,17,1,1.78,94.44,Moyen,Moyen,0,Meme Difficulté,Pas Adapte,Marketing
2527,2017,Marketing,1,Introduction a l'Etude du Langage,7,Le Developpement du Langage,7,306,1,QROC,0.79,0.22,18.39,6,28,34,23,6,17,1.48,26.09,Difficile,Difficile,0,Meme Difficulté,Pas Adapte,Marketing
3638,2018,Marketing,1,Introduction a l'Etude du Langage,7,Le Developpement du Langage,7,306,1,QROC,0.1,0.63,78.23,24,7,31,29,24,5,1.07,82.76,Difficile,Facile,2,Beaucoup plus Facile,Pas Adapte,Marketing
4749,2019,Marketing,1,Introduction a l'Etude du Langage,7,Le Developpement du Langage,7,306,1,QROC,0.39,0.26,43.98,12,15,27,20,12,8,1.35,60.0,Moyen,Moyen,0,Meme Difficulté,Pas Adapte,Marketing
5860,2020,Marketing,1,Introduction a l'Etude du Langage,7,Le Developpement du Langage,7,306,1,QROC,0.87,0.05,27.25,7,20,27,26,7,19,1.04,26.92,Difficile,Difficile,0,Meme Difficulté,Pas Adapte,Marketing
306,2015,Marketing,1,Introduction a l'Etude du Langage,7,Le Developpement du Langage,7,307,2,QROC,0.05,0.9,88.7,46,6,52,47,46,1,1.11,97.87,Facile,Facile,0,Meme Difficulté,Pas Adapte,Marketing
1417,2016,Marketing,1,Introduction a l'Etude du Langage,7,Le Developpement du Langage,7,307,2,QO,1.0,0.12,23.67,11,37,48,27,11,16,1.78,40.74,Difficile,Difficile,0,Meme Difficulté,Pas Adapte,Marketing
2528,2017,Marketing,1,Introduction a l'Etude du Langage,7,Le Developpement du Langage,7,307,2,QO,0.54,0.21,35.39,17,30,47,33,17,16,1.42,51.52,Difficile,Moyen,1,Plus Facile,Pas Adapte,Marketing
3639,2018,Marketing,1,Introduction a l'Etude du Langage,7,Le Developpement du Langage,7,307,2,QO,0.79,0.06,33.65,16,31,47,41,16,25,1.15,39.02,Facile,Difficile,-2,Beaucoup plus Difficile,Pas Adapte,Marketing
4750,2019,Marketing,1,Introduction a l'Etude du Langage,7,Le Developpement du Langage,7,307,2,QO,0.16,0.7,81.53,39,9,48,40,39,1,1.2,97.5,Moyen,Facile,1,Plus Facile,Pas Adapte,Marketing
5861,2020,Marketing,1,Introduction a l'Etude du Langage,7,Le Developpement du Langage,7,307,2,QO,0.76,0.07,12.55,6,44,50,46,6,40,1.09,13.04,Difficile,Difficile,0,Meme Difficulté,Pas Adapte,Marketing
307,2015,Marketing,1,Introduction a l'Etude du Langage,7,Le Developpement du Langage,7,308,3,QO,0.75,0.1,27.28,19,50,69,69,19,50,1.0,27.54,Moyen,Difficile,-1,Plus Difficile,Pas Adapte,Marketing
1418,2016,Marketing,1,Introduction a l'Etude du Langage,7,Le Developpement du Langage,7,308,3,QO,0.86,0.01,29.84,22,51,73,39,22,17,1.87,56.41,Difficile,Difficile,0,Meme Difficulté,Pas Adapte,Marketing
2529,2017,Marketing,1,Introduction a l'Etude du Langage,7,Le Developpement du Langage,7,308,3,QROC,0.72,0.04,1.98,1,62,63,47,1,46,1.34,2.13,Moyen,Difficile,-1,Plus Difficile,Pas Adapte,Marketing
3640,2018,Marketing,1,Introduction a l'Etude du Langage,7,Le Developpement du Langage,7,308,3,QROC,0.98,0.0,13.8,9,59,68,67,9,58,1.01,13.43,Facile,Difficile,-2,Beaucoup plus Difficile,Pas Adapte,Marketing
4751,2019,Marketing,1,Introduction a l'Etude du Langage,7,Le Developpement du Langage,7,308,3,QROC,0.89,0.0,7.23,4,55,59,37,4,33,1.59,10.81,Facile,Difficile,-2,Beaucoup plus Difficile,Pas Adapte,Marketing
5862,2020,Marketing,1,Introduction a l'Etude du Langage,7,Le Developpement du Langage,7,308,3,QROC,0.0,0.96,87.01,45,7,52,46,45,1,1.13,97.83,Moyen,Facile,1,Plus Facile,Pas Adapte,Marketing
308,2015,Marketing,1,Introduction a l'Etude du Langage,7,Le Developpement du Langage,7,309,4,QCM,0.12,0.8,69.0,49,22,71,50,49,1,1.42,98.0,Difficile,Facile,2,Beaucoup plus Facile,Adapte,Marketing
1419,2016,Marketing,1,Introduction a l'Etude du Langage,7,Le Developpement du Langage,7,309,4,QO,0.03,0.83,69.0,55,25,80,63,55,8,1.27,87.3,Facile,Facile,0,Meme Difficulté,Adapte,Marketing
2530,2017,Marketing,1,Introduction a l'Etude du Langage,7,Le Developpement du Langage,7,309,4,QO,0.14,0.54,69.0,48,22,70,54,48,6,1.3,88.89,Facile,Facile,0,Meme Difficulté,Adapte,Marketing
3641,2018,Marketing,1,Introduction a l'Etude du Langage,7,Le Developpement du Langage,7,309,4,QO,0.13,0.85,69.0,55,24,79,75,55,20,1.05,73.33,Facile,Facile,0,Meme Difficulté,Adapte,Marketing
4752,2019,Marketing,1,Introduction a l'Etude du Langage,7,Le Developpement du Langage,7,309,4,QO,0.2,0.64,69.0,53,24,77,69,53,16,1.12,76.81,Facile,Facile,0,Meme Difficulté,Adapte,Marketing
5863,2020,Marketing,1,Introduction a l'Etude du Langage,7,Le Developpement du Langage,7,309,4,QO,0.09,0.49,69.0,49,22,71,53,49,4,1.34,92.45,Facile,Facile,0,Meme Difficulté,Adapte,Marketing
309,2015,Marketing,1,Introduction a l'Etude du Langage,7,Le Developpement du Langage,7,310,5,QCM,0.68,0.19,29.74,8,18,26,23,8,15,1.13,34.78,Difficile,Difficile,0,Meme Difficulté,Pas Adapte,Marketing
1420,2016,Marketing,1,Introduction a l'Etude du Langage,7,Le Developpement du Langage,7,310,5,QCM,0.28,0.62,55.42,13,10,23,14,13,1,1.64,92.86,Facile,Moyen,-1,Plus Difficile,Pas Adapte,Marketing
2531,2017,Marketing,1,Introduction a l'Etude du Langage,7,Le Developpement du Langage,7,310,5,QCM,0.25,0.55,55.27,11,9,20,16,11,5,1.25,68.75,Facile,Moyen,-1,Plus Difficile,Pas Adapte,Marketing
3642,2018,Marketing,1,Introduction a l'Etude du Langage,7,Le Developpement du Langage,7,310,5,QCM,0.71,0.19,13.73,3,18,21,14,3,11,1.5,21.43,Facile,Difficile,-2,Beaucoup plus Difficile,Pas Adapte,Marketing
4753,2019,Marketing,1,Introduction a l'Etude du Langage,7,Le Developpement du Langage,7,310,5,QCU,0.64,0.26,12.3,2,16,18,11,2,9,1.64,18.18,Facile,Difficile,-2,Beaucoup plus Difficile,Pas Adapte,Marketing
5864,2020,Marketing,1,Introduction a l'Etude du Langage,7,Le Developpement du Langage,7,310,5,QCU,0.69,0.27,20.82,4,13,17,12,4,8,1.42,33.33,Facile,Difficile,-2,Beaucoup plus Difficile,Pas Adapte,Marketing
310,2015,Marketing,1,Introduction a l'Etude du Langage,7,Le Developpement du Langage,7,311,6,QCU,0.33,0.44,61.8,25,15,40,29,25,4,1.38,86.21,Moyen,Moyen,0,Meme Difficulté,Adapte,Marketing
1421,2016,Marketing,1,Introduction a l'Etude du Langage,7,Le Developpement du Langage,7,311,6,QCU,0.39,0.52,61.8,27,17,44,34,27,7,1.29,79.41,Moyen,Moyen,0,Meme Difficulté,Adapte,Marketing
2532,2017,Marketing,1,Introduction a l'Etude du Langage,7,Le Developpement du Langage,7,311,6,QCU,0.36,0.66,61.8,29,18,47,41,29,12,1.15,70.73,Moyen,Moyen,0,Meme Difficulté,Adapte,Marketing
3643,2018,Marketing,1,Introduction a l'Etude du Langage,7,Le Developpement du Langage,7,311,6,QCU,0.36,0.71,61.8,32,20,52,37,32,5,1.41,86.49,Moyen,Moyen,0,Meme Difficulté,Adapte,Marketing
4754,2019,Marketing,1,Introduction a l'Etude du Langage,7,Le Developpement du Langage,7,311,6,QCU,0.2,0.64,61.8,33,20,53,44,33,11,1.2,75.0,Moyen,Moyen,0,Meme Difficulté,Adapte,Marketing
5865,2020,Marketing,1,Introduction a l'Etude du Langage,7,Le Developpement du Langage,7,311,6,QCU,0.27,0.45,61.8,36,22,58,46,36,10,1.26,78.26,Moyen,Moyen,0,Meme Difficulté,Adapte,Marketing
311,2015,Marketing,1,Introduction a l'Etude du Langage,7,Le Developpement du Langage,7,312,7,QCU,0.4,0.25,30.25,21,50,71,30,21,9,2.37,70.0,Difficile,Difficile,0,Meme Difficulté,Pas Adapte,Marketing
1422,2016,Marketing,1,Introduction a l'Etude du Langage,7,Le Developpement du Langage,7,312,7,QCM,0.09,0.83,84.23,57,11,68,64,57,7,1.06,89.06,Difficile,Facile,2,Beaucoup plus Facile,Pas Adapte,Marketing
2533,2017,Marketing,1,Introduction a l'Etude du Langage,7,Le Developpement du Langage,7,312,7,QCM,0.56,0.25,30.92,23,51,74,59,23,36,1.25,38.98,Moyen,Difficile,-1,Plus Difficile,Pas Adapte,Marketing
3644,2018,Marketing,1,Introduction a l'Etude du Langage,7,Le Developpement du Langage,7,312,7,QCM,0.09,0.97,93.32,78,6,84,82,78,4,1.02,95.12,Moyen,Facile,1,Plus Facile,Pas Adapte,Marketing
4755,2019,Marketing,1,Introduction a l'Etude du Langage,7,Le Developpement du Langage,7,312,7,QCM,0.02,0.98,66.93,56,28,84,58,56,2,1.45,96.55,Facile,Facile,0,Meme Difficulté,Adapte,Marketing
5866,2020,Marketing,1,Introduction a l'Etude du Langage,7,Le Developpement du Langage,7,312,7,QCM,0.19,0.72,66.93,59,29,88,87,59,28,1.01,67.82,Facile,Facile,0,Meme Difficulté,Adapte,Marketing
312,2015,Marketing,1,Introduction a l'Etude du Langage,8,L'Apprentissage de la Langue Seconde,10,313,1,QCM,0.02,0.93,88.98,28,4,32,30,28,2,1.07,93.33,Moyen,Facile,1,Plus Facile,Pas Adapte,Marketing
1423,2016,Marketing,1,Introduction a l'Etude du Langage,8,L'Apprentissage de la Langue Seconde,10,313,1,QCM,0.67,0.25,20.1,6,24,30,15,6,9,2.0,40.0,Facile,Difficile,-2,Beaucoup plus Difficile,Pas Adapte,Marketing
2534,2017,Marketing,1,Introduction a l'Etude du Langage,8,L'Apprentissage de la Langue Seconde,10,313,1,QCM,0.16,0.86,70.59,19,8,27,24,19,5,1.12,79.17,Facile,Facile,0,Meme Difficulté,Adapte,Marketing
3645,2018,Marketing,1,Introduction a l'Etude du Langage,8,L'Apprentissage de la Langue Seconde,10,313,1,QCM,0.05,0.87,70.59,18,8,26,20,18,2,1.3,90.0,Facile,Facile,0,Meme Difficulté,Adapte,Marketing
4756,2019,Marketing,1,Introduction a l'Etude du Langage,8,L'Apprentissage de la Langue Seconde,10,313,1,QCU,0.16,0.81,70.59,17,7,24,23,17,6,1.04,73.91,Facile,Facile,0,Meme Difficulté,Adapte,Marketing
5867,2020,Marketing,1,Introduction a l'Etude du Langage,8,L'Apprentissage de la Langue Seconde,10,313,1,QCU,0.15,0.85,70.59,14,6,20,19,14,5,1.05,73.68,Facile,Facile,0,Meme Difficulté,Adapte,Marketing
313,2015,Marketing,1,Introduction a l'Etude du Langage,8,L'Apprentissage de la Langue Seconde,10,314,2,QCM,0.18,0.77,66.47,5,3,8,6,5,1,1.33,83.33,Facile,Facile,0,Meme Difficulté,Adapte,Marketing
1424,2016,Marketing,1,Introduction a l'Etude du Langage,8,L'Apprentissage de la Langue Seconde,10,314,2,QCM,0.02,0.87,66.47,5,3,8,5,5,0,1.6,100.0,Facile,Facile,0,Meme Difficulté,Adapte,Marketing
2535,2017,Marketing,1,Introduction a l'Etude du Langage,8,L'Apprentissage de la Langue Seconde,10,314,2,QCM,0.05,0.8,66.47,5,2,7,5,5,0,1.4,100.0,Facile,Facile,0,Meme Difficulté,Adapte,Marketing
3646,2018,Marketing,1,Introduction a l'Etude du Langage,8,L'Apprentissage de la Langue Seconde,10,314,2,QROC,0.15,0.54,66.47,5,3,8,6,5,1,1.33,83.33,Facile,Facile,0,Meme Difficulté,Adapte,Marketing
4757,2019,Marketing,1,Introduction a l'Etude du Langage,8,L'Apprentissage de la Langue Seconde,10,314,2,QROC,0.08,0.84,66.47,5,2,7,5,5,0,1.4,100.0,Facile,Facile,0,Meme Difficulté,Adapte,Marketing
5868,2020,Marketing,1,Introduction a l'Etude du Langage,8,L'Apprentissage de la Langue Seconde,10,314,2,QROC,0.11,0.45,66.47,5,2,7,5,5,0,1.4,100.0,Facile,Facile,0,Meme Difficulté,Adapte,Marketing
314,2015,Marketing,1,Introduction a l'Etude du Langage,8,L'Apprentissage de la Langue Seconde,10,315,3,QCM,0.2,0.92,77.93,5,2,7,7,5,2,1.0,71.43,Moyen,Facile,1,Plus Facile,Pas Adapte,Marketing
1425,2016,Marketing,1,Introduction a l'Etude du Langage,8,L'Apprentissage de la Langue Seconde,10,315,3,QCM,0.38,0.64,55.09,3,3,6,6,3,3,1.0,50.0,Moyen,Moyen,0,Meme Difficulté,Pas Adapte,Marketing
2536,2017,Marketing,1,Introduction a l'Etude du Langage,8,L'Apprentissage de la Langue Seconde,10,315,3,QCM,0.37,0.65,55.41,3,3,6,4,3,1,1.5,75.0,Difficile,Moyen,1,Plus Facile,Pas Adapte,Marketing
3647,2018,Marketing,1,Introduction a l'Etude du Langage,8,L'Apprentissage de la Langue Seconde,10,315,3,QCM,0.54,0.27,17.79,1,5,6,6,1,5,1.0,16.67,Difficile,Difficile,0,Meme Difficulté,Pas Adapte,Marketing
4758,2019,Marketing,1,Introduction a l'Etude du Langage,8,L'Apprentissage de la Langue Seconde,10,315,3,QCM,0.51,0.24,2.42,0,5,5,3,0,3,1.67,0.0,Facile,Difficile,-2,Beaucoup plus Difficile,Pas Adapte,Marketing
5869,2020,Marketing,1,Introduction a l'Etude du Langage,8,L'Apprentissage de la Langue Seconde,10,315,3,QCM,0.73,0.24,21.54,1,5,6,3,1,2,2.0,33.33,Difficile,Difficile,0,Meme Difficulté,Pas Adapte,Marketing
315,2015,Marketing,1,Introduction a l'Etude du Langage,8,L'Apprentissage de la Langue Seconde,10,316,4,QCM,0.48,0.49,60.64,10,6,16,13,10,3,1.23,76.92,Facile,Moyen,-1,Plus Difficile,Adapte,Marketing
1426,2016,Marketing,1,Introduction a l'Etude du Langage,8,L'Apprentissage de la Langue Seconde,10,316,4,QCU,0.33,0.53,60.64,10,6,16,13,10,3,1.23,76.92,Moyen,Moyen,0,Meme Difficulté,Adapte,Marketing
2537,2017,Marketing,1,Introduction a l'Etude du Langage,8,L'Apprentissage de la Langue Seconde,10,316,4,QCU,0.25,0.65,60.64,10,7,17,14,10,4,1.21,71.43,Moyen,Moyen,0,Meme Difficulté,Adapte,Marketing
3648,2018,Marketing,1,Introduction a l'Etude du Langage,8,L'Apprentissage de la Langue Seconde,10,316,4,QCU,0.24,0.61,60.64,10,7,17,11,10,1,1.55,90.91,Moyen,Moyen,0,Meme Difficulté,Adapte,Marketing
4759,2019,Marketing,1,Introduction a l'Etude du Langage,8,L'Apprentissage de la Langue Seconde,10,316,4,QCU,0.23,0.48,60.64,12,7,19,17,12,5,1.12,70.59,Moyen,Moyen,0,Meme Difficulté,Adapte,Marketing
5870,2020,Marketing,1,Introduction a l'Etude du Langage,8,L'Apprentissage de la Langue Seconde,10,316,4,QCU,0.39,0.44,60.64,13,9,22,16,13,3,1.38,81.25,Moyen,Moyen,0,Meme Difficulté,Adapte,Marketing
316,2015,Marketing,1,Introduction a l'Etude du Langage,8,L'Apprentissage de la Langue Seconde,10,317,5,QCU,0.66,0.37,28.94,10,24,34,14,10,4,2.43,71.43,Facile,Difficile,-2,Beaucoup plus Difficile,Pas Adapte,Marketing
1427,2016,Marketing,1,Introduction a l'Etude du Langage,8,L'Apprentissage de la Langue Seconde,10,317,5,QCU,0.17,0.97,71.26,21,8,29,28,21,7,1.04,75.0,Difficile,Facile,2,Beaucoup plus Facile,Adapte,Marketing
2538,2017,Marketing,1,Introduction a l'Etude du Langage,8,L'Apprentissage de la Langue Seconde,10,317,5,QCU,0.04,0.75,71.26,24,9,33,26,24,2,1.27,92.31,Facile,Facile,0,Meme Difficulté,Adapte,Marketing
3649,2018,Marketing,1,Introduction a l'Etude du Langage,8,L'Apprentissage de la Langue Seconde,10,317,5,QCU,0.1,0.96,71.26,21,8,29,22,21,1,1.32,95.45,Facile,Facile,0,Meme Difficulté,Adapte,Marketing
4760,2019,Marketing,1,Introduction a l'Etude du Langage,8,L'Apprentissage de la Langue Seconde,10,317,5,QCU,0.14,0.76,71.26,19,7,26,24,19,5,1.08,79.17,Facile,Facile,0,Meme Difficulté,Adapte,Marketing
5871,2020,Marketing,1,Introduction a l'Etude du Langage,8,L'Apprentissage de la Langue Seconde,10,317,5,QCU,0.05,0.95,71.26,19,8,27,27,19,8,1.0,70.37,Facile,Facile,0,Meme Difficulté,Adapte,Marketing
317,2015,Marketing,1,Introduction a l'Etude du Langage,8,L'Apprentissage de la Langue Seconde,10,318,6,QO,0.91,0.0,0.73,1,78,79,41,1,40,1.93,2.44,Facile,Difficile,-2,Beaucoup plus Difficile,Pas Adapte,Marketing
1428,2016,Marketing,1,Introduction a l'Etude du Langage,8,L'Apprentissage de la Langue Seconde,10,318,6,QROC,0.92,0.23,11.75,10,76,86,59,10,49,1.46,16.95,Moyen,Difficile,-1,Plus Difficile,Pas Adapte,Marketing
2539,2017,Marketing,1,Introduction a l'Etude du Langage,8,L'Apprentissage de la Langue Seconde,10,318,6,QROC,0.08,0.69,88.0,76,10,86,86,76,10,1.0,88.37,Facile,Facile,0,Meme Difficulté,Pas Adapte,Marketing
3650,2018,Marketing,1,Introduction a l'Etude du Langage,8,L'Apprentissage de la Langue Seconde,10,318,6,QO,0.1,0.4,94.61,86,5,91,90,86,4,1.01,95.56,Facile,Facile,0,Meme Difficulté,Pas Adapte,Marketing
4761,2019,Marketing,1,Introduction a l'Etude du Langage,8,L'Apprentissage de la Langue Seconde,10,318,6,QO,0.15,0.68,95.47,79,4,83,81,79,2,1.02,97.53,Facile,Facile,0,Meme Difficulté,Pas Adapte,Marketing
5872,2020,Marketing,1,Introduction a l'Etude du Langage,8,L'Apprentissage de la Langue Seconde,10,318,6,QO,0.76,0.0,6.66,5,70,75,70,5,65,1.07,7.14,Moyen,Difficile,-1,Plus Difficile,Pas Adapte,Marketing
318,2015,Marketing,1,Introduction a l'Etude du Langage,8,L'Apprentissage de la Langue Seconde,10,319,7,QCU,0.3,0.46,54.27,28,24,52,37,28,9,1.41,75.68,Moyen,Moyen,0,Meme Difficulté,Pas Adapte,Marketing
1429,2016,Marketing,1,Introduction a l'Etude du Langage,8,L'Apprentissage de la Langue Seconde,10,319,7,QCU,0.03,0.98,84.73,42,7,49,47,42,5,1.04,89.36,Facile,Facile,0,Meme Difficulté,Pas Adapte,Marketing
2540,2017,Marketing,1,Introduction a l'Etude du Langage,8,L'Apprentissage de la Langue Seconde,10,319,7,QCU,0.52,0.25,6.25,3,44,47,39,3,36,1.21,7.69,Moyen,Difficile,-1,Plus Difficile,Pas Adapte,Marketing
3651,2018,Marketing,1,Introduction a l'Etude du Langage,8,L'Apprentissage de la Langue Seconde,10,319,7,QCU,0.59,0.31,5.36,2,44,46,23,2,21,2.0,8.7,Moyen,Difficile,-1,Plus Difficile,Pas Adapte,Marketing
4762,2019,Marketing,1,Introduction a l'Etude du Langage,8,L'Apprentissage de la Langue Seconde,10,319,7,QCU,0.62,0.32,4.29,2,48,50,36,2,34,1.39,5.56,Facile,Difficile,-2,Beaucoup plus Difficile,Pas Adapte,Marketing
5873,2020,Marketing,1,Introduction a l'Etude du Langage,8,L'Apprentissage de la Langue Seconde,10,319,7,QCU,0.62,0.34,33.71,19,37,56,54,19,35,1.04,35.19,Difficile,Difficile,0,Meme Difficulté,Pas Adapte,Marketing
319,2015,Marketing,1,Introduction a l'Etude du Langage,8,L'Apprentissage de la Langue Seconde,10,320,8,QCU,0.75,0.26,9.83,3,32,35,12,3,9,2.92,25.0,Difficile,Difficile,0,Meme Difficulté,Pas Adapte,Marketing
1430,2016,Marketing,1,Introduction a l'Etude du Langage,8,L'Apprentissage de la Langue Seconde,10,320,8,QCU,0.37,0.42,61.28,20,12,32,25,20,5,1.28,80.0,Difficile,Moyen,1,Plus Facile,Adapte,Marketing
2541,2017,Marketing,1,Introduction a l'Etude du Langage,8,L'Apprentissage de la Langue Seconde,10,320,8,QCU,0.23,0.42,61.28,19,12,31,25,19,6,1.24,76.0,Moyen,Moyen,0,Meme Difficulté,Adapte,Marketing
3652,2018,Marketing,1,Introduction a l'Etude du Langage,8,L'Apprentissage de la Langue Seconde,10,320,8,QCU,0.29,0.72,61.28,18,12,30,19,18,1,1.58,94.74,Moyen,Moyen,0,Meme Difficulté,Adapte,Marketing
4763,2019,Marketing,1,Introduction a l'Etude du Langage,8,L'Apprentissage de la Langue Seconde,10,320,8,QCU,0.21,0.51,61.28,18,11,29,28,18,10,1.04,64.29,Moyen,Moyen,0,Meme Difficulté,Adapte,Marketing
5874,2020,Marketing,1,Introduction a l'Etude du Langage,8,L'Apprentissage de la Langue Seconde,10,320,8,QCU,0.37,0.71,61.28,16,10,26,22,16,6,1.18,72.73,Moyen,Moyen,0,Meme Difficulté,Adapte,Marketing
320,2015,Marketing,1,Introduction a l'Etude du Langage,8,L'Apprentissage de la Langue Seconde,10,321,9,QCM,0.68,0.23,3.78,2,46,48,34,2,32,1.41,5.88,Difficile,Difficile,0,Meme Difficulté,Pas Adapte,Marketing
1431,2016,Marketing,1,Introduction a l'Etude du Langage,8,L'Apprentissage de la Langue Seconde,10,321,9,QCM,0.39,0.4,50.63,22,21,43,43,22,21,1.0,51.16,Moyen,Moyen,0,Meme Difficulté,Pas Adapte,Marketing
2542,2017,Marketing,1,Introduction a l'Etude du Langage,8,L'Apprentissage de la Langue Seconde,10,321,9,QCM,0.05,0.75,71.58,30,12,42,37,30,7,1.14,81.08,Difficile,Facile,2,Beaucoup plus Facile,Adapte,Marketing
3653,2018,Marketing,1,Introduction a l'Etude du Langage,8,L'Apprentissage de la Langue Seconde,10,321,9,QCM,0.03,0.97,71.58,30,12,42,32,30,2,1.31,93.75,Facile,Facile,0,Meme Difficulté,Adapte,Marketing
4764,2019,Marketing,1,Introduction a l'Etude du Langage,8,L'Apprentissage de la Langue Seconde,10,321,9,QCM,0.09,0.88,71.58,33,13,46,43,33,10,1.07,76.74,Facile,Facile,0,Meme Difficulté,Adapte,Marketing
5875,2020,Marketing,1,Introduction a l'Etude du Langage,8,L'Apprentissage de la Langue Seconde,10,321,9,QCM,0.05,0.74,71.58,35,14,49,41,35,6,1.2,85.37,Facile,Facile,0,Meme Difficulté,Adapte,Marketing
321,2015,Marketing,1,Introduction a l'Etude du Langage,8,L'Apprentissage de la Langue Seconde,10,322,10,QCM,0.03,0.79,79.28,66,17,83,76,66,10,1.09,86.84,Difficile,Facile,2,Beaucoup plus Facile,Pas Adapte,Marketing
1432,2016,Marketing,1,Introduction a l'Etude du Langage,8,L'Apprentissage de la Langue Seconde,10,322,10,QCM,0.34,0.63,42.22,36,49,85,54,36,18,1.57,66.67,Moyen,Moyen,0,Meme Difficulté,Pas Adapte,Marketing
2543,2017,Marketing,1,Introduction a l'Etude du Langage,8,L'Apprentissage de la Langue Seconde,10,322,10,QCM,0.71,0.27,16.06,15,79,94,68,15,53,1.38,22.06,Facile,Difficile,-2,Beaucoup plus Difficile,Pas Adapte,Marketing
3654,2018,Marketing,1,Introduction a l'Etude du Langage,8,L'Apprentissage de la Langue Seconde,10,322,10,QCM,0.77,0.2,13.52,11,73,84,51,11,40,1.65,21.57,Facile,Difficile,-2,Beaucoup plus Difficile,Pas Adapte,Marketing
4765,2019,Marketing,1,Introduction a l'Etude du Langage,8,L'Apprentissage de la Langue Seconde,10,322,10,QROC,0.12,0.91,81.08,60,14,74,71,60,11,1.04,84.51,Difficile,Facile,2,Beaucoup plus Facile,Pas Adapte,Marketing
5876,2020,Marketing,1,Introduction a l'Etude du Langage,8,L'Apprentissage de la Langue Seconde,10,322,10,QROC,0.94,0.11,24.33,16,49,65,50,16,34,1.3,32.0,Moyen,Difficile,-1,Plus Difficile,Pas Adapte,Marketing
322,2015,Marketing,1,Introduction a l'Etude du Langage,9,La Sociolinguistique et la Dialectologie,12,323,1,QCU,0.34,0.45,41.2,33,47,80,39,33,6,2.05,84.62,Moyen,Moyen,0,Meme Difficulté,Pas Adapte,Marketing
1433,2016,Marketing,1,Introduction a l'Etude du Langage,9,La Sociolinguistique et la Dialectologie,12,323,1,QCU,0.07,0.77,81.6,73,17,90,76,73,3,1.18,96.05,Difficile,Facile,2,Beaucoup plus Facile,Pas Adapte,Marketing
2544,2017,Marketing,1,Introduction a l'Etude du Langage,9,La Sociolinguistique et la Dialectologie,12,323,1,QCU,0.6,0.35,15.85,13,67,80,56,13,43,1.43,23.21,Facile,Difficile,-2,Beaucoup plus Difficile,Pas Adapte,Marketing
3655,2018,Marketing,1,Introduction a l'Etude du Langage,9,La Sociolinguistique et la Dialectologie,12,323,1,QCU,0.18,0.82,87.33,76,11,87,82,76,6,1.06,92.68,Moyen,Facile,1,Plus Facile,Pas Adapte,Marketing
4766,2019,Marketing,1,Introduction a l'Etude du Langage,9,La Sociolinguistique et la Dialectologie,12,323,1,QCU,0.29,0.71,55.24,41,34,75,63,41,22,1.19,65.08,Difficile,Moyen,1,Plus Facile,Pas Adapte,Marketing
5877,2020,Marketing,1,Introduction a l'Etude du Langage,9,La Sociolinguistique et la Dialectologie,12,323,1,QCU,0.56,0.37,18.61,15,68,83,61,15,46,1.36,24.59,Facile,Difficile,-2,Beaucoup plus Difficile,Pas Adapte,Marketing
323,2015,Marketing,1,Introduction a l'Etude du Langage,9,La Sociolinguistique et la Dialectologie,12,324,2,QCM,0.77,0.24,30.55,24,54,78,49,24,25,1.59,48.98,Difficile,Difficile,0,Meme Difficulté,Pas Adapte,Marketing
1434,2016,Marketing,1,Introduction a l'Etude du Langage,9,La Sociolinguistique et la Dialectologie,12,324,2,QCM,0.02,0.7,67.42,51,24,75,71,51,20,1.06,71.83,Facile,Facile,0,Meme Difficulté,Adapte,Marketing
2545,2017,Marketing,1,Introduction a l'Etude du Langage,9,La Sociolinguistique et la Dialectologie,12,324,2,QCM,0.02,0.75,67.42,46,22,68,57,46,11,1.19,80.7,Facile,Facile,0,Meme Difficulté,Adapte,Marketing
3656,2018,Marketing,1,Introduction a l'Etude du Langage,9,La Sociolinguistique et la Dialectologie,12,324,2,QCM,0.02,0.98,67.42,44,22,66,51,44,7,1.29,86.27,Facile,Facile,0,Meme Difficulté,Adapte,Marketing
4767,2019,Marketing,1,Introduction a l'Etude du Langage,9,La Sociolinguistique et la Dialectologie,12,324,2,QCM,0.03,0.92,67.42,51,24,75,59,51,8,1.27,86.44,Facile,Facile,0,Meme Difficulté,Adapte,Marketing
5878,2020,Marketing,1,Introduction a l'Etude du Langage,9,La Sociolinguistique et la Dialectologie,12,324,2,QCU,0.0,0.77,67.42,48,23,71,50,48,2,1.42,96.0,Facile,Facile,0,Meme Difficulté,Adapte,Marketing
324,2015,Marketing,1,Introduction a l'Etude du Langage,9,La Sociolinguistique et la Dialectologie,12,325,3,QCU,0.36,0.57,35.48,7,12,19,13,7,6,1.46,53.85,Facile,Moyen,-1,Plus Difficile,Pas Adapte,Marketing
1435,2016,Marketing,1,Introduction a l'Etude du Langage,9,La Sociolinguistique et la Dialectologie,12,325,3,QCU,0.17,0.9,75.29,13,4,17,15,13,2,1.13,86.67,Difficile,Facile,2,Beaucoup plus Facile,Pas Adapte,Marketing
2546,2017,Marketing,1,Introduction a l'Etude du Langage,9,La Sociolinguistique et la Dialectologie,12,325,3,QROC,0.93,0.07,17.98,3,13,16,12,3,9,1.33,25.0,Facile,Difficile,-2,Beaucoup plus Difficile,Pas Adapte,Marketing
3657,2018,Marketing,1,Introduction a l'Etude du Langage,9,La Sociolinguistique et la Dialectologie,12,325,3,QROC,0.73,0.07,15.34,2,12,14,13,2,11,1.08,15.38,Difficile,Difficile,0,Meme Difficulté,Pas Adapte,Marketing
4768,2019,Marketing,1,Introduction a l'Etude du Langage,9,La Sociolinguistique et la Dialectologie,12,325,3,QROC,0.39,0.36,57.03,8,6,14,13,8,5,1.08,61.54,Difficile,Moyen,1,Plus Facile,Pas Adapte,Marketing
5879,2020,Marketing,1,Introduction a l'Etude du Langage,9,La Sociolinguistique et la Dialectologie,12,325,3,QROC,0.36,0.4,54.55,7,6,13,10,7,3,1.3,70.0,Moyen,Moyen,0,Meme Difficulté,Pas Adapte,Marketing
325,2015,Marketing,1,Introduction a l'Etude du Langage,9,La Sociolinguistique et la Dialectologie,12,326,4,QCM,0.45,0.51,58.05,34,25,59,46,34,12,1.28,73.91,Moyen,Moyen,0,Meme Difficulté,Pas Adapte,Marketing
1436,2016,Marketing,1,Introduction a l'Etude du Langage,9,La Sociolinguistique et la Dialectologie,12,326,4,QCM,0.1,0.96,77.62,48,14,62,58,48,10,1.07,82.76,Difficile,Facile,2,Beaucoup plus Facile,Pas Adapte,Marketing
2547,2017,Marketing,1,Introduction a l'Etude du Langage,9,La Sociolinguistique et la Dialectologie,12,326,4,QCM,0.74,0.25,34.18,21,41,62,41,21,20,1.51,51.22,Moyen,Difficile,-1,Plus Difficile,Pas Adapte,Marketing
3658,2018,Marketing,1,Introduction a l'Etude du Langage,9,La Sociolinguistique et la Dialectologie,12,326,4,QCM,0.49,0.56,39.07,23,36,59,57,23,34,1.04,40.35,Moyen,Moyen,0,Meme Difficulté,Pas Adapte,Marketing
4769,2019,Marketing,1,Introduction a l'Etude du Langage,9,La Sociolinguistique et la Dialectologie,12,326,4,QCM,0.03,0.79,70.71,45,18,63,52,45,7,1.21,86.54,Moyen,Facile,1,Plus Facile,Adapte,Marketing
5880,2020,Marketing,1,Introduction a l'Etude du Langage,9,La Sociolinguistique et la Dialectologie,12,326,4,QCM,0.01,0.85,70.71,45,18,63,57,45,12,1.11,78.95,Facile,Facile,0,Meme Difficulté,Adapte,Marketing
326,2015,Marketing,1,Introduction a l'Etude du Langage,9,La Sociolinguistique et la Dialectologie,12,327,5,QCM,0.4,0.58,39.45,17,25,42,36,17,19,1.17,47.22,Difficile,Moyen,1,Plus Facile,Pas Adapte,Marketing
1437,2016,Marketing,1,Introduction a l'Etude du Langage,9,La Sociolinguistique et la Dialectologie,12,327,5,QCM,0.03,0.77,84.24,38,7,45,39,38,1,1.15,97.44,Moyen,Facile,1,Plus Facile,Pas Adapte,Marketing
2548,2017,Marketing,1,Introduction a l'Etude du Langage,9,La Sociolinguistique et la Dialectologie,12,327,5,QCU,0.28,0.71,42.87,21,27,48,23,21,2,2.09,91.3,Difficile,Moyen,1,Plus Facile,Pas Adapte,Marketing
3659,2018,Marketing,1,Introduction a l'Etude du Langage,9,La Sociolinguistique et la Dialectologie,12,327,5,QCU,0.38,0.68,49.89,26,27,53,33,26,7,1.61,78.79,Facile,Moyen,-1,Plus Difficile,Pas Adapte,Marketing
4770,2019,Marketing,1,Introduction a l'Etude du Langage,9,La Sociolinguistique et la Dialectologie,12,327,5,QCU,0.24,0.48,47.28,28,31,59,32,28,4,1.84,87.5,Moyen,Moyen,0,Meme Difficulté,Pas Adapte,Marketing
5881,2020,Marketing,1,Introduction a l'Etude du Langage,9,La Sociolinguistique et la Dialectologie,12,327,5,QCU,0.02,0.95,97.78,62,1,63,63,62,1,1.0,98.41,Difficile,Facile,2,Beaucoup plus Facile,Pas Adapte,Marketing
327,2015,Marketing,1,Introduction a l'Etude du Langage,9,La Sociolinguistique et la Dialectologie,12,328,6,QCU,0.55,0.2,24.04,9,29,38,16,9,7,2.38,56.25,Difficile,Difficile,0,Meme Difficulté,Pas Adapte,Marketing
1438,2016,Marketing,1,Introduction a l'Etude du Langage,9,La Sociolinguistique et la Dialectologie,12,328,6,QCM,0.16,0.88,70.67,23,10,33,29,23,6,1.14,79.31,Difficile,Facile,2,Beaucoup plus Facile,Adapte,Marketing
2549,2017,Marketing,1,Introduction a l'Etude du Langage,9,La Sociolinguistique et la Dialectologie,12,328,6,QCU,0.19,0.81,70.67,21,9,30,23,21,2,1.3,91.3,Facile,Facile,0,Meme Difficulté,Adapte,Marketing
3660,2018,Marketing,1,Introduction a l'Etude du Langage,9,La Sociolinguistique et la Dialectologie,12,328,6,QCU,0.19,0.95,70.67,22,9,31,29,22,7,1.07,75.86,Facile,Facile,0,Meme Difficulté,Adapte,Marketing
4771,2019,Marketing,1,Introduction a l'Etude du Langage,9,La Sociolinguistique et la Dialectologie,12,328,6,QCU,0.09,0.79,70.67,20,8,28,24,20,4,1.17,83.33,Facile,Facile,0,Meme Difficulté,Adapte,Marketing
5882,2020,Marketing,1,Introduction a l'Etude du Langage,9,La Sociolinguistique et la Dialectologie,12,328,6,QCU,0.11,0.96,70.67,20,9,29,27,20,7,1.07,74.07,Facile,Facile,0,Meme Difficulté,Adapte,Marketing
328,2015,Marketing,1,Introduction a l'Etude du Langage,9,La Sociolinguistique et la Dialectologie,12,329,7,QCU,0.43,0.37,31.71,5,11,16,16,5,11,1.0,31.25,Difficile,Difficile,0,Meme Difficulté,Pas Adapte,Marketing
1439,2016,Marketing,1,Introduction a l'Etude du Langage,9,La Sociolinguistique et la Dialectologie,12,329,7,QCU,0.03,0.76,91.14,13,1,14,13,13,0,1.08,100.0,Moyen,Facile,1,Plus Facile,Pas Adapte,Marketing
2550,2017,Marketing,1,Introduction a l'Etude du Langage,9,La Sociolinguistique et la Dialectologie,12,329,7,QCU,0.4,0.23,0.08,0,16,16,12,0,12,1.33,0.0,Difficile,Difficile,0,Meme Difficulté,Pas Adapte,Marketing
3661,2018,Marketing,1,Introduction a l'Etude du Langage,9,La Sociolinguistique et la Dialectologie,12,329,7,QCU,0.16,1.0,76.89,12,4,16,15,12,3,1.07,80.0,Facile,Facile,0,Meme Difficulté,Pas Adapte,Marketing
4772,2019,Marketing,1,Introduction a l'Etude du Langage,9,La Sociolinguistique et la Dialectologie,12,329,7,QCU,0.41,0.24,18.26,3,14,17,7,3,4,2.43,42.86,Moyen,Difficile,-1,Plus Difficile,Pas Adapte,Marketing
5883,2020,Marketing,1,Introduction a l'Etude du Langage,9,La Sociolinguistique et la Dialectologie,12,329,7,QCU,0.43,0.25,18.87,3,12,15,8,3,5,1.88,37.5,Difficile,Difficile,0,Meme Difficulté,Pas Adapte,Marketing
329,2015,Marketing,1,Introduction a l'Etude du Langage,9,La Sociolinguistique et la Dialectologie,12,330,8,QCM,0.35,0.57,55.99,7,5,12,8,7,1,1.5,87.5,Difficile,Moyen,1,Plus Facile,Pas Adapte,Marketing
1440,2016,Marketing,1,Introduction a l'Etude du Langage,9,La Sociolinguistique et la Dialectologie,12,330,8,QCU,0.53,0.36,8.86,1,11,12,7,1,6,1.71,14.29,Difficile,Difficile,0,Meme Difficulté,Pas Adapte,Marketing
2551,2017,Marketing,1,Introduction a l'Etude du Langage,9,La Sociolinguistique et la Dialectologie,12,330,8,QCU,0.19,0.94,76.28,11,3,14,14,11,3,1.0,78.57,Facile,Facile,0,Meme Difficulté,Pas Adapte,Marketing
3662,2018,Marketing,1,Introduction a l'Etude du Langage,9,La Sociolinguistique et la Dialectologie,12,330,8,QCU,0.56,0.26,21.6,3,12,15,12,3,9,1.25,25.0,Facile,Difficile,-2,Beaucoup plus Difficile,Pas Adapte,Marketing
4773,2019,Marketing,1,Introduction a l'Etude du Langage,9,La Sociolinguistique et la Dialectologie,12,330,8,QCU,0.29,0.47,49.47,7,7,14,13,7,6,1.08,53.85,Moyen,Moyen,0,Meme Difficulté,Pas Adapte,Marketing
5884,2020,Marketing,1,Introduction a l'Etude du Langage,9,La Sociolinguistique et la Dialectologie,12,330,8,QCM,0.58,0.16,28.23,4,10,14,9,4,5,1.56,44.44,Facile,Difficile,-2,Beaucoup plus Difficile,Pas Adapte,Marketing
330,2015,Marketing,1,Introduction a l'Etude du Langage,9,La Sociolinguistique et la Dialectologie,12,331,9,QCM,0.08,0.74,92.61,84,7,91,89,84,5,1.02,94.38,Moyen,Facile,1,Plus Facile,Pas Adapte,Marketing
1441,2016,Marketing,1,Introduction a l'Etude du Langage,9,La Sociolinguistique et la Dialectologie,12,331,9,QCM,0.16,0.72,98.03,92,2,94,92,92,0,1.02,100.0,Moyen,Facile,1,Plus Facile,Pas Adapte,Marketing
2552,2017,Marketing,1,Introduction a l'Etude du Langage,9,La Sociolinguistique et la Dialectologie,12,331,9,QCM,0.69,0.19,13.13,14,89,103,71,14,57,1.45,19.72,Facile,Difficile,-2,Beaucoup plus Difficile,Pas Adapte,Marketing
3663,2018,Marketing,1,Introduction a l'Etude du Langage,9,La Sociolinguistique et la Dialectologie,12,331,9,QCM,0.48,0.55,37.03,44,74,118,48,44,4,2.46,91.67,Facile,Moyen,-1,Plus Difficile,Pas Adapte,Marketing
4774,2019,Marketing,1,Introduction a l'Etude du Langage,9,La Sociolinguistique et la Dialectologie,12,331,9,QCM,0.68,0.16,13.24,16,104,120,74,16,58,1.62,21.62,Facile,Difficile,-2,Beaucoup plus Difficile,Pas Adapte,Marketing
5885,2020,Marketing,1,Introduction a l'Etude du Langage,9,La Sociolinguistique et la Dialectologie,12,331,9,QCM,0.24,0.58,37.44,39,66,105,81,39,42,1.3,48.15,Facile,Moyen,-1,Plus Difficile,Pas Adapte,Marketing
331,2015,Marketing,1,Introduction a l'Etude du Langage,9,La Sociolinguistique et la Dialectologie,12,332,10,QCM,0.07,0.79,80.55,49,12,61,50,49,1,1.22,98.0,Difficile,Facile,2,Beaucoup plus Facile,Pas Adapte,Marketing
1442,2016,Marketing,1,Introduction a l'Etude du Langage,9,La Sociolinguistique et la Dialectologie,12,332,10,QCM,0.04,0.88,66.57,46,23,69,60,46,14,1.15,76.67,Facile,Facile,0,Meme Difficulté,Adapte,Marketing
2553,2017,Marketing,1,Introduction a l'Etude du Langage,9,La Sociolinguistique et la Dialectologie,12,332,10,QCM,0.08,0.73,66.57,51,26,77,63,51,12,1.22,80.95,Facile,Facile,0,Meme Difficulté,Adapte,Marketing
3664,2018,Marketing,1,Introduction a l'Etude du Langage,9,La Sociolinguistique et la Dialectologie,12,332,10,QCM,0.07,0.93,66.57,45,22,67,51,45,6,1.31,88.24,Facile,Facile,0,Meme Difficulté,Adapte,Marketing
4775,2019,Marketing,1,Introduction a l'Etude du Langage,9,La Sociolinguistique et la Dialectologie,12,332,10,QCM,0.14,0.85,66.57,45,23,68,59,45,14,1.15,76.27,Facile,Facile,0,Meme Difficulté,Adapte,Marketing
5886,2020,Marketing,1,Introduction a l'Etude du Langage,9,La Sociolinguistique et la Dialectologie,12,332,10,QCM,0.2,0.97,66.57,43,22,65,53,43,10,1.23,81.13,Facile,Facile,0,Meme Difficulté,Adapte,Marketing
332,2015,Marketing,1,Introduction a l'Etude du Langage,9,La Sociolinguistique et la Dialectologie,12,333,11,QCU,0.45,0.32,10.11,3,27,30,26,3,23,1.15,11.54,Facile,Difficile,-2,Beaucoup plus Difficile,Pas Adapte,Marketing
1443,2016,Marketing,1,Introduction a l'Etude du Langage,9,La Sociolinguistique et la Dialectologie,12,333,11,QCU,0.46,0.2,32.98,11,23,34,21,11,10,1.62,52.38,Moyen,Difficile,-1,Plus Difficile,Pas Adapte,Marketing
2554,2017,Marketing,1,Introduction a l'Etude du Langage,9,La Sociolinguistique et la Dialectologie,12,333,11,QCU,0.52,0.23,34.07,10,19,29,25,10,15,1.16,40.0,Difficile,Difficile,0,Meme Difficulté,Pas Adapte,Marketing
3665,2018,Marketing,1,Introduction a l'Etude du Langage,9,La Sociolinguistique et la Dialectologie,12,333,11,QCU,0.41,0.36,21.75,5,20,25,23,5,18,1.09,21.74,Facile,Difficile,-2,Beaucoup plus Difficile,Pas Adapte,Marketing
4776,2019,Marketing,1,Introduction a l'Etude du Langage,9,La Sociolinguistique et la Dialectologie,12,333,11,QCU,0.39,0.71,63.51,15,9,24,19,15,4,1.26,78.95,Facile,Moyen,-1,Plus Difficile,Adapte,Marketing
5887,2020,Marketing,1,Introduction a l'Etude du Langage,9,La Sociolinguistique et la Dialectologie,12,333,11,QCU,0.25,0.74,63.51,14,8,22,15,14,1,1.47,93.33,Moyen,Moyen,0,Meme Difficulté,Adapte,Marketing
333,2015,Marketing,1,Introduction a l'Etude du Langage,9,La Sociolinguistique et la Dialectologie,12,334,12,QCU,0.18,0.86,90.16,11,1,12,11,11,0,1.09,100.0,Moyen,Facile,1,Plus Facile,Pas Adapte,Marketing
1444,2016,Marketing,1,Introduction a l'Etude du Langage,9,La Sociolinguistique et la Dialectologie,12,334,12,QCU,0.35,0.55,54.05,8,6,14,14,8,6,1.0,57.14,Difficile,Moyen,1,Plus Facile,Pas Adapte,Marketing
2555,2017,Marketing,1,Introduction a l'Etude du Langage,9,La Sociolinguistique et la Dialectologie,12,334,12,QCU,0.66,0.23,23.69,3,10,13,11,3,8,1.18,27.27,Facile,Difficile,-2,Beaucoup plus Difficile,Pas Adapte,Marketing
3666,2018,Marketing,1,Introduction a l'Etude du Langage,9,La Sociolinguistique et la Dialectologie,12,334,12,QCU,0.69,0.39,5.2,1,10,11,10,1,9,1.1,10.0,Moyen,Difficile,-1,Plus Difficile,Pas Adapte,Marketing
4777,2019,Marketing,1,Introduction a l'Etude du Langage,9,La Sociolinguistique et la Dialectologie,12,334,12,QCU,0.09,0.76,67.98,7,3,10,8,7,1,1.25,87.5,Facile,Facile,0,Meme Difficulté,Adapte,Marketing
5888,2020,Marketing,1,Introduction a l'Etude du Langage,9,La Sociolinguistique et la Dialectologie,12,334,12,QCU,0.14,0.96,67.98,5,3,8,6,5,1,1.33,83.33,Facile,Facile,0,Meme Difficulté,Adapte,Marketing
334,2015,Marketing,1,Introduction a l'Etude du Langage,10,L'Amenagement Linguistique,13,335,1,QCM,0.47,0.69,40.53,25,36,61,55,25,30,1.11,45.45,Moyen,Moyen,0,Meme Difficulté,Pas Adapte,Marketing
1445,2016,Marketing,1,Introduction a l'Etude du Langage,10,L'Amenagement Linguistique,13,335,1,QCU,0.62,0.4,17.24,10,48,58,38,10,28,1.53,26.32,Facile,Difficile,-2,Beaucoup plus Difficile,Pas Adapte,Marketing
2556,2017,Marketing,1,Introduction a l'Etude du Langage,10,L'Amenagement Linguistique,13,335,1,QCU,0.69,0.23,6.39,3,48,51,21,3,18,2.43,14.29,Moyen,Difficile,-1,Plus Difficile,Pas Adapte,Marketing
3667,2018,Marketing,1,Introduction a l'Etude du Langage,10,L'Amenagement Linguistique,13,335,1,QCU,0.07,0.92,82.94,46,9,55,55,46,9,1.0,83.64,Facile,Facile,0,Meme Difficulté,Pas Adapte,Marketing
4778,2019,Marketing,1,Introduction a l'Etude du Langage,10,L'Amenagement Linguistique,13,335,1,QCU,0.15,0.76,96.08,49,2,51,51,49,2,1.0,96.08,Moyen,Facile,1,Plus Facile,Pas Adapte,Marketing
5889,2020,Marketing,1,Introduction a l'Etude du Langage,10,L'Amenagement Linguistique,13,335,1,QCU,0.69,0.24,2.86,1,43,44,21,1,20,2.1,4.76,Moyen,Difficile,-1,Plus Difficile,Pas Adapte,Marketing
335,2015,Marketing,1,Introduction a l'Etude du Langage,10,L'Amenagement Linguistique,13,336,2,QCU,0.51,0.29,14.86,10,55,65,53,10,43,1.23,18.87,Facile,Difficile,-2,Beaucoup plus Difficile,Pas Adapte,Marketing
1446,2016,Marketing,1,Introduction a l'Etude du Langage,10,L'Amenagement Linguistique,13,336,2,QCU,0.51,0.38,3.61,2,65,67,65,2,63,1.03,3.08,Difficile,Difficile,0,Meme Difficulté,Pas Adapte,Marketing
2557,2017,Marketing,1,Introduction a l'Etude du Langage,10,L'Amenagement Linguistique,13,336,2,QCU,0.61,0.21,2.39,2,66,68,33,2,31,2.06,6.06,Facile,Difficile,-2,Beaucoup plus Difficile,Pas Adapte,Marketing
3668,2018,Marketing,1,Introduction a l'Etude du Langage,10,L'Amenagement Linguistique,13,336,2,QCU,0.69,0.27,29.93,22,51,73,44,22,22,1.66,50.0,Facile,Difficile,-2,Beaucoup plus Difficile,Pas Adapte,Marketing
4779,2019,Marketing,1,Introduction a l'Etude du Langage,10,L'Amenagement Linguistique,13,336,2,QCU,0.29,0.73,41.88,28,40,68,52,28,24,1.31,53.85,Facile,Moyen,-1,Plus Difficile,Pas Adapte,Marketing
5890,2020,Marketing,1,Introduction a l'Etude du Langage,10,L'Amenagement Linguistique,13,336,2,QCU,0.58,0.29,16.85,13,63,76,49,13,36,1.55,26.53,Facile,Difficile,-2,Beaucoup plus Difficile,Pas Adapte,Marketing
336,2015,Marketing,1,Introduction a l'Etude du Langage,10,L'Amenagement Linguistique,13,337,3,QCM,0.7,0.25,8.73,2,18,20,13,2,11,1.54,15.38,Moyen,Difficile,-1,Plus Difficile,Pas Adapte,Marketing
1447,2016,Marketing,1,Introduction a l'Etude du Langage,10,L'Amenagement Linguistique,13,337,3,QCM,0.54,0.18,19.88,3,14,17,16,3,13,1.06,18.75,Moyen,Difficile,-1,Plus Difficile,Pas Adapte,Marketing
2558,2017,Marketing,1,Introduction a l'Etude du Langage,10,L'Amenagement Linguistique,13,337,3,QCM,0.58,0.2,15.15,2,12,14,11,2,9,1.27,18.18,Difficile,Difficile,0,Meme Difficulté,Pas Adapte,Marketing
3669,2018,Marketing,1,Introduction a l'Etude du Langage,10,L'Amenagement Linguistique,13,337,3,QCM,0.67,0.2,28.61,5,11,16,5,5,0,3.2,100.0,Moyen,Difficile,-1,Plus Difficile,Pas Adapte,Marketing
4780,2019,Marketing,1,Introduction a l'Etude du Langage,10,L'Amenagement Linguistique,13,337,3,QROC,0.67,0.08,26.13,4,10,14,12,4,8,1.17,33.33,Facile,Difficile,-2,Beaucoup plus Difficile,Pas Adapte,Marketing
5891,2020,Marketing,1,Introduction a l'Etude du Langage,10,L'Amenagement Linguistique,13,337,3,QO,0.19,0.7,80.57,13,3,16,15,13,2,1.07,86.67,Facile,Facile,0,Meme Difficulté,Pas Adapte,Marketing
337,2015,Marketing,1,Introduction a l'Etude du Langage,10,L'Amenagement Linguistique,13,338,4,QCM,0.59,0.2,12.48,9,60,69,46,9,37,1.5,19.57,Facile,Difficile,-2,Beaucoup plus Difficile,Pas Adapte,Marketing
1448,2016,Marketing,1,Introduction a l'Etude du Langage,10,L'Amenagement Linguistique,13,338,4,QCM,0.5,0.22,10.21,6,54,60,17,6,11,3.53,35.29,Facile,Difficile,-2,Beaucoup plus Difficile,Pas Adapte,Marketing
2559,2017,Marketing,1,Introduction a l'Etude du Langage,10,L'Amenagement Linguistique,13,338,4,QCU,0.64,0.24,11.88,7,52,59,52,7,45,1.13,13.46,Facile,Difficile,-2,Beaucoup plus Difficile,Pas Adapte,Marketing
3670,2018,Marketing,1,Introduction a l'Etude du Langage,10,L'Amenagement Linguistique,13,338,4,QCU,0.3,0.68,50.85,26,26,52,41,26,15,1.27,63.41,Moyen,Moyen,0,Meme Difficulté,Pas Adapte,Marketing
4781,2019,Marketing,1,Introduction a l'Etude du Langage,10,L'Amenagement Linguistique,13,338,4,QCU,0.2,0.88,70.91,37,15,52,42,37,5,1.24,88.1,Facile,Facile,0,Meme Difficulté,Adapte,Marketing
5892,2020,Marketing,1,Introduction a l'Etude du Langage,10,L'Amenagement Linguistique,13,338,4,QCU,0.15,0.82,70.91,38,15,53,47,38,9,1.13,80.85,Facile,Facile,0,Meme Difficulté,Adapte,Marketing
338,2015,Marketing,1,Introduction a l'Etude du Langage,10,L'Amenagement Linguistique,13,339,5,QCU,0.47,0.21,2.08,1,65,66,65,1,64,1.02,1.54,Moyen,Difficile,-1,Plus Difficile,Pas Adapte,Marketing
1449,2016,Marketing,1,Introduction a l'Etude du Langage,10,L'Amenagement Linguistique,13,339,5,QCU,0.09,0.89,72.22,45,17,62,54,45,9,1.15,83.33,Moyen,Facile,1,Plus Facile,Adapte,Marketing
2560,2017,Marketing,1,Introduction a l'Etude du Langage,10,L'Amenagement Linguistique,13,339,5,QROC,0.17,0.79,72.22,49,19,68,68,49,19,1.0,72.06,Facile,Facile,0,Meme Difficulté,Adapte,Marketing
3671,2018,Marketing,1,Introduction a l'Etude du Langage,10,L'Amenagement Linguistique,13,339,5,QROC,0.07,0.98,72.22,45,17,62,61,45,16,1.02,73.77,Facile,Facile,0,Meme Difficulté,Adapte,Marketing
4782,2019,Marketing,1,Introduction a l'Etude du Langage,10,L'Amenagement Linguistique,13,339,5,QROC,0.01,0.62,72.22,50,19,69,57,50,7,1.21,87.72,Facile,Facile,0,Meme Difficulté,Adapte,Marketing
5893,2020,Marketing,1,Introduction a l'Etude du Langage,10,L'Amenagement Linguistique,13,339,5,QROC,0.1,0.97,72.22,49,19,68,62,49,13,1.1,79.03,Facile,Facile,0,Meme Difficulté,Adapte,Marketing
339,2015,Marketing,1,Introduction a l'Etude du Langage,10,L'Amenagement Linguistique,13,340,6,QROC,0.79,0.22,34.41,34,64,98,98,34,64,1.0,34.69,Moyen,Difficile,-1,Plus Difficile,Pas Adapte,Marketing
1450,2016,Marketing,1,Introduction a l'Etude du Langage,10,L'Amenagement Linguistique,13,340,6,QROC,0.03,0.5,99.03,99,1,100,99,99,0,1.01,100.0,Moyen,Facile,1,Plus Facile,Pas Adapte,Marketing
2561,2017,Marketing,1,Introduction a l'Etude du Langage,10,L'Amenagement Linguistique,13,340,6,QROC,0.46,0.4,36.6,38,65,103,77,38,39,1.34,49.35,Difficile,Moyen,1,Plus Facile,Pas Adapte,Marketing
3672,2018,Marketing,1,Introduction a l'Etude du Langage,10,L'Amenagement Linguistique,13,340,6,QROC,0.6,0.23,23.86,21,68,89,41,21,20,2.17,51.22,Moyen,Difficile,-1,Plus Difficile,Pas Adapte,Marketing
4783,2019,Marketing,1,Introduction a l'Etude du Langage,10,L'Amenagement Linguistique,13,340,6,QROC,0.98,0.11,2.81,2,81,83,54,2,52,1.54,3.7,Moyen,Difficile,-1,Plus Difficile,Pas Adapte,Marketing
5894,2020,Marketing,1,Introduction a l'Etude du Langage,10,L'Amenagement Linguistique,13,340,6,QROC,0.48,0.35,57.17,51,39,90,64,51,13,1.41,79.69,Moyen,Moyen,0,Meme Difficulté,Pas Adapte,Marketing
340,2015,Marketing,1,Introduction a l'Etude du Langage,10,L'Amenagement Linguistique,13,341,7,QCU,0.12,0.93,74.99,22,8,30,23,22,1,1.3,95.65,Facile,Facile,0,Meme Difficulté,Adapte,Marketing
1451,2016,Marketing,1,Introduction a l'Etude du Langage,10,L'Amenagement Linguistique,13,341,7,QCU,0.02,0.97,74.99,20,7,27,20,20,0,1.35,100.0,Facile,Facile,0,Meme Difficulté,Adapte,Marketing
2562,2017,Marketing,1,Introduction a l'Etude du Langage,10,L'Amenagement Linguistique,13,341,7,QCU,0.18,0.8,74.99,20,7,27,25,20,5,1.08,80.0,Facile,Facile,0,Meme Difficulté,Adapte,Marketing
3673,2018,Marketing,1,Introduction a l'Etude du Langage,10,L'Amenagement Linguistique,13,341,7,QCU,0.07,0.78,74.99,20,7,27,22,20,2,1.23,90.91,Facile,Facile,0,Meme Difficulté,Adapte,Marketing
4784,2019,Marketing,1,Introduction a l'Etude du Langage,10,L'Amenagement Linguistique,13,341,7,QCU,0.01,0.83,74.99,19,6,25,24,19,5,1.04,79.17,Facile,Facile,0,Meme Difficulté,Adapte,Marketing
5895,2020,Marketing,1,Introduction a l'Etude du Langage,10,L'Amenagement Linguistique,13,341,7,QCU,0.07,0.96,74.99,22,7,29,25,22,3,1.16,88.0,Facile,Facile,0,Meme Difficulté,Adapte,Marketing
341,2015,Marketing,1,Introduction a l'Etude du Langage,10,L'Amenagement Linguistique,13,342,8,QCU,0.74,0.26,31.02,29,65,94,90,29,61,1.04,32.22,Facile,Difficile,-2,Beaucoup plus Difficile,Pas Adapte,Marketing
1452,2016,Marketing,1,Introduction a l'Etude du Langage,10,L'Amenagement Linguistique,13,342,8,QCU,0.1,0.81,69.25,74,33,107,96,74,22,1.11,77.08,Facile,Facile,0,Meme Difficulté,Adapte,Marketing
2563,2017,Marketing,1,Introduction a l'Etude du Langage,10,L'Amenagement Linguistique,13,342,8,QROC,0.01,0.95,69.25,80,35,115,113,80,33,1.02,70.8,Facile,Facile,0,Meme Difficulté,Adapte,Marketing
3674,2018,Marketing,1,Introduction a l'Etude du Langage,10,L'Amenagement Linguistique,13,342,8,QROC,0.05,1.0,69.25,78,34,112,92,78,14,1.22,84.78,Facile,Facile,0,Meme Difficulté,Adapte,Marketing
4785,2019,Marketing,1,Introduction a l'Etude du Langage,10,L'Amenagement Linguistique,13,342,8,QROC,0.14,0.74,69.25,70,31,101,94,70,24,1.07,74.47,Facile,Facile,0,Meme Difficulté,Adapte,Marketing
5896,2020,Marketing,1,Introduction a l'Etude du Langage,10,L'Amenagement Linguistique,13,342,8,QROC,0.08,0.75,69.25,62,27,89,82,62,20,1.09,75.61,Facile,Facile,0,Meme Difficulté,Adapte,Marketing
342,2015,Marketing,1,Introduction a l'Etude du Langage,10,L'Amenagement Linguistique,13,343,9,QROC,0.34,0.36,48.81,24,26,50,37,24,13,1.35,64.86,Difficile,Moyen,1,Plus Facile,Pas Adapte,Marketing
1453,2016,Marketing,1,Introduction a l'Etude du Langage,10,L'Amenagement Linguistique,13,343,9,QROC,0.46,0.38,53.91,23,19,42,42,23,19,1.0,54.76,Difficile,Moyen,1,Plus Facile,Pas Adapte,Marketing
2564,2017,Marketing,1,Introduction a l'Etude du Langage,10,L'Amenagement Linguistique,13,343,9,QROC,0.2,0.25,60.57,25,16,41,32,25,7,1.28,78.12,Moyen,Moyen,0,Meme Difficulté,Adapte,Marketing
3675,2018,Marketing,1,Introduction a l'Etude du Langage,10,L'Amenagement Linguistique,13,343,9,QO,0.39,0.16,60.57,25,16,41,36,25,11,1.14,69.44,Moyen,Moyen,0,Meme Difficulté,Adapte,Marketing
4786,2019,Marketing,1,Introduction a l'Etude du Langage,10,L'Amenagement Linguistique,13,343,9,QO,0.27,0.2,60.57,28,18,46,33,28,5,1.39,84.85,Moyen,Moyen,0,Meme Difficulté,Adapte,Marketing
5897,2020,Marketing,1,Introduction a l'Etude du Langage,10,L'Amenagement Linguistique,13,343,9,QO,0.31,0.18,60.57,24,16,40,31,24,7,1.29,77.42,Moyen,Moyen,0,Meme Difficulté,Adapte,Marketing
343,2015,Marketing,1,Introduction a l'Etude du Langage,10,L'Amenagement Linguistique,13,344,10,QCU,0.22,0.6,55.75,4,3,7,6,4,2,1.17,66.67,Facile,Moyen,-1,Plus Difficile,Pas Adapte,Marketing
1454,2016,Marketing,1,Introduction a l'Etude du Langage,10,L'Amenagement Linguistique,13,344,10,QCU,0.7,0.21,17.63,1,5,6,3,1,2,2.0,33.33,Facile,Difficile,-2,Beaucoup plus Difficile,Pas Adapte,Marketing
2565,2017,Marketing,1,Introduction a l'Etude du Langage,10,L'Amenagement Linguistique,13,344,10,QCU,0.47,0.31,4.82,0,5,5,5,0,5,1.0,0.0,Difficile,Difficile,0,Meme Difficulté,Pas Adapte,Marketing
3676,2018,Marketing,1,Introduction a l'Etude du Langage,10,L'Amenagement Linguistique,13,344,10,QCM,0.62,0.29,5.97,0,4,4,3,0,3,1.33,0.0,Difficile,Difficile,0,Meme Difficulté,Pas Adapte,Marketing
4787,2019,Marketing,1,Introduction a l'Etude du Langage,10,L'Amenagement Linguistique,13,344,10,QCU,0.54,0.35,23.8,1,3,4,2,1,1,2.0,50.0,Difficile,Difficile,0,Meme Difficulté,Pas Adapte,Marketing
5898,2020,Marketing,1,Introduction a l'Etude du Langage,10,L'Amenagement Linguistique,13,344,10,QCU,0.64,0.32,27.55,1,3,4,3,1,2,1.33,33.33,Difficile,Difficile,0,Meme Difficulté,Pas Adapte,Marketing
344,2015,Marketing,1,Introduction a l'Etude du Langage,10,L'Amenagement Linguistique,13,345,11,QCM,0.75,0.25,31.91,24,52,76,54,24,30,1.41,44.44,Facile,Difficile,-2,Beaucoup plus Difficile,Pas Adapte,Marketing
1455,2016,Marketing,1,Introduction a l'Etude du Langage,10,L'Amenagement Linguistique,13,345,11,QCM,0.05,0.78,71.24,52,21,73,56,52,4,1.3,92.86,Facile,Facile,0,Meme Difficulté,Adapte,Marketing
2566,2017,Marketing,1,Introduction a l'Etude du Langage,10,L'Amenagement Linguistique,13,345,11,QCM,0.04,0.76,71.24,60,24,84,74,60,14,1.14,81.08,Facile,Facile,0,Meme Difficulté,Adapte,Marketing
3677,2018,Marketing,1,Introduction a l'Etude du Langage,10,L'Amenagement Linguistique,13,345,11,QCM,0.09,0.92,71.24,69,28,97,75,69,6,1.29,92.0,Facile,Facile,0,Meme Difficulté,Adapte,Marketing
4788,2019,Marketing,1,Introduction a l'Etude du Langage,10,L'Amenagement Linguistique,13,345,11,QCU,0.19,0.98,71.24,60,24,84,71,60,11,1.18,84.51,Facile,Facile,0,Meme Difficulté,Adapte,Marketing
5899,2020,Marketing,1,Introduction a l'Etude du Langage,10,L'Amenagement Linguistique,13,345,11,QCU,0.15,0.97,71.24,57,23,80,59,57,2,1.36,96.61,Facile,Facile,0,Meme Difficulté,Adapte,Marketing
345,2015,Marketing,1,Introduction a l'Etude du Langage,10,L'Amenagement Linguistique,13,346,12,QCM,0.38,0.55,57.69,18,13,31,30,18,12,1.03,60.0,Difficile,Moyen,1,Plus Facile,Pas Adapte,Marketing
1456,2016,Marketing,1,Introduction a l'Etude du Langage,10,L'Amenagement Linguistique,13,346,12,QCM,0.59,0.27,2.36,1,29,30,27,1,26,1.11,3.7,Moyen,Difficile,-1,Plus Difficile,Pas Adapte,Marketing
2567,2017,Marketing,1,Introduction a l'Etude du Langage,10,L'Amenagement Linguistique,13,346,12,QCM,0.39,0.59,52.78,14,12,26,24,14,10,1.08,58.33,Difficile,Moyen,1,Plus Facile,Pas Adapte,Marketing
3678,2018,Marketing,1,Introduction a l'Etude du Langage,10,L'Amenagement Linguistique,13,346,12,QCM,0.69,0.19,30.0,8,18,26,15,8,7,1.73,53.33,Facile,Difficile,-2,Beaucoup plus Difficile,Pas Adapte,Marketing
4789,2019,Marketing,1,Introduction a l'Etude du Langage,10,L'Amenagement Linguistique,13,346,12,QCM,0.42,0.37,36.67,10,16,26,25,10,15,1.04,40.0,Difficile,Moyen,1,Plus Facile,Pas Adapte,Marketing
5900,2020,Marketing,1,Introduction a l'Etude du Langage,10,L'Amenagement Linguistique,13,346,12,QCM,0.72,0.24,10.5,3,26,29,20,3,17,1.45,15.0,Difficile,Difficile,0,Meme Difficulté,Pas Adapte,Marketing
346,2015,Marketing,1,Introduction a l'Etude du Langage,10,L'Amenagement Linguistique,13,347,13,QCU,0.09,0.86,86.69,70,11,81,76,70,6,1.07,92.11,Facile,Facile,0,Meme Difficulté,Pas Adapte,Marketing
1457,2016,Marketing,1,Introduction a l'Etude du Langage,10,L'Amenagement Linguistique,13,347,13,QCU,0.38,0.49,56.11,39,31,70,62,39,23,1.13,62.9,Facile,Moyen,-1,Plus Difficile,Pas Adapte,Marketing
2568,2017,Marketing,1,Introduction a l'Etude du Langage,10,L'Amenagement Linguistique,13,347,13,QCU,0.14,0.8,94.74,60,3,63,62,60,2,1.02,96.77,Moyen,Facile,1,Plus Facile,Pas Adapte,Marketing
3679,2018,Marketing,1,Introduction a l'Etude du Langage,10,L'Amenagement Linguistique,13,347,13,QCU,0.39,0.44,55.54,37,30,67,58,37,21,1.16,63.79,Difficile,Moyen,1,Plus Facile,Pas Adapte,Marketing
4790,2019,Marketing,1,Introduction a l'Etude du Langage,10,L'Amenagement Linguistique,13,347,13,QCU,0.05,0.9,98.23,73,1,74,73,73,0,1.01,100.0,Difficile,Facile,2,Beaucoup plus Facile,Pas Adapte,Marketing
5901,2020,Marketing,1,Introduction a l'Etude du Langage,10,L'Amenagement Linguistique,13,347,13,QCU,0.45,0.32,13.81,11,66,77,61,11,50,1.26,18.03,Difficile,Difficile,0,Meme Difficulté,Pas Adapte,Marketing
347,2015,Marketing,2,Grammaire Lexicale Fonctionnelle,1,Les Traits Syntaxiques,6,348,1,QCM,0.66,0.26,6.85,6,85,91,81,6,75,1.12,7.41,Moyen,Difficile,-1,Plus Difficile,Pas Adapte,Marketing
1458,2016,Marketing,2,Grammaire Lexicale Fonctionnelle,1,Les Traits Syntaxiques,6,348,1,QCU,0.13,0.97,82.55,71,15,86,76,71,5,1.13,93.42,Moyen,Facile,1,Plus Facile,Pas Adapte,Marketing
2569,2017,Marketing,2,Grammaire Lexicale Fonctionnelle,1,Les Traits Syntaxiques,6,348,1,QCU,0.08,0.77,99.48,98,1,99,98,98,0,1.01,100.0,Moyen,Facile,1,Plus Facile,Pas Adapte,Marketing
3680,2018,Marketing,2,Grammaire Lexicale Fonctionnelle,1,Les Traits Syntaxiques,6,348,1,QROC,0.55,0.29,43.54,40,52,92,78,40,38,1.18,51.28,Facile,Moyen,-1,Plus Difficile,Pas Adapte,Marketing
4791,2019,Marketing,2,Grammaire Lexicale Fonctionnelle,1,Les Traits Syntaxiques,6,348,1,QROC,0.37,0.32,36.96,39,67,106,83,39,44,1.28,46.99,Moyen,Moyen,0,Meme Difficulté,Pas Adapte,Marketing
5902,2020,Marketing,2,Grammaire Lexicale Fonctionnelle,1,Les Traits Syntaxiques,6,348,1,QROC,0.88,0.22,13.33,12,78,90,51,12,39,1.76,23.53,Difficile,Difficile,0,Meme Difficulté,Pas Adapte,Marketing
348,2015,Marketing,2,Grammaire Lexicale Fonctionnelle,1,Les Traits Syntaxiques,6,349,2,QCU,0.04,0.98,86.62,87,13,100,93,87,6,1.08,93.55,Difficile,Facile,2,Beaucoup plus Facile,Pas Adapte,Marketing
1459,2016,Marketing,2,Grammaire Lexicale Fonctionnelle,1,Les Traits Syntaxiques,6,349,2,QCU,0.46,0.38,30.21,31,71,102,66,31,35,1.55,46.97,Moyen,Difficile,-1,Plus Difficile,Pas Adapte,Marketing
2570,2017,Marketing,2,Grammaire Lexicale Fonctionnelle,1,Les Traits Syntaxiques,6,349,2,QCU,0.03,0.8,66.54,77,39,116,115,77,38,1.01,66.96,Facile,Facile,0,Meme Difficulté,Adapte,Marketing
3681,2018,Marketing,2,Grammaire Lexicale Fonctionnelle,1,Les Traits Syntaxiques,6,349,2,QCU,0.09,0.79,66.54,79,40,119,101,79,22,1.18,78.22,Facile,Facile,0,Meme Difficulté,Adapte,Marketing
4792,2019,Marketing,2,Grammaire Lexicale Fonctionnelle,1,Les Traits Syntaxiques,6,349,2,QCU,0.13,0.91,66.54,81,41,122,83,81,2,1.47,97.59,Facile,Facile,0,Meme Difficulté,Adapte,Marketing
5903,2020,Marketing,2,Grammaire Lexicale Fonctionnelle,1,Les Traits Syntaxiques,6,349,2,QROC,0.15,0.73,66.54,75,37,112,97,75,22,1.15,77.32,Facile,Facile,0,Meme Difficulté,Adapte,Marketing
349,2015,Marketing,2,Grammaire Lexicale Fonctionnelle,1,Les Traits Syntaxiques,6,350,3,QROC,0.78,0.05,25.11,4,12,16,7,4,3,2.29,57.14,Difficile,Difficile,0,Meme Difficulté,Pas Adapte,Marketing
1460,2016,Marketing,2,Grammaire Lexicale Fonctionnelle,1,Les Traits Syntaxiques,6,350,3,QROC,0.43,0.25,48.46,9,9,18,11,9,2,1.64,81.82,Difficile,Moyen,1,Plus Facile,Pas Adapte,Marketing
2571,2017,Marketing,2,Grammaire Lexicale Fonctionnelle,1,Les Traits Syntaxiques,6,350,3,QCM,0.17,0.87,99.49,20,0,20,20,20,0,1.0,100.0,Facile,Facile,0,Meme Difficulté,Pas Adapte,Marketing
3682,2018,Marketing,2,Grammaire Lexicale Fonctionnelle,1,Les Traits Syntaxiques,6,350,3,QCM,0.73,0.24,6.5,1,19,20,7,1,6,2.86,14.29,Difficile,Difficile,0,Meme Difficulté,Pas Adapte,Marketing
4793,2019,Marketing,2,Grammaire Lexicale Fonctionnelle,1,Les Traits Syntaxiques,6,350,3,QCM,0.04,0.98,71.11,16,6,22,18,16,2,1.22,88.89,Moyen,Facile,1,Plus Facile,Adapte,Marketing
5904,2020,Marketing,2,Grammaire Lexicale Fonctionnelle,1,Les Traits Syntaxiques,6,350,3,QCM,0.0,0.71,71.11,15,6,21,18,15,3,1.17,83.33,Facile,Facile,0,Meme Difficulté,Adapte,Marketing
350,2015,Marketing,2,Grammaire Lexicale Fonctionnelle,1,Les Traits Syntaxiques,6,351,4,QCU,0.6,0.39,8.29,5,59,64,29,5,24,2.21,17.24,Facile,Difficile,-2,Beaucoup plus Difficile,Pas Adapte,Marketing
1461,2016,Marketing,2,Grammaire Lexicale Fonctionnelle,1,Les Traits Syntaxiques,6,351,4,QROC,0.12,0.71,73.44,48,17,65,60,48,12,1.08,80.0,Facile,Facile,0,Meme Difficulté,Adapte,Marketing
2572,2017,Marketing,2,Grammaire Lexicale Fonctionnelle,1,Les Traits Syntaxiques,6,351,4,QROC,0.03,0.57,73.44,45,16,61,61,45,16,1.0,73.77,Facile,Facile,0,Meme Difficulté,Adapte,Marketing
3683,2018,Marketing,2,Grammaire Lexicale Fonctionnelle,1,Les Traits Syntaxiques,6,351,4,QROC,0.14,0.75,73.44,46,17,63,55,46,9,1.15,83.64,Facile,Facile,0,Meme Difficulté,Adapte,Marketing
4794,2019,Marketing,2,Grammaire Lexicale Fonctionnelle,1,Les Traits Syntaxiques,6,351,4,QROC,0.04,0.69,73.44,47,17,64,55,47,8,1.16,85.45,Facile,Facile,0,Meme Difficulté,Adapte,Marketing
5905,2020,Marketing,2,Grammaire Lexicale Fonctionnelle,1,Les Traits Syntaxiques,6,351,4,QROC,0.18,0.41,73.44,46,16,62,58,46,12,1.07,79.31,Facile,Facile,0,Meme Difficulté,Adapte,Marketing
351,2015,Marketing,2,Grammaire Lexicale Fonctionnelle,1,Les Traits Syntaxiques,6,352,5,QCM,0.72,0.15,0.7,0,45,45,14,0,14,3.21,0.0,Facile,Difficile,-2,Beaucoup plus Difficile,Pas Adapte,Marketing
1462,2016,Marketing,2,Grammaire Lexicale Fonctionnelle,1,Les Traits Syntaxiques,6,352,5,QCM,0.05,0.84,94.17,47,3,50,50,47,3,1.0,94.0,Moyen,Facile,1,Plus Facile,Pas Adapte,Marketing
2573,2017,Marketing,2,Grammaire Lexicale Fonctionnelle,1,Les Traits Syntaxiques,6,352,5,QROC,0.04,0.9,76.66,35,11,46,42,35,7,1.1,83.33,Facile,Facile,0,Meme Difficulté,Pas Adapte,Marketing
3684,2018,Marketing,2,Grammaire Lexicale Fonctionnelle,1,Les Traits Syntaxiques,6,352,5,QCM,0.3,0.64,42.12,19,25,44,31,19,12,1.42,61.29,Facile,Moyen,-1,Plus Difficile,Pas Adapte,Marketing
4795,2019,Marketing,2,Grammaire Lexicale Fonctionnelle,1,Les Traits Syntaxiques,6,352,5,QCU,0.36,0.42,42.56,16,21,37,35,16,19,1.06,45.71,Facile,Moyen,-1,Plus Difficile,Pas Adapte,Marketing
5906,2020,Marketing,2,Grammaire Lexicale Fonctionnelle,1,Les Traits Syntaxiques,6,352,5,QCM,0.26,0.51,64.61,27,15,42,33,27,6,1.27,81.82,Moyen,Moyen,0,Meme Difficulté,Adapte,Marketing
352,2015,Marketing,2,Grammaire Lexicale Fonctionnelle,1,Les Traits Syntaxiques,6,353,6,QCM,0.59,0.22,5.28,0,5,5,3,0,3,1.67,0.0,Difficile,Difficile,0,Meme Difficulté,Pas Adapte,Marketing
1463,2016,Marketing,2,Grammaire Lexicale Fonctionnelle,1,Les Traits Syntaxiques,6,353,6,QCM,0.37,0.44,52.76,3,2,5,3,3,0,1.67,100.0,Moyen,Moyen,0,Meme Difficulté,Pas Adapte,Marketing
2574,2017,Marketing,2,Grammaire Lexicale Fonctionnelle,1,Les Traits Syntaxiques,6,353,6,QCM,0.19,0.79,82.24,5,1,6,5,5,0,1.2,100.0,Moyen,Facile,1,Plus Facile,Pas Adapte,Marketing
3685,2018,Marketing,2,Grammaire Lexicale Fonctionnelle,1,Les Traits Syntaxiques,6,353,6,QROC,0.03,0.89,97.9,6,0,6,6,6,0,1.0,100.0,Difficile,Facile,2,Beaucoup plus Facile,Pas Adapte,Marketing
4796,2019,Marketing,2,Grammaire Lexicale Fonctionnelle,1,Les Traits Syntaxiques,6,353,6,QROC,0.92,0.24,33.13,2,5,7,5,2,3,1.4,40.0,Moyen,Difficile,-1,Plus Difficile,Pas Adapte,Marketing
5907,2020,Marketing,2,Grammaire Lexicale Fonctionnelle,1,Les Traits Syntaxiques,6,353,6,QO,0.15,0.82,91.42,6,1,7,6,6,0,1.17,100.0,Facile,Facile,0,Meme Difficulté,Pas Adapte,Marketing
353,2015,Marketing,2,Grammaire Lexicale Fonctionnelle,2,Les Fonctions,14,354,1,QCM,0.64,0.15,8.19,6,62,68,22,6,16,3.09,27.27,Difficile,Difficile,0,Meme Difficulté,Pas Adapte,Marketing
1464,2016,Marketing,2,Grammaire Lexicale Fonctionnelle,2,Les Fonctions,14,354,1,QCM,0.38,0.49,41.83,32,45,77,64,32,32,1.2,50.0,Facile,Moyen,-1,Plus Difficile,Pas Adapte,Marketing
2575,2017,Marketing,2,Grammaire Lexicale Fonctionnelle,2,Les Fonctions,14,354,1,QCM,0.09,0.93,79.82,63,16,79,70,63,7,1.13,90.0,Difficile,Facile,2,Beaucoup plus Facile,Pas Adapte,Marketing
3686,2018,Marketing,2,Grammaire Lexicale Fonctionnelle,2,Les Fonctions,14,354,1,QCM,0.51,0.22,30.41,24,56,80,28,24,4,2.86,85.71,Moyen,Difficile,-1,Plus Difficile,Pas Adapte,Marketing
4797,2019,Marketing,2,Grammaire Lexicale Fonctionnelle,2,Les Fonctions,14,354,1,QCM,0.71,0.27,3.63,3,67,70,57,3,54,1.23,5.26,Difficile,Difficile,0,Meme Difficulté,Pas Adapte,Marketing
5908,2020,Marketing,2,Grammaire Lexicale Fonctionnelle,2,Les Fonctions,14,354,1,QCM,0.29,0.67,49.49,36,37,73,65,36,29,1.12,55.38,Difficile,Moyen,1,Plus Facile,Pas Adapte,Marketing
354,2015,Marketing,2,Grammaire Lexicale Fonctionnelle,2,Les Fonctions,14,355,2,QO,0.8,0.14,27.01,11,31,42,32,11,21,1.31,34.38,Moyen,Difficile,-1,Plus Difficile,Pas Adapte,Marketing
1465,2016,Marketing,2,Grammaire Lexicale Fonctionnelle,2,Les Fonctions,14,355,2,QROC,0.06,0.5,69.13,28,13,41,34,28,6,1.21,82.35,Facile,Facile,0,Meme Difficulté,Adapte,Marketing
2576,2017,Marketing,2,Grammaire Lexicale Fonctionnelle,2,Les Fonctions,14,355,2,QROC,0.0,0.57,69.13,32,14,46,39,32,7,1.18,82.05,Facile,Facile,0,Meme Difficulté,Adapte,Marketing
3687,2018,Marketing,2,Grammaire Lexicale Fonctionnelle,2,Les Fonctions,14,355,2,QROC,0.06,0.86,69.13,30,14,44,38,30,8,1.16,78.95,Facile,Facile,0,Meme Difficulté,Adapte,Marketing
4798,2019,Marketing,2,Grammaire Lexicale Fonctionnelle,2,Les Fonctions,14,355,2,QROC,0.1,0.51,69.13,29,13,42,40,29,11,1.05,72.5,Facile,Facile,0,Meme Difficulté,Adapte,Marketing
5909,2020,Marketing,2,Grammaire Lexicale Fonctionnelle,2,Les Fonctions,14,355,2,QROC,0.08,0.65,69.13,31,14,45,42,31,11,1.07,73.81,Facile,Facile,0,Meme Difficulté,Adapte,Marketing
355,2015,Marketing,2,Grammaire Lexicale Fonctionnelle,2,Les Fonctions,14,356,3,QCU,0.44,0.4,12.11,10,72,82,76,10,66,1.08,13.16,Facile,Difficile,-2,Beaucoup plus Difficile,Pas Adapte,Marketing
1466,2016,Marketing,2,Grammaire Lexicale Fonctionnelle,2,Les Fonctions,14,356,3,QCM,0.04,0.87,85.66,71,12,83,79,71,8,1.05,89.87,Facile,Facile,0,Meme Difficulté,Pas Adapte,Marketing
2577,2017,Marketing,2,Grammaire Lexicale Fonctionnelle,2,Les Fonctions,14,356,3,QCU,0.3,0.59,47.62,36,40,76,45,36,9,1.69,80.0,Moyen,Moyen,0,Meme Difficulté,Pas Adapte,Marketing
3688,2018,Marketing,2,Grammaire Lexicale Fonctionnelle,2,Les Fonctions,14,356,3,QCU,0.36,0.65,55.89,46,36,82,79,46,33,1.04,58.23,Moyen,Moyen,0,Meme Difficulté,Pas Adapte,Marketing
4799,2019,Marketing,2,Grammaire Lexicale Fonctionnelle,2,Les Fonctions,14,356,3,QCU,0.09,0.91,99.69,80,0,80,80,80,0,1.0,100.0,Moyen,Facile,1,Plus Facile,Pas Adapte,Marketing
5910,2020,Marketing,2,Grammaire Lexicale Fonctionnelle,2,Les Fonctions,14,356,3,QCU,0.53,0.23,29.46,23,54,77,40,23,17,1.93,57.5,Facile,Difficile,-2,Beaucoup plus Difficile,Pas Adapte,Marketing
356,2015,Marketing,2,Grammaire Lexicale Fonctionnelle,2,Les Fonctions,14,357,4,QCU,0.12,0.89,70.86,32,13,45,36,32,4,1.25,88.89,Moyen,Facile,1,Plus Facile,Adapte,Marketing
1467,2016,Marketing,2,Grammaire Lexicale Fonctionnelle,2,Les Fonctions,14,357,4,QROC,0.01,0.78,70.86,30,13,43,36,30,6,1.19,83.33,Facile,Facile,0,Meme Difficulté,Adapte,Marketing
2578,2017,Marketing,2,Grammaire Lexicale Fonctionnelle,2,Les Fonctions,14,357,4,QROC,0.02,0.63,70.86,33,13,46,44,33,11,1.05,75.0,Facile,Facile,0,Meme Difficulté,Adapte,Marketing
3689,2018,Marketing,2,Grammaire Lexicale Fonctionnelle,2,Les Fonctions,14,357,4,QROC,0.07,0.73,70.86,33,13,46,41,33,8,1.12,80.49,Facile,Facile,0,Meme Difficulté,Adapte,Marketing
4800,2019,Marketing,2,Grammaire Lexicale Fonctionnelle,2,Les Fonctions,14,357,4,QROC,0.08,0.52,70.86,33,14,47,40,33,7,1.18,82.5,Facile,Facile,0,Meme Difficulté,Adapte,Marketing
5911,2020,Marketing,2,Grammaire Lexicale Fonctionnelle,2,Les Fonctions,14,357,4,QROC,0.02,0.44,70.86,33,13,46,44,33,11,1.05,75.0,Facile,Facile,0,Meme Difficulté,Adapte,Marketing
357,2015,Marketing,2,Grammaire Lexicale Fonctionnelle,2,Les Fonctions,14,358,5,QCU,0.73,0.23,6.83,2,34,36,35,2,33,1.03,5.71,Facile,Difficile,-2,Beaucoup plus Difficile,Pas Adapte,Marketing
1468,2016,Marketing,2,Grammaire Lexicale Fonctionnelle,2,Les Fonctions,14,358,5,QCU,0.7,0.31,9.61,3,32,35,27,3,24,1.3,11.11,Facile,Difficile,-2,Beaucoup plus Difficile,Pas Adapte,Marketing
2579,2017,Marketing,2,Grammaire Lexicale Fonctionnelle,2,Les Fonctions,14,358,5,QCU,0.38,0.74,38.45,12,18,30,16,12,4,1.88,75.0,Difficile,Moyen,1,Plus Facile,Pas Adapte,Marketing
3690,2018,Marketing,2,Grammaire Lexicale Fonctionnelle,2,Les Fonctions,14,358,5,QCU,0.32,0.47,51.7,14,13,27,21,14,7,1.29,66.67,Difficile,Moyen,1,Plus Facile,Pas Adapte,Marketing
4801,2019,Marketing,2,Grammaire Lexicale Fonctionnelle,2,Les Fonctions,14,358,5,QCU,0.54,0.27,20.57,6,25,31,23,6,17,1.35,26.09,Difficile,Difficile,0,Meme Difficulté,Pas Adapte,Marketing
5912,2020,Marketing,2,Grammaire Lexicale Fonctionnelle,2,Les Fonctions,14,358,5,QCU,0.2,0.84,84.23,30,6,36,33,30,3,1.09,90.91,Facile,Facile,0,Meme Difficulté,Pas Adapte,Marketing
358,2015,Marketing,2,Grammaire Lexicale Fonctionnelle,2,Les Fonctions,14,359,6,QCU,0.37,0.44,37.14,8,14,22,13,8,5,1.69,61.54,Facile,Moyen,-1,Plus Difficile,Pas Adapte,Marketing
1469,2016,Marketing,2,Grammaire Lexicale Fonctionnelle,2,Les Fonctions,14,359,6,QCU,0.2,0.99,96.12,24,1,25,24,24,0,1.04,100.0,Difficile,Facile,2,Beaucoup plus Facile,Pas Adapte,Marketing
2580,2017,Marketing,2,Grammaire Lexicale Fonctionnelle,2,Les Fonctions,14,359,6,QCU,0.07,0.91,82.91,23,5,28,27,23,4,1.04,85.19,Facile,Facile,0,Meme Difficulté,Pas Adapte,Marketing
3691,2018,Marketing,2,Grammaire Lexicale Fonctionnelle,2,Les Fonctions,14,359,6,QCM,0.19,0.89,92.5,23,2,25,24,23,1,1.04,95.83,Facile,Facile,0,Meme Difficulté,Pas Adapte,Marketing
4802,2019,Marketing,2,Grammaire Lexicale Fonctionnelle,2,Les Fonctions,14,359,6,QCM,0.27,0.66,46.71,11,12,23,20,11,9,1.15,55.0,Facile,Moyen,-1,Plus Difficile,Pas Adapte,Marketing
5913,2020,Marketing,2,Grammaire Lexicale Fonctionnelle,2,Les Fonctions,14,359,6,QCM,0.78,0.27,12.7,3,17,20,13,3,10,1.54,23.08,Difficile,Difficile,0,Meme Difficulté,Pas Adapte,Marketing
359,2015,Marketing,2,Grammaire Lexicale Fonctionnelle,2,Les Fonctions,14,360,7,QCM,0.63,0.19,31.63,27,59,86,72,27,45,1.19,37.5,Difficile,Difficile,0,Meme Difficulté,Pas Adapte,Marketing
1470,2016,Marketing,2,Grammaire Lexicale Fonctionnelle,2,Les Fonctions,14,360,7,QROC,0.2,0.36,42.38,35,47,82,64,35,29,1.28,54.69,Moyen,Moyen,0,Meme Difficulté,Pas Adapte,Marketing
2581,2017,Marketing,2,Grammaire Lexicale Fonctionnelle,2,Les Fonctions,14,360,7,QROC,0.17,0.63,70.03,53,23,76,64,53,11,1.19,82.81,Moyen,Facile,1,Plus Facile,Adapte,Marketing
3692,2018,Marketing,2,Grammaire Lexicale Fonctionnelle,2,Les Fonctions,14,360,7,QROC,0.15,0.45,70.03,57,24,81,69,57,12,1.17,82.61,Facile,Facile,0,Meme Difficulté,Adapte,Marketing
4803,2019,Marketing,2,Grammaire Lexicale Fonctionnelle,2,Les Fonctions,14,360,7,QROC,0.16,0.8,70.03,57,25,82,79,57,22,1.04,72.15,Facile,Facile,0,Meme Difficulté,Adapte,Marketing
5914,2020,Marketing,2,Grammaire Lexicale Fonctionnelle,2,Les Fonctions,14,360,7,QROC,0.13,0.6,70.03,57,24,81,76,57,19,1.07,75.0,Facile,Facile,0,Meme Difficulté,Adapte,Marketing
360,2015,Marketing,2,Grammaire Lexicale Fonctionnelle,2,Les Fonctions,14,361,8,QCU,0.29,0.49,62.39,29,18,47,47,29,18,1.0,61.7,Facile,Moyen,-1,Plus Difficile,Adapte,Marketing
1471,2016,Marketing,2,Grammaire Lexicale Fonctionnelle,2,Les Fonctions,14,361,8,QCU,0.28,0.55,62.39,31,18,49,35,31,4,1.4,88.57,Moyen,Moyen,0,Meme Difficulté,Adapte,Marketing
2582,2017,Marketing,2,Grammaire Lexicale Fonctionnelle,2,Les Fonctions,14,361,8,QCU,0.25,0.49,62.39,32,19,51,49,32,17,1.04,65.31,Moyen,Moyen,0,Meme Difficulté,Adapte,Marketing
3693,2018,Marketing,2,Grammaire Lexicale Fonctionnelle,2,Les Fonctions,14,361,8,QCU,0.27,0.7,62.39,36,21,57,54,36,18,1.06,66.67,Moyen,Moyen,0,Meme Difficulté,Adapte,Marketing
4804,2019,Marketing,2,Grammaire Lexicale Fonctionnelle,2,Les Fonctions,14,361,8,QCU,0.39,0.53,62.39,32,19,51,43,32,11,1.19,74.42,Moyen,Moyen,0,Meme Difficulté,Adapte,Marketing
5915,2020,Marketing,2,Grammaire Lexicale Fonctionnelle,2,Les Fonctions,14,361,8,QCM,0.49,0.51,62.39,36,22,58,56,36,20,1.04,64.29,Moyen,Moyen,0,Meme Difficulté,Adapte,Marketing
361,2015,Marketing,2,Grammaire Lexicale Fonctionnelle,2,Les Fonctions,14,362,9,QCU,0.29,0.54,42.08,32,45,77,46,32,14,1.67,69.57,Facile,Moyen,-1,Plus Difficile,Pas Adapte,Marketing
1472,2016,Marketing,2,Grammaire Lexicale Fonctionnelle,2,Les Fonctions,14,362,9,QCU,0.26,0.64,41.94,36,51,87,50,36,14,1.74,72.0,Facile,Moyen,-1,Plus Difficile,Pas Adapte,Marketing
2583,2017,Marketing,2,Grammaire Lexicale Fonctionnelle,2,Les Fonctions,14,362,9,QCU,0.18,0.96,92.94,72,6,78,77,72,5,1.01,93.51,Moyen,Facile,1,Plus Facile,Pas Adapte,Marketing
3694,2018,Marketing,2,Grammaire Lexicale Fonctionnelle,2,Les Fonctions,14,362,9,QCU,0.32,0.6,41.23,30,42,72,58,30,28,1.24,51.72,Difficile,Moyen,1,Plus Facile,Pas Adapte,Marketing
4805,2019,Marketing,2,Grammaire Lexicale Fonctionnelle,2,Les Fonctions,14,362,9,QCM,0.41,0.58,42.78,28,37,65,54,28,26,1.2,51.85,Moyen,Moyen,0,Meme Difficulté,Pas Adapte,Marketing
5916,2020,Marketing,2,Grammaire Lexicale Fonctionnelle,2,Les Fonctions,14,362,9,QCM,0.28,0.7,44.68,26,33,59,54,26,28,1.09,48.15,Difficile,Moyen,1,Plus Facile,Pas Adapte,Marketing
362,2015,Marketing,2,Grammaire Lexicale Fonctionnelle,2,Les Fonctions,14,363,10,QCM,0.46,0.47,64.33,20,11,31,28,20,8,1.11,71.43,Moyen,Moyen,0,Meme Difficulté,Adapte,Marketing
1473,2016,Marketing,2,Grammaire Lexicale Fonctionnelle,2,Les Fonctions,14,363,10,QCU,0.4,0.44,64.33,23,13,36,32,23,9,1.12,71.88,Moyen,Moyen,0,Meme Difficulté,Adapte,Marketing
2584,2017,Marketing,2,Grammaire Lexicale Fonctionnelle,2,Les Fonctions,14,363,10,QCM,0.48,0.47,64.33,26,14,40,27,26,1,1.48,96.3,Moyen,Moyen,0,Meme Difficulté,Adapte,Marketing
3695,2018,Marketing,2,Grammaire Lexicale Fonctionnelle,2,Les Fonctions,14,363,10,QCM,0.35,0.62,64.33,26,14,40,39,26,13,1.03,66.67,Moyen,Moyen,0,Meme Difficulté,Adapte,Marketing
4806,2019,Marketing,2,Grammaire Lexicale Fonctionnelle,2,Les Fonctions,14,363,10,QCM,0.46,0.47,64.33,24,14,38,25,24,1,1.52,96.0,Moyen,Moyen,0,Meme Difficulté,Adapte,Marketing
5917,2020,Marketing,2,Grammaire Lexicale Fonctionnelle,2,Les Fonctions,14,363,10,QCM,0.38,0.47,64.33,21,12,33,27,21,6,1.22,77.78,Moyen,Moyen,0,Meme Difficulté,Adapte,Marketing
363,2015,Marketing,2,Grammaire Lexicale Fonctionnelle,2,Les Fonctions,14,364,11,QCU,0.08,0.97,85.53,67,11,78,74,67,7,1.05,90.54,Difficile,Facile,2,Beaucoup plus Facile,Pas Adapte,Marketing
1474,2016,Marketing,2,Grammaire Lexicale Fonctionnelle,2,Les Fonctions,14,364,11,QCU,0.72,0.3,22.77,20,67,87,37,20,17,2.35,54.05,Facile,Difficile,-2,Beaucoup plus Difficile,Pas Adapte,Marketing
2585,2017,Marketing,2,Grammaire Lexicale Fonctionnelle,2,Les Fonctions,14,364,11,QCM,0.69,0.24,3.41,3,73,76,41,3,38,1.85,7.32,Facile,Difficile,-2,Beaucoup plus Difficile,Pas Adapte,Marketing
3696,2018,Marketing,2,Grammaire Lexicale Fonctionnelle,2,Les Fonctions,14,364,11,QCM,0.23,0.36,42.21,30,42,72,46,30,16,1.57,65.22,Moyen,Moyen,0,Meme Difficulté,Pas Adapte,Marketing
4807,2019,Marketing,2,Grammaire Lexicale Fonctionnelle,2,Les Fonctions,14,364,11,QCM,0.32,0.49,62.72,43,26,69,59,43,16,1.17,72.88,Moyen,Moyen,0,Meme Difficulté,Adapte,Marketing
5918,2020,Marketing,2,Grammaire Lexicale Fonctionnelle,2,Les Fonctions,14,364,11,QCU,0.39,0.62,62.72,38,23,61,44,38,6,1.39,86.36,Moyen,Moyen,0,Meme Difficulté,Adapte,Marketing
364,2015,Marketing,2,Grammaire Lexicale Fonctionnelle,2,Les Fonctions,14,365,12,QROC,0.58,0.39,37.02,8,14,22,18,8,10,1.22,44.44,Facile,Moyen,-1,Plus Difficile,Pas Adapte,Marketing
1475,2016,Marketing,2,Grammaire Lexicale Fonctionnelle,2,Les Fonctions,14,365,12,QROC,0.14,0.4,87.19,21,3,24,21,21,0,1.14,100.0,Moyen,Facile,1,Plus Facile,Pas Adapte,Marketing
2586,2017,Marketing,2,Grammaire Lexicale Fonctionnelle,2,Les Fonctions,14,365,12,QROC,0.11,0.7,90.64,19,2,21,21,19,2,1.0,90.48,Facile,Facile,0,Meme Difficulté,Pas Adapte,Marketing
3697,2018,Marketing,2,Grammaire Lexicale Fonctionnelle,2,Les Fonctions,14,365,12,QROC,0.44,0.38,38.21,7,11,18,13,7,6,1.38,53.85,Facile,Moyen,-1,Plus Difficile,Pas Adapte,Marketing
4808,2019,Marketing,2,Grammaire Lexicale Fonctionnelle,2,Les Fonctions,14,365,12,QROC,0.12,0.57,86.85,16,2,18,18,16,2,1.0,88.89,Difficile,Facile,2,Beaucoup plus Facile,Pas Adapte,Marketing
5919,2020,Marketing,2,Grammaire Lexicale Fonctionnelle,2,Les Fonctions,14,365,12,QROC,0.52,0.27,46.76,9,10,19,18,9,9,1.06,50.0,Difficile,Moyen,1,Plus Facile,Pas Adapte,Marketing
365,2015,Marketing,2,Grammaire Lexicale Fonctionnelle,2,Les Fonctions,14,366,13,QCU,0.63,0.27,30.42,5,11,16,9,5,4,1.78,55.56,Facile,Difficile,-2,Beaucoup plus Difficile,Pas Adapte,Marketing
1476,2016,Marketing,2,Grammaire Lexicale Fonctionnelle,2,Les Fonctions,14,366,13,QCU,0.07,0.99,85.3,15,2,17,16,15,1,1.06,93.75,Difficile,Facile,2,Beaucoup plus Facile,Pas Adapte,Marketing
2587,2017,Marketing,2,Grammaire Lexicale Fonctionnelle,2,Les Fonctions,14,366,13,QROC,0.63,0.14,2.73,0,16,16,7,0,7,2.29,0.0,Moyen,Difficile,-1,Plus Difficile,Pas Adapte,Marketing
3698,2018,Marketing,2,Grammaire Lexicale Fonctionnelle,2,Les Fonctions,14,366,13,QROC,0.2,0.27,41.13,7,11,18,16,7,9,1.12,43.75,Moyen,Moyen,0,Meme Difficulté,Pas Adapte,Marketing
4809,2019,Marketing,2,Grammaire Lexicale Fonctionnelle,2,Les Fonctions,14,366,13,QROC,0.38,0.34,44.06,8,11,19,9,8,1,2.11,88.89,Difficile,Moyen,1,Plus Facile,Pas Adapte,Marketing
5920,2020,Marketing,2,Grammaire Lexicale Fonctionnelle,2,Les Fonctions,14,366,13,QROC,0.47,0.33,53.41,11,9,20,14,11,3,1.43,78.57,Moyen,Moyen,0,Meme Difficulté,Pas Adapte,Marketing
366,2015,Marketing,2,Grammaire Lexicale Fonctionnelle,2,Les Fonctions,14,367,14,QROC,0.45,0.28,40.04,8,12,20,10,8,2,2.0,80.0,Difficile,Moyen,1,Plus Facile,Pas Adapte,Marketing
1477,2016,Marketing,2,Grammaire Lexicale Fonctionnelle,2,Les Fonctions,14,367,14,QROC,0.49,0.31,39.27,8,13,21,12,8,4,1.75,66.67,Facile,Moyen,-1,Plus Difficile,Pas Adapte,Marketing
2588,2017,Marketing,2,Grammaire Lexicale Fonctionnelle,2,Les Fonctions,14,367,14,QROC,0.7,0.17,8.07,1,17,18,8,1,7,2.25,12.5,Facile,Difficile,-2,Beaucoup plus Difficile,Pas Adapte,Marketing
3699,2018,Marketing,2,Grammaire Lexicale Fonctionnelle,2,Les Fonctions,14,367,14,QO,0.93,0.12,1.76,0,20,20,17,0,17,1.18,0.0,Moyen,Difficile,-1,Plus Difficile,Pas Adapte,Marketing
4810,2019,Marketing,2,Grammaire Lexicale Fonctionnelle,2,Les Fonctions,14,367,14,QO,0.66,0.21,50.1,9,8,17,15,9,6,1.13,60.0,Facile,Moyen,-1,Plus Difficile,Pas Adapte,Marketing
5921,2020,Marketing,2,Grammaire Lexicale Fonctionnelle,2,Les Fonctions,14,367,14,QO,0.06,0.49,89.66,17,2,19,17,17,0,1.12,100.0,Difficile,Facile,2,Beaucoup plus Facile,Pas Adapte,Marketing
367,2015,Marketing,2,Grammaire Lexicale Fonctionnelle,3,Ecrire une Grammaire Lexicale Fonctionnelle,8,368,1,QCM,0.52,0.15,25.61,7,22,29,26,7,19,1.12,26.92,Facile,Difficile,-2,Beaucoup plus Difficile,Pas Adapte,Marketing
1478,2016,Marketing,2,Grammaire Lexicale Fonctionnelle,3,Ecrire une Grammaire Lexicale Fonctionnelle,8,368,1,QCM,0.57,0.2,22.63,6,19,25,24,6,18,1.04,25.0,Facile,Difficile,-2,Beaucoup plus Difficile,Pas Adapte,Marketing
2589,2017,Marketing,2,Grammaire Lexicale Fonctionnelle,3,Ecrire une Grammaire Lexicale Fonctionnelle,8,368,1,QCU,0.21,0.4,45.3,11,13,24,14,11,3,1.71,78.57,Moyen,Moyen,0,Meme Difficulté,Pas Adapte,Marketing
3700,2018,Marketing,2,Grammaire Lexicale Fonctionnelle,3,Ecrire une Grammaire Lexicale Fonctionnelle,8,368,1,QCU,0.36,0.74,51.09,11,11,22,11,11,0,2.0,100.0,Difficile,Moyen,1,Plus Facile,Pas Adapte,Marketing
4811,2019,Marketing,2,Grammaire Lexicale Fonctionnelle,3,Ecrire une Grammaire Lexicale Fonctionnelle,8,368,1,QCU,0.0,0.97,87.15,20,3,23,21,20,1,1.1,95.24,Facile,Facile,0,Meme Difficulté,Pas Adapte,Marketing
5922,2020,Marketing,2,Grammaire Lexicale Fonctionnelle,3,Ecrire une Grammaire Lexicale Fonctionnelle,8,368,1,QCU,0.26,0.67,44.48,11,14,25,14,11,3,1.79,78.57,Moyen,Moyen,0,Meme Difficulté,Pas Adapte,Marketing
368,2015,Marketing,2,Grammaire Lexicale Fonctionnelle,3,Ecrire une Grammaire Lexicale Fonctionnelle,8,369,2,QROC,0.77,0.04,18.72,11,46,57,30,11,19,1.9,36.67,Facile,Difficile,-2,Beaucoup plus Difficile,Pas Adapte,Marketing
1479,2016,Marketing,2,Grammaire Lexicale Fonctionnelle,3,Ecrire une Grammaire Lexicale Fonctionnelle,8,369,2,QROC,0.87,0.14,20.69,10,39,49,34,10,24,1.44,29.41,Moyen,Difficile,-1,Plus Difficile,Pas Adapte,Marketing
2590,2017,Marketing,2,Grammaire Lexicale Fonctionnelle,3,Ecrire une Grammaire Lexicale Fonctionnelle,8,369,2,QCM,0.19,0.85,69.96,29,13,42,32,29,3,1.31,90.62,Difficile,Facile,2,Beaucoup plus Facile,Adapte,Marketing
3701,2018,Marketing,2,Grammaire Lexicale Fonctionnelle,3,Ecrire une Grammaire Lexicale Fonctionnelle,8,369,2,QCM,0.0,0.84,69.96,33,14,47,43,33,10,1.09,76.74,Facile,Facile,0,Meme Difficulté,Adapte,Marketing
4812,2019,Marketing,2,Grammaire Lexicale Fonctionnelle,3,Ecrire une Grammaire Lexicale Fonctionnelle,8,369,2,QCM,0.16,0.87,69.96,29,12,41,38,29,9,1.08,76.32,Facile,Facile,0,Meme Difficulté,Adapte,Marketing
5923,2020,Marketing,2,Grammaire Lexicale Fonctionnelle,3,Ecrire une Grammaire Lexicale Fonctionnelle,8,369,2,QCM,0.07,0.91,69.96,29,13,42,34,29,5,1.24,85.29,Facile,Facile,0,Meme Difficulté,Adapte,Marketing
369,2015,Marketing,2,Grammaire Lexicale Fonctionnelle,3,Ecrire une Grammaire Lexicale Fonctionnelle,8,370,3,QCU,0.28,0.6,44.09,30,39,69,32,30,2,2.16,93.75,Difficile,Moyen,1,Plus Facile,Pas Adapte,Marketing
1480,2016,Marketing,2,Grammaire Lexicale Fonctionnelle,3,Ecrire une Grammaire Lexicale Fonctionnelle,8,370,3,QCU,0.18,0.77,94.52,63,4,67,65,63,2,1.03,96.92,Difficile,Facile,2,Beaucoup plus Facile,Pas Adapte,Marketing
2591,2017,Marketing,2,Grammaire Lexicale Fonctionnelle,3,Ecrire une Grammaire Lexicale Fonctionnelle,8,370,3,QCU,0.28,0.48,53.86,31,27,58,45,31,14,1.29,68.89,Difficile,Moyen,1,Plus Facile,Pas Adapte,Marketing
3702,2018,Marketing,2,Grammaire Lexicale Fonctionnelle,3,Ecrire une Grammaire Lexicale Fonctionnelle,8,370,3,QCU,0.53,0.35,14.33,7,42,49,31,7,24,1.58,22.58,Facile,Difficile,-2,Beaucoup plus Difficile,Pas Adapte,Marketing
4813,2019,Marketing,2,Grammaire Lexicale Fonctionnelle,3,Ecrire une Grammaire Lexicale Fonctionnelle,8,370,3,QCM,0.44,0.57,53.3,23,20,43,31,23,8,1.39,74.19,Moyen,Moyen,0,Meme Difficulté,Pas Adapte,Marketing
5924,2020,Marketing,2,Grammaire Lexicale Fonctionnelle,3,Ecrire une Grammaire Lexicale Fonctionnelle,8,370,3,QCM,0.14,0.81,77.3,31,9,40,35,31,4,1.14,88.57,Facile,Facile,0,Meme Difficulté,Pas Adapte,Marketing
370,2015,Marketing,2,Grammaire Lexicale Fonctionnelle,3,Ecrire une Grammaire Lexicale Fonctionnelle,8,371,4,QCU,0.15,0.98,97.77,66,2,68,66,66,0,1.03,100.0,Difficile,Facile,2,Beaucoup plus Facile,Pas Adapte,Marketing
1481,2016,Marketing,2,Grammaire Lexicale Fonctionnelle,3,Ecrire une Grammaire Lexicale Fonctionnelle,8,371,4,QCM,0.59,0.26,24.41,18,56,74,25,18,7,2.96,72.0,Difficile,Difficile,0,Meme Difficulté,Pas Adapte,Marketing
2592,2017,Marketing,2,Grammaire Lexicale Fonctionnelle,3,Ecrire une Grammaire Lexicale Fonctionnelle,8,371,4,QCM,0.17,0.87,97.08,78,2,80,79,78,1,1.01,98.73,Moyen,Facile,1,Plus Facile,Pas Adapte,Marketing
3703,2018,Marketing,2,Grammaire Lexicale Fonctionnelle,3,Ecrire une Grammaire Lexicale Fonctionnelle,8,371,4,QCM,0.65,0.28,26.51,24,65,89,37,24,13,2.41,64.86,Difficile,Difficile,0,Meme Difficulté,Pas Adapte,Marketing
4814,2019,Marketing,2,Grammaire Lexicale Fonctionnelle,3,Ecrire une Grammaire Lexicale Fonctionnelle,8,371,4,QCU,0.74,0.23,34.02,31,61,92,49,31,18,1.88,63.27,Moyen,Difficile,-1,Plus Difficile,Pas Adapte,Marketing
5925,2020,Marketing,2,Grammaire Lexicale Fonctionnelle,3,Ecrire une Grammaire Lexicale Fonctionnelle,8,371,4,QCU,0.15,0.86,73.43,66,24,90,78,66,12,1.15,84.62,Facile,Facile,0,Meme Difficulté,Adapte,Marketing
371,2015,Marketing,2,Grammaire Lexicale Fonctionnelle,3,Ecrire une Grammaire Lexicale Fonctionnelle,8,372,5,QROC,0.67,0.12,23.75,10,32,42,34,10,24,1.24,29.41,Moyen,Difficile,-1,Plus Difficile,Pas Adapte,Marketing
1482,2016,Marketing,2,Grammaire Lexicale Fonctionnelle,3,Ecrire une Grammaire Lexicale Fonctionnelle,8,372,5,QROC,0.22,0.3,45.47,21,26,47,21,21,0,2.24,100.0,Difficile,Moyen,1,Plus Facile,Pas Adapte,Marketing
2593,2017,Marketing,2,Grammaire Lexicale Fonctionnelle,3,Ecrire une Grammaire Lexicale Fonctionnelle,8,372,5,QROC,0.01,0.58,68.59,27,13,40,38,27,11,1.05,71.05,Difficile,Facile,2,Beaucoup plus Facile,Adapte,Marketing
3704,2018,Marketing,2,Grammaire Lexicale Fonctionnelle,3,Ecrire une Grammaire Lexicale Fonctionnelle,8,372,5,QROC,0.14,0.67,68.59,23,11,34,23,23,0,1.48,100.0,Facile,Facile,0,Meme Difficulté,Adapte,Marketing
4815,2019,Marketing,2,Grammaire Lexicale Fonctionnelle,3,Ecrire une Grammaire Lexicale Fonctionnelle,8,372,5,QROC,0.09,0.83,68.59,20,9,29,24,20,4,1.21,83.33,Facile,Facile,0,Meme Difficulté,Adapte,Marketing
5926,2020,Marketing,2,Grammaire Lexicale Fonctionnelle,3,Ecrire une Grammaire Lexicale Fonctionnelle,8,372,5,QROC,0.16,0.75,68.59,22,10,32,23,22,1,1.39,95.65,Facile,Facile,0,Meme Difficulté,Adapte,Marketing
372,2015,Marketing,2,Grammaire Lexicale Fonctionnelle,3,Ecrire une Grammaire Lexicale Fonctionnelle,8,373,6,QO,0.92,0.03,29.77,19,45,64,57,19,38,1.12,33.33,Difficile,Difficile,0,Meme Difficulté,Pas Adapte,Marketing
1483,2016,Marketing,2,Grammaire Lexicale Fonctionnelle,3,Ecrire une Grammaire Lexicale Fonctionnelle,8,373,6,QO,0.04,0.69,78.25,49,13,62,61,49,12,1.02,80.33,Facile,Facile,0,Meme Difficulté,Pas Adapte,Marketing
2594,2017,Marketing,2,Grammaire Lexicale Fonctionnelle,3,Ecrire une Grammaire Lexicale Fonctionnelle,8,373,6,QO,0.77,0.0,16.4,10,53,63,44,10,34,1.43,22.73,Moyen,Difficile,-1,Plus Difficile,Pas Adapte,Marketing
3705,2018,Marketing,2,Grammaire Lexicale Fonctionnelle,3,Ecrire une Grammaire Lexicale Fonctionnelle,8,373,6,QO,0.53,0.18,36.91,23,40,63,46,23,23,1.37,50.0,Difficile,Moyen,1,Plus Facile,Pas Adapte,Marketing
4816,2019,Marketing,2,Grammaire Lexicale Fonctionnelle,3,Ecrire une Grammaire Lexicale Fonctionnelle,8,373,6,QO,0.46,0.27,52.49,36,32,68,54,36,18,1.26,66.67,Difficile,Moyen,1,Plus Facile,Pas Adapte,Marketing
5927,2020,Marketing,2,Grammaire Lexicale Fonctionnelle,3,Ecrire une Grammaire Lexicale Fonctionnelle,8,373,6,QO,0.32,0.18,61.56,44,27,71,65,44,21,1.09,67.69,Difficile,Moyen,1,Plus Facile,Adapte,Marketing
373,2015,Marketing,2,Grammaire Lexicale Fonctionnelle,3,Ecrire une Grammaire Lexicale Fonctionnelle,8,374,7,QCM,0.11,0.98,65.61,39,20,59,41,39,2,1.44,95.12,Moyen,Facile,1,Plus Facile,Adapte,Marketing
1484,2016,Marketing,2,Grammaire Lexicale Fonctionnelle,3,Ecrire une Grammaire Lexicale Fonctionnelle,8,374,7,QCM,0.19,0.93,65.61,34,18,52,49,34,15,1.06,69.39,Facile,Facile,0,Meme Difficulté,Adapte,Marketing
2595,2017,Marketing,2,Grammaire Lexicale Fonctionnelle,3,Ecrire une Grammaire Lexicale Fonctionnelle,8,374,7,QCM,0.03,0.84,65.61,35,18,53,53,35,18,1.0,66.04,Facile,Facile,0,Meme Difficulté,Adapte,Marketing
3706,2018,Marketing,2,Grammaire Lexicale Fonctionnelle,3,Ecrire une Grammaire Lexicale Fonctionnelle,8,374,7,QCM,0.16,0.91,65.61,39,21,60,42,39,3,1.43,92.86,Facile,Facile,0,Meme Difficulté,Adapte,Marketing
4817,2019,Marketing,2,Grammaire Lexicale Fonctionnelle,3,Ecrire une Grammaire Lexicale Fonctionnelle,8,374,7,QCU,0.13,0.78,65.61,35,18,53,46,35,11,1.15,76.09,Facile,Facile,0,Meme Difficulté,Adapte,Marketing
5928,2020,Marketing,2,Grammaire Lexicale Fonctionnelle,3,Ecrire une Grammaire Lexicale Fonctionnelle,8,374,7,QCU,0.13,0.77,65.61,30,16,46,37,30,7,1.24,81.08,Facile,Facile,0,Meme Difficulté,Adapte,Marketing
374,2015,Marketing,2,Grammaire Lexicale Fonctionnelle,3,Ecrire une Grammaire Lexicale Fonctionnelle,8,375,8,QO,0.04,0.53,77.18,23,7,30,25,23,2,1.2,92.0,Difficile,Facile,2,Beaucoup plus Facile,Pas Adapte,Marketing
1485,2016,Marketing,2,Grammaire Lexicale Fonctionnelle,3,Ecrire une Grammaire Lexicale Fonctionnelle,8,375,8,QO,0.06,0.62,88.71,25,3,28,27,25,2,1.04,92.59,Moyen,Facile,1,Plus Facile,Pas Adapte,Marketing
2596,2017,Marketing,2,Grammaire Lexicale Fonctionnelle,3,Ecrire une Grammaire Lexicale Fonctionnelle,8,375,8,QO,0.89,0.0,12.4,3,22,25,24,3,21,1.04,12.5,Facile,Difficile,-2,Beaucoup plus Difficile,Pas Adapte,Marketing
3707,2018,Marketing,2,Grammaire Lexicale Fonctionnelle,3,Ecrire une Grammaire Lexicale Fonctionnelle,8,375,8,QO,0.95,0.11,28.22,8,20,28,20,8,12,1.4,40.0,Moyen,Difficile,-1,Plus Difficile,Pas Adapte,Marketing
4818,2019,Marketing,2,Grammaire Lexicale Fonctionnelle,3,Ecrire une Grammaire Lexicale Fonctionnelle,8,375,8,QO,0.16,0.92,81.35,26,6,32,29,26,3,1.1,89.66,Facile,Facile,0,Meme Difficulté,Pas Adapte,Marketing
5929,2020,Marketing,2,Grammaire Lexicale Fonctionnelle,3,Ecrire une Grammaire Lexicale Fonctionnelle,8,375,8,QO,0.86,0.13,16.57,6,30,36,28,6,22,1.29,21.43,Facile,Difficile,-2,Beaucoup plus Difficile,Pas Adapte,Marketing
375,2015,Marketing,2,Grammaire Lexicale Fonctionnelle,4,Diversite des Fonctions Grammaticales,14,376,1,QROC,0.24,0.31,37.45,3,5,8,8,3,5,1.0,37.5,Difficile,Moyen,1,Plus Facile,Pas Adapte,Marketing
1486,2016,Marketing,2,Grammaire Lexicale Fonctionnelle,4,Diversite des Fonctions Grammaticales,14,376,1,QROC,0.43,0.26,62.99,4,3,7,6,4,2,1.17,66.67,Facile,Moyen,-1,Plus Difficile,Adapte,Marketing
2597,2017,Marketing,2,Grammaire Lexicale Fonctionnelle,4,Diversite des Fonctions Grammaticales,14,376,1,QROC,0.58,0.35,62.99,5,3,8,8,5,3,1.0,62.5,Moyen,Moyen,0,Meme Difficulté,Adapte,Marketing
3708,2018,Marketing,2,Grammaire Lexicale Fonctionnelle,4,Diversite des Fonctions Grammaticales,14,376,1,QROC,0.4,0.35,62.99,4,3,7,7,4,3,1.0,57.14,Moyen,Moyen,0,Meme Difficulté,Adapte,Marketing
4819,2019,Marketing,2,Grammaire Lexicale Fonctionnelle,4,Diversite des Fonctions Grammaticales,14,376,1,QROC,0.43,0.28,62.99,4,3,7,7,4,3,1.0,57.14,Moyen,Moyen,0,Meme Difficulté,Adapte,Marketing
5930,2020,Marketing,2,Grammaire Lexicale Fonctionnelle,4,Diversite des Fonctions Grammaticales,14,376,1,QROC,0.27,0.27,62.99,4,3,7,5,4,1,1.4,80.0,Moyen,Moyen,0,Meme Difficulté,Adapte,Marketing
376,2015,Marketing,2,Grammaire Lexicale Fonctionnelle,4,Diversite des Fonctions Grammaticales,14,377,2,QCU,0.39,0.42,53.79,28,24,52,39,28,11,1.33,71.79,Difficile,Moyen,1,Plus Facile,Pas Adapte,Marketing
1487,2016,Marketing,2,Grammaire Lexicale Fonctionnelle,4,Diversite des Fonctions Grammaticales,14,377,2,QCU,0.49,0.24,8.83,5,54,59,59,5,54,1.0,8.47,Moyen,Difficile,-1,Plus Difficile,Pas Adapte,Marketing
2598,2017,Marketing,2,Grammaire Lexicale Fonctionnelle,4,Diversite des Fonctions Grammaticales,14,377,2,QCU,0.21,0.45,58.75,32,23,55,53,32,21,1.04,60.38,Facile,Moyen,-1,Plus Difficile,Pas Adapte,Marketing
3709,2018,Marketing,2,Grammaire Lexicale Fonctionnelle,4,Diversite des Fonctions Grammaticales,14,377,2,QCU,0.63,0.24,15.71,7,40,47,44,7,37,1.07,15.91,Difficile,Difficile,0,Meme Difficulté,Pas Adapte,Marketing
4820,2019,Marketing,2,Grammaire Lexicale Fonctionnelle,4,Diversite des Fonctions Grammaticales,14,377,2,QCU,0.71,0.38,5.69,3,47,50,46,3,43,1.09,6.52,Moyen,Difficile,-1,Plus Difficile,Pas Adapte,Marketing
5931,2020,Marketing,2,Grammaire Lexicale Fonctionnelle,4,Diversite des Fonctions Grammaticales,14,377,2,QCU,0.02,0.78,93.94,49,3,52,52,49,3,1.0,94.23,Facile,Facile,0,Meme Difficulté,Pas Adapte,Marketing
377,2015,Marketing,2,Grammaire Lexicale Fonctionnelle,4,Diversite des Fonctions Grammaticales,14,378,3,QO,0.02,0.5,73.22,27,10,37,27,27,0,1.37,100.0,Difficile,Facile,2,Beaucoup plus Facile,Adapte,Marketing
1488,2016,Marketing,2,Grammaire Lexicale Fonctionnelle,4,Diversite des Fonctions Grammaticales,14,378,3,QO,0.06,0.89,73.22,29,11,40,32,29,3,1.25,90.62,Facile,Facile,0,Meme Difficulté,Adapte,Marketing
2599,2017,Marketing,2,Grammaire Lexicale Fonctionnelle,4,Diversite des Fonctions Grammaticales,14,378,3,QO,0.08,0.85,73.22,26,9,35,28,26,2,1.25,92.86,Facile,Facile,0,Meme Difficulté,Adapte,Marketing
3710,2018,Marketing,2,Grammaire Lexicale Fonctionnelle,4,Diversite des Fonctions Grammaticales,14,378,3,QO,0.04,0.8,73.22,23,8,31,25,23,2,1.24,92.0,Facile,Facile,0,Meme Difficulté,Adapte,Marketing
4821,2019,Marketing,2,Grammaire Lexicale Fonctionnelle,4,Diversite des Fonctions Grammaticales,14,378,3,QO,0.15,0.88,73.22,20,7,27,24,20,4,1.12,83.33,Facile,Facile,0,Meme Difficulté,Adapte,Marketing
5932,2020,Marketing,2,Grammaire Lexicale Fonctionnelle,4,Diversite des Fonctions Grammaticales,14,378,3,QROC,0.09,0.61,73.22,21,7,28,27,21,6,1.04,77.78,Facile,Facile,0,Meme Difficulté,Adapte,Marketing
378,2015,Marketing,2,Grammaire Lexicale Fonctionnelle,4,Diversite des Fonctions Grammaticales,14,379,4,QCU,0.51,0.37,33.19,11,21,32,24,11,13,1.33,45.83,Facile,Difficile,-2,Beaucoup plus Difficile,Pas Adapte,Marketing
1489,2016,Marketing,2,Grammaire Lexicale Fonctionnelle,4,Diversite des Fonctions Grammaticales,14,379,4,QCU,0.17,0.88,91.77,28,3,31,30,28,2,1.03,93.33,Facile,Facile,0,Meme Difficulté,Pas Adapte,Marketing
2600,2017,Marketing,2,Grammaire Lexicale Fonctionnelle,4,Diversite des Fonctions Grammaticales,14,379,4,QCU,0.46,0.23,3.48,1,34,35,31,1,30,1.13,3.23,Difficile,Difficile,0,Meme Difficulté,Pas Adapte,Marketing
3711,2018,Marketing,2,Grammaire Lexicale Fonctionnelle,4,Diversite des Fonctions Grammaticales,14,379,4,QCU,0.17,1.0,81.25,30,7,37,32,30,2,1.16,93.75,Facile,Facile,0,Meme Difficulté,Pas Adapte,Marketing
4822,2019,Marketing,2,Grammaire Lexicale Fonctionnelle,4,Diversite des Fonctions Grammaticales,14,379,4,QCU,0.36,0.57,35.28,15,27,42,22,15,7,1.91,68.18,Moyen,Moyen,0,Meme Difficulté,Pas Adapte,Marketing
5933,2020,Marketing,2,Grammaire Lexicale Fonctionnelle,4,Diversite des Fonctions Grammaticales,14,379,4,QCU,0.01,0.99,85.5,36,6,42,37,36,1,1.14,97.3,Difficile,Facile,2,Beaucoup plus Facile,Pas Adapte,Marketing
379,2015,Marketing,2,Grammaire Lexicale Fonctionnelle,4,Diversite des Fonctions Grammaticales,14,380,5,QCU,0.48,0.26,33.06,17,33,50,35,17,18,1.43,48.57,Difficile,Difficile,0,Meme Difficulté,Pas Adapte,Marketing
1490,2016,Marketing,2,Grammaire Lexicale Fonctionnelle,4,Diversite des Fonctions Grammaticales,14,380,5,QCU,0.29,0.57,52.21,29,27,56,41,29,12,1.37,70.73,Facile,Moyen,-1,Plus Difficile,Pas Adapte,Marketing
2601,2017,Marketing,2,Grammaire Lexicale Fonctionnelle,4,Diversite des Fonctions Grammaticales,14,380,5,QCU,0.22,0.62,38.93,23,36,59,44,23,21,1.34,52.27,Moyen,Moyen,0,Meme Difficulté,Pas Adapte,Marketing
3712,2018,Marketing,2,Grammaire Lexicale Fonctionnelle,4,Diversite des Fonctions Grammaticales,14,380,5,QCM,0.23,0.48,49.52,30,31,61,45,30,15,1.36,66.67,Facile,Moyen,-1,Plus Difficile,Pas Adapte,Marketing
4823,2019,Marketing,2,Grammaire Lexicale Fonctionnelle,4,Diversite des Fonctions Grammaticales,14,380,5,QCM,0.56,0.23,28.06,19,48,67,55,19,36,1.22,34.55,Facile,Difficile,-2,Beaucoup plus Difficile,Pas Adapte,Marketing
5934,2020,Marketing,2,Grammaire Lexicale Fonctionnelle,4,Diversite des Fonctions Grammaticales,14,380,5,QCU,0.25,0.57,59.14,37,26,63,51,37,14,1.24,72.55,Moyen,Moyen,0,Meme Difficulté,Pas Adapte,Marketing
380,2015,Marketing,2,Grammaire Lexicale Fonctionnelle,4,Diversite des Fonctions Grammaticales,14,381,6,QCM,0.13,0.88,69.44,19,8,27,26,19,7,1.04,73.08,Facile,Facile,0,Meme Difficulté,Adapte,Marketing
1491,2016,Marketing,2,Grammaire Lexicale Fonctionnelle,4,Diversite des Fonctions Grammaticales,14,381,6,QCM,0.15,0.79,69.44,22,9,31,26,22,4,1.19,84.62,Facile,Facile,0,Meme Difficulté,Adapte,Marketing
2602,2017,Marketing,2,Grammaire Lexicale Fonctionnelle,4,Diversite des Fonctions Grammaticales,14,381,6,QCU,0.12,0.97,69.44,22,10,32,27,22,5,1.19,81.48,Facile,Facile,0,Meme Difficulté,Adapte,Marketing
3713,2018,Marketing,2,Grammaire Lexicale Fonctionnelle,4,Diversite des Fonctions Grammaticales,14,381,6,QCU,0.2,0.8,69.44,21,9,30,28,21,7,1.07,75.0,Facile,Facile,0,Meme Difficulté,Adapte,Marketing
4824,2019,Marketing,2,Grammaire Lexicale Fonctionnelle,4,Diversite des Fonctions Grammaticales,14,381,6,QCU,0.06,0.82,69.44,19,9,28,28,19,9,1.0,67.86,Facile,Facile,0,Meme Difficulté,Adapte,Marketing
5935,2020,Marketing,2,Grammaire Lexicale Fonctionnelle,4,Diversite des Fonctions Grammaticales,14,381,6,QCU,0.03,0.82,69.44,21,9,30,22,21,1,1.36,95.45,Facile,Facile,0,Meme Difficulté,Adapte,Marketing
381,2015,Marketing,2,Grammaire Lexicale Fonctionnelle,4,Diversite des Fonctions Grammaticales,14,382,7,QCU,0.56,0.29,13.92,10,59,69,35,10,25,1.97,28.57,Difficile,Difficile,0,Meme Difficulté,Pas Adapte,Marketing
1492,2016,Marketing,2,Grammaire Lexicale Fonctionnelle,4,Diversite des Fonctions Grammaticales,14,382,7,QCU,0.21,0.47,37.23,29,49,78,43,29,14,1.81,67.44,Difficile,Moyen,1,Plus Facile,Pas Adapte,Marketing
2603,2017,Marketing,2,Grammaire Lexicale Fonctionnelle,4,Diversite des Fonctions Grammaticales,14,382,7,QCU,0.57,0.39,6.16,5,70,75,68,5,63,1.1,7.35,Facile,Difficile,-2,Beaucoup plus Difficile,Pas Adapte,Marketing
3714,2018,Marketing,2,Grammaire Lexicale Fonctionnelle,4,Diversite des Fonctions Grammaticales,14,382,7,QCU,0.24,0.67,57.43,40,30,70,65,40,25,1.08,61.54,Facile,Moyen,-1,Plus Difficile,Pas Adapte,Marketing
4825,2019,Marketing,2,Grammaire Lexicale Fonctionnelle,4,Diversite des Fonctions Grammaticales,14,382,7,QCU,0.67,0.24,9.48,7,69,76,71,7,64,1.07,9.86,Facile,Difficile,-2,Beaucoup plus Difficile,Pas Adapte,Marketing
5936,2020,Marketing,2,Grammaire Lexicale Fonctionnelle,4,Diversite des Fonctions Grammaticales,14,382,7,QCU,0.47,0.4,0.13,0,82,82,72,0,72,1.14,0.0,Difficile,Difficile,0,Meme Difficulté,Pas Adapte,Marketing
382,2015,Marketing,2,Grammaire Lexicale Fonctionnelle,4,Diversite des Fonctions Grammaticales,14,383,8,QCU,0.19,0.96,75.07,5,1,6,5,5,0,1.2,100.0,Difficile,Facile,2,Beaucoup plus Facile,Pas Adapte,Marketing
1493,2016,Marketing,2,Grammaire Lexicale Fonctionnelle,4,Diversite des Fonctions Grammaticales,14,383,8,QCU,0.33,0.49,48.37,2,3,5,3,2,1,1.67,66.67,Facile,Moyen,-1,Plus Difficile,Pas Adapte,Marketing
2604,2017,Marketing,2,Grammaire Lexicale Fonctionnelle,4,Diversite des Fonctions Grammaticales,14,383,8,QCU,0.23,0.41,62.74,3,2,5,5,3,2,1.0,60.0,Moyen,Moyen,0,Meme Difficulté,Adapte,Marketing
3715,2018,Marketing,2,Grammaire Lexicale Fonctionnelle,4,Diversite des Fonctions Grammaticales,14,383,8,QCU,0.21,0.66,62.74,3,1,4,3,3,0,1.33,100.0,Moyen,Moyen,0,Meme Difficulté,Adapte,Marketing
4826,2019,Marketing,2,Grammaire Lexicale Fonctionnelle,4,Diversite des Fonctions Grammaticales,14,383,8,QCU,0.25,0.48,62.74,3,1,4,3,3,0,1.33,100.0,Moyen,Moyen,0,Meme Difficulté,Adapte,Marketing
5937,2020,Marketing,2,Grammaire Lexicale Fonctionnelle,4,Diversite des Fonctions Grammaticales,14,383,8,QCU,0.34,0.74,62.74,2,1,3,2,2,0,1.5,100.0,Moyen,Moyen,0,Meme Difficulté,Adapte,Marketing
383,2015,Marketing,2,Grammaire Lexicale Fonctionnelle,4,Diversite des Fonctions Grammaticales,14,384,9,QCU,0.28,0.41,42.92,12,17,29,24,12,12,1.21,50.0,Difficile,Moyen,1,Plus Facile,Pas Adapte,Marketing
1494,2016,Marketing,2,Grammaire Lexicale Fonctionnelle,4,Diversite des Fonctions Grammaticales,14,384,9,QCM,0.73,0.27,7.65,2,29,31,18,2,16,1.72,11.11,Difficile,Difficile,0,Meme Difficulté,Pas Adapte,Marketing
2605,2017,Marketing,2,Grammaire Lexicale Fonctionnelle,4,Diversite des Fonctions Grammaticales,14,384,9,QCM,0.61,0.24,8.46,3,32,35,20,3,17,1.75,15.0,Moyen,Difficile,-1,Plus Difficile,Pas Adapte,Marketing
3716,2018,Marketing,2,Grammaire Lexicale Fonctionnelle,4,Diversite des Fonctions Grammaticales,14,384,9,QCM,0.06,0.75,81.33,24,6,30,30,24,6,1.0,80.0,Facile,Facile,0,Meme Difficulté,Pas Adapte,Marketing
4827,2019,Marketing,2,Grammaire Lexicale Fonctionnelle,4,Diversite des Fonctions Grammaticales,14,384,9,QCM,0.08,0.81,95.47,29,1,30,30,29,1,1.0,96.67,Difficile,Facile,2,Beaucoup plus Facile,Pas Adapte,Marketing
5938,2020,Marketing,2,Grammaire Lexicale Fonctionnelle,4,Diversite des Fonctions Grammaticales,14,384,9,QCM,0.02,0.73,97.89,31,1,32,31,31,0,1.03,100.0,Difficile,Facile,2,Beaucoup plus Facile,Pas Adapte,Marketing
384,2015,Marketing,2,Grammaire Lexicale Fonctionnelle,4,Diversite des Fonctions Grammaticales,14,385,10,QCU,0.08,0.86,70.15,8,3,11,10,8,2,1.1,80.0,Moyen,Facile,1,Plus Facile,Adapte,Marketing
1495,2016,Marketing,2,Grammaire Lexicale Fonctionnelle,4,Diversite des Fonctions Grammaticales,14,385,10,QCU,0.08,0.82,70.15,7,3,10,9,7,2,1.11,77.78,Facile,Facile,0,Meme Difficulté,Adapte,Marketing
2606,2017,Marketing,2,Grammaire Lexicale Fonctionnelle,4,Diversite des Fonctions Grammaticales,14,385,10,QCU,0.1,0.86,70.15,8,4,12,12,8,4,1.0,66.67,Facile,Facile,0,Meme Difficulté,Adapte,Marketing
3717,2018,Marketing,2,Grammaire Lexicale Fonctionnelle,4,Diversite des Fonctions Grammaticales,14,385,10,QCU,0.15,0.99,70.15,8,3,11,9,8,1,1.22,88.89,Facile,Facile,0,Meme Difficulté,Adapte,Marketing
4828,2019,Marketing,2,Grammaire Lexicale Fonctionnelle,4,Diversite des Fonctions Grammaticales,14,385,10,QCU,0.16,0.78,70.15,8,3,11,8,8,0,1.38,100.0,Facile,Facile,0,Meme Difficulté,Adapte,Marketing
5939,2020,Marketing,2,Grammaire Lexicale Fonctionnelle,4,Diversite des Fonctions Grammaticales,14,385,10,QCU,0.17,0.77,70.15,9,4,13,13,9,4,1.0,69.23,Facile,Facile,0,Meme Difficulté,Adapte,Marketing
385,2015,Marketing,2,Grammaire Lexicale Fonctionnelle,4,Diversite des Fonctions Grammaticales,14,386,11,QROC,0.52,0.31,59.28,5,3,8,6,5,1,1.33,83.33,Moyen,Moyen,0,Meme Difficulté,Pas Adapte,Marketing
1496,2016,Marketing,2,Grammaire Lexicale Fonctionnelle,4,Diversite des Fonctions Grammaticales,14,386,11,QROC,0.17,0.66,98.84,9,0,9,9,9,0,1.0,100.0,Facile,Facile,0,Meme Difficulté,Pas Adapte,Marketing
2607,2017,Marketing,2,Grammaire Lexicale Fonctionnelle,4,Diversite des Fonctions Grammaticales,14,386,11,QROC,0.72,0.03,0.02,0,8,8,4,0,4,2.0,0.0,Difficile,Difficile,0,Meme Difficulté,Pas Adapte,Marketing
3718,2018,Marketing,2,Grammaire Lexicale Fonctionnelle,4,Diversite des Fonctions Grammaticales,14,386,11,QROC,0.99,0.21,24.09,2,6,8,7,2,5,1.14,28.57,Moyen,Difficile,-1,Plus Difficile,Pas Adapte,Marketing
4829,2019,Marketing,2,Grammaire Lexicale Fonctionnelle,4,Diversite des Fonctions Grammaticales,14,386,11,QROC,0.12,0.69,99.85,7,0,7,7,7,0,1.0,100.0,Facile,Facile,0,Meme Difficulté,Pas Adapte,Marketing
5940,2020,Marketing,2,Grammaire Lexicale Fonctionnelle,4,Diversite des Fonctions Grammaticales,14,386,11,QROC,0.01,0.84,93.04,6,0,6,6,6,0,1.0,100.0,Difficile,Facile,2,Beaucoup plus Facile,Pas Adapte,Marketing
386,2015,Marketing,2,Grammaire Lexicale Fonctionnelle,4,Diversite des Fonctions Grammaticales,14,387,12,QROC,0.19,0.55,98.6,56,1,57,57,56,1,1.0,98.25,Difficile,Facile,2,Beaucoup plus Facile,Pas Adapte,Marketing
1497,2016,Marketing,2,Grammaire Lexicale Fonctionnelle,4,Diversite des Fonctions Grammaticales,14,387,12,QROC,0.17,0.67,95.68,55,2,57,57,55,2,1.0,96.49,Moyen,Facile,1,Plus Facile,Pas Adapte,Marketing
2608,2017,Marketing,2,Grammaire Lexicale Fonctionnelle,4,Diversite des Fonctions Grammaticales,14,387,12,QROC,0.64,0.07,23.34,12,40,52,36,12,24,1.44,33.33,Moyen,Difficile,-1,Plus Difficile,Pas Adapte,Marketing
3719,2018,Marketing,2,Grammaire Lexicale Fonctionnelle,4,Diversite des Fonctions Grammaticales,14,387,12,QROC,0.01,0.71,65.84,36,19,55,41,36,5,1.34,87.8,Difficile,Facile,2,Beaucoup plus Facile,Adapte,Marketing
4830,2019,Marketing,2,Grammaire Lexicale Fonctionnelle,4,Diversite des Fonctions Grammaticales,14,387,12,QROC,0.09,0.82,65.84,40,21,61,52,40,12,1.17,76.92,Facile,Facile,0,Meme Difficulté,Adapte,Marketing
5941,2020,Marketing,2,Grammaire Lexicale Fonctionnelle,4,Diversite des Fonctions Grammaticales,14,387,12,QROC,0.06,0.87,65.84,43,22,65,50,43,7,1.3,86.0,Facile,Facile,0,Meme Difficulté,Adapte,Marketing
387,2015,Marketing,2,Grammaire Lexicale Fonctionnelle,4,Diversite des Fonctions Grammaticales,14,388,13,QCM,0.63,0.18,14.72,14,83,97,34,14,20,2.85,41.18,Moyen,Difficile,-1,Plus Difficile,Pas Adapte,Marketing
1498,2016,Marketing,2,Grammaire Lexicale Fonctionnelle,4,Diversite des Fonctions Grammaticales,14,388,13,QCM,0.11,0.89,69.44,58,26,84,83,58,25,1.01,69.88,Difficile,Facile,2,Beaucoup plus Facile,Adapte,Marketing
2609,2017,Marketing,2,Grammaire Lexicale Fonctionnelle,4,Diversite des Fonctions Grammaticales,14,388,13,QCM,0.09,0.73,69.44,53,23,76,63,53,10,1.21,84.13,Facile,Facile,0,Meme Difficulté,Adapte,Marketing
3720,2018,Marketing,2,Grammaire Lexicale Fonctionnelle,4,Diversite des Fonctions Grammaticales,14,388,13,QCM,0.02,0.86,69.44,50,22,72,65,50,15,1.11,76.92,Facile,Facile,0,Meme Difficulté,Adapte,Marketing
4831,2019,Marketing,2,Grammaire Lexicale Fonctionnelle,4,Diversite des Fonctions Grammaticales,14,388,13,QCU,0.19,0.77,69.44,50,22,72,65,50,15,1.11,76.92,Facile,Facile,0,Meme Difficulté,Adapte,Marketing
5942,2020,Marketing,2,Grammaire Lexicale Fonctionnelle,4,Diversite des Fonctions Grammaticales,14,388,13,QCU,0.16,0.76,69.44,52,23,75,66,52,14,1.14,78.79,Facile,Facile,0,Meme Difficulté,Adapte,Marketing
388,2015,Marketing,2,Grammaire Lexicale Fonctionnelle,4,Diversite des Fonctions Grammaticales,14,389,14,QCM,0.45,0.66,48.31,22,24,46,34,22,12,1.35,64.71,Facile,Moyen,-1,Plus Difficile,Pas Adapte,Marketing
1499,2016,Marketing,2,Grammaire Lexicale Fonctionnelle,4,Diversite des Fonctions Grammaticales,14,389,14,QCM,0.01,0.89,79.12,33,9,42,38,33,5,1.11,86.84,Difficile,Facile,2,Beaucoup plus Facile,Pas Adapte,Marketing
2610,2017,Marketing,2,Grammaire Lexicale Fonctionnelle,4,Diversite des Fonctions Grammaticales,14,389,14,QCU,0.21,0.51,56.26,23,17,40,39,23,16,1.03,58.97,Moyen,Moyen,0,Meme Difficulté,Pas Adapte,Marketing
3721,2018,Marketing,2,Grammaire Lexicale Fonctionnelle,4,Diversite des Fonctions Grammaticales,14,389,14,QCU,0.1,0.99,84.97,31,5,36,34,31,3,1.06,91.18,Facile,Facile,0,Meme Difficulté,Pas Adapte,Marketing
4832,2019,Marketing,2,Grammaire Lexicale Fonctionnelle,4,Diversite des Fonctions Grammaticales,14,389,14,QCU,0.14,0.96,97.52,38,1,39,39,38,1,1.0,97.44,Difficile,Facile,2,Beaucoup plus Facile,Pas Adapte,Marketing
5943,2020,Marketing,2,Grammaire Lexicale Fonctionnelle,4,Diversite des Fonctions Grammaticales,14,389,14,QCU,0.13,0.91,78.48,34,9,43,43,34,9,1.0,79.07,Moyen,Facile,1,Plus Facile,Pas Adapte,Marketing
389,2015,Marketing,3,Grammaire et Syntaxe,1,Les Subordonnees,6,390,1,QCU,0.62,0.38,0.84,0,50,50,34,0,34,1.47,0.0,Difficile,Difficile,0,Meme Difficulté,Pas Adapte,Marketing
1500,2016,Marketing,3,Grammaire et Syntaxe,1,Les Subordonnees,6,390,1,QCM,0.17,0.9,79.01,39,10,49,42,39,3,1.17,92.86,Facile,Facile,0,Meme Difficulté,Pas Adapte,Marketing
2611,2017,Marketing,3,Grammaire et Syntaxe,1,Les Subordonnees,6,390,1,QO,0.7,0.23,56.19,24,19,43,29,24,5,1.48,82.76,Moyen,Moyen,0,Meme Difficulté,Pas Adapte,Marketing
3722,2018,Marketing,3,Grammaire et Syntaxe,1,Les Subordonnees,6,390,1,QO,0.08,0.34,74.08,32,11,43,32,32,0,1.34,100.0,Difficile,Facile,2,Beaucoup plus Facile,Adapte,Marketing
4833,2019,Marketing,3,Grammaire et Syntaxe,1,Les Subordonnees,6,390,1,QROC,0.19,0.56,74.08,33,12,45,39,33,6,1.15,84.62,Facile,Facile,0,Meme Difficulté,Adapte,Marketing
5944,2020,Marketing,3,Grammaire et Syntaxe,1,Les Subordonnees,6,390,1,QO,0.07,0.31,74.08,31,11,42,40,31,9,1.05,77.5,Facile,Facile,0,Meme Difficulté,Adapte,Marketing
390,2015,Marketing,3,Grammaire et Syntaxe,1,Les Subordonnees,6,391,2,QCM,0.61,0.16,8.46,5,50,55,55,5,50,1.0,9.09,Moyen,Difficile,-1,Plus Difficile,Pas Adapte,Marketing
1501,2016,Marketing,3,Grammaire et Syntaxe,1,Les Subordonnees,6,391,2,QCM,0.24,0.67,55.51,31,24,55,43,31,12,1.28,72.09,Moyen,Moyen,0,Meme Difficulté,Pas Adapte,Marketing
2612,2017,Marketing,3,Grammaire et Syntaxe,1,Les Subordonnees,6,391,2,QCM,0.02,0.79,97.4,48,1,49,49,48,1,1.0,97.96,Difficile,Facile,2,Beaucoup plus Facile,Pas Adapte,Marketing
3723,2018,Marketing,3,Grammaire et Syntaxe,1,Les Subordonnees,6,391,2,QCM,0.57,0.24,7.94,4,44,48,24,4,20,2.0,16.67,Facile,Difficile,-2,Beaucoup plus Difficile,Pas Adapte,Marketing
4834,2019,Marketing,3,Grammaire et Syntaxe,1,Les Subordonnees,6,391,2,QROC,0.75,0.14,21.82,12,42,54,22,12,10,2.45,54.55,Difficile,Difficile,0,Meme Difficulté,Pas Adapte,Marketing
5945,2020,Marketing,3,Grammaire et Syntaxe,1,Les Subordonnees,6,391,2,QROC,0.9,0.03,33.08,16,31,47,27,16,11,1.74,59.26,Moyen,Difficile,-1,Plus Difficile,Pas Adapte,Marketing
391,2015,Marketing,3,Grammaire et Syntaxe,1,Les Subordonnees,6,392,3,QCU,0.15,0.86,80.8,15,3,18,16,15,1,1.12,93.75,Difficile,Facile,2,Beaucoup plus Facile,Pas Adapte,Marketing
1502,2016,Marketing,3,Grammaire et Syntaxe,1,Les Subordonnees,6,392,3,QCU,0.29,0.73,44.3,9,12,21,14,9,5,1.5,64.29,Facile,Moyen,-1,Plus Difficile,Pas Adapte,Marketing
2613,2017,Marketing,3,Grammaire et Syntaxe,1,Les Subordonnees,6,392,3,QCU,0.62,0.34,19.43,3,15,18,14,3,11,1.29,21.43,Difficile,Difficile,0,Meme Difficulté,Pas Adapte,Marketing
3724,2018,Marketing,3,Grammaire et Syntaxe,1,Les Subordonnees,6,392,3,QCU,0.45,0.33,7.65,1,16,17,13,1,12,1.31,7.69,Difficile,Difficile,0,Meme Difficulté,Pas Adapte,Marketing
4835,2019,Marketing,3,Grammaire et Syntaxe,1,Les Subordonnees,6,392,3,QCU,0.21,0.62,41.01,7,9,16,8,7,1,2.0,87.5,Facile,Moyen,-1,Plus Difficile,Pas Adapte,Marketing
5946,2020,Marketing,3,Grammaire et Syntaxe,1,Les Subordonnees,6,392,3,QCU,0.37,0.47,44.38,6,8,14,13,6,7,1.08,46.15,Facile,Moyen,-1,Plus Difficile,Pas Adapte,Marketing
392,2015,Marketing,3,Grammaire et Syntaxe,1,Les Subordonnees,6,393,4,QCU,0.43,0.36,19.52,5,20,25,14,5,9,1.79,35.71,Moyen,Difficile,-1,Plus Difficile,Pas Adapte,Marketing
1503,2016,Marketing,3,Grammaire et Syntaxe,1,Les Subordonnees,6,393,4,QCU,0.27,0.56,55.79,14,11,25,25,14,11,1.0,56.0,Moyen,Moyen,0,Meme Difficulté,Pas Adapte,Marketing
2614,2017,Marketing,3,Grammaire et Syntaxe,1,Les Subordonnees,6,393,4,QCM,0.48,0.64,57.95,14,11,25,24,14,10,1.04,58.33,Facile,Moyen,-1,Plus Difficile,Pas Adapte,Marketing
3725,2018,Marketing,3,Grammaire et Syntaxe,1,Les Subordonnees,6,393,4,QCM,0.17,0.88,89.49,25,3,28,26,25,1,1.08,96.15,Facile,Facile,0,Meme Difficulté,Pas Adapte,Marketing
4836,2019,Marketing,3,Grammaire et Syntaxe,1,Les Subordonnees,6,393,4,QCM,0.08,0.75,99.45,28,0,28,28,28,0,1.0,100.0,Facile,Facile,0,Meme Difficulté,Pas Adapte,Marketing
5947,2020,Marketing,3,Grammaire et Syntaxe,1,Les Subordonnees,6,393,4,QCM,0.05,0.74,96.89,30,1,31,30,30,0,1.03,100.0,Facile,Facile,0,Meme Difficulté,Pas Adapte,Marketing
393,2015,Marketing,3,Grammaire et Syntaxe,1,Les Subordonnees,6,394,5,QCM,0.65,0.17,2.38,1,27,28,13,1,12,2.15,7.69,Facile,Difficile,-2,Beaucoup plus Difficile,Pas Adapte,Marketing
1504,2016,Marketing,3,Grammaire et Syntaxe,1,Les Subordonnees,6,394,5,QCM,0.36,0.52,43.66,13,17,30,13,13,0,2.31,100.0,Facile,Moyen,-1,Plus Difficile,Pas Adapte,Marketing
2615,2017,Marketing,3,Grammaire et Syntaxe,1,Les Subordonnees,6,394,5,QCM,0.44,0.54,40.68,12,18,30,25,12,13,1.2,48.0,Difficile,Moyen,1,Plus Facile,Pas Adapte,Marketing
3726,2018,Marketing,3,Grammaire et Syntaxe,1,Les Subordonnees,6,394,5,QCM,0.77,0.22,33.5,10,19,29,24,10,14,1.21,41.67,Difficile,Difficile,0,Meme Difficulté,Pas Adapte,Marketing
4837,2019,Marketing,3,Grammaire et Syntaxe,1,Les Subordonnees,6,394,5,QCM,0.75,0.24,1.67,1,31,32,31,1,30,1.03,3.23,Facile,Difficile,-2,Beaucoup plus Difficile,Pas Adapte,Marketing
5948,2020,Marketing,3,Grammaire et Syntaxe,1,Les Subordonnees,6,394,5,QCM,0.67,0.29,16.88,5,26,31,22,5,17,1.41,22.73,Moyen,Difficile,-1,Plus Difficile,Pas Adapte,Marketing
394,2015,Marketing,3,Grammaire et Syntaxe,1,Les Subordonnees,6,395,6,QCM,0.61,0.17,22.87,15,49,64,55,15,40,1.16,27.27,Facile,Difficile,-2,Beaucoup plus Difficile,Pas Adapte,Marketing
1505,2016,Marketing,3,Grammaire et Syntaxe,1,Les Subordonnees,6,395,6,QCM,0.04,0.79,84.45,54,10,64,58,54,4,1.1,93.1,Difficile,Facile,2,Beaucoup plus Facile,Pas Adapte,Marketing
2616,2017,Marketing,3,Grammaire et Syntaxe,1,Les Subordonnees,6,395,6,QCM,0.42,0.68,54.43,33,27,60,46,33,13,1.3,71.74,Moyen,Moyen,0,Meme Difficulté,Pas Adapte,Marketing
3727,2018,Marketing,3,Grammaire et Syntaxe,1,Les Subordonnees,6,395,6,QCM,0.12,0.75,99.03,58,1,59,58,58,0,1.02,100.0,Difficile,Facile,2,Beaucoup plus Facile,Pas Adapte,Marketing
4838,2019,Marketing,3,Grammaire et Syntaxe,1,Les Subordonnees,6,395,6,QCM,0.24,0.62,49.4,26,27,53,26,26,0,2.04,100.0,Facile,Moyen,-1,Plus Difficile,Pas Adapte,Marketing
5949,2020,Marketing,3,Grammaire et Syntaxe,1,Les Subordonnees,6,395,6,QCM,0.02,0.85,68.61,34,15,49,35,34,1,1.4,97.14,Moyen,Facile,1,Plus Facile,Adapte,Marketing
395,2015,Marketing,3,Grammaire et Syntaxe,2,La Coordination,10,396,1,QO,0.42,0.3,37.52,20,33,53,35,20,15,1.51,57.14,Facile,Moyen,-1,Plus Difficile,Pas Adapte,Marketing
1506,2016,Marketing,3,Grammaire et Syntaxe,2,La Coordination,10,396,1,QO,0.34,0.26,62.43,32,20,52,48,32,16,1.08,66.67,Facile,Moyen,-1,Plus Difficile,Adapte,Marketing
2617,2017,Marketing,3,Grammaire et Syntaxe,2,La Coordination,10,396,1,QO,0.53,0.2,62.43,34,20,54,48,34,14,1.12,70.83,Moyen,Moyen,0,Meme Difficulté,Adapte,Marketing
3728,2018,Marketing,3,Grammaire et Syntaxe,2,La Coordination,10,396,1,QO,0.4,0.19,62.43,38,23,61,58,38,20,1.05,65.52,Moyen,Moyen,0,Meme Difficulté,Adapte,Marketing
4839,2019,Marketing,3,Grammaire et Syntaxe,2,La Coordination,10,396,1,QO,0.56,0.27,62.43,36,22,58,53,36,17,1.09,67.92,Moyen,Moyen,0,Meme Difficulté,Adapte,Marketing
5950,2020,Marketing,3,Grammaire et Syntaxe,2,La Coordination,10,396,1,QO,0.21,0.23,62.43,32,19,51,50,32,18,1.02,64.0,Moyen,Moyen,0,Meme Difficulté,Adapte,Marketing
396,2015,Marketing,3,Grammaire et Syntaxe,2,La Coordination,10,397,2,QCM,0.57,0.25,16.52,2,12,14,4,2,2,3.5,50.0,Moyen,Difficile,-1,Plus Difficile,Pas Adapte,Marketing
1507,2016,Marketing,3,Grammaire et Syntaxe,2,La Coordination,10,397,2,QCM,0.25,0.43,60.58,9,6,15,11,9,2,1.36,81.82,Facile,Moyen,-1,Plus Difficile,Adapte,Marketing
2618,2017,Marketing,3,Grammaire et Syntaxe,2,La Coordination,10,397,2,QCU,0.38,0.53,60.58,10,6,16,16,10,6,1.0,62.5,Moyen,Moyen,0,Meme Difficulté,Adapte,Marketing
3729,2018,Marketing,3,Grammaire et Syntaxe,2,La Coordination,10,397,2,QCU,0.29,0.43,60.58,8,6,14,11,8,3,1.27,72.73,Moyen,Moyen,0,Meme Difficulté,Adapte,Marketing
4840,2019,Marketing,3,Grammaire et Syntaxe,2,La Coordination,10,397,2,QCU,0.32,0.42,60.58,9,6,15,10,9,1,1.5,90.0,Moyen,Moyen,0,Meme Difficulté,Adapte,Marketing
5951,2020,Marketing,3,Grammaire et Syntaxe,2,La Coordination,10,397,2,QCU,0.31,0.65,60.58,8,6,14,12,8,4,1.17,66.67,Moyen,Moyen,0,Meme Difficulté,Adapte,Marketing
397,2015,Marketing,3,Grammaire et Syntaxe,2,La Coordination,10,398,3,QO,0.86,0.11,26.9,10,26,36,28,10,18,1.29,35.71,Facile,Difficile,-2,Beaucoup plus Difficile,Pas Adapte,Marketing
1508,2016,Marketing,3,Grammaire et Syntaxe,2,La Coordination,10,398,3,QO,0.77,0.0,21.79,7,24,31,16,7,9,1.94,43.75,Facile,Difficile,-2,Beaucoup plus Difficile,Pas Adapte,Marketing
2619,2017,Marketing,3,Grammaire et Syntaxe,2,La Coordination,10,398,3,QO,0.14,0.45,65.35,21,11,32,27,21,6,1.19,77.78,Facile,Facile,0,Meme Difficulté,Adapte,Marketing
3730,2018,Marketing,3,Grammaire et Syntaxe,2,La Coordination,10,398,3,QO,0.06,0.89,65.35,21,11,32,30,21,9,1.07,70.0,Facile,Facile,0,Meme Difficulté,Adapte,Marketing
4841,2019,Marketing,3,Grammaire et Syntaxe,2,La Coordination,10,398,3,QROC,0.11,0.43,65.35,18,10,28,22,18,4,1.27,81.82,Facile,Facile,0,Meme Difficulté,Adapte,Marketing
5952,2020,Marketing,3,Grammaire et Syntaxe,2,La Coordination,10,398,3,QROC,0.06,0.83,65.35,20,10,30,26,20,6,1.15,76.92,Facile,Facile,0,Meme Difficulté,Adapte,Marketing
398,2015,Marketing,3,Grammaire et Syntaxe,2,La Coordination,10,399,4,QCU,0.01,0.95,68.89,21,10,31,26,21,5,1.19,80.77,Moyen,Facile,1,Plus Facile,Adapte,Marketing
1509,2016,Marketing,3,Grammaire et Syntaxe,2,La Coordination,10,399,4,QCU,0.06,0.97,68.89,25,11,36,36,25,11,1.0,69.44,Facile,Facile,0,Meme Difficulté,Adapte,Marketing
2620,2017,Marketing,3,Grammaire et Syntaxe,2,La Coordination,10,399,4,QCU,0.18,0.95,68.89,24,11,35,32,24,8,1.09,75.0,Facile,Facile,0,Meme Difficulté,Adapte,Marketing
3731,2018,Marketing,3,Grammaire et Syntaxe,2,La Coordination,10,399,4,QCU,0.04,0.78,68.89,27,12,39,33,27,6,1.18,81.82,Facile,Facile,0,Meme Difficulté,Adapte,Marketing
4842,2019,Marketing,3,Grammaire et Syntaxe,2,La Coordination,10,399,4,QCU,0.16,0.88,68.89,30,14,44,37,30,7,1.19,81.08,Facile,Facile,0,Meme Difficulté,Adapte,Marketing
5953,2020,Marketing,3,Grammaire et Syntaxe,2,La Coordination,10,399,4,QCU,0.18,0.94,68.89,30,13,43,34,30,4,1.26,88.24,Facile,Facile,0,Meme Difficulté,Adapte,Marketing
399,2015,Marketing,3,Grammaire et Syntaxe,2,La Coordination,10,400,5,QCU,0.29,0.43,50.75,20,20,40,38,20,18,1.05,52.63,Moyen,Moyen,0,Meme Difficulté,Pas Adapte,Marketing
1510,2016,Marketing,3,Grammaire et Syntaxe,2,La Coordination,10,400,5,QCU,0.21,0.43,36.99,13,21,34,21,13,8,1.62,61.9,Facile,Moyen,-1,Plus Difficile,Pas Adapte,Marketing
2621,2017,Marketing,3,Grammaire et Syntaxe,2,La Coordination,10,400,5,QCM,0.18,0.96,73.08,23,8,31,24,23,1,1.29,95.83,Difficile,Facile,2,Beaucoup plus Facile,Adapte,Marketing
3732,2018,Marketing,3,Grammaire et Syntaxe,2,La Coordination,10,400,5,QCM,0.17,0.9,73.08,22,8,30,27,22,5,1.11,81.48,Facile,Facile,0,Meme Difficulté,Adapte,Marketing
4843,2019,Marketing,3,Grammaire et Syntaxe,2,La Coordination,10,400,5,QCU,0.2,0.94,73.08,23,9,32,25,23,2,1.28,92.0,Facile,Facile,0,Meme Difficulté,Adapte,Marketing
5954,2020,Marketing,3,Grammaire et Syntaxe,2,La Coordination,10,400,5,QCM,0.14,0.71,73.08,22,8,30,28,22,6,1.07,78.57,Facile,Facile,0,Meme Difficulté,Adapte,Marketing
400,2015,Marketing,3,Grammaire et Syntaxe,2,La Coordination,10,401,6,QO,0.78,0.13,16.51,12,59,71,59,12,47,1.2,20.34,Difficile,Difficile,0,Meme Difficulté,Pas Adapte,Marketing
1511,2016,Marketing,3,Grammaire et Syntaxe,2,La Coordination,10,401,6,QO,0.23,0.18,49.72,41,41,82,77,41,36,1.06,53.25,Moyen,Moyen,0,Meme Difficulté,Pas Adapte,Marketing
2622,2017,Marketing,3,Grammaire et Syntaxe,2,La Coordination,10,401,6,QO,0.83,0.13,10.12,7,66,73,41,7,34,1.78,17.07,Facile,Difficile,-2,Beaucoup plus Difficile,Pas Adapte,Marketing
3733,2018,Marketing,3,Grammaire et Syntaxe,2,La Coordination,10,401,6,QROC,0.02,0.44,88.57,69,9,78,74,69,5,1.05,93.24,Facile,Facile,0,Meme Difficulté,Pas Adapte,Marketing
4844,2019,Marketing,3,Grammaire et Syntaxe,2,La Coordination,10,401,6,QROC,0.48,0.31,46.89,38,43,81,61,38,23,1.33,62.3,Difficile,Moyen,1,Plus Facile,Pas Adapte,Marketing
5955,2020,Marketing,3,Grammaire et Syntaxe,2,La Coordination,10,401,6,QROC,0.4,0.28,43.13,38,50,88,68,38,30,1.29,55.88,Facile,Moyen,-1,Plus Difficile,Pas Adapte,Marketing
401,2015,Marketing,3,Grammaire et Syntaxe,2,La Coordination,10,402,7,QCU,0.14,0.79,83.59,59,12,71,63,59,4,1.13,93.65,Facile,Facile,0,Meme Difficulté,Pas Adapte,Marketing
1512,2016,Marketing,3,Grammaire et Syntaxe,2,La Coordination,10,402,7,QCU,0.38,0.61,35.01,25,47,72,52,25,27,1.38,48.08,Facile,Moyen,-1,Plus Difficile,Pas Adapte,Marketing
2623,2017,Marketing,3,Grammaire et Syntaxe,2,La Coordination,10,402,7,QCU,0.31,0.4,47.31,30,34,64,63,30,33,1.02,47.62,Facile,Moyen,-1,Plus Difficile,Pas Adapte,Marketing
3734,2018,Marketing,3,Grammaire et Syntaxe,2,La Coordination,10,402,7,QCU,0.62,0.35,29.99,17,40,57,45,17,28,1.27,37.78,Facile,Difficile,-2,Beaucoup plus Difficile,Pas Adapte,Marketing
4845,2019,Marketing,3,Grammaire et Syntaxe,2,La Coordination,10,402,7,QCU,0.32,0.42,43.23,29,37,66,37,29,8,1.78,78.38,Moyen,Moyen,0,Meme Difficulté,Pas Adapte,Marketing
5956,2020,Marketing,3,Grammaire et Syntaxe,2,La Coordination,10,402,7,QCU,0.15,0.75,86.14,65,10,75,70,65,5,1.07,92.86,Moyen,Facile,1,Plus Facile,Pas Adapte,Marketing
402,2015,Marketing,3,Grammaire et Syntaxe,2,La Coordination,10,403,8,QCM,0.2,0.95,91.55,42,4,46,45,42,3,1.02,93.33,Moyen,Facile,1,Plus Facile,Pas Adapte,Marketing
1513,2016,Marketing,3,Grammaire et Syntaxe,2,La Coordination,10,403,8,QCU,0.18,0.77,99.2,49,0,49,49,49,0,1.0,100.0,Moyen,Facile,1,Plus Facile,Pas Adapte,Marketing
2624,2017,Marketing,3,Grammaire et Syntaxe,2,La Coordination,10,403,8,QCU,0.54,0.38,15.54,7,40,47,36,7,29,1.31,19.44,Facile,Difficile,-2,Beaucoup plus Difficile,Pas Adapte,Marketing
3735,2018,Marketing,3,Grammaire et Syntaxe,2,La Coordination,10,403,8,QCU,0.23,0.52,62.73,29,18,47,46,29,17,1.02,63.04,Moyen,Moyen,0,Meme Difficulté,Adapte,Marketing
4846,2019,Marketing,3,Grammaire et Syntaxe,2,La Coordination,10,403,8,QCU,0.28,0.46,62.73,33,20,53,40,33,7,1.32,82.5,Moyen,Moyen,0,Meme Difficulté,Adapte,Marketing
5957,2020,Marketing,3,Grammaire et Syntaxe,2,La Coordination,10,403,8,QCU,0.21,0.58,62.73,31,18,49,39,31,8,1.26,79.49,Moyen,Moyen,0,Meme Difficulté,Adapte,Marketing
403,2015,Marketing,3,Grammaire et Syntaxe,2,La Coordination,10,404,9,QCU,0.28,0.62,45.88,45,54,99,99,45,54,1.0,45.45,Facile,Moyen,-1,Plus Difficile,Pas Adapte,Marketing
1514,2016,Marketing,3,Grammaire et Syntaxe,2,La Coordination,10,404,9,QCU,0.16,0.95,88.53,80,10,90,87,80,7,1.03,91.95,Difficile,Facile,2,Beaucoup plus Facile,Pas Adapte,Marketing
2625,2017,Marketing,3,Grammaire et Syntaxe,2,La Coordination,10,404,9,QCU,0.4,0.21,6.78,5,76,81,73,5,68,1.11,6.85,Moyen,Difficile,-1,Plus Difficile,Pas Adapte,Marketing
3736,2018,Marketing,3,Grammaire et Syntaxe,2,La Coordination,10,404,9,QCU,0.14,0.9,77.16,68,20,88,84,68,16,1.05,80.95,Facile,Facile,0,Meme Difficulté,Pas Adapte,Marketing
4847,2019,Marketing,3,Grammaire et Syntaxe,2,La Coordination,10,404,9,QCM,0.7,0.17,29.12,26,64,90,71,26,45,1.27,36.62,Difficile,Difficile,0,Meme Difficulté,Pas Adapte,Marketing
5958,2020,Marketing,3,Grammaire et Syntaxe,2,La Coordination,10,404,9,QCM,0.63,0.22,25.85,24,69,93,25,24,1,3.72,96.0,Facile,Difficile,-2,Beaucoup plus Difficile,Pas Adapte,Marketing
404,2015,Marketing,3,Grammaire et Syntaxe,2,La Coordination,10,405,10,QCU,0.47,0.3,3.34,1,26,27,11,1,10,2.45,9.09,Moyen,Difficile,-1,Plus Difficile,Pas Adapte,Marketing
1515,2016,Marketing,3,Grammaire et Syntaxe,2,La Coordination,10,405,10,QCU,0.49,0.29,29.64,8,20,28,21,8,13,1.33,38.1,Difficile,Difficile,0,Meme Difficulté,Pas Adapte,Marketing
2626,2017,Marketing,3,Grammaire et Syntaxe,2,La Coordination,10,405,10,QCU,0.67,0.25,16.16,5,24,29,21,5,16,1.38,23.81,Facile,Difficile,-2,Beaucoup plus Difficile,Pas Adapte,Marketing
3737,2018,Marketing,3,Grammaire et Syntaxe,2,La Coordination,10,405,10,QCU,0.54,0.36,12.53,4,29,33,20,4,16,1.65,20.0,Facile,Difficile,-2,Beaucoup plus Difficile,Pas Adapte,Marketing
4848,2019,Marketing,3,Grammaire et Syntaxe,2,La Coordination,10,405,10,QCU,0.17,0.83,80.88,24,6,30,28,24,4,1.07,85.71,Facile,Facile,0,Meme Difficulté,Pas Adapte,Marketing
5959,2020,Marketing,3,Grammaire et Syntaxe,2,La Coordination,10,405,10,QCU,0.18,0.95,98.66,29,0,29,29,29,0,1.0,100.0,Moyen,Facile,1,Plus Facile,Pas Adapte,Marketing
405,2015,Marketing,3,Grammaire et Syntaxe,3,Le Statut des Pronoms,1,406,1,QCM,0.01,0.74,97.24,78,2,80,80,78,2,1.0,97.5,Facile,Facile,0,Meme Difficulté,Pas Adapte,Marketing
1516,2016,Marketing,3,Grammaire et Syntaxe,3,Le Statut des Pronoms,1,406,1,QCM,0.79,0.28,33.53,24,47,71,70,24,46,1.01,34.29,Difficile,Difficile,0,Meme Difficulté,Pas Adapte,Marketing
2627,2017,Marketing,3,Grammaire et Syntaxe,3,Le Statut des Pronoms,1,406,1,QCM,0.27,0.59,43.42,35,46,81,58,35,23,1.4,60.34,Difficile,Moyen,1,Plus Facile,Pas Adapte,Marketing
3738,2018,Marketing,3,Grammaire et Syntaxe,3,Le Statut des Pronoms,1,406,1,QCM,0.14,0.87,91.84,84,7,91,85,84,1,1.07,98.82,Moyen,Facile,1,Plus Facile,Pas Adapte,Marketing
4849,2019,Marketing,3,Grammaire et Syntaxe,3,Le Statut des Pronoms,1,406,1,QCM,0.31,0.43,42.61,45,60,105,73,45,28,1.44,61.64,Moyen,Moyen,0,Meme Difficulté,Pas Adapte,Marketing
5960,2020,Marketing,3,Grammaire et Syntaxe,3,Le Statut des Pronoms,1,406,1,QCM,0.74,0.22,14.84,17,97,114,77,17,60,1.48,22.08,Moyen,Difficile,-1,Plus Difficile,Pas Adapte,Marketing
406,2015,Marketing,4,Neologie,1,Les Innovations Lexicales,13,407,1,QCM,0.34,0.47,57.32,18,14,32,29,18,11,1.1,62.07,Moyen,Moyen,0,Meme Difficulté,Pas Adapte,Marketing
1517,2016,Marketing,4,Neologie,1,Les Innovations Lexicales,13,407,1,QCM,0.18,1.0,99.73,30,0,30,30,30,0,1.0,100.0,Moyen,Facile,1,Plus Facile,Pas Adapte,Marketing
2628,2017,Marketing,4,Neologie,1,Les Innovations Lexicales,13,407,1,QCM,0.75,0.26,14.11,4,24,28,13,4,9,2.15,30.77,Moyen,Difficile,-1,Plus Difficile,Pas Adapte,Marketing
3739,2018,Marketing,4,Neologie,1,Les Innovations Lexicales,13,407,1,QCM,0.69,0.18,27.15,9,23,32,32,9,23,1.0,28.12,Facile,Difficile,-2,Beaucoup plus Difficile,Pas Adapte,Marketing
4850,2019,Marketing,4,Neologie,1,Les Innovations Lexicales,13,407,1,QCM,0.03,0.96,97.14,28,1,29,28,28,0,1.04,100.0,Facile,Facile,0,Meme Difficulté,Pas Adapte,Marketing
5961,2020,Marketing,4,Neologie,1,Les Innovations Lexicales,13,407,1,QCM,0.18,0.83,71.89,23,9,32,26,23,3,1.23,88.46,Difficile,Facile,2,Beaucoup plus Facile,Adapte,Marketing
407,2015,Marketing,4,Neologie,1,Les Innovations Lexicales,13,408,2,QO,0.99,0.09,0.91,0,19,19,12,0,12,1.58,0.0,Difficile,Difficile,0,Meme Difficulté,Pas Adapte,Marketing
1518,2016,Marketing,4,Neologie,1,Les Innovations Lexicales,13,408,2,QO,0.11,0.46,97.74,21,0,21,21,21,0,1.0,100.0,Facile,Facile,0,Meme Difficulté,Pas Adapte,Marketing
2629,2017,Marketing,4,Neologie,1,Les Innovations Lexicales,13,408,2,QO,0.04,0.96,76.64,17,5,22,20,17,3,1.1,85.0,Moyen,Facile,1,Plus Facile,Pas Adapte,Marketing
3740,2018,Marketing,4,Neologie,1,Les Innovations Lexicales,13,408,2,QO,0.19,0.74,98.05,23,0,23,23,23,0,1.0,100.0,Facile,Facile,0,Meme Difficulté,Pas Adapte,Marketing
4851,2019,Marketing,4,Neologie,1,Les Innovations Lexicales,13,408,2,QO,0.06,0.66,71.45,18,7,25,21,18,3,1.19,85.71,Moyen,Facile,1,Plus Facile,Adapte,Marketing
5962,2020,Marketing,4,Neologie,1,Les Innovations Lexicales,13,408,2,QO,0.01,0.36,71.45,16,7,23,23,16,7,1.0,69.57,Facile,Facile,0,Meme Difficulté,Adapte,Marketing
408,2015,Marketing,4,Neologie,1,Les Innovations Lexicales,13,409,3,QCU,0.73,0.21,2.64,1,19,20,10,1,9,2.0,10.0,Facile,Difficile,-2,Beaucoup plus Difficile,Pas Adapte,Marketing
1519,2016,Marketing,4,Neologie,1,Les Innovations Lexicales,13,409,3,QCU,0.08,0.94,82.88,17,3,20,17,17,0,1.18,100.0,Difficile,Facile,2,Beaucoup plus Facile,Pas Adapte,Marketing
2630,2017,Marketing,4,Neologie,1,Les Innovations Lexicales,13,409,3,QCU,0.59,0.3,11.3,2,20,22,9,2,7,2.44,22.22,Moyen,Difficile,-1,Plus Difficile,Pas Adapte,Marketing
3741,2018,Marketing,4,Neologie,1,Les Innovations Lexicales,13,409,3,QCU,0.63,0.39,4.73,1,19,20,10,1,9,2.0,10.0,Difficile,Difficile,0,Meme Difficulté,Pas Adapte,Marketing
4852,2019,Marketing,4,Neologie,1,Les Innovations Lexicales,13,409,3,QCU,0.08,0.76,74.56,17,6,23,20,17,3,1.15,85.0,Difficile,Facile,2,Beaucoup plus Facile,Adapte,Marketing
5963,2020,Marketing,4,Neologie,1,Les Innovations Lexicales,13,409,3,QCU,0.1,0.94,74.56,16,5,21,21,16,5,1.0,76.19,Facile,Facile,0,Meme Difficulté,Adapte,Marketing
409,2015,Marketing,4,Neologie,1,Les Innovations Lexicales,13,410,4,QCU,0.23,0.54,47.6,26,28,54,32,26,6,1.69,81.25,Facile,Moyen,-1,Plus Difficile,Pas Adapte,Marketing
1520,2016,Marketing,4,Neologie,1,Les Innovations Lexicales,13,410,4,QCU,0.31,0.62,37.83,19,30,49,41,19,22,1.2,46.34,Difficile,Moyen,1,Plus Facile,Pas Adapte,Marketing
2631,2017,Marketing,4,Neologie,1,Les Innovations Lexicales,13,410,4,QCU,0.43,0.34,21.15,12,44,56,22,12,10,2.55,54.55,Difficile,Difficile,0,Meme Difficulté,Pas Adapte,Marketing
3742,2018,Marketing,4,Neologie,1,Les Innovations Lexicales,13,410,4,QCU,0.59,0.36,33.73,19,38,57,19,19,0,3.0,100.0,Facile,Difficile,-2,Beaucoup plus Difficile,Pas Adapte,Marketing
4853,2019,Marketing,4,Neologie,1,Les Innovations Lexicales,13,410,4,QCU,0.36,0.57,39.53,22,33,55,25,22,3,2.2,88.0,Facile,Moyen,-1,Plus Difficile,Pas Adapte,Marketing
5964,2020,Marketing,4,Neologie,1,Les Innovations Lexicales,13,410,4,QCU,0.32,0.72,48.64,25,27,52,26,25,1,2.0,96.15,Difficile,Moyen,1,Plus Facile,Pas Adapte,Marketing
410,2015,Marketing,4,Neologie,1,Les Innovations Lexicales,13,411,5,QCU,0.63,0.39,25.85,5,14,19,8,5,3,2.38,62.5,Moyen,Difficile,-1,Plus Difficile,Pas Adapte,Marketing
1521,2016,Marketing,4,Neologie,1,Les Innovations Lexicales,13,411,5,QCU,0.12,0.82,71.28,11,5,16,16,11,5,1.0,68.75,Moyen,Facile,1,Plus Facile,Adapte,Marketing
2632,2017,Marketing,4,Neologie,1,Les Innovations Lexicales,13,411,5,QCU,0.18,0.78,71.28,11,5,16,13,11,2,1.23,84.62,Facile,Facile,0,Meme Difficulté,Adapte,Marketing
3743,2018,Marketing,4,Neologie,1,Les Innovations Lexicales,13,411,5,QCU,0.16,0.89,71.28,12,5,17,14,12,2,1.21,85.71,Facile,Facile,0,Meme Difficulté,Adapte,Marketing
4854,2019,Marketing,4,Neologie,1,Les Innovations Lexicales,13,411,5,QCM,0.14,0.9,71.28,11,5,16,12,11,1,1.33,91.67,Facile,Facile,0,Meme Difficulté,Adapte,Marketing
5965,2020,Marketing,4,Neologie,1,Les Innovations Lexicales,13,411,5,QCM,0.19,0.84,71.28,13,5,18,15,13,2,1.2,86.67,Facile,Facile,0,Meme Difficulté,Adapte,Marketing
411,2015,Marketing,4,Neologie,1,Les Innovations Lexicales,13,412,6,QCU,0.51,0.31,9.28,4,42,46,43,4,39,1.07,9.3,Difficile,Difficile,0,Meme Difficulté,Pas Adapte,Marketing
1522,2016,Marketing,4,Neologie,1,Les Innovations Lexicales,13,412,6,QCU,0.67,0.24,30.58,13,28,41,19,13,6,2.16,68.42,Moyen,Difficile,-1,Plus Difficile,Pas Adapte,Marketing
2633,2017,Marketing,4,Neologie,1,Les Innovations Lexicales,13,412,6,QCU,0.62,0.32,9.49,4,38,42,14,4,10,3.0,28.57,Difficile,Difficile,0,Meme Difficulté,Pas Adapte,Marketing
3744,2018,Marketing,4,Neologie,1,Les Innovations Lexicales,13,412,6,QCU,0.03,0.98,93.99,43,3,46,45,43,2,1.02,95.56,Facile,Facile,0,Meme Difficulté,Pas Adapte,Marketing
4855,2019,Marketing,4,Neologie,1,Les Innovations Lexicales,13,412,6,QCM,0.15,0.78,68.83,30,14,44,37,30,7,1.19,81.08,Difficile,Facile,2,Beaucoup plus Facile,Adapte,Marketing
5966,2020,Marketing,4,Neologie,1,Les Innovations Lexicales,13,412,6,QCM,0.16,0.72,68.83,32,15,47,45,32,13,1.04,71.11,Facile,Facile,0,Meme Difficulté,Adapte,Marketing
412,2015,Marketing,4,Neologie,1,Les Innovations Lexicales,13,413,7,QO,0.03,0.5,69.41,38,17,55,44,38,6,1.25,86.36,Moyen,Facile,1,Plus Facile,Adapte,Marketing
1523,2016,Marketing,4,Neologie,1,Les Innovations Lexicales,13,413,7,QO,0.09,0.92,69.41,34,15,49,42,34,8,1.17,80.95,Facile,Facile,0,Meme Difficulté,Adapte,Marketing
2634,2017,Marketing,4,Neologie,1,Les Innovations Lexicales,13,413,7,QO,0.18,0.61,69.41,36,16,52,41,36,5,1.27,87.8,Facile,Facile,0,Meme Difficulté,Adapte,Marketing
3745,2018,Marketing,4,Neologie,1,Les Innovations Lexicales,13,413,7,QO,0.0,0.44,69.41,40,17,57,40,40,0,1.43,100.0,Facile,Facile,0,Meme Difficulté,Adapte,Marketing
4856,2019,Marketing,4,Neologie,1,Les Innovations Lexicales,13,413,7,QROC,0.04,0.72,69.41,38,17,55,44,38,6,1.25,86.36,Facile,Facile,0,Meme Difficulté,Adapte,Marketing
5967,2020,Marketing,4,Neologie,1,Les Innovations Lexicales,13,413,7,QROC,0.14,0.86,69.41,35,15,50,46,35,11,1.09,76.09,Facile,Facile,0,Meme Difficulté,Adapte,Marketing
413,2015,Marketing,4,Neologie,1,Les Innovations Lexicales,13,414,8,QCU,0.08,0.8,67.67,28,13,41,40,28,12,1.02,70.0,Difficile,Facile,2,Beaucoup plus Facile,Adapte,Marketing
1524,2016,Marketing,4,Neologie,1,Les Innovations Lexicales,13,414,8,QCU,0.17,0.99,67.67,26,12,38,32,26,6,1.19,81.25,Facile,Facile,0,Meme Difficulté,Adapte,Marketing
2635,2017,Marketing,4,Neologie,1,Les Innovations Lexicales,13,414,8,QCU,0.11,0.77,67.67,24,11,35,31,24,7,1.13,77.42,Facile,Facile,0,Meme Difficulté,Adapte,Marketing
3746,2018,Marketing,4,Neologie,1,Les Innovations Lexicales,13,414,8,QCU,0.08,0.92,67.67,20,10,30,30,20,10,1.0,66.67,Facile,Facile,0,Meme Difficulté,Adapte,Marketing
4857,2019,Marketing,4,Neologie,1,Les Innovations Lexicales,13,414,8,QCU,0.06,0.83,67.67,22,11,33,30,22,8,1.1,73.33,Facile,Facile,0,Meme Difficulté,Adapte,Marketing
5968,2020,Marketing,4,Neologie,1,Les Innovations Lexicales,13,414,8,QCU,0.07,0.98,67.67,24,11,35,34,24,10,1.03,70.59,Facile,Facile,0,Meme Difficulté,Adapte,Marketing
414,2015,Marketing,4,Neologie,1,Les Innovations Lexicales,13,415,9,QCU,0.42,0.31,32.15,21,44,65,42,21,21,1.55,50.0,Facile,Difficile,-2,Beaucoup plus Difficile,Pas Adapte,Marketing
1525,2016,Marketing,4,Neologie,1,Les Innovations Lexicales,13,415,9,QCU,0.22,0.56,39.4,22,33,55,48,22,26,1.15,45.83,Facile,Moyen,-1,Plus Difficile,Pas Adapte,Marketing
2636,2017,Marketing,4,Neologie,1,Les Innovations Lexicales,13,415,9,QROC,0.9,0.08,16.32,8,43,51,38,8,30,1.34,21.05,Facile,Difficile,-2,Beaucoup plus Difficile,Pas Adapte,Marketing
3747,2018,Marketing,4,Neologie,1,Les Innovations Lexicales,13,415,9,QROC,0.84,0.22,34.25,18,34,52,35,18,17,1.49,51.43,Facile,Difficile,-2,Beaucoup plus Difficile,Pas Adapte,Marketing
4858,2019,Marketing,4,Neologie,1,Les Innovations Lexicales,13,415,9,QROC,0.06,0.71,86.13,49,8,57,56,49,7,1.02,87.5,Difficile,Facile,2,Beaucoup plus Facile,Pas Adapte,Marketing
5969,2020,Marketing,4,Neologie,1,Les Innovations Lexicales,13,415,9,QROC,0.48,0.35,60.19,34,22,56,51,34,17,1.1,66.67,Facile,Moyen,-1,Plus Difficile,Adapte,Marketing
415,2015,Marketing,4,Neologie,1,Les Innovations Lexicales,13,416,10,QCM,0.56,0.24,21.41,1,4,5,3,1,2,1.67,33.33,Moyen,Difficile,-1,Plus Difficile,Pas Adapte,Marketing
1526,2016,Marketing,4,Neologie,1,Les Innovations Lexicales,13,416,10,QCM,0.57,0.17,15.81,1,5,6,3,1,2,2.0,33.33,Facile,Difficile,-2,Beaucoup plus Difficile,Pas Adapte,Marketing
2637,2017,Marketing,4,Neologie,1,Les Innovations Lexicales,13,416,10,QCM,0.12,0.83,91.74,5,0,5,5,5,0,1.0,100.0,Facile,Facile,0,Meme Difficulté,Pas Adapte,Marketing
3748,2018,Marketing,4,Neologie,1,Les Innovations Lexicales,13,416,10,QCM,0.58,0.24,18.25,1,3,4,1,1,0,4.0,100.0,Moyen,Difficile,-1,Plus Difficile,Pas Adapte,Marketing
4859,2019,Marketing,4,Neologie,1,Les Innovations Lexicales,13,416,10,QCM,0.18,0.98,91.1,4,0,4,4,4,0,1.0,100.0,Moyen,Facile,1,Plus Facile,Pas Adapte,Marketing
5970,2020,Marketing,4,Neologie,1,Les Innovations Lexicales,13,416,10,QCM,0.39,0.47,41.43,1,2,3,1,1,0,3.0,100.0,Facile,Moyen,-1,Plus Difficile,Pas Adapte,Marketing
416,2015,Marketing,4,Neologie,1,Les Innovations Lexicales,13,417,11,QCM,0.41,0.53,50.26,45,45,90,67,45,22,1.34,67.16,Difficile,Moyen,1,Plus Facile,Pas Adapte,Marketing
1527,2016,Marketing,4,Neologie,1,Les Innovations Lexicales,13,417,11,QCM,0.45,0.58,47.0,39,43,82,70,39,31,1.17,55.71,Facile,Moyen,-1,Plus Difficile,Pas Adapte,Marketing
2638,2017,Marketing,4,Neologie,1,Les Innovations Lexicales,13,417,11,QCM,0.53,0.3,34.13,24,46,70,69,24,45,1.01,34.78,Facile,Difficile,-2,Beaucoup plus Difficile,Pas Adapte,Marketing
3749,2018,Marketing,4,Neologie,1,Les Innovations Lexicales,13,417,11,QCM,0.24,0.57,51.25,35,33,68,59,35,24,1.15,59.32,Facile,Moyen,-1,Plus Difficile,Pas Adapte,Marketing
4860,2019,Marketing,4,Neologie,1,Les Innovations Lexicales,13,417,11,QCM,0.74,0.24,29.12,23,55,78,26,23,3,3.0,88.46,Difficile,Difficile,0,Meme Difficulté,Pas Adapte,Marketing
5971,2020,Marketing,4,Neologie,1,Les Innovations Lexicales,13,417,11,QCM,0.63,0.19,25.8,22,63,85,73,22,51,1.16,30.14,Moyen,Difficile,-1,Plus Difficile,Pas Adapte,Marketing
417,2015,Marketing,4,Neologie,1,Les Innovations Lexicales,13,418,12,QROC,0.89,0.01,1.2,0,10,10,9,0,9,1.11,0.0,Moyen,Difficile,-1,Plus Difficile,Pas Adapte,Marketing
1528,2016,Marketing,4,Neologie,1,Les Innovations Lexicales,13,418,12,QROC,0.96,0.2,2.21,0,11,11,5,0,5,2.2,0.0,Facile,Difficile,-2,Beaucoup plus Difficile,Pas Adapte,Marketing
2639,2017,Marketing,4,Neologie,1,Les Innovations Lexicales,13,418,12,QROC,0.95,0.06,18.85,2,7,9,6,2,4,1.5,33.33,Difficile,Difficile,0,Meme Difficulté,Pas Adapte,Marketing
3750,2018,Marketing,4,Neologie,1,Les Innovations Lexicales,13,418,12,QROC,0.67,0.2,21.26,2,8,10,5,2,3,2.0,40.0,Facile,Difficile,-2,Beaucoup plus Difficile,Pas Adapte,Marketing
4861,2019,Marketing,4,Neologie,1,Les Innovations Lexicales,13,418,12,QROC,0.45,0.37,36.36,4,8,12,9,4,5,1.33,44.44,Facile,Moyen,-1,Plus Difficile,Pas Adapte,Marketing
5972,2020,Marketing,4,Neologie,1,Les Innovations Lexicales,13,418,12,QCM,0.22,0.65,58.15,8,5,13,8,8,0,1.62,100.0,Moyen,Moyen,0,Meme Difficulté,Pas Adapte,Marketing
418,2015,Marketing,4,Neologie,1,Les Innovations Lexicales,13,419,13,QCM,0.08,0.91,69.62,56,24,80,71,56,15,1.13,78.87,Difficile,Facile,2,Beaucoup plus Facile,Adapte,Marketing
1529,2016,Marketing,4,Neologie,1,Les Innovations Lexicales,13,419,13,QCM,0.04,0.85,69.62,51,22,73,73,51,22,1.0,69.86,Facile,Facile,0,Meme Difficulté,Adapte,Marketing
2640,2017,Marketing,4,Neologie,1,Les Innovations Lexicales,13,419,13,QCM,0.12,0.85,69.62,47,21,68,63,47,16,1.08,74.6,Facile,Facile,0,Meme Difficulté,Adapte,Marketing
3751,2018,Marketing,4,Neologie,1,Les Innovations Lexicales,13,419,13,QCM,0.18,0.7,69.62,44,19,63,55,44,11,1.15,80.0,Facile,Facile,0,Meme Difficulté,Adapte,Marketing
4862,2019,Marketing,4,Neologie,1,Les Innovations Lexicales,13,419,13,QCM,0.17,0.7,69.62,47,20,67,50,47,3,1.34,94.0,Facile,Facile,0,Meme Difficulté,Adapte,Marketing
5973,2020,Marketing,4,Neologie,1,Les Innovations Lexicales,13,419,13,QCM,0.03,0.93,69.62,49,21,70,66,49,17,1.06,74.24,Facile,Facile,0,Meme Difficulté,Adapte,Marketing
419,2015,Marketing,4,Neologie,2,La Motivation Neologique,7,420,1,QCU,0.63,0.31,28.31,17,43,60,40,17,23,1.5,42.5,Moyen,Difficile,-1,Plus Difficile,Pas Adapte,Marketing
1530,2016,Marketing,4,Neologie,2,La Motivation Neologique,7,420,1,QCU,0.1,0.77,93.84,55,4,59,59,55,4,1.0,93.22,Difficile,Facile,2,Beaucoup plus Facile,Pas Adapte,Marketing
2641,2017,Marketing,4,Neologie,2,La Motivation Neologique,7,420,1,QCU,0.31,0.46,43.01,25,34,59,33,25,8,1.79,75.76,Difficile,Moyen,1,Plus Facile,Pas Adapte,Marketing
3752,2018,Marketing,4,Neologie,2,La Motivation Neologique,7,420,1,QCU,0.2,0.4,59.67,35,24,59,51,35,16,1.16,68.63,Facile,Moyen,-1,Plus Difficile,Pas Adapte,Marketing
4863,2019,Marketing,4,Neologie,2,La Motivation Neologique,7,420,1,QROC,0.33,0.27,61.54,32,20,52,35,32,3,1.49,91.43,Moyen,Moyen,0,Meme Difficulté,Adapte,Marketing
5974,2020,Marketing,4,Neologie,2,La Motivation Neologique,7,420,1,QROC,0.2,0.26,61.54,34,21,55,43,34,9,1.28,79.07,Moyen,Moyen,0,Meme Difficulté,Adapte,Marketing
420,2015,Marketing,4,Neologie,2,La Motivation Neologique,7,421,2,QCM,0.33,0.7,58.73,16,12,28,22,16,6,1.27,72.73,Difficile,Moyen,1,Plus Facile,Pas Adapte,Marketing
1531,2016,Marketing,4,Neologie,2,La Motivation Neologique,7,421,2,QCM,0.36,0.64,43.92,11,15,26,23,11,12,1.13,47.83,Facile,Moyen,-1,Plus Difficile,Pas Adapte,Marketing
2642,2017,Marketing,4,Neologie,2,La Motivation Neologique,7,421,2,QCM,0.67,0.24,1.0,0,23,23,11,0,11,2.09,0.0,Moyen,Difficile,-1,Plus Difficile,Pas Adapte,Marketing
3753,2018,Marketing,4,Neologie,2,La Motivation Neologique,7,421,2,QCM,0.41,0.49,61.98,15,10,25,21,15,6,1.19,71.43,Moyen,Moyen,0,Meme Difficulté,Adapte,Marketing
4864,2019,Marketing,4,Neologie,2,La Motivation Neologique,7,421,2,QCM,0.47,0.45,61.98,16,10,26,24,16,8,1.08,66.67,Moyen,Moyen,0,Meme Difficulté,Adapte,Marketing
5975,2020,Marketing,4,Neologie,2,La Motivation Neologique,7,421,2,QCM,0.43,0.32,61.98,15,10,25,18,15,3,1.39,83.33,Moyen,Moyen,0,Meme Difficulté,Adapte,Marketing
421,2015,Marketing,4,Neologie,2,La Motivation Neologique,7,422,3,QCM,0.06,0.78,69.93,30,13,43,38,30,8,1.13,78.95,Moyen,Facile,1,Plus Facile,Adapte,Marketing
1532,2016,Marketing,4,Neologie,2,La Motivation Neologique,7,422,3,QCM,0.04,0.85,69.93,29,12,41,29,29,0,1.41,100.0,Facile,Facile,0,Meme Difficulté,Adapte,Marketing
2643,2017,Marketing,4,Neologie,2,La Motivation Neologique,7,422,3,QROC,0.14,0.72,69.93,30,13,43,32,30,2,1.34,93.75,Facile,Facile,0,Meme Difficulté,Adapte,Marketing
3754,2018,Marketing,4,Neologie,2,La Motivation Neologique,7,422,3,QO,0.16,0.38,69.93,28,12,40,37,28,9,1.08,75.68,Facile,Facile,0,Meme Difficulté,Adapte,Marketing
4865,2019,Marketing,4,Neologie,2,La Motivation Neologique,7,422,3,QO,0.0,0.4,69.93,26,11,37,33,26,7,1.12,78.79,Facile,Facile,0,Meme Difficulté,Adapte,Marketing
5976,2020,Marketing,4,Neologie,2,La Motivation Neologique,7,422,3,QO,0.17,0.77,69.93,25,11,36,29,25,4,1.24,86.21,Facile,Facile,0,Meme Difficulté,Adapte,Marketing
422,2015,Marketing,4,Neologie,2,La Motivation Neologique,7,423,4,QCM,0.38,0.52,40.57,39,56,95,41,39,2,2.32,95.12,Difficile,Moyen,1,Plus Facile,Pas Adapte,Marketing
1533,2016,Marketing,4,Neologie,2,La Motivation Neologique,7,423,4,QCM,0.34,0.53,37.71,36,59,95,80,36,44,1.19,45.0,Moyen,Moyen,0,Meme Difficulté,Pas Adapte,Marketing
2644,2017,Marketing,4,Neologie,2,La Motivation Neologique,7,423,4,QCM,0.79,0.17,34.3,33,64,97,48,33,15,2.02,68.75,Facile,Difficile,-2,Beaucoup plus Difficile,Pas Adapte,Marketing
3755,2018,Marketing,4,Neologie,2,La Motivation Neologique,7,423,4,QCU,0.02,0.8,67.48,70,34,104,89,70,19,1.17,78.65,Moyen,Facile,1,Plus Facile,Adapte,Marketing
4866,2019,Marketing,4,Neologie,2,La Motivation Neologique,7,423,4,QCU,0.04,0.77,67.48,61,30,91,66,61,5,1.38,92.42,Facile,Facile,0,Meme Difficulté,Adapte,Marketing
5977,2020,Marketing,4,Neologie,2,La Motivation Neologique,7,423,4,QCU,0.19,0.89,67.48,54,26,80,56,54,2,1.43,96.43,Facile,Facile,0,Meme Difficulté,Adapte,Marketing
423,2015,Marketing,4,Neologie,2,La Motivation Neologique,7,424,5,QCU,0.7,0.24,15.92,6,30,36,17,6,11,2.12,35.29,Facile,Difficile,-2,Beaucoup plus Difficile,Pas Adapte,Marketing
1534,2016,Marketing,4,Neologie,2,La Motivation Neologique,7,424,5,QROC,0.04,0.53,70.59,23,9,32,28,23,5,1.14,82.14,Difficile,Facile,2,Beaucoup plus Facile,Adapte,Marketing
2645,2017,Marketing,4,Neologie,2,La Motivation Neologique,7,424,5,QROC,0.15,0.94,70.59,20,8,28,22,20,2,1.27,90.91,Facile,Facile,0,Meme Difficulté,Adapte,Marketing
3756,2018,Marketing,4,Neologie,2,La Motivation Neologique,7,424,5,QROC,0.13,0.49,70.59,21,9,30,27,21,6,1.11,77.78,Facile,Facile,0,Meme Difficulté,Adapte,Marketing
4867,2019,Marketing,4,Neologie,2,La Motivation Neologique,7,424,5,QROC,0.03,0.8,70.59,22,9,31,30,22,8,1.03,73.33,Facile,Facile,0,Meme Difficulté,Adapte,Marketing
5978,2020,Marketing,4,Neologie,2,La Motivation Neologique,7,424,5,QROC,0.14,0.82,70.59,20,9,29,28,20,8,1.04,71.43,Facile,Facile,0,Meme Difficulté,Adapte,Marketing
424,2015,Marketing,4,Neologie,2,La Motivation Neologique,7,425,6,QO,0.14,0.55,65.66,55,29,84,76,55,21,1.11,72.37,Facile,Facile,0,Meme Difficulté,Adapte,Marketing
1535,2016,Marketing,4,Neologie,2,La Motivation Neologique,7,425,6,QO,0.17,0.72,65.66,63,33,96,94,63,31,1.02,67.02,Facile,Facile,0,Meme Difficulté,Adapte,Marketing
2646,2017,Marketing,4,Neologie,2,La Motivation Neologique,7,425,6,QO,0.03,0.8,65.66,64,34,98,86,64,22,1.14,74.42,Facile,Facile,0,Meme Difficulté,Adapte,Marketing
3757,2018,Marketing,4,Neologie,2,La Motivation Neologique,7,425,6,QROC,0.01,0.62,65.66,64,33,97,78,64,14,1.24,82.05,Facile,Facile,0,Meme Difficulté,Adapte,Marketing
4868,2019,Marketing,4,Neologie,2,La Motivation Neologique,7,425,6,QROC,0.09,0.76,65.66,60,32,92,76,60,16,1.21,78.95,Facile,Facile,0,Meme Difficulté,Adapte,Marketing
5979,2020,Marketing,4,Neologie,2,La Motivation Neologique,7,425,6,QROC,0.06,0.95,65.66,64,33,97,84,64,20,1.15,76.19,Facile,Facile,0,Meme Difficulté,Adapte,Marketing
425,2015,Marketing,4,Neologie,2,La Motivation Neologique,7,426,7,QCU,0.32,0.55,41.8,18,26,44,40,18,22,1.1,45.0,Difficile,Moyen,1,Plus Facile,Pas Adapte,Marketing
1536,2016,Marketing,4,Neologie,2,La Motivation Neologique,7,426,7,QCM,0.24,0.46,60.9,26,16,42,35,26,9,1.2,74.29,Moyen,Moyen,0,Meme Difficulté,Adapte,Marketing
2647,2017,Marketing,4,Neologie,2,La Motivation Neologique,7,426,7,QCM,0.41,0.53,60.9,27,18,45,31,27,4,1.45,87.1,Moyen,Moyen,0,Meme Difficulté,Adapte,Marketing
3758,2018,Marketing,4,Neologie,2,La Motivation Neologique,7,426,7,QCM,0.24,0.5,60.9,30,19,49,35,30,5,1.4,85.71,Moyen,Moyen,0,Meme Difficulté,Adapte,Marketing
4869,2019,Marketing,4,Neologie,2,La Motivation Neologique,7,426,7,QCM,0.26,0.63,60.9,26,16,42,32,26,6,1.31,81.25,Moyen,Moyen,0,Meme Difficulté,Adapte,Marketing
5980,2020,Marketing,4,Neologie,2,La Motivation Neologique,7,426,7,QCM,0.37,0.62,60.9,24,15,39,37,24,13,1.05,64.86,Moyen,Moyen,0,Meme Difficulté,Adapte,Marketing
426,2015,Marketing,4,Neologie,3,La Creation Neologique,9,427,1,QCU,0.04,0.81,80.57,79,19,98,96,79,17,1.02,82.29,Moyen,Facile,1,Plus Facile,Pas Adapte,Marketing
1537,2016,Marketing,4,Neologie,3,La Creation Neologique,9,427,1,QCM,0.32,0.41,60.86,65,41,106,90,65,25,1.18,72.22,Facile,Moyen,-1,Plus Difficile,Adapte,Marketing
2648,2017,Marketing,4,Neologie,3,La Creation Neologique,9,427,1,QCM,0.27,0.62,60.86,65,42,107,73,65,8,1.47,89.04,Moyen,Moyen,0,Meme Difficulté,Adapte,Marketing
3759,2018,Marketing,4,Neologie,3,La Creation Neologique,9,427,1,QCM,0.23,0.62,60.86,73,47,120,85,73,12,1.41,85.88,Moyen,Moyen,0,Meme Difficulté,Adapte,Marketing
4870,2019,Marketing,4,Neologie,3,La Creation Neologique,9,427,1,QROC,0.5,0.38,60.86,74,47,121,105,74,31,1.15,70.48,Moyen,Moyen,0,Meme Difficulté,Adapte,Marketing
5981,2020,Marketing,4,Neologie,3,La Creation Neologique,9,427,1,QROC,0.58,0.31,60.86,69,44,113,106,69,37,1.07,65.09,Moyen,Moyen,0,Meme Difficulté,Adapte,Marketing
427,2015,Marketing,4,Neologie,3,La Creation Neologique,9,428,2,QCU,0.16,0.83,81.34,28,6,34,28,28,0,1.21,100.0,Moyen,Facile,1,Plus Facile,Pas Adapte,Marketing
1538,2016,Marketing,4,Neologie,3,La Creation Neologique,9,428,2,QCU,0.48,0.27,27.59,8,21,29,15,8,7,1.93,53.33,Facile,Difficile,-2,Beaucoup plus Difficile,Pas Adapte,Marketing
2649,2017,Marketing,4,Neologie,3,La Creation Neologique,9,428,2,QCU,0.73,0.37,32.45,10,22,32,13,10,3,2.46,76.92,Difficile,Difficile,0,Meme Difficulté,Pas Adapte,Marketing
3760,2018,Marketing,4,Neologie,3,La Creation Neologique,9,428,2,QCM,0.13,0.74,79.63,29,7,36,33,29,4,1.09,87.88,Difficile,Facile,2,Beaucoup plus Facile,Pas Adapte,Marketing
4871,2019,Marketing,4,Neologie,3,La Creation Neologique,9,428,2,QCM,0.51,0.23,33.89,14,26,40,27,14,13,1.48,51.85,Facile,Difficile,-2,Beaucoup plus Difficile,Pas Adapte,Marketing
5982,2020,Marketing,4,Neologie,3,La Creation Neologique,9,428,2,QCM,0.6,0.16,27.06,9,25,34,12,9,3,2.83,75.0,Facile,Difficile,-2,Beaucoup plus Difficile,Pas Adapte,Marketing
428,2015,Marketing,4,Neologie,3,La Creation Neologique,9,429,3,QROC,0.09,0.98,98.19,24,0,24,24,24,0,1.0,100.0,Moyen,Facile,1,Plus Facile,Pas Adapte,Marketing
1539,2016,Marketing,4,Neologie,3,La Creation Neologique,9,429,3,QROC,0.67,0.02,23.71,5,17,22,12,5,7,1.83,41.67,Facile,Difficile,-2,Beaucoup plus Difficile,Pas Adapte,Marketing
2650,2017,Marketing,4,Neologie,3,La Creation Neologique,9,429,3,QROC,0.25,0.38,53.93,13,11,24,19,13,6,1.26,68.42,Facile,Moyen,-1,Plus Difficile,Pas Adapte,Marketing
3761,2018,Marketing,4,Neologie,3,La Creation Neologique,9,429,3,QROC,0.79,0.18,29.9,7,15,22,9,7,2,2.44,77.78,Difficile,Difficile,0,Meme Difficulté,Pas Adapte,Marketing
4872,2019,Marketing,4,Neologie,3,La Creation Neologique,9,429,3,QROC,0.62,0.16,30.66,8,17,25,11,8,3,2.27,72.73,Moyen,Difficile,-1,Plus Difficile,Pas Adapte,Marketing
5983,2020,Marketing,4,Neologie,3,La Creation Neologique,9,429,3,QROC,0.74,0.23,8.67,2,26,28,18,2,16,1.56,11.11,Difficile,Difficile,0,Meme Difficulté,Pas Adapte,Marketing
429,2015,Marketing,4,Neologie,3,La Creation Neologique,9,430,4,QCU,0.27,0.59,46.7,5,5,10,8,5,3,1.25,62.5,Moyen,Moyen,0,Meme Difficulté,Pas Adapte,Marketing
1540,2016,Marketing,4,Neologie,3,La Creation Neologique,9,430,4,QCU,0.08,0.9,90.01,8,1,9,9,8,1,1.0,88.89,Facile,Facile,0,Meme Difficulté,Pas Adapte,Marketing
2651,2017,Marketing,4,Neologie,3,La Creation Neologique,9,430,4,QCU,0.25,0.6,56.11,5,4,9,8,5,3,1.12,62.5,Difficile,Moyen,1,Plus Facile,Pas Adapte,Marketing
3762,2018,Marketing,4,Neologie,3,La Creation Neologique,9,430,4,QCU,0.24,0.4,56.42,5,4,9,6,5,1,1.5,83.33,Moyen,Moyen,0,Meme Difficulté,Pas Adapte,Marketing
4873,2019,Marketing,4,Neologie,3,La Creation Neologique,9,430,4,QCU,0.56,0.33,3.74,0,10,10,4,0,4,2.5,0.0,Moyen,Difficile,-1,Plus Difficile,Pas Adapte,Marketing
5984,2020,Marketing,4,Neologie,3,La Creation Neologique,9,430,4,QCU,0.07,0.99,77.23,6,2,8,8,6,2,1.0,75.0,Moyen,Facile,1,Plus Facile,Pas Adapte,Marketing
430,2015,Marketing,4,Neologie,3,La Creation Neologique,9,431,5,QCU,0.42,0.22,28.94,27,66,93,57,27,30,1.63,47.37,Facile,Difficile,-2,Beaucoup plus Difficile,Pas Adapte,Marketing
1541,2016,Marketing,4,Neologie,3,La Creation Neologique,9,431,5,QCU,0.08,0.91,89.29,88,10,98,96,88,8,1.02,91.67,Difficile,Facile,2,Beaucoup plus Facile,Pas Adapte,Marketing
2652,2017,Marketing,4,Neologie,3,La Creation Neologique,9,431,5,QCU,0.21,0.65,48.69,55,57,112,58,55,3,1.93,94.83,Facile,Moyen,-1,Plus Difficile,Pas Adapte,Marketing
3763,2018,Marketing,4,Neologie,3,La Creation Neologique,9,431,5,QO,0.22,0.28,46.04,48,57,105,73,48,25,1.44,65.75,Difficile,Moyen,1,Plus Facile,Pas Adapte,Marketing
4874,2019,Marketing,4,Neologie,3,La Creation Neologique,9,431,5,QO,0.54,0.25,52.13,52,48,100,92,52,40,1.09,56.52,Difficile,Moyen,1,Plus Facile,Pas Adapte,Marketing
5985,2020,Marketing,4,Neologie,3,La Creation Neologique,9,431,5,QROC,0.83,0.08,16.64,19,96,115,49,19,30,2.35,38.78,Difficile,Difficile,0,Meme Difficulté,Pas Adapte,Marketing
431,2015,Marketing,4,Neologie,3,La Creation Neologique,9,432,6,QCU,0.67,0.38,23.8,20,63,83,40,20,20,2.08,50.0,Facile,Difficile,-2,Beaucoup plus Difficile,Pas Adapte,Marketing
1542,2016,Marketing,4,Neologie,3,La Creation Neologique,9,432,6,QCU,0.05,0.9,93.35,89,6,95,93,89,4,1.02,95.7,Difficile,Facile,2,Beaucoup plus Facile,Pas Adapte,Marketing
2653,2017,Marketing,4,Neologie,3,La Creation Neologique,9,432,6,QCU,0.68,0.26,15.47,16,90,106,53,16,37,2.0,30.19,Facile,Difficile,-2,Beaucoup plus Difficile,Pas Adapte,Marketing
3764,2018,Marketing,4,Neologie,3,La Creation Neologique,9,432,6,QROC,0.88,0.23,21.28,23,87,110,54,23,31,2.04,42.59,Facile,Difficile,-2,Beaucoup plus Difficile,Pas Adapte,Marketing
4875,2019,Marketing,4,Neologie,3,La Creation Neologique,9,432,6,QROC,0.51,0.36,50.66,62,60,122,79,62,17,1.54,78.48,Facile,Moyen,-1,Plus Difficile,Pas Adapte,Marketing
5986,2020,Marketing,4,Neologie,3,La Creation Neologique,9,432,6,QROC,0.76,0.0,10.91,13,105,118,83,13,70,1.42,15.66,Moyen,Difficile,-1,Plus Difficile,Pas Adapte,Marketing
432,2015,Marketing,4,Neologie,3,La Creation Neologique,9,433,7,QCU,0.17,0.97,84.12,27,5,32,28,27,1,1.14,96.43,Moyen,Facile,1,Plus Facile,Pas Adapte,Marketing
1543,2016,Marketing,4,Neologie,3,La Creation Neologique,9,433,7,QCU,0.54,0.23,33.71,10,19,29,17,10,7,1.71,58.82,Difficile,Difficile,0,Meme Difficulté,Pas Adapte,Marketing
2654,2017,Marketing,4,Neologie,3,La Creation Neologique,9,433,7,QCU,0.34,0.69,40.99,13,19,32,27,13,14,1.19,48.15,Facile,Moyen,-1,Plus Difficile,Pas Adapte,Marketing
3765,2018,Marketing,4,Neologie,3,La Creation Neologique,9,433,7,QCU,0.36,0.43,62.51,22,13,35,30,22,8,1.17,73.33,Moyen,Moyen,0,Meme Difficulté,Adapte,Marketing
4876,2019,Marketing,4,Neologie,3,La Creation Neologique,9,433,7,QCU,0.22,0.67,62.51,24,14,38,31,24,7,1.23,77.42,Moyen,Moyen,0,Meme Difficulté,Adapte,Marketing
5987,2020,Marketing,4,Neologie,3,La Creation Neologique,9,433,7,QCU,0.22,0.74,62.51,23,13,36,24,23,1,1.5,95.83,Moyen,Moyen,0,Meme Difficulté,Adapte,Marketing
433,2015,Marketing,4,Neologie,3,La Creation Neologique,9,434,8,QCU,0.19,0.95,98.82,56,1,57,56,56,0,1.02,100.0,Facile,Facile,0,Meme Difficulté,Pas Adapte,Marketing
1544,2016,Marketing,4,Neologie,3,La Creation Neologique,9,434,8,QCU,0.69,0.37,4.24,2,55,57,23,2,21,2.48,8.7,Facile,Difficile,-2,Beaucoup plus Difficile,Pas Adapte,Marketing
2655,2017,Marketing,4,Neologie,3,La Creation Neologique,9,434,8,QCU,0.2,0.54,61.87,34,21,55,54,34,20,1.02,62.96,Facile,Moyen,-1,Plus Difficile,Adapte,Marketing
3766,2018,Marketing,4,Neologie,3,La Creation Neologique,9,434,8,QCU,0.35,0.64,61.87,33,21,54,34,33,1,1.59,97.06,Moyen,Moyen,0,Meme Difficulté,Adapte,Marketing
4877,2019,Marketing,4,Neologie,3,La Creation Neologique,9,434,8,QCU,0.26,0.63,61.87,32,20,52,38,32,6,1.37,84.21,Moyen,Moyen,0,Meme Difficulté,Adapte,Marketing
5988,2020,Marketing,4,Neologie,3,La Creation Neologique,9,434,8,QCU,0.29,0.42,61.87,34,21,55,51,34,17,1.08,66.67,Moyen,Moyen,0,Meme Difficulté,Adapte,Marketing
434,2015,Marketing,4,Neologie,3,La Creation Neologique,9,435,9,QO,0.5,0.23,62.85,45,26,71,50,45,5,1.42,90.0,Difficile,Moyen,1,Plus Facile,Adapte,Marketing
1545,2016,Marketing,4,Neologie,3,La Creation Neologique,9,435,9,QO,0.25,0.29,62.85,47,28,75,60,47,13,1.25,78.33,Moyen,Moyen,0,Meme Difficulté,Adapte,Marketing
2656,2017,Marketing,4,Neologie,3,La Creation Neologique,9,435,9,QO,0.29,0.28,62.85,45,27,72,57,45,12,1.26,78.95,Moyen,Moyen,0,Meme Difficulté,Adapte,Marketing
3767,2018,Marketing,4,Neologie,3,La Creation Neologique,9,435,9,QROC,0.29,0.39,62.85,51,30,81,69,51,18,1.17,73.91,Moyen,Moyen,0,Meme Difficulté,Adapte,Marketing
4878,2019,Marketing,4,Neologie,3,La Creation Neologique,9,435,9,QROC,0.51,0.27,62.85,46,27,73,73,46,27,1.0,63.01,Moyen,Moyen,0,Meme Difficulté,Adapte,Marketing
5989,2020,Marketing,4,Neologie,3,La Creation Neologique,9,435,9,QCU,0.35,0.41,62.85,50,30,80,77,50,27,1.04,64.94,Moyen,Moyen,0,Meme Difficulté,Adapte,Marketing
435,2015,Marketing,4,Neologie,4,Les Accidents Lexicaux,10,436,1,QCM,0.15,0.75,88.36,84,11,95,91,84,7,1.04,92.31,Facile,Facile,0,Meme Difficulté,Pas Adapte,Marketing
1546,2016,Marketing,4,Neologie,4,Les Accidents Lexicaux,10,436,1,QCM,0.42,0.63,41.59,36,50,86,48,36,12,1.79,75.0,Facile,Moyen,-1,Plus Difficile,Pas Adapte,Marketing
2657,2017,Marketing,4,Neologie,4,Les Accidents Lexicaux,10,436,1,QCM,0.31,0.63,53.53,43,37,80,54,43,11,1.48,79.63,Difficile,Moyen,1,Plus Facile,Pas Adapte,Marketing
3768,2018,Marketing,4,Neologie,4,Les Accidents Lexicaux,10,436,1,QROC,0.89,0.08,16.7,13,63,76,38,13,25,2.0,34.21,Facile,Difficile,-2,Beaucoup plus Difficile,Pas Adapte,Marketing
4879,2019,Marketing,4,Neologie,4,Les Accidents Lexicaux,10,436,1,QROC,0.39,0.28,61.65,46,29,75,71,46,25,1.06,64.79,Moyen,Moyen,0,Meme Difficulté,Adapte,Marketing
5990,2020,Marketing,4,Neologie,4,Les Accidents Lexicaux,10,436,1,QROC,0.58,0.31,61.65,41,26,67,60,41,19,1.12,68.33,Moyen,Moyen,0,Meme Difficulté,Adapte,Marketing
436,2015,Marketing,4,Neologie,4,Les Accidents Lexicaux,10,437,2,QCM,0.41,0.48,40.03,22,33,55,43,22,21,1.28,51.16,Moyen,Moyen,0,Meme Difficulté,Pas Adapte,Marketing
1547,2016,Marketing,4,Neologie,4,Les Accidents Lexicaux,10,437,2,QCM,0.52,0.26,0.24,0,51,51,14,0,14,3.64,0.0,Moyen,Difficile,-1,Plus Difficile,Pas Adapte,Marketing
2658,2017,Marketing,4,Neologie,4,Les Accidents Lexicaux,10,437,2,QCM,0.39,0.37,63.67,35,20,55,48,35,13,1.15,72.92,Moyen,Moyen,0,Meme Difficulté,Adapte,Marketing
3769,2018,Marketing,4,Neologie,4,Les Accidents Lexicaux,10,437,2,QCM,0.32,0.45,63.67,36,20,56,56,36,20,1.0,64.29,Moyen,Moyen,0,Meme Difficulté,Adapte,Marketing
4880,2019,Marketing,4,Neologie,4,Les Accidents Lexicaux,10,437,2,QCM,0.23,0.5,63.67,32,18,50,41,32,9,1.22,78.05,Moyen,Moyen,0,Meme Difficulté,Adapte,Marketing
5991,2020,Marketing,4,Neologie,4,Les Accidents Lexicaux,10,437,2,QCU,0.37,0.65,63.67,36,21,57,51,36,15,1.12,70.59,Moyen,Moyen,0,Meme Difficulté,Adapte,Marketing
437,2015,Marketing,4,Neologie,4,Les Accidents Lexicaux,10,438,3,QCM,0.02,0.84,85.5,28,5,33,29,28,1,1.14,96.55,Moyen,Facile,1,Plus Facile,Pas Adapte,Marketing
1548,2016,Marketing,4,Neologie,4,Les Accidents Lexicaux,10,438,3,QCM,0.77,0.21,28.0,8,21,29,20,8,12,1.45,40.0,Difficile,Difficile,0,Meme Difficulté,Pas Adapte,Marketing
2659,2017,Marketing,4,Neologie,4,Les Accidents Lexicaux,10,438,3,QCM,0.54,0.28,2.77,1,24,25,19,1,18,1.32,5.26,Facile,Difficile,-2,Beaucoup plus Difficile,Pas Adapte,Marketing
3770,2018,Marketing,4,Neologie,4,Les Accidents Lexicaux,10,438,3,QCM,0.47,0.57,58.34,16,12,28,18,16,2,1.56,88.89,Facile,Moyen,-1,Plus Difficile,Pas Adapte,Marketing
4881,2019,Marketing,4,Neologie,4,Les Accidents Lexicaux,10,438,3,QCM,0.07,0.83,96.43,31,1,32,31,31,0,1.03,100.0,Difficile,Facile,2,Beaucoup plus Facile,Pas Adapte,Marketing
5992,2020,Marketing,4,Neologie,4,Les Accidents Lexicaux,10,438,3,QROC,0.47,0.37,57.81,19,13,32,31,19,12,1.03,61.29,Facile,Moyen,-1,Plus Difficile,Pas Adapte,Marketing
438,2015,Marketing,4,Neologie,4,Les Accidents Lexicaux,10,439,4,QCU,0.44,0.27,17.4,16,77,93,90,16,74,1.03,17.78,Difficile,Difficile,0,Meme Difficulté,Pas Adapte,Marketing
1549,2016,Marketing,4,Neologie,4,Les Accidents Lexicaux,10,439,4,QCU,0.17,0.98,91.05,73,7,80,78,73,5,1.03,93.59,Facile,Facile,0,Meme Difficulté,Pas Adapte,Marketing
2660,2017,Marketing,4,Neologie,4,Les Accidents Lexicaux,10,439,4,QCU,0.57,0.23,33.21,28,57,85,77,28,49,1.1,36.36,Facile,Difficile,-2,Beaucoup plus Difficile,Pas Adapte,Marketing
3771,2018,Marketing,4,Neologie,4,Les Accidents Lexicaux,10,439,4,QCU,0.31,0.66,38.62,30,48,78,63,30,33,1.24,47.62,Moyen,Moyen,0,Meme Difficulté,Pas Adapte,Marketing
4882,2019,Marketing,4,Neologie,4,Les Accidents Lexicaux,10,439,4,QCU,0.29,0.42,38.22,28,46,74,39,28,11,1.9,71.79,Facile,Moyen,-1,Plus Difficile,Pas Adapte,Marketing
5993,2020,Marketing,4,Neologie,4,Les Accidents Lexicaux,10,439,4,QCU,0.05,0.85,74.55,51,17,68,63,51,12,1.08,80.95,Difficile,Facile,2,Beaucoup plus Facile,Adapte,Marketing
439,2015,Marketing,4,Neologie,4,Les Accidents Lexicaux,10,440,5,QCM,0.68,0.21,9.5,1,6,7,3,1,2,2.33,33.33,Facile,Difficile,-2,Beaucoup plus Difficile,Pas Adapte,Marketing
1550,2016,Marketing,4,Neologie,4,Les Accidents Lexicaux,10,440,5,QCM,0.09,0.94,85.87,7,1,8,7,7,0,1.14,100.0,Difficile,Facile,2,Beaucoup plus Facile,Pas Adapte,Marketing
2661,2017,Marketing,4,Neologie,4,Les Accidents Lexicaux,10,440,5,QCM,0.56,0.24,16.69,1,6,7,5,1,4,1.4,20.0,Difficile,Difficile,0,Meme Difficulté,Pas Adapte,Marketing
3772,2018,Marketing,4,Neologie,4,Les Accidents Lexicaux,10,440,5,QCM,0.54,0.27,31.61,3,5,8,4,3,1,2.0,75.0,Moyen,Difficile,-1,Plus Difficile,Pas Adapte,Marketing
4883,2019,Marketing,4,Neologie,4,Les Accidents Lexicaux,10,440,5,QCM,0.71,0.19,4.14,0,7,7,7,0,7,1.0,0.0,Facile,Difficile,-2,Beaucoup plus Difficile,Pas Adapte,Marketing
5994,2020,Marketing,4,Neologie,4,Les Accidents Lexicaux,10,440,5,QCM,0.79,0.3,17.38,1,7,8,6,1,5,1.33,16.67,Difficile,Difficile,0,Meme Difficulté,Pas Adapte,Marketing
440,2015,Marketing,4,Neologie,4,Les Accidents Lexicaux,10,441,6,QCM,0.01,0.99,77.06,6,2,8,8,6,2,1.0,75.0,Moyen,Facile,1,Plus Facile,Pas Adapte,Marketing
1551,2016,Marketing,4,Neologie,4,Les Accidents Lexicaux,10,441,6,QCM,0.12,0.72,85.05,6,1,7,6,6,0,1.17,100.0,Moyen,Facile,1,Plus Facile,Pas Adapte,Marketing
2662,2017,Marketing,4,Neologie,4,Les Accidents Lexicaux,10,441,6,QCM,0.71,0.28,16.82,1,5,6,4,1,3,1.5,25.0,Moyen,Difficile,-1,Plus Difficile,Pas Adapte,Marketing
3773,2018,Marketing,4,Neologie,4,Les Accidents Lexicaux,10,441,6,QCM,0.38,0.45,38.63,3,4,7,4,3,1,1.75,75.0,Facile,Moyen,-1,Plus Difficile,Pas Adapte,Marketing
4884,2019,Marketing,4,Neologie,4,Les Accidents Lexicaux,10,441,6,QCM,0.18,0.78,93.93,6,0,6,6,6,0,1.0,100.0,Difficile,Facile,2,Beaucoup plus Facile,Pas Adapte,Marketing
5995,2020,Marketing,4,Neologie,4,Les Accidents Lexicaux,10,441,6,QCM,0.03,0.84,97.55,7,0,7,7,7,0,1.0,100.0,Difficile,Facile,2,Beaucoup plus Facile,Pas Adapte,Marketing
441,2015,Marketing,4,Neologie,4,Les Accidents Lexicaux,10,442,7,QROC,0.52,0.32,46.04,14,17,31,17,14,3,1.82,82.35,Facile,Moyen,-1,Plus Difficile,Pas Adapte,Marketing
1552,2016,Marketing,4,Neologie,4,Les Accidents Lexicaux,10,442,7,QROC,0.12,0.8,76.78,21,6,27,25,21,4,1.08,84.0,Difficile,Facile,2,Beaucoup plus Facile,Pas Adapte,Marketing
2663,2017,Marketing,4,Neologie,4,Les Accidents Lexicaux,10,442,7,QROC,0.49,0.31,54.96,16,14,30,18,16,2,1.67,88.89,Difficile,Moyen,1,Plus Facile,Pas Adapte,Marketing
3774,2018,Marketing,4,Neologie,4,Les Accidents Lexicaux,10,442,7,QO,0.9,0.08,26.46,8,24,32,26,8,18,1.23,30.77,Moyen,Difficile,-1,Plus Difficile,Pas Adapte,Marketing
4885,2019,Marketing,4,Neologie,4,Les Accidents Lexicaux,10,442,7,QO,0.03,0.42,91.97,26,2,28,28,26,2,1.0,92.86,Difficile,Facile,2,Beaucoup plus Facile,Pas Adapte,Marketing
5996,2020,Marketing,4,Neologie,4,Les Accidents Lexicaux,10,442,7,QO,0.12,0.65,68.79,19,9,28,27,19,8,1.04,70.37,Difficile,Facile,2,Beaucoup plus Facile,Adapte,Marketing
442,2015,Marketing,4,Neologie,4,Les Accidents Lexicaux,10,443,8,QROC,0.27,0.28,36.29,29,51,80,71,29,42,1.13,40.85,Moyen,Moyen,0,Meme Difficulté,Pas Adapte,Marketing
1553,2016,Marketing,4,Neologie,4,Les Accidents Lexicaux,10,443,8,QROC,0.99,0.12,26.41,21,59,80,38,21,17,2.11,55.26,Moyen,Difficile,-1,Plus Difficile,Pas Adapte,Marketing
2664,2017,Marketing,4,Neologie,4,Les Accidents Lexicaux,10,443,8,QROC,0.9,0.18,8.86,8,79,87,68,8,60,1.28,11.76,Moyen,Difficile,-1,Plus Difficile,Pas Adapte,Marketing
3775,2018,Marketing,4,Neologie,4,Les Accidents Lexicaux,10,443,8,QROC,0.04,0.65,94.87,75,4,79,77,75,2,1.03,97.4,Facile,Facile,0,Meme Difficulté,Pas Adapte,Marketing
4886,2019,Marketing,4,Neologie,4,Les Accidents Lexicaux,10,443,8,QROC,0.79,0.01,1.78,1,72,73,46,1,45,1.59,2.17,Moyen,Difficile,-1,Plus Difficile,Pas Adapte,Marketing
5997,2020,Marketing,4,Neologie,4,Les Accidents Lexicaux,10,443,8,QROC,0.27,0.34,36.98,28,49,77,59,28,31,1.31,47.46,Moyen,Moyen,0,Meme Difficulté,Pas Adapte,Marketing
443,2015,Marketing,4,Neologie,4,Les Accidents Lexicaux,10,444,9,QCM,0.17,0.8,83.48,9,2,11,9,9,0,1.22,100.0,Moyen,Facile,1,Plus Facile,Pas Adapte,Marketing
1554,2016,Marketing,4,Neologie,4,Les Accidents Lexicaux,10,444,9,QCU,0.38,0.43,35.27,5,8,13,7,5,2,1.86,71.43,Difficile,Moyen,1,Plus Facile,Pas Adapte,Marketing
2665,2017,Marketing,4,Neologie,4,Les Accidents Lexicaux,10,444,9,QCU,0.33,0.42,45.58,6,7,13,7,6,1,1.86,85.71,Difficile,Moyen,1,Plus Facile,Pas Adapte,Marketing
3776,2018,Marketing,4,Neologie,4,Les Accidents Lexicaux,10,444,9,QCU,0.38,0.56,51.77,7,6,13,8,7,1,1.62,87.5,Moyen,Moyen,0,Meme Difficulté,Pas Adapte,Marketing
4887,2019,Marketing,4,Neologie,4,Les Accidents Lexicaux,10,444,9,QCU,0.59,0.24,19.17,3,12,15,15,3,12,1.0,20.0,Moyen,Difficile,-1,Plus Difficile,Pas Adapte,Marketing
5998,2020,Marketing,4,Neologie,4,Les Accidents Lexicaux,10,444,9,QCU,0.68,0.38,5.86,1,12,13,6,1,5,2.17,16.67,Difficile,Difficile,0,Meme Difficulté,Pas Adapte,Marketing
444,2015,Marketing,4,Neologie,4,Les Accidents Lexicaux,10,445,10,QCU,0.33,0.69,51.88,8,8,16,10,8,2,1.6,80.0,Difficile,Moyen,1,Plus Facile,Pas Adapte,Marketing
1555,2016,Marketing,4,Neologie,4,Les Accidents Lexicaux,10,445,10,QCU,0.06,0.8,67.84,10,5,15,14,10,4,1.07,71.43,Difficile,Facile,2,Beaucoup plus Facile,Adapte,Marketing
2666,2017,Marketing,4,Neologie,4,Les Accidents Lexicaux,10,445,10,QCU,0.15,0.82,67.84,9,5,14,13,9,4,1.08,69.23,Facile,Facile,0,Meme Difficulté,Adapte,Marketing
3777,2018,Marketing,4,Neologie,4,Les Accidents Lexicaux,10,445,10,QCU,0.09,0.82,67.84,9,4,13,12,9,3,1.08,75.0,Facile,Facile,0,Meme Difficulté,Adapte,Marketing
4888,2019,Marketing,4,Neologie,4,Les Accidents Lexicaux,10,445,10,QCM,0.13,0.74,67.84,8,4,12,9,8,1,1.33,88.89,Facile,Facile,0,Meme Difficulté,Adapte,Marketing
5999,2020,Marketing,4,Neologie,4,Les Accidents Lexicaux,10,445,10,QCM,0.03,0.75,67.84,7,4,11,10,7,3,1.1,70.0,Facile,Facile,0,Meme Difficulté,Adapte,Marketing
445,2015,Marketing,5,Construction Morphologique,1,Alterations,6,446,1,QCU,0.53,0.26,10.03,10,90,100,41,10,31,2.44,24.39,Difficile,Difficile,0,Meme Difficulté,Pas Adapte,Marketing
1556,2016,Marketing,5,Construction Morphologique,1,Alterations,6,446,1,QCU,0.51,0.3,11.45,10,76,86,35,10,25,2.46,28.57,Difficile,Difficile,0,Meme Difficulté,Pas Adapte,Marketing
2667,2017,Marketing,5,Construction Morphologique,1,Alterations,6,446,1,QCU,0.66,0.28,3.52,3,95,98,49,3,46,2.0,6.12,Facile,Difficile,-2,Beaucoup plus Difficile,Pas Adapte,Marketing
3778,2018,Marketing,5,Construction Morphologique,1,Alterations,6,446,1,QROC,0.96,0.21,28.76,29,71,100,91,29,62,1.1,31.87,Moyen,Difficile,-1,Plus Difficile,Pas Adapte,Marketing
4889,2019,Marketing,5,Construction Morphologique,1,Alterations,6,446,1,QROC,0.09,0.54,74.48,80,27,107,95,80,15,1.13,84.21,Moyen,Facile,1,Plus Facile,Adapte,Marketing
6000,2020,Marketing,5,Construction Morphologique,1,Alterations,6,446,1,QROC,0.18,0.7,74.48,85,29,114,95,85,10,1.2,89.47,Facile,Facile,0,Meme Difficulté,Adapte,Marketing
446,2015,Marketing,5,Construction Morphologique,1,Alterations,6,447,2,QCM,0.58,0.26,0.43,0,96,96,47,0,47,2.04,0.0,Moyen,Difficile,-1,Plus Difficile,Pas Adapte,Marketing
1557,2016,Marketing,5,Construction Morphologique,1,Alterations,6,447,2,QCU,0.17,0.87,81.8,80,18,98,97,80,17,1.01,82.47,Facile,Facile,0,Meme Difficulté,Pas Adapte,Marketing
2668,2017,Marketing,5,Construction Morphologique,1,Alterations,6,447,2,QCU,0.49,0.38,22.91,22,72,94,59,22,37,1.59,37.29,Difficile,Difficile,0,Meme Difficulté,Pas Adapte,Marketing
3779,2018,Marketing,5,Construction Morphologique,1,Alterations,6,447,2,QCM,0.15,0.9,70.36,61,25,86,69,61,8,1.25,88.41,Difficile,Facile,2,Beaucoup plus Facile,Adapte,Marketing
4890,2019,Marketing,5,Construction Morphologique,1,Alterations,6,447,2,QROC,0.04,0.65,70.36,56,24,80,71,56,15,1.13,78.87,Facile,Facile,0,Meme Difficulté,Adapte,Marketing
6001,2020,Marketing,5,Construction Morphologique,1,Alterations,6,447,2,QROC,0.16,0.45,70.36,58,24,82,77,58,19,1.06,75.32,Facile,Facile,0,Meme Difficulté,Adapte,Marketing
447,2015,Marketing,5,Construction Morphologique,1,Alterations,6,448,3,QCU,0.47,0.3,25.17,9,25,34,24,9,15,1.42,37.5,Difficile,Difficile,0,Meme Difficulté,Pas Adapte,Marketing
1558,2016,Marketing,5,Construction Morphologique,1,Alterations,6,448,3,QCU,0.56,0.29,31.91,12,27,39,24,12,12,1.62,50.0,Moyen,Difficile,-1,Plus Difficile,Pas Adapte,Marketing
2669,2017,Marketing,5,Construction Morphologique,1,Alterations,6,448,3,QCU,0.6,0.23,6.06,3,41,44,16,3,13,2.75,18.75,Moyen,Difficile,-1,Plus Difficile,Pas Adapte,Marketing
3780,2018,Marketing,5,Construction Morphologique,1,Alterations,6,448,3,QCU,0.5,0.2,6.33,2,36,38,15,2,13,2.53,13.33,Difficile,Difficile,0,Meme Difficulté,Pas Adapte,Marketing
4891,2019,Marketing,5,Construction Morphologique,1,Alterations,6,448,3,QCU,0.45,0.34,22.54,9,33,42,32,9,23,1.31,28.12,Difficile,Difficile,0,Meme Difficulté,Pas Adapte,Marketing
6002,2020,Marketing,5,Construction Morphologique,1,Alterations,6,448,3,QCU,0.7,0.23,13.58,5,31,36,14,5,9,2.57,35.71,Facile,Difficile,-2,Beaucoup plus Difficile,Pas Adapte,Marketing
448,2015,Marketing,5,Construction Morphologique,1,Alterations,6,449,4,QO,0.03,0.46,90.71,72,7,79,77,72,5,1.03,93.51,Difficile,Facile,2,Beaucoup plus Facile,Pas Adapte,Marketing
1559,2016,Marketing,5,Construction Morphologique,1,Alterations,6,449,4,QCU,0.2,0.91,92.84,84,7,91,85,84,1,1.07,98.82,Facile,Facile,0,Meme Difficulté,Pas Adapte,Marketing
2670,2017,Marketing,5,Construction Morphologique,1,Alterations,6,449,4,QCU,0.39,0.46,56.98,47,36,83,48,47,1,1.73,97.92,Difficile,Moyen,1,Plus Facile,Pas Adapte,Marketing
3781,2018,Marketing,5,Construction Morphologique,1,Alterations,6,449,4,QCU,0.37,0.71,49.67,46,46,92,77,46,31,1.19,59.74,Moyen,Moyen,0,Meme Difficulté,Pas Adapte,Marketing
4892,2019,Marketing,5,Construction Morphologique,1,Alterations,6,449,4,QCU,0.67,0.28,23.88,21,69,90,35,21,14,2.57,60.0,Difficile,Difficile,0,Meme Difficulté,Pas Adapte,Marketing
6003,2020,Marketing,5,Construction Morphologique,1,Alterations,6,449,4,QCU,0.39,0.41,39.87,36,54,90,83,36,47,1.08,43.37,Moyen,Moyen,0,Meme Difficulté,Pas Adapte,Marketing
449,2015,Marketing,5,Construction Morphologique,1,Alterations,6,450,5,QROC,0.02,0.52,96.25,39,2,41,39,39,0,1.05,100.0,Facile,Facile,0,Meme Difficulté,Pas Adapte,Marketing
1560,2016,Marketing,5,Construction Morphologique,1,Alterations,6,450,5,QROC,0.13,0.99,81.74,30,7,37,33,30,3,1.12,90.91,Difficile,Facile,2,Beaucoup plus Facile,Pas Adapte,Marketing
2671,2017,Marketing,5,Construction Morphologique,1,Alterations,6,450,5,QO,0.11,0.52,87.08,35,5,40,39,35,4,1.03,89.74,Facile,Facile,0,Meme Difficulté,Pas Adapte,Marketing
3782,2018,Marketing,5,Construction Morphologique,1,Alterations,6,450,5,QO,0.24,0.15,45.14,16,20,36,28,16,12,1.29,57.14,Difficile,Moyen,1,Plus Facile,Pas Adapte,Marketing
4893,2019,Marketing,5,Construction Morphologique,1,Alterations,6,450,5,QROC,0.1,0.75,99.39,36,0,36,36,36,0,1.0,100.0,Moyen,Facile,1,Plus Facile,Pas Adapte,Marketing
6004,2020,Marketing,5,Construction Morphologique,1,Alterations,6,450,5,QROC,0.17,0.84,82.69,27,6,33,29,27,2,1.14,93.1,Moyen,Facile,1,Plus Facile,Pas Adapte,Marketing
450,2015,Marketing,5,Construction Morphologique,1,Alterations,6,451,6,QCM,0.77,0.29,18.82,3,11,14,11,3,8,1.27,27.27,Difficile,Difficile,0,Meme Difficulté,Pas Adapte,Marketing
1561,2016,Marketing,5,Construction Morphologique,1,Alterations,6,451,6,QCM,0.7,0.26,29.96,5,11,16,14,5,9,1.14,35.71,Moyen,Difficile,-1,Plus Difficile,Pas Adapte,Marketing
2672,2017,Marketing,5,Construction Morphologique,1,Alterations,6,451,6,QCU,0.35,0.47,41.15,7,9,16,10,7,3,1.6,70.0,Facile,Moyen,-1,Plus Difficile,Pas Adapte,Marketing
3783,2018,Marketing,5,Construction Morphologique,1,Alterations,6,451,6,QO,0.58,0.25,57.47,9,7,16,11,9,2,1.45,81.82,Facile,Moyen,-1,Plus Difficile,Pas Adapte,Marketing
4894,2019,Marketing,5,Construction Morphologique,1,Alterations,6,451,6,QO,0.17,0.45,86.41,15,2,17,16,15,1,1.06,93.75,Moyen,Facile,1,Plus Facile,Pas Adapte,Marketing
6005,2020,Marketing,5,Construction Morphologique,1,Alterations,6,451,6,QO,0.02,0.54,88.46,14,2,16,15,14,1,1.07,93.33,Facile,Facile,0,Meme Difficulté,Pas Adapte,Marketing
451,2015,Marketing,5,Construction Morphologique,2,Transferts,7,452,1,QCU,0.35,0.45,63.07,45,26,71,63,45,18,1.13,71.43,Moyen,Moyen,0,Meme Difficulté,Adapte,Marketing
1562,2016,Marketing,5,Construction Morphologique,2,Transferts,7,452,1,QCU,0.31,0.58,63.07,38,22,60,39,38,1,1.54,97.44,Moyen,Moyen,0,Meme Difficulté,Adapte,Marketing
2673,2017,Marketing,5,Construction Morphologique,2,Transferts,7,452,1,QCU,0.34,0.59,63.07,44,25,69,45,44,1,1.53,97.78,Moyen,Moyen,0,Meme Difficulté,Adapte,Marketing
3784,2018,Marketing,5,Construction Morphologique,2,Transferts,7,452,1,QCM,0.29,0.68,63.07,39,23,62,62,39,23,1.0,62.9,Moyen,Moyen,0,Meme Difficulté,Adapte,Marketing
4895,2019,Marketing,5,Construction Morphologique,2,Transferts,7,452,1,QCM,0.48,0.51,63.07,39,23,62,46,39,7,1.35,84.78,Moyen,Moyen,0,Meme Difficulté,Adapte,Marketing
6006,2020,Marketing,5,Construction Morphologique,2,Transferts,7,452,1,QCU,0.28,0.55,63.07,42,25,67,66,42,24,1.02,63.64,Moyen,Moyen,0,Meme Difficulté,Adapte,Marketing
452,2015,Marketing,5,Construction Morphologique,2,Transferts,7,453,2,QCU,0.05,0.86,90.68,12,1,13,13,12,1,1.0,92.31,Difficile,Facile,2,Beaucoup plus Facile,Pas Adapte,Marketing
1563,2016,Marketing,5,Construction Morphologique,2,Transferts,7,453,2,QCU,0.51,0.35,17.8,2,10,12,12,2,10,1.0,16.67,Moyen,Difficile,-1,Plus Difficile,Pas Adapte,Marketing
2674,2017,Marketing,5,Construction Morphologique,2,Transferts,7,453,2,QCU,0.02,0.78,68.02,9,4,13,12,9,3,1.08,75.0,Difficile,Facile,2,Beaucoup plus Facile,Adapte,Marketing
3785,2018,Marketing,5,Construction Morphologique,2,Transferts,7,453,2,QCU,0.04,0.93,68.02,7,4,11,10,7,3,1.1,70.0,Facile,Facile,0,Meme Difficulté,Adapte,Marketing
4896,2019,Marketing,5,Construction Morphologique,2,Transferts,7,453,2,QO,0.01,0.81,68.02,7,3,10,7,7,0,1.43,100.0,Facile,Facile,0,Meme Difficulté,Adapte,Marketing
6007,2020,Marketing,5,Construction Morphologique,2,Transferts,7,453,2,QO,0.19,0.66,68.02,8,4,12,10,8,2,1.2,80.0,Facile,Facile,0,Meme Difficulté,Adapte,Marketing
453,2015,Marketing,5,Construction Morphologique,2,Transferts,7,454,3,QROC,0.11,0.47,97.55,40,1,41,40,40,0,1.02,100.0,Moyen,Facile,1,Plus Facile,Pas Adapte,Marketing
1564,2016,Marketing,5,Construction Morphologique,2,Transferts,7,454,3,QCU,0.27,0.51,46.96,18,21,39,23,18,5,1.7,78.26,Facile,Moyen,-1,Plus Difficile,Pas Adapte,Marketing
2675,2017,Marketing,5,Construction Morphologique,2,Transferts,7,454,3,QCU,0.13,0.88,88.6,35,4,39,36,35,1,1.08,97.22,Moyen,Facile,1,Plus Facile,Pas Adapte,Marketing
3786,2018,Marketing,5,Construction Morphologique,2,Transferts,7,454,3,QCU,0.14,0.82,68.25,25,11,36,29,25,4,1.24,86.21,Facile,Facile,0,Meme Difficulté,Adapte,Marketing
4897,2019,Marketing,5,Construction Morphologique,2,Transferts,7,454,3,QCU,0.11,0.84,68.25,22,10,32,30,22,8,1.07,73.33,Facile,Facile,0,Meme Difficulté,Adapte,Marketing
6008,2020,Marketing,5,Construction Morphologique,2,Transferts,7,454,3,QCU,0.04,0.76,68.25,19,9,28,21,19,2,1.33,90.48,Facile,Facile,0,Meme Difficulté,Adapte,Marketing
454,2015,Marketing,5,Construction Morphologique,2,Transferts,7,455,4,QCU,0.14,0.76,76.58,43,13,56,50,43,7,1.12,86.0,Difficile,Facile,2,Beaucoup plus Facile,Pas Adapte,Marketing
1565,2016,Marketing,5,Construction Morphologique,2,Transferts,7,455,4,QCU,0.34,0.58,43.39,26,35,61,41,26,15,1.49,63.41,Difficile,Moyen,1,Plus Facile,Pas Adapte,Marketing
2676,2017,Marketing,5,Construction Morphologique,2,Transferts,7,455,4,QCU,0.02,1.0,68.32,40,18,58,51,40,11,1.14,78.43,Facile,Facile,0,Meme Difficulté,Adapte,Marketing
3787,2018,Marketing,5,Construction Morphologique,2,Transferts,7,455,4,QCU,0.07,0.99,68.32,41,19,60,51,41,10,1.18,80.39,Facile,Facile,0,Meme Difficulté,Adapte,Marketing
4898,2019,Marketing,5,Construction Morphologique,2,Transferts,7,455,4,QCM,0.18,0.86,68.32,44,21,65,46,44,2,1.41,95.65,Facile,Facile,0,Meme Difficulté,Adapte,Marketing
6009,2020,Marketing,5,Construction Morphologique,2,Transferts,7,455,4,QROC,0.06,0.49,68.32,45,21,66,50,45,5,1.32,90.0,Facile,Facile,0,Meme Difficulté,Adapte,Marketing
455,2015,Marketing,5,Construction Morphologique,2,Transferts,7,456,5,QCM,0.21,0.4,51.92,50,46,96,51,50,1,1.88,98.04,Facile,Moyen,-1,Plus Difficile,Pas Adapte,Marketing
1566,2016,Marketing,5,Construction Morphologique,2,Transferts,7,456,5,QROC,0.2,0.28,55.97,51,40,91,64,51,13,1.42,79.69,Facile,Moyen,-1,Plus Difficile,Pas Adapte,Marketing
2677,2017,Marketing,5,Construction Morphologique,2,Transferts,7,456,5,QROC,0.11,0.92,88.59,69,9,78,72,69,3,1.08,95.83,Facile,Facile,0,Meme Difficulté,Pas Adapte,Marketing
3788,2018,Marketing,5,Construction Morphologique,2,Transferts,7,456,5,QO,0.22,0.25,63.36,43,25,68,59,43,16,1.15,72.88,Facile,Moyen,-1,Plus Difficile,Adapte,Marketing
4899,2019,Marketing,5,Construction Morphologique,2,Transferts,7,456,5,QROC,0.41,0.35,63.36,49,29,78,55,49,6,1.42,89.09,Moyen,Moyen,0,Meme Difficulté,Adapte,Marketing
6010,2020,Marketing,5,Construction Morphologique,2,Transferts,7,456,5,QROC,0.28,0.4,63.36,51,30,81,68,51,17,1.19,75.0,Moyen,Moyen,0,Meme Difficulté,Adapte,Marketing
456,2015,Marketing,5,Construction Morphologique,2,Transferts,7,457,6,QROC,0.55,0.33,42.57,10,13,23,15,10,5,1.53,66.67,Difficile,Moyen,1,Plus Facile,Pas Adapte,Marketing
1567,2016,Marketing,5,Construction Morphologique,2,Transferts,7,457,6,QROC,0.04,0.42,86.62,21,3,24,22,21,1,1.09,95.45,Difficile,Facile,2,Beaucoup plus Facile,Pas Adapte,Marketing
2678,2017,Marketing,5,Construction Morphologique,2,Transferts,7,457,6,QO,0.47,0.21,50.53,13,12,25,17,13,4,1.47,76.47,Moyen,Moyen,0,Meme Difficulté,Pas Adapte,Marketing
3789,2018,Marketing,5,Construction Morphologique,2,Transferts,7,457,6,QO,0.85,0.04,25.21,6,17,23,23,6,17,1.0,26.09,Moyen,Difficile,-1,Plus Difficile,Pas Adapte,Marketing
4900,2019,Marketing,5,Construction Morphologique,2,Transferts,7,457,6,QO,0.1,0.66,78.87,17,4,21,19,17,2,1.11,89.47,Moyen,Facile,1,Plus Facile,Pas Adapte,Marketing
6011,2020,Marketing,5,Construction Morphologique,2,Transferts,7,457,6,QO,0.88,0.04,25.17,5,14,19,13,5,8,1.46,38.46,Facile,Difficile,-2,Beaucoup plus Difficile,Pas Adapte,Marketing
457,2015,Marketing,5,Construction Morphologique,2,Transferts,7,458,7,QROC,0.37,0.3,54.16,44,37,81,47,44,3,1.72,93.62,Facile,Moyen,-1,Plus Difficile,Pas Adapte,Marketing
1568,2016,Marketing,5,Construction Morphologique,2,Transferts,7,458,7,QROC,0.25,0.34,59.09,54,37,91,73,54,19,1.25,73.97,Facile,Moyen,-1,Plus Difficile,Pas Adapte,Marketing
2679,2017,Marketing,5,Construction Morphologique,2,Transferts,7,458,7,QROC,0.61,0.21,25.72,25,74,99,67,25,42,1.48,37.31,Moyen,Difficile,-1,Plus Difficile,Pas Adapte,Marketing
3790,2018,Marketing,5,Construction Morphologique,2,Transferts,7,458,7,QROC,0.58,0.27,62.68,55,32,87,59,55,4,1.47,93.22,Moyen,Moyen,0,Meme Difficulté,Adapte,Marketing
4901,2019,Marketing,5,Construction Morphologique,2,Transferts,7,458,7,QROC,0.56,0.32,62.68,63,37,100,71,63,8,1.41,88.73,Moyen,Moyen,0,Meme Difficulté,Adapte,Marketing
6012,2020,Marketing,5,Construction Morphologique,2,Transferts,7,458,7,QROC,0.54,0.32,62.68,53,32,85,74,53,21,1.15,71.62,Moyen,Moyen,0,Meme Difficulté,Adapte,Marketing
458,2015,Marketing,5,Construction Morphologique,3,Sens Predictible et Atteste,2,459,1,QCU,0.35,0.65,35.79,21,38,59,32,21,11,1.84,65.62,Difficile,Moyen,1,Plus Facile,Pas Adapte,Marketing
1569,2016,Marketing,5,Construction Morphologique,3,Sens Predictible et Atteste,2,459,1,QCU,0.73,0.29,8.31,5,56,61,49,5,44,1.24,10.2,Facile,Difficile,-2,Beaucoup plus Difficile,Pas Adapte,Marketing
2680,2017,Marketing,5,Construction Morphologique,3,Sens Predictible et Atteste,2,459,1,QCM,0.73,0.21,27.98,18,46,64,42,18,24,1.52,42.86,Moyen,Difficile,-1,Plus Difficile,Pas Adapte,Marketing
3791,2018,Marketing,5,Construction Morphologique,3,Sens Predictible et Atteste,2,459,1,QCM,0.03,0.85,70.71,52,21,73,69,52,17,1.06,75.36,Facile,Facile,0,Meme Difficulté,Adapte,Marketing
4902,2019,Marketing,5,Construction Morphologique,3,Sens Predictible et Atteste,2,459,1,QCM,0.11,0.71,70.71,54,22,76,74,54,20,1.03,72.97,Facile,Facile,0,Meme Difficulté,Adapte,Marketing
6013,2020,Marketing,5,Construction Morphologique,3,Sens Predictible et Atteste,2,459,1,QCM,0.1,0.9,70.71,57,23,80,69,57,12,1.16,82.61,Facile,Facile,0,Meme Difficulté,Adapte,Marketing
459,2015,Marketing,5,Construction Morphologique,3,Sens Predictible et Atteste,2,460,2,QCM,0.2,0.4,43.4,23,30,53,46,23,23,1.15,50.0,Moyen,Moyen,0,Meme Difficulté,Pas Adapte,Marketing
1570,2016,Marketing,5,Construction Morphologique,3,Sens Predictible et Atteste,2,460,2,QCM,0.21,0.31,61.95,30,18,48,32,30,2,1.5,93.75,Difficile,Moyen,1,Plus Facile,Adapte,Marketing
2681,2017,Marketing,5,Construction Morphologique,3,Sens Predictible et Atteste,2,460,2,QCM,0.49,0.57,61.95,32,20,52,48,32,16,1.08,66.67,Moyen,Moyen,0,Meme Difficulté,Adapte,Marketing
3792,2018,Marketing,5,Construction Morphologique,3,Sens Predictible et Atteste,2,460,2,QCM,0.27,0.52,61.95,27,17,44,30,27,3,1.47,90.0,Moyen,Moyen,0,Meme Difficulté,Adapte,Marketing
4903,2019,Marketing,5,Construction Morphologique,3,Sens Predictible et Atteste,2,460,2,QCM,0.5,0.56,61.95,26,16,42,34,26,8,1.24,76.47,Moyen,Moyen,0,Meme Difficulté,Adapte,Marketing
6014,2020,Marketing,5,Construction Morphologique,3,Sens Predictible et Atteste,2,460,2,QCM,0.28,0.39,61.95,30,18,48,39,30,9,1.23,76.92,Moyen,Moyen,0,Meme Difficulté,Adapte,Marketing
460,2015,Informatique,1,Generalites sur les Systeme Informatiques,1,Definitions et Vocabulaire de Base,6,461,1,QROC,0.05,1.0,95.0,26,1,27,27,26,1,1.0,96.3,Difficile,Facile,2,Beaucoup plus Facile,Pas Adapte,Computer Science
1571,2016,Informatique,1,Generalites sur les Systeme Informatiques,1,Definitions et Vocabulaire de Base,6,461,1,QROC,0.63,0.12,29.99,9,22,31,29,9,20,1.07,31.03,Difficile,Difficile,0,Meme Difficulté,Pas Adapte,Computer Science
2682,2017,Informatique,1,Generalites sur les Systeme Informatiques,1,Definitions et Vocabulaire de Base,6,461,1,QROC,0.75,0.12,25.27,7,22,29,12,7,5,2.42,58.33,Facile,Difficile,-2,Beaucoup plus Difficile,Pas Adapte,Computer Science
3793,2018,Informatique,1,Generalites sur les Systeme Informatiques,1,Definitions et Vocabulaire de Base,6,461,1,QO,0.44,0.2,63.63,18,10,28,24,18,6,1.17,75.0,Facile,Moyen,-1,Plus Difficile,Adapte,Computer Science
4904,2019,Informatique,1,Generalites sur les Systeme Informatiques,1,Definitions et Vocabulaire de Base,6,461,1,QO,0.39,0.2,63.63,16,9,25,25,16,9,1.0,64.0,Moyen,Moyen,0,Meme Difficulté,Adapte,Computer Science
6015,2020,Informatique,1,Generalites sur les Systeme Informatiques,1,Definitions et Vocabulaire de Base,6,461,1,QO,0.63,0.24,63.63,13,8,21,18,13,5,1.17,72.22,Moyen,Moyen,0,Meme Difficulté,Adapte,Computer Science
461,2015,Informatique,1,Generalites sur les Systeme Informatiques,1,Definitions et Vocabulaire de Base,6,462,2,QCU,0.15,0.8,75.19,17,5,22,19,17,2,1.16,89.47,Moyen,Facile,1,Plus Facile,Pas Adapte,Computer Science
1572,2016,Informatique,1,Generalites sur les Systeme Informatiques,1,Definitions et Vocabulaire de Base,6,462,2,QCU,0.32,0.7,61.75,15,9,24,19,15,4,1.26,78.95,Facile,Moyen,-1,Plus Difficile,Adapte,Computer Science
2683,2017,Informatique,1,Generalites sur les Systeme Informatiques,1,Definitions et Vocabulaire de Base,6,462,2,QCU,0.33,0.58,61.75,16,10,26,26,16,10,1.0,61.54,Moyen,Moyen,0,Meme Difficulté,Adapte,Computer Science
3794,2018,Informatique,1,Generalites sur les Systeme Informatiques,1,Definitions et Vocabulaire de Base,6,462,2,QCU,0.29,0.68,61.75,14,8,22,20,14,6,1.1,70.0,Moyen,Moyen,0,Meme Difficulté,Adapte,Computer Science
4905,2019,Informatique,1,Generalites sur les Systeme Informatiques,1,Definitions et Vocabulaire de Base,6,462,2,QCU,0.26,0.64,61.75,12,8,20,12,12,0,1.67,100.0,Moyen,Moyen,0,Meme Difficulté,Adapte,Computer Science
6016,2020,Informatique,1,Generalites sur les Systeme Informatiques,1,Definitions et Vocabulaire de Base,6,462,2,QCU,0.29,0.45,61.75,10,7,17,13,10,3,1.31,76.92,Moyen,Moyen,0,Meme Difficulté,Adapte,Computer Science
462,2015,Informatique,1,Generalites sur les Systeme Informatiques,1,Definitions et Vocabulaire de Base,6,463,3,QROC,0.17,0.46,80.5,11,3,14,13,11,2,1.08,84.62,Facile,Facile,0,Meme Difficulté,Pas Adapte,Computer Science
1573,2016,Informatique,1,Generalites sur les Systeme Informatiques,1,Definitions et Vocabulaire de Base,6,463,3,QROC,0.07,0.83,76.53,11,3,14,11,11,0,1.27,100.0,Facile,Facile,0,Meme Difficulté,Pas Adapte,Computer Science
2684,2017,Informatique,1,Generalites sur les Systeme Informatiques,1,Definitions et Vocabulaire de Base,6,463,3,QROC,0.9,0.03,2.18,0,14,14,11,0,11,1.27,0.0,Difficile,Difficile,0,Meme Difficulté,Pas Adapte,Computer Science
3795,2018,Informatique,1,Generalites sur les Systeme Informatiques,1,Definitions et Vocabulaire de Base,6,463,3,QCU,0.1,0.94,71.99,9,4,13,10,9,1,1.3,90.0,Facile,Facile,0,Meme Difficulté,Adapte,Computer Science
4906,2019,Informatique,1,Generalites sur les Systeme Informatiques,1,Definitions et Vocabulaire de Base,6,463,3,QCU,0.19,0.99,71.99,11,4,15,14,11,3,1.07,78.57,Facile,Facile,0,Meme Difficulté,Adapte,Computer Science
6017,2020,Informatique,1,Generalites sur les Systeme Informatiques,1,Definitions et Vocabulaire de Base,6,463,3,QCU,0.11,0.79,71.99,10,4,14,13,10,3,1.08,76.92,Facile,Facile,0,Meme Difficulté,Adapte,Computer Science
463,2015,Informatique,1,Generalites sur les Systeme Informatiques,1,Definitions et Vocabulaire de Base,6,464,4,QCU,0.18,0.92,84.97,54,10,64,60,54,6,1.07,90.0,Moyen,Facile,1,Plus Facile,Pas Adapte,Computer Science
1574,2016,Informatique,1,Generalites sur les Systeme Informatiques,1,Definitions et Vocabulaire de Base,6,464,4,QCU,0.07,0.86,93.46,53,4,57,55,53,2,1.04,96.36,Moyen,Facile,1,Plus Facile,Pas Adapte,Computer Science
2685,2017,Informatique,1,Generalites sur les Systeme Informatiques,1,Definitions et Vocabulaire de Base,6,464,4,QCU,0.4,0.25,7.52,5,58,63,41,5,36,1.54,12.2,Difficile,Difficile,0,Meme Difficulté,Pas Adapte,Computer Science
3796,2018,Informatique,1,Generalites sur les Systeme Informatiques,1,Definitions et Vocabulaire de Base,6,464,4,QROC,0.84,0.23,16.92,9,46,55,23,9,14,2.39,39.13,Moyen,Difficile,-1,Plus Difficile,Pas Adapte,Computer Science
4907,2019,Informatique,1,Generalites sur les Systeme Informatiques,1,Definitions et Vocabulaire de Base,6,464,4,QROC,0.15,0.95,95.1,60,3,63,62,60,2,1.02,96.77,Facile,Facile,0,Meme Difficulté,Pas Adapte,Computer Science
6018,2020,Informatique,1,Generalites sur les Systeme Informatiques,1,Definitions et Vocabulaire de Base,6,464,4,QO,0.91,0.06,31.02,20,45,65,50,20,30,1.3,40.0,Moyen,Difficile,-1,Plus Difficile,Pas Adapte,Computer Science
464,2015,Informatique,1,Generalites sur les Systeme Informatiques,1,Definitions et Vocabulaire de Base,6,465,5,QCU,0.18,0.83,83.53,43,8,51,51,43,8,1.0,84.31,Moyen,Facile,1,Plus Facile,Pas Adapte,Computer Science
1575,2016,Informatique,1,Generalites sur les Systeme Informatiques,1,Definitions et Vocabulaire de Base,6,465,5,QCU,0.23,0.51,51.93,23,22,45,35,23,12,1.29,65.71,Moyen,Moyen,0,Meme Difficulté,Pas Adapte,Computer Science
2686,2017,Informatique,1,Generalites sur les Systeme Informatiques,1,Definitions et Vocabulaire de Base,6,465,5,QCU,0.04,0.86,98.78,48,1,49,48,48,0,1.02,100.0,Facile,Facile,0,Meme Difficulté,Pas Adapte,Computer Science
3797,2018,Informatique,1,Generalites sur les Systeme Informatiques,1,Definitions et Vocabulaire de Base,6,465,5,QCU,0.65,0.37,19.26,9,39,48,23,9,14,2.09,39.13,Facile,Difficile,-2,Beaucoup plus Difficile,Pas Adapte,Computer Science
4908,2019,Informatique,1,Generalites sur les Systeme Informatiques,1,Definitions et Vocabulaire de Base,6,465,5,QCU,0.14,0.85,71.85,34,14,48,42,34,8,1.14,80.95,Facile,Facile,0,Meme Difficulté,Adapte,Computer Science
6019,2020,Informatique,1,Generalites sur les Systeme Informatiques,1,Definitions et Vocabulaire de Base,6,465,5,QCU,0.18,0.99,71.85,34,14,48,39,34,5,1.23,87.18,Facile,Facile,0,Meme Difficulté,Adapte,Computer Science
465,2015,Informatique,1,Generalites sur les Systeme Informatiques,1,Definitions et Vocabulaire de Base,6,466,6,QCU,0.07,1.0,97.81,97,2,99,98,97,1,1.01,98.98,Difficile,Facile,2,Beaucoup plus Facile,Pas Adapte,Computer Science
1576,2016,Informatique,1,Generalites sur les Systeme Informatiques,1,Definitions et Vocabulaire de Base,6,466,6,QCU,0.54,0.35,8.24,9,97,106,77,9,68,1.38,11.69,Moyen,Difficile,-1,Plus Difficile,Pas Adapte,Computer Science
2687,2017,Informatique,1,Generalites sur les Systeme Informatiques,1,Definitions et Vocabulaire de Base,6,466,6,QCU,0.11,0.96,75.33,76,25,101,92,76,16,1.1,82.61,Facile,Facile,0,Meme Difficulté,Pas Adapte,Computer Science
3798,2018,Informatique,1,Generalites sur les Systeme Informatiques,1,Definitions et Vocabulaire de Base,6,466,6,QCU,0.66,0.22,29.15,26,63,89,70,26,44,1.27,37.14,Facile,Difficile,-2,Beaucoup plus Difficile,Pas Adapte,Computer Science
4909,2019,Informatique,1,Generalites sur les Systeme Informatiques,1,Definitions et Vocabulaire de Base,6,466,6,QCU,0.28,0.61,43.96,35,44,79,41,35,6,1.93,85.37,Difficile,Moyen,1,Plus Facile,Pas Adapte,Computer Science
6020,2020,Informatique,1,Generalites sur les Systeme Informatiques,1,Definitions et Vocabulaire de Base,6,466,6,QCM,0.1,0.99,86.22,75,12,87,82,75,7,1.06,91.46,Difficile,Facile,2,Beaucoup plus Facile,Pas Adapte,Computer Science
466,2015,Informatique,1,Generalites sur les Systeme Informatiques,2,Structure de l'Ordinateur,7,467,1,QCM,0.28,0.64,51.06,36,35,71,68,36,32,1.04,52.94,Difficile,Moyen,1,Plus Facile,Pas Adapte,Computer Science
1577,2016,Informatique,1,Generalites sur les Systeme Informatiques,2,Structure de l'Ordinateur,7,467,1,QCM,0.59,0.19,30.93,20,46,66,32,20,12,2.06,62.5,Facile,Difficile,-2,Beaucoup plus Difficile,Pas Adapte,Computer Science
2688,2017,Informatique,1,Generalites sur les Systeme Informatiques,2,Structure de l'Ordinateur,7,467,1,QCM,0.07,0.89,79.6,48,12,60,52,48,4,1.15,92.31,Moyen,Facile,1,Plus Facile,Pas Adapte,Computer Science
3799,2018,Informatique,1,Generalites sur les Systeme Informatiques,2,Structure de l'Ordinateur,7,467,1,QCM,0.39,0.62,59.06,38,27,65,57,38,19,1.14,66.67,Facile,Moyen,-1,Plus Difficile,Pas Adapte,Computer Science
4910,2019,Informatique,1,Generalites sur les Systeme Informatiques,2,Structure de l'Ordinateur,7,467,1,QCM,0.45,0.37,39.36,23,35,58,36,23,13,1.61,63.89,Moyen,Moyen,0,Meme Difficulté,Pas Adapte,Computer Science
6021,2020,Informatique,1,Generalites sur les Systeme Informatiques,2,Structure de l'Ordinateur,7,467,1,QCM,0.3,0.54,43.23,28,36,64,62,28,34,1.03,45.16,Facile,Moyen,-1,Plus Difficile,Pas Adapte,Computer Science
467,2015,Informatique,1,Generalites sur les Systeme Informatiques,2,Structure de l'Ordinateur,7,468,2,QCU,0.06,0.82,88.06,52,7,59,57,52,5,1.04,91.23,Difficile,Facile,2,Beaucoup plus Facile,Pas Adapte,Computer Science
1578,2016,Informatique,1,Generalites sur les Systeme Informatiques,2,Structure de l'Ordinateur,7,468,2,QCU,0.27,0.5,52.72,30,26,56,38,30,8,1.47,78.95,Moyen,Moyen,0,Meme Difficulté,Pas Adapte,Computer Science
2689,2017,Informatique,1,Generalites sur les Systeme Informatiques,2,Structure de l'Ordinateur,7,468,2,QROC,0.7,0.17,25.63,15,44,59,56,15,41,1.05,26.79,Facile,Difficile,-2,Beaucoup plus Difficile,Pas Adapte,Computer Science
3800,2018,Informatique,1,Generalites sur les Systeme Informatiques,2,Structure de l'Ordinateur,7,468,2,QROC,0.04,0.7,71.82,39,15,54,47,39,8,1.15,82.98,Facile,Facile,0,Meme Difficulté,Adapte,Computer Science
4911,2019,Informatique,1,Generalites sur les Systeme Informatiques,2,Structure de l'Ordinateur,7,468,2,QROC,0.15,0.78,71.82,42,17,59,43,42,1,1.37,97.67,Facile,Facile,0,Meme Difficulté,Adapte,Computer Science
6022,2020,Informatique,1,Generalites sur les Systeme Informatiques,2,Structure de l'Ordinateur,7,468,2,QROC,0.18,0.55,71.82,45,17,62,56,45,11,1.11,80.36,Facile,Facile,0,Meme Difficulté,Adapte,Computer Science
468,2015,Informatique,1,Generalites sur les Systeme Informatiques,2,Structure de l'Ordinateur,7,469,3,QCU,0.23,0.47,38.07,28,45,73,55,28,27,1.33,50.91,Facile,Moyen,-1,Plus Difficile,Pas Adapte,Computer Science
1579,2016,Informatique,1,Generalites sur les Systeme Informatiques,2,Structure de l'Ordinateur,7,469,3,QCU,0.09,0.92,79.88,59,15,74,61,59,2,1.21,96.72,Moyen,Facile,1,Plus Facile,Pas Adapte,Computer Science
2690,2017,Informatique,1,Generalites sur les Systeme Informatiques,2,Structure de l'Ordinateur,7,469,3,QCU,0.17,0.9,85.76,69,11,80,71,69,2,1.13,97.18,Difficile,Facile,2,Beaucoup plus Facile,Pas Adapte,Computer Science
3801,2018,Informatique,1,Generalites sur les Systeme Informatiques,2,Structure de l'Ordinateur,7,469,3,QCU,0.6,0.23,4.51,4,85,89,40,4,36,2.23,10.0,Facile,Difficile,-2,Beaucoup plus Difficile,Pas Adapte,Computer Science
4912,2019,Informatique,1,Generalites sur les Systeme Informatiques,2,Structure de l'Ordinateur,7,469,3,QCU,0.13,0.84,83.42,82,16,98,86,82,4,1.14,95.35,Moyen,Facile,1,Plus Facile,Pas Adapte,Computer Science
6023,2020,Informatique,1,Generalites sur les Systeme Informatiques,2,Structure de l'Ordinateur,7,469,3,QCM,0.15,0.78,72.02,61,24,85,81,61,20,1.05,75.31,Facile,Facile,0,Meme Difficulté,Adapte,Computer Science
469,2015,Informatique,1,Generalites sur les Systeme Informatiques,2,Structure de l'Ordinateur,7,470,4,QCU,0.59,0.29,10.09,2,14,16,11,2,9,1.45,18.18,Facile,Difficile,-2,Beaucoup plus Difficile,Pas Adapte,Computer Science
1580,2016,Informatique,1,Generalites sur les Systeme Informatiques,2,Structure de l'Ordinateur,7,470,4,QCU,0.7,0.27,16.19,3,14,17,11,3,8,1.55,27.27,Difficile,Difficile,0,Meme Difficulté,Pas Adapte,Computer Science
2691,2017,Informatique,1,Generalites sur les Systeme Informatiques,2,Structure de l'Ordinateur,7,470,4,QROC,0.96,0.21,19.41,3,15,18,12,3,9,1.5,25.0,Moyen,Difficile,-1,Plus Difficile,Pas Adapte,Computer Science
3802,2018,Informatique,1,Generalites sur les Systeme Informatiques,2,Structure de l'Ordinateur,7,470,4,QROC,0.22,0.31,45.64,7,8,15,13,7,6,1.15,53.85,Facile,Moyen,-1,Plus Difficile,Pas Adapte,Computer Science
4913,2019,Informatique,1,Generalites sur les Systeme Informatiques,2,Structure de l'Ordinateur,7,470,4,QROC,0.09,0.87,99.66,15,0,15,15,15,0,1.0,100.0,Moyen,Facile,1,Plus Facile,Pas Adapte,Computer Science
6024,2020,Informatique,1,Generalites sur les Systeme Informatiques,2,Structure de l'Ordinateur,7,470,4,QROC,0.21,0.35,53.36,9,7,16,14,9,5,1.14,64.29,Difficile,Moyen,1,Plus Facile,Pas Adapte,Computer Science
470,2015,Informatique,1,Generalites sur les Systeme Informatiques,2,Structure de l'Ordinateur,7,471,5,QCU,0.38,0.68,51.45,30,28,58,44,30,14,1.32,68.18,Difficile,Moyen,1,Plus Facile,Pas Adapte,Computer Science
1581,2016,Informatique,1,Generalites sur les Systeme Informatiques,2,Structure de l'Ordinateur,7,471,5,QROC,0.03,0.84,95.74,52,2,54,53,52,1,1.02,98.11,Facile,Facile,0,Meme Difficulté,Pas Adapte,Computer Science
2692,2017,Informatique,1,Generalites sur les Systeme Informatiques,2,Structure de l'Ordinateur,7,471,5,QROC,0.72,0.15,34.64,18,33,51,28,18,10,1.82,64.29,Moyen,Difficile,-1,Plus Difficile,Pas Adapte,Computer Science
3803,2018,Informatique,1,Generalites sur les Systeme Informatiques,2,Structure de l'Ordinateur,7,471,5,QROC,0.99,0.07,12.17,7,48,55,23,7,16,2.39,30.43,Moyen,Difficile,-1,Plus Difficile,Pas Adapte,Computer Science
4914,2019,Informatique,1,Generalites sur les Systeme Informatiques,2,Structure de l'Ordinateur,7,471,5,QROC,0.11,0.93,97.83,59,1,60,60,59,1,1.0,98.33,Difficile,Facile,2,Beaucoup plus Facile,Pas Adapte,Computer Science
6025,2020,Informatique,1,Generalites sur les Systeme Informatiques,2,Structure de l'Ordinateur,7,471,5,QROC,0.11,0.46,71.73,44,17,61,53,44,9,1.15,83.02,Moyen,Facile,1,Plus Facile,Adapte,Computer Science
471,2015,Informatique,1,Generalites sur les Systeme Informatiques,2,Structure de l'Ordinateur,7,472,6,QCU,0.07,0.9,94.44,37,2,39,38,37,1,1.03,97.37,Moyen,Facile,1,Plus Facile,Pas Adapte,Computer Science
1582,2016,Informatique,1,Generalites sur les Systeme Informatiques,2,Structure de l'Ordinateur,7,472,6,QCU,0.35,0.53,58.4,22,15,37,32,22,10,1.16,68.75,Difficile,Moyen,1,Plus Facile,Pas Adapte,Computer Science
2693,2017,Informatique,1,Generalites sur les Systeme Informatiques,2,Structure de l'Ordinateur,7,472,6,QCU,0.06,0.82,84.73,29,5,34,33,29,4,1.03,87.88,Facile,Facile,0,Meme Difficulté,Pas Adapte,Computer Science
3804,2018,Informatique,1,Generalites sur les Systeme Informatiques,2,Structure de l'Ordinateur,7,472,6,QCU,0.14,0.93,80.96,30,7,37,35,30,5,1.06,85.71,Difficile,Facile,2,Beaucoup plus Facile,Pas Adapte,Computer Science
4915,2019,Informatique,1,Generalites sur les Systeme Informatiques,2,Structure de l'Ordinateur,7,472,6,QCU,0.28,0.62,35.26,13,25,38,24,13,11,1.58,54.17,Difficile,Moyen,1,Plus Facile,Pas Adapte,Computer Science
6026,2020,Informatique,1,Generalites sur les Systeme Informatiques,2,Structure de l'Ordinateur,7,472,6,QCU,0.42,0.22,23.04,10,33,43,39,10,29,1.1,25.64,Moyen,Difficile,-1,Plus Difficile,Pas Adapte,Computer Science
472,2015,Informatique,1,Generalites sur les Systeme Informatiques,2,Structure de l'Ordinateur,7,473,7,QROC,0.49,0.34,44.03,22,28,50,34,22,12,1.47,64.71,Facile,Moyen,-1,Plus Difficile,Pas Adapte,Computer Science
1583,2016,Informatique,1,Generalites sur les Systeme Informatiques,2,Structure de l'Ordinateur,7,473,7,QROC,0.61,0.16,7.77,4,48,52,26,4,22,2.0,15.38,Facile,Difficile,-2,Beaucoup plus Difficile,Pas Adapte,Computer Science
2694,2017,Informatique,1,Generalites sur les Systeme Informatiques,2,Structure de l'Ordinateur,7,473,7,QROC,0.61,0.0,11.97,6,41,47,41,6,35,1.15,14.63,Difficile,Difficile,0,Meme Difficulté,Pas Adapte,Computer Science
3805,2018,Informatique,1,Generalites sur les Systeme Informatiques,2,Structure de l'Ordinateur,7,473,7,QROC,0.43,0.36,49.93,20,20,40,30,20,10,1.33,66.67,Facile,Moyen,-1,Plus Difficile,Pas Adapte,Computer Science
4916,2019,Informatique,1,Generalites sur les Systeme Informatiques,2,Structure de l'Ordinateur,7,473,7,QROC,0.13,0.59,90.86,34,3,37,36,34,2,1.03,94.44,Difficile,Facile,2,Beaucoup plus Facile,Pas Adapte,Computer Science
6027,2020,Informatique,1,Generalites sur les Systeme Informatiques,2,Structure de l'Ordinateur,7,473,7,QROC,0.16,0.9,68.19,29,14,43,41,29,12,1.05,70.73,Moyen,Facile,1,Plus Facile,Adapte,Computer Science
473,2015,Informatique,1,Generalites sur les Systeme Informatiques,3,Logiciels et Domaines d'Applicationd de l'Informatique,5,474,1,QCM,0.1,0.77,86.22,12,2,14,13,12,1,1.08,92.31,Difficile,Facile,2,Beaucoup plus Facile,Pas Adapte,Computer Science
1584,2016,Informatique,1,Generalites sur les Systeme Informatiques,3,Logiciels et Domaines d'Applicationd de l'Informatique,5,474,1,QCM,0.58,0.26,1.09,0,14,14,7,0,7,2.0,0.0,Facile,Difficile,-2,Beaucoup plus Difficile,Pas Adapte,Computer Science
2695,2017,Informatique,1,Generalites sur les Systeme Informatiques,3,Logiciels et Domaines d'Applicationd de l'Informatique,5,474,1,QCM,0.75,0.21,24.03,3,9,12,8,3,5,1.5,37.5,Difficile,Difficile,0,Meme Difficulté,Pas Adapte,Computer Science
3806,2018,Informatique,1,Generalites sur les Systeme Informatiques,3,Logiciels et Domaines d'Applicationd de l'Informatique,5,474,1,QCM,0.11,0.89,75.71,8,2,10,8,8,0,1.25,100.0,Moyen,Facile,1,Plus Facile,Pas Adapte,Computer Science
4917,2019,Informatique,1,Generalites sur les Systeme Informatiques,3,Logiciels et Domaines d'Applicationd de l'Informatique,5,474,1,QCM,0.28,0.38,42.03,5,6,11,10,5,5,1.1,50.0,Difficile,Moyen,1,Plus Facile,Pas Adapte,Computer Science
6028,2020,Informatique,1,Generalites sur les Systeme Informatiques,3,Logiciels et Domaines d'Applicationd de l'Informatique,5,474,1,QCM,0.65,0.26,31.73,4,9,13,11,4,7,1.18,36.36,Facile,Difficile,-2,Beaucoup plus Difficile,Pas Adapte,Computer Science
474,2015,Informatique,1,Generalites sur les Systeme Informatiques,3,Logiciels et Domaines d'Applicationd de l'Informatique,5,475,2,QCM,0.46,0.49,42.83,37,50,87,41,37,4,2.12,90.24,Moyen,Moyen,0,Meme Difficulté,Pas Adapte,Computer Science
1585,2016,Informatique,1,Generalites sur les Systeme Informatiques,3,Logiciels et Domaines d'Applicationd de l'Informatique,5,475,2,QCM,0.39,0.43,39.6,36,55,91,59,36,23,1.54,61.02,Facile,Moyen,-1,Plus Difficile,Pas Adapte,Computer Science
2696,2017,Informatique,1,Generalites sur les Systeme Informatiques,3,Logiciels et Domaines d'Applicationd de l'Informatique,5,475,2,QCM,0.33,0.43,63.15,59,35,94,67,59,8,1.4,88.06,Difficile,Moyen,1,Plus Facile,Adapte,Computer Science
3807,2018,Informatique,1,Generalites sur les Systeme Informatiques,3,Logiciels et Domaines d'Applicationd de l'Informatique,5,475,2,QCM,0.44,0.53,63.15,57,34,91,68,57,11,1.34,83.82,Moyen,Moyen,0,Meme Difficulté,Adapte,Computer Science
4918,2019,Informatique,1,Generalites sur les Systeme Informatiques,3,Logiciels et Domaines d'Applicationd de l'Informatique,5,475,2,QCM,0.27,0.62,63.15,51,30,81,76,51,25,1.07,67.11,Moyen,Moyen,0,Meme Difficulté,Adapte,Computer Science
6029,2020,Informatique,1,Generalites sur les Systeme Informatiques,3,Logiciels et Domaines d'Applicationd de l'Informatique,5,475,2,QCM,0.32,0.57,63.15,49,28,77,72,49,23,1.07,68.06,Moyen,Moyen,0,Meme Difficulté,Adapte,Computer Science
475,2015,Informatique,1,Generalites sur les Systeme Informatiques,3,Logiciels et Domaines d'Applicationd de l'Informatique,5,476,3,QROC,0.03,0.57,79.92,68,17,85,78,68,10,1.09,87.18,Facile,Facile,0,Meme Difficulté,Pas Adapte,Computer Science
1586,2016,Informatique,1,Generalites sur les Systeme Informatiques,3,Logiciels et Domaines d'Applicationd de l'Informatique,5,476,3,QROC,0.12,0.97,88.8,71,9,80,77,71,6,1.04,92.21,Difficile,Facile,2,Beaucoup plus Facile,Pas Adapte,Computer Science
2697,2017,Informatique,1,Generalites sur les Systeme Informatiques,3,Logiciels et Domaines d'Applicationd de l'Informatique,5,476,3,QROC,0.0,0.95,86.6,72,11,83,77,72,5,1.08,93.51,Facile,Facile,0,Meme Difficulté,Pas Adapte,Computer Science
3808,2018,Informatique,1,Generalites sur les Systeme Informatiques,3,Logiciels et Domaines d'Applicationd de l'Informatique,5,476,3,QROC,0.76,0.13,18.71,14,63,77,55,14,41,1.4,25.45,Facile,Difficile,-2,Beaucoup plus Difficile,Pas Adapte,Computer Science
4919,2019,Informatique,1,Generalites sur les Systeme Informatiques,3,Logiciels et Domaines d'Applicationd de l'Informatique,5,476,3,QROC,0.08,0.88,69.22,59,26,85,73,59,14,1.16,80.82,Moyen,Facile,1,Plus Facile,Adapte,Computer Science
6030,2020,Informatique,1,Generalites sur les Systeme Informatiques,3,Logiciels et Domaines d'Applicationd de l'Informatique,5,476,3,QROC,0.12,0.88,69.22,66,30,96,73,66,7,1.32,90.41,Facile,Facile,0,Meme Difficulté,Adapte,Computer Science
476,2015,Informatique,1,Generalites sur les Systeme Informatiques,3,Logiciels et Domaines d'Applicationd de l'Informatique,5,477,4,QCM,0.51,0.25,21.33,8,30,38,38,8,30,1.0,21.05,Difficile,Difficile,0,Meme Difficulté,Pas Adapte,Computer Science
1587,2016,Informatique,1,Generalites sur les Systeme Informatiques,3,Logiciels et Domaines d'Applicationd de l'Informatique,5,477,4,QCM,0.59,0.24,30.15,13,29,42,22,13,9,1.91,59.09,Facile,Difficile,-2,Beaucoup plus Difficile,Pas Adapte,Computer Science
2698,2017,Informatique,1,Generalites sur les Systeme Informatiques,3,Logiciels et Domaines d'Applicationd de l'Informatique,5,477,4,QCM,0.77,0.19,18.31,8,36,44,28,8,20,1.57,28.57,Difficile,Difficile,0,Meme Difficulté,Pas Adapte,Computer Science
3809,2018,Informatique,1,Generalites sur les Systeme Informatiques,3,Logiciels et Domaines d'Applicationd de l'Informatique,5,477,4,QCM,0.28,0.4,55.2,26,21,47,34,26,8,1.38,76.47,Difficile,Moyen,1,Plus Facile,Pas Adapte,Computer Science
4920,2019,Informatique,1,Generalites sur les Systeme Informatiques,3,Logiciels et Domaines d'Applicationd de l'Informatique,5,477,4,QCM,0.68,0.22,23.09,10,34,44,37,10,27,1.19,27.03,Facile,Difficile,-2,Beaucoup plus Difficile,Pas Adapte,Computer Science
6031,2020,Informatique,1,Generalites sur les Systeme Informatiques,3,Logiciels et Domaines d'Applicationd de l'Informatique,5,477,4,QO,0.96,0.15,4.17,2,42,44,27,2,25,1.63,7.41,Difficile,Difficile,0,Meme Difficulté,Pas Adapte,Computer Science
477,2015,Informatique,1,Generalites sur les Systeme Informatiques,3,Logiciels et Domaines d'Applicationd de l'Informatique,5,478,5,QCU,0.56,0.27,13.59,1,6,7,4,1,3,1.75,25.0,Facile,Difficile,-2,Beaucoup plus Difficile,Pas Adapte,Computer Science
1588,2016,Informatique,1,Generalites sur les Systeme Informatiques,3,Logiciels et Domaines d'Applicationd de l'Informatique,5,478,5,QCU,0.57,0.36,6.39,0,7,7,4,0,4,1.75,0.0,Difficile,Difficile,0,Meme Difficulté,Pas Adapte,Computer Science
2699,2017,Informatique,1,Generalites sur les Systeme Informatiques,3,Logiciels et Domaines d'Applicationd de l'Informatique,5,478,5,QCU,0.36,0.46,55.17,3,3,6,4,3,1,1.5,75.0,Facile,Moyen,-1,Plus Difficile,Pas Adapte,Computer Science
3810,2018,Informatique,1,Generalites sur les Systeme Informatiques,3,Logiciels et Domaines d'Applicationd de l'Informatique,5,478,5,QCM,0.46,0.51,47.02,3,3,6,6,3,3,1.0,50.0,Facile,Moyen,-1,Plus Difficile,Pas Adapte,Computer Science
4921,2019,Informatique,1,Generalites sur les Systeme Informatiques,3,Logiciels et Domaines d'Applicationd de l'Informatique,5,478,5,QCM,0.56,0.18,6.64,0,7,7,6,0,6,1.17,0.0,Moyen,Difficile,-1,Plus Difficile,Pas Adapte,Computer Science
6032,2020,Informatique,1,Generalites sur les Systeme Informatiques,3,Logiciels et Domaines d'Applicationd de l'Informatique,5,478,5,QCM,0.18,0.74,69.44,5,2,7,5,5,0,1.4,100.0,Difficile,Facile,2,Beaucoup plus Facile,Adapte,Computer Science
478,2015,Informatique,2,Les Logiciels,1,Systeme d'Exploitation,5,479,1,QCM,0.18,0.84,99.71,63,0,63,63,63,0,1.0,100.0,Difficile,Facile,2,Beaucoup plus Facile,Pas Adapte,Computer Science
1589,2016,Informatique,2,Les Logiciels,1,Systeme d'Exploitation,5,479,1,QCM,0.53,0.29,4.84,3,68,71,37,3,34,1.92,8.11,Moyen,Difficile,-1,Plus Difficile,Pas Adapte,Computer Science
2700,2017,Informatique,2,Les Logiciels,1,Systeme d'Exploitation,5,479,1,QCM,0.22,0.68,53.25,32,29,61,42,32,10,1.45,76.19,Facile,Moyen,-1,Plus Difficile,Pas Adapte,Computer Science
3811,2018,Informatique,2,Les Logiciels,1,Systeme d'Exploitation,5,479,1,QCM,0.04,0.71,74.19,39,13,52,52,39,13,1.0,75.0,Moyen,Facile,1,Plus Facile,Adapte,Computer Science
4922,2019,Informatique,2,Les Logiciels,1,Systeme d'Exploitation,5,479,1,QCM,0.02,0.88,74.19,45,15,60,54,45,9,1.11,83.33,Facile,Facile,0,Meme Difficulté,Adapte,Computer Science
6033,2020,Informatique,2,Les Logiciels,1,Systeme d'Exploitation,5,479,1,QCM,0.15,0.81,74.19,47,16,63,55,47,8,1.15,85.45,Facile,Facile,0,Meme Difficulté,Adapte,Computer Science
479,2015,Informatique,2,Les Logiciels,1,Systeme d'Exploitation,5,480,2,QROC,0.86,0.15,14.79,1,4,5,3,1,2,1.67,33.33,Difficile,Difficile,0,Meme Difficulté,Pas Adapte,Computer Science
1590,2016,Informatique,2,Les Logiciels,1,Systeme d'Exploitation,5,480,2,QROC,0.97,0.21,31.09,2,3,5,4,2,2,1.25,50.0,Difficile,Difficile,0,Meme Difficulté,Pas Adapte,Computer Science
2701,2017,Informatique,2,Les Logiciels,1,Systeme d'Exploitation,5,480,2,QROC,0.15,0.57,89.72,4,1,5,5,4,1,1.0,80.0,Facile,Facile,0,Meme Difficulté,Pas Adapte,Computer Science
3812,2018,Informatique,2,Les Logiciels,1,Systeme d'Exploitation,5,480,2,QROC,0.33,0.38,55.22,3,2,5,5,3,2,1.0,60.0,Moyen,Moyen,0,Meme Difficulté,Pas Adapte,Computer Science
4923,2019,Informatique,2,Les Logiciels,1,Systeme d'Exploitation,5,480,2,QROC,0.16,0.98,74.55,4,2,6,5,4,1,1.2,80.0,Facile,Facile,0,Meme Difficulté,Adapte,Computer Science
6034,2020,Informatique,2,Les Logiciels,1,Systeme d'Exploitation,5,480,2,QROC,0.14,0.57,74.55,5,2,7,6,5,1,1.17,83.33,Facile,Facile,0,Meme Difficulté,Adapte,Computer Science
480,2015,Informatique,2,Les Logiciels,1,Systeme d'Exploitation,5,481,3,QCM,0.75,0.18,2.03,1,56,57,23,1,22,2.48,4.35,Facile,Difficile,-2,Beaucoup plus Difficile,Pas Adapte,Computer Science
1591,2016,Informatique,2,Les Logiciels,1,Systeme d'Exploitation,5,481,3,QCM,0.22,0.43,60.59,37,24,61,44,37,7,1.39,84.09,Facile,Moyen,-1,Plus Difficile,Adapte,Computer Science
2702,2017,Informatique,2,Les Logiciels,1,Systeme d'Exploitation,5,481,3,QCM,0.21,0.43,60.59,32,21,53,47,32,15,1.13,68.09,Moyen,Moyen,0,Meme Difficulté,Adapte,Computer Science
3813,2018,Informatique,2,Les Logiciels,1,Systeme d'Exploitation,5,481,3,QCM,0.44,0.36,60.59,35,22,57,53,35,18,1.08,66.04,Moyen,Moyen,0,Meme Difficulté,Adapte,Computer Science
4924,2019,Informatique,2,Les Logiciels,1,Systeme d'Exploitation,5,481,3,QCM,0.36,0.67,60.59,35,22,57,45,35,10,1.27,77.78,Moyen,Moyen,0,Meme Difficulté,Adapte,Computer Science
6035,2020,Informatique,2,Les Logiciels,1,Systeme d'Exploitation,5,481,3,QCM,0.3,0.62,60.59,32,20,52,45,32,13,1.16,71.11,Moyen,Moyen,0,Meme Difficulté,Adapte,Computer Science
481,2015,Informatique,2,Les Logiciels,1,Systeme d'Exploitation,5,482,4,QCU,0.6,0.39,26.31,26,72,98,46,26,20,2.13,56.52,Difficile,Difficile,0,Meme Difficulté,Pas Adapte,Computer Science
1592,2016,Informatique,2,Les Logiciels,1,Systeme d'Exploitation,5,482,4,QCU,0.58,0.27,0.1,0,104,104,99,0,99,1.05,0.0,Facile,Difficile,-2,Beaucoup plus Difficile,Pas Adapte,Computer Science
2703,2017,Informatique,2,Les Logiciels,1,Systeme d'Exploitation,5,482,4,QROC,0.05,0.84,70.62,70,29,99,87,70,17,1.14,80.46,Difficile,Facile,2,Beaucoup plus Facile,Adapte,Computer Science
3814,2018,Informatique,2,Les Logiciels,1,Systeme d'Exploitation,5,482,4,QROC,0.13,0.57,70.62,73,30,103,86,73,13,1.2,84.88,Facile,Facile,0,Meme Difficulté,Adapte,Computer Science
4925,2019,Informatique,2,Les Logiciels,1,Systeme d'Exploitation,5,482,4,QO,0.11,0.65,70.62,81,34,115,90,81,9,1.28,90.0,Facile,Facile,0,Meme Difficulté,Adapte,Computer Science
6036,2020,Informatique,2,Les Logiciels,1,Systeme d'Exploitation,5,482,4,QROC,0.18,0.86,70.62,89,37,126,99,89,10,1.27,89.9,Facile,Facile,0,Meme Difficulté,Adapte,Computer Science
482,2015,Informatique,2,Les Logiciels,1,Systeme d'Exploitation,5,483,5,QCM,0.16,0.71,69.2,58,26,84,72,58,14,1.17,80.56,Difficile,Facile,2,Beaucoup plus Facile,Adapte,Computer Science
1593,2016,Informatique,2,Les Logiciels,1,Systeme d'Exploitation,5,483,5,QCM,0.06,0.99,69.2,55,24,79,67,55,12,1.18,82.09,Facile,Facile,0,Meme Difficulté,Adapte,Computer Science
2704,2017,Informatique,2,Les Logiciels,1,Systeme d'Exploitation,5,483,5,QCM,0.14,0.98,69.2,48,21,69,60,48,12,1.15,80.0,Facile,Facile,0,Meme Difficulté,Adapte,Computer Science
3815,2018,Informatique,2,Les Logiciels,1,Systeme d'Exploitation,5,483,5,QROC,0.09,0.75,69.2,42,19,61,47,42,5,1.3,89.36,Facile,Facile,0,Meme Difficulté,Adapte,Computer Science
4926,2019,Informatique,2,Les Logiciels,1,Systeme d'Exploitation,5,483,5,QROC,0.14,0.95,69.2,36,16,52,50,36,14,1.04,72.0,Facile,Facile,0,Meme Difficulté,Adapte,Computer Science
6037,2020,Informatique,2,Les Logiciels,1,Systeme d'Exploitation,5,483,5,QO,0.11,0.74,69.2,39,17,56,42,39,3,1.33,92.86,Facile,Facile,0,Meme Difficulté,Adapte,Computer Science
483,2015,Informatique,2,Les Logiciels,2,Traitement de Texte,6,484,1,QCU,0.61,0.22,16.53,15,76,91,55,15,40,1.65,27.27,Difficile,Difficile,0,Meme Difficulté,Pas Adapte,Computer Science
1594,2016,Informatique,2,Les Logiciels,2,Traitement de Texte,6,484,1,QCU,0.06,0.84,99.53,81,0,81,81,81,0,1.0,100.0,Facile,Facile,0,Meme Difficulté,Pas Adapte,Computer Science
2705,2017,Informatique,2,Les Logiciels,2,Traitement de Texte,6,484,1,QCU,0.24,0.41,41.66,30,43,73,47,30,17,1.55,63.83,Facile,Moyen,-1,Plus Difficile,Pas Adapte,Computer Science
3816,2018,Informatique,2,Les Logiciels,2,Traitement de Texte,6,484,1,QCU,0.1,0.79,77.4,50,15,65,57,50,7,1.14,87.72,Moyen,Facile,1,Plus Facile,Pas Adapte,Computer Science
4927,2019,Informatique,2,Les Logiciels,2,Traitement de Texte,6,484,1,QCU,0.09,0.86,80.68,51,12,63,51,51,0,1.24,100.0,Facile,Facile,0,Meme Difficulté,Pas Adapte,Computer Science
6038,2020,Informatique,2,Les Logiciels,2,Traitement de Texte,6,484,1,QCU,0.46,0.28,21.28,12,44,56,22,12,10,2.55,54.55,Difficile,Difficile,0,Meme Difficulté,Pas Adapte,Computer Science
484,2015,Informatique,2,Les Logiciels,2,Traitement de Texte,6,485,2,QCM,0.67,0.25,17.31,16,77,93,87,16,71,1.07,18.39,Moyen,Difficile,-1,Plus Difficile,Pas Adapte,Computer Science
1595,2016,Informatique,2,Les Logiciels,2,Traitement de Texte,6,485,2,QCM,0.59,0.16,10.39,10,82,92,73,10,63,1.26,13.7,Difficile,Difficile,0,Meme Difficulté,Pas Adapte,Computer Science
2706,2017,Informatique,2,Les Logiciels,2,Traitement de Texte,6,485,2,QCM,0.13,0.74,78.11,80,22,102,82,80,2,1.24,97.56,Moyen,Facile,1,Plus Facile,Pas Adapte,Computer Science
3817,2018,Informatique,2,Les Logiciels,2,Traitement de Texte,6,485,2,QCM,0.29,0.61,63.68,64,36,100,93,64,29,1.08,68.82,Difficile,Moyen,1,Plus Facile,Adapte,Computer Science
4928,2019,Informatique,2,Les Logiciels,2,Traitement de Texte,6,485,2,QCM,0.47,0.63,63.68,62,36,98,95,62,33,1.03,65.26,Moyen,Moyen,0,Meme Difficulté,Adapte,Computer Science
6039,2020,Informatique,2,Les Logiciels,2,Traitement de Texte,6,485,2,QCM,0.41,0.34,63.68,69,40,109,70,69,1,1.56,98.57,Moyen,Moyen,0,Meme Difficulté,Adapte,Computer Science
485,2015,Informatique,2,Les Logiciels,2,Traitement de Texte,6,486,3,QCU,0.08,0.85,95.18,15,1,16,15,15,0,1.07,100.0,Facile,Facile,0,Meme Difficulté,Pas Adapte,Computer Science
1596,2016,Informatique,2,Les Logiciels,2,Traitement de Texte,6,486,3,QCU,0.38,0.71,61.58,9,5,14,10,9,1,1.4,90.0,Moyen,Moyen,0,Meme Difficulté,Adapte,Computer Science
2707,2017,Informatique,2,Les Logiciels,2,Traitement de Texte,6,486,3,QO,0.3,0.27,61.58,8,5,13,13,8,5,1.0,61.54,Moyen,Moyen,0,Meme Difficulté,Adapte,Computer Science
3818,2018,Informatique,2,Les Logiciels,2,Traitement de Texte,6,486,3,QO,0.22,0.26,61.58,9,6,15,12,9,3,1.25,75.0,Moyen,Moyen,0,Meme Difficulté,Adapte,Computer Science
4929,2019,Informatique,2,Les Logiciels,2,Traitement de Texte,6,486,3,QROC,0.25,0.29,61.58,9,6,15,15,9,6,1.0,60.0,Moyen,Moyen,0,Meme Difficulté,Adapte,Computer Science
6040,2020,Informatique,2,Les Logiciels,2,Traitement de Texte,6,486,3,QROC,0.37,0.37,61.58,9,5,14,13,9,4,1.08,69.23,Moyen,Moyen,0,Meme Difficulté,Adapte,Computer Science
486,2015,Informatique,2,Les Logiciels,2,Traitement de Texte,6,487,4,QCM,0.52,0.22,32.56,28,58,86,75,28,47,1.15,37.33,Facile,Difficile,-2,Beaucoup plus Difficile,Pas Adapte,Computer Science
1597,2016,Informatique,2,Les Logiciels,2,Traitement de Texte,6,487,4,QCM,0.43,0.59,36.79,29,50,79,76,29,47,1.04,38.16,Difficile,Moyen,1,Plus Facile,Pas Adapte,Computer Science
2708,2017,Informatique,2,Les Logiciels,2,Traitement de Texte,6,487,4,QCM,0.54,0.26,19.43,15,62,77,37,15,22,2.08,40.54,Facile,Difficile,-2,Beaucoup plus Difficile,Pas Adapte,Computer Science
3819,2018,Informatique,2,Les Logiciels,2,Traitement de Texte,6,487,4,QCM,0.41,0.46,45.73,36,43,79,55,36,19,1.44,65.45,Facile,Moyen,-1,Plus Difficile,Pas Adapte,Computer Science
4930,2019,Informatique,2,Les Logiciels,2,Traitement de Texte,6,487,4,QCM,0.05,0.95,97.77,87,2,89,87,87,0,1.02,100.0,Moyen,Facile,1,Plus Facile,Pas Adapte,Computer Science
6041,2020,Informatique,2,Les Logiciels,2,Traitement de Texte,6,487,4,QCM,0.36,0.53,54.94,51,41,92,86,51,35,1.07,59.3,Difficile,Moyen,1,Plus Facile,Pas Adapte,Computer Science
487,2015,Informatique,2,Les Logiciels,2,Traitement de Texte,6,488,5,QCU,0.08,0.93,65.29,64,34,98,94,64,30,1.04,68.09,Difficile,Facile,2,Beaucoup plus Facile,Adapte,Computer Science
1598,2016,Informatique,2,Les Logiciels,2,Traitement de Texte,6,488,5,QCU,0.12,0.75,65.29,62,33,95,86,62,24,1.1,72.09,Facile,Facile,0,Meme Difficulté,Adapte,Computer Science
2709,2017,Informatique,2,Les Logiciels,2,Traitement de Texte,6,488,5,QCU,0.06,0.95,65.29,60,32,92,75,60,15,1.23,80.0,Facile,Facile,0,Meme Difficulté,Adapte,Computer Science
3820,2018,Informatique,2,Les Logiciels,2,Traitement de Texte,6,488,5,QCU,0.17,0.96,65.29,59,32,91,79,59,20,1.15,74.68,Facile,Facile,0,Meme Difficulté,Adapte,Computer Science
4931,2019,Informatique,2,Les Logiciels,2,Traitement de Texte,6,488,5,QCU,0.19,0.95,65.29,61,32,93,90,61,29,1.03,67.78,Facile,Facile,0,Meme Difficulté,Adapte,Computer Science
6042,2020,Informatique,2,Les Logiciels,2,Traitement de Texte,6,488,5,QCM,0.03,0.85,65.29,69,37,106,70,69,1,1.51,98.57,Facile,Facile,0,Meme Difficulté,Adapte,Computer Science
488,2015,Informatique,2,Les Logiciels,2,Traitement de Texte,6,489,6,QCU,0.65,0.31,17.99,4,16,20,17,4,13,1.18,23.53,Facile,Difficile,-2,Beaucoup plus Difficile,Pas Adapte,Computer Science
1599,2016,Informatique,2,Les Logiciels,2,Traitement de Texte,6,489,6,QCU,0.75,0.2,8.3,2,17,19,14,2,12,1.36,14.29,Difficile,Difficile,0,Meme Difficulté,Pas Adapte,Computer Science
2710,2017,Informatique,2,Les Logiciels,2,Traitement de Texte,6,489,6,QCU,0.39,0.45,56.09,10,8,18,15,10,5,1.2,66.67,Facile,Moyen,-1,Plus Difficile,Pas Adapte,Computer Science
3821,2018,Informatique,2,Les Logiciels,2,Traitement de Texte,6,489,6,QCU,0.26,0.62,54.7,8,7,15,11,8,3,1.36,72.73,Moyen,Moyen,0,Meme Difficulté,Pas Adapte,Computer Science
4932,2019,Informatique,2,Les Logiciels,2,Traitement de Texte,6,489,6,QCU,0.51,0.37,24.04,3,11,14,11,3,8,1.27,27.27,Facile,Difficile,-2,Beaucoup plus Difficile,Pas Adapte,Computer Science
6043,2020,Informatique,2,Les Logiciels,2,Traitement de Texte,6,489,6,QCU,0.25,0.61,63.8,10,6,16,11,10,1,1.45,90.91,Facile,Moyen,-1,Plus Difficile,Adapte,Computer Science
489,2015,Informatique,2,Les Logiciels,3,Les Tableurs,5,490,1,QCM,0.12,0.7,75.28,50,17,67,61,50,11,1.1,81.97,Moyen,Facile,1,Plus Facile,Pas Adapte,Computer Science
1600,2016,Informatique,2,Les Logiciels,3,Les Tableurs,5,490,1,QCU,0.66,0.29,6.82,5,63,68,28,5,23,2.43,17.86,Difficile,Difficile,0,Meme Difficulté,Pas Adapte,Computer Science
2711,2017,Informatique,2,Les Logiciels,3,Les Tableurs,5,490,1,QCU,0.54,0.26,13.51,8,53,61,35,8,27,1.74,22.86,Moyen,Difficile,-1,Plus Difficile,Pas Adapte,Computer Science
3822,2018,Informatique,2,Les Logiciels,3,Les Tableurs,5,490,1,QCU,0.54,0.4,34.41,22,41,63,40,22,18,1.57,55.0,Facile,Difficile,-2,Beaucoup plus Difficile,Pas Adapte,Computer Science
4933,2019,Informatique,2,Les Logiciels,3,Les Tableurs,5,490,1,QCU,0.07,0.84,78.31,43,12,55,50,43,7,1.1,86.0,Difficile,Facile,2,Beaucoup plus Facile,Pas Adapte,Computer Science
6044,2020,Informatique,2,Les Logiciels,3,Les Tableurs,5,490,1,QCU,0.27,0.69,37.32,23,39,62,40,23,17,1.55,57.5,Moyen,Moyen,0,Meme Difficulté,Pas Adapte,Computer Science
490,2015,Informatique,2,Les Logiciels,3,Les Tableurs,5,491,2,QCU,0.02,0.98,76.57,29,9,38,34,29,5,1.12,85.29,Facile,Facile,0,Meme Difficulté,Pas Adapte,Computer Science
1601,2016,Informatique,2,Les Logiciels,3,Les Tableurs,5,491,2,QCU,0.01,0.98,97.68,42,1,43,42,42,0,1.02,100.0,Facile,Facile,0,Meme Difficulté,Pas Adapte,Computer Science
2712,2017,Informatique,2,Les Logiciels,3,Les Tableurs,5,491,2,QCU,0.29,0.71,54.41,22,18,40,32,22,10,1.25,68.75,Difficile,Moyen,1,Plus Facile,Pas Adapte,Computer Science
3823,2018,Informatique,2,Les Logiciels,3,Les Tableurs,5,491,2,QCU,0.73,0.27,21.64,9,31,40,34,9,25,1.18,26.47,Facile,Difficile,-2,Beaucoup plus Difficile,Pas Adapte,Computer Science
4934,2019,Informatique,2,Les Logiciels,3,Les Tableurs,5,491,2,QCU,0.44,0.29,18.4,6,28,34,14,6,8,2.43,42.86,Facile,Difficile,-2,Beaucoup plus Difficile,Pas Adapte,Computer Science
6045,2020,Informatique,2,Les Logiciels,3,Les Tableurs,5,491,2,QCU,0.06,0.95,83.59,31,6,37,35,31,4,1.06,88.57,Difficile,Facile,2,Beaucoup plus Facile,Pas Adapte,Computer Science
491,2015,Informatique,2,Les Logiciels,3,Les Tableurs,5,492,3,QCU,0.25,0.41,62.55,28,17,45,29,28,1,1.55,96.55,Difficile,Moyen,1,Plus Facile,Adapte,Computer Science
1602,2016,Informatique,2,Les Logiciels,3,Les Tableurs,5,492,3,QCU,0.39,0.58,62.55,26,15,41,37,26,11,1.11,70.27,Moyen,Moyen,0,Meme Difficulté,Adapte,Computer Science
2713,2017,Informatique,2,Les Logiciels,3,Les Tableurs,5,492,3,QCU,0.26,0.48,62.55,26,15,41,40,26,14,1.02,65.0,Moyen,Moyen,0,Meme Difficulté,Adapte,Computer Science
3824,2018,Informatique,2,Les Logiciels,3,Les Tableurs,5,492,3,QCU,0.33,0.57,62.55,29,18,47,45,29,16,1.04,64.44,Moyen,Moyen,0,Meme Difficulté,Adapte,Computer Science
4935,2019,Informatique,2,Les Logiciels,3,Les Tableurs,5,492,3,QCU,0.33,0.64,62.55,31,19,50,31,31,0,1.61,100.0,Moyen,Moyen,0,Meme Difficulté,Adapte,Computer Science
6046,2020,Informatique,2,Les Logiciels,3,Les Tableurs,5,492,3,QCU,0.24,0.49,62.55,35,21,56,52,35,17,1.08,67.31,Moyen,Moyen,0,Meme Difficulté,Adapte,Computer Science
492,2015,Informatique,2,Les Logiciels,3,Les Tableurs,5,493,4,QCU,0.17,0.76,66.85,64,31,95,93,64,29,1.02,68.82,Difficile,Facile,2,Beaucoup plus Facile,Adapte,Computer Science
1603,2016,Informatique,2,Les Logiciels,3,Les Tableurs,5,493,4,QCU,0.15,0.96,66.85,72,35,107,102,72,30,1.05,70.59,Facile,Facile,0,Meme Difficulté,Adapte,Computer Science
2714,2017,Informatique,2,Les Logiciels,3,Les Tableurs,5,493,4,QCM,0.01,0.97,66.85,72,36,108,98,72,26,1.1,73.47,Facile,Facile,0,Meme Difficulté,Adapte,Computer Science
3825,2018,Informatique,2,Les Logiciels,3,Les Tableurs,5,493,4,QCM,0.1,0.98,66.85,80,39,119,89,80,9,1.34,89.89,Facile,Facile,0,Meme Difficulté,Adapte,Computer Science
4936,2019,Informatique,2,Les Logiciels,3,Les Tableurs,5,493,4,QCM,0.11,0.96,66.85,90,44,134,108,90,18,1.24,83.33,Facile,Facile,0,Meme Difficulté,Adapte,Computer Science
6047,2020,Informatique,2,Les Logiciels,3,Les Tableurs,5,493,4,QCM,0.06,0.94,66.85,89,44,133,96,89,7,1.39,92.71,Facile,Facile,0,Meme Difficulté,Adapte,Computer Science
493,2015,Informatique,2,Les Logiciels,3,Les Tableurs,5,494,5,QO,0.02,0.74,91.13,89,9,98,90,89,1,1.09,98.89,Difficile,Facile,2,Beaucoup plus Facile,Pas Adapte,Computer Science
1604,2016,Informatique,2,Les Logiciels,3,Les Tableurs,5,494,5,QO,0.87,0.1,13.1,13,87,100,86,13,73,1.16,15.12,Moyen,Difficile,-1,Plus Difficile,Pas Adapte,Computer Science
2715,2017,Informatique,2,Les Logiciels,3,Les Tableurs,5,494,5,QO,0.02,0.36,79.09,79,21,100,84,79,5,1.19,94.05,Difficile,Facile,2,Beaucoup plus Facile,Pas Adapte,Computer Science
3826,2018,Informatique,2,Les Logiciels,3,Les Tableurs,5,494,5,QO,0.79,0.15,2.74,3,90,93,61,3,58,1.52,4.92,Facile,Difficile,-2,Beaucoup plus Difficile,Pas Adapte,Computer Science
4937,2019,Informatique,2,Les Logiciels,3,Les Tableurs,5,494,5,QO,0.86,0.05,26.74,25,70,95,50,25,25,1.9,50.0,Moyen,Difficile,-1,Plus Difficile,Pas Adapte,Computer Science
6048,2020,Informatique,2,Les Logiciels,3,Les Tableurs,5,494,5,QO,0.17,0.42,69.88,70,30,100,96,70,26,1.04,72.92,Moyen,Facile,1,Plus Facile,Adapte,Computer Science
494,2015,Informatique,3,Algorithme et Programmation,1,Notion d'Algorithme,5,495,1,QCM,0.03,0.88,82.53,77,16,93,87,77,10,1.07,88.51,Facile,Facile,0,Meme Difficulté,Pas Adapte,Computer Science
1605,2016,Informatique,3,Algorithme et Programmation,1,Notion d'Algorithme,5,495,1,QCM,0.42,0.66,42.25,41,57,98,56,41,15,1.75,73.21,Difficile,Moyen,1,Plus Facile,Pas Adapte,Computer Science
2716,2017,Informatique,3,Algorithme et Programmation,1,Notion d'Algorithme,5,495,1,QCM,0.24,0.59,44.34,42,53,95,71,42,29,1.34,59.15,Moyen,Moyen,0,Meme Difficulté,Pas Adapte,Computer Science
3827,2018,Informatique,3,Algorithme et Programmation,1,Notion d'Algorithme,5,495,1,QCM,0.62,0.27,23.02,25,82,107,71,25,46,1.51,35.21,Moyen,Difficile,-1,Plus Difficile,Pas Adapte,Computer Science
4938,2019,Informatique,3,Algorithme et Programmation,1,Notion d'Algorithme,5,495,1,QCU,0.54,0.21,2.79,3,119,122,112,3,109,1.09,2.68,Moyen,Difficile,-1,Plus Difficile,Pas Adapte,Computer Science
6049,2020,Informatique,3,Algorithme et Programmation,1,Notion d'Algorithme,5,495,1,QCU,0.39,0.64,47.35,56,63,119,81,56,25,1.47,69.14,Facile,Moyen,-1,Plus Difficile,Pas Adapte,Computer Science
495,2015,Informatique,3,Algorithme et Programmation,1,Notion d'Algorithme,5,496,2,QCU,0.28,0.47,49.32,29,29,58,53,29,24,1.09,54.72,Difficile,Moyen,1,Plus Facile,Pas Adapte,Computer Science
1606,2016,Informatique,3,Algorithme et Programmation,1,Notion d'Algorithme,5,496,2,QCU,0.32,0.67,63.61,38,21,59,54,38,16,1.09,70.37,Moyen,Moyen,0,Meme Difficulté,Adapte,Computer Science
2717,2017,Informatique,3,Algorithme et Programmation,1,Notion d'Algorithme,5,496,2,QCU,0.26,0.55,63.61,36,21,57,46,36,10,1.24,78.26,Moyen,Moyen,0,Meme Difficulté,Adapte,Computer Science
3828,2018,Informatique,3,Algorithme et Programmation,1,Notion d'Algorithme,5,496,2,QCM,0.21,0.54,63.61,39,23,62,52,39,13,1.19,75.0,Moyen,Moyen,0,Meme Difficulté,Adapte,Computer Science
4939,2019,Informatique,3,Algorithme et Programmation,1,Notion d'Algorithme,5,496,2,QCM,0.28,0.39,63.61,42,24,66,55,42,13,1.2,76.36,Moyen,Moyen,0,Meme Difficulté,Adapte,Computer Science
6050,2020,Informatique,3,Algorithme et Programmation,1,Notion d'Algorithme,5,496,2,QCM,0.29,0.7,63.61,42,24,66,46,42,4,1.43,91.3,Moyen,Moyen,0,Meme Difficulté,Adapte,Computer Science
496,2015,Informatique,3,Algorithme et Programmation,1,Notion d'Algorithme,5,497,3,QCU,0.1,0.77,68.1,67,31,98,74,67,7,1.32,90.54,Difficile,Facile,2,Beaucoup plus Facile,Adapte,Computer Science
1607,2016,Informatique,3,Algorithme et Programmation,1,Notion d'Algorithme,5,497,3,QCU,0.08,0.85,68.1,70,33,103,77,70,7,1.34,90.91,Facile,Facile,0,Meme Difficulté,Adapte,Computer Science
2718,2017,Informatique,3,Algorithme et Programmation,1,Notion d'Algorithme,5,497,3,QO,0.04,0.9,68.1,62,29,91,63,62,1,1.44,98.41,Facile,Facile,0,Meme Difficulté,Adapte,Computer Science
3829,2018,Informatique,3,Algorithme et Programmation,1,Notion d'Algorithme,5,497,3,QO,0.17,0.9,68.1,63,29,92,80,63,17,1.15,78.75,Facile,Facile,0,Meme Difficulté,Adapte,Computer Science
4940,2019,Informatique,3,Algorithme et Programmation,1,Notion d'Algorithme,5,497,3,QROC,0.0,0.53,68.1,54,26,80,76,54,22,1.05,71.05,Facile,Facile,0,Meme Difficulté,Adapte,Computer Science
6051,2020,Informatique,3,Algorithme et Programmation,1,Notion d'Algorithme,5,497,3,QROC,0.08,0.97,68.1,61,28,89,69,61,8,1.29,88.41,Facile,Facile,0,Meme Difficulté,Adapte,Computer Science
497,2015,Informatique,3,Algorithme et Programmation,1,Notion d'Algorithme,5,498,4,QCU,0.67,0.22,1.49,1,82,83,38,1,37,2.18,2.63,Facile,Difficile,-2,Beaucoup plus Difficile,Pas Adapte,Computer Science
1608,2016,Informatique,3,Algorithme et Programmation,1,Notion d'Algorithme,5,498,4,QROC,0.17,0.53,74.3,68,24,92,77,68,9,1.19,88.31,Moyen,Facile,1,Plus Facile,Adapte,Computer Science
2719,2017,Informatique,3,Algorithme et Programmation,1,Notion d'Algorithme,5,498,4,QO,0.04,0.84,74.3,67,23,90,75,67,8,1.2,89.33,Facile,Facile,0,Meme Difficulté,Adapte,Computer Science
3830,2018,Informatique,3,Algorithme et Programmation,1,Notion d'Algorithme,5,498,4,QROC,0.06,0.9,74.3,58,20,78,75,58,17,1.04,77.33,Facile,Facile,0,Meme Difficulté,Adapte,Computer Science
4941,2019,Informatique,3,Algorithme et Programmation,1,Notion d'Algorithme,5,498,4,QROC,0.15,0.87,74.3,51,18,69,65,51,14,1.06,78.46,Facile,Facile,0,Meme Difficulté,Adapte,Computer Science
6052,2020,Informatique,3,Algorithme et Programmation,1,Notion d'Algorithme,5,498,4,QO,0.1,0.81,74.3,55,19,74,55,55,0,1.35,100.0,Facile,Facile,0,Meme Difficulté,Adapte,Computer Science
498,2015,Informatique,3,Algorithme et Programmation,1,Notion d'Algorithme,5,499,5,QROC,0.82,0.02,4.89,4,78,82,82,4,78,1.0,4.88,Difficile,Difficile,0,Meme Difficulté,Pas Adapte,Computer Science
1609,2016,Informatique,3,Algorithme et Programmation,1,Notion d'Algorithme,5,499,5,QROC,0.48,0.25,53.95,41,35,76,71,41,30,1.07,57.75,Difficile,Moyen,1,Plus Facile,Pas Adapte,Computer Science
2720,2017,Informatique,3,Algorithme et Programmation,1,Notion d'Algorithme,5,499,5,QROC,0.01,0.84,75.81,50,16,66,64,50,14,1.03,78.12,Facile,Facile,0,Meme Difficulté,Pas Adapte,Computer Science
3831,2018,Informatique,3,Algorithme et Programmation,1,Notion d'Algorithme,5,499,5,QROC,0.08,0.51,80.35,47,11,58,57,47,10,1.02,82.46,Moyen,Facile,1,Plus Facile,Pas Adapte,Computer Science
4942,2019,Informatique,3,Algorithme et Programmation,1,Notion d'Algorithme,5,499,5,QROC,0.9,0.03,25.02,13,37,50,25,13,12,2.0,52.0,Difficile,Difficile,0,Meme Difficulté,Pas Adapte,Computer Science
6053,2020,Informatique,3,Algorithme et Programmation,1,Notion d'Algorithme,5,499,5,QROC,0.61,0.01,6.96,3,39,42,36,3,33,1.17,8.33,Facile,Difficile,-2,Beaucoup plus Difficile,Pas Adapte,Computer Science
499,2015,Informatique,3,Algorithme et Programmation,2,Instruction de Base,9,500,1,QCU,0.05,0.78,91.86,43,4,47,46,43,3,1.02,93.48,Facile,Facile,0,Meme Difficulté,Pas Adapte,Computer Science
1610,2016,Informatique,3,Algorithme et Programmation,2,Instruction de Base,9,500,1,QCU,0.38,0.42,37.59,15,26,41,39,15,24,1.05,38.46,Facile,Moyen,-1,Plus Difficile,Pas Adapte,Computer Science
2721,2017,Informatique,3,Algorithme et Programmation,2,Instruction de Base,9,500,1,QCU,0.57,0.25,34.99,15,28,43,26,15,11,1.65,57.69,Moyen,Difficile,-1,Plus Difficile,Pas Adapte,Computer Science
3832,2018,Informatique,3,Algorithme et Programmation,2,Instruction de Base,9,500,1,QCU,0.11,0.84,98.28,48,1,49,48,48,0,1.02,100.0,Moyen,Facile,1,Plus Facile,Pas Adapte,Computer Science
4943,2019,Informatique,3,Algorithme et Programmation,2,Instruction de Base,9,500,1,QCU,0.39,0.73,49.45,25,25,50,28,25,3,1.79,89.29,Difficile,Moyen,1,Plus Facile,Pas Adapte,Computer Science
6054,2020,Informatique,3,Algorithme et Programmation,2,Instruction de Base,9,500,1,QCU,0.03,0.8,67.08,35,17,52,37,35,2,1.41,94.59,Moyen,Facile,1,Plus Facile,Adapte,Computer Science
500,2015,Informatique,3,Algorithme et Programmation,2,Instruction de Base,9,501,2,QCM,0.34,0.6,62.34,54,33,87,86,54,32,1.01,62.79,Facile,Moyen,-1,Plus Difficile,Adapte,Computer Science
1611,2016,Informatique,3,Algorithme et Programmation,2,Instruction de Base,9,501,2,QCM,0.2,0.54,62.34,48,29,77,62,48,14,1.24,77.42,Moyen,Moyen,0,Meme Difficulté,Adapte,Computer Science
2722,2017,Informatique,3,Algorithme et Programmation,2,Instruction de Base,9,501,2,QCM,0.32,0.43,62.34,55,33,88,56,55,1,1.57,98.21,Moyen,Moyen,0,Meme Difficulté,Adapte,Computer Science
3833,2018,Informatique,3,Algorithme et Programmation,2,Instruction de Base,9,501,2,QCU,0.31,0.54,62.34,60,36,96,95,60,35,1.01,63.16,Moyen,Moyen,0,Meme Difficulté,Adapte,Computer Science
4944,2019,Informatique,3,Algorithme et Programmation,2,Instruction de Base,9,501,2,QCU,0.27,0.54,62.34,65,40,105,86,65,21,1.22,75.58,Moyen,Moyen,0,Meme Difficulté,Adapte,Computer Science
6055,2020,Informatique,3,Algorithme et Programmation,2,Instruction de Base,9,501,2,QCU,0.39,0.68,62.34,59,36,95,75,59,16,1.27,78.67,Moyen,Moyen,0,Meme Difficulté,Adapte,Computer Science
501,2015,Informatique,3,Algorithme et Programmation,2,Instruction de Base,9,502,3,QROC,0.2,0.42,90.71,78,8,86,84,78,6,1.02,92.86,Difficile,Facile,2,Beaucoup plus Facile,Pas Adapte,Computer Science
1612,2016,Informatique,3,Algorithme et Programmation,2,Instruction de Base,9,502,3,QROC,0.99,0.16,19.53,19,79,98,75,19,56,1.31,25.33,Difficile,Difficile,0,Meme Difficulté,Pas Adapte,Computer Science
2723,2017,Informatique,3,Algorithme et Programmation,2,Instruction de Base,9,502,3,QROC,0.84,0.16,21.99,21,75,96,74,21,53,1.3,28.38,Moyen,Difficile,-1,Plus Difficile,Pas Adapte,Computer Science
3834,2018,Informatique,3,Algorithme et Programmation,2,Instruction de Base,9,502,3,QROC,0.12,0.78,88.67,88,11,99,89,88,1,1.11,98.88,Difficile,Facile,2,Beaucoup plus Facile,Pas Adapte,Computer Science
4945,2019,Informatique,3,Algorithme et Programmation,2,Instruction de Base,9,502,3,QROC,0.78,0.09,21.76,19,67,86,45,19,26,1.91,42.22,Facile,Difficile,-2,Beaucoup plus Difficile,Pas Adapte,Computer Science
6056,2020,Informatique,3,Algorithme et Programmation,2,Instruction de Base,9,502,3,QROC,0.1,0.77,85.54,71,12,83,71,71,0,1.17,100.0,Facile,Facile,0,Meme Difficulté,Pas Adapte,Computer Science
502,2015,Informatique,3,Algorithme et Programmation,2,Instruction de Base,9,503,4,QCM,0.32,0.4,38.31,13,22,35,22,13,9,1.59,59.09,Difficile,Moyen,1,Plus Facile,Pas Adapte,Computer Science
1613,2016,Informatique,3,Algorithme et Programmation,2,Instruction de Base,9,503,4,QCM,0.58,0.24,9.11,3,31,34,9,3,6,3.78,33.33,Difficile,Difficile,0,Meme Difficulté,Pas Adapte,Computer Science
2724,2017,Informatique,3,Algorithme et Programmation,2,Instruction de Base,9,503,4,QCM,0.07,0.97,65.07,21,11,32,30,21,9,1.07,70.0,Facile,Facile,0,Meme Difficulté,Adapte,Computer Science
3835,2018,Informatique,3,Algorithme et Programmation,2,Instruction de Base,9,503,4,QCM,0.19,0.96,65.07,24,13,37,31,24,7,1.19,77.42,Facile,Facile,0,Meme Difficulté,Adapte,Computer Science
4946,2019,Informatique,3,Algorithme et Programmation,2,Instruction de Base,9,503,4,QCM,0.11,0.79,65.07,26,14,40,27,26,1,1.48,96.3,Facile,Facile,0,Meme Difficulté,Adapte,Computer Science
6057,2020,Informatique,3,Algorithme et Programmation,2,Instruction de Base,9,503,4,QCM,0.19,0.86,65.07,29,15,44,34,29,5,1.29,85.29,Facile,Facile,0,Meme Difficulté,Adapte,Computer Science
503,2015,Informatique,3,Algorithme et Programmation,2,Instruction de Base,9,504,5,QCU,0.74,0.22,10.38,8,68,76,48,8,40,1.58,16.67,Moyen,Difficile,-1,Plus Difficile,Pas Adapte,Computer Science
1614,2016,Informatique,3,Algorithme et Programmation,2,Instruction de Base,9,504,5,QCU,0.4,0.64,58.54,41,29,70,56,41,15,1.25,73.21,Moyen,Moyen,0,Meme Difficulté,Pas Adapte,Computer Science
2725,2017,Informatique,3,Algorithme et Programmation,2,Instruction de Base,9,504,5,QCU,0.51,0.39,31.4,22,49,71,60,22,38,1.18,36.67,Difficile,Difficile,0,Meme Difficulté,Pas Adapte,Computer Science
3836,2018,Informatique,3,Algorithme et Programmation,2,Instruction de Base,9,504,5,QCU,0.18,0.96,70.48,43,18,61,44,43,1,1.39,97.73,Facile,Facile,0,Meme Difficulté,Adapte,Computer Science
4947,2019,Informatique,3,Algorithme et Programmation,2,Instruction de Base,9,504,5,QCU,0.11,0.79,70.48,37,15,52,43,37,6,1.21,86.05,Facile,Facile,0,Meme Difficulté,Adapte,Computer Science
6058,2020,Informatique,3,Algorithme et Programmation,2,Instruction de Base,9,504,5,QCU,0.16,0.94,70.48,41,17,58,46,41,5,1.26,89.13,Facile,Facile,0,Meme Difficulté,Adapte,Computer Science
504,2015,Informatique,3,Algorithme et Programmation,2,Instruction de Base,9,505,6,QCM,0.6,0.18,10.08,8,68,76,24,8,16,3.17,33.33,Difficile,Difficile,0,Meme Difficulté,Pas Adapte,Computer Science
1615,2016,Informatique,3,Algorithme et Programmation,2,Instruction de Base,9,505,6,QCM,0.06,0.9,71.83,47,18,65,63,47,16,1.03,74.6,Difficile,Facile,2,Beaucoup plus Facile,Adapte,Computer Science
2726,2017,Informatique,3,Algorithme et Programmation,2,Instruction de Base,9,505,6,QCM,0.16,1.0,71.83,49,19,68,62,49,13,1.1,79.03,Facile,Facile,0,Meme Difficulté,Adapte,Computer Science
3837,2018,Informatique,3,Algorithme et Programmation,2,Instruction de Base,9,505,6,QCM,0.08,0.98,71.83,48,19,67,62,48,14,1.08,77.42,Facile,Facile,0,Meme Difficulté,Adapte,Computer Science
4948,2019,Informatique,3,Algorithme et Programmation,2,Instruction de Base,9,505,6,QCM,0.14,0.89,71.83,48,19,67,52,48,4,1.29,92.31,Facile,Facile,0,Meme Difficulté,Adapte,Computer Science
6059,2020,Informatique,3,Algorithme et Programmation,2,Instruction de Base,9,505,6,QCM,0.05,0.99,71.83,46,18,64,52,46,6,1.23,88.46,Facile,Facile,0,Meme Difficulté,Adapte,Computer Science
505,2015,Informatique,3,Algorithme et Programmation,2,Instruction de Base,9,506,7,QCU,0.34,0.72,61.71,24,15,39,29,24,5,1.34,82.76,Moyen,Moyen,0,Meme Difficulté,Adapte,Computer Science
1616,2016,Informatique,3,Algorithme et Programmation,2,Instruction de Base,9,506,7,QCU,0.39,0.4,61.71,23,14,37,23,23,0,1.61,100.0,Moyen,Moyen,0,Meme Difficulté,Adapte,Computer Science
2727,2017,Informatique,3,Algorithme et Programmation,2,Instruction de Base,9,506,7,QCU,0.39,0.41,61.71,22,13,35,33,22,11,1.06,66.67,Moyen,Moyen,0,Meme Difficulté,Adapte,Computer Science
3838,2018,Informatique,3,Algorithme et Programmation,2,Instruction de Base,9,506,7,QCU,0.22,0.58,61.71,24,15,39,27,24,3,1.44,88.89,Moyen,Moyen,0,Meme Difficulté,Adapte,Computer Science
4949,2019,Informatique,3,Algorithme et Programmation,2,Instruction de Base,9,506,7,QCM,0.22,0.57,61.71,25,15,40,27,25,2,1.48,92.59,Moyen,Moyen,0,Meme Difficulté,Adapte,Computer Science
6060,2020,Informatique,3,Algorithme et Programmation,2,Instruction de Base,9,506,7,QCU,0.24,0.7,61.71,27,16,43,31,27,4,1.39,87.1,Moyen,Moyen,0,Meme Difficulté,Adapte,Computer Science
506,2015,Informatique,3,Algorithme et Programmation,2,Instruction de Base,9,507,8,QCU,0.48,0.21,0.95,0,40,40,27,0,27,1.48,0.0,Facile,Difficile,-2,Beaucoup plus Difficile,Pas Adapte,Computer Science
1617,2016,Informatique,3,Algorithme et Programmation,2,Instruction de Base,9,507,8,QCU,0.0,0.83,68.2,29,13,42,34,29,5,1.24,85.29,Facile,Facile,0,Meme Difficulté,Adapte,Computer Science
2728,2017,Informatique,3,Algorithme et Programmation,2,Instruction de Base,9,507,8,QCU,0.02,0.83,68.2,27,12,39,35,27,8,1.11,77.14,Facile,Facile,0,Meme Difficulté,Adapte,Computer Science
3839,2018,Informatique,3,Algorithme et Programmation,2,Instruction de Base,9,507,8,QCU,0.02,0.97,68.2,25,12,37,30,25,5,1.23,83.33,Facile,Facile,0,Meme Difficulté,Adapte,Computer Science
4950,2019,Informatique,3,Algorithme et Programmation,2,Instruction de Base,9,507,8,QCU,0.2,0.85,68.2,22,10,32,31,22,9,1.03,70.97,Facile,Facile,0,Meme Difficulté,Adapte,Computer Science
6061,2020,Informatique,3,Algorithme et Programmation,2,Instruction de Base,9,507,8,QCM,0.02,0.78,68.2,25,11,36,25,25,0,1.44,100.0,Facile,Facile,0,Meme Difficulté,Adapte,Computer Science
507,2015,Informatique,3,Algorithme et Programmation,2,Instruction de Base,9,508,9,QCU,0.67,0.21,28.27,15,38,53,48,15,33,1.1,31.25,Moyen,Difficile,-1,Plus Difficile,Pas Adapte,Computer Science
1618,2016,Informatique,3,Algorithme et Programmation,2,Instruction de Base,9,508,9,QCU,0.55,0.37,8.04,4,46,50,29,4,25,1.72,13.79,Difficile,Difficile,0,Meme Difficulté,Pas Adapte,Computer Science
2729,2017,Informatique,3,Algorithme et Programmation,2,Instruction de Base,9,508,9,QCU,0.67,0.24,29.02,17,40,57,49,17,32,1.16,34.69,Facile,Difficile,-2,Beaucoup plus Difficile,Pas Adapte,Computer Science
3840,2018,Informatique,3,Algorithme et Programmation,2,Instruction de Base,9,508,9,QCU,0.49,0.21,1.2,1,64,65,38,1,37,1.71,2.63,Facile,Difficile,-2,Beaucoup plus Difficile,Pas Adapte,Computer Science
4951,2019,Informatique,3,Algorithme et Programmation,2,Instruction de Base,9,508,9,QROC,0.21,0.31,59.29,35,24,59,58,35,23,1.02,60.34,Difficile,Moyen,1,Plus Facile,Pas Adapte,Computer Science
6062,2020,Informatique,3,Algorithme et Programmation,2,Instruction de Base,9,508,9,QO,0.06,0.82,86.45,48,8,56,52,48,4,1.08,92.31,Difficile,Facile,2,Beaucoup plus Facile,Pas Adapte,Computer Science
508,2015,Informatique,3,Algorithme et Programmation,3,Les Langagues de Programmation,8,509,1,QROC,0.04,0.78,75.99,6,2,8,6,6,0,1.33,100.0,Moyen,Facile,1,Plus Facile,Pas Adapte,Computer Science
1619,2016,Informatique,3,Algorithme et Programmation,3,Les Langagues de Programmation,8,509,1,QROC,0.82,0.1,15.64,1,7,8,4,1,3,2.0,25.0,Facile,Difficile,-2,Beaucoup plus Difficile,Pas Adapte,Computer Science
2730,2017,Informatique,3,Algorithme et Programmation,3,Les Langagues de Programmation,8,509,1,QROC,0.81,0.23,6.21,0,7,7,5,0,5,1.4,0.0,Difficile,Difficile,0,Meme Difficulté,Pas Adapte,Computer Science
3841,2018,Informatique,3,Algorithme et Programmation,3,Les Langagues de Programmation,8,509,1,QROC,0.26,0.38,61.69,4,2,6,5,4,1,1.2,80.0,Facile,Moyen,-1,Plus Difficile,Adapte,Computer Science
4952,2019,Informatique,3,Algorithme et Programmation,3,Les Langagues de Programmation,8,509,1,QO,0.34,0.24,61.69,3,2,5,3,3,0,1.67,100.0,Moyen,Moyen,0,Meme Difficulté,Adapte,Computer Science
6063,2020,Informatique,3,Algorithme et Programmation,3,Les Langagues de Programmation,8,509,1,QO,0.51,0.28,61.69,3,2,5,4,3,1,1.25,75.0,Moyen,Moyen,0,Meme Difficulté,Adapte,Computer Science
509,2015,Informatique,3,Algorithme et Programmation,3,Les Langagues de Programmation,8,510,2,QCU,0.4,0.69,63.81,36,21,57,57,36,21,1.0,63.16,Difficile,Moyen,1,Plus Facile,Adapte,Computer Science
1620,2016,Informatique,3,Algorithme et Programmation,3,Les Langagues de Programmation,8,510,2,QCU,0.3,0.68,63.81,41,24,65,49,41,8,1.33,83.67,Moyen,Moyen,0,Meme Difficulté,Adapte,Computer Science
2731,2017,Informatique,3,Algorithme et Programmation,3,Les Langagues de Programmation,8,510,2,QCU,0.4,0.67,63.81,38,22,60,53,38,15,1.13,71.7,Moyen,Moyen,0,Meme Difficulté,Adapte,Computer Science
3842,2018,Informatique,3,Algorithme et Programmation,3,Les Langagues de Programmation,8,510,2,QCM,0.49,0.62,63.81,44,25,69,59,44,15,1.17,74.58,Moyen,Moyen,0,Meme Difficulté,Adapte,Computer Science
4953,2019,Informatique,3,Algorithme et Programmation,3,Les Langagues de Programmation,8,510,2,QCU,0.32,0.41,63.81,40,22,62,55,40,15,1.13,72.73,Moyen,Moyen,0,Meme Difficulté,Adapte,Computer Science
6064,2020,Informatique,3,Algorithme et Programmation,3,Les Langagues de Programmation,8,510,2,QCU,0.4,0.66,63.81,43,25,68,63,43,20,1.08,68.25,Moyen,Moyen,0,Meme Difficulté,Adapte,Computer Science
510,2015,Informatique,3,Algorithme et Programmation,3,Les Langagues de Programmation,8,511,3,QCU,0.2,0.9,74.07,26,9,35,32,26,6,1.09,81.25,Difficile,Facile,2,Beaucoup plus Facile,Adapte,Computer Science
1621,2016,Informatique,3,Algorithme et Programmation,3,Les Langagues de Programmation,8,511,3,QROC,0.06,0.9,74.07,22,8,30,25,22,3,1.2,88.0,Facile,Facile,0,Meme Difficulté,Adapte,Computer Science
2732,2017,Informatique,3,Algorithme et Programmation,3,Les Langagues de Programmation,8,511,3,QROC,0.09,0.5,74.07,24,9,33,26,24,2,1.27,92.31,Facile,Facile,0,Meme Difficulté,Adapte,Computer Science
3843,2018,Informatique,3,Algorithme et Programmation,3,Les Langagues de Programmation,8,511,3,QROC,0.14,1.0,74.07,21,8,29,23,21,2,1.26,91.3,Facile,Facile,0,Meme Difficulté,Adapte,Computer Science
4954,2019,Informatique,3,Algorithme et Programmation,3,Les Langagues de Programmation,8,511,3,QROC,0.17,0.7,74.07,23,8,31,26,23,3,1.19,88.46,Facile,Facile,0,Meme Difficulté,Adapte,Computer Science
6065,2020,Informatique,3,Algorithme et Programmation,3,Les Langagues de Programmation,8,511,3,QO,0.18,0.51,74.07,26,9,35,32,26,6,1.09,81.25,Facile,Facile,0,Meme Difficulté,Adapte,Computer Science
511,2015,Informatique,3,Algorithme et Programmation,3,Les Langagues de Programmation,8,512,4,QCU,0.1,0.83,90.54,12,1,13,13,12,1,1.0,92.31,Difficile,Facile,2,Beaucoup plus Facile,Pas Adapte,Computer Science
1622,2016,Informatique,3,Algorithme et Programmation,3,Les Langagues de Programmation,8,512,4,QCU,0.27,0.63,51.23,7,7,14,9,7,2,1.56,77.78,Moyen,Moyen,0,Meme Difficulté,Pas Adapte,Computer Science
2733,2017,Informatique,3,Algorithme et Programmation,3,Les Langagues de Programmation,8,512,4,QO,0.87,0.03,4.34,1,15,16,14,1,13,1.14,7.14,Moyen,Difficile,-1,Plus Difficile,Pas Adapte,Computer Science
3844,2018,Informatique,3,Algorithme et Programmation,3,Les Langagues de Programmation,8,512,4,QO,0.97,0.09,24.27,4,13,17,10,4,6,1.7,40.0,Difficile,Difficile,0,Meme Difficulté,Pas Adapte,Computer Science
4955,2019,Informatique,3,Algorithme et Programmation,3,Les Langagues de Programmation,8,512,4,QO,0.67,0.25,57.4,11,8,19,13,11,2,1.46,84.62,Moyen,Moyen,0,Meme Difficulté,Pas Adapte,Computer Science
6066,2020,Informatique,3,Algorithme et Programmation,3,Les Langagues de Programmation,8,512,4,QO,0.1,0.48,77.94,13,4,17,15,13,2,1.13,86.67,Difficile,Facile,2,Beaucoup plus Facile,Pas Adapte,Computer Science
512,2015,Informatique,3,Algorithme et Programmation,3,Les Langagues de Programmation,8,513,5,QCU,0.12,0.81,78.41,24,7,31,25,24,1,1.24,96.0,Difficile,Facile,2,Beaucoup plus Facile,Pas Adapte,Computer Science
1623,2016,Informatique,3,Algorithme et Programmation,3,Les Langagues de Programmation,8,513,5,QCU,0.04,0.94,81.07,24,6,30,29,24,5,1.03,82.76,Difficile,Facile,2,Beaucoup plus Facile,Pas Adapte,Computer Science
2734,2017,Informatique,3,Algorithme et Programmation,3,Les Langagues de Programmation,8,513,5,QCU,0.31,0.69,38.21,10,17,27,13,10,3,2.08,76.92,Facile,Moyen,-1,Plus Difficile,Pas Adapte,Computer Science
3845,2018,Informatique,3,Algorithme et Programmation,3,Les Langagues de Programmation,8,513,5,QCU,0.17,0.93,98.06,23,0,23,23,23,0,1.0,100.0,Difficile,Facile,2,Beaucoup plus Facile,Pas Adapte,Computer Science
4956,2019,Informatique,3,Algorithme et Programmation,3,Les Langagues de Programmation,8,513,5,QCU,0.38,0.57,62.45,15,9,24,23,15,8,1.04,65.22,Moyen,Moyen,0,Meme Difficulté,Adapte,Computer Science
6067,2020,Informatique,3,Algorithme et Programmation,3,Les Langagues de Programmation,8,513,5,QCU,0.26,0.41,62.45,14,9,23,21,14,7,1.1,66.67,Moyen,Moyen,0,Meme Difficulté,Adapte,Computer Science
513,2015,Informatique,3,Algorithme et Programmation,3,Les Langagues de Programmation,8,514,6,QCM,0.73,0.26,5.54,4,60,64,39,4,35,1.64,10.26,Difficile,Difficile,0,Meme Difficulté,Pas Adapte,Computer Science
1624,2016,Informatique,3,Algorithme et Programmation,3,Les Langagues de Programmation,8,514,6,QCM,0.43,0.66,44.07,31,40,71,48,31,17,1.48,64.58,Difficile,Moyen,1,Plus Facile,Pas Adapte,Computer Science
2735,2017,Informatique,3,Algorithme et Programmation,3,Les Langagues de Programmation,8,514,6,QCM,0.47,0.55,37.61,30,50,80,78,30,48,1.03,38.46,Facile,Moyen,-1,Plus Difficile,Pas Adapte,Computer Science
3846,2018,Informatique,3,Algorithme et Programmation,3,Les Langagues de Programmation,8,514,6,QCM,0.17,0.74,70.77,58,24,82,79,58,21,1.04,73.42,Difficile,Facile,2,Beaucoup plus Facile,Adapte,Computer Science
4957,2019,Informatique,3,Algorithme et Programmation,3,Les Langagues de Programmation,8,514,6,QCM,0.05,0.97,70.77,55,23,78,63,55,8,1.24,87.3,Facile,Facile,0,Meme Difficulté,Adapte,Computer Science
6068,2020,Informatique,3,Algorithme et Programmation,3,Les Langagues de Programmation,8,514,6,QCM,0.12,0.77,70.77,61,25,86,74,61,13,1.16,82.43,Facile,Facile,0,Meme Difficulté,Adapte,Computer Science
514,2015,Informatique,3,Algorithme et Programmation,3,Les Langagues de Programmation,8,515,7,QCU,0.28,0.44,41.36,14,21,35,25,14,11,1.4,56.0,Facile,Moyen,-1,Plus Difficile,Pas Adapte,Computer Science
1625,2016,Informatique,3,Algorithme et Programmation,3,Les Langagues de Programmation,8,515,7,QCU,0.33,0.69,42.18,17,23,40,35,17,18,1.14,48.57,Facile,Moyen,-1,Plus Difficile,Pas Adapte,Computer Science
2736,2017,Informatique,3,Algorithme et Programmation,3,Les Langagues de Programmation,8,515,7,QCU,0.33,0.56,48.83,17,18,35,25,17,8,1.4,68.0,Difficile,Moyen,1,Plus Facile,Pas Adapte,Computer Science
3847,2018,Informatique,3,Algorithme et Programmation,3,Les Langagues de Programmation,8,515,7,QCU,0.09,0.99,70.35,25,11,36,35,25,10,1.03,71.43,Difficile,Facile,2,Beaucoup plus Facile,Adapte,Computer Science
4958,2019,Informatique,3,Algorithme et Programmation,3,Les Langagues de Programmation,8,515,7,QCU,0.19,0.9,70.35,22,9,31,22,22,0,1.41,100.0,Facile,Facile,0,Meme Difficulté,Adapte,Computer Science
6069,2020,Informatique,3,Algorithme et Programmation,3,Les Langagues de Programmation,8,515,7,QROC,0.18,0.56,70.35,22,9,31,28,22,6,1.11,78.57,Facile,Facile,0,Meme Difficulté,Adapte,Computer Science
515,2015,Informatique,3,Algorithme et Programmation,3,Les Langagues de Programmation,8,516,8,QCM,0.77,0.15,27.3,27,72,99,31,27,4,3.19,87.1,Difficile,Difficile,0,Meme Difficulté,Pas Adapte,Computer Science
1626,2016,Informatique,3,Algorithme et Programmation,3,Les Langagues de Programmation,8,516,8,QCM,0.02,0.82,97.5,108,3,111,108,108,0,1.03,100.0,Facile,Facile,0,Meme Difficulté,Pas Adapte,Computer Science
2737,2017,Informatique,3,Algorithme et Programmation,3,Les Langagues de Programmation,8,516,8,QCM,0.21,0.66,57.56,74,54,128,113,74,39,1.13,65.49,Moyen,Moyen,0,Meme Difficulté,Pas Adapte,Computer Science
3848,2018,Informatique,3,Algorithme et Programmation,3,Les Langagues de Programmation,8,516,8,QCM,0.47,0.7,40.49,46,68,114,107,46,61,1.07,42.99,Moyen,Moyen,0,Meme Difficulté,Pas Adapte,Computer Science
4959,2019,Informatique,3,Algorithme et Programmation,3,Les Langagues de Programmation,8,516,8,QCM,0.53,0.16,33.54,35,69,104,83,35,48,1.25,42.17,Moyen,Difficile,-1,Plus Difficile,Pas Adapte,Computer Science
6070,2020,Informatique,3,Algorithme et Programmation,3,Les Langagues de Programmation,8,516,8,QCM,0.65,0.27,20.4,20,78,98,39,20,19,2.51,51.28,Moyen,Difficile,-1,Plus Difficile,Pas Adapte,Computer Science
516,2015,Informatique,4,Reseaux et Internet,1,Notion de Reseau Informatique,10,517,1,QO,0.18,0.84,88.88,42,5,47,46,42,4,1.02,91.3,Facile,Facile,0,Meme Difficulté,Pas Adapte,Computer Science
1627,2016,Informatique,4,Reseaux et Internet,1,Notion de Reseau Informatique,10,517,1,QO,0.14,0.52,78.3,32,9,41,36,32,4,1.14,88.89,Difficile,Facile,2,Beaucoup plus Facile,Pas Adapte,Computer Science
2738,2017,Informatique,4,Reseaux et Internet,1,Notion de Reseau Informatique,10,517,1,QO,0.14,0.34,87.9,39,5,44,39,39,0,1.13,100.0,Facile,Facile,0,Meme Difficulté,Pas Adapte,Computer Science
3849,2018,Informatique,4,Reseaux et Internet,1,Notion de Reseau Informatique,10,517,1,QO,0.15,1.0,93.34,44,3,47,47,44,3,1.0,93.62,Facile,Facile,0,Meme Difficulté,Pas Adapte,Computer Science
4960,2019,Informatique,4,Reseaux et Internet,1,Notion de Reseau Informatique,10,517,1,QO,0.98,0.13,2.15,1,40,41,41,1,40,1.0,2.44,Facile,Difficile,-2,Beaucoup plus Difficile,Pas Adapte,Computer Science
6071,2020,Informatique,4,Reseaux et Internet,1,Notion de Reseau Informatique,10,517,1,QO,0.81,0.12,6.82,3,43,46,30,3,27,1.53,10.0,Moyen,Difficile,-1,Plus Difficile,Pas Adapte,Computer Science
517,2015,Informatique,4,Reseaux et Internet,1,Notion de Reseau Informatique,10,518,2,QROC,0.58,0.33,41.67,23,31,54,43,23,20,1.26,53.49,Difficile,Moyen,1,Plus Facile,Pas Adapte,Computer Science
1628,2016,Informatique,4,Reseaux et Internet,1,Notion de Reseau Informatique,10,518,2,QROC,0.05,0.97,87.73,41,6,47,46,41,5,1.02,89.13,Facile,Facile,0,Meme Difficulté,Pas Adapte,Computer Science
2739,2017,Informatique,4,Reseaux et Internet,1,Notion de Reseau Informatique,10,518,2,QROC,0.33,0.31,40.06,18,26,44,24,18,6,1.83,75.0,Facile,Moyen,-1,Plus Difficile,Pas Adapte,Computer Science
3850,2018,Informatique,4,Reseaux et Internet,1,Notion de Reseau Informatique,10,518,2,QROC,0.91,0.16,8.88,4,37,41,21,4,17,1.95,19.05,Facile,Difficile,-2,Beaucoup plus Difficile,Pas Adapte,Computer Science
4961,2019,Informatique,4,Reseaux et Internet,1,Notion de Reseau Informatique,10,518,2,QROC,0.98,0.13,17.56,7,33,40,31,7,24,1.29,22.58,Difficile,Difficile,0,Meme Difficulté,Pas Adapte,Computer Science
6072,2020,Informatique,4,Reseaux et Internet,1,Notion de Reseau Informatique,10,518,2,QROC,0.08,0.46,85.15,36,6,42,39,36,3,1.08,92.31,Moyen,Facile,1,Plus Facile,Pas Adapte,Computer Science
518,2015,Informatique,4,Reseaux et Internet,1,Notion de Reseau Informatique,10,519,3,QROC,0.55,0.35,35.83,9,17,26,17,9,8,1.53,52.94,Facile,Moyen,-1,Plus Difficile,Pas Adapte,Computer Science
1629,2016,Informatique,4,Reseaux et Internet,1,Notion de Reseau Informatique,10,519,3,QROC,0.57,0.33,42.41,9,13,22,11,9,2,2.0,81.82,Difficile,Moyen,1,Plus Facile,Pas Adapte,Computer Science
2740,2017,Informatique,4,Reseaux et Internet,1,Notion de Reseau Informatique,10,519,3,QROC,0.95,0.11,33.21,6,13,19,16,6,10,1.19,37.5,Facile,Difficile,-2,Beaucoup plus Difficile,Pas Adapte,Computer Science
3851,2018,Informatique,4,Reseaux et Internet,1,Notion de Reseau Informatique,10,519,3,QROC,0.1,0.53,74.91,12,4,16,14,12,2,1.14,85.71,Moyen,Facile,1,Plus Facile,Adapte,Computer Science
4962,2019,Informatique,4,Reseaux et Internet,1,Notion de Reseau Informatique,10,519,3,QROC,0.07,0.63,74.91,12,4,16,13,12,1,1.23,92.31,Facile,Facile,0,Meme Difficulté,Adapte,Computer Science
6073,2020,Informatique,4,Reseaux et Internet,1,Notion de Reseau Informatique,10,519,3,QROC,0.04,0.63,74.91,13,5,18,15,13,2,1.2,86.67,Facile,Facile,0,Meme Difficulté,Adapte,Computer Science
519,2015,Informatique,4,Reseaux et Internet,1,Notion de Reseau Informatique,10,520,4,QCU,0.73,0.35,16.91,17,81,98,40,17,23,2.45,42.5,Difficile,Difficile,0,Meme Difficulté,Pas Adapte,Computer Science
1630,2016,Informatique,4,Reseaux et Internet,1,Notion de Reseau Informatique,10,520,4,QCU,0.29,0.47,57.87,54,40,94,93,54,39,1.01,58.06,Moyen,Moyen,0,Meme Difficulté,Pas Adapte,Computer Science
2741,2017,Informatique,4,Reseaux et Internet,1,Notion de Reseau Informatique,10,520,4,QCM,0.08,0.84,93.34,89,6,95,90,89,1,1.06,98.89,Difficile,Facile,2,Beaucoup plus Facile,Pas Adapte,Computer Science
3852,2018,Informatique,4,Reseaux et Internet,1,Notion de Reseau Informatique,10,520,4,QCM,0.02,0.72,97.85,97,2,99,98,97,1,1.01,98.98,Moyen,Facile,1,Plus Facile,Pas Adapte,Computer Science
4963,2019,Informatique,4,Reseaux et Internet,1,Notion de Reseau Informatique,10,520,4,QCM,0.22,0.68,44.36,47,59,106,92,47,45,1.15,51.09,Moyen,Moyen,0,Meme Difficulté,Pas Adapte,Computer Science
6074,2020,Informatique,4,Reseaux et Internet,1,Notion de Reseau Informatique,10,520,4,QCM,0.09,0.93,69.24,75,34,109,89,75,14,1.22,84.27,Difficile,Facile,2,Beaucoup plus Facile,Adapte,Computer Science
520,2015,Informatique,4,Reseaux et Internet,1,Notion de Reseau Informatique,10,521,5,QCU,0.55,0.21,12.33,7,53,60,55,7,48,1.09,12.73,Moyen,Difficile,-1,Plus Difficile,Pas Adapte,Computer Science
1631,2016,Informatique,4,Reseaux et Internet,1,Notion de Reseau Informatique,10,521,5,QCU,0.07,0.88,72.35,43,17,60,53,43,10,1.13,81.13,Moyen,Facile,1,Plus Facile,Adapte,Computer Science
2742,2017,Informatique,4,Reseaux et Internet,1,Notion de Reseau Informatique,10,521,5,QCU,0.17,0.86,72.35,46,18,64,47,46,1,1.36,97.87,Facile,Facile,0,Meme Difficulté,Adapte,Computer Science
3853,2018,Informatique,4,Reseaux et Internet,1,Notion de Reseau Informatique,10,521,5,QCU,0.09,0.97,72.35,43,17,60,47,43,4,1.28,91.49,Facile,Facile,0,Meme Difficulté,Adapte,Computer Science
4964,2019,Informatique,4,Reseaux et Internet,1,Notion de Reseau Informatique,10,521,5,QROC,0.06,0.52,72.35,49,19,68,59,49,10,1.15,83.05,Facile,Facile,0,Meme Difficulté,Adapte,Computer Science
6075,2020,Informatique,4,Reseaux et Internet,1,Notion de Reseau Informatique,10,521,5,QCU,0.09,0.95,72.35,45,17,62,55,45,10,1.13,81.82,Facile,Facile,0,Meme Difficulté,Adapte,Computer Science
521,2015,Informatique,4,Reseaux et Internet,1,Notion de Reseau Informatique,10,522,6,QCU,0.58,0.36,23.37,11,35,46,45,11,34,1.02,24.44,Moyen,Difficile,-1,Plus Difficile,Pas Adapte,Computer Science
1632,2016,Informatique,4,Reseaux et Internet,1,Notion de Reseau Informatique,10,522,6,QO,0.84,0.01,32.35,14,28,42,36,14,22,1.17,38.89,Difficile,Difficile,0,Meme Difficulté,Pas Adapte,Computer Science
2743,2017,Informatique,4,Reseaux et Internet,1,Notion de Reseau Informatique,10,522,6,QO,0.11,1.0,65.69,32,16,48,46,32,14,1.04,69.57,Moyen,Facile,1,Plus Facile,Adapte,Computer Science
3854,2018,Informatique,4,Reseaux et Internet,1,Notion de Reseau Informatique,10,522,6,QO,0.16,0.69,65.69,32,16,48,42,32,10,1.14,76.19,Facile,Facile,0,Meme Difficulté,Adapte,Computer Science
4965,2019,Informatique,4,Reseaux et Internet,1,Notion de Reseau Informatique,10,522,6,QO,0.18,0.93,65.69,32,17,49,43,32,11,1.14,74.42,Facile,Facile,0,Meme Difficulté,Adapte,Computer Science
6076,2020,Informatique,4,Reseaux et Internet,1,Notion de Reseau Informatique,10,522,6,QO,0.01,0.71,65.69,35,19,54,41,35,6,1.32,85.37,Facile,Facile,0,Meme Difficulté,Adapte,Computer Science
522,2015,Informatique,4,Reseaux et Internet,1,Notion de Reseau Informatique,10,523,7,QROC,0.16,0.77,72.07,24,9,33,30,24,6,1.1,80.0,Moyen,Facile,1,Plus Facile,Adapte,Computer Science
1633,2016,Informatique,4,Reseaux et Internet,1,Notion de Reseau Informatique,10,523,7,QROC,0.05,0.9,72.07,26,10,36,36,26,10,1.0,72.22,Facile,Facile,0,Meme Difficulté,Adapte,Computer Science
2744,2017,Informatique,4,Reseaux et Internet,1,Notion de Reseau Informatique,10,523,7,QROC,0.06,0.97,72.07,25,9,34,27,25,2,1.26,92.59,Facile,Facile,0,Meme Difficulté,Adapte,Computer Science
3855,2018,Informatique,4,Reseaux et Internet,1,Notion de Reseau Informatique,10,523,7,QO,0.02,0.92,72.07,22,9,31,29,22,7,1.07,75.86,Facile,Facile,0,Meme Difficulté,Adapte,Computer Science
4966,2019,Informatique,4,Reseaux et Internet,1,Notion de Reseau Informatique,10,523,7,QO,0.06,0.44,72.07,21,8,29,26,21,5,1.12,80.77,Facile,Facile,0,Meme Difficulté,Adapte,Computer Science
6077,2020,Informatique,4,Reseaux et Internet,1,Notion de Reseau Informatique,10,523,7,QROC,0.14,0.43,72.07,19,8,27,23,19,4,1.17,82.61,Facile,Facile,0,Meme Difficulté,Adapte,Computer Science
523,2015,Informatique,4,Reseaux et Internet,1,Notion de Reseau Informatique,10,524,8,QCU,0.33,0.57,42.79,23,30,53,42,23,19,1.26,54.76,Difficile,Moyen,1,Plus Facile,Pas Adapte,Computer Science
1634,2016,Informatique,4,Reseaux et Internet,1,Notion de Reseau Informatique,10,524,8,QCU,0.03,0.88,73.37,43,15,58,57,43,14,1.02,75.44,Facile,Facile,0,Meme Difficulté,Adapte,Computer Science
2745,2017,Informatique,4,Reseaux et Internet,1,Notion de Reseau Informatique,10,524,8,QROC,0.11,0.96,73.37,44,16,60,51,44,7,1.18,86.27,Facile,Facile,0,Meme Difficulté,Adapte,Computer Science
3856,2018,Informatique,4,Reseaux et Internet,1,Notion de Reseau Informatique,10,524,8,QO,0.15,0.72,73.37,40,15,55,50,40,10,1.1,80.0,Facile,Facile,0,Meme Difficulté,Adapte,Computer Science
4967,2019,Informatique,4,Reseaux et Internet,1,Notion de Reseau Informatique,10,524,8,QCM,0.12,0.94,73.37,40,14,54,52,40,12,1.04,76.92,Facile,Facile,0,Meme Difficulté,Adapte,Computer Science
6078,2020,Informatique,4,Reseaux et Internet,1,Notion de Reseau Informatique,10,524,8,QCM,0.09,0.97,73.37,35,13,48,42,35,7,1.14,83.33,Facile,Facile,0,Meme Difficulté,Adapte,Computer Science
524,2015,Informatique,4,Reseaux et Internet,1,Notion de Reseau Informatique,10,525,9,QROC,0.97,0.17,26.94,25,66,91,69,25,44,1.32,36.23,Facile,Difficile,-2,Beaucoup plus Difficile,Pas Adapte,Computer Science
1635,2016,Informatique,4,Reseaux et Internet,1,Notion de Reseau Informatique,10,525,9,QROC,0.38,0.35,39.83,35,53,88,63,35,28,1.4,55.56,Moyen,Moyen,0,Meme Difficulté,Pas Adapte,Computer Science
2746,2017,Informatique,4,Reseaux et Internet,1,Notion de Reseau Informatique,10,525,9,QCM,0.51,0.28,23.32,18,59,77,75,18,57,1.03,24.0,Moyen,Difficile,-1,Plus Difficile,Pas Adapte,Computer Science
3857,2018,Informatique,4,Reseaux et Internet,1,Notion de Reseau Informatique,10,525,9,QCM,0.21,0.33,49.96,37,37,74,42,37,5,1.76,88.1,Facile,Moyen,-1,Plus Difficile,Pas Adapte,Computer Science
4968,2019,Informatique,4,Reseaux et Internet,1,Notion de Reseau Informatique,10,525,9,QCM,0.43,0.67,45.19,28,35,63,63,28,35,1.0,44.44,Facile,Moyen,-1,Plus Difficile,Pas Adapte,Computer Science
6079,2020,Informatique,4,Reseaux et Internet,1,Notion de Reseau Informatique,10,525,9,QCM,0.65,0.19,18.12,10,44,54,45,10,35,1.2,22.22,Facile,Difficile,-2,Beaucoup plus Difficile,Pas Adapte,Computer Science
525,2015,Informatique,4,Reseaux et Internet,1,Notion de Reseau Informatique,10,526,10,QCU,0.26,0.47,39.75,33,50,83,63,33,30,1.32,52.38,Facile,Moyen,-1,Plus Difficile,Pas Adapte,Computer Science
1636,2016,Informatique,4,Reseaux et Internet,1,Notion de Reseau Informatique,10,526,10,QCU,0.28,0.5,46.3,40,46,86,56,40,16,1.54,71.43,Moyen,Moyen,0,Meme Difficulté,Pas Adapte,Computer Science
2747,2017,Informatique,4,Reseaux et Internet,1,Notion de Reseau Informatique,10,526,10,QCU,0.12,0.86,96.92,77,2,79,77,77,0,1.03,100.0,Facile,Facile,0,Meme Difficulté,Pas Adapte,Computer Science
3858,2018,Informatique,4,Reseaux et Internet,1,Notion de Reseau Informatique,10,526,10,QCU,0.09,0.77,78.64,59,16,75,63,59,4,1.19,93.65,Facile,Facile,0,Meme Difficulté,Pas Adapte,Computer Science
4969,2019,Informatique,4,Reseaux et Internet,1,Notion de Reseau Informatique,10,526,10,QCU,0.29,0.48,41.73,29,40,69,31,29,2,2.23,93.55,Moyen,Moyen,0,Meme Difficulté,Pas Adapte,Computer Science
6080,2020,Informatique,4,Reseaux et Internet,1,Notion de Reseau Informatique,10,526,10,QCU,0.03,0.82,74.17,50,17,67,63,50,13,1.06,79.37,Facile,Facile,0,Meme Difficulté,Adapte,Computer Science
526,2015,Mathématiques,1,L'Algebre Lineaire,1,Sommes de Sous Espaces,12,527,1,QCU,0.22,0.74,45.0,27,34,61,50,27,23,1.22,54.0,Difficile,Moyen,1,Plus Facile,Pas Adapte,Mathematics
1637,2016,Mathématiques,1,L'Algebre Lineaire,1,Sommes de Sous Espaces,12,527,1,QCM,0.3,0.58,37.0,23,40,63,62,23,39,1.02,37.1,Difficile,Moyen,1,Plus Facile,Pas Adapte,Mathematics
2748,2017,Mathématiques,1,L'Algebre Lineaire,1,Sommes de Sous Espaces,12,527,1,QCU,0.43,0.35,19.0,10,45,55,21,10,11,2.62,47.62,Facile,Difficile,-2,Beaucoup plus Difficile,Pas Adapte,Mathematics
3859,2018,Mathématiques,1,L'Algebre Lineaire,1,Sommes de Sous Espaces,12,527,1,QCU,0.29,0.67,45.0,27,33,60,37,27,10,1.62,72.97,Facile,Moyen,-1,Plus Difficile,Pas Adapte,Mathematics
4970,2019,Mathématiques,1,L'Algebre Lineaire,1,Sommes de Sous Espaces,12,527,1,QCU,0.41,0.26,14.0,9,53,62,21,9,12,2.95,42.86,Moyen,Difficile,-1,Plus Difficile,Pas Adapte,Mathematics
6081,2020,Mathématiques,1,L'Algebre Lineaire,1,Sommes de Sous Espaces,12,527,1,QCU,0.39,0.45,38.0,27,44,71,53,27,26,1.34,50.94,Difficile,Moyen,1,Plus Facile,Pas Adapte,Mathematics
527,2015,Mathématiques,1,L'Algebre Lineaire,1,Sommes de Sous Espaces,12,528,2,QROC,0.57,0.34,36.0,6,10,16,9,6,3,1.78,66.67,Difficile,Moyen,1,Plus Facile,Pas Adapte,Mathematics
1638,2016,Mathématiques,1,L'Algebre Lineaire,1,Sommes de Sous Espaces,12,528,2,QO,0.55,0.2,48.0,8,8,16,9,8,1,1.78,88.89,Difficile,Moyen,1,Plus Facile,Pas Adapte,Mathematics
2749,2017,Mathématiques,1,L'Algebre Lineaire,1,Sommes de Sous Espaces,12,528,2,QCU,0.71,0.32,2.0,0,18,18,12,0,12,1.5,0.0,Facile,Difficile,-2,Beaucoup plus Difficile,Pas Adapte,Mathematics
3860,2018,Mathématiques,1,L'Algebre Lineaire,1,Sommes de Sous Espaces,12,528,2,QCU,0.46,0.38,31.0,5,12,17,17,5,12,1.0,29.41,Difficile,Difficile,0,Meme Difficulté,Pas Adapte,Mathematics
4971,2019,Mathématiques,1,L'Algebre Lineaire,1,Sommes de Sous Espaces,12,528,2,QO,0.69,0.25,42.0,7,9,16,14,7,7,1.14,50.0,Moyen,Moyen,0,Meme Difficulté,Pas Adapte,Mathematics
6082,2020,Mathématiques,1,L'Algebre Lineaire,1,Sommes de Sous Espaces,12,528,2,QO,0.93,0.05,28.0,4,11,15,8,4,4,1.88,50.0,Facile,Difficile,-2,Beaucoup plus Difficile,Pas Adapte,Mathematics
528,2015,Mathématiques,1,L'Algebre Lineaire,1,Sommes de Sous Espaces,12,529,3,QCU,0.64,0.3,29.0,21,51,72,46,21,25,1.57,45.65,Facile,Difficile,-2,Beaucoup plus Difficile,Pas Adapte,Mathematics
1639,2016,Mathématiques,1,L'Algebre Lineaire,1,Sommes de Sous Espaces,12,529,3,QCU,0.3,0.45,48.0,38,42,80,54,38,16,1.48,70.37,Facile,Moyen,-1,Plus Difficile,Pas Adapte,Mathematics
2750,2017,Mathématiques,1,L'Algebre Lineaire,1,Sommes de Sous Espaces,12,529,3,QCU,0.28,0.7,40.0,29,44,73,52,29,23,1.4,55.77,Moyen,Moyen,0,Meme Difficulté,Pas Adapte,Mathematics
3861,2018,Mathématiques,1,L'Algebre Lineaire,1,Sommes de Sous Espaces,12,529,3,QCU,0.66,0.39,24.0,16,51,67,24,16,8,2.79,66.67,Difficile,Difficile,0,Meme Difficulté,Pas Adapte,Mathematics
4972,2019,Mathématiques,1,L'Algebre Lineaire,1,Sommes de Sous Espaces,12,529,3,QCU,0.57,0.21,24.0,17,54,71,55,17,38,1.29,30.91,Facile,Difficile,-2,Beaucoup plus Difficile,Pas Adapte,Mathematics
6083,2020,Mathématiques,1,L'Algebre Lineaire,1,Sommes de Sous Espaces,12,529,3,QCU,0.47,0.4,2.0,2,73,75,51,2,49,1.47,3.92,Moyen,Difficile,-1,Plus Difficile,Pas Adapte,Mathematics
529,2015,Mathématiques,1,L'Algebre Lineaire,1,Sommes de Sous Espaces,12,530,4,QCU,0.71,0.23,14.0,13,82,95,83,13,70,1.14,15.66,Difficile,Difficile,0,Meme Difficulté,Pas Adapte,Mathematics
1640,2016,Mathématiques,1,L'Algebre Lineaire,1,Sommes de Sous Espaces,12,530,4,QCU,0.69,0.24,24.0,23,71,94,90,23,67,1.04,25.56,Difficile,Difficile,0,Meme Difficulté,Pas Adapte,Mathematics
2751,2017,Mathématiques,1,L'Algebre Lineaire,1,Sommes de Sous Espaces,12,530,4,QCU,0.37,0.67,42.0,44,61,105,88,44,44,1.19,50.0,Difficile,Moyen,1,Plus Facile,Pas Adapte,Mathematics
3862,2018,Mathématiques,1,L'Algebre Lineaire,1,Sommes de Sous Espaces,12,530,4,QCU,0.28,0.59,37.0,34,58,92,38,34,4,2.42,89.47,Moyen,Moyen,0,Meme Difficulté,Pas Adapte,Mathematics
4973,2019,Mathématiques,1,L'Algebre Lineaire,1,Sommes de Sous Espaces,12,530,4,QCU,0.73,0.39,18.0,14,65,79,29,14,15,2.72,48.28,Difficile,Difficile,0,Meme Difficulté,Pas Adapte,Mathematics
6084,2020,Mathématiques,1,L'Algebre Lineaire,1,Sommes de Sous Espaces,12,530,4,QCM,0.22,0.38,50.0,45,45,90,64,45,19,1.41,70.31,Moyen,Moyen,0,Meme Difficulté,Pas Adapte,Mathematics
530,2015,Mathématiques,1,L'Algebre Lineaire,1,Sommes de Sous Espaces,12,531,5,QCU,0.57,0.21,32.0,23,50,73,35,23,12,2.09,65.71,Facile,Difficile,-2,Beaucoup plus Difficile,Pas Adapte,Mathematics
1641,2016,Mathématiques,1,L'Algebre Lineaire,1,Sommes de Sous Espaces,12,531,5,QCU,0.74,0.37,30.0,22,50,72,48,22,26,1.5,45.83,Facile,Difficile,-2,Beaucoup plus Difficile,Pas Adapte,Mathematics
2752,2017,Mathématiques,1,L'Algebre Lineaire,1,Sommes de Sous Espaces,12,531,5,QCU,0.73,0.26,3.0,2,67,69,25,2,23,2.76,8.0,Difficile,Difficile,0,Meme Difficulté,Pas Adapte,Mathematics
3863,2018,Mathématiques,1,L'Algebre Lineaire,1,Sommes de Sous Espaces,12,531,5,QCU,0.36,0.66,60.0,41,28,69,64,41,23,1.08,64.06,Difficile,Moyen,1,Plus Facile,Adapte,Mathematics
4974,2019,Mathématiques,1,L'Algebre Lineaire,1,Sommes de Sous Espaces,12,531,5,QCM,0.27,0.65,60.0,37,25,62,52,37,15,1.19,71.15,Moyen,Moyen,0,Meme Difficulté,Adapte,Mathematics
6085,2020,Mathématiques,1,L'Algebre Lineaire,1,Sommes de Sous Espaces,12,531,5,QCM,0.36,0.61,60.0,39,26,65,64,39,25,1.02,60.94,Moyen,Moyen,0,Meme Difficulté,Adapte,Mathematics
531,2015,Mathématiques,1,L'Algebre Lineaire,1,Sommes de Sous Espaces,12,532,6,QCU,0.51,0.37,2.0,2,82,84,29,2,27,2.9,6.9,Difficile,Difficile,0,Meme Difficulté,Pas Adapte,Mathematics
1642,2016,Mathématiques,1,L'Algebre Lineaire,1,Sommes de Sous Espaces,12,532,6,QCU,0.39,0.51,40.0,38,56,94,83,38,45,1.13,45.78,Difficile,Moyen,1,Plus Facile,Pas Adapte,Mathematics
2753,2017,Mathématiques,1,L'Algebre Lineaire,1,Sommes de Sous Espaces,12,532,6,QCU,0.52,0.34,31.0,32,70,102,90,32,58,1.13,35.56,Moyen,Difficile,-1,Plus Difficile,Pas Adapte,Mathematics
3864,2018,Mathématiques,1,L'Algebre Lineaire,1,Sommes de Sous Espaces,12,532,6,QCU,0.25,0.56,59.0,60,42,102,61,60,1,1.67,98.36,Difficile,Moyen,1,Plus Facile,Pas Adapte,Mathematics
4975,2019,Mathématiques,1,L'Algebre Lineaire,1,Sommes de Sous Espaces,12,532,6,QCU,0.35,0.68,55.0,51,42,93,69,51,18,1.35,73.91,Facile,Moyen,-1,Plus Difficile,Pas Adapte,Mathematics
6086,2020,Mathématiques,1,L'Algebre Lineaire,1,Sommes de Sous Espaces,12,532,6,QCU,0.75,0.24,24.0,23,74,97,48,23,25,2.02,47.92,Facile,Difficile,-2,Beaucoup plus Difficile,Pas Adapte,Mathematics
532,2015,Mathématiques,1,L'Algebre Lineaire,1,Sommes de Sous Espaces,12,533,7,QROC,0.58,0.28,37.0,18,30,48,34,18,16,1.41,52.94,Difficile,Moyen,1,Plus Facile,Pas Adapte,Mathematics
1643,2016,Mathématiques,1,L'Algebre Lineaire,1,Sommes de Sous Espaces,12,533,7,QROC,0.91,0.03,31.0,16,36,52,43,16,27,1.21,37.21,Facile,Difficile,-2,Beaucoup plus Difficile,Pas Adapte,Mathematics
2754,2017,Mathématiques,1,L'Algebre Lineaire,1,Sommes de Sous Espaces,12,533,7,QO,0.45,0.21,41.0,19,27,46,40,19,21,1.15,47.5,Facile,Moyen,-1,Plus Difficile,Pas Adapte,Mathematics
3865,2018,Mathématiques,1,L'Algebre Lineaire,1,Sommes de Sous Espaces,12,533,7,QO,0.99,0.03,20.0,8,34,42,25,8,17,1.68,32.0,Difficile,Difficile,0,Meme Difficulté,Pas Adapte,Mathematics
4976,2019,Mathématiques,1,L'Algebre Lineaire,1,Sommes de Sous Espaces,12,533,7,QO,0.26,0.26,51.0,21,21,42,38,21,17,1.11,55.26,Difficile,Moyen,1,Plus Facile,Pas Adapte,Mathematics
6087,2020,Mathématiques,1,L'Algebre Lineaire,1,Sommes de Sous Espaces,12,533,7,QO,0.42,0.17,50.0,18,19,37,31,18,13,1.19,58.06,Difficile,Moyen,1,Plus Facile,Pas Adapte,Mathematics
533,2015,Mathématiques,1,L'Algebre Lineaire,1,Sommes de Sous Espaces,12,534,8,QCU,0.67,0.37,20.0,6,23,29,18,6,12,1.61,33.33,Facile,Difficile,-2,Beaucoup plus Difficile,Pas Adapte,Mathematics
1644,2016,Mathématiques,1,L'Algebre Lineaire,1,Sommes de Sous Espaces,12,534,8,QCU,0.71,0.37,32.0,8,17,25,13,8,5,1.92,61.54,Facile,Difficile,-2,Beaucoup plus Difficile,Pas Adapte,Mathematics
2755,2017,Mathématiques,1,L'Algebre Lineaire,1,Sommes de Sous Espaces,12,534,8,QROC,0.86,0.23,4.0,1,27,28,23,1,22,1.22,4.35,Facile,Difficile,-2,Beaucoup plus Difficile,Pas Adapte,Mathematics
3866,2018,Mathématiques,1,L'Algebre Lineaire,1,Sommes de Sous Espaces,12,534,8,QROC,0.3,0.32,64.0,20,11,31,26,20,6,1.19,76.92,Facile,Moyen,-1,Plus Difficile,Adapte,Mathematics
4977,2019,Mathématiques,1,L'Algebre Lineaire,1,Sommes de Sous Espaces,12,534,8,QROC,0.33,0.3,64.0,20,11,31,31,20,11,1.0,64.52,Moyen,Moyen,0,Meme Difficulté,Adapte,Mathematics
6088,2020,Mathématiques,1,L'Algebre Lineaire,1,Sommes de Sous Espaces,12,534,8,QROC,0.46,0.31,64.0,20,12,32,31,20,11,1.03,64.52,Moyen,Moyen,0,Meme Difficulté,Adapte,Mathematics
534,2015,Mathématiques,1,L'Algebre Lineaire,1,Sommes de Sous Espaces,12,535,9,QCM,0.57,0.2,8.0,5,62,67,47,5,42,1.43,10.64,Moyen,Difficile,-1,Plus Difficile,Pas Adapte,Mathematics
1645,2016,Mathématiques,1,L'Algebre Lineaire,1,Sommes de Sous Espaces,12,535,9,QROC,0.99,0.15,29.0,17,43,60,39,17,22,1.54,43.59,Facile,Difficile,-2,Beaucoup plus Difficile,Pas Adapte,Mathematics
2756,2017,Mathématiques,1,L'Algebre Lineaire,1,Sommes de Sous Espaces,12,535,9,QROC,0.56,0.39,40.0,23,35,58,38,23,15,1.53,60.53,Moyen,Moyen,0,Meme Difficulté,Pas Adapte,Mathematics
3867,2018,Mathématiques,1,L'Algebre Lineaire,1,Sommes de Sous Espaces,12,535,9,QO,0.86,0.05,31.0,16,35,51,28,16,12,1.82,57.14,Difficile,Difficile,0,Meme Difficulté,Pas Adapte,Mathematics
4978,2019,Mathématiques,1,L'Algebre Lineaire,1,Sommes de Sous Espaces,12,535,9,QROC,0.45,0.37,37.0,18,30,48,29,18,11,1.66,62.07,Difficile,Moyen,1,Plus Facile,Pas Adapte,Mathematics
6089,2020,Mathématiques,1,L'Algebre Lineaire,1,Sommes de Sous Espaces,12,535,9,QROC,0.71,0.15,14.0,7,45,52,44,7,37,1.18,15.91,Difficile,Difficile,0,Meme Difficulté,Pas Adapte,Mathematics
535,2015,Mathématiques,1,L'Algebre Lineaire,1,Sommes de Sous Espaces,12,536,10,QCU,0.31,0.67,54.0,32,27,59,33,32,1,1.79,96.97,Facile,Moyen,-1,Plus Difficile,Pas Adapte,Mathematics
1646,2016,Mathématiques,1,L'Algebre Lineaire,1,Sommes de Sous Espaces,12,536,10,QCU,0.28,0.61,41.0,27,38,65,61,27,34,1.07,44.26,Facile,Moyen,-1,Plus Difficile,Pas Adapte,Mathematics
2757,2017,Mathématiques,1,L'Algebre Lineaire,1,Sommes de Sous Espaces,12,536,10,QCU,0.32,0.72,39.0,25,38,63,47,25,22,1.34,53.19,Moyen,Moyen,0,Meme Difficulté,Pas Adapte,Mathematics
3868,2018,Mathématiques,1,L'Algebre Lineaire,1,Sommes de Sous Espaces,12,536,10,QCU,0.56,0.24,21.0,12,43,55,45,12,33,1.22,26.67,Moyen,Difficile,-1,Plus Difficile,Pas Adapte,Mathematics
4979,2019,Mathématiques,1,L'Algebre Lineaire,1,Sommes de Sous Espaces,12,536,10,QCU,0.5,0.37,11.0,5,44,49,18,5,13,2.72,27.78,Facile,Difficile,-2,Beaucoup plus Difficile,Pas Adapte,Mathematics
6090,2020,Mathématiques,1,L'Algebre Lineaire,1,Sommes de Sous Espaces,12,536,10,QCU,0.35,0.68,58.0,31,23,54,32,31,1,1.69,96.88,Difficile,Moyen,1,Plus Facile,Pas Adapte,Mathematics
536,2015,Mathématiques,1,L'Algebre Lineaire,1,Sommes de Sous Espaces,12,537,11,QCM,0.51,0.16,28.0,22,55,77,55,22,33,1.4,40.0,Difficile,Difficile,0,Meme Difficulté,Pas Adapte,Mathematics
1647,2016,Mathématiques,1,L'Algebre Lineaire,1,Sommes de Sous Espaces,12,537,11,QCM,0.05,0.8,65.0,52,28,80,61,52,9,1.31,85.25,Moyen,Facile,1,Plus Facile,Adapte,Mathematics
2758,2017,Mathématiques,1,L'Algebre Lineaire,1,Sommes de Sous Espaces,12,537,11,QCM,0.18,0.94,65.0,44,24,68,59,44,15,1.15,74.58,Facile,Facile,0,Meme Difficulté,Adapte,Mathematics
3869,2018,Mathématiques,1,L'Algebre Lineaire,1,Sommes de Sous Espaces,12,537,11,QCM,0.11,0.98,65.0,51,27,78,65,51,14,1.2,78.46,Facile,Facile,0,Meme Difficulté,Adapte,Mathematics
4980,2019,Mathématiques,1,L'Algebre Lineaire,1,Sommes de Sous Espaces,12,537,11,QCM,0.11,0.83,65.0,49,27,76,59,49,10,1.29,83.05,Facile,Facile,0,Meme Difficulté,Adapte,Mathematics
6091,2020,Mathématiques,1,L'Algebre Lineaire,1,Sommes de Sous Espaces,12,537,11,QCM,0.03,0.87,65.0,51,27,78,59,51,8,1.32,86.44,Facile,Facile,0,Meme Difficulté,Adapte,Mathematics
537,2015,Mathématiques,1,L'Algebre Lineaire,1,Sommes de Sous Espaces,12,538,12,QCU,0.65,0.39,29.0,12,28,40,22,12,10,1.82,54.55,Moyen,Difficile,-1,Plus Difficile,Pas Adapte,Mathematics
1648,2016,Mathématiques,1,L'Algebre Lineaire,1,Sommes de Sous Espaces,12,538,12,QCU,0.61,0.37,10.0,4,41,45,41,4,37,1.1,9.76,Facile,Difficile,-2,Beaucoup plus Difficile,Pas Adapte,Mathematics
2759,2017,Mathématiques,1,L'Algebre Lineaire,1,Sommes de Sous Espaces,12,538,12,QCU,0.48,0.2,33.0,15,29,44,20,15,5,2.2,75.0,Moyen,Difficile,-1,Plus Difficile,Pas Adapte,Mathematics
3870,2018,Mathématiques,1,L'Algebre Lineaire,1,Sommes de Sous Espaces,12,538,12,QCU,0.28,0.43,54.0,28,23,51,47,28,19,1.09,59.57,Facile,Moyen,-1,Plus Difficile,Pas Adapte,Mathematics
4981,2019,Mathématiques,1,L'Algebre Lineaire,1,Sommes de Sous Espaces,12,538,12,QCU,0.66,0.22,8.0,4,41,45,22,4,18,2.05,18.18,Moyen,Difficile,-1,Plus Difficile,Pas Adapte,Mathematics
6092,2020,Mathématiques,1,L'Algebre Lineaire,1,Sommes de Sous Espaces,12,538,12,QCU,0.52,0.24,33.0,16,32,48,28,16,12,1.71,57.14,Facile,Difficile,-2,Beaucoup plus Difficile,Pas Adapte,Mathematics
538,2015,Mathématiques,1,L'Algebre Lineaire,2,Sous Espaces Supplementaires,8,539,1,QCU,0.62,0.37,30.0,11,25,36,16,11,5,2.25,68.75,Difficile,Difficile,0,Meme Difficulté,Pas Adapte,Mathematics
1649,2016,Mathématiques,1,L'Algebre Lineaire,2,Sous Espaces Supplementaires,8,539,1,QCU,0.28,0.56,46.0,18,21,39,24,18,6,1.62,75.0,Moyen,Moyen,0,Meme Difficulté,Pas Adapte,Mathematics
2760,2017,Mathématiques,1,L'Algebre Lineaire,2,Sous Espaces Supplementaires,8,539,1,QCU,0.73,0.3,28.0,13,32,45,42,13,29,1.07,30.95,Facile,Difficile,-2,Beaucoup plus Difficile,Pas Adapte,Mathematics
3871,2018,Mathématiques,1,L'Algebre Lineaire,2,Sous Espaces Supplementaires,8,539,1,QCU,0.3,0.66,44.0,22,27,49,48,22,26,1.02,45.83,Facile,Moyen,-1,Plus Difficile,Pas Adapte,Mathematics
4982,2019,Mathématiques,1,L'Algebre Lineaire,2,Sous Espaces Supplementaires,8,539,1,QCU,0.43,0.27,12.0,6,43,49,18,6,12,2.72,33.33,Facile,Difficile,-2,Beaucoup plus Difficile,Pas Adapte,Mathematics
6093,2020,Mathématiques,1,L'Algebre Lineaire,2,Sous Espaces Supplementaires,8,539,1,QCU,0.6,0.2,8.0,3,40,43,16,3,13,2.69,18.75,Facile,Difficile,-2,Beaucoup plus Difficile,Pas Adapte,Mathematics
539,2015,Mathématiques,1,L'Algebre Lineaire,2,Sous Espaces Supplementaires,8,540,2,QCU,0.23,0.48,57.0,46,34,80,65,46,19,1.23,70.77,Difficile,Moyen,1,Plus Facile,Pas Adapte,Mathematics
1650,2016,Mathématiques,1,L'Algebre Lineaire,2,Sous Espaces Supplementaires,8,540,2,QCU,0.42,0.35,3.0,2,79,81,46,2,44,1.76,4.35,Facile,Difficile,-2,Beaucoup plus Difficile,Pas Adapte,Mathematics
2761,2017,Mathématiques,1,L'Algebre Lineaire,2,Sous Espaces Supplementaires,8,540,2,QCU,0.32,0.61,49.0,40,41,81,44,40,4,1.84,90.91,Difficile,Moyen,1,Plus Facile,Pas Adapte,Mathematics
3872,2018,Mathématiques,1,L'Algebre Lineaire,2,Sous Espaces Supplementaires,8,540,2,QCU,0.62,0.27,20.0,19,74,93,55,19,36,1.69,34.55,Difficile,Difficile,0,Meme Difficulté,Pas Adapte,Mathematics
4983,2019,Mathématiques,1,L'Algebre Lineaire,2,Sous Espaces Supplementaires,8,540,2,QCU,0.35,0.41,58.0,57,42,99,96,57,39,1.03,59.38,Facile,Moyen,-1,Plus Difficile,Pas Adapte,Mathematics
6094,2020,Mathématiques,1,L'Algebre Lineaire,2,Sous Espaces Supplementaires,8,540,2,QCU,0.21,0.46,36.0,40,72,112,52,40,12,2.15,76.92,Moyen,Moyen,0,Meme Difficulté,Pas Adapte,Mathematics
540,2015,Mathématiques,1,L'Algebre Lineaire,2,Sous Espaces Supplementaires,8,541,3,QCU,0.65,0.2,16.0,9,48,57,45,9,36,1.27,20.0,Moyen,Difficile,-1,Plus Difficile,Pas Adapte,Mathematics
1651,2016,Mathématiques,1,L'Algebre Lineaire,2,Sous Espaces Supplementaires,8,541,3,QCU,0.29,0.41,51.0,29,28,57,31,29,2,1.84,93.55,Difficile,Moyen,1,Plus Facile,Pas Adapte,Mathematics
2762,2017,Mathématiques,1,L'Algebre Lineaire,2,Sous Espaces Supplementaires,8,541,3,QCU,0.39,0.56,51.0,27,25,52,32,27,5,1.62,84.38,Facile,Moyen,-1,Plus Difficile,Pas Adapte,Mathematics
3873,2018,Mathématiques,1,L'Algebre Lineaire,2,Sous Espaces Supplementaires,8,541,3,QCU,0.48,0.3,31.0,18,41,59,26,18,8,2.27,69.23,Moyen,Difficile,-1,Plus Difficile,Pas Adapte,Mathematics
4984,2019,Mathématiques,1,L'Algebre Lineaire,2,Sous Espaces Supplementaires,8,541,3,QCU,0.51,0.27,30.0,15,35,50,27,15,12,1.85,55.56,Facile,Difficile,-2,Beaucoup plus Difficile,Pas Adapte,Mathematics
6095,2020,Mathématiques,1,L'Algebre Lineaire,2,Sous Espaces Supplementaires,8,541,3,QCU,0.23,0.42,61.0,27,18,45,44,27,17,1.02,61.36,Facile,Moyen,-1,Plus Difficile,Adapte,Mathematics
541,2015,Mathématiques,1,L'Algebre Lineaire,2,Sous Espaces Supplementaires,8,542,4,QCU,0.58,0.37,22.0,4,13,17,6,4,2,2.83,66.67,Facile,Difficile,-2,Beaucoup plus Difficile,Pas Adapte,Mathematics
1652,2016,Mathématiques,1,L'Algebre Lineaire,2,Sous Espaces Supplementaires,8,542,4,QCU,0.4,0.25,27.0,4,11,15,14,4,10,1.07,28.57,Facile,Difficile,-2,Beaucoup plus Difficile,Pas Adapte,Mathematics
2763,2017,Mathématiques,1,L'Algebre Lineaire,2,Sous Espaces Supplementaires,8,542,4,QCU,0.28,0.45,55.0,9,8,17,16,9,7,1.06,56.25,Difficile,Moyen,1,Plus Facile,Pas Adapte,Mathematics
3874,2018,Mathématiques,1,L'Algebre Lineaire,2,Sous Espaces Supplementaires,8,542,4,QCU,0.66,0.34,3.0,1,18,19,16,1,15,1.19,6.25,Facile,Difficile,-2,Beaucoup plus Difficile,Pas Adapte,Mathematics
4985,2019,Mathématiques,1,L'Algebre Lineaire,2,Sous Espaces Supplementaires,8,542,4,QCU,0.26,0.58,42.0,8,11,19,10,8,2,1.9,80.0,Difficile,Moyen,1,Plus Facile,Pas Adapte,Mathematics
6096,2020,Mathématiques,1,L'Algebre Lineaire,2,Sous Espaces Supplementaires,8,542,4,QCU,0.36,0.45,64.0,11,6,17,13,11,2,1.31,84.62,Difficile,Moyen,1,Plus Facile,Adapte,Mathematics
542,2015,Mathématiques,1,L'Algebre Lineaire,2,Sous Espaces Supplementaires,8,543,5,QCM,0.72,0.26,6.0,3,39,42,11,3,8,3.82,27.27,Facile,Difficile,-2,Beaucoup plus Difficile,Pas Adapte,Mathematics
1653,2016,Mathématiques,1,L'Algebre Lineaire,2,Sous Espaces Supplementaires,8,543,5,QCM,0.49,0.64,43.0,18,24,42,40,18,22,1.05,45.0,Difficile,Moyen,1,Plus Facile,Pas Adapte,Mathematics
2764,2017,Mathématiques,1,L'Algebre Lineaire,2,Sous Espaces Supplementaires,8,543,5,QCM,0.71,0.29,26.0,12,36,48,39,12,27,1.23,30.77,Moyen,Difficile,-1,Plus Difficile,Pas Adapte,Mathematics
3875,2018,Mathématiques,1,L'Algebre Lineaire,2,Sous Espaces Supplementaires,8,543,5,QCM,0.44,0.44,56.0,23,18,41,34,23,11,1.21,67.65,Facile,Moyen,-1,Plus Difficile,Pas Adapte,Mathematics
4986,2019,Mathématiques,1,L'Algebre Lineaire,2,Sous Espaces Supplementaires,8,543,5,QCM,0.56,0.25,18.0,7,31,38,18,7,11,2.11,38.89,Difficile,Difficile,0,Meme Difficulté,Pas Adapte,Mathematics
6097,2020,Mathématiques,1,L'Algebre Lineaire,2,Sous Espaces Supplementaires,8,543,5,QCM,0.69,0.23,27.0,11,28,39,12,11,1,3.25,91.67,Difficile,Difficile,0,Meme Difficulté,Pas Adapte,Mathematics
543,2015,Mathématiques,1,L'Algebre Lineaire,2,Sous Espaces Supplementaires,8,544,6,QCU,0.43,0.22,27.0,16,45,61,27,16,11,2.26,59.26,Moyen,Difficile,-1,Plus Difficile,Pas Adapte,Mathematics
1654,2016,Mathématiques,1,L'Algebre Lineaire,2,Sous Espaces Supplementaires,8,544,6,QCU,0.31,0.63,60.0,31,21,52,46,31,15,1.13,67.39,Facile,Moyen,-1,Plus Difficile,Adapte,Mathematics
2765,2017,Mathématiques,1,L'Algebre Lineaire,2,Sous Espaces Supplementaires,8,544,6,QROC,0.23,0.28,60.0,26,18,44,27,26,1,1.63,96.3,Moyen,Moyen,0,Meme Difficulté,Adapte,Mathematics
3876,2018,Mathématiques,1,L'Algebre Lineaire,2,Sous Espaces Supplementaires,8,544,6,QROC,0.21,0.37,60.0,25,17,42,35,25,10,1.2,71.43,Moyen,Moyen,0,Meme Difficulté,Adapte,Mathematics
4987,2019,Mathématiques,1,L'Algebre Lineaire,2,Sous Espaces Supplementaires,8,544,6,QROC,0.59,0.33,60.0,25,16,41,41,25,16,1.0,60.98,Moyen,Moyen,0,Meme Difficulté,Adapte,Mathematics
6098,2020,Mathématiques,1,L'Algebre Lineaire,2,Sous Espaces Supplementaires,8,544,6,QROC,0.59,0.28,60.0,26,18,44,28,26,2,1.57,92.86,Moyen,Moyen,0,Meme Difficulté,Adapte,Mathematics
544,2015,Mathématiques,1,L'Algebre Lineaire,2,Sous Espaces Supplementaires,8,545,7,QCM,0.29,0.47,50.0,31,31,62,52,31,21,1.19,59.62,Moyen,Moyen,0,Meme Difficulté,Pas Adapte,Mathematics
1655,2016,Mathématiques,1,L'Algebre Lineaire,2,Sous Espaces Supplementaires,8,545,7,QCM,0.55,0.19,6.0,4,61,65,55,4,51,1.18,7.27,Difficile,Difficile,0,Meme Difficulté,Pas Adapte,Mathematics
2766,2017,Mathématiques,1,L'Algebre Lineaire,2,Sous Espaces Supplementaires,8,545,7,QCM,0.66,0.27,4.0,2,59,61,58,2,56,1.05,3.45,Moyen,Difficile,-1,Plus Difficile,Pas Adapte,Mathematics
3877,2018,Mathématiques,1,L'Algebre Lineaire,2,Sous Espaces Supplementaires,8,545,7,QCM,0.26,0.6,52.0,35,32,67,41,35,6,1.63,85.37,Difficile,Moyen,1,Plus Facile,Pas Adapte,Mathematics
4988,2019,Mathématiques,1,L'Algebre Lineaire,2,Sous Espaces Supplementaires,8,545,7,QCM,0.44,0.5,55.0,31,26,57,47,31,16,1.21,65.96,Facile,Moyen,-1,Plus Difficile,Pas Adapte,Mathematics
6099,2020,Mathématiques,1,L'Algebre Lineaire,2,Sous Espaces Supplementaires,8,545,7,QCM,0.67,0.19,29.0,15,36,51,38,15,23,1.34,39.47,Facile,Difficile,-2,Beaucoup plus Difficile,Pas Adapte,Mathematics
545,2015,Mathématiques,1,L'Algebre Lineaire,2,Sous Espaces Supplementaires,8,546,8,QCU,0.35,0.54,59.0,8,5,13,13,8,5,1.0,61.54,Moyen,Moyen,0,Meme Difficulté,Pas Adapte,Mathematics
1656,2016,Mathématiques,1,L'Algebre Lineaire,2,Sous Espaces Supplementaires,8,546,8,QCU,0.33,0.44,47.0,5,6,11,10,5,5,1.1,50.0,Difficile,Moyen,1,Plus Facile,Pas Adapte,Mathematics
2767,2017,Mathématiques,1,L'Algebre Lineaire,2,Sous Espaces Supplementaires,8,546,8,QCM,0.28,0.44,43.0,5,6,11,5,5,0,2.2,100.0,Moyen,Moyen,0,Meme Difficulté,Pas Adapte,Mathematics
3878,2018,Mathématiques,1,L'Algebre Lineaire,2,Sous Espaces Supplementaires,8,546,8,QCM,0.55,0.29,17.0,2,8,10,5,2,3,2.0,40.0,Facile,Difficile,-2,Beaucoup plus Difficile,Pas Adapte,Mathematics
4989,2019,Mathématiques,1,L'Algebre Lineaire,2,Sous Espaces Supplementaires,8,546,8,QCM,0.51,0.2,18.0,2,10,12,7,2,5,1.71,28.57,Moyen,Difficile,-1,Plus Difficile,Pas Adapte,Mathematics
6100,2020,Mathématiques,1,L'Algebre Lineaire,2,Sous Espaces Supplementaires,8,546,8,QCM,0.46,0.63,42.0,5,7,12,7,5,2,1.71,71.43,Difficile,Moyen,1,Plus Facile,Pas Adapte,Mathematics
546,2015,Mathématiques,1,L'Algebre Lineaire,3,Theoreme du Rang,3,547,1,QCM,0.52,0.19,4.0,4,89,93,53,4,49,1.75,7.55,Facile,Difficile,-2,Beaucoup plus Difficile,Pas Adapte,Mathematics
1657,2016,Mathématiques,1,L'Algebre Lineaire,3,Theoreme du Rang,3,547,1,QCM,0.35,0.43,63.0,66,38,104,67,66,1,1.55,98.51,Difficile,Moyen,1,Plus Facile,Adapte,Mathematics
2768,2017,Mathématiques,1,L'Algebre Lineaire,3,Theoreme du Rang,3,547,1,QCM,0.21,0.45,63.0,63,37,100,71,63,8,1.41,88.73,Moyen,Moyen,0,Meme Difficulté,Adapte,Mathematics
3879,2018,Mathématiques,1,L'Algebre Lineaire,3,Theoreme du Rang,3,547,1,QCM,0.34,0.33,63.0,65,38,103,91,65,26,1.13,71.43,Moyen,Moyen,0,Meme Difficulté,Adapte,Mathematics
4990,2019,Mathématiques,1,L'Algebre Lineaire,3,Theoreme du Rang,3,547,1,QCM,0.26,0.51,63.0,67,39,106,104,67,37,1.02,64.42,Moyen,Moyen,0,Meme Difficulté,Adapte,Mathematics
6101,2020,Mathématiques,1,L'Algebre Lineaire,3,Theoreme du Rang,3,547,1,QCM,0.25,0.46,63.0,71,42,113,109,71,38,1.04,65.14,Moyen,Moyen,0,Meme Difficulté,Adapte,Mathematics
547,2015,Mathématiques,1,L'Algebre Lineaire,3,Theoreme du Rang,3,548,2,QROC,0.32,0.35,48.0,10,11,21,17,10,7,1.24,58.82,Moyen,Moyen,0,Meme Difficulté,Pas Adapte,Mathematics
1658,2016,Mathématiques,1,L'Algebre Lineaire,3,Theoreme du Rang,3,548,2,QCM,0.29,0.66,57.0,10,8,18,17,10,7,1.06,58.82,Moyen,Moyen,0,Meme Difficulté,Pas Adapte,Mathematics
2769,2017,Mathématiques,1,L'Algebre Lineaire,3,Theoreme du Rang,3,548,2,QCM,0.38,0.4,48.0,9,10,19,15,9,6,1.27,60.0,Moyen,Moyen,0,Meme Difficulté,Pas Adapte,Mathematics
3880,2018,Mathématiques,1,L'Algebre Lineaire,3,Theoreme du Rang,3,548,2,QCM,0.52,0.19,30.0,5,11,16,8,5,3,2.0,62.5,Facile,Difficile,-2,Beaucoup plus Difficile,Pas Adapte,Mathematics
4991,2019,Mathématiques,1,L'Algebre Lineaire,3,Theoreme du Rang,3,548,2,QCM,0.36,0.58,55.0,9,7,16,9,9,0,1.78,100.0,Difficile,Moyen,1,Plus Facile,Pas Adapte,Mathematics
6102,2020,Mathématiques,1,L'Algebre Lineaire,3,Theoreme du Rang,3,548,2,QCM,0.51,0.28,35.0,6,11,17,7,6,1,2.43,85.71,Moyen,Difficile,-1,Plus Difficile,Pas Adapte,Mathematics
548,2015,Mathématiques,1,L'Algebre Lineaire,3,Theoreme du Rang,3,549,3,QCM,0.48,0.38,44.0,27,34,61,32,27,5,1.91,84.38,Facile,Moyen,-1,Plus Difficile,Pas Adapte,Mathematics
1659,2016,Mathématiques,1,L'Algebre Lineaire,3,Theoreme du Rang,3,549,3,QROC,0.63,0.07,28.0,15,40,55,54,15,39,1.02,27.78,Moyen,Difficile,-1,Plus Difficile,Pas Adapte,Mathematics
2770,2017,Mathématiques,1,L'Algebre Lineaire,3,Theoreme du Rang,3,549,3,QROC,0.14,0.77,65.0,33,18,51,37,33,4,1.38,89.19,Facile,Facile,0,Meme Difficulté,Adapte,Mathematics
3881,2018,Mathématiques,1,L'Algebre Lineaire,3,Theoreme du Rang,3,549,3,QROC,0.02,0.81,65.0,28,15,43,34,28,6,1.26,82.35,Facile,Facile,0,Meme Difficulté,Adapte,Mathematics
4992,2019,Mathématiques,1,L'Algebre Lineaire,3,Theoreme du Rang,3,549,3,QCU,0.03,0.99,65.0,28,15,43,40,28,12,1.07,70.0,Facile,Facile,0,Meme Difficulté,Adapte,Mathematics
6103,2020,Mathématiques,1,L'Algebre Lineaire,3,Theoreme du Rang,3,549,3,QCU,0.16,0.78,65.0,30,16,46,30,30,0,1.53,100.0,Facile,Facile,0,Meme Difficulté,Adapte,Mathematics
549,2015,Mathématiques,1,L'Algebre Lineaire,4,Projecteurs et Symetries,10,550,1,QCM,0.75,0.29,1.0,1,61,62,61,1,60,1.02,1.64,Facile,Difficile,-2,Beaucoup plus Difficile,Pas Adapte,Mathematics
1660,2016,Mathématiques,1,L'Algebre Lineaire,4,Projecteurs et Symetries,10,550,1,QCU,0.66,0.21,26.0,14,40,54,38,14,24,1.42,36.84,Difficile,Difficile,0,Meme Difficulté,Pas Adapte,Mathematics
2771,2017,Mathématiques,1,L'Algebre Lineaire,4,Projecteurs et Symetries,10,550,1,QCU,0.63,0.36,32.0,16,33,49,20,16,4,2.45,80.0,Facile,Difficile,-2,Beaucoup plus Difficile,Pas Adapte,Mathematics
3882,2018,Mathématiques,1,L'Algebre Lineaire,4,Projecteurs et Symetries,10,550,1,QCU,0.55,0.32,7.0,3,45,48,20,3,17,2.4,15.0,Moyen,Difficile,-1,Plus Difficile,Pas Adapte,Mathematics
4993,2019,Mathématiques,1,L'Algebre Lineaire,4,Projecteurs et Symetries,10,550,1,QCU,0.58,0.31,6.0,3,52,55,33,3,30,1.67,9.09,Difficile,Difficile,0,Meme Difficulté,Pas Adapte,Mathematics
6104,2020,Mathématiques,1,L'Algebre Lineaire,4,Projecteurs et Symetries,10,550,1,QCU,0.35,0.65,52.0,29,26,55,53,29,24,1.04,54.72,Difficile,Moyen,1,Plus Facile,Pas Adapte,Mathematics
550,2015,Mathématiques,1,L'Algebre Lineaire,4,Projecteurs et Symetries,10,551,2,QCM,0.64,0.24,22.0,5,18,23,20,5,15,1.15,25.0,Difficile,Difficile,0,Meme Difficulté,Pas Adapte,Mathematics
1661,2016,Mathématiques,1,L'Algebre Lineaire,4,Projecteurs et Symetries,10,551,2,QCM,0.61,0.21,34.0,7,14,21,18,7,11,1.17,38.89,Moyen,Difficile,-1,Plus Difficile,Pas Adapte,Mathematics
2772,2017,Mathématiques,1,L'Algebre Lineaire,4,Projecteurs et Symetries,10,551,2,QCM,0.7,0.16,2.0,0,23,23,6,0,6,3.83,0.0,Facile,Difficile,-2,Beaucoup plus Difficile,Pas Adapte,Mathematics
3883,2018,Mathématiques,1,L'Algebre Lineaire,4,Projecteurs et Symetries,10,551,2,QCM,0.21,0.66,54.0,11,9,20,15,11,4,1.33,73.33,Facile,Moyen,-1,Plus Difficile,Pas Adapte,Mathematics
4994,2019,Mathématiques,1,L'Algebre Lineaire,4,Projecteurs et Symetries,10,551,2,QCM,0.25,0.59,36.0,7,13,20,17,7,10,1.18,41.18,Moyen,Moyen,0,Meme Difficulté,Pas Adapte,Mathematics
6105,2020,Mathématiques,1,L'Algebre Lineaire,4,Projecteurs et Symetries,10,551,2,QCM,0.73,0.29,21.0,4,14,18,11,4,7,1.64,36.36,Difficile,Difficile,0,Meme Difficulté,Pas Adapte,Mathematics
551,2015,Mathématiques,1,L'Algebre Lineaire,4,Projecteurs et Symetries,10,552,3,QCM,0.54,0.28,1.0,0,27,27,17,0,17,1.59,0.0,Facile,Difficile,-2,Beaucoup plus Difficile,Pas Adapte,Mathematics
1662,2016,Mathématiques,1,L'Algebre Lineaire,4,Projecteurs et Symetries,10,552,3,QCM,0.69,0.25,7.0,2,21,23,6,2,4,3.83,33.33,Difficile,Difficile,0,Meme Difficulté,Pas Adapte,Mathematics
2773,2017,Mathématiques,1,L'Algebre Lineaire,4,Projecteurs et Symetries,10,552,3,QCM,0.35,0.36,49.0,10,10,20,20,10,10,1.0,50.0,Difficile,Moyen,1,Plus Facile,Pas Adapte,Mathematics
3884,2018,Mathématiques,1,L'Algebre Lineaire,4,Projecteurs et Symetries,10,552,3,QCM,0.33,0.33,36.0,6,11,17,16,6,10,1.06,37.5,Facile,Moyen,-1,Plus Difficile,Pas Adapte,Mathematics
4995,2019,Mathématiques,1,L'Algebre Lineaire,4,Projecteurs et Symetries,10,552,3,QCM,0.54,0.27,8.0,1,14,15,14,1,13,1.07,7.14,Facile,Difficile,-2,Beaucoup plus Difficile,Pas Adapte,Mathematics
6106,2020,Mathématiques,1,L'Algebre Lineaire,4,Projecteurs et Symetries,10,552,3,QROC,0.26,0.28,58.0,9,7,16,10,9,1,1.6,90.0,Facile,Moyen,-1,Plus Difficile,Pas Adapte,Mathematics
552,2015,Mathématiques,1,L'Algebre Lineaire,4,Projecteurs et Symetries,10,553,4,QCM,0.37,0.53,54.0,7,6,13,11,7,4,1.18,63.64,Moyen,Moyen,0,Meme Difficulté,Pas Adapte,Mathematics
1663,2016,Mathématiques,1,L'Algebre Lineaire,4,Projecteurs et Symetries,10,553,4,QCM,0.61,0.2,24.0,3,10,13,8,3,5,1.62,37.5,Facile,Difficile,-2,Beaucoup plus Difficile,Pas Adapte,Mathematics
2774,2017,Mathématiques,1,L'Algebre Lineaire,4,Projecteurs et Symetries,10,553,4,QCM,0.37,0.48,64.0,8,4,12,8,8,0,1.5,100.0,Difficile,Moyen,1,Plus Facile,Adapte,Mathematics
3885,2018,Mathématiques,1,L'Algebre Lineaire,4,Projecteurs et Symetries,10,553,4,QCM,0.49,0.31,64.0,6,4,10,9,6,3,1.11,66.67,Moyen,Moyen,0,Meme Difficulté,Adapte,Mathematics
4996,2019,Mathématiques,1,L'Algebre Lineaire,4,Projecteurs et Symetries,10,553,4,QCM,0.4,0.59,64.0,6,3,9,7,6,1,1.29,85.71,Moyen,Moyen,0,Meme Difficulté,Adapte,Mathematics
6107,2020,Mathématiques,1,L'Algebre Lineaire,4,Projecteurs et Symetries,10,553,4,QCM,0.33,0.44,64.0,6,3,9,8,6,2,1.12,75.0,Moyen,Moyen,0,Meme Difficulté,Adapte,Mathematics
553,2015,Mathématiques,1,L'Algebre Lineaire,4,Projecteurs et Symetries,10,554,5,QROC,0.59,0.32,49.0,23,23,46,24,23,1,1.92,95.83,Difficile,Moyen,1,Plus Facile,Pas Adapte,Mathematics
1664,2016,Mathématiques,1,L'Algebre Lineaire,4,Projecteurs et Symetries,10,554,5,QROC,0.71,0.06,9.0,5,46,51,21,5,16,2.43,23.81,Difficile,Difficile,0,Meme Difficulté,Pas Adapte,Mathematics
2775,2017,Mathématiques,1,L'Algebre Lineaire,4,Projecteurs et Symetries,10,554,5,QROC,0.02,0.98,65.0,32,18,50,43,32,11,1.16,74.42,Difficile,Facile,2,Beaucoup plus Facile,Adapte,Mathematics
3886,2018,Mathématiques,1,L'Algebre Lineaire,4,Projecteurs et Symetries,10,554,5,QROC,0.18,0.99,65.0,35,19,54,35,35,0,1.54,100.0,Facile,Facile,0,Meme Difficulté,Adapte,Mathematics
4997,2019,Mathématiques,1,L'Algebre Lineaire,4,Projecteurs et Symetries,10,554,5,QROC,0.09,0.84,65.0,39,21,60,46,39,7,1.3,84.78,Facile,Facile,0,Meme Difficulté,Adapte,Mathematics
6108,2020,Mathématiques,1,L'Algebre Lineaire,4,Projecteurs et Symetries,10,554,5,QROC,0.15,0.81,65.0,42,23,65,60,42,18,1.08,70.0,Facile,Facile,0,Meme Difficulté,Adapte,Mathematics
554,2015,Mathématiques,1,L'Algebre Lineaire,4,Projecteurs et Symetries,10,555,6,QCU,0.37,0.62,62.0,18,11,29,22,18,4,1.32,81.82,Difficile,Moyen,1,Plus Facile,Adapte,Mathematics
1665,2016,Mathématiques,1,L'Algebre Lineaire,4,Projecteurs et Symetries,10,555,6,QCU,0.38,0.55,62.0,16,10,26,21,16,5,1.24,76.19,Moyen,Moyen,0,Meme Difficulté,Adapte,Mathematics
2776,2017,Mathématiques,1,L'Algebre Lineaire,4,Projecteurs et Symetries,10,555,6,QCM,0.42,0.57,62.0,19,11,30,21,19,2,1.43,90.48,Moyen,Moyen,0,Meme Difficulté,Adapte,Mathematics
3887,2018,Mathématiques,1,L'Algebre Lineaire,4,Projecteurs et Symetries,10,555,6,QCM,0.36,0.41,62.0,20,13,33,29,20,9,1.14,68.97,Moyen,Moyen,0,Meme Difficulté,Adapte,Mathematics
4998,2019,Mathématiques,1,L'Algebre Lineaire,4,Projecteurs et Symetries,10,555,6,QCM,0.4,0.34,62.0,24,14,38,36,24,12,1.06,66.67,Moyen,Moyen,0,Meme Difficulté,Adapte,Mathematics
6109,2020,Mathématiques,1,L'Algebre Lineaire,4,Projecteurs et Symetries,10,555,6,QCM,0.45,0.39,62.0,26,16,42,31,26,5,1.35,83.87,Moyen,Moyen,0,Meme Difficulté,Adapte,Mathematics
555,2015,Mathématiques,1,L'Algebre Lineaire,4,Projecteurs et Symetries,10,556,7,QCM,0.77,0.26,14.0,9,52,61,21,9,12,2.9,42.86,Difficile,Difficile,0,Meme Difficulté,Pas Adapte,Mathematics
1666,2016,Mathématiques,1,L'Algebre Lineaire,4,Projecteurs et Symetries,10,556,7,QCM,0.3,0.53,47.0,26,30,56,32,26,6,1.75,81.25,Moyen,Moyen,0,Meme Difficulté,Pas Adapte,Mathematics
2777,2017,Mathématiques,1,L'Algebre Lineaire,4,Projecteurs et Symetries,10,556,7,QCM,0.76,0.18,21.0,10,38,48,27,10,17,1.78,37.04,Moyen,Difficile,-1,Plus Difficile,Pas Adapte,Mathematics
3888,2018,Mathématiques,1,L'Algebre Lineaire,4,Projecteurs et Symetries,10,556,7,QCM,0.54,0.29,26.0,12,34,46,19,12,7,2.42,63.16,Facile,Difficile,-2,Beaucoup plus Difficile,Pas Adapte,Mathematics
4999,2019,Mathématiques,1,L'Algebre Lineaire,4,Projecteurs et Symetries,10,556,7,QCM,0.74,0.26,26.0,12,33,45,31,12,19,1.45,38.71,Facile,Difficile,-2,Beaucoup plus Difficile,Pas Adapte,Mathematics
6110,2020,Mathématiques,1,L'Algebre Lineaire,4,Projecteurs et Symetries,10,556,7,QCM,0.25,0.67,51.0,20,19,39,37,20,17,1.05,54.05,Moyen,Moyen,0,Meme Difficulté,Pas Adapte,Mathematics
556,2015,Mathématiques,1,L'Algebre Lineaire,4,Projecteurs et Symetries,10,557,8,QCU,0.27,0.73,37.0,33,56,89,72,33,39,1.24,45.83,Difficile,Moyen,1,Plus Facile,Pas Adapte,Mathematics
1667,2016,Mathématiques,1,L'Algebre Lineaire,4,Projecteurs et Symetries,10,557,8,QCU,0.29,0.41,36.0,35,62,97,59,35,24,1.64,59.32,Difficile,Moyen,1,Plus Facile,Pas Adapte,Mathematics
2778,2017,Mathématiques,1,L'Algebre Lineaire,4,Projecteurs et Symetries,10,557,8,QCU,0.31,0.63,38.0,37,61,98,39,37,2,2.51,94.87,Facile,Moyen,-1,Plus Difficile,Pas Adapte,Mathematics
3889,2018,Mathématiques,1,L'Algebre Lineaire,4,Projecteurs et Symetries,10,557,8,QROC,0.55,0.38,56.0,48,38,86,59,48,11,1.46,81.36,Facile,Moyen,-1,Plus Difficile,Pas Adapte,Mathematics
5000,2019,Mathématiques,1,L'Algebre Lineaire,4,Projecteurs et Symetries,10,557,8,QROC,0.61,0.17,9.0,8,85,93,65,8,57,1.43,12.31,Facile,Difficile,-2,Beaucoup plus Difficile,Pas Adapte,Mathematics
6111,2020,Mathématiques,1,L'Algebre Lineaire,4,Projecteurs et Symetries,10,557,8,QROC,0.28,0.37,56.0,50,39,89,79,50,29,1.13,63.29,Moyen,Moyen,0,Meme Difficulté,Pas Adapte,Mathematics
557,2015,Mathématiques,1,L'Algebre Lineaire,4,Projecteurs et Symetries,10,558,9,QROC,0.79,0.15,28.0,18,46,64,50,18,32,1.28,36.0,Difficile,Difficile,0,Meme Difficulté,Pas Adapte,Mathematics
1668,2016,Mathématiques,1,L'Algebre Lineaire,4,Projecteurs et Symetries,10,558,9,QROC,0.46,0.34,55.0,35,29,64,46,35,11,1.39,76.09,Facile,Moyen,-1,Plus Difficile,Pas Adapte,Mathematics
2779,2017,Mathématiques,1,L'Algebre Lineaire,4,Projecteurs et Symetries,10,558,9,QROC,0.86,0.01,10.0,5,49,54,39,5,34,1.38,12.82,Moyen,Difficile,-1,Plus Difficile,Pas Adapte,Mathematics
3890,2018,Mathématiques,1,L'Algebre Lineaire,4,Projecteurs et Symetries,10,558,9,QROC,0.47,0.3,49.0,24,26,50,27,24,3,1.85,88.89,Moyen,Moyen,0,Meme Difficulté,Pas Adapte,Mathematics
5001,2019,Mathématiques,1,L'Algebre Lineaire,4,Projecteurs et Symetries,10,558,9,QROC,0.45,0.37,43.0,23,30,53,43,23,20,1.23,53.49,Facile,Moyen,-1,Plus Difficile,Pas Adapte,Mathematics
6112,2020,Mathématiques,1,L'Algebre Lineaire,4,Projecteurs et Symetries,10,558,9,QROC,0.65,0.2,33.0,19,38,57,27,19,8,2.11,70.37,Facile,Difficile,-2,Beaucoup plus Difficile,Pas Adapte,Mathematics
558,2015,Mathématiques,1,L'Algebre Lineaire,4,Projecteurs et Symetries,10,559,10,QCU,0.24,0.66,54.0,53,46,99,64,53,11,1.55,82.81,Moyen,Moyen,0,Meme Difficulté,Pas Adapte,Mathematics
1669,2016,Mathématiques,1,L'Algebre Lineaire,4,Projecteurs et Symetries,10,559,10,QCU,0.38,0.65,50.0,44,45,89,50,44,6,1.78,88.0,Moyen,Moyen,0,Meme Difficulté,Pas Adapte,Mathematics
2780,2017,Mathématiques,1,L'Algebre Lineaire,4,Projecteurs et Symetries,10,559,10,QCU,0.39,0.6,54.0,48,40,88,53,48,5,1.66,90.57,Difficile,Moyen,1,Plus Facile,Pas Adapte,Mathematics
3891,2018,Mathématiques,1,L'Algebre Lineaire,4,Projecteurs et Symetries,10,559,10,QCU,0.48,0.34,20.0,19,75,94,62,19,43,1.52,30.65,Moyen,Difficile,-1,Plus Difficile,Pas Adapte,Mathematics
5002,2019,Mathématiques,1,L'Algebre Lineaire,4,Projecteurs et Symetries,10,559,10,QCU,0.58,0.28,11.0,10,80,90,53,10,43,1.7,18.87,Facile,Difficile,-2,Beaucoup plus Difficile,Pas Adapte,Mathematics
6113,2020,Mathématiques,1,L'Algebre Lineaire,4,Projecteurs et Symetries,10,559,10,QCU,0.32,0.47,36.0,37,65,102,54,37,17,1.89,68.52,Facile,Moyen,-1,Plus Difficile,Pas Adapte,Mathematics
559,2015,Mathématiques,1,L'Algebre Lineaire,5,Determination et Construction d'Applications Lineaires,14,560,1,QCU,0.37,0.41,47.0,29,33,62,58,29,29,1.07,50.0,Moyen,Moyen,0,Meme Difficulté,Pas Adapte,Mathematics
1670,2016,Mathématiques,1,L'Algebre Lineaire,5,Determination et Construction d'Applications Lineaires,14,560,1,QCU,0.2,0.59,56.0,36,29,65,37,36,1,1.76,97.3,Facile,Moyen,-1,Plus Difficile,Pas Adapte,Mathematics
2781,2017,Mathématiques,1,L'Algebre Lineaire,5,Determination et Construction d'Applications Lineaires,14,560,1,QCU,0.71,0.26,4.0,3,67,70,56,3,53,1.25,5.36,Difficile,Difficile,0,Meme Difficulté,Pas Adapte,Mathematics
3892,2018,Mathématiques,1,L'Algebre Lineaire,5,Determination et Construction d'Applications Lineaires,14,560,1,QCU,0.67,0.25,20.0,13,52,65,55,13,42,1.18,23.64,Facile,Difficile,-2,Beaucoup plus Difficile,Pas Adapte,Mathematics
5003,2019,Mathématiques,1,L'Algebre Lineaire,5,Determination et Construction d'Applications Lineaires,14,560,1,QCM,0.5,0.68,36.0,27,47,74,67,27,40,1.1,40.3,Moyen,Moyen,0,Meme Difficulté,Pas Adapte,Mathematics
6114,2020,Mathématiques,1,L'Algebre Lineaire,5,Determination et Construction d'Applications Lineaires,14,560,1,QCM,0.65,0.29,26.0,21,60,81,61,21,40,1.33,34.43,Difficile,Difficile,0,Meme Difficulté,Pas Adapte,Mathematics
560,2015,Mathématiques,1,L'Algebre Lineaire,5,Determination et Construction d'Applications Lineaires,14,561,2,QCU,0.45,0.24,19.0,8,33,41,38,8,30,1.08,21.05,Difficile,Difficile,0,Meme Difficulté,Pas Adapte,Mathematics
1671,2016,Mathématiques,1,L'Algebre Lineaire,5,Determination et Construction d'Applications Lineaires,14,561,2,QCU,0.3,0.75,61.0,22,14,36,27,22,5,1.33,81.48,Moyen,Moyen,0,Meme Difficulté,Adapte,Mathematics
2782,2017,Mathématiques,1,L'Algebre Lineaire,5,Determination et Construction d'Applications Lineaires,14,561,2,QROC,0.35,0.33,61.0,24,15,39,35,24,11,1.11,68.57,Moyen,Moyen,0,Meme Difficulté,Adapte,Mathematics
3893,2018,Mathématiques,1,L'Algebre Lineaire,5,Determination et Construction d'Applications Lineaires,14,561,2,QROC,0.41,0.35,61.0,27,17,44,40,27,13,1.1,67.5,Moyen,Moyen,0,Meme Difficulté,Adapte,Mathematics
5004,2019,Mathématiques,1,L'Algebre Lineaire,5,Determination et Construction d'Applications Lineaires,14,561,2,QROC,0.26,0.29,61.0,23,14,37,32,23,9,1.16,71.88,Moyen,Moyen,0,Meme Difficulté,Adapte,Mathematics
6115,2020,Mathématiques,1,L'Algebre Lineaire,5,Determination et Construction d'Applications Lineaires,14,561,2,QROC,0.3,0.3,61.0,24,15,39,32,24,8,1.22,75.0,Moyen,Moyen,0,Meme Difficulté,Adapte,Mathematics
561,2015,Mathématiques,1,L'Algebre Lineaire,5,Determination et Construction d'Applications Lineaires,14,562,3,QCM,0.78,0.23,21.0,4,13,17,6,4,2,2.83,66.67,Moyen,Difficile,-1,Plus Difficile,Pas Adapte,Mathematics
1672,2016,Mathématiques,1,L'Algebre Lineaire,5,Determination et Construction d'Applications Lineaires,14,562,3,QCM,0.59,0.18,20.0,4,16,20,14,4,10,1.43,28.57,Facile,Difficile,-2,Beaucoup plus Difficile,Pas Adapte,Mathematics
2783,2017,Mathématiques,1,L'Algebre Lineaire,5,Determination et Construction d'Applications Lineaires,14,562,3,QCM,0.63,0.17,24.0,5,16,21,9,5,4,2.33,55.56,Difficile,Difficile,0,Meme Difficulté,Pas Adapte,Mathematics
3894,2018,Mathématiques,1,L'Algebre Lineaire,5,Determination et Construction d'Applications Lineaires,14,562,3,QCM,0.6,0.29,21.0,4,17,21,6,4,2,3.5,66.67,Facile,Difficile,-2,Beaucoup plus Difficile,Pas Adapte,Mathematics
5005,2019,Mathématiques,1,L'Algebre Lineaire,5,Determination et Construction d'Applications Lineaires,14,562,3,QCM,0.34,0.4,62.0,12,8,20,18,12,6,1.11,66.67,Difficile,Moyen,1,Plus Facile,Adapte,Mathematics
6116,2020,Mathématiques,1,L'Algebre Lineaire,5,Determination et Construction d'Applications Lineaires,14,562,3,QCM,0.37,0.57,62.0,11,7,18,16,11,5,1.12,68.75,Moyen,Moyen,0,Meme Difficulté,Adapte,Mathematics
562,2015,Mathématiques,1,L'Algebre Lineaire,5,Determination et Construction d'Applications Lineaires,14,563,4,QCU,0.42,0.29,13.0,9,57,66,62,9,53,1.06,14.52,Difficile,Difficile,0,Meme Difficulté,Pas Adapte,Mathematics
1673,2016,Mathématiques,1,L'Algebre Lineaire,5,Determination et Construction d'Applications Lineaires,14,563,4,QCU,0.46,0.33,23.0,17,58,75,38,17,21,1.97,44.74,Difficile,Difficile,0,Meme Difficulté,Pas Adapte,Mathematics
2784,2017,Mathématiques,1,L'Algebre Lineaire,5,Determination et Construction d'Applications Lineaires,14,563,4,QCU,0.63,0.24,29.0,24,59,83,55,24,31,1.51,43.64,Facile,Difficile,-2,Beaucoup plus Difficile,Pas Adapte,Mathematics
3895,2018,Mathématiques,1,L'Algebre Lineaire,5,Determination et Construction d'Applications Lineaires,14,563,4,QCU,0.37,0.58,52.0,41,38,79,56,41,15,1.41,73.21,Moyen,Moyen,0,Meme Difficulté,Pas Adapte,Mathematics
5006,2019,Mathématiques,1,L'Algebre Lineaire,5,Determination et Construction d'Applications Lineaires,14,563,4,QCU,0.63,0.31,30.0,25,57,82,76,25,51,1.08,32.89,Difficile,Difficile,0,Meme Difficulté,Pas Adapte,Mathematics
6117,2020,Mathématiques,1,L'Algebre Lineaire,5,Determination et Construction d'Applications Lineaires,14,563,4,QCU,0.5,0.22,9.0,7,71,78,61,7,54,1.28,11.48,Facile,Difficile,-2,Beaucoup plus Difficile,Pas Adapte,Mathematics
563,2015,Mathématiques,1,L'Algebre Lineaire,5,Determination et Construction d'Applications Lineaires,14,564,5,QCM,0.6,0.26,12.0,8,62,70,22,8,14,3.18,36.36,Difficile,Difficile,0,Meme Difficulté,Pas Adapte,Mathematics
1674,2016,Mathématiques,1,L'Algebre Lineaire,5,Determination et Construction d'Applications Lineaires,14,564,5,QCU,0.56,0.4,20.0,14,58,72,32,14,18,2.25,43.75,Facile,Difficile,-2,Beaucoup plus Difficile,Pas Adapte,Mathematics
2785,2017,Mathématiques,1,L'Algebre Lineaire,5,Determination et Construction d'Applications Lineaires,14,564,5,QCU,0.52,0.38,30.0,24,55,79,66,24,42,1.2,36.36,Difficile,Difficile,0,Meme Difficulté,Pas Adapte,Mathematics
3896,2018,Mathématiques,1,L'Algebre Lineaire,5,Determination et Construction d'Applications Lineaires,14,564,5,QCM,0.74,0.21,21.0,16,62,78,53,16,37,1.47,30.19,Facile,Difficile,-2,Beaucoup plus Difficile,Pas Adapte,Mathematics
5007,2019,Mathématiques,1,L'Algebre Lineaire,5,Determination et Construction d'Applications Lineaires,14,564,5,QCM,0.2,0.59,62.0,41,25,66,52,41,11,1.27,78.85,Facile,Moyen,-1,Plus Difficile,Adapte,Mathematics
6118,2020,Mathématiques,1,L'Algebre Lineaire,5,Determination et Construction d'Applications Lineaires,14,564,5,QCM,0.43,0.44,62.0,46,29,75,48,46,2,1.56,95.83,Moyen,Moyen,0,Meme Difficulté,Adapte,Mathematics
564,2015,Mathématiques,1,L'Algebre Lineaire,5,Determination et Construction d'Applications Lineaires,14,565,6,QCM,0.64,0.26,29.0,23,56,79,37,23,14,2.14,62.16,Facile,Difficile,-2,Beaucoup plus Difficile,Pas Adapte,Mathematics
1675,2016,Mathématiques,1,L'Algebre Lineaire,5,Determination et Construction d'Applications Lineaires,14,565,6,QROC,0.6,0.17,34.0,30,57,87,87,30,57,1.0,34.48,Difficile,Difficile,0,Meme Difficulté,Pas Adapte,Mathematics
2786,2017,Mathématiques,1,L'Algebre Lineaire,5,Determination et Construction d'Applications Lineaires,14,565,6,QO,0.39,0.22,37.0,29,49,78,68,29,39,1.15,42.65,Moyen,Moyen,0,Meme Difficulté,Pas Adapte,Mathematics
3897,2018,Mathématiques,1,L'Algebre Lineaire,5,Determination et Construction d'Applications Lineaires,14,565,6,QO,0.89,0.02,34.0,30,57,87,46,30,16,1.89,65.22,Moyen,Difficile,-1,Plus Difficile,Pas Adapte,Mathematics
5008,2019,Mathématiques,1,L'Algebre Lineaire,5,Determination et Construction d'Applications Lineaires,14,565,6,QO,0.41,0.21,47.0,38,43,81,54,38,16,1.5,70.37,Difficile,Moyen,1,Plus Facile,Pas Adapte,Mathematics
6119,2020,Mathématiques,1,L'Algebre Lineaire,5,Determination et Construction d'Applications Lineaires,14,565,6,QO,1.0,0.04,22.0,18,66,84,58,18,40,1.45,31.03,Moyen,Difficile,-1,Plus Difficile,Pas Adapte,Mathematics
565,2015,Mathématiques,1,L'Algebre Lineaire,5,Determination et Construction d'Applications Lineaires,14,566,7,QCM,0.39,0.31,42.0,19,27,46,38,19,19,1.21,50.0,Facile,Moyen,-1,Plus Difficile,Pas Adapte,Mathematics
1676,2016,Mathématiques,1,L'Algebre Lineaire,5,Determination et Construction d'Applications Lineaires,14,566,7,QCM,0.46,0.37,41.0,22,31,53,45,22,23,1.18,48.89,Facile,Moyen,-1,Plus Difficile,Pas Adapte,Mathematics
2787,2017,Mathématiques,1,L'Algebre Lineaire,5,Determination et Construction d'Applications Lineaires,14,566,7,QCM,0.63,0.29,5.0,3,55,58,26,3,23,2.23,11.54,Facile,Difficile,-2,Beaucoup plus Difficile,Pas Adapte,Mathematics
3898,2018,Mathématiques,1,L'Algebre Lineaire,5,Determination et Construction d'Applications Lineaires,14,566,7,QCM,0.68,0.29,26.0,13,38,51,22,13,9,2.32,59.09,Moyen,Difficile,-1,Plus Difficile,Pas Adapte,Mathematics
5009,2019,Mathématiques,1,L'Algebre Lineaire,5,Determination et Construction d'Applications Lineaires,14,566,7,QCM,0.26,0.62,61.0,34,22,56,53,34,19,1.06,64.15,Difficile,Moyen,1,Plus Facile,Adapte,Mathematics
6120,2020,Mathématiques,1,L'Algebre Lineaire,5,Determination et Construction d'Applications Lineaires,14,566,7,QCM,0.43,0.34,61.0,31,20,51,33,31,2,1.55,93.94,Moyen,Moyen,0,Meme Difficulté,Adapte,Mathematics
566,2015,Mathématiques,1,L'Algebre Lineaire,5,Determination et Construction d'Applications Lineaires,14,567,8,QCU,0.34,0.53,44.0,40,51,91,85,40,45,1.07,47.06,Moyen,Moyen,0,Meme Difficulté,Pas Adapte,Mathematics
1677,2016,Mathématiques,1,L'Algebre Lineaire,5,Determination et Construction d'Applications Lineaires,14,567,8,QCU,0.36,0.53,50.0,47,47,94,74,47,27,1.27,63.51,Facile,Moyen,-1,Plus Difficile,Pas Adapte,Mathematics
2788,2017,Mathématiques,1,L'Algebre Lineaire,5,Determination et Construction d'Applications Lineaires,14,567,8,QCM,0.58,0.22,12.0,11,83,94,66,11,55,1.42,16.67,Difficile,Difficile,0,Meme Difficulté,Pas Adapte,Mathematics
3899,2018,Mathématiques,1,L'Algebre Lineaire,5,Determination et Construction d'Applications Lineaires,14,567,8,QCM,0.53,0.23,2.0,2,99,101,86,2,84,1.17,2.33,Difficile,Difficile,0,Meme Difficulté,Pas Adapte,Mathematics
5010,2019,Mathématiques,1,L'Algebre Lineaire,5,Determination et Construction d'Applications Lineaires,14,567,8,QCM,0.56,0.24,3.0,3,98,101,80,3,77,1.26,3.75,Moyen,Difficile,-1,Plus Difficile,Pas Adapte,Mathematics
6121,2020,Mathématiques,1,L'Algebre Lineaire,5,Determination et Construction d'Applications Lineaires,14,567,8,QCM,0.39,0.45,59.0,67,46,113,102,67,35,1.11,65.69,Facile,Moyen,-1,Plus Difficile,Pas Adapte,Mathematics
567,2015,Mathématiques,1,L'Algebre Lineaire,5,Determination et Construction d'Applications Lineaires,14,568,9,QCU,0.54,0.27,24.0,20,63,83,41,20,21,2.02,48.78,Moyen,Difficile,-1,Plus Difficile,Pas Adapte,Mathematics
1678,2016,Mathématiques,1,L'Algebre Lineaire,5,Determination et Construction d'Applications Lineaires,14,568,9,QCU,0.6,0.35,29.0,26,64,90,74,26,48,1.22,35.14,Moyen,Difficile,-1,Plus Difficile,Pas Adapte,Mathematics
2789,2017,Mathématiques,1,L'Algebre Lineaire,5,Determination et Construction d'Applications Lineaires,14,568,9,QCU,0.53,0.26,14.0,11,68,79,58,11,47,1.36,18.97,Difficile,Difficile,0,Meme Difficulté,Pas Adapte,Mathematics
3900,2018,Mathématiques,1,L'Algebre Lineaire,5,Determination et Construction d'Applications Lineaires,14,568,9,QCU,0.68,0.23,13.0,11,76,87,53,11,42,1.64,20.75,Moyen,Difficile,-1,Plus Difficile,Pas Adapte,Mathematics
5011,2019,Mathématiques,1,L'Algebre Lineaire,5,Determination et Construction d'Applications Lineaires,14,568,9,QCU,0.66,0.21,29.0,27,67,94,83,27,56,1.13,32.53,Moyen,Difficile,-1,Plus Difficile,Pas Adapte,Mathematics
6122,2020,Mathématiques,1,L'Algebre Lineaire,5,Determination et Construction d'Applications Lineaires,14,568,9,QCU,0.35,0.66,42.0,39,55,94,87,39,48,1.08,44.83,Facile,Moyen,-1,Plus Difficile,Pas Adapte,Mathematics
568,2015,Mathématiques,1,L'Algebre Lineaire,5,Determination et Construction d'Applications Lineaires,14,569,10,QCM,0.51,0.26,26.0,9,24,33,24,9,15,1.38,37.5,Difficile,Difficile,0,Meme Difficulté,Pas Adapte,Mathematics
1679,2016,Mathématiques,1,L'Algebre Lineaire,5,Determination et Construction d'Applications Lineaires,14,569,10,QCM,0.51,0.2,26.0,9,27,36,15,9,6,2.4,60.0,Difficile,Difficile,0,Meme Difficulté,Pas Adapte,Mathematics
2790,2017,Mathématiques,1,L'Algebre Lineaire,5,Determination et Construction d'Applications Lineaires,14,569,10,QCM,0.54,0.16,28.0,10,24,34,15,10,5,2.27,66.67,Facile,Difficile,-2,Beaucoup plus Difficile,Pas Adapte,Mathematics
3901,2018,Mathématiques,1,L'Algebre Lineaire,5,Determination et Construction d'Applications Lineaires,14,569,10,QCU,0.52,0.23,15.0,5,27,32,24,5,19,1.33,20.83,Difficile,Difficile,0,Meme Difficulté,Pas Adapte,Mathematics
5012,2019,Mathématiques,1,L'Algebre Lineaire,5,Determination et Construction d'Applications Lineaires,14,569,10,QCU,0.69,0.29,23.0,7,22,29,22,7,15,1.32,31.82,Moyen,Difficile,-1,Plus Difficile,Pas Adapte,Mathematics
6123,2020,Mathématiques,1,L'Algebre Lineaire,5,Determination et Construction d'Applications Lineaires,14,569,10,QCU,0.4,0.4,53.0,13,12,25,23,13,10,1.09,56.52,Moyen,Moyen,0,Meme Difficulté,Pas Adapte,Mathematics
569,2015,Mathématiques,1,L'Algebre Lineaire,5,Determination et Construction d'Applications Lineaires,14,570,11,QROC,0.78,0.24,31.0,7,15,22,20,7,13,1.1,35.0,Facile,Difficile,-2,Beaucoup plus Difficile,Pas Adapte,Mathematics
1680,2016,Mathématiques,1,L'Algebre Lineaire,5,Determination et Construction d'Applications Lineaires,14,570,11,QROC,0.5,0.39,45.0,10,13,23,20,10,10,1.15,50.0,Difficile,Moyen,1,Plus Facile,Pas Adapte,Mathematics
2791,2017,Mathématiques,1,L'Algebre Lineaire,5,Determination et Construction d'Applications Lineaires,14,570,11,QROC,0.2,0.31,46.0,12,13,25,13,12,1,1.92,92.31,Facile,Moyen,-1,Plus Difficile,Pas Adapte,Mathematics
3902,2018,Mathématiques,1,L'Algebre Lineaire,5,Determination et Construction d'Applications Lineaires,14,570,11,QROC,1.0,0.16,23.0,6,21,27,20,6,14,1.35,30.0,Facile,Difficile,-2,Beaucoup plus Difficile,Pas Adapte,Mathematics
5013,2019,Mathématiques,1,L'Algebre Lineaire,5,Determination et Construction d'Applications Lineaires,14,570,11,QROC,0.43,0.32,56.0,15,12,27,22,15,7,1.23,68.18,Moyen,Moyen,0,Meme Difficulté,Pas Adapte,Mathematics
6124,2020,Mathématiques,1,L'Algebre Lineaire,5,Determination et Construction d'Applications Lineaires,14,570,11,QCU,0.65,0.26,3.0,1,28,29,13,1,12,2.23,7.69,Difficile,Difficile,0,Meme Difficulté,Pas Adapte,Mathematics
570,2015,Mathématiques,1,L'Algebre Lineaire,5,Determination et Construction d'Applications Lineaires,14,571,12,QO,0.48,0.27,41.0,20,29,49,42,20,22,1.17,47.62,Difficile,Moyen,1,Plus Facile,Pas Adapte,Mathematics
1681,2016,Mathématiques,1,L'Algebre Lineaire,5,Determination et Construction d'Applications Lineaires,14,571,12,QO,0.67,0.18,54.0,24,20,44,37,24,13,1.19,64.86,Moyen,Moyen,0,Meme Difficulté,Pas Adapte,Mathematics
2792,2017,Mathématiques,1,L'Algebre Lineaire,5,Determination et Construction d'Applications Lineaires,14,571,12,QO,0.66,0.18,53.0,21,18,39,30,21,9,1.3,70.0,Moyen,Moyen,0,Meme Difficulté,Pas Adapte,Mathematics
3903,2018,Mathématiques,1,L'Algebre Lineaire,5,Determination et Construction d'Applications Lineaires,14,571,12,QO,0.87,0.03,24.0,10,32,42,34,10,24,1.24,29.41,Difficile,Difficile,0,Meme Difficulté,Pas Adapte,Mathematics
5014,2019,Mathématiques,1,L'Algebre Lineaire,5,Determination et Construction d'Applications Lineaires,14,571,12,QO,0.9,0.15,21.0,8,28,36,30,8,22,1.2,26.67,Difficile,Difficile,0,Meme Difficulté,Pas Adapte,Mathematics
6125,2020,Mathématiques,1,L'Algebre Lineaire,5,Determination et Construction d'Applications Lineaires,14,571,12,QO,0.92,0.14,13.0,4,30,34,27,4,23,1.26,14.81,Facile,Difficile,-2,Beaucoup plus Difficile,Pas Adapte,Mathematics
571,2015,Mathématiques,1,L'Algebre Lineaire,5,Determination et Construction d'Applications Lineaires,14,572,13,QCU,0.64,0.33,13.0,1,10,11,6,1,5,1.83,16.67,Facile,Difficile,-2,Beaucoup plus Difficile,Pas Adapte,Mathematics
1682,2016,Mathématiques,1,L'Algebre Lineaire,5,Determination et Construction d'Applications Lineaires,14,572,13,QCU,0.58,0.26,24.0,2,7,9,4,2,2,2.25,50.0,Moyen,Difficile,-1,Plus Difficile,Pas Adapte,Mathematics
2793,2017,Mathématiques,1,L'Algebre Lineaire,5,Determination et Construction d'Applications Lineaires,14,572,13,QCU,0.34,0.55,38.0,3,5,8,4,3,1,2.0,75.0,Moyen,Moyen,0,Meme Difficulté,Pas Adapte,Mathematics
3904,2018,Mathématiques,1,L'Algebre Lineaire,5,Determination et Construction d'Applications Lineaires,14,572,13,QCU,0.46,0.36,35.0,2,5,7,6,2,4,1.17,33.33,Difficile,Difficile,0,Meme Difficulté,Pas Adapte,Mathematics
5015,2019,Mathématiques,1,L'Algebre Lineaire,5,Determination et Construction d'Applications Lineaires,14,572,13,QCU,0.42,0.36,7.0,0,6,6,4,0,4,1.5,0.0,Moyen,Difficile,-1,Plus Difficile,Pas Adapte,Mathematics
6126,2020,Mathématiques,1,L'Algebre Lineaire,5,Determination et Construction d'Applications Lineaires,14,572,13,QCU,0.43,0.29,8.0,0,6,6,5,0,5,1.2,0.0,Moyen,Difficile,-1,Plus Difficile,Pas Adapte,Mathematics
572,2015,Mathématiques,1,L'Algebre Lineaire,5,Determination et Construction d'Applications Lineaires,14,573,14,QCM,0.46,0.31,45.0,37,46,83,68,37,31,1.22,54.41,Moyen,Moyen,0,Meme Difficulté,Pas Adapte,Mathematics
1683,2016,Mathématiques,1,L'Algebre Lineaire,5,Determination et Construction d'Applications Lineaires,14,573,14,QCM,0.6,0.2,16.0,14,73,87,78,14,64,1.12,17.95,Moyen,Difficile,-1,Plus Difficile,Pas Adapte,Mathematics
2794,2017,Mathématiques,1,L'Algebre Lineaire,5,Determination et Construction d'Applications Lineaires,14,573,14,QCM,0.35,0.46,49.0,40,42,82,70,40,30,1.17,57.14,Difficile,Moyen,1,Plus Facile,Pas Adapte,Mathematics
3905,2018,Mathématiques,1,L'Algebre Lineaire,5,Determination et Construction d'Applications Lineaires,14,573,14,QROC,0.26,0.29,44.0,37,48,85,68,37,31,1.25,54.41,Facile,Moyen,-1,Plus Difficile,Pas Adapte,Mathematics
5016,2019,Mathématiques,1,L'Algebre Lineaire,5,Determination et Construction d'Applications Lineaires,14,573,14,QROC,0.73,0.18,23.0,18,62,80,49,18,31,1.63,36.73,Difficile,Difficile,0,Meme Difficulté,Pas Adapte,Mathematics
6127,2020,Mathématiques,1,L'Algebre Lineaire,5,Determination et Construction d'Applications Lineaires,14,573,14,QROC,0.98,0.25,15.0,11,61,72,71,11,60,1.01,15.49,Moyen,Difficile,-1,Plus Difficile,Pas Adapte,Mathematics
573,2015,Mathématiques,1,L'Algebre Lineaire,6,"Calcul de Dimensions et Construction de Bases, utilisant de la Dualite",2,574,1,QCM,0.72,0.16,9.0,3,31,34,25,3,22,1.36,12.0,Difficile,Difficile,0,Meme Difficulté,Pas Adapte,Mathematics
1684,2016,Mathématiques,1,L'Algebre Lineaire,6,"Calcul de Dimensions et Construction de Bases, utilisant de la Dualite",2,574,1,QCM,0.23,0.46,57.0,22,17,39,28,22,6,1.39,78.57,Moyen,Moyen,0,Meme Difficulté,Pas Adapte,Mathematics
2795,2017,Mathématiques,1,L'Algebre Lineaire,6,"Calcul de Dimensions et Construction de Bases, utilisant de la Dualite",2,574,1,QCM,0.71,0.17,2.0,1,40,41,32,1,31,1.28,3.12,Facile,Difficile,-2,Beaucoup plus Difficile,Pas Adapte,Mathematics
3906,2018,Mathématiques,1,L'Algebre Lineaire,6,"Calcul de Dimensions et Construction de Bases, utilisant de la Dualite",2,574,1,QCM,0.73,0.27,25.0,12,34,46,37,12,25,1.24,32.43,Facile,Difficile,-2,Beaucoup plus Difficile,Pas Adapte,Mathematics
5017,2019,Mathématiques,1,L'Algebre Lineaire,6,"Calcul de Dimensions et Construction de Bases, utilisant de la Dualite",2,574,1,QCM,0.72,0.26,27.0,11,29,40,39,11,28,1.03,28.21,Moyen,Difficile,-1,Plus Difficile,Pas Adapte,Mathematics
6128,2020,Mathématiques,1,L'Algebre Lineaire,6,"Calcul de Dimensions et Construction de Bases, utilisant de la Dualite",2,574,1,QCM,0.25,0.44,51.0,17,17,34,23,17,6,1.48,73.91,Moyen,Moyen,0,Meme Difficulté,Pas Adapte,Mathematics
574,2015,Mathématiques,1,L'Algebre Lineaire,6,"Calcul de Dimensions et Construction de Bases, utilisant de la Dualite",2,575,2,QCU,0.46,0.26,29.0,6,14,20,10,6,4,2.0,60.0,Difficile,Difficile,0,Meme Difficulté,Pas Adapte,Mathematics
1685,2016,Mathématiques,1,L'Algebre Lineaire,6,"Calcul de Dimensions et Construction de Bases, utilisant de la Dualite",2,575,2,QCU,0.68,0.36,13.0,2,16,18,11,2,9,1.64,18.18,Difficile,Difficile,0,Meme Difficulté,Pas Adapte,Mathematics
2796,2017,Mathématiques,1,L'Algebre Lineaire,6,"Calcul de Dimensions et Construction de Bases, utilisant de la Dualite",2,575,2,QCU,0.34,0.52,50.0,8,9,17,8,8,0,2.12,100.0,Moyen,Moyen,0,Meme Difficulté,Pas Adapte,Mathematics
3907,2018,Mathématiques,1,L'Algebre Lineaire,6,"Calcul de Dimensions et Construction de Bases, utilisant de la Dualite",2,575,2,QCM,0.72,0.27,13.0,2,12,14,7,2,5,2.0,28.57,Difficile,Difficile,0,Meme Difficulté,Pas Adapte,Mathematics
5018,2019,Mathématiques,1,L'Algebre Lineaire,6,"Calcul de Dimensions et Construction de Bases, utilisant de la Dualite",2,575,2,QCU,0.74,0.31,23.0,3,11,14,11,3,8,1.27,27.27,Facile,Difficile,-2,Beaucoup plus Difficile,Pas Adapte,Mathematics
6129,2020,Mathématiques,1,L'Algebre Lineaire,6,"Calcul de Dimensions et Construction de Bases, utilisant de la Dualite",2,575,2,QCU,0.59,0.22,11.0,2,12,14,14,2,12,1.0,14.29,Facile,Difficile,-2,Beaucoup plus Difficile,Pas Adapte,Mathematics
575,2015,Mathématiques,2,Le Calcul d'Integral,1,Les Divers Types d'Integrale,14,576,1,QCM,0.61,0.21,27.0,4,12,16,13,4,9,1.23,30.77,Moyen,Difficile,-1,Plus Difficile,Pas Adapte,Mathematics
1686,2016,Mathématiques,2,Le Calcul d'Integral,1,Les Divers Types d'Integrale,14,576,1,QO,0.78,0.09,12.0,2,16,18,17,2,15,1.06,11.76,Moyen,Difficile,-1,Plus Difficile,Pas Adapte,Mathematics
2797,2017,Mathématiques,2,Le Calcul d'Integral,1,Les Divers Types d'Integrale,14,576,1,QO,0.69,0.19,38.0,6,11,17,10,6,4,1.7,60.0,Facile,Moyen,-1,Plus Difficile,Pas Adapte,Mathematics
3908,2018,Mathématiques,2,Le Calcul d'Integral,1,Les Divers Types d'Integrale,14,576,1,QO,0.69,0.2,42.0,6,8,14,7,6,1,2.0,85.71,Facile,Moyen,-1,Plus Difficile,Pas Adapte,Mathematics
5019,2019,Mathématiques,2,Le Calcul d'Integral,1,Les Divers Types d'Integrale,14,576,1,QO,0.78,0.12,7.0,1,13,14,11,1,10,1.27,9.09,Difficile,Difficile,0,Meme Difficulté,Pas Adapte,Mathematics
6130,2020,Mathématiques,2,Le Calcul d'Integral,1,Les Divers Types d'Integrale,14,576,1,QO,0.35,0.26,36.0,5,9,14,13,5,8,1.08,38.46,Difficile,Moyen,1,Plus Facile,Pas Adapte,Mathematics
576,2015,Mathématiques,2,Le Calcul d'Integral,1,Les Divers Types d'Integrale,14,577,2,QCU,0.64,0.32,19.0,2,8,10,4,2,2,2.5,50.0,Difficile,Difficile,0,Meme Difficulté,Pas Adapte,Mathematics
1687,2016,Mathématiques,2,Le Calcul d'Integral,1,Les Divers Types d'Integrale,14,577,2,QCU,0.64,0.2,4.0,0,12,12,11,0,11,1.09,0.0,Difficile,Difficile,0,Meme Difficulté,Pas Adapte,Mathematics
2798,2017,Mathématiques,2,Le Calcul d'Integral,1,Les Divers Types d'Integrale,14,577,2,QO,0.46,0.21,49.0,6,7,13,12,6,6,1.08,50.0,Moyen,Moyen,0,Meme Difficulté,Pas Adapte,Mathematics
3909,2018,Mathématiques,2,Le Calcul d'Integral,1,Les Divers Types d'Integrale,14,577,2,QO,0.2,0.18,38.0,5,9,14,12,5,7,1.17,41.67,Facile,Moyen,-1,Plus Difficile,Pas Adapte,Mathematics
5020,2019,Mathématiques,2,Le Calcul d'Integral,1,Les Divers Types d'Integrale,14,577,2,QO,0.91,0.13,9.0,1,12,13,12,1,11,1.08,8.33,Difficile,Difficile,0,Meme Difficulté,Pas Adapte,Mathematics
6131,2020,Mathématiques,2,Le Calcul d'Integral,1,Les Divers Types d'Integrale,14,577,2,QCM,0.68,0.26,5.0,1,11,12,10,1,9,1.2,10.0,Difficile,Difficile,0,Meme Difficulté,Pas Adapte,Mathematics
577,2015,Mathématiques,2,Le Calcul d'Integral,1,Les Divers Types d'Integrale,14,578,3,QROC,0.63,0.0,23.0,13,42,55,27,13,14,2.04,48.15,Difficile,Difficile,0,Meme Difficulté,Pas Adapte,Mathematics
1688,2016,Mathématiques,2,Le Calcul d'Integral,1,Les Divers Types d'Integrale,14,578,3,QO,0.51,0.18,48.0,28,30,58,43,28,15,1.35,65.12,Facile,Moyen,-1,Plus Difficile,Pas Adapte,Mathematics
2799,2017,Mathématiques,2,Le Calcul d'Integral,1,Les Divers Types d'Integrale,14,578,3,QO,0.85,0.08,35.0,18,34,52,32,18,14,1.62,56.25,Difficile,Difficile,0,Meme Difficulté,Pas Adapte,Mathematics
3910,2018,Mathématiques,2,Le Calcul d'Integral,1,Les Divers Types d'Integrale,14,578,3,QO,0.5,0.15,47.0,26,29,55,37,26,11,1.49,70.27,Difficile,Moyen,1,Plus Facile,Pas Adapte,Mathematics
5021,2019,Mathématiques,2,Le Calcul d'Integral,1,Les Divers Types d'Integrale,14,578,3,QO,0.64,0.18,37.0,23,39,62,55,23,32,1.13,41.82,Facile,Moyen,-1,Plus Difficile,Pas Adapte,Mathematics
6132,2020,Mathématiques,2,Le Calcul d'Integral,1,Les Divers Types d'Integrale,14,578,3,QO,0.93,0.04,3.0,2,62,64,62,2,60,1.03,3.23,Facile,Difficile,-2,Beaucoup plus Difficile,Pas Adapte,Mathematics
578,2015,Mathématiques,2,Le Calcul d'Integral,1,Les Divers Types d'Integrale,14,579,4,QCU,0.29,0.47,36.0,35,62,97,52,35,17,1.87,67.31,Facile,Moyen,-1,Plus Difficile,Pas Adapte,Mathematics
1689,2016,Mathématiques,2,Le Calcul d'Integral,1,Les Divers Types d'Integrale,14,579,4,QCM,0.3,0.37,47.0,43,48,91,64,43,21,1.42,67.19,Difficile,Moyen,1,Plus Facile,Pas Adapte,Mathematics
2800,2017,Mathématiques,2,Le Calcul d'Integral,1,Les Divers Types d'Integrale,14,579,4,QCM,0.59,0.26,31.0,24,54,78,46,24,22,1.7,52.17,Difficile,Difficile,0,Meme Difficulté,Pas Adapte,Mathematics
3911,2018,Mathématiques,2,Le Calcul d'Integral,1,Les Divers Types d'Integrale,14,579,4,QCM,0.54,0.3,8.0,6,64,70,44,6,38,1.59,13.64,Moyen,Difficile,-1,Plus Difficile,Pas Adapte,Mathematics
5022,2019,Mathématiques,2,Le Calcul d'Integral,1,Les Divers Types d'Integrale,14,579,4,QCM,0.22,0.38,60.0,37,24,61,56,37,19,1.09,66.07,Facile,Moyen,-1,Plus Difficile,Adapte,Mathematics
6133,2020,Mathématiques,2,Le Calcul d'Integral,1,Les Divers Types d'Integrale,14,579,4,QCM,0.37,0.61,60.0,40,26,66,41,40,1,1.61,97.56,Moyen,Moyen,0,Meme Difficulté,Adapte,Mathematics
579,2015,Mathématiques,2,Le Calcul d'Integral,1,Les Divers Types d'Integrale,14,580,5,QCM,0.73,0.3,29.0,21,50,71,61,21,40,1.16,34.43,Difficile,Difficile,0,Meme Difficulté,Pas Adapte,Mathematics
1690,2016,Mathématiques,2,Le Calcul d'Integral,1,Les Divers Types d'Integrale,14,580,5,QCM,0.71,0.17,35.0,24,46,70,49,24,25,1.43,48.98,Difficile,Difficile,0,Meme Difficulté,Pas Adapte,Mathematics
2801,2017,Mathématiques,2,Le Calcul d'Integral,1,Les Divers Types d'Integrale,14,580,5,QCM,0.33,0.37,61.0,41,27,68,49,41,8,1.39,83.67,Moyen,Moyen,0,Meme Difficulté,Adapte,Mathematics
3912,2018,Mathématiques,2,Le Calcul d'Integral,1,Les Divers Types d'Integrale,14,580,5,QCM,0.38,0.33,61.0,46,29,75,64,46,18,1.17,71.88,Moyen,Moyen,0,Meme Difficulté,Adapte,Mathematics
5023,2019,Mathématiques,2,Le Calcul d'Integral,1,Les Divers Types d'Integrale,14,580,5,QCM,0.29,0.64,61.0,51,32,83,58,51,7,1.43,87.93,Moyen,Moyen,0,Meme Difficulté,Adapte,Mathematics
6134,2020,Mathématiques,2,Le Calcul d'Integral,1,Les Divers Types d'Integrale,14,580,5,QCM,0.25,0.37,61.0,55,35,90,57,55,2,1.58,96.49,Moyen,Moyen,0,Meme Difficulté,Adapte,Mathematics
580,2015,Mathématiques,2,Le Calcul d'Integral,1,Les Divers Types d'Integrale,14,581,6,QCU,0.64,0.23,6.0,2,39,41,29,2,27,1.41,6.9,Moyen,Difficile,-1,Plus Difficile,Pas Adapte,Mathematics
1691,2016,Mathématiques,2,Le Calcul d'Integral,1,Les Divers Types d'Integrale,14,581,6,QCU,0.7,0.37,26.0,11,33,44,25,11,14,1.76,44.0,Moyen,Difficile,-1,Plus Difficile,Pas Adapte,Mathematics
2802,2017,Mathématiques,2,Le Calcul d'Integral,1,Les Divers Types d'Integrale,14,581,6,QCU,0.38,0.64,54.0,23,19,42,28,23,5,1.5,82.14,Moyen,Moyen,0,Meme Difficulté,Pas Adapte,Mathematics
3913,2018,Mathématiques,2,Le Calcul d'Integral,1,Les Divers Types d'Integrale,14,581,6,QCU,0.3,0.55,48.0,21,22,43,26,21,5,1.65,80.77,Difficile,Moyen,1,Plus Facile,Pas Adapte,Mathematics
5024,2019,Mathématiques,2,Le Calcul d'Integral,1,Les Divers Types d'Integrale,14,581,6,QCU,0.6,0.21,31.0,15,33,48,33,15,18,1.45,45.45,Facile,Difficile,-2,Beaucoup plus Difficile,Pas Adapte,Mathematics
6135,2020,Mathématiques,2,Le Calcul d'Integral,1,Les Divers Types d'Integrale,14,581,6,QCU,0.7,0.32,28.0,12,31,43,15,12,3,2.87,80.0,Moyen,Difficile,-1,Plus Difficile,Pas Adapte,Mathematics
581,2015,Mathématiques,2,Le Calcul d'Integral,1,Les Divers Types d'Integrale,14,582,7,QROC,0.22,0.37,54.0,36,31,67,43,36,7,1.56,83.72,Difficile,Moyen,1,Plus Facile,Pas Adapte,Mathematics
1692,2016,Mathématiques,2,Le Calcul d'Integral,1,Les Divers Types d'Integrale,14,582,7,QROC,0.37,0.36,44.0,27,35,62,35,27,8,1.77,77.14,Difficile,Moyen,1,Plus Facile,Pas Adapte,Mathematics
2803,2017,Mathématiques,2,Le Calcul d'Integral,1,Les Divers Types d'Integrale,14,582,7,QROC,0.83,0.05,11.0,6,47,53,26,6,20,2.04,23.08,Moyen,Difficile,-1,Plus Difficile,Pas Adapte,Mathematics
3914,2018,Mathématiques,2,Le Calcul d'Integral,1,Les Divers Types d'Integrale,14,582,7,QROC,0.28,0.28,54.0,33,28,61,43,33,10,1.42,76.74,Facile,Moyen,-1,Plus Difficile,Pas Adapte,Mathematics
5025,2019,Mathématiques,2,Le Calcul d'Integral,1,Les Divers Types d'Integrale,14,582,7,QROC,0.89,0.12,32.0,20,43,63,59,20,39,1.07,33.9,Facile,Difficile,-2,Beaucoup plus Difficile,Pas Adapte,Mathematics
6136,2020,Mathématiques,2,Le Calcul d'Integral,1,Les Divers Types d'Integrale,14,582,7,QROC,0.63,0.07,6.0,4,63,67,34,4,30,1.97,11.76,Moyen,Difficile,-1,Plus Difficile,Pas Adapte,Mathematics
582,2015,Mathématiques,2,Le Calcul d'Integral,1,Les Divers Types d'Integrale,14,583,8,QROC,0.23,0.36,46.0,6,6,12,8,6,2,1.5,75.0,Facile,Moyen,-1,Plus Difficile,Pas Adapte,Mathematics
1693,2016,Mathématiques,2,Le Calcul d'Integral,1,Les Divers Types d'Integrale,14,583,8,QROC,0.89,0.02,19.0,2,10,12,7,2,5,1.71,28.57,Facile,Difficile,-2,Beaucoup plus Difficile,Pas Adapte,Mathematics
2804,2017,Mathématiques,2,Le Calcul d'Integral,1,Les Divers Types d'Integrale,14,583,8,QROC,0.45,0.36,43.0,6,8,14,8,6,2,1.75,75.0,Moyen,Moyen,0,Meme Difficulté,Pas Adapte,Mathematics
3915,2018,Mathématiques,2,Le Calcul d'Integral,1,Les Divers Types d'Integrale,14,583,8,QROC,0.72,0.1,3.0,0,13,13,6,0,6,2.17,0.0,Moyen,Difficile,-1,Plus Difficile,Pas Adapte,Mathematics
5026,2019,Mathématiques,2,Le Calcul d'Integral,1,Les Divers Types d'Integrale,14,583,8,QROC,0.39,0.28,56.0,7,6,13,11,7,4,1.18,63.64,Difficile,Moyen,1,Plus Facile,Pas Adapte,Mathematics
6137,2020,Mathématiques,2,Le Calcul d'Integral,1,Les Divers Types d'Integrale,14,583,8,QROC,0.83,0.01,27.0,4,9,13,11,4,7,1.18,36.36,Facile,Difficile,-2,Beaucoup plus Difficile,Pas Adapte,Mathematics
583,2015,Mathématiques,2,Le Calcul d'Integral,1,Les Divers Types d'Integrale,14,584,9,QCM,0.51,0.22,2.0,2,91,93,84,2,82,1.11,2.38,Moyen,Difficile,-1,Plus Difficile,Pas Adapte,Mathematics
1694,2016,Mathématiques,2,Le Calcul d'Integral,1,Les Divers Types d'Integrale,14,584,9,QCM,0.77,0.17,35.0,29,54,83,78,29,49,1.06,37.18,Difficile,Difficile,0,Meme Difficulté,Pas Adapte,Mathematics
2805,2017,Mathématiques,2,Le Calcul d'Integral,1,Les Divers Types d'Integrale,14,584,9,QCM,0.43,0.35,62.0,51,32,83,57,51,6,1.46,89.47,Facile,Moyen,-1,Plus Difficile,Adapte,Mathematics
3916,2018,Mathématiques,2,Le Calcul d'Integral,1,Les Divers Types d'Integrale,14,584,9,QCM,0.34,0.61,62.0,57,35,92,63,57,6,1.46,90.48,Moyen,Moyen,0,Meme Difficulté,Adapte,Mathematics
5027,2019,Mathématiques,2,Le Calcul d'Integral,1,Les Divers Types d'Integrale,14,584,9,QCU,0.3,0.41,62.0,48,30,78,57,48,9,1.37,84.21,Moyen,Moyen,0,Meme Difficulté,Adapte,Mathematics
6138,2020,Mathématiques,2,Le Calcul d'Integral,1,Les Divers Types d'Integrale,14,584,9,QCU,0.24,0.55,62.0,50,31,81,51,50,1,1.59,98.04,Moyen,Moyen,0,Meme Difficulté,Adapte,Mathematics
584,2015,Mathématiques,2,Le Calcul d'Integral,1,Les Divers Types d'Integrale,14,585,10,QCM,0.71,0.28,7.0,4,53,57,42,4,38,1.36,9.52,Difficile,Difficile,0,Meme Difficulté,Pas Adapte,Mathematics
1695,2016,Mathématiques,2,Le Calcul d'Integral,1,Les Divers Types d'Integrale,14,585,10,QCM,0.33,0.31,61.0,29,19,48,39,29,10,1.23,74.36,Moyen,Moyen,0,Meme Difficulté,Adapte,Mathematics
2806,2017,Mathématiques,2,Le Calcul d'Integral,1,Les Divers Types d'Integrale,14,585,10,QCM,0.44,0.48,61.0,32,21,53,39,32,7,1.36,82.05,Moyen,Moyen,0,Meme Difficulté,Adapte,Mathematics
3917,2018,Mathématiques,2,Le Calcul d'Integral,1,Les Divers Types d'Integrale,14,585,10,QCM,0.26,0.31,61.0,34,21,55,44,34,10,1.25,77.27,Moyen,Moyen,0,Meme Difficulté,Adapte,Mathematics
5028,2019,Mathématiques,2,Le Calcul d'Integral,1,Les Divers Types d'Integrale,14,585,10,QCM,0.37,0.38,61.0,29,18,47,42,29,13,1.12,69.05,Moyen,Moyen,0,Meme Difficulté,Adapte,Mathematics
6139,2020,Mathématiques,2,Le Calcul d'Integral,1,Les Divers Types d'Integrale,14,585,10,QCU,0.3,0.75,61.0,24,16,40,40,24,16,1.0,60.0,Moyen,Moyen,0,Meme Difficulté,Adapte,Mathematics
585,2015,Mathématiques,2,Le Calcul d'Integral,1,Les Divers Types d'Integrale,14,586,11,QCU,0.49,0.29,21.0,14,54,68,52,14,38,1.31,26.92,Difficile,Difficile,0,Meme Difficulté,Pas Adapte,Mathematics
1696,2016,Mathématiques,2,Le Calcul d'Integral,1,Les Divers Types d'Integrale,14,586,11,QCU,0.71,0.23,19.0,14,62,76,66,14,52,1.15,21.21,Facile,Difficile,-2,Beaucoup plus Difficile,Pas Adapte,Mathematics
2807,2017,Mathématiques,2,Le Calcul d'Integral,1,Les Divers Types d'Integrale,14,586,11,QCU,0.68,0.36,19.0,13,53,66,55,13,42,1.2,23.64,Moyen,Difficile,-1,Plus Difficile,Pas Adapte,Mathematics
3918,2018,Mathématiques,2,Le Calcul d'Integral,1,Les Divers Types d'Integrale,14,586,11,QCU,0.21,0.47,46.0,29,33,62,56,29,27,1.11,51.79,Moyen,Moyen,0,Meme Difficulté,Pas Adapte,Mathematics
5029,2019,Mathématiques,2,Le Calcul d'Integral,1,Les Divers Types d'Integrale,14,586,11,QCU,0.5,0.35,33.0,18,38,56,54,18,36,1.04,33.33,Moyen,Difficile,-1,Plus Difficile,Pas Adapte,Mathematics
6140,2020,Mathématiques,2,Le Calcul d'Integral,1,Les Divers Types d'Integrale,14,586,11,QCU,0.26,0.41,60.0,32,22,54,51,32,19,1.06,62.75,Difficile,Moyen,1,Plus Facile,Adapte,Mathematics
586,2015,Mathématiques,2,Le Calcul d'Integral,1,Les Divers Types d'Integrale,14,587,12,QCM,0.58,0.2,11.0,4,29,33,15,4,11,2.2,26.67,Facile,Difficile,-2,Beaucoup plus Difficile,Pas Adapte,Mathematics
1697,2016,Mathématiques,2,Le Calcul d'Integral,1,Les Divers Types d'Integrale,14,587,12,QCM,0.75,0.16,31.0,11,25,36,14,11,3,2.57,78.57,Difficile,Difficile,0,Meme Difficulté,Pas Adapte,Mathematics
2808,2017,Mathématiques,2,Le Calcul d'Integral,1,Les Divers Types d'Integrale,14,587,12,QCM,0.72,0.27,17.0,6,28,34,12,6,6,2.83,50.0,Difficile,Difficile,0,Meme Difficulté,Pas Adapte,Mathematics
3919,2018,Mathématiques,2,Le Calcul d'Integral,1,Les Divers Types d'Integrale,14,587,12,QCM,0.76,0.25,28.0,11,28,39,35,11,24,1.11,31.43,Facile,Difficile,-2,Beaucoup plus Difficile,Pas Adapte,Mathematics
5030,2019,Mathématiques,2,Le Calcul d'Integral,1,Les Divers Types d'Integrale,14,587,12,QCM,0.69,0.22,32.0,12,26,38,31,12,19,1.23,38.71,Facile,Difficile,-2,Beaucoup plus Difficile,Pas Adapte,Mathematics
6141,2020,Mathématiques,2,Le Calcul d'Integral,1,Les Divers Types d'Integrale,14,587,12,QCM,0.71,0.21,5.0,2,34,36,34,2,32,1.06,5.88,Moyen,Difficile,-1,Plus Difficile,Pas Adapte,Mathematics
587,2015,Mathématiques,2,Le Calcul d'Integral,1,Les Divers Types d'Integrale,14,588,13,QCM,0.42,0.34,55.0,47,38,85,56,47,9,1.52,83.93,Difficile,Moyen,1,Plus Facile,Pas Adapte,Mathematics
1698,2016,Mathématiques,2,Le Calcul d'Integral,1,Les Divers Types d'Integrale,14,588,13,QCM,0.48,0.33,49.0,47,49,96,56,47,9,1.71,83.93,Moyen,Moyen,0,Meme Difficulté,Pas Adapte,Mathematics
2809,2017,Mathématiques,2,Le Calcul d'Integral,1,Les Divers Types d'Integrale,14,588,13,QCM,0.36,0.47,64.0,54,31,85,71,54,17,1.2,76.06,Moyen,Moyen,0,Meme Difficulté,Adapte,Mathematics
3920,2018,Mathématiques,2,Le Calcul d'Integral,1,Les Divers Types d'Integrale,14,588,13,QCM,0.5,0.49,64.0,54,31,85,79,54,25,1.08,68.35,Moyen,Moyen,0,Meme Difficulté,Adapte,Mathematics
5031,2019,Mathématiques,2,Le Calcul d'Integral,1,Les Divers Types d'Integrale,14,588,13,QCM,0.21,0.34,64.0,60,34,94,77,60,17,1.22,77.92,Moyen,Moyen,0,Meme Difficulté,Adapte,Mathematics
6142,2020,Mathématiques,2,Le Calcul d'Integral,1,Les Divers Types d'Integrale,14,588,13,QCM,0.4,0.64,64.0,55,31,86,68,55,13,1.26,80.88,Moyen,Moyen,0,Meme Difficulté,Adapte,Mathematics
588,2015,Mathématiques,2,Le Calcul d'Integral,1,Les Divers Types d'Integrale,14,589,14,QROC,0.44,0.39,56.0,39,31,70,49,39,10,1.43,79.59,Facile,Moyen,-1,Plus Difficile,Pas Adapte,Mathematics
1699,2016,Mathématiques,2,Le Calcul d'Integral,1,Les Divers Types d'Integrale,14,589,14,QROC,0.9,0.02,24.0,16,49,65,46,16,30,1.41,34.78,Facile,Difficile,-2,Beaucoup plus Difficile,Pas Adapte,Mathematics
2810,2017,Mathématiques,2,Le Calcul d'Integral,1,Les Divers Types d'Integrale,14,589,14,QROC,0.8,0.08,18.0,12,53,65,45,12,33,1.44,26.67,Difficile,Difficile,0,Meme Difficulté,Pas Adapte,Mathematics
3921,2018,Mathématiques,2,Le Calcul d'Integral,1,Les Divers Types d'Integrale,14,589,14,QROC,0.89,0.24,21.0,13,50,63,50,13,37,1.26,26.0,Difficile,Difficile,0,Meme Difficulté,Pas Adapte,Mathematics
5032,2019,Mathématiques,2,Le Calcul d'Integral,1,Les Divers Types d'Integrale,14,589,14,QROC,0.63,0.23,11.0,8,63,71,71,8,63,1.0,11.27,Facile,Difficile,-2,Beaucoup plus Difficile,Pas Adapte,Mathematics
6143,2020,Mathématiques,2,Le Calcul d'Integral,1,Les Divers Types d'Integrale,14,589,14,QROC,0.81,0.24,33.0,27,55,82,40,27,13,2.05,67.5,Facile,Difficile,-2,Beaucoup plus Difficile,Pas Adapte,Mathematics
589,2015,Mathématiques,2,Le Calcul d'Integral,2,Les Methodes Generales d'Integration,7,590,1,QCM,0.43,0.42,56.0,51,40,91,58,51,7,1.57,87.93,Facile,Moyen,-1,Plus Difficile,Pas Adapte,Mathematics
1700,2016,Mathématiques,2,Le Calcul d'Integral,2,Les Methodes Generales d'Integration,7,590,1,QCM,0.39,0.36,59.0,54,37,91,56,54,2,1.62,96.43,Facile,Moyen,-1,Plus Difficile,Pas Adapte,Mathematics
2811,2017,Mathématiques,2,Le Calcul d'Integral,2,Les Methodes Generales d'Integration,7,590,1,QCM,0.78,0.2,30.0,25,58,83,81,25,56,1.02,30.86,Facile,Difficile,-2,Beaucoup plus Difficile,Pas Adapte,Mathematics
3922,2018,Mathématiques,2,Le Calcul d'Integral,2,Les Methodes Generales d'Integration,7,590,1,QCM,0.46,0.33,38.0,32,53,85,77,32,45,1.1,41.56,Moyen,Moyen,0,Meme Difficulté,Pas Adapte,Mathematics
5033,2019,Mathématiques,2,Le Calcul d'Integral,2,Les Methodes Generales d'Integration,7,590,1,QCM,0.38,0.58,63.0,50,30,80,68,50,18,1.18,73.53,Difficile,Moyen,1,Plus Facile,Adapte,Mathematics
6144,2020,Mathématiques,2,Le Calcul d'Integral,2,Les Methodes Generales d'Integration,7,590,1,QCM,0.44,0.39,63.0,58,34,92,60,58,2,1.53,96.67,Moyen,Moyen,0,Meme Difficulté,Adapte,Mathematics
590,2015,Mathématiques,2,Le Calcul d'Integral,2,Les Methodes Generales d'Integration,7,591,2,QCU,0.35,0.7,42.0,37,52,89,82,37,45,1.09,45.12,Facile,Moyen,-1,Plus Difficile,Pas Adapte,Mathematics
1701,2016,Mathématiques,2,Le Calcul d'Integral,2,Les Methodes Generales d'Integration,7,591,2,QCU,0.39,0.5,62.0,58,35,93,63,58,5,1.48,92.06,Difficile,Moyen,1,Plus Facile,Adapte,Mathematics
2812,2017,Mathématiques,2,Le Calcul d'Integral,2,Les Methodes Generales d'Integration,7,591,2,QCU,0.31,0.49,62.0,54,33,87,75,54,21,1.16,72.0,Moyen,Moyen,0,Meme Difficulté,Adapte,Mathematics
3923,2018,Mathématiques,2,Le Calcul d'Integral,2,Les Methodes Generales d'Integration,7,591,2,QCU,0.3,0.69,62.0,50,31,81,57,50,7,1.42,87.72,Moyen,Moyen,0,Meme Difficulté,Adapte,Mathematics
5034,2019,Mathématiques,2,Le Calcul d'Integral,2,Les Methodes Generales d'Integration,7,591,2,QCU,0.33,0.64,62.0,55,33,88,60,55,5,1.47,91.67,Moyen,Moyen,0,Meme Difficulté,Adapte,Mathematics
6145,2020,Mathématiques,2,Le Calcul d'Integral,2,Les Methodes Generales d'Integration,7,591,2,QCU,0.35,0.46,62.0,56,34,90,87,56,31,1.03,64.37,Moyen,Moyen,0,Meme Difficulté,Adapte,Mathematics
591,2015,Mathématiques,2,Le Calcul d'Integral,2,Les Methodes Generales d'Integration,7,592,3,QCU,0.54,0.38,19.0,2,7,9,5,2,3,1.8,40.0,Moyen,Difficile,-1,Plus Difficile,Pas Adapte,Mathematics
1702,2016,Mathématiques,2,Le Calcul d'Integral,2,Les Methodes Generales d'Integration,7,592,3,QCU,0.67,0.22,10.0,1,8,9,7,1,6,1.29,14.29,Facile,Difficile,-2,Beaucoup plus Difficile,Pas Adapte,Mathematics
2813,2017,Mathématiques,2,Le Calcul d'Integral,2,Les Methodes Generales d'Integration,7,592,3,QCU,0.66,0.31,7.0,1,8,9,9,1,8,1.0,11.11,Moyen,Difficile,-1,Plus Difficile,Pas Adapte,Mathematics
3924,2018,Mathématiques,2,Le Calcul d'Integral,2,Les Methodes Generales d'Integration,7,592,3,QCU,0.35,0.51,48.0,4,4,8,6,4,2,1.33,66.67,Difficile,Moyen,1,Plus Facile,Pas Adapte,Mathematics
5035,2019,Mathématiques,2,Le Calcul d'Integral,2,Les Methodes Generales d'Integration,7,592,3,QCU,0.66,0.28,13.0,1,8,9,9,1,8,1.0,11.11,Facile,Difficile,-2,Beaucoup plus Difficile,Pas Adapte,Mathematics
6146,2020,Mathématiques,2,Le Calcul d'Integral,2,Les Methodes Generales d'Integration,7,592,3,QCU,0.41,0.28,13.0,1,8,9,5,1,4,1.8,20.0,Facile,Difficile,-2,Beaucoup plus Difficile,Pas Adapte,Mathematics
592,2015,Mathématiques,2,Le Calcul d'Integral,2,Les Methodes Generales d'Integration,7,593,4,QO,0.6,0.16,50.0,40,40,80,69,40,29,1.16,57.97,Facile,Moyen,-1,Plus Difficile,Pas Adapte,Mathematics
1703,2016,Mathématiques,2,Le Calcul d'Integral,2,Les Methodes Generales d'Integration,7,593,4,QROC,0.33,0.39,50.0,36,35,71,52,36,16,1.37,69.23,Facile,Moyen,-1,Plus Difficile,Pas Adapte,Mathematics
2814,2017,Mathématiques,2,Le Calcul d'Integral,2,Les Methodes Generales d'Integration,7,593,4,QROC,0.68,0.22,3.0,2,62,64,28,2,26,2.29,7.14,Difficile,Difficile,0,Meme Difficulté,Pas Adapte,Mathematics
3925,2018,Mathématiques,2,Le Calcul d'Integral,2,Les Methodes Generales d'Integration,7,593,4,QROC,0.73,0.09,32.0,19,40,59,38,19,19,1.55,50.0,Moyen,Difficile,-1,Plus Difficile,Pas Adapte,Mathematics
5036,2019,Mathématiques,2,Le Calcul d'Integral,2,Les Methodes Generales d'Integration,7,593,4,QROC,0.76,0.24,0.0,0,66,66,58,0,58,1.14,0.0,Moyen,Difficile,-1,Plus Difficile,Pas Adapte,Mathematics
6147,2020,Mathématiques,2,Le Calcul d'Integral,2,Les Methodes Generales d'Integration,7,593,4,QROC,0.49,0.28,57.0,35,27,62,48,35,13,1.29,72.92,Difficile,Moyen,1,Plus Facile,Pas Adapte,Mathematics
593,2015,Mathématiques,2,Le Calcul d'Integral,2,Les Methodes Generales d'Integration,7,594,5,QCM,0.53,0.18,22.0,10,37,47,29,10,19,1.62,34.48,Difficile,Difficile,0,Meme Difficulté,Pas Adapte,Mathematics
1704,2016,Mathématiques,2,Le Calcul d'Integral,2,Les Methodes Generales d'Integration,7,594,5,QCM,0.47,0.53,52.0,24,23,47,33,24,9,1.42,72.73,Moyen,Moyen,0,Meme Difficulté,Pas Adapte,Mathematics
2815,2017,Mathématiques,2,Le Calcul d'Integral,2,Les Methodes Generales d'Integration,7,594,5,QCM,0.62,0.26,17.0,7,37,44,29,7,22,1.52,24.14,Moyen,Difficile,-1,Plus Difficile,Pas Adapte,Mathematics
3926,2018,Mathématiques,2,Le Calcul d'Integral,2,Les Methodes Generales d'Integration,7,594,5,QCM,0.64,0.24,35.0,13,24,37,34,13,21,1.09,38.24,Difficile,Difficile,0,Meme Difficulté,Pas Adapte,Mathematics
5037,2019,Mathématiques,2,Le Calcul d'Integral,2,Les Methodes Generales d'Integration,7,594,5,QCM,0.78,0.25,13.0,5,36,41,15,5,10,2.73,33.33,Difficile,Difficile,0,Meme Difficulté,Pas Adapte,Mathematics
6148,2020,Mathématiques,2,Le Calcul d'Integral,2,Les Methodes Generales d'Integration,7,594,5,QCM,0.61,0.3,17.0,6,30,36,32,6,26,1.12,18.75,Facile,Difficile,-2,Beaucoup plus Difficile,Pas Adapte,Mathematics
594,2015,Mathématiques,2,Le Calcul d'Integral,2,Les Methodes Generales d'Integration,7,595,6,QCM,0.36,0.49,57.0,46,35,81,59,46,13,1.37,77.97,Difficile,Moyen,1,Plus Facile,Pas Adapte,Mathematics
1705,2016,Mathématiques,2,Le Calcul d'Integral,2,Les Methodes Generales d'Integration,7,595,6,QCM,0.56,0.21,10.0,8,74,82,50,8,42,1.64,16.0,Facile,Difficile,-2,Beaucoup plus Difficile,Pas Adapte,Mathematics
2816,2017,Mathématiques,2,Le Calcul d'Integral,2,Les Methodes Generales d'Integration,7,595,6,QCM,0.36,0.65,43.0,39,52,91,82,39,43,1.11,47.56,Difficile,Moyen,1,Plus Facile,Pas Adapte,Mathematics
3927,2018,Mathématiques,2,Le Calcul d'Integral,2,Les Methodes Generales d'Integration,7,595,6,QCM,0.41,0.39,62.0,49,30,79,66,49,17,1.2,74.24,Facile,Moyen,-1,Plus Difficile,Adapte,Mathematics
5038,2019,Mathématiques,2,Le Calcul d'Integral,2,Les Methodes Generales d'Integration,7,595,6,QCM,0.44,0.41,62.0,50,30,80,78,50,28,1.03,64.1,Moyen,Moyen,0,Meme Difficulté,Adapte,Mathematics
6149,2020,Mathématiques,2,Le Calcul d'Integral,2,Les Methodes Generales d'Integration,7,595,6,QCM,0.22,0.58,62.0,49,30,79,57,49,8,1.39,85.96,Moyen,Moyen,0,Meme Difficulté,Adapte,Mathematics
595,2015,Mathématiques,2,Le Calcul d'Integral,2,Les Methodes Generales d'Integration,7,596,7,QCU,0.38,0.67,62.0,21,13,34,30,21,9,1.13,70.0,Facile,Moyen,-1,Plus Difficile,Adapte,Mathematics
1706,2016,Mathématiques,2,Le Calcul d'Integral,2,Les Methodes Generales d'Integration,7,596,7,QCU,0.28,0.63,62.0,22,13,35,26,22,4,1.35,84.62,Moyen,Moyen,0,Meme Difficulté,Adapte,Mathematics
2817,2017,Mathématiques,2,Le Calcul d'Integral,2,Les Methodes Generales d'Integration,7,596,7,QCU,0.27,0.7,62.0,19,12,31,25,19,6,1.24,76.0,Moyen,Moyen,0,Meme Difficulté,Adapte,Mathematics
3928,2018,Mathématiques,2,Le Calcul d'Integral,2,Les Methodes Generales d'Integration,7,596,7,QCU,0.26,0.72,62.0,22,14,36,28,22,6,1.29,78.57,Moyen,Moyen,0,Meme Difficulté,Adapte,Mathematics
5039,2019,Mathématiques,2,Le Calcul d'Integral,2,Les Methodes Generales d'Integration,7,596,7,QCU,0.31,0.43,62.0,25,16,41,28,25,3,1.46,89.29,Moyen,Moyen,0,Meme Difficulté,Adapte,Mathematics
6150,2020,Mathématiques,2,Le Calcul d'Integral,2,Les Methodes Generales d'Integration,7,596,7,QCU,0.34,0.72,62.0,23,14,37,29,23,6,1.28,79.31,Moyen,Moyen,0,Meme Difficulté,Adapte,Mathematics
596,2015,Mathématiques,2,Le Calcul d'Integral,3,Integration des Fractions Rationnelles,8,597,1,QCM,0.56,0.26,5.0,1,10,11,5,1,4,2.2,20.0,Difficile,Difficile,0,Meme Difficulté,Pas Adapte,Mathematics
1707,2016,Mathématiques,2,Le Calcul d'Integral,3,Integration des Fractions Rationnelles,8,597,1,QCM,0.55,0.19,23.0,3,9,12,11,3,8,1.09,27.27,Facile,Difficile,-2,Beaucoup plus Difficile,Pas Adapte,Mathematics
2818,2017,Mathématiques,2,Le Calcul d'Integral,3,Integration des Fractions Rationnelles,8,597,1,QCM,0.68,0.28,21.0,3,10,13,4,3,1,3.25,75.0,Facile,Difficile,-2,Beaucoup plus Difficile,Pas Adapte,Mathematics
3929,2018,Mathématiques,2,Le Calcul d'Integral,3,Integration des Fractions Rationnelles,8,597,1,QCM,0.43,0.3,53.0,8,7,15,12,8,4,1.25,66.67,Difficile,Moyen,1,Plus Facile,Pas Adapte,Mathematics
5040,2019,Mathématiques,2,Le Calcul d'Integral,3,Integration des Fractions Rationnelles,8,597,1,QCM,0.34,0.55,50.0,6,7,13,8,6,2,1.62,75.0,Difficile,Moyen,1,Plus Facile,Pas Adapte,Mathematics
6151,2020,Mathématiques,2,Le Calcul d'Integral,3,Integration des Fractions Rationnelles,8,597,1,QCM,0.54,0.29,10.0,1,10,11,9,1,8,1.22,11.11,Difficile,Difficile,0,Meme Difficulté,Pas Adapte,Mathematics
597,2015,Mathématiques,2,Le Calcul d'Integral,3,Integration des Fractions Rationnelles,8,598,2,QCU,0.64,0.28,6.0,4,59,63,55,4,51,1.15,7.27,Difficile,Difficile,0,Meme Difficulté,Pas Adapte,Mathematics
1708,2016,Mathématiques,2,Le Calcul d'Integral,3,Integration des Fractions Rationnelles,8,598,2,QCU,0.35,0.72,36.0,23,41,64,62,23,39,1.03,37.1,Difficile,Moyen,1,Plus Facile,Pas Adapte,Mathematics
2819,2017,Mathématiques,2,Le Calcul d'Integral,3,Integration des Fractions Rationnelles,8,598,2,QCM,0.77,0.24,1.0,1,71,72,44,1,43,1.64,2.27,Facile,Difficile,-2,Beaucoup plus Difficile,Pas Adapte,Mathematics
3930,2018,Mathématiques,2,Le Calcul d'Integral,3,Integration des Fractions Rationnelles,8,598,2,QCM,0.65,0.18,18.0,14,62,76,71,14,57,1.07,19.72,Difficile,Difficile,0,Meme Difficulté,Pas Adapte,Mathematics
5041,2019,Mathématiques,2,Le Calcul d'Integral,3,Integration des Fractions Rationnelles,8,598,2,QCM,0.54,0.17,8.0,6,75,81,70,6,64,1.16,8.57,Difficile,Difficile,0,Meme Difficulté,Pas Adapte,Mathematics
6152,2020,Mathématiques,2,Le Calcul d'Integral,3,Integration des Fractions Rationnelles,8,598,2,QROC,0.98,0.25,28.0,22,55,77,53,22,31,1.45,41.51,Facile,Difficile,-2,Beaucoup plus Difficile,Pas Adapte,Mathematics
598,2015,Mathématiques,2,Le Calcul d'Integral,3,Integration des Fractions Rationnelles,8,599,3,QO,0.61,0.29,63.0,46,27,73,49,46,3,1.49,93.88,Moyen,Moyen,0,Meme Difficulté,Adapte,Mathematics
1709,2016,Mathématiques,2,Le Calcul d'Integral,3,Integration des Fractions Rationnelles,8,599,3,QO,0.36,0.27,63.0,43,26,69,54,43,11,1.28,79.63,Moyen,Moyen,0,Meme Difficulté,Adapte,Mathematics
2820,2017,Mathématiques,2,Le Calcul d'Integral,3,Integration des Fractions Rationnelles,8,599,3,QROC,0.3,0.37,63.0,38,23,61,43,38,5,1.42,88.37,Moyen,Moyen,0,Meme Difficulté,Adapte,Mathematics
3931,2018,Mathématiques,2,Le Calcul d'Integral,3,Integration des Fractions Rationnelles,8,599,3,QROC,0.38,0.37,63.0,33,19,52,37,33,4,1.41,89.19,Moyen,Moyen,0,Meme Difficulté,Adapte,Mathematics
5042,2019,Mathématiques,2,Le Calcul d'Integral,3,Integration des Fractions Rationnelles,8,599,3,QO,0.29,0.19,63.0,32,18,50,45,32,13,1.11,71.11,Moyen,Moyen,0,Meme Difficulté,Adapte,Mathematics
6153,2020,Mathématiques,2,Le Calcul d'Integral,3,Integration des Fractions Rationnelles,8,599,3,QO,0.49,0.21,63.0,27,16,43,35,27,8,1.23,77.14,Moyen,Moyen,0,Meme Difficulté,Adapte,Mathematics
599,2015,Mathématiques,2,Le Calcul d'Integral,3,Integration des Fractions Rationnelles,8,600,4,QCM,0.25,0.57,64.0,35,19,54,38,35,3,1.42,92.11,Facile,Moyen,-1,Plus Difficile,Adapte,Mathematics
1710,2016,Mathématiques,2,Le Calcul d'Integral,3,Integration des Fractions Rationnelles,8,600,4,QCM,0.31,0.36,64.0,31,18,49,35,31,4,1.4,88.57,Moyen,Moyen,0,Meme Difficulté,Adapte,Mathematics
2821,2017,Mathématiques,2,Le Calcul d'Integral,3,Integration des Fractions Rationnelles,8,600,4,QROC,0.27,0.31,64.0,33,18,51,41,33,8,1.24,80.49,Moyen,Moyen,0,Meme Difficulté,Adapte,Mathematics
3932,2018,Mathématiques,2,Le Calcul d'Integral,3,Integration des Fractions Rationnelles,8,600,4,QROC,0.21,0.32,64.0,35,19,54,38,35,3,1.42,92.11,Moyen,Moyen,0,Meme Difficulté,Adapte,Mathematics
5043,2019,Mathématiques,2,Le Calcul d'Integral,3,Integration des Fractions Rationnelles,8,600,4,QROC,0.53,0.37,64.0,31,17,48,36,31,5,1.33,86.11,Moyen,Moyen,0,Meme Difficulté,Adapte,Mathematics
6154,2020,Mathématiques,2,Le Calcul d'Integral,3,Integration des Fractions Rationnelles,8,600,4,QROC,0.27,0.38,64.0,29,16,45,42,29,13,1.07,69.05,Moyen,Moyen,0,Meme Difficulté,Adapte,Mathematics
600,2015,Mathématiques,2,Le Calcul d'Integral,3,Integration des Fractions Rationnelles,8,601,5,QO,0.01,0.79,65.0,12,6,18,16,12,4,1.12,75.0,Facile,Facile,0,Meme Difficulté,Adapte,Mathematics
1711,2016,Mathématiques,2,Le Calcul d'Integral,3,Integration des Fractions Rationnelles,8,601,5,QO,0.1,0.72,65.0,13,7,20,15,13,2,1.33,86.67,Facile,Facile,0,Meme Difficulté,Adapte,Mathematics
2822,2017,Mathématiques,2,Le Calcul d'Integral,3,Integration des Fractions Rationnelles,8,601,5,QO,0.01,0.46,65.0,13,7,20,18,13,5,1.11,72.22,Facile,Facile,0,Meme Difficulté,Adapte,Mathematics
3933,2018,Mathématiques,2,Le Calcul d'Integral,3,Integration des Fractions Rationnelles,8,601,5,QROC,0.11,0.6,65.0,12,6,18,17,12,5,1.06,70.59,Facile,Facile,0,Meme Difficulté,Adapte,Mathematics
5044,2019,Mathématiques,2,Le Calcul d'Integral,3,Integration des Fractions Rationnelles,8,601,5,QO,0.14,0.86,65.0,13,7,20,16,13,3,1.25,81.25,Facile,Facile,0,Meme Difficulté,Adapte,Mathematics
6155,2020,Mathématiques,2,Le Calcul d'Integral,3,Integration des Fractions Rationnelles,8,601,5,QO,0.1,0.79,65.0,12,7,19,16,12,4,1.19,75.0,Facile,Facile,0,Meme Difficulté,Adapte,Mathematics
601,2015,Mathématiques,2,Le Calcul d'Integral,3,Integration des Fractions Rationnelles,8,602,6,QCU,0.51,0.34,4.0,4,91,95,80,4,76,1.19,5.0,Difficile,Difficile,0,Meme Difficulté,Pas Adapte,Mathematics
1712,2016,Mathématiques,2,Le Calcul d'Integral,3,Integration des Fractions Rationnelles,8,602,6,QCU,0.63,0.36,10.0,8,77,85,77,8,69,1.1,10.39,Moyen,Difficile,-1,Plus Difficile,Pas Adapte,Mathematics
2823,2017,Mathématiques,2,Le Calcul d'Integral,3,Integration des Fractions Rationnelles,8,602,6,QCU,0.44,0.36,1.0,1,92,93,91,1,90,1.02,1.1,Moyen,Difficile,-1,Plus Difficile,Pas Adapte,Mathematics
3934,2018,Mathématiques,2,Le Calcul d'Integral,3,Integration des Fractions Rationnelles,8,602,6,QCM,0.22,0.32,42.0,42,58,100,50,42,8,2.0,84.0,Facile,Moyen,-1,Plus Difficile,Pas Adapte,Mathematics
5045,2019,Mathématiques,2,Le Calcul d'Integral,3,Integration des Fractions Rationnelles,8,602,6,QCM,0.61,0.18,12.0,13,97,110,44,13,31,2.5,29.55,Facile,Difficile,-2,Beaucoup plus Difficile,Pas Adapte,Mathematics
6156,2020,Mathématiques,2,Le Calcul d'Integral,3,Integration des Fractions Rationnelles,8,602,6,QCM,0.5,0.33,60.0,61,41,102,92,61,31,1.11,66.3,Moyen,Moyen,0,Meme Difficulté,Adapte,Mathematics
602,2015,Mathématiques,2,Le Calcul d'Integral,3,Integration des Fractions Rationnelles,8,603,7,QCU,0.57,0.26,29.0,9,22,31,17,9,8,1.82,52.94,Facile,Difficile,-2,Beaucoup plus Difficile,Pas Adapte,Mathematics
1713,2016,Mathématiques,2,Le Calcul d'Integral,3,Integration des Fractions Rationnelles,8,603,7,QCU,0.25,0.49,59.0,17,12,29,22,17,5,1.32,77.27,Difficile,Moyen,1,Plus Facile,Pas Adapte,Mathematics
2824,2017,Mathématiques,2,Le Calcul d'Integral,3,Integration des Fractions Rationnelles,8,603,7,QCU,0.27,0.52,56.0,17,13,30,25,17,8,1.2,68.0,Facile,Moyen,-1,Plus Difficile,Pas Adapte,Mathematics
3935,2018,Mathématiques,2,Le Calcul d'Integral,3,Integration des Fractions Rationnelles,8,603,7,QCU,0.26,0.61,63.0,16,10,26,22,16,6,1.18,72.73,Moyen,Moyen,0,Meme Difficulté,Adapte,Mathematics
5046,2019,Mathématiques,2,Le Calcul d'Integral,3,Integration des Fractions Rationnelles,8,603,7,QCU,0.31,0.42,63.0,16,9,25,24,16,8,1.04,66.67,Moyen,Moyen,0,Meme Difficulté,Adapte,Mathematics
6157,2020,Mathématiques,2,Le Calcul d'Integral,3,Integration des Fractions Rationnelles,8,603,7,QCU,0.39,0.56,63.0,18,11,29,19,18,1,1.53,94.74,Moyen,Moyen,0,Meme Difficulté,Adapte,Mathematics
603,2015,Mathématiques,2,Le Calcul d'Integral,3,Integration des Fractions Rationnelles,8,604,8,QCU,0.39,0.72,41.0,35,50,85,72,35,37,1.18,48.61,Difficile,Moyen,1,Plus Facile,Pas Adapte,Mathematics
1714,2016,Mathématiques,2,Le Calcul d'Integral,3,Integration des Fractions Rationnelles,8,604,8,QCU,0.26,0.53,60.0,44,30,74,67,44,23,1.1,65.67,Moyen,Moyen,0,Meme Difficulté,Adapte,Mathematics
2825,2017,Mathématiques,2,Le Calcul d'Integral,3,Integration des Fractions Rationnelles,8,604,8,QCU,0.22,0.52,60.0,46,30,76,57,46,11,1.33,80.7,Moyen,Moyen,0,Meme Difficulté,Adapte,Mathematics
3936,2018,Mathématiques,2,Le Calcul d'Integral,3,Integration des Fractions Rationnelles,8,604,8,QCU,0.31,0.41,60.0,40,26,66,56,40,16,1.18,71.43,Moyen,Moyen,0,Meme Difficulté,Adapte,Mathematics
5047,2019,Mathématiques,2,Le Calcul d'Integral,3,Integration des Fractions Rationnelles,8,604,8,QCU,0.36,0.73,60.0,34,22,56,37,34,3,1.51,91.89,Moyen,Moyen,0,Meme Difficulté,Adapte,Mathematics
6158,2020,Mathématiques,2,Le Calcul d'Integral,3,Integration des Fractions Rationnelles,8,604,8,QCU,0.2,0.5,60.0,30,20,50,47,30,17,1.06,63.83,Moyen,Moyen,0,Meme Difficulté,Adapte,Mathematics
604,2015,Mathématiques,2,Le Calcul d'Integral,4,Fonction Trigonometriques,11,605,1,QCM,0.43,0.53,57.0,26,20,46,34,26,8,1.35,76.47,Difficile,Moyen,1,Plus Facile,Pas Adapte,Mathematics
1715,2016,Mathématiques,2,Le Calcul d'Integral,4,Fonction Trigonometriques,11,605,1,QCM,0.54,0.25,34.0,15,30,45,16,15,1,2.81,93.75,Facile,Difficile,-2,Beaucoup plus Difficile,Pas Adapte,Mathematics
2826,2017,Mathématiques,2,Le Calcul d'Integral,4,Fonction Trigonometriques,11,605,1,QO,0.75,0.06,1.0,0,38,38,29,0,29,1.31,0.0,Difficile,Difficile,0,Meme Difficulté,Pas Adapte,Mathematics
3937,2018,Mathématiques,2,Le Calcul d'Integral,4,Fonction Trigonometriques,11,605,1,QCM,0.4,0.69,62.0,23,14,37,33,23,10,1.12,69.7,Facile,Moyen,-1,Plus Difficile,Adapte,Mathematics
5048,2019,Mathématiques,2,Le Calcul d'Integral,4,Fonction Trigonometriques,11,605,1,QCM,0.24,0.41,62.0,19,12,31,30,19,11,1.03,63.33,Moyen,Moyen,0,Meme Difficulté,Adapte,Mathematics
6159,2020,Mathématiques,2,Le Calcul d'Integral,4,Fonction Trigonometriques,11,605,1,QCM,0.5,0.65,62.0,20,13,33,22,20,2,1.5,90.91,Moyen,Moyen,0,Meme Difficulté,Adapte,Mathematics
605,2015,Mathématiques,2,Le Calcul d'Integral,4,Fonction Trigonometriques,11,606,2,QROC,0.56,0.27,49.0,12,12,24,12,12,0,2.0,100.0,Difficile,Moyen,1,Plus Facile,Pas Adapte,Mathematics
1716,2016,Mathématiques,2,Le Calcul d'Integral,4,Fonction Trigonometriques,11,606,2,QO,0.49,0.26,40.0,9,13,22,12,9,3,1.83,75.0,Difficile,Moyen,1,Plus Facile,Pas Adapte,Mathematics
2827,2017,Mathématiques,2,Le Calcul d'Integral,4,Fonction Trigonometriques,11,606,2,QO,0.98,0.02,25.0,5,14,19,19,5,14,1.0,26.32,Difficile,Difficile,0,Meme Difficulté,Pas Adapte,Mathematics
3938,2018,Mathématiques,2,Le Calcul d'Integral,4,Fonction Trigonometriques,11,606,2,QO,0.59,0.19,48.0,8,8,16,10,8,2,1.6,80.0,Difficile,Moyen,1,Plus Facile,Pas Adapte,Mathematics
5049,2019,Mathématiques,2,Le Calcul d'Integral,4,Fonction Trigonometriques,11,606,2,QO,0.78,0.1,29.0,4,11,15,11,4,7,1.36,36.36,Moyen,Difficile,-1,Plus Difficile,Pas Adapte,Mathematics
6160,2020,Mathématiques,2,Le Calcul d'Integral,4,Fonction Trigonometriques,11,606,2,QROC,0.8,0.0,26.0,4,12,16,8,4,4,2.0,50.0,Facile,Difficile,-2,Beaucoup plus Difficile,Pas Adapte,Mathematics
606,2015,Mathématiques,2,Le Calcul d'Integral,4,Fonction Trigonometriques,11,607,3,QROC,0.82,0.16,33.0,22,45,67,49,22,27,1.37,44.9,Difficile,Difficile,0,Meme Difficulté,Pas Adapte,Mathematics
1717,2016,Mathématiques,2,Le Calcul d'Integral,4,Fonction Trigonometriques,11,607,3,QROC,0.55,0.33,46.0,30,35,65,45,30,15,1.44,66.67,Moyen,Moyen,0,Meme Difficulté,Pas Adapte,Mathematics
2828,2017,Mathématiques,2,Le Calcul d'Integral,4,Fonction Trigonometriques,11,607,3,QROC,0.55,0.28,61.0,36,23,59,46,36,10,1.28,78.26,Facile,Moyen,-1,Plus Difficile,Adapte,Mathematics
3939,2018,Mathématiques,2,Le Calcul d'Integral,4,Fonction Trigonometriques,11,607,3,QROC,0.41,0.28,61.0,35,23,58,40,35,5,1.45,87.5,Moyen,Moyen,0,Meme Difficulté,Adapte,Mathematics
5050,2019,Mathématiques,2,Le Calcul d'Integral,4,Fonction Trigonometriques,11,607,3,QROC,0.33,0.35,61.0,30,19,49,42,30,12,1.17,71.43,Moyen,Moyen,0,Meme Difficulté,Adapte,Mathematics
6161,2020,Mathématiques,2,Le Calcul d'Integral,4,Fonction Trigonometriques,11,607,3,QROC,0.25,0.39,61.0,27,18,45,44,27,17,1.02,61.36,Moyen,Moyen,0,Meme Difficulté,Adapte,Mathematics
607,2015,Mathématiques,2,Le Calcul d'Integral,4,Fonction Trigonometriques,11,608,4,QCU,0.56,0.21,33.0,24,48,72,67,24,43,1.07,35.82,Facile,Difficile,-2,Beaucoup plus Difficile,Pas Adapte,Mathematics
1718,2016,Mathématiques,2,Le Calcul d'Integral,4,Fonction Trigonometriques,11,608,4,QCU,0.36,0.51,37.0,31,52,83,55,31,24,1.51,56.36,Moyen,Moyen,0,Meme Difficulté,Pas Adapte,Mathematics
2829,2017,Mathématiques,2,Le Calcul d'Integral,4,Fonction Trigonometriques,11,608,4,QCU,0.62,0.36,32.0,26,54,80,38,26,12,2.11,68.42,Moyen,Difficile,-1,Plus Difficile,Pas Adapte,Mathematics
3940,2018,Mathématiques,2,Le Calcul d'Integral,4,Fonction Trigonometriques,11,608,4,QCU,0.26,0.6,56.0,41,32,73,43,41,2,1.7,95.35,Difficile,Moyen,1,Plus Facile,Pas Adapte,Mathematics
5051,2019,Mathématiques,2,Le Calcul d'Integral,4,Fonction Trigonometriques,11,608,4,QCU,0.49,0.25,7.0,5,63,68,51,5,46,1.33,9.8,Facile,Difficile,-2,Beaucoup plus Difficile,Pas Adapte,Mathematics
6162,2020,Mathématiques,2,Le Calcul d'Integral,4,Fonction Trigonometriques,11,608,4,QCU,0.23,0.41,46.0,30,36,66,35,30,5,1.89,85.71,Moyen,Moyen,0,Meme Difficulté,Pas Adapte,Mathematics
608,2015,Mathématiques,2,Le Calcul d'Integral,4,Fonction Trigonometriques,11,609,5,QCM,0.51,0.25,1.0,1,93,94,32,1,31,2.94,3.12,Moyen,Difficile,-1,Plus Difficile,Pas Adapte,Mathematics
1719,2016,Mathématiques,2,Le Calcul d'Integral,4,Fonction Trigonometriques,11,609,5,QCM,0.78,0.28,6.0,5,79,84,32,5,27,2.62,15.62,Moyen,Difficile,-1,Plus Difficile,Pas Adapte,Mathematics
2830,2017,Mathématiques,2,Le Calcul d'Integral,4,Fonction Trigonometriques,11,609,5,QCM,0.43,0.58,36.0,29,51,80,53,29,24,1.51,54.72,Moyen,Moyen,0,Meme Difficulté,Pas Adapte,Mathematics
3941,2018,Mathématiques,2,Le Calcul d'Integral,4,Fonction Trigonometriques,11,609,5,QCM,0.36,0.6,51.0,46,44,90,80,46,34,1.12,57.5,Difficile,Moyen,1,Plus Facile,Pas Adapte,Mathematics
5052,2019,Mathématiques,2,Le Calcul d'Integral,4,Fonction Trigonometriques,11,609,5,QCM,0.45,0.68,54.0,46,40,86,75,46,29,1.15,61.33,Facile,Moyen,-1,Plus Difficile,Pas Adapte,Mathematics
6163,2020,Mathématiques,2,Le Calcul d'Integral,4,Fonction Trigonometriques,11,609,5,QCM,0.6,0.22,15.0,11,65,76,36,11,25,2.11,30.56,Facile,Difficile,-2,Beaucoup plus Difficile,Pas Adapte,Mathematics
609,2015,Mathématiques,2,Le Calcul d'Integral,4,Fonction Trigonometriques,11,610,6,QCU,0.5,0.36,6.0,2,33,35,13,2,11,2.69,15.38,Moyen,Difficile,-1,Plus Difficile,Pas Adapte,Mathematics
1720,2016,Mathématiques,2,Le Calcul d'Integral,4,Fonction Trigonometriques,11,610,6,QCM,0.77,0.17,7.0,3,34,37,34,3,31,1.09,8.82,Moyen,Difficile,-1,Plus Difficile,Pas Adapte,Mathematics
2831,2017,Mathématiques,2,Le Calcul d'Integral,4,Fonction Trigonometriques,11,610,6,QCM,0.5,0.24,27.0,11,31,42,22,11,11,1.91,50.0,Facile,Difficile,-2,Beaucoup plus Difficile,Pas Adapte,Mathematics
3942,2018,Mathématiques,2,Le Calcul d'Integral,4,Fonction Trigonometriques,11,610,6,QCU,0.64,0.24,13.0,6,41,47,17,6,11,2.76,35.29,Facile,Difficile,-2,Beaucoup plus Difficile,Pas Adapte,Mathematics
5053,2019,Mathématiques,2,Le Calcul d'Integral,4,Fonction Trigonometriques,11,610,6,QCU,0.41,0.21,1.0,0,45,45,36,0,36,1.25,0.0,Moyen,Difficile,-1,Plus Difficile,Pas Adapte,Mathematics
6164,2020,Mathématiques,2,Le Calcul d'Integral,4,Fonction Trigonometriques,11,610,6,QCU,0.68,0.27,16.0,6,32,38,19,6,13,2.0,31.58,Facile,Difficile,-2,Beaucoup plus Difficile,Pas Adapte,Mathematics
610,2015,Mathématiques,2,Le Calcul d'Integral,4,Fonction Trigonometriques,11,611,7,QCM,0.55,0.29,16.0,9,50,59,21,9,12,2.81,42.86,Difficile,Difficile,0,Meme Difficulté,Pas Adapte,Mathematics
1721,2016,Mathématiques,2,Le Calcul d'Integral,4,Fonction Trigonometriques,11,611,7,QCM,0.67,0.26,19.0,11,49,60,22,11,11,2.73,50.0,Difficile,Difficile,0,Meme Difficulté,Pas Adapte,Mathematics
2832,2017,Mathématiques,2,Le Calcul d'Integral,4,Fonction Trigonometriques,11,611,7,QCM,0.41,0.33,45.0,26,32,58,51,26,25,1.14,50.98,Difficile,Moyen,1,Plus Facile,Pas Adapte,Mathematics
3943,2018,Mathématiques,2,Le Calcul d'Integral,4,Fonction Trigonometriques,11,611,7,QCM,0.34,0.66,59.0,29,20,49,34,29,5,1.44,85.29,Moyen,Moyen,0,Meme Difficulté,Pas Adapte,Mathematics
5054,2019,Mathématiques,2,Le Calcul d'Integral,4,Fonction Trigonometriques,11,611,7,QCM,0.74,0.3,28.0,15,40,55,51,15,36,1.08,29.41,Facile,Difficile,-2,Beaucoup plus Difficile,Pas Adapte,Mathematics
6165,2020,Mathématiques,2,Le Calcul d'Integral,4,Fonction Trigonometriques,11,611,7,QCU,0.29,0.67,39.0,21,33,54,22,21,1,2.45,95.45,Moyen,Moyen,0,Meme Difficulté,Pas Adapte,Mathematics
611,2015,Mathématiques,2,Le Calcul d'Integral,4,Fonction Trigonometriques,11,612,8,QCM,0.35,0.37,44.0,38,48,86,80,38,42,1.07,47.5,Facile,Moyen,-1,Plus Difficile,Pas Adapte,Mathematics
1722,2016,Mathématiques,2,Le Calcul d'Integral,4,Fonction Trigonometriques,11,612,8,QCM,0.78,0.19,23.0,20,66,86,82,20,62,1.05,24.39,Moyen,Difficile,-1,Plus Difficile,Pas Adapte,Mathematics
2833,2017,Mathématiques,2,Le Calcul d'Integral,4,Fonction Trigonometriques,11,612,8,QCM,0.34,0.56,63.0,52,30,82,57,52,5,1.44,91.23,Facile,Moyen,-1,Plus Difficile,Adapte,Mathematics
3944,2018,Mathématiques,2,Le Calcul d'Integral,4,Fonction Trigonometriques,11,612,8,QCM,0.27,0.39,63.0,55,32,87,62,55,7,1.4,88.71,Moyen,Moyen,0,Meme Difficulté,Adapte,Mathematics
5055,2019,Mathématiques,2,Le Calcul d'Integral,4,Fonction Trigonometriques,11,612,8,QCM,0.22,0.66,63.0,56,33,89,71,56,15,1.25,78.87,Moyen,Moyen,0,Meme Difficulté,Adapte,Mathematics
6166,2020,Mathématiques,2,Le Calcul d'Integral,4,Fonction Trigonometriques,11,612,8,QCU,0.23,0.63,63.0,63,37,100,83,63,20,1.2,75.9,Moyen,Moyen,0,Meme Difficulté,Adapte,Mathematics
612,2015,Mathématiques,2,Le Calcul d'Integral,4,Fonction Trigonometriques,11,613,9,QCU,0.54,0.28,6.0,1,17,18,15,1,14,1.2,6.67,Facile,Difficile,-2,Beaucoup plus Difficile,Pas Adapte,Mathematics
1723,2016,Mathématiques,2,Le Calcul d'Integral,4,Fonction Trigonometriques,11,613,9,QCU,0.27,0.68,63.0,11,7,18,16,11,5,1.12,68.75,Moyen,Moyen,0,Meme Difficulté,Adapte,Mathematics
2834,2017,Mathématiques,2,Le Calcul d'Integral,4,Fonction Trigonometriques,11,613,9,QROC,0.27,0.3,63.0,11,6,17,14,11,3,1.21,78.57,Moyen,Moyen,0,Meme Difficulté,Adapte,Mathematics
3945,2018,Mathématiques,2,Le Calcul d'Integral,4,Fonction Trigonometriques,11,613,9,QROC,0.27,0.4,63.0,10,6,16,16,10,6,1.0,62.5,Moyen,Moyen,0,Meme Difficulté,Adapte,Mathematics
5056,2019,Mathématiques,2,Le Calcul d'Integral,4,Fonction Trigonometriques,11,613,9,QROC,0.34,0.3,63.0,11,6,17,14,11,3,1.21,78.57,Moyen,Moyen,0,Meme Difficulté,Adapte,Mathematics
6167,2020,Mathématiques,2,Le Calcul d'Integral,4,Fonction Trigonometriques,11,613,9,QROC,0.39,0.3,63.0,10,6,16,13,10,3,1.23,76.92,Moyen,Moyen,0,Meme Difficulté,Adapte,Mathematics
613,2015,Mathématiques,2,Le Calcul d'Integral,4,Fonction Trigonometriques,11,614,10,QCM,0.43,0.58,43.0,6,8,14,11,6,5,1.27,54.55,Moyen,Moyen,0,Meme Difficulté,Pas Adapte,Mathematics
1724,2016,Mathématiques,2,Le Calcul d'Integral,4,Fonction Trigonometriques,11,614,10,QCM,0.24,0.61,41.0,5,7,12,6,5,1,2.0,83.33,Difficile,Moyen,1,Plus Facile,Pas Adapte,Mathematics
2835,2017,Mathématiques,2,Le Calcul d'Integral,4,Fonction Trigonometriques,11,614,10,QO,0.84,0.04,3.0,0,12,12,9,0,9,1.33,0.0,Difficile,Difficile,0,Meme Difficulté,Pas Adapte,Mathematics
3946,2018,Mathématiques,2,Le Calcul d'Integral,4,Fonction Trigonometriques,11,614,10,QO,0.42,0.21,59.0,6,4,10,7,6,1,1.43,85.71,Moyen,Moyen,0,Meme Difficulté,Pas Adapte,Mathematics
5057,2019,Mathématiques,2,Le Calcul d'Integral,4,Fonction Trigonometriques,11,614,10,QO,0.23,0.22,58.0,5,4,9,6,5,1,1.5,83.33,Difficile,Moyen,1,Plus Facile,Pas Adapte,Mathematics
6168,2020,Mathématiques,2,Le Calcul d'Integral,4,Fonction Trigonometriques,11,614,10,QCU,0.35,0.48,53.0,4,4,8,7,4,3,1.14,57.14,Moyen,Moyen,0,Meme Difficulté,Pas Adapte,Mathematics
614,2015,Mathématiques,2,Le Calcul d'Integral,4,Fonction Trigonometriques,11,615,11,QROC,0.65,0.22,15.0,11,61,72,63,11,52,1.14,17.46,Facile,Difficile,-2,Beaucoup plus Difficile,Pas Adapte,Mathematics
1725,2016,Mathématiques,2,Le Calcul d'Integral,4,Fonction Trigonometriques,11,615,11,QROC,0.27,0.38,55.0,45,37,82,51,45,6,1.61,88.24,Moyen,Moyen,0,Meme Difficulté,Pas Adapte,Mathematics
2836,2017,Mathématiques,2,Le Calcul d'Integral,4,Fonction Trigonometriques,11,615,11,QROC,0.6,0.17,0.0,0,79,79,66,0,66,1.2,0.0,Facile,Difficile,-2,Beaucoup plus Difficile,Pas Adapte,Mathematics
3947,2018,Mathématiques,2,Le Calcul d'Integral,4,Fonction Trigonometriques,11,615,11,QROC,0.34,0.37,54.0,47,40,87,48,47,1,1.81,97.92,Facile,Moyen,-1,Plus Difficile,Pas Adapte,Mathematics
5058,2019,Mathématiques,2,Le Calcul d'Integral,4,Fonction Trigonometriques,11,615,11,QO,0.78,0.05,22.0,19,69,88,66,19,47,1.33,28.79,Facile,Difficile,-2,Beaucoup plus Difficile,Pas Adapte,Mathematics
6169,2020,Mathématiques,2,Le Calcul d'Integral,4,Fonction Trigonometriques,11,615,11,QO,0.49,0.24,43.0,43,56,99,60,43,17,1.65,71.67,Facile,Moyen,-1,Plus Difficile,Pas Adapte,Mathematics
615,2015,Mathématiques,2,Le Calcul d'Integral,5,Integrales Abeliennes,9,616,1,QCU,0.55,0.21,6.0,0,8,8,4,0,4,2.0,0.0,Difficile,Difficile,0,Meme Difficulté,Pas Adapte,Mathematics
1726,2016,Mathématiques,2,Le Calcul d'Integral,5,Integrales Abeliennes,9,616,1,QCU,0.2,0.59,48.0,3,4,7,4,3,1,1.75,75.0,Difficile,Moyen,1,Plus Facile,Pas Adapte,Mathematics
2837,2017,Mathématiques,2,Le Calcul d'Integral,5,Integrales Abeliennes,9,616,1,QCU,0.37,0.67,43.0,3,4,7,5,3,2,1.4,60.0,Difficile,Moyen,1,Plus Facile,Pas Adapte,Mathematics
3948,2018,Mathématiques,2,Le Calcul d'Integral,5,Integrales Abeliennes,9,616,1,QCU,0.44,0.31,14.0,1,6,7,4,1,3,1.75,25.0,Facile,Difficile,-2,Beaucoup plus Difficile,Pas Adapte,Mathematics
5059,2019,Mathématiques,2,Le Calcul d'Integral,5,Integrales Abeliennes,9,616,1,QCU,0.6,0.26,6.0,0,7,7,6,0,6,1.17,0.0,Moyen,Difficile,-1,Plus Difficile,Pas Adapte,Mathematics
6170,2020,Mathématiques,2,Le Calcul d'Integral,5,Integrales Abeliennes,9,616,1,QCU,0.48,0.23,31.0,2,6,8,4,2,2,2.0,50.0,Difficile,Difficile,0,Meme Difficulté,Pas Adapte,Mathematics
616,2015,Mathématiques,2,Le Calcul d'Integral,5,Integrales Abeliennes,9,617,2,QCM,0.72,0.2,16.0,14,74,88,37,14,23,2.38,37.84,Difficile,Difficile,0,Meme Difficulté,Pas Adapte,Mathematics
1727,2016,Mathématiques,2,Le Calcul d'Integral,5,Integrales Abeliennes,9,617,2,QCM,0.75,0.3,4.0,3,76,79,20,3,17,3.95,15.0,Facile,Difficile,-2,Beaucoup plus Difficile,Pas Adapte,Mathematics
2838,2017,Mathématiques,2,Le Calcul d'Integral,5,Integrales Abeliennes,9,617,2,QCM,0.35,0.63,38.0,27,44,71,54,27,27,1.31,50.0,Facile,Moyen,-1,Plus Difficile,Pas Adapte,Mathematics
3949,2018,Mathématiques,2,Le Calcul d'Integral,5,Integrales Abeliennes,9,617,2,QCM,0.78,0.16,14.0,10,61,71,40,10,30,1.77,25.0,Difficile,Difficile,0,Meme Difficulté,Pas Adapte,Mathematics
5060,2019,Mathématiques,2,Le Calcul d'Integral,5,Integrales Abeliennes,9,617,2,QCU,0.52,0.35,22.0,15,52,67,43,15,28,1.56,34.88,Moyen,Difficile,-1,Plus Difficile,Pas Adapte,Mathematics
6171,2020,Mathématiques,2,Le Calcul d'Integral,5,Integrales Abeliennes,9,617,2,QCU,0.3,0.5,60.0,37,25,62,38,37,1,1.63,97.37,Moyen,Moyen,0,Meme Difficulté,Adapte,Mathematics
617,2015,Mathématiques,2,Le Calcul d'Integral,5,Integrales Abeliennes,9,618,3,QCM,0.78,0.23,31.0,16,34,50,22,16,6,2.27,72.73,Facile,Difficile,-2,Beaucoup plus Difficile,Pas Adapte,Mathematics
1728,2016,Mathématiques,2,Le Calcul d'Integral,5,Integrales Abeliennes,9,618,3,QCU,0.68,0.36,31.0,14,32,46,19,14,5,2.42,73.68,Moyen,Difficile,-1,Plus Difficile,Pas Adapte,Mathematics
2839,2017,Mathématiques,2,Le Calcul d'Integral,5,Integrales Abeliennes,9,618,3,QCU,0.5,0.28,34.0,13,26,39,28,13,15,1.39,46.43,Moyen,Difficile,-1,Plus Difficile,Pas Adapte,Mathematics
3950,2018,Mathématiques,2,Le Calcul d'Integral,5,Integrales Abeliennes,9,618,3,QCU,0.56,0.33,2.0,1,42,43,40,1,39,1.07,2.5,Difficile,Difficile,0,Meme Difficulté,Pas Adapte,Mathematics
5061,2019,Mathématiques,2,Le Calcul d'Integral,5,Integrales Abeliennes,9,618,3,QCU,0.28,0.73,48.0,18,20,38,30,18,12,1.27,60.0,Facile,Moyen,-1,Plus Difficile,Pas Adapte,Mathematics
6172,2020,Mathématiques,2,Le Calcul d'Integral,5,Integrales Abeliennes,9,618,3,QCU,0.49,0.26,6.0,2,38,40,27,2,25,1.48,7.41,Facile,Difficile,-2,Beaucoup plus Difficile,Pas Adapte,Mathematics
618,2015,Mathématiques,2,Le Calcul d'Integral,5,Integrales Abeliennes,9,619,4,QROC,0.6,0.1,30.0,14,32,46,34,14,20,1.35,41.18,Difficile,Difficile,0,Meme Difficulté,Pas Adapte,Mathematics
1729,2016,Mathématiques,2,Le Calcul d'Integral,5,Integrales Abeliennes,9,619,4,QROC,0.51,0.38,48.0,19,20,39,23,19,4,1.7,82.61,Moyen,Moyen,0,Meme Difficulté,Pas Adapte,Mathematics
2840,2017,Mathématiques,2,Le Calcul d'Integral,5,Integrales Abeliennes,9,619,4,QROC,0.97,0.02,32.0,14,31,45,44,14,30,1.02,31.82,Difficile,Difficile,0,Meme Difficulté,Pas Adapte,Mathematics
3951,2018,Mathématiques,2,Le Calcul d'Integral,5,Integrales Abeliennes,9,619,4,QCM,0.26,0.69,50.0,24,24,48,34,24,10,1.41,70.59,Moyen,Moyen,0,Meme Difficulté,Pas Adapte,Mathematics
5062,2019,Mathématiques,2,Le Calcul d'Integral,5,Integrales Abeliennes,9,619,4,QCU,0.65,0.38,31.0,13,29,42,41,13,28,1.02,31.71,Moyen,Difficile,-1,Plus Difficile,Pas Adapte,Mathematics
6173,2020,Mathématiques,2,Le Calcul d'Integral,5,Integrales Abeliennes,9,619,4,QCU,0.38,0.52,60.0,22,15,37,33,22,11,1.12,66.67,Moyen,Moyen,0,Meme Difficulté,Adapte,Mathematics
619,2015,Mathématiques,2,Le Calcul d'Integral,5,Integrales Abeliennes,9,620,5,QO,0.22,0.22,58.0,4,3,7,5,4,1,1.4,80.0,Facile,Moyen,-1,Plus Difficile,Pas Adapte,Mathematics
1730,2016,Mathématiques,2,Le Calcul d'Integral,5,Integrales Abeliennes,9,620,5,QCM,0.65,0.29,7.0,0,6,6,4,0,4,1.5,0.0,Difficile,Difficile,0,Meme Difficulté,Pas Adapte,Mathematics
2841,2017,Mathématiques,2,Le Calcul d'Integral,5,Integrales Abeliennes,9,620,5,QCM,0.52,0.2,21.0,1,5,6,6,1,5,1.0,16.67,Facile,Difficile,-2,Beaucoup plus Difficile,Pas Adapte,Mathematics
3952,2018,Mathématiques,2,Le Calcul d'Integral,5,Integrales Abeliennes,9,620,5,QCM,0.5,0.59,46.0,2,3,5,5,2,3,1.0,40.0,Moyen,Moyen,0,Meme Difficulté,Pas Adapte,Mathematics
5063,2019,Mathématiques,2,Le Calcul d'Integral,5,Integrales Abeliennes,9,620,5,QCM,0.67,0.29,18.0,1,3,4,3,1,2,1.33,33.33,Facile,Difficile,-2,Beaucoup plus Difficile,Pas Adapte,Mathematics
6174,2020,Mathématiques,2,Le Calcul d'Integral,5,Integrales Abeliennes,9,620,5,QO,0.94,0.15,33.0,1,2,3,3,1,2,1.0,33.33,Facile,Difficile,-2,Beaucoup plus Difficile,Pas Adapte,Mathematics
620,2015,Mathématiques,2,Le Calcul d'Integral,5,Integrales Abeliennes,9,621,6,QCU,0.5,0.24,12.0,2,17,19,17,2,15,1.12,11.76,Difficile,Difficile,0,Meme Difficulté,Pas Adapte,Mathematics
1731,2016,Mathématiques,2,Le Calcul d'Integral,5,Integrales Abeliennes,9,621,6,QCU,0.62,0.24,21.0,4,13,17,15,4,11,1.13,26.67,Difficile,Difficile,0,Meme Difficulté,Pas Adapte,Mathematics
2842,2017,Mathématiques,2,Le Calcul d'Integral,5,Integrales Abeliennes,9,621,6,QCU,0.58,0.37,35.0,6,11,17,14,6,8,1.21,42.86,Facile,Difficile,-2,Beaucoup plus Difficile,Pas Adapte,Mathematics
3953,2018,Mathématiques,2,Le Calcul d'Integral,5,Integrales Abeliennes,9,621,6,QCM,0.31,0.6,62.0,9,5,14,11,9,2,1.27,81.82,Facile,Moyen,-1,Plus Difficile,Adapte,Mathematics
5064,2019,Mathématiques,2,Le Calcul d'Integral,5,Integrales Abeliennes,9,621,6,QCM,0.44,0.69,62.0,9,5,14,10,9,1,1.4,90.0,Moyen,Moyen,0,Meme Difficulté,Adapte,Mathematics
6175,2020,Mathématiques,2,Le Calcul d'Integral,5,Integrales Abeliennes,9,621,6,QCM,0.25,0.49,62.0,8,5,13,13,8,5,1.0,61.54,Moyen,Moyen,0,Meme Difficulté,Adapte,Mathematics
621,2015,Mathématiques,2,Le Calcul d'Integral,5,Integrales Abeliennes,9,622,7,QCM,0.28,0.6,54.0,4,3,7,5,4,1,1.4,80.0,Facile,Moyen,-1,Plus Difficile,Pas Adapte,Mathematics
1732,2016,Mathématiques,2,Le Calcul d'Integral,5,Integrales Abeliennes,9,622,7,QCM,0.72,0.22,28.0,2,6,8,5,2,3,1.6,40.0,Moyen,Difficile,-1,Plus Difficile,Pas Adapte,Mathematics
2843,2017,Mathématiques,2,Le Calcul d'Integral,5,Integrales Abeliennes,9,622,7,QCM,0.58,0.2,14.0,1,8,9,5,1,4,1.8,20.0,Moyen,Difficile,-1,Plus Difficile,Pas Adapte,Mathematics
3954,2018,Mathématiques,2,Le Calcul d'Integral,5,Integrales Abeliennes,9,622,7,QCM,0.65,0.19,3.0,0,10,10,5,0,5,2.0,0.0,Moyen,Difficile,-1,Plus Difficile,Pas Adapte,Mathematics
5065,2019,Mathématiques,2,Le Calcul d'Integral,5,Integrales Abeliennes,9,622,7,QCM,0.43,0.66,60.0,5,4,9,5,5,0,1.8,100.0,Difficile,Moyen,1,Plus Facile,Adapte,Mathematics
6176,2020,Mathématiques,2,Le Calcul d'Integral,5,Integrales Abeliennes,9,622,7,QCM,0.28,0.47,60.0,6,4,10,10,6,4,1.0,60.0,Moyen,Moyen,0,Meme Difficulté,Adapte,Mathematics
622,2015,Mathématiques,2,Le Calcul d'Integral,5,Integrales Abeliennes,9,623,8,QCM,0.5,0.2,21.0,10,36,46,13,10,3,3.54,76.92,Moyen,Difficile,-1,Plus Difficile,Pas Adapte,Mathematics
1733,2016,Mathématiques,2,Le Calcul d'Integral,5,Integrales Abeliennes,9,623,8,QCM,0.74,0.24,7.0,3,41,44,25,3,22,1.76,12.0,Difficile,Difficile,0,Meme Difficulté,Pas Adapte,Mathematics
2844,2017,Mathématiques,2,Le Calcul d'Integral,5,Integrales Abeliennes,9,623,8,QCM,0.46,0.33,38.0,19,31,50,33,19,14,1.52,57.58,Facile,Moyen,-1,Plus Difficile,Pas Adapte,Mathematics
3955,2018,Mathématiques,2,Le Calcul d'Integral,5,Integrales Abeliennes,9,623,8,QCM,0.46,0.49,44.0,19,25,44,35,19,16,1.26,54.29,Difficile,Moyen,1,Plus Facile,Pas Adapte,Mathematics
5066,2019,Mathématiques,2,Le Calcul d'Integral,5,Integrales Abeliennes,9,623,8,QCM,0.56,0.18,11.0,4,35,39,11,4,7,3.55,36.36,Facile,Difficile,-2,Beaucoup plus Difficile,Pas Adapte,Mathematics
6177,2020,Mathématiques,2,Le Calcul d'Integral,5,Integrales Abeliennes,9,623,8,QCM,0.21,0.65,43.0,14,19,33,20,14,6,1.65,70.0,Moyen,Moyen,0,Meme Difficulté,Pas Adapte,Mathematics
623,2015,Mathématiques,2,Le Calcul d'Integral,5,Integrales Abeliennes,9,624,9,QCM,0.36,0.68,45.0,31,37,68,43,31,12,1.58,72.09,Difficile,Moyen,1,Plus Facile,Pas Adapte,Mathematics
1734,2016,Mathématiques,2,Le Calcul d'Integral,5,Integrales Abeliennes,9,624,9,QO,0.25,0.23,53.0,40,36,76,54,40,14,1.41,74.07,Difficile,Moyen,1,Plus Facile,Pas Adapte,Mathematics
2845,2017,Mathématiques,2,Le Calcul d'Integral,5,Integrales Abeliennes,9,624,9,QO,0.87,0.12,14.0,10,64,74,58,10,48,1.28,17.24,Facile,Difficile,-2,Beaucoup plus Difficile,Pas Adapte,Mathematics
3956,2018,Mathématiques,2,Le Calcul d'Integral,5,Integrales Abeliennes,9,624,9,QO,0.84,0.1,17.0,13,63,76,41,13,28,1.85,31.71,Difficile,Difficile,0,Meme Difficulté,Pas Adapte,Mathematics
5067,2019,Mathématiques,2,Le Calcul d'Integral,5,Integrales Abeliennes,9,624,9,QO,0.27,0.22,38.0,25,41,66,55,25,30,1.2,45.45,Moyen,Moyen,0,Meme Difficulté,Pas Adapte,Mathematics
6178,2020,Mathématiques,2,Le Calcul d'Integral,5,Integrales Abeliennes,9,624,9,QROC,0.92,0.17,17.0,13,63,76,66,13,53,1.15,19.7,Facile,Difficile,-2,Beaucoup plus Difficile,Pas Adapte,Mathematics
624,2015,Mathématiques,2,Le Calcul d'Integral,6,Quelques Exemples en Maple,6,625,1,QCU,0.36,0.71,39.0,9,14,23,15,9,6,1.53,60.0,Facile,Moyen,-1,Plus Difficile,Pas Adapte,Mathematics
1735,2016,Mathématiques,2,Le Calcul d'Integral,6,Quelques Exemples en Maple,6,625,1,QCU,0.6,0.24,28.0,6,17,23,22,6,16,1.05,27.27,Facile,Difficile,-2,Beaucoup plus Difficile,Pas Adapte,Mathematics
2846,2017,Mathématiques,2,Le Calcul d'Integral,6,Quelques Exemples en Maple,6,625,1,QCU,0.66,0.23,24.0,5,15,20,17,5,12,1.18,29.41,Moyen,Difficile,-1,Plus Difficile,Pas Adapte,Mathematics
3957,2018,Mathématiques,2,Le Calcul d'Integral,6,Quelques Exemples en Maple,6,625,1,QCU,0.5,0.2,23.0,4,15,19,12,4,8,1.58,33.33,Difficile,Difficile,0,Meme Difficulté,Pas Adapte,Mathematics
5068,2019,Mathématiques,2,Le Calcul d'Integral,6,Quelques Exemples en Maple,6,625,1,QCU,0.47,0.29,30.0,6,14,20,14,6,8,1.43,42.86,Difficile,Difficile,0,Meme Difficulté,Pas Adapte,Mathematics
6179,2020,Mathématiques,2,Le Calcul d'Integral,6,Quelques Exemples en Maple,6,625,1,QCU,0.74,0.27,28.0,5,13,18,16,5,11,1.12,31.25,Difficile,Difficile,0,Meme Difficulté,Pas Adapte,Mathematics
625,2015,Mathématiques,2,Le Calcul d'Integral,6,Quelques Exemples en Maple,6,626,2,QCM,0.39,0.48,42.0,30,42,72,51,30,21,1.41,58.82,Difficile,Moyen,1,Plus Facile,Pas Adapte,Mathematics
1736,2016,Mathématiques,2,Le Calcul d'Integral,6,Quelques Exemples en Maple,6,626,2,QCM,0.29,0.37,40.0,25,37,62,54,25,29,1.15,46.3,Moyen,Moyen,0,Meme Difficulté,Pas Adapte,Mathematics
2847,2017,Mathématiques,2,Le Calcul d'Integral,6,Quelques Exemples en Maple,6,626,2,QROC,0.34,0.27,48.0,31,34,65,58,31,27,1.12,53.45,Moyen,Moyen,0,Meme Difficulté,Pas Adapte,Mathematics
3958,2018,Mathématiques,2,Le Calcul d'Integral,6,Quelques Exemples en Maple,6,626,2,QROC,0.34,0.32,58.0,41,29,70,58,41,17,1.21,70.69,Moyen,Moyen,0,Meme Difficulté,Pas Adapte,Mathematics
5069,2019,Mathématiques,2,Le Calcul d'Integral,6,Quelques Exemples en Maple,6,626,2,QO,0.85,0.1,15.0,9,54,63,32,9,23,1.97,28.12,Moyen,Difficile,-1,Plus Difficile,Pas Adapte,Mathematics
6180,2020,Mathématiques,2,Le Calcul d'Integral,6,Quelques Exemples en Maple,6,626,2,QO,0.9,0.04,25.0,18,53,71,43,18,25,1.65,41.86,Facile,Difficile,-2,Beaucoup plus Difficile,Pas Adapte,Mathematics
626,2015,Mathématiques,2,Le Calcul d'Integral,6,Quelques Exemples en Maple,6,627,3,QCM,0.7,0.27,33.0,24,50,74,46,24,22,1.61,52.17,Facile,Difficile,-2,Beaucoup plus Difficile,Pas Adapte,Mathematics
1737,2016,Mathématiques,2,Le Calcul d'Integral,6,Quelques Exemples en Maple,6,627,3,QCM,0.67,0.27,31.0,22,49,71,59,22,37,1.2,37.29,Facile,Difficile,-2,Beaucoup plus Difficile,Pas Adapte,Mathematics
2848,2017,Mathématiques,2,Le Calcul d'Integral,6,Quelques Exemples en Maple,6,627,3,QCM,0.74,0.24,27.0,17,46,63,32,17,15,1.97,53.12,Moyen,Difficile,-1,Plus Difficile,Pas Adapte,Mathematics
3959,2018,Mathématiques,2,Le Calcul d'Integral,6,Quelques Exemples en Maple,6,627,3,QROC,0.54,0.26,57.0,40,31,71,58,40,18,1.22,68.97,Moyen,Moyen,0,Meme Difficulté,Pas Adapte,Mathematics
5070,2019,Mathématiques,2,Le Calcul d'Integral,6,Quelques Exemples en Maple,6,627,3,QROC,0.82,0.08,32.0,25,53,78,68,25,43,1.15,36.76,Moyen,Difficile,-1,Plus Difficile,Pas Adapte,Mathematics
6181,2020,Mathématiques,2,Le Calcul d'Integral,6,Quelques Exemples en Maple,6,627,3,QROC,0.35,0.36,36.0,26,45,71,57,26,31,1.25,45.61,Difficile,Moyen,1,Plus Facile,Pas Adapte,Mathematics
627,2015,Mathématiques,2,Le Calcul d'Integral,6,Quelques Exemples en Maple,6,628,4,QO,0.95,0.07,3.0,1,28,29,22,1,21,1.32,4.55,Moyen,Difficile,-1,Plus Difficile,Pas Adapte,Mathematics
1738,2016,Mathématiques,2,Le Calcul d'Integral,6,Quelques Exemples en Maple,6,628,4,QO,0.61,0.25,58.0,17,13,30,26,17,9,1.15,65.38,Moyen,Moyen,0,Meme Difficulté,Pas Adapte,Mathematics
2849,2017,Mathématiques,2,Le Calcul d'Integral,6,Quelques Exemples en Maple,6,628,4,QO,0.23,0.28,48.0,13,14,27,26,13,13,1.04,50.0,Moyen,Moyen,0,Meme Difficulté,Pas Adapte,Mathematics
3960,2018,Mathématiques,2,Le Calcul d'Integral,6,Quelques Exemples en Maple,6,628,4,QO,0.42,0.24,43.0,13,18,31,24,13,11,1.29,54.17,Difficile,Moyen,1,Plus Facile,Pas Adapte,Mathematics
5071,2019,Mathématiques,2,Le Calcul d'Integral,6,Quelques Exemples en Maple,6,628,4,QO,0.93,0.01,19.0,5,22,27,25,5,20,1.08,20.0,Difficile,Difficile,0,Meme Difficulté,Pas Adapte,Mathematics
6182,2020,Mathématiques,2,Le Calcul d'Integral,6,Quelques Exemples en Maple,6,628,4,QROC,0.62,0.1,27.0,8,21,29,22,8,14,1.32,36.36,Moyen,Difficile,-1,Plus Difficile,Pas Adapte,Mathematics
628,2015,Mathématiques,2,Le Calcul d'Integral,6,Quelques Exemples en Maple,6,629,5,QCM,0.65,0.2,8.0,0,6,6,6,0,6,1.0,0.0,Facile,Difficile,-2,Beaucoup plus Difficile,Pas Adapte,Mathematics
1739,2016,Mathématiques,2,Le Calcul d'Integral,6,Quelques Exemples en Maple,6,629,5,QCM,0.78,0.17,33.0,2,3,5,3,2,1,1.67,66.67,Facile,Difficile,-2,Beaucoup plus Difficile,Pas Adapte,Mathematics
2850,2017,Mathématiques,2,Le Calcul d'Integral,6,Quelques Exemples en Maple,6,629,5,QCM,0.64,0.25,34.0,2,3,5,4,2,2,1.25,50.0,Difficile,Difficile,0,Meme Difficulté,Pas Adapte,Mathematics
3961,2018,Mathématiques,2,Le Calcul d'Integral,6,Quelques Exemples en Maple,6,629,5,QCM,0.61,0.22,17.0,1,5,6,6,1,5,1.0,16.67,Facile,Difficile,-2,Beaucoup plus Difficile,Pas Adapte,Mathematics
5072,2019,Mathématiques,2,Le Calcul d'Integral,6,Quelques Exemples en Maple,6,629,5,QCM,0.21,0.53,43.0,3,4,7,7,3,4,1.0,42.86,Facile,Moyen,-1,Plus Difficile,Pas Adapte,Mathematics
6183,2020,Mathématiques,2,Le Calcul d'Integral,6,Quelques Exemples en Maple,6,629,5,QCM,0.6,0.27,25.0,2,4,6,5,2,3,1.2,40.0,Moyen,Difficile,-1,Plus Difficile,Pas Adapte,Mathematics
629,2015,Mathématiques,2,Le Calcul d'Integral,6,Quelques Exemples en Maple,6,630,6,QCM,0.22,0.64,57.0,23,17,40,38,23,15,1.05,60.53,Difficile,Moyen,1,Plus Facile,Pas Adapte,Mathematics
1740,2016,Mathématiques,2,Le Calcul d'Integral,6,Quelques Exemples en Maple,6,630,6,QCM,0.7,0.26,30.0,11,27,38,17,11,6,2.24,64.71,Difficile,Difficile,0,Meme Difficulté,Pas Adapte,Mathematics
2851,2017,Mathématiques,2,Le Calcul d'Integral,6,Quelques Exemples en Maple,6,630,6,QCM,0.76,0.25,18.0,7,34,41,31,7,24,1.32,22.58,Difficile,Difficile,0,Meme Difficulté,Pas Adapte,Mathematics
3962,2018,Mathématiques,2,Le Calcul d'Integral,6,Quelques Exemples en Maple,6,630,6,QCM,0.68,0.24,30.0,12,27,39,31,12,19,1.26,38.71,Facile,Difficile,-2,Beaucoup plus Difficile,Pas Adapte,Mathematics
5073,2019,Mathématiques,2,Le Calcul d'Integral,6,Quelques Exemples en Maple,6,630,6,QROC,0.27,0.31,48.0,19,20,39,20,19,1,1.95,95.0,Difficile,Moyen,1,Plus Facile,Pas Adapte,Mathematics
6184,2020,Mathématiques,2,Le Calcul d'Integral,6,Quelques Exemples en Maple,6,630,6,QCM,0.66,0.22,26.0,10,27,37,27,10,17,1.37,37.04,Facile,Difficile,-2,Beaucoup plus Difficile,Pas Adapte,Mathematics
630,2015,Mathématiques,3,La Derivation,1,Derivee en un Point,7,631,1,QCM,0.42,0.41,58.0,28,21,49,36,28,8,1.36,77.78,Difficile,Moyen,1,Plus Facile,Pas Adapte,Mathematics
1741,2016,Mathématiques,3,La Derivation,1,Derivee en un Point,7,631,1,QO,0.95,0.13,17.0,9,42,51,43,9,34,1.19,20.93,Difficile,Difficile,0,Meme Difficulté,Pas Adapte,Mathematics
2852,2017,Mathématiques,3,La Derivation,1,Derivee en un Point,7,631,1,QROC,0.81,0.05,14.0,8,49,57,47,8,39,1.21,17.02,Difficile,Difficile,0,Meme Difficulté,Pas Adapte,Mathematics
3963,2018,Mathématiques,3,La Derivation,1,Derivee en un Point,7,631,1,QROC,0.27,0.37,47.0,25,29,54,49,25,24,1.1,51.02,Facile,Moyen,-1,Plus Difficile,Pas Adapte,Mathematics
5074,2019,Mathématiques,3,La Derivation,1,Derivee en un Point,7,631,1,QROC,0.4,0.34,42.0,19,27,46,39,19,20,1.18,48.72,Facile,Moyen,-1,Plus Difficile,Pas Adapte,Mathematics
6185,2020,Mathématiques,3,La Derivation,1,Derivee en un Point,7,631,1,QROC,0.86,0.14,13.0,6,42,48,43,6,37,1.12,13.95,Facile,Difficile,-2,Beaucoup plus Difficile,Pas Adapte,Mathematics
631,2015,Mathématiques,3,La Derivation,1,Derivee en un Point,7,632,2,QROC,0.76,0.09,12.0,6,42,48,20,6,14,2.4,30.0,Facile,Difficile,-2,Beaucoup plus Difficile,Pas Adapte,Mathematics
1742,2016,Mathématiques,3,La Derivation,1,Derivee en un Point,7,632,2,QROC,0.43,0.28,54.0,24,21,45,39,24,15,1.15,61.54,Difficile,Moyen,1,Plus Facile,Pas Adapte,Mathematics
2853,2017,Mathématiques,3,La Derivation,1,Derivee en un Point,7,632,2,QROC,0.74,0.24,16.0,8,39,47,45,8,37,1.04,17.78,Facile,Difficile,-2,Beaucoup plus Difficile,Pas Adapte,Mathematics
3964,2018,Mathématiques,3,La Derivation,1,Derivee en un Point,7,632,2,QROC,0.27,0.32,64.0,31,17,48,43,31,12,1.12,72.09,Moyen,Moyen,0,Meme Difficulté,Adapte,Mathematics
5075,2019,Mathématiques,3,La Derivation,1,Derivee en un Point,7,632,2,QROC,0.43,0.33,64.0,31,17,48,32,31,1,1.5,96.88,Moyen,Moyen,0,Meme Difficulté,Adapte,Mathematics
6186,2020,Mathématiques,3,La Derivation,1,Derivee en un Point,7,632,2,QROC,0.27,0.34,64.0,28,16,44,39,28,11,1.13,71.79,Moyen,Moyen,0,Meme Difficulté,Adapte,Mathematics
632,2015,Mathématiques,3,La Derivation,1,Derivee en un Point,7,633,3,QROC,0.85,0.16,22.0,9,34,43,23,9,14,1.87,39.13,Facile,Difficile,-2,Beaucoup plus Difficile,Pas Adapte,Mathematics
1743,2016,Mathématiques,3,La Derivation,1,Derivee en un Point,7,633,3,QO,0.95,0.15,25.0,10,29,39,30,10,20,1.3,33.33,Difficile,Difficile,0,Meme Difficulté,Pas Adapte,Mathematics
2854,2017,Mathématiques,3,La Derivation,1,Derivee en un Point,7,633,3,QO,0.9,0.06,19.0,8,32,40,33,8,25,1.21,24.24,Moyen,Difficile,-1,Plus Difficile,Pas Adapte,Mathematics
3965,2018,Mathématiques,3,La Derivation,1,Derivee en un Point,7,633,3,QO,0.59,0.27,47.0,17,20,37,20,17,3,1.85,85.0,Difficile,Moyen,1,Plus Facile,Pas Adapte,Mathematics
5076,2019,Mathématiques,3,La Derivation,1,Derivee en un Point,7,633,3,QO,0.89,0.02,5.0,2,41,43,28,2,26,1.54,7.14,Facile,Difficile,-2,Beaucoup plus Difficile,Pas Adapte,Mathematics
6187,2020,Mathématiques,3,La Derivation,1,Derivee en un Point,7,633,3,QO,0.93,0.12,8.0,4,43,47,47,4,43,1.0,8.51,Difficile,Difficile,0,Meme Difficulté,Pas Adapte,Mathematics
633,2015,Mathématiques,3,La Derivation,1,Derivee en un Point,7,634,4,QCU,0.5,0.37,29.0,6,14,20,19,6,13,1.05,31.58,Difficile,Difficile,0,Meme Difficulté,Pas Adapte,Mathematics
1744,2016,Mathématiques,3,La Derivation,1,Derivee en un Point,7,634,4,QCM,0.79,0.21,3.0,1,17,18,13,1,12,1.38,7.69,Facile,Difficile,-2,Beaucoup plus Difficile,Pas Adapte,Mathematics
2855,2017,Mathématiques,3,La Derivation,1,Derivee en un Point,7,634,4,QCM,0.35,0.52,51.0,10,9,19,13,10,3,1.46,76.92,Difficile,Moyen,1,Plus Facile,Pas Adapte,Mathematics
3966,2018,Mathématiques,3,La Derivation,1,Derivee en un Point,7,634,4,QCM,0.65,0.28,11.0,2,16,18,14,2,12,1.29,14.29,Facile,Difficile,-2,Beaucoup plus Difficile,Pas Adapte,Mathematics
5077,2019,Mathématiques,3,La Derivation,1,Derivee en un Point,7,634,4,QCM,0.61,0.25,30.0,6,14,20,8,6,2,2.5,75.0,Facile,Difficile,-2,Beaucoup plus Difficile,Pas Adapte,Mathematics
6188,2020,Mathématiques,3,La Derivation,1,Derivee en un Point,7,634,4,QCU,0.69,0.21,2.0,0,21,21,16,0,16,1.31,0.0,Facile,Difficile,-2,Beaucoup plus Difficile,Pas Adapte,Mathematics
634,2015,Mathématiques,3,La Derivation,1,Derivee en un Point,7,635,5,QCU,0.61,0.21,14.0,11,70,81,76,11,65,1.07,14.47,Facile,Difficile,-2,Beaucoup plus Difficile,Pas Adapte,Mathematics
1745,2016,Mathématiques,3,La Derivation,1,Derivee en un Point,7,635,5,QCM,0.32,0.65,51.0,40,38,78,76,40,36,1.03,52.63,Difficile,Moyen,1,Plus Facile,Pas Adapte,Mathematics
2856,2017,Mathématiques,3,La Derivation,1,Derivee en un Point,7,635,5,QCM,0.74,0.3,31.0,20,46,66,22,20,2,3.0,90.91,Facile,Difficile,-2,Beaucoup plus Difficile,Pas Adapte,Mathematics
3967,2018,Mathématiques,3,La Derivation,1,Derivee en un Point,7,635,5,QO,0.54,0.21,51.0,36,34,70,52,36,16,1.35,69.23,Facile,Moyen,-1,Plus Difficile,Pas Adapte,Mathematics
5078,2019,Mathématiques,3,La Derivation,1,Derivee en un Point,7,635,5,QO,0.91,0.08,8.0,6,74,80,44,6,38,1.82,13.64,Difficile,Difficile,0,Meme Difficulté,Pas Adapte,Mathematics
6189,2020,Mathématiques,3,La Derivation,1,Derivee en un Point,7,635,5,QO,0.6,0.17,53.0,43,38,81,76,43,33,1.07,56.58,Difficile,Moyen,1,Plus Facile,Pas Adapte,Mathematics
635,2015,Mathématiques,3,La Derivation,1,Derivee en un Point,7,636,6,QCM,0.75,0.19,9.0,8,78,86,39,8,31,2.21,20.51,Facile,Difficile,-2,Beaucoup plus Difficile,Pas Adapte,Mathematics
1746,2016,Mathématiques,3,La Derivation,1,Derivee en un Point,7,636,6,QROC,0.63,0.1,2.0,2,82,84,76,2,74,1.11,2.63,Difficile,Difficile,0,Meme Difficulté,Pas Adapte,Mathematics
2857,2017,Mathématiques,3,La Derivation,1,Derivee en un Point,7,636,6,QROC,0.92,0.14,35.0,33,62,95,76,33,43,1.25,43.42,Facile,Difficile,-2,Beaucoup plus Difficile,Pas Adapte,Mathematics
3968,2018,Mathématiques,3,La Derivation,1,Derivee en un Point,7,636,6,QROC,0.95,0.08,14.0,15,92,107,59,15,44,1.81,25.42,Moyen,Difficile,-1,Plus Difficile,Pas Adapte,Mathematics
5079,2019,Mathématiques,3,La Derivation,1,Derivee en un Point,7,636,6,QROC,0.85,0.05,14.0,16,95,111,77,16,61,1.44,20.78,Moyen,Difficile,-1,Plus Difficile,Pas Adapte,Mathematics
6190,2020,Mathématiques,3,La Derivation,1,Derivee en un Point,7,636,6,QROC,0.92,0.11,11.0,14,110,124,81,14,67,1.53,17.28,Facile,Difficile,-2,Beaucoup plus Difficile,Pas Adapte,Mathematics
636,2015,Mathématiques,3,La Derivation,1,Derivee en un Point,7,637,7,QCM,0.54,0.25,21.0,13,50,63,24,13,11,2.62,54.17,Facile,Difficile,-2,Beaucoup plus Difficile,Pas Adapte,Mathematics
1747,2016,Mathématiques,3,La Derivation,1,Derivee en un Point,7,637,7,QCU,0.65,0.25,8.0,5,55,60,52,5,47,1.15,9.62,Difficile,Difficile,0,Meme Difficulté,Pas Adapte,Mathematics
2858,2017,Mathématiques,3,La Derivation,1,Derivee en un Point,7,637,7,QCU,0.37,0.57,61.0,36,23,59,43,36,7,1.37,83.72,Facile,Moyen,-1,Plus Difficile,Adapte,Mathematics
3969,2018,Mathématiques,3,La Derivation,1,Derivee en un Point,7,637,7,QCU,0.29,0.41,61.0,31,20,51,33,31,2,1.55,93.94,Moyen,Moyen,0,Meme Difficulté,Adapte,Mathematics
5080,2019,Mathématiques,3,La Derivation,1,Derivee en un Point,7,637,7,QCU,0.39,0.46,61.0,26,17,43,37,26,11,1.16,70.27,Moyen,Moyen,0,Meme Difficulté,Adapte,Mathematics
6191,2020,Mathématiques,3,La Derivation,1,Derivee en un Point,7,637,7,QCU,0.36,0.45,61.0,30,19,49,35,30,5,1.4,85.71,Moyen,Moyen,0,Meme Difficulté,Adapte,Mathematics
637,2015,Mathématiques,3,La Derivation,2,Derivee Globale,7,638,1,QO,0.47,0.2,56.0,20,15,35,35,20,15,1.0,57.14,Facile,Moyen,-1,Plus Difficile,Pas Adapte,Mathematics
1748,2016,Mathématiques,3,La Derivation,2,Derivee Globale,7,638,1,QO,0.82,0.04,1.0,0,33,33,20,0,20,1.65,0.0,Difficile,Difficile,0,Meme Difficulté,Pas Adapte,Mathematics
2859,2017,Mathématiques,3,La Derivation,2,Derivee Globale,7,638,1,QO,0.6,0.26,48.0,14,15,29,22,14,8,1.32,63.64,Moyen,Moyen,0,Meme Difficulté,Pas Adapte,Mathematics
3970,2018,Mathématiques,3,La Derivation,2,Derivee Globale,7,638,1,QO,0.27,0.18,60.0,20,13,33,23,20,3,1.43,86.96,Difficile,Moyen,1,Plus Facile,Adapte,Mathematics
5081,2019,Mathématiques,3,La Derivation,2,Derivee Globale,7,638,1,QO,0.72,0.24,60.0,17,11,28,23,17,6,1.22,73.91,Moyen,Moyen,0,Meme Difficulté,Adapte,Mathematics
6192,2020,Mathématiques,3,La Derivation,2,Derivee Globale,7,638,1,QO,0.22,0.29,60.0,14,10,24,24,14,10,1.0,58.33,Moyen,Moyen,0,Meme Difficulté,Adapte,Mathematics
638,2015,Mathématiques,3,La Derivation,2,Derivee Globale,7,639,2,QCM,0.38,0.62,45.0,40,50,90,70,40,30,1.29,57.14,Facile,Moyen,-1,Plus Difficile,Pas Adapte,Mathematics
1749,2016,Mathématiques,3,La Derivation,2,Derivee Globale,7,639,2,QCM,0.24,0.67,49.0,47,49,96,85,47,38,1.13,55.29,Difficile,Moyen,1,Plus Facile,Pas Adapte,Mathematics
2860,2017,Mathématiques,3,La Derivation,2,Derivee Globale,7,639,2,QCM,0.74,0.26,34.0,30,58,88,54,30,24,1.63,55.56,Moyen,Difficile,-1,Plus Difficile,Pas Adapte,Mathematics
3971,2018,Mathématiques,3,La Derivation,2,Derivee Globale,7,639,2,QCM,0.24,0.4,46.0,40,48,88,42,40,2,2.1,95.24,Facile,Moyen,-1,Plus Difficile,Pas Adapte,Mathematics
5082,2019,Mathématiques,3,La Derivation,2,Derivee Globale,7,639,2,QCM,0.55,0.26,22.0,21,75,96,44,21,23,2.18,47.73,Moyen,Difficile,-1,Plus Difficile,Pas Adapte,Mathematics
6193,2020,Mathématiques,3,La Derivation,2,Derivee Globale,7,639,2,QCM,0.74,0.16,33.0,30,62,92,70,30,40,1.31,42.86,Moyen,Difficile,-1,Plus Difficile,Pas Adapte,Mathematics
639,2015,Mathématiques,3,La Derivation,2,Derivee Globale,7,640,3,QCU,0.45,0.22,9.0,4,45,49,32,4,28,1.53,12.5,Difficile,Difficile,0,Meme Difficulté,Pas Adapte,Mathematics
1750,2016,Mathématiques,3,La Derivation,2,Derivee Globale,7,640,3,QCU,0.59,0.33,28.0,13,34,47,20,13,7,2.35,65.0,Difficile,Difficile,0,Meme Difficulté,Pas Adapte,Mathematics
2861,2017,Mathématiques,3,La Derivation,2,Derivee Globale,7,640,3,QCU,0.64,0.29,14.0,6,38,44,22,6,16,2.0,27.27,Difficile,Difficile,0,Meme Difficulté,Pas Adapte,Mathematics
3972,2018,Mathématiques,3,La Derivation,2,Derivee Globale,7,640,3,QCU,0.67,0.34,19.0,8,32,40,27,8,19,1.48,29.63,Facile,Difficile,-2,Beaucoup plus Difficile,Pas Adapte,Mathematics
5083,2019,Mathématiques,3,La Derivation,2,Derivee Globale,7,640,3,QCU,0.4,0.36,25.0,9,27,36,31,9,22,1.16,29.03,Difficile,Difficile,0,Meme Difficulté,Pas Adapte,Mathematics
6194,2020,Mathématiques,3,La Derivation,2,Derivee Globale,7,640,3,QCU,0.63,0.29,16.0,6,30,36,28,6,22,1.29,21.43,Difficile,Difficile,0,Meme Difficulté,Pas Adapte,Mathematics
640,2015,Mathématiques,3,La Derivation,2,Derivee Globale,7,641,4,QCM,0.61,0.23,5.0,1,20,21,13,1,12,1.62,7.69,Moyen,Difficile,-1,Plus Difficile,Pas Adapte,Mathematics
1751,2016,Mathématiques,3,La Derivation,2,Derivee Globale,7,641,4,QCU,0.41,0.31,21.0,4,17,21,7,4,3,3.0,57.14,Difficile,Difficile,0,Meme Difficulté,Pas Adapte,Mathematics
2862,2017,Mathématiques,3,La Derivation,2,Derivee Globale,7,641,4,QCU,0.23,0.5,64.0,13,8,21,18,13,5,1.17,72.22,Facile,Moyen,-1,Plus Difficile,Adapte,Mathematics
3973,2018,Mathématiques,3,La Derivation,2,Derivee Globale,7,641,4,QCU,0.23,0.42,64.0,15,8,23,19,15,4,1.21,78.95,Moyen,Moyen,0,Meme Difficulté,Adapte,Mathematics
5084,2019,Mathématiques,3,La Derivation,2,Derivee Globale,7,641,4,QCU,0.32,0.4,64.0,13,8,21,15,13,2,1.4,86.67,Moyen,Moyen,0,Meme Difficulté,Adapte,Mathematics
6195,2020,Mathématiques,3,La Derivation,2,Derivee Globale,7,641,4,QCM,0.28,0.68,64.0,15,9,24,17,15,2,1.41,88.24,Moyen,Moyen,0,Meme Difficulté,Adapte,Mathematics
641,2015,Mathématiques,3,La Derivation,2,Derivee Globale,7,642,5,QROC,0.8,0.04,20.0,15,62,77,33,15,18,2.33,45.45,Facile,Difficile,-2,Beaucoup plus Difficile,Pas Adapte,Mathematics
1752,2016,Mathématiques,3,La Derivation,2,Derivee Globale,7,642,5,QO,0.86,0.12,1.0,1,64,65,65,1,64,1.0,1.54,Difficile,Difficile,0,Meme Difficulté,Pas Adapte,Mathematics
2863,2017,Mathématiques,3,La Derivation,2,Derivee Globale,7,642,5,QO,0.27,0.17,62.0,37,23,60,40,37,3,1.5,92.5,Facile,Moyen,-1,Plus Difficile,Adapte,Mathematics
3974,2018,Mathématiques,3,La Derivation,2,Derivee Globale,7,642,5,QO,0.24,0.29,62.0,41,25,66,52,41,11,1.27,78.85,Moyen,Moyen,0,Meme Difficulté,Adapte,Mathematics
5085,2019,Mathématiques,3,La Derivation,2,Derivee Globale,7,642,5,QROC,0.4,0.38,62.0,45,27,72,54,45,9,1.33,83.33,Moyen,Moyen,0,Meme Difficulté,Adapte,Mathematics
6196,2020,Mathématiques,3,La Derivation,2,Derivee Globale,7,642,5,QROC,0.37,0.39,62.0,48,29,77,52,48,4,1.48,92.31,Moyen,Moyen,0,Meme Difficulté,Adapte,Mathematics
642,2015,Mathématiques,3,La Derivation,2,Derivee Globale,7,643,6,QROC,0.76,0.09,2.0,1,32,33,15,1,14,2.2,6.67,Difficile,Difficile,0,Meme Difficulté,Pas Adapte,Mathematics
1753,2016,Mathématiques,3,La Derivation,2,Derivee Globale,7,643,6,QROC,0.89,0.11,34.0,11,20,31,23,11,12,1.35,47.83,Facile,Difficile,-2,Beaucoup plus Difficile,Pas Adapte,Mathematics
2864,2017,Mathématiques,3,La Derivation,2,Derivee Globale,7,643,6,QROC,0.73,0.06,34.0,10,19,29,15,10,5,1.93,66.67,Difficile,Difficile,0,Meme Difficulté,Pas Adapte,Mathematics
3975,2018,Mathématiques,3,La Derivation,2,Derivee Globale,7,643,6,QO,0.33,0.17,55.0,15,12,27,18,15,3,1.5,83.33,Facile,Moyen,-1,Plus Difficile,Pas Adapte,Mathematics
5086,2019,Mathématiques,3,La Derivation,2,Derivee Globale,7,643,6,QROC,0.49,0.35,53.0,15,14,29,15,15,0,1.93,100.0,Moyen,Moyen,0,Meme Difficulté,Pas Adapte,Mathematics
6197,2020,Mathématiques,3,La Derivation,2,Derivee Globale,7,643,6,QROC,0.66,0.12,11.0,3,28,31,14,3,11,2.21,21.43,Facile,Difficile,-2,Beaucoup plus Difficile,Pas Adapte,Mathematics
643,2015,Mathématiques,3,La Derivation,2,Derivee Globale,7,644,7,QCM,0.52,0.25,6.0,2,35,37,22,2,20,1.68,9.09,Facile,Difficile,-2,Beaucoup plus Difficile,Pas Adapte,Mathematics
1754,2016,Mathématiques,3,La Derivation,2,Derivee Globale,7,644,7,QCM,0.76,0.2,28.0,11,28,39,13,11,2,3.0,84.62,Moyen,Difficile,-1,Plus Difficile,Pas Adapte,Mathematics
2865,2017,Mathématiques,3,La Derivation,2,Derivee Globale,7,644,7,QCM,0.38,0.65,63.0,21,12,33,27,21,6,1.22,77.78,Facile,Moyen,-1,Plus Difficile,Adapte,Mathematics
3976,2018,Mathématiques,3,La Derivation,2,Derivee Globale,7,644,7,QCM,0.3,0.42,63.0,22,13,35,29,22,7,1.21,75.86,Moyen,Moyen,0,Meme Difficulté,Adapte,Mathematics
5087,2019,Mathématiques,3,La Derivation,2,Derivee Globale,7,644,7,QCM,0.43,0.31,63.0,24,14,38,37,24,13,1.03,64.86,Moyen,Moyen,0,Meme Difficulté,Adapte,Mathematics
6198,2020,Mathématiques,3,La Derivation,2,Derivee Globale,7,644,7,QCM,0.37,0.52,63.0,23,14,37,25,23,2,1.48,92.0,Moyen,Moyen,0,Meme Difficulté,Adapte,Mathematics
644,2015,Mathématiques,3,La Derivation,3,Theroeme de Rolle et des Accroissements Finis,14,645,1,QCU,0.21,0.74,53.0,21,18,39,26,21,5,1.5,80.77,Moyen,Moyen,0,Meme Difficulté,Pas Adapte,Mathematics
1755,2016,Mathématiques,3,La Derivation,3,Theroeme de Rolle et des Accroissements Finis,14,645,1,QCU,0.52,0.37,28.0,12,31,43,17,12,5,2.53,70.59,Facile,Difficile,-2,Beaucoup plus Difficile,Pas Adapte,Mathematics
2866,2017,Mathématiques,3,La Derivation,3,Theroeme de Rolle et des Accroissements Finis,14,645,1,QCU,0.2,0.72,51.0,22,22,44,37,22,15,1.19,59.46,Moyen,Moyen,0,Meme Difficulté,Pas Adapte,Mathematics
3977,2018,Mathématiques,3,La Derivation,3,Theroeme de Rolle et des Accroissements Finis,14,645,1,QCU,0.29,0.75,49.0,25,26,51,48,25,23,1.06,52.08,Difficile,Moyen,1,Plus Facile,Pas Adapte,Mathematics
5088,2019,Mathématiques,3,La Derivation,3,Theroeme de Rolle et des Accroissements Finis,14,645,1,QCU,0.34,0.58,43.0,20,27,47,27,20,7,1.74,74.07,Difficile,Moyen,1,Plus Facile,Pas Adapte,Mathematics
6199,2020,Mathématiques,3,La Derivation,3,Theroeme de Rolle et des Accroissements Finis,14,645,1,QCU,0.4,0.39,26.0,11,30,41,27,11,16,1.52,40.74,Moyen,Difficile,-1,Plus Difficile,Pas Adapte,Mathematics
645,2015,Mathématiques,3,La Derivation,3,Theroeme de Rolle et des Accroissements Finis,14,646,2,QCU,0.68,0.37,11.0,2,13,15,14,2,12,1.07,14.29,Difficile,Difficile,0,Meme Difficulté,Pas Adapte,Mathematics
1756,2016,Mathématiques,3,La Derivation,3,Theroeme de Rolle et des Accroissements Finis,14,646,2,QROC,0.83,0.04,15.0,3,14,17,12,3,9,1.42,25.0,Facile,Difficile,-2,Beaucoup plus Difficile,Pas Adapte,Mathematics
2867,2017,Mathématiques,3,La Derivation,3,Theroeme de Rolle et des Accroissements Finis,14,646,2,QROC,0.79,0.08,4.0,1,14,15,12,1,11,1.25,8.33,Moyen,Difficile,-1,Plus Difficile,Pas Adapte,Mathematics
3978,2018,Mathématiques,3,La Derivation,3,Theroeme de Rolle et des Accroissements Finis,14,646,2,QROC,0.71,0.19,22.0,4,12,16,12,4,8,1.33,33.33,Moyen,Difficile,-1,Plus Difficile,Pas Adapte,Mathematics
5089,2019,Mathématiques,3,La Derivation,3,Theroeme de Rolle et des Accroissements Finis,14,646,2,QROC,0.25,0.36,38.0,5,9,14,13,5,8,1.08,38.46,Moyen,Moyen,0,Meme Difficulté,Pas Adapte,Mathematics
6200,2020,Mathématiques,3,La Derivation,3,Theroeme de Rolle et des Accroissements Finis,14,646,2,QROC,0.5,0.38,38.0,5,9,14,10,5,5,1.4,50.0,Facile,Moyen,-1,Plus Difficile,Pas Adapte,Mathematics
646,2015,Mathématiques,3,La Derivation,3,Theroeme de Rolle et des Accroissements Finis,14,647,3,QCM,0.64,0.16,27.0,26,72,98,93,26,67,1.05,27.96,Difficile,Difficile,0,Meme Difficulté,Pas Adapte,Mathematics
1757,2016,Mathématiques,3,La Derivation,3,Theroeme de Rolle et des Accroissements Finis,14,647,3,QCM,0.77,0.21,25.0,22,68,90,54,22,32,1.67,40.74,Moyen,Difficile,-1,Plus Difficile,Pas Adapte,Mathematics
2868,2017,Mathématiques,3,La Derivation,3,Theroeme de Rolle et des Accroissements Finis,14,647,3,QCM,0.59,0.25,16.0,15,79,94,29,15,14,3.24,51.72,Facile,Difficile,-2,Beaucoup plus Difficile,Pas Adapte,Mathematics
3979,2018,Mathématiques,3,La Derivation,3,Theroeme de Rolle et des Accroissements Finis,14,647,3,QCM,0.31,0.33,55.0,58,47,105,89,58,31,1.18,65.17,Facile,Moyen,-1,Plus Difficile,Pas Adapte,Mathematics
5090,2019,Mathématiques,3,La Derivation,3,Theroeme de Rolle et des Accroissements Finis,14,647,3,QCM,0.52,0.21,12.0,11,82,93,87,11,76,1.07,12.64,Difficile,Difficile,0,Meme Difficulté,Pas Adapte,Mathematics
6201,2020,Mathématiques,3,La Derivation,3,Theroeme de Rolle et des Accroissements Finis,14,647,3,QCM,0.44,0.51,53.0,48,43,91,51,48,3,1.78,94.12,Difficile,Moyen,1,Plus Facile,Pas Adapte,Mathematics
647,2015,Mathématiques,3,La Derivation,3,Theroeme de Rolle et des Accroissements Finis,14,648,4,QCU,0.26,0.5,37.0,23,39,62,27,23,4,2.3,85.19,Moyen,Moyen,0,Meme Difficulté,Pas Adapte,Mathematics
1758,2016,Mathématiques,3,La Derivation,3,Theroeme de Rolle et des Accroissements Finis,14,648,4,QCU,0.71,0.37,35.0,24,46,70,29,24,5,2.41,82.76,Moyen,Difficile,-1,Plus Difficile,Pas Adapte,Mathematics
2869,2017,Mathématiques,3,La Derivation,3,Theroeme de Rolle et des Accroissements Finis,14,648,4,QCU,0.26,0.6,46.0,31,37,68,56,31,25,1.21,55.36,Facile,Moyen,-1,Plus Difficile,Pas Adapte,Mathematics
3980,2018,Mathématiques,3,La Derivation,3,Theroeme de Rolle et des Accroissements Finis,14,648,4,QCU,0.56,0.28,6.0,5,71,76,49,5,44,1.55,10.2,Facile,Difficile,-2,Beaucoup plus Difficile,Pas Adapte,Mathematics
5091,2019,Mathématiques,3,La Derivation,3,Theroeme de Rolle et des Accroissements Finis,14,648,4,QCU,0.62,0.24,24.0,18,59,77,44,18,26,1.75,40.91,Facile,Difficile,-2,Beaucoup plus Difficile,Pas Adapte,Mathematics
6202,2020,Mathématiques,3,La Derivation,3,Theroeme de Rolle et des Accroissements Finis,14,648,4,QO,0.82,0.09,18.0,12,55,67,61,12,49,1.1,19.67,Moyen,Difficile,-1,Plus Difficile,Pas Adapte,Mathematics
648,2015,Mathématiques,3,La Derivation,3,Theroeme de Rolle et des Accroissements Finis,14,649,5,QCU,0.43,0.32,11.0,7,55,62,34,7,27,1.82,20.59,Moyen,Difficile,-1,Plus Difficile,Pas Adapte,Mathematics
1759,2016,Mathématiques,3,La Derivation,3,Theroeme de Rolle et des Accroissements Finis,14,649,5,QCU,0.44,0.28,11.0,6,51,57,56,6,50,1.02,10.71,Difficile,Difficile,0,Meme Difficulté,Pas Adapte,Mathematics
2870,2017,Mathématiques,3,La Derivation,3,Theroeme de Rolle et des Accroissements Finis,14,649,5,QCU,0.69,0.29,27.0,13,35,48,20,13,7,2.4,65.0,Difficile,Difficile,0,Meme Difficulté,Pas Adapte,Mathematics
3981,2018,Mathématiques,3,La Derivation,3,Theroeme de Rolle et des Accroissements Finis,14,649,5,QCU,0.33,0.74,44.0,22,29,51,25,22,3,2.04,88.0,Difficile,Moyen,1,Plus Facile,Pas Adapte,Mathematics
5092,2019,Mathématiques,3,La Derivation,3,Theroeme de Rolle et des Accroissements Finis,14,649,5,QROC,0.84,0.06,35.0,16,29,45,43,16,27,1.05,37.21,Facile,Difficile,-2,Beaucoup plus Difficile,Pas Adapte,Mathematics
6203,2020,Mathématiques,3,La Derivation,3,Theroeme de Rolle et des Accroissements Finis,14,649,5,QROC,0.62,0.09,4.0,2,46,48,41,2,39,1.17,4.88,Moyen,Difficile,-1,Plus Difficile,Pas Adapte,Mathematics
649,2015,Mathématiques,3,La Derivation,3,Theroeme de Rolle et des Accroissements Finis,14,650,6,QCU,0.29,0.56,61.0,44,28,72,67,44,23,1.07,65.67,Facile,Moyen,-1,Plus Difficile,Adapte,Mathematics
1760,2016,Mathématiques,3,La Derivation,3,Theroeme de Rolle et des Accroissements Finis,14,650,6,QCU,0.32,0.45,61.0,37,24,61,55,37,18,1.11,67.27,Moyen,Moyen,0,Meme Difficulté,Adapte,Mathematics
2871,2017,Mathématiques,3,La Derivation,3,Theroeme de Rolle et des Accroissements Finis,14,650,6,QCU,0.25,0.54,61.0,41,27,68,55,41,14,1.24,74.55,Moyen,Moyen,0,Meme Difficulté,Adapte,Mathematics
3982,2018,Mathématiques,3,La Derivation,3,Theroeme de Rolle et des Accroissements Finis,14,650,6,QCU,0.37,0.56,61.0,46,29,75,51,46,5,1.47,90.2,Moyen,Moyen,0,Meme Difficulté,Adapte,Mathematics
5093,2019,Mathématiques,3,La Derivation,3,Theroeme de Rolle et des Accroissements Finis,14,650,6,QCU,0.22,0.73,61.0,47,30,77,69,47,22,1.12,68.12,Moyen,Moyen,0,Meme Difficulté,Adapte,Mathematics
6204,2020,Mathématiques,3,La Derivation,3,Theroeme de Rolle et des Accroissements Finis,14,650,6,QCU,0.35,0.6,61.0,49,32,81,75,49,26,1.08,65.33,Moyen,Moyen,0,Meme Difficulté,Adapte,Mathematics
650,2015,Mathématiques,3,La Derivation,3,Theroeme de Rolle et des Accroissements Finis,14,651,7,QCM,0.73,0.18,34.0,24,47,71,29,24,5,2.45,82.76,Facile,Difficile,-2,Beaucoup plus Difficile,Pas Adapte,Mathematics
1761,2016,Mathématiques,3,La Derivation,3,Theroeme de Rolle et des Accroissements Finis,14,651,7,QCU,0.69,0.35,4.0,3,72,75,25,3,22,3.0,12.0,Moyen,Difficile,-1,Plus Difficile,Pas Adapte,Mathematics
2872,2017,Mathématiques,3,La Derivation,3,Theroeme de Rolle et des Accroissements Finis,14,651,7,QCU,0.21,0.47,56.0,40,32,72,65,40,25,1.11,61.54,Facile,Moyen,-1,Plus Difficile,Pas Adapte,Mathematics
3983,2018,Mathématiques,3,La Derivation,3,Theroeme de Rolle et des Accroissements Finis,14,651,7,QCU,0.37,0.52,39.0,26,40,66,48,26,22,1.38,54.17,Difficile,Moyen,1,Plus Facile,Pas Adapte,Mathematics
5094,2019,Mathématiques,3,La Derivation,3,Theroeme de Rolle et des Accroissements Finis,14,651,7,QCU,0.58,0.38,23.0,16,53,69,47,16,31,1.47,34.04,Moyen,Difficile,-1,Plus Difficile,Pas Adapte,Mathematics
6205,2020,Mathématiques,3,La Derivation,3,Theroeme de Rolle et des Accroissements Finis,14,651,7,QCU,0.7,0.38,2.0,1,73,74,26,1,25,2.85,3.85,Moyen,Difficile,-1,Plus Difficile,Pas Adapte,Mathematics
651,2015,Mathématiques,3,La Derivation,3,Theroeme de Rolle et des Accroissements Finis,14,652,8,QCU,0.56,0.33,25.0,3,9,12,9,3,6,1.33,33.33,Facile,Difficile,-2,Beaucoup plus Difficile,Pas Adapte,Mathematics
1762,2016,Mathématiques,3,La Derivation,3,Theroeme de Rolle et des Accroissements Finis,14,652,8,QCU,0.66,0.2,6.0,1,12,13,13,1,12,1.0,7.69,Moyen,Difficile,-1,Plus Difficile,Pas Adapte,Mathematics
2873,2017,Mathématiques,3,La Derivation,3,Theroeme de Rolle et des Accroissements Finis,14,652,8,QCU,0.47,0.27,24.0,3,9,12,9,3,6,1.33,33.33,Facile,Difficile,-2,Beaucoup plus Difficile,Pas Adapte,Mathematics
3984,2018,Mathématiques,3,La Derivation,3,Theroeme de Rolle et des Accroissements Finis,14,652,8,QROC,0.73,0.01,16.0,2,10,12,12,2,10,1.0,16.67,Difficile,Difficile,0,Meme Difficulté,Pas Adapte,Mathematics
5095,2019,Mathématiques,3,La Derivation,3,Theroeme de Rolle et des Accroissements Finis,14,652,8,QROC,0.56,0.4,43.0,5,6,11,9,5,4,1.22,55.56,Facile,Moyen,-1,Plus Difficile,Pas Adapte,Mathematics
6206,2020,Mathématiques,3,La Derivation,3,Theroeme de Rolle et des Accroissements Finis,14,652,8,QROC,0.45,0.37,51.0,5,4,9,8,5,3,1.12,62.5,Difficile,Moyen,1,Plus Facile,Pas Adapte,Mathematics
652,2015,Mathématiques,3,La Derivation,3,Theroeme de Rolle et des Accroissements Finis,14,653,9,QCM,0.66,0.3,11.0,6,52,58,55,6,49,1.05,10.91,Moyen,Difficile,-1,Plus Difficile,Pas Adapte,Mathematics
1763,2016,Mathématiques,3,La Derivation,3,Theroeme de Rolle et des Accroissements Finis,14,653,9,QCM,0.76,0.3,28.0,19,48,67,41,19,22,1.63,46.34,Facile,Difficile,-2,Beaucoup plus Difficile,Pas Adapte,Mathematics
2874,2017,Mathématiques,3,La Derivation,3,Theroeme de Rolle et des Accroissements Finis,14,653,9,QCM,0.65,0.25,8.0,6,69,75,44,6,38,1.7,13.64,Facile,Difficile,-2,Beaucoup plus Difficile,Pas Adapte,Mathematics
3985,2018,Mathématiques,3,La Derivation,3,Theroeme de Rolle et des Accroissements Finis,14,653,9,QCM,0.47,0.43,57.0,46,35,81,51,46,5,1.59,90.2,Difficile,Moyen,1,Plus Facile,Pas Adapte,Mathematics
5096,2019,Mathématiques,3,La Derivation,3,Theroeme de Rolle et des Accroissements Finis,14,653,9,QCM,0.53,0.3,28.0,24,63,87,66,24,42,1.32,36.36,Difficile,Difficile,0,Meme Difficulté,Pas Adapte,Mathematics
6207,2020,Mathématiques,3,La Derivation,3,Theroeme de Rolle et des Accroissements Finis,14,653,9,QCM,0.65,0.25,34.0,26,51,77,45,26,19,1.71,57.78,Difficile,Difficile,0,Meme Difficulté,Pas Adapte,Mathematics
653,2015,Mathématiques,3,La Derivation,3,Theroeme de Rolle et des Accroissements Finis,14,654,10,QCU,0.72,0.29,24.0,4,12,16,7,4,3,2.29,57.14,Facile,Difficile,-2,Beaucoup plus Difficile,Pas Adapte,Mathematics
1764,2016,Mathématiques,3,La Derivation,3,Theroeme de Rolle et des Accroissements Finis,14,654,10,QCU,0.28,0.45,45.0,8,10,18,16,8,8,1.12,50.0,Facile,Moyen,-1,Plus Difficile,Pas Adapte,Mathematics
2875,2017,Mathématiques,3,La Derivation,3,Theroeme de Rolle et des Accroissements Finis,14,654,10,QCU,0.55,0.36,32.0,6,13,19,19,6,13,1.0,31.58,Facile,Difficile,-2,Beaucoup plus Difficile,Pas Adapte,Mathematics
3986,2018,Mathématiques,3,La Derivation,3,Theroeme de Rolle et des Accroissements Finis,14,654,10,QCU,0.48,0.31,35.0,6,10,16,8,6,2,2.0,75.0,Difficile,Difficile,0,Meme Difficulté,Pas Adapte,Mathematics
5097,2019,Mathématiques,3,La Derivation,3,Theroeme de Rolle et des Accroissements Finis,14,654,10,QCM,0.61,0.29,13.0,2,13,15,8,2,6,1.88,25.0,Facile,Difficile,-2,Beaucoup plus Difficile,Pas Adapte,Mathematics
6208,2020,Mathématiques,3,La Derivation,3,Theroeme de Rolle et des Accroissements Finis,14,654,10,QCM,0.26,0.39,38.0,6,9,15,11,6,5,1.36,54.55,Moyen,Moyen,0,Meme Difficulté,Pas Adapte,Mathematics
654,2015,Mathématiques,3,La Derivation,3,Theroeme de Rolle et des Accroissements Finis,14,655,11,QCU,0.58,0.33,26.0,16,44,60,36,16,20,1.67,44.44,Facile,Difficile,-2,Beaucoup plus Difficile,Pas Adapte,Mathematics
1765,2016,Mathématiques,3,La Derivation,3,Theroeme de Rolle et des Accroissements Finis,14,655,11,QCU,0.73,0.22,7.0,4,50,54,46,4,42,1.17,8.7,Facile,Difficile,-2,Beaucoup plus Difficile,Pas Adapte,Mathematics
2876,2017,Mathématiques,3,La Derivation,3,Theroeme de Rolle et des Accroissements Finis,14,655,11,QCU,0.51,0.26,14.0,8,48,56,23,8,15,2.43,34.78,Moyen,Difficile,-1,Plus Difficile,Pas Adapte,Mathematics
3987,2018,Mathématiques,3,La Derivation,3,Theroeme de Rolle et des Accroissements Finis,14,655,11,QCU,0.67,0.37,35.0,19,35,54,26,19,7,2.08,73.08,Facile,Difficile,-2,Beaucoup plus Difficile,Pas Adapte,Mathematics
5098,2019,Mathématiques,3,La Derivation,3,Theroeme de Rolle et des Accroissements Finis,14,655,11,QCU,0.53,0.23,4.0,2,46,48,26,2,24,1.85,7.69,Difficile,Difficile,0,Meme Difficulté,Pas Adapte,Mathematics
6209,2020,Mathématiques,3,La Derivation,3,Theroeme de Rolle et des Accroissements Finis,14,655,11,QCU,0.58,0.26,15.0,7,39,46,30,7,23,1.53,23.33,Facile,Difficile,-2,Beaucoup plus Difficile,Pas Adapte,Mathematics
655,2015,Mathématiques,3,La Derivation,3,Theroeme de Rolle et des Accroissements Finis,14,656,12,QCU,0.21,0.67,43.0,39,51,90,86,39,47,1.05,45.35,Moyen,Moyen,0,Meme Difficulté,Pas Adapte,Mathematics
1766,2016,Mathématiques,3,La Derivation,3,Theroeme de Rolle et des Accroissements Finis,14,656,12,QCU,0.42,0.33,34.0,26,51,77,27,26,1,2.85,96.3,Moyen,Difficile,-1,Plus Difficile,Pas Adapte,Mathematics
2877,2017,Mathématiques,3,La Derivation,3,Theroeme de Rolle et des Accroissements Finis,14,656,12,QCU,0.42,0.39,12.0,10,74,84,34,10,24,2.47,29.41,Facile,Difficile,-2,Beaucoup plus Difficile,Pas Adapte,Mathematics
3988,2018,Mathématiques,3,La Derivation,3,Theroeme de Rolle et des Accroissements Finis,14,656,12,QCU,0.36,0.5,41.0,38,54,92,43,38,5,2.14,88.37,Difficile,Moyen,1,Plus Facile,Pas Adapte,Mathematics
5099,2019,Mathématiques,3,La Derivation,3,Theroeme de Rolle et des Accroissements Finis,14,656,12,QCU,0.44,0.3,4.0,4,96,100,73,4,69,1.37,5.48,Difficile,Difficile,0,Meme Difficulté,Pas Adapte,Mathematics
6210,2020,Mathématiques,3,La Derivation,3,Theroeme de Rolle et des Accroissements Finis,14,656,12,QCU,0.52,0.27,16.0,15,79,94,37,15,22,2.54,40.54,Difficile,Difficile,0,Meme Difficulté,Pas Adapte,Mathematics
656,2015,Mathématiques,3,La Derivation,3,Theroeme de Rolle et des Accroissements Finis,14,657,13,QROC,0.76,0.2,28.0,8,21,29,18,8,10,1.61,44.44,Facile,Difficile,-2,Beaucoup plus Difficile,Pas Adapte,Mathematics
1767,2016,Mathématiques,3,La Derivation,3,Theroeme de Rolle et des Accroissements Finis,14,657,13,QROC,0.48,0.26,56.0,18,15,33,30,18,12,1.1,60.0,Moyen,Moyen,0,Meme Difficulté,Pas Adapte,Mathematics
2878,2017,Mathématiques,3,La Derivation,3,Theroeme de Rolle et des Accroissements Finis,14,657,13,QROC,0.84,0.18,4.0,1,31,32,23,1,22,1.39,4.35,Difficile,Difficile,0,Meme Difficulté,Pas Adapte,Mathematics
3989,2018,Mathématiques,3,La Derivation,3,Theroeme de Rolle et des Accroissements Finis,14,657,13,QROC,0.69,0.22,14.0,4,23,27,21,4,17,1.29,19.05,Facile,Difficile,-2,Beaucoup plus Difficile,Pas Adapte,Mathematics
5100,2019,Mathématiques,3,La Derivation,3,Theroeme de Rolle et des Accroissements Finis,14,657,13,QROC,0.48,0.37,40.0,9,14,23,11,9,2,2.09,81.82,Moyen,Moyen,0,Meme Difficulté,Pas Adapte,Mathematics
6211,2020,Mathématiques,3,La Derivation,3,Theroeme de Rolle et des Accroissements Finis,14,657,13,QROC,0.22,0.33,59.0,14,10,24,15,14,1,1.6,93.33,Difficile,Moyen,1,Plus Facile,Pas Adapte,Mathematics
657,2015,Mathématiques,3,La Derivation,3,Theroeme de Rolle et des Accroissements Finis,14,658,14,QCM,0.59,0.16,27.0,12,34,46,43,12,31,1.07,27.91,Difficile,Difficile,0,Meme Difficulté,Pas Adapte,Mathematics
1768,2016,Mathématiques,3,La Derivation,3,Theroeme de Rolle et des Accroissements Finis,14,658,14,QCU,0.4,0.39,25.0,12,38,50,38,12,26,1.32,31.58,Facile,Difficile,-2,Beaucoup plus Difficile,Pas Adapte,Mathematics
2879,2017,Mathématiques,3,La Derivation,3,Theroeme de Rolle et des Accroissements Finis,14,658,14,QCM,0.42,0.65,38.0,17,29,46,35,17,18,1.31,48.57,Difficile,Moyen,1,Plus Facile,Pas Adapte,Mathematics
3990,2018,Mathématiques,3,La Derivation,3,Theroeme de Rolle et des Accroissements Finis,14,658,14,QCM,0.55,0.21,15.0,7,38,45,13,7,6,3.46,53.85,Facile,Difficile,-2,Beaucoup plus Difficile,Pas Adapte,Mathematics
5101,2019,Mathématiques,3,La Derivation,3,Theroeme de Rolle et des Accroissements Finis,14,658,14,QCM,0.59,0.15,5.0,2,45,47,20,2,18,2.35,10.0,Moyen,Difficile,-1,Plus Difficile,Pas Adapte,Mathematics
6212,2020,Mathématiques,3,La Derivation,3,Theroeme de Rolle et des Accroissements Finis,14,658,14,QCM,0.36,0.4,60.0,26,17,43,39,26,13,1.1,66.67,Difficile,Moyen,1,Plus Facile,Adapte,Mathematics
658,2015,Mathématiques,3,La Derivation,4,La Fonction Exponentielle Complexe,8,659,1,QROC,0.8,0.21,11.0,9,77,86,63,9,54,1.37,14.29,Moyen,Difficile,-1,Plus Difficile,Pas Adapte,Mathematics
1769,2016,Mathématiques,3,La Derivation,4,La Fonction Exponentielle Complexe,8,659,1,QROC,0.48,0.38,47.0,37,42,79,63,37,26,1.25,58.73,Moyen,Moyen,0,Meme Difficulté,Pas Adapte,Mathematics
2880,2017,Mathématiques,3,La Derivation,4,La Fonction Exponentielle Complexe,8,659,1,QROC,0.87,0.13,23.0,20,68,88,61,20,41,1.44,32.79,Facile,Difficile,-2,Beaucoup plus Difficile,Pas Adapte,Mathematics
3991,2018,Mathématiques,3,La Derivation,4,La Fonction Exponentielle Complexe,8,659,1,QROC,0.62,0.04,31.0,28,61,89,47,28,19,1.89,59.57,Moyen,Difficile,-1,Plus Difficile,Pas Adapte,Mathematics
5102,2019,Mathématiques,3,La Derivation,4,La Fonction Exponentielle Complexe,8,659,1,QROC,0.55,0.35,59.0,53,36,89,84,53,31,1.06,63.1,Facile,Moyen,-1,Plus Difficile,Pas Adapte,Mathematics
6213,2020,Mathématiques,3,La Derivation,4,La Fonction Exponentielle Complexe,8,659,1,QROC,0.26,0.34,52.0,45,41,86,60,45,15,1.43,75.0,Facile,Moyen,-1,Plus Difficile,Pas Adapte,Mathematics
659,2015,Mathématiques,3,La Derivation,4,La Fonction Exponentielle Complexe,8,660,2,QCU,0.22,0.43,59.0,19,14,33,28,19,9,1.18,67.86,Facile,Moyen,-1,Plus Difficile,Pas Adapte,Mathematics
1770,2016,Mathématiques,3,La Derivation,4,La Fonction Exponentielle Complexe,8,660,2,QCM,0.7,0.16,31.0,10,21,31,18,10,8,1.72,55.56,Difficile,Difficile,0,Meme Difficulté,Pas Adapte,Mathematics
2881,2017,Mathématiques,3,La Derivation,4,La Fonction Exponentielle Complexe,8,660,2,QCM,0.2,0.34,41.0,12,18,30,21,12,9,1.43,57.14,Difficile,Moyen,1,Plus Facile,Pas Adapte,Mathematics
3992,2018,Mathématiques,3,La Derivation,4,La Fonction Exponentielle Complexe,8,660,2,QCM,0.4,0.65,40.0,14,20,34,24,14,10,1.42,58.33,Difficile,Moyen,1,Plus Facile,Pas Adapte,Mathematics
5103,2019,Mathématiques,3,La Derivation,4,La Fonction Exponentielle Complexe,8,660,2,QCM,0.64,0.21,11.0,4,32,36,32,4,28,1.12,12.5,Facile,Difficile,-2,Beaucoup plus Difficile,Pas Adapte,Mathematics
6214,2020,Mathématiques,3,La Derivation,4,La Fonction Exponentielle Complexe,8,660,2,QCM,0.74,0.24,2.0,1,39,40,20,1,19,2.0,5.0,Difficile,Difficile,0,Meme Difficulté,Pas Adapte,Mathematics
660,2015,Mathématiques,3,La Derivation,4,La Fonction Exponentielle Complexe,8,661,3,QO,0.87,0.09,10.0,8,74,82,69,8,61,1.19,11.59,Difficile,Difficile,0,Meme Difficulté,Pas Adapte,Mathematics
1771,2016,Mathématiques,3,La Derivation,4,La Fonction Exponentielle Complexe,8,661,3,QO,0.34,0.2,37.0,30,51,81,41,30,11,1.98,73.17,Facile,Moyen,-1,Plus Difficile,Pas Adapte,Mathematics
2882,2017,Mathématiques,3,La Derivation,4,La Fonction Exponentielle Complexe,8,661,3,QROC,0.91,0.01,18.0,13,61,74,48,13,35,1.54,27.08,Moyen,Difficile,-1,Plus Difficile,Pas Adapte,Mathematics
3993,2018,Mathématiques,3,La Derivation,4,La Fonction Exponentielle Complexe,8,661,3,QROC,0.88,0.21,25.0,21,64,85,80,21,59,1.06,26.25,Difficile,Difficile,0,Meme Difficulté,Pas Adapte,Mathematics
5104,2019,Mathématiques,3,La Derivation,4,La Fonction Exponentielle Complexe,8,661,3,QROC,0.62,0.0,8.0,7,85,92,58,7,51,1.59,12.07,Difficile,Difficile,0,Meme Difficulté,Pas Adapte,Mathematics
6215,2020,Mathématiques,3,La Derivation,4,La Fonction Exponentielle Complexe,8,661,3,QROC,0.61,0.01,10.0,11,95,106,60,11,49,1.77,18.33,Facile,Difficile,-2,Beaucoup plus Difficile,Pas Adapte,Mathematics
661,2015,Mathématiques,3,La Derivation,4,La Fonction Exponentielle Complexe,8,662,4,QCU,0.29,0.53,59.0,42,29,71,43,42,1,1.65,97.67,Facile,Moyen,-1,Plus Difficile,Pas Adapte,Mathematics
1772,2016,Mathématiques,3,La Derivation,4,La Fonction Exponentielle Complexe,8,662,4,QCU,0.48,0.39,8.0,6,65,71,50,6,44,1.42,12.0,Moyen,Difficile,-1,Plus Difficile,Pas Adapte,Mathematics
2883,2017,Mathématiques,3,La Derivation,4,La Fonction Exponentielle Complexe,8,662,4,QCU,0.55,0.3,17.0,11,55,66,55,11,44,1.2,20.0,Facile,Difficile,-2,Beaucoup plus Difficile,Pas Adapte,Mathematics
3994,2018,Mathématiques,3,La Derivation,4,La Fonction Exponentielle Complexe,8,662,4,QCU,0.44,0.4,21.0,13,50,63,62,13,49,1.02,20.97,Moyen,Difficile,-1,Plus Difficile,Pas Adapte,Mathematics
5105,2019,Mathématiques,3,La Derivation,4,La Fonction Exponentielle Complexe,8,662,4,QCM,0.61,0.25,5.0,3,60,63,58,3,55,1.09,5.17,Difficile,Difficile,0,Meme Difficulté,Pas Adapte,Mathematics
6216,2020,Mathématiques,3,La Derivation,4,La Fonction Exponentielle Complexe,8,662,4,QCM,0.76,0.17,1.0,1,61,62,30,1,29,2.07,3.33,Facile,Difficile,-2,Beaucoup plus Difficile,Pas Adapte,Mathematics
662,2015,Mathématiques,3,La Derivation,4,La Fonction Exponentielle Complexe,8,663,5,QCU,0.51,0.33,30.0,24,55,79,56,24,32,1.41,42.86,Difficile,Difficile,0,Meme Difficulté,Pas Adapte,Mathematics
1773,2016,Mathématiques,3,La Derivation,4,La Fonction Exponentielle Complexe,8,663,5,QCU,0.26,0.57,37.0,25,43,68,63,25,38,1.08,39.68,Difficile,Moyen,1,Plus Facile,Pas Adapte,Mathematics
2884,2017,Mathématiques,3,La Derivation,4,La Fonction Exponentielle Complexe,8,663,5,QCU,0.7,0.3,0.0,0,60,60,21,0,21,2.86,0.0,Difficile,Difficile,0,Meme Difficulté,Pas Adapte,Mathematics
3995,2018,Mathématiques,3,La Derivation,4,La Fonction Exponentielle Complexe,8,663,5,QCU,0.44,0.3,17.0,10,50,60,27,10,17,2.22,37.04,Difficile,Difficile,0,Meme Difficulté,Pas Adapte,Mathematics
5106,2019,Mathématiques,3,La Derivation,4,La Fonction Exponentielle Complexe,8,663,5,QCU,0.49,0.28,33.0,20,41,61,36,20,16,1.69,55.56,Moyen,Difficile,-1,Plus Difficile,Pas Adapte,Mathematics
6217,2020,Mathématiques,3,La Derivation,4,La Fonction Exponentielle Complexe,8,663,5,QROC,0.89,0.22,10.0,5,47,52,52,5,47,1.0,9.62,Facile,Difficile,-2,Beaucoup plus Difficile,Pas Adapte,Mathematics
663,2015,Mathématiques,3,La Derivation,4,La Fonction Exponentielle Complexe,8,664,6,QCU,0.59,0.31,23.0,6,21,27,26,6,20,1.04,23.08,Facile,Difficile,-2,Beaucoup plus Difficile,Pas Adapte,Mathematics
1774,2016,Mathématiques,3,La Derivation,4,La Fonction Exponentielle Complexe,8,664,6,QCU,0.67,0.23,33.0,10,21,31,26,10,16,1.19,38.46,Facile,Difficile,-2,Beaucoup plus Difficile,Pas Adapte,Mathematics
2885,2017,Mathématiques,3,La Derivation,4,La Fonction Exponentielle Complexe,8,664,6,QCU,0.02,1.0,65.0,21,12,33,29,21,8,1.14,72.41,Facile,Facile,0,Meme Difficulté,Adapte,Mathematics
3996,2018,Mathématiques,3,La Derivation,4,La Fonction Exponentielle Complexe,8,664,6,QCU,0.14,0.84,65.0,21,12,33,23,21,2,1.43,91.3,Facile,Facile,0,Meme Difficulté,Adapte,Mathematics
5107,2019,Mathématiques,3,La Derivation,4,La Fonction Exponentielle Complexe,8,664,6,QCU,0.2,0.82,65.0,19,10,29,24,19,5,1.21,79.17,Facile,Facile,0,Meme Difficulté,Adapte,Mathematics
6218,2020,Mathématiques,3,La Derivation,4,La Fonction Exponentielle Complexe,8,664,6,QCU,0.15,0.75,65.0,21,12,33,32,21,11,1.03,65.62,Facile,Facile,0,Meme Difficulté,Adapte,Mathematics
664,2015,Mathématiques,3,La Derivation,4,La Fonction Exponentielle Complexe,8,665,7,QCU,0.58,0.29,8.0,1,10,11,8,1,7,1.38,12.5,Moyen,Difficile,-1,Plus Difficile,Pas Adapte,Mathematics
1775,2016,Mathématiques,3,La Derivation,4,La Fonction Exponentielle Complexe,8,665,7,QCU,0.62,0.34,14.0,2,11,13,12,2,10,1.08,16.67,Facile,Difficile,-2,Beaucoup plus Difficile,Pas Adapte,Mathematics
2886,2017,Mathématiques,3,La Derivation,4,La Fonction Exponentielle Complexe,8,665,7,QCU,0.54,0.28,19.0,3,12,15,5,3,2,3.0,60.0,Difficile,Difficile,0,Meme Difficulté,Pas Adapte,Mathematics
3997,2018,Mathématiques,3,La Derivation,4,La Fonction Exponentielle Complexe,8,665,7,QCU,0.21,0.62,44.0,6,8,14,10,6,4,1.4,60.0,Difficile,Moyen,1,Plus Facile,Pas Adapte,Mathematics
5108,2019,Mathématiques,3,La Derivation,4,La Fonction Exponentielle Complexe,8,665,7,QCU,0.72,0.22,11.0,1,12,13,5,1,4,2.6,20.0,Moyen,Difficile,-1,Plus Difficile,Pas Adapte,Mathematics
6219,2020,Mathématiques,3,La Derivation,4,La Fonction Exponentielle Complexe,8,665,7,QCM,0.78,0.28,27.0,4,10,14,8,4,4,1.75,50.0,Difficile,Difficile,0,Meme Difficulté,Pas Adapte,Mathematics
665,2015,Mathématiques,3,La Derivation,4,La Fonction Exponentielle Complexe,8,666,8,QCU,0.39,0.43,55.0,40,32,72,68,40,28,1.06,58.82,Facile,Moyen,-1,Plus Difficile,Pas Adapte,Mathematics
1776,2016,Mathématiques,3,La Derivation,4,La Fonction Exponentielle Complexe,8,666,8,QCU,0.43,0.28,1.0,1,66,67,46,1,45,1.46,2.17,Moyen,Difficile,-1,Plus Difficile,Pas Adapte,Mathematics
2887,2017,Mathématiques,3,La Derivation,4,La Fonction Exponentielle Complexe,8,666,8,QCU,0.21,0.68,60.0,37,25,62,40,37,3,1.55,92.5,Facile,Moyen,-1,Plus Difficile,Adapte,Mathematics
3998,2018,Mathématiques,3,La Derivation,4,La Fonction Exponentielle Complexe,8,666,8,QCU,0.31,0.71,60.0,35,24,59,38,35,3,1.55,92.11,Moyen,Moyen,0,Meme Difficulté,Adapte,Mathematics
5109,2019,Mathématiques,3,La Derivation,4,La Fonction Exponentielle Complexe,8,666,8,QCU,0.28,0.51,60.0,36,24,60,41,36,5,1.46,87.8,Moyen,Moyen,0,Meme Difficulté,Adapte,Mathematics
6220,2020,Mathématiques,3,La Derivation,4,La Fonction Exponentielle Complexe,8,666,8,QCU,0.23,0.64,60.0,37,25,62,51,37,14,1.22,72.55,Moyen,Moyen,0,Meme Difficulté,Adapte,Mathematics
666,2015,Mathématiques,3,La Derivation,5,Derivees d'Ordres Superieurs,1,667,1,QCM,0.29,0.43,49.0,43,45,88,58,43,15,1.52,74.14,Moyen,Moyen,0,Meme Difficulté,Pas Adapte,Mathematics
1777,2016,Mathématiques,3,La Derivation,5,Derivees d'Ordres Superieurs,1,667,1,QCU,0.26,0.47,55.0,49,40,89,84,49,35,1.06,58.33,Facile,Moyen,-1,Plus Difficile,Pas Adapte,Mathematics
2888,2017,Mathématiques,3,La Derivation,5,Derivees d'Ordres Superieurs,1,667,1,QCU,0.44,0.23,9.0,9,90,99,82,9,73,1.21,10.98,Difficile,Difficile,0,Meme Difficulté,Pas Adapte,Mathematics
3999,2018,Mathématiques,3,La Derivation,5,Derivees d'Ordres Superieurs,1,667,1,QCM,0.4,0.7,37.0,34,59,93,86,34,52,1.08,39.53,Moyen,Moyen,0,Meme Difficulté,Pas Adapte,Mathematics
5110,2019,Mathématiques,3,La Derivation,5,Derivees d'Ordres Superieurs,1,667,1,QCU,0.55,0.24,35.0,33,61,94,91,33,58,1.03,36.26,Moyen,Difficile,-1,Plus Difficile,Pas Adapte,Mathematics
6221,2020,Mathématiques,3,La Derivation,5,Derivees d'Ordres Superieurs,1,667,1,QCU,0.46,0.36,16.0,16,84,100,98,16,82,1.02,16.33,Facile,Difficile,-2,Beaucoup plus Difficile,Pas Adapte,Mathematics
667,2015,Mathématiques,3,La Derivation,6,Classe Cn par Morceaux,11,668,1,QCM,0.75,0.17,12.0,3,26,29,25,3,22,1.16,12.0,Difficile,Difficile,0,Meme Difficulté,Pas Adapte,Mathematics
1778,2016,Mathématiques,3,La Derivation,6,Classe Cn par Morceaux,11,668,1,QCM,0.65,0.16,15.0,4,25,29,18,4,14,1.61,22.22,Difficile,Difficile,0,Meme Difficulté,Pas Adapte,Mathematics
2889,2017,Mathématiques,3,La Derivation,6,Classe Cn par Morceaux,11,668,1,QCM,0.51,0.28,0.0,0,32,32,27,0,27,1.19,0.0,Difficile,Difficile,0,Meme Difficulté,Pas Adapte,Mathematics
4000,2018,Mathématiques,3,La Derivation,6,Classe Cn par Morceaux,11,668,1,QCM,0.8,0.25,22.0,7,24,31,13,7,6,2.38,53.85,Difficile,Difficile,0,Meme Difficulté,Pas Adapte,Mathematics
5111,2019,Mathématiques,3,La Derivation,6,Classe Cn par Morceaux,11,668,1,QCM,0.58,0.25,10.0,3,29,32,18,3,15,1.78,16.67,Facile,Difficile,-2,Beaucoup plus Difficile,Pas Adapte,Mathematics
6222,2020,Mathématiques,3,La Derivation,6,Classe Cn par Morceaux,11,668,1,QCM,0.75,0.2,19.0,7,30,37,13,7,6,2.85,53.85,Moyen,Difficile,-1,Plus Difficile,Pas Adapte,Mathematics
668,2015,Mathématiques,3,La Derivation,6,Classe Cn par Morceaux,11,669,2,QCM,0.36,0.5,41.0,39,55,94,72,39,33,1.31,54.17,Moyen,Moyen,0,Meme Difficulté,Pas Adapte,Mathematics
1779,2016,Mathématiques,3,La Derivation,6,Classe Cn par Morceaux,11,669,2,QCU,0.24,0.47,36.0,38,67,105,79,38,41,1.33,48.1,Moyen,Moyen,0,Meme Difficulté,Pas Adapte,Mathematics
2890,2017,Mathématiques,3,La Derivation,6,Classe Cn par Morceaux,11,669,2,QCU,0.62,0.26,12.0,13,99,112,111,13,98,1.01,11.71,Moyen,Difficile,-1,Plus Difficile,Pas Adapte,Mathematics
4001,2018,Mathématiques,3,La Derivation,6,Classe Cn par Morceaux,11,669,2,QCU,0.31,0.72,59.0,76,52,128,99,76,23,1.29,76.77,Facile,Moyen,-1,Plus Difficile,Pas Adapte,Mathematics
5112,2019,Mathématiques,3,La Derivation,6,Classe Cn par Morceaux,11,669,2,QCU,0.31,0.67,38.0,52,84,136,115,52,63,1.18,45.22,Facile,Moyen,-1,Plus Difficile,Pas Adapte,Mathematics
6223,2020,Mathématiques,3,La Derivation,6,Classe Cn par Morceaux,11,669,2,QCU,0.33,0.65,48.0,72,77,149,125,72,53,1.19,57.6,Difficile,Moyen,1,Plus Facile,Pas Adapte,Mathematics
669,2015,Mathématiques,3,La Derivation,6,Classe Cn par Morceaux,11,670,3,QCU,0.71,0.4,1.0,1,95,96,77,1,76,1.25,1.3,Facile,Difficile,-2,Beaucoup plus Difficile,Pas Adapte,Mathematics
1780,2016,Mathématiques,3,La Derivation,6,Classe Cn par Morceaux,11,670,3,QCU,0.45,0.21,9.0,9,86,95,32,9,23,2.97,28.12,Facile,Difficile,-2,Beaucoup plus Difficile,Pas Adapte,Mathematics
2891,2017,Mathématiques,3,La Derivation,6,Classe Cn par Morceaux,11,670,3,QCU,0.48,0.35,20.0,18,74,92,80,18,62,1.15,22.5,Difficile,Difficile,0,Meme Difficulté,Pas Adapte,Mathematics
4002,2018,Mathématiques,3,La Derivation,6,Classe Cn par Morceaux,11,670,3,QCU,0.42,0.37,1.0,1,96,97,39,1,38,2.49,2.56,Facile,Difficile,-2,Beaucoup plus Difficile,Pas Adapte,Mathematics
5113,2019,Mathématiques,3,La Derivation,6,Classe Cn par Morceaux,11,670,3,QCU,0.21,0.57,56.0,57,44,101,83,57,26,1.22,68.67,Difficile,Moyen,1,Plus Facile,Pas Adapte,Mathematics
6224,2020,Mathématiques,3,La Derivation,6,Classe Cn par Morceaux,11,670,3,QCM,0.63,0.22,22.0,24,87,111,74,24,50,1.5,32.43,Difficile,Difficile,0,Meme Difficulté,Pas Adapte,Mathematics
670,2015,Mathématiques,3,La Derivation,6,Classe Cn par Morceaux,11,671,4,QROC,0.52,0.35,53.0,34,31,65,57,34,23,1.14,59.65,Facile,Moyen,-1,Plus Difficile,Pas Adapte,Mathematics
1781,2016,Mathématiques,3,La Derivation,6,Classe Cn par Morceaux,11,671,4,QO,0.91,0.1,9.0,6,61,67,46,6,40,1.46,13.04,Difficile,Difficile,0,Meme Difficulté,Pas Adapte,Mathematics
2892,2017,Mathématiques,3,La Derivation,6,Classe Cn par Morceaux,11,671,4,QROC,0.38,0.26,57.0,44,33,77,61,44,17,1.26,72.13,Facile,Moyen,-1,Plus Difficile,Pas Adapte,Mathematics
4003,2018,Mathématiques,3,La Derivation,6,Classe Cn par Morceaux,11,671,4,QROC,0.65,0.05,15.0,10,55,65,26,10,16,2.5,38.46,Difficile,Difficile,0,Meme Difficulté,Pas Adapte,Mathematics
5114,2019,Mathématiques,3,La Derivation,6,Classe Cn par Morceaux,11,671,4,QROC,0.44,0.34,41.0,29,42,71,70,29,41,1.01,41.43,Facile,Moyen,-1,Plus Difficile,Pas Adapte,Mathematics
6225,2020,Mathématiques,3,La Derivation,6,Classe Cn par Morceaux,11,671,4,QROC,0.54,0.33,48.0,35,37,72,51,35,16,1.41,68.63,Moyen,Moyen,0,Meme Difficulté,Pas Adapte,Mathematics
671,2015,Mathématiques,3,La Derivation,6,Classe Cn par Morceaux,11,672,5,QCM,0.42,0.55,40.0,20,31,51,22,20,2,2.32,90.91,Facile,Moyen,-1,Plus Difficile,Pas Adapte,Mathematics
1782,2016,Mathématiques,3,La Derivation,6,Classe Cn par Morceaux,11,672,5,QCU,0.22,0.69,45.0,19,24,43,40,19,21,1.07,47.5,Moyen,Moyen,0,Meme Difficulté,Pas Adapte,Mathematics
2893,2017,Mathématiques,3,La Derivation,6,Classe Cn par Morceaux,11,672,5,QCU,0.74,0.4,35.0,16,31,47,44,16,28,1.07,36.36,Moyen,Difficile,-1,Plus Difficile,Pas Adapte,Mathematics
4004,2018,Mathématiques,3,La Derivation,6,Classe Cn par Morceaux,11,672,5,QCU,0.54,0.3,22.0,10,36,46,41,10,31,1.12,24.39,Difficile,Difficile,0,Meme Difficulté,Pas Adapte,Mathematics
5115,2019,Mathématiques,3,La Derivation,6,Classe Cn par Morceaux,11,672,5,QCU,0.28,0.73,48.0,22,24,46,44,22,22,1.05,50.0,Facile,Moyen,-1,Plus Difficile,Pas Adapte,Mathematics
6226,2020,Mathématiques,3,La Derivation,6,Classe Cn par Morceaux,11,672,5,QCU,0.37,0.59,49.0,22,22,44,36,22,14,1.22,61.11,Facile,Moyen,-1,Plus Difficile,Pas Adapte,Mathematics
672,2015,Mathématiques,3,La Derivation,6,Classe Cn par Morceaux,11,673,6,QCM,0.67,0.3,31.0,23,51,74,32,23,9,2.31,71.88,Difficile,Difficile,0,Meme Difficulté,Pas Adapte,Mathematics
1783,2016,Mathématiques,3,La Derivation,6,Classe Cn par Morceaux,11,673,6,QROC,0.77,0.22,16.0,12,61,73,50,12,38,1.46,24.0,Moyen,Difficile,-1,Plus Difficile,Pas Adapte,Mathematics
2894,2017,Mathématiques,3,La Derivation,6,Classe Cn par Morceaux,11,673,6,QROC,0.21,0.26,49.0,32,33,65,49,32,17,1.33,65.31,Facile,Moyen,-1,Plus Difficile,Pas Adapte,Mathematics
4005,2018,Mathématiques,3,La Derivation,6,Classe Cn par Morceaux,11,673,6,QROC,0.92,0.02,33.0,24,50,74,61,24,37,1.21,39.34,Difficile,Difficile,0,Meme Difficulté,Pas Adapte,Mathematics
5116,2019,Mathématiques,3,La Derivation,6,Classe Cn par Morceaux,11,673,6,QROC,0.94,0.21,7.0,5,67,72,30,5,25,2.4,16.67,Moyen,Difficile,-1,Plus Difficile,Pas Adapte,Mathematics
6227,2020,Mathématiques,3,La Derivation,6,Classe Cn par Morceaux,11,673,6,QROC,0.26,0.31,53.0,37,32,69,38,37,1,1.82,97.37,Facile,Moyen,-1,Plus Difficile,Pas Adapte,Mathematics
673,2015,Mathématiques,3,La Derivation,6,Classe Cn par Morceaux,11,674,7,QROC,0.33,0.34,38.0,13,21,34,25,13,12,1.36,52.0,Difficile,Moyen,1,Plus Facile,Pas Adapte,Mathematics
1784,2016,Mathématiques,3,La Derivation,6,Classe Cn par Morceaux,11,674,7,QROC,0.72,0.24,25.0,8,23,31,16,8,8,1.94,50.0,Difficile,Difficile,0,Meme Difficulté,Pas Adapte,Mathematics
2895,2017,Mathématiques,3,La Derivation,6,Classe Cn par Morceaux,11,674,7,QROC,0.47,0.28,40.0,12,18,30,17,12,5,1.76,70.59,Facile,Moyen,-1,Plus Difficile,Pas Adapte,Mathematics
4006,2018,Mathématiques,3,La Derivation,6,Classe Cn par Morceaux,11,674,7,QROC,0.91,0.04,22.0,7,23,30,12,7,5,2.5,58.33,Moyen,Difficile,-1,Plus Difficile,Pas Adapte,Mathematics
5117,2019,Mathématiques,3,La Derivation,6,Classe Cn par Morceaux,11,674,7,QROC,0.77,0.25,1.0,0,29,29,18,0,18,1.61,0.0,Difficile,Difficile,0,Meme Difficulté,Pas Adapte,Mathematics
6228,2020,Mathématiques,3,La Derivation,6,Classe Cn par Morceaux,11,674,7,QROC,0.7,0.07,35.0,10,19,29,20,10,10,1.45,50.0,Moyen,Difficile,-1,Plus Difficile,Pas Adapte,Mathematics
674,2015,Mathématiques,3,La Derivation,6,Classe Cn par Morceaux,11,675,8,QCU,0.31,0.46,59.0,34,23,57,48,34,14,1.19,70.83,Facile,Moyen,-1,Plus Difficile,Pas Adapte,Mathematics
1785,2016,Mathématiques,3,La Derivation,6,Classe Cn par Morceaux,11,675,8,QCU,0.27,0.67,58.0,38,28,66,53,38,15,1.25,71.7,Difficile,Moyen,1,Plus Facile,Pas Adapte,Mathematics
2896,2017,Mathématiques,3,La Derivation,6,Classe Cn par Morceaux,11,675,8,QCU,0.7,0.33,4.0,2,55,57,26,2,24,2.19,7.69,Facile,Difficile,-2,Beaucoup plus Difficile,Pas Adapte,Mathematics
4007,2018,Mathématiques,3,La Derivation,6,Classe Cn par Morceaux,11,675,8,QCU,0.66,0.28,10.0,6,52,58,23,6,17,2.52,26.09,Moyen,Difficile,-1,Plus Difficile,Pas Adapte,Mathematics
5118,2019,Mathématiques,3,La Derivation,6,Classe Cn par Morceaux,11,675,8,QCM,0.69,0.22,23.0,14,49,63,19,14,5,3.32,73.68,Difficile,Difficile,0,Meme Difficulté,Pas Adapte,Mathematics
6229,2020,Mathématiques,3,La Derivation,6,Classe Cn par Morceaux,11,675,8,QCM,0.74,0.23,26.0,18,53,71,60,18,42,1.18,30.0,Facile,Difficile,-2,Beaucoup plus Difficile,Pas Adapte,Mathematics
675,2015,Mathématiques,3,La Derivation,6,Classe Cn par Morceaux,11,676,9,QCM,0.35,0.53,54.0,40,34,74,69,40,29,1.07,57.97,Facile,Moyen,-1,Plus Difficile,Pas Adapte,Mathematics
1786,2016,Mathématiques,3,La Derivation,6,Classe Cn par Morceaux,11,676,9,QCM,0.62,0.28,9.0,6,65,71,59,6,53,1.2,10.17,Facile,Difficile,-2,Beaucoup plus Difficile,Pas Adapte,Mathematics
2897,2017,Mathématiques,3,La Derivation,6,Classe Cn par Morceaux,11,676,9,QCM,0.7,0.17,29.0,20,50,70,42,20,22,1.67,47.62,Difficile,Difficile,0,Meme Difficulté,Pas Adapte,Mathematics
4008,2018,Mathématiques,3,La Derivation,6,Classe Cn par Morceaux,11,676,9,QCM,0.59,0.22,23.0,16,54,70,58,16,42,1.21,27.59,Facile,Difficile,-2,Beaucoup plus Difficile,Pas Adapte,Mathematics
5119,2019,Mathématiques,3,La Derivation,6,Classe Cn par Morceaux,11,676,9,QCM,0.62,0.2,24.0,18,55,73,27,18,9,2.7,66.67,Moyen,Difficile,-1,Plus Difficile,Pas Adapte,Mathematics
6230,2020,Mathématiques,3,La Derivation,6,Classe Cn par Morceaux,11,676,9,QCM,0.47,0.41,47.0,34,38,72,60,34,26,1.2,56.67,Moyen,Moyen,0,Meme Difficulté,Pas Adapte,Mathematics
676,2015,Mathématiques,3,La Derivation,6,Classe Cn par Morceaux,11,677,10,QCU,0.67,0.38,13.0,13,87,100,53,13,40,1.89,24.53,Difficile,Difficile,0,Meme Difficulté,Pas Adapte,Mathematics
1787,2016,Mathématiques,3,La Derivation,6,Classe Cn par Morceaux,11,677,10,QCU,0.64,0.21,24.0,24,75,99,67,24,43,1.48,35.82,Difficile,Difficile,0,Meme Difficulté,Pas Adapte,Mathematics
2898,2017,Mathématiques,3,La Derivation,6,Classe Cn par Morceaux,11,677,10,QCU,0.57,0.2,22.0,20,71,91,80,20,60,1.14,25.0,Facile,Difficile,-2,Beaucoup plus Difficile,Pas Adapte,Mathematics
4009,2018,Mathématiques,3,La Derivation,6,Classe Cn par Morceaux,11,677,10,QCU,0.38,0.67,48.0,48,51,99,49,48,1,2.02,97.96,Facile,Moyen,-1,Plus Difficile,Pas Adapte,Mathematics
5120,2019,Mathématiques,3,La Derivation,6,Classe Cn par Morceaux,11,677,10,QCU,0.7,0.35,24.0,27,87,114,86,27,59,1.33,31.4,Facile,Difficile,-2,Beaucoup plus Difficile,Pas Adapte,Mathematics
6231,2020,Mathématiques,3,La Derivation,6,Classe Cn par Morceaux,11,677,10,QCU,0.64,0.27,5.0,6,109,115,46,6,40,2.5,13.04,Difficile,Difficile,0,Meme Difficulté,Pas Adapte,Mathematics
677,2015,Mathématiques,3,La Derivation,6,Classe Cn par Morceaux,11,678,11,QCU,0.63,0.36,14.0,3,18,21,20,3,17,1.05,15.0,Facile,Difficile,-2,Beaucoup plus Difficile,Pas Adapte,Mathematics
1788,2016,Mathématiques,3,La Derivation,6,Classe Cn par Morceaux,11,678,11,QCU,0.63,0.37,33.0,7,13,20,11,7,4,1.82,63.64,Difficile,Difficile,0,Meme Difficulté,Pas Adapte,Mathematics
2899,2017,Mathématiques,3,La Derivation,6,Classe Cn par Morceaux,11,678,11,QCU,0.65,0.35,35.0,7,14,21,18,7,11,1.17,38.89,Facile,Difficile,-2,Beaucoup plus Difficile,Pas Adapte,Mathematics
4010,2018,Mathématiques,3,La Derivation,6,Classe Cn par Morceaux,11,678,11,QCU,0.61,0.34,13.0,3,18,21,17,3,14,1.24,17.65,Difficile,Difficile,0,Meme Difficulté,Pas Adapte,Mathematics
5121,2019,Mathématiques,3,La Derivation,6,Classe Cn par Morceaux,11,678,11,QCU,0.7,0.37,23.0,6,18,24,13,6,7,1.85,46.15,Difficile,Difficile,0,Meme Difficulté,Pas Adapte,Mathematics
6232,2020,Mathématiques,3,La Derivation,6,Classe Cn par Morceaux,11,678,11,QCU,0.73,0.31,27.0,5,15,20,20,5,15,1.0,25.0,Facile,Difficile,-2,Beaucoup plus Difficile,Pas Adapte,Mathematics
678,2015,Mathématiques,3,La Derivation,7,Fonctions Reciproques,10,679,1,QO,0.31,0.3,44.0,20,26,46,43,20,23,1.07,46.51,Facile,Moyen,-1,Plus Difficile,Pas Adapte,Mathematics
1789,2016,Mathématiques,3,La Derivation,7,Fonctions Reciproques,10,679,1,QROC,0.47,0.31,48.0,24,27,51,43,24,19,1.19,55.81,Difficile,Moyen,1,Plus Facile,Pas Adapte,Mathematics
2900,2017,Mathématiques,3,La Derivation,7,Fonctions Reciproques,10,679,1,QROC,0.72,0.09,26.0,15,44,59,47,15,32,1.26,31.91,Moyen,Difficile,-1,Plus Difficile,Pas Adapte,Mathematics
4011,2018,Mathématiques,3,La Derivation,7,Fonctions Reciproques,10,679,1,QROC,0.64,0.17,30.0,20,47,67,59,20,39,1.14,33.9,Difficile,Difficile,0,Meme Difficulté,Pas Adapte,Mathematics
5122,2019,Mathématiques,3,La Derivation,7,Fonctions Reciproques,10,679,1,QROC,1.0,0.12,4.0,3,61,64,36,3,33,1.78,8.33,Difficile,Difficile,0,Meme Difficulté,Pas Adapte,Mathematics
6233,2020,Mathématiques,3,La Derivation,7,Fonctions Reciproques,10,679,1,QROC,0.26,0.3,46.0,25,29,54,46,25,21,1.17,54.35,Facile,Moyen,-1,Plus Difficile,Pas Adapte,Mathematics
679,2015,Mathématiques,3,La Derivation,7,Fonctions Reciproques,10,680,2,QCU,0.61,0.27,19.0,11,46,57,27,11,16,2.11,40.74,Facile,Difficile,-2,Beaucoup plus Difficile,Pas Adapte,Mathematics
1790,2016,Mathématiques,3,La Derivation,7,Fonctions Reciproques,10,680,2,QCU,0.53,0.26,14.0,8,46,54,52,8,44,1.04,15.38,Moyen,Difficile,-1,Plus Difficile,Pas Adapte,Mathematics
2901,2017,Mathématiques,3,La Derivation,7,Fonctions Reciproques,10,680,2,QCM,0.4,0.65,60.0,36,24,60,49,36,13,1.22,73.47,Facile,Moyen,-1,Plus Difficile,Adapte,Mathematics
4012,2018,Mathématiques,3,La Derivation,7,Fonctions Reciproques,10,680,2,QCM,0.48,0.6,60.0,32,21,53,41,32,9,1.29,78.05,Moyen,Moyen,0,Meme Difficulté,Adapte,Mathematics
5123,2019,Mathématiques,3,La Derivation,7,Fonctions Reciproques,10,680,2,QCM,0.33,0.59,60.0,28,19,47,46,28,18,1.02,60.87,Moyen,Moyen,0,Meme Difficulté,Adapte,Mathematics
6234,2020,Mathématiques,3,La Derivation,7,Fonctions Reciproques,10,680,2,QCM,0.29,0.38,60.0,27,18,45,45,27,18,1.0,60.0,Moyen,Moyen,0,Meme Difficulté,Adapte,Mathematics
680,2015,Mathématiques,3,La Derivation,7,Fonctions Reciproques,10,681,3,QROC,0.77,0.15,6.0,2,29,31,18,2,16,1.72,11.11,Difficile,Difficile,0,Meme Difficulté,Pas Adapte,Mathematics
1791,2016,Mathématiques,3,La Derivation,7,Fonctions Reciproques,10,681,3,QROC,0.26,0.26,42.0,11,15,26,16,11,5,1.62,68.75,Facile,Moyen,-1,Plus Difficile,Pas Adapte,Mathematics
2902,2017,Mathématiques,3,La Derivation,7,Fonctions Reciproques,10,681,3,QROC,0.6,0.13,24.0,5,17,22,17,5,12,1.29,29.41,Facile,Difficile,-2,Beaucoup plus Difficile,Pas Adapte,Mathematics
4013,2018,Mathématiques,3,La Derivation,7,Fonctions Reciproques,10,681,3,QROC,0.52,0.27,45.0,9,12,21,13,9,4,1.62,69.23,Facile,Moyen,-1,Plus Difficile,Pas Adapte,Mathematics
5124,2019,Mathématiques,3,La Derivation,7,Fonctions Reciproques,10,681,3,QROC,0.74,0.12,22.0,5,18,23,16,5,11,1.44,31.25,Facile,Difficile,-2,Beaucoup plus Difficile,Pas Adapte,Mathematics
6235,2020,Mathématiques,3,La Derivation,7,Fonctions Reciproques,10,681,3,QROC,0.97,0.15,28.0,6,14,20,10,6,4,2.0,60.0,Difficile,Difficile,0,Meme Difficulté,Pas Adapte,Mathematics
681,2015,Mathématiques,3,La Derivation,7,Fonctions Reciproques,10,682,4,QCU,0.56,0.37,15.0,13,75,88,74,13,61,1.19,17.57,Facile,Difficile,-2,Beaucoup plus Difficile,Pas Adapte,Mathematics
1792,2016,Mathématiques,3,La Derivation,7,Fonctions Reciproques,10,682,4,QCU,0.34,0.71,44.0,36,46,82,46,36,10,1.78,78.26,Difficile,Moyen,1,Plus Facile,Pas Adapte,Mathematics
2903,2017,Mathématiques,3,La Derivation,7,Fonctions Reciproques,10,682,4,QCU,0.62,0.3,12.0,10,72,82,78,10,68,1.05,12.82,Facile,Difficile,-2,Beaucoup plus Difficile,Pas Adapte,Mathematics
4014,2018,Mathématiques,3,La Derivation,7,Fonctions Reciproques,10,682,4,QCU,0.5,0.2,22.0,20,70,90,57,20,37,1.58,35.09,Moyen,Difficile,-1,Plus Difficile,Pas Adapte,Mathematics
5125,2019,Mathématiques,3,La Derivation,7,Fonctions Reciproques,10,682,4,QCM,0.46,0.52,49.0,41,42,83,71,41,30,1.17,57.75,Difficile,Moyen,1,Plus Facile,Pas Adapte,Mathematics
6236,2020,Mathématiques,3,La Derivation,7,Fonctions Reciproques,10,682,4,QCM,0.77,0.24,4.0,3,71,74,24,3,21,3.08,12.5,Facile,Difficile,-2,Beaucoup plus Difficile,Pas Adapte,Mathematics
682,2015,Mathématiques,3,La Derivation,7,Fonctions Reciproques,10,683,5,QCM,0.58,0.22,18.0,10,43,53,44,10,34,1.2,22.73,Facile,Difficile,-2,Beaucoup plus Difficile,Pas Adapte,Mathematics
1793,2016,Mathématiques,3,La Derivation,7,Fonctions Reciproques,10,683,5,QCM,0.71,0.18,17.0,9,46,55,38,9,29,1.45,23.68,Difficile,Difficile,0,Meme Difficulté,Pas Adapte,Mathematics
2904,2017,Mathématiques,3,La Derivation,7,Fonctions Reciproques,10,683,5,QCM,0.79,0.25,29.0,17,42,59,24,17,7,2.46,70.83,Moyen,Difficile,-1,Plus Difficile,Pas Adapte,Mathematics
4015,2018,Mathématiques,3,La Derivation,7,Fonctions Reciproques,10,683,5,QO,0.03,0.91,65.0,34,19,53,41,34,7,1.29,82.93,Difficile,Facile,2,Beaucoup plus Facile,Adapte,Mathematics
5126,2019,Mathématiques,3,La Derivation,7,Fonctions Reciproques,10,683,5,QROC,0.02,0.94,65.0,31,17,48,44,31,13,1.09,70.45,Facile,Facile,0,Meme Difficulté,Adapte,Mathematics
6237,2020,Mathématiques,3,La Derivation,7,Fonctions Reciproques,10,683,5,QROC,0.14,0.41,65.0,28,15,43,35,28,7,1.23,80.0,Facile,Facile,0,Meme Difficulté,Adapte,Mathematics
683,2015,Mathématiques,3,La Derivation,7,Fonctions Reciproques,10,684,6,QROC,0.25,0.34,38.0,6,10,16,11,6,5,1.45,54.55,Moyen,Moyen,0,Meme Difficulté,Pas Adapte,Mathematics
1794,2016,Mathématiques,3,La Derivation,7,Fonctions Reciproques,10,684,6,QROC,0.97,0.17,20.0,3,11,14,9,3,6,1.56,33.33,Facile,Difficile,-2,Beaucoup plus Difficile,Pas Adapte,Mathematics
2905,2017,Mathématiques,3,La Derivation,7,Fonctions Reciproques,10,684,6,QROC,0.82,0.23,13.0,2,14,16,9,2,7,1.78,22.22,Facile,Difficile,-2,Beaucoup plus Difficile,Pas Adapte,Mathematics
4016,2018,Mathématiques,3,La Derivation,7,Fonctions Reciproques,10,684,6,QROC,0.77,0.15,21.0,4,13,17,10,4,6,1.7,40.0,Moyen,Difficile,-1,Plus Difficile,Pas Adapte,Mathematics
5127,2019,Mathématiques,3,La Derivation,7,Fonctions Reciproques,10,684,6,QROC,0.37,0.32,54.0,9,8,17,15,9,6,1.13,60.0,Moyen,Moyen,0,Meme Difficulté,Pas Adapte,Mathematics
6238,2020,Mathématiques,3,La Derivation,7,Fonctions Reciproques,10,684,6,QROC,0.26,0.31,52.0,8,8,16,8,8,0,2.0,100.0,Difficile,Moyen,1,Plus Facile,Pas Adapte,Mathematics
684,2015,Mathématiques,3,La Derivation,7,Fonctions Reciproques,10,685,7,QCU,0.51,0.23,22.0,14,48,62,62,14,48,1.0,22.58,Facile,Difficile,-2,Beaucoup plus Difficile,Pas Adapte,Mathematics
1795,2016,Mathématiques,3,La Derivation,7,Fonctions Reciproques,10,685,7,QCM,0.63,0.26,17.0,10,46,56,27,10,17,2.07,37.04,Moyen,Difficile,-1,Plus Difficile,Pas Adapte,Mathematics
2906,2017,Mathématiques,3,La Derivation,7,Fonctions Reciproques,10,685,7,QCM,0.49,0.41,44.0,26,32,58,50,26,24,1.16,52.0,Moyen,Moyen,0,Meme Difficulté,Pas Adapte,Mathematics
4017,2018,Mathématiques,3,La Derivation,7,Fonctions Reciproques,10,685,7,QCM,0.05,0.81,65.0,34,18,52,49,34,15,1.06,69.39,Moyen,Facile,1,Plus Facile,Adapte,Mathematics
5128,2019,Mathématiques,3,La Derivation,7,Fonctions Reciproques,10,685,7,QCM,0.04,0.88,65.0,36,20,56,46,36,10,1.22,78.26,Facile,Facile,0,Meme Difficulté,Adapte,Mathematics
6239,2020,Mathématiques,3,La Derivation,7,Fonctions Reciproques,10,685,7,QCM,0.19,0.84,65.0,32,18,50,40,32,8,1.25,80.0,Facile,Facile,0,Meme Difficulté,Adapte,Mathematics
685,2015,Mathématiques,3,La Derivation,7,Fonctions Reciproques,10,686,8,QCU,0.22,0.44,40.0,10,15,25,17,10,7,1.47,58.82,Difficile,Moyen,1,Plus Facile,Pas Adapte,Mathematics
1796,2016,Mathématiques,3,La Derivation,7,Fonctions Reciproques,10,686,8,QCU,0.67,0.23,19.0,5,22,27,24,5,19,1.12,20.83,Facile,Difficile,-2,Beaucoup plus Difficile,Pas Adapte,Mathematics
2907,2017,Mathématiques,3,La Derivation,7,Fonctions Reciproques,10,686,8,QCU,0.36,0.55,46.0,14,16,30,23,14,9,1.3,60.87,Facile,Moyen,-1,Plus Difficile,Pas Adapte,Mathematics
4018,2018,Mathématiques,3,La Derivation,7,Fonctions Reciproques,10,686,8,QCU,0.57,0.32,15.0,4,25,29,24,4,20,1.21,16.67,Difficile,Difficile,0,Meme Difficulté,Pas Adapte,Mathematics
5129,2019,Mathématiques,3,La Derivation,7,Fonctions Reciproques,10,686,8,QCU,0.34,0.49,54.0,17,15,32,31,17,14,1.03,54.84,Difficile,Moyen,1,Plus Facile,Pas Adapte,Mathematics
6240,2020,Mathématiques,3,La Derivation,7,Fonctions Reciproques,10,686,8,QCM,0.66,0.26,33.0,11,23,34,18,11,7,1.89,61.11,Facile,Difficile,-2,Beaucoup plus Difficile,Pas Adapte,Mathematics
686,2015,Mathématiques,3,La Derivation,7,Fonctions Reciproques,10,687,9,QCM,0.22,0.38,44.0,44,56,100,68,44,24,1.47,64.71,Moyen,Moyen,0,Meme Difficulté,Pas Adapte,Mathematics
1797,2016,Mathématiques,3,La Derivation,7,Fonctions Reciproques,10,687,9,QCM,0.56,0.19,31.0,30,67,97,30,30,0,3.23,100.0,Facile,Difficile,-2,Beaucoup plus Difficile,Pas Adapte,Mathematics
2908,2017,Mathématiques,3,La Derivation,7,Fonctions Reciproques,10,687,9,QCM,0.76,0.28,13.0,11,72,83,29,11,18,2.86,37.93,Moyen,Difficile,-1,Plus Difficile,Pas Adapte,Mathematics
4019,2018,Mathématiques,3,La Derivation,7,Fonctions Reciproques,10,687,9,QCM,0.79,0.19,1.0,1,76,77,71,1,70,1.08,1.41,Facile,Difficile,-2,Beaucoup plus Difficile,Pas Adapte,Mathematics
5130,2019,Mathématiques,3,La Derivation,7,Fonctions Reciproques,10,687,9,QCU,0.34,0.64,52.0,35,33,68,53,35,18,1.28,66.04,Difficile,Moyen,1,Plus Facile,Pas Adapte,Mathematics
6241,2020,Mathématiques,3,La Derivation,7,Fonctions Reciproques,10,687,9,QCU,0.58,0.21,15.0,10,54,64,60,10,50,1.07,16.67,Facile,Difficile,-2,Beaucoup plus Difficile,Pas Adapte,Mathematics
687,2015,Mathématiques,3,La Derivation,7,Fonctions Reciproques,10,688,10,QCU,0.74,0.31,34.0,9,18,27,22,9,13,1.23,40.91,Difficile,Difficile,0,Meme Difficulté,Pas Adapte,Mathematics
1798,2016,Mathématiques,3,La Derivation,7,Fonctions Reciproques,10,688,10,QCU,0.41,0.34,17.0,5,24,29,21,5,16,1.38,23.81,Facile,Difficile,-2,Beaucoup plus Difficile,Pas Adapte,Mathematics
2909,2017,Mathématiques,3,La Derivation,7,Fonctions Reciproques,10,688,10,QCU,0.32,0.66,45.0,14,17,31,20,14,6,1.55,70.0,Difficile,Moyen,1,Plus Facile,Pas Adapte,Mathematics
4020,2018,Mathématiques,3,La Derivation,7,Fonctions Reciproques,10,688,10,QCU,0.51,0.23,6.0,2,30,32,21,2,19,1.52,9.52,Facile,Difficile,-2,Beaucoup plus Difficile,Pas Adapte,Mathematics
5131,2019,Mathématiques,3,La Derivation,7,Fonctions Reciproques,10,688,10,QCU,0.33,0.66,55.0,16,14,30,19,16,3,1.58,84.21,Moyen,Moyen,0,Meme Difficulté,Pas Adapte,Mathematics
6242,2020,Mathématiques,3,La Derivation,7,Fonctions Reciproques,10,688,10,QCU,0.36,0.44,43.0,12,15,27,26,12,14,1.04,46.15,Difficile,Moyen,1,Plus Facile,Pas Adapte,Mathematics
688,2015,Mathématiques,3,La Derivation,8,Quelques Techniques de Calcul,2,689,1,QO,0.9,0.08,10.0,1,7,8,5,1,4,1.6,20.0,Facile,Difficile,-2,Beaucoup plus Difficile,Pas Adapte,Mathematics
1799,2016,Mathématiques,3,La Derivation,8,Quelques Techniques de Calcul,2,689,1,QO,0.66,0.28,55.0,4,4,8,8,4,4,1.0,50.0,Difficile,Moyen,1,Plus Facile,Pas Adapte,Mathematics
2910,2017,Mathématiques,3,La Derivation,8,Quelques Techniques de Calcul,2,689,1,QO,0.96,0.13,28.0,2,6,8,4,2,2,2.0,50.0,Facile,Difficile,-2,Beaucoup plus Difficile,Pas Adapte,Mathematics
4021,2018,Mathématiques,3,La Derivation,8,Quelques Techniques de Calcul,2,689,1,QO,0.99,0.08,7.0,1,7,8,5,1,4,1.6,20.0,Facile,Difficile,-2,Beaucoup plus Difficile,Pas Adapte,Mathematics
5132,2019,Mathématiques,3,La Derivation,8,Quelques Techniques de Calcul,2,689,1,QO,0.82,0.0,31.0,3,6,9,8,3,5,1.12,37.5,Moyen,Difficile,-1,Plus Difficile,Pas Adapte,Mathematics
6243,2020,Mathématiques,3,La Derivation,8,Quelques Techniques de Calcul,2,689,1,QO,0.77,0.11,11.0,1,8,9,7,1,6,1.29,14.29,Difficile,Difficile,0,Meme Difficulté,Pas Adapte,Mathematics
689,2015,Mathématiques,3,La Derivation,8,Quelques Techniques de Calcul,2,690,2,QCM,0.62,0.17,18.0,17,76,93,43,17,26,2.16,39.53,Difficile,Difficile,0,Meme Difficulté,Pas Adapte,Mathematics
1800,2016,Mathématiques,3,La Derivation,8,Quelques Techniques de Calcul,2,690,2,QCM,0.71,0.21,26.0,24,70,94,53,24,29,1.77,45.28,Facile,Difficile,-2,Beaucoup plus Difficile,Pas Adapte,Mathematics
2911,2017,Mathématiques,3,La Derivation,8,Quelques Techniques de Calcul,2,690,2,QCM,0.48,0.4,38.0,35,57,92,74,35,39,1.24,47.3,Difficile,Moyen,1,Plus Facile,Pas Adapte,Mathematics
4022,2018,Mathématiques,3,La Derivation,8,Quelques Techniques de Calcul,2,690,2,QCM,0.39,0.45,52.0,55,51,106,62,55,7,1.71,88.71,Moyen,Moyen,0,Meme Difficulté,Pas Adapte,Mathematics
5133,2019,Mathématiques,3,La Derivation,8,Quelques Techniques de Calcul,2,690,2,QROC,0.64,0.05,26.0,28,78,106,103,28,75,1.03,27.18,Facile,Difficile,-2,Beaucoup plus Difficile,Pas Adapte,Mathematics
6244,2020,Mathématiques,3,La Derivation,8,Quelques Techniques de Calcul,2,690,2,QROC,0.6,0.33,40.0,46,68,114,73,46,27,1.56,63.01,Facile,Moyen,-1,Plus Difficile,Pas Adapte,Mathematics
690,2015,Mathématiques,4,Les Espaces Pre-Hilbertiens et Hilbertiens,1,Espaces Prehilbertiens Reel ou Complexes,14,691,1,QCM,0.47,0.48,50.0,29,29,58,56,29,27,1.04,51.79,Difficile,Moyen,1,Plus Facile,Pas Adapte,Mathematics
1801,2016,Mathématiques,4,Les Espaces Pre-Hilbertiens et Hilbertiens,1,Espaces Prehilbertiens Reel ou Complexes,14,691,1,QCM,0.24,0.66,60.0,40,27,67,61,40,21,1.1,65.57,Difficile,Moyen,1,Plus Facile,Adapte,Mathematics
2912,2017,Mathématiques,4,Les Espaces Pre-Hilbertiens et Hilbertiens,1,Espaces Prehilbertiens Reel ou Complexes,14,691,1,QCM,0.37,0.37,60.0,36,24,60,50,36,14,1.2,72.0,Moyen,Moyen,0,Meme Difficulté,Adapte,Mathematics
4023,2018,Mathématiques,4,Les Espaces Pre-Hilbertiens et Hilbertiens,1,Espaces Prehilbertiens Reel ou Complexes,14,691,1,QCM,0.4,0.53,60.0,31,20,51,48,31,17,1.06,64.58,Moyen,Moyen,0,Meme Difficulté,Adapte,Mathematics
5134,2019,Mathématiques,4,Les Espaces Pre-Hilbertiens et Hilbertiens,1,Espaces Prehilbertiens Reel ou Complexes,14,691,1,QCM,0.27,0.32,60.0,30,20,50,43,30,13,1.16,69.77,Moyen,Moyen,0,Meme Difficulté,Adapte,Mathematics
6245,2020,Mathématiques,4,Les Espaces Pre-Hilbertiens et Hilbertiens,1,Espaces Prehilbertiens Reel ou Complexes,14,691,1,QCU,0.21,0.51,60.0,29,19,48,41,29,12,1.17,70.73,Moyen,Moyen,0,Meme Difficulté,Adapte,Mathematics
691,2015,Mathématiques,4,Les Espaces Pre-Hilbertiens et Hilbertiens,1,Espaces Prehilbertiens Reel ou Complexes,14,692,2,QCU,0.37,0.52,52.0,38,36,74,52,38,14,1.42,73.08,Facile,Moyen,-1,Plus Difficile,Pas Adapte,Mathematics
1802,2016,Mathématiques,4,Les Espaces Pre-Hilbertiens et Hilbertiens,1,Espaces Prehilbertiens Reel ou Complexes,14,692,2,QCU,0.44,0.23,35.0,28,51,79,73,28,45,1.08,38.36,Facile,Difficile,-2,Beaucoup plus Difficile,Pas Adapte,Mathematics
2913,2017,Mathématiques,4,Les Espaces Pre-Hilbertiens et Hilbertiens,1,Espaces Prehilbertiens Reel ou Complexes,14,692,2,QCU,0.67,0.32,1.0,1,89,90,66,1,65,1.36,1.52,Moyen,Difficile,-1,Plus Difficile,Pas Adapte,Mathematics
4024,2018,Mathématiques,4,Les Espaces Pre-Hilbertiens et Hilbertiens,1,Espaces Prehilbertiens Reel ou Complexes,14,692,2,QCM,0.8,0.25,15.0,15,86,101,73,15,58,1.38,20.55,Facile,Difficile,-2,Beaucoup plus Difficile,Pas Adapte,Mathematics
5135,2019,Mathématiques,4,Les Espaces Pre-Hilbertiens et Hilbertiens,1,Espaces Prehilbertiens Reel ou Complexes,14,692,2,QCM,0.68,0.21,30.0,35,81,116,98,35,63,1.18,35.71,Moyen,Difficile,-1,Plus Difficile,Pas Adapte,Mathematics
6246,2020,Mathématiques,4,Les Espaces Pre-Hilbertiens et Hilbertiens,1,Espaces Prehilbertiens Reel ou Complexes,14,692,2,QCM,0.29,0.31,45.0,58,70,128,95,58,37,1.35,61.05,Moyen,Moyen,0,Meme Difficulté,Pas Adapte,Mathematics
692,2015,Mathématiques,4,Les Espaces Pre-Hilbertiens et Hilbertiens,1,Espaces Prehilbertiens Reel ou Complexes,14,693,3,QROC,0.49,0.31,38.0,27,44,71,33,27,6,2.15,81.82,Difficile,Moyen,1,Plus Facile,Pas Adapte,Mathematics
1803,2016,Mathématiques,4,Les Espaces Pre-Hilbertiens et Hilbertiens,1,Espaces Prehilbertiens Reel ou Complexes,14,693,3,QROC,0.67,0.07,6.0,4,67,71,60,4,56,1.18,6.67,Facile,Difficile,-2,Beaucoup plus Difficile,Pas Adapte,Mathematics
2914,2017,Mathématiques,4,Les Espaces Pre-Hilbertiens et Hilbertiens,1,Espaces Prehilbertiens Reel ou Complexes,14,693,3,QROC,0.89,0.02,13.0,9,59,68,55,9,46,1.24,16.36,Difficile,Difficile,0,Meme Difficulté,Pas Adapte,Mathematics
4025,2018,Mathématiques,4,Les Espaces Pre-Hilbertiens et Hilbertiens,1,Espaces Prehilbertiens Reel ou Complexes,14,693,3,QROC,0.3,0.38,38.0,23,37,60,36,23,13,1.67,63.89,Moyen,Moyen,0,Meme Difficulté,Pas Adapte,Mathematics
5136,2019,Mathématiques,4,Les Espaces Pre-Hilbertiens et Hilbertiens,1,Espaces Prehilbertiens Reel ou Complexes,14,693,3,QROC,0.55,0.29,45.0,26,32,58,56,26,30,1.04,46.43,Difficile,Moyen,1,Plus Facile,Pas Adapte,Mathematics
6247,2020,Mathématiques,4,Les Espaces Pre-Hilbertiens et Hilbertiens,1,Espaces Prehilbertiens Reel ou Complexes,14,693,3,QROC,0.96,0.0,21.0,10,39,49,38,10,28,1.29,26.32,Facile,Difficile,-2,Beaucoup plus Difficile,Pas Adapte,Mathematics
693,2015,Mathématiques,4,Les Espaces Pre-Hilbertiens et Hilbertiens,1,Espaces Prehilbertiens Reel ou Complexes,14,694,4,QCU,0.67,0.34,6.0,5,83,88,41,5,36,2.15,12.2,Facile,Difficile,-2,Beaucoup plus Difficile,Pas Adapte,Mathematics
1804,2016,Mathématiques,4,Les Espaces Pre-Hilbertiens et Hilbertiens,1,Espaces Prehilbertiens Reel ou Complexes,14,694,4,QCU,0.25,0.51,52.0,49,45,94,72,49,23,1.31,68.06,Facile,Moyen,-1,Plus Difficile,Pas Adapte,Mathematics
2915,2017,Mathématiques,4,Les Espaces Pre-Hilbertiens et Hilbertiens,1,Espaces Prehilbertiens Reel ou Complexes,14,694,4,QCU,0.6,0.38,22.0,23,83,106,36,23,13,2.94,63.89,Moyen,Difficile,-1,Plus Difficile,Pas Adapte,Mathematics
4026,2018,Mathématiques,4,Les Espaces Pre-Hilbertiens et Hilbertiens,1,Espaces Prehilbertiens Reel ou Complexes,14,694,4,QCM,0.54,0.24,16.0,17,87,104,66,17,49,1.58,25.76,Difficile,Difficile,0,Meme Difficulté,Pas Adapte,Mathematics
5137,2019,Mathématiques,4,Les Espaces Pre-Hilbertiens et Hilbertiens,1,Espaces Prehilbertiens Reel ou Complexes,14,694,4,QCU,0.39,0.48,45.0,44,54,98,73,44,29,1.34,60.27,Facile,Moyen,-1,Plus Difficile,Pas Adapte,Mathematics
6248,2020,Mathématiques,4,Les Espaces Pre-Hilbertiens et Hilbertiens,1,Espaces Prehilbertiens Reel ou Complexes,14,694,4,QCU,0.37,0.68,63.0,56,33,89,80,56,24,1.11,70.0,Difficile,Moyen,1,Plus Facile,Adapte,Mathematics
694,2015,Mathématiques,4,Les Espaces Pre-Hilbertiens et Hilbertiens,1,Espaces Prehilbertiens Reel ou Complexes,14,695,5,QCM,0.56,0.17,29.0,9,22,31,16,9,7,1.94,56.25,Difficile,Difficile,0,Meme Difficulté,Pas Adapte,Mathematics
1805,2016,Mathématiques,4,Les Espaces Pre-Hilbertiens et Hilbertiens,1,Espaces Prehilbertiens Reel ou Complexes,14,695,5,QCM,0.39,0.51,36.0,10,19,29,14,10,4,2.07,71.43,Moyen,Moyen,0,Meme Difficulté,Pas Adapte,Mathematics
2916,2017,Mathématiques,4,Les Espaces Pre-Hilbertiens et Hilbertiens,1,Espaces Prehilbertiens Reel ou Complexes,14,695,5,QCM,0.48,0.64,45.0,13,15,28,18,13,5,1.56,72.22,Moyen,Moyen,0,Meme Difficulté,Pas Adapte,Mathematics
4027,2018,Mathématiques,4,Les Espaces Pre-Hilbertiens et Hilbertiens,1,Espaces Prehilbertiens Reel ou Complexes,14,695,5,QCM,0.77,0.3,29.0,8,20,28,13,8,5,2.15,61.54,Moyen,Difficile,-1,Plus Difficile,Pas Adapte,Mathematics
5138,2019,Mathématiques,4,Les Espaces Pre-Hilbertiens et Hilbertiens,1,Espaces Prehilbertiens Reel ou Complexes,14,695,5,QCM,0.4,0.57,51.0,12,12,24,12,12,0,2.0,100.0,Moyen,Moyen,0,Meme Difficulté,Pas Adapte,Mathematics
6249,2020,Mathématiques,4,Les Espaces Pre-Hilbertiens et Hilbertiens,1,Espaces Prehilbertiens Reel ou Complexes,14,695,5,QCM,0.77,0.26,34.0,8,17,25,19,8,11,1.32,42.11,Facile,Difficile,-2,Beaucoup plus Difficile,Pas Adapte,Mathematics
695,2015,Mathématiques,4,Les Espaces Pre-Hilbertiens et Hilbertiens,1,Espaces Prehilbertiens Reel ou Complexes,14,696,6,QROC,0.83,0.03,6.0,4,58,62,54,4,50,1.15,7.41,Moyen,Difficile,-1,Plus Difficile,Pas Adapte,Mathematics
1806,2016,Mathématiques,4,Les Espaces Pre-Hilbertiens et Hilbertiens,1,Espaces Prehilbertiens Reel ou Complexes,14,696,6,QROC,0.2,0.37,53.0,36,32,68,41,36,5,1.66,87.8,Moyen,Moyen,0,Meme Difficulté,Pas Adapte,Mathematics
2917,2017,Mathématiques,4,Les Espaces Pre-Hilbertiens et Hilbertiens,1,Espaces Prehilbertiens Reel ou Complexes,14,696,6,QROC,0.86,0.01,18.0,12,57,69,47,12,35,1.47,25.53,Difficile,Difficile,0,Meme Difficulté,Pas Adapte,Mathematics
4028,2018,Mathématiques,4,Les Espaces Pre-Hilbertiens et Hilbertiens,1,Espaces Prehilbertiens Reel ou Complexes,14,696,6,QROC,0.34,0.34,43.0,29,38,67,42,29,13,1.6,69.05,Difficile,Moyen,1,Plus Facile,Pas Adapte,Mathematics
5139,2019,Mathématiques,4,Les Espaces Pre-Hilbertiens et Hilbertiens,1,Espaces Prehilbertiens Reel ou Complexes,14,696,6,QROC,0.75,0.14,13.0,9,62,71,37,9,28,1.92,24.32,Difficile,Difficile,0,Meme Difficulté,Pas Adapte,Mathematics
6250,2020,Mathématiques,4,Les Espaces Pre-Hilbertiens et Hilbertiens,1,Espaces Prehilbertiens Reel ou Complexes,14,696,6,QROC,0.49,0.35,54.0,36,31,67,63,36,27,1.06,57.14,Moyen,Moyen,0,Meme Difficulté,Pas Adapte,Mathematics
696,2015,Mathématiques,4,Les Espaces Pre-Hilbertiens et Hilbertiens,1,Espaces Prehilbertiens Reel ou Complexes,14,697,7,QROC,0.42,0.26,50.0,12,13,25,20,12,8,1.25,60.0,Moyen,Moyen,0,Meme Difficulté,Pas Adapte,Mathematics
1807,2016,Mathématiques,4,Les Espaces Pre-Hilbertiens et Hilbertiens,1,Espaces Prehilbertiens Reel ou Complexes,14,697,7,QO,0.83,0.14,18.0,5,23,28,20,5,15,1.4,25.0,Difficile,Difficile,0,Meme Difficulté,Pas Adapte,Mathematics
2918,2017,Mathématiques,4,Les Espaces Pre-Hilbertiens et Hilbertiens,1,Espaces Prehilbertiens Reel ou Complexes,14,697,7,QO,0.3,0.2,47.0,13,14,27,15,13,2,1.8,86.67,Difficile,Moyen,1,Plus Facile,Pas Adapte,Mathematics
4029,2018,Mathématiques,4,Les Espaces Pre-Hilbertiens et Hilbertiens,1,Espaces Prehilbertiens Reel ou Complexes,14,697,7,QO,0.9,0.02,10.0,3,26,29,25,3,22,1.16,12.0,Moyen,Difficile,-1,Plus Difficile,Pas Adapte,Mathematics
5140,2019,Mathématiques,4,Les Espaces Pre-Hilbertiens et Hilbertiens,1,Espaces Prehilbertiens Reel ou Complexes,14,697,7,QCM,0.4,0.68,46.0,13,15,28,22,13,9,1.27,59.09,Moyen,Moyen,0,Meme Difficulté,Pas Adapte,Mathematics
6251,2020,Mathématiques,4,Les Espaces Pre-Hilbertiens et Hilbertiens,1,Espaces Prehilbertiens Reel ou Complexes,14,697,7,QCM,0.64,0.29,23.0,6,19,25,23,6,17,1.09,26.09,Facile,Difficile,-2,Beaucoup plus Difficile,Pas Adapte,Mathematics
697,2015,Mathématiques,4,Les Espaces Pre-Hilbertiens et Hilbertiens,1,Espaces Prehilbertiens Reel ou Complexes,14,698,8,QCM,0.64,0.24,28.0,8,19,27,11,8,3,2.45,72.73,Difficile,Difficile,0,Meme Difficulté,Pas Adapte,Mathematics
1808,2016,Mathématiques,4,Les Espaces Pre-Hilbertiens et Hilbertiens,1,Espaces Prehilbertiens Reel ou Complexes,14,698,8,QCM,0.72,0.18,14.0,4,24,28,15,4,11,1.87,26.67,Difficile,Difficile,0,Meme Difficulté,Pas Adapte,Mathematics
2919,2017,Mathématiques,4,Les Espaces Pre-Hilbertiens et Hilbertiens,1,Espaces Prehilbertiens Reel ou Complexes,14,698,8,QCM,0.74,0.18,12.0,3,26,29,29,3,26,1.0,10.34,Facile,Difficile,-2,Beaucoup plus Difficile,Pas Adapte,Mathematics
4030,2018,Mathématiques,4,Les Espaces Pre-Hilbertiens et Hilbertiens,1,Espaces Prehilbertiens Reel ou Complexes,14,698,8,QCM,0.71,0.18,33.0,9,18,27,13,9,4,2.08,69.23,Difficile,Difficile,0,Meme Difficulté,Pas Adapte,Mathematics
5141,2019,Mathématiques,4,Les Espaces Pre-Hilbertiens et Hilbertiens,1,Espaces Prehilbertiens Reel ou Complexes,14,698,8,QCM,0.38,0.64,51.0,16,15,31,24,16,8,1.29,66.67,Facile,Moyen,-1,Plus Difficile,Pas Adapte,Mathematics
6252,2020,Mathématiques,4,Les Espaces Pre-Hilbertiens et Hilbertiens,1,Espaces Prehilbertiens Reel ou Complexes,14,698,8,QCM,0.63,0.3,7.0,2,29,31,16,2,14,1.94,12.5,Moyen,Difficile,-1,Plus Difficile,Pas Adapte,Mathematics
698,2015,Mathématiques,4,Les Espaces Pre-Hilbertiens et Hilbertiens,1,Espaces Prehilbertiens Reel ou Complexes,14,699,9,QROC,0.88,0.22,31.0,17,37,54,53,17,36,1.02,32.08,Difficile,Difficile,0,Meme Difficulté,Pas Adapte,Mathematics
1809,2016,Mathématiques,4,Les Espaces Pre-Hilbertiens et Hilbertiens,1,Espaces Prehilbertiens Reel ou Complexes,14,699,9,QROC,0.59,0.26,44.0,24,30,54,41,24,17,1.32,58.54,Difficile,Moyen,1,Plus Facile,Pas Adapte,Mathematics
2920,2017,Mathématiques,4,Les Espaces Pre-Hilbertiens et Hilbertiens,1,Espaces Prehilbertiens Reel ou Complexes,14,699,9,QROC,0.72,0.17,21.0,11,41,52,24,11,13,2.17,45.83,Difficile,Difficile,0,Meme Difficulté,Pas Adapte,Mathematics
4031,2018,Mathématiques,4,Les Espaces Pre-Hilbertiens et Hilbertiens,1,Espaces Prehilbertiens Reel ou Complexes,14,699,9,QROC,0.32,0.31,41.0,24,35,59,33,24,9,1.79,72.73,Moyen,Moyen,0,Meme Difficulté,Pas Adapte,Mathematics
5142,2019,Mathématiques,4,Les Espaces Pre-Hilbertiens et Hilbertiens,1,Espaces Prehilbertiens Reel ou Complexes,14,699,9,QROC,0.94,0.02,7.0,5,60,65,34,5,29,1.91,14.71,Facile,Difficile,-2,Beaucoup plus Difficile,Pas Adapte,Mathematics
6253,2020,Mathématiques,4,Les Espaces Pre-Hilbertiens et Hilbertiens,1,Espaces Prehilbertiens Reel ou Complexes,14,699,9,QROC,0.72,0.16,24.0,14,44,58,29,14,15,2.0,48.28,Facile,Difficile,-2,Beaucoup plus Difficile,Pas Adapte,Mathematics
699,2015,Mathématiques,4,Les Espaces Pre-Hilbertiens et Hilbertiens,1,Espaces Prehilbertiens Reel ou Complexes,14,700,10,QCM,0.59,0.25,25.0,21,64,85,71,21,50,1.2,29.58,Difficile,Difficile,0,Meme Difficulté,Pas Adapte,Mathematics
1810,2016,Mathématiques,4,Les Espaces Pre-Hilbertiens et Hilbertiens,1,Espaces Prehilbertiens Reel ou Complexes,14,700,10,QCM,0.69,0.23,14.0,12,77,89,83,12,71,1.07,14.46,Moyen,Difficile,-1,Plus Difficile,Pas Adapte,Mathematics
2921,2017,Mathématiques,4,Les Espaces Pre-Hilbertiens et Hilbertiens,1,Espaces Prehilbertiens Reel ou Complexes,14,700,10,QCM,0.33,0.56,50.0,44,43,87,49,44,5,1.78,89.8,Difficile,Moyen,1,Plus Facile,Pas Adapte,Mathematics
4032,2018,Mathématiques,4,Les Espaces Pre-Hilbertiens et Hilbertiens,1,Espaces Prehilbertiens Reel ou Complexes,14,700,10,QCM,0.34,0.66,48.0,47,50,97,52,47,5,1.87,90.38,Moyen,Moyen,0,Meme Difficulté,Pas Adapte,Mathematics
5143,2019,Mathématiques,4,Les Espaces Pre-Hilbertiens et Hilbertiens,1,Espaces Prehilbertiens Reel ou Complexes,14,700,10,QCU,0.51,0.24,14.0,15,94,109,71,15,56,1.54,21.13,Facile,Difficile,-2,Beaucoup plus Difficile,Pas Adapte,Mathematics
6254,2020,Mathématiques,4,Les Espaces Pre-Hilbertiens et Hilbertiens,1,Espaces Prehilbertiens Reel ou Complexes,14,700,10,QCU,0.33,0.58,48.0,48,53,101,66,48,18,1.53,72.73,Facile,Moyen,-1,Plus Difficile,Pas Adapte,Mathematics
700,2015,Mathématiques,4,Les Espaces Pre-Hilbertiens et Hilbertiens,1,Espaces Prehilbertiens Reel ou Complexes,14,701,11,QCM,0.2,0.6,56.0,44,34,78,71,44,27,1.1,61.97,Facile,Moyen,-1,Plus Difficile,Pas Adapte,Mathematics
1811,2016,Mathématiques,4,Les Espaces Pre-Hilbertiens et Hilbertiens,1,Espaces Prehilbertiens Reel ou Complexes,14,701,11,QCM,0.42,0.58,61.0,41,27,68,52,41,11,1.31,78.85,Facile,Moyen,-1,Plus Difficile,Adapte,Mathematics
2922,2017,Mathématiques,4,Les Espaces Pre-Hilbertiens et Hilbertiens,1,Espaces Prehilbertiens Reel ou Complexes,14,701,11,QCM,0.39,0.59,61.0,46,29,75,71,46,25,1.06,64.79,Moyen,Moyen,0,Meme Difficulté,Adapte,Mathematics
4033,2018,Mathématiques,4,Les Espaces Pre-Hilbertiens et Hilbertiens,1,Espaces Prehilbertiens Reel ou Complexes,14,701,11,QCU,0.25,0.68,61.0,41,26,67,53,41,12,1.26,77.36,Moyen,Moyen,0,Meme Difficulté,Adapte,Mathematics
5144,2019,Mathématiques,4,Les Espaces Pre-Hilbertiens et Hilbertiens,1,Espaces Prehilbertiens Reel ou Complexes,14,701,11,QCU,0.33,0.6,61.0,42,27,69,68,42,26,1.01,61.76,Moyen,Moyen,0,Meme Difficulté,Adapte,Mathematics
6255,2020,Mathématiques,4,Les Espaces Pre-Hilbertiens et Hilbertiens,1,Espaces Prehilbertiens Reel ou Complexes,14,701,11,QCU,0.28,0.7,61.0,42,27,69,67,42,25,1.03,62.69,Moyen,Moyen,0,Meme Difficulté,Adapte,Mathematics
701,2015,Mathématiques,4,Les Espaces Pre-Hilbertiens et Hilbertiens,1,Espaces Prehilbertiens Reel ou Complexes,14,702,12,QCU,0.6,0.36,17.0,11,55,66,62,11,51,1.06,17.74,Facile,Difficile,-2,Beaucoup plus Difficile,Pas Adapte,Mathematics
1812,2016,Mathématiques,4,Les Espaces Pre-Hilbertiens et Hilbertiens,1,Espaces Prehilbertiens Reel ou Complexes,14,702,12,QCU,0.29,0.49,52.0,38,35,73,61,38,23,1.2,62.3,Facile,Moyen,-1,Plus Difficile,Pas Adapte,Mathematics
2923,2017,Mathématiques,4,Les Espaces Pre-Hilbertiens et Hilbertiens,1,Espaces Prehilbertiens Reel ou Complexes,14,702,12,QCU,0.49,0.3,18.0,13,60,73,55,13,42,1.33,23.64,Moyen,Difficile,-1,Plus Difficile,Pas Adapte,Mathematics
4034,2018,Mathématiques,4,Les Espaces Pre-Hilbertiens et Hilbertiens,1,Espaces Prehilbertiens Reel ou Complexes,14,702,12,QCU,0.67,0.39,33.0,26,52,78,35,26,9,2.23,74.29,Facile,Difficile,-2,Beaucoup plus Difficile,Pas Adapte,Mathematics
5145,2019,Mathématiques,4,Les Espaces Pre-Hilbertiens et Hilbertiens,1,Espaces Prehilbertiens Reel ou Complexes,14,702,12,QCU,0.75,0.37,18.0,12,54,66,23,12,11,2.87,52.17,Difficile,Difficile,0,Meme Difficulté,Pas Adapte,Mathematics
6256,2020,Mathématiques,4,Les Espaces Pre-Hilbertiens et Hilbertiens,1,Espaces Prehilbertiens Reel ou Complexes,14,702,12,QO,0.97,0.05,23.0,14,49,63,51,14,37,1.24,27.45,Difficile,Difficile,0,Meme Difficulté,Pas Adapte,Mathematics
702,2015,Mathématiques,4,Les Espaces Pre-Hilbertiens et Hilbertiens,1,Espaces Prehilbertiens Reel ou Complexes,14,703,13,QCU,0.3,0.45,46.0,20,24,44,28,20,8,1.57,71.43,Moyen,Moyen,0,Meme Difficulté,Pas Adapte,Mathematics
1813,2016,Mathématiques,4,Les Espaces Pre-Hilbertiens et Hilbertiens,1,Espaces Prehilbertiens Reel ou Complexes,14,703,13,QCU,0.71,0.32,31.0,15,33,48,16,15,1,3.0,93.75,Difficile,Difficile,0,Meme Difficulté,Pas Adapte,Mathematics
2924,2017,Mathématiques,4,Les Espaces Pre-Hilbertiens et Hilbertiens,1,Espaces Prehilbertiens Reel ou Complexes,14,703,13,QCU,0.59,0.26,12.0,6,43,49,18,6,12,2.72,33.33,Moyen,Difficile,-1,Plus Difficile,Pas Adapte,Mathematics
4035,2018,Mathématiques,4,Les Espaces Pre-Hilbertiens et Hilbertiens,1,Espaces Prehilbertiens Reel ou Complexes,14,703,13,QCU,0.42,0.33,21.0,12,43,55,37,12,25,1.49,32.43,Moyen,Difficile,-1,Plus Difficile,Pas Adapte,Mathematics
5146,2019,Mathématiques,4,Les Espaces Pre-Hilbertiens et Hilbertiens,1,Espaces Prehilbertiens Reel ou Complexes,14,703,13,QCU,0.63,0.38,34.0,20,40,60,46,20,26,1.3,43.48,Difficile,Difficile,0,Meme Difficulté,Pas Adapte,Mathematics
6257,2020,Mathématiques,4,Les Espaces Pre-Hilbertiens et Hilbertiens,1,Espaces Prehilbertiens Reel ou Complexes,14,703,13,QCU,0.57,0.27,7.0,4,59,63,28,4,24,2.25,14.29,Moyen,Difficile,-1,Plus Difficile,Pas Adapte,Mathematics
703,2015,Mathématiques,4,Les Espaces Pre-Hilbertiens et Hilbertiens,1,Espaces Prehilbertiens Reel ou Complexes,14,704,14,QCM,0.3,0.4,48.0,19,21,40,40,19,21,1.0,47.5,Facile,Moyen,-1,Plus Difficile,Pas Adapte,Mathematics
1814,2016,Mathématiques,4,Les Espaces Pre-Hilbertiens et Hilbertiens,1,Espaces Prehilbertiens Reel ou Complexes,14,704,14,QCM,0.72,0.26,21.0,8,29,37,24,8,16,1.54,33.33,Moyen,Difficile,-1,Plus Difficile,Pas Adapte,Mathematics
2925,2017,Mathématiques,4,Les Espaces Pre-Hilbertiens et Hilbertiens,1,Espaces Prehilbertiens Reel ou Complexes,14,704,14,QCM,0.5,0.33,36.0,11,20,31,26,11,15,1.19,42.31,Moyen,Moyen,0,Meme Difficulté,Pas Adapte,Mathematics
4036,2018,Mathématiques,4,Les Espaces Pre-Hilbertiens et Hilbertiens,1,Espaces Prehilbertiens Reel ou Complexes,14,704,14,QCM,0.21,0.4,37.0,10,18,28,15,10,5,1.87,66.67,Facile,Moyen,-1,Plus Difficile,Pas Adapte,Mathematics
5147,2019,Mathématiques,4,Les Espaces Pre-Hilbertiens et Hilbertiens,1,Espaces Prehilbertiens Reel ou Complexes,14,704,14,QCM,0.56,0.22,23.0,7,24,31,28,7,21,1.11,25.0,Facile,Difficile,-2,Beaucoup plus Difficile,Pas Adapte,Mathematics
6258,2020,Mathématiques,4,Les Espaces Pre-Hilbertiens et Hilbertiens,1,Espaces Prehilbertiens Reel ou Complexes,14,704,14,QCM,0.32,0.5,55.0,16,14,30,26,16,10,1.15,61.54,Moyen,Moyen,0,Meme Difficulté,Pas Adapte,Mathematics
704,2015,Mathématiques,4,Les Espaces Pre-Hilbertiens et Hilbertiens,2,Espaces Euclidiens,10,705,1,QCU,0.65,0.24,1.0,1,95,96,50,1,49,1.92,2.0,Facile,Difficile,-2,Beaucoup plus Difficile,Pas Adapte,Mathematics
1815,2016,Mathématiques,4,Les Espaces Pre-Hilbertiens et Hilbertiens,2,Espaces Euclidiens,10,705,1,QCU,0.21,0.41,64.0,63,35,98,64,63,1,1.53,98.44,Moyen,Moyen,0,Meme Difficulté,Adapte,Mathematics
2926,2017,Mathématiques,4,Les Espaces Pre-Hilbertiens et Hilbertiens,2,Espaces Euclidiens,10,705,1,QCM,0.45,0.37,64.0,70,39,109,98,70,28,1.11,71.43,Moyen,Moyen,0,Meme Difficulté,Adapte,Mathematics
4037,2018,Mathématiques,4,Les Espaces Pre-Hilbertiens et Hilbertiens,2,Espaces Euclidiens,10,705,1,QCM,0.3,0.34,64.0,77,43,120,109,77,32,1.1,70.64,Moyen,Moyen,0,Meme Difficulté,Adapte,Mathematics
5148,2019,Mathématiques,4,Les Espaces Pre-Hilbertiens et Hilbertiens,2,Espaces Euclidiens,10,705,1,QCM,0.36,0.56,64.0,84,48,132,111,84,27,1.19,75.68,Moyen,Moyen,0,Meme Difficulté,Adapte,Mathematics
6259,2020,Mathématiques,4,Les Espaces Pre-Hilbertiens et Hilbertiens,2,Espaces Euclidiens,10,705,1,QCU,0.38,0.57,64.0,92,52,144,109,92,17,1.32,84.4,Moyen,Moyen,0,Meme Difficulté,Adapte,Mathematics
705,2015,Mathématiques,4,Les Espaces Pre-Hilbertiens et Hilbertiens,2,Espaces Euclidiens,10,706,2,QCM,0.42,0.41,63.0,4,3,7,5,4,1,1.4,80.0,Facile,Moyen,-1,Plus Difficile,Adapte,Mathematics
1816,2016,Mathématiques,4,Les Espaces Pre-Hilbertiens et Hilbertiens,2,Espaces Euclidiens,10,706,2,QCM,0.32,0.57,63.0,4,2,6,4,4,0,1.5,100.0,Moyen,Moyen,0,Meme Difficulté,Adapte,Mathematics
2927,2017,Mathématiques,4,Les Espaces Pre-Hilbertiens et Hilbertiens,2,Espaces Euclidiens,10,706,2,QCM,0.26,0.59,63.0,4,2,6,5,4,1,1.2,80.0,Moyen,Moyen,0,Meme Difficulté,Adapte,Mathematics
4038,2018,Mathématiques,4,Les Espaces Pre-Hilbertiens et Hilbertiens,2,Espaces Euclidiens,10,706,2,QCM,0.42,0.53,63.0,4,3,7,6,4,2,1.17,66.67,Moyen,Moyen,0,Meme Difficulté,Adapte,Mathematics
5149,2019,Mathématiques,4,Les Espaces Pre-Hilbertiens et Hilbertiens,2,Espaces Euclidiens,10,706,2,QCM,0.46,0.47,63.0,5,3,8,5,5,0,1.6,100.0,Moyen,Moyen,0,Meme Difficulté,Adapte,Mathematics
6260,2020,Mathématiques,4,Les Espaces Pre-Hilbertiens et Hilbertiens,2,Espaces Euclidiens,10,706,2,QCM,0.4,0.55,63.0,5,3,8,7,5,2,1.14,71.43,Moyen,Moyen,0,Meme Difficulté,Adapte,Mathematics
706,2015,Mathématiques,4,Les Espaces Pre-Hilbertiens et Hilbertiens,2,Espaces Euclidiens,10,707,3,QCU,0.21,0.51,63.0,45,26,71,57,45,12,1.25,78.95,Difficile,Moyen,1,Plus Facile,Adapte,Mathematics
1817,2016,Mathématiques,4,Les Espaces Pre-Hilbertiens et Hilbertiens,2,Espaces Euclidiens,10,707,3,QCU,0.33,0.67,63.0,39,23,62,42,39,3,1.48,92.86,Moyen,Moyen,0,Meme Difficulté,Adapte,Mathematics
2928,2017,Mathématiques,4,Les Espaces Pre-Hilbertiens et Hilbertiens,2,Espaces Euclidiens,10,707,3,QCU,0.39,0.5,63.0,40,24,64,63,40,23,1.02,63.49,Moyen,Moyen,0,Meme Difficulté,Adapte,Mathematics
4039,2018,Mathématiques,4,Les Espaces Pre-Hilbertiens et Hilbertiens,2,Espaces Euclidiens,10,707,3,QROC,0.48,0.28,63.0,44,26,70,66,44,22,1.06,66.67,Moyen,Moyen,0,Meme Difficulté,Adapte,Mathematics
5150,2019,Mathématiques,4,Les Espaces Pre-Hilbertiens et Hilbertiens,2,Espaces Euclidiens,10,707,3,QROC,0.38,0.34,63.0,45,27,72,55,45,10,1.31,81.82,Moyen,Moyen,0,Meme Difficulté,Adapte,Mathematics
6261,2020,Mathématiques,4,Les Espaces Pre-Hilbertiens et Hilbertiens,2,Espaces Euclidiens,10,707,3,QCM,0.22,0.38,63.0,50,29,79,74,50,24,1.07,67.57,Moyen,Moyen,0,Meme Difficulté,Adapte,Mathematics
707,2015,Mathématiques,4,Les Espaces Pre-Hilbertiens et Hilbertiens,2,Espaces Euclidiens,10,708,4,QCM,0.6,0.3,0.0,0,99,99,45,0,45,2.2,0.0,Difficile,Difficile,0,Meme Difficulté,Pas Adapte,Mathematics
1818,2016,Mathématiques,4,Les Espaces Pre-Hilbertiens et Hilbertiens,2,Espaces Euclidiens,10,708,4,QCM,0.74,0.2,7.0,6,79,85,71,6,65,1.2,8.45,Moyen,Difficile,-1,Plus Difficile,Pas Adapte,Mathematics
2929,2017,Mathématiques,4,Les Espaces Pre-Hilbertiens et Hilbertiens,2,Espaces Euclidiens,10,708,4,QROC,0.39,0.32,54.0,48,41,89,85,48,37,1.05,56.47,Difficile,Moyen,1,Plus Facile,Pas Adapte,Mathematics
4040,2018,Mathématiques,4,Les Espaces Pre-Hilbertiens et Hilbertiens,2,Espaces Euclidiens,10,708,4,QROC,0.95,0.18,4.0,4,84,88,50,4,46,1.76,8.0,Moyen,Difficile,-1,Plus Difficile,Pas Adapte,Mathematics
5151,2019,Mathématiques,4,Les Espaces Pre-Hilbertiens et Hilbertiens,2,Espaces Euclidiens,10,708,4,QROC,0.5,0.31,60.0,53,35,88,55,53,2,1.6,96.36,Difficile,Moyen,1,Plus Facile,Adapte,Mathematics
6262,2020,Mathématiques,4,Les Espaces Pre-Hilbertiens et Hilbertiens,2,Espaces Euclidiens,10,708,4,QROC,0.37,0.38,60.0,51,34,85,69,51,18,1.23,73.91,Moyen,Moyen,0,Meme Difficulté,Adapte,Mathematics
708,2015,Mathématiques,4,Les Espaces Pre-Hilbertiens et Hilbertiens,2,Espaces Euclidiens,10,709,5,QCU,0.45,0.32,28.0,27,68,95,87,27,60,1.09,31.03,Moyen,Difficile,-1,Plus Difficile,Pas Adapte,Mathematics
1819,2016,Mathématiques,4,Les Espaces Pre-Hilbertiens et Hilbertiens,2,Espaces Euclidiens,10,709,5,QCU,0.3,0.74,41.0,34,49,83,55,34,21,1.51,61.82,Moyen,Moyen,0,Meme Difficulté,Pas Adapte,Mathematics
2930,2017,Mathématiques,4,Les Espaces Pre-Hilbertiens et Hilbertiens,2,Espaces Euclidiens,10,709,5,QCU,0.24,0.53,54.0,51,43,94,75,51,24,1.25,68.0,Difficile,Moyen,1,Plus Facile,Pas Adapte,Mathematics
4041,2018,Mathématiques,4,Les Espaces Pre-Hilbertiens et Hilbertiens,2,Espaces Euclidiens,10,709,5,QCU,0.21,0.62,48.0,42,45,87,49,42,7,1.78,85.71,Difficile,Moyen,1,Plus Facile,Pas Adapte,Mathematics
5152,2019,Mathématiques,4,Les Espaces Pre-Hilbertiens et Hilbertiens,2,Espaces Euclidiens,10,709,5,QCU,0.47,0.34,34.0,31,61,92,44,31,13,2.09,70.45,Moyen,Difficile,-1,Plus Difficile,Pas Adapte,Mathematics
6263,2020,Mathématiques,4,Les Espaces Pre-Hilbertiens et Hilbertiens,2,Espaces Euclidiens,10,709,5,QCU,0.25,0.64,38.0,32,52,84,54,32,22,1.56,59.26,Facile,Moyen,-1,Plus Difficile,Pas Adapte,Mathematics
709,2015,Mathématiques,4,Les Espaces Pre-Hilbertiens et Hilbertiens,2,Espaces Euclidiens,10,710,6,QCM,0.78,0.21,34.0,9,18,27,25,9,16,1.08,36.0,Facile,Difficile,-2,Beaucoup plus Difficile,Pas Adapte,Mathematics
1820,2016,Mathématiques,4,Les Espaces Pre-Hilbertiens et Hilbertiens,2,Espaces Euclidiens,10,710,6,QCM,0.41,0.69,63.0,20,11,31,26,20,6,1.19,76.92,Moyen,Moyen,0,Meme Difficulté,Adapte,Mathematics
2931,2017,Mathématiques,4,Les Espaces Pre-Hilbertiens et Hilbertiens,2,Espaces Euclidiens,10,710,6,QCM,0.38,0.66,63.0,18,11,29,18,18,0,1.61,100.0,Moyen,Moyen,0,Meme Difficulté,Adapte,Mathematics
4042,2018,Mathématiques,4,Les Espaces Pre-Hilbertiens et Hilbertiens,2,Espaces Euclidiens,10,710,6,QCM,0.33,0.45,63.0,19,11,30,20,19,1,1.5,95.0,Moyen,Moyen,0,Meme Difficulté,Adapte,Mathematics
5153,2019,Mathématiques,4,Les Espaces Pre-Hilbertiens et Hilbertiens,2,Espaces Euclidiens,10,710,6,QCM,0.43,0.68,63.0,16,10,26,18,16,2,1.44,88.89,Moyen,Moyen,0,Meme Difficulté,Adapte,Mathematics
6264,2020,Mathématiques,4,Les Espaces Pre-Hilbertiens et Hilbertiens,2,Espaces Euclidiens,10,710,6,QCM,0.29,0.46,63.0,16,10,26,18,16,2,1.44,88.89,Moyen,Moyen,0,Meme Difficulté,Adapte,Mathematics
710,2015,Mathématiques,4,Les Espaces Pre-Hilbertiens et Hilbertiens,2,Espaces Euclidiens,10,711,7,QCU,0.55,0.2,8.0,7,84,91,47,7,40,1.94,14.89,Difficile,Difficile,0,Meme Difficulté,Pas Adapte,Mathematics
1821,2016,Mathématiques,4,Les Espaces Pre-Hilbertiens et Hilbertiens,2,Espaces Euclidiens,10,711,7,QCU,0.58,0.35,23.0,24,79,103,45,24,21,2.29,53.33,Difficile,Difficile,0,Meme Difficulté,Pas Adapte,Mathematics
2932,2017,Mathématiques,4,Les Espaces Pre-Hilbertiens et Hilbertiens,2,Espaces Euclidiens,10,711,7,QCU,0.46,0.36,21.0,20,75,95,40,20,20,2.38,50.0,Moyen,Difficile,-1,Plus Difficile,Pas Adapte,Mathematics
4043,2018,Mathématiques,4,Les Espaces Pre-Hilbertiens et Hilbertiens,2,Espaces Euclidiens,10,711,7,QCU,0.73,0.24,30.0,26,60,86,35,26,9,2.46,74.29,Facile,Difficile,-2,Beaucoup plus Difficile,Pas Adapte,Mathematics
5154,2019,Mathématiques,4,Les Espaces Pre-Hilbertiens et Hilbertiens,2,Espaces Euclidiens,10,711,7,QCU,0.21,0.65,42.0,34,47,81,42,34,8,1.93,80.95,Difficile,Moyen,1,Plus Facile,Pas Adapte,Mathematics
6265,2020,Mathématiques,4,Les Espaces Pre-Hilbertiens et Hilbertiens,2,Espaces Euclidiens,10,711,7,QCU,0.5,0.35,9.0,6,63,69,33,6,27,2.09,18.18,Facile,Difficile,-2,Beaucoup plus Difficile,Pas Adapte,Mathematics
711,2015,Mathématiques,4,Les Espaces Pre-Hilbertiens et Hilbertiens,2,Espaces Euclidiens,10,712,8,QCU,0.49,0.27,10.0,7,62,69,50,7,43,1.38,14.0,Difficile,Difficile,0,Meme Difficulté,Pas Adapte,Mathematics
1822,2016,Mathématiques,4,Les Espaces Pre-Hilbertiens et Hilbertiens,2,Espaces Euclidiens,10,712,8,QCU,0.67,0.32,10.0,8,67,75,69,8,61,1.09,11.59,Difficile,Difficile,0,Meme Difficulté,Pas Adapte,Mathematics
2933,2017,Mathématiques,4,Les Espaces Pre-Hilbertiens et Hilbertiens,2,Espaces Euclidiens,10,712,8,QCU,0.68,0.32,4.0,3,76,79,54,3,51,1.46,5.56,Facile,Difficile,-2,Beaucoup plus Difficile,Pas Adapte,Mathematics
4044,2018,Mathématiques,4,Les Espaces Pre-Hilbertiens et Hilbertiens,2,Espaces Euclidiens,10,712,8,QCU,0.29,0.52,61.0,44,28,72,61,44,17,1.18,72.13,Difficile,Moyen,1,Plus Facile,Adapte,Mathematics
5155,2019,Mathématiques,4,Les Espaces Pre-Hilbertiens et Hilbertiens,2,Espaces Euclidiens,10,712,8,QCU,0.34,0.56,61.0,51,32,83,52,51,1,1.6,98.08,Moyen,Moyen,0,Meme Difficulté,Adapte,Mathematics
6266,2020,Mathématiques,4,Les Espaces Pre-Hilbertiens et Hilbertiens,2,Espaces Euclidiens,10,712,8,QCU,0.25,0.67,61.0,57,36,93,71,57,14,1.31,80.28,Moyen,Moyen,0,Meme Difficulté,Adapte,Mathematics
712,2015,Mathématiques,4,Les Espaces Pre-Hilbertiens et Hilbertiens,2,Espaces Euclidiens,10,713,9,QROC,0.8,0.02,15.0,1,7,8,6,1,5,1.33,16.67,Moyen,Difficile,-1,Plus Difficile,Pas Adapte,Mathematics
1823,2016,Mathématiques,4,Les Espaces Pre-Hilbertiens et Hilbertiens,2,Espaces Euclidiens,10,713,9,QROC,0.46,0.34,47.0,4,4,8,4,4,0,2.0,100.0,Facile,Moyen,-1,Plus Difficile,Pas Adapte,Mathematics
2934,2017,Mathématiques,4,Les Espaces Pre-Hilbertiens et Hilbertiens,2,Espaces Euclidiens,10,713,9,QO,0.8,0.11,35.0,3,6,9,5,3,2,1.8,60.0,Facile,Difficile,-2,Beaucoup plus Difficile,Pas Adapte,Mathematics
4045,2018,Mathématiques,4,Les Espaces Pre-Hilbertiens et Hilbertiens,2,Espaces Euclidiens,10,713,9,QO,0.8,0.08,30.0,2,6,8,6,2,4,1.33,33.33,Difficile,Difficile,0,Meme Difficulté,Pas Adapte,Mathematics
5156,2019,Mathématiques,4,Les Espaces Pre-Hilbertiens et Hilbertiens,2,Espaces Euclidiens,10,713,9,QO,0.97,0.14,13.0,1,8,9,9,1,8,1.0,11.11,Difficile,Difficile,0,Meme Difficulté,Pas Adapte,Mathematics
6267,2020,Mathématiques,4,Les Espaces Pre-Hilbertiens et Hilbertiens,2,Espaces Euclidiens,10,713,9,QO,0.54,0.19,48.0,4,4,8,5,4,1,1.6,80.0,Difficile,Moyen,1,Plus Facile,Pas Adapte,Mathematics
713,2015,Mathématiques,4,Les Espaces Pre-Hilbertiens et Hilbertiens,2,Espaces Euclidiens,10,714,10,QCM,0.43,0.38,62.0,62,38,100,99,62,37,1.01,62.63,Facile,Moyen,-1,Plus Difficile,Adapte,Mathematics
1824,2016,Mathématiques,4,Les Espaces Pre-Hilbertiens et Hilbertiens,2,Espaces Euclidiens,10,714,10,QCM,0.27,0.53,62.0,70,43,113,110,70,40,1.03,63.64,Moyen,Moyen,0,Meme Difficulté,Adapte,Mathematics
2935,2017,Mathématiques,4,Les Espaces Pre-Hilbertiens et Hilbertiens,2,Espaces Euclidiens,10,714,10,QCM,0.36,0.33,62.0,64,40,104,92,64,28,1.13,69.57,Moyen,Moyen,0,Meme Difficulté,Adapte,Mathematics
4046,2018,Mathématiques,4,Les Espaces Pre-Hilbertiens et Hilbertiens,2,Espaces Euclidiens,10,714,10,QCM,0.46,0.6,62.0,71,44,115,82,71,11,1.4,86.59,Moyen,Moyen,0,Meme Difficulté,Adapte,Mathematics
5157,2019,Mathématiques,4,Les Espaces Pre-Hilbertiens et Hilbertiens,2,Espaces Euclidiens,10,714,10,QCM,0.33,0.66,62.0,64,39,103,87,64,23,1.18,73.56,Moyen,Moyen,0,Meme Difficulté,Adapte,Mathematics
6268,2020,Mathématiques,4,Les Espaces Pre-Hilbertiens et Hilbertiens,2,Espaces Euclidiens,10,714,10,QCM,0.27,0.5,62.0,71,44,115,103,71,32,1.12,68.93,Moyen,Moyen,0,Meme Difficulté,Adapte,Mathematics
714,2015,Mathématiques,4,Les Espaces Pre-Hilbertiens et Hilbertiens,3,Rappels et Complements sur le Groupe Orthogonal d'un Espace Euclidien,7,715,1,QCM,0.3,0.66,54.0,11,10,21,18,11,7,1.17,61.11,Moyen,Moyen,0,Meme Difficulté,Pas Adapte,Mathematics
1825,2016,Mathématiques,4,Les Espaces Pre-Hilbertiens et Hilbertiens,3,Rappels et Complements sur le Groupe Orthogonal d'un Espace Euclidien,7,715,1,QCM,0.78,0.28,16.0,3,18,21,16,3,13,1.31,18.75,Moyen,Difficile,-1,Plus Difficile,Pas Adapte,Mathematics
2936,2017,Mathématiques,4,Les Espaces Pre-Hilbertiens et Hilbertiens,3,Rappels et Complements sur le Groupe Orthogonal d'un Espace Euclidien,7,715,1,QCU,0.54,0.38,9.0,2,18,20,12,2,10,1.67,16.67,Facile,Difficile,-2,Beaucoup plus Difficile,Pas Adapte,Mathematics
4047,2018,Mathématiques,4,Les Espaces Pre-Hilbertiens et Hilbertiens,3,Rappels et Complements sur le Groupe Orthogonal d'un Espace Euclidien,7,715,1,QCU,0.46,0.24,35.0,7,12,19,13,7,6,1.46,53.85,Facile,Difficile,-2,Beaucoup plus Difficile,Pas Adapte,Mathematics
5158,2019,Mathématiques,4,Les Espaces Pre-Hilbertiens et Hilbertiens,3,Rappels et Complements sur le Groupe Orthogonal d'un Espace Euclidien,7,715,1,QCU,0.2,0.58,52.0,8,8,16,11,8,3,1.45,72.73,Difficile,Moyen,1,Plus Facile,Pas Adapte,Mathematics
6269,2020,Mathématiques,4,Les Espaces Pre-Hilbertiens et Hilbertiens,3,Rappels et Complements sur le Groupe Orthogonal d'un Espace Euclidien,7,715,1,QCU,0.24,0.65,57.0,9,6,15,10,9,1,1.5,90.0,Moyen,Moyen,0,Meme Difficulté,Pas Adapte,Mathematics
715,2015,Mathématiques,4,Les Espaces Pre-Hilbertiens et Hilbertiens,3,Rappels et Complements sur le Groupe Orthogonal d'un Espace Euclidien,7,716,2,QROC,0.65,0.05,29.0,14,34,48,45,14,31,1.07,31.11,Facile,Difficile,-2,Beaucoup plus Difficile,Pas Adapte,Mathematics
1826,2016,Mathématiques,4,Les Espaces Pre-Hilbertiens et Hilbertiens,3,Rappels et Complements sur le Groupe Orthogonal d'un Espace Euclidien,7,716,2,QROC,0.52,0.28,50.0,27,27,54,30,27,3,1.8,90.0,Facile,Moyen,-1,Plus Difficile,Pas Adapte,Mathematics
2937,2017,Mathématiques,4,Les Espaces Pre-Hilbertiens et Hilbertiens,3,Rappels et Complements sur le Groupe Orthogonal d'un Espace Euclidien,7,716,2,QROC,0.42,0.32,49.0,23,24,47,37,23,14,1.27,62.16,Moyen,Moyen,0,Meme Difficulté,Pas Adapte,Mathematics
4048,2018,Mathématiques,4,Les Espaces Pre-Hilbertiens et Hilbertiens,3,Rappels et Complements sur le Groupe Orthogonal d'un Espace Euclidien,7,716,2,QROC,0.91,0.02,1.0,0,43,43,39,0,39,1.1,0.0,Moyen,Difficile,-1,Plus Difficile,Pas Adapte,Mathematics
5159,2019,Mathématiques,4,Les Espaces Pre-Hilbertiens et Hilbertiens,3,Rappels et Complements sur le Groupe Orthogonal d'un Espace Euclidien,7,716,2,QROC,0.8,0.23,7.0,3,34,37,27,3,24,1.37,11.11,Facile,Difficile,-2,Beaucoup plus Difficile,Pas Adapte,Mathematics
6270,2020,Mathématiques,4,Les Espaces Pre-Hilbertiens et Hilbertiens,3,Rappels et Complements sur le Groupe Orthogonal d'un Espace Euclidien,7,716,2,QROC,0.69,0.16,34.0,13,26,39,16,13,3,2.44,81.25,Facile,Difficile,-2,Beaucoup plus Difficile,Pas Adapte,Mathematics
716,2015,Mathématiques,4,Les Espaces Pre-Hilbertiens et Hilbertiens,3,Rappels et Complements sur le Groupe Orthogonal d'un Espace Euclidien,7,717,3,QCM,0.68,0.21,10.0,6,54,60,60,6,54,1.0,10.0,Difficile,Difficile,0,Meme Difficulté,Pas Adapte,Mathematics
1827,2016,Mathématiques,4,Les Espaces Pre-Hilbertiens et Hilbertiens,3,Rappels et Complements sur le Groupe Orthogonal d'un Espace Euclidien,7,717,3,QCU,0.33,0.59,64.0,33,18,51,44,33,11,1.16,75.0,Difficile,Moyen,1,Plus Facile,Adapte,Mathematics
2938,2017,Mathématiques,4,Les Espaces Pre-Hilbertiens et Hilbertiens,3,Rappels et Complements sur le Groupe Orthogonal d'un Espace Euclidien,7,717,3,QCU,0.33,0.45,64.0,31,17,48,47,31,16,1.02,65.96,Moyen,Moyen,0,Meme Difficulté,Adapte,Mathematics
4049,2018,Mathématiques,4,Les Espaces Pre-Hilbertiens et Hilbertiens,3,Rappels et Complements sur le Groupe Orthogonal d'un Espace Euclidien,7,717,3,QCU,0.23,0.43,64.0,34,19,53,36,34,2,1.47,94.44,Moyen,Moyen,0,Meme Difficulté,Adapte,Mathematics
5160,2019,Mathématiques,4,Les Espaces Pre-Hilbertiens et Hilbertiens,3,Rappels et Complements sur le Groupe Orthogonal d'un Espace Euclidien,7,717,3,QCU,0.23,0.55,64.0,38,22,60,39,38,1,1.54,97.44,Moyen,Moyen,0,Meme Difficulté,Adapte,Mathematics
6271,2020,Mathématiques,4,Les Espaces Pre-Hilbertiens et Hilbertiens,3,Rappels et Complements sur le Groupe Orthogonal d'un Espace Euclidien,7,717,3,QCU,0.31,0.72,64.0,44,24,68,68,44,24,1.0,64.71,Moyen,Moyen,0,Meme Difficulté,Adapte,Mathematics
717,2015,Mathématiques,4,Les Espaces Pre-Hilbertiens et Hilbertiens,3,Rappels et Complements sur le Groupe Orthogonal d'un Espace Euclidien,7,718,4,QCM,0.66,0.21,18.0,13,57,70,69,13,56,1.01,18.84,Moyen,Difficile,-1,Plus Difficile,Pas Adapte,Mathematics
1828,2016,Mathématiques,4,Les Espaces Pre-Hilbertiens et Hilbertiens,3,Rappels et Complements sur le Groupe Orthogonal d'un Espace Euclidien,7,718,4,QCM,0.38,0.37,51.0,38,37,75,66,38,28,1.14,57.58,Difficile,Moyen,1,Plus Facile,Pas Adapte,Mathematics
2939,2017,Mathématiques,4,Les Espaces Pre-Hilbertiens et Hilbertiens,3,Rappels et Complements sur le Groupe Orthogonal d'un Espace Euclidien,7,718,4,QCM,0.24,0.51,60.0,39,26,65,63,39,24,1.03,61.9,Facile,Moyen,-1,Plus Difficile,Adapte,Mathematics
4050,2018,Mathématiques,4,Les Espaces Pre-Hilbertiens et Hilbertiens,3,Rappels et Complements sur le Groupe Orthogonal d'un Espace Euclidien,7,718,4,QCM,0.23,0.34,60.0,43,28,71,55,43,12,1.29,78.18,Moyen,Moyen,0,Meme Difficulté,Adapte,Mathematics
5161,2019,Mathématiques,4,Les Espaces Pre-Hilbertiens et Hilbertiens,3,Rappels et Complements sur le Groupe Orthogonal d'un Espace Euclidien,7,718,4,QCM,0.41,0.47,60.0,39,26,65,46,39,7,1.41,84.78,Moyen,Moyen,0,Meme Difficulté,Adapte,Mathematics
6272,2020,Mathématiques,4,Les Espaces Pre-Hilbertiens et Hilbertiens,3,Rappels et Complements sur le Groupe Orthogonal d'un Espace Euclidien,7,718,4,QCM,0.32,0.42,60.0,38,25,63,58,38,20,1.09,65.52,Moyen,Moyen,0,Meme Difficulté,Adapte,Mathematics
718,2015,Mathématiques,4,Les Espaces Pre-Hilbertiens et Hilbertiens,3,Rappels et Complements sur le Groupe Orthogonal d'un Espace Euclidien,7,719,5,QCM,0.59,0.29,17.0,15,73,88,26,15,11,3.38,57.69,Moyen,Difficile,-1,Plus Difficile,Pas Adapte,Mathematics
1829,2016,Mathématiques,4,Les Espaces Pre-Hilbertiens et Hilbertiens,3,Rappels et Complements sur le Groupe Orthogonal d'un Espace Euclidien,7,719,5,QCM,0.67,0.16,35.0,28,52,80,67,28,39,1.19,41.79,Facile,Difficile,-2,Beaucoup plus Difficile,Pas Adapte,Mathematics
2940,2017,Mathématiques,4,Les Espaces Pre-Hilbertiens et Hilbertiens,3,Rappels et Complements sur le Groupe Orthogonal d'un Espace Euclidien,7,719,5,QCM,0.3,0.53,59.0,54,38,92,74,54,20,1.24,72.97,Facile,Moyen,-1,Plus Difficile,Pas Adapte,Mathematics
4051,2018,Mathématiques,4,Les Espaces Pre-Hilbertiens et Hilbertiens,3,Rappels et Complements sur le Groupe Orthogonal d'un Espace Euclidien,7,719,5,QCM,0.59,0.16,21.0,18,70,88,45,18,27,1.96,40.0,Facile,Difficile,-2,Beaucoup plus Difficile,Pas Adapte,Mathematics
5162,2019,Mathématiques,4,Les Espaces Pre-Hilbertiens et Hilbertiens,3,Rappels et Complements sur le Groupe Orthogonal d'un Espace Euclidien,7,719,5,QCM,0.69,0.18,17.0,13,62,75,34,13,21,2.21,38.24,Difficile,Difficile,0,Meme Difficulté,Pas Adapte,Mathematics
6273,2020,Mathématiques,4,Les Espaces Pre-Hilbertiens et Hilbertiens,3,Rappels et Complements sur le Groupe Orthogonal d'un Espace Euclidien,7,719,5,QROC,0.94,0.16,18.0,12,53,65,48,12,36,1.35,25.0,Facile,Difficile,-2,Beaucoup plus Difficile,Pas Adapte,Mathematics
719,2015,Mathématiques,4,Les Espaces Pre-Hilbertiens et Hilbertiens,3,Rappels et Complements sur le Groupe Orthogonal d'un Espace Euclidien,7,720,6,QO,0.83,0.02,35.0,12,21,33,25,12,13,1.32,48.0,Difficile,Difficile,0,Meme Difficulté,Pas Adapte,Mathematics
1830,2016,Mathématiques,4,Les Espaces Pre-Hilbertiens et Hilbertiens,3,Rappels et Complements sur le Groupe Orthogonal d'un Espace Euclidien,7,720,6,QO,0.34,0.19,52.0,16,15,31,22,16,6,1.41,72.73,Difficile,Moyen,1,Plus Facile,Pas Adapte,Mathematics
2941,2017,Mathématiques,4,Les Espaces Pre-Hilbertiens et Hilbertiens,3,Rappels et Complements sur le Groupe Orthogonal d'un Espace Euclidien,7,720,6,QROC,0.65,0.01,35.0,12,23,35,18,12,6,1.94,66.67,Difficile,Difficile,0,Meme Difficulté,Pas Adapte,Mathematics
4052,2018,Mathématiques,4,Les Espaces Pre-Hilbertiens et Hilbertiens,3,Rappels et Complements sur le Groupe Orthogonal d'un Espace Euclidien,7,720,6,QO,0.92,0.09,16.0,5,27,32,28,5,23,1.14,17.86,Difficile,Difficile,0,Meme Difficulté,Pas Adapte,Mathematics
5163,2019,Mathématiques,4,Les Espaces Pre-Hilbertiens et Hilbertiens,3,Rappels et Complements sur le Groupe Orthogonal d'un Espace Euclidien,7,720,6,QO,0.84,0.01,32.0,11,24,35,29,11,18,1.21,37.93,Moyen,Difficile,-1,Plus Difficile,Pas Adapte,Mathematics
6274,2020,Mathématiques,4,Les Espaces Pre-Hilbertiens et Hilbertiens,3,Rappels et Complements sur le Groupe Orthogonal d'un Espace Euclidien,7,720,6,QO,0.78,0.1,34.0,13,24,37,35,13,22,1.06,37.14,Facile,Difficile,-2,Beaucoup plus Difficile,Pas Adapte,Mathematics
720,2015,Mathématiques,4,Les Espaces Pre-Hilbertiens et Hilbertiens,3,Rappels et Complements sur le Groupe Orthogonal d'un Espace Euclidien,7,721,7,QCU,0.36,0.72,45.0,12,14,26,26,12,14,1.0,46.15,Facile,Moyen,-1,Plus Difficile,Pas Adapte,Mathematics
1831,2016,Mathématiques,4,Les Espaces Pre-Hilbertiens et Hilbertiens,3,Rappels et Complements sur le Groupe Orthogonal d'un Espace Euclidien,7,721,7,QCU,0.4,0.28,25.0,6,16,22,12,6,6,1.83,50.0,Difficile,Difficile,0,Meme Difficulté,Pas Adapte,Mathematics
2942,2017,Mathématiques,4,Les Espaces Pre-Hilbertiens et Hilbertiens,3,Rappels et Complements sur le Groupe Orthogonal d'un Espace Euclidien,7,721,7,QCU,0.35,0.58,37.0,9,14,23,17,9,8,1.35,52.94,Moyen,Moyen,0,Meme Difficulté,Pas Adapte,Mathematics
4053,2018,Mathématiques,4,Les Espaces Pre-Hilbertiens et Hilbertiens,3,Rappels et Complements sur le Groupe Orthogonal d'un Espace Euclidien,7,721,7,QCU,0.3,0.58,48.0,12,12,24,24,12,12,1.0,50.0,Facile,Moyen,-1,Plus Difficile,Pas Adapte,Mathematics
5164,2019,Mathématiques,4,Les Espaces Pre-Hilbertiens et Hilbertiens,3,Rappels et Complements sur le Groupe Orthogonal d'un Espace Euclidien,7,721,7,QCU,0.5,0.24,34.0,7,15,22,10,7,3,2.2,70.0,Difficile,Difficile,0,Meme Difficulté,Pas Adapte,Mathematics
6275,2020,Mathématiques,4,Les Espaces Pre-Hilbertiens et Hilbertiens,3,Rappels et Complements sur le Groupe Orthogonal d'un Espace Euclidien,7,721,7,QCU,0.28,0.72,42.0,8,11,19,8,8,0,2.38,100.0,Difficile,Moyen,1,Plus Facile,Pas Adapte,Mathematics
721,2015,Mathématiques,4,Les Espaces Pre-Hilbertiens et Hilbertiens,4,Complement sur les Endomorphismes Autoadjoints d'un Espace Euclidien et les Matrices Symetriques,1,722,1,QCU,0.32,0.57,61.0,53,34,87,54,53,1,1.61,98.15,Moyen,Moyen,0,Meme Difficulté,Adapte,Mathematics
1832,2016,Mathématiques,4,Les Espaces Pre-Hilbertiens et Hilbertiens,4,Complement sur les Endomorphismes Autoadjoints d'un Espace Euclidien et les Matrices Symetriques,1,722,1,QCM,0.29,0.66,61.0,51,33,84,53,51,2,1.58,96.23,Moyen,Moyen,0,Meme Difficulté,Adapte,Mathematics
2943,2017,Mathématiques,4,Les Espaces Pre-Hilbertiens et Hilbertiens,4,Complement sur les Endomorphismes Autoadjoints d'un Espace Euclidien et les Matrices Symetriques,1,722,1,QCM,0.44,0.36,61.0,54,34,88,84,54,30,1.05,64.29,Moyen,Moyen,0,Meme Difficulté,Adapte,Mathematics
4054,2018,Mathématiques,4,Les Espaces Pre-Hilbertiens et Hilbertiens,4,Complement sur les Endomorphismes Autoadjoints d'un Espace Euclidien et les Matrices Symetriques,1,722,1,QCM,0.48,0.39,61.0,56,35,91,90,56,34,1.01,62.22,Moyen,Moyen,0,Meme Difficulté,Adapte,Mathematics
5165,2019,Mathématiques,4,Les Espaces Pre-Hilbertiens et Hilbertiens,4,Complement sur les Endomorphismes Autoadjoints d'un Espace Euclidien et les Matrices Symetriques,1,722,1,QCM,0.33,0.39,61.0,63,40,103,91,63,28,1.13,69.23,Moyen,Moyen,0,Meme Difficulté,Adapte,Mathematics
6276,2020,Mathématiques,4,Les Espaces Pre-Hilbertiens et Hilbertiens,4,Complement sur les Endomorphismes Autoadjoints d'un Espace Euclidien et les Matrices Symetriques,1,722,1,QCM,0.45,0.6,61.0,69,44,113,83,69,14,1.36,83.13,Moyen,Moyen,0,Meme Difficulté,Adapte,Mathematics
722,2015,Mathématiques,5,La Geometrie Analytique,1,Sur l'Utilisation de Maple,12,723,1,QCM,0.63,0.19,28.0,13,35,48,16,13,3,3.0,81.25,Moyen,Difficile,-1,Plus Difficile,Pas Adapte,Mathematics
1833,2016,Mathématiques,5,La Geometrie Analytique,1,Sur l'Utilisation de Maple,12,723,1,QCM,0.55,0.18,35.0,15,29,44,25,15,10,1.76,60.0,Difficile,Difficile,0,Meme Difficulté,Pas Adapte,Mathematics
2944,2017,Mathématiques,5,La Geometrie Analytique,1,Sur l'Utilisation de Maple,12,723,1,QCM,0.76,0.16,30.0,14,32,46,23,14,9,2.0,60.87,Difficile,Difficile,0,Meme Difficulté,Pas Adapte,Mathematics
4055,2018,Mathématiques,5,La Geometrie Analytique,1,Sur l'Utilisation de Maple,12,723,1,QCM,0.39,0.62,45.0,19,24,43,38,19,19,1.13,50.0,Difficile,Moyen,1,Plus Facile,Pas Adapte,Mathematics
5166,2019,Mathématiques,5,La Geometrie Analytique,1,Sur l'Utilisation de Maple,12,723,1,QCM,0.39,0.58,54.0,23,20,43,35,23,12,1.23,65.71,Difficile,Moyen,1,Plus Facile,Pas Adapte,Mathematics
6277,2020,Mathématiques,5,La Geometrie Analytique,1,Sur l'Utilisation de Maple,12,723,1,QCM,0.47,0.59,57.0,26,20,46,31,26,5,1.48,83.87,Facile,Moyen,-1,Plus Difficile,Pas Adapte,Mathematics
723,2015,Mathématiques,5,La Geometrie Analytique,1,Sur l'Utilisation de Maple,12,724,2,QROC,0.26,0.32,49.0,10,10,20,10,10,0,2.0,100.0,Facile,Moyen,-1,Plus Difficile,Pas Adapte,Mathematics
1834,2016,Mathématiques,5,La Geometrie Analytique,1,Sur l'Utilisation de Maple,12,724,2,QROC,0.27,0.27,42.0,9,12,21,10,9,1,2.1,90.0,Difficile,Moyen,1,Plus Facile,Pas Adapte,Mathematics
2945,2017,Mathématiques,5,La Geometrie Analytique,1,Sur l'Utilisation de Maple,12,724,2,QROC,0.64,0.04,9.0,2,18,20,18,2,16,1.11,11.11,Facile,Difficile,-2,Beaucoup plus Difficile,Pas Adapte,Mathematics
4056,2018,Mathématiques,5,La Geometrie Analytique,1,Sur l'Utilisation de Maple,12,724,2,QROC,0.49,0.36,43.0,10,13,23,12,10,2,1.92,83.33,Facile,Moyen,-1,Plus Difficile,Pas Adapte,Mathematics
5167,2019,Mathématiques,5,La Geometrie Analytique,1,Sur l'Utilisation de Maple,12,724,2,QROC,0.96,0.18,10.0,2,21,23,20,2,18,1.15,10.0,Facile,Difficile,-2,Beaucoup plus Difficile,Pas Adapte,Mathematics
6278,2020,Mathématiques,5,La Geometrie Analytique,1,Sur l'Utilisation de Maple,12,724,2,QROC,0.55,0.29,46.0,11,12,23,18,11,7,1.28,61.11,Difficile,Moyen,1,Plus Facile,Pas Adapte,Mathematics
724,2015,Mathématiques,5,La Geometrie Analytique,1,Sur l'Utilisation de Maple,12,725,3,QCU,0.72,0.3,35.0,6,11,17,6,6,0,2.83,100.0,Facile,Difficile,-2,Beaucoup plus Difficile,Pas Adapte,Mathematics
1835,2016,Mathématiques,5,La Geometrie Analytique,1,Sur l'Utilisation de Maple,12,725,3,QCM,0.24,0.5,60.0,9,6,15,14,9,5,1.07,64.29,Facile,Moyen,-1,Plus Difficile,Adapte,Mathematics
2946,2017,Mathématiques,5,La Geometrie Analytique,1,Sur l'Utilisation de Maple,12,725,3,QO,0.71,0.26,60.0,10,6,16,15,10,5,1.07,66.67,Moyen,Moyen,0,Meme Difficulté,Adapte,Mathematics
4057,2018,Mathématiques,5,La Geometrie Analytique,1,Sur l'Utilisation de Maple,12,725,3,QO,0.37,0.21,60.0,10,6,16,11,10,1,1.45,90.91,Moyen,Moyen,0,Meme Difficulté,Adapte,Mathematics
5168,2019,Mathématiques,5,La Geometrie Analytique,1,Sur l'Utilisation de Maple,12,725,3,QO,0.39,0.28,60.0,9,6,15,14,9,5,1.07,64.29,Moyen,Moyen,0,Meme Difficulté,Adapte,Mathematics
6279,2020,Mathématiques,5,La Geometrie Analytique,1,Sur l'Utilisation de Maple,12,725,3,QO,0.56,0.15,60.0,10,6,16,14,10,4,1.14,71.43,Moyen,Moyen,0,Meme Difficulté,Adapte,Mathematics
725,2015,Mathématiques,5,La Geometrie Analytique,1,Sur l'Utilisation de Maple,12,726,4,QCM,0.79,0.22,25.0,18,52,70,29,18,11,2.41,62.07,Facile,Difficile,-2,Beaucoup plus Difficile,Pas Adapte,Mathematics
1836,2016,Mathématiques,5,La Geometrie Analytique,1,Sur l'Utilisation de Maple,12,726,4,QCM,0.61,0.23,20.0,12,48,60,40,12,28,1.5,30.0,Moyen,Difficile,-1,Plus Difficile,Pas Adapte,Mathematics
2947,2017,Mathématiques,5,La Geometrie Analytique,1,Sur l'Utilisation de Maple,12,726,4,QCM,0.55,0.23,18.0,11,50,61,25,11,14,2.44,44.0,Facile,Difficile,-2,Beaucoup plus Difficile,Pas Adapte,Mathematics
4058,2018,Mathématiques,5,La Geometrie Analytique,1,Sur l'Utilisation de Maple,12,726,4,QCM,0.61,0.25,21.0,12,43,55,22,12,10,2.5,54.55,Moyen,Difficile,-1,Plus Difficile,Pas Adapte,Mathematics
5169,2019,Mathématiques,5,La Geometrie Analytique,1,Sur l'Utilisation de Maple,12,726,4,QCU,0.37,0.61,39.0,22,35,57,36,22,14,1.58,61.11,Difficile,Moyen,1,Plus Facile,Pas Adapte,Mathematics
6280,2020,Mathématiques,5,La Geometrie Analytique,1,Sur l'Utilisation de Maple,12,726,4,QO,0.78,0.08,11.0,6,49,55,39,6,33,1.41,15.38,Difficile,Difficile,0,Meme Difficulté,Pas Adapte,Mathematics
726,2015,Mathématiques,5,La Geometrie Analytique,1,Sur l'Utilisation de Maple,12,727,5,QCU,0.42,0.32,27.0,22,58,80,69,22,47,1.16,31.88,Facile,Difficile,-2,Beaucoup plus Difficile,Pas Adapte,Mathematics
1837,2016,Mathématiques,5,La Geometrie Analytique,1,Sur l'Utilisation de Maple,12,727,5,QCU,0.38,0.7,56.0,49,39,88,65,49,16,1.35,75.38,Difficile,Moyen,1,Plus Facile,Pas Adapte,Mathematics
2948,2017,Mathématiques,5,La Geometrie Analytique,1,Sur l'Utilisation de Maple,12,727,5,QCU,0.29,0.44,36.0,33,60,93,66,33,33,1.41,50.0,Facile,Moyen,-1,Plus Difficile,Pas Adapte,Mathematics
4059,2018,Mathématiques,5,La Geometrie Analytique,1,Sur l'Utilisation de Maple,12,727,5,QCU,0.51,0.37,28.0,29,74,103,65,29,36,1.58,44.62,Facile,Difficile,-2,Beaucoup plus Difficile,Pas Adapte,Mathematics
5170,2019,Mathématiques,5,La Geometrie Analytique,1,Sur l'Utilisation de Maple,12,727,5,QCM,0.66,0.29,23.0,23,78,101,73,23,50,1.38,31.51,Difficile,Difficile,0,Meme Difficulté,Pas Adapte,Mathematics
6281,2020,Mathématiques,5,La Geometrie Analytique,1,Sur l'Utilisation de Maple,12,727,5,QCM,0.75,0.26,8.0,8,96,104,48,8,40,2.17,16.67,Difficile,Difficile,0,Meme Difficulté,Pas Adapte,Mathematics
727,2015,Mathématiques,5,La Geometrie Analytique,1,Sur l'Utilisation de Maple,12,728,6,QCU,0.25,0.75,37.0,34,58,92,54,34,20,1.7,62.96,Difficile,Moyen,1,Plus Facile,Pas Adapte,Mathematics
1838,2016,Mathématiques,5,La Geometrie Analytique,1,Sur l'Utilisation de Maple,12,728,6,QCU,0.56,0.38,13.0,14,92,106,88,14,74,1.2,15.91,Facile,Difficile,-2,Beaucoup plus Difficile,Pas Adapte,Mathematics
2949,2017,Mathématiques,5,La Geometrie Analytique,1,Sur l'Utilisation de Maple,12,728,6,QCU,0.6,0.26,16.0,19,102,121,118,19,99,1.03,16.1,Facile,Difficile,-2,Beaucoup plus Difficile,Pas Adapte,Mathematics
4060,2018,Mathématiques,5,La Geometrie Analytique,1,Sur l'Utilisation de Maple,12,728,6,QCM,0.6,0.16,3.0,4,120,124,107,4,103,1.16,3.74,Facile,Difficile,-2,Beaucoup plus Difficile,Pas Adapte,Mathematics
5171,2019,Mathématiques,5,La Geometrie Analytique,1,Sur l'Utilisation de Maple,12,728,6,QCM,0.63,0.21,17.0,20,99,119,84,20,64,1.42,23.81,Difficile,Difficile,0,Meme Difficulté,Pas Adapte,Mathematics
6282,2020,Mathématiques,5,La Geometrie Analytique,1,Sur l'Utilisation de Maple,12,728,6,QCM,0.32,0.33,60.0,82,55,137,127,82,45,1.08,64.57,Facile,Moyen,-1,Plus Difficile,Adapte,Mathematics
728,2015,Mathématiques,5,La Geometrie Analytique,1,Sur l'Utilisation de Maple,12,729,7,QCU,0.71,0.39,31.0,18,39,57,50,18,32,1.14,36.0,Facile,Difficile,-2,Beaucoup plus Difficile,Pas Adapte,Mathematics
1839,2016,Mathématiques,5,La Geometrie Analytique,1,Sur l'Utilisation de Maple,12,729,7,QROC,0.81,0.12,33.0,21,43,64,55,21,34,1.16,38.18,Moyen,Difficile,-1,Plus Difficile,Pas Adapte,Mathematics
2950,2017,Mathématiques,5,La Geometrie Analytique,1,Sur l'Utilisation de Maple,12,729,7,QCM,0.77,0.17,6.0,4,60,64,29,4,25,2.21,13.79,Moyen,Difficile,-1,Plus Difficile,Pas Adapte,Mathematics
4061,2018,Mathématiques,5,La Geometrie Analytique,1,Sur l'Utilisation de Maple,12,729,7,QCM,0.78,0.22,14.0,9,56,65,48,9,39,1.35,18.75,Difficile,Difficile,0,Meme Difficulté,Pas Adapte,Mathematics
5172,2019,Mathématiques,5,La Geometrie Analytique,1,Sur l'Utilisation de Maple,12,729,7,QCM,0.59,0.27,8.0,5,56,61,30,5,25,2.03,16.67,Facile,Difficile,-2,Beaucoup plus Difficile,Pas Adapte,Mathematics
6283,2020,Mathématiques,5,La Geometrie Analytique,1,Sur l'Utilisation de Maple,12,729,7,QCM,0.35,0.62,43.0,25,34,59,39,25,14,1.51,64.1,Moyen,Moyen,0,Meme Difficulté,Pas Adapte,Mathematics
729,2015,Mathématiques,5,La Geometrie Analytique,1,Sur l'Utilisation de Maple,12,730,8,QROC,0.47,0.33,43.0,3,5,8,8,3,5,1.0,37.5,Moyen,Moyen,0,Meme Difficulté,Pas Adapte,Mathematics
1840,2016,Mathématiques,5,La Geometrie Analytique,1,Sur l'Utilisation de Maple,12,730,8,QROC,0.63,0.04,29.0,3,6,9,6,3,3,1.5,50.0,Difficile,Difficile,0,Meme Difficulté,Pas Adapte,Mathematics
2951,2017,Mathématiques,5,La Geometrie Analytique,1,Sur l'Utilisation de Maple,12,730,8,QROC,0.9,0.23,23.0,2,7,9,9,2,7,1.0,22.22,Difficile,Difficile,0,Meme Difficulté,Pas Adapte,Mathematics
4062,2018,Mathématiques,5,La Geometrie Analytique,1,Sur l'Utilisation de Maple,12,730,8,QROC,0.92,0.1,32.0,3,6,9,5,3,2,1.8,60.0,Difficile,Difficile,0,Meme Difficulté,Pas Adapte,Mathematics
5173,2019,Mathématiques,5,La Geometrie Analytique,1,Sur l'Utilisation de Maple,12,730,8,QROC,0.28,0.36,43.0,4,6,10,6,4,2,1.67,66.67,Difficile,Moyen,1,Plus Facile,Pas Adapte,Mathematics
6284,2020,Mathématiques,5,La Geometrie Analytique,1,Sur l'Utilisation de Maple,12,730,8,QROC,0.36,0.36,54.0,4,4,8,4,4,0,2.0,100.0,Difficile,Moyen,1,Plus Facile,Pas Adapte,Mathematics
730,2015,Mathématiques,5,La Geometrie Analytique,1,Sur l'Utilisation de Maple,12,731,9,QCM,0.32,0.54,57.0,47,36,83,73,47,26,1.14,64.38,Difficile,Moyen,1,Plus Facile,Pas Adapte,Mathematics
1841,2016,Mathématiques,5,La Geometrie Analytique,1,Sur l'Utilisation de Maple,12,731,9,QCM,0.4,0.53,55.0,43,36,79,68,43,25,1.16,63.24,Moyen,Moyen,0,Meme Difficulté,Pas Adapte,Mathematics
2952,2017,Mathématiques,5,La Geometrie Analytique,1,Sur l'Utilisation de Maple,12,731,9,QCM,0.62,0.2,32.0,26,56,82,64,26,38,1.28,40.62,Facile,Difficile,-2,Beaucoup plus Difficile,Pas Adapte,Mathematics
4063,2018,Mathématiques,5,La Geometrie Analytique,1,Sur l'Utilisation de Maple,12,731,9,QCM,0.55,0.21,20.0,15,60,75,57,15,42,1.32,26.32,Facile,Difficile,-2,Beaucoup plus Difficile,Pas Adapte,Mathematics
5174,2019,Mathématiques,5,La Geometrie Analytique,1,Sur l'Utilisation de Maple,12,731,9,QCM,0.32,0.51,63.0,46,27,73,66,46,20,1.11,69.7,Difficile,Moyen,1,Plus Facile,Adapte,Mathematics
6285,2020,Mathématiques,5,La Geometrie Analytique,1,Sur l'Utilisation de Maple,12,731,9,QCM,0.49,0.49,63.0,49,29,78,78,49,29,1.0,62.82,Moyen,Moyen,0,Meme Difficulté,Adapte,Mathematics
731,2015,Mathématiques,5,La Geometrie Analytique,1,Sur l'Utilisation de Maple,12,732,10,QCU,0.2,0.84,65.0,60,33,93,79,60,19,1.18,75.95,Moyen,Facile,1,Plus Facile,Adapte,Mathematics
1842,2016,Mathématiques,5,La Geometrie Analytique,1,Sur l'Utilisation de Maple,12,732,10,QCU,0.19,0.81,65.0,69,37,106,91,69,22,1.16,75.82,Facile,Facile,0,Meme Difficulté,Adapte,Mathematics
2953,2017,Mathématiques,5,La Geometrie Analytique,1,Sur l'Utilisation de Maple,12,732,10,QCU,0.03,0.82,65.0,66,36,102,83,66,17,1.23,79.52,Facile,Facile,0,Meme Difficulté,Adapte,Mathematics
4064,2018,Mathématiques,5,La Geometrie Analytique,1,Sur l'Utilisation de Maple,12,732,10,QCU,0.16,0.83,65.0,69,37,106,70,69,1,1.51,98.57,Facile,Facile,0,Meme Difficulté,Adapte,Mathematics
5175,2019,Mathématiques,5,La Geometrie Analytique,1,Sur l'Utilisation de Maple,12,732,10,QCU,0.16,0.85,65.0,64,35,99,89,64,25,1.11,71.91,Facile,Facile,0,Meme Difficulté,Adapte,Mathematics
6286,2020,Mathématiques,5,La Geometrie Analytique,1,Sur l'Utilisation de Maple,12,732,10,QCU,0.16,0.9,65.0,66,35,101,85,66,19,1.19,77.65,Facile,Facile,0,Meme Difficulté,Adapte,Mathematics
732,2015,Mathématiques,5,La Geometrie Analytique,1,Sur l'Utilisation de Maple,12,733,11,QCU,0.52,0.28,26.0,14,41,55,54,14,40,1.02,25.93,Facile,Difficile,-2,Beaucoup plus Difficile,Pas Adapte,Mathematics
1843,2016,Mathématiques,5,La Geometrie Analytique,1,Sur l'Utilisation de Maple,12,733,11,QCM,0.54,0.24,7.0,4,58,62,48,4,44,1.29,8.33,Difficile,Difficile,0,Meme Difficulté,Pas Adapte,Mathematics
2954,2017,Mathématiques,5,La Geometrie Analytique,1,Sur l'Utilisation de Maple,12,733,11,QCM,0.67,0.28,4.0,2,56,58,40,2,38,1.45,5.0,Facile,Difficile,-2,Beaucoup plus Difficile,Pas Adapte,Mathematics
4065,2018,Mathématiques,5,La Geometrie Analytique,1,Sur l'Utilisation de Maple,12,733,11,QCM,0.37,0.47,40.0,20,29,49,32,20,12,1.53,62.5,Moyen,Moyen,0,Meme Difficulté,Pas Adapte,Mathematics
5176,2019,Mathématiques,5,La Geometrie Analytique,1,Sur l'Utilisation de Maple,12,733,11,QCU,0.57,0.3,5.0,3,49,52,47,3,44,1.11,6.38,Difficile,Difficile,0,Meme Difficulté,Pas Adapte,Mathematics
6287,2020,Mathématiques,5,La Geometrie Analytique,1,Sur l'Utilisation de Maple,12,733,11,QCU,0.25,0.61,40.0,21,31,52,52,21,31,1.0,40.38,Difficile,Moyen,1,Plus Facile,Pas Adapte,Mathematics
733,2015,Mathématiques,5,La Geometrie Analytique,1,Sur l'Utilisation de Maple,12,734,12,QROC,0.71,0.22,15.0,3,18,21,21,3,18,1.0,14.29,Facile,Difficile,-2,Beaucoup plus Difficile,Pas Adapte,Mathematics
1844,2016,Mathématiques,5,La Geometrie Analytique,1,Sur l'Utilisation de Maple,12,734,12,QROC,0.91,0.22,28.0,6,14,20,18,6,12,1.11,33.33,Difficile,Difficile,0,Meme Difficulté,Pas Adapte,Mathematics
2955,2017,Mathématiques,5,La Geometrie Analytique,1,Sur l'Utilisation de Maple,12,734,12,QROC,0.88,0.21,33.0,6,12,18,17,6,11,1.06,35.29,Facile,Difficile,-2,Beaucoup plus Difficile,Pas Adapte,Mathematics
4066,2018,Mathématiques,5,La Geometrie Analytique,1,Sur l'Utilisation de Maple,12,734,12,QROC,0.99,0.05,27.0,5,14,19,9,5,4,2.11,55.56,Moyen,Difficile,-1,Plus Difficile,Pas Adapte,Mathematics
5177,2019,Mathématiques,5,La Geometrie Analytique,1,Sur l'Utilisation de Maple,12,734,12,QROC,0.27,0.26,49.0,10,10,20,20,10,10,1.0,50.0,Difficile,Moyen,1,Plus Facile,Pas Adapte,Mathematics
6288,2020,Mathématiques,5,La Geometrie Analytique,1,Sur l'Utilisation de Maple,12,734,12,QROC,0.64,0.17,0.0,0,22,22,17,0,17,1.29,0.0,Moyen,Difficile,-1,Plus Difficile,Pas Adapte,Mathematics
734,2015,Mathématiques,5,La Geometrie Analytique,2,Methodes Generales pour aborder un probleme de Geometrie Analytique,1,735,1,QCM,0.59,0.21,1.0,1,68,69,50,1,49,1.38,2.0,Moyen,Difficile,-1,Plus Difficile,Pas Adapte,Mathematics
1845,2016,Mathématiques,5,La Geometrie Analytique,2,Methodes Generales pour aborder un probleme de Geometrie Analytique,1,735,1,QCM,0.74,0.27,5.0,3,57,60,20,3,17,3.0,15.0,Facile,Difficile,-2,Beaucoup plus Difficile,Pas Adapte,Mathematics
2956,2017,Mathématiques,5,La Geometrie Analytique,2,Methodes Generales pour aborder un probleme de Geometrie Analytique,1,735,1,QCM,0.53,0.22,1.0,1,55,56,37,1,36,1.51,2.7,Facile,Difficile,-2,Beaucoup plus Difficile,Pas Adapte,Mathematics
4067,2018,Mathématiques,5,La Geometrie Analytique,2,Methodes Generales pour aborder un probleme de Geometrie Analytique,1,735,1,QCM,0.2,0.68,49.0,25,26,51,26,25,1,1.96,96.15,Facile,Moyen,-1,Plus Difficile,Pas Adapte,Mathematics
5178,2019,Mathématiques,5,La Geometrie Analytique,2,Methodes Generales pour aborder un probleme de Geometrie Analytique,1,735,1,QCM,0.51,0.19,23.0,12,38,50,44,12,32,1.14,27.27,Facile,Difficile,-2,Beaucoup plus Difficile,Pas Adapte,Mathematics
6289,2020,Mathématiques,5,La Geometrie Analytique,2,Methodes Generales pour aborder un probleme de Geometrie Analytique,1,735,1,QCM,0.3,0.56,53.0,23,21,44,24,23,1,1.83,95.83,Difficile,Moyen,1,Plus Facile,Pas Adapte,Mathematics
735,2015,Mathématiques,5,La Geometrie Analytique,3,Geometrie Plane,9,736,1,QCM,0.56,0.29,6.0,3,49,52,18,3,15,2.89,16.67,Difficile,Difficile,0,Meme Difficulté,Pas Adapte,Mathematics
1846,2016,Mathématiques,5,La Geometrie Analytique,3,Geometrie Plane,9,736,1,QCM,0.45,0.7,52.0,26,24,50,34,26,8,1.47,76.47,Facile,Moyen,-1,Plus Difficile,Pas Adapte,Mathematics
2957,2017,Mathématiques,5,La Geometrie Analytique,3,Geometrie Plane,9,736,1,QCM,0.4,0.35,36.0,19,35,54,53,19,34,1.02,35.85,Facile,Moyen,-1,Plus Difficile,Pas Adapte,Mathematics
4068,2018,Mathématiques,5,La Geometrie Analytique,3,Geometrie Plane,9,736,1,QCM,0.35,0.66,61.0,34,22,56,36,34,2,1.56,94.44,Moyen,Moyen,0,Meme Difficulté,Adapte,Mathematics
5179,2019,Mathématiques,5,La Geometrie Analytique,3,Geometrie Plane,9,736,1,QCM,0.4,0.53,61.0,35,22,57,37,35,2,1.54,94.59,Moyen,Moyen,0,Meme Difficulté,Adapte,Mathematics
6290,2020,Mathématiques,5,La Geometrie Analytique,3,Geometrie Plane,9,736,1,QCM,0.46,0.47,61.0,35,22,57,53,35,18,1.08,66.04,Moyen,Moyen,0,Meme Difficulté,Adapte,Mathematics
736,2015,Mathématiques,5,La Geometrie Analytique,3,Geometrie Plane,9,737,2,QCM,0.28,0.44,58.0,32,23,55,40,32,8,1.38,80.0,Difficile,Moyen,1,Plus Facile,Pas Adapte,Mathematics
1847,2016,Mathématiques,5,La Geometrie Analytique,3,Geometrie Plane,9,737,2,QCM,0.68,0.23,1.0,1,53,54,42,1,41,1.29,2.38,Facile,Difficile,-2,Beaucoup plus Difficile,Pas Adapte,Mathematics
2958,2017,Mathématiques,5,La Geometrie Analytique,3,Geometrie Plane,9,737,2,QCM,0.34,0.64,53.0,28,25,53,41,28,13,1.29,68.29,Facile,Moyen,-1,Plus Difficile,Pas Adapte,Mathematics
4069,2018,Mathématiques,5,La Geometrie Analytique,3,Geometrie Plane,9,737,2,QCM,0.6,0.22,5.0,3,51,54,37,3,34,1.46,8.11,Facile,Difficile,-2,Beaucoup plus Difficile,Pas Adapte,Mathematics
5180,2019,Mathématiques,5,La Geometrie Analytique,3,Geometrie Plane,9,737,2,QCM,0.73,0.23,16.0,8,39,47,47,8,39,1.0,17.02,Difficile,Difficile,0,Meme Difficulté,Pas Adapte,Mathematics
6291,2020,Mathématiques,5,La Geometrie Analytique,3,Geometrie Plane,9,737,2,QCM,0.7,0.24,27.0,11,30,41,23,11,12,1.78,47.83,Difficile,Difficile,0,Meme Difficulté,Pas Adapte,Mathematics
737,2015,Mathématiques,5,La Geometrie Analytique,3,Geometrie Plane,9,738,3,QCU,0.37,0.41,47.0,44,49,93,82,44,38,1.13,53.66,Facile,Moyen,-1,Plus Difficile,Pas Adapte,Mathematics
1848,2016,Mathématiques,5,La Geometrie Analytique,3,Geometrie Plane,9,738,3,QCU,0.23,0.51,37.0,39,66,105,83,39,44,1.27,46.99,Difficile,Moyen,1,Plus Facile,Pas Adapte,Mathematics
2959,2017,Mathématiques,5,La Geometrie Analytique,3,Geometrie Plane,9,738,3,QCU,0.58,0.27,12.0,11,78,89,54,11,43,1.65,20.37,Difficile,Difficile,0,Meme Difficulté,Pas Adapte,Mathematics
4070,2018,Mathématiques,5,La Geometrie Analytique,3,Geometrie Plane,9,738,3,QCU,0.36,0.72,38.0,31,51,82,66,31,35,1.24,46.97,Difficile,Moyen,1,Plus Facile,Pas Adapte,Mathematics
5181,2019,Mathématiques,5,La Geometrie Analytique,3,Geometrie Plane,9,738,3,QCU,0.36,0.54,64.0,49,28,77,64,49,15,1.2,76.56,Moyen,Moyen,0,Meme Difficulté,Adapte,Mathematics
6292,2020,Mathématiques,5,La Geometrie Analytique,3,Geometrie Plane,9,738,3,QCU,0.24,0.58,64.0,53,30,83,63,53,10,1.32,84.13,Moyen,Moyen,0,Meme Difficulté,Adapte,Mathematics
738,2015,Mathématiques,5,La Geometrie Analytique,3,Geometrie Plane,9,739,4,QCU,0.28,0.67,64.0,56,31,87,59,56,3,1.47,94.92,Moyen,Moyen,0,Meme Difficulté,Adapte,Mathematics
1849,2016,Mathématiques,5,La Geometrie Analytique,3,Geometrie Plane,9,739,4,QCU,0.26,0.74,64.0,59,33,92,59,59,0,1.56,100.0,Moyen,Moyen,0,Meme Difficulté,Adapte,Mathematics
2960,2017,Mathématiques,5,La Geometrie Analytique,3,Geometrie Plane,9,739,4,QCU,0.29,0.47,64.0,67,37,104,90,67,23,1.16,74.44,Moyen,Moyen,0,Meme Difficulté,Adapte,Mathematics
4071,2018,Mathématiques,5,La Geometrie Analytique,3,Geometrie Plane,9,739,4,QCU,0.31,0.46,64.0,63,35,98,83,63,20,1.18,75.9,Moyen,Moyen,0,Meme Difficulté,Adapte,Mathematics
5182,2019,Mathématiques,5,La Geometrie Analytique,3,Geometrie Plane,9,739,4,QCU,0.35,0.68,64.0,58,32,90,66,58,8,1.36,87.88,Moyen,Moyen,0,Meme Difficulté,Adapte,Mathematics
6293,2020,Mathématiques,5,La Geometrie Analytique,3,Geometrie Plane,9,739,4,QCU,0.35,0.44,64.0,58,32,90,76,58,18,1.18,76.32,Moyen,Moyen,0,Meme Difficulté,Adapte,Mathematics
739,2015,Mathématiques,5,La Geometrie Analytique,3,Geometrie Plane,9,740,5,QCM,0.39,0.4,55.0,51,42,93,78,51,27,1.19,65.38,Difficile,Moyen,1,Plus Facile,Pas Adapte,Mathematics
1850,2016,Mathématiques,5,La Geometrie Analytique,3,Geometrie Plane,9,740,5,QCM,0.65,0.23,16.0,16,85,101,96,16,80,1.05,16.67,Facile,Difficile,-2,Beaucoup plus Difficile,Pas Adapte,Mathematics
2961,2017,Mathématiques,5,La Geometrie Analytique,3,Geometrie Plane,9,740,5,QCM,0.3,0.51,59.0,60,41,101,68,60,8,1.49,88.24,Moyen,Moyen,0,Meme Difficulté,Pas Adapte,Mathematics
4072,2018,Mathématiques,5,La Geometrie Analytique,3,Geometrie Plane,9,740,5,QCM,0.45,0.5,60.0,66,44,110,79,66,13,1.39,83.54,Facile,Moyen,-1,Plus Difficile,Adapte,Mathematics
5183,2019,Mathématiques,5,La Geometrie Analytique,3,Geometrie Plane,9,740,5,QCM,0.24,0.59,60.0,67,45,112,100,67,33,1.12,67.0,Moyen,Moyen,0,Meme Difficulté,Adapte,Mathematics
6294,2020,Mathématiques,5,La Geometrie Analytique,3,Geometrie Plane,9,740,5,QCM,0.32,0.42,60.0,64,43,107,66,64,2,1.62,96.97,Moyen,Moyen,0,Meme Difficulté,Adapte,Mathematics
740,2015,Mathématiques,5,La Geometrie Analytique,3,Geometrie Plane,9,741,6,QCU,0.39,0.74,54.0,46,40,86,72,46,26,1.19,63.89,Difficile,Moyen,1,Plus Facile,Pas Adapte,Mathematics
1851,2016,Mathématiques,5,La Geometrie Analytique,3,Geometrie Plane,9,741,6,QCU,0.64,0.36,11.0,9,76,85,83,9,74,1.02,10.84,Facile,Difficile,-2,Beaucoup plus Difficile,Pas Adapte,Mathematics
2962,2017,Mathématiques,5,La Geometrie Analytique,3,Geometrie Plane,9,741,6,QCU,0.22,0.67,62.0,59,36,95,59,59,0,1.61,100.0,Moyen,Moyen,0,Meme Difficulté,Adapte,Mathematics
4073,2018,Mathématiques,5,La Geometrie Analytique,3,Geometrie Plane,9,741,6,QCU,0.28,0.63,62.0,56,34,90,66,56,10,1.36,84.85,Moyen,Moyen,0,Meme Difficulté,Adapte,Mathematics
5184,2019,Mathématiques,5,La Geometrie Analytique,3,Geometrie Plane,9,741,6,QCU,0.22,0.54,62.0,51,32,83,82,51,31,1.01,62.2,Moyen,Moyen,0,Meme Difficulté,Adapte,Mathematics
6295,2020,Mathématiques,5,La Geometrie Analytique,3,Geometrie Plane,9,741,6,QCU,0.29,0.54,62.0,48,30,78,65,48,17,1.2,73.85,Moyen,Moyen,0,Meme Difficulté,Adapte,Mathematics
741,2015,Mathématiques,5,La Geometrie Analytique,3,Geometrie Plane,9,742,7,QCU,0.72,0.35,21.0,19,72,91,63,19,44,1.44,30.16,Facile,Difficile,-2,Beaucoup plus Difficile,Pas Adapte,Mathematics
1852,2016,Mathématiques,5,La Geometrie Analytique,3,Geometrie Plane,9,742,7,QCU,0.32,0.41,51.0,46,45,91,85,46,39,1.07,54.12,Moyen,Moyen,0,Meme Difficulté,Pas Adapte,Mathematics
2963,2017,Mathématiques,5,La Geometrie Analytique,3,Geometrie Plane,9,742,7,QCU,0.3,0.69,46.0,40,46,86,40,40,0,2.15,100.0,Facile,Moyen,-1,Plus Difficile,Pas Adapte,Mathematics
4074,2018,Mathématiques,5,La Geometrie Analytique,3,Geometrie Plane,9,742,7,QCM,0.25,0.58,40.0,35,53,88,62,35,27,1.42,56.45,Difficile,Moyen,1,Plus Facile,Pas Adapte,Mathematics
5185,2019,Mathématiques,5,La Geometrie Analytique,3,Geometrie Plane,9,742,7,QCM,0.51,0.15,34.0,34,66,100,91,34,57,1.1,37.36,Moyen,Difficile,-1,Plus Difficile,Pas Adapte,Mathematics
6296,2020,Mathématiques,5,La Geometrie Analytique,3,Geometrie Plane,9,742,7,QCM,0.42,0.36,46.0,50,58,108,106,50,56,1.02,47.17,Difficile,Moyen,1,Plus Facile,Pas Adapte,Mathematics
742,2015,Mathématiques,5,La Geometrie Analytique,3,Geometrie Plane,9,743,8,QCM,0.29,0.32,45.0,14,18,32,22,14,8,1.45,63.64,Difficile,Moyen,1,Plus Facile,Pas Adapte,Mathematics
1853,2016,Mathématiques,5,La Geometrie Analytique,3,Geometrie Plane,9,743,8,QCM,0.19,0.95,65.0,21,11,32,25,21,4,1.28,84.0,Facile,Facile,0,Meme Difficulté,Adapte,Mathematics
2964,2017,Mathématiques,5,La Geometrie Analytique,3,Geometrie Plane,9,743,8,QCM,0.07,0.98,65.0,23,13,36,27,23,4,1.33,85.19,Facile,Facile,0,Meme Difficulté,Adapte,Mathematics
4075,2018,Mathématiques,5,La Geometrie Analytique,3,Geometrie Plane,9,743,8,QCM,0.01,0.8,65.0,25,14,39,30,25,5,1.3,83.33,Facile,Facile,0,Meme Difficulté,Adapte,Mathematics
5186,2019,Mathématiques,5,La Geometrie Analytique,3,Geometrie Plane,9,743,8,QCM,0.16,0.95,65.0,22,12,34,31,22,9,1.1,70.97,Facile,Facile,0,Meme Difficulté,Adapte,Mathematics
6297,2020,Mathématiques,5,La Geometrie Analytique,3,Geometrie Plane,9,743,8,QCM,0.02,0.93,65.0,23,12,35,35,23,12,1.0,65.71,Facile,Facile,0,Meme Difficulté,Adapte,Mathematics
743,2015,Mathématiques,5,La Geometrie Analytique,3,Geometrie Plane,9,744,9,QCU,0.63,0.27,7.0,3,39,42,21,3,18,2.0,14.29,Difficile,Difficile,0,Meme Difficulté,Pas Adapte,Mathematics
1854,2016,Mathématiques,5,La Geometrie Analytique,3,Geometrie Plane,9,744,9,QCM,0.24,0.34,39.0,16,24,40,24,16,8,1.67,66.67,Difficile,Moyen,1,Plus Facile,Pas Adapte,Mathematics
2965,2017,Mathématiques,5,La Geometrie Analytique,3,Geometrie Plane,9,744,9,QCU,0.55,0.27,33.0,12,23,35,22,12,10,1.59,54.55,Difficile,Difficile,0,Meme Difficulté,Pas Adapte,Mathematics
4076,2018,Mathématiques,5,La Geometrie Analytique,3,Geometrie Plane,9,744,9,QCU,0.63,0.4,29.0,10,24,34,18,10,8,1.89,55.56,Moyen,Difficile,-1,Plus Difficile,Pas Adapte,Mathematics
5187,2019,Mathématiques,5,La Geometrie Analytique,3,Geometrie Plane,9,744,9,QCM,0.35,0.46,63.0,25,14,39,39,25,14,1.0,64.1,Difficile,Moyen,1,Plus Facile,Adapte,Mathematics
6298,2020,Mathématiques,5,La Geometrie Analytique,3,Geometrie Plane,9,744,9,QCM,0.29,0.67,63.0,21,13,34,34,21,13,1.0,61.76,Moyen,Moyen,0,Meme Difficulté,Adapte,Mathematics
744,2015,Philosophie,1,Introduction a la Philosophie,1,La Nature,12,745,1,QCU,0.06,0.98,66.93,54,27,81,62,54,8,1.31,87.1,Facile,Facile,0,Meme Difficulté,Adapte,Philosophy
1855,2016,Philosophie,1,Introduction a la Philosophie,1,La Nature,12,745,1,QCU,0.06,0.79,66.93,57,28,85,70,57,13,1.21,81.43,Facile,Facile,0,Meme Difficulté,Adapte,Philosophy
2966,2017,Philosophie,1,Introduction a la Philosophie,1,La Nature,12,745,1,QCU,0.19,0.94,66.93,59,29,88,70,59,11,1.26,84.29,Facile,Facile,0,Meme Difficulté,Adapte,Philosophy
4077,2018,Philosophie,1,Introduction a la Philosophie,1,La Nature,12,745,1,QO,0.18,0.39,66.93,57,28,85,76,57,19,1.12,75.0,Facile,Facile,0,Meme Difficulté,Adapte,Philosophy
5188,2019,Philosophie,1,Introduction a la Philosophie,1,La Nature,12,745,1,QO,0.03,0.39,66.93,64,32,96,66,64,2,1.45,96.97,Facile,Facile,0,Meme Difficulté,Adapte,Philosophy
6299,2020,Philosophie,1,Introduction a la Philosophie,1,La Nature,12,745,1,QROC,0.15,0.53,66.93,67,33,100,86,67,19,1.16,77.91,Facile,Facile,0,Meme Difficulté,Adapte,Philosophy
745,2015,Philosophie,1,Introduction a la Philosophie,1,La Nature,12,746,2,QCM,0.13,0.99,74.71,66,23,89,67,66,1,1.33,98.51,Facile,Facile,0,Meme Difficulté,Adapte,Philosophy
1856,2016,Philosophie,1,Introduction a la Philosophie,1,La Nature,12,746,2,QCU,0.02,0.8,74.71,61,20,81,77,61,16,1.05,79.22,Facile,Facile,0,Meme Difficulté,Adapte,Philosophy
2967,2017,Philosophie,1,Introduction a la Philosophie,1,La Nature,12,746,2,QCU,0.12,0.77,74.71,64,21,85,66,64,2,1.29,96.97,Facile,Facile,0,Meme Difficulté,Adapte,Philosophy
4078,2018,Philosophie,1,Introduction a la Philosophie,1,La Nature,12,746,2,QCM,0.09,0.71,74.71,70,24,94,90,70,20,1.04,77.78,Facile,Facile,0,Meme Difficulté,Adapte,Philosophy
5189,2019,Philosophie,1,Introduction a la Philosophie,1,La Nature,12,746,2,QCM,0.13,0.79,74.71,71,24,95,79,71,8,1.2,89.87,Facile,Facile,0,Meme Difficulté,Adapte,Philosophy
6300,2020,Philosophie,1,Introduction a la Philosophie,1,La Nature,12,746,2,QCM,0.2,0.87,74.71,66,22,88,67,66,1,1.31,98.51,Facile,Facile,0,Meme Difficulté,Adapte,Philosophy
746,2015,Philosophie,1,Introduction a la Philosophie,1,La Nature,12,747,3,QCU,0.28,0.43,36.13,25,45,70,29,25,4,2.41,86.21,Facile,Moyen,-1,Plus Difficile,Pas Adapte,Philosophy
1857,2016,Philosophie,1,Introduction a la Philosophie,1,La Nature,12,747,3,QCU,0.01,0.9,96.5,59,2,61,61,59,2,1.0,96.72,Difficile,Facile,2,Beaucoup plus Facile,Pas Adapte,Philosophy
2968,2017,Philosophie,1,Introduction a la Philosophie,1,La Nature,12,747,3,QCM,0.52,0.17,30.33,16,37,53,46,16,30,1.15,34.78,Moyen,Difficile,-1,Plus Difficile,Pas Adapte,Philosophy
4079,2018,Philosophie,1,Introduction a la Philosophie,1,La Nature,12,747,3,QCM,0.01,0.74,75.54,40,13,53,47,40,7,1.13,85.11,Facile,Facile,0,Meme Difficulté,Pas Adapte,Philosophy
5190,2019,Philosophie,1,Introduction a la Philosophie,1,La Nature,12,747,3,QCM,0.27,0.6,55.21,34,27,61,57,34,23,1.07,59.65,Facile,Moyen,-1,Plus Difficile,Pas Adapte,Philosophy
6301,2020,Philosophie,1,Introduction a la Philosophie,1,La Nature,12,747,3,QCM,0.5,0.29,34.81,19,35,54,51,19,32,1.06,37.25,Moyen,Difficile,-1,Plus Difficile,Pas Adapte,Philosophy
747,2015,Philosophie,1,Introduction a la Philosophie,1,La Nature,12,748,4,QROC,0.03,0.57,70.12,69,30,99,91,69,22,1.09,75.82,Moyen,Facile,1,Plus Facile,Adapte,Philosophy
1858,2016,Philosophie,1,Introduction a la Philosophie,1,La Nature,12,748,4,QROC,0.16,0.76,70.12,61,26,87,72,61,11,1.21,84.72,Facile,Facile,0,Meme Difficulté,Adapte,Philosophy
2969,2017,Philosophie,1,Introduction a la Philosophie,1,La Nature,12,748,4,QROC,0.18,0.65,70.12,57,25,82,69,57,12,1.19,82.61,Facile,Facile,0,Meme Difficulté,Adapte,Philosophy
4080,2018,Philosophie,1,Introduction a la Philosophie,1,La Nature,12,748,4,QROC,0.18,0.99,70.12,65,27,92,91,65,26,1.01,71.43,Facile,Facile,0,Meme Difficulté,Adapte,Philosophy
5191,2019,Philosophie,1,Introduction a la Philosophie,1,La Nature,12,748,4,QROC,0.02,0.55,70.12,59,25,84,72,59,13,1.17,81.94,Facile,Facile,0,Meme Difficulté,Adapte,Philosophy
6302,2020,Philosophie,1,Introduction a la Philosophie,1,La Nature,12,748,4,QROC,0.1,0.49,70.12,55,24,79,56,55,1,1.41,98.21,Facile,Facile,0,Meme Difficulté,Adapte,Philosophy
748,2015,Philosophie,1,Introduction a la Philosophie,1,La Nature,12,749,5,QCM,0.66,0.2,21.32,7,25,32,16,7,9,2.0,43.75,Facile,Difficile,-2,Beaucoup plus Difficile,Pas Adapte,Philosophy
1859,2016,Philosophie,1,Introduction a la Philosophie,1,La Nature,12,749,5,QCM,0.12,0.79,67.54,24,12,36,36,24,12,1.0,66.67,Moyen,Facile,1,Plus Facile,Adapte,Philosophy
2970,2017,Philosophie,1,Introduction a la Philosophie,1,La Nature,12,749,5,QCM,0.2,0.79,67.54,23,11,34,26,23,3,1.31,88.46,Facile,Facile,0,Meme Difficulté,Adapte,Philosophy
4081,2018,Philosophie,1,Introduction a la Philosophie,1,La Nature,12,749,5,QCM,0.05,0.94,67.54,22,10,32,22,22,0,1.45,100.0,Facile,Facile,0,Meme Difficulté,Adapte,Philosophy
5192,2019,Philosophie,1,Introduction a la Philosophie,1,La Nature,12,749,5,QCM,0.14,0.89,67.54,22,10,32,32,22,10,1.0,68.75,Facile,Facile,0,Meme Difficulté,Adapte,Philosophy
6303,2020,Philosophie,1,Introduction a la Philosophie,1,La Nature,12,749,5,QCM,0.1,0.95,67.54,22,11,33,23,22,1,1.43,95.65,Facile,Facile,0,Meme Difficulté,Adapte,Philosophy
749,2015,Philosophie,1,Introduction a la Philosophie,1,La Nature,12,750,6,QCM,0.07,0.95,82.25,65,14,79,66,65,1,1.2,98.48,Moyen,Facile,1,Plus Facile,Pas Adapte,Philosophy
1860,2016,Philosophie,1,Introduction a la Philosophie,1,La Nature,12,750,6,QCM,0.13,0.85,91.78,63,6,69,63,63,0,1.1,100.0,Difficile,Facile,2,Beaucoup plus Facile,Pas Adapte,Philosophy
2971,2017,Philosophie,1,Introduction a la Philosophie,1,La Nature,12,750,6,QCM,0.62,0.19,7.92,5,64,69,28,5,23,2.46,17.86,Moyen,Difficile,-1,Plus Difficile,Pas Adapte,Philosophy
4082,2018,Philosophie,1,Introduction a la Philosophie,1,La Nature,12,750,6,QCM,0.75,0.16,22.28,13,46,59,35,13,22,1.69,37.14,Facile,Difficile,-2,Beaucoup plus Difficile,Pas Adapte,Philosophy
5193,2019,Philosophie,1,Introduction a la Philosophie,1,La Nature,12,750,6,QCM,0.01,0.82,65.36,36,19,55,45,36,9,1.22,80.0,Facile,Facile,0,Meme Difficulté,Adapte,Philosophy
6304,2020,Philosophie,1,Introduction a la Philosophie,1,La Nature,12,750,6,QCU,0.17,0.89,65.36,41,22,63,53,41,12,1.19,77.36,Facile,Facile,0,Meme Difficulté,Adapte,Philosophy
750,2015,Philosophie,1,Introduction a la Philosophie,1,La Nature,12,751,7,QROC,0.01,0.48,94.87,70,4,74,71,70,1,1.04,98.59,Facile,Facile,0,Meme Difficulté,Pas Adapte,Philosophy
1861,2016,Philosophie,1,Introduction a la Philosophie,1,La Nature,12,751,7,QROC,0.12,0.83,83.64,65,13,78,72,65,7,1.08,90.28,Difficile,Facile,2,Beaucoup plus Facile,Pas Adapte,Philosophy
2972,2017,Philosophie,1,Introduction a la Philosophie,1,La Nature,12,751,7,QROC,0.78,0.15,5.02,4,71,75,34,4,30,2.21,11.76,Moyen,Difficile,-1,Plus Difficile,Pas Adapte,Philosophy
4083,2018,Philosophie,1,Introduction a la Philosophie,1,La Nature,12,751,7,QROC,0.04,0.58,97.75,63,1,64,64,63,1,1.0,98.44,Difficile,Facile,2,Beaucoup plus Facile,Pas Adapte,Philosophy
5194,2019,Philosophie,1,Introduction a la Philosophie,1,La Nature,12,751,7,QROC,0.2,0.67,69.13,40,18,58,44,40,4,1.32,90.91,Moyen,Facile,1,Plus Facile,Adapte,Philosophy
6305,2020,Philosophie,1,Introduction a la Philosophie,1,La Nature,12,751,7,QROC,0.05,0.72,69.13,37,16,53,43,37,6,1.23,86.05,Facile,Facile,0,Meme Difficulté,Adapte,Philosophy
751,2015,Philosophie,1,Introduction a la Philosophie,1,La Nature,12,752,8,QCU,0.28,0.51,56.95,23,17,40,33,23,10,1.21,69.7,Difficile,Moyen,1,Plus Facile,Pas Adapte,Philosophy
1862,2016,Philosophie,1,Introduction a la Philosophie,1,La Nature,12,752,8,QCU,0.3,0.49,41.43,19,26,45,32,19,13,1.41,59.38,Difficile,Moyen,1,Plus Facile,Pas Adapte,Philosophy
2973,2017,Philosophie,1,Introduction a la Philosophie,1,La Nature,12,752,8,QCM,0.54,0.22,11.64,5,41,46,38,5,33,1.21,13.16,Facile,Difficile,-2,Beaucoup plus Difficile,Pas Adapte,Philosophy
4084,2018,Philosophie,1,Introduction a la Philosophie,1,La Nature,12,752,8,QCM,0.22,0.34,38.49,17,27,44,19,17,2,2.32,89.47,Difficile,Moyen,1,Plus Facile,Pas Adapte,Philosophy
5195,2019,Philosophie,1,Introduction a la Philosophie,1,La Nature,12,752,8,QCM,0.15,0.74,69.64,31,14,45,42,31,11,1.07,73.81,Moyen,Facile,1,Plus Facile,Adapte,Philosophy
6306,2020,Philosophie,1,Introduction a la Philosophie,1,La Nature,12,752,8,QCM,0.02,0.79,69.64,33,14,47,47,33,14,1.0,70.21,Facile,Facile,0,Meme Difficulté,Adapte,Philosophy
752,2015,Philosophie,1,Introduction a la Philosophie,1,La Nature,12,753,9,QROC,0.11,0.44,72.34,38,15,53,38,38,0,1.39,100.0,Difficile,Facile,2,Beaucoup plus Facile,Adapte,Philosophy
1863,2016,Philosophie,1,Introduction a la Philosophie,1,La Nature,12,753,9,QROC,0.04,0.85,72.34,39,15,54,43,39,4,1.26,90.7,Facile,Facile,0,Meme Difficulté,Adapte,Philosophy
2974,2017,Philosophie,1,Introduction a la Philosophie,1,La Nature,12,753,9,QROC,0.06,0.47,72.34,41,16,57,50,41,9,1.14,82.0,Facile,Facile,0,Meme Difficulté,Adapte,Philosophy
4085,2018,Philosophie,1,Introduction a la Philosophie,1,La Nature,12,753,9,QROC,0.1,0.93,72.34,47,18,65,47,47,0,1.38,100.0,Facile,Facile,0,Meme Difficulté,Adapte,Philosophy
5196,2019,Philosophie,1,Introduction a la Philosophie,1,La Nature,12,753,9,QROC,0.05,0.73,72.34,45,17,62,56,45,11,1.11,80.36,Facile,Facile,0,Meme Difficulté,Adapte,Philosophy
6307,2020,Philosophie,1,Introduction a la Philosophie,1,La Nature,12,753,9,QROC,0.08,0.96,72.34,44,17,61,46,44,2,1.33,95.65,Facile,Facile,0,Meme Difficulté,Adapte,Philosophy
753,2015,Philosophie,1,Introduction a la Philosophie,1,La Nature,12,754,10,QCM,0.72,0.18,15.19,12,66,78,32,12,20,2.44,37.5,Facile,Difficile,-2,Beaucoup plus Difficile,Pas Adapte,Philosophy
1864,2016,Philosophie,1,Introduction a la Philosophie,1,La Nature,12,754,10,QCM,0.15,0.83,68.98,61,27,88,84,61,23,1.05,72.62,Difficile,Facile,2,Beaucoup plus Facile,Adapte,Philosophy
2975,2017,Philosophie,1,Introduction a la Philosophie,1,La Nature,12,754,10,QCM,0.12,0.83,68.98,56,25,81,69,56,13,1.17,81.16,Facile,Facile,0,Meme Difficulté,Adapte,Philosophy
4086,2018,Philosophie,1,Introduction a la Philosophie,1,La Nature,12,754,10,QCU,0.11,0.85,68.98,55,25,80,67,55,12,1.19,82.09,Facile,Facile,0,Meme Difficulté,Adapte,Philosophy
5197,2019,Philosophie,1,Introduction a la Philosophie,1,La Nature,12,754,10,QCU,0.05,0.94,68.98,50,22,72,69,50,19,1.04,72.46,Facile,Facile,0,Meme Difficulté,Adapte,Philosophy
6308,2020,Philosophie,1,Introduction a la Philosophie,1,La Nature,12,754,10,QCU,0.13,0.84,68.98,48,21,69,53,48,5,1.3,90.57,Facile,Facile,0,Meme Difficulté,Adapte,Philosophy
754,2015,Philosophie,1,Introduction a la Philosophie,1,La Nature,12,755,11,QCM,0.45,0.39,46.59,20,22,42,37,20,17,1.14,54.05,Difficile,Moyen,1,Plus Facile,Pas Adapte,Philosophy
1865,2016,Philosophie,1,Introduction a la Philosophie,1,La Nature,12,755,11,QCM,0.5,0.27,16.68,8,40,48,23,8,15,2.09,34.78,Moyen,Difficile,-1,Plus Difficile,Pas Adapte,Philosophy
2976,2017,Philosophie,1,Introduction a la Philosophie,1,La Nature,12,755,11,QCM,0.51,0.18,28.27,13,34,47,46,13,33,1.02,28.26,Difficile,Difficile,0,Meme Difficulté,Pas Adapte,Philosophy
4087,2018,Philosophie,1,Introduction a la Philosophie,1,La Nature,12,755,11,QCM,0.18,0.82,85.88,34,6,40,36,34,2,1.11,94.44,Facile,Facile,0,Meme Difficulté,Pas Adapte,Philosophy
5198,2019,Philosophie,1,Introduction a la Philosophie,1,La Nature,12,755,11,QCM,0.67,0.17,7.15,3,35,38,10,3,7,3.8,30.0,Facile,Difficile,-2,Beaucoup plus Difficile,Pas Adapte,Philosophy
6309,2020,Philosophie,1,Introduction a la Philosophie,1,La Nature,12,755,11,QCU,0.32,0.68,46.39,15,17,32,29,15,14,1.1,51.72,Moyen,Moyen,0,Meme Difficulté,Pas Adapte,Philosophy
755,2015,Philosophie,1,Introduction a la Philosophie,1,La Nature,12,756,12,QCU,0.45,0.36,25.34,11,32,43,31,11,20,1.39,35.48,Facile,Difficile,-2,Beaucoup plus Difficile,Pas Adapte,Philosophy
1866,2016,Philosophie,1,Introduction a la Philosophie,1,La Nature,12,756,12,QCU,0.55,0.38,0.73,0,47,47,45,0,45,1.04,0.0,Moyen,Difficile,-1,Plus Difficile,Pas Adapte,Philosophy
2977,2017,Philosophie,1,Introduction a la Philosophie,1,La Nature,12,756,12,QROC,0.52,0.28,49.61,23,23,46,36,23,13,1.28,63.89,Facile,Moyen,-1,Plus Difficile,Pas Adapte,Philosophy
4088,2018,Philosophie,1,Introduction a la Philosophie,1,La Nature,12,756,12,QROC,0.28,0.34,56.55,29,23,52,31,29,2,1.68,93.55,Difficile,Moyen,1,Plus Facile,Pas Adapte,Philosophy
5199,2019,Philosophie,1,Introduction a la Philosophie,1,La Nature,12,756,12,QO,0.08,0.72,84.53,48,9,57,53,48,5,1.08,90.57,Moyen,Facile,1,Plus Facile,Pas Adapte,Philosophy
6310,2020,Philosophie,1,Introduction a la Philosophie,1,La Nature,12,756,12,QO,0.93,0.02,11.87,6,43,49,39,6,33,1.26,15.38,Facile,Difficile,-2,Beaucoup plus Difficile,Pas Adapte,Philosophy
756,2015,Philosophie,1,Introduction a la Philosophie,2,La Technique,12,757,1,QCU,0.04,0.77,72.8,68,25,93,70,68,2,1.33,97.14,Moyen,Facile,1,Plus Facile,Adapte,Philosophy
1867,2016,Philosophie,1,Introduction a la Philosophie,2,La Technique,12,757,1,QCU,0.13,0.96,72.8,62,23,85,76,62,14,1.12,81.58,Facile,Facile,0,Meme Difficulté,Adapte,Philosophy
2978,2017,Philosophie,1,Introduction a la Philosophie,2,La Technique,12,757,1,QCU,0.16,0.85,72.8,56,21,77,58,56,2,1.33,96.55,Facile,Facile,0,Meme Difficulté,Adapte,Philosophy
4089,2018,Philosophie,1,Introduction a la Philosophie,2,La Technique,12,757,1,QCM,0.1,0.88,72.8,58,21,79,72,58,14,1.1,80.56,Facile,Facile,0,Meme Difficulté,Adapte,Philosophy
5200,2019,Philosophie,1,Introduction a la Philosophie,2,La Technique,12,757,1,QCM,0.13,0.89,72.8,58,21,79,63,58,5,1.25,92.06,Facile,Facile,0,Meme Difficulté,Adapte,Philosophy
6311,2020,Philosophie,1,Introduction a la Philosophie,2,La Technique,12,757,1,QCM,0.2,0.9,72.8,50,18,68,61,50,11,1.11,81.97,Facile,Facile,0,Meme Difficulté,Adapte,Philosophy
757,2015,Philosophie,1,Introduction a la Philosophie,2,La Technique,12,758,2,QCM,0.17,0.75,83.72,82,16,98,86,82,4,1.14,95.35,Facile,Facile,0,Meme Difficulté,Pas Adapte,Philosophy
1868,2016,Philosophie,1,Introduction a la Philosophie,2,La Technique,12,758,2,QCM,0.09,0.86,65.66,62,33,95,78,62,16,1.22,79.49,Difficile,Facile,2,Beaucoup plus Facile,Adapte,Philosophy
2979,2017,Philosophie,1,Introduction a la Philosophie,2,La Technique,12,758,2,QCM,0.15,0.86,65.66,62,33,95,73,62,11,1.3,84.93,Facile,Facile,0,Meme Difficulté,Adapte,Philosophy
4090,2018,Philosophie,1,Introduction a la Philosophie,2,La Technique,12,758,2,QCM,0.01,0.86,65.66,62,33,95,80,62,18,1.19,77.5,Facile,Facile,0,Meme Difficulté,Adapte,Philosophy
5201,2019,Philosophie,1,Introduction a la Philosophie,2,La Technique,12,758,2,QCM,0.19,0.96,65.66,66,34,100,70,66,4,1.43,94.29,Facile,Facile,0,Meme Difficulté,Adapte,Philosophy
6312,2020,Philosophie,1,Introduction a la Philosophie,2,La Technique,12,758,2,QCM,0.09,0.8,65.66,74,39,113,107,74,33,1.06,69.16,Facile,Facile,0,Meme Difficulté,Adapte,Philosophy
758,2015,Philosophie,1,Introduction a la Philosophie,2,La Technique,12,759,3,QO,0.79,0.11,20.8,6,24,30,16,6,10,1.88,37.5,Facile,Difficile,-2,Beaucoup plus Difficile,Pas Adapte,Philosophy
1869,2016,Philosophie,1,Introduction a la Philosophie,2,La Technique,12,759,3,QO,0.23,0.21,52.64,17,15,32,29,17,12,1.1,58.62,Moyen,Moyen,0,Meme Difficulté,Pas Adapte,Philosophy
2980,2017,Philosophie,1,Introduction a la Philosophie,2,La Technique,12,759,3,QO,0.32,0.27,42.62,14,19,33,33,14,19,1.0,42.42,Moyen,Moyen,0,Meme Difficulté,Pas Adapte,Philosophy
4091,2018,Philosophie,1,Introduction a la Philosophie,2,La Technique,12,759,3,QO,0.84,0.08,27.61,8,20,28,14,8,6,2.0,57.14,Facile,Difficile,-2,Beaucoup plus Difficile,Pas Adapte,Philosophy
5202,2019,Philosophie,1,Introduction a la Philosophie,2,La Technique,12,759,3,QCM,0.17,0.84,84.56,25,4,29,27,25,2,1.07,92.59,Difficile,Facile,2,Beaucoup plus Facile,Pas Adapte,Philosophy
6313,2020,Philosophie,1,Introduction a la Philosophie,2,La Technique,12,759,3,QCM,0.11,0.99,79.34,23,6,29,27,23,4,1.07,85.19,Difficile,Facile,2,Beaucoup plus Facile,Pas Adapte,Philosophy
759,2015,Philosophie,1,Introduction a la Philosophie,2,La Technique,12,760,4,QCM,0.74,0.17,13.72,13,81,94,52,13,39,1.81,25.0,Facile,Difficile,-2,Beaucoup plus Difficile,Pas Adapte,Philosophy
1870,2016,Philosophie,1,Introduction a la Philosophie,2,La Technique,12,760,4,QCM,0.66,0.29,2.82,2,81,83,34,2,32,2.44,5.88,Moyen,Difficile,-1,Plus Difficile,Pas Adapte,Philosophy
2981,2017,Philosophie,1,Introduction a la Philosophie,2,La Technique,12,760,4,QROC,0.7,0.13,34.33,30,57,87,86,30,56,1.01,34.88,Difficile,Difficile,0,Meme Difficulté,Pas Adapte,Philosophy
4092,2018,Philosophie,1,Introduction a la Philosophie,2,La Technique,12,760,4,QROC,0.51,0.26,35.78,29,53,82,42,29,13,1.95,69.05,Moyen,Moyen,0,Meme Difficulté,Pas Adapte,Philosophy
5203,2019,Philosophie,1,Introduction a la Philosophie,2,La Technique,12,760,4,QROC,0.27,0.33,36.1,31,54,85,44,31,13,1.93,70.45,Moyen,Moyen,0,Meme Difficulté,Pas Adapte,Philosophy
6314,2020,Philosophie,1,Introduction a la Philosophie,2,La Technique,12,760,4,QCU,0.62,0.25,10.79,8,70,78,56,8,48,1.39,14.29,Difficile,Difficile,0,Meme Difficulté,Pas Adapte,Philosophy
760,2015,Philosophie,1,Introduction a la Philosophie,2,La Technique,12,761,5,QCU,0.58,0.3,26.73,16,44,60,51,16,35,1.18,31.37,Facile,Difficile,-2,Beaucoup plus Difficile,Pas Adapte,Philosophy
1871,2016,Philosophie,1,Introduction a la Philosophie,2,La Technique,12,761,5,QROC,0.83,0.1,5.24,3,51,54,50,3,47,1.08,6.0,Difficile,Difficile,0,Meme Difficulté,Pas Adapte,Philosophy
2982,2017,Philosophie,1,Introduction a la Philosophie,2,La Technique,12,761,5,QCM,0.36,0.7,51.64,32,29,61,55,32,23,1.11,58.18,Difficile,Moyen,1,Plus Facile,Pas Adapte,Philosophy
4093,2018,Philosophie,1,Introduction a la Philosophie,2,La Technique,12,761,5,QCM,0.45,0.36,35.5,24,45,69,38,24,14,1.82,63.16,Facile,Moyen,-1,Plus Difficile,Pas Adapte,Philosophy
5204,2019,Philosophie,1,Introduction a la Philosophie,2,La Technique,12,761,5,QCM,0.02,0.9,73.79,57,20,77,65,57,8,1.18,87.69,Difficile,Facile,2,Beaucoup plus Facile,Adapte,Philosophy
6315,2020,Philosophie,1,Introduction a la Philosophie,2,La Technique,12,761,5,QCM,0.13,0.79,73.79,54,19,73,55,54,1,1.33,98.18,Facile,Facile,0,Meme Difficulté,Adapte,Philosophy
761,2015,Philosophie,1,Introduction a la Philosophie,2,La Technique,12,762,6,QO,0.44,0.17,59.44,48,33,81,54,48,6,1.5,88.89,Facile,Moyen,-1,Plus Difficile,Pas Adapte,Philosophy
1872,2016,Philosophie,1,Introduction a la Philosophie,2,La Technique,12,762,6,QO,0.91,0.06,19.78,17,69,86,57,17,40,1.51,29.82,Moyen,Difficile,-1,Plus Difficile,Pas Adapte,Philosophy
2983,2017,Philosophie,1,Introduction a la Philosophie,2,La Technique,12,762,6,QO,0.61,0.18,53.51,40,35,75,62,40,22,1.21,64.52,Difficile,Moyen,1,Plus Facile,Pas Adapte,Philosophy
4094,2018,Philosophie,1,Introduction a la Philosophie,2,La Technique,12,762,6,QO,0.78,0.08,14.76,11,61,72,59,11,48,1.22,18.64,Facile,Difficile,-2,Beaucoup plus Difficile,Pas Adapte,Philosophy
5205,2019,Philosophie,1,Introduction a la Philosophie,2,La Technique,12,762,6,QO,0.85,0.06,32.55,21,44,65,53,21,32,1.23,39.62,Facile,Difficile,-2,Beaucoup plus Difficile,Pas Adapte,Philosophy
6316,2020,Philosophie,1,Introduction a la Philosophie,2,La Technique,12,762,6,QO,0.07,0.57,69.63,47,21,68,51,47,4,1.33,92.16,Difficile,Facile,2,Beaucoup plus Facile,Adapte,Philosophy
762,2015,Philosophie,1,Introduction a la Philosophie,2,La Technique,12,763,7,QCU,0.02,0.78,91.02,67,7,74,73,67,6,1.01,91.78,Moyen,Facile,1,Plus Facile,Pas Adapte,Philosophy
1873,2016,Philosophie,1,Introduction a la Philosophie,2,La Technique,12,763,7,QCU,0.55,0.27,3.01,2,76,78,38,2,36,2.05,5.26,Facile,Difficile,-2,Beaucoup plus Difficile,Pas Adapte,Philosophy
2984,2017,Philosophie,1,Introduction a la Philosophie,2,La Technique,12,763,7,QCU,0.74,0.35,0.93,1,71,72,59,1,58,1.22,1.69,Moyen,Difficile,-1,Plus Difficile,Pas Adapte,Philosophy
4095,2018,Philosophie,1,Introduction a la Philosophie,2,La Technique,12,763,7,QCM,0.03,0.83,69.75,52,23,75,66,52,14,1.14,78.79,Moyen,Facile,1,Plus Facile,Adapte,Philosophy
5206,2019,Philosophie,1,Introduction a la Philosophie,2,La Technique,12,763,7,QCM,0.16,0.88,69.75,48,21,69,51,48,3,1.35,94.12,Facile,Facile,0,Meme Difficulté,Adapte,Philosophy
6317,2020,Philosophie,1,Introduction a la Philosophie,2,La Technique,12,763,7,QCM,0.11,0.97,69.75,51,22,73,70,51,19,1.04,72.86,Facile,Facile,0,Meme Difficulté,Adapte,Philosophy
763,2015,Philosophie,1,Introduction a la Philosophie,2,La Technique,12,764,8,QCM,0.26,0.32,62.27,6,4,10,9,6,3,1.11,66.67,Facile,Moyen,-1,Plus Difficile,Adapte,Philosophy
1874,2016,Philosophie,1,Introduction a la Philosophie,2,La Technique,12,764,8,QCM,0.41,0.34,62.27,7,4,11,8,7,1,1.38,87.5,Moyen,Moyen,0,Meme Difficulté,Adapte,Philosophy
2985,2017,Philosophie,1,Introduction a la Philosophie,2,La Technique,12,764,8,QCM,0.3,0.48,62.27,6,3,9,6,6,0,1.5,100.0,Moyen,Moyen,0,Meme Difficulté,Adapte,Philosophy
4096,2018,Philosophie,1,Introduction a la Philosophie,2,La Technique,12,764,8,QCM,0.47,0.32,62.27,5,3,8,8,5,3,1.0,62.5,Moyen,Moyen,0,Meme Difficulté,Adapte,Philosophy
5207,2019,Philosophie,1,Introduction a la Philosophie,2,La Technique,12,764,8,QCM,0.5,0.67,62.27,5,3,8,7,5,2,1.14,71.43,Moyen,Moyen,0,Meme Difficulté,Adapte,Philosophy
6318,2020,Philosophie,1,Introduction a la Philosophie,2,La Technique,12,764,8,QCM,0.36,0.35,62.27,4,3,7,5,4,1,1.4,80.0,Moyen,Moyen,0,Meme Difficulté,Adapte,Philosophy
764,2015,Philosophie,1,Introduction a la Philosophie,2,La Technique,12,765,9,QCU,0.35,0.52,61.04,7,4,11,7,7,0,1.57,100.0,Facile,Moyen,-1,Plus Difficile,Adapte,Philosophy
1875,2016,Philosophie,1,Introduction a la Philosophie,2,La Technique,12,765,9,QCU,0.27,0.45,61.04,7,5,12,9,7,2,1.33,77.78,Moyen,Moyen,0,Meme Difficulté,Adapte,Philosophy
2986,2017,Philosophie,1,Introduction a la Philosophie,2,La Technique,12,765,9,QCU,0.25,0.62,61.04,8,5,13,12,8,4,1.08,66.67,Moyen,Moyen,0,Meme Difficulté,Adapte,Philosophy
4097,2018,Philosophie,1,Introduction a la Philosophie,2,La Technique,12,765,9,QCU,0.26,0.45,61.04,9,5,14,12,9,3,1.17,75.0,Moyen,Moyen,0,Meme Difficulté,Adapte,Philosophy
5208,2019,Philosophie,1,Introduction a la Philosophie,2,La Technique,12,765,9,QCU,0.29,0.51,61.04,9,6,15,11,9,2,1.36,81.82,Moyen,Moyen,0,Meme Difficulté,Adapte,Philosophy
6319,2020,Philosophie,1,Introduction a la Philosophie,2,La Technique,12,765,9,QCU,0.22,0.46,61.04,10,6,16,13,10,3,1.23,76.92,Moyen,Moyen,0,Meme Difficulté,Adapte,Philosophy
765,2015,Philosophie,1,Introduction a la Philosophie,2,La Technique,12,766,10,QROC,0.64,0.17,23.81,19,59,78,52,19,33,1.5,36.54,Facile,Difficile,-2,Beaucoup plus Difficile,Pas Adapte,Philosophy
1876,2016,Philosophie,1,Introduction a la Philosophie,2,La Technique,12,766,10,QROC,0.69,0.06,30.86,21,46,67,58,21,37,1.16,36.21,Difficile,Difficile,0,Meme Difficulté,Pas Adapte,Philosophy
2987,2017,Philosophie,1,Introduction a la Philosophie,2,La Technique,12,766,10,QCM,0.42,0.53,63.27,41,24,65,43,41,2,1.51,95.35,Difficile,Moyen,1,Plus Facile,Adapte,Philosophy
4098,2018,Philosophie,1,Introduction a la Philosophie,2,La Technique,12,766,10,QCM,0.45,0.66,63.27,35,20,55,46,35,11,1.2,76.09,Moyen,Moyen,0,Meme Difficulté,Adapte,Philosophy
5209,2019,Philosophie,1,Introduction a la Philosophie,2,La Technique,12,766,10,QCM,0.23,0.58,63.27,39,23,62,61,39,22,1.02,63.93,Moyen,Moyen,0,Meme Difficulté,Adapte,Philosophy
6320,2020,Philosophie,1,Introduction a la Philosophie,2,La Technique,12,766,10,QCM,0.21,0.43,63.27,35,20,55,50,35,15,1.1,70.0,Moyen,Moyen,0,Meme Difficulté,Adapte,Philosophy
766,2015,Philosophie,1,Introduction a la Philosophie,2,La Technique,12,767,11,QCM,0.79,0.29,23.17,14,46,60,19,14,5,3.16,73.68,Moyen,Difficile,-1,Plus Difficile,Pas Adapte,Philosophy
1877,2016,Philosophie,1,Introduction a la Philosophie,2,La Technique,12,767,11,QCM,0.62,0.17,16.35,9,49,58,49,9,40,1.18,18.37,Difficile,Difficile,0,Meme Difficulté,Pas Adapte,Philosophy
2988,2017,Philosophie,1,Introduction a la Philosophie,2,La Technique,12,767,11,QCU,0.25,0.48,45.61,30,35,65,34,30,4,1.91,88.24,Moyen,Moyen,0,Meme Difficulté,Pas Adapte,Philosophy
4099,2018,Philosophie,1,Introduction a la Philosophie,2,La Technique,12,767,11,QCM,0.62,0.24,29.73,21,48,69,64,21,43,1.08,32.81,Facile,Difficile,-2,Beaucoup plus Difficile,Pas Adapte,Philosophy
5210,2019,Philosophie,1,Introduction a la Philosophie,2,La Technique,12,767,11,QCM,0.01,0.72,70.79,42,17,59,46,42,4,1.28,91.3,Difficile,Facile,2,Beaucoup plus Facile,Adapte,Philosophy
6321,2020,Philosophie,1,Introduction a la Philosophie,2,La Technique,12,767,11,QCM,0.06,0.91,70.79,40,16,56,53,40,13,1.06,75.47,Facile,Facile,0,Meme Difficulté,Adapte,Philosophy
767,2015,Philosophie,1,Introduction a la Philosophie,2,La Technique,12,768,12,QCU,0.09,0.78,77.23,10,3,13,13,10,3,1.0,76.92,Moyen,Facile,1,Plus Facile,Pas Adapte,Philosophy
1878,2016,Philosophie,1,Introduction a la Philosophie,2,La Technique,12,768,12,QCU,0.26,0.69,58.93,8,6,14,11,8,3,1.27,72.73,Moyen,Moyen,0,Meme Difficulté,Pas Adapte,Philosophy
2989,2017,Philosophie,1,Introduction a la Philosophie,2,La Technique,12,768,12,QCM,0.6,0.29,29.26,4,11,15,6,4,2,2.5,66.67,Moyen,Difficile,-1,Plus Difficile,Pas Adapte,Philosophy
4100,2018,Philosophie,1,Introduction a la Philosophie,2,La Technique,12,768,12,QCM,0.58,0.3,1.78,0,17,17,17,0,17,1.0,0.0,Difficile,Difficile,0,Meme Difficulté,Pas Adapte,Philosophy
5211,2019,Philosophie,1,Introduction a la Philosophie,2,La Technique,12,768,12,QROC,0.8,0.15,28.74,4,11,15,7,4,3,2.14,57.14,Difficile,Difficile,0,Meme Difficulté,Pas Adapte,Philosophy
6322,2020,Philosophie,1,Introduction a la Philosophie,2,La Technique,12,768,12,QO,0.2,0.6,70.61,12,5,17,17,12,5,1.0,70.59,Facile,Facile,0,Meme Difficulté,Adapte,Philosophy
768,2015,Philosophie,1,Introduction a la Philosophie,3,L'Oeuvre d'Art,5,769,1,QCU,0.21,0.45,48.72,21,23,44,32,21,11,1.38,65.62,Facile,Moyen,-1,Plus Difficile,Pas Adapte,Philosophy
1879,2016,Philosophie,1,Introduction a la Philosophie,3,L'Oeuvre d'Art,5,769,1,QCU,0.29,0.7,44.78,23,28,51,35,23,12,1.46,65.71,Facile,Moyen,-1,Plus Difficile,Pas Adapte,Philosophy
2990,2017,Philosophie,1,Introduction a la Philosophie,3,L'Oeuvre d'Art,5,769,1,QCU,0.4,0.48,52.44,30,28,58,35,30,5,1.66,85.71,Difficile,Moyen,1,Plus Facile,Pas Adapte,Philosophy
4101,2018,Philosophie,1,Introduction a la Philosophie,3,L'Oeuvre d'Art,5,769,1,QCU,0.46,0.21,24.79,14,44,58,51,14,37,1.14,27.45,Facile,Difficile,-2,Beaucoup plus Difficile,Pas Adapte,Philosophy
5212,2019,Philosophie,1,Introduction a la Philosophie,3,L'Oeuvre d'Art,5,769,1,QCM,0.14,0.72,79.16,39,10,49,40,39,1,1.23,97.5,Difficile,Facile,2,Beaucoup plus Facile,Pas Adapte,Philosophy
6323,2020,Philosophie,1,Introduction a la Philosophie,3,L'Oeuvre d'Art,5,769,1,QCM,0.02,0.72,85.47,48,8,56,49,48,1,1.14,97.96,Moyen,Facile,1,Plus Facile,Pas Adapte,Philosophy
769,2015,Philosophie,1,Introduction a la Philosophie,3,L'Oeuvre d'Art,5,770,2,QROC,0.38,0.27,50.85,27,27,54,50,27,23,1.08,54.0,Difficile,Moyen,1,Plus Facile,Pas Adapte,Philosophy
1880,2016,Philosophie,1,Introduction a la Philosophie,3,L'Oeuvre d'Art,5,770,2,QROC,0.73,0.22,34.16,20,40,60,40,20,20,1.5,50.0,Difficile,Difficile,0,Meme Difficulté,Pas Adapte,Philosophy
2991,2017,Philosophie,1,Introduction a la Philosophie,3,L'Oeuvre d'Art,5,770,2,QROC,0.71,0.13,34.69,22,40,62,56,22,34,1.11,39.29,Difficile,Difficile,0,Meme Difficulté,Pas Adapte,Philosophy
4102,2018,Philosophie,1,Introduction a la Philosophie,3,L'Oeuvre d'Art,5,770,2,QROC,0.57,0.28,39.56,21,32,53,51,21,30,1.04,41.18,Difficile,Moyen,1,Plus Facile,Pas Adapte,Philosophy
5213,2019,Philosophie,1,Introduction a la Philosophie,3,L'Oeuvre d'Art,5,770,2,QROC,0.24,0.28,42.39,24,33,57,48,24,24,1.19,50.0,Facile,Moyen,-1,Plus Difficile,Pas Adapte,Philosophy
6324,2020,Philosophie,1,Introduction a la Philosophie,3,L'Oeuvre d'Art,5,770,2,QROC,0.69,0.03,1.16,1,48,49,36,1,35,1.36,2.78,Difficile,Difficile,0,Meme Difficulté,Pas Adapte,Philosophy
770,2015,Philosophie,1,Introduction a la Philosophie,3,L'Oeuvre d'Art,5,771,3,QCU,0.52,0.33,31.05,13,29,42,40,13,27,1.05,32.5,Moyen,Difficile,-1,Plus Difficile,Pas Adapte,Philosophy
1881,2016,Philosophie,1,Introduction a la Philosophie,3,L'Oeuvre d'Art,5,771,3,QCU,0.21,0.72,37.7,16,26,42,30,16,14,1.4,53.33,Facile,Moyen,-1,Plus Difficile,Pas Adapte,Philosophy
2992,2017,Philosophie,1,Introduction a la Philosophie,3,L'Oeuvre d'Art,5,771,3,QCM,0.0,0.86,81.1,33,8,41,40,33,7,1.02,82.5,Facile,Facile,0,Meme Difficulté,Pas Adapte,Philosophy
4103,2018,Philosophie,1,Introduction a la Philosophie,3,L'Oeuvre d'Art,5,771,3,QCM,0.1,0.84,92.81,42,3,45,45,42,3,1.0,93.33,Facile,Facile,0,Meme Difficulté,Pas Adapte,Philosophy
5214,2019,Philosophie,1,Introduction a la Philosophie,3,L'Oeuvre d'Art,5,771,3,QCM,0.67,0.22,10.16,5,46,51,48,5,43,1.06,10.42,Moyen,Difficile,-1,Plus Difficile,Pas Adapte,Philosophy
6325,2020,Philosophie,1,Introduction a la Philosophie,3,L'Oeuvre d'Art,5,771,3,QCM,0.01,1.0,76.94,36,11,47,43,36,7,1.09,83.72,Moyen,Facile,1,Plus Facile,Pas Adapte,Philosophy
771,2015,Philosophie,1,Introduction a la Philosophie,3,L'Oeuvre d'Art,5,772,4,QROC,0.93,0.06,8.09,0,5,5,4,0,4,1.25,0.0,Facile,Difficile,-2,Beaucoup plus Difficile,Pas Adapte,Philosophy
1882,2016,Philosophie,1,Introduction a la Philosophie,3,L'Oeuvre d'Art,5,772,4,QROC,0.25,0.27,38.05,2,4,6,3,2,1,2.0,66.67,Moyen,Moyen,0,Meme Difficulté,Pas Adapte,Philosophy
2993,2017,Philosophie,1,Introduction a la Philosophie,3,L'Oeuvre d'Art,5,772,4,QROC,0.21,0.27,42.81,3,4,7,5,3,2,1.4,60.0,Facile,Moyen,-1,Plus Difficile,Pas Adapte,Philosophy
4104,2018,Philosophie,1,Introduction a la Philosophie,3,L'Oeuvre d'Art,5,772,4,QO,0.96,0.02,14.75,1,7,8,8,1,7,1.0,12.5,Facile,Difficile,-2,Beaucoup plus Difficile,Pas Adapte,Philosophy
5215,2019,Philosophie,1,Introduction a la Philosophie,3,L'Oeuvre d'Art,5,772,4,QROC,0.91,0.23,1.78,0,9,9,5,0,5,1.8,0.0,Moyen,Difficile,-1,Plus Difficile,Pas Adapte,Philosophy
6326,2020,Philosophie,1,Introduction a la Philosophie,3,L'Oeuvre d'Art,5,772,4,QROC,0.06,0.57,79.6,6,2,8,8,6,2,1.0,75.0,Moyen,Facile,1,Plus Facile,Pas Adapte,Philosophy
772,2015,Philosophie,1,Introduction a la Philosophie,3,L'Oeuvre d'Art,5,773,5,QCU,0.44,0.39,26.67,12,33,45,28,12,16,1.61,42.86,Difficile,Difficile,0,Meme Difficulté,Pas Adapte,Philosophy
1883,2016,Philosophie,1,Introduction a la Philosophie,3,L'Oeuvre d'Art,5,773,5,QCU,0.23,0.54,62.67,33,19,52,42,33,9,1.24,78.57,Moyen,Moyen,0,Meme Difficulté,Adapte,Philosophy
2994,2017,Philosophie,1,Introduction a la Philosophie,3,L'Oeuvre d'Art,5,773,5,QCU,0.37,0.58,62.67,33,20,53,52,33,19,1.02,63.46,Moyen,Moyen,0,Meme Difficulté,Adapte,Philosophy
4105,2018,Philosophie,1,Introduction a la Philosophie,3,L'Oeuvre d'Art,5,773,5,QCU,0.25,0.48,62.67,31,19,50,47,31,16,1.06,65.96,Moyen,Moyen,0,Meme Difficulté,Adapte,Philosophy
5216,2019,Philosophie,1,Introduction a la Philosophie,3,L'Oeuvre d'Art,5,773,5,QCM,0.27,0.6,62.67,31,19,50,47,31,16,1.06,65.96,Moyen,Moyen,0,Meme Difficulté,Adapte,Philosophy
6327,2020,Philosophie,1,Introduction a la Philosophie,3,L'Oeuvre d'Art,5,773,5,QCM,0.35,0.69,62.67,31,19,50,45,31,14,1.11,68.89,Moyen,Moyen,0,Meme Difficulté,Adapte,Philosophy
773,2015,Philosophie,1,Introduction a la Philosophie,4,L'Histoire,9,774,1,QCM,0.58,0.26,22.61,7,25,32,9,7,2,3.56,77.78,Difficile,Difficile,0,Meme Difficulté,Pas Adapte,Philosophy
1884,2016,Philosophie,1,Introduction a la Philosophie,4,L'Histoire,9,774,1,QO,0.9,0.02,11.16,4,28,32,22,4,18,1.45,18.18,Facile,Difficile,-2,Beaucoup plus Difficile,Pas Adapte,Philosophy
2995,2017,Philosophie,1,Introduction a la Philosophie,4,L'Histoire,9,774,1,QO,0.03,0.35,65.4,21,11,32,24,21,3,1.33,87.5,Facile,Facile,0,Meme Difficulté,Adapte,Philosophy
4106,2018,Philosophie,1,Introduction a la Philosophie,4,L'Histoire,9,774,1,QO,0.14,0.99,65.4,22,11,33,29,22,7,1.14,75.86,Facile,Facile,0,Meme Difficulté,Adapte,Philosophy
5217,2019,Philosophie,1,Introduction a la Philosophie,4,L'Histoire,9,774,1,QCM,0.0,0.89,65.4,18,10,28,25,18,7,1.12,72.0,Facile,Facile,0,Meme Difficulté,Adapte,Philosophy
6328,2020,Philosophie,1,Introduction a la Philosophie,4,L'Histoire,9,774,1,QCM,0.01,1.0,65.4,18,9,27,25,18,7,1.08,72.0,Facile,Facile,0,Meme Difficulté,Adapte,Philosophy
774,2015,Philosophie,1,Introduction a la Philosophie,4,L'Histoire,9,775,2,QCU,0.56,0.37,18.16,3,12,15,9,3,6,1.67,33.33,Moyen,Difficile,-1,Plus Difficile,Pas Adapte,Philosophy
1885,2016,Philosophie,1,Introduction a la Philosophie,4,L'Histoire,9,775,2,QCU,0.24,0.6,62.66,9,6,15,13,9,4,1.15,69.23,Difficile,Moyen,1,Plus Facile,Adapte,Philosophy
2996,2017,Philosophie,1,Introduction a la Philosophie,4,L'Histoire,9,775,2,QCU,0.28,0.65,62.66,9,6,15,12,9,3,1.25,75.0,Moyen,Moyen,0,Meme Difficulté,Adapte,Philosophy
4107,2018,Philosophie,1,Introduction a la Philosophie,4,L'Histoire,9,775,2,QCU,0.31,0.42,62.66,8,5,13,11,8,3,1.18,72.73,Moyen,Moyen,0,Meme Difficulté,Adapte,Philosophy
5218,2019,Philosophie,1,Introduction a la Philosophie,4,L'Histoire,9,775,2,QCU,0.32,0.69,62.66,8,5,13,11,8,3,1.18,72.73,Moyen,Moyen,0,Meme Difficulté,Adapte,Philosophy
6329,2020,Philosophie,1,Introduction a la Philosophie,4,L'Histoire,9,775,2,QCU,0.34,0.69,62.66,7,4,11,10,7,3,1.1,70.0,Moyen,Moyen,0,Meme Difficulté,Adapte,Philosophy
775,2015,Philosophie,1,Introduction a la Philosophie,4,L'Histoire,9,776,3,QCM,0.52,0.21,4.19,1,34,35,35,1,34,1.0,2.86,Facile,Difficile,-2,Beaucoup plus Difficile,Pas Adapte,Philosophy
1886,2016,Philosophie,1,Introduction a la Philosophie,4,L'Histoire,9,776,3,QCM,0.01,0.73,83.53,26,5,31,29,26,3,1.07,89.66,Facile,Facile,0,Meme Difficulté,Pas Adapte,Philosophy
2997,2017,Philosophie,1,Introduction a la Philosophie,4,L'Histoire,9,776,3,QCU,0.38,0.44,64.9,19,10,29,25,19,6,1.16,76.0,Difficile,Moyen,1,Plus Facile,Adapte,Philosophy
4108,2018,Philosophie,1,Introduction a la Philosophie,4,L'Histoire,9,776,3,QCU,0.3,0.48,64.9,21,12,33,27,21,6,1.22,77.78,Moyen,Moyen,0,Meme Difficulté,Adapte,Philosophy
5219,2019,Philosophie,1,Introduction a la Philosophie,4,L'Histoire,9,776,3,QCU,0.29,0.71,64.9,20,11,31,21,20,1,1.48,95.24,Moyen,Moyen,0,Meme Difficulté,Adapte,Philosophy
6330,2020,Philosophie,1,Introduction a la Philosophie,4,L'Histoire,9,776,3,QCU,0.22,0.53,64.9,17,9,26,22,17,5,1.18,77.27,Moyen,Moyen,0,Meme Difficulté,Adapte,Philosophy
776,2015,Philosophie,1,Introduction a la Philosophie,4,L'Histoire,9,777,4,QCU,0.59,0.3,1.98,1,61,62,58,1,57,1.07,1.72,Difficile,Difficile,0,Meme Difficulté,Pas Adapte,Philosophy
1887,2016,Philosophie,1,Introduction a la Philosophie,4,L'Histoire,9,777,4,QCU,0.08,0.85,97.06,53,2,55,54,53,1,1.02,98.15,Moyen,Facile,1,Plus Facile,Pas Adapte,Philosophy
2998,2017,Philosophie,1,Introduction a la Philosophie,4,L'Histoire,9,777,4,QCM,0.57,0.28,1.51,1,48,49,27,1,26,1.81,3.7,Moyen,Difficile,-1,Plus Difficile,Pas Adapte,Philosophy
4109,2018,Philosophie,1,Introduction a la Philosophie,4,L'Histoire,9,777,4,QCM,0.08,0.87,95.45,51,2,53,53,51,2,1.0,96.23,Difficile,Facile,2,Beaucoup plus Facile,Pas Adapte,Philosophy
5220,2019,Philosophie,1,Introduction a la Philosophie,4,L'Histoire,9,777,4,QCU,0.09,0.96,65.33,40,21,61,42,40,2,1.45,95.24,Facile,Facile,0,Meme Difficulté,Adapte,Philosophy
6331,2020,Philosophie,1,Introduction a la Philosophie,4,L'Histoire,9,777,4,QCM,0.01,0.92,65.33,43,23,66,49,43,6,1.35,87.76,Facile,Facile,0,Meme Difficulté,Adapte,Philosophy
777,2015,Philosophie,1,Introduction a la Philosophie,4,L'Histoire,9,778,5,QCU,0.48,0.4,28.21,23,58,81,68,23,45,1.19,33.82,Facile,Difficile,-2,Beaucoup plus Difficile,Pas Adapte,Philosophy
1888,2016,Philosophie,1,Introduction a la Philosophie,4,L'Histoire,9,778,5,QCU,0.1,0.94,65.1,46,24,70,61,46,15,1.15,75.41,Difficile,Facile,2,Beaucoup plus Facile,Adapte,Philosophy
2999,2017,Philosophie,1,Introduction a la Philosophie,4,L'Histoire,9,778,5,QCU,0.18,0.86,65.1,44,23,67,65,44,21,1.03,67.69,Facile,Facile,0,Meme Difficulté,Adapte,Philosophy
4110,2018,Philosophie,1,Introduction a la Philosophie,4,L'Histoire,9,778,5,QCU,0.08,0.86,65.1,40,21,61,56,40,16,1.09,71.43,Facile,Facile,0,Meme Difficulté,Adapte,Philosophy
5221,2019,Philosophie,1,Introduction a la Philosophie,4,L'Histoire,9,778,5,QCU,0.17,0.84,65.1,44,23,67,60,44,16,1.12,73.33,Facile,Facile,0,Meme Difficulté,Adapte,Philosophy
6332,2020,Philosophie,1,Introduction a la Philosophie,4,L'Histoire,9,778,5,QCU,0.03,0.92,65.1,39,21,60,48,39,9,1.25,81.25,Facile,Facile,0,Meme Difficulté,Adapte,Philosophy
778,2015,Philosophie,1,Introduction a la Philosophie,4,L'Histoire,9,779,6,QCM,0.04,0.7,74.36,4,2,6,6,4,2,1.0,66.67,Moyen,Facile,1,Plus Facile,Adapte,Philosophy
1889,2016,Philosophie,1,Introduction a la Philosophie,4,L'Histoire,9,779,6,QCM,0.11,0.84,74.36,4,1,5,4,4,0,1.25,100.0,Facile,Facile,0,Meme Difficulté,Adapte,Philosophy
3000,2017,Philosophie,1,Introduction a la Philosophie,4,L'Histoire,9,779,6,QCM,0.12,0.81,74.36,3,1,4,4,3,1,1.0,75.0,Facile,Facile,0,Meme Difficulté,Adapte,Philosophy
4111,2018,Philosophie,1,Introduction a la Philosophie,4,L'Histoire,9,779,6,QCM,0.11,0.85,74.36,2,1,3,2,2,0,1.5,100.0,Facile,Facile,0,Meme Difficulté,Adapte,Philosophy
5222,2019,Philosophie,1,Introduction a la Philosophie,4,L'Histoire,9,779,6,QCM,0.19,0.88,74.36,2,1,3,2,2,0,1.5,100.0,Facile,Facile,0,Meme Difficulté,Adapte,Philosophy
6333,2020,Philosophie,1,Introduction a la Philosophie,4,L'Histoire,9,779,6,QCM,0.15,0.84,74.36,2,1,3,2,2,0,1.5,100.0,Facile,Facile,0,Meme Difficulté,Adapte,Philosophy
779,2015,Philosophie,1,Introduction a la Philosophie,4,L'Histoire,9,780,7,QCU,0.15,0.8,78.94,53,14,67,66,53,13,1.02,80.3,Facile,Facile,0,Meme Difficulté,Pas Adapte,Philosophy
1890,2016,Philosophie,1,Introduction a la Philosophie,4,L'Histoire,9,780,7,QCU,0.31,0.54,36.07,22,38,60,48,22,26,1.25,45.83,Moyen,Moyen,0,Meme Difficulté,Pas Adapte,Philosophy
3001,2017,Philosophie,1,Introduction a la Philosophie,4,L'Histoire,9,780,7,QCM,0.21,0.53,59.75,38,26,64,57,38,19,1.12,66.67,Difficile,Moyen,1,Plus Facile,Pas Adapte,Philosophy
4112,2018,Philosophie,1,Introduction a la Philosophie,4,L'Histoire,9,780,7,QCM,0.38,0.46,61.48,36,22,58,42,36,6,1.38,85.71,Moyen,Moyen,0,Meme Difficulté,Adapte,Philosophy
5223,2019,Philosophie,1,Introduction a la Philosophie,4,L'Histoire,9,780,7,QCM,0.42,0.64,61.48,41,26,67,47,41,6,1.43,87.23,Moyen,Moyen,0,Meme Difficulté,Adapte,Philosophy
6334,2020,Philosophie,1,Introduction a la Philosophie,4,L'Histoire,9,780,7,QCU,0.32,0.74,61.48,45,28,73,64,45,19,1.14,70.31,Moyen,Moyen,0,Meme Difficulté,Adapte,Philosophy
780,2015,Philosophie,1,Introduction a la Philosophie,4,L'Histoire,9,781,8,QCU,0.38,0.59,38.02,13,20,33,17,13,4,1.94,76.47,Difficile,Moyen,1,Plus Facile,Pas Adapte,Philosophy
1891,2016,Philosophie,1,Introduction a la Philosophie,4,L'Histoire,9,781,8,QCU,0.02,0.86,78.21,28,8,36,31,28,3,1.16,90.32,Difficile,Facile,2,Beaucoup plus Facile,Pas Adapte,Philosophy
3002,2017,Philosophie,1,Introduction a la Philosophie,4,L'Histoire,9,781,8,QCU,0.43,0.23,11.91,4,27,31,27,4,23,1.15,14.81,Facile,Difficile,-2,Beaucoup plus Difficile,Pas Adapte,Philosophy
4113,2018,Philosophie,1,Introduction a la Philosophie,4,L'Histoire,9,781,8,QCU,0.23,0.65,54.67,16,14,30,26,16,10,1.15,61.54,Facile,Moyen,-1,Plus Difficile,Pas Adapte,Philosophy
5224,2019,Philosophie,1,Introduction a la Philosophie,4,L'Histoire,9,781,8,QCU,0.03,0.76,70.11,24,10,34,31,24,7,1.1,77.42,Facile,Facile,0,Meme Difficulté,Adapte,Philosophy
6335,2020,Philosophie,1,Introduction a la Philosophie,4,L'Histoire,9,781,8,QCU,0.18,0.97,70.11,22,9,31,27,22,5,1.15,81.48,Facile,Facile,0,Meme Difficulté,Adapte,Philosophy
781,2015,Philosophie,1,Introduction a la Philosophie,4,L'Histoire,9,782,9,QCM,0.26,0.47,43.29,14,18,32,23,14,9,1.39,60.87,Moyen,Moyen,0,Meme Difficulté,Pas Adapte,Philosophy
1892,2016,Philosophie,1,Introduction a la Philosophie,4,L'Histoire,9,782,9,QROC,0.92,0.13,21.13,7,27,34,23,7,16,1.48,30.43,Facile,Difficile,-2,Beaucoup plus Difficile,Pas Adapte,Philosophy
3003,2017,Philosophie,1,Introduction a la Philosophie,4,L'Histoire,9,782,9,QROC,0.35,0.29,48.78,16,17,33,18,16,2,1.83,88.89,Moyen,Moyen,0,Meme Difficulté,Pas Adapte,Philosophy
4114,2018,Philosophie,1,Introduction a la Philosophie,4,L'Histoire,9,782,9,QROC,0.97,0.11,33.13,10,20,30,14,10,4,2.14,71.43,Moyen,Difficile,-1,Plus Difficile,Pas Adapte,Philosophy
5225,2019,Philosophie,1,Introduction a la Philosophie,4,L'Histoire,9,782,9,QROC,0.04,0.94,84.68,22,4,26,22,22,0,1.18,100.0,Facile,Facile,0,Meme Difficulté,Pas Adapte,Philosophy
6336,2020,Philosophie,1,Introduction a la Philosophie,4,L'Histoire,9,782,9,QROC,0.01,0.66,65.4,16,8,24,23,16,7,1.04,69.57,Moyen,Facile,1,Plus Facile,Adapte,Philosophy
782,2015,Philosophie,1,Introduction a la Philosophie,5,Le Droit,7,783,1,QCM,0.09,0.71,75.88,44,14,58,48,44,4,1.21,91.67,Facile,Facile,0,Meme Difficulté,Pas Adapte,Philosophy
1893,2016,Philosophie,1,Introduction a la Philosophie,5,Le Droit,7,783,1,QCU,0.68,0.37,28.93,17,43,60,48,17,31,1.25,35.42,Moyen,Difficile,-1,Plus Difficile,Pas Adapte,Philosophy
3004,2017,Philosophie,1,Introduction a la Philosophie,5,Le Droit,7,783,1,QCU,0.5,0.34,12.36,7,53,60,49,7,42,1.22,14.29,Moyen,Difficile,-1,Plus Difficile,Pas Adapte,Philosophy
4115,2018,Philosophie,1,Introduction a la Philosophie,5,Le Droit,7,783,1,QCM,0.11,0.85,71.41,45,18,63,58,45,13,1.09,77.59,Moyen,Facile,1,Plus Facile,Adapte,Philosophy
5226,2019,Philosophie,1,Introduction a la Philosophie,5,Le Droit,7,783,1,QCM,0.13,0.72,71.41,49,20,69,66,49,17,1.05,74.24,Facile,Facile,0,Meme Difficulté,Adapte,Philosophy
6337,2020,Philosophie,1,Introduction a la Philosophie,5,Le Droit,7,783,1,QCM,0.06,0.9,71.41,45,18,63,62,45,17,1.02,72.58,Facile,Facile,0,Meme Difficulté,Adapte,Philosophy
783,2015,Philosophie,1,Introduction a la Philosophie,5,Le Droit,7,784,2,QCU,0.08,0.95,94.07,8,1,9,8,8,0,1.12,100.0,Difficile,Facile,2,Beaucoup plus Facile,Pas Adapte,Philosophy
1894,2016,Philosophie,1,Introduction a la Philosophie,5,Le Droit,7,784,2,QCM,0.62,0.24,25.93,3,7,10,8,3,5,1.25,37.5,Difficile,Difficile,0,Meme Difficulté,Pas Adapte,Philosophy
3005,2017,Philosophie,1,Introduction a la Philosophie,5,Le Droit,7,784,2,QCM,0.01,0.78,86.2,7,1,8,7,7,0,1.14,100.0,Difficile,Facile,2,Beaucoup plus Facile,Pas Adapte,Philosophy
4116,2018,Philosophie,1,Introduction a la Philosophie,5,Le Droit,7,784,2,QCM,0.66,0.27,32.87,3,6,9,8,3,5,1.12,37.5,Moyen,Difficile,-1,Plus Difficile,Pas Adapte,Philosophy
5227,2019,Philosophie,1,Introduction a la Philosophie,5,Le Droit,7,784,2,QCM,0.32,0.59,35.37,3,5,8,6,3,3,1.33,50.0,Facile,Moyen,-1,Plus Difficile,Pas Adapte,Philosophy
6338,2020,Philosophie,1,Introduction a la Philosophie,5,Le Droit,7,784,2,QCM,0.19,0.75,71.17,6,3,9,7,6,1,1.29,85.71,Facile,Facile,0,Meme Difficulté,Adapte,Philosophy
784,2015,Philosophie,1,Introduction a la Philosophie,5,Le Droit,7,785,3,QCU,0.3,0.71,43.58,5,7,12,9,5,4,1.33,55.56,Difficile,Moyen,1,Plus Facile,Pas Adapte,Philosophy
1895,2016,Philosophie,1,Introduction a la Philosophie,5,Le Droit,7,785,3,QCM,0.56,0.25,20.42,3,10,13,10,3,7,1.3,30.0,Difficile,Difficile,0,Meme Difficulté,Pas Adapte,Philosophy
3006,2017,Philosophie,1,Introduction a la Philosophie,5,Le Droit,7,785,3,QCM,0.16,0.9,97.69,15,0,15,15,15,0,1.0,100.0,Difficile,Facile,2,Beaucoup plus Facile,Pas Adapte,Philosophy
4117,2018,Philosophie,1,Introduction a la Philosophie,5,Le Droit,7,785,3,QROC,0.94,0.14,9.97,1,14,15,13,1,12,1.15,7.69,Difficile,Difficile,0,Meme Difficulté,Pas Adapte,Philosophy
5228,2019,Philosophie,1,Introduction a la Philosophie,5,Le Droit,7,785,3,QROC,0.01,0.71,68.15,9,4,13,10,9,1,1.3,90.0,Difficile,Facile,2,Beaucoup plus Facile,Adapte,Philosophy
6339,2020,Philosophie,1,Introduction a la Philosophie,5,Le Droit,7,785,3,QROC,0.15,0.68,68.15,8,4,12,8,8,0,1.5,100.0,Facile,Facile,0,Meme Difficulté,Adapte,Philosophy
785,2015,Philosophie,1,Introduction a la Philosophie,5,Le Droit,7,786,4,QROC,0.78,0.09,31.82,20,43,63,54,20,34,1.17,37.04,Moyen,Difficile,-1,Plus Difficile,Pas Adapte,Philosophy
1896,2016,Philosophie,1,Introduction a la Philosophie,5,Le Droit,7,786,4,QROC,0.81,0.01,11.33,7,56,63,53,7,46,1.19,13.21,Facile,Difficile,-2,Beaucoup plus Difficile,Pas Adapte,Philosophy
3007,2017,Philosophie,1,Introduction a la Philosophie,5,Le Droit,7,786,4,QROC,0.92,0.02,16.37,10,51,61,43,10,33,1.42,23.26,Facile,Difficile,-2,Beaucoup plus Difficile,Pas Adapte,Philosophy
4118,2018,Philosophie,1,Introduction a la Philosophie,5,Le Droit,7,786,4,QROC,0.96,0.04,7.01,5,64,69,49,5,44,1.41,10.2,Facile,Difficile,-2,Beaucoup plus Difficile,Pas Adapte,Philosophy
5229,2019,Philosophie,1,Introduction a la Philosophie,5,Le Droit,7,786,4,QROC,0.13,0.94,69.04,47,21,68,59,47,12,1.15,79.66,Facile,Facile,0,Meme Difficulté,Adapte,Philosophy
6340,2020,Philosophie,1,Introduction a la Philosophie,5,Le Droit,7,786,4,QROC,0.07,0.72,69.04,44,20,64,57,44,13,1.12,77.19,Facile,Facile,0,Meme Difficulté,Adapte,Philosophy
786,2015,Philosophie,1,Introduction a la Philosophie,5,Le Droit,7,787,5,QCU,0.31,0.61,39.0,24,37,61,34,24,10,1.79,70.59,Facile,Moyen,-1,Plus Difficile,Pas Adapte,Philosophy
1897,2016,Philosophie,1,Introduction a la Philosophie,5,Le Droit,7,787,5,QCU,0.21,0.51,51.81,35,33,68,45,35,10,1.51,77.78,Difficile,Moyen,1,Plus Facile,Pas Adapte,Philosophy
3008,2017,Philosophie,1,Introduction a la Philosophie,5,Le Droit,7,787,5,QCU,0.39,0.73,41.37,25,36,61,57,25,32,1.07,43.86,Facile,Moyen,-1,Plus Difficile,Pas Adapte,Philosophy
4119,2018,Philosophie,1,Introduction a la Philosophie,5,Le Droit,7,787,5,QROC,0.18,0.87,84.76,55,10,65,55,55,0,1.18,100.0,Facile,Facile,0,Meme Difficulté,Pas Adapte,Philosophy
5230,2019,Philosophie,1,Introduction a la Philosophie,5,Le Droit,7,787,5,QO,0.93,0.03,24.13,16,49,65,44,16,28,1.48,36.36,Difficile,Difficile,0,Meme Difficulté,Pas Adapte,Philosophy
6341,2020,Philosophie,1,Introduction a la Philosophie,5,Le Droit,7,787,5,QO,0.94,0.09,1.91,1,59,60,53,1,52,1.13,1.89,Facile,Difficile,-2,Beaucoup plus Difficile,Pas Adapte,Philosophy
787,2015,Philosophie,1,Introduction a la Philosophie,5,Le Droit,7,788,6,QCU,0.27,0.54,47.67,2,3,5,2,2,0,2.5,100.0,Difficile,Moyen,1,Plus Facile,Pas Adapte,Philosophy
1898,2016,Philosophie,1,Introduction a la Philosophie,5,Le Droit,7,788,6,QCU,0.51,0.25,22.28,1,4,5,2,1,1,2.5,50.0,Difficile,Difficile,0,Meme Difficulté,Pas Adapte,Philosophy
3009,2017,Philosophie,1,Introduction a la Philosophie,5,Le Droit,7,788,6,QCU,0.6,0.31,0.61,0,5,5,5,0,5,1.0,0.0,Facile,Difficile,-2,Beaucoup plus Difficile,Pas Adapte,Philosophy
4120,2018,Philosophie,1,Introduction a la Philosophie,5,Le Droit,7,788,6,QCU,0.0,0.91,84.99,4,1,5,5,4,1,1.0,80.0,Moyen,Facile,1,Plus Facile,Pas Adapte,Philosophy
5231,2019,Philosophie,1,Introduction a la Philosophie,5,Le Droit,7,788,6,QCU,0.34,0.64,41.18,2,3,5,3,2,1,1.67,66.67,Difficile,Moyen,1,Plus Facile,Pas Adapte,Philosophy
6342,2020,Philosophie,1,Introduction a la Philosophie,5,Le Droit,7,788,6,QCU,0.28,0.67,51.08,2,2,4,3,2,1,1.33,66.67,Moyen,Moyen,0,Meme Difficulté,Pas Adapte,Philosophy
788,2015,Philosophie,1,Introduction a la Philosophie,5,Le Droit,7,789,7,QO,0.03,0.76,85.91,68,11,79,76,68,8,1.04,89.47,Moyen,Facile,1,Plus Facile,Pas Adapte,Philosophy
1899,2016,Philosophie,1,Introduction a la Philosophie,5,Le Droit,7,789,7,QO,0.97,0.12,1.95,1,74,75,40,1,39,1.88,2.5,Moyen,Difficile,-1,Plus Difficile,Pas Adapte,Philosophy
3010,2017,Philosophie,1,Introduction a la Philosophie,5,Le Droit,7,789,7,QO,0.61,0.26,37.3,32,53,85,76,32,44,1.12,42.11,Moyen,Moyen,0,Meme Difficulté,Pas Adapte,Philosophy
4121,2018,Philosophie,1,Introduction a la Philosophie,5,Le Droit,7,789,7,QO,0.33,0.17,35.73,34,60,94,88,34,54,1.07,38.64,Moyen,Moyen,0,Meme Difficulté,Pas Adapte,Philosophy
5232,2019,Philosophie,1,Introduction a la Philosophie,5,Le Droit,7,789,7,QROC,0.63,0.08,8.71,8,84,92,84,8,76,1.1,9.52,Difficile,Difficile,0,Meme Difficulté,Pas Adapte,Philosophy
6343,2020,Philosophie,1,Introduction a la Philosophie,5,Le Droit,7,789,7,QROC,0.68,0.23,19.17,18,77,95,88,18,70,1.08,20.45,Facile,Difficile,-2,Beaucoup plus Difficile,Pas Adapte,Philosophy
789,2015,Philosophie,1,Introduction a la Philosophie,6,La Raison,7,790,1,QCU,0.33,0.48,42.64,9,11,20,13,9,4,1.54,69.23,Difficile,Moyen,1,Plus Facile,Pas Adapte,Philosophy
1900,2016,Philosophie,1,Introduction a la Philosophie,6,La Raison,7,790,1,QCU,0.19,0.9,78.96,17,4,21,20,17,3,1.05,85.0,Difficile,Facile,2,Beaucoup plus Facile,Pas Adapte,Philosophy
3011,2017,Philosophie,1,Introduction a la Philosophie,6,La Raison,7,790,1,QCU,0.12,0.83,90.35,17,2,19,19,17,2,1.0,89.47,Facile,Facile,0,Meme Difficulté,Pas Adapte,Philosophy
4122,2018,Philosophie,1,Introduction a la Philosophie,6,La Raison,7,790,1,QCU,0.58,0.34,32.69,6,12,18,14,6,8,1.29,42.86,Facile,Difficile,-2,Beaucoup plus Difficile,Pas Adapte,Philosophy
5233,2019,Philosophie,1,Introduction a la Philosophie,6,La Raison,7,790,1,QCU,0.58,0.3,18.03,3,15,18,15,3,12,1.2,20.0,Facile,Difficile,-2,Beaucoup plus Difficile,Pas Adapte,Philosophy
6344,2020,Philosophie,1,Introduction a la Philosophie,6,La Raison,7,790,1,QCM,0.21,0.37,40.83,8,12,20,13,8,5,1.54,61.54,Moyen,Moyen,0,Meme Difficulté,Pas Adapte,Philosophy
790,2015,Philosophie,1,Introduction a la Philosophie,6,La Raison,7,791,2,QCM,0.54,0.26,15.96,12,66,78,34,12,22,2.29,35.29,Difficile,Difficile,0,Meme Difficulté,Pas Adapte,Philosophy
1901,2016,Philosophie,1,Introduction a la Philosophie,6,La Raison,7,791,2,QCM,0.61,0.17,31.09,28,62,90,54,28,26,1.67,51.85,Difficile,Difficile,0,Meme Difficulté,Pas Adapte,Philosophy
3012,2017,Philosophie,1,Introduction a la Philosophie,6,La Raison,7,791,2,QCM,0.07,0.76,74.82,77,26,103,82,77,5,1.26,93.9,Difficile,Facile,2,Beaucoup plus Facile,Adapte,Philosophy
4123,2018,Philosophie,1,Introduction a la Philosophie,6,La Raison,7,791,2,QCM,0.11,0.84,74.82,85,29,114,107,85,22,1.07,79.44,Facile,Facile,0,Meme Difficulté,Adapte,Philosophy
5234,2019,Philosophie,1,Introduction a la Philosophie,6,La Raison,7,791,2,QROC,0.1,0.44,74.82,98,33,131,115,98,17,1.14,85.22,Facile,Facile,0,Meme Difficulté,Adapte,Philosophy
6345,2020,Philosophie,1,Introduction a la Philosophie,6,La Raison,7,791,2,QROC,0.11,0.89,74.82,101,34,135,131,101,30,1.03,77.1,Facile,Facile,0,Meme Difficulté,Adapte,Philosophy
791,2015,Philosophie,1,Introduction a la Philosophie,6,La Raison,7,792,3,QCU,0.38,0.47,35.6,30,54,84,63,30,33,1.33,47.62,Difficile,Moyen,1,Plus Facile,Pas Adapte,Philosophy
1902,2016,Philosophie,1,Introduction a la Philosophie,6,La Raison,7,792,3,QCU,0.65,0.36,8.35,8,86,94,89,8,81,1.06,8.99,Difficile,Difficile,0,Meme Difficulté,Pas Adapte,Philosophy
3013,2017,Philosophie,1,Introduction a la Philosophie,6,La Raison,7,792,3,QCU,0.21,0.57,54.78,55,46,101,68,55,13,1.49,80.88,Difficile,Moyen,1,Plus Facile,Pas Adapte,Philosophy
4124,2018,Philosophie,1,Introduction a la Philosophie,6,La Raison,7,792,3,QCU,0.28,0.53,37.4,36,59,95,93,36,57,1.02,38.71,Moyen,Moyen,0,Meme Difficulté,Pas Adapte,Philosophy
5235,2019,Philosophie,1,Introduction a la Philosophie,6,La Raison,7,792,3,QCU,0.23,0.74,51.9,56,51,107,88,56,32,1.22,63.64,Difficile,Moyen,1,Plus Facile,Pas Adapte,Philosophy
6346,2020,Philosophie,1,Introduction a la Philosophie,6,La Raison,7,792,3,QCU,0.57,0.3,16.78,19,93,112,76,19,57,1.47,25.0,Moyen,Difficile,-1,Plus Difficile,Pas Adapte,Philosophy
792,2015,Philosophie,1,Introduction a la Philosophie,6,La Raison,7,793,4,QCU,0.25,0.63,56.77,48,37,85,71,48,23,1.2,67.61,Difficile,Moyen,1,Plus Facile,Pas Adapte,Philosophy
1903,2016,Philosophie,1,Introduction a la Philosophie,6,La Raison,7,793,4,QCU,0.33,0.44,50.94,41,40,81,44,41,3,1.84,93.18,Facile,Moyen,-1,Plus Difficile,Pas Adapte,Philosophy
3014,2017,Philosophie,1,Introduction a la Philosophie,6,La Raison,7,793,4,QCU,0.25,0.74,55.62,45,36,81,49,45,4,1.65,91.84,Moyen,Moyen,0,Meme Difficulté,Pas Adapte,Philosophy
4125,2018,Philosophie,1,Introduction a la Philosophie,6,La Raison,7,793,4,QCU,0.01,0.93,95.11,79,4,83,82,79,3,1.01,96.34,Facile,Facile,0,Meme Difficulté,Pas Adapte,Philosophy
5236,2019,Philosophie,1,Introduction a la Philosophie,6,La Raison,7,793,4,QCU,0.18,0.81,80.63,72,17,89,83,72,11,1.07,86.75,Facile,Facile,0,Meme Difficulté,Pas Adapte,Philosophy
6347,2020,Philosophie,1,Introduction a la Philosophie,6,La Raison,7,793,4,QCM,0.79,0.27,31.66,28,61,89,87,28,59,1.02,32.18,Facile,Difficile,-2,Beaucoup plus Difficile,Pas Adapte,Philosophy
793,2015,Philosophie,1,Introduction a la Philosophie,6,La Raison,7,794,5,QCU,0.1,0.91,68.51,22,10,32,31,22,9,1.03,70.97,Difficile,Facile,2,Beaucoup plus Facile,Adapte,Philosophy
1904,2016,Philosophie,1,Introduction a la Philosophie,6,La Raison,7,794,5,QCU,0.14,0.78,68.51,25,12,37,28,25,3,1.32,89.29,Facile,Facile,0,Meme Difficulté,Adapte,Philosophy
3015,2017,Philosophie,1,Introduction a la Philosophie,6,La Raison,7,794,5,QCU,0.18,0.88,68.51,27,12,39,28,27,1,1.39,96.43,Facile,Facile,0,Meme Difficulté,Adapte,Philosophy
4126,2018,Philosophie,1,Introduction a la Philosophie,6,La Raison,7,794,5,QCU,0.06,0.87,68.51,25,11,36,32,25,7,1.12,78.12,Facile,Facile,0,Meme Difficulté,Adapte,Philosophy
5237,2019,Philosophie,1,Introduction a la Philosophie,6,La Raison,7,794,5,QCU,0.11,0.85,68.51,28,13,41,40,28,12,1.02,70.0,Facile,Facile,0,Meme Difficulté,Adapte,Philosophy
6348,2020,Philosophie,1,Introduction a la Philosophie,6,La Raison,7,794,5,QCU,0.01,0.94,68.51,32,15,47,38,32,6,1.24,84.21,Facile,Facile,0,Meme Difficulté,Adapte,Philosophy
794,2015,Philosophie,1,Introduction a la Philosophie,6,La Raison,7,795,6,QCU,0.44,0.25,3.79,0,12,12,6,0,6,2.0,0.0,Facile,Difficile,-2,Beaucoup plus Difficile,Pas Adapte,Philosophy
1905,2016,Philosophie,1,Introduction a la Philosophie,6,La Raison,7,795,6,QCU,0.29,0.7,62.54,6,4,10,7,6,1,1.43,85.71,Moyen,Moyen,0,Meme Difficulté,Adapte,Philosophy
3016,2017,Philosophie,1,Introduction a la Philosophie,6,La Raison,7,795,6,QCU,0.39,0.64,62.54,7,4,11,11,7,4,1.0,63.64,Moyen,Moyen,0,Meme Difficulté,Adapte,Philosophy
4127,2018,Philosophie,1,Introduction a la Philosophie,6,La Raison,7,795,6,QCU,0.39,0.52,62.54,7,4,11,9,7,2,1.22,77.78,Moyen,Moyen,0,Meme Difficulté,Adapte,Philosophy
5238,2019,Philosophie,1,Introduction a la Philosophie,6,La Raison,7,795,6,QCU,0.27,0.64,62.54,6,3,9,6,6,0,1.5,100.0,Moyen,Moyen,0,Meme Difficulté,Adapte,Philosophy
6349,2020,Philosophie,1,Introduction a la Philosophie,6,La Raison,7,795,6,QCM,0.34,0.48,62.54,6,4,10,9,6,3,1.11,66.67,Moyen,Moyen,0,Meme Difficulté,Adapte,Philosophy
795,2015,Philosophie,1,Introduction a la Philosophie,6,La Raison,7,796,7,QO,0.19,1.0,98.8,11,0,11,11,11,0,1.0,100.0,Difficile,Facile,2,Beaucoup plus Facile,Pas Adapte,Philosophy
1906,2016,Philosophie,1,Introduction a la Philosophie,6,La Raison,7,796,7,QO,0.15,0.67,83.94,11,2,13,11,11,0,1.18,100.0,Moyen,Facile,1,Plus Facile,Pas Adapte,Philosophy
3017,2017,Philosophie,1,Introduction a la Philosophie,6,La Raison,7,796,7,QO,0.77,0.03,23.38,3,11,14,10,3,7,1.4,30.0,Facile,Difficile,-2,Beaucoup plus Difficile,Pas Adapte,Philosophy
4128,2018,Philosophie,1,Introduction a la Philosophie,6,La Raison,7,796,7,QO,0.05,0.82,93.52,11,1,12,12,11,1,1.0,91.67,Difficile,Facile,2,Beaucoup plus Facile,Pas Adapte,Philosophy
5239,2019,Philosophie,1,Introduction a la Philosophie,6,La Raison,7,796,7,QO,0.55,0.16,56.62,7,5,12,11,7,4,1.09,63.64,Moyen,Moyen,0,Meme Difficulté,Pas Adapte,Philosophy
6350,2020,Philosophie,1,Introduction a la Philosophie,6,La Raison,7,796,7,QO,0.04,0.32,84.51,10,2,12,11,10,1,1.09,90.91,Difficile,Facile,2,Beaucoup plus Facile,Pas Adapte,Philosophy
796,2015,Philosophie,1,Introduction a la Philosophie,7,La Verite,9,797,1,QCM,0.69,0.17,32.43,19,40,59,45,19,26,1.31,42.22,Facile,Difficile,-2,Beaucoup plus Difficile,Pas Adapte,Philosophy
1907,2016,Philosophie,1,Introduction a la Philosophie,7,La Verite,9,797,1,QCM,0.02,0.71,82.62,49,10,59,49,49,0,1.2,100.0,Moyen,Facile,1,Plus Facile,Pas Adapte,Philosophy
3018,2017,Philosophie,1,Introduction a la Philosophie,7,La Verite,9,797,1,QCM,0.75,0.17,27.95,15,38,53,41,15,26,1.29,36.59,Moyen,Difficile,-1,Plus Difficile,Pas Adapte,Philosophy
4129,2018,Philosophie,1,Introduction a la Philosophie,7,La Verite,9,797,1,QCM,0.45,0.34,54.36,30,26,56,44,30,14,1.27,68.18,Difficile,Moyen,1,Plus Facile,Pas Adapte,Philosophy
5240,2019,Philosophie,1,Introduction a la Philosophie,7,La Verite,9,797,1,QCM,0.15,0.84,81.24,51,12,63,60,51,9,1.05,85.0,Moyen,Facile,1,Plus Facile,Pas Adapte,Philosophy
6351,2020,Philosophie,1,Introduction a la Philosophie,7,La Verite,9,797,1,QCM,0.07,0.8,91.59,60,5,65,64,60,4,1.02,93.75,Difficile,Facile,2,Beaucoup plus Facile,Pas Adapte,Philosophy
797,2015,Philosophie,1,Introduction a la Philosophie,7,La Verite,9,798,2,QO,0.14,0.66,96.56,93,3,96,94,93,1,1.02,98.94,Facile,Facile,0,Meme Difficulté,Pas Adapte,Philosophy
1908,2016,Philosophie,1,Introduction a la Philosophie,7,La Verite,9,798,2,QO,0.11,0.44,84.04,81,15,96,87,81,6,1.1,93.1,Difficile,Facile,2,Beaucoup plus Facile,Pas Adapte,Philosophy
3019,2017,Philosophie,1,Introduction a la Philosophie,7,La Verite,9,798,2,QO,0.79,0.01,17.81,16,75,91,91,16,75,1.0,17.58,Facile,Difficile,-2,Beaucoup plus Difficile,Pas Adapte,Philosophy
4130,2018,Philosophie,1,Introduction a la Philosophie,7,La Verite,9,798,2,QO,0.59,0.27,60.72,48,31,79,74,48,26,1.07,64.86,Facile,Moyen,-1,Plus Difficile,Adapte,Philosophy
5241,2019,Philosophie,1,Introduction a la Philosophie,7,La Verite,9,798,2,QO,0.71,0.19,60.72,51,33,84,78,51,27,1.08,65.38,Moyen,Moyen,0,Meme Difficulté,Adapte,Philosophy
6352,2020,Philosophie,1,Introduction a la Philosophie,7,La Verite,9,798,2,QO,0.54,0.27,60.72,48,31,79,76,48,28,1.04,63.16,Moyen,Moyen,0,Meme Difficulté,Adapte,Philosophy
798,2015,Philosophie,1,Introduction a la Philosophie,7,La Verite,9,799,3,QCM,0.57,0.28,32.04,7,16,23,16,7,9,1.44,43.75,Facile,Difficile,-2,Beaucoup plus Difficile,Pas Adapte,Philosophy
1909,2016,Philosophie,1,Introduction a la Philosophie,7,La Verite,9,799,3,QCU,0.1,1.0,96.4,22,1,23,22,22,0,1.05,100.0,Moyen,Facile,1,Plus Facile,Pas Adapte,Philosophy
3020,2017,Philosophie,1,Introduction a la Philosophie,7,La Verite,9,799,3,QROC,0.45,0.31,54.6,11,9,20,15,11,4,1.33,73.33,Difficile,Moyen,1,Plus Facile,Pas Adapte,Philosophy
4131,2018,Philosophie,1,Introduction a la Philosophie,7,La Verite,9,799,3,QROC,0.39,0.4,37.82,7,11,18,18,7,11,1.0,38.89,Difficile,Moyen,1,Plus Facile,Pas Adapte,Philosophy
5242,2019,Philosophie,1,Introduction a la Philosophie,7,La Verite,9,799,3,QROC,0.19,0.83,86.35,16,2,18,16,16,0,1.12,100.0,Facile,Facile,0,Meme Difficulté,Pas Adapte,Philosophy
6353,2020,Philosophie,1,Introduction a la Philosophie,7,La Verite,9,799,3,QROC,0.09,0.84,75.39,16,5,21,20,16,4,1.05,80.0,Difficile,Facile,2,Beaucoup plus Facile,Pas Adapte,Philosophy
799,2015,Philosophie,1,Introduction a la Philosophie,7,La Verite,9,800,4,QCM,0.53,0.27,10.46,7,64,71,37,7,30,1.92,18.92,Difficile,Difficile,0,Meme Difficulté,Pas Adapte,Philosophy
1910,2016,Philosophie,1,Introduction a la Philosophie,7,La Verite,9,800,4,QCM,0.26,0.64,40.04,32,48,80,50,32,18,1.6,64.0,Facile,Moyen,-1,Plus Difficile,Pas Adapte,Philosophy
3021,2017,Philosophie,1,Introduction a la Philosophie,7,La Verite,9,800,4,QROC,0.23,0.37,40.38,36,54,90,83,36,47,1.08,43.37,Difficile,Moyen,1,Plus Facile,Pas Adapte,Philosophy
4132,2018,Philosophie,1,Introduction a la Philosophie,7,La Verite,9,800,4,QROC,0.54,0.31,63.37,60,35,95,79,60,19,1.2,75.95,Moyen,Moyen,0,Meme Difficulté,Adapte,Philosophy
5243,2019,Philosophie,1,Introduction a la Philosophie,7,La Verite,9,800,4,QROC,0.53,0.33,63.37,62,36,98,93,62,31,1.05,66.67,Moyen,Moyen,0,Meme Difficulté,Adapte,Philosophy
6354,2020,Philosophie,1,Introduction a la Philosophie,7,La Verite,9,800,4,QROC,0.47,0.27,63.37,67,38,105,99,67,32,1.06,67.68,Moyen,Moyen,0,Meme Difficulté,Adapte,Philosophy
800,2015,Philosophie,1,Introduction a la Philosophie,7,La Verite,9,801,5,QCU,0.07,0.84,70.32,22,9,31,28,22,6,1.11,78.57,Difficile,Facile,2,Beaucoup plus Facile,Adapte,Philosophy
1911,2016,Philosophie,1,Introduction a la Philosophie,7,La Verite,9,801,5,QCM,0.02,1.0,70.32,23,9,32,23,23,0,1.39,100.0,Facile,Facile,0,Meme Difficulté,Adapte,Philosophy
3022,2017,Philosophie,1,Introduction a la Philosophie,7,La Verite,9,801,5,QCM,0.02,0.77,70.32,25,10,35,30,25,5,1.17,83.33,Facile,Facile,0,Meme Difficulté,Adapte,Philosophy
4133,2018,Philosophie,1,Introduction a la Philosophie,7,La Verite,9,801,5,QCM,0.15,0.85,70.32,28,12,40,33,28,5,1.21,84.85,Facile,Facile,0,Meme Difficulté,Adapte,Philosophy
5244,2019,Philosophie,1,Introduction a la Philosophie,7,La Verite,9,801,5,QCM,0.06,0.83,70.32,25,10,35,30,25,5,1.17,83.33,Facile,Facile,0,Meme Difficulté,Adapte,Philosophy
6355,2020,Philosophie,1,Introduction a la Philosophie,7,La Verite,9,801,5,QCM,0.19,0.76,70.32,23,10,33,31,23,8,1.06,74.19,Facile,Facile,0,Meme Difficulté,Adapte,Philosophy
801,2015,Philosophie,1,Introduction a la Philosophie,7,La Verite,9,802,6,QCU,0.2,0.81,66.05,18,9,27,22,18,4,1.23,81.82,Facile,Facile,0,Meme Difficulté,Adapte,Philosophy
1912,2016,Philosophie,1,Introduction a la Philosophie,7,La Verite,9,802,6,QCU,0.11,0.84,66.05,17,9,26,20,17,3,1.3,85.0,Facile,Facile,0,Meme Difficulté,Adapte,Philosophy
3023,2017,Philosophie,1,Introduction a la Philosophie,7,La Verite,9,802,6,QCU,0.06,0.96,66.05,18,10,28,21,18,3,1.33,85.71,Facile,Facile,0,Meme Difficulté,Adapte,Philosophy
4134,2018,Philosophie,1,Introduction a la Philosophie,7,La Verite,9,802,6,QCU,0.06,0.8,66.05,18,9,27,20,18,2,1.35,90.0,Facile,Facile,0,Meme Difficulté,Adapte,Philosophy
5245,2019,Philosophie,1,Introduction a la Philosophie,7,La Verite,9,802,6,QCU,0.16,0.93,66.05,15,8,23,23,15,8,1.0,65.22,Facile,Facile,0,Meme Difficulté,Adapte,Philosophy
6356,2020,Philosophie,1,Introduction a la Philosophie,7,La Verite,9,802,6,QCU,0.02,0.96,66.05,14,7,21,18,14,4,1.17,77.78,Facile,Facile,0,Meme Difficulté,Adapte,Philosophy
802,2015,Philosophie,1,Introduction a la Philosophie,7,La Verite,9,803,7,QCM,0.65,0.28,19.9,3,11,14,13,3,10,1.08,23.08,Difficile,Difficile,0,Meme Difficulté,Pas Adapte,Philosophy
1913,2016,Philosophie,1,Introduction a la Philosophie,7,La Verite,9,803,7,QCM,0.17,0.96,94.66,11,1,12,11,11,0,1.09,100.0,Facile,Facile,0,Meme Difficulté,Pas Adapte,Philosophy
3024,2017,Philosophie,1,Introduction a la Philosophie,7,La Verite,9,803,7,QCM,0.76,0.28,31.87,4,10,14,8,4,4,1.75,50.0,Difficile,Difficile,0,Meme Difficulté,Pas Adapte,Philosophy
4135,2018,Philosophie,1,Introduction a la Philosophie,7,La Verite,9,803,7,QCM,0.11,0.89,95.11,15,1,16,16,15,1,1.0,93.75,Facile,Facile,0,Meme Difficulté,Pas Adapte,Philosophy
5246,2019,Philosophie,1,Introduction a la Philosophie,7,La Verite,9,803,7,QCM,0.48,0.51,60.85,9,5,14,14,9,5,1.0,64.29,Moyen,Moyen,0,Meme Difficulté,Adapte,Philosophy
6357,2020,Philosophie,1,Introduction a la Philosophie,7,La Verite,9,803,7,QCM,0.33,0.57,60.85,8,5,13,9,8,1,1.44,88.89,Moyen,Moyen,0,Meme Difficulté,Adapte,Philosophy
803,2015,Philosophie,1,Introduction a la Philosophie,7,La Verite,9,804,8,QCU,0.25,0.67,39.39,3,5,8,4,3,1,2.0,75.0,Facile,Moyen,-1,Plus Difficile,Pas Adapte,Philosophy
1914,2016,Philosophie,1,Introduction a la Philosophie,7,La Verite,9,804,8,QCM,0.69,0.18,11.32,1,6,7,2,1,1,3.5,50.0,Difficile,Difficile,0,Meme Difficulté,Pas Adapte,Philosophy
3025,2017,Philosophie,1,Introduction a la Philosophie,7,La Verite,9,804,8,QCM,0.52,0.2,27.01,2,4,6,5,2,3,1.2,40.0,Difficile,Difficile,0,Meme Difficulté,Pas Adapte,Philosophy
4136,2018,Philosophie,1,Introduction a la Philosophie,7,La Verite,9,804,8,QCM,0.21,0.4,57.93,3,2,5,4,3,1,1.25,75.0,Moyen,Moyen,0,Meme Difficulté,Pas Adapte,Philosophy
5247,2019,Philosophie,1,Introduction a la Philosophie,7,La Verite,9,804,8,QCM,0.14,0.72,82.31,3,1,4,3,3,0,1.33,100.0,Difficile,Facile,2,Beaucoup plus Facile,Pas Adapte,Philosophy
6358,2020,Philosophie,1,Introduction a la Philosophie,7,La Verite,9,804,8,QCM,0.67,0.17,18.35,1,2,3,2,1,1,1.5,50.0,Moyen,Difficile,-1,Plus Difficile,Pas Adapte,Philosophy
804,2015,Philosophie,1,Introduction a la Philosophie,7,La Verite,9,805,9,QCU,0.0,0.92,96.17,21,1,22,22,21,1,1.0,95.45,Facile,Facile,0,Meme Difficulté,Pas Adapte,Philosophy
1915,2016,Philosophie,1,Introduction a la Philosophie,7,La Verite,9,805,9,QCU,0.19,0.82,87.96,21,3,24,24,21,3,1.0,87.5,Difficile,Facile,2,Beaucoup plus Facile,Pas Adapte,Philosophy
3026,2017,Philosophie,1,Introduction a la Philosophie,7,La Verite,9,805,9,QCU,0.1,0.81,70.07,17,7,24,19,17,2,1.26,89.47,Facile,Facile,0,Meme Difficulté,Adapte,Philosophy
4137,2018,Philosophie,1,Introduction a la Philosophie,7,La Verite,9,805,9,QCU,0.06,0.85,70.07,18,8,26,21,18,3,1.24,85.71,Facile,Facile,0,Meme Difficulté,Adapte,Philosophy
5248,2019,Philosophie,1,Introduction a la Philosophie,7,La Verite,9,805,9,QCU,0.15,0.97,70.07,21,9,30,27,21,6,1.11,77.78,Facile,Facile,0,Meme Difficulté,Adapte,Philosophy
6359,2020,Philosophie,1,Introduction a la Philosophie,7,La Verite,9,805,9,QCU,0.1,0.75,70.07,18,8,26,18,18,0,1.44,100.0,Facile,Facile,0,Meme Difficulté,Adapte,Philosophy
805,2015,Philosophie,1,Introduction a la Philosophie,8,La Conscience,9,806,1,QCM,0.02,0.98,96.93,47,1,48,47,47,0,1.02,100.0,Facile,Facile,0,Meme Difficulté,Pas Adapte,Philosophy
1916,2016,Philosophie,1,Introduction a la Philosophie,8,La Conscience,9,806,1,QCM,0.08,0.74,73.61,38,13,51,51,38,13,1.0,74.51,Facile,Facile,0,Meme Difficulté,Adapte,Philosophy
3027,2017,Philosophie,1,Introduction a la Philosophie,8,La Conscience,9,806,1,QCU,0.11,0.92,73.61,42,15,57,43,42,1,1.33,97.67,Facile,Facile,0,Meme Difficulté,Adapte,Philosophy
4138,2018,Philosophie,1,Introduction a la Philosophie,8,La Conscience,9,806,1,QCU,0.02,0.84,73.61,37,13,50,47,37,10,1.06,78.72,Facile,Facile,0,Meme Difficulté,Adapte,Philosophy
5249,2019,Philosophie,1,Introduction a la Philosophie,8,La Conscience,9,806,1,QCU,0.05,0.8,73.61,36,13,49,41,36,5,1.2,87.8,Facile,Facile,0,Meme Difficulté,Adapte,Philosophy
6360,2020,Philosophie,1,Introduction a la Philosophie,8,La Conscience,9,806,1,QCU,0.05,0.9,73.61,41,15,56,48,41,7,1.17,85.42,Facile,Facile,0,Meme Difficulté,Adapte,Philosophy
806,2015,Philosophie,1,Introduction a la Philosophie,8,La Conscience,9,807,2,QCU,0.02,0.9,87.26,45,7,52,46,45,1,1.13,97.83,Facile,Facile,0,Meme Difficulté,Pas Adapte,Philosophy
1917,2016,Philosophie,1,Introduction a la Philosophie,8,La Conscience,9,807,2,QCU,0.32,0.74,50.59,29,29,58,40,29,11,1.45,72.5,Moyen,Moyen,0,Meme Difficulté,Pas Adapte,Philosophy
3028,2017,Philosophie,1,Introduction a la Philosophie,8,La Conscience,9,807,2,QCU,0.61,0.3,33.34,22,43,65,40,22,18,1.62,55.0,Facile,Difficile,-2,Beaucoup plus Difficile,Pas Adapte,Philosophy
4139,2018,Philosophie,1,Introduction a la Philosophie,8,La Conscience,9,807,2,QCU,0.07,0.97,76.12,43,13,56,49,43,6,1.14,87.76,Difficile,Facile,2,Beaucoup plus Facile,Pas Adapte,Philosophy
5250,2019,Philosophie,1,Introduction a la Philosophie,8,La Conscience,9,807,2,QCU,0.09,0.76,70.32,45,19,64,59,45,14,1.08,76.27,Moyen,Facile,1,Plus Facile,Adapte,Philosophy
6361,2020,Philosophie,1,Introduction a la Philosophie,8,La Conscience,9,807,2,QCU,0.18,0.78,70.32,39,17,56,54,39,15,1.04,72.22,Facile,Facile,0,Meme Difficulté,Adapte,Philosophy
807,2015,Philosophie,1,Introduction a la Philosophie,8,La Conscience,9,808,3,QCU,0.65,0.36,28.28,10,25,35,34,10,24,1.03,29.41,Facile,Difficile,-2,Beaucoup plus Difficile,Pas Adapte,Philosophy
1918,2016,Philosophie,1,Introduction a la Philosophie,8,La Conscience,9,808,3,QCU,0.64,0.28,10.26,4,34,38,18,4,14,2.11,22.22,Difficile,Difficile,0,Meme Difficulté,Pas Adapte,Philosophy
3029,2017,Philosophie,1,Introduction a la Philosophie,8,La Conscience,9,808,3,QCU,0.48,0.29,21.8,9,31,40,34,9,25,1.18,26.47,Difficile,Difficile,0,Meme Difficulté,Pas Adapte,Philosophy
4140,2018,Philosophie,1,Introduction a la Philosophie,8,La Conscience,9,808,3,QCM,0.08,0.81,81.9,29,7,36,33,29,4,1.09,87.88,Difficile,Facile,2,Beaucoup plus Facile,Pas Adapte,Philosophy
5251,2019,Philosophie,1,Introduction a la Philosophie,8,La Conscience,9,808,3,QCM,0.15,0.75,89.92,36,4,40,38,36,2,1.05,94.74,Moyen,Facile,1,Plus Facile,Pas Adapte,Philosophy
6362,2020,Philosophie,1,Introduction a la Philosophie,8,La Conscience,9,808,3,QCM,0.54,0.17,20.04,7,28,35,14,7,7,2.5,50.0,Difficile,Difficile,0,Meme Difficulté,Pas Adapte,Philosophy
808,2015,Philosophie,1,Introduction a la Philosophie,8,La Conscience,9,809,4,QROC,0.46,0.4,43.85,34,44,78,38,34,4,2.05,89.47,Facile,Moyen,-1,Plus Difficile,Pas Adapte,Philosophy
1919,2016,Philosophie,1,Introduction a la Philosophie,8,La Conscience,9,809,4,QO,0.58,0.28,58.29,47,34,81,65,47,18,1.25,72.31,Facile,Moyen,-1,Plus Difficile,Pas Adapte,Philosophy
3030,2017,Philosophie,1,Introduction a la Philosophie,8,La Conscience,9,809,4,QO,0.02,0.3,79.69,70,18,88,80,70,10,1.1,87.5,Moyen,Facile,1,Plus Facile,Pas Adapte,Philosophy
4141,2018,Philosophie,1,Introduction a la Philosophie,8,La Conscience,9,809,4,QO,0.84,0.13,1.05,1,87,88,66,1,65,1.33,1.52,Facile,Difficile,-2,Beaucoup plus Difficile,Pas Adapte,Philosophy
5252,2019,Philosophie,1,Introduction a la Philosophie,8,La Conscience,9,809,4,QO,0.96,0.0,11.77,9,68,77,44,9,35,1.75,20.45,Difficile,Difficile,0,Meme Difficulté,Pas Adapte,Philosophy
6363,2020,Philosophie,1,Introduction a la Philosophie,8,La Conscience,9,809,4,QO,0.92,0.01,2.31,2,86,88,87,2,85,1.01,2.3,Moyen,Difficile,-1,Plus Difficile,Pas Adapte,Philosophy
809,2015,Philosophie,1,Introduction a la Philosophie,8,La Conscience,9,810,5,QCU,0.71,0.29,12.27,3,21,24,10,3,7,2.4,30.0,Moyen,Difficile,-1,Plus Difficile,Pas Adapte,Philosophy
1920,2016,Philosophie,1,Introduction a la Philosophie,8,La Conscience,9,810,5,QCU,0.7,0.23,18.69,4,17,21,9,4,5,2.33,44.44,Moyen,Difficile,-1,Plus Difficile,Pas Adapte,Philosophy
3031,2017,Philosophie,1,Introduction a la Philosophie,8,La Conscience,9,810,5,QCU,0.62,0.35,30.33,7,17,24,13,7,6,1.85,53.85,Moyen,Difficile,-1,Plus Difficile,Pas Adapte,Philosophy
4142,2018,Philosophie,1,Introduction a la Philosophie,8,La Conscience,9,810,5,QCU,0.66,0.35,10.42,3,24,27,27,3,24,1.0,11.11,Facile,Difficile,-2,Beaucoup plus Difficile,Pas Adapte,Philosophy
5253,2019,Philosophie,1,Introduction a la Philosophie,8,La Conscience,9,810,5,QO,0.99,0.09,16.69,4,20,24,21,4,17,1.14,19.05,Facile,Difficile,-2,Beaucoup plus Difficile,Pas Adapte,Philosophy
6364,2020,Philosophie,1,Introduction a la Philosophie,8,La Conscience,9,810,5,QO,0.68,0.15,47.48,10,11,21,19,10,9,1.11,52.63,Moyen,Moyen,0,Meme Difficulté,Pas Adapte,Philosophy
810,2015,Philosophie,1,Introduction a la Philosophie,8,La Conscience,9,811,6,QROC,0.44,0.27,61.19,61,39,100,83,61,22,1.2,73.49,Difficile,Moyen,1,Plus Facile,Adapte,Philosophy
1921,2016,Philosophie,1,Introduction a la Philosophie,8,La Conscience,9,811,6,QROC,0.41,0.32,61.19,59,38,97,96,59,37,1.01,61.46,Moyen,Moyen,0,Meme Difficulté,Adapte,Philosophy
3032,2017,Philosophie,1,Introduction a la Philosophie,8,La Conscience,9,811,6,QROC,0.49,0.29,61.19,55,35,90,77,55,22,1.17,71.43,Moyen,Moyen,0,Meme Difficulté,Adapte,Philosophy
4143,2018,Philosophie,1,Introduction a la Philosophie,8,La Conscience,9,811,6,QROC,0.45,0.36,61.19,60,38,98,75,60,15,1.31,80.0,Moyen,Moyen,0,Meme Difficulté,Adapte,Philosophy
5254,2019,Philosophie,1,Introduction a la Philosophie,8,La Conscience,9,811,6,QROC,0.46,0.38,61.19,55,35,90,80,55,25,1.12,68.75,Moyen,Moyen,0,Meme Difficulté,Adapte,Philosophy
6365,2020,Philosophie,1,Introduction a la Philosophie,8,La Conscience,9,811,6,QROC,0.51,0.38,61.19,51,33,84,58,51,7,1.45,87.93,Moyen,Moyen,0,Meme Difficulté,Adapte,Philosophy
811,2015,Philosophie,1,Introduction a la Philosophie,8,La Conscience,9,812,7,QCM,0.24,0.63,39.33,34,52,86,81,34,47,1.06,41.98,Moyen,Moyen,0,Meme Difficulté,Pas Adapte,Philosophy
1922,2016,Philosophie,1,Introduction a la Philosophie,8,La Conscience,9,812,7,QCU,0.13,0.8,85.54,63,11,74,67,63,4,1.1,94.03,Facile,Facile,0,Meme Difficulté,Pas Adapte,Philosophy
3033,2017,Philosophie,1,Introduction a la Philosophie,8,La Conscience,9,812,7,QCU,0.07,0.85,84.16,72,13,85,85,72,13,1.0,84.71,Difficile,Facile,2,Beaucoup plus Facile,Pas Adapte,Philosophy
4144,2018,Philosophie,1,Introduction a la Philosophie,8,La Conscience,9,812,7,QCU,0.3,0.52,36.76,32,55,87,76,32,44,1.14,42.11,Facile,Moyen,-1,Plus Difficile,Pas Adapte,Philosophy
5255,2019,Philosophie,1,Introduction a la Philosophie,8,La Conscience,9,812,7,QCU,0.11,0.87,96.75,77,3,80,78,77,1,1.03,98.72,Facile,Facile,0,Meme Difficulté,Pas Adapte,Philosophy
6366,2020,Philosophie,1,Introduction a la Philosophie,8,La Conscience,9,812,7,QCU,0.27,0.49,49.37,39,40,79,47,39,8,1.68,82.98,Difficile,Moyen,1,Plus Facile,Pas Adapte,Philosophy
812,2015,Philosophie,1,Introduction a la Philosophie,8,La Conscience,9,813,8,QCM,0.68,0.28,26.84,7,20,27,26,7,19,1.04,26.92,Moyen,Difficile,-1,Plus Difficile,Pas Adapte,Philosophy
1923,2016,Philosophie,1,Introduction a la Philosophie,8,La Conscience,9,813,8,QCM,0.36,0.38,38.83,10,17,27,24,10,14,1.12,41.67,Facile,Moyen,-1,Plus Difficile,Pas Adapte,Philosophy
3034,2017,Philosophie,1,Introduction a la Philosophie,8,La Conscience,9,813,8,QCM,0.61,0.15,19.66,6,23,29,22,6,16,1.32,27.27,Moyen,Difficile,-1,Plus Difficile,Pas Adapte,Philosophy
4145,2018,Philosophie,1,Introduction a la Philosophie,8,La Conscience,9,813,8,QCM,0.19,0.75,65.5,21,11,32,23,21,2,1.39,91.3,Difficile,Facile,2,Beaucoup plus Facile,Adapte,Philosophy
5256,2019,Philosophie,1,Introduction a la Philosophie,8,La Conscience,9,813,8,QCM,0.04,0.92,65.5,21,11,32,26,21,5,1.23,80.77,Facile,Facile,0,Meme Difficulté,Adapte,Philosophy
6367,2020,Philosophie,1,Introduction a la Philosophie,8,La Conscience,9,813,8,QCM,0.03,0.9,65.5,18,9,27,19,18,1,1.42,94.74,Facile,Facile,0,Meme Difficulté,Adapte,Philosophy
813,2015,Philosophie,1,Introduction a la Philosophie,8,La Conscience,9,814,9,QCM,0.18,0.92,97.28,37,1,38,38,37,1,1.0,97.37,Facile,Facile,0,Meme Difficulté,Pas Adapte,Philosophy
1924,2016,Philosophie,1,Introduction a la Philosophie,8,La Conscience,9,814,9,QCM,0.72,0.18,24.23,10,33,43,41,10,31,1.05,24.39,Difficile,Difficile,0,Meme Difficulté,Pas Adapte,Philosophy
3035,2017,Philosophie,1,Introduction a la Philosophie,8,La Conscience,9,814,9,QCM,0.15,0.94,81.33,37,9,46,37,37,0,1.24,100.0,Difficile,Facile,2,Beaucoup plus Facile,Pas Adapte,Philosophy
4146,2018,Philosophie,1,Introduction a la Philosophie,8,La Conscience,9,814,9,QROC,0.21,0.37,39.83,17,26,43,40,17,23,1.07,42.5,Moyen,Moyen,0,Meme Difficulté,Pas Adapte,Philosophy
5257,2019,Philosophie,1,Introduction a la Philosophie,8,La Conscience,9,814,9,QROC,0.04,0.72,86.78,43,6,49,48,43,5,1.02,89.58,Moyen,Facile,1,Plus Facile,Pas Adapte,Philosophy
6368,2020,Philosophie,1,Introduction a la Philosophie,8,La Conscience,9,814,9,QROC,0.92,0.13,30.61,16,36,52,28,16,12,1.86,57.14,Facile,Difficile,-2,Beaucoup plus Difficile,Pas Adapte,Philosophy
814,2015,Philosophie,1,Introduction a la Philosophie,9,La Liberte,5,815,1,QCU,0.22,0.52,63.49,13,8,21,18,13,5,1.17,72.22,Facile,Moyen,-1,Plus Difficile,Adapte,Philosophy
1925,2016,Philosophie,1,Introduction a la Philosophie,9,La Liberte,5,815,1,QCU,0.31,0.63,63.49,13,7,20,13,13,0,1.54,100.0,Moyen,Moyen,0,Meme Difficulté,Adapte,Philosophy
3036,2017,Philosophie,1,Introduction a la Philosophie,9,La Liberte,5,815,1,QO,0.75,0.25,63.49,11,7,18,16,11,5,1.12,68.75,Moyen,Moyen,0,Meme Difficulté,Adapte,Philosophy
4147,2018,Philosophie,1,Introduction a la Philosophie,9,La Liberte,5,815,1,QO,0.45,0.18,63.49,13,8,21,14,13,1,1.5,92.86,Moyen,Moyen,0,Meme Difficulté,Adapte,Philosophy
5258,2019,Philosophie,1,Introduction a la Philosophie,9,La Liberte,5,815,1,QO,0.66,0.26,63.49,14,8,22,17,14,3,1.29,82.35,Moyen,Moyen,0,Meme Difficulté,Adapte,Philosophy
6369,2020,Philosophie,1,Introduction a la Philosophie,9,La Liberte,5,815,1,QO,0.42,0.16,63.49,13,8,21,16,13,3,1.31,81.25,Moyen,Moyen,0,Meme Difficulté,Adapte,Philosophy
815,2015,Philosophie,1,Introduction a la Philosophie,9,La Liberte,5,816,2,QCU,0.08,0.83,92.73,66,5,71,68,66,2,1.04,97.06,Facile,Facile,0,Meme Difficulté,Pas Adapte,Philosophy
1926,2016,Philosophie,1,Introduction a la Philosophie,9,La Liberte,5,816,2,QROC,0.82,0.1,3.06,3,79,82,77,3,74,1.06,3.9,Facile,Difficile,-2,Beaucoup plus Difficile,Pas Adapte,Philosophy
3037,2017,Philosophie,1,Introduction a la Philosophie,9,La Liberte,5,816,2,QROC,0.17,0.95,76.15,68,21,89,83,68,15,1.07,81.93,Moyen,Facile,1,Plus Facile,Pas Adapte,Philosophy
4148,2018,Philosophie,1,Introduction a la Philosophie,9,La Liberte,5,816,2,QROC,0.17,0.48,72.97,66,24,90,88,66,22,1.02,75.0,Moyen,Facile,1,Plus Facile,Adapte,Philosophy
5259,2019,Philosophie,1,Introduction a la Philosophie,9,La Liberte,5,816,2,QROC,0.0,0.96,72.97,73,27,100,84,73,11,1.19,86.9,Facile,Facile,0,Meme Difficulté,Adapte,Philosophy
6370,2020,Philosophie,1,Introduction a la Philosophie,9,La Liberte,5,816,2,QROC,0.2,0.61,72.97,80,29,109,91,80,11,1.2,87.91,Facile,Facile,0,Meme Difficulté,Adapte,Philosophy
816,2015,Philosophie,1,Introduction a la Philosophie,9,La Liberte,5,817,3,QCM,0.03,0.74,74.3,42,14,56,44,42,2,1.27,95.45,Difficile,Facile,2,Beaucoup plus Facile,Adapte,Philosophy
1927,2016,Philosophie,1,Introduction a la Philosophie,9,La Liberte,5,817,3,QCM,0.09,0.77,74.3,45,15,60,53,45,8,1.13,84.91,Facile,Facile,0,Meme Difficulté,Adapte,Philosophy
3038,2017,Philosophie,1,Introduction a la Philosophie,9,La Liberte,5,817,3,QCM,0.15,0.77,74.3,45,16,61,48,45,3,1.27,93.75,Facile,Facile,0,Meme Difficulté,Adapte,Philosophy
4149,2018,Philosophie,1,Introduction a la Philosophie,9,La Liberte,5,817,3,QCM,0.06,0.98,74.3,51,17,68,62,51,11,1.1,82.26,Facile,Facile,0,Meme Difficulté,Adapte,Philosophy
5260,2019,Philosophie,1,Introduction a la Philosophie,9,La Liberte,5,817,3,QCM,0.0,0.75,74.3,47,16,63,52,47,5,1.21,90.38,Facile,Facile,0,Meme Difficulté,Adapte,Philosophy
6371,2020,Philosophie,1,Introduction a la Philosophie,9,La Liberte,5,817,3,QCM,0.15,0.78,74.3,45,15,60,53,45,8,1.13,84.91,Facile,Facile,0,Meme Difficulté,Adapte,Philosophy
817,2015,Philosophie,1,Introduction a la Philosophie,9,La Liberte,5,818,4,QROC,0.2,0.28,51.81,42,40,82,59,42,17,1.39,71.19,Facile,Moyen,-1,Plus Difficile,Pas Adapte,Philosophy
1928,2016,Philosophie,1,Introduction a la Philosophie,9,La Liberte,5,818,4,QROC,0.8,0.02,30.14,26,60,86,35,26,9,2.46,74.29,Moyen,Difficile,-1,Plus Difficile,Pas Adapte,Philosophy
3039,2017,Philosophie,1,Introduction a la Philosophie,9,La Liberte,5,818,4,QROC,0.11,0.82,79.04,61,16,77,69,61,8,1.12,88.41,Facile,Facile,0,Meme Difficulté,Pas Adapte,Philosophy
4150,2018,Philosophie,1,Introduction a la Philosophie,9,La Liberte,5,818,4,QROC,0.15,0.43,88.42,64,8,72,69,64,5,1.04,92.75,Moyen,Facile,1,Plus Facile,Pas Adapte,Philosophy
5261,2019,Philosophie,1,Introduction a la Philosophie,9,La Liberte,5,818,4,QROC,0.21,0.37,46.41,38,43,81,47,38,9,1.72,80.85,Moyen,Moyen,0,Meme Difficulté,Pas Adapte,Philosophy
6372,2020,Philosophie,1,Introduction a la Philosophie,9,La Liberte,5,818,4,QROC,0.0,0.46,74.36,52,18,70,53,52,1,1.32,98.11,Facile,Facile,0,Meme Difficulté,Adapte,Philosophy
818,2015,Philosophie,1,Introduction a la Philosophie,9,La Liberte,5,819,5,QROC,0.18,0.49,86.47,16,2,18,17,16,1,1.06,94.12,Difficile,Facile,2,Beaucoup plus Facile,Pas Adapte,Philosophy
1929,2016,Philosophie,1,Introduction a la Philosophie,9,La Liberte,5,819,5,QO,0.93,0.09,17.52,3,16,19,17,3,14,1.12,17.65,Difficile,Difficile,0,Meme Difficulté,Pas Adapte,Philosophy
3040,2017,Philosophie,1,Introduction a la Philosophie,9,La Liberte,5,819,5,QO,0.66,0.3,38.78,8,13,21,20,8,12,1.05,40.0,Facile,Moyen,-1,Plus Difficile,Pas Adapte,Philosophy
4151,2018,Philosophie,1,Introduction a la Philosophie,9,La Liberte,5,819,5,QO,0.02,0.98,91.12,20,2,22,21,20,1,1.05,95.24,Difficile,Facile,2,Beaucoup plus Facile,Pas Adapte,Philosophy
5262,2019,Philosophie,1,Introduction a la Philosophie,9,La Liberte,5,819,5,QO,0.85,0.08,26.76,6,15,21,18,6,12,1.17,33.33,Difficile,Difficile,0,Meme Difficulté,Pas Adapte,Philosophy
6373,2020,Philosophie,1,Introduction a la Philosophie,9,La Liberte,5,819,5,QO,0.17,0.54,80.49,17,4,21,20,17,3,1.05,85.0,Moyen,Facile,1,Plus Facile,Pas Adapte,Philosophy
819,2015,Philosophie,2,La Notion de Logique,1,Les Lois Logiques,9,820,1,QCU,0.04,0.77,84.14,34,6,40,37,34,3,1.08,91.89,Facile,Facile,0,Meme Difficulté,Pas Adapte,Philosophy
1930,2016,Philosophie,2,La Notion de Logique,1,Les Lois Logiques,9,820,1,QROC,0.84,0.18,14.71,5,29,34,20,5,15,1.7,25.0,Difficile,Difficile,0,Meme Difficulté,Pas Adapte,Philosophy
3041,2017,Philosophie,2,La Notion de Logique,1,Les Lois Logiques,9,820,1,QROC,0.63,0.03,19.46,7,28,35,26,7,19,1.35,26.92,Moyen,Difficile,-1,Plus Difficile,Pas Adapte,Philosophy
4152,2018,Philosophie,2,La Notion de Logique,1,Les Lois Logiques,9,820,1,QROC,0.63,0.1,23.53,9,29,38,29,9,20,1.31,31.03,Difficile,Difficile,0,Meme Difficulté,Pas Adapte,Philosophy
5263,2019,Philosophie,2,La Notion de Logique,1,Les Lois Logiques,9,820,1,QROC,0.66,0.2,29.57,12,27,39,22,12,10,1.77,54.55,Moyen,Difficile,-1,Plus Difficile,Pas Adapte,Philosophy
6374,2020,Philosophie,2,La Notion de Logique,1,Les Lois Logiques,9,820,1,QROC,0.97,0.17,2.19,1,32,33,17,1,16,1.94,5.88,Difficile,Difficile,0,Meme Difficulté,Pas Adapte,Philosophy
820,2015,Philosophie,2,La Notion de Logique,1,Les Lois Logiques,9,821,2,QCU,0.08,0.81,81.63,34,8,42,40,34,6,1.05,85.0,Facile,Facile,0,Meme Difficulté,Pas Adapte,Philosophy
1931,2016,Philosophie,2,La Notion de Logique,1,Les Lois Logiques,9,821,2,QCU,0.22,0.73,62.09,30,18,48,38,30,8,1.26,78.95,Moyen,Moyen,0,Meme Difficulté,Adapte,Philosophy
3042,2017,Philosophie,2,La Notion de Logique,1,Les Lois Logiques,9,821,2,QCU,0.37,0.46,62.09,26,16,42,38,26,12,1.11,68.42,Moyen,Moyen,0,Meme Difficulté,Adapte,Philosophy
4153,2018,Philosophie,2,La Notion de Logique,1,Les Lois Logiques,9,821,2,QCM,0.39,0.49,62.09,22,14,36,23,22,1,1.57,95.65,Moyen,Moyen,0,Meme Difficulté,Adapte,Philosophy
5264,2019,Philosophie,2,La Notion de Logique,1,Les Lois Logiques,9,821,2,QCM,0.37,0.59,62.09,23,14,37,32,23,9,1.16,71.88,Moyen,Moyen,0,Meme Difficulté,Adapte,Philosophy
6375,2020,Philosophie,2,La Notion de Logique,1,Les Lois Logiques,9,821,2,QCU,0.3,0.55,62.09,20,12,32,28,20,8,1.14,71.43,Moyen,Moyen,0,Meme Difficulté,Adapte,Philosophy
821,2015,Philosophie,2,La Notion de Logique,1,Les Lois Logiques,9,822,3,QCM,0.58,0.18,29.48,24,58,82,58,24,34,1.41,41.38,Moyen,Difficile,-1,Plus Difficile,Pas Adapte,Philosophy
1932,2016,Philosophie,2,La Notion de Logique,1,Les Lois Logiques,9,822,3,QCM,0.02,0.98,98.09,70,1,71,70,70,0,1.01,100.0,Facile,Facile,0,Meme Difficulté,Pas Adapte,Philosophy
3043,2017,Philosophie,2,La Notion de Logique,1,Les Lois Logiques,9,822,3,QCM,0.65,0.3,8.87,6,62,68,25,6,19,2.72,24.0,Facile,Difficile,-2,Beaucoup plus Difficile,Pas Adapte,Philosophy
4154,2018,Philosophie,2,La Notion de Logique,1,Les Lois Logiques,9,822,3,QCM,0.06,0.95,71.64,54,22,76,62,54,8,1.23,87.1,Difficile,Facile,2,Beaucoup plus Facile,Adapte,Philosophy
5265,2019,Philosophie,2,La Notion de Logique,1,Les Lois Logiques,9,822,3,QCU,0.02,0.99,71.64,56,22,78,58,56,2,1.34,96.55,Facile,Facile,0,Meme Difficulté,Adapte,Philosophy
6376,2020,Philosophie,2,La Notion de Logique,1,Les Lois Logiques,9,822,3,QCU,0.1,0.81,71.64,48,19,67,52,48,4,1.29,92.31,Facile,Facile,0,Meme Difficulté,Adapte,Philosophy
822,2015,Philosophie,2,La Notion de Logique,1,Les Lois Logiques,9,823,4,QCU,0.48,0.33,3.41,2,57,59,39,2,37,1.51,5.13,Facile,Difficile,-2,Beaucoup plus Difficile,Pas Adapte,Philosophy
1933,2016,Philosophie,2,La Notion de Logique,1,Les Lois Logiques,9,823,4,QCU,0.02,0.96,90.22,55,6,61,59,55,4,1.03,93.22,Difficile,Facile,2,Beaucoup plus Facile,Pas Adapte,Philosophy
3044,2017,Philosophie,2,La Notion de Logique,1,Les Lois Logiques,9,823,4,QCU,0.34,0.41,58.68,33,24,57,40,33,7,1.43,82.5,Moyen,Moyen,0,Meme Difficulté,Pas Adapte,Philosophy
4155,2018,Philosophie,2,La Notion de Logique,1,Les Lois Logiques,9,823,4,QCU,0.29,0.74,54.82,35,29,64,38,35,3,1.68,92.11,Difficile,Moyen,1,Plus Facile,Pas Adapte,Philosophy
5266,2019,Philosophie,2,La Notion de Logique,1,Les Lois Logiques,9,823,4,QROC,0.2,0.58,92.71,64,5,69,67,64,3,1.03,95.52,Moyen,Facile,1,Plus Facile,Pas Adapte,Philosophy
6377,2020,Philosophie,2,La Notion de Logique,1,Les Lois Logiques,9,823,4,QROC,0.34,0.32,49.65,30,31,61,38,30,8,1.61,78.95,Moyen,Moyen,0,Meme Difficulté,Pas Adapte,Philosophy
823,2015,Philosophie,2,La Notion de Logique,1,Les Lois Logiques,9,824,5,QROC,0.86,0.2,17.64,11,51,62,49,11,38,1.27,22.45,Moyen,Difficile,-1,Plus Difficile,Pas Adapte,Philosophy
1934,2016,Philosophie,2,La Notion de Logique,1,Les Lois Logiques,9,824,5,QROC,0.19,0.74,91.81,55,5,60,60,55,5,1.0,91.67,Difficile,Facile,2,Beaucoup plus Facile,Pas Adapte,Philosophy
3045,2017,Philosophie,2,La Notion de Logique,1,Les Lois Logiques,9,824,5,QROC,0.19,0.55,84.41,49,9,58,54,49,5,1.07,90.74,Moyen,Facile,1,Plus Facile,Pas Adapte,Philosophy
4156,2018,Philosophie,2,La Notion de Logique,1,Les Lois Logiques,9,824,5,QROC,0.78,0.05,21.08,12,47,59,49,12,37,1.2,24.49,Facile,Difficile,-2,Beaucoup plus Difficile,Pas Adapte,Philosophy
5267,2019,Philosophie,2,La Notion de Logique,1,Les Lois Logiques,9,824,5,QROC,0.02,0.96,90.9,56,6,62,61,56,5,1.02,91.8,Facile,Facile,0,Meme Difficulté,Pas Adapte,Philosophy
6378,2020,Philosophie,2,La Notion de Logique,1,Les Lois Logiques,9,824,5,QROC,0.25,0.35,36.76,25,42,67,36,25,11,1.86,69.44,Difficile,Moyen,1,Plus Facile,Pas Adapte,Philosophy
824,2015,Philosophie,2,La Notion de Logique,1,Les Lois Logiques,9,825,6,QCM,0.57,0.24,32.61,23,46,69,50,23,27,1.38,46.0,Facile,Difficile,-2,Beaucoup plus Difficile,Pas Adapte,Philosophy
1935,2016,Philosophie,2,La Notion de Logique,1,Les Lois Logiques,9,825,6,QCM,0.7,0.24,9.1,7,67,74,36,7,29,2.06,19.44,Difficile,Difficile,0,Meme Difficulté,Pas Adapte,Philosophy
3046,2017,Philosophie,2,La Notion de Logique,1,Les Lois Logiques,9,825,6,QCM,0.16,0.93,98.6,67,1,68,68,67,1,1.0,98.53,Facile,Facile,0,Meme Difficulté,Pas Adapte,Philosophy
4157,2018,Philosophie,2,La Notion de Logique,1,Les Lois Logiques,9,825,6,QCM,0.17,0.84,69.76,54,24,78,59,54,5,1.32,91.53,Difficile,Facile,2,Beaucoup plus Facile,Adapte,Philosophy
5268,2019,Philosophie,2,La Notion de Logique,1,Les Lois Logiques,9,825,6,QCM,0.05,0.96,69.76,47,21,68,48,47,1,1.42,97.92,Facile,Facile,0,Meme Difficulté,Adapte,Philosophy
6379,2020,Philosophie,2,La Notion de Logique,1,Les Lois Logiques,9,825,6,QCU,0.17,0.83,69.76,42,18,60,53,42,11,1.13,79.25,Facile,Facile,0,Meme Difficulté,Adapte,Philosophy
825,2015,Philosophie,2,La Notion de Logique,1,Les Lois Logiques,9,826,7,QCU,0.23,0.51,56.4,19,14,33,20,19,1,1.65,95.0,Facile,Moyen,-1,Plus Difficile,Pas Adapte,Philosophy
1936,2016,Philosophie,2,La Notion de Logique,1,Les Lois Logiques,9,826,7,QCU,0.06,0.86,84.4,26,5,31,30,26,4,1.03,86.67,Moyen,Facile,1,Plus Facile,Pas Adapte,Philosophy
3047,2017,Philosophie,2,La Notion de Logique,1,Les Lois Logiques,9,826,7,QCU,0.28,0.59,46.35,15,18,33,27,15,12,1.22,55.56,Facile,Moyen,-1,Plus Difficile,Pas Adapte,Philosophy
4158,2018,Philosophie,2,La Notion de Logique,1,Les Lois Logiques,9,826,7,QROC,0.88,0.0,25.63,7,22,29,17,7,10,1.71,41.18,Facile,Difficile,-2,Beaucoup plus Difficile,Pas Adapte,Philosophy
5269,2019,Philosophie,2,La Notion de Logique,1,Les Lois Logiques,9,826,7,QO,0.1,0.61,93.58,28,2,30,29,28,1,1.03,96.55,Difficile,Facile,2,Beaucoup plus Facile,Pas Adapte,Philosophy
6380,2020,Philosophie,2,La Notion de Logique,1,Les Lois Logiques,9,826,7,QO,0.1,0.74,95.82,28,1,29,29,28,1,1.0,96.55,Moyen,Facile,1,Plus Facile,Pas Adapte,Philosophy
826,2015,Philosophie,2,La Notion de Logique,1,Les Lois Logiques,9,827,8,QCM,0.57,0.19,7.45,1,6,7,5,1,4,1.4,20.0,Facile,Difficile,-2,Beaucoup plus Difficile,Pas Adapte,Philosophy
1937,2016,Philosophie,2,La Notion de Logique,1,Les Lois Logiques,9,827,8,QCM,0.36,0.37,37.43,2,4,6,5,2,3,1.2,40.0,Facile,Moyen,-1,Plus Difficile,Pas Adapte,Philosophy
3048,2017,Philosophie,2,La Notion de Logique,1,Les Lois Logiques,9,827,8,QCM,0.22,0.63,49.16,3,4,7,6,3,3,1.17,50.0,Facile,Moyen,-1,Plus Difficile,Pas Adapte,Philosophy
4159,2018,Philosophie,2,La Notion de Logique,1,Les Lois Logiques,9,827,8,QCM,0.07,0.88,96.34,8,0,8,8,8,0,1.0,100.0,Facile,Facile,0,Meme Difficulté,Pas Adapte,Philosophy
5270,2019,Philosophie,2,La Notion de Logique,1,Les Lois Logiques,9,827,8,QCM,0.58,0.23,23.48,2,5,7,2,2,0,3.5,100.0,Moyen,Difficile,-1,Plus Difficile,Pas Adapte,Philosophy
6381,2020,Philosophie,2,La Notion de Logique,1,Les Lois Logiques,9,827,8,QCU,0.42,0.23,1.37,0,8,8,7,0,7,1.14,0.0,Difficile,Difficile,0,Meme Difficulté,Pas Adapte,Philosophy
827,2015,Philosophie,2,La Notion de Logique,1,Les Lois Logiques,9,828,9,QCU,0.55,0.22,6.78,1,11,12,8,1,7,1.5,12.5,Facile,Difficile,-2,Beaucoup plus Difficile,Pas Adapte,Philosophy
1938,2016,Philosophie,2,La Notion de Logique,1,Les Lois Logiques,9,828,9,QCU,0.64,0.23,11.51,1,12,13,7,1,6,1.86,14.29,Moyen,Difficile,-1,Plus Difficile,Pas Adapte,Philosophy
3049,2017,Philosophie,2,La Notion de Logique,1,Les Lois Logiques,9,828,9,QCU,0.43,0.38,22.67,3,12,15,9,3,6,1.67,33.33,Difficile,Difficile,0,Meme Difficulté,Pas Adapte,Philosophy
4160,2018,Philosophie,2,La Notion de Logique,1,Les Lois Logiques,9,828,9,QCU,0.2,0.94,73.44,10,3,13,12,10,2,1.08,83.33,Facile,Facile,0,Meme Difficulté,Adapte,Philosophy
5271,2019,Philosophie,2,La Notion de Logique,1,Les Lois Logiques,9,828,9,QCM,0.06,0.92,73.44,9,3,12,11,9,2,1.09,81.82,Facile,Facile,0,Meme Difficulté,Adapte,Philosophy
6382,2020,Philosophie,2,La Notion de Logique,1,Les Lois Logiques,9,828,9,QCM,0.08,0.96,73.44,10,3,13,12,10,2,1.08,83.33,Facile,Facile,0,Meme Difficulté,Adapte,Philosophy
828,2015,Philosophie,2,La Notion de Logique,2,Les Raisonnements Valides,11,829,1,QROC,0.92,0.23,29.69,22,53,75,36,22,14,2.08,61.11,Difficile,Difficile,0,Meme Difficulté,Pas Adapte,Philosophy
1939,2016,Philosophie,2,La Notion de Logique,2,Les Raisonnements Valides,11,829,1,QROC,0.0,0.84,99.21,71,1,72,72,71,1,1.0,98.61,Difficile,Facile,2,Beaucoup plus Facile,Pas Adapte,Philosophy
3050,2017,Philosophie,2,La Notion de Logique,2,Les Raisonnements Valides,11,829,1,QROC,0.31,0.3,52.02,38,36,74,52,38,14,1.42,73.08,Difficile,Moyen,1,Plus Facile,Pas Adapte,Philosophy
4161,2018,Philosophie,2,La Notion de Logique,2,Les Raisonnements Valides,11,829,1,QROC,0.12,0.57,90.35,66,7,73,67,66,1,1.09,98.51,Moyen,Facile,1,Plus Facile,Pas Adapte,Philosophy
5272,2019,Philosophie,2,La Notion de Logique,2,Les Raisonnements Valides,11,829,1,QCM,0.17,0.92,83.67,59,12,71,71,59,12,1.0,83.1,Difficile,Facile,2,Beaucoup plus Facile,Pas Adapte,Philosophy
6383,2020,Philosophie,2,La Notion de Logique,2,Les Raisonnements Valides,11,829,1,QCM,0.54,0.26,4.15,3,65,68,40,3,37,1.7,7.5,Difficile,Difficile,0,Meme Difficulté,Pas Adapte,Philosophy
829,2015,Philosophie,2,La Notion de Logique,2,Les Raisonnements Valides,11,830,2,QROC,0.45,0.29,45.55,20,24,44,28,20,8,1.57,71.43,Difficile,Moyen,1,Plus Facile,Pas Adapte,Philosophy
1940,2016,Philosophie,2,La Notion de Logique,2,Les Raisonnements Valides,11,830,2,QROC,0.5,0.36,55.34,27,22,49,38,27,11,1.29,71.05,Difficile,Moyen,1,Plus Facile,Pas Adapte,Philosophy
3051,2017,Philosophie,2,La Notion de Logique,2,Les Raisonnements Valides,11,830,2,QROC,0.91,0.05,24.45,13,41,54,28,13,15,1.93,46.43,Difficile,Difficile,0,Meme Difficulté,Pas Adapte,Philosophy
4162,2018,Philosophie,2,La Notion de Logique,2,Les Raisonnements Valides,11,830,2,QO,0.77,0.09,23.91,13,42,55,53,13,40,1.04,24.53,Moyen,Difficile,-1,Plus Difficile,Pas Adapte,Philosophy
5273,2019,Philosophie,2,La Notion de Logique,2,Les Raisonnements Valides,11,830,2,QO,0.6,0.29,52.93,26,24,50,43,26,17,1.16,60.47,Moyen,Moyen,0,Meme Difficulté,Pas Adapte,Philosophy
6384,2020,Philosophie,2,La Notion de Logique,2,Les Raisonnements Valides,11,830,2,QO,0.14,0.79,73.92,35,12,47,40,35,5,1.18,87.5,Moyen,Facile,1,Plus Facile,Adapte,Philosophy
830,2015,Philosophie,2,La Notion de Logique,2,Les Raisonnements Valides,11,831,3,QCM,0.08,0.88,95.94,56,2,58,57,56,1,1.02,98.25,Facile,Facile,0,Meme Difficulté,Pas Adapte,Philosophy
1941,2016,Philosophie,2,La Notion de Logique,2,Les Raisonnements Valides,11,831,3,QCM,0.69,0.25,13.03,9,58,67,58,9,49,1.16,15.52,Facile,Difficile,-2,Beaucoup plus Difficile,Pas Adapte,Philosophy
3052,2017,Philosophie,2,La Notion de Logique,2,Les Raisonnements Valides,11,831,3,QCM,0.14,0.81,73.69,48,17,65,51,48,3,1.27,94.12,Difficile,Facile,2,Beaucoup plus Facile,Adapte,Philosophy
4163,2018,Philosophie,2,La Notion de Logique,2,Les Raisonnements Valides,11,831,3,QCM,0.08,0.86,73.69,48,17,65,52,48,4,1.25,92.31,Facile,Facile,0,Meme Difficulté,Adapte,Philosophy
5274,2019,Philosophie,2,La Notion de Logique,2,Les Raisonnements Valides,11,831,3,QCM,0.1,0.79,73.69,41,15,56,45,41,4,1.24,91.11,Facile,Facile,0,Meme Difficulté,Adapte,Philosophy
6385,2020,Philosophie,2,La Notion de Logique,2,Les Raisonnements Valides,11,831,3,QCM,0.08,0.82,73.69,45,16,61,54,45,9,1.13,83.33,Facile,Facile,0,Meme Difficulté,Adapte,Philosophy
831,2015,Philosophie,2,La Notion de Logique,2,Les Raisonnements Valides,11,832,4,QO,0.77,0.12,25.12,7,20,27,17,7,10,1.59,41.18,Facile,Difficile,-2,Beaucoup plus Difficile,Pas Adapte,Philosophy
1942,2016,Philosophie,2,La Notion de Logique,2,Les Raisonnements Valides,11,832,4,QCM,0.05,0.94,98.9,29,0,29,29,29,0,1.0,100.0,Moyen,Facile,1,Plus Facile,Pas Adapte,Philosophy
3053,2017,Philosophie,2,La Notion de Logique,2,Les Raisonnements Valides,11,832,4,QCM,0.04,0.97,83.1,24,5,29,28,24,4,1.04,85.71,Moyen,Facile,1,Plus Facile,Pas Adapte,Philosophy
4164,2018,Philosophie,2,La Notion de Logique,2,Les Raisonnements Valides,11,832,4,QROC,0.55,0.27,63.11,18,10,28,26,18,8,1.08,69.23,Difficile,Moyen,1,Plus Facile,Adapte,Philosophy
5275,2019,Philosophie,2,La Notion de Logique,2,Les Raisonnements Valides,11,832,4,QROC,0.31,0.38,63.11,18,10,28,20,18,2,1.4,90.0,Moyen,Moyen,0,Meme Difficulté,Adapte,Philosophy
6386,2020,Philosophie,2,La Notion de Logique,2,Les Raisonnements Valides,11,832,4,QROC,0.28,0.38,63.11,15,9,24,22,15,7,1.09,68.18,Moyen,Moyen,0,Meme Difficulté,Adapte,Philosophy
832,2015,Philosophie,2,La Notion de Logique,2,Les Raisonnements Valides,11,833,5,QROC,0.15,0.67,65.5,37,20,57,50,37,13,1.14,74.0,Difficile,Facile,2,Beaucoup plus Facile,Adapte,Philosophy
1943,2016,Philosophie,2,La Notion de Logique,2,Les Raisonnements Valides,11,833,5,QROC,0.09,0.73,65.5,41,22,63,43,41,2,1.47,95.35,Facile,Facile,0,Meme Difficulté,Adapte,Philosophy
3054,2017,Philosophie,2,La Notion de Logique,2,Les Raisonnements Valides,11,833,5,QROC,0.06,0.9,65.5,35,19,54,40,35,5,1.35,87.5,Facile,Facile,0,Meme Difficulté,Adapte,Philosophy
4165,2018,Philosophie,2,La Notion de Logique,2,Les Raisonnements Valides,11,833,5,QO,0.18,0.66,65.5,39,21,60,45,39,6,1.33,86.67,Facile,Facile,0,Meme Difficulté,Adapte,Philosophy
5276,2019,Philosophie,2,La Notion de Logique,2,Les Raisonnements Valides,11,833,5,QO,0.03,0.66,65.5,34,18,52,48,34,14,1.08,70.83,Facile,Facile,0,Meme Difficulté,Adapte,Philosophy
6387,2020,Philosophie,2,La Notion de Logique,2,Les Raisonnements Valides,11,833,5,QCU,0.06,0.99,65.5,29,16,45,41,29,12,1.1,70.73,Facile,Facile,0,Meme Difficulté,Adapte,Philosophy
833,2015,Philosophie,2,La Notion de Logique,2,Les Raisonnements Valides,11,834,6,QCM,0.2,0.83,76.93,22,7,29,25,22,3,1.16,88.0,Facile,Facile,0,Meme Difficulté,Pas Adapte,Philosophy
1944,2016,Philosophie,2,La Notion de Logique,2,Les Raisonnements Valides,11,834,6,QCM,0.73,0.17,2.04,1,26,27,16,1,15,1.69,6.25,Moyen,Difficile,-1,Plus Difficile,Pas Adapte,Philosophy
3055,2017,Philosophie,2,La Notion de Logique,2,Les Raisonnements Valides,11,834,6,QCM,0.71,0.17,30.06,7,17,24,21,7,14,1.14,33.33,Facile,Difficile,-2,Beaucoup plus Difficile,Pas Adapte,Philosophy
4166,2018,Philosophie,2,La Notion de Logique,2,Les Raisonnements Valides,11,834,6,QCM,0.17,0.88,91.22,24,2,26,25,24,1,1.04,96.0,Moyen,Facile,1,Plus Facile,Pas Adapte,Philosophy
5277,2019,Philosophie,2,La Notion de Logique,2,Les Raisonnements Valides,11,834,6,QCM,0.64,0.29,7.82,2,20,22,20,2,18,1.1,10.0,Facile,Difficile,-2,Beaucoup plus Difficile,Pas Adapte,Philosophy
6388,2020,Philosophie,2,La Notion de Logique,2,Les Raisonnements Valides,11,834,6,QCM,0.13,0.85,68.67,14,7,21,19,14,5,1.11,73.68,Moyen,Facile,1,Plus Facile,Adapte,Philosophy
834,2015,Philosophie,2,La Notion de Logique,2,Les Raisonnements Valides,11,835,7,QCM,0.22,0.54,37.14,27,47,74,50,27,23,1.48,54.0,Moyen,Moyen,0,Meme Difficulté,Pas Adapte,Philosophy
1945,2016,Philosophie,2,La Notion de Logique,2,Les Raisonnements Valides,11,835,7,QCM,0.01,0.76,80.41,58,14,72,71,58,13,1.01,81.69,Facile,Facile,0,Meme Difficulté,Pas Adapte,Philosophy
3056,2017,Philosophie,2,La Notion de Logique,2,Les Raisonnements Valides,11,835,7,QCM,0.54,0.22,16.49,12,59,71,51,12,39,1.39,23.53,Moyen,Difficile,-1,Plus Difficile,Pas Adapte,Philosophy
4167,2018,Philosophie,2,La Notion de Logique,2,Les Raisonnements Valides,11,835,7,QROC,0.91,0.2,17.45,11,52,63,29,11,18,2.17,37.93,Difficile,Difficile,0,Meme Difficulté,Pas Adapte,Philosophy
5278,2019,Philosophie,2,La Notion de Logique,2,Les Raisonnements Valides,11,835,7,QCM,0.05,0.74,94.56,66,4,70,67,66,1,1.04,98.51,Difficile,Facile,2,Beaucoup plus Facile,Pas Adapte,Philosophy
6389,2020,Philosophie,2,La Notion de Logique,2,Les Raisonnements Valides,11,835,7,QCM,0.23,0.66,35.15,24,45,69,44,24,20,1.57,54.55,Facile,Moyen,-1,Plus Difficile,Pas Adapte,Philosophy
835,2015,Philosophie,2,La Notion de Logique,2,Les Raisonnements Valides,11,836,8,QCM,0.23,0.68,37.97,16,25,41,36,16,20,1.14,44.44,Difficile,Moyen,1,Plus Facile,Pas Adapte,Philosophy
1946,2016,Philosophie,2,La Notion de Logique,2,Les Raisonnements Valides,11,836,8,QCM,0.03,0.9,92.15,42,4,46,44,42,2,1.05,95.45,Facile,Facile,0,Meme Difficulté,Pas Adapte,Philosophy
3057,2017,Philosophie,2,La Notion de Logique,2,Les Raisonnements Valides,11,836,8,QCU,0.44,0.27,25.33,11,32,43,20,11,9,2.15,55.0,Difficile,Difficile,0,Meme Difficulté,Pas Adapte,Philosophy
4168,2018,Philosophie,2,La Notion de Logique,2,Les Raisonnements Valides,11,836,8,QCU,0.5,0.4,7.79,4,43,47,28,4,24,1.68,14.29,Facile,Difficile,-2,Beaucoup plus Difficile,Pas Adapte,Philosophy
5279,2019,Philosophie,2,La Notion de Logique,2,Les Raisonnements Valides,11,836,8,QCU,0.02,0.96,77.52,34,10,44,43,34,9,1.02,79.07,Difficile,Facile,2,Beaucoup plus Facile,Pas Adapte,Philosophy
6390,2020,Philosophie,2,La Notion de Logique,2,Les Raisonnements Valides,11,836,8,QROC,0.54,0.35,51.35,19,18,37,20,19,1,1.85,95.0,Difficile,Moyen,1,Plus Facile,Pas Adapte,Philosophy
836,2015,Philosophie,2,La Notion de Logique,2,Les Raisonnements Valides,11,837,9,QCU,0.04,0.91,95.61,50,2,52,52,50,2,1.0,96.15,Difficile,Facile,2,Beaucoup plus Facile,Pas Adapte,Philosophy
1947,2016,Philosophie,2,La Notion de Logique,2,Les Raisonnements Valides,11,837,9,QCU,0.08,0.85,87.1,49,7,56,56,49,7,1.0,87.5,Moyen,Facile,1,Plus Facile,Pas Adapte,Philosophy
3058,2017,Philosophie,2,La Notion de Logique,2,Les Raisonnements Valides,11,837,9,QROC,0.01,0.76,80.25,44,11,55,54,44,10,1.02,81.48,Facile,Facile,0,Meme Difficulté,Pas Adapte,Philosophy
4169,2018,Philosophie,2,La Notion de Logique,2,Les Raisonnements Valides,11,837,9,QROC,0.12,0.99,87.25,54,8,62,58,54,4,1.07,93.1,Facile,Facile,0,Meme Difficulté,Pas Adapte,Philosophy
5280,2019,Philosophie,2,La Notion de Logique,2,Les Raisonnements Valides,11,837,9,QROC,0.94,0.19,2.57,2,57,59,25,2,23,2.36,8.0,Facile,Difficile,-2,Beaucoup plus Difficile,Pas Adapte,Philosophy
6391,2020,Philosophie,2,La Notion de Logique,2,Les Raisonnements Valides,11,837,9,QROC,0.38,0.34,40.83,23,34,57,34,23,11,1.68,67.65,Moyen,Moyen,0,Meme Difficulté,Pas Adapte,Philosophy
837,2015,Philosophie,2,La Notion de Logique,2,Les Raisonnements Valides,11,838,10,QCU,0.13,0.75,85.21,30,5,35,31,30,1,1.13,96.77,Facile,Facile,0,Meme Difficulté,Pas Adapte,Philosophy
1948,2016,Philosophie,2,La Notion de Logique,2,Les Raisonnements Valides,11,838,10,QCU,0.69,0.27,11.99,4,31,35,15,4,11,2.33,26.67,Difficile,Difficile,0,Meme Difficulté,Pas Adapte,Philosophy
3059,2017,Philosophie,2,La Notion de Logique,2,Les Raisonnements Valides,11,838,10,QCU,0.72,0.29,24.52,8,23,31,31,8,23,1.0,25.81,Facile,Difficile,-2,Beaucoup plus Difficile,Pas Adapte,Philosophy
4170,2018,Philosophie,2,La Notion de Logique,2,Les Raisonnements Valides,11,838,10,QCU,0.05,0.9,94.73,27,2,29,28,27,1,1.04,96.43,Facile,Facile,0,Meme Difficulté,Pas Adapte,Philosophy
5281,2019,Philosophie,2,La Notion de Logique,2,Les Raisonnements Valides,11,838,10,QCU,0.18,0.93,89.61,27,3,30,28,27,1,1.07,96.43,Difficile,Facile,2,Beaucoup plus Facile,Pas Adapte,Philosophy
6392,2020,Philosophie,2,La Notion de Logique,2,Les Raisonnements Valides,11,838,10,QCU,0.13,0.81,68.77,23,10,33,26,23,3,1.27,88.46,Facile,Facile,0,Meme Difficulté,Adapte,Philosophy
838,2015,Philosophie,2,La Notion de Logique,2,Les Raisonnements Valides,11,839,11,QCU,0.16,0.95,76.39,18,5,23,19,18,1,1.21,94.74,Moyen,Facile,1,Plus Facile,Pas Adapte,Philosophy
1949,2016,Philosophie,2,La Notion de Logique,2,Les Raisonnements Valides,11,839,11,QCU,0.2,0.65,56.03,13,11,24,17,13,4,1.41,76.47,Facile,Moyen,-1,Plus Difficile,Pas Adapte,Philosophy
3060,2017,Philosophie,2,La Notion de Logique,2,Les Raisonnements Valides,11,839,11,QCM,0.15,0.83,66.62,14,7,21,15,14,1,1.4,93.33,Difficile,Facile,2,Beaucoup plus Facile,Adapte,Philosophy
4171,2018,Philosophie,2,La Notion de Logique,2,Les Raisonnements Valides,11,839,11,QCM,0.01,0.91,66.62,15,8,23,20,15,5,1.15,75.0,Facile,Facile,0,Meme Difficulté,Adapte,Philosophy
5282,2019,Philosophie,2,La Notion de Logique,2,Les Raisonnements Valides,11,839,11,QCM,0.14,0.75,66.62,17,8,25,24,17,7,1.04,70.83,Facile,Facile,0,Meme Difficulté,Adapte,Philosophy
6393,2020,Philosophie,2,La Notion de Logique,2,Les Raisonnements Valides,11,839,11,QCM,0.17,0.94,66.62,19,9,28,20,19,1,1.4,95.0,Facile,Facile,0,Meme Difficulté,Adapte,Philosophy
839,2015,Philosophie,2,La Notion de Logique,3,Les Paradoxes,10,840,1,QCU,0.51,0.34,1.59,0,23,23,16,0,16,1.44,0.0,Difficile,Difficile,0,Meme Difficulté,Pas Adapte,Philosophy
1950,2016,Philosophie,2,La Notion de Logique,3,Les Paradoxes,10,840,1,QROC,0.24,0.38,61.36,13,8,21,16,13,3,1.31,81.25,Facile,Moyen,-1,Plus Difficile,Adapte,Philosophy
3061,2017,Philosophie,2,La Notion de Logique,3,Les Paradoxes,10,840,1,QROC,0.57,0.35,61.36,11,7,18,16,11,5,1.12,68.75,Moyen,Moyen,0,Meme Difficulté,Adapte,Philosophy
4172,2018,Philosophie,2,La Notion de Logique,3,Les Paradoxes,10,840,1,QCM,0.37,0.44,61.36,11,7,18,13,11,2,1.38,84.62,Moyen,Moyen,0,Meme Difficulté,Adapte,Philosophy
5283,2019,Philosophie,2,La Notion de Logique,3,Les Paradoxes,10,840,1,QCM,0.45,0.43,61.36,13,8,21,16,13,3,1.31,81.25,Moyen,Moyen,0,Meme Difficulté,Adapte,Philosophy
6394,2020,Philosophie,2,La Notion de Logique,3,Les Paradoxes,10,840,1,QCM,0.21,0.4,61.36,13,9,22,17,13,4,1.29,76.47,Moyen,Moyen,0,Meme Difficulté,Adapte,Philosophy
840,2015,Philosophie,2,La Notion de Logique,3,Les Paradoxes,10,841,2,QCU,0.11,0.96,86.07,71,12,83,79,71,8,1.05,89.87,Moyen,Facile,1,Plus Facile,Pas Adapte,Philosophy
1951,2016,Philosophie,2,La Notion de Logique,3,Les Paradoxes,10,841,2,QCU,0.55,0.32,10.97,8,64,72,42,8,34,1.71,19.05,Moyen,Difficile,-1,Plus Difficile,Pas Adapte,Philosophy
3062,2017,Philosophie,2,La Notion de Logique,3,Les Paradoxes,10,841,2,QCU,0.06,0.91,88.87,57,7,64,57,57,0,1.12,100.0,Facile,Facile,0,Meme Difficulté,Pas Adapte,Philosophy
4173,2018,Philosophie,2,La Notion de Logique,3,Les Paradoxes,10,841,2,QCU,0.71,0.25,13.44,8,48,56,42,8,34,1.33,19.05,Difficile,Difficile,0,Meme Difficulté,Pas Adapte,Philosophy
5284,2019,Philosophie,2,La Notion de Logique,3,Les Paradoxes,10,841,2,QCU,0.49,0.36,5.93,4,57,61,52,4,48,1.17,7.69,Moyen,Difficile,-1,Plus Difficile,Pas Adapte,Philosophy
6395,2020,Philosophie,2,La Notion de Logique,3,Les Paradoxes,10,841,2,QCM,0.19,0.79,79.47,56,14,70,58,56,2,1.21,96.55,Facile,Facile,0,Meme Difficulté,Pas Adapte,Philosophy
841,2015,Philosophie,2,La Notion de Logique,3,Les Paradoxes,10,842,3,QCU,0.57,0.28,14.09,10,64,74,33,10,23,2.24,30.3,Facile,Difficile,-2,Beaucoup plus Difficile,Pas Adapte,Philosophy
1952,2016,Philosophie,2,La Notion de Logique,3,Les Paradoxes,10,842,3,QCU,0.02,0.93,88.85,64,8,72,69,64,5,1.04,92.75,Facile,Facile,0,Meme Difficulté,Pas Adapte,Philosophy
3063,2017,Philosophie,2,La Notion de Logique,3,Les Paradoxes,10,842,3,QCU,0.42,0.2,9.47,6,57,63,41,6,35,1.54,14.63,Difficile,Difficile,0,Meme Difficulté,Pas Adapte,Philosophy
4174,2018,Philosophie,2,La Notion de Logique,3,Les Paradoxes,10,842,3,QCU,0.32,0.41,44.87,31,39,70,67,31,36,1.04,46.27,Facile,Moyen,-1,Plus Difficile,Pas Adapte,Philosophy
5285,2019,Philosophie,2,La Notion de Logique,3,Les Paradoxes,10,842,3,QCU,0.33,0.61,37.55,23,39,62,46,23,23,1.35,50.0,Facile,Moyen,-1,Plus Difficile,Pas Adapte,Philosophy
6396,2020,Philosophie,2,La Notion de Logique,3,Les Paradoxes,10,842,3,QCU,0.1,0.94,77.48,52,15,67,64,52,12,1.05,81.25,Facile,Facile,0,Meme Difficulté,Pas Adapte,Philosophy
842,2015,Philosophie,2,La Notion de Logique,3,Les Paradoxes,10,843,4,QO,0.93,0.03,11.42,4,33,37,30,4,26,1.23,13.33,Difficile,Difficile,0,Meme Difficulté,Pas Adapte,Philosophy
1953,2016,Philosophie,2,La Notion de Logique,3,Les Paradoxes,10,843,4,QO,0.8,0.08,26.39,9,25,34,21,9,12,1.62,42.86,Difficile,Difficile,0,Meme Difficulté,Pas Adapte,Philosophy
3064,2017,Philosophie,2,La Notion de Logique,3,Les Paradoxes,10,843,4,QO,0.37,0.17,44.74,15,18,33,18,15,3,1.83,83.33,Facile,Moyen,-1,Plus Difficile,Pas Adapte,Philosophy
4175,2018,Philosophie,2,La Notion de Logique,3,Les Paradoxes,10,843,4,QO,0.54,0.18,50.8,15,14,29,27,15,12,1.07,55.56,Difficile,Moyen,1,Plus Facile,Pas Adapte,Philosophy
5286,2019,Philosophie,2,La Notion de Logique,3,Les Paradoxes,10,843,4,QO,0.25,0.25,59.2,18,12,30,29,18,11,1.03,62.07,Moyen,Moyen,0,Meme Difficulté,Pas Adapte,Philosophy
6397,2020,Philosophie,2,La Notion de Logique,3,Les Paradoxes,10,843,4,QO,0.13,0.83,96.83,25,1,26,26,25,1,1.0,96.15,Facile,Facile,0,Meme Difficulté,Pas Adapte,Philosophy
843,2015,Philosophie,2,La Notion de Logique,3,Les Paradoxes,10,844,5,QO,0.28,0.25,43.9,3,3,6,4,3,1,1.5,75.0,Difficile,Moyen,1,Plus Facile,Pas Adapte,Philosophy
1954,2016,Philosophie,2,La Notion de Logique,3,Les Paradoxes,10,844,5,QO,0.99,0.13,15.34,1,5,6,4,1,3,1.5,25.0,Moyen,Difficile,-1,Plus Difficile,Pas Adapte,Philosophy
3065,2017,Philosophie,2,La Notion de Logique,3,Les Paradoxes,10,844,5,QO,0.82,0.12,5.0,0,5,5,4,0,4,1.25,0.0,Facile,Difficile,-2,Beaucoup plus Difficile,Pas Adapte,Philosophy
4176,2018,Philosophie,2,La Notion de Logique,3,Les Paradoxes,10,844,5,QO,0.03,0.6,74.3,4,2,6,6,4,2,1.0,66.67,Moyen,Facile,1,Plus Facile,Adapte,Philosophy
5287,2019,Philosophie,2,La Notion de Logique,3,Les Paradoxes,10,844,5,QO,0.05,0.45,74.3,4,2,6,6,4,2,1.0,66.67,Facile,Facile,0,Meme Difficulté,Adapte,Philosophy
6398,2020,Philosophie,2,La Notion de Logique,3,Les Paradoxes,10,844,5,QO,0.14,0.6,74.3,5,2,7,6,5,1,1.17,83.33,Facile,Facile,0,Meme Difficulté,Adapte,Philosophy
844,2015,Philosophie,2,La Notion de Logique,3,Les Paradoxes,10,845,6,QCM,0.04,0.9,88.53,45,6,51,48,45,3,1.06,93.75,Facile,Facile,0,Meme Difficulté,Pas Adapte,Philosophy
1955,2016,Philosophie,2,La Notion de Logique,3,Les Paradoxes,10,845,6,QCM,0.06,0.71,95.98,52,2,54,53,52,1,1.02,98.11,Difficile,Facile,2,Beaucoup plus Facile,Pas Adapte,Philosophy
3066,2017,Philosophie,2,La Notion de Logique,3,Les Paradoxes,10,845,6,QCM,0.25,0.59,39.96,22,33,55,28,22,6,1.96,78.57,Facile,Moyen,-1,Plus Difficile,Pas Adapte,Philosophy
4177,2018,Philosophie,2,La Notion de Logique,3,Les Paradoxes,10,845,6,QCM,0.2,0.47,43.38,23,31,54,44,23,21,1.23,52.27,Facile,Moyen,-1,Plus Difficile,Pas Adapte,Philosophy
5288,2019,Philosophie,2,La Notion de Logique,3,Les Paradoxes,10,845,6,QCM,0.66,0.21,4.27,3,59,62,40,3,37,1.55,7.5,Facile,Difficile,-2,Beaucoup plus Difficile,Pas Adapte,Philosophy
6399,2020,Philosophie,2,La Notion de Logique,3,Les Paradoxes,10,845,6,QCM,0.22,0.63,60.92,43,28,71,49,43,6,1.45,87.76,Facile,Moyen,-1,Plus Difficile,Adapte,Philosophy
845,2015,Philosophie,2,La Notion de Logique,3,Les Paradoxes,10,846,7,QCU,0.16,0.84,67.07,5,3,8,8,5,3,1.0,62.5,Facile,Facile,0,Meme Difficulté,Adapte,Philosophy
1956,2016,Philosophie,2,La Notion de Logique,3,Les Paradoxes,10,846,7,QCU,0.17,0.85,67.07,5,2,7,7,5,2,1.0,71.43,Facile,Facile,0,Meme Difficulté,Adapte,Philosophy
3067,2017,Philosophie,2,La Notion de Logique,3,Les Paradoxes,10,846,7,QCU,0.06,0.8,67.07,4,2,6,4,4,0,1.5,100.0,Facile,Facile,0,Meme Difficulté,Adapte,Philosophy
4178,2018,Philosophie,2,La Notion de Logique,3,Les Paradoxes,10,846,7,QCU,0.18,0.79,67.07,5,2,7,7,5,2,1.0,71.43,Facile,Facile,0,Meme Difficulté,Adapte,Philosophy
5289,2019,Philosophie,2,La Notion de Logique,3,Les Paradoxes,10,846,7,QCU,0.08,0.93,67.07,5,2,7,6,5,1,1.17,83.33,Facile,Facile,0,Meme Difficulté,Adapte,Philosophy
6400,2020,Philosophie,2,La Notion de Logique,3,Les Paradoxes,10,846,7,QROC,0.15,0.45,67.07,5,2,7,7,5,2,1.0,71.43,Facile,Facile,0,Meme Difficulté,Adapte,Philosophy
846,2015,Philosophie,2,La Notion de Logique,3,Les Paradoxes,10,847,8,QCU,0.21,0.43,47.74,44,48,92,64,44,20,1.44,68.75,Moyen,Moyen,0,Meme Difficulté,Pas Adapte,Philosophy
1957,2016,Philosophie,2,La Notion de Logique,3,Les Paradoxes,10,847,8,QCU,0.51,0.2,22.42,19,64,83,76,19,57,1.09,25.0,Moyen,Difficile,-1,Plus Difficile,Pas Adapte,Philosophy
3068,2017,Philosophie,2,La Notion de Logique,3,Les Paradoxes,10,847,8,QCU,0.38,0.61,46.84,34,39,73,56,34,22,1.3,60.71,Difficile,Moyen,1,Plus Facile,Pas Adapte,Philosophy
4179,2018,Philosophie,2,La Notion de Logique,3,Les Paradoxes,10,847,8,QCU,0.21,0.49,55.96,39,30,69,44,39,5,1.57,88.64,Facile,Moyen,-1,Plus Difficile,Pas Adapte,Philosophy
5290,2019,Philosophie,2,La Notion de Logique,3,Les Paradoxes,10,847,8,QCU,0.74,0.27,21.02,15,54,69,41,15,26,1.68,36.59,Facile,Difficile,-2,Beaucoup plus Difficile,Pas Adapte,Philosophy
6401,2020,Philosophie,2,La Notion de Logique,3,Les Paradoxes,10,847,8,QCU,0.67,0.36,27.4,18,48,66,42,18,24,1.57,42.86,Difficile,Difficile,0,Meme Difficulté,Pas Adapte,Philosophy
847,2015,Philosophie,2,La Notion de Logique,3,Les Paradoxes,10,848,9,QCM,0.35,0.5,48.33,34,36,70,53,34,19,1.32,64.15,Facile,Moyen,-1,Plus Difficile,Pas Adapte,Philosophy
1958,2016,Philosophie,2,La Notion de Logique,3,Les Paradoxes,10,848,9,QCM,0.39,0.54,50.87,36,34,70,62,36,26,1.13,58.06,Difficile,Moyen,1,Plus Facile,Pas Adapte,Philosophy
3069,2017,Philosophie,2,La Notion de Logique,3,Les Paradoxes,10,848,9,QCM,0.08,0.9,79.81,54,14,68,57,54,3,1.19,94.74,Difficile,Facile,2,Beaucoup plus Facile,Pas Adapte,Philosophy
4180,2018,Philosophie,2,La Notion de Logique,3,Les Paradoxes,10,848,9,QCM,0.64,0.29,4.45,3,73,76,55,3,52,1.38,5.45,Difficile,Difficile,0,Meme Difficulté,Pas Adapte,Philosophy
5291,2019,Philosophie,2,La Notion de Logique,3,Les Paradoxes,10,848,9,QCM,0.45,0.37,55.49,43,35,78,62,43,19,1.26,69.35,Moyen,Moyen,0,Meme Difficulté,Pas Adapte,Philosophy
6402,2020,Philosophie,2,La Notion de Logique,3,Les Paradoxes,10,848,9,QCM,0.37,0.61,60.09,52,35,87,78,52,26,1.12,66.67,Difficile,Moyen,1,Plus Facile,Adapte,Philosophy
848,2015,Philosophie,2,La Notion de Logique,3,Les Paradoxes,10,849,10,QCU,0.71,0.22,25.75,25,72,97,39,25,14,2.49,64.1,Facile,Difficile,-2,Beaucoup plus Difficile,Pas Adapte,Philosophy
1959,2016,Philosophie,2,La Notion de Logique,3,Les Paradoxes,10,849,10,QCU,0.67,0.27,1.25,1,104,105,68,1,67,1.54,1.47,Moyen,Difficile,-1,Plus Difficile,Pas Adapte,Philosophy
3070,2017,Philosophie,2,La Notion de Logique,3,Les Paradoxes,10,849,10,QCU,0.05,0.89,99.52,99,0,99,99,99,0,1.0,100.0,Moyen,Facile,1,Plus Facile,Pas Adapte,Philosophy
4181,2018,Philosophie,2,La Notion de Logique,3,Les Paradoxes,10,849,10,QCU,0.2,0.87,93.31,85,6,91,86,85,1,1.06,98.84,Moyen,Facile,1,Plus Facile,Pas Adapte,Philosophy
5292,2019,Philosophie,2,La Notion de Logique,3,Les Paradoxes,10,849,10,QCU,0.44,0.35,12.19,10,68,78,53,10,43,1.47,18.87,Difficile,Difficile,0,Meme Difficulté,Pas Adapte,Philosophy
6403,2020,Philosophie,2,La Notion de Logique,3,Les Paradoxes,10,849,10,QCU,0.28,0.74,51.14,41,40,81,49,41,8,1.65,83.67,Facile,Moyen,-1,Plus Difficile,Pas Adapte,Philosophy
849,2015,Philosophie,2,La Notion de Logique,4,La Notion du Modele,7,850,1,QROC,0.1,0.54,92.11,6,0,6,6,6,0,1.0,100.0,Facile,Facile,0,Meme Difficulté,Pas Adapte,Philosophy
1960,2016,Philosophie,2,La Notion de Logique,4,La Notion du Modele,7,850,1,QROC,0.25,0.28,35.87,3,4,7,4,3,1,1.75,75.0,Difficile,Moyen,1,Plus Facile,Pas Adapte,Philosophy
3071,2017,Philosophie,2,La Notion de Logique,4,La Notion du Modele,7,850,1,QROC,0.09,0.76,72.82,6,2,8,6,6,0,1.33,100.0,Moyen,Facile,1,Plus Facile,Adapte,Philosophy
4182,2018,Philosophie,2,La Notion de Logique,4,La Notion du Modele,7,850,1,QROC,0.08,0.94,72.82,6,2,8,6,6,0,1.33,100.0,Facile,Facile,0,Meme Difficulté,Adapte,Philosophy
5293,2019,Philosophie,2,La Notion de Logique,4,La Notion du Modele,7,850,1,QO,0.17,0.94,72.82,7,2,9,8,7,1,1.12,87.5,Facile,Facile,0,Meme Difficulté,Adapte,Philosophy
6404,2020,Philosophie,2,La Notion de Logique,4,La Notion du Modele,7,850,1,QO,0.14,0.93,72.82,7,3,10,9,7,2,1.11,77.78,Facile,Facile,0,Meme Difficulté,Adapte,Philosophy
850,2015,Philosophie,2,La Notion de Logique,4,La Notion du Modele,7,851,2,QCM,0.05,0.81,65.58,12,7,19,16,12,4,1.19,75.0,Facile,Facile,0,Meme Difficulté,Adapte,Philosophy
1961,2016,Philosophie,2,La Notion de Logique,4,La Notion du Modele,7,851,2,QCM,0.06,0.74,65.58,12,6,18,18,12,6,1.0,66.67,Facile,Facile,0,Meme Difficulté,Adapte,Philosophy
3072,2017,Philosophie,2,La Notion de Logique,4,La Notion du Modele,7,851,2,QROC,0.02,0.77,65.58,11,6,17,17,11,6,1.0,64.71,Facile,Facile,0,Meme Difficulté,Adapte,Philosophy
4183,2018,Philosophie,2,La Notion de Logique,4,La Notion du Modele,7,851,2,QROC,0.02,0.45,65.58,10,5,15,15,10,5,1.0,66.67,Facile,Facile,0,Meme Difficulté,Adapte,Philosophy
5294,2019,Philosophie,2,La Notion de Logique,4,La Notion du Modele,7,851,2,QO,0.12,0.48,65.58,9,4,13,13,9,4,1.0,69.23,Facile,Facile,0,Meme Difficulté,Adapte,Philosophy
6405,2020,Philosophie,2,La Notion de Logique,4,La Notion du Modele,7,851,2,QO,0.15,0.31,65.58,10,5,15,13,10,3,1.15,76.92,Facile,Facile,0,Meme Difficulté,Adapte,Philosophy
851,2015,Philosophie,2,La Notion de Logique,4,La Notion du Modele,7,852,3,QCM,0.63,0.21,4.7,4,85,89,69,4,65,1.29,5.8,Facile,Difficile,-2,Beaucoup plus Difficile,Pas Adapte,Philosophy
1962,2016,Philosophie,2,La Notion de Logique,4,La Notion du Modele,7,852,3,QCM,0.11,0.9,65.63,66,35,101,100,66,34,1.01,66.0,Facile,Facile,0,Meme Difficulté,Adapte,Philosophy
3073,2017,Philosophie,2,La Notion de Logique,4,La Notion du Modele,7,852,3,QCM,0.1,0.94,65.63,59,31,90,80,59,21,1.12,73.75,Facile,Facile,0,Meme Difficulté,Adapte,Philosophy
4184,2018,Philosophie,2,La Notion de Logique,4,La Notion du Modele,7,852,3,QCU,0.08,0.77,65.63,67,35,102,84,67,17,1.21,79.76,Facile,Facile,0,Meme Difficulté,Adapte,Philosophy
5295,2019,Philosophie,2,La Notion de Logique,4,La Notion du Modele,7,852,3,QCM,0.12,0.73,65.63,77,40,117,92,77,15,1.27,83.7,Facile,Facile,0,Meme Difficulté,Adapte,Philosophy
6406,2020,Philosophie,2,La Notion de Logique,4,La Notion du Modele,7,852,3,QCM,0.16,0.88,65.63,83,43,126,85,83,2,1.48,97.65,Facile,Facile,0,Meme Difficulté,Adapte,Philosophy
852,2015,Philosophie,2,La Notion de Logique,4,La Notion du Modele,7,853,4,QCM,0.03,0.71,86.85,30,5,35,35,30,5,1.0,85.71,Facile,Facile,0,Meme Difficulté,Pas Adapte,Philosophy
1963,2016,Philosophie,2,La Notion de Logique,4,La Notion du Modele,7,853,4,QCM,0.03,0.79,78.24,25,7,32,25,25,0,1.28,100.0,Moyen,Facile,1,Plus Facile,Pas Adapte,Philosophy
3074,2017,Philosophie,2,La Notion de Logique,4,La Notion du Modele,7,853,4,QCM,0.49,0.64,48.23,18,19,37,23,18,5,1.61,78.26,Facile,Moyen,-1,Plus Difficile,Pas Adapte,Philosophy
4185,2018,Philosophie,2,La Notion de Logique,4,La Notion du Modele,7,853,4,QCM,0.21,0.67,57.93,23,17,40,23,23,0,1.74,100.0,Difficile,Moyen,1,Plus Facile,Pas Adapte,Philosophy
5296,2019,Philosophie,2,La Notion de Logique,4,La Notion du Modele,7,853,4,QCM,0.09,0.71,82.54,29,6,35,32,29,3,1.09,90.62,Difficile,Facile,2,Beaucoup plus Facile,Pas Adapte,Philosophy
6407,2020,Philosophie,2,La Notion de Logique,4,La Notion du Modele,7,853,4,QCU,0.18,0.87,68.09,24,11,35,30,24,6,1.17,80.0,Difficile,Facile,2,Beaucoup plus Facile,Adapte,Philosophy
853,2015,Philosophie,2,La Notion de Logique,4,La Notion du Modele,7,854,5,QO,0.46,0.18,63.51,10,6,16,15,10,5,1.07,66.67,Moyen,Moyen,0,Meme Difficulté,Adapte,Philosophy
1964,2016,Philosophie,2,La Notion de Logique,4,La Notion du Modele,7,854,5,QO,0.34,0.29,63.51,11,6,17,14,11,3,1.21,78.57,Moyen,Moyen,0,Meme Difficulté,Adapte,Philosophy
3075,2017,Philosophie,2,La Notion de Logique,4,La Notion du Modele,7,854,5,QO,0.65,0.23,63.51,13,7,20,16,13,3,1.25,81.25,Moyen,Moyen,0,Meme Difficulté,Adapte,Philosophy
4186,2018,Philosophie,2,La Notion de Logique,4,La Notion du Modele,7,854,5,QO,0.51,0.18,63.51,14,8,22,21,14,7,1.05,66.67,Moyen,Moyen,0,Meme Difficulté,Adapte,Philosophy
5297,2019,Philosophie,2,La Notion de Logique,4,La Notion du Modele,7,854,5,QO,0.59,0.28,63.51,15,8,23,20,15,5,1.15,75.0,Moyen,Moyen,0,Meme Difficulté,Adapte,Philosophy
6408,2020,Philosophie,2,La Notion de Logique,4,La Notion du Modele,7,854,5,QO,0.45,0.2,63.51,15,9,24,20,15,5,1.2,75.0,Moyen,Moyen,0,Meme Difficulté,Adapte,Philosophy
854,2015,Philosophie,2,La Notion de Logique,4,La Notion du Modele,7,855,6,QCM,0.44,0.63,37.46,9,15,24,19,9,10,1.26,47.37,Difficile,Moyen,1,Plus Facile,Pas Adapte,Philosophy
1965,2016,Philosophie,2,La Notion de Logique,4,La Notion du Modele,7,855,6,QCM,0.15,0.84,71.8,17,6,23,21,17,4,1.1,80.95,Facile,Facile,0,Meme Difficulté,Adapte,Philosophy
3076,2017,Philosophie,2,La Notion de Logique,4,La Notion du Modele,7,855,6,QROC,0.02,0.56,71.8,19,7,26,26,19,7,1.0,73.08,Facile,Facile,0,Meme Difficulté,Adapte,Philosophy
4187,2018,Philosophie,2,La Notion de Logique,4,La Notion du Modele,7,855,6,QROC,0.07,0.8,71.8,21,8,29,23,21,2,1.26,91.3,Facile,Facile,0,Meme Difficulté,Adapte,Philosophy
5298,2019,Philosophie,2,La Notion de Logique,4,La Notion du Modele,7,855,6,QROC,0.12,0.42,71.8,23,9,32,31,23,8,1.03,74.19,Facile,Facile,0,Meme Difficulté,Adapte,Philosophy
6409,2020,Philosophie,2,La Notion de Logique,4,La Notion du Modele,7,855,6,QROC,0.11,0.49,71.8,25,10,35,30,25,5,1.17,83.33,Facile,Facile,0,Meme Difficulté,Adapte,Philosophy
855,2015,Philosophie,2,La Notion de Logique,4,La Notion du Modele,7,856,7,QCU,0.62,0.29,19.09,13,54,67,41,13,28,1.63,31.71,Facile,Difficile,-2,Beaucoup plus Difficile,Pas Adapte,Philosophy
1966,2016,Philosophie,2,La Notion de Logique,4,La Notion du Modele,7,856,7,QCU,0.68,0.34,0.3,0,73,73,36,0,36,2.03,0.0,Facile,Difficile,-2,Beaucoup plus Difficile,Pas Adapte,Philosophy
3077,2017,Philosophie,2,La Notion de Logique,4,La Notion du Modele,7,856,7,QCU,0.61,0.21,34.63,22,42,64,54,22,32,1.19,40.74,Moyen,Difficile,-1,Plus Difficile,Pas Adapte,Philosophy
4188,2018,Philosophie,2,La Notion de Logique,4,La Notion du Modele,7,856,7,QCU,0.64,0.36,18.05,11,49,60,48,11,37,1.25,22.92,Facile,Difficile,-2,Beaucoup plus Difficile,Pas Adapte,Philosophy
5299,2019,Philosophie,2,La Notion de Logique,4,La Notion du Modele,7,856,7,QCU,0.34,0.69,50.01,32,32,64,53,32,21,1.21,60.38,Facile,Moyen,-1,Plus Difficile,Pas Adapte,Philosophy
6410,2020,Philosophie,2,La Notion de Logique,4,La Notion du Modele,7,856,7,QCU,0.7,0.31,26.24,17,47,64,29,17,12,2.21,58.62,Difficile,Difficile,0,Meme Difficulté,Pas Adapte,Philosophy
856,2015,Philosophie,2,La Notion de Logique,5,Le Calcul des Sequents,12,857,1,QCM,0.08,0.81,79.86,36,9,45,42,36,6,1.07,85.71,Facile,Facile,0,Meme Difficulté,Pas Adapte,Philosophy
1967,2016,Philosophie,2,La Notion de Logique,5,Le Calcul des Sequents,12,857,1,QCM,0.45,0.48,62.58,27,16,43,37,27,10,1.16,72.97,Facile,Moyen,-1,Plus Difficile,Adapte,Philosophy
3078,2017,Philosophie,2,La Notion de Logique,5,Le Calcul des Sequents,12,857,1,QCM,0.46,0.34,62.58,24,15,39,37,24,13,1.05,64.86,Moyen,Moyen,0,Meme Difficulté,Adapte,Philosophy
4189,2018,Philosophie,2,La Notion de Logique,5,Le Calcul des Sequents,12,857,1,QCM,0.5,0.33,62.58,23,14,37,33,23,10,1.12,69.7,Moyen,Moyen,0,Meme Difficulté,Adapte,Philosophy
5300,2019,Philosophie,2,La Notion de Logique,5,Le Calcul des Sequents,12,857,1,QCM,0.46,0.68,62.58,23,13,36,24,23,1,1.5,95.83,Moyen,Moyen,0,Meme Difficulté,Adapte,Philosophy
6411,2020,Philosophie,2,La Notion de Logique,5,Le Calcul des Sequents,12,857,1,QCM,0.3,0.45,62.58,21,12,33,28,21,7,1.18,75.0,Moyen,Moyen,0,Meme Difficulté,Adapte,Philosophy
857,2015,Philosophie,2,La Notion de Logique,5,Le Calcul des Sequents,12,858,2,QROC,0.81,0.18,14.6,3,17,20,13,3,10,1.54,23.08,Facile,Difficile,-2,Beaucoup plus Difficile,Pas Adapte,Philosophy
1968,2016,Philosophie,2,La Notion de Logique,5,Le Calcul des Sequents,12,858,2,QROC,0.02,0.92,88.87,19,2,21,21,19,2,1.0,90.48,Facile,Facile,0,Meme Difficulté,Pas Adapte,Philosophy
3079,2017,Philosophie,2,La Notion de Logique,5,Le Calcul des Sequents,12,858,2,QROC,0.02,0.64,73.23,17,6,23,18,17,1,1.28,94.44,Facile,Facile,0,Meme Difficulté,Adapte,Philosophy
4190,2018,Philosophie,2,La Notion de Logique,5,Le Calcul des Sequents,12,858,2,QROC,0.01,0.73,73.23,15,5,20,16,15,1,1.25,93.75,Facile,Facile,0,Meme Difficulté,Adapte,Philosophy
5301,2019,Philosophie,2,La Notion de Logique,5,Le Calcul des Sequents,12,858,2,QROC,0.0,0.84,73.23,14,5,19,19,14,5,1.0,73.68,Facile,Facile,0,Meme Difficulté,Adapte,Philosophy
6412,2020,Philosophie,2,La Notion de Logique,5,Le Calcul des Sequents,12,858,2,QROC,0.01,0.65,73.23,12,5,17,14,12,2,1.21,85.71,Facile,Facile,0,Meme Difficulté,Adapte,Philosophy
858,2015,Philosophie,2,La Notion de Logique,5,Le Calcul des Sequents,12,859,3,QCU,0.06,0.93,70.29,44,19,63,55,44,11,1.15,80.0,Moyen,Facile,1,Plus Facile,Adapte,Philosophy
1969,2016,Philosophie,2,La Notion de Logique,5,Le Calcul des Sequents,12,859,3,QCU,0.13,0.8,70.29,51,21,72,67,51,16,1.07,76.12,Facile,Facile,0,Meme Difficulté,Adapte,Philosophy
3080,2017,Philosophie,2,La Notion de Logique,5,Le Calcul des Sequents,12,859,3,QCU,0.02,0.8,70.29,51,22,73,56,51,5,1.3,91.07,Facile,Facile,0,Meme Difficulté,Adapte,Philosophy
4191,2018,Philosophie,2,La Notion de Logique,5,Le Calcul des Sequents,12,859,3,QCU,0.2,0.81,70.29,50,21,71,54,50,4,1.31,92.59,Facile,Facile,0,Meme Difficulté,Adapte,Philosophy
5302,2019,Philosophie,2,La Notion de Logique,5,Le Calcul des Sequents,12,859,3,QCU,0.03,0.99,70.29,56,24,80,65,56,9,1.23,86.15,Facile,Facile,0,Meme Difficulté,Adapte,Philosophy
6413,2020,Philosophie,2,La Notion de Logique,5,Le Calcul des Sequents,12,859,3,QCU,0.06,0.94,70.29,48,20,68,62,48,14,1.1,77.42,Facile,Facile,0,Meme Difficulté,Adapte,Philosophy
859,2015,Philosophie,2,La Notion de Logique,5,Le Calcul des Sequents,12,860,4,QROC,0.36,0.26,57.83,6,4,10,10,6,4,1.0,60.0,Moyen,Moyen,0,Meme Difficulté,Pas Adapte,Philosophy
1970,2016,Philosophie,2,La Notion de Logique,5,Le Calcul des Sequents,12,860,4,QROC,0.92,0.01,0.09,0,11,11,6,0,6,1.83,0.0,Moyen,Difficile,-1,Plus Difficile,Pas Adapte,Philosophy
3081,2017,Philosophie,2,La Notion de Logique,5,Le Calcul des Sequents,12,860,4,QROC,0.98,0.01,17.79,2,11,13,8,2,6,1.62,25.0,Difficile,Difficile,0,Meme Difficulté,Pas Adapte,Philosophy
4192,2018,Philosophie,2,La Notion de Logique,5,Le Calcul des Sequents,12,860,4,QROC,0.33,0.32,50.96,8,7,15,11,8,3,1.36,72.73,Facile,Moyen,-1,Plus Difficile,Pas Adapte,Philosophy
5303,2019,Philosophie,2,La Notion de Logique,5,Le Calcul des Sequents,12,860,4,QROC,0.91,0.22,15.92,3,14,17,10,3,7,1.7,30.0,Moyen,Difficile,-1,Plus Difficile,Pas Adapte,Philosophy
6414,2020,Philosophie,2,La Notion de Logique,5,Le Calcul des Sequents,12,860,4,QROC,0.2,0.5,80.93,14,3,17,17,14,3,1.0,82.35,Moyen,Facile,1,Plus Facile,Pas Adapte,Philosophy
860,2015,Philosophie,2,La Notion de Logique,5,Le Calcul des Sequents,12,861,5,QCM,0.73,0.19,24.08,20,64,84,68,20,48,1.24,29.41,Facile,Difficile,-2,Beaucoup plus Difficile,Pas Adapte,Philosophy
1971,2016,Philosophie,2,La Notion de Logique,5,Le Calcul des Sequents,12,861,5,QCM,0.55,0.2,7.75,6,69,75,58,6,52,1.29,10.34,Facile,Difficile,-2,Beaucoup plus Difficile,Pas Adapte,Philosophy
3082,2017,Philosophie,2,La Notion de Logique,5,Le Calcul des Sequents,12,861,5,QCM,0.58,0.25,17.5,12,56,68,20,12,8,3.4,60.0,Facile,Difficile,-2,Beaucoup plus Difficile,Pas Adapte,Philosophy
4193,2018,Philosophie,2,La Notion de Logique,5,Le Calcul des Sequents,12,861,5,QCM,0.27,0.36,44.95,27,34,61,47,27,20,1.3,57.45,Moyen,Moyen,0,Meme Difficulté,Pas Adapte,Philosophy
5304,2019,Philosophie,2,La Notion de Logique,5,Le Calcul des Sequents,12,861,5,QCM,0.56,0.26,29.35,18,45,63,30,18,12,2.1,60.0,Difficile,Difficile,0,Meme Difficulté,Pas Adapte,Philosophy
6415,2020,Philosophie,2,La Notion de Logique,5,Le Calcul des Sequents,12,861,5,QCM,0.05,0.82,74.36,49,17,66,56,49,7,1.18,87.5,Moyen,Facile,1,Plus Facile,Adapte,Philosophy
861,2015,Philosophie,2,La Notion de Logique,5,Le Calcul des Sequents,12,862,6,QCU,0.14,0.92,81.82,41,9,50,44,41,3,1.14,93.18,Difficile,Facile,2,Beaucoup plus Facile,Pas Adapte,Philosophy
1972,2016,Philosophie,2,La Notion de Logique,5,Le Calcul des Sequents,12,862,6,QCM,0.48,0.3,44.97,22,27,49,25,22,3,1.96,88.0,Moyen,Moyen,0,Meme Difficulté,Pas Adapte,Philosophy
3083,2017,Philosophie,2,La Notion de Logique,5,Le Calcul des Sequents,12,862,6,QCM,0.19,0.94,76.53,39,12,51,39,39,0,1.31,100.0,Moyen,Facile,1,Plus Facile,Pas Adapte,Philosophy
4194,2018,Philosophie,2,La Notion de Logique,5,Le Calcul des Sequents,12,862,6,QCM,0.37,0.63,44.92,23,29,52,32,23,9,1.62,71.88,Difficile,Moyen,1,Plus Facile,Pas Adapte,Philosophy
5305,2019,Philosophie,2,La Notion de Logique,5,Le Calcul des Sequents,12,862,6,QCM,0.6,0.21,21.37,11,41,52,44,11,33,1.18,25.0,Difficile,Difficile,0,Meme Difficulté,Pas Adapte,Philosophy
6416,2020,Philosophie,2,La Notion de Logique,5,Le Calcul des Sequents,12,862,6,QCM,0.68,0.27,1.97,1,48,49,39,1,38,1.26,2.56,Difficile,Difficile,0,Meme Difficulté,Pas Adapte,Philosophy
862,2015,Philosophie,2,La Notion de Logique,5,Le Calcul des Sequents,12,863,7,QCU,0.4,0.68,48.29,11,12,23,21,11,10,1.1,52.38,Moyen,Moyen,0,Meme Difficulté,Pas Adapte,Philosophy
1973,2016,Philosophie,2,La Notion de Logique,5,Le Calcul des Sequents,12,863,7,QCU,0.65,0.28,5.45,1,19,20,18,1,17,1.11,5.56,Facile,Difficile,-2,Beaucoup plus Difficile,Pas Adapte,Philosophy
3084,2017,Philosophie,2,La Notion de Logique,5,Le Calcul des Sequents,12,863,7,QCU,0.26,0.52,49.23,9,10,19,13,9,4,1.46,69.23,Moyen,Moyen,0,Meme Difficulté,Pas Adapte,Philosophy
4195,2018,Philosophie,2,La Notion de Logique,5,Le Calcul des Sequents,12,863,7,QCU,0.28,0.55,53.94,12,10,22,18,12,6,1.22,66.67,Moyen,Moyen,0,Meme Difficulté,Pas Adapte,Philosophy
5306,2019,Philosophie,2,La Notion de Logique,5,Le Calcul des Sequents,12,863,7,QCU,0.07,0.82,90.75,21,2,23,22,21,1,1.05,95.45,Facile,Facile,0,Meme Difficulté,Pas Adapte,Philosophy
6417,2020,Philosophie,2,La Notion de Logique,5,Le Calcul des Sequents,12,863,7,QCU,0.09,0.96,85.37,22,4,26,25,22,3,1.04,88.0,Facile,Facile,0,Meme Difficulté,Pas Adapte,Philosophy
863,2015,Philosophie,2,La Notion de Logique,5,Le Calcul des Sequents,12,864,8,QCU,0.42,0.25,16.95,6,31,37,26,6,20,1.42,23.08,Moyen,Difficile,-1,Plus Difficile,Pas Adapte,Philosophy
1974,2016,Philosophie,2,La Notion de Logique,5,Le Calcul des Sequents,12,864,8,QCU,0.52,0.29,0.12,0,40,40,15,0,15,2.67,0.0,Difficile,Difficile,0,Meme Difficulté,Pas Adapte,Philosophy
3085,2017,Philosophie,2,La Notion de Logique,5,Le Calcul des Sequents,12,864,8,QCU,0.02,0.8,88.11,33,5,38,34,33,1,1.12,97.06,Moyen,Facile,1,Plus Facile,Pas Adapte,Philosophy
4196,2018,Philosophie,2,La Notion de Logique,5,Le Calcul des Sequents,12,864,8,QCU,0.51,0.21,13.68,5,34,39,18,5,13,2.17,27.78,Moyen,Difficile,-1,Plus Difficile,Pas Adapte,Philosophy
5307,2019,Philosophie,2,La Notion de Logique,5,Le Calcul des Sequents,12,864,8,QCU,0.42,0.2,20.44,8,30,38,33,8,25,1.15,24.24,Moyen,Difficile,-1,Plus Difficile,Pas Adapte,Philosophy
6418,2020,Philosophie,2,La Notion de Logique,5,Le Calcul des Sequents,12,864,8,QCU,0.21,0.51,49.19,16,17,33,32,16,16,1.03,50.0,Difficile,Moyen,1,Plus Facile,Pas Adapte,Philosophy
864,2015,Philosophie,2,La Notion de Logique,5,Le Calcul des Sequents,12,865,9,QCU,0.02,0.81,77.44,60,18,78,64,60,4,1.22,93.75,Moyen,Facile,1,Plus Facile,Pas Adapte,Philosophy
1975,2016,Philosophie,2,La Notion de Logique,5,Le Calcul des Sequents,12,865,9,QCU,0.29,0.66,49.76,43,44,87,46,43,3,1.89,93.48,Moyen,Moyen,0,Meme Difficulté,Pas Adapte,Philosophy
3086,2017,Philosophie,2,La Notion de Logique,5,Le Calcul des Sequents,12,865,9,QCM,0.68,0.18,1.75,1,82,83,80,1,79,1.04,1.25,Facile,Difficile,-2,Beaucoup plus Difficile,Pas Adapte,Philosophy
4197,2018,Philosophie,2,La Notion de Logique,5,Le Calcul des Sequents,12,865,9,QCM,0.13,0.87,84.07,77,14,91,90,77,13,1.01,85.56,Moyen,Facile,1,Plus Facile,Pas Adapte,Philosophy
5308,2019,Philosophie,2,La Notion de Logique,5,Le Calcul des Sequents,12,865,9,QCM,0.16,0.9,79.15,74,20,94,74,74,0,1.27,100.0,Moyen,Facile,1,Plus Facile,Pas Adapte,Philosophy
6419,2020,Philosophie,2,La Notion de Logique,5,Le Calcul des Sequents,12,865,9,QCM,0.25,0.61,41.62,39,54,93,53,39,14,1.75,73.58,Difficile,Moyen,1,Plus Facile,Pas Adapte,Philosophy
865,2015,Philosophie,2,La Notion de Logique,5,Le Calcul des Sequents,12,866,10,QCM,0.61,0.29,16.2,2,8,10,3,2,1,3.33,66.67,Difficile,Difficile,0,Meme Difficulté,Pas Adapte,Philosophy
1976,2016,Philosophie,2,La Notion de Logique,5,Le Calcul des Sequents,12,866,10,QCM,0.78,0.28,18.2,2,8,10,7,2,5,1.43,28.57,Moyen,Difficile,-1,Plus Difficile,Pas Adapte,Philosophy
3087,2017,Philosophie,2,La Notion de Logique,5,Le Calcul des Sequents,12,866,10,QCM,0.75,0.21,3.72,0,9,9,3,0,3,3.0,0.0,Difficile,Difficile,0,Meme Difficulté,Pas Adapte,Philosophy
4198,2018,Philosophie,2,La Notion de Logique,5,Le Calcul des Sequents,12,866,10,QCM,0.32,0.59,60.81,5,4,9,8,5,3,1.12,62.5,Moyen,Moyen,0,Meme Difficulté,Adapte,Philosophy
5309,2019,Philosophie,2,La Notion de Logique,5,Le Calcul des Sequents,12,866,10,QROC,0.41,0.27,60.81,6,4,10,7,6,1,1.43,85.71,Moyen,Moyen,0,Meme Difficulté,Adapte,Philosophy
6420,2020,Philosophie,2,La Notion de Logique,5,Le Calcul des Sequents,12,866,10,QROC,0.53,0.3,60.81,5,4,9,7,5,2,1.29,71.43,Moyen,Moyen,0,Meme Difficulté,Adapte,Philosophy
866,2015,Philosophie,2,La Notion de Logique,5,Le Calcul des Sequents,12,867,11,QCU,0.66,0.27,24.07,22,70,92,34,22,12,2.71,64.71,Difficile,Difficile,0,Meme Difficulté,Pas Adapte,Philosophy
1977,2016,Philosophie,2,La Notion de Logique,5,Le Calcul des Sequents,12,867,11,QCM,0.13,0.89,97.34,86,2,88,87,86,1,1.01,98.85,Difficile,Facile,2,Beaucoup plus Facile,Pas Adapte,Philosophy
3088,2017,Philosophie,2,La Notion de Logique,5,Le Calcul des Sequents,12,867,11,QCM,0.05,0.97,65.52,66,35,101,78,66,12,1.29,84.62,Facile,Facile,0,Meme Difficulté,Adapte,Philosophy
4199,2018,Philosophie,2,La Notion de Logique,5,Le Calcul des Sequents,12,867,11,QCM,0.07,0.82,65.52,62,32,94,81,62,19,1.16,76.54,Facile,Facile,0,Meme Difficulté,Adapte,Philosophy
5310,2019,Philosophie,2,La Notion de Logique,5,Le Calcul des Sequents,12,867,11,QCM,0.05,0.85,65.52,65,34,99,71,65,6,1.39,91.55,Facile,Facile,0,Meme Difficulté,Adapte,Philosophy
6421,2020,Philosophie,2,La Notion de Logique,5,Le Calcul des Sequents,12,867,11,QCM,0.18,0.85,65.52,56,29,85,70,56,14,1.21,80.0,Facile,Facile,0,Meme Difficulté,Adapte,Philosophy
867,2015,Philosophie,2,La Notion de Logique,5,Le Calcul des Sequents,12,868,12,QCU,0.62,0.35,18.02,14,61,75,55,14,41,1.36,25.45,Difficile,Difficile,0,Meme Difficulté,Pas Adapte,Philosophy
1978,2016,Philosophie,2,La Notion de Logique,5,Le Calcul des Sequents,12,868,12,QCU,0.11,0.96,86.68,59,9,68,63,59,4,1.08,93.65,Moyen,Facile,1,Plus Facile,Pas Adapte,Philosophy
3089,2017,Philosophie,2,La Notion de Logique,5,Le Calcul des Sequents,12,868,12,QCU,0.02,0.93,82.51,48,10,58,49,48,1,1.18,97.96,Difficile,Facile,2,Beaucoup plus Facile,Pas Adapte,Philosophy
4200,2018,Philosophie,2,La Notion de Logique,5,Le Calcul des Sequents,12,868,12,QCU,0.61,0.22,10.95,7,57,64,31,7,24,2.06,22.58,Facile,Difficile,-2,Beaucoup plus Difficile,Pas Adapte,Philosophy
5311,2019,Philosophie,2,La Notion de Logique,5,Le Calcul des Sequents,12,868,12,QCU,0.38,0.74,54.8,38,32,70,39,38,1,1.79,97.44,Facile,Moyen,-1,Plus Difficile,Pas Adapte,Philosophy
6422,2020,Philosophie,2,La Notion de Logique,5,Le Calcul des Sequents,12,868,12,QCU,0.13,0.89,97.72,72,2,74,73,72,1,1.01,98.63,Facile,Facile,0,Meme Difficulté,Pas Adapte,Philosophy
868,2015,Philosophie,2,La Notion de Logique,6,Le Theoreme de Completude,9,869,1,QROC,0.44,0.26,56.74,26,19,45,31,26,5,1.45,83.87,Difficile,Moyen,1,Plus Facile,Pas Adapte,Philosophy
1979,2016,Philosophie,2,La Notion de Logique,6,Le Theoreme de Completude,9,869,1,QROC,0.45,0.37,47.63,20,23,43,29,20,9,1.48,68.97,Difficile,Moyen,1,Plus Facile,Pas Adapte,Philosophy
3090,2017,Philosophie,2,La Notion de Logique,6,Le Theoreme de Completude,9,869,1,QROC,0.46,0.27,51.34,24,23,47,44,24,20,1.07,54.55,Moyen,Moyen,0,Meme Difficulté,Pas Adapte,Philosophy
4201,2018,Philosophie,2,La Notion de Logique,6,Le Theoreme de Completude,9,869,1,QROC,0.53,0.29,46.19,21,25,46,36,21,15,1.28,58.33,Difficile,Moyen,1,Plus Facile,Pas Adapte,Philosophy
5312,2019,Philosophie,2,La Notion de Logique,6,Le Theoreme de Completude,9,869,1,QROC,0.68,0.15,1.9,1,51,52,36,1,35,1.44,2.78,Difficile,Difficile,0,Meme Difficulté,Pas Adapte,Philosophy
6423,2020,Philosophie,2,La Notion de Logique,6,Le Theoreme de Completude,9,869,1,QROC,0.86,0.11,0.73,0,47,47,39,0,39,1.21,0.0,Moyen,Difficile,-1,Plus Difficile,Pas Adapte,Philosophy
869,2015,Philosophie,2,La Notion de Logique,6,Le Theoreme de Completude,9,870,2,QCM,0.68,0.25,15.11,14,79,93,58,14,44,1.6,24.14,Difficile,Difficile,0,Meme Difficulté,Pas Adapte,Philosophy
1980,2016,Philosophie,2,La Notion de Logique,6,Le Theoreme de Completude,9,870,2,QCM,0.12,0.97,83.34,88,18,106,93,88,5,1.14,94.62,Difficile,Facile,2,Beaucoup plus Facile,Pas Adapte,Philosophy
3091,2017,Philosophie,2,La Notion de Logique,6,Le Theoreme de Completude,9,870,2,QCM,0.43,0.32,58.33,65,47,112,85,65,20,1.32,76.47,Moyen,Moyen,0,Meme Difficulté,Pas Adapte,Philosophy
4202,2018,Philosophie,2,La Notion de Logique,6,Le Theoreme de Completude,9,870,2,QCM,0.19,0.82,83.61,95,19,114,107,95,12,1.07,88.79,Difficile,Facile,2,Beaucoup plus Facile,Pas Adapte,Philosophy
5313,2019,Philosophie,2,La Notion de Logique,6,Le Theoreme de Completude,9,870,2,QCM,0.12,0.98,82.92,90,18,108,94,90,4,1.15,95.74,Difficile,Facile,2,Beaucoup plus Facile,Pas Adapte,Philosophy
6424,2020,Philosophie,2,La Notion de Logique,6,Le Theoreme de Completude,9,870,2,QCU,0.33,0.57,58.5,64,46,110,72,64,8,1.53,88.89,Facile,Moyen,-1,Plus Difficile,Pas Adapte,Philosophy
870,2015,Philosophie,2,La Notion de Logique,6,Le Theoreme de Completude,9,871,3,QCM,0.61,0.22,25.07,21,61,82,69,21,48,1.19,30.43,Facile,Difficile,-2,Beaucoup plus Difficile,Pas Adapte,Philosophy
1981,2016,Philosophie,2,La Notion de Logique,6,Le Theoreme de Completude,9,871,3,QCM,0.05,0.86,71.33,58,24,82,65,58,7,1.26,89.23,Moyen,Facile,1,Plus Facile,Adapte,Philosophy
3092,2017,Philosophie,2,La Notion de Logique,6,Le Theoreme de Completude,9,871,3,QCU,0.18,0.82,71.33,50,20,70,55,50,5,1.27,90.91,Facile,Facile,0,Meme Difficulté,Adapte,Philosophy
4203,2018,Philosophie,2,La Notion de Logique,6,Le Theoreme de Completude,9,871,3,QCU,0.03,0.91,71.33,53,21,74,70,53,17,1.06,75.71,Facile,Facile,0,Meme Difficulté,Adapte,Philosophy
5314,2019,Philosophie,2,La Notion de Logique,6,Le Theoreme de Completude,9,871,3,QCM,0.01,0.77,71.33,49,19,68,60,49,11,1.13,81.67,Facile,Facile,0,Meme Difficulté,Adapte,Philosophy
6425,2020,Philosophie,2,La Notion de Logique,6,Le Theoreme de Completude,9,871,3,QCM,0.15,0.99,71.33,43,17,60,52,43,9,1.15,82.69,Facile,Facile,0,Meme Difficulté,Adapte,Philosophy
871,2015,Philosophie,2,La Notion de Logique,6,Le Theoreme de Completude,9,872,4,QCM,0.01,0.78,83.72,6,1,7,7,6,1,1.0,85.71,Difficile,Facile,2,Beaucoup plus Facile,Pas Adapte,Philosophy
1982,2016,Philosophie,2,La Notion de Logique,6,Le Theoreme de Completude,9,872,4,QO,0.69,0.2,37.16,2,4,6,4,2,2,1.5,50.0,Difficile,Moyen,1,Plus Facile,Pas Adapte,Philosophy
3093,2017,Philosophie,2,La Notion de Logique,6,Le Theoreme de Completude,9,872,4,QO,0.72,0.22,37.37,2,4,6,4,2,2,1.5,50.0,Difficile,Moyen,1,Plus Facile,Pas Adapte,Philosophy
4204,2018,Philosophie,2,La Notion de Logique,6,Le Theoreme de Completude,9,872,4,QO,0.11,0.48,88.19,5,1,6,5,5,0,1.2,100.0,Difficile,Facile,2,Beaucoup plus Facile,Pas Adapte,Philosophy
5315,2019,Philosophie,2,La Notion de Logique,6,Le Theoreme de Completude,9,872,4,QO,0.71,0.16,61.4,3,2,5,3,3,0,1.67,100.0,Moyen,Moyen,0,Meme Difficulté,Adapte,Philosophy
6426,2020,Philosophie,2,La Notion de Logique,6,Le Theoreme de Completude,9,872,4,QO,0.46,0.22,61.4,3,2,5,4,3,1,1.25,75.0,Moyen,Moyen,0,Meme Difficulté,Adapte,Philosophy
872,2015,Philosophie,2,La Notion de Logique,6,Le Theoreme de Completude,9,873,5,QCU,0.67,0.33,5.17,4,75,79,27,4,23,2.93,14.81,Moyen,Difficile,-1,Plus Difficile,Pas Adapte,Philosophy
1983,2016,Philosophie,2,La Notion de Logique,6,Le Theoreme de Completude,9,873,5,QCU,0.16,0.91,86.12,68,11,79,71,68,3,1.11,95.77,Moyen,Facile,1,Plus Facile,Pas Adapte,Philosophy
3094,2017,Philosophie,2,La Notion de Logique,6,Le Theoreme de Completude,9,873,5,QCU,0.13,0.91,78.96,64,17,81,68,64,4,1.19,94.12,Difficile,Facile,2,Beaucoup plus Facile,Pas Adapte,Philosophy
4205,2018,Philosophie,2,La Notion de Logique,6,Le Theoreme de Completude,9,873,5,QCM,0.25,0.35,56.4,50,38,88,87,50,37,1.01,57.47,Difficile,Moyen,1,Plus Facile,Pas Adapte,Philosophy
5316,2019,Philosophie,2,La Notion de Logique,6,Le Theoreme de Completude,9,873,5,QCM,0.2,1.0,84.91,70,12,82,72,70,2,1.14,97.22,Difficile,Facile,2,Beaucoup plus Facile,Pas Adapte,Philosophy
6427,2020,Philosophie,2,La Notion de Logique,6,Le Theoreme de Completude,9,873,5,QCM,0.71,0.16,10.67,10,82,92,44,10,34,2.09,22.73,Difficile,Difficile,0,Meme Difficulté,Pas Adapte,Philosophy
873,2015,Philosophie,2,La Notion de Logique,6,Le Theoreme de Completude,9,874,6,QCU,0.11,0.92,97.38,64,2,66,65,64,1,1.02,98.46,Facile,Facile,0,Meme Difficulté,Pas Adapte,Philosophy
1984,2016,Philosophie,2,La Notion de Logique,6,Le Theoreme de Completude,9,874,6,QCU,0.71,0.22,15.45,9,52,61,21,9,12,2.9,42.86,Moyen,Difficile,-1,Plus Difficile,Pas Adapte,Philosophy
3095,2017,Philosophie,2,La Notion de Logique,6,Le Theoreme de Completude,9,874,6,QCU,0.44,0.32,33.17,20,40,60,52,20,32,1.15,38.46,Moyen,Difficile,-1,Plus Difficile,Pas Adapte,Philosophy
4206,2018,Philosophie,2,La Notion de Logique,6,Le Theoreme de Completude,9,874,6,QCU,0.12,0.77,90.34,52,6,58,57,52,5,1.02,91.23,Facile,Facile,0,Meme Difficulté,Pas Adapte,Philosophy
5317,2019,Philosophie,2,La Notion de Logique,6,Le Theoreme de Completude,9,874,6,QCU,0.08,0.95,65.44,33,17,50,46,33,13,1.09,71.74,Facile,Facile,0,Meme Difficulté,Adapte,Philosophy
6428,2020,Philosophie,2,La Notion de Logique,6,Le Theoreme de Completude,9,874,6,QCU,0.0,0.83,65.44,31,16,47,41,31,10,1.15,75.61,Facile,Facile,0,Meme Difficulté,Adapte,Philosophy
874,2015,Philosophie,2,La Notion de Logique,6,Le Theoreme de Completude,9,875,7,QCU,0.63,0.27,31.0,5,11,16,15,5,10,1.07,33.33,Moyen,Difficile,-1,Plus Difficile,Pas Adapte,Philosophy
1985,2016,Philosophie,2,La Notion de Logique,6,Le Theoreme de Completude,9,875,7,QCM,0.13,0.97,81.44,12,3,15,13,12,1,1.15,92.31,Facile,Facile,0,Meme Difficulté,Pas Adapte,Philosophy
3096,2017,Philosophie,2,La Notion de Logique,6,Le Theoreme de Completude,9,875,7,QCM,0.51,0.3,16.92,2,12,14,6,2,4,2.33,33.33,Difficile,Difficile,0,Meme Difficulté,Pas Adapte,Philosophy
4207,2018,Philosophie,2,La Notion de Logique,6,Le Theoreme de Completude,9,875,7,QCM,0.61,0.24,31.51,4,10,14,4,4,0,3.5,100.0,Facile,Difficile,-2,Beaucoup plus Difficile,Pas Adapte,Philosophy
5318,2019,Philosophie,2,La Notion de Logique,6,Le Theoreme de Completude,9,875,7,QCM,0.51,0.22,3.5,0,12,12,4,0,4,3.0,0.0,Difficile,Difficile,0,Meme Difficulté,Pas Adapte,Philosophy
6429,2020,Philosophie,2,La Notion de Logique,6,Le Theoreme de Completude,9,875,7,QCM,0.56,0.19,25.39,3,9,12,9,3,6,1.33,33.33,Difficile,Difficile,0,Meme Difficulté,Pas Adapte,Philosophy
875,2015,Philosophie,2,La Notion de Logique,6,Le Theoreme de Completude,9,876,8,QCU,0.5,0.33,29.25,4,9,13,7,4,3,1.86,57.14,Difficile,Difficile,0,Meme Difficulté,Pas Adapte,Philosophy
1986,2016,Philosophie,2,La Notion de Logique,6,Le Theoreme de Completude,9,876,8,QCU,0.1,0.79,96.77,13,0,13,13,13,0,1.0,100.0,Difficile,Facile,2,Beaucoup plus Facile,Pas Adapte,Philosophy
3097,2017,Philosophie,2,La Notion de Logique,6,Le Theoreme de Completude,9,876,8,QCU,0.22,0.65,53.27,8,7,15,14,8,6,1.07,57.14,Difficile,Moyen,1,Plus Facile,Pas Adapte,Philosophy
4208,2018,Philosophie,2,La Notion de Logique,6,Le Theoreme de Completude,9,876,8,QCU,0.2,0.65,58.48,9,7,16,10,9,1,1.6,90.0,Facile,Moyen,-1,Plus Difficile,Pas Adapte,Philosophy
5319,2019,Philosophie,2,La Notion de Logique,6,Le Theoreme de Completude,9,876,8,QCU,0.27,0.47,58.28,9,6,15,10,9,1,1.5,90.0,Moyen,Moyen,0,Meme Difficulté,Pas Adapte,Philosophy
6430,2020,Philosophie,2,La Notion de Logique,6,Le Theoreme de Completude,9,876,8,QCU,0.1,0.86,78.17,11,3,14,14,11,3,1.0,78.57,Facile,Facile,0,Meme Difficulté,Pas Adapte,Philosophy
876,2015,Philosophie,2,La Notion de Logique,6,Le Theoreme de Completude,9,877,9,QCU,0.17,0.92,80.04,24,6,30,27,24,3,1.11,88.89,Moyen,Facile,1,Plus Facile,Pas Adapte,Philosophy
1987,2016,Philosophie,2,La Notion de Logique,6,Le Theoreme de Completude,9,877,9,QCM,0.45,0.42,42.52,13,17,30,25,13,12,1.2,52.0,Moyen,Moyen,0,Meme Difficulté,Pas Adapte,Philosophy
3098,2017,Philosophie,2,La Notion de Logique,6,Le Theoreme de Completude,9,877,9,QCM,0.11,0.99,81.22,28,6,34,33,28,5,1.03,84.85,Difficile,Facile,2,Beaucoup plus Facile,Pas Adapte,Philosophy
4209,2018,Philosophie,2,La Notion de Logique,6,Le Theoreme de Completude,9,877,9,QCM,0.57,0.17,17.88,6,25,31,24,6,18,1.29,25.0,Facile,Difficile,-2,Beaucoup plus Difficile,Pas Adapte,Philosophy
5320,2019,Philosophie,2,La Notion de Logique,6,Le Theoreme de Completude,9,877,9,QCM,0.37,0.7,51.76,18,16,34,31,18,13,1.1,58.06,Facile,Moyen,-1,Plus Difficile,Pas Adapte,Philosophy
6431,2020,Philosophie,2,La Notion de Logique,6,Le Theoreme de Completude,9,877,9,QCM,0.66,0.25,9.01,3,32,35,22,3,19,1.59,13.64,Difficile,Difficile,0,Meme Difficulté,Pas Adapte,Philosophy
877,2015,Philosophie,3,La Notion d'Ethique,1,La Recherche d'Ethique,9,878,1,QCM,0.69,0.2,18.37,8,38,46,13,8,5,3.54,61.54,Facile,Difficile,-2,Beaucoup plus Difficile,Pas Adapte,Philosophy
1988,2016,Philosophie,3,La Notion d'Ethique,1,La Recherche d'Ethique,9,878,1,QCM,0.07,0.93,89.68,36,4,40,38,36,2,1.05,94.74,Facile,Facile,0,Meme Difficulté,Pas Adapte,Philosophy
3099,2017,Philosophie,3,La Notion d'Ethique,1,La Recherche d'Ethique,9,878,1,QCM,0.15,0.92,98.85,37,0,37,37,37,0,1.0,100.0,Facile,Facile,0,Meme Difficulté,Pas Adapte,Philosophy
4210,2018,Philosophie,3,La Notion d'Ethique,1,La Recherche d'Ethique,9,878,1,QCM,0.42,0.58,58.33,19,13,32,29,19,10,1.1,65.52,Facile,Moyen,-1,Plus Difficile,Pas Adapte,Philosophy
5321,2019,Philosophie,3,La Notion d'Ethique,1,La Recherche d'Ethique,9,878,1,QCM,0.43,0.42,47.95,16,18,34,32,16,16,1.06,50.0,Difficile,Moyen,1,Plus Facile,Pas Adapte,Philosophy
6432,2020,Philosophie,3,La Notion d'Ethique,1,La Recherche d'Ethique,9,878,1,QCU,0.02,0.97,84.72,31,6,37,37,31,6,1.0,83.78,Facile,Facile,0,Meme Difficulté,Pas Adapte,Philosophy
878,2015,Philosophie,3,La Notion d'Ethique,1,La Recherche d'Ethique,9,879,2,QCU,0.14,0.76,67.5,44,21,65,55,44,11,1.18,80.0,Difficile,Facile,2,Beaucoup plus Facile,Adapte,Philosophy
1989,2016,Philosophie,3,La Notion d'Ethique,1,La Recherche d'Ethique,9,879,2,QCU,0.19,0.97,67.5,40,19,59,52,40,12,1.13,76.92,Facile,Facile,0,Meme Difficulté,Adapte,Philosophy
3100,2017,Philosophie,3,La Notion d'Ethique,1,La Recherche d'Ethique,9,879,2,QCU,0.03,0.97,67.5,34,17,51,38,34,4,1.34,89.47,Facile,Facile,0,Meme Difficulté,Adapte,Philosophy
4211,2018,Philosophie,3,La Notion d'Ethique,1,La Recherche d'Ethique,9,879,2,QCU,0.2,0.95,67.5,38,18,56,46,38,8,1.22,82.61,Facile,Facile,0,Meme Difficulté,Adapte,Philosophy
5322,2019,Philosophie,3,La Notion d'Ethique,1,La Recherche d'Ethique,9,879,2,QCU,0.16,0.84,67.5,38,18,56,41,38,3,1.37,92.68,Facile,Facile,0,Meme Difficulté,Adapte,Philosophy
6433,2020,Philosophie,3,La Notion d'Ethique,1,La Recherche d'Ethique,9,879,2,QCU,0.04,0.94,67.5,39,19,58,49,39,10,1.18,79.59,Facile,Facile,0,Meme Difficulté,Adapte,Philosophy
879,2015,Philosophie,3,La Notion d'Ethique,1,La Recherche d'Ethique,9,880,3,QCM,0.15,0.8,72.98,55,21,76,68,55,13,1.12,80.88,Moyen,Facile,1,Plus Facile,Adapte,Philosophy
1990,2016,Philosophie,3,La Notion d'Ethique,1,La Recherche d'Ethique,9,880,3,QCM,0.02,0.96,72.98,50,19,69,50,50,0,1.38,100.0,Facile,Facile,0,Meme Difficulté,Adapte,Philosophy
3101,2017,Philosophie,3,La Notion d'Ethique,1,La Recherche d'Ethique,9,880,3,QCM,0.14,0.89,72.98,55,20,75,67,55,12,1.12,82.09,Facile,Facile,0,Meme Difficulté,Adapte,Philosophy
4212,2018,Philosophie,3,La Notion d'Ethique,1,La Recherche d'Ethique,9,880,3,QCM,0.14,0.72,72.98,48,18,66,66,48,18,1.0,72.73,Facile,Facile,0,Meme Difficulté,Adapte,Philosophy
5323,2019,Philosophie,3,La Notion d'Ethique,1,La Recherche d'Ethique,9,880,3,QCM,0.09,0.91,72.98,43,16,59,48,43,5,1.23,89.58,Facile,Facile,0,Meme Difficulté,Adapte,Philosophy
6434,2020,Philosophie,3,La Notion d'Ethique,1,La Recherche d'Ethique,9,880,3,QCM,0.18,0.72,72.98,50,18,68,54,50,4,1.26,92.59,Facile,Facile,0,Meme Difficulté,Adapte,Philosophy
880,2015,Philosophie,3,La Notion d'Ethique,1,La Recherche d'Ethique,9,881,4,QCM,0.12,0.78,88.26,55,7,62,60,55,5,1.03,91.67,Difficile,Facile,2,Beaucoup plus Facile,Pas Adapte,Philosophy
1991,2016,Philosophie,3,La Notion d'Ethique,1,La Recherche d'Ethique,9,881,4,QCM,0.08,0.76,79.43,52,13,65,58,52,6,1.12,89.66,Difficile,Facile,2,Beaucoup plus Facile,Pas Adapte,Philosophy
3102,2017,Philosophie,3,La Notion d'Ethique,1,La Recherche d'Ethique,9,881,4,QCU,0.04,0.84,98.25,70,1,71,71,70,1,1.0,98.59,Moyen,Facile,1,Plus Facile,Pas Adapte,Philosophy
4213,2018,Philosophie,3,La Notion d'Ethique,1,La Recherche d'Ethique,9,881,4,QCU,0.46,0.29,2.68,2,61,63,60,2,58,1.05,3.33,Moyen,Difficile,-1,Plus Difficile,Pas Adapte,Philosophy
5324,2019,Philosophie,3,La Notion d'Ethique,1,La Recherche d'Ethique,9,881,4,QCU,0.15,0.78,74.11,44,16,60,45,44,1,1.33,97.78,Difficile,Facile,2,Beaucoup plus Facile,Adapte,Philosophy
6435,2020,Philosophie,3,La Notion d'Ethique,1,La Recherche d'Ethique,9,881,4,QCU,0.0,0.96,74.11,42,14,56,48,42,6,1.17,87.5,Facile,Facile,0,Meme Difficulté,Adapte,Philosophy
881,2015,Philosophie,3,La Notion d'Ethique,1,La Recherche d'Ethique,9,882,5,QCM,0.43,0.53,36.51,24,43,67,48,24,24,1.4,50.0,Moyen,Moyen,0,Meme Difficulté,Pas Adapte,Philosophy
1992,2016,Philosophie,3,La Notion d'Ethique,1,La Recherche d'Ethique,9,882,5,QCM,0.03,0.86,98.64,57,1,58,58,57,1,1.0,98.28,Moyen,Facile,1,Plus Facile,Pas Adapte,Philosophy
3103,2017,Philosophie,3,La Notion d'Ethique,1,La Recherche d'Ethique,9,882,5,QCM,0.72,0.27,5.15,3,48,51,49,3,46,1.04,6.12,Facile,Difficile,-2,Beaucoup plus Difficile,Pas Adapte,Philosophy
4214,2018,Philosophie,3,La Notion d'Ethique,1,La Recherche d'Ethique,9,882,5,QCM,0.57,0.19,8.04,4,43,47,24,4,20,1.96,16.67,Difficile,Difficile,0,Meme Difficulté,Pas Adapte,Philosophy
5325,2019,Philosophie,3,La Notion d'Ethique,1,La Recherche d'Ethique,9,882,5,QCM,0.07,0.99,72.25,37,14,51,47,37,10,1.09,78.72,Facile,Facile,0,Meme Difficulté,Adapte,Philosophy
6436,2020,Philosophie,3,La Notion d'Ethique,1,La Recherche d'Ethique,9,882,5,QCM,0.1,0.73,72.25,40,15,55,52,40,12,1.06,76.92,Facile,Facile,0,Meme Difficulté,Adapte,Philosophy
882,2015,Philosophie,3,La Notion d'Ethique,1,La Recherche d'Ethique,9,883,6,QCM,0.14,0.84,80.44,47,12,59,53,47,6,1.11,88.68,Moyen,Facile,1,Plus Facile,Pas Adapte,Philosophy
1993,2016,Philosophie,3,La Notion d'Ethique,1,La Recherche d'Ethique,9,883,6,QCM,0.13,0.72,90.75,56,6,62,61,56,5,1.02,91.8,Difficile,Facile,2,Beaucoup plus Facile,Pas Adapte,Philosophy
3104,2017,Philosophie,3,La Notion d'Ethique,1,La Recherche d'Ethique,9,883,6,QCM,0.61,0.2,21.82,14,52,66,19,14,5,3.47,73.68,Difficile,Difficile,0,Meme Difficulté,Pas Adapte,Philosophy
4215,2018,Philosophie,3,La Notion d'Ethique,1,La Recherche d'Ethique,9,883,6,QCM,0.05,0.89,99.73,70,0,70,70,70,0,1.0,100.0,Difficile,Facile,2,Beaucoup plus Facile,Pas Adapte,Philosophy
5326,2019,Philosophie,3,La Notion d'Ethique,1,La Recherche d'Ethique,9,883,6,QCM,0.24,0.62,60.47,39,26,65,44,39,5,1.48,88.64,Moyen,Moyen,0,Meme Difficulté,Adapte,Philosophy
6437,2020,Philosophie,3,La Notion d'Ethique,1,La Recherche d'Ethique,9,883,6,QCM,0.38,0.44,60.47,44,28,72,55,44,11,1.31,80.0,Moyen,Moyen,0,Meme Difficulté,Adapte,Philosophy
883,2015,Philosophie,3,La Notion d'Ethique,1,La Recherche d'Ethique,9,884,7,QCU,0.55,0.34,19.11,7,31,38,23,7,16,1.65,30.43,Moyen,Difficile,-1,Plus Difficile,Pas Adapte,Philosophy
1994,2016,Philosophie,3,La Notion d'Ethique,1,La Recherche d'Ethique,9,884,7,QCU,0.59,0.33,30.74,12,27,39,37,12,25,1.05,32.43,Difficile,Difficile,0,Meme Difficulté,Pas Adapte,Philosophy
3105,2017,Philosophie,3,La Notion d'Ethique,1,La Recherche d'Ethique,9,884,7,QCU,0.07,0.98,94.28,31,2,33,31,31,0,1.06,100.0,Difficile,Facile,2,Beaucoup plus Facile,Pas Adapte,Philosophy
4216,2018,Philosophie,3,La Notion d'Ethique,1,La Recherche d'Ethique,9,884,7,QROC,0.05,0.87,71.95,20,8,28,25,20,5,1.12,80.0,Difficile,Facile,2,Beaucoup plus Facile,Adapte,Philosophy
5327,2019,Philosophie,3,La Notion d'Ethique,1,La Recherche d'Ethique,9,884,7,QROC,0.13,0.75,71.95,22,8,30,28,22,6,1.07,78.57,Facile,Facile,0,Meme Difficulté,Adapte,Philosophy
6438,2020,Philosophie,3,La Notion d'Ethique,1,La Recherche d'Ethique,9,884,7,QROC,0.19,0.92,71.95,20,8,28,22,20,2,1.27,90.91,Facile,Facile,0,Meme Difficulté,Adapte,Philosophy
884,2015,Philosophie,3,La Notion d'Ethique,1,La Recherche d'Ethique,9,885,8,QROC,0.04,0.45,82.63,45,9,54,52,45,7,1.04,86.54,Facile,Facile,0,Meme Difficulté,Pas Adapte,Philosophy
1995,2016,Philosophie,3,La Notion d'Ethique,1,La Recherche d'Ethique,9,885,8,QROC,0.15,0.86,91.82,50,4,54,54,50,4,1.0,92.59,Difficile,Facile,2,Beaucoup plus Facile,Pas Adapte,Philosophy
3106,2017,Philosophie,3,La Notion d'Ethique,1,La Recherche d'Ethique,9,885,8,QROC,0.1,0.62,70.76,38,15,53,39,38,1,1.36,97.44,Difficile,Facile,2,Beaucoup plus Facile,Adapte,Philosophy
4217,2018,Philosophie,3,La Notion d'Ethique,1,La Recherche d'Ethique,9,885,8,QROC,0.03,0.4,70.76,42,18,60,54,42,12,1.11,77.78,Facile,Facile,0,Meme Difficulté,Adapte,Philosophy
5328,2019,Philosophie,3,La Notion d'Ethique,1,La Recherche d'Ethique,9,885,8,QROC,0.15,0.56,70.76,43,18,61,60,43,17,1.02,71.67,Facile,Facile,0,Meme Difficulté,Adapte,Philosophy
6439,2020,Philosophie,3,La Notion d'Ethique,1,La Recherche d'Ethique,9,885,8,QROC,0.11,0.54,70.76,43,18,61,46,43,3,1.33,93.48,Facile,Facile,0,Meme Difficulté,Adapte,Philosophy
885,2015,Philosophie,3,La Notion d'Ethique,1,La Recherche d'Ethique,9,886,9,QCU,0.25,0.49,47.56,9,9,18,10,9,1,1.8,90.0,Moyen,Moyen,0,Meme Difficulté,Pas Adapte,Philosophy
1996,2016,Philosophie,3,La Notion d'Ethique,1,La Recherche d'Ethique,9,886,9,QCU,0.65,0.31,6.4,1,20,21,10,1,9,2.1,10.0,Difficile,Difficile,0,Meme Difficulté,Pas Adapte,Philosophy
3107,2017,Philosophie,3,La Notion d'Ethique,1,La Recherche d'Ethique,9,886,9,QCU,0.15,0.95,73.68,13,5,18,17,13,4,1.06,76.47,Moyen,Facile,1,Plus Facile,Adapte,Philosophy
4218,2018,Philosophie,3,La Notion d'Ethique,1,La Recherche d'Ethique,9,886,9,QCU,0.1,0.81,73.68,13,5,18,14,13,1,1.29,92.86,Facile,Facile,0,Meme Difficulté,Adapte,Philosophy
5329,2019,Philosophie,3,La Notion d'Ethique,1,La Recherche d'Ethique,9,886,9,QCU,0.14,0.78,73.68,12,4,16,14,12,2,1.14,85.71,Facile,Facile,0,Meme Difficulté,Adapte,Philosophy
6440,2020,Philosophie,3,La Notion d'Ethique,1,La Recherche d'Ethique,9,886,9,QCU,0.07,0.88,73.68,13,5,18,15,13,2,1.2,86.67,Facile,Facile,0,Meme Difficulté,Adapte,Philosophy
886,2015,Philosophie,3,La Notion d'Ethique,2,Libre Arbitre et Determinisme,4,887,1,QCU,0.31,0.62,61.82,47,29,76,64,47,17,1.19,73.44,Difficile,Moyen,1,Plus Facile,Adapte,Philosophy
1997,2016,Philosophie,3,La Notion d'Ethique,2,Libre Arbitre et Determinisme,4,887,1,QCU,0.22,0.71,61.82,44,27,71,70,44,26,1.01,62.86,Moyen,Moyen,0,Meme Difficulté,Adapte,Philosophy
3108,2017,Philosophie,3,La Notion d'Ethique,2,Libre Arbitre et Determinisme,4,887,1,QCM,0.34,0.48,61.82,51,31,82,75,51,24,1.09,68.0,Moyen,Moyen,0,Meme Difficulté,Adapte,Philosophy
4219,2018,Philosophie,3,La Notion d'Ethique,2,Libre Arbitre et Determinisme,4,887,1,QCM,0.45,0.58,61.82,45,28,73,47,45,2,1.55,95.74,Moyen,Moyen,0,Meme Difficulté,Adapte,Philosophy
5330,2019,Philosophie,3,La Notion d'Ethique,2,Libre Arbitre et Determinisme,4,887,1,QCM,0.28,0.67,61.82,46,29,75,65,46,19,1.15,70.77,Moyen,Moyen,0,Meme Difficulté,Adapte,Philosophy
6441,2020,Philosophie,3,La Notion d'Ethique,2,Libre Arbitre et Determinisme,4,887,1,QCM,0.47,0.34,61.82,43,26,69,49,43,6,1.41,87.76,Moyen,Moyen,0,Meme Difficulté,Adapte,Philosophy
887,2015,Philosophie,3,La Notion d'Ethique,2,Libre Arbitre et Determinisme,4,888,2,QCU,0.34,0.45,42.86,29,38,67,46,29,17,1.46,63.04,Facile,Moyen,-1,Plus Difficile,Pas Adapte,Philosophy
1998,2016,Philosophie,3,La Notion d'Ethique,2,Libre Arbitre et Determinisme,4,888,2,QCU,0.74,0.35,27.22,20,53,73,67,20,47,1.09,29.85,Facile,Difficile,-2,Beaucoup plus Difficile,Pas Adapte,Philosophy
3109,2017,Philosophie,3,La Notion d'Ethique,2,Libre Arbitre et Determinisme,4,888,2,QCU,0.71,0.26,21.56,17,60,77,39,17,22,1.97,43.59,Facile,Difficile,-2,Beaucoup plus Difficile,Pas Adapte,Philosophy
4220,2018,Philosophie,3,La Notion d'Ethique,2,Libre Arbitre et Determinisme,4,888,2,QCU,0.0,0.85,98.68,75,1,76,76,75,1,1.0,98.68,Moyen,Facile,1,Plus Facile,Pas Adapte,Philosophy
5331,2019,Philosophie,3,La Notion d'Ethique,2,Libre Arbitre et Determinisme,4,888,2,QCU,0.08,0.99,80.75,67,16,83,71,67,4,1.17,94.37,Difficile,Facile,2,Beaucoup plus Facile,Pas Adapte,Philosophy
6442,2020,Philosophie,3,La Notion d'Ethique,2,Libre Arbitre et Determinisme,4,888,2,QCU,0.63,0.27,9.35,7,64,71,65,7,58,1.09,10.77,Facile,Difficile,-2,Beaucoup plus Difficile,Pas Adapte,Philosophy
888,2015,Philosophie,3,La Notion d'Ethique,2,Libre Arbitre et Determinisme,4,889,3,QCM,0.13,0.75,75.21,47,16,63,47,47,0,1.34,100.0,Difficile,Facile,2,Beaucoup plus Facile,Pas Adapte,Philosophy
1999,2016,Philosophie,3,La Notion d'Ethique,2,Libre Arbitre et Determinisme,4,889,3,QCM,0.67,0.29,19.38,10,44,54,24,10,14,2.25,41.67,Facile,Difficile,-2,Beaucoup plus Difficile,Pas Adapte,Philosophy
3110,2017,Philosophie,3,La Notion d'Ethique,2,Libre Arbitre et Determinisme,4,889,3,QCM,0.01,0.74,69.98,33,14,47,33,33,0,1.42,100.0,Difficile,Facile,2,Beaucoup plus Facile,Adapte,Philosophy
4221,2018,Philosophie,3,La Notion d'Ethique,2,Libre Arbitre et Determinisme,4,889,3,QCM,0.11,0.72,69.98,36,16,52,36,36,0,1.44,100.0,Facile,Facile,0,Meme Difficulté,Adapte,Philosophy
5332,2019,Philosophie,3,La Notion d'Ethique,2,Libre Arbitre et Determinisme,4,889,3,QCM,0.18,0.94,69.98,33,14,47,37,33,4,1.27,89.19,Facile,Facile,0,Meme Difficulté,Adapte,Philosophy
6443,2020,Philosophie,3,La Notion d'Ethique,2,Libre Arbitre et Determinisme,4,889,3,QCM,0.12,0.99,69.98,36,16,52,45,36,9,1.16,80.0,Facile,Facile,0,Meme Difficulté,Adapte,Philosophy
889,2015,Philosophie,3,La Notion d'Ethique,2,Libre Arbitre et Determinisme,4,890,4,QROC,0.35,0.36,61.04,12,7,19,13,12,1,1.46,92.31,Facile,Moyen,-1,Plus Difficile,Adapte,Philosophy
2000,2016,Philosophie,3,La Notion d'Ethique,2,Libre Arbitre et Determinisme,4,890,4,QROC,0.31,0.25,61.04,10,6,16,11,10,1,1.45,90.91,Moyen,Moyen,0,Meme Difficulté,Adapte,Philosophy
3111,2017,Philosophie,3,La Notion d'Ethique,2,Libre Arbitre et Determinisme,4,890,4,QROC,0.41,0.32,61.04,11,7,18,13,11,2,1.38,84.62,Moyen,Moyen,0,Meme Difficulté,Adapte,Philosophy
4222,2018,Philosophie,3,La Notion d'Ethique,2,Libre Arbitre et Determinisme,4,890,4,QROC,0.32,0.28,61.04,10,7,17,10,10,0,1.7,100.0,Moyen,Moyen,0,Meme Difficulté,Adapte,Philosophy
5333,2019,Philosophie,3,La Notion d'Ethique,2,Libre Arbitre et Determinisme,4,890,4,QROC,0.29,0.33,61.04,12,8,20,14,12,2,1.43,85.71,Moyen,Moyen,0,Meme Difficulté,Adapte,Philosophy
6444,2020,Philosophie,3,La Notion d'Ethique,2,Libre Arbitre et Determinisme,4,890,4,QO,0.47,0.29,61.04,10,7,17,15,10,5,1.13,66.67,Moyen,Moyen,0,Meme Difficulté,Adapte,Philosophy
890,2015,Philosophie,3,La Notion d'Ethique,3,Ethique du Devoir et Ethique Religieuse,13,891,1,QCU,0.49,0.39,33.73,24,47,71,32,24,8,2.22,75.0,Facile,Difficile,-2,Beaucoup plus Difficile,Pas Adapte,Philosophy
2001,2016,Philosophie,3,La Notion d'Ethique,3,Ethique du Devoir et Ethique Religieuse,13,891,1,QCU,0.31,0.5,41.6,33,46,79,68,33,35,1.16,48.53,Difficile,Moyen,1,Plus Facile,Pas Adapte,Philosophy
3112,2017,Philosophie,3,La Notion d'Ethique,3,Ethique du Devoir et Ethique Religieuse,13,891,1,QCU,0.16,0.89,75.13,50,17,67,61,50,11,1.1,81.97,Moyen,Facile,1,Plus Facile,Pas Adapte,Philosophy
4223,2018,Philosophie,3,La Notion d'Ethique,3,Ethique du Devoir et Ethique Religieuse,13,891,1,QCU,0.3,0.54,46.71,35,39,74,52,35,17,1.42,67.31,Moyen,Moyen,0,Meme Difficulté,Pas Adapte,Philosophy
5334,2019,Philosophie,3,La Notion d'Ethique,3,Ethique du Devoir et Ethique Religieuse,13,891,1,QCM,0.26,0.51,38.88,33,51,84,40,33,7,2.1,82.5,Difficile,Moyen,1,Plus Facile,Pas Adapte,Philosophy
6445,2020,Philosophie,3,La Notion d'Ethique,3,Ethique du Devoir et Ethique Religieuse,13,891,1,QCM,0.06,0.73,99.26,87,1,88,87,87,0,1.01,100.0,Difficile,Facile,2,Beaucoup plus Facile,Pas Adapte,Philosophy
891,2015,Philosophie,3,La Notion d'Ethique,3,Ethique du Devoir et Ethique Religieuse,13,892,2,QCM,0.03,0.82,72.56,36,13,49,46,36,10,1.07,78.26,Moyen,Facile,1,Plus Facile,Adapte,Philosophy
2002,2016,Philosophie,3,La Notion d'Ethique,3,Ethique du Devoir et Ethique Religieuse,13,892,2,QCM,0.1,0.94,72.56,39,15,54,39,39,0,1.38,100.0,Facile,Facile,0,Meme Difficulté,Adapte,Philosophy
3113,2017,Philosophie,3,La Notion d'Ethique,3,Ethique du Devoir et Ethique Religieuse,13,892,2,QCM,0.02,0.76,72.56,43,16,59,51,43,8,1.16,84.31,Facile,Facile,0,Meme Difficulté,Adapte,Philosophy
4224,2018,Philosophie,3,La Notion d'Ethique,3,Ethique du Devoir et Ethique Religieuse,13,892,2,QCM,0.12,0.95,72.56,44,16,60,54,44,10,1.11,81.48,Facile,Facile,0,Meme Difficulté,Adapte,Philosophy
5335,2019,Philosophie,3,La Notion d'Ethique,3,Ethique du Devoir et Ethique Religieuse,13,892,2,QCM,0.07,0.86,72.56,38,15,53,49,38,11,1.08,77.55,Facile,Facile,0,Meme Difficulté,Adapte,Philosophy
6446,2020,Philosophie,3,La Notion d'Ethique,3,Ethique du Devoir et Ethique Religieuse,13,892,2,QCM,0.06,0.82,72.56,33,12,45,41,33,8,1.1,80.49,Facile,Facile,0,Meme Difficulté,Adapte,Philosophy
892,2015,Philosophie,3,La Notion d'Ethique,3,Ethique du Devoir et Ethique Religieuse,13,893,3,QCM,0.41,0.33,35.59,27,50,77,31,27,4,2.48,87.1,Difficile,Moyen,1,Plus Facile,Pas Adapte,Philosophy
2003,2016,Philosophie,3,La Notion d'Ethique,3,Ethique du Devoir et Ethique Religieuse,13,893,3,QCM,0.3,0.53,49.1,33,34,67,65,33,32,1.03,50.77,Facile,Moyen,-1,Plus Difficile,Pas Adapte,Philosophy
3114,2017,Philosophie,3,La Notion d'Ethique,3,Ethique du Devoir et Ethique Religieuse,13,893,3,QO,0.73,0.17,58.47,41,29,70,62,41,21,1.13,66.13,Difficile,Moyen,1,Plus Facile,Pas Adapte,Philosophy
4225,2018,Philosophie,3,La Notion d'Ethique,3,Ethique du Devoir et Ethique Religieuse,13,893,3,QO,0.91,0.05,29.8,19,45,64,33,19,14,1.94,57.58,Difficile,Difficile,0,Meme Difficulté,Pas Adapte,Philosophy
5336,2019,Philosophie,3,La Notion d'Ethique,3,Ethique du Devoir et Ethique Religieuse,13,893,3,QO,0.07,0.59,88.67,59,8,67,61,59,2,1.1,96.72,Difficile,Facile,2,Beaucoup plus Facile,Pas Adapte,Philosophy
6447,2020,Philosophie,3,La Notion d'Ethique,3,Ethique du Devoir et Ethique Religieuse,13,893,3,QCM,0.38,0.32,40.23,23,34,57,41,23,18,1.39,56.1,Difficile,Moyen,1,Plus Facile,Pas Adapte,Philosophy
893,2015,Philosophie,3,La Notion d'Ethique,3,Ethique du Devoir et Ethique Religieuse,13,894,4,QROC,0.01,0.86,75.51,15,5,20,15,15,0,1.33,100.0,Difficile,Facile,2,Beaucoup plus Facile,Pas Adapte,Philosophy
2004,2016,Philosophie,3,La Notion d'Ethique,3,Ethique du Devoir et Ethique Religieuse,13,894,4,QROC,0.18,0.95,88.15,17,2,19,18,17,1,1.06,94.44,Difficile,Facile,2,Beaucoup plus Facile,Pas Adapte,Philosophy
3115,2017,Philosophie,3,La Notion d'Ethique,3,Ethique du Devoir et Ethique Religieuse,13,894,4,QROC,0.99,0.21,28.98,6,15,21,12,6,6,1.75,50.0,Difficile,Difficile,0,Meme Difficulté,Pas Adapte,Philosophy
4226,2018,Philosophie,3,La Notion d'Ethique,3,Ethique du Devoir et Ethique Religieuse,13,894,4,QROC,0.04,0.45,94.35,20,1,21,21,20,1,1.0,95.24,Facile,Facile,0,Meme Difficulté,Pas Adapte,Philosophy
5337,2019,Philosophie,3,La Notion d'Ethique,3,Ethique du Devoir et Ethique Religieuse,13,894,4,QROC,0.14,0.86,67.1,13,6,19,14,13,1,1.36,92.86,Moyen,Facile,1,Plus Facile,Adapte,Philosophy
6448,2020,Philosophie,3,La Notion d'Ethique,3,Ethique du Devoir et Ethique Religieuse,13,894,4,QROC,0.06,0.7,67.1,11,5,16,14,11,3,1.14,78.57,Facile,Facile,0,Meme Difficulté,Adapte,Philosophy
894,2015,Philosophie,3,La Notion d'Ethique,3,Ethique du Devoir et Ethique Religieuse,13,895,5,QCU,0.07,0.84,73.34,10,3,13,12,10,2,1.08,83.33,Facile,Facile,0,Meme Difficulté,Adapte,Philosophy
2005,2016,Philosophie,3,La Notion d'Ethique,3,Ethique du Devoir et Ethique Religieuse,13,895,5,QCU,0.05,0.92,73.34,10,4,14,11,10,1,1.27,90.91,Facile,Facile,0,Meme Difficulté,Adapte,Philosophy
3116,2017,Philosophie,3,La Notion d'Ethique,3,Ethique du Devoir et Ethique Religieuse,13,895,5,QCU,0.19,0.76,73.34,12,4,16,13,12,1,1.23,92.31,Facile,Facile,0,Meme Difficulté,Adapte,Philosophy
4227,2018,Philosophie,3,La Notion d'Ethique,3,Ethique du Devoir et Ethique Religieuse,13,895,5,QCU,0.01,0.99,73.34,12,4,16,16,12,4,1.0,75.0,Facile,Facile,0,Meme Difficulté,Adapte,Philosophy
5338,2019,Philosophie,3,La Notion d'Ethique,3,Ethique du Devoir et Ethique Religieuse,13,895,5,QCU,0.11,0.78,73.34,13,5,18,16,13,3,1.12,81.25,Facile,Facile,0,Meme Difficulté,Adapte,Philosophy
6449,2020,Philosophie,3,La Notion d'Ethique,3,Ethique du Devoir et Ethique Religieuse,13,895,5,QCU,0.16,0.89,73.34,15,5,20,20,15,5,1.0,75.0,Facile,Facile,0,Meme Difficulté,Adapte,Philosophy
895,2015,Philosophie,3,La Notion d'Ethique,3,Ethique du Devoir et Ethique Religieuse,13,896,6,QO,1.0,0.13,21.19,8,32,40,23,8,15,1.74,34.78,Moyen,Difficile,-1,Plus Difficile,Pas Adapte,Philosophy
2006,2016,Philosophie,3,La Notion d'Ethique,3,Ethique du Devoir et Ethique Religieuse,13,896,6,QO,0.72,0.21,41.92,16,22,38,35,16,19,1.09,45.71,Facile,Moyen,-1,Plus Difficile,Pas Adapte,Philosophy
3117,2017,Philosophie,3,La Notion d'Ethique,3,Ethique du Devoir et Ethique Religieuse,13,896,6,QO,0.62,0.2,48.82,18,18,36,24,18,6,1.5,75.0,Difficile,Moyen,1,Plus Facile,Pas Adapte,Philosophy
4228,2018,Philosophie,3,La Notion d'Ethique,3,Ethique du Devoir et Ethique Religieuse,13,896,6,QO,0.2,0.4,96.5,38,1,39,39,38,1,1.0,97.44,Difficile,Facile,2,Beaucoup plus Facile,Pas Adapte,Philosophy
5339,2019,Philosophie,3,La Notion d'Ethique,3,Ethique du Devoir et Ethique Religieuse,13,896,6,QO,0.34,0.17,50.96,20,20,40,21,20,1,1.9,95.24,Facile,Moyen,-1,Plus Difficile,Pas Adapte,Philosophy
6450,2020,Philosophie,3,La Notion d'Ethique,3,Ethique du Devoir et Ethique Religieuse,13,896,6,QO,0.85,0.14,10.11,4,34,38,36,4,32,1.06,11.11,Facile,Difficile,-2,Beaucoup plus Difficile,Pas Adapte,Philosophy
896,2015,Philosophie,3,La Notion d'Ethique,3,Ethique du Devoir et Ethique Religieuse,13,897,7,QCU,0.35,0.61,57.38,22,16,38,32,22,10,1.19,68.75,Facile,Moyen,-1,Plus Difficile,Pas Adapte,Philosophy
2007,2016,Philosophie,3,La Notion d'Ethique,3,Ethique du Devoir et Ethique Religieuse,13,897,7,QCU,0.6,0.25,31.37,11,24,35,23,11,12,1.52,47.83,Facile,Difficile,-2,Beaucoup plus Difficile,Pas Adapte,Philosophy
3118,2017,Philosophie,3,La Notion d'Ethique,3,Ethique du Devoir et Ethique Religieuse,13,897,7,QCU,0.16,0.89,82.06,29,6,35,32,29,3,1.09,90.62,Difficile,Facile,2,Beaucoup plus Facile,Pas Adapte,Philosophy
4229,2018,Philosophie,3,La Notion d'Ethique,3,Ethique du Devoir et Ethique Religieuse,13,897,7,QCU,0.06,0.82,82.36,32,7,39,34,32,2,1.15,94.12,Facile,Facile,0,Meme Difficulté,Pas Adapte,Philosophy
5340,2019,Philosophie,3,La Notion d'Ethique,3,Ethique du Devoir et Ethique Religieuse,13,897,7,QCU,0.4,0.36,28.06,11,27,38,25,11,14,1.52,44.0,Moyen,Difficile,-1,Plus Difficile,Pas Adapte,Philosophy
6451,2020,Philosophie,3,La Notion d'Ethique,3,Ethique du Devoir et Ethique Religieuse,13,897,7,QCU,0.53,0.36,14.11,5,32,37,20,5,15,1.85,25.0,Difficile,Difficile,0,Meme Difficulté,Pas Adapte,Philosophy
897,2015,Philosophie,3,La Notion d'Ethique,3,Ethique du Devoir et Ethique Religieuse,13,898,8,QCU,0.19,0.78,74.14,14,5,19,18,14,4,1.06,77.78,Facile,Facile,0,Meme Difficulté,Adapte,Philosophy
2008,2016,Philosophie,3,La Notion d'Ethique,3,Ethique du Devoir et Ethique Religieuse,13,898,8,QCM,0.1,0.93,74.14,14,5,19,14,14,0,1.36,100.0,Facile,Facile,0,Meme Difficulté,Adapte,Philosophy
3119,2017,Philosophie,3,La Notion d'Ethique,3,Ethique du Devoir et Ethique Religieuse,13,898,8,QCM,0.01,0.84,74.14,13,5,18,17,13,4,1.06,76.47,Facile,Facile,0,Meme Difficulté,Adapte,Philosophy
4230,2018,Philosophie,3,La Notion d'Ethique,3,Ethique du Devoir et Ethique Religieuse,13,898,8,QCM,0.11,0.9,74.14,13,5,18,15,13,2,1.2,86.67,Facile,Facile,0,Meme Difficulté,Adapte,Philosophy
5341,2019,Philosophie,3,La Notion d'Ethique,3,Ethique du Devoir et Ethique Religieuse,13,898,8,QCM,0.05,0.83,74.14,11,4,15,13,11,2,1.15,84.62,Facile,Facile,0,Meme Difficulté,Adapte,Philosophy
6452,2020,Philosophie,3,La Notion d'Ethique,3,Ethique du Devoir et Ethique Religieuse,13,898,8,QCM,0.04,0.73,74.14,13,4,17,17,13,4,1.0,76.47,Facile,Facile,0,Meme Difficulté,Adapte,Philosophy
898,2015,Philosophie,3,La Notion d'Ethique,3,Ethique du Devoir et Ethique Religieuse,13,899,9,QCM,0.75,0.24,7.04,7,88,95,62,7,55,1.53,11.29,Difficile,Difficile,0,Meme Difficulté,Pas Adapte,Philosophy
2009,2016,Philosophie,3,La Notion d'Ethique,3,Ethique du Devoir et Ethique Religieuse,13,899,9,QROC,0.1,0.42,73.13,66,24,90,76,66,10,1.18,86.84,Facile,Facile,0,Meme Difficulté,Adapte,Philosophy
3120,2017,Philosophie,3,La Notion d'Ethique,3,Ethique du Devoir et Ethique Religieuse,13,899,9,QROC,0.04,0.75,73.13,63,23,86,83,63,20,1.04,75.9,Facile,Facile,0,Meme Difficulté,Adapte,Philosophy
4231,2018,Philosophie,3,La Notion d'Ethique,3,Ethique du Devoir et Ethique Religieuse,13,899,9,QROC,0.16,0.84,73.13,71,26,97,93,71,22,1.04,76.34,Facile,Facile,0,Meme Difficulté,Adapte,Philosophy
5342,2019,Philosophie,3,La Notion d'Ethique,3,Ethique du Devoir et Ethique Religieuse,13,899,9,QROC,0.12,0.79,73.13,79,29,108,101,79,22,1.07,78.22,Facile,Facile,0,Meme Difficulté,Adapte,Philosophy
6453,2020,Philosophie,3,La Notion d'Ethique,3,Ethique du Devoir et Ethique Religieuse,13,899,9,QO,0.08,0.9,73.13,87,32,119,117,87,30,1.02,74.36,Facile,Facile,0,Meme Difficulté,Adapte,Philosophy
899,2015,Philosophie,3,La Notion d'Ethique,3,Ethique du Devoir et Ethique Religieuse,13,900,10,QROC,0.93,0.13,29.96,18,41,59,54,18,36,1.09,33.33,Difficile,Difficile,0,Meme Difficulté,Pas Adapte,Philosophy
2010,2016,Philosophie,3,La Notion d'Ethique,3,Ethique du Devoir et Ethique Religieuse,13,900,10,QROC,0.05,0.98,74.32,45,15,60,56,45,11,1.07,80.36,Difficile,Facile,2,Beaucoup plus Facile,Adapte,Philosophy
3121,2017,Philosophie,3,La Notion d'Ethique,3,Ethique du Devoir et Ethique Religieuse,13,900,10,QROC,0.16,0.53,74.32,48,17,65,62,48,14,1.05,77.42,Facile,Facile,0,Meme Difficulté,Adapte,Philosophy
4232,2018,Philosophie,3,La Notion d'Ethique,3,Ethique du Devoir et Ethique Religieuse,13,900,10,QROC,0.11,0.59,74.32,53,18,71,65,53,12,1.09,81.54,Facile,Facile,0,Meme Difficulté,Adapte,Philosophy
5343,2019,Philosophie,3,La Notion d'Ethique,3,Ethique du Devoir et Ethique Religieuse,13,900,10,QCM,0.12,0.93,74.32,50,17,67,57,50,7,1.18,87.72,Facile,Facile,0,Meme Difficulté,Adapte,Philosophy
6454,2020,Philosophie,3,La Notion d'Ethique,3,Ethique du Devoir et Ethique Religieuse,13,900,10,QCM,0.09,0.93,74.32,56,20,76,71,56,15,1.07,78.87,Facile,Facile,0,Meme Difficulté,Adapte,Philosophy
900,2015,Philosophie,3,La Notion d'Ethique,3,Ethique du Devoir et Ethique Religieuse,13,901,11,QCM,0.24,0.33,56.08,43,34,77,53,43,10,1.45,81.13,Facile,Moyen,-1,Plus Difficile,Pas Adapte,Philosophy
2011,2016,Philosophie,3,La Notion d'Ethique,3,Ethique du Devoir et Ethique Religieuse,13,901,11,QCM,0.01,0.91,90.79,69,7,76,70,69,1,1.09,98.57,Difficile,Facile,2,Beaucoup plus Facile,Pas Adapte,Philosophy
3122,2017,Philosophie,3,La Notion d'Ethique,3,Ethique du Devoir et Ethique Religieuse,13,901,11,QCM,0.39,0.68,57.67,50,36,86,55,50,5,1.56,90.91,Moyen,Moyen,0,Meme Difficulté,Pas Adapte,Philosophy
4233,2018,Philosophie,3,La Notion d'Ethique,3,Ethique du Devoir et Ethique Religieuse,13,901,11,QCM,0.35,0.59,56.01,53,42,95,66,53,13,1.44,80.3,Moyen,Moyen,0,Meme Difficulté,Pas Adapte,Philosophy
5344,2019,Philosophie,3,La Notion d'Ethique,3,Ethique du Devoir et Ethique Religieuse,13,901,11,QCM,0.08,0.84,88.7,89,11,100,90,89,1,1.11,98.89,Facile,Facile,0,Meme Difficulté,Pas Adapte,Philosophy
6455,2020,Philosophie,3,La Notion d'Ethique,3,Ethique du Devoir et Ethique Religieuse,13,901,11,QCM,0.34,0.37,37.34,38,65,103,48,38,10,2.15,79.17,Difficile,Moyen,1,Plus Facile,Pas Adapte,Philosophy
901,2015,Philosophie,3,La Notion d'Ethique,3,Ethique du Devoir et Ethique Religieuse,13,902,12,QCU,0.26,0.65,64.93,8,4,12,12,8,4,1.0,66.67,Facile,Moyen,-1,Plus Difficile,Adapte,Philosophy
2012,2016,Philosophie,3,La Notion d'Ethique,3,Ethique du Devoir et Ethique Religieuse,13,902,12,QCU,0.2,0.66,64.93,8,5,13,13,8,5,1.0,61.54,Moyen,Moyen,0,Meme Difficulté,Adapte,Philosophy
3123,2017,Philosophie,3,La Notion d'Ethique,3,Ethique du Devoir et Ethique Religieuse,13,902,12,QCU,0.27,0.6,64.93,8,4,12,12,8,4,1.0,66.67,Moyen,Moyen,0,Meme Difficulté,Adapte,Philosophy
4234,2018,Philosophie,3,La Notion d'Ethique,3,Ethique du Devoir et Ethique Religieuse,13,902,12,QCM,0.21,0.68,64.93,8,5,13,13,8,5,1.0,61.54,Moyen,Moyen,0,Meme Difficulté,Adapte,Philosophy
5345,2019,Philosophie,3,La Notion d'Ethique,3,Ethique du Devoir et Ethique Religieuse,13,902,12,QCM,0.26,0.34,64.93,8,4,12,11,8,3,1.09,72.73,Moyen,Moyen,0,Meme Difficulté,Adapte,Philosophy
6456,2020,Philosophie,3,La Notion d'Ethique,3,Ethique du Devoir et Ethique Religieuse,13,902,12,QCM,0.46,0.39,64.93,8,4,12,8,8,0,1.5,100.0,Moyen,Moyen,0,Meme Difficulté,Adapte,Philosophy
902,2015,Philosophie,3,La Notion d'Ethique,3,Ethique du Devoir et Ethique Religieuse,13,903,13,QCM,0.27,0.54,48.11,24,26,50,46,24,22,1.09,52.17,Difficile,Moyen,1,Plus Facile,Pas Adapte,Philosophy
2013,2016,Philosophie,3,La Notion d'Ethique,3,Ethique du Devoir et Ethique Religieuse,13,903,13,QCM,0.67,0.28,22.49,10,35,45,33,10,23,1.36,30.3,Difficile,Difficile,0,Meme Difficulté,Pas Adapte,Philosophy
3124,2017,Philosophie,3,La Notion d'Ethique,3,Ethique du Devoir et Ethique Religieuse,13,903,13,QCM,0.02,0.79,69.08,35,16,51,41,35,6,1.24,85.37,Facile,Facile,0,Meme Difficulté,Adapte,Philosophy
4235,2018,Philosophie,3,La Notion d'Ethique,3,Ethique du Devoir et Ethique Religieuse,13,903,13,QCM,0.19,0.96,69.08,37,17,54,53,37,16,1.02,69.81,Facile,Facile,0,Meme Difficulté,Adapte,Philosophy
5346,2019,Philosophie,3,La Notion d'Ethique,3,Ethique du Devoir et Ethique Religieuse,13,903,13,QCM,0.18,0.93,69.08,32,14,46,35,32,3,1.31,91.43,Facile,Facile,0,Meme Difficulté,Adapte,Philosophy
6457,2020,Philosophie,3,La Notion d'Ethique,3,Ethique du Devoir et Ethique Religieuse,13,903,13,QCM,0.11,0.89,69.08,30,13,43,35,30,5,1.23,85.71,Facile,Facile,0,Meme Difficulté,Adapte,Philosophy
903,2015,Philosophie,4,La Culture,1,Sentiments Croyance et Cultes Religieux,6,904,1,QCU,0.38,0.63,41.41,5,8,13,9,5,4,1.44,55.56,Facile,Moyen,-1,Plus Difficile,Pas Adapte,Philosophy
2014,2016,Philosophie,4,La Culture,1,Sentiments Croyance et Cultes Religieux,6,904,1,QCU,0.11,0.99,79.83,9,2,11,11,9,2,1.0,81.82,Moyen,Facile,1,Plus Facile,Pas Adapte,Philosophy
3125,2017,Philosophie,4,La Culture,1,Sentiments Croyance et Cultes Religieux,6,904,1,QCU,0.64,0.37,22.42,3,9,12,7,3,4,1.71,42.86,Facile,Difficile,-2,Beaucoup plus Difficile,Pas Adapte,Philosophy
4236,2018,Philosophie,4,La Culture,1,Sentiments Croyance et Cultes Religieux,6,904,1,QCU,0.08,0.99,83.29,9,2,11,9,9,0,1.22,100.0,Facile,Facile,0,Meme Difficulté,Pas Adapte,Philosophy
5347,2019,Philosophie,4,La Culture,1,Sentiments Croyance et Cultes Religieux,6,904,1,QCM,0.26,0.33,49.04,6,6,12,6,6,0,2.0,100.0,Facile,Moyen,-1,Plus Difficile,Pas Adapte,Philosophy
6458,2020,Philosophie,4,La Culture,1,Sentiments Croyance et Cultes Religieux,6,904,1,QCM,0.76,0.21,30.61,4,9,13,9,4,5,1.44,44.44,Difficile,Difficile,0,Meme Difficulté,Pas Adapte,Philosophy
904,2015,Philosophie,4,La Culture,1,Sentiments Croyance et Cultes Religieux,6,905,2,QCM,0.28,0.61,48.8,34,36,70,42,34,8,1.67,80.95,Difficile,Moyen,1,Plus Facile,Pas Adapte,Philosophy
2015,2016,Philosophie,4,La Culture,1,Sentiments Croyance et Cultes Religieux,6,905,2,QCM,0.28,0.46,47.95,31,34,65,42,31,11,1.55,73.81,Difficile,Moyen,1,Plus Facile,Pas Adapte,Philosophy
3126,2017,Philosophie,4,La Culture,1,Sentiments Croyance et Cultes Religieux,6,905,2,QROC,0.23,0.4,43.41,31,41,72,66,31,35,1.09,46.97,Moyen,Moyen,0,Meme Difficulté,Pas Adapte,Philosophy
4237,2018,Philosophie,4,La Culture,1,Sentiments Croyance et Cultes Religieux,6,905,2,QO,0.82,0.13,25.1,17,51,68,45,17,28,1.51,37.78,Difficile,Difficile,0,Meme Difficulté,Pas Adapte,Philosophy
5348,2019,Philosophie,4,La Culture,1,Sentiments Croyance et Cultes Religieux,6,905,2,QO,0.02,0.89,67.79,49,24,73,50,49,1,1.46,98.0,Difficile,Facile,2,Beaucoup plus Facile,Adapte,Philosophy
6459,2020,Philosophie,4,La Culture,1,Sentiments Croyance et Cultes Religieux,6,905,2,QO,0.09,0.67,67.79,56,26,82,78,56,22,1.05,71.79,Facile,Facile,0,Meme Difficulté,Adapte,Philosophy
905,2015,Philosophie,4,La Culture,1,Sentiments Croyance et Cultes Religieux,6,906,3,QCM,0.6,0.2,15.74,11,57,68,66,11,55,1.03,16.67,Facile,Difficile,-2,Beaucoup plus Difficile,Pas Adapte,Philosophy
2016,2016,Philosophie,4,La Culture,1,Sentiments Croyance et Cultes Religieux,6,906,3,QCM,0.0,0.97,77.6,52,15,67,53,52,1,1.26,98.11,Difficile,Facile,2,Beaucoup plus Facile,Pas Adapte,Philosophy
3127,2017,Philosophie,4,La Culture,1,Sentiments Croyance et Cultes Religieux,6,906,3,QCM,0.27,0.51,56.32,37,28,65,38,37,1,1.71,97.37,Moyen,Moyen,0,Meme Difficulté,Pas Adapte,Philosophy
4238,2018,Philosophie,4,La Culture,1,Sentiments Croyance et Cultes Religieux,6,906,3,QCM,0.51,0.29,10.59,6,53,59,34,6,28,1.74,17.65,Difficile,Difficile,0,Meme Difficulté,Pas Adapte,Philosophy
5349,2019,Philosophie,4,La Culture,1,Sentiments Croyance et Cultes Religieux,6,906,3,QCM,0.04,0.76,81.66,51,11,62,53,51,2,1.17,96.23,Facile,Facile,0,Meme Difficulté,Pas Adapte,Philosophy
6460,2020,Philosophie,4,La Culture,1,Sentiments Croyance et Cultes Religieux,6,906,3,QCM,0.15,0.78,78.72,42,11,53,52,42,10,1.02,80.77,Difficile,Facile,2,Beaucoup plus Facile,Pas Adapte,Philosophy
906,2015,Philosophie,4,La Culture,1,Sentiments Croyance et Cultes Religieux,6,907,4,QO,0.1,0.55,93.46,45,3,48,46,45,1,1.04,97.83,Difficile,Facile,2,Beaucoup plus Facile,Pas Adapte,Philosophy
2017,2016,Philosophie,4,La Culture,1,Sentiments Croyance et Cultes Religieux,6,907,4,QO,0.59,0.27,40.27,17,24,41,22,17,5,1.86,77.27,Difficile,Moyen,1,Plus Facile,Pas Adapte,Philosophy
3128,2017,Philosophie,4,La Culture,1,Sentiments Croyance et Cultes Religieux,6,907,4,QO,0.03,0.92,69.16,28,12,40,29,28,1,1.38,96.55,Moyen,Facile,1,Plus Facile,Adapte,Philosophy
4239,2018,Philosophie,4,La Culture,1,Sentiments Croyance et Cultes Religieux,6,907,4,QO,0.1,0.84,69.16,32,14,46,35,32,3,1.31,91.43,Facile,Facile,0,Meme Difficulté,Adapte,Philosophy
5350,2019,Philosophie,4,La Culture,1,Sentiments Croyance et Cultes Religieux,6,907,4,QO,0.05,0.37,69.16,35,16,51,41,35,6,1.24,85.37,Facile,Facile,0,Meme Difficulté,Adapte,Philosophy
6461,2020,Philosophie,4,La Culture,1,Sentiments Croyance et Cultes Religieux,6,907,4,QO,0.13,0.64,69.16,38,17,55,50,38,12,1.1,76.0,Facile,Facile,0,Meme Difficulté,Adapte,Philosophy
907,2015,Philosophie,4,La Culture,1,Sentiments Croyance et Cultes Religieux,6,908,5,QCM,0.64,0.29,3.17,0,15,15,9,0,9,1.67,0.0,Moyen,Difficile,-1,Plus Difficile,Pas Adapte,Philosophy
2018,2016,Philosophie,4,La Culture,1,Sentiments Croyance et Cultes Religieux,6,908,5,QCM,0.79,0.28,34.61,4,9,13,12,4,8,1.08,33.33,Difficile,Difficile,0,Meme Difficulté,Pas Adapte,Philosophy
3129,2017,Philosophie,4,La Culture,1,Sentiments Croyance et Cultes Religieux,6,908,5,QCM,0.12,0.8,89.85,10,1,11,11,10,1,1.0,90.91,Difficile,Facile,2,Beaucoup plus Facile,Pas Adapte,Philosophy
4240,2018,Philosophie,4,La Culture,1,Sentiments Croyance et Cultes Religieux,6,908,5,QCM,0.04,0.92,95.24,10,0,10,10,10,0,1.0,100.0,Difficile,Facile,2,Beaucoup plus Facile,Pas Adapte,Philosophy
5351,2019,Philosophie,4,La Culture,1,Sentiments Croyance et Cultes Religieux,6,908,5,QCM,0.33,0.33,41.43,4,6,10,7,4,3,1.43,57.14,Moyen,Moyen,0,Meme Difficulté,Pas Adapte,Philosophy
6462,2020,Philosophie,4,La Culture,1,Sentiments Croyance et Cultes Religieux,6,908,5,QCM,0.05,0.74,79.45,10,2,12,11,10,1,1.09,90.91,Difficile,Facile,2,Beaucoup plus Facile,Pas Adapte,Philosophy
908,2015,Philosophie,4,La Culture,1,Sentiments Croyance et Cultes Religieux,6,909,6,QCM,0.44,0.61,62.2,58,36,94,64,58,6,1.47,90.62,Moyen,Moyen,0,Meme Difficulté,Adapte,Philosophy
2019,2016,Philosophie,4,La Culture,1,Sentiments Croyance et Cultes Religieux,6,909,6,QCM,0.3,0.56,62.2,57,35,92,77,57,20,1.19,74.03,Moyen,Moyen,0,Meme Difficulté,Adapte,Philosophy
3130,2017,Philosophie,4,La Culture,1,Sentiments Croyance et Cultes Religieux,6,909,6,QCM,0.44,0.51,62.2,65,40,105,71,65,6,1.48,91.55,Moyen,Moyen,0,Meme Difficulté,Adapte,Philosophy
4241,2018,Philosophie,4,La Culture,1,Sentiments Croyance et Cultes Religieux,6,909,6,QCM,0.28,0.61,62.2,57,34,91,87,57,30,1.05,65.52,Moyen,Moyen,0,Meme Difficulté,Adapte,Philosophy
5352,2019,Philosophie,4,La Culture,1,Sentiments Croyance et Cultes Religieux,6,909,6,QCM,0.43,0.45,62.2,63,38,101,82,63,19,1.23,76.83,Moyen,Moyen,0,Meme Difficulté,Adapte,Philosophy
6463,2020,Philosophie,4,La Culture,1,Sentiments Croyance et Cultes Religieux,6,909,6,QCM,0.22,0.62,62.2,67,40,107,99,67,32,1.08,67.68,Moyen,Moyen,0,Meme Difficulté,Adapte,Philosophy
909,2015,Philosophie,4,La Culture,2,Croyances Religieuses et Verite,13,910,1,QCU,0.08,0.82,83.62,47,9,56,54,47,7,1.04,87.04,Difficile,Facile,2,Beaucoup plus Facile,Pas Adapte,Philosophy
2020,2016,Philosophie,4,La Culture,2,Croyances Religieuses et Verite,13,910,1,QCU,0.75,0.35,21.98,12,42,54,50,12,38,1.08,24.0,Facile,Difficile,-2,Beaucoup plus Difficile,Pas Adapte,Philosophy
3131,2017,Philosophie,4,La Culture,2,Croyances Religieuses et Verite,13,910,1,QCU,0.46,0.2,17.9,10,46,56,35,10,25,1.6,28.57,Moyen,Difficile,-1,Plus Difficile,Pas Adapte,Philosophy
4242,2018,Philosophie,4,La Culture,2,Croyances Religieuses et Verite,13,910,1,QCU,0.64,0.23,0.76,0,63,63,57,0,57,1.11,0.0,Difficile,Difficile,0,Meme Difficulté,Pas Adapte,Philosophy
5353,2019,Philosophie,4,La Culture,2,Croyances Religieuses et Verite,13,910,1,QCU,0.27,0.63,43.13,25,32,57,49,25,24,1.16,51.02,Facile,Moyen,-1,Plus Difficile,Pas Adapte,Philosophy
6464,2020,Philosophie,4,La Culture,2,Croyances Religieuses et Verite,13,910,1,QCU,0.47,0.38,4.9,2,46,48,35,2,33,1.37,5.71,Facile,Difficile,-2,Beaucoup plus Difficile,Pas Adapte,Philosophy
910,2015,Philosophie,4,La Culture,2,Croyances Religieuses et Verite,13,911,2,QCU,0.06,0.78,88.72,80,10,90,88,80,8,1.02,90.91,Facile,Facile,0,Meme Difficulté,Pas Adapte,Philosophy
2021,2016,Philosophie,4,La Culture,2,Croyances Religieuses et Verite,13,911,2,QROC,0.15,0.61,66.73,58,29,87,60,58,2,1.45,96.67,Facile,Facile,0,Meme Difficulté,Adapte,Philosophy
3132,2017,Philosophie,4,La Culture,2,Croyances Religieuses et Verite,13,911,2,QROC,0.05,0.74,66.73,64,32,96,95,64,31,1.01,67.37,Facile,Facile,0,Meme Difficulté,Adapte,Philosophy
4243,2018,Philosophie,4,La Culture,2,Croyances Religieuses et Verite,13,911,2,QO,0.09,0.4,66.73,59,29,88,85,59,26,1.04,69.41,Facile,Facile,0,Meme Difficulté,Adapte,Philosophy
5354,2019,Philosophie,4,La Culture,2,Croyances Religieuses et Verite,13,911,2,QO,0.01,0.66,66.73,62,31,93,92,62,30,1.01,67.39,Facile,Facile,0,Meme Difficulté,Adapte,Philosophy
6465,2020,Philosophie,4,La Culture,2,Croyances Religieuses et Verite,13,911,2,QO,0.1,0.51,66.73,62,31,93,87,62,25,1.07,71.26,Facile,Facile,0,Meme Difficulté,Adapte,Philosophy
911,2015,Philosophie,4,La Culture,2,Croyances Religieuses et Verite,13,912,3,QCM,0.69,0.15,6.42,6,86,92,35,6,29,2.63,17.14,Moyen,Difficile,-1,Plus Difficile,Pas Adapte,Philosophy
2022,2016,Philosophie,4,La Culture,2,Croyances Religieuses et Verite,13,912,3,QCU,0.26,0.49,54.64,50,42,92,66,50,16,1.39,75.76,Difficile,Moyen,1,Plus Facile,Pas Adapte,Philosophy
3133,2017,Philosophie,4,La Culture,2,Croyances Religieuses et Verite,13,912,3,QCU,0.08,0.79,82.23,86,18,104,90,86,4,1.16,95.56,Difficile,Facile,2,Beaucoup plus Facile,Pas Adapte,Philosophy
4244,2018,Philosophie,4,La Culture,2,Croyances Religieuses et Verite,13,912,3,QCU,0.19,0.87,91.23,109,10,119,114,109,5,1.04,95.61,Difficile,Facile,2,Beaucoup plus Facile,Pas Adapte,Philosophy
5355,2019,Philosophie,4,La Culture,2,Croyances Religieuses et Verite,13,912,3,QCU,0.44,0.22,4.08,5,115,120,95,5,90,1.26,5.26,Difficile,Difficile,0,Meme Difficulté,Pas Adapte,Philosophy
6466,2020,Philosophie,4,La Culture,2,Croyances Religieuses et Verite,13,912,3,QCM,0.66,0.29,19.22,26,110,136,113,26,87,1.2,23.01,Moyen,Difficile,-1,Plus Difficile,Pas Adapte,Philosophy
912,2015,Philosophie,4,La Culture,2,Croyances Religieuses et Verite,13,913,4,QROC,0.62,0.17,13.21,8,49,57,46,8,38,1.24,17.39,Moyen,Difficile,-1,Plus Difficile,Pas Adapte,Philosophy
2023,2016,Philosophie,4,La Culture,2,Croyances Religieuses et Verite,13,913,4,QROC,0.15,1.0,66.36,40,20,60,50,40,10,1.2,80.0,Facile,Facile,0,Meme Difficulté,Adapte,Philosophy
3134,2017,Philosophie,4,La Culture,2,Croyances Religieuses et Verite,13,913,4,QROC,0.16,0.73,66.36,37,19,56,44,37,7,1.27,84.09,Facile,Facile,0,Meme Difficulté,Adapte,Philosophy
4245,2018,Philosophie,4,La Culture,2,Croyances Religieuses et Verite,13,913,4,QCU,0.04,0.88,66.36,38,19,57,45,38,7,1.27,84.44,Facile,Facile,0,Meme Difficulté,Adapte,Philosophy
5356,2019,Philosophie,4,La Culture,2,Croyances Religieuses et Verite,13,913,4,QCU,0.16,0.88,66.36,40,21,61,44,40,4,1.39,90.91,Facile,Facile,0,Meme Difficulté,Adapte,Philosophy
6467,2020,Philosophie,4,La Culture,2,Croyances Religieuses et Verite,13,913,4,QCU,0.07,0.95,66.36,40,21,61,49,40,9,1.24,81.63,Facile,Facile,0,Meme Difficulté,Adapte,Philosophy
913,2015,Philosophie,4,La Culture,2,Croyances Religieuses et Verite,13,914,5,QROC,0.85,0.12,30.13,13,29,42,26,13,13,1.62,50.0,Facile,Difficile,-2,Beaucoup plus Difficile,Pas Adapte,Philosophy
2024,2016,Philosophie,4,La Culture,2,Croyances Religieuses et Verite,13,914,5,QO,0.9,0.03,16.7,6,30,36,27,6,21,1.33,22.22,Difficile,Difficile,0,Meme Difficulté,Pas Adapte,Philosophy
3135,2017,Philosophie,4,La Culture,2,Croyances Religieuses et Verite,13,914,5,QO,0.97,0.11,21.96,7,24,31,29,7,22,1.07,24.14,Facile,Difficile,-2,Beaucoup plus Difficile,Pas Adapte,Philosophy
4246,2018,Philosophie,4,La Culture,2,Croyances Religieuses et Verite,13,914,5,QO,0.14,0.49,89.0,28,4,32,30,28,2,1.07,93.33,Moyen,Facile,1,Plus Facile,Pas Adapte,Philosophy
5357,2019,Philosophie,4,La Culture,2,Croyances Religieuses et Verite,13,914,5,QO,0.05,0.4,86.9,28,4,32,28,28,0,1.14,100.0,Facile,Facile,0,Meme Difficulté,Pas Adapte,Philosophy
6468,2020,Philosophie,4,La Culture,2,Croyances Religieuses et Verite,13,914,5,QO,0.78,0.13,14.17,4,24,28,18,4,14,1.56,22.22,Facile,Difficile,-2,Beaucoup plus Difficile,Pas Adapte,Philosophy
914,2015,Philosophie,4,La Culture,2,Croyances Religieuses et Verite,13,915,6,QCM,0.02,0.84,67.9,61,29,90,68,61,7,1.32,89.71,Difficile,Facile,2,Beaucoup plus Facile,Adapte,Philosophy
2025,2016,Philosophie,4,La Culture,2,Croyances Religieuses et Verite,13,915,6,QCM,0.19,0.87,67.9,62,30,92,71,62,9,1.3,87.32,Facile,Facile,0,Meme Difficulté,Adapte,Philosophy
3136,2017,Philosophie,4,La Culture,2,Croyances Religieuses et Verite,13,915,6,QCM,0.14,0.72,67.9,71,33,104,77,71,6,1.35,92.21,Facile,Facile,0,Meme Difficulté,Adapte,Philosophy
4247,2018,Philosophie,4,La Culture,2,Croyances Religieuses et Verite,13,915,6,QCM,0.15,0.74,67.9,66,31,97,70,66,4,1.39,94.29,Facile,Facile,0,Meme Difficulté,Adapte,Philosophy
5358,2019,Philosophie,4,La Culture,2,Croyances Religieuses et Verite,13,915,6,QCM,0.1,0.94,67.9,60,28,88,83,60,23,1.06,72.29,Facile,Facile,0,Meme Difficulté,Adapte,Philosophy
6469,2020,Philosophie,4,La Culture,2,Croyances Religieuses et Verite,13,915,6,QCM,0.2,0.84,67.9,64,30,94,74,64,10,1.27,86.49,Facile,Facile,0,Meme Difficulté,Adapte,Philosophy
915,2015,Philosophie,4,La Culture,2,Croyances Religieuses et Verite,13,916,7,QCU,0.43,0.33,32.58,7,15,22,8,7,1,2.75,87.5,Facile,Difficile,-2,Beaucoup plus Difficile,Pas Adapte,Philosophy
2026,2016,Philosophie,4,La Culture,2,Croyances Religieuses et Verite,13,916,7,QCU,0.14,0.89,77.01,15,4,19,15,15,0,1.27,100.0,Difficile,Facile,2,Beaucoup plus Facile,Pas Adapte,Philosophy
3137,2017,Philosophie,4,La Culture,2,Croyances Religieuses et Verite,13,916,7,QCU,0.33,0.63,45.07,9,11,20,16,9,7,1.25,56.25,Difficile,Moyen,1,Plus Facile,Pas Adapte,Philosophy
4248,2018,Philosophie,4,La Culture,2,Croyances Religieuses et Verite,13,916,7,QCU,0.73,0.33,16.66,3,15,18,11,3,8,1.64,27.27,Difficile,Difficile,0,Meme Difficulté,Pas Adapte,Philosophy
5359,2019,Philosophie,4,La Culture,2,Croyances Religieuses et Verite,13,916,7,QCU,0.19,0.92,78.17,13,3,16,15,13,2,1.07,86.67,Moyen,Facile,1,Plus Facile,Pas Adapte,Philosophy
6470,2020,Philosophie,4,La Culture,2,Croyances Religieuses et Verite,13,916,7,QCU,0.57,0.38,16.27,3,14,17,12,3,9,1.42,25.0,Moyen,Difficile,-1,Plus Difficile,Pas Adapte,Philosophy
916,2015,Philosophie,4,La Culture,2,Croyances Religieuses et Verite,13,917,8,QROC,0.55,0.39,49.5,30,30,60,38,30,8,1.58,78.95,Facile,Moyen,-1,Plus Difficile,Pas Adapte,Philosophy
2027,2016,Philosophie,4,La Culture,2,Croyances Religieuses et Verite,13,917,8,QROC,0.56,0.38,41.61,24,34,58,48,24,24,1.21,50.0,Facile,Moyen,-1,Plus Difficile,Pas Adapte,Philosophy
3138,2017,Philosophie,4,La Culture,2,Croyances Religieuses et Verite,13,917,8,QROC,0.0,0.88,77.12,42,13,55,46,42,4,1.2,91.3,Difficile,Facile,2,Beaucoup plus Facile,Pas Adapte,Philosophy
4249,2018,Philosophie,4,La Culture,2,Croyances Religieuses et Verite,13,917,8,QROC,0.18,0.42,76.37,42,13,55,48,42,6,1.15,87.5,Difficile,Facile,2,Beaucoup plus Facile,Pas Adapte,Philosophy
5360,2019,Philosophie,4,La Culture,2,Croyances Religieuses et Verite,13,917,8,QROC,0.17,0.78,80.24,43,11,54,48,43,5,1.12,89.58,Difficile,Facile,2,Beaucoup plus Facile,Pas Adapte,Philosophy
6471,2020,Philosophie,4,La Culture,2,Croyances Religieuses et Verite,13,917,8,QROC,0.94,0.04,12.63,7,49,56,54,7,47,1.04,12.96,Facile,Difficile,-2,Beaucoup plus Difficile,Pas Adapte,Philosophy
917,2015,Philosophie,4,La Culture,2,Croyances Religieuses et Verite,13,918,9,QCU,0.07,0.9,75.44,28,9,37,34,28,6,1.09,82.35,Difficile,Facile,2,Beaucoup plus Facile,Pas Adapte,Philosophy
2028,2016,Philosophie,4,La Culture,2,Croyances Religieuses et Verite,13,918,9,QCU,0.34,0.45,59.86,19,12,31,31,19,12,1.0,61.29,Facile,Moyen,-1,Plus Difficile,Pas Adapte,Philosophy
3139,2017,Philosophie,4,La Culture,2,Croyances Religieuses et Verite,13,918,9,QCU,0.03,0.75,83.18,22,4,26,26,22,4,1.0,84.62,Facile,Facile,0,Meme Difficulté,Pas Adapte,Philosophy
4250,2018,Philosophie,4,La Culture,2,Croyances Religieuses et Verite,13,918,9,QCU,0.28,0.53,58.66,18,12,30,21,18,3,1.43,85.71,Difficile,Moyen,1,Plus Facile,Pas Adapte,Philosophy
5361,2019,Philosophie,4,La Culture,2,Croyances Religieuses et Verite,13,918,9,QCU,0.57,0.35,11.38,4,30,34,21,4,17,1.62,19.05,Facile,Difficile,-2,Beaucoup plus Difficile,Pas Adapte,Philosophy
6472,2020,Philosophie,4,La Culture,2,Croyances Religieuses et Verite,13,918,9,QCU,0.36,0.68,61.41,24,15,39,37,24,13,1.05,64.86,Moyen,Moyen,0,Meme Difficulté,Adapte,Philosophy
918,2015,Philosophie,4,La Culture,2,Croyances Religieuses et Verite,13,919,10,QCM,0.19,0.76,70.91,48,20,68,65,48,17,1.05,73.85,Moyen,Facile,1,Plus Facile,Adapte,Philosophy
2029,2016,Philosophie,4,La Culture,2,Croyances Religieuses et Verite,13,919,10,QO,0.15,0.37,70.91,45,19,64,51,45,6,1.25,88.24,Facile,Facile,0,Meme Difficulté,Adapte,Philosophy
3140,2017,Philosophie,4,La Culture,2,Croyances Religieuses et Verite,13,919,10,QO,0.06,0.91,70.91,38,16,54,39,38,1,1.38,97.44,Facile,Facile,0,Meme Difficulté,Adapte,Philosophy
4251,2018,Philosophie,4,La Culture,2,Croyances Religieuses et Verite,13,919,10,QROC,0.17,0.82,70.91,37,15,52,51,37,14,1.02,72.55,Facile,Facile,0,Meme Difficulté,Adapte,Philosophy
5362,2019,Philosophie,4,La Culture,2,Croyances Religieuses et Verite,13,919,10,QO,0.11,0.56,70.91,39,16,55,51,39,12,1.08,76.47,Facile,Facile,0,Meme Difficulté,Adapte,Philosophy
6473,2020,Philosophie,4,La Culture,2,Croyances Religieuses et Verite,13,919,10,QO,0.2,0.31,70.91,42,17,59,44,42,2,1.34,95.45,Facile,Facile,0,Meme Difficulté,Adapte,Philosophy
919,2015,Philosophie,4,La Culture,2,Croyances Religieuses et Verite,13,920,11,QCM,0.5,0.33,54.37,45,37,82,64,45,19,1.28,70.31,Facile,Moyen,-1,Plus Difficile,Pas Adapte,Philosophy
2030,2016,Philosophie,4,La Culture,2,Croyances Religieuses et Verite,13,920,11,QCM,0.68,0.26,14.45,13,74,87,84,13,71,1.04,15.48,Difficile,Difficile,0,Meme Difficulté,Pas Adapte,Philosophy
3141,2017,Philosophie,4,La Culture,2,Croyances Religieuses et Verite,13,920,11,QCM,0.63,0.24,33.25,27,54,81,58,27,31,1.4,46.55,Facile,Difficile,-2,Beaucoup plus Difficile,Pas Adapte,Philosophy
4252,2018,Philosophie,4,La Culture,2,Croyances Religieuses et Verite,13,920,11,QCM,0.68,0.25,8.9,7,77,84,24,7,17,3.5,29.17,Moyen,Difficile,-1,Plus Difficile,Pas Adapte,Philosophy
5363,2019,Philosophie,4,La Culture,2,Croyances Religieuses et Verite,13,920,11,QCM,0.52,0.21,6.86,5,68,73,24,5,19,3.04,20.83,Difficile,Difficile,0,Meme Difficulté,Pas Adapte,Philosophy
6474,2020,Philosophie,4,La Culture,2,Croyances Religieuses et Verite,13,920,11,QCM,0.22,0.65,39.67,27,42,69,37,27,10,1.86,72.97,Difficile,Moyen,1,Plus Facile,Pas Adapte,Philosophy
920,2015,Philosophie,4,La Culture,2,Croyances Religieuses et Verite,13,921,12,QCM,0.32,0.35,45.09,30,37,67,41,30,11,1.63,73.17,Moyen,Moyen,0,Meme Difficulté,Pas Adapte,Philosophy
2031,2016,Philosophie,4,La Culture,2,Croyances Religieuses et Verite,13,921,12,QROC,0.17,0.89,91.55,65,6,71,67,65,2,1.06,97.01,Moyen,Facile,1,Plus Facile,Pas Adapte,Philosophy
3142,2017,Philosophie,4,La Culture,2,Croyances Religieuses et Verite,13,921,12,QROC,0.1,0.42,94.04,73,5,78,77,73,4,1.01,94.81,Facile,Facile,0,Meme Difficulté,Pas Adapte,Philosophy
4253,2018,Philosophie,4,La Culture,2,Croyances Religieuses et Verite,13,921,12,QROC,0.24,0.39,49.49,37,38,75,59,37,22,1.27,62.71,Difficile,Moyen,1,Plus Facile,Pas Adapte,Philosophy
5364,2019,Philosophie,4,La Culture,2,Croyances Religieuses et Verite,13,921,12,QROC,0.58,0.39,46.39,39,45,84,84,39,45,1.0,46.43,Difficile,Moyen,1,Plus Facile,Pas Adapte,Philosophy
6475,2020,Philosophie,4,La Culture,2,Croyances Religieuses et Verite,13,921,12,QROC,0.14,0.87,79.07,76,20,96,80,76,4,1.2,95.0,Moyen,Facile,1,Plus Facile,Pas Adapte,Philosophy
921,2015,Philosophie,4,La Culture,2,Croyances Religieuses et Verite,13,922,13,QCU,0.01,0.9,89.02,51,6,57,54,51,3,1.06,94.44,Facile,Facile,0,Meme Difficulté,Pas Adapte,Philosophy
2032,2016,Philosophie,4,La Culture,2,Croyances Religieuses et Verite,13,922,13,QCU,0.63,0.21,22.87,11,38,49,17,11,6,2.88,64.71,Difficile,Difficile,0,Meme Difficulté,Pas Adapte,Philosophy
3143,2017,Philosophie,4,La Culture,2,Croyances Religieuses et Verite,13,922,13,QCU,0.27,0.44,64.48,28,16,44,36,28,8,1.22,77.78,Difficile,Moyen,1,Plus Facile,Adapte,Philosophy
4254,2018,Philosophie,4,La Culture,2,Croyances Religieuses et Verite,13,922,13,QCU,0.35,0.74,64.48,31,17,48,46,31,15,1.04,67.39,Moyen,Moyen,0,Meme Difficulté,Adapte,Philosophy
5365,2019,Philosophie,4,La Culture,2,Croyances Religieuses et Verite,13,922,13,QCU,0.26,0.55,64.48,35,20,55,50,35,15,1.1,70.0,Moyen,Moyen,0,Meme Difficulté,Adapte,Philosophy
6476,2020,Philosophie,4,La Culture,2,Croyances Religieuses et Verite,13,922,13,QCU,0.35,0.45,64.48,36,20,56,44,36,8,1.27,81.82,Moyen,Moyen,0,Meme Difficulté,Adapte,Philosophy
922,2015,Philosophie,4,La Culture,3,Religion et Morale,7,923,1,QROC,0.32,0.31,50.7,41,39,80,49,41,8,1.63,83.67,Moyen,Moyen,0,Meme Difficulté,Pas Adapte,Philosophy
2033,2016,Philosophie,4,La Culture,3,Religion et Morale,7,923,1,QROC,0.63,0.09,3.85,3,65,68,42,3,39,1.62,7.14,Difficile,Difficile,0,Meme Difficulté,Pas Adapte,Philosophy
3144,2017,Philosophie,4,La Culture,3,Religion et Morale,7,923,1,QROC,0.57,0.31,52.5,31,28,59,37,31,6,1.59,83.78,Moyen,Moyen,0,Meme Difficulté,Pas Adapte,Philosophy
4255,2018,Philosophie,4,La Culture,3,Religion et Morale,7,923,1,QROC,0.99,0.03,32.56,21,45,66,65,21,44,1.02,32.31,Difficile,Difficile,0,Meme Difficulté,Pas Adapte,Philosophy
5366,2019,Philosophie,4,La Culture,3,Religion et Morale,7,923,1,QROC,0.01,0.94,79.95,53,13,66,62,53,9,1.06,85.48,Moyen,Facile,1,Plus Facile,Pas Adapte,Philosophy
6477,2020,Philosophie,4,La Culture,3,Religion et Morale,7,923,1,QROC,0.53,0.34,48.47,28,29,57,39,28,11,1.46,71.79,Difficile,Moyen,1,Plus Facile,Pas Adapte,Philosophy
923,2015,Philosophie,4,La Culture,3,Religion et Morale,7,924,2,QROC,0.89,0.13,3.97,2,45,47,26,2,24,1.81,7.69,Difficile,Difficile,0,Meme Difficulté,Pas Adapte,Philosophy
2034,2016,Philosophie,4,La Culture,3,Religion et Morale,7,924,2,QCM,0.59,0.17,28.82,12,31,43,28,12,16,1.54,42.86,Difficile,Difficile,0,Meme Difficulté,Pas Adapte,Philosophy
3145,2017,Philosophie,4,La Culture,3,Religion et Morale,7,924,2,QCM,0.05,0.89,67.12,30,15,45,42,30,12,1.07,71.43,Difficile,Facile,2,Beaucoup plus Facile,Adapte,Philosophy
4256,2018,Philosophie,4,La Culture,3,Religion et Morale,7,924,2,QCM,0.2,0.76,67.12,33,16,49,35,33,2,1.4,94.29,Facile,Facile,0,Meme Difficulté,Adapte,Philosophy
5367,2019,Philosophie,4,La Culture,3,Religion et Morale,7,924,2,QCM,0.18,0.78,67.12,38,18,56,52,38,14,1.08,73.08,Facile,Facile,0,Meme Difficulté,Adapte,Philosophy
6478,2020,Philosophie,4,La Culture,3,Religion et Morale,7,924,2,QCM,0.06,0.92,67.12,32,16,48,42,32,10,1.14,76.19,Facile,Facile,0,Meme Difficulté,Adapte,Philosophy
924,2015,Philosophie,4,La Culture,3,Religion et Morale,7,925,3,QCU,0.55,0.35,13.36,10,68,78,78,10,68,1.0,12.82,Moyen,Difficile,-1,Plus Difficile,Pas Adapte,Philosophy
2035,2016,Philosophie,4,La Culture,3,Religion et Morale,7,925,3,QCU,0.64,0.36,10.1,7,62,69,51,7,44,1.35,13.73,Difficile,Difficile,0,Meme Difficulté,Pas Adapte,Philosophy
3146,2017,Philosophie,4,La Culture,3,Religion et Morale,7,925,3,QCU,0.07,1.0,84.11,50,10,60,55,50,5,1.09,90.91,Moyen,Facile,1,Plus Facile,Pas Adapte,Philosophy
4257,2018,Philosophie,4,La Culture,3,Religion et Morale,7,925,3,QCU,0.08,0.84,76.3,44,14,58,49,44,5,1.18,89.8,Facile,Facile,0,Meme Difficulté,Pas Adapte,Philosophy
5368,2019,Philosophie,4,La Culture,3,Religion et Morale,7,925,3,QCU,0.48,0.3,10.09,5,49,54,20,5,15,2.7,25.0,Moyen,Difficile,-1,Plus Difficile,Pas Adapte,Philosophy
6479,2020,Philosophie,4,La Culture,3,Religion et Morale,7,925,3,QCU,0.08,0.79,79.42,41,11,52,47,41,6,1.11,87.23,Facile,Facile,0,Meme Difficulté,Pas Adapte,Philosophy
925,2015,Philosophie,4,La Culture,3,Religion et Morale,7,926,4,QCM,0.39,0.65,54.6,29,24,53,37,29,8,1.43,78.38,Facile,Moyen,-1,Plus Difficile,Pas Adapte,Philosophy
2036,2016,Philosophie,4,La Culture,3,Religion et Morale,7,926,4,QCM,0.6,0.28,11.4,6,46,52,17,6,11,3.06,35.29,Difficile,Difficile,0,Meme Difficulté,Pas Adapte,Philosophy
3147,2017,Philosophie,4,La Culture,3,Religion et Morale,7,926,4,QCM,0.62,0.21,29.2,16,38,54,20,16,4,2.7,80.0,Facile,Difficile,-2,Beaucoup plus Difficile,Pas Adapte,Philosophy
4258,2018,Philosophie,4,La Culture,3,Religion et Morale,7,926,4,QCM,0.49,0.62,38.52,19,30,49,48,19,29,1.02,39.58,Facile,Moyen,-1,Plus Difficile,Pas Adapte,Philosophy
5369,2019,Philosophie,4,La Culture,3,Religion et Morale,7,926,4,QCM,0.2,0.55,49.5,26,26,52,51,26,25,1.02,50.98,Difficile,Moyen,1,Plus Facile,Pas Adapte,Philosophy
6480,2020,Philosophie,4,La Culture,3,Religion et Morale,7,926,4,QCM,0.19,0.88,84.79,48,9,57,57,48,9,1.0,84.21,Difficile,Facile,2,Beaucoup plus Facile,Pas Adapte,Philosophy
926,2015,Philosophie,4,La Culture,3,Religion et Morale,7,927,5,QCM,0.3,0.47,52.28,50,46,96,91,50,41,1.05,54.95,Moyen,Moyen,0,Meme Difficulté,Pas Adapte,Philosophy
2037,2016,Philosophie,4,La Culture,3,Religion et Morale,7,927,5,QCM,0.2,0.89,77.1,66,19,85,77,66,11,1.1,85.71,Difficile,Facile,2,Beaucoup plus Facile,Pas Adapte,Philosophy
3148,2017,Philosophie,4,La Culture,3,Religion et Morale,7,927,5,QCM,0.46,0.39,37.22,30,50,80,47,30,17,1.7,63.83,Facile,Moyen,-1,Plus Difficile,Pas Adapte,Philosophy
4259,2018,Philosophie,4,La Culture,3,Religion et Morale,7,927,5,QCM,0.08,0.9,84.11,67,13,80,68,67,1,1.18,98.53,Facile,Facile,0,Meme Difficulté,Pas Adapte,Philosophy
5370,2019,Philosophie,4,La Culture,3,Religion et Morale,7,927,5,QCM,0.08,0.72,96.16,81,3,84,83,81,2,1.01,97.59,Moyen,Facile,1,Plus Facile,Pas Adapte,Philosophy
6481,2020,Philosophie,4,La Culture,3,Religion et Morale,7,927,5,QCM,0.75,0.2,3.93,4,87,91,53,4,49,1.72,7.55,Moyen,Difficile,-1,Plus Difficile,Pas Adapte,Philosophy
927,2015,Philosophie,4,La Culture,3,Religion et Morale,7,928,6,QCU,0.7,0.28,27.23,23,60,83,80,23,57,1.04,28.75,Difficile,Difficile,0,Meme Difficulté,Pas Adapte,Philosophy
2038,2016,Philosophie,4,La Culture,3,Religion et Morale,7,928,6,QCU,0.58,0.23,26.14,24,66,90,62,24,38,1.45,38.71,Moyen,Difficile,-1,Plus Difficile,Pas Adapte,Philosophy
3149,2017,Philosophie,4,La Culture,3,Religion et Morale,7,928,6,QCU,0.25,0.52,42.71,44,58,102,88,44,44,1.16,50.0,Facile,Moyen,-1,Plus Difficile,Pas Adapte,Philosophy
4260,2018,Philosophie,4,La Culture,3,Religion et Morale,7,928,6,QCU,0.65,0.29,10.96,10,77,87,81,10,71,1.07,12.35,Moyen,Difficile,-1,Plus Difficile,Pas Adapte,Philosophy
5371,2019,Philosophie,4,La Culture,3,Religion et Morale,7,928,6,QCU,0.02,0.9,82.21,77,17,94,77,77,0,1.22,100.0,Difficile,Facile,2,Beaucoup plus Facile,Pas Adapte,Philosophy
6482,2020,Philosophie,4,La Culture,3,Religion et Morale,7,928,6,QCU,0.21,0.69,51.04,45,44,89,74,45,29,1.2,60.81,Difficile,Moyen,1,Plus Facile,Pas Adapte,Philosophy
928,2015,Philosophie,4,La Culture,3,Religion et Morale,7,929,7,QCM,0.46,0.35,63.14,36,21,57,51,36,15,1.12,70.59,Moyen,Moyen,0,Meme Difficulté,Adapte,Philosophy
2039,2016,Philosophie,4,La Culture,3,Religion et Morale,7,929,7,QCM,0.38,0.49,63.14,31,18,49,33,31,2,1.48,93.94,Moyen,Moyen,0,Meme Difficulté,Adapte,Philosophy
3150,2017,Philosophie,4,La Culture,3,Religion et Morale,7,929,7,QCU,0.28,0.42,63.14,27,15,42,38,27,11,1.11,71.05,Moyen,Moyen,0,Meme Difficulté,Adapte,Philosophy
4261,2018,Philosophie,4,La Culture,3,Religion et Morale,7,929,7,QCU,0.31,0.54,63.14,27,15,42,38,27,11,1.11,71.05,Moyen,Moyen,0,Meme Difficulté,Adapte,Philosophy
5372,2019,Philosophie,4,La Culture,3,Religion et Morale,7,929,7,QCU,0.34,0.65,63.14,23,14,37,23,23,0,1.61,100.0,Moyen,Moyen,0,Meme Difficulté,Adapte,Philosophy
6483,2020,Philosophie,4,La Culture,3,Religion et Morale,7,929,7,QCU,0.25,0.49,63.14,21,12,33,30,21,9,1.1,70.0,Moyen,Moyen,0,Meme Difficulté,Adapte,Philosophy
929,2015,Sociologie,1,Les Differentes Approches de l'Economie,1,Comment l'Activite et la Science Economiques se detachent-elles de la Morale et de la Politique?,5,930,1,QCM,0.13,0.97,87.23,46,7,53,48,46,2,1.1,95.83,Moyen,Facile,1,Plus Facile,Pas Adapte,Sociology
2040,2016,Sociologie,1,Les Differentes Approches de l'Economie,1,Comment l'Activite et la Science Economiques se detachent-elles de la Morale et de la Politique?,5,930,1,QCM,0.2,0.75,99.13,49,0,49,49,49,0,1.0,100.0,Facile,Facile,0,Meme Difficulté,Pas Adapte,Sociology
3151,2017,Sociologie,1,Les Differentes Approches de l'Economie,1,Comment l'Activite et la Science Economiques se detachent-elles de la Morale et de la Politique?,5,930,1,QCU,0.57,0.28,9.52,5,44,49,40,5,35,1.23,12.5,Difficile,Difficile,0,Meme Difficulté,Pas Adapte,Sociology
4262,2018,Sociologie,1,Les Differentes Approches de l'Economie,1,Comment l'Activite et la Science Economiques se detachent-elles de la Morale et de la Politique?,5,930,1,QCU,0.1,0.98,83.35,45,9,54,54,45,9,1.0,83.33,Moyen,Facile,1,Plus Facile,Pas Adapte,Sociology
5373,2019,Sociologie,1,Les Differentes Approches de l'Economie,1,Comment l'Activite et la Science Economiques se detachent-elles de la Morale et de la Politique?,5,930,1,QCM,0.06,0.79,81.63,42,9,51,47,42,5,1.09,89.36,Difficile,Facile,2,Beaucoup plus Facile,Pas Adapte,Sociology
6484,2020,Sociologie,1,Les Differentes Approches de l'Economie,1,Comment l'Activite et la Science Economiques se detachent-elles de la Morale et de la Politique?,5,930,1,QCM,0.03,0.98,80.7,45,11,56,55,45,10,1.02,81.82,Moyen,Facile,1,Plus Facile,Pas Adapte,Sociology
930,2015,Sociologie,1,Les Differentes Approches de l'Economie,1,Comment l'Activite et la Science Economiques se detachent-elles de la Morale et de la Politique?,5,931,2,QCM,0.77,0.23,5.02,3,62,65,26,3,23,2.5,11.54,Facile,Difficile,-2,Beaucoup plus Difficile,Pas Adapte,Sociology
2041,2016,Sociologie,1,Les Differentes Approches de l'Economie,1,Comment l'Activite et la Science Economiques se detachent-elles de la Morale et de la Politique?,5,931,2,QCM,0.4,0.63,54.25,40,33,73,49,40,9,1.49,81.63,Facile,Moyen,-1,Plus Difficile,Pas Adapte,Sociology
3152,2017,Sociologie,1,Les Differentes Approches de l'Economie,1,Comment l'Activite et la Science Economiques se detachent-elles de la Morale et de la Politique?,5,931,2,QCM,0.06,0.78,94.7,65,4,69,67,65,2,1.03,97.01,Moyen,Facile,1,Plus Facile,Pas Adapte,Sociology
4263,2018,Sociologie,1,Les Differentes Approches de l'Economie,1,Comment l'Activite et la Science Economiques se detachent-elles de la Morale et de la Politique?,5,931,2,QCU,0.19,0.91,73.43,45,16,61,49,45,4,1.24,91.84,Moyen,Facile,1,Plus Facile,Adapte,Sociology
5374,2019,Sociologie,1,Les Differentes Approches de l'Economie,1,Comment l'Activite et la Science Economiques se detachent-elles de la Morale et de la Politique?,5,931,2,QCU,0.14,0.84,73.43,40,15,55,47,40,7,1.17,85.11,Facile,Facile,0,Meme Difficulté,Adapte,Sociology
6485,2020,Sociologie,1,Les Differentes Approches de l'Economie,1,Comment l'Activite et la Science Economiques se detachent-elles de la Morale et de la Politique?,5,931,2,QCU,0.16,0.95,73.43,42,15,57,52,42,10,1.1,80.77,Facile,Facile,0,Meme Difficulté,Adapte,Sociology
931,2015,Sociologie,1,Les Differentes Approches de l'Economie,1,Comment l'Activite et la Science Economiques se detachent-elles de la Morale et de la Politique?,5,932,3,QO,0.02,0.68,68.77,61,27,88,62,61,1,1.42,98.39,Facile,Facile,0,Meme Difficulté,Adapte,Sociology
2042,2016,Sociologie,1,Les Differentes Approches de l'Economie,1,Comment l'Activite et la Science Economiques se detachent-elles de la Morale et de la Politique?,5,932,3,QO,0.04,0.91,68.77,65,29,94,69,65,4,1.36,94.2,Facile,Facile,0,Meme Difficulté,Adapte,Sociology
3153,2017,Sociologie,1,Les Differentes Approches de l'Economie,1,Comment l'Activite et la Science Economiques se detachent-elles de la Morale et de la Politique?,5,932,3,QO,0.13,0.83,68.77,66,30,96,70,66,4,1.37,94.29,Facile,Facile,0,Meme Difficulté,Adapte,Sociology
4264,2018,Sociologie,1,Les Differentes Approches de l'Economie,1,Comment l'Activite et la Science Economiques se detachent-elles de la Morale et de la Politique?,5,932,3,QO,0.05,0.51,68.77,76,34,110,88,76,12,1.25,86.36,Facile,Facile,0,Meme Difficulté,Adapte,Sociology
5375,2019,Sociologie,1,Les Differentes Approches de l'Economie,1,Comment l'Activite et la Science Economiques se detachent-elles de la Morale et de la Politique?,5,932,3,QO,0.18,0.68,68.77,80,36,116,97,80,17,1.2,82.47,Facile,Facile,0,Meme Difficulté,Adapte,Sociology
6486,2020,Sociologie,1,Les Differentes Approches de l'Economie,1,Comment l'Activite et la Science Economiques se detachent-elles de la Morale et de la Politique?,5,932,3,QO,0.14,0.65,68.77,89,41,130,106,89,17,1.23,83.96,Facile,Facile,0,Meme Difficulté,Adapte,Sociology
932,2015,Sociologie,1,Les Differentes Approches de l'Economie,1,Comment l'Activite et la Science Economiques se detachent-elles de la Morale et de la Politique?,5,933,4,QCM,0.4,0.65,63.75,43,25,68,51,43,8,1.33,84.31,Facile,Moyen,-1,Plus Difficile,Adapte,Sociology
2043,2016,Sociologie,1,Les Differentes Approches de l'Economie,1,Comment l'Activite et la Science Economiques se detachent-elles de la Morale et de la Politique?,5,933,4,QCM,0.26,0.36,63.75,47,27,74,55,47,8,1.35,85.45,Moyen,Moyen,0,Meme Difficulté,Adapte,Sociology
3154,2017,Sociologie,1,Les Differentes Approches de l'Economie,1,Comment l'Activite et la Science Economiques se detachent-elles de la Morale et de la Politique?,5,933,4,QCM,0.23,0.51,63.75,49,28,77,61,49,12,1.26,80.33,Moyen,Moyen,0,Meme Difficulté,Adapte,Sociology
4265,2018,Sociologie,1,Les Differentes Approches de l'Economie,1,Comment l'Activite et la Science Economiques se detachent-elles de la Morale et de la Politique?,5,933,4,QROC,0.25,0.34,63.75,54,31,85,84,54,30,1.01,64.29,Moyen,Moyen,0,Meme Difficulté,Adapte,Sociology
5376,2019,Sociologie,1,Les Differentes Approches de l'Economie,1,Comment l'Activite et la Science Economiques se detachent-elles de la Morale et de la Politique?,5,933,4,QROC,0.34,0.28,63.75,57,33,90,90,57,33,1.0,63.33,Moyen,Moyen,0,Meme Difficulté,Adapte,Sociology
6487,2020,Sociologie,1,Les Differentes Approches de l'Economie,1,Comment l'Activite et la Science Economiques se detachent-elles de la Morale et de la Politique?,5,933,4,QROC,0.33,0.32,63.75,55,31,86,66,55,11,1.3,83.33,Moyen,Moyen,0,Meme Difficulté,Adapte,Sociology
933,2015,Sociologie,1,Les Differentes Approches de l'Economie,1,Comment l'Activite et la Science Economiques se detachent-elles de la Morale et de la Politique?,5,934,5,QCM,0.55,0.27,6.65,1,7,8,6,1,5,1.33,16.67,Facile,Difficile,-2,Beaucoup plus Difficile,Pas Adapte,Sociology
2044,2016,Sociologie,1,Les Differentes Approches de l'Economie,1,Comment l'Activite et la Science Economiques se detachent-elles de la Morale et de la Politique?,5,934,5,QCM,0.73,0.24,32.4,3,6,9,8,3,5,1.12,37.5,Moyen,Difficile,-1,Plus Difficile,Pas Adapte,Sociology
3155,2017,Sociologie,1,Les Differentes Approches de l'Economie,1,Comment l'Activite et la Science Economiques se detachent-elles de la Morale et de la Politique?,5,934,5,QCM,0.79,0.23,7.07,1,8,9,8,1,7,1.12,12.5,Moyen,Difficile,-1,Plus Difficile,Pas Adapte,Sociology
4266,2018,Sociologie,1,Les Differentes Approches de l'Economie,1,Comment l'Activite et la Science Economiques se detachent-elles de la Morale et de la Politique?,5,934,5,QCM,0.45,0.42,41.76,4,5,9,8,4,4,1.12,50.0,Difficile,Moyen,1,Plus Facile,Pas Adapte,Sociology
5377,2019,Sociologie,1,Les Differentes Approches de l'Economie,1,Comment l'Activite et la Science Economiques se detachent-elles de la Morale et de la Politique?,5,934,5,QCM,0.14,0.73,88.28,7,1,8,8,7,1,1.0,87.5,Difficile,Facile,2,Beaucoup plus Facile,Pas Adapte,Sociology
6488,2020,Sociologie,1,Les Differentes Approches de l'Economie,1,Comment l'Activite et la Science Economiques se detachent-elles de la Morale et de la Politique?,5,934,5,QCU,0.35,0.72,63.36,4,3,7,4,4,0,1.75,100.0,Moyen,Moyen,0,Meme Difficulté,Adapte,Sociology
934,2015,Sociologie,1,Les Differentes Approches de l'Economie,2,Les Auteurs Classiques,10,935,1,QCU,0.56,0.27,8.37,8,84,92,57,8,49,1.61,14.04,Moyen,Difficile,-1,Plus Difficile,Pas Adapte,Sociology
2045,2016,Sociologie,1,Les Differentes Approches de l'Economie,2,Les Auteurs Classiques,10,935,1,QCU,0.41,0.25,11.33,10,80,90,43,10,33,2.09,23.26,Difficile,Difficile,0,Meme Difficulté,Pas Adapte,Sociology
3156,2017,Sociologie,1,Les Differentes Approches de l'Economie,2,Les Auteurs Classiques,10,935,1,QCU,0.6,0.25,33.88,31,60,91,50,31,19,1.82,62.0,Facile,Difficile,-2,Beaucoup plus Difficile,Pas Adapte,Sociology
4267,2018,Sociologie,1,Les Differentes Approches de l'Economie,2,Les Auteurs Classiques,10,935,1,QCU,0.5,0.36,10.16,10,91,101,85,10,75,1.19,11.76,Difficile,Difficile,0,Meme Difficulté,Pas Adapte,Sociology
5378,2019,Sociologie,1,Les Differentes Approches de l'Economie,2,Les Auteurs Classiques,10,935,1,QCU,0.38,0.48,60.71,52,34,86,67,52,15,1.28,77.61,Difficile,Moyen,1,Plus Facile,Adapte,Sociology
6489,2020,Sociologie,1,Les Differentes Approches de l'Economie,2,Les Auteurs Classiques,10,935,1,QCM,0.43,0.36,60.71,44,29,73,70,44,26,1.04,62.86,Moyen,Moyen,0,Meme Difficulté,Adapte,Sociology
935,2015,Sociologie,1,Les Differentes Approches de l'Economie,2,Les Auteurs Classiques,10,936,2,QCU,0.71,0.23,22.2,3,11,14,11,3,8,1.27,27.27,Moyen,Difficile,-1,Plus Difficile,Pas Adapte,Sociology
2046,2016,Sociologie,1,Les Differentes Approches de l'Economie,2,Les Auteurs Classiques,10,936,2,QCU,0.62,0.33,15.31,2,13,15,8,2,6,1.88,25.0,Moyen,Difficile,-1,Plus Difficile,Pas Adapte,Sociology
3157,2017,Sociologie,1,Les Differentes Approches de l'Economie,2,Les Auteurs Classiques,10,936,2,QCU,0.27,0.7,41.9,6,8,14,14,6,8,1.0,42.86,Moyen,Moyen,0,Meme Difficulté,Pas Adapte,Sociology
4268,2018,Sociologie,1,Les Differentes Approches de l'Economie,2,Les Auteurs Classiques,10,936,2,QCU,0.29,0.64,37.84,6,10,16,9,6,3,1.78,66.67,Difficile,Moyen,1,Plus Facile,Pas Adapte,Sociology
5379,2019,Sociologie,1,Les Differentes Approches de l'Economie,2,Les Auteurs Classiques,10,936,2,QCU,0.71,0.36,1.69,0,18,18,6,0,6,3.0,0.0,Facile,Difficile,-2,Beaucoup plus Difficile,Pas Adapte,Sociology
6490,2020,Sociologie,1,Les Differentes Approches de l'Economie,2,Les Auteurs Classiques,10,936,2,QCU,0.27,0.73,64.24,11,6,17,17,11,6,1.0,64.71,Difficile,Moyen,1,Plus Facile,Adapte,Sociology
936,2015,Sociologie,1,Les Differentes Approches de l'Economie,2,Les Auteurs Classiques,10,937,3,QCM,0.56,0.25,23.46,22,73,95,33,22,11,2.88,66.67,Difficile,Difficile,0,Meme Difficulté,Pas Adapte,Sociology
2047,2016,Sociologie,1,Les Differentes Approches de l'Economie,2,Les Auteurs Classiques,10,937,3,QCM,0.23,0.65,60.4,57,37,94,59,57,2,1.59,96.61,Facile,Moyen,-1,Plus Difficile,Adapte,Sociology
3158,2017,Sociologie,1,Les Differentes Approches de l'Economie,2,Les Auteurs Classiques,10,937,3,QO,0.48,0.21,60.4,64,42,106,80,64,16,1.32,80.0,Moyen,Moyen,0,Meme Difficulté,Adapte,Sociology
4269,2018,Sociologie,1,Les Differentes Approches de l'Economie,2,Les Auteurs Classiques,10,937,3,QO,0.54,0.27,60.4,68,44,112,76,68,8,1.47,89.47,Moyen,Moyen,0,Meme Difficulté,Adapte,Sociology
5380,2019,Sociologie,1,Les Differentes Approches de l'Economie,2,Les Auteurs Classiques,10,937,3,QO,0.58,0.24,60.4,58,38,96,77,58,19,1.25,75.32,Moyen,Moyen,0,Meme Difficulté,Adapte,Sociology
6491,2020,Sociologie,1,Les Differentes Approches de l'Economie,2,Les Auteurs Classiques,10,937,3,QO,0.41,0.23,60.4,63,42,105,93,63,30,1.13,67.74,Moyen,Moyen,0,Meme Difficulté,Adapte,Sociology
937,2015,Sociologie,1,Les Differentes Approches de l'Economie,2,Les Auteurs Classiques,10,938,4,QCU,0.37,0.5,48.47,31,32,63,51,31,20,1.24,60.78,Difficile,Moyen,1,Plus Facile,Pas Adapte,Sociology
2048,2016,Sociologie,1,Les Differentes Approches de l'Economie,2,Les Auteurs Classiques,10,938,4,QCU,0.66,0.28,15.41,10,58,68,46,10,36,1.48,21.74,Moyen,Difficile,-1,Plus Difficile,Pas Adapte,Sociology
3159,2017,Sociologie,1,Les Differentes Approches de l'Economie,2,Les Auteurs Classiques,10,938,4,QCU,0.58,0.2,23.21,13,45,58,33,13,20,1.76,39.39,Moyen,Difficile,-1,Plus Difficile,Pas Adapte,Sociology
4270,2018,Sociologie,1,Les Differentes Approches de l'Economie,2,Les Auteurs Classiques,10,938,4,QCU,0.22,0.73,44.37,28,34,62,59,28,31,1.05,47.46,Difficile,Moyen,1,Plus Facile,Pas Adapte,Sociology
5381,2019,Sociologie,1,Les Differentes Approches de l'Economie,2,Les Auteurs Classiques,10,938,4,QCU,0.19,0.79,86.32,47,7,54,50,47,3,1.08,94.0,Facile,Facile,0,Meme Difficulté,Pas Adapte,Sociology
6492,2020,Sociologie,1,Les Differentes Approches de l'Economie,2,Les Auteurs Classiques,10,938,4,QCU,0.1,0.92,65.95,35,18,53,40,35,5,1.32,87.5,Facile,Facile,0,Meme Difficulté,Adapte,Sociology
938,2015,Sociologie,1,Les Differentes Approches de l'Economie,2,Les Auteurs Classiques,10,939,5,QROC,0.38,0.31,40.56,29,43,72,48,29,19,1.5,60.42,Moyen,Moyen,0,Meme Difficulté,Pas Adapte,Sociology
2049,2016,Sociologie,1,Les Differentes Approches de l'Economie,2,Les Auteurs Classiques,10,939,5,QROC,0.79,0.01,11.84,7,55,62,33,7,26,1.88,21.21,Moyen,Difficile,-1,Plus Difficile,Pas Adapte,Sociology
3160,2017,Sociologie,1,Les Differentes Approches de l'Economie,2,Les Auteurs Classiques,10,939,5,QROC,0.67,0.22,27.59,16,43,59,54,16,38,1.09,29.63,Facile,Difficile,-2,Beaucoup plus Difficile,Pas Adapte,Sociology
4271,2018,Sociologie,1,Les Differentes Approches de l'Economie,2,Les Auteurs Classiques,10,939,5,QROC,0.97,0.19,24.01,16,51,67,55,16,39,1.22,29.09,Difficile,Difficile,0,Meme Difficulté,Pas Adapte,Sociology
5382,2019,Sociologie,1,Les Differentes Approches de l'Economie,2,Les Auteurs Classiques,10,939,5,QROC,0.17,1.0,82.16,51,11,62,58,51,7,1.07,87.93,Moyen,Facile,1,Plus Facile,Pas Adapte,Sociology
6493,2020,Sociologie,1,Les Differentes Approches de l'Economie,2,Les Auteurs Classiques,10,939,5,QO,0.48,0.21,41.8,26,37,63,50,26,24,1.26,52.0,Moyen,Moyen,0,Meme Difficulté,Pas Adapte,Sociology
939,2015,Sociologie,1,Les Differentes Approches de l'Economie,2,Les Auteurs Classiques,10,940,6,QCU,0.52,0.4,0.08,0,62,62,47,0,47,1.32,0.0,Difficile,Difficile,0,Meme Difficulté,Pas Adapte,Sociology
2050,2016,Sociologie,1,Les Differentes Approches de l'Economie,2,Les Auteurs Classiques,10,940,6,QO,0.96,0.04,30.0,20,48,68,38,20,18,1.79,52.63,Difficile,Difficile,0,Meme Difficulté,Pas Adapte,Sociology
3161,2017,Sociologie,1,Les Differentes Approches de l'Economie,2,Les Auteurs Classiques,10,940,6,QO,0.87,0.07,18.09,10,48,58,38,10,28,1.53,26.32,Moyen,Difficile,-1,Plus Difficile,Pas Adapte,Sociology
4272,2018,Sociologie,1,Les Differentes Approches de l'Economie,2,Les Auteurs Classiques,10,940,6,QO,0.68,0.19,35.44,17,32,49,34,17,17,1.44,50.0,Moyen,Moyen,0,Meme Difficulté,Pas Adapte,Sociology
5383,2019,Sociologie,1,Les Differentes Approches de l'Economie,2,Les Auteurs Classiques,10,940,6,QO,0.16,0.64,98.42,54,1,55,54,54,0,1.02,100.0,Difficile,Facile,2,Beaucoup plus Facile,Pas Adapte,Sociology
6494,2020,Sociologie,1,Les Differentes Approches de l'Economie,2,Les Auteurs Classiques,10,940,6,QROC,0.19,0.67,73.63,36,13,49,45,36,9,1.09,80.0,Difficile,Facile,2,Beaucoup plus Facile,Adapte,Sociology
940,2015,Sociologie,1,Les Differentes Approches de l'Economie,2,Les Auteurs Classiques,10,941,7,QCU,0.49,0.31,3.17,2,57,59,45,2,43,1.31,4.44,Moyen,Difficile,-1,Plus Difficile,Pas Adapte,Sociology
2051,2016,Sociologie,1,Les Differentes Approches de l'Economie,2,Les Auteurs Classiques,10,941,7,QCU,0.38,0.43,45.58,31,37,68,36,31,5,1.89,86.11,Difficile,Moyen,1,Plus Facile,Pas Adapte,Sociology
3162,2017,Sociologie,1,Les Differentes Approches de l'Economie,2,Les Auteurs Classiques,10,941,7,QCU,0.15,0.88,85.57,66,11,77,73,66,7,1.05,90.41,Facile,Facile,0,Meme Difficulté,Pas Adapte,Sociology
4273,2018,Sociologie,1,Les Differentes Approches de l'Economie,2,Les Auteurs Classiques,10,941,7,QCM,0.18,0.84,78.52,52,14,66,55,52,3,1.2,94.55,Difficile,Facile,2,Beaucoup plus Facile,Pas Adapte,Sociology
5384,2019,Sociologie,1,Les Differentes Approches de l'Economie,2,Les Auteurs Classiques,10,941,7,QCM,0.54,0.29,24.79,17,50,67,53,17,36,1.26,32.08,Moyen,Difficile,-1,Plus Difficile,Pas Adapte,Sociology
6495,2020,Sociologie,1,Les Differentes Approches de l'Economie,2,Les Auteurs Classiques,10,941,7,QCM,0.58,0.21,11.77,8,64,72,18,8,10,4.0,44.44,Difficile,Difficile,0,Meme Difficulté,Pas Adapte,Sociology
941,2015,Sociologie,1,Les Differentes Approches de l'Economie,2,Les Auteurs Classiques,10,942,8,QROC,0.72,0.2,12.92,4,29,33,22,4,18,1.5,18.18,Facile,Difficile,-2,Beaucoup plus Difficile,Pas Adapte,Sociology
2052,2016,Sociologie,1,Les Differentes Approches de l'Economie,2,Les Auteurs Classiques,10,942,8,QROC,0.19,0.88,94.01,36,2,38,37,36,1,1.03,97.3,Difficile,Facile,2,Beaucoup plus Facile,Pas Adapte,Sociology
3163,2017,Sociologie,1,Les Differentes Approches de l'Economie,2,Les Auteurs Classiques,10,942,8,QROC,0.48,0.35,40.39,17,25,42,31,17,14,1.35,54.84,Difficile,Moyen,1,Plus Facile,Pas Adapte,Sociology
4274,2018,Sociologie,1,Les Differentes Approches de l'Economie,2,Les Auteurs Classiques,10,942,8,QROC,0.04,0.75,98.38,47,1,48,47,47,0,1.02,100.0,Facile,Facile,0,Meme Difficulté,Pas Adapte,Sociology
5385,2019,Sociologie,1,Les Differentes Approches de l'Economie,2,Les Auteurs Classiques,10,942,8,QROC,0.95,0.2,6.26,3,42,45,26,3,23,1.73,11.54,Facile,Difficile,-2,Beaucoup plus Difficile,Pas Adapte,Sociology
6496,2020,Sociologie,1,Les Differentes Approches de l'Economie,2,Les Auteurs Classiques,10,942,8,QROC,0.17,0.57,66.91,27,13,40,36,27,9,1.11,75.0,Difficile,Facile,2,Beaucoup plus Facile,Adapte,Sociology
942,2015,Sociologie,1,Les Differentes Approches de l'Economie,2,Les Auteurs Classiques,10,943,9,QCU,0.34,0.5,58.89,52,37,89,80,52,28,1.11,65.0,Difficile,Moyen,1,Plus Facile,Pas Adapte,Sociology
2053,2016,Sociologie,1,Les Differentes Approches de l'Economie,2,Les Auteurs Classiques,10,943,9,QCM,0.01,0.88,75.75,58,19,77,74,58,16,1.04,78.38,Facile,Facile,0,Meme Difficulté,Pas Adapte,Sociology
3164,2017,Sociologie,1,Les Differentes Approches de l'Economie,2,Les Auteurs Classiques,10,943,9,QCM,0.3,0.38,39.33,28,42,70,60,28,32,1.17,46.67,Difficile,Moyen,1,Plus Facile,Pas Adapte,Sociology
4275,2018,Sociologie,1,Les Differentes Approches de l'Economie,2,Les Auteurs Classiques,10,943,9,QCM,0.2,0.41,48.77,30,32,62,47,30,17,1.32,63.83,Facile,Moyen,-1,Plus Difficile,Pas Adapte,Sociology
5386,2019,Sociologie,1,Les Differentes Approches de l'Economie,2,Les Auteurs Classiques,10,943,9,QCM,0.69,0.23,29.41,16,37,53,50,16,34,1.06,32.0,Difficile,Difficile,0,Meme Difficulté,Pas Adapte,Sociology
6497,2020,Sociologie,1,Les Differentes Approches de l'Economie,2,Les Auteurs Classiques,10,943,9,QCM,0.47,0.66,41.53,19,26,45,31,19,12,1.45,61.29,Facile,Moyen,-1,Plus Difficile,Pas Adapte,Sociology
943,2015,Sociologie,1,Les Differentes Approches de l'Economie,2,Les Auteurs Classiques,10,944,10,QCU,0.01,0.8,74.48,43,15,58,50,43,7,1.16,86.0,Moyen,Facile,1,Plus Facile,Adapte,Sociology
2054,2016,Sociologie,1,Les Differentes Approches de l'Economie,2,Les Auteurs Classiques,10,944,10,QCU,0.07,0.76,74.48,41,14,55,47,41,6,1.17,87.23,Facile,Facile,0,Meme Difficulté,Adapte,Sociology
3165,2017,Sociologie,1,Les Differentes Approches de l'Economie,2,Les Auteurs Classiques,10,944,10,QCU,0.16,0.77,74.48,42,14,56,49,42,7,1.14,85.71,Facile,Facile,0,Meme Difficulté,Adapte,Sociology
4276,2018,Sociologie,1,Les Differentes Approches de l'Economie,2,Les Auteurs Classiques,10,944,10,QCU,0.02,0.94,74.48,37,13,50,44,37,7,1.14,84.09,Facile,Facile,0,Meme Difficulté,Adapte,Sociology
5387,2019,Sociologie,1,Les Differentes Approches de l'Economie,2,Les Auteurs Classiques,10,944,10,QCM,0.15,0.9,74.48,37,13,50,42,37,5,1.19,88.1,Facile,Facile,0,Meme Difficulté,Adapte,Sociology
6498,2020,Sociologie,1,Les Differentes Approches de l'Economie,2,Les Auteurs Classiques,10,944,10,QCM,0.15,0.99,74.48,41,14,55,53,41,12,1.04,77.36,Facile,Facile,0,Meme Difficulté,Adapte,Sociology
944,2015,Sociologie,1,Les Differentes Approches de l'Economie,3,Les Auteurs Neoclassiques,2,945,1,QROC,0.81,0.22,23.83,4,12,16,7,4,3,2.29,57.14,Moyen,Difficile,-1,Plus Difficile,Pas Adapte,Sociology
2055,2016,Sociologie,1,Les Differentes Approches de l'Economie,3,Les Auteurs Neoclassiques,2,945,1,QROC,0.22,0.39,56.39,10,7,17,10,10,0,1.7,100.0,Facile,Moyen,-1,Plus Difficile,Pas Adapte,Sociology
3166,2017,Sociologie,1,Les Differentes Approches de l'Economie,3,Les Auteurs Neoclassiques,2,945,1,QROC,0.16,0.7,85.06,16,3,19,18,16,2,1.06,88.89,Difficile,Facile,2,Beaucoup plus Facile,Pas Adapte,Sociology
4277,2018,Sociologie,1,Les Differentes Approches de l'Economie,3,Les Auteurs Neoclassiques,2,945,1,QO,0.02,0.77,78.52,13,3,16,14,13,1,1.14,92.86,Difficile,Facile,2,Beaucoup plus Facile,Pas Adapte,Sociology
5388,2019,Sociologie,1,Les Differentes Approches de l'Economie,3,Les Auteurs Neoclassiques,2,945,1,QO,0.15,0.44,65.41,11,6,17,16,11,5,1.06,68.75,Facile,Facile,0,Meme Difficulté,Adapte,Sociology
6499,2020,Sociologie,1,Les Differentes Approches de l'Economie,3,Les Auteurs Neoclassiques,2,945,1,QROC,0.01,0.56,65.41,12,6,18,14,12,2,1.29,85.71,Facile,Facile,0,Meme Difficulté,Adapte,Sociology
945,2015,Sociologie,1,Les Differentes Approches de l'Economie,3,Les Auteurs Neoclassiques,2,946,2,QCM,0.68,0.2,8.75,3,28,31,30,3,27,1.03,10.0,Difficile,Difficile,0,Meme Difficulté,Pas Adapte,Sociology
2056,2016,Sociologie,1,Les Differentes Approches de l'Economie,3,Les Auteurs Neoclassiques,2,946,2,QCM,0.07,0.89,68.75,25,11,36,29,25,4,1.24,86.21,Facile,Facile,0,Meme Difficulté,Adapte,Sociology
3167,2017,Sociologie,1,Les Differentes Approches de l'Economie,3,Les Auteurs Neoclassiques,2,946,2,QCM,0.0,0.88,68.75,25,11,36,29,25,4,1.24,86.21,Facile,Facile,0,Meme Difficulté,Adapte,Sociology
4278,2018,Sociologie,1,Les Differentes Approches de l'Economie,3,Les Auteurs Neoclassiques,2,946,2,QROC,0.18,0.87,68.75,23,11,34,32,23,9,1.06,71.88,Facile,Facile,0,Meme Difficulté,Adapte,Sociology
5389,2019,Sociologie,1,Les Differentes Approches de l'Economie,3,Les Auteurs Neoclassiques,2,946,2,QROC,0.09,0.58,68.75,27,12,39,38,27,11,1.03,71.05,Facile,Facile,0,Meme Difficulté,Adapte,Sociology
6500,2020,Sociologie,1,Les Differentes Approches de l'Economie,3,Les Auteurs Neoclassiques,2,946,2,QROC,0.19,0.86,68.75,25,11,36,36,25,11,1.0,69.44,Facile,Facile,0,Meme Difficulté,Adapte,Sociology
946,2015,Sociologie,1,Les Differentes Approches de l'Economie,4,L'Analyse Marxiste,14,947,1,QCU,0.6,0.26,17.27,8,41,49,41,8,33,1.2,19.51,Moyen,Difficile,-1,Plus Difficile,Pas Adapte,Sociology
2057,2016,Sociologie,1,Les Differentes Approches de l'Economie,4,L'Analyse Marxiste,14,947,1,QCU,0.69,0.39,11.75,5,39,44,37,5,32,1.19,13.51,Moyen,Difficile,-1,Plus Difficile,Pas Adapte,Sociology
3168,2017,Sociologie,1,Les Differentes Approches de l'Economie,4,L'Analyse Marxiste,14,947,1,QROC,0.74,0.1,5.4,3,45,48,23,3,20,2.09,13.04,Difficile,Difficile,0,Meme Difficulté,Pas Adapte,Sociology
4279,2018,Sociologie,1,Les Differentes Approches de l'Economie,4,L'Analyse Marxiste,14,947,1,QROC,0.17,0.94,68.14,35,16,51,39,35,4,1.31,89.74,Facile,Facile,0,Meme Difficulté,Adapte,Sociology
5390,2019,Sociologie,1,Les Differentes Approches de l'Economie,4,L'Analyse Marxiste,14,947,1,QROC,0.07,0.88,68.14,36,17,53,41,36,5,1.29,87.8,Facile,Facile,0,Meme Difficulté,Adapte,Sociology
6501,2020,Sociologie,1,Les Differentes Approches de l'Economie,4,L'Analyse Marxiste,14,947,1,QROC,0.07,0.73,68.14,42,19,61,48,42,6,1.27,87.5,Facile,Facile,0,Meme Difficulté,Adapte,Sociology
947,2015,Sociologie,1,Les Differentes Approches de l'Economie,4,L'Analyse Marxiste,14,948,2,QCU,0.23,0.59,48.06,42,45,87,69,42,27,1.26,60.87,Moyen,Moyen,0,Meme Difficulté,Pas Adapte,Sociology
2058,2016,Sociologie,1,Les Differentes Approches de l'Economie,4,L'Analyse Marxiste,14,948,2,QCU,0.19,0.79,84.43,81,15,96,82,81,1,1.17,98.78,Difficile,Facile,2,Beaucoup plus Facile,Pas Adapte,Sociology
3169,2017,Sociologie,1,Les Differentes Approches de l'Economie,4,L'Analyse Marxiste,14,948,2,QCU,0.37,0.73,59.59,64,44,108,74,64,10,1.46,86.49,Moyen,Moyen,0,Meme Difficulté,Pas Adapte,Sociology
4280,2018,Sociologie,1,Les Differentes Approches de l'Economie,4,L'Analyse Marxiste,14,948,2,QCU,0.25,0.49,35.92,40,72,112,41,40,1,2.73,97.56,Difficile,Moyen,1,Plus Facile,Pas Adapte,Sociology
5391,2019,Sociologie,1,Les Differentes Approches de l'Economie,4,L'Analyse Marxiste,14,948,2,QCU,0.57,0.36,22.99,26,85,111,96,26,70,1.16,27.08,Facile,Difficile,-2,Beaucoup plus Difficile,Pas Adapte,Sociology
6502,2020,Sociologie,1,Les Differentes Approches de l'Economie,4,L'Analyse Marxiste,14,948,2,QCU,0.66,0.31,10.43,11,93,104,36,11,25,2.89,30.56,Difficile,Difficile,0,Meme Difficulté,Pas Adapte,Sociology
948,2015,Sociologie,1,Les Differentes Approches de l'Economie,4,L'Analyse Marxiste,14,949,3,QCM,0.02,0.77,68.17,39,18,57,41,39,2,1.39,95.12,Moyen,Facile,1,Plus Facile,Adapte,Sociology
2059,2016,Sociologie,1,Les Differentes Approches de l'Economie,4,L'Analyse Marxiste,14,949,3,QCM,0.2,0.75,68.17,44,21,65,51,44,7,1.27,86.27,Facile,Facile,0,Meme Difficulté,Adapte,Sociology
3170,2017,Sociologie,1,Les Differentes Approches de l'Economie,4,L'Analyse Marxiste,14,949,3,QCM,0.02,0.97,68.17,44,21,65,54,44,10,1.2,81.48,Facile,Facile,0,Meme Difficulté,Adapte,Sociology
4281,2018,Sociologie,1,Les Differentes Approches de l'Economie,4,L'Analyse Marxiste,14,949,3,QCM,0.03,0.76,68.17,44,20,64,57,44,13,1.12,77.19,Facile,Facile,0,Meme Difficulté,Adapte,Sociology
5392,2019,Sociologie,1,Les Differentes Approches de l'Economie,4,L'Analyse Marxiste,14,949,3,QCM,0.09,0.88,68.17,38,18,56,55,38,17,1.02,69.09,Facile,Facile,0,Meme Difficulté,Adapte,Sociology
6503,2020,Sociologie,1,Les Differentes Approches de l'Economie,4,L'Analyse Marxiste,14,949,3,QCM,0.02,0.88,68.17,42,19,61,59,42,17,1.03,71.19,Facile,Facile,0,Meme Difficulté,Adapte,Sociology
949,2015,Sociologie,1,Les Differentes Approches de l'Economie,4,L'Analyse Marxiste,14,950,4,QCM,0.73,0.17,9.52,6,57,63,50,6,44,1.26,12.0,Facile,Difficile,-2,Beaucoup plus Difficile,Pas Adapte,Sociology
2060,2016,Sociologie,1,Les Differentes Approches de l'Economie,4,L'Analyse Marxiste,14,950,4,QCU,0.39,0.59,61.09,34,22,56,39,34,5,1.44,87.18,Facile,Moyen,-1,Plus Difficile,Adapte,Sociology
3171,2017,Sociologie,1,Les Differentes Approches de l'Economie,4,L'Analyse Marxiste,14,950,4,QCU,0.4,0.64,61.09,31,20,51,43,31,12,1.19,72.09,Moyen,Moyen,0,Meme Difficulté,Adapte,Sociology
4282,2018,Sociologie,1,Les Differentes Approches de l'Economie,4,L'Analyse Marxiste,14,950,4,QCM,0.48,0.35,61.09,26,17,43,41,26,15,1.05,63.41,Moyen,Moyen,0,Meme Difficulté,Adapte,Sociology
5393,2019,Sociologie,1,Les Differentes Approches de l'Economie,4,L'Analyse Marxiste,14,950,4,QCM,0.46,0.34,61.09,24,16,40,29,24,5,1.38,82.76,Moyen,Moyen,0,Meme Difficulté,Adapte,Sociology
6504,2020,Sociologie,1,Les Differentes Approches de l'Economie,4,L'Analyse Marxiste,14,950,4,QCM,0.5,0.45,61.09,23,14,37,26,23,3,1.42,88.46,Moyen,Moyen,0,Meme Difficulté,Adapte,Sociology
950,2015,Sociologie,1,Les Differentes Approches de l'Economie,4,L'Analyse Marxiste,14,951,5,QCM,0.06,0.88,83.33,48,10,58,54,48,6,1.07,88.89,Moyen,Facile,1,Plus Facile,Pas Adapte,Sociology
2061,2016,Sociologie,1,Les Differentes Approches de l'Economie,4,L'Analyse Marxiste,14,951,5,QCM,0.04,0.91,77.4,49,14,63,59,49,10,1.07,83.05,Moyen,Facile,1,Plus Facile,Pas Adapte,Sociology
3172,2017,Sociologie,1,Les Differentes Approches de l'Economie,4,L'Analyse Marxiste,14,951,5,QROC,0.52,0.3,57.67,34,25,59,41,34,7,1.44,82.93,Moyen,Moyen,0,Meme Difficulté,Pas Adapte,Sociology
4283,2018,Sociologie,1,Les Differentes Approches de l'Economie,4,L'Analyse Marxiste,14,951,5,QO,0.99,0.14,32.12,16,34,50,45,16,29,1.11,35.56,Moyen,Difficile,-1,Plus Difficile,Pas Adapte,Sociology
5394,2019,Sociologie,1,Les Differentes Approches de l'Economie,4,L'Analyse Marxiste,14,951,5,QROC,0.93,0.05,17.46,9,43,52,42,9,33,1.24,21.43,Facile,Difficile,-2,Beaucoup plus Difficile,Pas Adapte,Sociology
6505,2020,Sociologie,1,Les Differentes Approches de l'Economie,4,L'Analyse Marxiste,14,951,5,QROC,0.9,0.14,9.3,5,53,58,27,5,22,2.15,18.52,Facile,Difficile,-2,Beaucoup plus Difficile,Pas Adapte,Sociology
951,2015,Sociologie,1,Les Differentes Approches de l'Economie,4,L'Analyse Marxiste,14,952,6,QCM,0.76,0.22,6.97,6,87,93,43,6,37,2.16,13.95,Difficile,Difficile,0,Meme Difficulté,Pas Adapte,Sociology
2062,2016,Sociologie,1,Les Differentes Approches de l'Economie,4,L'Analyse Marxiste,14,952,6,QCM,0.04,0.93,73.51,78,28,106,82,78,4,1.29,95.12,Moyen,Facile,1,Plus Facile,Adapte,Sociology
3173,2017,Sociologie,1,Les Differentes Approches de l'Economie,4,L'Analyse Marxiste,14,952,6,QCM,0.14,0.71,73.51,88,32,120,111,88,23,1.08,79.28,Facile,Facile,0,Meme Difficulté,Adapte,Sociology
4284,2018,Sociologie,1,Les Differentes Approches de l'Economie,4,L'Analyse Marxiste,14,952,6,QCM,0.01,0.94,73.51,84,30,114,102,84,18,1.12,82.35,Facile,Facile,0,Meme Difficulté,Adapte,Sociology
5395,2019,Sociologie,1,Les Differentes Approches de l'Economie,4,L'Analyse Marxiste,14,952,6,QCM,0.09,0.94,73.51,71,26,97,74,71,3,1.31,95.95,Facile,Facile,0,Meme Difficulté,Adapte,Sociology
6506,2020,Sociologie,1,Les Differentes Approches de l'Economie,4,L'Analyse Marxiste,14,952,6,QCU,0.03,0.98,73.51,79,29,108,94,79,15,1.15,84.04,Facile,Facile,0,Meme Difficulté,Adapte,Sociology
952,2015,Sociologie,1,Les Differentes Approches de l'Economie,4,L'Analyse Marxiste,14,953,7,QROC,0.09,0.72,86.48,64,10,74,67,64,3,1.1,95.52,Facile,Facile,0,Meme Difficulté,Pas Adapte,Sociology
2063,2016,Sociologie,1,Les Differentes Approches de l'Economie,4,L'Analyse Marxiste,14,953,7,QROC,0.76,0.12,19.59,13,53,66,44,13,31,1.5,29.55,Difficile,Difficile,0,Meme Difficulté,Pas Adapte,Sociology
3174,2017,Sociologie,1,Les Differentes Approches de l'Economie,4,L'Analyse Marxiste,14,953,7,QO,0.05,0.78,66.08,48,24,72,65,48,17,1.11,73.85,Difficile,Facile,2,Beaucoup plus Facile,Adapte,Sociology
4285,2018,Sociologie,1,Les Differentes Approches de l'Economie,4,L'Analyse Marxiste,14,953,7,QO,0.13,0.74,66.08,42,22,64,53,42,11,1.21,79.25,Facile,Facile,0,Meme Difficulté,Adapte,Sociology
5396,2019,Sociologie,1,Les Differentes Approches de l'Economie,4,L'Analyse Marxiste,14,953,7,QO,0.19,0.51,66.08,40,21,61,40,40,0,1.52,100.0,Facile,Facile,0,Meme Difficulté,Adapte,Sociology
6507,2020,Sociologie,1,Les Differentes Approches de l'Economie,4,L'Analyse Marxiste,14,953,7,QO,0.2,0.49,66.08,46,23,69,65,46,19,1.06,70.77,Facile,Facile,0,Meme Difficulté,Adapte,Sociology
953,2015,Sociologie,1,Les Differentes Approches de l'Economie,4,L'Analyse Marxiste,14,954,8,QCM,0.02,0.77,70.71,10,4,14,10,10,0,1.4,100.0,Difficile,Facile,2,Beaucoup plus Facile,Adapte,Sociology
2064,2016,Sociologie,1,Les Differentes Approches de l'Economie,4,L'Analyse Marxiste,14,954,8,QCM,0.1,0.88,70.71,11,4,15,15,11,4,1.0,73.33,Facile,Facile,0,Meme Difficulté,Adapte,Sociology
3175,2017,Sociologie,1,Les Differentes Approches de l'Economie,4,L'Analyse Marxiste,14,954,8,QCM,0.02,0.9,70.71,10,4,14,13,10,3,1.08,76.92,Facile,Facile,0,Meme Difficulté,Adapte,Sociology
4286,2018,Sociologie,1,Les Differentes Approches de l'Economie,4,L'Analyse Marxiste,14,954,8,QCM,0.0,0.78,70.71,11,5,16,13,11,2,1.23,84.62,Facile,Facile,0,Meme Difficulté,Adapte,Sociology
5397,2019,Sociologie,1,Les Differentes Approches de l'Economie,4,L'Analyse Marxiste,14,954,8,QCM,0.15,0.77,70.71,11,5,16,13,11,2,1.23,84.62,Facile,Facile,0,Meme Difficulté,Adapte,Sociology
6508,2020,Sociologie,1,Les Differentes Approches de l'Economie,4,L'Analyse Marxiste,14,954,8,QCM,0.16,0.9,70.71,11,4,15,14,11,3,1.07,78.57,Facile,Facile,0,Meme Difficulté,Adapte,Sociology
954,2015,Sociologie,1,Les Differentes Approches de l'Economie,4,L'Analyse Marxiste,14,955,9,QO,0.94,0.04,25.08,24,70,94,77,24,53,1.22,31.17,Difficile,Difficile,0,Meme Difficulté,Pas Adapte,Sociology
2065,2016,Sociologie,1,Les Differentes Approches de l'Economie,4,L'Analyse Marxiste,14,955,9,QO,0.51,0.16,58.32,49,35,84,60,49,11,1.4,81.67,Facile,Moyen,-1,Plus Difficile,Pas Adapte,Sociology
3176,2017,Sociologie,1,Les Differentes Approches de l'Economie,4,L'Analyse Marxiste,14,955,9,QCM,0.12,0.82,80.18,75,19,94,89,75,14,1.06,84.27,Difficile,Facile,2,Beaucoup plus Facile,Pas Adapte,Sociology
4287,2018,Sociologie,1,Les Differentes Approches de l'Economie,4,L'Analyse Marxiste,14,955,9,QCM,0.33,0.49,48.98,49,51,100,99,49,50,1.01,49.49,Facile,Moyen,-1,Plus Difficile,Pas Adapte,Sociology
5398,2019,Sociologie,1,Les Differentes Approches de l'Economie,4,L'Analyse Marxiste,14,955,9,QCM,0.59,0.19,11.95,12,85,97,34,12,22,2.85,35.29,Facile,Difficile,-2,Beaucoup plus Difficile,Pas Adapte,Sociology
6509,2020,Sociologie,1,Les Differentes Approches de l'Economie,4,L'Analyse Marxiste,14,955,9,QCU,0.26,0.58,58.86,61,42,103,61,61,0,1.69,100.0,Difficile,Moyen,1,Plus Facile,Pas Adapte,Sociology
955,2015,Sociologie,1,Les Differentes Approches de l'Economie,4,L'Analyse Marxiste,14,956,10,QCM,0.44,0.58,48.73,8,9,17,13,8,5,1.31,61.54,Moyen,Moyen,0,Meme Difficulté,Pas Adapte,Sociology
2066,2016,Sociologie,1,Les Differentes Approches de l'Economie,4,L'Analyse Marxiste,14,956,10,QCM,0.27,0.6,41.43,7,11,18,10,7,3,1.8,70.0,Facile,Moyen,-1,Plus Difficile,Pas Adapte,Sociology
3177,2017,Sociologie,1,Les Differentes Approches de l'Economie,4,L'Analyse Marxiste,14,956,10,QCM,0.36,0.69,60.48,13,8,21,14,13,1,1.5,92.86,Facile,Moyen,-1,Plus Difficile,Adapte,Sociology
4288,2018,Sociologie,1,Les Differentes Approches de l'Economie,4,L'Analyse Marxiste,14,956,10,QCM,0.44,0.6,60.48,13,8,21,16,13,3,1.31,81.25,Moyen,Moyen,0,Meme Difficulté,Adapte,Sociology
5399,2019,Sociologie,1,Les Differentes Approches de l'Economie,4,L'Analyse Marxiste,14,956,10,QCM,0.45,0.64,60.48,12,8,20,18,12,6,1.11,66.67,Moyen,Moyen,0,Meme Difficulté,Adapte,Sociology
6510,2020,Sociologie,1,Les Differentes Approches de l'Economie,4,L'Analyse Marxiste,14,956,10,QCM,0.22,0.31,60.48,13,8,21,17,13,4,1.24,76.47,Moyen,Moyen,0,Meme Difficulté,Adapte,Sociology
956,2015,Sociologie,1,Les Differentes Approches de l'Economie,4,L'Analyse Marxiste,14,957,11,QCM,0.41,0.51,49.85,26,26,52,48,26,22,1.08,54.17,Difficile,Moyen,1,Plus Facile,Pas Adapte,Sociology
2067,2016,Sociologie,1,Les Differentes Approches de l'Economie,4,L'Analyse Marxiste,14,957,11,QCM,0.55,0.23,11.92,7,52,59,37,7,30,1.59,18.92,Moyen,Difficile,-1,Plus Difficile,Pas Adapte,Sociology
3178,2017,Sociologie,1,Les Differentes Approches de l'Economie,4,L'Analyse Marxiste,14,957,11,QCM,0.3,0.69,64.81,38,20,58,57,38,19,1.02,66.67,Facile,Moyen,-1,Plus Difficile,Adapte,Sociology
4289,2018,Sociologie,1,Les Differentes Approches de l'Economie,4,L'Analyse Marxiste,14,957,11,QCM,0.31,0.34,64.81,39,21,60,47,39,8,1.28,82.98,Moyen,Moyen,0,Meme Difficulté,Adapte,Sociology
5400,2019,Sociologie,1,Les Differentes Approches de l'Economie,4,L'Analyse Marxiste,14,957,11,QCM,0.25,0.55,64.81,40,22,62,57,40,17,1.09,70.18,Moyen,Moyen,0,Meme Difficulté,Adapte,Sociology
6511,2020,Sociologie,1,Les Differentes Approches de l'Economie,4,L'Analyse Marxiste,14,957,11,QCM,0.33,0.48,64.81,45,24,69,59,45,14,1.17,76.27,Moyen,Moyen,0,Meme Difficulté,Adapte,Sociology
957,2015,Sociologie,1,Les Differentes Approches de l'Economie,4,L'Analyse Marxiste,14,958,12,QCM,0.34,0.36,59.76,19,13,32,26,19,7,1.23,73.08,Moyen,Moyen,0,Meme Difficulté,Pas Adapte,Sociology
2068,2016,Sociologie,1,Les Differentes Approches de l'Economie,4,L'Analyse Marxiste,14,958,12,QCM,0.3,0.58,63.01,18,11,29,25,18,7,1.16,72.0,Moyen,Moyen,0,Meme Difficulté,Adapte,Sociology
3179,2017,Sociologie,1,Les Differentes Approches de l'Economie,4,L'Analyse Marxiste,14,958,12,QCM,0.3,0.43,63.01,20,11,31,27,20,7,1.15,74.07,Moyen,Moyen,0,Meme Difficulté,Adapte,Sociology
4290,2018,Sociologie,1,Les Differentes Approches de l'Economie,4,L'Analyse Marxiste,14,958,12,QCM,0.46,0.53,63.01,18,10,28,25,18,7,1.12,72.0,Moyen,Moyen,0,Meme Difficulté,Adapte,Sociology
5401,2019,Sociologie,1,Les Differentes Approches de l'Economie,4,L'Analyse Marxiste,14,958,12,QCM,0.45,0.49,63.01,15,9,24,19,15,4,1.26,78.95,Moyen,Moyen,0,Meme Difficulté,Adapte,Sociology
6512,2020,Sociologie,1,Les Differentes Approches de l'Economie,4,L'Analyse Marxiste,14,958,12,QCM,0.25,0.56,63.01,17,10,27,24,17,7,1.12,70.83,Moyen,Moyen,0,Meme Difficulté,Adapte,Sociology
958,2015,Sociologie,1,Les Differentes Approches de l'Economie,4,L'Analyse Marxiste,14,959,13,QO,0.99,0.12,13.49,9,56,65,42,9,33,1.55,21.43,Moyen,Difficile,-1,Plus Difficile,Pas Adapte,Sociology
2069,2016,Sociologie,1,Les Differentes Approches de l'Economie,4,L'Analyse Marxiste,14,959,13,QCU,0.02,0.77,72.98,53,20,73,54,53,1,1.35,98.15,Facile,Facile,0,Meme Difficulté,Adapte,Sociology
3180,2017,Sociologie,1,Les Differentes Approches de l'Economie,4,L'Analyse Marxiste,14,959,13,QCU,0.14,0.76,72.98,45,17,62,50,45,5,1.24,90.0,Facile,Facile,0,Meme Difficulté,Adapte,Sociology
4291,2018,Sociologie,1,Les Differentes Approches de l'Economie,4,L'Analyse Marxiste,14,959,13,QCM,0.07,0.89,72.98,47,17,64,55,47,8,1.16,85.45,Facile,Facile,0,Meme Difficulté,Adapte,Sociology
5402,2019,Sociologie,1,Les Differentes Approches de l'Economie,4,L'Analyse Marxiste,14,959,13,QCM,0.08,0.73,72.98,39,15,54,45,39,6,1.2,86.67,Facile,Facile,0,Meme Difficulté,Adapte,Sociology
6513,2020,Sociologie,1,Les Differentes Approches de l'Economie,4,L'Analyse Marxiste,14,959,13,QCM,0.01,0.97,72.98,42,16,58,52,42,10,1.12,80.77,Facile,Facile,0,Meme Difficulté,Adapte,Sociology
959,2015,Sociologie,1,Les Differentes Approches de l'Economie,4,L'Analyse Marxiste,14,960,14,QCM,0.32,0.47,53.8,40,35,75,55,40,15,1.36,72.73,Facile,Moyen,-1,Plus Difficile,Pas Adapte,Sociology
2070,2016,Sociologie,1,Les Differentes Approches de l'Economie,4,L'Analyse Marxiste,14,960,14,QCM,0.15,0.96,69.69,48,21,69,66,48,18,1.05,72.73,Facile,Facile,0,Meme Difficulté,Adapte,Sociology
3181,2017,Sociologie,1,Les Differentes Approches de l'Economie,4,L'Analyse Marxiste,14,960,14,QCM,0.17,0.73,69.69,53,23,76,69,53,16,1.1,76.81,Facile,Facile,0,Meme Difficulté,Adapte,Sociology
4292,2018,Sociologie,1,Les Differentes Approches de l'Economie,4,L'Analyse Marxiste,14,960,14,QCM,0.09,0.93,69.69,58,25,83,72,58,14,1.15,80.56,Facile,Facile,0,Meme Difficulté,Adapte,Sociology
5403,2019,Sociologie,1,Les Differentes Approches de l'Economie,4,L'Analyse Marxiste,14,960,14,QCM,0.05,0.81,69.69,54,23,77,66,54,12,1.17,81.82,Facile,Facile,0,Meme Difficulté,Adapte,Sociology
6514,2020,Sociologie,1,Les Differentes Approches de l'Economie,4,L'Analyse Marxiste,14,960,14,QCM,0.12,0.89,69.69,58,25,83,70,58,12,1.19,82.86,Facile,Facile,0,Meme Difficulté,Adapte,Sociology
960,2015,Sociologie,1,Les Differentes Approches de l'Economie,5,La Pensee Economique de Keynes,1,961,1,QCU,0.08,0.81,73.62,54,19,73,66,54,12,1.11,81.82,Difficile,Facile,2,Beaucoup plus Facile,Adapte,Sociology
2071,2016,Sociologie,1,Les Differentes Approches de l'Economie,5,La Pensee Economique de Keynes,1,961,1,QCU,0.03,0.77,73.62,55,20,75,74,55,19,1.01,74.32,Facile,Facile,0,Meme Difficulté,Adapte,Sociology
3182,2017,Sociologie,1,Les Differentes Approches de l'Economie,5,La Pensee Economique de Keynes,1,961,1,QCU,0.06,0.8,73.62,50,18,68,58,50,8,1.17,86.21,Facile,Facile,0,Meme Difficulté,Adapte,Sociology
4293,2018,Sociologie,1,Les Differentes Approches de l'Economie,5,La Pensee Economique de Keynes,1,961,1,QCU,0.1,0.86,73.62,54,19,73,64,54,10,1.14,84.38,Facile,Facile,0,Meme Difficulté,Adapte,Sociology
5404,2019,Sociologie,1,Les Differentes Approches de l'Economie,5,La Pensee Economique de Keynes,1,961,1,QCU,0.1,0.78,73.62,56,20,76,68,56,12,1.12,82.35,Facile,Facile,0,Meme Difficulté,Adapte,Sociology
6515,2020,Sociologie,1,Les Differentes Approches de l'Economie,5,La Pensee Economique de Keynes,1,961,1,QCU,0.19,0.85,73.62,59,21,80,65,59,6,1.23,90.77,Facile,Facile,0,Meme Difficulté,Adapte,Sociology
961,2015,Sociologie,1,Les Differentes Approches de l'Economie,6,Les Insuffisances d'une Pensee purement Economique,6,962,1,QCU,0.02,0.94,68.29,26,12,38,28,26,2,1.36,92.86,Difficile,Facile,2,Beaucoup plus Facile,Adapte,Sociology
2072,2016,Sociologie,1,Les Differentes Approches de l'Economie,6,Les Insuffisances d'une Pensee purement Economique,6,962,1,QCU,0.02,0.95,68.29,25,12,37,33,25,8,1.12,75.76,Facile,Facile,0,Meme Difficulté,Adapte,Sociology
3183,2017,Sociologie,1,Les Differentes Approches de l'Economie,6,Les Insuffisances d'une Pensee purement Economique,6,962,1,QCU,0.16,0.93,68.29,25,12,37,26,25,1,1.42,96.15,Facile,Facile,0,Meme Difficulté,Adapte,Sociology
4294,2018,Sociologie,1,Les Differentes Approches de l'Economie,6,Les Insuffisances d'une Pensee purement Economique,6,962,1,QCU,0.1,0.79,68.29,21,10,31,21,21,0,1.48,100.0,Facile,Facile,0,Meme Difficulté,Adapte,Sociology
5405,2019,Sociologie,1,Les Differentes Approches de l'Economie,6,Les Insuffisances d'une Pensee purement Economique,6,962,1,QROC,0.16,0.42,68.29,24,11,35,34,24,10,1.03,70.59,Facile,Facile,0,Meme Difficulté,Adapte,Sociology
6516,2020,Sociologie,1,Les Differentes Approches de l'Economie,6,Les Insuffisances d'une Pensee purement Economique,6,962,1,QROC,0.11,0.48,68.29,24,11,35,27,24,3,1.3,88.89,Facile,Facile,0,Meme Difficulté,Adapte,Sociology
962,2015,Sociologie,1,Les Differentes Approches de l'Economie,6,Les Insuffisances d'une Pensee purement Economique,6,963,2,QCU,0.05,0.97,95.66,48,2,50,49,48,1,1.02,97.96,Facile,Facile,0,Meme Difficulté,Pas Adapte,Sociology
2073,2016,Sociologie,1,Les Differentes Approches de l'Economie,6,Les Insuffisances d'une Pensee purement Economique,6,963,2,QCU,0.07,0.8,94.97,47,3,50,49,47,2,1.02,95.92,Moyen,Facile,1,Plus Facile,Pas Adapte,Sociology
3184,2017,Sociologie,1,Les Differentes Approches de l'Economie,6,Les Insuffisances d'une Pensee purement Economique,6,963,2,QCU,0.56,0.24,14.54,8,48,56,27,8,19,2.07,29.63,Difficile,Difficile,0,Meme Difficulté,Pas Adapte,Sociology
4295,2018,Sociologie,1,Les Differentes Approches de l'Economie,6,Les Insuffisances d'une Pensee purement Economique,6,963,2,QCU,0.03,0.76,91.44,45,4,49,49,45,4,1.0,91.84,Moyen,Facile,1,Plus Facile,Pas Adapte,Sociology
5406,2019,Sociologie,1,Les Differentes Approches de l'Economie,6,Les Insuffisances d'une Pensee purement Economique,6,963,2,QCM,0.09,0.8,93.21,51,4,55,55,51,4,1.0,92.73,Facile,Facile,0,Meme Difficulté,Pas Adapte,Sociology
6517,2020,Sociologie,1,Les Differentes Approches de l'Economie,6,Les Insuffisances d'une Pensee purement Economique,6,963,2,QCM,0.32,0.53,60.33,31,21,52,50,31,19,1.04,62.0,Moyen,Moyen,0,Meme Difficulté,Adapte,Sociology
963,2015,Sociologie,1,Les Differentes Approches de l'Economie,6,Les Insuffisances d'une Pensee purement Economique,6,964,3,QO,0.01,0.84,75.05,67,22,89,88,67,21,1.01,76.14,Moyen,Facile,1,Plus Facile,Pas Adapte,Sociology
2074,2016,Sociologie,1,Les Differentes Approches de l'Economie,6,Les Insuffisances d'une Pensee purement Economique,6,964,3,QO,0.04,0.98,91.79,75,7,82,76,75,1,1.08,98.68,Facile,Facile,0,Meme Difficulté,Pas Adapte,Sociology
3185,2017,Sociologie,1,Les Differentes Approches de l'Economie,6,Les Insuffisances d'une Pensee purement Economique,6,964,3,QROC,0.68,0.19,23.46,17,57,74,35,17,18,2.11,48.57,Facile,Difficile,-2,Beaucoup plus Difficile,Pas Adapte,Sociology
4296,2018,Sociologie,1,Les Differentes Approches de l'Economie,6,Les Insuffisances d'une Pensee purement Economique,6,964,3,QROC,0.03,0.47,98.92,64,1,65,65,64,1,1.0,98.46,Difficile,Facile,2,Beaucoup plus Facile,Pas Adapte,Sociology
5407,2019,Sociologie,1,Les Differentes Approches de l'Economie,6,Les Insuffisances d'une Pensee purement Economique,6,964,3,QROC,0.59,0.4,40.57,23,34,57,29,23,6,1.97,79.31,Moyen,Moyen,0,Meme Difficulté,Pas Adapte,Sociology
6518,2020,Sociologie,1,Les Differentes Approches de l'Economie,6,Les Insuffisances d'une Pensee purement Economique,6,964,3,QROC,0.1,0.95,69.98,46,20,66,51,46,5,1.29,90.2,Difficile,Facile,2,Beaucoup plus Facile,Adapte,Sociology
964,2015,Sociologie,1,Les Differentes Approches de l'Economie,6,Les Insuffisances d'une Pensee purement Economique,6,965,4,QCU,0.23,0.54,41.1,16,22,38,24,16,8,1.58,66.67,Moyen,Moyen,0,Meme Difficulté,Pas Adapte,Sociology
2075,2016,Sociologie,1,Les Differentes Approches de l'Economie,6,Les Insuffisances d'une Pensee purement Economique,6,965,4,QROC,0.36,0.33,55.82,21,16,37,29,21,8,1.28,72.41,Facile,Moyen,-1,Plus Difficile,Pas Adapte,Sociology
3186,2017,Sociologie,1,Les Differentes Approches de l'Economie,6,Les Insuffisances d'une Pensee purement Economique,6,965,4,QROC,0.74,0.21,0.31,0,38,38,16,0,16,2.38,0.0,Moyen,Difficile,-1,Plus Difficile,Pas Adapte,Sociology
4297,2018,Sociologie,1,Les Differentes Approches de l'Economie,6,Les Insuffisances d'une Pensee purement Economique,6,965,4,QROC,0.05,0.97,94.88,37,2,39,38,37,1,1.03,97.37,Moyen,Facile,1,Plus Facile,Pas Adapte,Sociology
5408,2019,Sociologie,1,Les Differentes Approches de l'Economie,6,Les Insuffisances d'une Pensee purement Economique,6,965,4,QROC,0.56,0.37,62.34,23,14,37,26,23,3,1.42,88.46,Facile,Moyen,-1,Plus Difficile,Adapte,Sociology
6519,2020,Sociologie,1,Les Differentes Approches de l'Economie,6,Les Insuffisances d'une Pensee purement Economique,6,965,4,QROC,0.22,0.38,62.34,20,12,32,24,20,4,1.33,83.33,Moyen,Moyen,0,Meme Difficulté,Adapte,Sociology
965,2015,Sociologie,1,Les Differentes Approches de l'Economie,6,Les Insuffisances d'une Pensee purement Economique,6,966,5,QCM,0.21,0.33,54.69,21,17,38,22,21,1,1.73,95.45,Moyen,Moyen,0,Meme Difficulté,Pas Adapte,Sociology
2076,2016,Sociologie,1,Les Differentes Approches de l'Economie,6,Les Insuffisances d'une Pensee purement Economique,6,966,5,QCM,0.28,0.43,53.7,23,20,43,32,23,9,1.34,71.88,Difficile,Moyen,1,Plus Facile,Pas Adapte,Sociology
3187,2017,Sociologie,1,Les Differentes Approches de l'Economie,6,Les Insuffisances d'une Pensee purement Economique,6,966,5,QCM,0.4,0.4,62.06,24,15,39,30,24,6,1.3,80.0,Difficile,Moyen,1,Plus Facile,Adapte,Sociology
4298,2018,Sociologie,1,Les Differentes Approches de l'Economie,6,Les Insuffisances d'une Pensee purement Economique,6,966,5,QCM,0.5,0.53,62.06,25,15,40,36,25,11,1.11,69.44,Moyen,Moyen,0,Meme Difficulté,Adapte,Sociology
5409,2019,Sociologie,1,Les Differentes Approches de l'Economie,6,Les Insuffisances d'une Pensee purement Economique,6,966,5,QCU,0.29,0.74,62.06,24,15,39,27,24,3,1.44,88.89,Moyen,Moyen,0,Meme Difficulté,Adapte,Sociology
6520,2020,Sociologie,1,Les Differentes Approches de l'Economie,6,Les Insuffisances d'une Pensee purement Economique,6,966,5,QCU,0.21,0.52,62.06,20,13,33,31,20,11,1.06,64.52,Moyen,Moyen,0,Meme Difficulté,Adapte,Sociology
966,2015,Sociologie,1,Les Differentes Approches de l'Economie,6,Les Insuffisances d'une Pensee purement Economique,6,967,6,QROC,0.42,0.3,43.58,6,7,13,6,6,0,2.17,100.0,Moyen,Moyen,0,Meme Difficulté,Pas Adapte,Sociology
2077,2016,Sociologie,1,Les Differentes Approches de l'Economie,6,Les Insuffisances d'une Pensee purement Economique,6,967,6,QROC,0.14,0.65,87.9,10,1,11,10,10,0,1.1,100.0,Difficile,Facile,2,Beaucoup plus Facile,Pas Adapte,Sociology
3188,2017,Sociologie,1,Les Differentes Approches de l'Economie,6,Les Insuffisances d'une Pensee purement Economique,6,967,6,QROC,0.94,0.07,12.67,1,9,10,6,1,5,1.67,16.67,Facile,Difficile,-2,Beaucoup plus Difficile,Pas Adapte,Sociology
4299,2018,Sociologie,1,Les Differentes Approches de l'Economie,6,Les Insuffisances d'une Pensee purement Economique,6,967,6,QROC,0.58,0.37,51.61,6,5,11,6,6,0,1.83,100.0,Moyen,Moyen,0,Meme Difficulté,Pas Adapte,Sociology
5410,2019,Sociologie,1,Les Differentes Approches de l'Economie,6,Les Insuffisances d'une Pensee purement Economique,6,967,6,QROC,0.83,0.09,7.57,1,9,10,7,1,6,1.43,14.29,Facile,Difficile,-2,Beaucoup plus Difficile,Pas Adapte,Sociology
6521,2020,Sociologie,1,Les Differentes Approches de l'Economie,6,Les Insuffisances d'une Pensee purement Economique,6,967,6,QROC,0.07,0.64,91.1,9,1,10,9,9,0,1.11,100.0,Facile,Facile,0,Meme Difficulté,Pas Adapte,Sociology
967,2015,Sociologie,2,Histoire de la Pensee Economique,1,Introduction,3,968,1,QCU,0.66,0.27,8.43,2,21,23,21,2,19,1.1,9.52,Difficile,Difficile,0,Meme Difficulté,Pas Adapte,Sociology
2078,2016,Sociologie,2,Histoire de la Pensee Economique,1,Introduction,3,968,1,QCU,0.54,0.39,32.58,7,15,22,9,7,2,2.44,77.78,Facile,Difficile,-2,Beaucoup plus Difficile,Pas Adapte,Sociology
3189,2017,Sociologie,2,Histoire de la Pensee Economique,1,Introduction,3,968,1,QCU,0.55,0.24,1.64,0,22,22,22,0,22,1.0,0.0,Moyen,Difficile,-1,Plus Difficile,Pas Adapte,Sociology
4300,2018,Sociologie,2,Histoire de la Pensee Economique,1,Introduction,3,968,1,QCU,0.28,0.64,55.19,13,10,23,21,13,8,1.1,61.9,Moyen,Moyen,0,Meme Difficulté,Pas Adapte,Sociology
5411,2019,Sociologie,2,Histoire de la Pensee Economique,1,Introduction,3,968,1,QO,0.31,0.2,59.54,13,9,22,14,13,1,1.57,92.86,Difficile,Moyen,1,Plus Facile,Pas Adapte,Sociology
6522,2020,Sociologie,2,Histoire de la Pensee Economique,1,Introduction,3,968,1,QO,0.18,0.53,75.67,17,5,22,17,17,0,1.29,100.0,Difficile,Facile,2,Beaucoup plus Facile,Pas Adapte,Sociology
968,2015,Sociologie,2,Histoire de la Pensee Economique,1,Introduction,3,969,2,QCM,0.45,0.35,48.17,41,44,85,58,41,17,1.47,70.69,Moyen,Moyen,0,Meme Difficulté,Pas Adapte,Sociology
2079,2016,Sociologie,2,Histoire de la Pensee Economique,1,Introduction,3,969,2,QCM,0.01,0.87,71.6,55,22,77,75,55,20,1.03,73.33,Moyen,Facile,1,Plus Facile,Adapte,Sociology
3190,2017,Sociologie,2,Histoire de la Pensee Economique,1,Introduction,3,969,2,QCM,0.08,0.8,71.6,52,21,73,60,52,8,1.22,86.67,Facile,Facile,0,Meme Difficulté,Adapte,Sociology
4301,2018,Sociologie,2,Histoire de la Pensee Economique,1,Introduction,3,969,2,QROC,0.11,0.87,71.6,57,23,80,59,57,2,1.36,96.61,Facile,Facile,0,Meme Difficulté,Adapte,Sociology
5412,2019,Sociologie,2,Histoire de la Pensee Economique,1,Introduction,3,969,2,QROC,0.01,0.89,71.6,51,20,71,57,51,6,1.25,89.47,Facile,Facile,0,Meme Difficulté,Adapte,Sociology
6523,2020,Sociologie,2,Histoire de la Pensee Economique,1,Introduction,3,969,2,QROC,0.19,0.45,71.6,51,20,71,62,51,11,1.15,82.26,Facile,Facile,0,Meme Difficulté,Adapte,Sociology
969,2015,Sociologie,2,Histoire de la Pensee Economique,1,Introduction,3,970,3,QROC,0.97,0.24,19.44,13,54,67,64,13,51,1.05,20.31,Facile,Difficile,-2,Beaucoup plus Difficile,Pas Adapte,Sociology
2080,2016,Sociologie,2,Histoire de la Pensee Economique,1,Introduction,3,970,3,QROC,0.9,0.07,28.61,20,51,71,34,20,14,2.09,58.82,Moyen,Difficile,-1,Plus Difficile,Pas Adapte,Sociology
3191,2017,Sociologie,2,Histoire de la Pensee Economique,1,Introduction,3,970,3,QO,0.37,0.28,52.39,32,30,62,48,32,16,1.29,66.67,Difficile,Moyen,1,Plus Facile,Pas Adapte,Sociology
4302,2018,Sociologie,2,Histoire de la Pensee Economique,1,Introduction,3,970,3,QO,0.18,0.37,88.01,49,7,56,52,49,3,1.08,94.23,Moyen,Facile,1,Plus Facile,Pas Adapte,Sociology
5413,2019,Sociologie,2,Histoire de la Pensee Economique,1,Introduction,3,970,3,QROC,0.57,0.31,50.92,30,29,59,44,30,14,1.34,68.18,Facile,Moyen,-1,Plus Difficile,Pas Adapte,Sociology
6524,2020,Sociologie,2,Histoire de la Pensee Economique,1,Introduction,3,970,3,QROC,0.84,0.08,9.6,6,61,67,67,6,61,1.0,8.96,Difficile,Difficile,0,Meme Difficulté,Pas Adapte,Sociology
970,2015,Sociologie,2,Histoire de la Pensee Economique,2,La Formation de la Pensee Economique jusqu'a Adam Smith,7,971,1,QCU,0.59,0.28,17.36,4,20,24,20,4,16,1.2,20.0,Facile,Difficile,-2,Beaucoup plus Difficile,Pas Adapte,Sociology
2081,2016,Sociologie,2,Histoire de la Pensee Economique,2,La Formation de la Pensee Economique jusqu'a Adam Smith,7,971,1,QCU,0.46,0.34,12.56,3,17,20,14,3,11,1.43,21.43,Moyen,Difficile,-1,Plus Difficile,Pas Adapte,Sociology
3192,2017,Sociologie,2,Histoire de la Pensee Economique,2,La Formation de la Pensee Economique jusqu'a Adam Smith,7,971,1,QCU,0.59,0.33,28.11,5,14,19,16,5,11,1.19,31.25,Facile,Difficile,-2,Beaucoup plus Difficile,Pas Adapte,Sociology
4303,2018,Sociologie,2,Histoire de la Pensee Economique,2,La Formation de la Pensee Economique jusqu'a Adam Smith,7,971,1,QCU,0.33,0.55,60.16,11,8,19,13,11,2,1.46,84.62,Facile,Moyen,-1,Plus Difficile,Adapte,Sociology
5414,2019,Sociologie,2,Histoire de la Pensee Economique,2,La Formation de la Pensee Economique jusqu'a Adam Smith,7,971,1,QCU,0.31,0.73,60.16,11,8,19,15,11,4,1.27,73.33,Moyen,Moyen,0,Meme Difficulté,Adapte,Sociology
6525,2020,Sociologie,2,Histoire de la Pensee Economique,2,La Formation de la Pensee Economique jusqu'a Adam Smith,7,971,1,QCU,0.28,0.68,60.16,12,8,20,16,12,4,1.25,75.0,Moyen,Moyen,0,Meme Difficulté,Adapte,Sociology
971,2015,Sociologie,2,Histoire de la Pensee Economique,2,La Formation de la Pensee Economique jusqu'a Adam Smith,7,972,2,QCU,0.1,0.76,88.94,51,6,57,57,51,6,1.0,89.47,Difficile,Facile,2,Beaucoup plus Facile,Pas Adapte,Sociology
2082,2016,Sociologie,2,Histoire de la Pensee Economique,2,La Formation de la Pensee Economique jusqu'a Adam Smith,7,972,2,QCU,0.64,0.28,28.39,14,35,49,19,14,5,2.58,73.68,Moyen,Difficile,-1,Plus Difficile,Pas Adapte,Sociology
3193,2017,Sociologie,2,Histoire de la Pensee Economique,2,La Formation de la Pensee Economique jusqu'a Adam Smith,7,972,2,QCU,0.06,0.87,74.21,39,13,52,45,39,6,1.16,86.67,Moyen,Facile,1,Plus Facile,Adapte,Sociology
4304,2018,Sociologie,2,Histoire de la Pensee Economique,2,La Formation de la Pensee Economique jusqu'a Adam Smith,7,972,2,QCU,0.16,0.9,74.21,39,14,53,51,39,12,1.04,76.47,Facile,Facile,0,Meme Difficulté,Adapte,Sociology
5415,2019,Sociologie,2,Histoire de la Pensee Economique,2,La Formation de la Pensee Economique jusqu'a Adam Smith,7,972,2,QCU,0.12,0.97,74.21,42,15,57,51,42,9,1.12,82.35,Facile,Facile,0,Meme Difficulté,Adapte,Sociology
6526,2020,Sociologie,2,Histoire de la Pensee Economique,2,La Formation de la Pensee Economique jusqu'a Adam Smith,7,972,2,QCU,0.05,0.9,74.21,43,15,58,55,43,12,1.05,78.18,Facile,Facile,0,Meme Difficulté,Adapte,Sociology
972,2015,Sociologie,2,Histoire de la Pensee Economique,2,La Formation de la Pensee Economique jusqu'a Adam Smith,7,973,3,QROC,0.68,0.04,33.6,11,22,33,18,11,7,1.83,61.11,Facile,Difficile,-2,Beaucoup plus Difficile,Pas Adapte,Sociology
2083,2016,Sociologie,2,Histoire de la Pensee Economique,2,La Formation de la Pensee Economique jusqu'a Adam Smith,7,973,3,QCM,0.79,0.17,15.52,5,30,35,14,5,9,2.5,35.71,Facile,Difficile,-2,Beaucoup plus Difficile,Pas Adapte,Sociology
3194,2017,Sociologie,2,Histoire de la Pensee Economique,2,La Formation de la Pensee Economique jusqu'a Adam Smith,7,973,3,QCM,0.4,0.47,52.8,17,15,32,32,17,15,1.0,53.12,Difficile,Moyen,1,Plus Facile,Pas Adapte,Sociology
4305,2018,Sociologie,2,Histoire de la Pensee Economique,2,La Formation de la Pensee Economique jusqu'a Adam Smith,7,973,3,QCM,0.55,0.2,19.04,6,25,31,28,6,22,1.11,21.43,Difficile,Difficile,0,Meme Difficulté,Pas Adapte,Sociology
5416,2019,Sociologie,2,Histoire de la Pensee Economique,2,La Formation de la Pensee Economique jusqu'a Adam Smith,7,973,3,QCM,0.33,0.63,60.62,17,11,28,22,17,5,1.27,77.27,Moyen,Moyen,0,Meme Difficulté,Adapte,Sociology
6527,2020,Sociologie,2,Histoire de la Pensee Economique,2,La Formation de la Pensee Economique jusqu'a Adam Smith,7,973,3,QCU,0.33,0.71,60.62,15,9,24,21,15,6,1.14,71.43,Moyen,Moyen,0,Meme Difficulté,Adapte,Sociology
973,2015,Sociologie,2,Histoire de la Pensee Economique,2,La Formation de la Pensee Economique jusqu'a Adam Smith,7,974,4,QCM,0.77,0.29,18.25,9,42,51,50,9,41,1.02,18.0,Difficile,Difficile,0,Meme Difficulté,Pas Adapte,Sociology
2084,2016,Sociologie,2,Histoire de la Pensee Economique,2,La Formation de la Pensee Economique jusqu'a Adam Smith,7,974,4,QCM,0.13,0.72,87.8,38,5,43,41,38,3,1.05,92.68,Difficile,Facile,2,Beaucoup plus Facile,Pas Adapte,Sociology
3195,2017,Sociologie,2,Histoire de la Pensee Economique,2,La Formation de la Pensee Economique jusqu'a Adam Smith,7,974,4,QCM,0.6,0.25,9.41,4,41,45,34,4,30,1.32,11.76,Moyen,Difficile,-1,Plus Difficile,Pas Adapte,Sociology
4306,2018,Sociologie,2,Histoire de la Pensee Economique,2,La Formation de la Pensee Economique jusqu'a Adam Smith,7,974,4,QCM,0.41,0.52,63.46,27,16,43,39,27,12,1.1,69.23,Difficile,Moyen,1,Plus Facile,Adapte,Sociology
5417,2019,Sociologie,2,Histoire de la Pensee Economique,2,La Formation de la Pensee Economique jusqu'a Adam Smith,7,974,4,QCM,0.49,0.61,63.46,27,16,43,29,27,2,1.48,93.1,Moyen,Moyen,0,Meme Difficulté,Adapte,Sociology
6528,2020,Sociologie,2,Histoire de la Pensee Economique,2,La Formation de la Pensee Economique jusqu'a Adam Smith,7,974,4,QCM,0.39,0.56,63.46,29,17,46,38,29,9,1.21,76.32,Moyen,Moyen,0,Meme Difficulté,Adapte,Sociology
974,2015,Sociologie,2,Histoire de la Pensee Economique,2,La Formation de la Pensee Economique jusqu'a Adam Smith,7,975,5,QCU,0.1,0.86,95.6,8,0,8,8,8,0,1.0,100.0,Facile,Facile,0,Meme Difficulté,Pas Adapte,Sociology
2085,2016,Sociologie,2,Histoire de la Pensee Economique,2,La Formation de la Pensee Economique jusqu'a Adam Smith,7,975,5,QCU,0.0,0.84,96.19,7,0,7,7,7,0,1.0,100.0,Moyen,Facile,1,Plus Facile,Pas Adapte,Sociology
3196,2017,Sociologie,2,Histoire de la Pensee Economique,2,La Formation de la Pensee Economique jusqu'a Adam Smith,7,975,5,QCM,0.65,0.21,24.93,2,6,8,4,2,2,2.0,50.0,Facile,Difficile,-2,Beaucoup plus Difficile,Pas Adapte,Sociology
4307,2018,Sociologie,2,Histoire de la Pensee Economique,2,La Formation de la Pensee Economique jusqu'a Adam Smith,7,975,5,QCU,0.21,0.49,52.22,5,4,9,7,5,2,1.29,71.43,Difficile,Moyen,1,Plus Facile,Pas Adapte,Sociology
5418,2019,Sociologie,2,Histoire de la Pensee Economique,2,La Formation de la Pensee Economique jusqu'a Adam Smith,7,975,5,QCU,0.62,0.29,3.56,0,10,10,9,0,9,1.11,0.0,Moyen,Difficile,-1,Plus Difficile,Pas Adapte,Sociology
6529,2020,Sociologie,2,Histoire de la Pensee Economique,2,La Formation de la Pensee Economique jusqu'a Adam Smith,7,975,5,QCU,0.25,0.52,41.46,5,7,12,7,5,2,1.71,71.43,Facile,Moyen,-1,Plus Difficile,Pas Adapte,Sociology
975,2015,Sociologie,2,Histoire de la Pensee Economique,2,La Formation de la Pensee Economique jusqu'a Adam Smith,7,976,6,QCU,0.21,0.54,43.79,21,27,48,29,21,8,1.66,72.41,Facile,Moyen,-1,Plus Difficile,Pas Adapte,Sociology
2086,2016,Sociologie,2,Histoire de la Pensee Economique,2,La Formation de la Pensee Economique jusqu'a Adam Smith,7,976,6,QCM,0.07,0.93,94.63,48,3,51,49,48,1,1.04,97.96,Moyen,Facile,1,Plus Facile,Pas Adapte,Sociology
3197,2017,Sociologie,2,Histoire de la Pensee Economique,2,La Formation de la Pensee Economique jusqu'a Adam Smith,7,976,6,QO,0.19,0.46,99.57,43,0,43,43,43,0,1.0,100.0,Facile,Facile,0,Meme Difficulté,Pas Adapte,Sociology
4308,2018,Sociologie,2,Histoire de la Pensee Economique,2,La Formation de la Pensee Economique jusqu'a Adam Smith,7,976,6,QO,0.8,0.13,21.57,11,38,49,44,11,33,1.11,25.0,Moyen,Difficile,-1,Plus Difficile,Pas Adapte,Sociology
5419,2019,Sociologie,2,Histoire de la Pensee Economique,2,La Formation de la Pensee Economique jusqu'a Adam Smith,7,976,6,QO,0.95,0.05,2.62,1,49,50,36,1,35,1.39,2.78,Difficile,Difficile,0,Meme Difficulté,Pas Adapte,Sociology
6530,2020,Sociologie,2,Histoire de la Pensee Economique,2,La Formation de la Pensee Economique jusqu'a Adam Smith,7,976,6,QO,0.18,0.96,77.15,34,10,44,37,34,3,1.19,91.89,Facile,Facile,0,Meme Difficulté,Pas Adapte,Sociology
976,2015,Sociologie,2,Histoire de la Pensee Economique,2,La Formation de la Pensee Economique jusqu'a Adam Smith,7,977,7,QCU,0.28,0.65,56.57,7,6,13,11,7,4,1.18,63.64,Facile,Moyen,-1,Plus Difficile,Pas Adapte,Sociology
2087,2016,Sociologie,2,Histoire de la Pensee Economique,2,La Formation de la Pensee Economique jusqu'a Adam Smith,7,977,7,QCU,0.11,0.79,71.6,9,3,12,9,9,0,1.33,100.0,Difficile,Facile,2,Beaucoup plus Facile,Adapte,Sociology
3198,2017,Sociologie,2,Histoire de la Pensee Economique,2,La Formation de la Pensee Economique jusqu'a Adam Smith,7,977,7,QCU,0.05,0.93,71.6,8,3,11,9,8,1,1.22,88.89,Facile,Facile,0,Meme Difficulté,Adapte,Sociology
4309,2018,Sociologie,2,Histoire de la Pensee Economique,2,La Formation de la Pensee Economique jusqu'a Adam Smith,7,977,7,QCU,0.02,0.9,71.6,9,3,12,11,9,2,1.09,81.82,Facile,Facile,0,Meme Difficulté,Adapte,Sociology
5420,2019,Sociologie,2,Histoire de la Pensee Economique,2,La Formation de la Pensee Economique jusqu'a Adam Smith,7,977,7,QCU,0.03,0.97,71.6,8,3,11,10,8,2,1.1,80.0,Facile,Facile,0,Meme Difficulté,Adapte,Sociology
6531,2020,Sociologie,2,Histoire de la Pensee Economique,2,La Formation de la Pensee Economique jusqu'a Adam Smith,7,977,7,QCU,0.1,1.0,71.6,7,3,10,10,7,3,1.0,70.0,Facile,Facile,0,Meme Difficulté,Adapte,Sociology
977,2015,Sociologie,2,Histoire de la Pensee Economique,3,La Conception Liberale de l'Economie,9,978,1,QCU,0.57,0.23,21.16,18,66,84,67,18,49,1.25,26.87,Moyen,Difficile,-1,Plus Difficile,Pas Adapte,Sociology
2088,2016,Sociologie,2,Histoire de la Pensee Economique,3,La Conception Liberale de l'Economie,9,978,1,QCM,0.18,0.85,82.02,76,17,93,83,76,7,1.12,91.57,Moyen,Facile,1,Plus Facile,Pas Adapte,Sociology
3199,2017,Sociologie,2,Histoire de la Pensee Economique,3,La Conception Liberale de l'Economie,9,978,1,QCM,0.02,0.9,95.72,99,4,103,100,99,1,1.03,99.0,Moyen,Facile,1,Plus Facile,Pas Adapte,Sociology
4310,2018,Sociologie,2,Histoire de la Pensee Economique,3,La Conception Liberale de l'Economie,9,978,1,QCM,0.63,0.24,13.3,12,79,91,34,12,22,2.68,35.29,Difficile,Difficile,0,Meme Difficulté,Pas Adapte,Sociology
5421,2019,Sociologie,2,Histoire de la Pensee Economique,3,La Conception Liberale de l'Economie,9,978,1,QCM,0.2,0.66,43.46,40,52,92,61,40,21,1.51,65.57,Facile,Moyen,-1,Plus Difficile,Pas Adapte,Sociology
6532,2020,Sociologie,2,Histoire de la Pensee Economique,3,La Conception Liberale de l'Economie,9,978,1,QCM,0.37,0.57,47.16,37,42,79,61,37,24,1.3,60.66,Difficile,Moyen,1,Plus Facile,Pas Adapte,Sociology
978,2015,Sociologie,2,Histoire de la Pensee Economique,3,La Conception Liberale de l'Economie,9,979,2,QCM,0.79,0.15,32.56,13,26,39,30,13,17,1.3,43.33,Facile,Difficile,-2,Beaucoup plus Difficile,Pas Adapte,Sociology
2089,2016,Sociologie,2,Histoire de la Pensee Economique,3,La Conception Liberale de l'Economie,9,979,2,QCU,0.02,0.79,86.31,28,5,33,30,28,2,1.1,93.33,Difficile,Facile,2,Beaucoup plus Facile,Pas Adapte,Sociology
3200,2017,Sociologie,2,Histoire de la Pensee Economique,3,La Conception Liberale de l'Economie,9,979,2,QCU,0.23,0.45,60.13,18,12,30,25,18,7,1.2,72.0,Facile,Moyen,-1,Plus Difficile,Adapte,Sociology
4311,2018,Sociologie,2,Histoire de la Pensee Economique,3,La Conception Liberale de l'Economie,9,979,2,QCU,0.29,0.45,60.13,18,12,30,27,18,9,1.11,66.67,Moyen,Moyen,0,Meme Difficulté,Adapte,Sociology
5422,2019,Sociologie,2,Histoire de la Pensee Economique,3,La Conception Liberale de l'Economie,9,979,2,QCU,0.32,0.45,60.13,16,10,26,21,16,5,1.24,76.19,Moyen,Moyen,0,Meme Difficulté,Adapte,Sociology
6533,2020,Sociologie,2,Histoire de la Pensee Economique,3,La Conception Liberale de l'Economie,9,979,2,QCU,0.35,0.56,60.13,13,9,22,15,13,2,1.47,86.67,Moyen,Moyen,0,Meme Difficulté,Adapte,Sociology
979,2015,Sociologie,2,Histoire de la Pensee Economique,3,La Conception Liberale de l'Economie,9,980,3,QCU,0.17,0.98,83.93,46,9,55,49,46,3,1.12,93.88,Moyen,Facile,1,Plus Facile,Pas Adapte,Sociology
2090,2016,Sociologie,2,Histoire de la Pensee Economique,3,La Conception Liberale de l'Economie,9,980,3,QCU,0.05,0.85,75.09,44,14,58,45,44,1,1.29,97.78,Moyen,Facile,1,Plus Facile,Pas Adapte,Sociology
3201,2017,Sociologie,2,Histoire de la Pensee Economique,3,La Conception Liberale de l'Economie,9,980,3,QCU,0.53,0.38,18.03,10,44,54,32,10,22,1.69,31.25,Facile,Difficile,-2,Beaucoup plus Difficile,Pas Adapte,Sociology
4312,2018,Sociologie,2,Histoire de la Pensee Economique,3,La Conception Liberale de l'Economie,9,980,3,QCU,0.17,0.87,66.5,35,18,53,50,35,15,1.06,70.0,Difficile,Facile,2,Beaucoup plus Facile,Adapte,Sociology
5423,2019,Sociologie,2,Histoire de la Pensee Economique,3,La Conception Liberale de l'Economie,9,980,3,QCU,0.0,0.96,66.5,32,16,48,45,32,13,1.07,71.11,Facile,Facile,0,Meme Difficulté,Adapte,Sociology
6534,2020,Sociologie,2,Histoire de la Pensee Economique,3,La Conception Liberale de l'Economie,9,980,3,QCU,0.08,0.81,66.5,30,15,45,41,30,11,1.1,73.17,Facile,Facile,0,Meme Difficulté,Adapte,Sociology
980,2015,Sociologie,2,Histoire de la Pensee Economique,3,La Conception Liberale de l'Economie,9,981,4,QCM,0.14,0.74,79.45,44,12,56,53,44,9,1.06,83.02,Moyen,Facile,1,Plus Facile,Pas Adapte,Sociology
2091,2016,Sociologie,2,Histoire de la Pensee Economique,3,La Conception Liberale de l'Economie,9,981,4,QCM,0.02,0.74,88.3,49,6,55,51,49,2,1.08,96.08,Difficile,Facile,2,Beaucoup plus Facile,Pas Adapte,Sociology
3202,2017,Sociologie,2,Histoire de la Pensee Economique,3,La Conception Liberale de l'Economie,9,981,4,QCM,0.69,0.21,1.08,1,56,57,34,1,33,1.68,2.94,Facile,Difficile,-2,Beaucoup plus Difficile,Pas Adapte,Sociology
4313,2018,Sociologie,2,Histoire de la Pensee Economique,3,La Conception Liberale de l'Economie,9,981,4,QCM,0.21,0.6,50.24,32,31,63,40,32,8,1.57,80.0,Difficile,Moyen,1,Plus Facile,Pas Adapte,Sociology
5424,2019,Sociologie,2,Histoire de la Pensee Economique,3,La Conception Liberale de l'Economie,9,981,4,QCM,0.46,0.67,52.2,31,28,59,47,31,16,1.26,65.96,Difficile,Moyen,1,Plus Facile,Pas Adapte,Sociology
6535,2020,Sociologie,2,Histoire de la Pensee Economique,3,La Conception Liberale de l'Economie,9,981,4,QCM,0.79,0.29,13.3,7,43,50,26,7,19,1.92,26.92,Difficile,Difficile,0,Meme Difficulté,Pas Adapte,Sociology
981,2015,Sociologie,2,Histoire de la Pensee Economique,3,La Conception Liberale de l'Economie,9,982,5,QCM,0.17,0.93,86.21,26,4,30,26,26,0,1.15,100.0,Moyen,Facile,1,Plus Facile,Pas Adapte,Sociology
2092,2016,Sociologie,2,Histoire de la Pensee Economique,3,La Conception Liberale de l'Economie,9,982,5,QCM,0.66,0.19,10.96,4,28,32,30,4,26,1.07,13.33,Difficile,Difficile,0,Meme Difficulté,Pas Adapte,Sociology
3203,2017,Sociologie,2,Histoire de la Pensee Economique,3,La Conception Liberale de l'Economie,9,982,5,QCM,0.56,0.19,17.92,6,28,34,29,6,23,1.17,20.69,Difficile,Difficile,0,Meme Difficulté,Pas Adapte,Sociology
4314,2018,Sociologie,2,Histoire de la Pensee Economique,3,La Conception Liberale de l'Economie,9,982,5,QROC,0.6,0.03,16.82,6,32,38,25,6,19,1.52,24.0,Facile,Difficile,-2,Beaucoup plus Difficile,Pas Adapte,Sociology
5425,2019,Sociologie,2,Histoire de la Pensee Economique,3,La Conception Liberale de l'Economie,9,982,5,QROC,0.03,0.65,70.8,26,11,37,26,26,0,1.42,100.0,Difficile,Facile,2,Beaucoup plus Facile,Adapte,Sociology
6536,2020,Sociologie,2,Histoire de la Pensee Economique,3,La Conception Liberale de l'Economie,9,982,5,QROC,0.04,0.53,70.8,23,9,32,26,23,3,1.23,88.46,Facile,Facile,0,Meme Difficulté,Adapte,Sociology
982,2015,Sociologie,2,Histoire de la Pensee Economique,3,La Conception Liberale de l'Economie,9,983,6,QCM,0.43,0.57,36.88,18,31,49,38,18,20,1.29,47.37,Facile,Moyen,-1,Plus Difficile,Pas Adapte,Sociology
2093,2016,Sociologie,2,Histoire de la Pensee Economique,3,La Conception Liberale de l'Economie,9,983,6,QCM,0.32,0.31,62.42,28,17,45,38,28,10,1.18,73.68,Moyen,Moyen,0,Meme Difficulté,Adapte,Sociology
3204,2017,Sociologie,2,Histoire de la Pensee Economique,3,La Conception Liberale de l'Economie,9,983,6,QCM,0.31,0.65,62.42,32,19,51,36,32,4,1.42,88.89,Moyen,Moyen,0,Meme Difficulté,Adapte,Sociology
4315,2018,Sociologie,2,Histoire de la Pensee Economique,3,La Conception Liberale de l'Economie,9,983,6,QCM,0.22,0.55,62.42,30,18,48,47,30,17,1.02,63.83,Moyen,Moyen,0,Meme Difficulté,Adapte,Sociology
5426,2019,Sociologie,2,Histoire de la Pensee Economique,3,La Conception Liberale de l'Economie,9,983,6,QCM,0.26,0.33,62.42,31,19,50,43,31,12,1.16,72.09,Moyen,Moyen,0,Meme Difficulté,Adapte,Sociology
6537,2020,Sociologie,2,Histoire de la Pensee Economique,3,La Conception Liberale de l'Economie,9,983,6,QCM,0.21,0.58,62.42,27,16,43,27,27,0,1.59,100.0,Moyen,Moyen,0,Meme Difficulté,Adapte,Sociology
983,2015,Sociologie,2,Histoire de la Pensee Economique,3,La Conception Liberale de l'Economie,9,984,7,QCM,0.21,0.57,56.97,46,35,81,61,46,15,1.33,75.41,Facile,Moyen,-1,Plus Difficile,Pas Adapte,Sociology
2094,2016,Sociologie,2,Histoire de la Pensee Economique,3,La Conception Liberale de l'Economie,9,984,7,QCM,0.25,0.38,61.25,53,34,87,71,53,18,1.23,74.65,Facile,Moyen,-1,Plus Difficile,Adapte,Sociology
3205,2017,Sociologie,2,Histoire de la Pensee Economique,3,La Conception Liberale de l'Economie,9,984,7,QCM,0.37,0.61,61.25,58,36,94,76,58,18,1.24,76.32,Moyen,Moyen,0,Meme Difficulté,Adapte,Sociology
4316,2018,Sociologie,2,Histoire de la Pensee Economique,3,La Conception Liberale de l'Economie,9,984,7,QCM,0.35,0.5,61.25,58,37,95,64,58,6,1.48,90.62,Moyen,Moyen,0,Meme Difficulté,Adapte,Sociology
5427,2019,Sociologie,2,Histoire de la Pensee Economique,3,La Conception Liberale de l'Economie,9,984,7,QCM,0.25,0.31,61.25,66,41,107,95,66,29,1.13,69.47,Moyen,Moyen,0,Meme Difficulté,Adapte,Sociology
6538,2020,Sociologie,2,Histoire de la Pensee Economique,3,La Conception Liberale de l'Economie,9,984,7,QCM,0.39,0.47,61.25,74,47,121,104,74,30,1.16,71.15,Moyen,Moyen,0,Meme Difficulté,Adapte,Sociology
984,2015,Sociologie,2,Histoire de la Pensee Economique,3,La Conception Liberale de l'Economie,9,985,8,QCM,0.34,0.55,36.59,12,20,32,16,12,4,2.0,75.0,Moyen,Moyen,0,Meme Difficulté,Pas Adapte,Sociology
2095,2016,Sociologie,2,Histoire de la Pensee Economique,3,La Conception Liberale de l'Economie,9,985,8,QCM,0.21,0.5,62.86,18,10,28,24,18,6,1.17,75.0,Facile,Moyen,-1,Plus Difficile,Adapte,Sociology
3206,2017,Sociologie,2,Histoire de la Pensee Economique,3,La Conception Liberale de l'Economie,9,985,8,QCM,0.44,0.52,62.86,19,12,31,21,19,2,1.48,90.48,Moyen,Moyen,0,Meme Difficulté,Adapte,Sociology
4317,2018,Sociologie,2,Histoire de la Pensee Economique,3,La Conception Liberale de l'Economie,9,985,8,QCM,0.44,0.53,62.86,18,11,29,19,18,1,1.53,94.74,Moyen,Moyen,0,Meme Difficulté,Adapte,Sociology
5428,2019,Sociologie,2,Histoire de la Pensee Economique,3,La Conception Liberale de l'Economie,9,985,8,QCU,0.37,0.49,62.86,19,11,30,30,19,11,1.0,63.33,Moyen,Moyen,0,Meme Difficulté,Adapte,Sociology
6539,2020,Sociologie,2,Histoire de la Pensee Economique,3,La Conception Liberale de l'Economie,9,985,8,QCU,0.26,0.49,62.86,18,10,28,26,18,8,1.08,69.23,Moyen,Moyen,0,Meme Difficulté,Adapte,Sociology
985,2015,Sociologie,2,Histoire de la Pensee Economique,3,La Conception Liberale de l'Economie,9,986,9,QO,0.19,0.53,73.67,71,25,96,89,71,18,1.08,79.78,Difficile,Facile,2,Beaucoup plus Facile,Adapte,Sociology
2096,2016,Sociologie,2,Histoire de la Pensee Economique,3,La Conception Liberale de l'Economie,9,986,9,QO,0.19,0.94,73.67,63,22,85,72,63,9,1.18,87.5,Facile,Facile,0,Meme Difficulté,Adapte,Sociology
3207,2017,Sociologie,2,Histoire de la Pensee Economique,3,La Conception Liberale de l'Economie,9,986,9,QO,0.12,0.35,73.67,59,21,80,79,59,20,1.01,74.68,Facile,Facile,0,Meme Difficulté,Adapte,Sociology
4318,2018,Sociologie,2,Histoire de la Pensee Economique,3,La Conception Liberale de l'Economie,9,986,9,QO,0.15,0.5,73.67,56,20,76,59,56,3,1.29,94.92,Facile,Facile,0,Meme Difficulté,Adapte,Sociology
5429,2019,Sociologie,2,Histoire de la Pensee Economique,3,La Conception Liberale de l'Economie,9,986,9,QO,0.09,0.43,73.67,57,21,78,71,57,14,1.1,80.28,Facile,Facile,0,Meme Difficulté,Adapte,Sociology
6540,2020,Sociologie,2,Histoire de la Pensee Economique,3,La Conception Liberale de l'Economie,9,986,9,QO,0.02,0.66,73.67,64,23,87,86,64,22,1.01,74.42,Facile,Facile,0,Meme Difficulté,Adapte,Sociology
986,2015,Sociologie,2,Histoire de la Pensee Economique,4,L'Analyse Marxiste,14,987,1,QCM,0.17,0.81,78.19,38,11,49,38,38,0,1.29,100.0,Facile,Facile,0,Meme Difficulté,Pas Adapte,Sociology
2097,2016,Sociologie,2,Histoire de la Pensee Economique,4,L'Analyse Marxiste,14,987,1,QCM,0.29,0.45,45.24,19,23,42,32,19,13,1.31,59.38,Difficile,Moyen,1,Plus Facile,Pas Adapte,Sociology
3208,2017,Sociologie,2,Histoire de la Pensee Economique,4,L'Analyse Marxiste,14,987,1,QCM,0.24,0.55,56.66,22,16,38,31,22,9,1.23,70.97,Moyen,Moyen,0,Meme Difficulté,Pas Adapte,Sociology
4319,2018,Sociologie,2,Histoire de la Pensee Economique,4,L'Analyse Marxiste,14,987,1,QCM,0.24,0.55,63.33,28,16,44,31,28,3,1.42,90.32,Difficile,Moyen,1,Plus Facile,Adapte,Sociology
5430,2019,Sociologie,2,Histoire de la Pensee Economique,4,L'Analyse Marxiste,14,987,1,QROC,0.34,0.28,63.33,25,14,39,29,25,4,1.34,86.21,Moyen,Moyen,0,Meme Difficulté,Adapte,Sociology
6541,2020,Sociologie,2,Histoire de la Pensee Economique,4,L'Analyse Marxiste,14,987,1,QROC,0.51,0.26,63.33,22,13,35,34,22,12,1.03,64.71,Moyen,Moyen,0,Meme Difficulté,Adapte,Sociology
987,2015,Sociologie,2,Histoire de la Pensee Economique,4,L'Analyse Marxiste,14,988,2,QCM,0.36,0.44,51.63,24,22,46,27,24,3,1.7,88.89,Facile,Moyen,-1,Plus Difficile,Pas Adapte,Sociology
2098,2016,Sociologie,2,Histoire de la Pensee Economique,4,L'Analyse Marxiste,14,988,2,QCU,0.01,0.76,81.24,40,9,49,46,40,6,1.07,86.96,Moyen,Facile,1,Plus Facile,Pas Adapte,Sociology
3209,2017,Sociologie,2,Histoire de la Pensee Economique,4,L'Analyse Marxiste,14,988,2,QCU,0.19,0.97,75.21,35,12,47,44,35,9,1.07,79.55,Difficile,Facile,2,Beaucoup plus Facile,Pas Adapte,Sociology
4320,2018,Sociologie,2,Histoire de la Pensee Economique,4,L'Analyse Marxiste,14,988,2,QCU,0.56,0.24,33.92,16,30,46,41,16,25,1.12,39.02,Difficile,Difficile,0,Meme Difficulté,Pas Adapte,Sociology
5431,2019,Sociologie,2,Histoire de la Pensee Economique,4,L'Analyse Marxiste,14,988,2,QCU,0.04,0.95,78.84,41,11,52,47,41,6,1.11,87.23,Moyen,Facile,1,Plus Facile,Pas Adapte,Sociology
6542,2020,Sociologie,2,Histoire de la Pensee Economique,4,L'Analyse Marxiste,14,988,2,QCU,0.22,0.45,49.07,26,28,54,53,26,27,1.02,49.06,Difficile,Moyen,1,Plus Facile,Pas Adapte,Sociology
988,2015,Sociologie,2,Histoire de la Pensee Economique,4,L'Analyse Marxiste,14,989,3,QCM,0.36,0.37,56.77,9,7,16,9,9,0,1.78,100.0,Moyen,Moyen,0,Meme Difficulté,Pas Adapte,Sociology
2099,2016,Sociologie,2,Histoire de la Pensee Economique,4,L'Analyse Marxiste,14,989,3,QCM,0.78,0.19,19.12,3,15,18,5,3,2,3.6,60.0,Moyen,Difficile,-1,Plus Difficile,Pas Adapte,Sociology
3210,2017,Sociologie,2,Histoire de la Pensee Economique,4,L'Analyse Marxiste,14,989,3,QCM,0.39,0.48,43.26,9,12,21,13,9,4,1.62,69.23,Facile,Moyen,-1,Plus Difficile,Pas Adapte,Sociology
4321,2018,Sociologie,2,Histoire de la Pensee Economique,4,L'Analyse Marxiste,14,989,3,QCM,0.04,0.85,91.73,22,2,24,23,22,1,1.04,95.65,Facile,Facile,0,Meme Difficulté,Pas Adapte,Sociology
5432,2019,Sociologie,2,Histoire de la Pensee Economique,4,L'Analyse Marxiste,14,989,3,QCM,0.59,0.21,7.81,2,22,24,6,2,4,4.0,33.33,Facile,Difficile,-2,Beaucoup plus Difficile,Pas Adapte,Sociology
6543,2020,Sociologie,2,Histoire de la Pensee Economique,4,L'Analyse Marxiste,14,989,3,QROC,0.03,0.42,80.18,21,5,26,23,21,2,1.13,91.3,Facile,Facile,0,Meme Difficulté,Pas Adapte,Sociology
989,2015,Sociologie,2,Histoire de la Pensee Economique,4,L'Analyse Marxiste,14,990,4,QCU,0.32,0.41,59.0,53,37,90,86,53,33,1.05,61.63,Moyen,Moyen,0,Meme Difficulté,Pas Adapte,Sociology
2100,2016,Sociologie,2,Histoire de la Pensee Economique,4,L'Analyse Marxiste,14,990,4,QCU,0.58,0.22,21.75,19,70,89,55,19,36,1.62,34.55,Difficile,Difficile,0,Meme Difficulté,Pas Adapte,Sociology
3211,2017,Sociologie,2,Histoire de la Pensee Economique,4,L'Analyse Marxiste,14,990,4,QCU,0.09,1.0,76.35,66,21,87,70,66,4,1.24,94.29,Moyen,Facile,1,Plus Facile,Pas Adapte,Sociology
4322,2018,Sociologie,2,Histoire de la Pensee Economique,4,L'Analyse Marxiste,14,990,4,QCM,0.19,0.81,65.77,62,33,95,68,62,6,1.4,91.18,Facile,Facile,0,Meme Difficulté,Adapte,Sociology
5433,2019,Sociologie,2,Histoire de la Pensee Economique,4,L'Analyse Marxiste,14,990,4,QCM,0.04,0.99,65.77,56,29,85,78,56,22,1.09,71.79,Facile,Facile,0,Meme Difficulté,Adapte,Sociology
6544,2020,Sociologie,2,Histoire de la Pensee Economique,4,L'Analyse Marxiste,14,990,4,QCM,0.06,0.86,65.77,52,27,79,57,52,5,1.39,91.23,Facile,Facile,0,Meme Difficulté,Adapte,Sociology
990,2015,Sociologie,2,Histoire de la Pensee Economique,4,L'Analyse Marxiste,14,991,5,QCU,0.44,0.23,26.93,17,46,63,25,17,8,2.52,68.0,Difficile,Difficile,0,Meme Difficulté,Pas Adapte,Sociology
2101,2016,Sociologie,2,Histoire de la Pensee Economique,4,L'Analyse Marxiste,14,991,5,QCU,0.55,0.32,19.28,12,49,61,54,12,42,1.13,22.22,Difficile,Difficile,0,Meme Difficulté,Pas Adapte,Sociology
3212,2017,Sociologie,2,Histoire de la Pensee Economique,4,L'Analyse Marxiste,14,991,5,QCU,0.13,0.93,74.09,49,17,66,51,49,2,1.29,96.08,Moyen,Facile,1,Plus Facile,Adapte,Sociology
4323,2018,Sociologie,2,Histoire de la Pensee Economique,4,L'Analyse Marxiste,14,991,5,QCU,0.13,0.88,74.09,53,19,72,62,53,9,1.16,85.48,Facile,Facile,0,Meme Difficulté,Adapte,Sociology
5434,2019,Sociologie,2,Histoire de la Pensee Economique,4,L'Analyse Marxiste,14,991,5,QCU,0.08,0.9,74.09,47,17,64,52,47,5,1.23,90.38,Facile,Facile,0,Meme Difficulté,Adapte,Sociology
6545,2020,Sociologie,2,Histoire de la Pensee Economique,4,L'Analyse Marxiste,14,991,5,QCU,0.07,0.95,74.09,50,18,68,62,50,12,1.1,80.65,Facile,Facile,0,Meme Difficulté,Adapte,Sociology
991,2015,Sociologie,2,Histoire de la Pensee Economique,4,L'Analyse Marxiste,14,992,6,QCM,0.35,0.38,39.07,9,14,23,14,9,5,1.64,64.29,Moyen,Moyen,0,Meme Difficulté,Pas Adapte,Sociology
2102,2016,Sociologie,2,Histoire de la Pensee Economique,4,L'Analyse Marxiste,14,992,6,QCM,0.37,0.34,52.13,11,11,22,16,11,5,1.38,68.75,Difficile,Moyen,1,Plus Facile,Pas Adapte,Sociology
3213,2017,Sociologie,2,Histoire de la Pensee Economique,4,L'Analyse Marxiste,14,992,6,QCM,0.62,0.24,27.09,7,18,25,13,7,6,1.92,53.85,Difficile,Difficile,0,Meme Difficulté,Pas Adapte,Sociology
4324,2018,Sociologie,2,Histoire de la Pensee Economique,4,L'Analyse Marxiste,14,992,6,QCM,0.72,0.25,9.52,2,20,22,9,2,7,2.44,22.22,Difficile,Difficile,0,Meme Difficulté,Pas Adapte,Sociology
5435,2019,Sociologie,2,Histoire de la Pensee Economique,4,L'Analyse Marxiste,14,992,6,QCM,0.59,0.23,0.18,0,19,19,18,0,18,1.06,0.0,Facile,Difficile,-2,Beaucoup plus Difficile,Pas Adapte,Sociology
6546,2020,Sociologie,2,Histoire de la Pensee Economique,4,L'Analyse Marxiste,14,992,6,QCM,0.14,0.89,90.43,14,2,16,15,14,1,1.07,93.33,Moyen,Facile,1,Plus Facile,Pas Adapte,Sociology
992,2015,Sociologie,2,Histoire de la Pensee Economique,4,L'Analyse Marxiste,14,993,7,QCU,0.63,0.32,30.72,23,53,76,29,23,6,2.62,79.31,Difficile,Difficile,0,Meme Difficulté,Pas Adapte,Sociology
2103,2016,Sociologie,2,Histoire de la Pensee Economique,4,L'Analyse Marxiste,14,993,7,QCU,0.39,0.48,58.51,47,34,81,78,47,31,1.04,60.26,Facile,Moyen,-1,Plus Difficile,Pas Adapte,Sociology
3214,2017,Sociologie,2,Histoire de la Pensee Economique,4,L'Analyse Marxiste,14,993,7,QCU,0.39,0.46,39.39,33,50,83,47,33,14,1.77,70.21,Moyen,Moyen,0,Meme Difficulté,Pas Adapte,Sociology
4325,2018,Sociologie,2,Histoire de la Pensee Economique,4,L'Analyse Marxiste,14,993,7,QCU,0.19,0.96,74.59,54,19,73,72,54,18,1.01,75.0,Facile,Facile,0,Meme Difficulté,Adapte,Sociology
5436,2019,Sociologie,2,Histoire de la Pensee Economique,4,L'Analyse Marxiste,14,993,7,QO,0.02,0.97,74.59,54,18,72,60,54,6,1.2,90.0,Facile,Facile,0,Meme Difficulté,Adapte,Sociology
6547,2020,Sociologie,2,Histoire de la Pensee Economique,4,L'Analyse Marxiste,14,993,7,QO,0.04,0.64,74.59,61,21,82,74,61,13,1.11,82.43,Facile,Facile,0,Meme Difficulté,Adapte,Sociology
993,2015,Sociologie,2,Histoire de la Pensee Economique,4,L'Analyse Marxiste,14,994,8,QCU,0.02,0.96,87.69,58,8,66,60,58,2,1.1,96.67,Moyen,Facile,1,Plus Facile,Pas Adapte,Sociology
2104,2016,Sociologie,2,Histoire de la Pensee Economique,4,L'Analyse Marxiste,14,994,8,QCU,0.27,0.42,46.1,27,32,59,40,27,13,1.48,67.5,Difficile,Moyen,1,Plus Facile,Pas Adapte,Sociology
3215,2017,Sociologie,2,Histoire de la Pensee Economique,4,L'Analyse Marxiste,14,994,8,QCU,0.19,0.89,90.53,47,5,52,51,47,4,1.02,92.16,Moyen,Facile,1,Plus Facile,Pas Adapte,Sociology
4326,2018,Sociologie,2,Histoire de la Pensee Economique,4,L'Analyse Marxiste,14,994,8,QCU,0.06,0.94,96.79,43,1,44,44,43,1,1.0,97.73,Difficile,Facile,2,Beaucoup plus Facile,Pas Adapte,Sociology
5437,2019,Sociologie,2,Histoire de la Pensee Economique,4,L'Analyse Marxiste,14,994,8,QCU,0.21,0.44,46.65,18,20,38,29,18,11,1.31,62.07,Facile,Moyen,-1,Plus Difficile,Pas Adapte,Sociology
6548,2020,Sociologie,2,Histoire de la Pensee Economique,4,L'Analyse Marxiste,14,994,8,QCU,0.21,0.62,61.77,27,16,43,43,27,16,1.0,62.79,Difficile,Moyen,1,Plus Facile,Adapte,Sociology
994,2015,Sociologie,2,Histoire de la Pensee Economique,4,L'Analyse Marxiste,14,995,9,QROC,0.89,0.03,2.77,1,51,52,26,1,25,2.0,3.85,Moyen,Difficile,-1,Plus Difficile,Pas Adapte,Sociology
2105,2016,Sociologie,2,Histoire de la Pensee Economique,4,L'Analyse Marxiste,14,995,9,QO,0.84,0.15,13.25,7,48,55,49,7,42,1.12,14.29,Facile,Difficile,-2,Beaucoup plus Difficile,Pas Adapte,Sociology
3216,2017,Sociologie,2,Histoire de la Pensee Economique,4,L'Analyse Marxiste,14,995,9,QO,0.0,0.45,86.78,41,6,47,44,41,3,1.07,93.18,Moyen,Facile,1,Plus Facile,Pas Adapte,Sociology
4327,2018,Sociologie,2,Histoire de la Pensee Economique,4,L'Analyse Marxiste,14,995,9,QO,0.89,0.01,27.06,12,33,45,35,12,23,1.29,34.29,Difficile,Difficile,0,Meme Difficulté,Pas Adapte,Sociology
5438,2019,Sociologie,2,Histoire de la Pensee Economique,4,L'Analyse Marxiste,14,995,9,QO,0.28,0.26,49.26,24,24,48,33,24,9,1.45,72.73,Facile,Moyen,-1,Plus Difficile,Pas Adapte,Sociology
6549,2020,Sociologie,2,Histoire de la Pensee Economique,4,L'Analyse Marxiste,14,995,9,QO,0.9,0.1,1.82,1,50,51,42,1,41,1.21,2.38,Facile,Difficile,-2,Beaucoup plus Difficile,Pas Adapte,Sociology
995,2015,Sociologie,2,Histoire de la Pensee Economique,4,L'Analyse Marxiste,14,996,10,QCU,0.26,0.49,64.71,27,14,41,31,27,4,1.32,87.1,Difficile,Moyen,1,Plus Facile,Adapte,Sociology
2106,2016,Sociologie,2,Histoire de la Pensee Economique,4,L'Analyse Marxiste,14,996,10,QCU,0.34,0.6,64.71,28,15,43,36,28,8,1.19,77.78,Moyen,Moyen,0,Meme Difficulté,Adapte,Sociology
3217,2017,Sociologie,2,Histoire de la Pensee Economique,4,L'Analyse Marxiste,14,996,10,QCU,0.37,0.67,64.71,29,16,45,31,29,2,1.45,93.55,Moyen,Moyen,0,Meme Difficulté,Adapte,Sociology
4328,2018,Sociologie,2,Histoire de la Pensee Economique,4,L'Analyse Marxiste,14,996,10,QCU,0.29,0.49,64.71,25,13,38,35,25,10,1.09,71.43,Moyen,Moyen,0,Meme Difficulté,Adapte,Sociology
5439,2019,Sociologie,2,Histoire de la Pensee Economique,4,L'Analyse Marxiste,14,996,10,QCU,0.28,0.72,64.71,25,14,39,25,25,0,1.56,100.0,Moyen,Moyen,0,Meme Difficulté,Adapte,Sociology
6550,2020,Sociologie,2,Histoire de la Pensee Economique,4,L'Analyse Marxiste,14,996,10,QCU,0.24,0.45,64.71,28,15,43,29,28,1,1.48,96.55,Moyen,Moyen,0,Meme Difficulté,Adapte,Sociology
996,2015,Sociologie,2,Histoire de la Pensee Economique,4,L'Analyse Marxiste,14,997,11,QCM,0.64,0.27,26.87,1,4,5,4,1,3,1.25,25.0,Difficile,Difficile,0,Meme Difficulté,Pas Adapte,Sociology
2107,2016,Sociologie,2,Histoire de la Pensee Economique,4,L'Analyse Marxiste,14,997,11,QCM,0.38,0.32,40.39,2,4,6,5,2,3,1.2,40.0,Facile,Moyen,-1,Plus Difficile,Pas Adapte,Sociology
3218,2017,Sociologie,2,Histoire de la Pensee Economique,4,L'Analyse Marxiste,14,997,11,QCM,0.54,0.24,13.59,1,6,7,4,1,3,1.75,25.0,Difficile,Difficile,0,Meme Difficulté,Pas Adapte,Sociology
4329,2018,Sociologie,2,Histoire de la Pensee Economique,4,L'Analyse Marxiste,14,997,11,QROC,0.31,0.39,60.78,4,2,6,5,4,1,1.2,80.0,Facile,Moyen,-1,Plus Difficile,Adapte,Sociology
5440,2019,Sociologie,2,Histoire de la Pensee Economique,4,L'Analyse Marxiste,14,997,11,QROC,0.58,0.28,60.78,4,2,6,6,4,2,1.0,66.67,Moyen,Moyen,0,Meme Difficulté,Adapte,Sociology
6551,2020,Sociologie,2,Histoire de la Pensee Economique,4,L'Analyse Marxiste,14,997,11,QROC,0.36,0.27,60.78,3,2,5,3,3,0,1.67,100.0,Moyen,Moyen,0,Meme Difficulté,Adapte,Sociology
997,2015,Sociologie,2,Histoire de la Pensee Economique,4,L'Analyse Marxiste,14,998,12,QCM,0.75,0.26,6.96,6,76,82,56,6,50,1.46,10.71,Moyen,Difficile,-1,Plus Difficile,Pas Adapte,Sociology
2108,2016,Sociologie,2,Histoire de la Pensee Economique,4,L'Analyse Marxiste,14,998,12,QCU,0.74,0.36,5.31,4,72,76,65,4,61,1.17,6.15,Difficile,Difficile,0,Meme Difficulté,Pas Adapte,Sociology
3219,2017,Sociologie,2,Histoire de la Pensee Economique,4,L'Analyse Marxiste,14,998,12,QCU,0.26,0.49,52.34,44,41,85,55,44,11,1.55,80.0,Difficile,Moyen,1,Plus Facile,Pas Adapte,Sociology
4330,2018,Sociologie,2,Histoire de la Pensee Economique,4,L'Analyse Marxiste,14,998,12,QCU,0.51,0.24,30.13,22,52,74,55,22,33,1.35,40.0,Facile,Difficile,-2,Beaucoup plus Difficile,Pas Adapte,Sociology
5441,2019,Sociologie,2,Histoire de la Pensee Economique,4,L'Analyse Marxiste,14,998,12,QCU,0.15,0.88,93.33,74,5,79,79,74,5,1.0,93.67,Facile,Facile,0,Meme Difficulté,Pas Adapte,Sociology
6552,2020,Sociologie,2,Histoire de la Pensee Economique,4,L'Analyse Marxiste,14,998,12,QCU,0.07,0.87,88.51,76,10,86,76,76,0,1.13,100.0,Difficile,Facile,2,Beaucoup plus Facile,Pas Adapte,Sociology
998,2015,Sociologie,2,Histoire de la Pensee Economique,4,L'Analyse Marxiste,14,999,13,QCU,0.09,0.8,99.27,15,0,15,15,15,0,1.0,100.0,Facile,Facile,0,Meme Difficulté,Pas Adapte,Sociology
2109,2016,Sociologie,2,Histoire de la Pensee Economique,4,L'Analyse Marxiste,14,999,13,QCU,0.17,0.99,68.57,11,5,16,16,11,5,1.0,68.75,Facile,Facile,0,Meme Difficulté,Adapte,Sociology
3220,2017,Sociologie,2,Histoire de la Pensee Economique,4,L'Analyse Marxiste,14,999,13,QCM,0.1,0.98,68.57,10,5,15,11,10,1,1.36,90.91,Facile,Facile,0,Meme Difficulté,Adapte,Sociology
4331,2018,Sociologie,2,Histoire de la Pensee Economique,4,L'Analyse Marxiste,14,999,13,QO,0.19,0.38,68.57,9,4,13,12,9,3,1.08,75.0,Facile,Facile,0,Meme Difficulté,Adapte,Sociology
5442,2019,Sociologie,2,Histoire de la Pensee Economique,4,L'Analyse Marxiste,14,999,13,QO,0.18,0.61,68.57,10,4,14,12,10,2,1.17,83.33,Facile,Facile,0,Meme Difficulté,Adapte,Sociology
6553,2020,Sociologie,2,Histoire de la Pensee Economique,4,L'Analyse Marxiste,14,999,13,QO,0.15,0.74,68.57,11,5,16,14,11,3,1.14,78.57,Facile,Facile,0,Meme Difficulté,Adapte,Sociology
999,2015,Sociologie,2,Histoire de la Pensee Economique,4,L'Analyse Marxiste,14,1000,14,QCU,0.35,0.7,40.0,30,46,76,34,30,4,2.24,88.24,Moyen,Moyen,0,Meme Difficulté,Pas Adapte,Sociology
2110,2016,Sociologie,2,Histoire de la Pensee Economique,4,L'Analyse Marxiste,14,1000,14,QCU,0.67,0.25,4.88,4,75,79,46,4,42,1.72,8.7,Facile,Difficile,-2,Beaucoup plus Difficile,Pas Adapte,Sociology
3221,2017,Sociologie,2,Histoire de la Pensee Economique,4,L'Analyse Marxiste,14,1000,14,QCU,0.37,0.56,39.56,31,47,78,37,31,6,2.11,83.78,Facile,Moyen,-1,Plus Difficile,Pas Adapte,Sociology
4332,2018,Sociologie,2,Histoire de la Pensee Economique,4,L'Analyse Marxiste,14,1000,14,QCU,0.54,0.38,11.26,10,79,89,68,10,58,1.31,14.71,Facile,Difficile,-2,Beaucoup plus Difficile,Pas Adapte,Sociology
5443,2019,Sociologie,2,Histoire de la Pensee Economique,4,L'Analyse Marxiste,14,1000,14,QCU,0.27,0.61,61.94,48,30,78,58,48,10,1.34,82.76,Facile,Moyen,-1,Plus Difficile,Adapte,Sociology
6554,2020,Sociologie,2,Histoire de la Pensee Economique,4,L'Analyse Marxiste,14,1000,14,QCU,0.38,0.56,61.94,51,31,82,82,51,31,1.0,62.2,Moyen,Moyen,0,Meme Difficulté,Adapte,Sociology
1000,2015,Sociologie,2,Histoire de la Pensee Economique,5,La Revolution Keynesienne,7,1001,1,QROC,0.11,0.96,85.94,40,7,47,42,40,2,1.12,95.24,Facile,Facile,0,Meme Difficulté,Pas Adapte,Sociology
2111,2016,Sociologie,2,Histoire de la Pensee Economique,5,La Revolution Keynesienne,7,1001,1,QROC,0.2,0.31,57.22,24,18,42,32,24,8,1.31,75.0,Moyen,Moyen,0,Meme Difficulté,Pas Adapte,Sociology
3222,2017,Sociologie,2,Histoire de la Pensee Economique,5,La Revolution Keynesienne,7,1001,1,QO,0.02,0.32,82.48,32,7,39,38,32,6,1.03,84.21,Facile,Facile,0,Meme Difficulté,Pas Adapte,Sociology
4333,2018,Sociologie,2,Histoire de la Pensee Economique,5,La Revolution Keynesienne,7,1001,1,QO,0.17,0.98,90.96,38,4,42,42,38,4,1.0,90.48,Facile,Facile,0,Meme Difficulté,Pas Adapte,Sociology
5444,2019,Sociologie,2,Histoire de la Pensee Economique,5,La Revolution Keynesienne,7,1001,1,QO,0.87,0.02,24.45,11,35,46,43,11,32,1.07,25.58,Moyen,Difficile,-1,Plus Difficile,Pas Adapte,Sociology
6555,2020,Sociologie,2,Histoire de la Pensee Economique,5,La Revolution Keynesienne,7,1001,1,QO,0.63,0.23,43.91,18,24,42,29,18,11,1.45,62.07,Moyen,Moyen,0,Meme Difficulté,Pas Adapte,Sociology
1001,2015,Sociologie,2,Histoire de la Pensee Economique,5,La Revolution Keynesienne,7,1002,2,QROC,0.1,0.68,67.28,14,7,21,18,14,4,1.17,77.78,Difficile,Facile,2,Beaucoup plus Facile,Adapte,Sociology
2112,2016,Sociologie,2,Histoire de la Pensee Economique,5,La Revolution Keynesienne,7,1002,2,QROC,0.08,0.69,67.28,15,7,22,19,15,4,1.16,78.95,Facile,Facile,0,Meme Difficulté,Adapte,Sociology
3223,2017,Sociologie,2,Histoire de la Pensee Economique,5,La Revolution Keynesienne,7,1002,2,QROC,0.16,0.95,67.28,16,8,24,20,16,4,1.2,80.0,Facile,Facile,0,Meme Difficulté,Adapte,Sociology
4334,2018,Sociologie,2,Histoire de la Pensee Economique,5,La Revolution Keynesienne,7,1002,2,QROC,0.17,0.58,67.28,19,9,28,19,19,0,1.47,100.0,Facile,Facile,0,Meme Difficulté,Adapte,Sociology
5445,2019,Sociologie,2,Histoire de la Pensee Economique,5,La Revolution Keynesienne,7,1002,2,QROC,0.14,0.85,67.28,17,8,25,18,17,1,1.39,94.44,Facile,Facile,0,Meme Difficulté,Adapte,Sociology
6556,2020,Sociologie,2,Histoire de la Pensee Economique,5,La Revolution Keynesienne,7,1002,2,QO,0.1,0.99,67.28,17,9,26,21,17,4,1.24,80.95,Facile,Facile,0,Meme Difficulté,Adapte,Sociology
1002,2015,Sociologie,2,Histoire de la Pensee Economique,5,La Revolution Keynesienne,7,1003,3,QO,0.85,0.15,33.98,5,9,14,10,5,5,1.4,50.0,Difficile,Difficile,0,Meme Difficulté,Pas Adapte,Sociology
2113,2016,Sociologie,2,Histoire de la Pensee Economique,5,La Revolution Keynesienne,7,1003,3,QO,0.98,0.14,10.89,1,11,12,9,1,8,1.33,11.11,Difficile,Difficile,0,Meme Difficulté,Pas Adapte,Sociology
3224,2017,Sociologie,2,Histoire de la Pensee Economique,5,La Revolution Keynesienne,7,1003,3,QO,0.76,0.03,19.69,3,10,13,11,3,8,1.18,27.27,Difficile,Difficile,0,Meme Difficulté,Pas Adapte,Sociology
4335,2018,Sociologie,2,Histoire de la Pensee Economique,5,La Revolution Keynesienne,7,1003,3,QO,0.88,0.15,8.53,1,10,11,6,1,5,1.83,16.67,Facile,Difficile,-2,Beaucoup plus Difficile,Pas Adapte,Sociology
5446,2019,Sociologie,2,Histoire de la Pensee Economique,5,La Revolution Keynesienne,7,1003,3,QO,0.47,0.26,61.3,7,4,11,10,7,3,1.1,70.0,Moyen,Moyen,0,Meme Difficulté,Adapte,Sociology
6557,2020,Sociologie,2,Histoire de la Pensee Economique,5,La Revolution Keynesienne,7,1003,3,QO,0.66,0.25,61.3,6,3,9,8,6,2,1.12,75.0,Moyen,Moyen,0,Meme Difficulté,Adapte,Sociology
1003,2015,Sociologie,2,Histoire de la Pensee Economique,5,La Revolution Keynesienne,7,1004,4,QCU,0.6,0.38,0.67,0,41,41,20,0,20,2.05,0.0,Difficile,Difficile,0,Meme Difficulté,Pas Adapte,Sociology
2114,2016,Sociologie,2,Histoire de la Pensee Economique,5,La Revolution Keynesienne,7,1004,4,QCU,0.32,0.59,48.7,17,18,35,33,17,16,1.06,51.52,Difficile,Moyen,1,Plus Facile,Pas Adapte,Sociology
3225,2017,Sociologie,2,Histoire de la Pensee Economique,5,La Revolution Keynesienne,7,1004,4,QCU,0.35,0.74,49.23,17,18,35,24,17,7,1.46,70.83,Difficile,Moyen,1,Plus Facile,Pas Adapte,Sociology
4336,2018,Sociologie,2,Histoire de la Pensee Economique,5,La Revolution Keynesienne,7,1004,4,QCU,0.08,0.93,75.21,24,8,32,26,24,2,1.23,92.31,Facile,Facile,0,Meme Difficulté,Pas Adapte,Sociology
5447,2019,Sociologie,2,Histoire de la Pensee Economique,5,La Revolution Keynesienne,7,1004,4,QCU,0.63,0.27,17.47,6,31,37,27,6,21,1.37,22.22,Facile,Difficile,-2,Beaucoup plus Difficile,Pas Adapte,Sociology
6558,2020,Sociologie,2,Histoire de la Pensee Economique,5,La Revolution Keynesienne,7,1004,4,QCU,0.52,0.34,1.48,1,40,41,14,1,13,2.93,7.14,Facile,Difficile,-2,Beaucoup plus Difficile,Pas Adapte,Sociology
1004,2015,Sociologie,2,Histoire de la Pensee Economique,5,La Revolution Keynesienne,7,1005,5,QCU,0.73,0.3,1.73,1,47,48,40,1,39,1.2,2.5,Moyen,Difficile,-1,Plus Difficile,Pas Adapte,Sociology
2115,2016,Sociologie,2,Histoire de la Pensee Economique,5,La Revolution Keynesienne,7,1005,5,QCU,0.11,0.89,94.53,46,3,49,47,46,1,1.04,97.87,Difficile,Facile,2,Beaucoup plus Facile,Pas Adapte,Sociology
3226,2017,Sociologie,2,Histoire de la Pensee Economique,5,La Revolution Keynesienne,7,1005,5,QCU,0.16,0.86,68.8,37,17,54,43,37,6,1.26,86.05,Difficile,Facile,2,Beaucoup plus Facile,Adapte,Sociology
4337,2018,Sociologie,2,Histoire de la Pensee Economique,5,La Revolution Keynesienne,7,1005,5,QCU,0.04,0.78,68.8,33,15,48,36,33,3,1.33,91.67,Facile,Facile,0,Meme Difficulté,Adapte,Sociology
5448,2019,Sociologie,2,Histoire de la Pensee Economique,5,La Revolution Keynesienne,7,1005,5,QCU,0.18,0.95,68.8,38,17,55,47,38,9,1.17,80.85,Facile,Facile,0,Meme Difficulté,Adapte,Sociology
6559,2020,Sociologie,2,Histoire de la Pensee Economique,5,La Revolution Keynesienne,7,1005,5,QCU,0.11,0.76,68.8,39,17,56,42,39,3,1.33,92.86,Facile,Facile,0,Meme Difficulté,Adapte,Sociology
1005,2015,Sociologie,2,Histoire de la Pensee Economique,5,La Revolution Keynesienne,7,1006,6,QCU,0.23,0.44,64.94,29,15,44,32,29,3,1.38,90.62,Moyen,Moyen,0,Meme Difficulté,Adapte,Sociology
2116,2016,Sociologie,2,Histoire de la Pensee Economique,5,La Revolution Keynesienne,7,1006,6,QCU,0.39,0.56,64.94,31,17,48,36,31,5,1.33,86.11,Moyen,Moyen,0,Meme Difficulté,Adapte,Sociology
3227,2017,Sociologie,2,Histoire de la Pensee Economique,5,La Revolution Keynesienne,7,1006,6,QCU,0.35,0.56,64.94,32,17,49,46,32,14,1.07,69.57,Moyen,Moyen,0,Meme Difficulté,Adapte,Sociology
4338,2018,Sociologie,2,Histoire de la Pensee Economique,5,La Revolution Keynesienne,7,1006,6,QCU,0.32,0.65,64.94,29,16,45,40,29,11,1.12,72.5,Moyen,Moyen,0,Meme Difficulté,Adapte,Sociology
5449,2019,Sociologie,2,Histoire de la Pensee Economique,5,La Revolution Keynesienne,7,1006,6,QCU,0.24,0.54,64.94,27,15,42,31,27,4,1.35,87.1,Moyen,Moyen,0,Meme Difficulté,Adapte,Sociology
6560,2020,Sociologie,2,Histoire de la Pensee Economique,5,La Revolution Keynesienne,7,1006,6,QCU,0.29,0.63,64.94,26,14,40,30,26,4,1.33,86.67,Moyen,Moyen,0,Meme Difficulté,Adapte,Sociology
1006,2015,Sociologie,2,Histoire de la Pensee Economique,5,La Revolution Keynesienne,7,1007,7,QCM,0.17,0.88,90.99,84,8,92,88,84,4,1.05,95.45,Moyen,Facile,1,Plus Facile,Pas Adapte,Sociology
2117,2016,Sociologie,2,Histoire de la Pensee Economique,5,La Revolution Keynesienne,7,1007,7,QCM,0.48,0.37,62.98,50,29,79,54,50,4,1.46,92.59,Facile,Moyen,-1,Plus Difficile,Adapte,Sociology
3228,2017,Sociologie,2,Histoire de la Pensee Economique,5,La Revolution Keynesienne,7,1007,7,QCM,0.24,0.47,62.98,42,25,67,55,42,13,1.22,76.36,Moyen,Moyen,0,Meme Difficulté,Adapte,Sociology
4339,2018,Sociologie,2,Histoire de la Pensee Economique,5,La Revolution Keynesienne,7,1007,7,QCM,0.25,0.41,62.98,38,23,61,45,38,7,1.36,84.44,Moyen,Moyen,0,Meme Difficulté,Adapte,Sociology
5450,2019,Sociologie,2,Histoire de la Pensee Economique,5,La Revolution Keynesienne,7,1007,7,QCU,0.3,0.49,62.98,36,21,57,52,36,16,1.1,69.23,Moyen,Moyen,0,Meme Difficulté,Adapte,Sociology
6561,2020,Sociologie,2,Histoire de la Pensee Economique,5,La Revolution Keynesienne,7,1007,7,QCM,0.29,0.62,62.98,31,18,49,41,31,10,1.2,75.61,Moyen,Moyen,0,Meme Difficulté,Adapte,Sociology
1007,2015,Sociologie,3,"Travail, Emploi, Chomage",1,Caracteristiques de l'Emploi et du Chomage,5,1008,1,QROC,0.05,0.58,67.04,4,2,6,6,4,2,1.0,66.67,Difficile,Facile,2,Beaucoup plus Facile,Adapte,Sociology
2118,2016,Sociologie,3,"Travail, Emploi, Chomage",1,Caracteristiques de l'Emploi et du Chomage,5,1008,1,QCM,0.15,0.81,67.04,5,2,7,5,5,0,1.4,100.0,Facile,Facile,0,Meme Difficulté,Adapte,Sociology
3229,2017,Sociologie,3,"Travail, Emploi, Chomage",1,Caracteristiques de l'Emploi et du Chomage,5,1008,1,QCM,0.07,0.8,67.04,5,2,7,6,5,1,1.17,83.33,Facile,Facile,0,Meme Difficulté,Adapte,Sociology
4340,2018,Sociologie,3,"Travail, Emploi, Chomage",1,Caracteristiques de l'Emploi et du Chomage,5,1008,1,QCM,0.06,0.95,67.04,4,2,6,5,4,1,1.2,80.0,Facile,Facile,0,Meme Difficulté,Adapte,Sociology
5451,2019,Sociologie,3,"Travail, Emploi, Chomage",1,Caracteristiques de l'Emploi et du Chomage,5,1008,1,QCU,0.0,0.79,67.04,5,2,7,5,5,0,1.4,100.0,Facile,Facile,0,Meme Difficulté,Adapte,Sociology
6562,2020,Sociologie,3,"Travail, Emploi, Chomage",1,Caracteristiques de l'Emploi et du Chomage,5,1008,1,QCM,0.18,0.95,67.04,4,2,6,5,4,1,1.2,80.0,Facile,Facile,0,Meme Difficulté,Adapte,Sociology
1008,2015,Sociologie,3,"Travail, Emploi, Chomage",1,Caracteristiques de l'Emploi et du Chomage,5,1009,2,QCU,0.34,0.7,48.9,25,27,52,49,25,24,1.06,51.02,Difficile,Moyen,1,Plus Facile,Pas Adapte,Sociology
2119,2016,Sociologie,3,"Travail, Emploi, Chomage",1,Caracteristiques de l'Emploi et du Chomage,5,1009,2,QCU,0.02,0.8,97.58,55,1,56,55,55,0,1.02,100.0,Facile,Facile,0,Meme Difficulté,Pas Adapte,Sociology
3230,2017,Sociologie,3,"Travail, Emploi, Chomage",1,Caracteristiques de l'Emploi et du Chomage,5,1009,2,QCU,0.07,0.83,74.53,36,12,48,40,36,4,1.2,90.0,Facile,Facile,0,Meme Difficulté,Adapte,Sociology
4341,2018,Sociologie,3,"Travail, Emploi, Chomage",1,Caracteristiques de l'Emploi et du Chomage,5,1009,2,QCU,0.18,0.84,74.53,40,14,54,41,40,1,1.32,97.56,Facile,Facile,0,Meme Difficulté,Adapte,Sociology
5452,2019,Sociologie,3,"Travail, Emploi, Chomage",1,Caracteristiques de l'Emploi et du Chomage,5,1009,2,QCM,0.05,0.79,74.53,45,15,60,54,45,9,1.11,83.33,Facile,Facile,0,Meme Difficulté,Adapte,Sociology
6563,2020,Sociologie,3,"Travail, Emploi, Chomage",1,Caracteristiques de l'Emploi et du Chomage,5,1009,2,QCM,0.2,0.73,74.53,40,14,54,48,40,8,1.12,83.33,Facile,Facile,0,Meme Difficulté,Adapte,Sociology
1009,2015,Sociologie,3,"Travail, Emploi, Chomage",1,Caracteristiques de l'Emploi et du Chomage,5,1010,3,QCU,0.03,0.92,79.72,63,16,79,70,63,7,1.13,90.0,Difficile,Facile,2,Beaucoup plus Facile,Pas Adapte,Sociology
2120,2016,Sociologie,3,"Travail, Emploi, Chomage",1,Caracteristiques de l'Emploi et du Chomage,5,1010,3,QCU,0.05,0.79,96.21,79,3,82,81,79,2,1.01,97.53,Facile,Facile,0,Meme Difficulté,Pas Adapte,Sociology
3231,2017,Sociologie,3,"Travail, Emploi, Chomage",1,Caracteristiques de l'Emploi et du Chomage,5,1010,3,QCU,0.7,0.22,29.05,26,64,90,57,26,31,1.58,45.61,Difficile,Difficile,0,Meme Difficulté,Pas Adapte,Sociology
4342,2018,Sociologie,3,"Travail, Emploi, Chomage",1,Caracteristiques de l'Emploi et du Chomage,5,1010,3,QCU,0.29,0.68,42.19,42,58,100,88,42,46,1.14,47.73,Moyen,Moyen,0,Meme Difficulté,Pas Adapte,Sociology
5453,2019,Sociologie,3,"Travail, Emploi, Chomage",1,Caracteristiques de l'Emploi et du Chomage,5,1010,3,QCU,0.14,0.95,92.24,106,9,115,107,106,1,1.07,99.07,Difficile,Facile,2,Beaucoup plus Facile,Pas Adapte,Sociology
6564,2020,Sociologie,3,"Travail, Emploi, Chomage",1,Caracteristiques de l'Emploi et du Chomage,5,1010,3,QCU,0.51,0.4,12.18,13,94,107,78,13,65,1.37,16.67,Moyen,Difficile,-1,Plus Difficile,Pas Adapte,Sociology
1010,2015,Sociologie,3,"Travail, Emploi, Chomage",1,Caracteristiques de l'Emploi et du Chomage,5,1011,4,QCM,0.37,0.42,54.51,11,9,20,13,11,2,1.54,84.62,Moyen,Moyen,0,Meme Difficulté,Pas Adapte,Sociology
2121,2016,Sociologie,3,"Travail, Emploi, Chomage",1,Caracteristiques de l'Emploi et du Chomage,5,1011,4,QCM,0.28,0.4,48.2,9,10,19,16,9,7,1.19,56.25,Facile,Moyen,-1,Plus Difficile,Pas Adapte,Sociology
3232,2017,Sociologie,3,"Travail, Emploi, Chomage",1,Caracteristiques de l'Emploi et du Chomage,5,1011,4,QCU,0.1,0.9,69.36,14,6,20,16,14,2,1.25,87.5,Difficile,Facile,2,Beaucoup plus Facile,Adapte,Sociology
4343,2018,Sociologie,3,"Travail, Emploi, Chomage",1,Caracteristiques de l'Emploi et du Chomage,5,1011,4,QCU,0.13,0.78,69.36,15,6,21,19,15,4,1.11,78.95,Facile,Facile,0,Meme Difficulté,Adapte,Sociology
5454,2019,Sociologie,3,"Travail, Emploi, Chomage",1,Caracteristiques de l'Emploi et du Chomage,5,1011,4,QCU,0.02,0.85,69.36,15,6,21,16,15,1,1.31,93.75,Facile,Facile,0,Meme Difficulté,Adapte,Sociology
6565,2020,Sociologie,3,"Travail, Emploi, Chomage",1,Caracteristiques de l'Emploi et du Chomage,5,1011,4,QCM,0.04,0.8,69.36,14,6,20,15,14,1,1.33,93.33,Facile,Facile,0,Meme Difficulté,Adapte,Sociology
1011,2015,Sociologie,3,"Travail, Emploi, Chomage",1,Caracteristiques de l'Emploi et du Chomage,5,1012,5,QROC,0.97,0.16,17.92,5,24,29,21,5,16,1.38,23.81,Moyen,Difficile,-1,Plus Difficile,Pas Adapte,Sociology
2122,2016,Sociologie,3,"Travail, Emploi, Chomage",1,Caracteristiques de l'Emploi et du Chomage,5,1012,5,QROC,0.89,0.02,34.21,9,17,26,15,9,6,1.73,60.0,Facile,Difficile,-2,Beaucoup plus Difficile,Pas Adapte,Sociology
3233,2017,Sociologie,3,"Travail, Emploi, Chomage",1,Caracteristiques de l'Emploi et du Chomage,5,1012,5,QROC,0.98,0.07,16.49,4,18,22,20,4,16,1.1,20.0,Difficile,Difficile,0,Meme Difficulté,Pas Adapte,Sociology
4344,2018,Sociologie,3,"Travail, Emploi, Chomage",1,Caracteristiques de l'Emploi et du Chomage,5,1012,5,QROC,0.76,0.05,34.65,8,15,23,21,8,13,1.1,38.1,Facile,Difficile,-2,Beaucoup plus Difficile,Pas Adapte,Sociology
5455,2019,Sociologie,3,"Travail, Emploi, Chomage",1,Caracteristiques de l'Emploi et du Chomage,5,1012,5,QROC,0.17,0.68,68.69,18,8,26,21,18,3,1.24,85.71,Facile,Facile,0,Meme Difficulté,Adapte,Sociology
6566,2020,Sociologie,3,"Travail, Emploi, Chomage",1,Caracteristiques de l'Emploi et du Chomage,5,1012,5,QROC,0.14,0.59,68.69,20,9,29,26,20,6,1.12,76.92,Facile,Facile,0,Meme Difficulté,Adapte,Sociology
1012,2015,Sociologie,3,"Travail, Emploi, Chomage",2,Fonctionnement du Marche du Chomage dans les Theories Economiques,8,1013,1,QCM,0.66,0.29,30.47,26,59,85,85,26,59,1.0,30.59,Facile,Difficile,-2,Beaucoup plus Difficile,Pas Adapte,Sociology
2123,2016,Sociologie,3,"Travail, Emploi, Chomage",2,Fonctionnement du Marche du Chomage dans les Theories Economiques,8,1013,1,QCM,0.52,0.19,7.4,7,87,94,78,7,71,1.21,8.97,Difficile,Difficile,0,Meme Difficulté,Pas Adapte,Sociology
3234,2017,Sociologie,3,"Travail, Emploi, Chomage",2,Fonctionnement du Marche du Chomage dans les Theories Economiques,8,1013,1,QO,0.18,0.78,80.28,72,18,90,74,72,2,1.22,97.3,Facile,Facile,0,Meme Difficulté,Pas Adapte,Sociology
4345,2018,Sociologie,3,"Travail, Emploi, Chomage",2,Fonctionnement du Marche du Chomage dans les Theories Economiques,8,1013,1,QO,0.98,0.02,19.56,16,66,82,72,16,56,1.14,22.22,Moyen,Difficile,-1,Plus Difficile,Pas Adapte,Sociology
5456,2019,Sociologie,3,"Travail, Emploi, Chomage",2,Fonctionnement du Marche du Chomage dans les Theories Economiques,8,1013,1,QO,0.84,0.13,14.62,14,80,94,49,14,35,1.92,28.57,Facile,Difficile,-2,Beaucoup plus Difficile,Pas Adapte,Sociology
6567,2020,Sociologie,3,"Travail, Emploi, Chomage",2,Fonctionnement du Marche du Chomage dans les Theories Economiques,8,1013,1,QO,0.16,0.46,94.52,101,6,107,105,101,4,1.02,96.19,Difficile,Facile,2,Beaucoup plus Facile,Pas Adapte,Sociology
1013,2015,Sociologie,3,"Travail, Emploi, Chomage",2,Fonctionnement du Marche du Chomage dans les Theories Economiques,8,1014,2,QCU,0.61,0.38,27.15,16,42,58,58,16,42,1.0,27.59,Difficile,Difficile,0,Meme Difficulté,Pas Adapte,Sociology
2124,2016,Sociologie,3,"Travail, Emploi, Chomage",2,Fonctionnement du Marche du Chomage dans les Theories Economiques,8,1014,2,QCU,0.15,0.94,71.22,38,16,54,40,38,2,1.35,95.0,Facile,Facile,0,Meme Difficulté,Adapte,Sociology
3235,2017,Sociologie,3,"Travail, Emploi, Chomage",2,Fonctionnement du Marche du Chomage dans les Theories Economiques,8,1014,2,QCM,0.17,0.97,71.22,43,17,60,56,43,13,1.07,76.79,Facile,Facile,0,Meme Difficulté,Adapte,Sociology
4346,2018,Sociologie,3,"Travail, Emploi, Chomage",2,Fonctionnement du Marche du Chomage dans les Theories Economiques,8,1014,2,QCM,0.08,0.71,71.22,36,15,51,45,36,9,1.13,80.0,Facile,Facile,0,Meme Difficulté,Adapte,Sociology
5457,2019,Sociologie,3,"Travail, Emploi, Chomage",2,Fonctionnement du Marche du Chomage dans les Theories Economiques,8,1014,2,QCM,0.16,0.87,71.22,36,14,50,47,36,11,1.06,76.6,Facile,Facile,0,Meme Difficulté,Adapte,Sociology
6568,2020,Sociologie,3,"Travail, Emploi, Chomage",2,Fonctionnement du Marche du Chomage dans les Theories Economiques,8,1014,2,QCM,0.19,0.93,71.22,35,14,49,40,35,5,1.23,87.5,Facile,Facile,0,Meme Difficulté,Adapte,Sociology
1014,2015,Sociologie,3,"Travail, Emploi, Chomage",2,Fonctionnement du Marche du Chomage dans les Theories Economiques,8,1015,3,QCM,0.77,0.16,16.47,3,15,18,6,3,3,3.0,50.0,Moyen,Difficile,-1,Plus Difficile,Pas Adapte,Sociology
2125,2016,Sociologie,3,"Travail, Emploi, Chomage",2,Fonctionnement du Marche du Chomage dans les Theories Economiques,8,1015,3,QCM,0.68,0.23,31.43,5,10,15,12,5,7,1.25,41.67,Facile,Difficile,-2,Beaucoup plus Difficile,Pas Adapte,Sociology
3236,2017,Sociologie,3,"Travail, Emploi, Chomage",2,Fonctionnement du Marche du Chomage dans les Theories Economiques,8,1015,3,QCM,0.53,0.26,11.16,2,14,16,14,2,12,1.14,14.29,Facile,Difficile,-2,Beaucoup plus Difficile,Pas Adapte,Sociology
4347,2018,Sociologie,3,"Travail, Emploi, Chomage",2,Fonctionnement du Marche du Chomage dans les Theories Economiques,8,1015,3,QCM,0.08,0.91,74.09,12,4,16,16,12,4,1.0,75.0,Difficile,Facile,2,Beaucoup plus Facile,Adapte,Sociology
5458,2019,Sociologie,3,"Travail, Emploi, Chomage",2,Fonctionnement du Marche du Chomage dans les Theories Economiques,8,1015,3,QROC,0.13,0.96,74.09,12,4,16,16,12,4,1.0,75.0,Facile,Facile,0,Meme Difficulté,Adapte,Sociology
6569,2020,Sociologie,3,"Travail, Emploi, Chomage",2,Fonctionnement du Marche du Chomage dans les Theories Economiques,8,1015,3,QROC,0.08,0.94,74.09,10,4,14,10,10,0,1.4,100.0,Facile,Facile,0,Meme Difficulté,Adapte,Sociology
1015,2015,Sociologie,3,"Travail, Emploi, Chomage",2,Fonctionnement du Marche du Chomage dans les Theories Economiques,8,1016,4,QCM,0.14,0.7,93.94,79,5,84,80,79,1,1.05,98.75,Moyen,Facile,1,Plus Facile,Pas Adapte,Sociology
2126,2016,Sociologie,3,"Travail, Emploi, Chomage",2,Fonctionnement du Marche du Chomage dans les Theories Economiques,8,1016,4,QO,0.64,0.18,45.05,36,45,81,47,36,11,1.72,76.6,Difficile,Moyen,1,Plus Facile,Pas Adapte,Sociology
3237,2017,Sociologie,3,"Travail, Emploi, Chomage",2,Fonctionnement du Marche du Chomage dans les Theories Economiques,8,1016,4,QO,0.05,0.33,85.26,76,13,89,86,76,10,1.03,88.37,Difficile,Facile,2,Beaucoup plus Facile,Pas Adapte,Sociology
4348,2018,Sociologie,3,"Travail, Emploi, Chomage",2,Fonctionnement du Marche du Chomage dans les Theories Economiques,8,1016,4,QO,0.82,0.06,27.79,25,66,91,74,25,49,1.23,33.78,Facile,Difficile,-2,Beaucoup plus Difficile,Pas Adapte,Sociology
5459,2019,Sociologie,3,"Travail, Emploi, Chomage",2,Fonctionnement du Marche du Chomage dans les Theories Economiques,8,1016,4,QO,0.87,0.02,20.78,16,61,77,39,16,23,1.97,41.03,Moyen,Difficile,-1,Plus Difficile,Pas Adapte,Sociology
6570,2020,Sociologie,3,"Travail, Emploi, Chomage",2,Fonctionnement du Marche du Chomage dans les Theories Economiques,8,1016,4,QO,0.68,0.28,44.84,33,40,73,63,33,30,1.16,52.38,Facile,Moyen,-1,Plus Difficile,Pas Adapte,Sociology
1016,2015,Sociologie,3,"Travail, Emploi, Chomage",2,Fonctionnement du Marche du Chomage dans les Theories Economiques,8,1017,5,QCM,0.79,0.3,27.3,8,21,29,13,8,5,2.23,61.54,Difficile,Difficile,0,Meme Difficulté,Pas Adapte,Sociology
2127,2016,Sociologie,3,"Travail, Emploi, Chomage",2,Fonctionnement du Marche du Chomage dans les Theories Economiques,8,1017,5,QCM,0.11,0.8,77.63,25,7,32,30,25,5,1.07,83.33,Difficile,Facile,2,Beaucoup plus Facile,Pas Adapte,Sociology
3238,2017,Sociologie,3,"Travail, Emploi, Chomage",2,Fonctionnement du Marche du Chomage dans les Theories Economiques,8,1017,5,QCM,0.3,0.7,39.41,13,19,32,21,13,8,1.52,61.9,Facile,Moyen,-1,Plus Difficile,Pas Adapte,Sociology
4349,2018,Sociologie,3,"Travail, Emploi, Chomage",2,Fonctionnement du Marche du Chomage dans les Theories Economiques,8,1017,5,QCM,0.0,0.91,87.08,29,4,33,33,29,4,1.0,87.88,Moyen,Facile,1,Plus Facile,Pas Adapte,Sociology
5460,2019,Sociologie,3,"Travail, Emploi, Chomage",2,Fonctionnement du Marche du Chomage dans les Theories Economiques,8,1017,5,QCM,0.07,0.98,87.48,31,4,35,32,31,1,1.09,96.88,Difficile,Facile,2,Beaucoup plus Facile,Pas Adapte,Sociology
6571,2020,Sociologie,3,"Travail, Emploi, Chomage",2,Fonctionnement du Marche du Chomage dans les Theories Economiques,8,1017,5,QCM,0.11,0.98,69.96,24,10,34,25,24,1,1.36,96.0,Facile,Facile,0,Meme Difficulté,Adapte,Sociology
1017,2015,Sociologie,3,"Travail, Emploi, Chomage",2,Fonctionnement du Marche du Chomage dans les Theories Economiques,8,1018,6,QCM,0.69,0.2,11.77,6,42,48,17,6,11,2.82,35.29,Difficile,Difficile,0,Meme Difficulté,Pas Adapte,Sociology
2128,2016,Sociologie,3,"Travail, Emploi, Chomage",2,Fonctionnement du Marche du Chomage dans les Theories Economiques,8,1018,6,QCM,0.77,0.22,14.94,8,46,54,15,8,7,3.6,53.33,Difficile,Difficile,0,Meme Difficulté,Pas Adapte,Sociology
3239,2017,Sociologie,3,"Travail, Emploi, Chomage",2,Fonctionnement du Marche du Chomage dans les Theories Economiques,8,1018,6,QCM,0.17,0.87,89.96,44,5,49,46,44,2,1.07,95.65,Difficile,Facile,2,Beaucoup plus Facile,Pas Adapte,Sociology
4350,2018,Sociologie,3,"Travail, Emploi, Chomage",2,Fonctionnement du Marche du Chomage dans les Theories Economiques,8,1018,6,QROC,0.8,0.1,2.85,2,52,54,24,2,22,2.25,8.33,Moyen,Difficile,-1,Plus Difficile,Pas Adapte,Sociology
5461,2019,Sociologie,3,"Travail, Emploi, Chomage",2,Fonctionnement du Marche du Chomage dans les Theories Economiques,8,1018,6,QROC,0.66,0.21,21.58,11,40,51,26,11,15,1.96,42.31,Facile,Difficile,-2,Beaucoup plus Difficile,Pas Adapte,Sociology
6572,2020,Sociologie,3,"Travail, Emploi, Chomage",2,Fonctionnement du Marche du Chomage dans les Theories Economiques,8,1018,6,QO,0.38,0.26,49.13,24,24,48,36,24,12,1.33,66.67,Moyen,Moyen,0,Meme Difficulté,Pas Adapte,Sociology
1018,2015,Sociologie,3,"Travail, Emploi, Chomage",2,Fonctionnement du Marche du Chomage dans les Theories Economiques,8,1019,7,QCM,0.47,0.44,39.41,9,13,22,16,9,7,1.38,56.25,Difficile,Moyen,1,Plus Facile,Pas Adapte,Sociology
2129,2016,Sociologie,3,"Travail, Emploi, Chomage",2,Fonctionnement du Marche du Chomage dans les Theories Economiques,8,1019,7,QCM,0.06,0.72,91.07,19,2,21,20,19,1,1.05,95.0,Difficile,Facile,2,Beaucoup plus Facile,Pas Adapte,Sociology
3240,2017,Sociologie,3,"Travail, Emploi, Chomage",2,Fonctionnement du Marche du Chomage dans les Theories Economiques,8,1019,7,QCM,0.42,0.31,57.93,12,9,21,19,12,7,1.11,63.16,Facile,Moyen,-1,Plus Difficile,Pas Adapte,Sociology
4351,2018,Sociologie,3,"Travail, Emploi, Chomage",2,Fonctionnement du Marche du Chomage dans les Theories Economiques,8,1019,7,QCM,0.51,0.25,15.28,3,18,21,12,3,9,1.75,25.0,Facile,Difficile,-2,Beaucoup plus Difficile,Pas Adapte,Sociology
5462,2019,Sociologie,3,"Travail, Emploi, Chomage",2,Fonctionnement du Marche du Chomage dans les Theories Economiques,8,1019,7,QCM,0.57,0.21,1.51,0,18,18,6,0,6,3.0,0.0,Difficile,Difficile,0,Meme Difficulté,Pas Adapte,Sociology
6573,2020,Sociologie,3,"Travail, Emploi, Chomage",2,Fonctionnement du Marche du Chomage dans les Theories Economiques,8,1019,7,QCM,0.8,0.2,10.5,2,19,21,20,2,18,1.05,10.0,Difficile,Difficile,0,Meme Difficulté,Pas Adapte,Sociology
1019,2015,Sociologie,3,"Travail, Emploi, Chomage",2,Fonctionnement du Marche du Chomage dans les Theories Economiques,8,1020,8,QROC,0.12,0.7,95.77,77,3,80,77,77,0,1.04,100.0,Facile,Facile,0,Meme Difficulté,Pas Adapte,Sociology
2130,2016,Sociologie,3,"Travail, Emploi, Chomage",2,Fonctionnement du Marche du Chomage dans les Theories Economiques,8,1020,8,QROC,0.08,0.83,94.48,68,4,72,71,68,3,1.01,95.77,Moyen,Facile,1,Plus Facile,Pas Adapte,Sociology
3241,2017,Sociologie,3,"Travail, Emploi, Chomage",2,Fonctionnement du Marche du Chomage dans les Theories Economiques,8,1020,8,QROC,0.39,0.28,37.53,27,45,72,50,27,23,1.44,54.0,Facile,Moyen,-1,Plus Difficile,Pas Adapte,Sociology
4352,2018,Sociologie,3,"Travail, Emploi, Chomage",2,Fonctionnement du Marche du Chomage dans les Theories Economiques,8,1020,8,QROC,0.53,0.34,43.95,32,40,72,71,32,39,1.01,45.07,Moyen,Moyen,0,Meme Difficulté,Pas Adapte,Sociology
5463,2019,Sociologie,3,"Travail, Emploi, Chomage",2,Fonctionnement du Marche du Chomage dans les Theories Economiques,8,1020,8,QROC,0.15,0.7,96.62,59,2,61,60,59,1,1.02,98.33,Moyen,Facile,1,Plus Facile,Pas Adapte,Sociology
6574,2020,Sociologie,3,"Travail, Emploi, Chomage",2,Fonctionnement du Marche du Chomage dans les Theories Economiques,8,1020,8,QROC,0.16,0.67,99.3,62,0,62,62,62,0,1.0,100.0,Facile,Facile,0,Meme Difficulté,Pas Adapte,Sociology
1020,2015,Sociologie,3,"Travail, Emploi, Chomage",3,Les Actions pour l'Emploi,9,1021,1,QCU,0.18,0.8,83.58,60,12,72,71,60,11,1.01,84.51,Moyen,Facile,1,Plus Facile,Pas Adapte,Sociology
2131,2016,Sociologie,3,"Travail, Emploi, Chomage",3,Les Actions pour l'Emploi,9,1021,1,QCU,0.27,0.59,52.98,35,32,67,59,35,24,1.14,59.32,Difficile,Moyen,1,Plus Facile,Pas Adapte,Sociology
3242,2017,Sociologie,3,"Travail, Emploi, Chomage",3,Les Actions pour l'Emploi,9,1021,1,QCU,0.3,0.61,41.01,28,40,68,57,28,29,1.19,49.12,Difficile,Moyen,1,Plus Facile,Pas Adapte,Sociology
4353,2018,Sociologie,3,"Travail, Emploi, Chomage",3,Les Actions pour l'Emploi,9,1021,1,QCU,0.27,0.43,52.9,38,34,72,58,38,20,1.24,65.52,Moyen,Moyen,0,Meme Difficulté,Pas Adapte,Sociology
5464,2019,Sociologie,3,"Travail, Emploi, Chomage",3,Les Actions pour l'Emploi,9,1021,1,QCU,0.01,0.87,93.11,75,6,81,77,75,2,1.05,97.4,Moyen,Facile,1,Plus Facile,Pas Adapte,Sociology
6575,2020,Sociologie,3,"Travail, Emploi, Chomage",3,Les Actions pour l'Emploi,9,1021,1,QCU,0.74,0.34,16.26,12,63,75,57,12,45,1.32,21.05,Difficile,Difficile,0,Meme Difficulté,Pas Adapte,Sociology
1021,2015,Sociologie,3,"Travail, Emploi, Chomage",3,Les Actions pour l'Emploi,9,1022,2,QROC,0.21,0.35,55.12,25,20,45,26,25,1,1.73,96.15,Moyen,Moyen,0,Meme Difficulté,Pas Adapte,Sociology
2132,2016,Sociologie,3,"Travail, Emploi, Chomage",3,Les Actions pour l'Emploi,9,1022,2,QO,0.09,0.81,80.0,41,10,51,48,41,7,1.06,85.42,Moyen,Facile,1,Plus Facile,Pas Adapte,Sociology
3243,2017,Sociologie,3,"Travail, Emploi, Chomage",3,Les Actions pour l'Emploi,9,1022,2,QROC,0.02,0.89,67.69,32,15,47,37,32,5,1.27,86.49,Difficile,Facile,2,Beaucoup plus Facile,Adapte,Sociology
4354,2018,Sociologie,3,"Travail, Emploi, Chomage",3,Les Actions pour l'Emploi,9,1022,2,QROC,0.15,0.44,67.69,31,15,46,46,31,15,1.0,67.39,Facile,Facile,0,Meme Difficulté,Adapte,Sociology
5465,2019,Sociologie,3,"Travail, Emploi, Chomage",3,Les Actions pour l'Emploi,9,1022,2,QROC,0.09,0.77,67.69,33,16,49,36,33,3,1.36,91.67,Facile,Facile,0,Meme Difficulté,Adapte,Sociology
6576,2020,Sociologie,3,"Travail, Emploi, Chomage",3,Les Actions pour l'Emploi,9,1022,2,QROC,0.17,0.99,67.69,38,18,56,38,38,0,1.47,100.0,Facile,Facile,0,Meme Difficulté,Adapte,Sociology
1022,2015,Sociologie,3,"Travail, Emploi, Chomage",3,Les Actions pour l'Emploi,9,1023,3,QROC,0.68,0.23,25.37,20,60,80,52,20,32,1.54,38.46,Moyen,Difficile,-1,Plus Difficile,Pas Adapte,Sociology
2133,2016,Sociologie,3,"Travail, Emploi, Chomage",3,Les Actions pour l'Emploi,9,1023,3,QROC,0.26,0.31,51.64,46,43,89,74,46,28,1.2,62.16,Difficile,Moyen,1,Plus Facile,Pas Adapte,Sociology
3244,2017,Sociologie,3,"Travail, Emploi, Chomage",3,Les Actions pour l'Emploi,9,1023,3,QROC,0.22,0.27,35.52,35,64,99,49,35,14,2.02,71.43,Facile,Moyen,-1,Plus Difficile,Pas Adapte,Sociology
4355,2018,Sociologie,3,"Travail, Emploi, Chomage",3,Les Actions pour l'Emploi,9,1023,3,QO,0.19,0.78,69.88,73,31,104,90,73,17,1.16,81.11,Facile,Facile,0,Meme Difficulté,Adapte,Sociology
5466,2019,Sociologie,3,"Travail, Emploi, Chomage",3,Les Actions pour l'Emploi,9,1023,3,QO,0.13,0.59,69.88,78,33,111,87,78,9,1.28,89.66,Facile,Facile,0,Meme Difficulté,Adapte,Sociology
6577,2020,Sociologie,3,"Travail, Emploi, Chomage",3,Les Actions pour l'Emploi,9,1023,3,QO,0.14,0.75,69.88,68,30,98,95,68,27,1.03,71.58,Facile,Facile,0,Meme Difficulté,Adapte,Sociology
1023,2015,Sociologie,3,"Travail, Emploi, Chomage",3,Les Actions pour l'Emploi,9,1024,4,QROC,0.17,0.42,99.0,62,1,63,63,62,1,1.0,98.41,Difficile,Facile,2,Beaucoup plus Facile,Pas Adapte,Sociology
2134,2016,Sociologie,3,"Travail, Emploi, Chomage",3,Les Actions pour l'Emploi,9,1024,4,QROC,0.92,0.16,25.98,17,47,64,49,17,32,1.31,34.69,Moyen,Difficile,-1,Plus Difficile,Pas Adapte,Sociology
3245,2017,Sociologie,3,"Travail, Emploi, Chomage",3,Les Actions pour l'Emploi,9,1024,4,QROC,0.16,0.67,89.46,64,7,71,65,64,1,1.09,98.46,Difficile,Facile,2,Beaucoup plus Facile,Pas Adapte,Sociology
4356,2018,Sociologie,3,"Travail, Emploi, Chomage",3,Les Actions pour l'Emploi,9,1024,4,QROC,0.36,0.26,57.0,46,35,81,70,46,24,1.16,65.71,Facile,Moyen,-1,Plus Difficile,Pas Adapte,Sociology
5467,2019,Sociologie,3,"Travail, Emploi, Chomage",3,Les Actions pour l'Emploi,9,1024,4,QROC,0.67,0.09,18.23,13,56,69,51,13,38,1.35,25.49,Moyen,Difficile,-1,Plus Difficile,Pas Adapte,Sociology
6578,2020,Sociologie,3,"Travail, Emploi, Chomage",3,Les Actions pour l'Emploi,9,1024,4,QROC,0.06,0.92,71.84,43,17,60,48,43,5,1.25,89.58,Difficile,Facile,2,Beaucoup plus Facile,Adapte,Sociology
1024,2015,Sociologie,3,"Travail, Emploi, Chomage",3,Les Actions pour l'Emploi,9,1025,5,QCU,0.7,0.21,12.55,10,68,78,56,10,46,1.39,17.86,Facile,Difficile,-2,Beaucoup plus Difficile,Pas Adapte,Sociology
2135,2016,Sociologie,3,"Travail, Emploi, Chomage",3,Les Actions pour l'Emploi,9,1025,5,QCU,0.01,0.84,85.67,75,12,87,81,75,6,1.07,92.59,Difficile,Facile,2,Beaucoup plus Facile,Pas Adapte,Sociology
3246,2017,Sociologie,3,"Travail, Emploi, Chomage",3,Les Actions pour l'Emploi,9,1025,5,QROC,0.81,0.14,25.47,24,71,95,81,24,57,1.17,29.63,Facile,Difficile,-2,Beaucoup plus Difficile,Pas Adapte,Sociology
4357,2018,Sociologie,3,"Travail, Emploi, Chomage",3,Les Actions pour l'Emploi,9,1025,5,QROC,0.62,0.15,6.13,5,79,84,82,5,77,1.02,6.1,Difficile,Difficile,0,Meme Difficulté,Pas Adapte,Sociology
5468,2019,Sociologie,3,"Travail, Emploi, Chomage",3,Les Actions pour l'Emploi,9,1025,5,QROC,0.06,0.54,66.1,61,31,92,69,61,8,1.33,88.41,Difficile,Facile,2,Beaucoup plus Facile,Adapte,Sociology
6579,2020,Sociologie,3,"Travail, Emploi, Chomage",3,Les Actions pour l'Emploi,9,1025,5,QROC,0.04,1.0,66.1,68,35,103,102,68,34,1.01,66.67,Facile,Facile,0,Meme Difficulté,Adapte,Sociology
1025,2015,Sociologie,3,"Travail, Emploi, Chomage",3,Les Actions pour l'Emploi,9,1026,6,QCM,0.8,0.21,2.71,1,27,28,12,1,11,2.33,8.33,Facile,Difficile,-2,Beaucoup plus Difficile,Pas Adapte,Sociology
2136,2016,Sociologie,3,"Travail, Emploi, Chomage",3,Les Actions pour l'Emploi,9,1026,6,QCM,0.78,0.29,18.0,5,24,29,21,5,16,1.38,23.81,Difficile,Difficile,0,Meme Difficulté,Pas Adapte,Sociology
3247,2017,Sociologie,3,"Travail, Emploi, Chomage",3,Les Actions pour l'Emploi,9,1026,6,QCM,0.68,0.23,5.51,2,31,33,15,2,13,2.2,13.33,Facile,Difficile,-2,Beaucoup plus Difficile,Pas Adapte,Sociology
4358,2018,Sociologie,3,"Travail, Emploi, Chomage",3,Les Actions pour l'Emploi,9,1026,6,QCM,0.47,0.45,53.72,20,18,38,25,20,5,1.52,80.0,Facile,Moyen,-1,Plus Difficile,Pas Adapte,Sociology
5469,2019,Sociologie,3,"Travail, Emploi, Chomage",3,Les Actions pour l'Emploi,9,1026,6,QCM,0.22,0.63,62.67,21,12,33,25,21,4,1.32,84.0,Facile,Moyen,-1,Plus Difficile,Adapte,Sociology
6580,2020,Sociologie,3,"Travail, Emploi, Chomage",3,Les Actions pour l'Emploi,9,1026,6,QCU,0.27,0.65,62.67,21,12,33,31,21,10,1.06,67.74,Moyen,Moyen,0,Meme Difficulté,Adapte,Sociology
1026,2015,Sociologie,3,"Travail, Emploi, Chomage",3,Les Actions pour l'Emploi,9,1027,7,QCM,0.28,0.41,52.24,34,31,65,43,34,9,1.51,79.07,Difficile,Moyen,1,Plus Facile,Pas Adapte,Sociology
2137,2016,Sociologie,3,"Travail, Emploi, Chomage",3,Les Actions pour l'Emploi,9,1027,7,QCM,0.11,0.99,88.26,49,7,56,52,49,3,1.08,94.23,Difficile,Facile,2,Beaucoup plus Facile,Pas Adapte,Sociology
3248,2017,Sociologie,3,"Travail, Emploi, Chomage",3,Les Actions pour l'Emploi,9,1027,7,QCM,0.09,0.8,77.41,42,12,54,47,42,5,1.15,89.36,Difficile,Facile,2,Beaucoup plus Facile,Pas Adapte,Sociology
4359,2018,Sociologie,3,"Travail, Emploi, Chomage",3,Les Actions pour l'Emploi,9,1027,7,QCM,0.09,0.99,66.64,41,21,62,45,41,4,1.38,91.11,Facile,Facile,0,Meme Difficulté,Adapte,Sociology
5470,2019,Sociologie,3,"Travail, Emploi, Chomage",3,Les Actions pour l'Emploi,9,1027,7,QROC,0.09,0.7,66.64,47,24,71,64,47,17,1.11,73.44,Facile,Facile,0,Meme Difficulté,Adapte,Sociology
6581,2020,Sociologie,3,"Travail, Emploi, Chomage",3,Les Actions pour l'Emploi,9,1027,7,QROC,0.09,0.58,66.64,43,21,64,51,43,8,1.25,84.31,Facile,Facile,0,Meme Difficulté,Adapte,Sociology
1027,2015,Sociologie,3,"Travail, Emploi, Chomage",3,Les Actions pour l'Emploi,9,1028,8,QCM,0.02,0.94,91.18,7,1,8,7,7,0,1.14,100.0,Moyen,Facile,1,Plus Facile,Pas Adapte,Sociology
2138,2016,Sociologie,3,"Travail, Emploi, Chomage",3,Les Actions pour l'Emploi,9,1028,8,QCM,0.68,0.22,14.07,1,8,9,7,1,6,1.29,14.29,Moyen,Difficile,-1,Plus Difficile,Pas Adapte,Sociology
3249,2017,Sociologie,3,"Travail, Emploi, Chomage",3,Les Actions pour l'Emploi,9,1028,8,QCM,0.77,0.28,23.69,2,8,10,9,2,7,1.11,22.22,Moyen,Difficile,-1,Plus Difficile,Pas Adapte,Sociology
4360,2018,Sociologie,3,"Travail, Emploi, Chomage",3,Les Actions pour l'Emploi,9,1028,8,QCM,0.67,0.16,11.36,1,10,11,11,1,10,1.0,9.09,Facile,Difficile,-2,Beaucoup plus Difficile,Pas Adapte,Sociology
5471,2019,Sociologie,3,"Travail, Emploi, Chomage",3,Les Actions pour l'Emploi,9,1028,8,QCM,0.03,0.99,87.71,11,2,13,11,11,0,1.18,100.0,Difficile,Facile,2,Beaucoup plus Facile,Pas Adapte,Sociology
6582,2020,Sociologie,3,"Travail, Emploi, Chomage",3,Les Actions pour l'Emploi,9,1028,8,QCM,0.13,0.96,74.52,11,4,15,11,11,0,1.36,100.0,Facile,Facile,0,Meme Difficulté,Adapte,Sociology
1028,2015,Sociologie,3,"Travail, Emploi, Chomage",3,Les Actions pour l'Emploi,9,1029,9,QCU,0.03,0.94,71.68,16,6,22,20,16,4,1.1,80.0,Facile,Facile,0,Meme Difficulté,Adapte,Sociology
2139,2016,Sociologie,3,"Travail, Emploi, Chomage",3,Les Actions pour l'Emploi,9,1029,9,QCU,0.03,0.89,71.68,14,6,20,17,14,3,1.18,82.35,Facile,Facile,0,Meme Difficulté,Adapte,Sociology
3250,2017,Sociologie,3,"Travail, Emploi, Chomage",3,Les Actions pour l'Emploi,9,1029,9,QCU,0.11,0.9,71.68,16,6,22,17,16,1,1.29,94.12,Facile,Facile,0,Meme Difficulté,Adapte,Sociology
4361,2018,Sociologie,3,"Travail, Emploi, Chomage",3,Les Actions pour l'Emploi,9,1029,9,QCM,0.08,0.85,71.68,18,7,25,23,18,5,1.09,78.26,Facile,Facile,0,Meme Difficulté,Adapte,Sociology
5472,2019,Sociologie,3,"Travail, Emploi, Chomage",3,Les Actions pour l'Emploi,9,1029,9,QCU,0.02,0.84,71.68,16,6,22,20,16,4,1.1,80.0,Facile,Facile,0,Meme Difficulté,Adapte,Sociology
6583,2020,Sociologie,3,"Travail, Emploi, Chomage",3,Les Actions pour l'Emploi,9,1029,9,QCU,0.19,0.83,71.68,16,7,23,16,16,0,1.44,100.0,Facile,Facile,0,Meme Difficulté,Adapte,Sociology
1029,2015,Sociologie,3,"Travail, Emploi, Chomage",4,La Question du Travail,8,1030,1,QCU,0.44,0.31,10.7,9,78,87,58,9,49,1.5,15.52,Difficile,Difficile,0,Meme Difficulté,Pas Adapte,Sociology
2140,2016,Sociologie,3,"Travail, Emploi, Chomage",4,La Question du Travail,8,1030,1,QCU,0.49,0.2,16.44,13,68,81,36,13,23,2.25,36.11,Moyen,Difficile,-1,Plus Difficile,Pas Adapte,Sociology
3251,2017,Sociologie,3,"Travail, Emploi, Chomage",4,La Question du Travail,8,1030,1,QCU,0.44,0.29,0.61,1,91,92,34,1,33,2.71,2.94,Difficile,Difficile,0,Meme Difficulté,Pas Adapte,Sociology
4362,2018,Sociologie,3,"Travail, Emploi, Chomage",4,La Question du Travail,8,1030,1,QCM,0.08,0.7,84.06,67,13,80,77,67,10,1.04,87.01,Moyen,Facile,1,Plus Facile,Pas Adapte,Sociology
5473,2019,Sociologie,3,"Travail, Emploi, Chomage",4,La Question du Travail,8,1030,1,QCU,0.75,0.39,26.61,22,59,81,74,22,52,1.09,29.73,Facile,Difficile,-2,Beaucoup plus Difficile,Pas Adapte,Sociology
6584,2020,Sociologie,3,"Travail, Emploi, Chomage",4,La Question du Travail,8,1030,1,QCU,0.25,0.67,62.91,50,30,80,56,50,6,1.43,89.29,Moyen,Moyen,0,Meme Difficulté,Adapte,Sociology
1030,2015,Sociologie,3,"Travail, Emploi, Chomage",4,La Question du Travail,8,1031,2,QCU,0.6,0.24,34.11,9,17,26,22,9,13,1.18,40.91,Facile,Difficile,-2,Beaucoup plus Difficile,Pas Adapte,Sociology
2141,2016,Sociologie,3,"Travail, Emploi, Chomage",4,La Question du Travail,8,1031,2,QCU,0.15,0.77,81.48,24,6,30,29,24,5,1.03,82.76,Difficile,Facile,2,Beaucoup plus Facile,Pas Adapte,Sociology
3252,2017,Sociologie,3,"Travail, Emploi, Chomage",4,La Question du Travail,8,1031,2,QCU,0.4,0.42,58.23,17,12,29,19,17,2,1.53,89.47,Facile,Moyen,-1,Plus Difficile,Pas Adapte,Sociology
4363,2018,Sociologie,3,"Travail, Emploi, Chomage",4,La Question du Travail,8,1031,2,QCU,0.13,0.84,71.86,21,8,29,25,21,4,1.16,84.0,Moyen,Facile,1,Plus Facile,Adapte,Sociology
5474,2019,Sociologie,3,"Travail, Emploi, Chomage",4,La Question du Travail,8,1031,2,QCU,0.06,0.92,71.86,21,8,29,24,21,3,1.21,87.5,Facile,Facile,0,Meme Difficulté,Adapte,Sociology
6585,2020,Sociologie,3,"Travail, Emploi, Chomage",4,La Question du Travail,8,1031,2,QCU,0.04,0.83,71.86,18,7,25,19,18,1,1.32,94.74,Facile,Facile,0,Meme Difficulté,Adapte,Sociology
1031,2015,Sociologie,3,"Travail, Emploi, Chomage",4,La Question du Travail,8,1032,3,QCM,0.47,0.58,62.71,38,23,61,41,38,3,1.49,92.68,Facile,Moyen,-1,Plus Difficile,Adapte,Sociology
2142,2016,Sociologie,3,"Travail, Emploi, Chomage",4,La Question du Travail,8,1032,3,QCM,0.27,0.5,62.71,34,21,55,45,34,11,1.22,75.56,Moyen,Moyen,0,Meme Difficulté,Adapte,Sociology
3253,2017,Sociologie,3,"Travail, Emploi, Chomage",4,La Question du Travail,8,1032,3,QROC,0.32,0.39,62.71,33,20,53,35,33,2,1.51,94.29,Moyen,Moyen,0,Meme Difficulté,Adapte,Sociology
4364,2018,Sociologie,3,"Travail, Emploi, Chomage",4,La Question du Travail,8,1032,3,QROC,0.2,0.26,62.71,33,20,53,43,33,10,1.23,76.74,Moyen,Moyen,0,Meme Difficulté,Adapte,Sociology
5475,2019,Sociologie,3,"Travail, Emploi, Chomage",4,La Question du Travail,8,1032,3,QROC,0.26,0.32,62.71,28,17,45,40,28,12,1.12,70.0,Moyen,Moyen,0,Meme Difficulté,Adapte,Sociology
6586,2020,Sociologie,3,"Travail, Emploi, Chomage",4,La Question du Travail,8,1032,3,QROC,0.4,0.26,62.71,31,19,50,48,31,17,1.04,64.58,Moyen,Moyen,0,Meme Difficulté,Adapte,Sociology
1032,2015,Sociologie,3,"Travail, Emploi, Chomage",4,La Question du Travail,8,1033,4,QCU,0.63,0.3,27.16,6,17,23,8,6,2,2.88,75.0,Facile,Difficile,-2,Beaucoup plus Difficile,Pas Adapte,Sociology
2143,2016,Sociologie,3,"Travail, Emploi, Chomage",4,La Question du Travail,8,1033,4,QCU,0.24,0.51,40.14,9,13,22,17,9,8,1.29,52.94,Facile,Moyen,-1,Plus Difficile,Pas Adapte,Sociology
3254,2017,Sociologie,3,"Travail, Emploi, Chomage",4,La Question du Travail,8,1033,4,QCU,0.2,0.97,75.98,19,6,25,24,19,5,1.04,79.17,Facile,Facile,0,Meme Difficulté,Pas Adapte,Sociology
4365,2018,Sociologie,3,"Travail, Emploi, Chomage",4,La Question du Travail,8,1033,4,QROC,0.06,0.61,82.36,20,4,24,22,20,2,1.09,90.91,Difficile,Facile,2,Beaucoup plus Facile,Pas Adapte,Sociology
5476,2019,Sociologie,3,"Travail, Emploi, Chomage",4,La Question du Travail,8,1033,4,QO,0.06,0.63,88.61,21,3,24,22,21,1,1.09,95.45,Moyen,Facile,1,Plus Facile,Pas Adapte,Sociology
6587,2020,Sociologie,3,"Travail, Emploi, Chomage",4,La Question du Travail,8,1033,4,QO,0.62,0.27,43.28,10,14,24,13,10,3,1.85,76.92,Facile,Moyen,-1,Plus Difficile,Pas Adapte,Sociology
1033,2015,Sociologie,3,"Travail, Emploi, Chomage",4,La Question du Travail,8,1034,5,QCU,0.66,0.36,10.68,9,74,83,76,9,67,1.09,11.84,Difficile,Difficile,0,Meme Difficulté,Pas Adapte,Sociology
2144,2016,Sociologie,3,"Travail, Emploi, Chomage",4,La Question du Travail,8,1034,5,QCM,0.19,0.79,85.96,61,10,71,69,61,8,1.03,88.41,Difficile,Facile,2,Beaucoup plus Facile,Pas Adapte,Sociology
3255,2017,Sociologie,3,"Travail, Emploi, Chomage",4,La Question du Travail,8,1034,5,QCM,0.76,0.28,4.94,4,69,73,47,4,43,1.55,8.51,Facile,Difficile,-2,Beaucoup plus Difficile,Pas Adapte,Sociology
4366,2018,Sociologie,3,"Travail, Emploi, Chomage",4,La Question du Travail,8,1034,5,QCM,0.73,0.26,14.17,11,67,78,70,11,59,1.11,15.71,Moyen,Difficile,-1,Plus Difficile,Pas Adapte,Sociology
5477,2019,Sociologie,3,"Travail, Emploi, Chomage",4,La Question du Travail,8,1034,5,QCM,0.64,0.18,10.63,10,80,90,85,10,75,1.06,11.76,Facile,Difficile,-2,Beaucoup plus Difficile,Pas Adapte,Sociology
6588,2020,Sociologie,3,"Travail, Emploi, Chomage",4,La Question du Travail,8,1034,5,QCM,0.56,0.24,9.41,7,69,76,43,7,36,1.77,16.28,Moyen,Difficile,-1,Plus Difficile,Pas Adapte,Sociology
1034,2015,Sociologie,3,"Travail, Emploi, Chomage",4,La Question du Travail,8,1035,6,QCM,0.15,0.72,94.43,52,3,55,54,52,2,1.02,96.3,Difficile,Facile,2,Beaucoup plus Facile,Pas Adapte,Sociology
2145,2016,Sociologie,3,"Travail, Emploi, Chomage",4,La Question du Travail,8,1035,6,QCM,0.29,0.47,61.75,31,19,50,47,31,16,1.06,65.96,Difficile,Moyen,1,Plus Facile,Adapte,Sociology
3256,2017,Sociologie,3,"Travail, Emploi, Chomage",4,La Question du Travail,8,1035,6,QCM,0.46,0.57,61.75,35,21,56,46,35,11,1.22,76.09,Moyen,Moyen,0,Meme Difficulté,Adapte,Sociology
4367,2018,Sociologie,3,"Travail, Emploi, Chomage",4,La Question du Travail,8,1035,6,QCM,0.38,0.57,61.75,33,20,53,44,33,11,1.2,75.0,Moyen,Moyen,0,Meme Difficulté,Adapte,Sociology
5478,2019,Sociologie,3,"Travail, Emploi, Chomage",4,La Question du Travail,8,1035,6,QCM,0.36,0.33,61.75,35,22,57,44,35,9,1.3,79.55,Moyen,Moyen,0,Meme Difficulté,Adapte,Sociology
6589,2020,Sociologie,3,"Travail, Emploi, Chomage",4,La Question du Travail,8,1035,6,QCU,0.28,0.74,61.75,34,21,55,38,34,4,1.45,89.47,Moyen,Moyen,0,Meme Difficulté,Adapte,Sociology
1035,2015,Sociologie,3,"Travail, Emploi, Chomage",4,La Question du Travail,8,1036,7,QCU,0.61,0.27,24.0,17,54,71,54,17,37,1.31,31.48,Difficile,Difficile,0,Meme Difficulté,Pas Adapte,Sociology
2146,2016,Sociologie,3,"Travail, Emploi, Chomage",4,La Question du Travail,8,1036,7,QCM,0.67,0.25,20.41,13,51,64,59,13,46,1.08,22.03,Facile,Difficile,-2,Beaucoup plus Difficile,Pas Adapte,Sociology
3257,2017,Sociologie,3,"Travail, Emploi, Chomage",4,La Question du Travail,8,1036,7,QCM,0.13,0.85,87.89,55,8,63,60,55,5,1.05,91.67,Facile,Facile,0,Meme Difficulté,Pas Adapte,Sociology
4368,2018,Sociologie,3,"Travail, Emploi, Chomage",4,La Question du Travail,8,1036,7,QCM,0.53,0.27,7.7,4,53,57,19,4,15,3.0,21.05,Difficile,Difficile,0,Meme Difficulté,Pas Adapte,Sociology
5479,2019,Sociologie,3,"Travail, Emploi, Chomage",4,La Question du Travail,8,1036,7,QCU,0.48,0.34,22.79,14,49,63,57,14,43,1.11,24.56,Facile,Difficile,-2,Beaucoup plus Difficile,Pas Adapte,Sociology
6590,2020,Sociologie,3,"Travail, Emploi, Chomage",4,La Question du Travail,8,1036,7,QROC,0.16,0.45,78.12,52,14,66,62,52,10,1.06,83.87,Moyen,Facile,1,Plus Facile,Pas Adapte,Sociology
1036,2015,Sociologie,3,"Travail, Emploi, Chomage",4,La Question du Travail,8,1037,8,QROC,0.14,0.97,87.95,6,1,7,7,6,1,1.0,85.71,Facile,Facile,0,Meme Difficulté,Pas Adapte,Sociology
2147,2016,Sociologie,3,"Travail, Emploi, Chomage",4,La Question du Travail,8,1037,8,QROC,0.74,0.09,7.67,1,7,8,5,1,4,1.6,20.0,Moyen,Difficile,-1,Plus Difficile,Pas Adapte,Sociology
3258,2017,Sociologie,3,"Travail, Emploi, Chomage",4,La Question du Travail,8,1037,8,QO,0.16,0.57,75.29,7,2,9,8,7,1,1.12,87.5,Difficile,Facile,2,Beaucoup plus Facile,Pas Adapte,Sociology
4369,2018,Sociologie,3,"Travail, Emploi, Chomage",4,La Question du Travail,8,1037,8,QO,0.13,0.88,80.57,8,2,10,10,8,2,1.0,80.0,Facile,Facile,0,Meme Difficulté,Pas Adapte,Sociology
5480,2019,Sociologie,3,"Travail, Emploi, Chomage",4,La Question du Travail,8,1037,8,QO,0.23,0.25,44.48,4,5,9,7,4,3,1.29,57.14,Moyen,Moyen,0,Meme Difficulté,Pas Adapte,Sociology
6591,2020,Sociologie,3,"Travail, Emploi, Chomage",4,La Question du Travail,8,1037,8,QO,0.92,0.05,28.12,3,7,10,10,3,7,1.0,30.0,Moyen,Difficile,-1,Plus Difficile,Pas Adapte,Sociology
1037,2015,Sociologie,4,Notions de Sociologie,1,Les Modernites,9,1038,1,QCU,0.1,0.82,93.27,66,5,71,70,66,4,1.01,94.29,Facile,Facile,0,Meme Difficulté,Pas Adapte,Sociology
2148,2016,Sociologie,4,Notions de Sociologie,1,Les Modernites,9,1038,1,QCU,0.51,0.21,28.12,20,52,72,44,20,24,1.64,45.45,Moyen,Difficile,-1,Plus Difficile,Pas Adapte,Sociology
3259,2017,Sociologie,4,Notions de Sociologie,1,Les Modernites,9,1038,1,QCU,0.67,0.29,32.05,20,42,62,38,20,18,1.63,52.63,Difficile,Difficile,0,Meme Difficulté,Pas Adapte,Sociology
4370,2018,Sociologie,4,Notions de Sociologie,1,Les Modernites,9,1038,1,QCU,0.05,0.93,91.19,53,5,58,56,53,3,1.04,94.64,Facile,Facile,0,Meme Difficulté,Pas Adapte,Sociology
5481,2019,Sociologie,4,Notions de Sociologie,1,Les Modernites,9,1038,1,QCU,0.25,0.49,49.01,30,31,61,35,30,5,1.74,85.71,Moyen,Moyen,0,Meme Difficulté,Pas Adapte,Sociology
6592,2020,Sociologie,4,Notions de Sociologie,1,Les Modernites,9,1038,1,QCU,0.29,0.49,39.79,21,32,53,40,21,19,1.32,52.5,Moyen,Moyen,0,Meme Difficulté,Pas Adapte,Sociology
1038,2015,Sociologie,4,Notions de Sociologie,1,Les Modernites,9,1039,2,QCM,0.26,0.47,40.88,7,11,18,13,7,6,1.38,53.85,Moyen,Moyen,0,Meme Difficulté,Pas Adapte,Sociology
2149,2016,Sociologie,4,Notions de Sociologie,1,Les Modernites,9,1039,2,QCM,0.6,0.27,12.51,2,13,15,15,2,13,1.0,13.33,Facile,Difficile,-2,Beaucoup plus Difficile,Pas Adapte,Sociology
3260,2017,Sociologie,4,Notions de Sociologie,1,Les Modernites,9,1039,2,QCM,0.08,0.71,79.23,13,3,16,15,13,2,1.07,86.67,Facile,Facile,0,Meme Difficulté,Pas Adapte,Sociology
4371,2018,Sociologie,4,Notions de Sociologie,1,Les Modernites,9,1039,2,QCM,0.55,0.27,10.02,2,14,16,13,2,11,1.23,15.38,Difficile,Difficile,0,Meme Difficulté,Pas Adapte,Sociology
5482,2019,Sociologie,4,Notions de Sociologie,1,Les Modernites,9,1039,2,QCM,0.69,0.25,25.37,5,13,18,12,5,7,1.5,41.67,Moyen,Difficile,-1,Plus Difficile,Pas Adapte,Sociology
6593,2020,Sociologie,4,Notions de Sociologie,1,Les Modernites,9,1039,2,QROC,0.6,0.26,51.49,10,10,20,17,10,7,1.18,58.82,Moyen,Moyen,0,Meme Difficulté,Pas Adapte,Sociology
1039,2015,Sociologie,4,Notions de Sociologie,1,Les Modernites,9,1040,3,QROC,0.18,0.75,87.51,59,8,67,60,59,1,1.12,98.33,Difficile,Facile,2,Beaucoup plus Facile,Pas Adapte,Sociology
2150,2016,Sociologie,4,Notions de Sociologie,1,Les Modernites,9,1040,3,QROC,0.28,0.36,59.91,35,23,58,45,35,10,1.29,77.78,Difficile,Moyen,1,Plus Facile,Pas Adapte,Sociology
3261,2017,Sociologie,4,Notions de Sociologie,1,Les Modernites,9,1040,3,QROC,0.0,0.96,78.54,49,13,62,50,49,1,1.24,98.0,Moyen,Facile,1,Plus Facile,Pas Adapte,Sociology
4372,2018,Sociologie,4,Notions de Sociologie,1,Les Modernites,9,1040,3,QROC,0.63,0.2,14.75,10,56,66,59,10,49,1.12,16.95,Moyen,Difficile,-1,Plus Difficile,Pas Adapte,Sociology
5483,2019,Sociologie,4,Notions de Sociologie,1,Les Modernites,9,1040,3,QROC,0.01,0.61,78.49,46,12,58,47,46,1,1.23,97.87,Difficile,Facile,2,Beaucoup plus Facile,Pas Adapte,Sociology
6594,2020,Sociologie,4,Notions de Sociologie,1,Les Modernites,9,1040,3,QROC,0.81,0.03,32.33,20,42,62,57,20,37,1.09,35.09,Facile,Difficile,-2,Beaucoup plus Difficile,Pas Adapte,Sociology
1040,2015,Sociologie,4,Notions de Sociologie,1,Les Modernites,9,1041,4,QCU,0.62,0.22,4.54,2,51,53,44,2,42,1.2,4.55,Difficile,Difficile,0,Meme Difficulté,Pas Adapte,Sociology
2151,2016,Sociologie,4,Notions de Sociologie,1,Les Modernites,9,1041,4,QCU,0.35,0.72,44.95,22,27,49,43,22,21,1.14,51.16,Difficile,Moyen,1,Plus Facile,Pas Adapte,Sociology
3262,2017,Sociologie,4,Notions de Sociologie,1,Les Modernites,9,1041,4,QCU,0.66,0.21,24.53,13,42,55,55,13,42,1.0,23.64,Facile,Difficile,-2,Beaucoup plus Difficile,Pas Adapte,Sociology
4373,2018,Sociologie,4,Notions de Sociologie,1,Les Modernites,9,1041,4,QCU,0.21,0.46,48.46,24,25,49,35,24,11,1.4,68.57,Facile,Moyen,-1,Plus Difficile,Pas Adapte,Sociology
5484,2019,Sociologie,4,Notions de Sociologie,1,Les Modernites,9,1041,4,QCU,0.27,0.7,38.9,21,32,53,24,21,3,2.21,87.5,Facile,Moyen,-1,Plus Difficile,Pas Adapte,Sociology
6595,2020,Sociologie,4,Notions de Sociologie,1,Les Modernites,9,1041,4,QCM,0.61,0.18,5.97,3,49,52,32,3,29,1.62,9.38,Facile,Difficile,-2,Beaucoup plus Difficile,Pas Adapte,Sociology
1041,2015,Sociologie,4,Notions de Sociologie,1,Les Modernites,9,1042,5,QCM,0.39,0.43,35.24,32,60,92,36,32,4,2.56,88.89,Facile,Moyen,-1,Plus Difficile,Pas Adapte,Sociology
2152,2016,Sociologie,4,Notions de Sociologie,1,Les Modernites,9,1042,5,QCM,0.08,0.87,98.48,101,2,103,102,101,1,1.01,99.02,Difficile,Facile,2,Beaucoup plus Facile,Pas Adapte,Sociology
3263,2017,Sociologie,4,Notions de Sociologie,1,Les Modernites,9,1042,5,QCM,0.24,0.43,53.67,61,52,113,68,61,7,1.66,89.71,Facile,Moyen,-1,Plus Difficile,Pas Adapte,Sociology
4374,2018,Sociologie,4,Notions de Sociologie,1,Les Modernites,9,1042,5,QCM,0.65,0.23,33.84,34,65,99,70,34,36,1.41,48.57,Moyen,Difficile,-1,Plus Difficile,Pas Adapte,Sociology
5485,2019,Sociologie,4,Notions de Sociologie,1,Les Modernites,9,1042,5,QCM,0.15,0.83,66.38,59,30,89,70,59,11,1.27,84.29,Facile,Facile,0,Meme Difficulté,Adapte,Sociology
6596,2020,Sociologie,4,Notions de Sociologie,1,Les Modernites,9,1042,5,QCM,0.0,0.81,66.38,51,26,77,58,51,7,1.33,87.93,Facile,Facile,0,Meme Difficulté,Adapte,Sociology
1042,2015,Sociologie,4,Notions de Sociologie,1,Les Modernites,9,1043,6,QROC,0.5,0.37,42.57,8,10,18,18,8,10,1.0,44.44,Moyen,Moyen,0,Meme Difficulté,Pas Adapte,Sociology
2153,2016,Sociologie,4,Notions de Sociologie,1,Les Modernites,9,1043,6,QROC,0.73,0.11,24.99,4,14,18,15,4,11,1.2,26.67,Moyen,Difficile,-1,Plus Difficile,Pas Adapte,Sociology
3264,2017,Sociologie,4,Notions de Sociologie,1,Les Modernites,9,1043,6,QROC,0.92,0.13,25.6,5,15,20,9,5,4,2.22,55.56,Facile,Difficile,-2,Beaucoup plus Difficile,Pas Adapte,Sociology
4375,2018,Sociologie,4,Notions de Sociologie,1,Les Modernites,9,1043,6,QROC,0.85,0.22,2.4,0,19,19,18,0,18,1.06,0.0,Difficile,Difficile,0,Meme Difficulté,Pas Adapte,Sociology
5486,2019,Sociologie,4,Notions de Sociologie,1,Les Modernites,9,1043,6,QO,0.45,0.18,63.42,11,7,18,13,11,2,1.38,84.62,Facile,Moyen,-1,Plus Difficile,Adapte,Sociology
6597,2020,Sociologie,4,Notions de Sociologie,1,Les Modernites,9,1043,6,QO,0.44,0.25,63.42,10,5,15,10,10,0,1.5,100.0,Moyen,Moyen,0,Meme Difficulté,Adapte,Sociology
1043,2015,Sociologie,4,Notions de Sociologie,1,Les Modernites,9,1044,7,QROC,0.03,0.51,75.98,21,6,27,23,21,2,1.17,91.3,Moyen,Facile,1,Plus Facile,Pas Adapte,Sociology
2154,2016,Sociologie,4,Notions de Sociologie,1,Les Modernites,9,1044,7,QROC,0.53,0.33,61.88,16,10,26,23,16,7,1.13,69.57,Moyen,Moyen,0,Meme Difficulté,Adapte,Sociology
3265,2017,Sociologie,4,Notions de Sociologie,1,Les Modernites,9,1044,7,QROC,0.28,0.37,61.88,18,11,29,22,18,4,1.32,81.82,Moyen,Moyen,0,Meme Difficulté,Adapte,Sociology
4376,2018,Sociologie,4,Notions de Sociologie,1,Les Modernites,9,1044,7,QROC,0.44,0.34,61.88,20,13,33,31,20,11,1.06,64.52,Moyen,Moyen,0,Meme Difficulté,Adapte,Sociology
5487,2019,Sociologie,4,Notions de Sociologie,1,Les Modernites,9,1044,7,QO,0.27,0.19,61.88,24,14,38,35,24,11,1.09,68.57,Moyen,Moyen,0,Meme Difficulté,Adapte,Sociology
6598,2020,Sociologie,4,Notions de Sociologie,1,Les Modernites,9,1044,7,QO,0.74,0.18,61.88,22,13,35,32,22,10,1.09,68.75,Moyen,Moyen,0,Meme Difficulté,Adapte,Sociology
1044,2015,Sociologie,4,Notions de Sociologie,1,Les Modernites,9,1045,8,QCM,0.69,0.16,14.28,9,57,66,26,9,17,2.54,34.62,Moyen,Difficile,-1,Plus Difficile,Pas Adapte,Sociology
2155,2016,Sociologie,4,Notions de Sociologie,1,Les Modernites,9,1045,8,QCM,0.05,0.94,83.18,52,11,63,61,52,9,1.03,85.25,Moyen,Facile,1,Plus Facile,Pas Adapte,Sociology
3266,2017,Sociologie,4,Notions de Sociologie,1,Les Modernites,9,1045,8,QCM,0.1,0.93,69.48,50,22,72,68,50,18,1.06,73.53,Difficile,Facile,2,Beaucoup plus Facile,Adapte,Sociology
4377,2018,Sociologie,4,Notions de Sociologie,1,Les Modernites,9,1045,8,QCM,0.18,0.86,69.48,51,23,74,62,51,11,1.19,82.26,Facile,Facile,0,Meme Difficulté,Adapte,Sociology
5488,2019,Sociologie,4,Notions de Sociologie,1,Les Modernites,9,1045,8,QCM,0.15,0.85,69.48,49,21,70,53,49,4,1.32,92.45,Facile,Facile,0,Meme Difficulté,Adapte,Sociology
6599,2020,Sociologie,4,Notions de Sociologie,1,Les Modernites,9,1045,8,QCM,0.07,0.78,69.48,56,24,80,74,56,18,1.08,75.68,Facile,Facile,0,Meme Difficulté,Adapte,Sociology
1045,2015,Sociologie,4,Notions de Sociologie,1,Les Modernites,9,1046,9,QCM,0.25,0.43,62.83,57,34,91,80,57,23,1.14,71.25,Facile,Moyen,-1,Plus Difficile,Adapte,Sociology
2156,2016,Sociologie,4,Notions de Sociologie,1,Les Modernites,9,1046,9,QCU,0.26,0.72,62.83,60,35,95,77,60,17,1.23,77.92,Moyen,Moyen,0,Meme Difficulté,Adapte,Sociology
3267,2017,Sociologie,4,Notions de Sociologie,1,Les Modernites,9,1046,9,QCU,0.38,0.66,62.83,68,41,109,99,68,31,1.1,68.69,Moyen,Moyen,0,Meme Difficulté,Adapte,Sociology
4378,2018,Sociologie,4,Notions de Sociologie,1,Les Modernites,9,1046,9,QCU,0.36,0.46,62.83,75,45,120,105,75,30,1.14,71.43,Moyen,Moyen,0,Meme Difficulté,Adapte,Sociology
5489,2019,Sociologie,4,Notions de Sociologie,1,Les Modernites,9,1046,9,QCU,0.35,0.75,62.83,85,50,135,104,85,19,1.3,81.73,Moyen,Moyen,0,Meme Difficulté,Adapte,Sociology
6600,2020,Sociologie,4,Notions de Sociologie,1,Les Modernites,9,1046,9,QCU,0.24,0.66,62.83,85,51,136,111,85,26,1.23,76.58,Moyen,Moyen,0,Meme Difficulté,Adapte,Sociology
1046,2015,Sociologie,4,Notions de Sociologie,2,Structure et Classes Sociales,6,1047,1,QROC,0.09,0.43,76.91,18,6,24,21,18,3,1.14,85.71,Facile,Facile,0,Meme Difficulté,Pas Adapte,Sociology
2157,2016,Sociologie,4,Notions de Sociologie,2,Structure et Classes Sociales,6,1047,1,QROC,0.09,0.49,90.65,21,2,23,23,21,2,1.0,91.3,Difficile,Facile,2,Beaucoup plus Facile,Pas Adapte,Sociology
3268,2017,Sociologie,4,Notions de Sociologie,2,Structure et Classes Sociales,6,1047,1,QO,0.74,0.21,37.18,8,13,21,15,8,7,1.4,53.33,Difficile,Moyen,1,Plus Facile,Pas Adapte,Sociology
4379,2018,Sociologie,4,Notions de Sociologie,2,Structure et Classes Sociales,6,1047,1,QO,0.57,0.24,40.05,9,13,22,14,9,5,1.57,64.29,Facile,Moyen,-1,Plus Difficile,Pas Adapte,Sociology
5490,2019,Sociologie,4,Notions de Sociologie,2,Structure et Classes Sociales,6,1047,1,QO,0.04,0.7,66.37,16,8,24,19,16,3,1.26,84.21,Facile,Facile,0,Meme Difficulté,Adapte,Sociology
6601,2020,Sociologie,4,Notions de Sociologie,2,Structure et Classes Sociales,6,1047,1,QO,0.0,0.61,66.37,16,8,24,18,16,2,1.33,88.89,Facile,Facile,0,Meme Difficulté,Adapte,Sociology
1047,2015,Sociologie,4,Notions de Sociologie,2,Structure et Classes Sociales,6,1048,2,QO,0.16,0.76,79.96,62,16,78,70,62,8,1.11,88.57,Difficile,Facile,2,Beaucoup plus Facile,Pas Adapte,Sociology
2158,2016,Sociologie,4,Notions de Sociologie,2,Structure et Classes Sociales,6,1048,2,QO,0.08,0.39,69.52,54,23,77,77,54,23,1.0,70.13,Moyen,Facile,1,Plus Facile,Adapte,Sociology
3269,2017,Sociologie,4,Notions de Sociologie,2,Structure et Classes Sociales,6,1048,2,QO,0.0,0.32,69.52,45,20,65,49,45,4,1.33,91.84,Facile,Facile,0,Meme Difficulté,Adapte,Sociology
4380,2018,Sociologie,4,Notions de Sociologie,2,Structure et Classes Sociales,6,1048,2,QO,0.12,0.74,69.52,45,20,65,52,45,7,1.25,86.54,Facile,Facile,0,Meme Difficulté,Adapte,Sociology
5491,2019,Sociologie,4,Notions de Sociologie,2,Structure et Classes Sociales,6,1048,2,QROC,0.2,0.78,69.52,42,19,61,50,42,8,1.22,84.0,Facile,Facile,0,Meme Difficulté,Adapte,Sociology
6602,2020,Sociologie,4,Notions de Sociologie,2,Structure et Classes Sociales,6,1048,2,QROC,0.01,0.9,69.52,48,21,69,59,48,11,1.17,81.36,Facile,Facile,0,Meme Difficulté,Adapte,Sociology
1048,2015,Sociologie,4,Notions de Sociologie,2,Structure et Classes Sociales,6,1049,3,QCM,0.5,0.21,28.46,24,62,86,57,24,33,1.51,42.11,Moyen,Difficile,-1,Plus Difficile,Pas Adapte,Sociology
2159,2016,Sociologie,4,Notions de Sociologie,2,Structure et Classes Sociales,6,1049,3,QCM,0.51,0.16,6.17,5,79,84,54,5,49,1.56,9.26,Facile,Difficile,-2,Beaucoup plus Difficile,Pas Adapte,Sociology
3270,2017,Sociologie,4,Notions de Sociologie,2,Structure et Classes Sociales,6,1049,3,QCM,0.1,0.88,89.27,79,9,88,80,79,1,1.1,98.75,Moyen,Facile,1,Plus Facile,Pas Adapte,Sociology
4381,2018,Sociologie,4,Notions de Sociologie,2,Structure et Classes Sociales,6,1049,3,QCM,0.01,0.91,79.19,77,20,97,84,77,7,1.15,91.67,Facile,Facile,0,Meme Difficulté,Pas Adapte,Sociology
5492,2019,Sociologie,4,Notions de Sociologie,2,Structure et Classes Sociales,6,1049,3,QCM,0.2,0.66,63.57,55,31,86,56,55,1,1.54,98.21,Facile,Moyen,-1,Plus Difficile,Adapte,Sociology
6603,2020,Sociologie,4,Notions de Sociologie,2,Structure et Classes Sociales,6,1049,3,QCM,0.4,0.46,63.57,55,31,86,63,55,8,1.37,87.3,Moyen,Moyen,0,Meme Difficulté,Adapte,Sociology
1049,2015,Sociologie,4,Notions de Sociologie,2,Structure et Classes Sociales,6,1050,4,QCM,0.1,0.94,71.08,16,7,23,21,16,5,1.1,76.19,Facile,Facile,0,Meme Difficulté,Adapte,Sociology
2160,2016,Sociologie,4,Notions de Sociologie,2,Structure et Classes Sociales,6,1050,4,QCM,0.04,0.89,71.08,16,6,22,17,16,1,1.29,94.12,Facile,Facile,0,Meme Difficulté,Adapte,Sociology
3271,2017,Sociologie,4,Notions de Sociologie,2,Structure et Classes Sociales,6,1050,4,QCM,0.01,0.94,71.08,16,6,22,20,16,4,1.1,80.0,Facile,Facile,0,Meme Difficulté,Adapte,Sociology
4382,2018,Sociologie,4,Notions de Sociologie,2,Structure et Classes Sociales,6,1050,4,QCU,0.14,0.94,71.08,17,7,24,22,17,5,1.09,77.27,Facile,Facile,0,Meme Difficulté,Adapte,Sociology
5493,2019,Sociologie,4,Notions de Sociologie,2,Structure et Classes Sociales,6,1050,4,QCU,0.14,0.93,71.08,19,8,27,21,19,2,1.29,90.48,Facile,Facile,0,Meme Difficulté,Adapte,Sociology
6604,2020,Sociologie,4,Notions de Sociologie,2,Structure et Classes Sociales,6,1050,4,QCU,0.15,1.0,71.08,17,7,24,18,17,1,1.33,94.44,Facile,Facile,0,Meme Difficulté,Adapte,Sociology
1050,2015,Sociologie,4,Notions de Sociologie,2,Structure et Classes Sociales,6,1051,5,QCM,0.55,0.16,8.28,6,63,69,34,6,28,2.03,17.65,Moyen,Difficile,-1,Plus Difficile,Pas Adapte,Sociology
2161,2016,Sociologie,4,Notions de Sociologie,2,Structure et Classes Sociales,6,1051,5,QCU,0.48,0.33,14.43,9,55,64,34,9,25,1.88,26.47,Difficile,Difficile,0,Meme Difficulté,Pas Adapte,Sociology
3272,2017,Sociologie,4,Notions de Sociologie,2,Structure et Classes Sociales,6,1051,5,QCU,0.74,0.24,21.46,14,53,67,66,14,52,1.02,21.21,Difficile,Difficile,0,Meme Difficulté,Pas Adapte,Sociology
4383,2018,Sociologie,4,Notions de Sociologie,2,Structure et Classes Sociales,6,1051,5,QCU,0.13,0.89,66.13,47,24,71,64,47,17,1.11,73.44,Facile,Facile,0,Meme Difficulté,Adapte,Sociology
5494,2019,Sociologie,4,Notions de Sociologie,2,Structure et Classes Sociales,6,1051,5,QCU,0.07,0.81,66.13,52,26,78,65,52,13,1.2,80.0,Facile,Facile,0,Meme Difficulté,Adapte,Sociology
6605,2020,Sociologie,4,Notions de Sociologie,2,Structure et Classes Sociales,6,1051,5,QCU,0.15,0.99,66.13,58,30,88,68,58,10,1.29,85.29,Facile,Facile,0,Meme Difficulté,Adapte,Sociology
1051,2015,Sociologie,4,Notions de Sociologie,2,Structure et Classes Sociales,6,1052,6,QCU,0.31,0.6,38.28,21,35,56,52,21,31,1.08,40.38,Moyen,Moyen,0,Meme Difficulté,Pas Adapte,Sociology
2162,2016,Sociologie,4,Notions de Sociologie,2,Structure et Classes Sociales,6,1052,6,QCU,0.58,0.36,34.32,19,35,54,34,19,15,1.59,55.88,Facile,Difficile,-2,Beaucoup plus Difficile,Pas Adapte,Sociology
3273,2017,Sociologie,4,Notions de Sociologie,2,Structure et Classes Sociales,6,1052,6,QCU,0.44,0.35,30.81,18,39,57,55,18,37,1.04,32.73,Moyen,Difficile,-1,Plus Difficile,Pas Adapte,Sociology
4384,2018,Sociologie,4,Notions de Sociologie,2,Structure et Classes Sociales,6,1052,6,QCU,0.59,0.23,24.39,16,50,66,29,16,13,2.28,55.17,Moyen,Difficile,-1,Plus Difficile,Pas Adapte,Sociology
5495,2019,Sociologie,4,Notions de Sociologie,2,Structure et Classes Sociales,6,1052,6,QCU,0.67,0.22,14.77,9,52,61,38,9,29,1.61,23.68,Difficile,Difficile,0,Meme Difficulté,Pas Adapte,Sociology
6606,2020,Sociologie,4,Notions de Sociologie,2,Structure et Classes Sociales,6,1052,6,QCU,0.74,0.22,5.01,3,62,65,57,3,54,1.14,5.26,Moyen,Difficile,-1,Plus Difficile,Pas Adapte,Sociology
1052,2015,Sociologie,4,Notions de Sociologie,3,Organisation et Institution,14,1053,1,QCU,0.59,0.28,0.66,0,31,31,12,0,12,2.58,0.0,Facile,Difficile,-2,Beaucoup plus Difficile,Pas Adapte,Sociology
2163,2016,Sociologie,4,Notions de Sociologie,3,Organisation et Institution,14,1053,1,QCU,0.32,0.58,64.06,22,12,34,27,22,5,1.26,81.48,Moyen,Moyen,0,Meme Difficulté,Adapte,Sociology
3274,2017,Sociologie,4,Notions de Sociologie,3,Organisation et Institution,14,1053,1,QCU,0.25,0.43,64.06,21,11,32,22,21,1,1.45,95.45,Moyen,Moyen,0,Meme Difficulté,Adapte,Sociology
4385,2018,Sociologie,4,Notions de Sociologie,3,Organisation et Institution,14,1053,1,QCU,0.38,0.62,64.06,22,12,34,33,22,11,1.03,66.67,Moyen,Moyen,0,Meme Difficulté,Adapte,Sociology
5496,2019,Sociologie,4,Notions de Sociologie,3,Organisation et Institution,14,1053,1,QCU,0.24,0.73,64.06,24,13,37,33,24,9,1.12,72.73,Moyen,Moyen,0,Meme Difficulté,Adapte,Sociology
6607,2020,Sociologie,4,Notions de Sociologie,3,Organisation et Institution,14,1053,1,QCU,0.35,0.68,64.06,28,15,43,42,28,14,1.02,66.67,Moyen,Moyen,0,Meme Difficulté,Adapte,Sociology
1053,2015,Sociologie,4,Notions de Sociologie,3,Organisation et Institution,14,1054,2,QCU,0.45,0.31,12.97,7,46,53,35,7,28,1.51,20.0,Moyen,Difficile,-1,Plus Difficile,Pas Adapte,Sociology
2164,2016,Sociologie,4,Notions de Sociologie,3,Organisation et Institution,14,1054,2,QCU,0.22,0.65,44.93,22,26,48,44,22,22,1.09,50.0,Difficile,Moyen,1,Plus Facile,Pas Adapte,Sociology
3275,2017,Sociologie,4,Notions de Sociologie,3,Organisation et Institution,14,1054,2,QCU,0.05,0.87,79.88,34,8,42,37,34,3,1.14,91.89,Facile,Facile,0,Meme Difficulté,Pas Adapte,Sociology
4386,2018,Sociologie,4,Notions de Sociologie,3,Organisation et Institution,14,1054,2,QCU,0.74,0.31,14.33,6,35,41,29,6,23,1.41,20.69,Facile,Difficile,-2,Beaucoup plus Difficile,Pas Adapte,Sociology
5497,2019,Sociologie,4,Notions de Sociologie,3,Organisation et Institution,14,1054,2,QCU,0.47,0.34,13.09,6,40,46,34,6,28,1.35,17.65,Facile,Difficile,-2,Beaucoup plus Difficile,Pas Adapte,Sociology
6608,2020,Sociologie,4,Notions de Sociologie,3,Organisation et Institution,14,1054,2,QROC,0.28,0.32,54.75,23,19,42,28,23,5,1.5,82.14,Moyen,Moyen,0,Meme Difficulté,Pas Adapte,Sociology
1054,2015,Sociologie,4,Notions de Sociologie,3,Organisation et Institution,14,1055,3,QCM,0.24,0.45,40.14,22,34,56,54,22,32,1.04,40.74,Difficile,Moyen,1,Plus Facile,Pas Adapte,Sociology
2165,2016,Sociologie,4,Notions de Sociologie,3,Organisation et Institution,14,1055,3,QCM,0.52,0.18,6.91,4,49,53,33,4,29,1.61,12.12,Difficile,Difficile,0,Meme Difficulté,Pas Adapte,Sociology
3276,2017,Sociologie,4,Notions de Sociologie,3,Organisation et Institution,14,1055,3,QCM,0.36,0.44,60.09,37,24,61,40,37,3,1.52,92.5,Facile,Moyen,-1,Plus Difficile,Adapte,Sociology
4387,2018,Sociologie,4,Notions de Sociologie,3,Organisation et Institution,14,1055,3,QCM,0.34,0.48,60.09,31,21,52,51,31,20,1.02,60.78,Moyen,Moyen,0,Meme Difficulté,Adapte,Sociology
5498,2019,Sociologie,4,Notions de Sociologie,3,Organisation et Institution,14,1055,3,QCM,0.29,0.67,60.09,36,24,60,51,36,15,1.18,70.59,Moyen,Moyen,0,Meme Difficulté,Adapte,Sociology
6609,2020,Sociologie,4,Notions de Sociologie,3,Organisation et Institution,14,1055,3,QCM,0.44,0.47,60.09,34,22,56,42,34,8,1.33,80.95,Moyen,Moyen,0,Meme Difficulté,Adapte,Sociology
1055,2015,Sociologie,4,Notions de Sociologie,3,Organisation et Institution,14,1056,4,QCM,0.17,0.84,88.84,40,5,45,40,40,0,1.12,100.0,Facile,Facile,0,Meme Difficulté,Pas Adapte,Sociology
2166,2016,Sociologie,4,Notions de Sociologie,3,Organisation et Institution,14,1056,4,QCM,0.71,0.25,11.83,5,35,40,22,5,17,1.82,22.73,Facile,Difficile,-2,Beaucoup plus Difficile,Pas Adapte,Sociology
3277,2017,Sociologie,4,Notions de Sociologie,3,Organisation et Institution,14,1056,4,QCM,0.37,0.36,61.15,21,13,34,27,21,6,1.26,77.78,Difficile,Moyen,1,Plus Facile,Adapte,Sociology
4388,2018,Sociologie,4,Notions de Sociologie,3,Organisation et Institution,14,1056,4,QCU,0.39,0.42,61.15,21,14,35,32,21,11,1.09,65.62,Moyen,Moyen,0,Meme Difficulté,Adapte,Sociology
5499,2019,Sociologie,4,Notions de Sociologie,3,Organisation et Institution,14,1056,4,QCU,0.26,0.68,61.15,23,15,38,38,23,15,1.0,60.53,Moyen,Moyen,0,Meme Difficulté,Adapte,Sociology
6610,2020,Sociologie,4,Notions de Sociologie,3,Organisation et Institution,14,1056,4,QCU,0.34,0.44,61.15,23,14,37,24,23,1,1.54,95.83,Moyen,Moyen,0,Meme Difficulté,Adapte,Sociology
1056,2015,Sociologie,4,Notions de Sociologie,3,Organisation et Institution,14,1057,5,QO,0.76,0.03,26.75,15,41,56,45,15,30,1.24,33.33,Difficile,Difficile,0,Meme Difficulté,Pas Adapte,Sociology
2167,2016,Sociologie,4,Notions de Sociologie,3,Organisation et Institution,14,1057,5,QO,0.95,0.04,30.56,18,42,60,45,18,27,1.33,40.0,Facile,Difficile,-2,Beaucoup plus Difficile,Pas Adapte,Sociology
3278,2017,Sociologie,4,Notions de Sociologie,3,Organisation et Institution,14,1057,5,QO,0.89,0.06,12.97,8,55,63,59,8,51,1.07,13.56,Difficile,Difficile,0,Meme Difficulté,Pas Adapte,Sociology
4389,2018,Sociologie,4,Notions de Sociologie,3,Organisation et Institution,14,1057,5,QO,0.92,0.06,24.9,18,54,72,38,18,20,1.89,47.37,Facile,Difficile,-2,Beaucoup plus Difficile,Pas Adapte,Sociology
5500,2019,Sociologie,4,Notions de Sociologie,3,Organisation et Institution,14,1057,5,QO,0.87,0.12,29.84,20,48,68,49,20,29,1.39,40.82,Difficile,Difficile,0,Meme Difficulté,Pas Adapte,Sociology
6611,2020,Sociologie,4,Notions de Sociologie,3,Organisation et Institution,14,1057,5,QO,0.04,0.94,96.24,69,3,72,70,69,1,1.03,98.57,Difficile,Facile,2,Beaucoup plus Facile,Pas Adapte,Sociology
1057,2015,Sociologie,4,Notions de Sociologie,3,Organisation et Institution,14,1058,6,QROC,1.0,0.1,2.12,1,28,29,22,1,21,1.32,4.55,Difficile,Difficile,0,Meme Difficulté,Pas Adapte,Sociology
2168,2016,Sociologie,4,Notions de Sociologie,3,Organisation et Institution,14,1058,6,QROC,0.1,0.75,88.77,29,4,33,29,29,0,1.14,100.0,Facile,Facile,0,Meme Difficulté,Pas Adapte,Sociology
3279,2017,Sociologie,4,Notions de Sociologie,3,Organisation et Institution,14,1058,6,QCM,0.66,0.3,6.75,2,29,31,11,2,9,2.82,18.18,Facile,Difficile,-2,Beaucoup plus Difficile,Pas Adapte,Sociology
4390,2018,Sociologie,4,Notions de Sociologie,3,Organisation et Institution,14,1058,6,QCU,0.13,0.94,96.01,25,1,26,25,25,0,1.04,100.0,Difficile,Facile,2,Beaucoup plus Facile,Pas Adapte,Sociology
5501,2019,Sociologie,4,Notions de Sociologie,3,Organisation et Institution,14,1058,6,QCU,0.72,0.29,24.89,5,17,22,9,5,4,2.44,55.56,Difficile,Difficile,0,Meme Difficulté,Pas Adapte,Sociology
6612,2020,Sociologie,4,Notions de Sociologie,3,Organisation et Institution,14,1058,6,QCM,0.16,0.99,74.84,19,6,25,22,19,3,1.14,86.36,Facile,Facile,0,Meme Difficulté,Adapte,Sociology
1058,2015,Sociologie,4,Notions de Sociologie,3,Organisation et Institution,14,1059,7,QROC,0.35,0.26,60.74,16,10,26,19,16,3,1.37,84.21,Difficile,Moyen,1,Plus Facile,Adapte,Sociology
2169,2016,Sociologie,4,Notions de Sociologie,3,Organisation et Institution,14,1059,7,QCU,0.36,0.5,60.74,17,11,28,25,17,8,1.12,68.0,Moyen,Moyen,0,Meme Difficulté,Adapte,Sociology
3280,2017,Sociologie,4,Notions de Sociologie,3,Organisation et Institution,14,1059,7,QCU,0.29,0.69,60.74,18,11,29,25,18,7,1.16,72.0,Moyen,Moyen,0,Meme Difficulté,Adapte,Sociology
4391,2018,Sociologie,4,Notions de Sociologie,3,Organisation et Institution,14,1059,7,QCU,0.26,0.63,60.74,18,11,29,21,18,3,1.38,85.71,Moyen,Moyen,0,Meme Difficulté,Adapte,Sociology
5502,2019,Sociologie,4,Notions de Sociologie,3,Organisation et Institution,14,1059,7,QCU,0.31,0.5,60.74,20,13,33,25,20,5,1.32,80.0,Moyen,Moyen,0,Meme Difficulté,Adapte,Sociology
6613,2020,Sociologie,4,Notions de Sociologie,3,Organisation et Institution,14,1059,7,QCU,0.25,0.42,60.74,18,11,29,27,18,9,1.07,66.67,Moyen,Moyen,0,Meme Difficulté,Adapte,Sociology
1059,2015,Sociologie,4,Notions de Sociologie,3,Organisation et Institution,14,1060,8,QCM,0.21,0.47,48.62,9,9,18,12,9,3,1.5,75.0,Facile,Moyen,-1,Plus Difficile,Pas Adapte,Sociology
2170,2016,Sociologie,4,Notions de Sociologie,3,Organisation et Institution,14,1060,8,QCM,0.52,0.25,24.93,5,14,19,13,5,8,1.46,38.46,Facile,Difficile,-2,Beaucoup plus Difficile,Pas Adapte,Sociology
3281,2017,Sociologie,4,Notions de Sociologie,3,Organisation et Institution,14,1060,8,QCM,0.02,0.99,88.16,19,3,22,19,19,0,1.16,100.0,Facile,Facile,0,Meme Difficulté,Pas Adapte,Sociology
4392,2018,Sociologie,4,Notions de Sociologie,3,Organisation et Institution,14,1060,8,QCM,0.25,0.44,51.88,11,11,22,19,11,8,1.16,57.89,Moyen,Moyen,0,Meme Difficulté,Pas Adapte,Sociology
5503,2019,Sociologie,4,Notions de Sociologie,3,Organisation et Institution,14,1060,8,QCM,0.65,0.21,17.81,4,20,24,23,4,19,1.04,17.39,Difficile,Difficile,0,Meme Difficulté,Pas Adapte,Sociology
6614,2020,Sociologie,4,Notions de Sociologie,3,Organisation et Institution,14,1060,8,QCM,0.56,0.23,10.09,3,23,26,15,3,12,1.73,20.0,Moyen,Difficile,-1,Plus Difficile,Pas Adapte,Sociology
1060,2015,Sociologie,4,Notions de Sociologie,3,Organisation et Institution,14,1061,9,QROC,0.16,0.95,85.37,72,12,84,75,72,3,1.12,96.0,Moyen,Facile,1,Plus Facile,Pas Adapte,Sociology
2171,2016,Sociologie,4,Notions de Sociologie,3,Organisation et Institution,14,1061,9,QROC,0.47,0.39,58.23,50,36,86,83,50,33,1.04,60.24,Facile,Moyen,-1,Plus Difficile,Pas Adapte,Sociology
3282,2017,Sociologie,4,Notions de Sociologie,3,Organisation et Institution,14,1061,9,QROC,0.45,0.31,55.11,41,33,74,46,41,5,1.61,89.13,Moyen,Moyen,0,Meme Difficulté,Pas Adapte,Sociology
4393,2018,Sociologie,4,Notions de Sociologie,3,Organisation et Institution,14,1061,9,QROC,0.2,0.62,75.48,60,19,79,73,60,13,1.08,82.19,Facile,Facile,0,Meme Difficulté,Pas Adapte,Sociology
5504,2019,Sociologie,4,Notions de Sociologie,3,Organisation et Institution,14,1061,9,QROC,0.14,0.62,91.55,81,7,88,81,81,0,1.09,100.0,Moyen,Facile,1,Plus Facile,Pas Adapte,Sociology
6615,2020,Sociologie,4,Notions de Sociologie,3,Organisation et Institution,14,1061,9,QROC,0.05,0.53,87.44,66,10,76,72,66,6,1.06,91.67,Moyen,Facile,1,Plus Facile,Pas Adapte,Sociology
1061,2015,Sociologie,4,Notions de Sociologie,3,Organisation et Institution,14,1062,10,QCM,0.4,0.48,59.53,12,8,20,20,12,8,1.0,60.0,Difficile,Moyen,1,Plus Facile,Pas Adapte,Sociology
2172,2016,Sociologie,4,Notions de Sociologie,3,Organisation et Institution,14,1062,10,QCM,0.07,0.78,75.62,13,4,17,17,13,4,1.0,76.47,Moyen,Facile,1,Plus Facile,Pas Adapte,Sociology
3283,2017,Sociologie,4,Notions de Sociologie,3,Organisation et Institution,14,1062,10,QCM,0.26,0.55,38.22,6,11,17,8,6,2,2.12,75.0,Difficile,Moyen,1,Plus Facile,Pas Adapte,Sociology
4394,2018,Sociologie,4,Notions de Sociologie,3,Organisation et Institution,14,1062,10,QCM,0.34,0.34,38.62,5,9,14,11,5,6,1.27,45.45,Difficile,Moyen,1,Plus Facile,Pas Adapte,Sociology
5505,2019,Sociologie,4,Notions de Sociologie,3,Organisation et Institution,14,1062,10,QCU,0.03,0.83,91.94,11,1,12,11,11,0,1.09,100.0,Difficile,Facile,2,Beaucoup plus Facile,Pas Adapte,Sociology
6616,2020,Sociologie,4,Notions de Sociologie,3,Organisation et Institution,14,1062,10,QCM,0.17,0.74,76.23,11,3,14,14,11,3,1.0,78.57,Facile,Facile,0,Meme Difficulté,Pas Adapte,Sociology
1062,2015,Sociologie,4,Notions de Sociologie,3,Organisation et Institution,14,1063,11,QCU,0.54,0.23,14.35,5,30,35,15,5,10,2.33,33.33,Facile,Difficile,-2,Beaucoup plus Difficile,Pas Adapte,Sociology
2173,2016,Sociologie,4,Notions de Sociologie,3,Organisation et Institution,14,1063,11,QCM,0.02,0.87,84.88,33,6,39,35,33,2,1.11,94.29,Facile,Facile,0,Meme Difficulté,Pas Adapte,Sociology
3284,2017,Sociologie,4,Notions de Sociologie,3,Organisation et Institution,14,1063,11,QCM,0.06,0.71,77.36,29,8,37,33,29,4,1.12,87.88,Difficile,Facile,2,Beaucoup plus Facile,Pas Adapte,Sociology
4395,2018,Sociologie,4,Notions de Sociologie,3,Organisation et Institution,14,1063,11,QCM,0.72,0.15,12.34,5,38,43,24,5,19,1.79,20.83,Facile,Difficile,-2,Beaucoup plus Difficile,Pas Adapte,Sociology
5506,2019,Sociologie,4,Notions de Sociologie,3,Organisation et Institution,14,1063,11,QCM,0.66,0.22,30.64,15,34,49,33,15,18,1.48,45.45,Moyen,Difficile,-1,Plus Difficile,Pas Adapte,Sociology
6617,2020,Sociologie,4,Notions de Sociologie,3,Organisation et Institution,14,1063,11,QCM,0.4,0.36,59.05,30,21,51,30,30,0,1.7,100.0,Difficile,Moyen,1,Plus Facile,Pas Adapte,Sociology
1063,2015,Sociologie,4,Notions de Sociologie,3,Organisation et Institution,14,1064,12,QCM,0.46,0.47,38.14,14,22,36,22,14,8,1.64,63.64,Difficile,Moyen,1,Plus Facile,Pas Adapte,Sociology
2174,2016,Sociologie,4,Notions de Sociologie,3,Organisation et Institution,14,1064,12,QCM,0.7,0.26,10.21,3,30,33,20,3,17,1.65,15.0,Moyen,Difficile,-1,Plus Difficile,Pas Adapte,Sociology
3285,2017,Sociologie,4,Notions de Sociologie,3,Organisation et Institution,14,1064,12,QCM,0.0,0.9,82.02,28,6,34,28,28,0,1.21,100.0,Facile,Facile,0,Meme Difficulté,Pas Adapte,Sociology
4396,2018,Sociologie,4,Notions de Sociologie,3,Organisation et Institution,14,1064,12,QCM,0.62,0.26,28.93,11,26,37,12,11,1,3.08,91.67,Facile,Difficile,-2,Beaucoup plus Difficile,Pas Adapte,Sociology
5507,2019,Sociologie,4,Notions de Sociologie,3,Organisation et Institution,14,1064,12,QCM,0.34,0.48,64.64,25,13,38,27,25,2,1.41,92.59,Facile,Moyen,-1,Plus Difficile,Adapte,Sociology
6618,2020,Sociologie,4,Notions de Sociologie,3,Organisation et Institution,14,1064,12,QCM,0.33,0.6,64.64,25,13,38,38,25,13,1.0,65.79,Moyen,Moyen,0,Meme Difficulté,Adapte,Sociology
1064,2015,Sociologie,4,Notions de Sociologie,3,Organisation et Institution,14,1065,13,QCU,0.17,0.9,70.38,53,22,75,73,53,20,1.03,72.6,Moyen,Facile,1,Plus Facile,Adapte,Sociology
2175,2016,Sociologie,4,Notions de Sociologie,3,Organisation et Institution,14,1065,13,QCM,0.14,0.76,70.38,53,23,76,70,53,17,1.09,75.71,Facile,Facile,0,Meme Difficulté,Adapte,Sociology
3286,2017,Sociologie,4,Notions de Sociologie,3,Organisation et Institution,14,1065,13,QCM,0.06,0.91,70.38,61,25,86,77,61,16,1.12,79.22,Facile,Facile,0,Meme Difficulté,Adapte,Sociology
4397,2018,Sociologie,4,Notions de Sociologie,3,Organisation et Institution,14,1065,13,QCM,0.06,0.92,70.38,53,23,76,64,53,11,1.19,82.81,Facile,Facile,0,Meme Difficulté,Adapte,Sociology
5508,2019,Sociologie,4,Notions de Sociologie,3,Organisation et Institution,14,1065,13,QCM,0.14,0.82,70.38,52,22,74,59,52,7,1.25,88.14,Facile,Facile,0,Meme Difficulté,Adapte,Sociology
6619,2020,Sociologie,4,Notions de Sociologie,3,Organisation et Institution,14,1065,13,QCM,0.03,0.86,70.38,51,22,73,68,51,17,1.07,75.0,Facile,Facile,0,Meme Difficulté,Adapte,Sociology
1065,2015,Sociologie,4,Notions de Sociologie,3,Organisation et Institution,14,1066,14,QCU,0.69,0.21,7.77,6,68,74,63,6,57,1.17,9.52,Difficile,Difficile,0,Meme Difficulté,Pas Adapte,Sociology
2176,2016,Sociologie,4,Notions de Sociologie,3,Organisation et Institution,14,1066,14,QCM,0.67,0.23,9.96,6,58,64,43,6,37,1.49,13.95,Moyen,Difficile,-1,Plus Difficile,Pas Adapte,Sociology
3287,2017,Sociologie,4,Notions de Sociologie,3,Organisation et Institution,14,1066,14,QCM,0.64,0.26,15.23,9,53,62,61,9,52,1.02,14.75,Facile,Difficile,-2,Beaucoup plus Difficile,Pas Adapte,Sociology
4398,2018,Sociologie,4,Notions de Sociologie,3,Organisation et Institution,14,1066,14,QCM,0.76,0.28,20.3,14,53,67,20,14,6,3.35,70.0,Difficile,Difficile,0,Meme Difficulté,Pas Adapte,Sociology
5509,2019,Sociologie,4,Notions de Sociologie,3,Organisation et Institution,14,1066,14,QCM,0.15,0.94,90.54,53,5,58,56,53,3,1.04,94.64,Difficile,Facile,2,Beaucoup plus Facile,Pas Adapte,Sociology
6620,2020,Sociologie,4,Notions de Sociologie,3,Organisation et Institution,14,1066,14,QCM,0.07,0.77,90.14,50,6,56,52,50,2,1.08,96.15,Moyen,Facile,1,Plus Facile,Pas Adapte,Sociology
1066,2015,Sociologie,4,Notions de Sociologie,4,La Socialisation,7,1067,1,QCU,0.06,0.9,81.25,26,6,32,29,26,3,1.1,89.66,Facile,Facile,0,Meme Difficulté,Pas Adapte,Sociology
2177,2016,Sociologie,4,Notions de Sociologie,4,La Socialisation,7,1067,1,QCU,0.18,0.99,69.93,22,10,32,26,22,4,1.23,84.62,Facile,Facile,0,Meme Difficulté,Adapte,Sociology
3288,2017,Sociologie,4,Notions de Sociologie,4,La Socialisation,7,1067,1,QCU,0.15,1.0,69.93,25,11,36,35,25,10,1.03,71.43,Facile,Facile,0,Meme Difficulté,Adapte,Sociology
4399,2018,Sociologie,4,Notions de Sociologie,4,La Socialisation,7,1067,1,QROC,0.04,0.7,69.93,26,11,37,27,26,1,1.37,96.3,Facile,Facile,0,Meme Difficulté,Adapte,Sociology
5510,2019,Sociologie,4,Notions de Sociologie,4,La Socialisation,7,1067,1,QROC,0.1,0.42,69.93,25,11,36,29,25,4,1.24,86.21,Facile,Facile,0,Meme Difficulté,Adapte,Sociology
6621,2020,Sociologie,4,Notions de Sociologie,4,La Socialisation,7,1067,1,QCM,0.17,0.89,69.93,24,10,34,31,24,7,1.1,77.42,Facile,Facile,0,Meme Difficulté,Adapte,Sociology
1067,2015,Sociologie,4,Notions de Sociologie,4,La Socialisation,7,1068,2,QCM,0.39,0.63,56.84,7,5,12,9,7,2,1.33,77.78,Moyen,Moyen,0,Meme Difficulté,Pas Adapte,Sociology
2178,2016,Sociologie,4,Notions de Sociologie,4,La Socialisation,7,1068,2,QCM,0.59,0.2,22.5,3,9,12,4,3,1,3.0,75.0,Facile,Difficile,-2,Beaucoup plus Difficile,Pas Adapte,Sociology
3289,2017,Sociologie,4,Notions de Sociologie,4,La Socialisation,7,1068,2,QCM,0.05,0.79,78.12,8,2,10,8,8,0,1.25,100.0,Difficile,Facile,2,Beaucoup plus Facile,Pas Adapte,Sociology
4400,2018,Sociologie,4,Notions de Sociologie,4,La Socialisation,7,1068,2,QCM,0.28,0.57,50.12,5,4,9,5,5,0,1.8,100.0,Moyen,Moyen,0,Meme Difficulté,Pas Adapte,Sociology
5511,2019,Sociologie,4,Notions de Sociologie,4,La Socialisation,7,1068,2,QCM,0.32,0.51,42.09,4,6,10,7,4,3,1.43,57.14,Difficile,Moyen,1,Plus Facile,Pas Adapte,Sociology
6622,2020,Sociologie,4,Notions de Sociologie,4,La Socialisation,7,1068,2,QCM,0.35,0.36,55.44,6,5,11,9,6,3,1.22,66.67,Moyen,Moyen,0,Meme Difficulté,Pas Adapte,Sociology
1068,2015,Sociologie,4,Notions de Sociologie,4,La Socialisation,7,1069,3,QCM,0.64,0.25,13.54,2,12,14,14,2,12,1.0,14.29,Moyen,Difficile,-1,Plus Difficile,Pas Adapte,Sociology
2179,2016,Sociologie,4,Notions de Sociologie,4,La Socialisation,7,1069,3,QROC,0.31,0.32,54.3,7,5,12,8,7,1,1.5,87.5,Moyen,Moyen,0,Meme Difficulté,Pas Adapte,Sociology
3290,2017,Sociologie,4,Notions de Sociologie,4,La Socialisation,7,1069,3,QROC,0.05,0.44,76.89,8,2,10,10,8,2,1.0,80.0,Moyen,Facile,1,Plus Facile,Pas Adapte,Sociology
4401,2018,Sociologie,4,Notions de Sociologie,4,La Socialisation,7,1069,3,QROC,0.93,0.12,32.96,4,7,11,8,4,4,1.38,50.0,Difficile,Difficile,0,Meme Difficulté,Pas Adapte,Sociology
5512,2019,Sociologie,4,Notions de Sociologie,4,La Socialisation,7,1069,3,QROC,0.13,0.63,85.8,8,1,9,9,8,1,1.0,88.89,Facile,Facile,0,Meme Difficulté,Pas Adapte,Sociology
6623,2020,Sociologie,4,Notions de Sociologie,4,La Socialisation,7,1069,3,QROC,0.79,0.01,8.01,1,8,9,8,1,7,1.12,12.5,Facile,Difficile,-2,Beaucoup plus Difficile,Pas Adapte,Sociology
1069,2015,Sociologie,4,Notions de Sociologie,4,La Socialisation,7,1070,4,QCU,0.64,0.2,13.85,2,13,15,5,2,3,3.0,40.0,Difficile,Difficile,0,Meme Difficulté,Pas Adapte,Sociology
2180,2016,Sociologie,4,Notions de Sociologie,4,La Socialisation,7,1070,4,QCU,0.6,0.3,9.18,1,15,16,14,1,13,1.14,7.14,Difficile,Difficile,0,Meme Difficulté,Pas Adapte,Sociology
3291,2017,Sociologie,4,Notions de Sociologie,4,La Socialisation,7,1070,4,QCU,0.13,0.77,93.32,14,1,15,14,14,0,1.07,100.0,Facile,Facile,0,Meme Difficulté,Pas Adapte,Sociology
4402,2018,Sociologie,4,Notions de Sociologie,4,La Socialisation,7,1070,4,QCU,0.03,0.9,76.2,11,4,15,12,11,1,1.25,91.67,Facile,Facile,0,Meme Difficulté,Pas Adapte,Sociology
5513,2019,Sociologie,4,Notions de Sociologie,4,La Socialisation,7,1070,4,QCM,0.7,0.17,10.43,1,13,14,6,1,5,2.33,16.67,Moyen,Difficile,-1,Plus Difficile,Pas Adapte,Sociology
6624,2020,Sociologie,4,Notions de Sociologie,4,La Socialisation,7,1070,4,QCM,0.16,0.79,85.95,13,2,15,14,13,1,1.07,92.86,Difficile,Facile,2,Beaucoup plus Facile,Pas Adapte,Sociology
1070,2015,Sociologie,4,Notions de Sociologie,4,La Socialisation,7,1071,5,QO,0.91,0.02,17.56,16,75,91,70,16,54,1.3,22.86,Difficile,Difficile,0,Meme Difficulté,Pas Adapte,Sociology
2181,2016,Sociologie,4,Notions de Sociologie,4,La Socialisation,7,1071,5,QO,0.4,0.23,57.63,56,41,97,63,56,7,1.54,88.89,Difficile,Moyen,1,Plus Facile,Pas Adapte,Sociology
3292,2017,Sociologie,4,Notions de Sociologie,4,La Socialisation,7,1071,5,QO,0.11,0.83,79.78,88,22,110,108,88,20,1.02,81.48,Moyen,Facile,1,Plus Facile,Pas Adapte,Sociology
4403,2018,Sociologie,4,Notions de Sociologie,4,La Socialisation,7,1071,5,QO,0.96,0.13,12.41,15,103,118,116,15,101,1.02,12.93,Difficile,Difficile,0,Meme Difficulté,Pas Adapte,Sociology
5514,2019,Sociologie,4,Notions de Sociologie,4,La Socialisation,7,1071,5,QO,0.27,0.23,45.07,49,59,108,54,49,5,2.0,90.74,Difficile,Moyen,1,Plus Facile,Pas Adapte,Sociology
6625,2020,Sociologie,4,Notions de Sociologie,4,La Socialisation,7,1071,5,QROC,0.04,0.72,70.05,75,32,107,86,75,11,1.24,87.21,Difficile,Facile,2,Beaucoup plus Facile,Adapte,Sociology
1071,2015,Sociologie,4,Notions de Sociologie,4,La Socialisation,7,1072,6,QCM,0.06,0.81,72.21,59,23,82,79,59,20,1.04,74.68,Facile,Facile,0,Meme Difficulté,Adapte,Sociology
2182,2016,Sociologie,4,Notions de Sociologie,4,La Socialisation,7,1072,6,QCM,0.11,0.98,72.21,52,20,72,60,52,8,1.2,86.67,Facile,Facile,0,Meme Difficulté,Adapte,Sociology
3293,2017,Sociologie,4,Notions de Sociologie,4,La Socialisation,7,1072,6,QCM,0.02,0.8,72.21,48,19,67,49,48,1,1.37,97.96,Facile,Facile,0,Meme Difficulté,Adapte,Sociology
4404,2018,Sociologie,4,Notions de Sociologie,4,La Socialisation,7,1072,6,QCM,0.02,0.88,72.21,45,17,62,58,45,13,1.07,77.59,Facile,Facile,0,Meme Difficulté,Adapte,Sociology
5515,2019,Sociologie,4,Notions de Sociologie,4,La Socialisation,7,1072,6,QCM,0.11,0.8,72.21,39,15,54,54,39,15,1.0,72.22,Facile,Facile,0,Meme Difficulté,Adapte,Sociology
6626,2020,Sociologie,4,Notions de Sociologie,4,La Socialisation,7,1072,6,QCM,0.13,0.94,72.21,35,13,48,37,35,2,1.3,94.59,Facile,Facile,0,Meme Difficulté,Adapte,Sociology
1072,2015,Sociologie,4,Notions de Sociologie,4,La Socialisation,7,1073,7,QCM,0.62,0.16,23.87,2,7,9,7,2,5,1.29,28.57,Facile,Difficile,-2,Beaucoup plus Difficile,Pas Adapte,Sociology
2183,2016,Sociologie,4,Notions de Sociologie,4,La Socialisation,7,1073,7,QCM,0.09,0.83,92.24,9,1,10,10,9,1,1.0,90.0,Moyen,Facile,1,Plus Facile,Pas Adapte,Sociology
3294,2017,Sociologie,4,Notions de Sociologie,4,La Socialisation,7,1073,7,QCM,0.73,0.25,25.96,3,9,12,5,3,2,2.4,60.0,Facile,Difficile,-2,Beaucoup plus Difficile,Pas Adapte,Sociology
4405,2018,Sociologie,4,Notions de Sociologie,4,La Socialisation,7,1073,7,QROC,0.15,0.6,94.57,11,1,12,12,11,1,1.0,91.67,Difficile,Facile,2,Beaucoup plus Facile,Pas Adapte,Sociology
5516,2019,Sociologie,4,Notions de Sociologie,4,La Socialisation,7,1073,7,QROC,0.13,0.44,68.18,9,4,13,12,9,3,1.08,75.0,Facile,Facile,0,Meme Difficulté,Adapte,Sociology
6627,2020,Sociologie,4,Notions de Sociologie,4,La Socialisation,7,1073,7,QO,0.2,0.45,68.18,8,4,12,11,8,3,1.09,72.73,Facile,Facile,0,Meme Difficulté,Adapte,Sociology
1073,2015,Sociologie,4,Notions de Sociologie,5,Au-dela de l'Idee de Societe,8,1074,1,QCM,0.31,0.55,41.36,11,15,26,24,11,13,1.08,45.83,Difficile,Moyen,1,Plus Facile,Pas Adapte,Sociology
2184,2016,Sociologie,4,Notions de Sociologie,5,Au-dela de l'Idee de Societe,8,1074,1,QCU,0.07,0.85,98.01,22,0,22,22,22,0,1.0,100.0,Facile,Facile,0,Meme Difficulté,Pas Adapte,Sociology
3295,2017,Sociologie,4,Notions de Sociologie,5,Au-dela de l'Idee de Societe,8,1074,1,QCU,0.18,1.0,66.17,15,8,23,15,15,0,1.53,100.0,Facile,Facile,0,Meme Difficulté,Adapte,Sociology
4406,2018,Sociologie,4,Notions de Sociologie,5,Au-dela de l'Idee de Societe,8,1074,1,QCU,0.12,0.89,66.17,14,7,21,21,14,7,1.0,66.67,Facile,Facile,0,Meme Difficulté,Adapte,Sociology
5517,2019,Sociologie,4,Notions de Sociologie,5,Au-dela de l'Idee de Societe,8,1074,1,QCU,0.03,0.75,66.17,13,6,19,14,13,1,1.36,92.86,Facile,Facile,0,Meme Difficulté,Adapte,Sociology
6628,2020,Sociologie,4,Notions de Sociologie,5,Au-dela de l'Idee de Societe,8,1074,1,QCU,0.14,0.8,66.17,13,7,20,16,13,3,1.25,81.25,Facile,Facile,0,Meme Difficulté,Adapte,Sociology
1074,2015,Sociologie,4,Notions de Sociologie,5,Au-dela de l'Idee de Societe,8,1075,2,QCM,0.21,0.67,45.64,31,37,68,57,31,26,1.19,54.39,Facile,Moyen,-1,Plus Difficile,Pas Adapte,Sociology
2185,2016,Sociologie,4,Notions de Sociologie,5,Au-dela de l'Idee de Societe,8,1075,2,QCM,0.15,0.96,77.78,49,14,63,58,49,9,1.09,84.48,Facile,Facile,0,Meme Difficulté,Pas Adapte,Sociology
3296,2017,Sociologie,4,Notions de Sociologie,5,Au-dela de l'Idee de Societe,8,1075,2,QCM,0.04,0.85,96.44,64,2,66,65,64,1,1.02,98.46,Facile,Facile,0,Meme Difficulté,Pas Adapte,Sociology
4407,2018,Sociologie,4,Notions de Sociologie,5,Au-dela de l'Idee de Societe,8,1075,2,QCM,0.55,0.2,10.16,6,52,58,16,6,10,3.62,37.5,Moyen,Difficile,-1,Plus Difficile,Pas Adapte,Sociology
5518,2019,Sociologie,4,Notions de Sociologie,5,Au-dela de l'Idee de Societe,8,1075,2,QCM,0.74,0.22,32.4,21,45,66,52,21,31,1.27,40.38,Moyen,Difficile,-1,Plus Difficile,Pas Adapte,Sociology
6629,2020,Sociologie,4,Notions de Sociologie,5,Au-dela de l'Idee de Societe,8,1075,2,QCM,0.71,0.24,1.15,1,57,58,41,1,40,1.41,2.44,Moyen,Difficile,-1,Plus Difficile,Pas Adapte,Sociology
1075,2015,Sociologie,4,Notions de Sociologie,5,Au-dela de l'Idee de Societe,8,1076,3,QCM,0.27,0.47,63.43,25,15,40,27,25,2,1.48,92.59,Difficile,Moyen,1,Plus Facile,Adapte,Sociology
2186,2016,Sociologie,4,Notions de Sociologie,5,Au-dela de l'Idee de Societe,8,1076,3,QCM,0.2,0.47,63.43,29,16,45,30,29,1,1.5,96.67,Moyen,Moyen,0,Meme Difficulté,Adapte,Sociology
3297,2017,Sociologie,4,Notions de Sociologie,5,Au-dela de l'Idee de Societe,8,1076,3,QCM,0.34,0.47,63.43,26,15,41,29,26,3,1.41,89.66,Moyen,Moyen,0,Meme Difficulté,Adapte,Sociology
4408,2018,Sociologie,4,Notions de Sociologie,5,Au-dela de l'Idee de Societe,8,1076,3,QCM,0.43,0.63,63.43,25,15,40,29,25,4,1.38,86.21,Moyen,Moyen,0,Meme Difficulté,Adapte,Sociology
5519,2019,Sociologie,4,Notions de Sociologie,5,Au-dela de l'Idee de Societe,8,1076,3,QCM,0.33,0.38,63.43,23,14,37,28,23,5,1.32,82.14,Moyen,Moyen,0,Meme Difficulté,Adapte,Sociology
6630,2020,Sociologie,4,Notions de Sociologie,5,Au-dela de l'Idee de Societe,8,1076,3,QCM,0.39,0.42,63.43,27,15,42,33,27,6,1.27,81.82,Moyen,Moyen,0,Meme Difficulté,Adapte,Sociology
1076,2015,Sociologie,4,Notions de Sociologie,5,Au-dela de l'Idee de Societe,8,1077,4,QCU,0.23,0.53,53.59,54,46,100,82,54,28,1.22,65.85,Moyen,Moyen,0,Meme Difficulté,Pas Adapte,Sociology
2187,2016,Sociologie,4,Notions de Sociologie,5,Au-dela de l'Idee de Societe,8,1077,4,QCU,0.24,0.56,53.63,56,48,104,69,56,13,1.51,81.16,Difficile,Moyen,1,Plus Facile,Pas Adapte,Sociology
3298,2017,Sociologie,4,Notions de Sociologie,5,Au-dela de l'Idee de Societe,8,1077,4,QCU,0.18,0.95,67.46,74,36,110,108,74,34,1.02,68.52,Moyen,Facile,1,Plus Facile,Adapte,Sociology
4409,2018,Sociologie,4,Notions de Sociologie,5,Au-dela de l'Idee de Societe,8,1077,4,QCU,0.04,0.98,67.46,67,32,99,85,67,18,1.16,78.82,Facile,Facile,0,Meme Difficulté,Adapte,Sociology
5520,2019,Sociologie,4,Notions de Sociologie,5,Au-dela de l'Idee de Societe,8,1077,4,QCU,0.16,0.95,67.46,69,33,102,78,69,9,1.31,88.46,Facile,Facile,0,Meme Difficulté,Adapte,Sociology
6631,2020,Sociologie,4,Notions de Sociologie,5,Au-dela de l'Idee de Societe,8,1077,4,QCU,0.18,0.77,67.46,68,33,101,78,68,10,1.29,87.18,Facile,Facile,0,Meme Difficulté,Adapte,Sociology
1077,2015,Sociologie,4,Notions de Sociologie,5,Au-dela de l'Idee de Societe,8,1078,5,QCM,0.74,0.28,30.69,30,69,99,98,30,68,1.01,30.61,Difficile,Difficile,0,Meme Difficulté,Pas Adapte,Sociology
2188,2016,Sociologie,4,Notions de Sociologie,5,Au-dela de l'Idee de Societe,8,1078,5,QCM,0.01,0.72,71.61,66,26,92,87,66,21,1.06,75.86,Facile,Facile,0,Meme Difficulté,Adapte,Sociology
3299,2017,Sociologie,4,Notions de Sociologie,5,Au-dela de l'Idee de Societe,8,1078,5,QCM,0.14,0.94,71.61,62,24,86,70,62,8,1.23,88.57,Facile,Facile,0,Meme Difficulté,Adapte,Sociology
4410,2018,Sociologie,4,Notions de Sociologie,5,Au-dela de l'Idee de Societe,8,1078,5,QCU,0.07,0.86,71.61,65,26,91,81,65,16,1.12,80.25,Facile,Facile,0,Meme Difficulté,Adapte,Sociology
5521,2019,Sociologie,4,Notions de Sociologie,5,Au-dela de l'Idee de Societe,8,1078,5,QCU,0.04,0.96,71.61,72,28,100,84,72,12,1.19,85.71,Facile,Facile,0,Meme Difficulté,Adapte,Sociology
6632,2020,Sociologie,4,Notions de Sociologie,5,Au-dela de l'Idee de Societe,8,1078,5,QCU,0.14,0.88,71.61,77,31,108,99,77,22,1.09,77.78,Facile,Facile,0,Meme Difficulté,Adapte,Sociology
1078,2015,Sociologie,4,Notions de Sociologie,5,Au-dela de l'Idee de Societe,8,1079,6,QCM,0.71,0.17,29.09,26,64,90,47,26,21,1.91,55.32,Facile,Difficile,-2,Beaucoup plus Difficile,Pas Adapte,Sociology
2189,2016,Sociologie,4,Notions de Sociologie,5,Au-dela de l'Idee de Societe,8,1079,6,QCM,0.31,0.44,47.75,37,40,77,68,37,31,1.13,54.41,Facile,Moyen,-1,Plus Difficile,Pas Adapte,Sociology
3300,2017,Sociologie,4,Notions de Sociologie,5,Au-dela de l'Idee de Societe,8,1079,6,QCU,0.29,0.46,57.21,50,37,87,86,50,36,1.01,58.14,Moyen,Moyen,0,Meme Difficulté,Pas Adapte,Sociology
4411,2018,Sociologie,4,Notions de Sociologie,5,Au-dela de l'Idee de Societe,8,1079,6,QCU,0.3,0.67,44.75,44,55,99,53,44,9,1.87,83.02,Facile,Moyen,-1,Plus Difficile,Pas Adapte,Sociology
5522,2019,Sociologie,4,Notions de Sociologie,5,Au-dela de l'Idee de Societe,8,1079,6,QCU,0.15,1.0,83.68,94,18,112,112,94,18,1.0,83.93,Facile,Facile,0,Meme Difficulté,Pas Adapte,Sociology
6633,2020,Sociologie,4,Notions de Sociologie,5,Au-dela de l'Idee de Societe,8,1079,6,QCU,0.39,0.68,46.84,60,69,129,95,60,35,1.36,63.16,Moyen,Moyen,0,Meme Difficulté,Pas Adapte,Sociology
1079,2015,Sociologie,4,Notions de Sociologie,5,Au-dela de l'Idee de Societe,8,1080,7,QCM,0.51,0.21,24.63,7,22,29,28,7,21,1.04,25.0,Difficile,Difficile,0,Meme Difficulté,Pas Adapte,Sociology
2190,2016,Sociologie,4,Notions de Sociologie,5,Au-dela de l'Idee de Societe,8,1080,7,QCM,0.21,0.43,42.06,12,16,28,14,12,2,2.0,85.71,Difficile,Moyen,1,Plus Facile,Pas Adapte,Sociology
3301,2017,Sociologie,4,Notions de Sociologie,5,Au-dela de l'Idee de Societe,8,1080,7,QCM,0.43,0.67,46.61,13,14,27,15,13,2,1.8,86.67,Facile,Moyen,-1,Plus Difficile,Pas Adapte,Sociology
4412,2018,Sociologie,4,Notions de Sociologie,5,Au-dela de l'Idee de Societe,8,1080,7,QCM,0.26,0.64,52.63,15,13,28,18,15,3,1.56,83.33,Facile,Moyen,-1,Plus Difficile,Pas Adapte,Sociology
5523,2019,Sociologie,4,Notions de Sociologie,5,Au-dela de l'Idee de Societe,8,1080,7,QCM,0.52,0.27,28.73,7,18,25,16,7,9,1.56,43.75,Difficile,Difficile,0,Meme Difficulté,Pas Adapte,Sociology
6634,2020,Sociologie,4,Notions de Sociologie,5,Au-dela de l'Idee de Societe,8,1080,7,QCU,0.6,0.21,6.58,2,25,27,18,2,16,1.5,11.11,Facile,Difficile,-2,Beaucoup plus Difficile,Pas Adapte,Sociology
1080,2015,Sociologie,4,Notions de Sociologie,5,Au-dela de l'Idee de Societe,8,1081,8,QCM,0.74,0.29,31.85,18,39,57,55,18,37,1.04,32.73,Difficile,Difficile,0,Meme Difficulté,Pas Adapte,Sociology
2191,2016,Sociologie,4,Notions de Sociologie,5,Au-dela de l'Idee de Societe,8,1081,8,QCM,0.71,0.18,15.82,9,47,56,38,9,29,1.47,23.68,Difficile,Difficile,0,Meme Difficulté,Pas Adapte,Sociology
3302,2017,Sociologie,4,Notions de Sociologie,5,Au-dela de l'Idee de Societe,8,1081,8,QCM,0.0,0.97,75.09,44,14,58,55,44,11,1.05,80.0,Moyen,Facile,1,Plus Facile,Pas Adapte,Sociology
4413,2018,Sociologie,4,Notions de Sociologie,5,Au-dela de l'Idee de Societe,8,1081,8,QCM,0.53,0.26,33.42,17,33,50,26,17,9,1.92,65.38,Facile,Difficile,-2,Beaucoup plus Difficile,Pas Adapte,Sociology
5524,2019,Sociologie,4,Notions de Sociologie,5,Au-dela de l'Idee de Societe,8,1081,8,QCM,0.75,0.24,2.73,1,49,50,17,1,16,2.94,5.88,Moyen,Difficile,-1,Plus Difficile,Pas Adapte,Sociology
6635,2020,Sociologie,4,Notions de Sociologie,5,Au-dela de l'Idee de Societe,8,1081,8,QCM,0.18,0.91,98.83,49,1,50,49,49,0,1.02,100.0,Moyen,Facile,1,Plus Facile,Pas Adapte,Sociology
1081,2015,Sociologie,5,Sociologie Generale,1,"Le Sociologue, la Sociologie et la Vie Sociale",9,1082,1,QCU,0.18,0.87,92.63,17,1,18,18,17,1,1.0,94.44,Moyen,Facile,1,Plus Facile,Pas Adapte,Sociology
2192,2016,Sociologie,5,Sociologie Generale,1,"Le Sociologue, la Sociologie et la Vie Sociale",9,1082,1,QCU,0.14,0.85,66.08,10,5,15,11,10,1,1.36,90.91,Difficile,Facile,2,Beaucoup plus Facile,Adapte,Sociology
3303,2017,Sociologie,5,Sociologie Generale,1,"Le Sociologue, la Sociologie et la Vie Sociale",9,1082,1,QCU,0.09,0.96,66.08,9,4,13,11,9,2,1.18,81.82,Facile,Facile,0,Meme Difficulté,Adapte,Sociology
4414,2018,Sociologie,5,Sociologie Generale,1,"Le Sociologue, la Sociologie et la Vie Sociale",9,1082,1,QCU,0.18,0.76,66.08,7,4,11,10,7,3,1.1,70.0,Facile,Facile,0,Meme Difficulté,Adapte,Sociology
5525,2019,Sociologie,5,Sociologie Generale,1,"Le Sociologue, la Sociologie et la Vie Sociale",9,1082,1,QCU,0.01,0.96,66.08,9,4,13,11,9,2,1.18,81.82,Facile,Facile,0,Meme Difficulté,Adapte,Sociology
6636,2020,Sociologie,5,Sociologie Generale,1,"Le Sociologue, la Sociologie et la Vie Sociale",9,1082,1,QCM,0.05,0.82,66.08,7,4,11,10,7,3,1.1,70.0,Facile,Facile,0,Meme Difficulté,Adapte,Sociology
1082,2015,Sociologie,5,Sociologie Generale,1,"Le Sociologue, la Sociologie et la Vie Sociale",9,1083,2,QO,0.86,0.14,31.7,9,20,29,23,9,14,1.26,39.13,Facile,Difficile,-2,Beaucoup plus Difficile,Pas Adapte,Sociology
2193,2016,Sociologie,5,Sociologie Generale,1,"Le Sociologue, la Sociologie et la Vie Sociale",9,1083,2,QO,0.98,0.09,33.1,10,20,30,23,10,13,1.3,43.48,Facile,Difficile,-2,Beaucoup plus Difficile,Pas Adapte,Sociology
3304,2017,Sociologie,5,Sociologie Generale,1,"Le Sociologue, la Sociologie et la Vie Sociale",9,1083,2,QO,0.14,0.73,74.28,22,8,30,24,22,2,1.25,91.67,Difficile,Facile,2,Beaucoup plus Facile,Adapte,Sociology
4415,2018,Sociologie,5,Sociologie Generale,1,"Le Sociologue, la Sociologie et la Vie Sociale",9,1083,2,QO,0.17,0.45,74.28,23,8,31,24,23,1,1.29,95.83,Facile,Facile,0,Meme Difficulté,Adapte,Sociology
5526,2019,Sociologie,5,Sociologie Generale,1,"Le Sociologue, la Sociologie et la Vie Sociale",9,1083,2,QROC,0.11,0.91,74.28,27,9,36,33,27,6,1.09,81.82,Facile,Facile,0,Meme Difficulté,Adapte,Sociology
6637,2020,Sociologie,5,Sociologie Generale,1,"Le Sociologue, la Sociologie et la Vie Sociale",9,1083,2,QROC,0.02,0.93,74.28,30,10,40,38,30,8,1.05,78.95,Facile,Facile,0,Meme Difficulté,Adapte,Sociology
1083,2015,Sociologie,5,Sociologie Generale,1,"Le Sociologue, la Sociologie et la Vie Sociale",9,1084,3,QCM,0.15,0.95,92.06,27,2,29,27,27,0,1.07,100.0,Difficile,Facile,2,Beaucoup plus Facile,Pas Adapte,Sociology
2194,2016,Sociologie,5,Sociologie Generale,1,"Le Sociologue, la Sociologie et la Vie Sociale",9,1084,3,QCU,0.53,0.32,11.91,3,23,26,19,3,16,1.37,15.79,Facile,Difficile,-2,Beaucoup plus Difficile,Pas Adapte,Sociology
3305,2017,Sociologie,5,Sociologie Generale,1,"Le Sociologue, la Sociologie et la Vie Sociale",9,1084,3,QCU,0.22,0.45,46.09,10,12,22,10,10,0,2.2,100.0,Moyen,Moyen,0,Meme Difficulté,Pas Adapte,Sociology
4416,2018,Sociologie,5,Sociologie Generale,1,"Le Sociologue, la Sociologie et la Vie Sociale",9,1084,3,QCU,0.39,0.73,37.9,9,14,23,20,9,11,1.15,45.0,Facile,Moyen,-1,Plus Difficile,Pas Adapte,Sociology
5527,2019,Sociologie,5,Sociologie Generale,1,"Le Sociologue, la Sociologie et la Vie Sociale",9,1084,3,QCU,0.42,0.26,22.93,6,18,24,21,6,15,1.14,28.57,Facile,Difficile,-2,Beaucoup plus Difficile,Pas Adapte,Sociology
6638,2020,Sociologie,5,Sociologie Generale,1,"Le Sociologue, la Sociologie et la Vie Sociale",9,1084,3,QROC,0.71,0.24,20.63,5,21,26,21,5,16,1.24,23.81,Difficile,Difficile,0,Meme Difficulté,Pas Adapte,Sociology
1084,2015,Sociologie,5,Sociologie Generale,1,"Le Sociologue, la Sociologie et la Vie Sociale",9,1085,4,QCU,0.27,0.55,60.1,50,34,84,63,50,13,1.33,79.37,Facile,Moyen,-1,Plus Difficile,Adapte,Sociology
2195,2016,Sociologie,5,Sociologie Generale,1,"Le Sociologue, la Sociologie et la Vie Sociale",9,1085,4,QCU,0.22,0.64,60.1,50,34,84,59,50,9,1.42,84.75,Moyen,Moyen,0,Meme Difficulté,Adapte,Sociology
3306,2017,Sociologie,5,Sociologie Generale,1,"Le Sociologue, la Sociologie et la Vie Sociale",9,1085,4,QCU,0.22,0.62,60.1,44,29,73,45,44,1,1.62,97.78,Moyen,Moyen,0,Meme Difficulté,Adapte,Sociology
4417,2018,Sociologie,5,Sociologie Generale,1,"Le Sociologue, la Sociologie et la Vie Sociale",9,1085,4,QCU,0.36,0.44,60.1,40,27,67,50,40,10,1.34,80.0,Moyen,Moyen,0,Meme Difficulté,Adapte,Sociology
5528,2019,Sociologie,5,Sociologie Generale,1,"Le Sociologue, la Sociologie et la Vie Sociale",9,1085,4,QCU,0.29,0.42,60.1,41,28,69,43,41,2,1.6,95.35,Moyen,Moyen,0,Meme Difficulté,Adapte,Sociology
6639,2020,Sociologie,5,Sociologie Generale,1,"Le Sociologue, la Sociologie et la Vie Sociale",9,1085,4,QCU,0.31,0.48,60.1,35,24,59,48,35,13,1.23,72.92,Moyen,Moyen,0,Meme Difficulté,Adapte,Sociology
1085,2015,Sociologie,5,Sociologie Generale,1,"Le Sociologue, la Sociologie et la Vie Sociale",9,1086,5,QCU,0.58,0.36,14.46,12,71,83,64,12,52,1.3,18.75,Facile,Difficile,-2,Beaucoup plus Difficile,Pas Adapte,Sociology
2196,2016,Sociologie,5,Sociologie Generale,1,"Le Sociologue, la Sociologie et la Vie Sociale",9,1086,5,QCU,0.07,0.8,79.43,64,17,81,71,64,7,1.14,90.14,Difficile,Facile,2,Beaucoup plus Facile,Pas Adapte,Sociology
3307,2017,Sociologie,5,Sociologie Generale,1,"Le Sociologue, la Sociologie et la Vie Sociale",9,1086,5,QCU,0.56,0.37,12.11,9,62,71,35,9,26,2.03,25.71,Facile,Difficile,-2,Beaucoup plus Difficile,Pas Adapte,Sociology
4418,2018,Sociologie,5,Sociologie Generale,1,"Le Sociologue, la Sociologie et la Vie Sociale",9,1086,5,QCU,0.16,0.85,68.85,44,20,64,60,44,16,1.07,73.33,Difficile,Facile,2,Beaucoup plus Facile,Adapte,Sociology
5529,2019,Sociologie,5,Sociologie Generale,1,"Le Sociologue, la Sociologie et la Vie Sociale",9,1086,5,QCM,0.03,0.92,68.85,45,21,66,52,45,7,1.27,86.54,Facile,Facile,0,Meme Difficulté,Adapte,Sociology
6640,2020,Sociologie,5,Sociologie Generale,1,"Le Sociologue, la Sociologie et la Vie Sociale",9,1086,5,QCM,0.15,0.92,68.85,39,18,57,43,39,4,1.33,90.7,Facile,Facile,0,Meme Difficulté,Adapte,Sociology
1086,2015,Sociologie,5,Sociologie Generale,1,"Le Sociologue, la Sociologie et la Vie Sociale",9,1087,6,QCM,0.71,0.25,14.6,5,26,31,17,5,12,1.82,29.41,Difficile,Difficile,0,Meme Difficulté,Pas Adapte,Sociology
2197,2016,Sociologie,5,Sociologie Generale,1,"Le Sociologue, la Sociologie et la Vie Sociale",9,1087,6,QCM,0.56,0.29,1.71,0,26,26,20,0,20,1.3,0.0,Facile,Difficile,-2,Beaucoup plus Difficile,Pas Adapte,Sociology
3308,2017,Sociologie,5,Sociologie Generale,1,"Le Sociologue, la Sociologie et la Vie Sociale",9,1087,6,QCU,0.28,0.41,62.67,19,11,30,23,19,4,1.3,82.61,Facile,Moyen,-1,Plus Difficile,Adapte,Sociology
4419,2018,Sociologie,5,Sociologie Generale,1,"Le Sociologue, la Sociologie et la Vie Sociale",9,1087,6,QCU,0.25,0.73,62.67,18,11,29,29,18,11,1.0,62.07,Moyen,Moyen,0,Meme Difficulté,Adapte,Sociology
5530,2019,Sociologie,5,Sociologie Generale,1,"Le Sociologue, la Sociologie et la Vie Sociale",9,1087,6,QCU,0.21,0.48,62.67,16,10,26,19,16,3,1.37,84.21,Moyen,Moyen,0,Meme Difficulté,Adapte,Sociology
6641,2020,Sociologie,5,Sociologie Generale,1,"Le Sociologue, la Sociologie et la Vie Sociale",9,1087,6,QCU,0.24,0.72,62.67,18,10,28,18,18,0,1.56,100.0,Moyen,Moyen,0,Meme Difficulté,Adapte,Sociology
1087,2015,Sociologie,5,Sociologie Generale,1,"Le Sociologue, la Sociologie et la Vie Sociale",9,1088,7,QCM,0.14,0.8,66.96,54,27,81,62,54,8,1.31,87.1,Facile,Facile,0,Meme Difficulté,Adapte,Sociology
2198,2016,Sociologie,5,Sociologie Generale,1,"Le Sociologue, la Sociologie et la Vie Sociale",9,1088,7,QCM,0.15,0.96,66.96,48,24,72,66,48,18,1.09,72.73,Facile,Facile,0,Meme Difficulté,Adapte,Sociology
3309,2017,Sociologie,5,Sociologie Generale,1,"Le Sociologue, la Sociologie et la Vie Sociale",9,1088,7,QCM,0.02,0.72,66.96,54,27,81,66,54,12,1.23,81.82,Facile,Facile,0,Meme Difficulté,Adapte,Sociology
4420,2018,Sociologie,5,Sociologie Generale,1,"Le Sociologue, la Sociologie et la Vie Sociale",9,1088,7,QCM,0.08,0.76,66.96,62,31,93,90,62,28,1.03,68.89,Facile,Facile,0,Meme Difficulté,Adapte,Sociology
5531,2019,Sociologie,5,Sociologie Generale,1,"Le Sociologue, la Sociologie et la Vie Sociale",9,1088,7,QCM,0.02,0.76,66.96,59,29,88,63,59,4,1.4,93.65,Facile,Facile,0,Meme Difficulté,Adapte,Sociology
6642,2020,Sociologie,5,Sociologie Generale,1,"Le Sociologue, la Sociologie et la Vie Sociale",9,1088,7,QCU,0.02,0.97,66.96,67,33,100,83,67,16,1.2,80.72,Facile,Facile,0,Meme Difficulté,Adapte,Sociology
1088,2015,Sociologie,5,Sociologie Generale,1,"Le Sociologue, la Sociologie et la Vie Sociale",9,1089,8,QROC,0.2,0.87,70.95,57,24,81,73,57,16,1.11,78.08,Facile,Facile,0,Meme Difficulté,Adapte,Sociology
2199,2016,Sociologie,5,Sociologie Generale,1,"Le Sociologue, la Sociologie et la Vie Sociale",9,1089,8,QROC,0.07,0.78,70.95,65,26,91,82,65,17,1.11,79.27,Facile,Facile,0,Meme Difficulté,Adapte,Sociology
3310,2017,Sociologie,5,Sociologie Generale,1,"Le Sociologue, la Sociologie et la Vie Sociale",9,1089,8,QROC,0.11,0.61,70.95,68,28,96,86,68,18,1.12,79.07,Facile,Facile,0,Meme Difficulté,Adapte,Sociology
4421,2018,Sociologie,5,Sociologie Generale,1,"Le Sociologue, la Sociologie et la Vie Sociale",9,1089,8,QROC,0.13,0.63,70.95,64,26,90,89,64,25,1.01,71.91,Facile,Facile,0,Meme Difficulté,Adapte,Sociology
5532,2019,Sociologie,5,Sociologie Generale,1,"Le Sociologue, la Sociologie et la Vie Sociale",9,1089,8,QROC,0.14,0.5,70.95,62,25,87,64,62,2,1.36,96.88,Facile,Facile,0,Meme Difficulté,Adapte,Sociology
6643,2020,Sociologie,5,Sociologie Generale,1,"Le Sociologue, la Sociologie et la Vie Sociale",9,1089,8,QROC,0.02,0.43,70.95,67,27,94,91,67,24,1.03,73.63,Facile,Facile,0,Meme Difficulté,Adapte,Sociology
1089,2015,Sociologie,5,Sociologie Generale,1,"Le Sociologue, la Sociologie et la Vie Sociale",9,1090,9,QCU,0.02,0.85,73.67,62,22,84,65,62,3,1.29,95.38,Difficile,Facile,2,Beaucoup plus Facile,Adapte,Sociology
2200,2016,Sociologie,5,Sociologie Generale,1,"Le Sociologue, la Sociologie et la Vie Sociale",9,1090,9,QCU,0.03,0.77,73.67,61,22,83,78,61,17,1.06,78.21,Facile,Facile,0,Meme Difficulté,Adapte,Sociology
3311,2017,Sociologie,5,Sociologie Generale,1,"Le Sociologue, la Sociologie et la Vie Sociale",9,1090,9,QCU,0.11,0.84,73.67,60,22,82,62,60,2,1.32,96.77,Facile,Facile,0,Meme Difficulté,Adapte,Sociology
4422,2018,Sociologie,5,Sociologie Generale,1,"Le Sociologue, la Sociologie et la Vie Sociale",9,1090,9,QCU,0.12,0.86,73.67,55,20,75,60,55,5,1.25,91.67,Facile,Facile,0,Meme Difficulté,Adapte,Sociology
5533,2019,Sociologie,5,Sociologie Generale,1,"Le Sociologue, la Sociologie et la Vie Sociale",9,1090,9,QCU,0.07,0.96,73.67,49,18,67,61,49,12,1.1,80.33,Facile,Facile,0,Meme Difficulté,Adapte,Sociology
6644,2020,Sociologie,5,Sociologie Generale,1,"Le Sociologue, la Sociologie et la Vie Sociale",9,1090,9,QCU,0.2,0.79,73.67,52,19,71,61,52,9,1.16,85.25,Facile,Facile,0,Meme Difficulté,Adapte,Sociology
1090,2015,Sociologie,5,Sociologie Generale,2,La Theorie Sociologique,6,1091,1,QCM,0.1,0.77,89.25,30,4,34,33,30,3,1.03,90.91,Difficile,Facile,2,Beaucoup plus Facile,Pas Adapte,Sociology
2201,2016,Sociologie,5,Sociologie Generale,2,La Theorie Sociologique,6,1091,1,QCM,0.46,0.69,51.07,20,19,39,34,20,14,1.15,58.82,Difficile,Moyen,1,Plus Facile,Pas Adapte,Sociology
3312,2017,Sociologie,5,Sociologie Generale,2,La Theorie Sociologique,6,1091,1,QCM,0.24,0.37,60.46,26,17,43,29,26,3,1.48,89.66,Moyen,Moyen,0,Meme Difficulté,Adapte,Sociology
4423,2018,Sociologie,5,Sociologie Generale,2,La Theorie Sociologique,6,1091,1,QCM,0.31,0.36,60.46,28,19,47,33,28,5,1.42,84.85,Moyen,Moyen,0,Meme Difficulté,Adapte,Sociology
5534,2019,Sociologie,5,Sociologie Generale,2,La Theorie Sociologique,6,1091,1,QCM,0.28,0.51,60.46,33,21,54,44,33,11,1.23,75.0,Moyen,Moyen,0,Meme Difficulté,Adapte,Sociology
6645,2020,Sociologie,5,Sociologie Generale,2,La Theorie Sociologique,6,1091,1,QCM,0.28,0.41,60.46,30,19,49,38,30,8,1.29,78.95,Moyen,Moyen,0,Meme Difficulté,Adapte,Sociology
1091,2015,Sociologie,5,Sociologie Generale,2,La Theorie Sociologique,6,1092,2,QROC,0.79,0.17,19.08,3,14,17,15,3,12,1.13,20.0,Moyen,Difficile,-1,Plus Difficile,Pas Adapte,Sociology
2202,2016,Sociologie,5,Sociologie Generale,2,La Theorie Sociologique,6,1092,2,QROC,0.44,0.3,42.27,6,8,14,11,6,5,1.27,54.55,Moyen,Moyen,0,Meme Difficulté,Pas Adapte,Sociology
3313,2017,Sociologie,5,Sociologie Generale,2,La Theorie Sociologique,6,1092,2,QROC,0.35,0.26,57.68,9,6,15,12,9,3,1.25,75.0,Moyen,Moyen,0,Meme Difficulté,Pas Adapte,Sociology
4424,2018,Sociologie,5,Sociologie Generale,2,La Theorie Sociologique,6,1092,2,QROC,0.36,0.32,54.13,8,6,14,12,8,4,1.17,66.67,Facile,Moyen,-1,Plus Difficile,Pas Adapte,Sociology
5535,2019,Sociologie,5,Sociologie Generale,2,La Theorie Sociologique,6,1092,2,QROC,0.55,0.35,41.0,6,9,15,12,6,6,1.25,50.0,Moyen,Moyen,0,Meme Difficulté,Pas Adapte,Sociology
6646,2020,Sociologie,5,Sociologie Generale,2,La Theorie Sociologique,6,1092,2,QROC,0.99,0.05,16.72,3,12,15,14,3,11,1.07,21.43,Facile,Difficile,-2,Beaucoup plus Difficile,Pas Adapte,Sociology
1092,2015,Sociologie,5,Sociologie Generale,2,La Theorie Sociologique,6,1093,3,QROC,0.16,0.92,78.51,4,1,5,5,4,1,1.0,80.0,Difficile,Facile,2,Beaucoup plus Facile,Pas Adapte,Sociology
2203,2016,Sociologie,5,Sociologie Generale,2,La Theorie Sociologique,6,1093,3,QROC,0.53,0.36,57.12,2,2,4,4,2,2,1.0,50.0,Moyen,Moyen,0,Meme Difficulté,Pas Adapte,Sociology
3314,2017,Sociologie,5,Sociologie Generale,2,La Theorie Sociologique,6,1093,3,QROC,0.46,0.39,58.97,2,2,4,2,2,0,2.0,100.0,Facile,Moyen,-1,Plus Difficile,Pas Adapte,Sociology
4425,2018,Sociologie,5,Sociologie Generale,2,La Theorie Sociologique,6,1093,3,QROC,0.04,0.47,89.07,4,0,4,4,4,0,1.0,100.0,Difficile,Facile,2,Beaucoup plus Facile,Pas Adapte,Sociology
5536,2019,Sociologie,5,Sociologie Generale,2,La Theorie Sociologique,6,1093,3,QROC,0.46,0.3,53.9,2,2,4,4,2,2,1.0,50.0,Facile,Moyen,-1,Plus Difficile,Pas Adapte,Sociology
6647,2020,Sociologie,5,Sociologie Generale,2,La Theorie Sociologique,6,1093,3,QROC,0.06,0.78,94.11,5,0,5,5,5,0,1.0,100.0,Moyen,Facile,1,Plus Facile,Pas Adapte,Sociology
1093,2015,Sociologie,5,Sociologie Generale,2,La Theorie Sociologique,6,1094,4,QCU,0.03,0.92,79.0,40,10,50,46,40,6,1.09,86.96,Facile,Facile,0,Meme Difficulté,Pas Adapte,Sociology
2204,2016,Sociologie,5,Sociologie Generale,2,La Theorie Sociologique,6,1094,4,QCU,0.36,0.68,64.06,29,16,45,32,29,3,1.41,90.62,Difficile,Moyen,1,Plus Facile,Adapte,Sociology
3315,2017,Sociologie,5,Sociologie Generale,2,La Theorie Sociologique,6,1094,4,QCU,0.32,0.56,64.06,32,18,50,42,32,10,1.19,76.19,Moyen,Moyen,0,Meme Difficulté,Adapte,Sociology
4426,2018,Sociologie,5,Sociologie Generale,2,La Theorie Sociologique,6,1094,4,QCU,0.36,0.41,64.06,27,15,42,36,27,9,1.17,75.0,Moyen,Moyen,0,Meme Difficulté,Adapte,Sociology
5537,2019,Sociologie,5,Sociologie Generale,2,La Theorie Sociologique,6,1094,4,QCU,0.27,0.67,64.06,26,14,40,34,26,8,1.18,76.47,Moyen,Moyen,0,Meme Difficulté,Adapte,Sociology
6648,2020,Sociologie,5,Sociologie Generale,2,La Theorie Sociologique,6,1094,4,QCU,0.23,0.57,64.06,26,14,40,38,26,12,1.05,68.42,Moyen,Moyen,0,Meme Difficulté,Adapte,Sociology
1094,2015,Sociologie,5,Sociologie Generale,2,La Theorie Sociologique,6,1095,5,QCM,0.53,0.18,20.54,9,34,43,31,9,22,1.39,29.03,Difficile,Difficile,0,Meme Difficulté,Pas Adapte,Sociology
2205,2016,Sociologie,5,Sociologie Generale,2,La Theorie Sociologique,6,1095,5,QCM,0.02,0.93,86.58,42,7,49,47,42,5,1.04,89.36,Difficile,Facile,2,Beaucoup plus Facile,Pas Adapte,Sociology
3316,2017,Sociologie,5,Sociologie Generale,2,La Theorie Sociologique,6,1095,5,QCM,0.03,0.96,87.16,37,5,42,41,37,4,1.02,90.24,Difficile,Facile,2,Beaucoup plus Facile,Pas Adapte,Sociology
4427,2018,Sociologie,5,Sociologie Generale,2,La Theorie Sociologique,6,1095,5,QCM,0.06,0.76,69.17,33,15,48,48,33,15,1.0,68.75,Moyen,Facile,1,Plus Facile,Adapte,Sociology
5538,2019,Sociologie,5,Sociologie Generale,2,La Theorie Sociologique,6,1095,5,QCM,0.13,0.89,69.17,37,16,53,46,37,9,1.15,80.43,Facile,Facile,0,Meme Difficulté,Adapte,Sociology
6649,2020,Sociologie,5,Sociologie Generale,2,La Theorie Sociologique,6,1095,5,QCM,0.14,0.79,69.17,33,14,47,35,33,2,1.34,94.29,Facile,Facile,0,Meme Difficulté,Adapte,Sociology
1095,2015,Sociologie,5,Sociologie Generale,2,La Theorie Sociologique,6,1096,6,QCU,0.19,0.96,97.83,52,1,53,53,52,1,1.0,98.11,Moyen,Facile,1,Plus Facile,Pas Adapte,Sociology
2206,2016,Sociologie,5,Sociologie Generale,2,La Theorie Sociologique,6,1096,6,QCU,0.22,0.52,42.76,19,26,45,37,19,18,1.22,51.35,Difficile,Moyen,1,Plus Facile,Pas Adapte,Sociology
3317,2017,Sociologie,5,Sociologie Generale,2,La Theorie Sociologique,6,1096,6,QCU,0.13,0.83,81.51,40,9,49,48,40,8,1.02,83.33,Difficile,Facile,2,Beaucoup plus Facile,Pas Adapte,Sociology
4428,2018,Sociologie,5,Sociologie Generale,2,La Theorie Sociologique,6,1096,6,QCU,0.34,0.47,39.11,19,29,48,28,19,9,1.71,67.86,Moyen,Moyen,0,Meme Difficulté,Pas Adapte,Sociology
5539,2019,Sociologie,5,Sociologie Generale,2,La Theorie Sociologique,6,1096,6,QCU,0.6,0.25,8.61,4,43,47,27,4,23,1.74,14.81,Difficile,Difficile,0,Meme Difficulté,Pas Adapte,Sociology
6650,2020,Sociologie,5,Sociologie Generale,2,La Theorie Sociologique,6,1096,6,QCU,0.18,0.96,85.91,44,7,51,50,44,6,1.02,88.0,Difficile,Facile,2,Beaucoup plus Facile,Pas Adapte,Sociology
1096,2015,Sociologie,5,Sociologie Generale,3,La Condition Moderne,5,1097,1,QROC,0.17,0.46,82.47,75,16,91,91,75,16,1.0,82.42,Moyen,Facile,1,Plus Facile,Pas Adapte,Sociology
2207,2016,Sociologie,5,Sociologie Generale,3,La Condition Moderne,5,1097,1,QROC,0.04,0.49,65.18,53,28,81,53,53,0,1.53,100.0,Moyen,Facile,1,Plus Facile,Adapte,Sociology
3318,2017,Sociologie,5,Sociologie Generale,3,La Condition Moderne,5,1097,1,QCM,0.02,0.81,65.18,55,30,85,68,55,13,1.25,80.88,Facile,Facile,0,Meme Difficulté,Adapte,Sociology
4429,2018,Sociologie,5,Sociologie Generale,3,La Condition Moderne,5,1097,1,QCM,0.13,0.98,65.18,61,32,93,74,61,13,1.26,82.43,Facile,Facile,0,Meme Difficulté,Adapte,Sociology
5540,2019,Sociologie,5,Sociologie Generale,3,La Condition Moderne,5,1097,1,QCM,0.19,0.8,65.18,62,33,95,74,62,12,1.28,83.78,Facile,Facile,0,Meme Difficulté,Adapte,Sociology
6651,2020,Sociologie,5,Sociologie Generale,3,La Condition Moderne,5,1097,1,QCU,0.19,0.86,65.18,68,36,104,93,68,25,1.12,73.12,Facile,Facile,0,Meme Difficulté,Adapte,Sociology
1097,2015,Sociologie,5,Sociologie Generale,3,La Condition Moderne,5,1098,2,QCM,0.29,0.4,58.21,24,17,41,40,24,16,1.02,60.0,Facile,Moyen,-1,Plus Difficile,Pas Adapte,Sociology
2208,2016,Sociologie,5,Sociologie Generale,3,La Condition Moderne,5,1098,2,QCM,0.18,0.96,74.12,35,12,47,45,35,10,1.04,77.78,Difficile,Facile,2,Beaucoup plus Facile,Adapte,Sociology
3319,2017,Sociologie,5,Sociologie Generale,3,La Condition Moderne,5,1098,2,QCU,0.07,0.88,74.12,30,11,41,38,30,8,1.08,78.95,Facile,Facile,0,Meme Difficulté,Adapte,Sociology
4430,2018,Sociologie,5,Sociologie Generale,3,La Condition Moderne,5,1098,2,QCU,0.08,0.89,74.12,30,11,41,31,30,1,1.32,96.77,Facile,Facile,0,Meme Difficulté,Adapte,Sociology
5541,2019,Sociologie,5,Sociologie Generale,3,La Condition Moderne,5,1098,2,QROC,0.07,0.91,74.12,29,10,39,33,29,4,1.18,87.88,Facile,Facile,0,Meme Difficulté,Adapte,Sociology
6652,2020,Sociologie,5,Sociologie Generale,3,La Condition Moderne,5,1098,2,QROC,0.01,0.77,74.12,25,9,34,27,25,2,1.26,92.59,Facile,Facile,0,Meme Difficulté,Adapte,Sociology
1098,2015,Sociologie,5,Sociologie Generale,3,La Condition Moderne,5,1099,3,QROC,0.99,0.15,33.1,25,52,77,39,25,14,1.97,64.1,Facile,Difficile,-2,Beaucoup plus Difficile,Pas Adapte,Sociology
2209,2016,Sociologie,5,Sociologie Generale,3,La Condition Moderne,5,1099,3,QROC,0.43,0.26,54.38,46,38,84,55,46,9,1.53,83.64,Difficile,Moyen,1,Plus Facile,Pas Adapte,Sociology
3320,2017,Sociologie,5,Sociologie Generale,3,La Condition Moderne,5,1099,3,QROC,0.65,0.02,8.79,8,83,91,63,8,55,1.44,12.7,Moyen,Difficile,-1,Plus Difficile,Pas Adapte,Sociology
4431,2018,Sociologie,5,Sociologie Generale,3,La Condition Moderne,5,1099,3,QROC,0.5,0.28,36.23,34,61,95,49,34,15,1.94,69.39,Difficile,Moyen,1,Plus Facile,Pas Adapte,Sociology
5542,2019,Sociologie,5,Sociologie Generale,3,La Condition Moderne,5,1099,3,QROC,0.05,0.64,81.98,70,15,85,77,70,7,1.1,90.91,Difficile,Facile,2,Beaucoup plus Facile,Pas Adapte,Sociology
6653,2020,Sociologie,5,Sociologie Generale,3,La Condition Moderne,5,1099,3,QROC,0.51,0.37,45.92,45,53,98,95,45,50,1.03,47.37,Moyen,Moyen,0,Meme Difficulté,Pas Adapte,Sociology
1099,2015,Sociologie,5,Sociologie Generale,3,La Condition Moderne,5,1100,4,QCU,0.44,0.27,1.77,2,86,88,43,2,41,2.05,4.65,Difficile,Difficile,0,Meme Difficulté,Pas Adapte,Sociology
2210,2016,Sociologie,5,Sociologie Generale,3,La Condition Moderne,5,1100,4,QCU,0.06,0.94,79.48,76,19,95,78,76,2,1.22,97.44,Facile,Facile,0,Meme Difficulté,Pas Adapte,Sociology
3321,2017,Sociologie,5,Sociologie Generale,3,La Condition Moderne,5,1100,4,QCU,0.63,0.39,14.23,15,92,107,78,15,63,1.37,19.23,Facile,Difficile,-2,Beaucoup plus Difficile,Pas Adapte,Sociology
4432,2018,Sociologie,5,Sociologie Generale,3,La Condition Moderne,5,1100,4,QCU,0.12,0.89,91.19,103,10,113,109,103,6,1.04,94.5,Facile,Facile,0,Meme Difficulté,Pas Adapte,Sociology
5543,2019,Sociologie,5,Sociologie Generale,3,La Condition Moderne,5,1100,4,QCU,0.67,0.34,31.93,40,85,125,96,40,56,1.3,41.67,Moyen,Difficile,-1,Plus Difficile,Pas Adapte,Sociology
6654,2020,Sociologie,5,Sociologie Generale,3,La Condition Moderne,5,1100,4,QCU,0.21,0.66,42.77,49,66,115,110,49,61,1.05,44.55,Facile,Moyen,-1,Plus Difficile,Pas Adapte,Sociology
1100,2015,Sociologie,5,Sociologie Generale,3,La Condition Moderne,5,1101,5,QCM,0.26,0.49,48.33,9,9,18,13,9,4,1.38,69.23,Facile,Moyen,-1,Plus Difficile,Pas Adapte,Sociology
2211,2016,Sociologie,5,Sociologie Generale,3,La Condition Moderne,5,1101,5,QCM,0.74,0.23,14.45,3,18,21,20,3,17,1.05,15.0,Facile,Difficile,-2,Beaucoup plus Difficile,Pas Adapte,Sociology
3322,2017,Sociologie,5,Sociologie Generale,3,La Condition Moderne,5,1101,5,QCM,0.65,0.16,28.66,6,14,20,6,6,0,3.33,100.0,Facile,Difficile,-2,Beaucoup plus Difficile,Pas Adapte,Sociology
4433,2018,Sociologie,5,Sociologie Generale,3,La Condition Moderne,5,1101,5,QCM,0.63,0.26,14.75,3,16,19,16,3,13,1.19,18.75,Difficile,Difficile,0,Meme Difficulté,Pas Adapte,Sociology
5544,2019,Sociologie,5,Sociologie Generale,3,La Condition Moderne,5,1101,5,QCM,0.04,0.97,94.33,15,1,16,15,15,0,1.07,100.0,Facile,Facile,0,Meme Difficulté,Pas Adapte,Sociology
6655,2020,Sociologie,5,Sociologie Generale,3,La Condition Moderne,5,1101,5,QCM,0.41,0.41,45.23,6,8,14,11,6,5,1.27,54.55,Difficile,Moyen,1,Plus Facile,Pas Adapte,Sociology
1101,2015,Sociologie,5,Sociologie Generale,4,Les Debats Sociologiques Contemporains,10,1102,1,QO,0.99,0.09,21.37,1,6,7,7,1,6,1.0,14.29,Facile,Difficile,-2,Beaucoup plus Difficile,Pas Adapte,Sociology
2212,2016,Sociologie,5,Sociologie Generale,4,Les Debats Sociologiques Contemporains,10,1102,1,QO,0.03,0.9,93.03,7,1,8,7,7,0,1.14,100.0,Difficile,Facile,2,Beaucoup plus Facile,Pas Adapte,Sociology
3323,2017,Sociologie,5,Sociologie Generale,4,Les Debats Sociologiques Contemporains,10,1102,1,QO,0.07,0.31,65.82,5,2,7,6,5,1,1.17,83.33,Moyen,Facile,1,Plus Facile,Adapte,Sociology
4434,2018,Sociologie,5,Sociologie Generale,4,Les Debats Sociologiques Contemporains,10,1102,1,QO,0.13,0.85,65.82,4,2,6,5,4,1,1.2,80.0,Facile,Facile,0,Meme Difficulté,Adapte,Sociology
5545,2019,Sociologie,5,Sociologie Generale,4,Les Debats Sociologiques Contemporains,10,1102,1,QCU,0.09,0.91,65.82,5,2,7,6,5,1,1.17,83.33,Facile,Facile,0,Meme Difficulté,Adapte,Sociology
6656,2020,Sociologie,5,Sociologie Generale,4,Les Debats Sociologiques Contemporains,10,1102,1,QCM,0.01,0.9,65.82,5,2,7,7,5,2,1.0,71.43,Facile,Facile,0,Meme Difficulté,Adapte,Sociology
1102,2015,Sociologie,5,Sociologie Generale,4,Les Debats Sociologiques Contemporains,10,1103,2,QCM,0.66,0.17,15.61,5,26,31,24,5,19,1.29,20.83,Moyen,Difficile,-1,Plus Difficile,Pas Adapte,Sociology
2213,2016,Sociologie,5,Sociologie Generale,4,Les Debats Sociologiques Contemporains,10,1103,2,QCM,0.68,0.28,28.04,9,24,33,32,9,23,1.03,28.12,Moyen,Difficile,-1,Plus Difficile,Pas Adapte,Sociology
3324,2017,Sociologie,5,Sociologie Generale,4,Les Debats Sociologiques Contemporains,10,1103,2,QCM,0.79,0.29,33.85,9,19,28,28,9,19,1.0,32.14,Facile,Difficile,-2,Beaucoup plus Difficile,Pas Adapte,Sociology
4435,2018,Sociologie,5,Sociologie Generale,4,Les Debats Sociologiques Contemporains,10,1103,2,QCM,0.18,0.81,74.69,24,8,32,30,24,6,1.07,80.0,Difficile,Facile,2,Beaucoup plus Facile,Adapte,Sociology
5546,2019,Sociologie,5,Sociologie Generale,4,Les Debats Sociologiques Contemporains,10,1103,2,QCM,0.04,0.75,74.69,28,9,37,36,28,8,1.03,77.78,Facile,Facile,0,Meme Difficulté,Adapte,Sociology
6657,2020,Sociologie,5,Sociologie Generale,4,Les Debats Sociologiques Contemporains,10,1103,2,QCM,0.05,0.93,74.69,25,8,33,27,25,2,1.22,92.59,Facile,Facile,0,Meme Difficulté,Adapte,Sociology
1103,2015,Sociologie,5,Sociologie Generale,4,Les Debats Sociologiques Contemporains,10,1104,3,QCM,0.17,0.98,94.61,57,3,60,58,57,1,1.03,98.28,Difficile,Facile,2,Beaucoup plus Facile,Pas Adapte,Sociology
2214,2016,Sociologie,5,Sociologie Generale,4,Les Debats Sociologiques Contemporains,10,1104,3,QCM,0.69,0.25,31.04,16,35,51,36,16,20,1.42,44.44,Facile,Difficile,-2,Beaucoup plus Difficile,Pas Adapte,Sociology
3325,2017,Sociologie,5,Sociologie Generale,4,Les Debats Sociologiques Contemporains,10,1104,3,QCM,0.19,0.73,66.05,31,16,47,38,31,7,1.24,81.58,Facile,Facile,0,Meme Difficulté,Adapte,Sociology
4436,2018,Sociologie,5,Sociologie Generale,4,Les Debats Sociologiques Contemporains,10,1104,3,QCM,0.07,0.87,66.05,32,17,49,35,32,3,1.4,91.43,Facile,Facile,0,Meme Difficulté,Adapte,Sociology
5547,2019,Sociologie,5,Sociologie Generale,4,Les Debats Sociologiques Contemporains,10,1104,3,QCM,0.07,0.85,66.05,30,15,45,40,30,10,1.12,75.0,Facile,Facile,0,Meme Difficulté,Adapte,Sociology
6658,2020,Sociologie,5,Sociologie Generale,4,Les Debats Sociologiques Contemporains,10,1104,3,QCM,0.09,0.81,66.05,28,15,43,35,28,7,1.23,80.0,Facile,Facile,0,Meme Difficulté,Adapte,Sociology
1104,2015,Sociologie,5,Sociologie Generale,4,Les Debats Sociologiques Contemporains,10,1105,4,QCM,0.71,0.19,2.86,2,83,85,37,2,35,2.3,5.41,Difficile,Difficile,0,Meme Difficulté,Pas Adapte,Sociology
2215,2016,Sociologie,5,Sociologie Generale,4,Les Debats Sociologiques Contemporains,10,1105,4,QCM,0.11,0.79,79.43,69,18,87,73,69,4,1.19,94.52,Moyen,Facile,1,Plus Facile,Pas Adapte,Sociology
3326,2017,Sociologie,5,Sociologie Generale,4,Les Debats Sociologiques Contemporains,10,1105,4,QCM,0.37,0.32,43.46,37,47,84,67,37,30,1.25,55.22,Difficile,Moyen,1,Plus Facile,Pas Adapte,Sociology
4437,2018,Sociologie,5,Sociologie Generale,4,Les Debats Sociologiques Contemporains,10,1105,4,QCM,0.51,0.19,26.78,25,69,94,52,25,27,1.81,48.08,Moyen,Difficile,-1,Plus Difficile,Pas Adapte,Sociology
5548,2019,Sociologie,5,Sociologie Generale,4,Les Debats Sociologiques Contemporains,10,1105,4,QCM,0.39,0.66,61.31,49,31,80,55,49,6,1.45,89.09,Difficile,Moyen,1,Plus Facile,Adapte,Sociology
6659,2020,Sociologie,5,Sociologie Generale,4,Les Debats Sociologiques Contemporains,10,1105,4,QCM,0.39,0.32,61.31,48,30,78,65,48,17,1.2,73.85,Moyen,Moyen,0,Meme Difficulté,Adapte,Sociology
1105,2015,Sociologie,5,Sociologie Generale,4,Les Debats Sociologiques Contemporains,10,1106,5,QROC,0.82,0.16,27.64,23,61,84,65,23,42,1.29,35.38,Moyen,Difficile,-1,Plus Difficile,Pas Adapte,Sociology
2216,2016,Sociologie,5,Sociologie Generale,4,Les Debats Sociologiques Contemporains,10,1106,5,QROC,0.32,0.32,39.78,35,53,88,75,35,40,1.17,46.67,Moyen,Moyen,0,Meme Difficulté,Pas Adapte,Sociology
3327,2017,Sociologie,5,Sociologie Generale,4,Les Debats Sociologiques Contemporains,10,1106,5,QROC,0.61,0.12,18.43,15,67,82,50,15,35,1.64,30.0,Difficile,Difficile,0,Meme Difficulté,Pas Adapte,Sociology
4438,2018,Sociologie,5,Sociologie Generale,4,Les Debats Sociologiques Contemporains,10,1106,5,QCM,0.27,0.58,42.16,32,45,77,49,32,17,1.57,65.31,Difficile,Moyen,1,Plus Facile,Pas Adapte,Sociology
5549,2019,Sociologie,5,Sociologie Generale,4,Les Debats Sociologiques Contemporains,10,1106,5,QCM,0.39,0.69,54.86,48,40,88,72,48,24,1.22,66.67,Difficile,Moyen,1,Plus Facile,Pas Adapte,Sociology
6660,2020,Sociologie,5,Sociologie Generale,4,Les Debats Sociologiques Contemporains,10,1106,5,QCU,0.6,0.37,28.07,22,57,79,67,22,45,1.18,32.84,Difficile,Difficile,0,Meme Difficulté,Pas Adapte,Sociology
1106,2015,Sociologie,5,Sociologie Generale,4,Les Debats Sociologiques Contemporains,10,1107,6,QCU,0.04,0.78,69.28,57,25,82,62,57,5,1.32,91.94,Facile,Facile,0,Meme Difficulté,Adapte,Sociology
2217,2016,Sociologie,5,Sociologie Generale,4,Les Debats Sociologiques Contemporains,10,1107,6,QCM,0.05,0.85,69.28,60,27,87,81,60,21,1.07,74.07,Facile,Facile,0,Meme Difficulté,Adapte,Sociology
3328,2017,Sociologie,5,Sociologie Generale,4,Les Debats Sociologiques Contemporains,10,1107,6,QCM,0.03,0.99,69.28,53,24,77,72,53,19,1.07,73.61,Facile,Facile,0,Meme Difficulté,Adapte,Sociology
4439,2018,Sociologie,5,Sociologie Generale,4,Les Debats Sociologiques Contemporains,10,1107,6,QCM,0.13,0.87,69.28,53,23,76,76,53,23,1.0,69.74,Facile,Facile,0,Meme Difficulté,Adapte,Sociology
5550,2019,Sociologie,5,Sociologie Generale,4,Les Debats Sociologiques Contemporains,10,1107,6,QCM,0.01,0.73,69.28,51,22,73,65,51,14,1.12,78.46,Facile,Facile,0,Meme Difficulté,Adapte,Sociology
6661,2020,Sociologie,5,Sociologie Generale,4,Les Debats Sociologiques Contemporains,10,1107,6,QCM,0.14,0.85,69.28,55,25,80,61,55,6,1.31,90.16,Facile,Facile,0,Meme Difficulté,Adapte,Sociology
1107,2015,Sociologie,5,Sociologie Generale,4,Les Debats Sociologiques Contemporains,10,1108,7,QO,0.65,0.24,55.36,39,32,71,71,39,32,1.0,54.93,Facile,Moyen,-1,Plus Difficile,Pas Adapte,Sociology
2218,2016,Sociologie,5,Sociologie Generale,4,Les Debats Sociologiques Contemporains,10,1108,7,QO,0.15,0.49,96.9,58,2,60,59,58,1,1.02,98.31,Difficile,Facile,2,Beaucoup plus Facile,Pas Adapte,Sociology
3329,2017,Sociologie,5,Sociologie Generale,4,Les Debats Sociologiques Contemporains,10,1108,7,QO,0.17,0.88,99.21,63,0,63,63,63,0,1.0,100.0,Facile,Facile,0,Meme Difficulté,Pas Adapte,Sociology
4440,2018,Sociologie,5,Sociologie Generale,4,Les Debats Sociologiques Contemporains,10,1108,7,QO,0.89,0.04,16.65,9,47,56,34,9,25,1.65,26.47,Difficile,Difficile,0,Meme Difficulté,Pas Adapte,Sociology
5551,2019,Sociologie,5,Sociologie Generale,4,Les Debats Sociologiques Contemporains,10,1108,7,QO,0.6,0.23,39.41,23,35,58,56,23,33,1.04,41.07,Moyen,Moyen,0,Meme Difficulté,Pas Adapte,Sociology
6662,2020,Sociologie,5,Sociologie Generale,4,Les Debats Sociologiques Contemporains,10,1108,7,QO,0.48,0.29,60.99,30,19,49,47,30,17,1.04,63.83,Difficile,Moyen,1,Plus Facile,Adapte,Sociology
1108,2015,Sociologie,5,Sociologie Generale,4,Les Debats Sociologiques Contemporains,10,1109,8,QCU,0.2,0.93,79.67,13,3,16,15,13,2,1.07,86.67,Difficile,Facile,2,Beaucoup plus Facile,Pas Adapte,Sociology
2219,2016,Sociologie,5,Sociologie Generale,4,Les Debats Sociologiques Contemporains,10,1109,8,QCU,0.36,0.63,53.11,7,7,14,13,7,6,1.08,53.85,Difficile,Moyen,1,Plus Facile,Pas Adapte,Sociology
3330,2017,Sociologie,5,Sociologie Generale,4,Les Debats Sociologiques Contemporains,10,1109,8,QCU,0.12,0.81,96.24,12,0,12,12,12,0,1.0,100.0,Facile,Facile,0,Meme Difficulté,Pas Adapte,Sociology
4441,2018,Sociologie,5,Sociologie Generale,4,Les Debats Sociologiques Contemporains,10,1109,8,QCU,0.14,0.94,97.2,12,0,12,12,12,0,1.0,100.0,Difficile,Facile,2,Beaucoup plus Facile,Pas Adapte,Sociology
5552,2019,Sociologie,5,Sociologie Generale,4,Les Debats Sociologiques Contemporains,10,1109,8,QCU,0.4,0.63,59.13,8,5,13,8,8,0,1.62,100.0,Facile,Moyen,-1,Plus Difficile,Pas Adapte,Sociology
6663,2020,Sociologie,5,Sociologie Generale,4,Les Debats Sociologiques Contemporains,10,1109,8,QCU,0.08,0.77,69.5,8,3,11,10,8,2,1.1,80.0,Difficile,Facile,2,Beaucoup plus Facile,Adapte,Sociology
1109,2015,Sociologie,5,Sociologie Generale,4,Les Debats Sociologiques Contemporains,10,1110,9,QROC,0.04,0.78,97.01,61,2,63,62,61,1,1.02,98.39,Moyen,Facile,1,Plus Facile,Pas Adapte,Sociology
2220,2016,Sociologie,5,Sociologie Generale,4,Les Debats Sociologiques Contemporains,10,1110,9,QROC,0.49,0.26,52.5,29,27,56,54,29,25,1.04,53.7,Facile,Moyen,-1,Plus Difficile,Pas Adapte,Sociology
3331,2017,Sociologie,5,Sociologie Generale,4,Les Debats Sociologiques Contemporains,10,1110,9,QROC,0.02,0.48,88.22,54,7,61,60,54,6,1.02,90.0,Facile,Facile,0,Meme Difficulté,Pas Adapte,Sociology
4442,2018,Sociologie,5,Sociologie Generale,4,Les Debats Sociologiques Contemporains,10,1110,9,QROC,0.85,0.19,28.67,18,46,64,34,18,16,1.88,52.94,Moyen,Difficile,-1,Plus Difficile,Pas Adapte,Sociology
5553,2019,Sociologie,5,Sociologie Generale,4,Les Debats Sociologiques Contemporains,10,1110,9,QO,0.02,0.61,71.51,43,17,60,48,43,5,1.25,89.58,Difficile,Facile,2,Beaucoup plus Facile,Adapte,Sociology
6664,2020,Sociologie,5,Sociologie Generale,4,Les Debats Sociologiques Contemporains,10,1110,9,QO,0.11,0.51,71.51,42,17,59,54,42,12,1.09,77.78,Facile,Facile,0,Meme Difficulté,Adapte,Sociology
1110,2015,Sociologie,5,Sociologie Generale,4,Les Debats Sociologiques Contemporains,10,1111,10,QCU,0.18,0.98,90.11,20,2,22,22,20,2,1.0,90.91,Facile,Facile,0,Meme Difficulté,Pas Adapte,Sociology
2221,2016,Sociologie,5,Sociologie Generale,4,Les Debats Sociologiques Contemporains,10,1111,10,QCU,0.32,0.7,37.44,7,12,19,15,7,8,1.27,46.67,Difficile,Moyen,1,Plus Facile,Pas Adapte,Sociology
3332,2017,Sociologie,5,Sociologie Generale,4,Les Debats Sociologiques Contemporains,10,1111,10,QROC,0.41,0.31,47.96,10,11,21,11,10,1,1.91,90.91,Difficile,Moyen,1,Plus Facile,Pas Adapte,Sociology
4443,2018,Sociologie,5,Sociologie Generale,4,Les Debats Sociologiques Contemporains,10,1111,10,QROC,0.81,0.24,16.91,4,17,21,10,4,6,2.1,40.0,Difficile,Difficile,0,Meme Difficulté,Pas Adapte,Sociology
5554,2019,Sociologie,5,Sociologie Generale,4,Les Debats Sociologiques Contemporains,10,1111,10,QO,0.88,0.15,27.51,7,17,24,16,7,9,1.5,43.75,Facile,Difficile,-2,Beaucoup plus Difficile,Pas Adapte,Sociology
6665,2020,Sociologie,5,Sociologie Generale,4,Les Debats Sociologiques Contemporains,10,1111,10,QO,0.16,0.8,85.61,19,3,22,20,19,1,1.1,95.0,Moyen,Facile,1,Plus Facile,Pas Adapte,Sociology
