Course_ID,Duration,Duration_Digit,Duration_Present,Year,Total_Courses_perYear,Digit_Ratio,Digit_Percentage,Digitalization,Type
1,77,65,12,2013,1045,0.84,84,High Digitalization,High Course ( >40H )
2,61,20,41,2013,1045,0.33,33,Medium-Low Digitalization,High Course ( >40H )
3,33,18,15,2013,1045,0.56,56,Medium-High Digitalization,Medium Course ( >15H and <40H )
4,39,29,10,2013,1045,0.74,74,Medium-High Digitalization,Medium Course ( >15H and <40H )
5,15,0,15,2013,1045,0.01,1,Low Digitalization,Small Course ( <15H )
6,52,44,8,2013,1045,0.85,85,High Digitalization,High Course ( >40H )
7,5,3,2,2013,1045,0.51,51,Medium-High Digitalization,Small Course ( <15H )
8,9,0,9,2013,1045,0.05,5,Low Digitalization,Small Course ( <15H )
9,31,13,18,2013,1045,0.42,42,Medium-Low Digitalization,Medium Course ( >15H and <40H )
10,17,1,16,2013,1045,0.04,4,Low Digitalization,Medium Course ( >15H and <40H )
11,54,14,40,2013,1045,0.26,26,Medium-Low Digitalization,High Course ( >40H )
12,11,5,6,2013,1045,0.44,44,Medium-Low Digitalization,Small Course ( <15H )
13,66,3,63,2013,1045,0.04,4,Low Digitalization,High Course ( >40H )
14,11,8,3,2013,1045,0.71,71,Medium-High Digitalization,Small Course ( <15H )
15,35,22,13,2013,1045,0.64,64,Medium-High Digitalization,Medium Course ( >15H and <40H )
16,6,2,4,2013,1045,0.39,39,Medium-Low Digitalization,Small Course ( <15H )
17,43,37,6,2013,1045,0.85,85,High Digitalization,High Course ( >40H )
18,14,13,1,2013,1045,0.95,95,High Digitalization,Small Course ( <15H )
19,60,18,42,2013,1045,0.3,30,Medium-Low Digitalization,High Course ( >40H )
20,8,0,8,2013,1045,0.04,4,Low Digitalization,Small Course ( <15H )
21,64,33,31,2013,1045,0.51,51,Medium-High Digitalization,High Course ( >40H )
22,24,14,10,2013,1045,0.58,57,Medium-High Digitalization,Medium Course ( >15H and <40H )
23,15,4,11,2013,1045,0.28,28,Medium-Low Digitalization,Small Course ( <15H )
24,30,1,29,2013,1045,0.02,2,Low Digitalization,Medium Course ( >15H and <40H )
25,13,10,3,2013,1045,0.74,74,Medium-High Digitalization,Small Course ( <15H )
26,72,41,31,2013,1045,0.57,56,Medium-High Digitalization,High Course ( >40H )
27,7,4,3,2013,1045,0.51,51,Medium-High Digitalization,Small Course ( <15H )
28,61,1,60,2013,1045,0.01,1,Low Digitalization,High Course ( >40H )
29,88,61,27,2013,1045,0.69,69,Medium-High Digitalization,High Course ( >40H )
30,10,1,9,2013,1045,0.1,10,Low Digitalization,Small Course ( <15H )
31,57,36,21,2013,1045,0.63,63,Medium-High Digitalization,High Course ( >40H )
32,55,45,10,2013,1045,0.82,82,High Digitalization,High Course ( >40H )
33,23,2,21,2013,1045,0.1,10,Low Digitalization,Medium Course ( >15H and <40H )
34,36,0,36,2013,1045,0.01,1,Low Digitalization,Medium Course ( >15H and <40H )
35,62,40,22,2013,1045,0.64,64,Medium-High Digitalization,High Course ( >40H )
36,78,60,18,2013,1045,0.77,77,Medium-High Digitalization,High Course ( >40H )
37,31,17,14,2013,1045,0.55,55,Medium-High Digitalization,Medium Course ( >15H and <40H )
38,14,14,0,2013,1045,0.99,99,High Digitalization,Small Course ( <15H )
39,86,6,80,2013,1045,0.07,7,Low Digitalization,High Course ( >40H )
40,77,46,31,2013,1045,0.6,60,Medium-High Digitalization,High Course ( >40H )
41,9,4,4,2013,1045,0.5,50,Medium-Low Digitalization,Small Course ( <15H )
42,23,16,7,2013,1045,0.69,69,Medium-High Digitalization,Medium Course ( >15H and <40H )
43,43,13,30,2013,1045,0.31,31,Medium-Low Digitalization,High Course ( >40H )
44,27,4,23,2013,1045,0.16,16,Low Digitalization,Medium Course ( >15H and <40H )
45,26,4,22,2013,1045,0.15,15,Low Digitalization,Medium Course ( >15H and <40H )
46,31,6,25,2013,1045,0.19,19,Low Digitalization,Medium Course ( >15H and <40H )
47,20,16,4,2013,1045,0.82,82,High Digitalization,Medium Course ( >15H and <40H )
48,33,18,15,2013,1045,0.54,54,Medium-High Digitalization,Medium Course ( >15H and <40H )
49,29,1,28,2013,1045,0.03,3,Low Digitalization,Medium Course ( >15H and <40H )
50,8,2,6,2013,1045,0.19,19,Low Digitalization,Small Course ( <15H )
51,77,26,51,2013,1045,0.34,34,Medium-Low Digitalization,High Course ( >40H )
52,6,1,5,2013,1045,0.17,17,Low Digitalization,Small Course ( <15H )
53,38,2,36,2013,1045,0.05,5,Low Digitalization,Medium Course ( >15H and <40H )
54,14,2,12,2013,1045,0.16,16,Low Digitalization,Small Course ( <15H )
55,60,35,25,2013,1045,0.59,59,Medium-High Digitalization,High Course ( >40H )
56,21,11,10,2013,1045,0.51,51,Medium-High Digitalization,Medium Course ( >15H and <40H )
57,68,25,43,2013,1045,0.37,37,Medium-Low Digitalization,High Course ( >40H )
58,13,8,5,2013,1045,0.58,57,Medium-High Digitalization,Small Course ( <15H )
59,26,9,17,2013,1045,0.34,34,Medium-Low Digitalization,Medium Course ( >15H and <40H )
60,11,1,10,2013,1045,0.07,7,Low Digitalization,Small Course ( <15H )
61,15,8,7,2013,1045,0.53,53,Medium-High Digitalization,Small Course ( <15H )
62,43,40,3,2013,1045,0.92,92,High Digitalization,High Course ( >40H )
63,37,3,34,2013,1045,0.07,7,Low Digitalization,Medium Course ( >15H and <40H )
64,83,63,20,2013,1045,0.76,76,Medium-High Digitalization,High Course ( >40H )
65,50,30,20,2013,1045,0.59,59,Medium-High Digitalization,High Course ( >40H )
66,34,8,26,2013,1045,0.25,25,Medium-Low Digitalization,Medium Course ( >15H and <40H )
67,57,50,7,2013,1045,0.88,88,High Digitalization,High Course ( >40H )
68,85,77,8,2013,1045,0.91,91,High Digitalization,High Course ( >40H )
69,22,12,10,2013,1045,0.55,55,Medium-High Digitalization,Medium Course ( >15H and <40H )
70,24,23,1,2013,1045,0.95,95,High Digitalization,Medium Course ( >15H and <40H )
71,60,16,44,2013,1045,0.26,26,Medium-Low Digitalization,High Course ( >40H )
72,9,4,5,2013,1045,0.46,46,Medium-Low Digitalization,Small Course ( <15H )
73,8,1,7,2013,1045,0.12,12,Low Digitalization,Small Course ( <15H )
74,86,39,47,2013,1045,0.45,45,Medium-Low Digitalization,High Course ( >40H )
75,23,8,15,2013,1045,0.36,36,Medium-Low Digitalization,Medium Course ( >15H and <40H )
76,23,20,3,2013,1045,0.86,86,High Digitalization,Medium Course ( >15H and <40H )
77,11,5,6,2013,1045,0.45,45,Medium-Low Digitalization,Small Course ( <15H )
78,40,34,6,2013,1045,0.85,85,High Digitalization,High Course ( >40H )
79,70,66,4,2013,1045,0.95,95,High Digitalization,High Course ( >40H )
80,28,14,14,2013,1045,0.51,51,Medium-High Digitalization,Medium Course ( >15H and <40H )
81,80,39,41,2013,1045,0.49,49,Medium-Low Digitalization,High Course ( >40H )
82,89,18,71,2013,1045,0.2,20,Low Digitalization,High Course ( >40H )
83,56,38,18,2013,1045,0.67,67,Medium-High Digitalization,High Course ( >40H )
84,41,21,20,2013,1045,0.52,52,Medium-High Digitalization,High Course ( >40H )
85,35,33,2,2013,1045,0.93,93,High Digitalization,Medium Course ( >15H and <40H )
86,56,46,10,2013,1045,0.83,83,High Digitalization,High Course ( >40H )
87,40,26,14,2013,1045,0.65,65,Medium-High Digitalization,High Course ( >40H )
88,49,14,35,2013,1045,0.28,28,Medium-Low Digitalization,High Course ( >40H )
89,11,11,0,2013,1045,0.99,99,High Digitalization,Small Course ( <15H )
90,86,28,58,2013,1045,0.33,33,Medium-Low Digitalization,High Course ( >40H )
91,24,16,8,2013,1045,0.68,68,Medium-High Digitalization,Medium Course ( >15H and <40H )
92,21,14,7,2013,1045,0.65,65,Medium-High Digitalization,Medium Course ( >15H and <40H )
93,14,3,11,2013,1045,0.22,22,Medium-Low Digitalization,Small Course ( <15H )
94,29,8,21,2013,1045,0.26,26,Medium-Low Digitalization,Medium Course ( >15H and <40H )
95,60,41,19,2013,1045,0.68,68,Medium-High Digitalization,High Course ( >40H )
96,38,19,19,2013,1045,0.51,51,Medium-High Digitalization,Medium Course ( >15H and <40H )
97,60,38,22,2013,1045,0.63,63,Medium-High Digitalization,High Course ( >40H )
98,65,3,62,2013,1045,0.05,5,Low Digitalization,High Course ( >40H )
99,44,33,11,2013,1045,0.76,76,Medium-High Digitalization,High Course ( >40H )
100,80,27,53,2013,1045,0.34,34,Medium-Low Digitalization,High Course ( >40H )
101,5,4,1,2013,1045,0.85,85,High Digitalization,Small Course ( <15H )
102,55,7,48,2013,1045,0.13,13,Low Digitalization,High Course ( >40H )
103,69,52,17,2013,1045,0.76,76,Medium-High Digitalization,High Course ( >40H )
104,10,8,2,2013,1045,0.75,75,Medium-High Digitalization,Small Course ( <15H )
105,29,18,11,2013,1045,0.61,61,Medium-High Digitalization,Medium Course ( >15H and <40H )
106,15,2,13,2013,1045,0.13,13,Low Digitalization,Small Course ( <15H )
107,65,40,25,2013,1045,0.62,62,Medium-High Digitalization,High Course ( >40H )
108,58,3,55,2013,1045,0.06,6,Low Digitalization,High Course ( >40H )
109,44,36,8,2013,1045,0.81,81,High Digitalization,High Course ( >40H )
110,72,32,40,2013,1045,0.45,45,Medium-Low Digitalization,High Course ( >40H )
111,88,84,4,2013,1045,0.96,96,High Digitalization,High Course ( >40H )
112,57,32,25,2013,1045,0.56,56,Medium-High Digitalization,High Course ( >40H )
113,8,4,4,2013,1045,0.51,51,Medium-High Digitalization,Small Course ( <15H )
114,9,9,0,2013,1045,0.96,96,High Digitalization,Small Course ( <15H )
115,8,7,1,2013,1045,0.91,91,High Digitalization,Small Course ( <15H )
116,67,31,36,2013,1045,0.46,46,Medium-Low Digitalization,High Course ( >40H )
117,56,13,43,2013,1045,0.23,23,Medium-Low Digitalization,High Course ( >40H )
118,7,1,6,2013,1045,0.11,11,Low Digitalization,Small Course ( <15H )
119,14,4,10,2013,1045,0.27,27,Medium-Low Digitalization,Small Course ( <15H )
120,7,5,2,2013,1045,0.65,65,Medium-High Digitalization,Small Course ( <15H )
121,27,23,4,2013,1045,0.87,87,High Digitalization,Medium Course ( >15H and <40H )
122,57,45,12,2013,1045,0.79,79,Medium-High Digitalization,High Course ( >40H )
123,57,27,30,2013,1045,0.47,47,Medium-Low Digitalization,High Course ( >40H )
124,38,4,34,2013,1045,0.1,10,Low Digitalization,Medium Course ( >15H and <40H )
125,57,48,9,2013,1045,0.85,85,High Digitalization,High Course ( >40H )
126,47,4,43,2013,1045,0.09,9,Low Digitalization,High Course ( >40H )
127,56,30,26,2013,1045,0.53,53,Medium-High Digitalization,High Course ( >40H )
128,37,25,12,2013,1045,0.68,68,Medium-High Digitalization,Medium Course ( >15H and <40H )
129,50,17,33,2013,1045,0.34,34,Medium-Low Digitalization,High Course ( >40H )
130,41,40,1,2013,1045,0.97,97,High Digitalization,High Course ( >40H )
131,44,35,9,2013,1045,0.79,79,Medium-High Digitalization,High Course ( >40H )
132,8,5,3,2013,1045,0.64,64,Medium-High Digitalization,Small Course ( <15H )
133,63,43,20,2013,1045,0.68,68,Medium-High Digitalization,High Course ( >40H )
134,14,12,2,2013,1045,0.83,83,High Digitalization,Small Course ( <15H )
135,24,5,19,2013,1045,0.2,20,Low Digitalization,Medium Course ( >15H and <40H )
136,32,15,17,2013,1045,0.48,48,Medium-Low Digitalization,Medium Course ( >15H and <40H )
137,65,38,27,2013,1045,0.58,57,Medium-High Digitalization,High Course ( >40H )
138,45,44,1,2013,1045,0.97,97,High Digitalization,High Course ( >40H )
139,15,3,12,2013,1045,0.17,17,Low Digitalization,Small Course ( <15H )
140,15,5,10,2013,1045,0.35,35,Medium-Low Digitalization,Small Course ( <15H )
141,67,61,6,2013,1045,0.91,91,High Digitalization,High Course ( >40H )
142,34,15,19,2013,1045,0.43,43,Medium-Low Digitalization,Medium Course ( >15H and <40H )
143,67,54,13,2013,1045,0.8,80,Medium-High Digitalization,High Course ( >40H )
144,9,9,0,2013,1045,1.0,100,High Digitalization,Small Course ( <15H )
145,11,5,6,2013,1045,0.46,46,Medium-Low Digitalization,Small Course ( <15H )
146,55,31,24,2013,1045,0.57,56,Medium-High Digitalization,High Course ( >40H )
147,9,2,7,2013,1045,0.24,24,Medium-Low Digitalization,Small Course ( <15H )
148,50,30,20,2013,1045,0.6,60,Medium-High Digitalization,High Course ( >40H )
149,10,8,2,2013,1045,0.84,84,High Digitalization,Small Course ( <15H )
150,64,56,8,2013,1045,0.87,87,High Digitalization,High Course ( >40H )
151,69,48,21,2013,1045,0.7,70,Medium-High Digitalization,High Course ( >40H )
152,33,9,24,2013,1045,0.28,28,Medium-Low Digitalization,Medium Course ( >15H and <40H )
153,62,57,5,2013,1045,0.92,92,High Digitalization,High Course ( >40H )
154,19,4,15,2013,1045,0.21,21,Medium-Low Digitalization,Medium Course ( >15H and <40H )
155,61,18,43,2013,1045,0.3,30,Medium-Low Digitalization,High Course ( >40H )
156,48,28,20,2013,1045,0.58,57,Medium-High Digitalization,High Course ( >40H )
157,69,31,38,2013,1045,0.45,45,Medium-Low Digitalization,High Course ( >40H )
158,7,6,1,2013,1045,0.85,85,High Digitalization,Small Course ( <15H )
159,49,5,44,2013,1045,0.11,11,Low Digitalization,High Course ( >40H )
160,42,36,6,2013,1045,0.85,85,High Digitalization,High Course ( >40H )
161,32,22,10,2013,1045,0.7,70,Medium-High Digitalization,Medium Course ( >15H and <40H )
162,9,6,3,2013,1045,0.64,64,Medium-High Digitalization,Small Course ( <15H )
163,9,4,4,2013,1045,0.5,50,Medium-Low Digitalization,Small Course ( <15H )
164,80,65,15,2013,1045,0.81,81,High Digitalization,High Course ( >40H )
165,24,6,18,2013,1045,0.23,23,Medium-Low Digitalization,Medium Course ( >15H and <40H )
166,14,11,3,2013,1045,0.78,78,Medium-High Digitalization,Small Course ( <15H )
167,11,7,4,2013,1045,0.61,61,Medium-High Digitalization,Small Course ( <15H )
168,60,35,25,2013,1045,0.58,57,Medium-High Digitalization,High Course ( >40H )
169,76,7,69,2013,1045,0.09,9,Low Digitalization,High Course ( >40H )
170,45,22,23,2013,1045,0.49,49,Medium-Low Digitalization,High Course ( >40H )
171,14,5,9,2013,1045,0.35,35,Medium-Low Digitalization,Small Course ( <15H )
172,75,71,4,2013,1045,0.95,95,High Digitalization,High Course ( >40H )
173,54,22,32,2013,1045,0.4,40,Medium-Low Digitalization,High Course ( >40H )
174,81,27,54,2013,1045,0.33,33,Medium-Low Digitalization,High Course ( >40H )
175,19,11,8,2013,1045,0.59,59,Medium-High Digitalization,Medium Course ( >15H and <40H )
176,12,10,2,2013,1045,0.85,85,High Digitalization,Small Course ( <15H )
177,6,3,3,2013,1045,0.48,48,Medium-Low Digitalization,Small Course ( <15H )
178,54,13,41,2013,1045,0.24,24,Medium-Low Digitalization,High Course ( >40H )
179,21,3,18,2013,1045,0.13,13,Low Digitalization,Medium Course ( >15H and <40H )
180,69,53,16,2013,1045,0.77,77,Medium-High Digitalization,High Course ( >40H )
181,6,5,1,2013,1045,0.91,91,High Digitalization,Small Course ( <15H )
182,36,33,3,2013,1045,0.93,93,High Digitalization,Medium Course ( >15H and <40H )
183,68,50,18,2013,1045,0.73,73,Medium-High Digitalization,High Course ( >40H )
184,15,11,4,2013,1045,0.71,71,Medium-High Digitalization,Small Course ( <15H )
185,12,4,8,2013,1045,0.32,32,Medium-Low Digitalization,Small Course ( <15H )
186,14,0,14,2013,1045,0.01,1,Low Digitalization,Small Course ( <15H )
187,8,4,4,2013,1045,0.44,44,Medium-Low Digitalization,Small Course ( <15H )
188,41,23,18,2013,1045,0.56,56,Medium-High Digitalization,High Course ( >40H )
189,64,53,11,2013,1045,0.83,83,High Digitalization,High Course ( >40H )
190,84,60,24,2013,1045,0.72,72,Medium-High Digitalization,High Course ( >40H )
191,61,38,23,2013,1045,0.62,62,Medium-High Digitalization,High Course ( >40H )
192,53,11,42,2013,1045,0.2,20,Low Digitalization,High Course ( >40H )
193,44,22,22,2013,1045,0.5,50,Medium-Low Digitalization,High Course ( >40H )
194,60,28,32,2013,1045,0.46,46,Medium-Low Digitalization,High Course ( >40H )
195,7,5,2,2013,1045,0.76,76,Medium-High Digitalization,Small Course ( <15H )
196,37,14,23,2013,1045,0.38,38,Medium-Low Digitalization,Medium Course ( >15H and <40H )
197,75,17,58,2013,1045,0.23,23,Medium-Low Digitalization,High Course ( >40H )
198,24,13,11,2013,1045,0.54,54,Medium-High Digitalization,Medium Course ( >15H and <40H )
199,15,14,1,2013,1045,0.96,96,High Digitalization,Small Course ( <15H )
200,37,36,1,2013,1045,0.96,96,High Digitalization,Medium Course ( >15H and <40H )
201,6,2,4,2013,1045,0.33,33,Medium-Low Digitalization,Small Course ( <15H )
202,15,7,8,2013,1045,0.45,45,Medium-Low Digitalization,Small Course ( <15H )
203,7,3,4,2013,1045,0.47,47,Medium-Low Digitalization,Small Course ( <15H )
204,64,13,51,2013,1045,0.21,21,Medium-Low Digitalization,High Course ( >40H )
205,38,35,3,2013,1045,0.91,91,High Digitalization,Medium Course ( >15H and <40H )
206,22,2,20,2013,1045,0.1,10,Low Digitalization,Medium Course ( >15H and <40H )
207,14,3,11,2013,1045,0.2,20,Low Digitalization,Small Course ( <15H )
208,15,6,9,2013,1045,0.38,38,Medium-Low Digitalization,Small Course ( <15H )
209,29,2,27,2013,1045,0.07,7,Low Digitalization,Medium Course ( >15H and <40H )
210,11,9,2,2013,1045,0.86,86,High Digitalization,Small Course ( <15H )
211,8,2,6,2013,1045,0.23,23,Medium-Low Digitalization,Small Course ( <15H )
212,83,65,18,2013,1045,0.78,78,Medium-High Digitalization,High Course ( >40H )
213,34,32,2,2013,1045,0.94,94,High Digitalization,Medium Course ( >15H and <40H )
214,8,5,3,2013,1045,0.6,60,Medium-High Digitalization,Small Course ( <15H )
215,17,5,12,2013,1045,0.3,30,Medium-Low Digitalization,Medium Course ( >15H and <40H )
216,50,48,2,2013,1045,0.95,95,High Digitalization,High Course ( >40H )
217,47,16,31,2013,1045,0.35,35,Medium-Low Digitalization,High Course ( >40H )
218,30,25,5,2013,1045,0.82,82,High Digitalization,Medium Course ( >15H and <40H )
219,52,7,45,2013,1045,0.14,14,Low Digitalization,High Course ( >40H )
220,17,14,3,2013,1045,0.8,80,Medium-High Digitalization,Medium Course ( >15H and <40H )
221,8,5,3,2013,1045,0.57,56,Medium-High Digitalization,Small Course ( <15H )
222,8,3,5,2013,1045,0.33,33,Medium-Low Digitalization,Small Course ( <15H )
223,5,3,2,2013,1045,0.68,68,Medium-High Digitalization,Small Course ( <15H )
224,17,16,1,2013,1045,0.96,96,High Digitalization,Medium Course ( >15H and <40H )
225,48,14,34,2013,1045,0.3,30,Medium-Low Digitalization,High Course ( >40H )
226,5,4,1,2013,1045,0.85,85,High Digitalization,Small Course ( <15H )
227,27,6,21,2013,1045,0.23,23,Medium-Low Digitalization,Medium Course ( >15H and <40H )
228,6,2,4,2013,1045,0.36,36,Medium-Low Digitalization,Small Course ( <15H )
229,26,18,8,2013,1045,0.69,69,Medium-High Digitalization,Medium Course ( >15H and <40H )
230,85,1,84,2013,1045,0.01,1,Low Digitalization,High Course ( >40H )
231,10,9,1,2013,1045,0.94,94,High Digitalization,Small Course ( <15H )
232,57,9,48,2013,1045,0.15,15,Low Digitalization,High Course ( >40H )
233,15,4,11,2013,1045,0.26,26,Medium-Low Digitalization,Small Course ( <15H )
234,12,4,8,2013,1045,0.32,32,Medium-Low Digitalization,Small Course ( <15H )
235,52,31,21,2013,1045,0.6,60,Medium-High Digitalization,High Course ( >40H )
236,44,16,28,2013,1045,0.37,37,Medium-Low Digitalization,High Course ( >40H )
237,48,46,2,2013,1045,0.96,96,High Digitalization,High Course ( >40H )
238,39,20,19,2013,1045,0.51,51,Medium-High Digitalization,Medium Course ( >15H and <40H )
239,7,2,5,2013,1045,0.24,24,Medium-Low Digitalization,Small Course ( <15H )
240,21,5,16,2013,1045,0.23,23,Medium-Low Digitalization,Medium Course ( >15H and <40H )
241,13,8,5,2013,1045,0.63,63,Medium-High Digitalization,Small Course ( <15H )
242,6,3,3,2013,1045,0.54,54,Medium-High Digitalization,Small Course ( <15H )
243,78,65,13,2013,1045,0.83,83,High Digitalization,High Course ( >40H )
244,54,26,28,2013,1045,0.48,48,Medium-Low Digitalization,High Course ( >40H )
245,14,13,1,2013,1045,0.9,90,High Digitalization,Small Course ( <15H )
246,48,0,48,2013,1045,0.01,1,Low Digitalization,High Course ( >40H )
247,13,1,12,2013,1045,0.07,7,Low Digitalization,Small Course ( <15H )
248,56,21,35,2013,1045,0.38,38,Medium-Low Digitalization,High Course ( >40H )
249,55,35,20,2013,1045,0.63,63,Medium-High Digitalization,High Course ( >40H )
250,83,19,64,2013,1045,0.23,23,Medium-Low Digitalization,High Course ( >40H )
251,70,32,38,2013,1045,0.46,46,Medium-Low Digitalization,High Course ( >40H )
252,82,72,10,2013,1045,0.88,88,High Digitalization,High Course ( >40H )
253,11,4,7,2013,1045,0.34,34,Medium-Low Digitalization,Small Course ( <15H )
254,15,11,4,2013,1045,0.72,72,Medium-High Digitalization,Small Course ( <15H )
255,49,31,18,2013,1045,0.64,64,Medium-High Digitalization,High Course ( >40H )
256,12,6,6,2013,1045,0.48,48,Medium-Low Digitalization,Small Course ( <15H )
257,60,56,4,2013,1045,0.93,93,High Digitalization,High Course ( >40H )
258,83,12,71,2013,1045,0.14,14,Low Digitalization,High Course ( >40H )
259,18,8,10,2013,1045,0.43,43,Medium-Low Digitalization,Medium Course ( >15H and <40H )
260,10,2,8,2013,1045,0.19,19,Low Digitalization,Small Course ( <15H )
261,11,9,2,2013,1045,0.83,83,High Digitalization,Small Course ( <15H )
262,15,8,7,2013,1045,0.54,54,Medium-High Digitalization,Small Course ( <15H )
263,39,5,34,2013,1045,0.12,12,Low Digitalization,Medium Course ( >15H and <40H )
264,21,8,13,2013,1045,0.38,38,Medium-Low Digitalization,Medium Course ( >15H and <40H )
265,7,2,5,2013,1045,0.33,33,Medium-Low Digitalization,Small Course ( <15H )
266,29,10,19,2013,1045,0.34,34,Medium-Low Digitalization,Medium Course ( >15H and <40H )
267,66,43,23,2013,1045,0.65,65,Medium-High Digitalization,High Course ( >40H )
268,47,15,32,2013,1045,0.31,31,Medium-Low Digitalization,High Course ( >40H )
269,14,2,12,2013,1045,0.14,14,Low Digitalization,Small Course ( <15H )
270,14,11,3,2013,1045,0.82,82,High Digitalization,Small Course ( <15H )
271,87,29,58,2013,1045,0.33,33,Medium-Low Digitalization,High Course ( >40H )
272,19,2,17,2013,1045,0.11,11,Low Digitalization,Medium Course ( >15H and <40H )
273,72,42,30,2013,1045,0.59,59,Medium-High Digitalization,High Course ( >40H )
274,46,26,20,2013,1045,0.57,56,Medium-High Digitalization,High Course ( >40H )
275,7,4,3,2013,1045,0.54,54,Medium-High Digitalization,Small Course ( <15H )
276,63,49,14,2013,1045,0.77,77,Medium-High Digitalization,High Course ( >40H )
277,67,17,50,2013,1045,0.25,25,Medium-Low Digitalization,High Course ( >40H )
278,16,9,7,2013,1045,0.56,56,Medium-High Digitalization,Medium Course ( >15H and <40H )
279,49,4,45,2013,1045,0.08,8,Low Digitalization,High Course ( >40H )
280,37,29,8,2013,1045,0.79,79,Medium-High Digitalization,Medium Course ( >15H and <40H )
281,55,26,29,2013,1045,0.47,47,Medium-Low Digitalization,High Course ( >40H )
282,65,28,37,2013,1045,0.43,43,Medium-Low Digitalization,High Course ( >40H )
283,13,12,1,2013,1045,0.89,89,High Digitalization,Small Course ( <15H )
284,25,3,22,2013,1045,0.11,11,Low Digitalization,Medium Course ( >15H and <40H )
285,7,6,1,2013,1045,0.85,85,High Digitalization,Small Course ( <15H )
286,24,20,4,2013,1045,0.82,82,High Digitalization,Medium Course ( >15H and <40H )
287,63,16,47,2013,1045,0.26,26,Medium-Low Digitalization,High Course ( >40H )
288,5,4,1,2013,1045,0.87,87,High Digitalization,Small Course ( <15H )
289,69,20,49,2013,1045,0.29,28,Medium-Low Digitalization,High Course ( >40H )
290,21,18,3,2013,1045,0.87,87,High Digitalization,Medium Course ( >15H and <40H )
291,57,42,15,2013,1045,0.74,74,Medium-High Digitalization,High Course ( >40H )
292,55,53,2,2013,1045,0.97,97,High Digitalization,High Course ( >40H )
293,13,1,12,2013,1045,0.06,6,Low Digitalization,Small Course ( <15H )
294,13,9,4,2013,1045,0.7,70,Medium-High Digitalization,Small Course ( <15H )
295,7,2,5,2013,1045,0.27,27,Medium-Low Digitalization,Small Course ( <15H )
296,63,39,24,2013,1045,0.62,62,Medium-High Digitalization,High Course ( >40H )
297,32,26,6,2013,1045,0.82,82,High Digitalization,Medium Course ( >15H and <40H )
298,50,34,16,2013,1045,0.68,68,Medium-High Digitalization,High Course ( >40H )
299,11,9,2,2013,1045,0.8,80,Medium-High Digitalization,Small Course ( <15H )
300,49,20,29,2013,1045,0.41,41,Medium-Low Digitalization,High Course ( >40H )
301,10,4,6,2013,1045,0.36,36,Medium-Low Digitalization,Small Course ( <15H )
302,31,22,9,2013,1045,0.71,71,Medium-High Digitalization,Medium Course ( >15H and <40H )
303,84,45,39,2013,1045,0.54,54,Medium-High Digitalization,High Course ( >40H )
304,75,12,63,2013,1045,0.16,16,Low Digitalization,High Course ( >40H )
305,15,11,4,2013,1045,0.75,75,Medium-High Digitalization,Small Course ( <15H )
306,74,30,44,2013,1045,0.41,41,Medium-Low Digitalization,High Course ( >40H )
307,26,12,14,2013,1045,0.45,45,Medium-Low Digitalization,Medium Course ( >15H and <40H )
308,5,1,4,2013,1045,0.27,27,Medium-Low Digitalization,Small Course ( <15H )
309,81,79,2,2013,1045,0.97,97,High Digitalization,High Course ( >40H )
310,50,17,33,2013,1045,0.34,34,Medium-Low Digitalization,High Course ( >40H )
311,40,4,36,2013,1045,0.1,10,Low Digitalization,High Course ( >40H )
312,23,2,21,2013,1045,0.08,8,Low Digitalization,Medium Course ( >15H and <40H )
313,8,8,0,2013,1045,0.97,97,High Digitalization,Small Course ( <15H )
314,25,23,2,2013,1045,0.92,92,High Digitalization,Medium Course ( >15H and <40H )
315,6,1,5,2013,1045,0.09,9,Low Digitalization,Small Course ( <15H )
316,22,0,22,2013,1045,0.02,2,Low Digitalization,Medium Course ( >15H and <40H )
317,8,3,5,2013,1045,0.38,38,Medium-Low Digitalization,Small Course ( <15H )
318,20,12,8,2013,1045,0.58,57,Medium-High Digitalization,Medium Course ( >15H and <40H )
319,15,6,9,2013,1045,0.39,39,Medium-Low Digitalization,Small Course ( <15H )
320,74,26,48,2013,1045,0.35,35,Medium-Low Digitalization,High Course ( >40H )
321,59,34,25,2013,1045,0.58,57,Medium-High Digitalization,High Course ( >40H )
322,27,1,26,2013,1045,0.03,3,Low Digitalization,Medium Course ( >15H and <40H )
323,71,62,9,2013,1045,0.87,87,High Digitalization,High Course ( >40H )
324,44,42,2,2013,1045,0.96,96,High Digitalization,High Course ( >40H )
325,56,4,52,2013,1045,0.08,8,Low Digitalization,High Course ( >40H )
326,8,6,2,2013,1045,0.81,81,High Digitalization,Small Course ( <15H )
327,53,19,34,2013,1045,0.35,35,Medium-Low Digitalization,High Course ( >40H )
328,54,4,50,2013,1045,0.08,8,Low Digitalization,High Course ( >40H )
329,19,12,7,2013,1045,0.63,63,Medium-High Digitalization,Medium Course ( >15H and <40H )
330,49,31,18,2013,1045,0.63,63,Medium-High Digitalization,High Course ( >40H )
331,53,36,17,2013,1045,0.67,67,Medium-High Digitalization,High Course ( >40H )
332,5,2,3,2013,1045,0.39,39,Medium-Low Digitalization,Small Course ( <15H )
333,12,2,10,2013,1045,0.19,19,Low Digitalization,Small Course ( <15H )
334,29,26,3,2013,1045,0.91,91,High Digitalization,Medium Course ( >15H and <40H )
335,55,39,16,2013,1045,0.71,71,Medium-High Digitalization,High Course ( >40H )
336,18,4,14,2013,1045,0.25,25,Medium-Low Digitalization,Medium Course ( >15H and <40H )
337,9,0,9,2013,1045,0.0,0,Low Digitalization,Small Course ( <15H )
338,42,28,14,2013,1045,0.67,67,Medium-High Digitalization,High Course ( >40H )
339,31,10,21,2013,1045,0.32,32,Medium-Low Digitalization,Medium Course ( >15H and <40H )
340,41,13,28,2013,1045,0.31,31,Medium-Low Digitalization,High Course ( >40H )
341,51,33,18,2013,1045,0.64,64,Medium-High Digitalization,High Course ( >40H )
342,52,19,33,2013,1045,0.37,37,Medium-Low Digitalization,High Course ( >40H )
343,14,6,8,2013,1045,0.42,42,Medium-Low Digitalization,Small Course ( <15H )
344,23,3,20,2013,1045,0.12,12,Low Digitalization,Medium Course ( >15H and <40H )
345,8,0,8,2013,1045,0.06,6,Low Digitalization,Small Course ( <15H )
346,15,2,14,2013,1045,0.1,10,Low Digitalization,Small Course ( <15H )
347,25,5,20,2013,1045,0.2,20,Low Digitalization,Medium Course ( >15H and <40H )
348,43,37,6,2013,1045,0.86,86,High Digitalization,High Course ( >40H )
349,19,15,4,2013,1045,0.81,81,High Digitalization,Medium Course ( >15H and <40H )
350,13,11,2,2013,1045,0.85,85,High Digitalization,Small Course ( <15H )
351,71,8,63,2013,1045,0.11,11,Low Digitalization,High Course ( >40H )
352,30,28,2,2013,1045,0.95,95,High Digitalization,Medium Course ( >15H and <40H )
353,72,58,14,2013,1045,0.81,81,High Digitalization,High Course ( >40H )
354,15,2,13,2013,1045,0.11,11,Low Digitalization,Small Course ( <15H )
355,60,43,17,2013,1045,0.71,71,Medium-High Digitalization,High Course ( >40H )
356,23,2,21,2013,1045,0.09,9,Low Digitalization,Medium Course ( >15H and <40H )
357,27,24,3,2013,1045,0.9,90,High Digitalization,Medium Course ( >15H and <40H )
358,38,11,27,2013,1045,0.28,28,Medium-Low Digitalization,Medium Course ( >15H and <40H )
359,60,1,59,2013,1045,0.01,1,Low Digitalization,High Course ( >40H )
360,58,1,57,2013,1045,0.02,2,Low Digitalization,High Course ( >40H )
361,80,14,66,2013,1045,0.18,18,Low Digitalization,High Course ( >40H )
362,5,3,2,2013,1045,0.62,62,Medium-High Digitalization,Small Course ( <15H )
363,22,11,11,2013,1045,0.49,49,Medium-Low Digitalization,Medium Course ( >15H and <40H )
364,26,4,22,2013,1045,0.16,16,Low Digitalization,Medium Course ( >15H and <40H )
365,60,41,19,2013,1045,0.69,69,Medium-High Digitalization,High Course ( >40H )
366,57,44,13,2013,1045,0.77,77,Medium-High Digitalization,High Course ( >40H )
367,11,3,8,2013,1045,0.25,25,Medium-Low Digitalization,Small Course ( <15H )
368,45,30,15,2013,1045,0.66,66,Medium-High Digitalization,High Course ( >40H )
369,25,19,6,2013,1045,0.76,76,Medium-High Digitalization,Medium Course ( >15H and <40H )
370,38,33,5,2013,1045,0.88,88,High Digitalization,Medium Course ( >15H and <40H )
371,8,2,6,2013,1045,0.24,24,Medium-Low Digitalization,Small Course ( <15H )
372,11,8,3,2013,1045,0.77,77,Medium-High Digitalization,Small Course ( <15H )
373,46,23,23,2013,1045,0.5,50,Medium-Low Digitalization,High Course ( >40H )
374,80,15,65,2013,1045,0.19,19,Low Digitalization,High Course ( >40H )
375,9,0,9,2013,1045,0.05,5,Low Digitalization,Small Course ( <15H )
376,33,9,24,2013,1045,0.27,27,Medium-Low Digitalization,Medium Course ( >15H and <40H )
377,25,12,14,2013,1045,0.46,46,Medium-Low Digitalization,Medium Course ( >15H and <40H )
378,13,1,12,2013,1045,0.07,7,Low Digitalization,Small Course ( <15H )
379,48,4,44,2013,1045,0.08,8,Low Digitalization,High Course ( >40H )
380,15,14,1,2013,1045,0.96,96,High Digitalization,Small Course ( <15H )
381,15,9,6,2013,1045,0.6,60,Medium-High Digitalization,Small Course ( <15H )
382,18,6,12,2013,1045,0.34,34,Medium-Low Digitalization,Medium Course ( >15H and <40H )
383,27,21,6,2013,1045,0.79,79,Medium-High Digitalization,Medium Course ( >15H and <40H )
384,6,5,1,2013,1045,0.82,82,High Digitalization,Small Course ( <15H )
385,5,0,5,2013,1045,0.04,4,Low Digitalization,Small Course ( <15H )
386,46,36,10,2013,1045,0.79,79,Medium-High Digitalization,High Course ( >40H )
387,63,43,20,2013,1045,0.68,68,Medium-High Digitalization,High Course ( >40H )
388,13,7,6,2013,1045,0.53,53,Medium-High Digitalization,Small Course ( <15H )
389,41,26,15,2013,1045,0.64,64,Medium-High Digitalization,High Course ( >40H )
390,15,14,2,2013,1045,0.9,90,High Digitalization,Small Course ( <15H )
391,14,12,2,2013,1045,0.87,87,High Digitalization,Small Course ( <15H )
392,33,20,13,2013,1045,0.62,62,Medium-High Digitalization,Medium Course ( >15H and <40H )
393,6,0,6,2013,1045,0.02,2,Low Digitalization,Small Course ( <15H )
394,60,13,47,2013,1045,0.22,22,Medium-Low Digitalization,High Course ( >40H )
395,11,2,9,2013,1045,0.16,16,Low Digitalization,Small Course ( <15H )
396,10,6,4,2013,1045,0.61,61,Medium-High Digitalization,Small Course ( <15H )
397,33,22,11,2013,1045,0.67,67,Medium-High Digitalization,Medium Course ( >15H and <40H )
398,48,12,36,2013,1045,0.26,26,Medium-Low Digitalization,High Course ( >40H )
399,31,2,29,2013,1045,0.05,5,Low Digitalization,Medium Course ( >15H and <40H )
400,25,2,24,2013,1045,0.06,6,Low Digitalization,Medium Course ( >15H and <40H )
401,25,0,25,2013,1045,0.01,1,Low Digitalization,Medium Course ( >15H and <40H )
402,36,32,4,2013,1045,0.89,89,High Digitalization,Medium Course ( >15H and <40H )
403,88,4,84,2013,1045,0.04,4,Low Digitalization,High Course ( >40H )
404,38,25,13,2013,1045,0.65,65,Medium-High Digitalization,Medium Course ( >15H and <40H )
405,52,23,29,2013,1045,0.45,45,Medium-Low Digitalization,High Course ( >40H )
406,30,15,15,2013,1045,0.51,51,Medium-High Digitalization,Medium Course ( >15H and <40H )
407,52,18,34,2013,1045,0.35,35,Medium-Low Digitalization,High Course ( >40H )
408,13,5,8,2013,1045,0.42,42,Medium-Low Digitalization,Small Course ( <15H )
409,7,2,5,2013,1045,0.27,27,Medium-Low Digitalization,Small Course ( <15H )
410,28,9,19,2013,1045,0.31,31,Medium-Low Digitalization,Medium Course ( >15H and <40H )
411,36,10,26,2013,1045,0.27,27,Medium-Low Digitalization,Medium Course ( >15H and <40H )
412,30,1,29,2013,1045,0.02,2,Low Digitalization,Medium Course ( >15H and <40H )
413,76,4,72,2013,1045,0.05,5,Low Digitalization,High Course ( >40H )
414,12,12,0,2013,1045,0.99,99,High Digitalization,Small Course ( <15H )
415,14,10,4,2013,1045,0.72,72,Medium-High Digitalization,Small Course ( <15H )
416,41,23,18,2013,1045,0.57,56,Medium-High Digitalization,High Course ( >40H )
417,26,20,6,2013,1045,0.78,78,Medium-High Digitalization,Medium Course ( >15H and <40H )
418,75,8,67,2013,1045,0.11,11,Low Digitalization,High Course ( >40H )
419,26,14,12,2013,1045,0.54,54,Medium-High Digitalization,Medium Course ( >15H and <40H )
420,52,44,8,2013,1045,0.85,85,High Digitalization,High Course ( >40H )
421,55,32,23,2013,1045,0.58,57,Medium-High Digitalization,High Course ( >40H )
422,53,36,17,2013,1045,0.67,67,Medium-High Digitalization,High Course ( >40H )
423,50,35,15,2013,1045,0.7,70,Medium-High Digitalization,High Course ( >40H )
424,15,2,13,2013,1045,0.13,13,Low Digitalization,Small Course ( <15H )
425,11,3,8,2013,1045,0.23,23,Medium-Low Digitalization,Small Course ( <15H )
426,51,17,34,2013,1045,0.33,33,Medium-Low Digitalization,High Course ( >40H )
427,26,23,3,2013,1045,0.9,90,High Digitalization,Medium Course ( >15H and <40H )
428,40,26,14,2013,1045,0.64,64,Medium-High Digitalization,High Course ( >40H )
429,60,49,11,2013,1045,0.82,82,High Digitalization,High Course ( >40H )
430,12,9,3,2013,1045,0.79,79,Medium-High Digitalization,Small Course ( <15H )
431,5,2,3,2013,1045,0.31,31,Medium-Low Digitalization,Small Course ( <15H )
432,45,45,0,2013,1045,0.99,99,High Digitalization,High Course ( >40H )
433,34,12,22,2013,1045,0.36,36,Medium-Low Digitalization,Medium Course ( >15H and <40H )
434,45,18,27,2013,1045,0.41,41,Medium-Low Digitalization,High Course ( >40H )
435,23,12,11,2013,1045,0.51,51,Medium-High Digitalization,Medium Course ( >15H and <40H )
436,31,27,4,2013,1045,0.86,86,High Digitalization,Medium Course ( >15H and <40H )
437,60,20,40,2013,1045,0.34,34,Medium-Low Digitalization,High Course ( >40H )
438,44,23,21,2013,1045,0.53,53,Medium-High Digitalization,High Course ( >40H )
439,36,10,26,2013,1045,0.27,27,Medium-Low Digitalization,Medium Course ( >15H and <40H )
440,25,12,13,2013,1045,0.48,48,Medium-Low Digitalization,Medium Course ( >15H and <40H )
441,12,5,7,2013,1045,0.42,42,Medium-Low Digitalization,Small Course ( <15H )
442,74,25,49,2013,1045,0.34,34,Medium-Low Digitalization,High Course ( >40H )
443,54,38,16,2013,1045,0.7,70,Medium-High Digitalization,High Course ( >40H )
444,56,47,9,2013,1045,0.84,84,High Digitalization,High Course ( >40H )
445,68,43,25,2013,1045,0.63,63,Medium-High Digitalization,High Course ( >40H )
446,31,3,28,2013,1045,0.1,10,Low Digitalization,Medium Course ( >15H and <40H )
447,64,15,49,2013,1045,0.24,24,Medium-Low Digitalization,High Course ( >40H )
448,35,6,29,2013,1045,0.17,17,Low Digitalization,Medium Course ( >15H and <40H )
449,78,49,29,2013,1045,0.63,63,Medium-High Digitalization,High Course ( >40H )
450,23,9,14,2013,1045,0.37,37,Medium-Low Digitalization,Medium Course ( >15H and <40H )
451,31,19,12,2013,1045,0.61,61,Medium-High Digitalization,Medium Course ( >15H and <40H )
452,26,7,19,2013,1045,0.28,28,Medium-Low Digitalization,Medium Course ( >15H and <40H )
453,6,4,2,2013,1045,0.59,59,Medium-High Digitalization,Small Course ( <15H )
454,58,7,51,2013,1045,0.12,12,Low Digitalization,High Course ( >40H )
455,27,25,2,2013,1045,0.93,93,High Digitalization,Medium Course ( >15H and <40H )
456,9,7,2,2013,1045,0.75,75,Medium-High Digitalization,Small Course ( <15H )
457,70,22,48,2013,1045,0.32,32,Medium-Low Digitalization,High Course ( >40H )
458,41,1,40,2013,1045,0.02,2,Low Digitalization,High Course ( >40H )
459,58,14,44,2013,1045,0.25,25,Medium-Low Digitalization,High Course ( >40H )
460,38,0,38,2013,1045,0.0,0,Low Digitalization,Medium Course ( >15H and <40H )
461,31,23,8,2013,1045,0.73,73,Medium-High Digitalization,Medium Course ( >15H and <40H )
462,10,0,10,2013,1045,0.05,5,Low Digitalization,Small Course ( <15H )
463,48,13,35,2013,1045,0.27,27,Medium-Low Digitalization,High Course ( >40H )
464,20,10,10,2013,1045,0.48,48,Medium-Low Digitalization,Medium Course ( >15H and <40H )
465,8,3,5,2013,1045,0.32,32,Medium-Low Digitalization,Small Course ( <15H )
466,11,2,9,2013,1045,0.14,14,Low Digitalization,Small Course ( <15H )
467,12,3,9,2013,1045,0.21,21,Medium-Low Digitalization,Small Course ( <15H )
468,41,9,32,2013,1045,0.22,22,Medium-Low Digitalization,High Course ( >40H )
469,56,4,52,2013,1045,0.07,7,Low Digitalization,High Course ( >40H )
470,67,66,1,2013,1045,0.99,99,High Digitalization,High Course ( >40H )
471,47,29,18,2013,1045,0.62,62,Medium-High Digitalization,High Course ( >40H )
472,12,2,10,2013,1045,0.17,17,Low Digitalization,Small Course ( <15H )
473,79,54,25,2013,1045,0.68,68,Medium-High Digitalization,High Course ( >40H )
474,5,3,2,2013,1045,0.67,67,Medium-High Digitalization,Small Course ( <15H )
475,12,3,9,2013,1045,0.28,28,Medium-Low Digitalization,Small Course ( <15H )
476,5,4,1,2013,1045,0.81,81,High Digitalization,Small Course ( <15H )
477,6,4,2,2013,1045,0.72,72,Medium-High Digitalization,Small Course ( <15H )
478,64,62,2,2013,1045,0.97,97,High Digitalization,High Course ( >40H )
479,15,12,3,2013,1045,0.81,81,High Digitalization,Small Course ( <15H )
480,88,70,18,2013,1045,0.79,79,Medium-High Digitalization,High Course ( >40H )
481,86,55,31,2013,1045,0.64,64,Medium-High Digitalization,High Course ( >40H )
482,18,11,7,2013,1045,0.62,62,Medium-High Digitalization,Medium Course ( >15H and <40H )
483,54,35,19,2013,1045,0.64,64,Medium-High Digitalization,High Course ( >40H )
484,75,74,1,2013,1045,0.99,99,High Digitalization,High Course ( >40H )
485,17,6,11,2013,1045,0.38,38,Medium-Low Digitalization,Medium Course ( >15H and <40H )
486,50,22,28,2013,1045,0.45,45,Medium-Low Digitalization,High Course ( >40H )
487,9,6,3,2013,1045,0.69,69,Medium-High Digitalization,Small Course ( <15H )
488,17,9,8,2013,1045,0.54,54,Medium-High Digitalization,Medium Course ( >15H and <40H )
489,9,3,6,2013,1045,0.32,32,Medium-Low Digitalization,Small Course ( <15H )
490,7,6,1,2013,1045,0.84,84,High Digitalization,Small Course ( <15H )
491,8,7,1,2013,1045,0.84,84,High Digitalization,Small Course ( <15H )
492,90,25,65,2013,1045,0.28,28,Medium-Low Digitalization,High Course ( >40H )
493,11,11,0,2013,1045,0.99,99,High Digitalization,Small Course ( <15H )
494,35,32,4,2013,1045,0.9,90,High Digitalization,Medium Course ( >15H and <40H )
495,41,19,22,2013,1045,0.47,47,Medium-Low Digitalization,High Course ( >40H )
496,82,62,20,2013,1045,0.75,75,Medium-High Digitalization,High Course ( >40H )
497,42,41,1,2013,1045,0.98,98,High Digitalization,High Course ( >40H )
498,84,41,43,2013,1045,0.49,49,Medium-Low Digitalization,High Course ( >40H )
499,37,28,9,2013,1045,0.76,76,Medium-High Digitalization,Medium Course ( >15H and <40H )
500,53,43,10,2013,1045,0.82,82,High Digitalization,High Course ( >40H )
501,15,13,2,2013,1045,0.86,86,High Digitalization,Small Course ( <15H )
502,16,15,1,2013,1045,0.92,92,High Digitalization,Medium Course ( >15H and <40H )
503,40,1,39,2013,1045,0.02,2,Low Digitalization,High Course ( >40H )
504,35,6,29,2013,1045,0.17,17,Low Digitalization,Medium Course ( >15H and <40H )
505,34,31,3,2013,1045,0.91,91,High Digitalization,Medium Course ( >15H and <40H )
506,71,51,20,2013,1045,0.72,72,Medium-High Digitalization,High Course ( >40H )
507,9,7,2,2013,1045,0.77,77,Medium-High Digitalization,Small Course ( <15H )
508,45,25,20,2013,1045,0.55,55,Medium-High Digitalization,High Course ( >40H )
509,8,0,8,2013,1045,0.05,5,Low Digitalization,Small Course ( <15H )
510,76,30,46,2013,1045,0.39,39,Medium-Low Digitalization,High Course ( >40H )
511,80,15,65,2013,1045,0.19,19,Low Digitalization,High Course ( >40H )
512,66,31,35,2013,1045,0.47,47,Medium-Low Digitalization,High Course ( >40H )
513,15,8,7,2013,1045,0.55,55,Medium-High Digitalization,Small Course ( <15H )
514,81,6,75,2013,1045,0.08,8,Low Digitalization,High Course ( >40H )
515,72,46,26,2013,1045,0.64,64,Medium-High Digitalization,High Course ( >40H )
516,23,11,12,2013,1045,0.49,49,Medium-Low Digitalization,Medium Course ( >15H and <40H )
517,34,0,34,2013,1045,0.0,0,Low Digitalization,Medium Course ( >15H and <40H )
518,22,18,4,2013,1045,0.8,80,Medium-High Digitalization,Medium Course ( >15H and <40H )
519,14,7,7,2013,1045,0.53,53,Medium-High Digitalization,Small Course ( <15H )
520,29,13,16,2013,1045,0.44,44,Medium-Low Digitalization,Medium Course ( >15H and <40H )
521,21,20,1,2013,1045,0.94,94,High Digitalization,Medium Course ( >15H and <40H )
522,19,8,11,2013,1045,0.42,42,Medium-Low Digitalization,Medium Course ( >15H and <40H )
523,12,11,1,2013,1045,0.89,89,High Digitalization,Small Course ( <15H )
524,9,0,9,2013,1045,0.0,0,Low Digitalization,Small Course ( <15H )
525,14,8,6,2013,1045,0.55,55,Medium-High Digitalization,Small Course ( <15H )
526,53,25,28,2013,1045,0.47,47,Medium-Low Digitalization,High Course ( >40H )
527,77,43,34,2013,1045,0.56,56,Medium-High Digitalization,High Course ( >40H )
528,10,8,2,2013,1045,0.81,81,High Digitalization,Small Course ( <15H )
529,14,10,4,2013,1045,0.72,72,Medium-High Digitalization,Small Course ( <15H )
530,43,1,42,2013,1045,0.03,3,Low Digitalization,High Course ( >40H )
531,71,63,8,2013,1045,0.89,89,High Digitalization,High Course ( >40H )
532,12,9,3,2013,1045,0.74,74,Medium-High Digitalization,Small Course ( <15H )
533,7,4,3,2013,1045,0.57,56,Medium-High Digitalization,Small Course ( <15H )
534,9,8,1,2013,1045,0.88,88,High Digitalization,Small Course ( <15H )
535,21,20,1,2013,1045,0.97,97,High Digitalization,Medium Course ( >15H and <40H )
536,83,33,50,2013,1045,0.4,40,Medium-Low Digitalization,High Course ( >40H )
537,12,2,10,2013,1045,0.15,15,Low Digitalization,Small Course ( <15H )
538,39,37,2,2013,1045,0.96,96,High Digitalization,Medium Course ( >15H and <40H )
539,12,12,0,2013,1045,0.96,96,High Digitalization,Small Course ( <15H )
540,59,21,38,2013,1045,0.36,36,Medium-Low Digitalization,High Course ( >40H )
541,17,12,5,2013,1045,0.73,73,Medium-High Digitalization,Medium Course ( >15H and <40H )
542,60,17,43,2013,1045,0.29,28,Medium-Low Digitalization,High Course ( >40H )
543,14,1,13,2013,1045,0.08,8,Low Digitalization,Small Course ( <15H )
544,9,2,7,2013,1045,0.22,22,Medium-Low Digitalization,Small Course ( <15H )
545,36,14,22,2013,1045,0.4,40,Medium-Low Digitalization,Medium Course ( >15H and <40H )
546,40,16,24,2013,1045,0.41,41,Medium-Low Digitalization,High Course ( >40H )
547,70,8,62,2013,1045,0.12,12,Low Digitalization,High Course ( >40H )
548,54,22,32,2013,1045,0.4,40,Medium-Low Digitalization,High Course ( >40H )
549,85,45,40,2013,1045,0.53,53,Medium-High Digitalization,High Course ( >40H )
550,88,28,60,2013,1045,0.32,32,Medium-Low Digitalization,High Course ( >40H )
551,49,44,5,2013,1045,0.89,89,High Digitalization,High Course ( >40H )
552,80,63,17,2013,1045,0.79,79,Medium-High Digitalization,High Course ( >40H )
553,9,8,1,2013,1045,0.85,85,High Digitalization,Small Course ( <15H )
554,80,6,74,2013,1045,0.07,7,Low Digitalization,High Course ( >40H )
555,28,0,28,2013,1045,0.0,0,Low Digitalization,Medium Course ( >15H and <40H )
556,50,6,44,2013,1045,0.13,13,Low Digitalization,High Course ( >40H )
557,31,25,6,2013,1045,0.8,80,Medium-High Digitalization,Medium Course ( >15H and <40H )
558,11,10,1,2013,1045,0.87,87,High Digitalization,Small Course ( <15H )
559,13,1,12,2013,1045,0.09,9,Low Digitalization,Small Course ( <15H )
560,22,20,2,2013,1045,0.89,89,High Digitalization,Medium Course ( >15H and <40H )
561,58,8,50,2013,1045,0.13,13,Low Digitalization,High Course ( >40H )
562,10,7,3,2013,1045,0.66,66,Medium-High Digitalization,Small Course ( <15H )
563,52,39,13,2013,1045,0.75,75,Medium-High Digitalization,High Course ( >40H )
564,69,15,54,2013,1045,0.22,22,Medium-Low Digitalization,High Course ( >40H )
565,16,12,4,2013,1045,0.77,77,Medium-High Digitalization,Medium Course ( >15H and <40H )
566,59,21,38,2013,1045,0.36,36,Medium-Low Digitalization,High Course ( >40H )
567,12,2,10,2013,1045,0.13,13,Low Digitalization,Small Course ( <15H )
568,58,14,44,2013,1045,0.25,25,Medium-Low Digitalization,High Course ( >40H )
569,7,6,1,2013,1045,0.81,81,High Digitalization,Small Course ( <15H )
570,69,16,53,2013,1045,0.23,23,Medium-Low Digitalization,High Course ( >40H )
571,14,1,13,2013,1045,0.09,9,Low Digitalization,Small Course ( <15H )
572,11,7,4,2013,1045,0.63,63,Medium-High Digitalization,Small Course ( <15H )
573,23,19,4,2013,1045,0.83,83,High Digitalization,Medium Course ( >15H and <40H )
574,10,4,6,2013,1045,0.35,35,Medium-Low Digitalization,Small Course ( <15H )
575,35,1,34,2013,1045,0.04,4,Low Digitalization,Medium Course ( >15H and <40H )
576,67,66,1,2013,1045,0.98,98,High Digitalization,High Course ( >40H )
577,40,16,24,2013,1045,0.41,41,Medium-Low Digitalization,High Course ( >40H )
578,88,84,4,2013,1045,0.95,95,High Digitalization,High Course ( >40H )
579,56,52,4,2013,1045,0.93,93,High Digitalization,High Course ( >40H )
580,43,30,13,2013,1045,0.69,69,Medium-High Digitalization,High Course ( >40H )
581,42,22,20,2013,1045,0.53,53,Medium-High Digitalization,High Course ( >40H )
582,26,18,8,2013,1045,0.7,70,Medium-High Digitalization,Medium Course ( >15H and <40H )
583,65,25,40,2013,1045,0.39,39,Medium-Low Digitalization,High Course ( >40H )
584,78,19,59,2013,1045,0.24,24,Medium-Low Digitalization,High Course ( >40H )
585,5,0,5,2013,1045,0.06,6,Low Digitalization,Small Course ( <15H )
586,60,56,4,2013,1045,0.93,93,High Digitalization,High Course ( >40H )
587,15,4,11,2013,1045,0.27,27,Medium-Low Digitalization,Small Course ( <15H )
588,15,3,12,2013,1045,0.18,18,Low Digitalization,Small Course ( <15H )
589,13,12,1,2013,1045,0.94,94,High Digitalization,Small Course ( <15H )
590,9,4,5,2013,1045,0.44,44,Medium-Low Digitalization,Small Course ( <15H )
591,10,9,1,2013,1045,0.9,90,High Digitalization,Small Course ( <15H )
592,75,33,42,2013,1045,0.44,44,Medium-Low Digitalization,High Course ( >40H )
593,60,45,15,2013,1045,0.75,75,Medium-High Digitalization,High Course ( >40H )
594,8,5,3,2013,1045,0.6,60,Medium-High Digitalization,Small Course ( <15H )
595,7,3,4,2013,1045,0.46,46,Medium-Low Digitalization,Small Course ( <15H )
596,52,8,44,2013,1045,0.16,16,Low Digitalization,High Course ( >40H )
597,30,9,21,2013,1045,0.29,28,Medium-Low Digitalization,Medium Course ( >15H and <40H )
598,11,8,3,2013,1045,0.74,74,Medium-High Digitalization,Small Course ( <15H )
599,17,6,11,2013,1045,0.33,33,Medium-Low Digitalization,Medium Course ( >15H and <40H )
600,12,7,5,2013,1045,0.59,59,Medium-High Digitalization,Small Course ( <15H )
601,44,34,10,2013,1045,0.77,77,Medium-High Digitalization,High Course ( >40H )
602,88,68,20,2013,1045,0.77,77,Medium-High Digitalization,High Course ( >40H )
603,12,10,2,2013,1045,0.83,83,High Digitalization,Small Course ( <15H )
604,37,3,34,2013,1045,0.07,7,Low Digitalization,Medium Course ( >15H and <40H )
605,29,13,16,2013,1045,0.45,45,Medium-Low Digitalization,Medium Course ( >15H and <40H )
606,56,21,35,2013,1045,0.37,37,Medium-Low Digitalization,High Course ( >40H )
607,12,2,10,2013,1045,0.13,13,Low Digitalization,Small Course ( <15H )
608,9,9,0,2013,1045,0.98,98,High Digitalization,Small Course ( <15H )
609,40,11,29,2013,1045,0.27,27,Medium-Low Digitalization,High Course ( >40H )
610,87,3,84,2013,1045,0.04,4,Low Digitalization,High Course ( >40H )
611,23,22,1,2013,1045,0.97,97,High Digitalization,Medium Course ( >15H and <40H )
612,47,35,12,2013,1045,0.75,75,Medium-High Digitalization,High Course ( >40H )
613,6,4,2,2013,1045,0.75,75,Medium-High Digitalization,Small Course ( <15H )
614,9,3,6,2013,1045,0.36,36,Medium-Low Digitalization,Small Course ( <15H )
615,9,2,7,2013,1045,0.24,24,Medium-Low Digitalization,Small Course ( <15H )
616,7,6,1,2013,1045,0.91,91,High Digitalization,Small Course ( <15H )
617,43,20,23,2013,1045,0.46,46,Medium-Low Digitalization,High Course ( >40H )
618,12,3,9,2013,1045,0.21,21,Medium-Low Digitalization,Small Course ( <15H )
619,41,39,2,2013,1045,0.96,96,High Digitalization,High Course ( >40H )
620,86,27,59,2013,1045,0.31,31,Medium-Low Digitalization,High Course ( >40H )
621,76,64,12,2013,1045,0.84,84,High Digitalization,High Course ( >40H )
622,35,13,22,2013,1045,0.37,37,Medium-Low Digitalization,Medium Course ( >15H and <40H )
623,85,25,60,2013,1045,0.29,28,Medium-Low Digitalization,High Course ( >40H )
624,66,44,22,2013,1045,0.67,67,Medium-High Digitalization,High Course ( >40H )
625,77,36,41,2013,1045,0.47,47,Medium-Low Digitalization,High Course ( >40H )
626,17,10,7,2013,1045,0.56,56,Medium-High Digitalization,Medium Course ( >15H and <40H )
627,10,3,7,2013,1045,0.31,31,Medium-Low Digitalization,Small Course ( <15H )
628,28,19,9,2013,1045,0.69,69,Medium-High Digitalization,Medium Course ( >15H and <40H )
629,11,9,2,2013,1045,0.79,79,Medium-High Digitalization,Small Course ( <15H )
630,31,23,8,2013,1045,0.75,75,Medium-High Digitalization,Medium Course ( >15H and <40H )
631,85,38,47,2013,1045,0.45,45,Medium-Low Digitalization,High Course ( >40H )
632,58,10,48,2013,1045,0.18,18,Low Digitalization,High Course ( >40H )
633,13,1,12,2013,1045,0.09,9,Low Digitalization,Small Course ( <15H )
634,18,14,4,2013,1045,0.79,79,Medium-High Digitalization,Medium Course ( >15H and <40H )
635,15,13,2,2013,1045,0.87,87,High Digitalization,Small Course ( <15H )
636,42,7,35,2013,1045,0.17,17,Low Digitalization,High Course ( >40H )
637,84,45,39,2013,1045,0.53,53,Medium-High Digitalization,High Course ( >40H )
638,50,46,4,2013,1045,0.93,93,High Digitalization,High Course ( >40H )
639,27,6,21,2013,1045,0.21,21,Medium-Low Digitalization,Medium Course ( >15H and <40H )
640,10,2,8,2013,1045,0.23,23,Medium-Low Digitalization,Small Course ( <15H )
641,25,2,23,2013,1045,0.08,8,Low Digitalization,Medium Course ( >15H and <40H )
642,35,24,11,2013,1045,0.68,68,Medium-High Digitalization,Medium Course ( >15H and <40H )
643,7,7,0,2013,1045,0.96,96,High Digitalization,Small Course ( <15H )
644,56,1,55,2013,1045,0.02,2,Low Digitalization,High Course ( >40H )
645,47,10,37,2013,1045,0.21,21,Medium-Low Digitalization,High Course ( >40H )
646,22,1,21,2013,1045,0.06,6,Low Digitalization,Medium Course ( >15H and <40H )
647,13,9,4,2013,1045,0.66,66,Medium-High Digitalization,Small Course ( <15H )
648,82,66,16,2013,1045,0.8,80,Medium-High Digitalization,High Course ( >40H )
649,19,5,14,2013,1045,0.25,25,Medium-Low Digitalization,Medium Course ( >15H and <40H )
650,14,5,9,2013,1045,0.35,35,Medium-Low Digitalization,Small Course ( <15H )
651,68,44,24,2013,1045,0.65,65,Medium-High Digitalization,High Course ( >40H )
652,52,6,46,2013,1045,0.11,11,Low Digitalization,High Course ( >40H )
653,11,3,8,2013,1045,0.3,30,Medium-Low Digitalization,Small Course ( <15H )
654,16,7,9,2013,1045,0.41,41,Medium-Low Digitalization,Medium Course ( >15H and <40H )
655,24,17,7,2013,1045,0.69,69,Medium-High Digitalization,Medium Course ( >15H and <40H )
656,89,5,84,2013,1045,0.06,6,Low Digitalization,High Course ( >40H )
657,59,46,13,2013,1045,0.78,78,Medium-High Digitalization,High Course ( >40H )
658,28,13,15,2013,1045,0.46,46,Medium-Low Digitalization,Medium Course ( >15H and <40H )
659,48,4,44,2013,1045,0.09,9,Low Digitalization,High Course ( >40H )
660,9,1,8,2013,1045,0.09,9,Low Digitalization,Small Course ( <15H )
661,10,9,1,2013,1045,0.87,87,High Digitalization,Small Course ( <15H )
662,7,1,6,2013,1045,0.15,15,Low Digitalization,Small Course ( <15H )
663,23,3,20,2013,1045,0.12,12,Low Digitalization,Medium Course ( >15H and <40H )
664,46,38,8,2013,1045,0.82,82,High Digitalization,High Course ( >40H )
665,15,5,10,2013,1045,0.31,31,Medium-Low Digitalization,Small Course ( <15H )
666,64,35,29,2013,1045,0.55,55,Medium-High Digitalization,High Course ( >40H )
667,65,56,9,2013,1045,0.86,86,High Digitalization,High Course ( >40H )
668,69,37,32,2013,1045,0.53,53,Medium-High Digitalization,High Course ( >40H )
669,14,4,10,2013,1045,0.31,31,Medium-Low Digitalization,Small Course ( <15H )
670,13,1,12,2013,1045,0.11,11,Low Digitalization,Small Course ( <15H )
671,57,52,5,2013,1045,0.92,92,High Digitalization,High Course ( >40H )
672,9,5,4,2013,1045,0.61,61,Medium-High Digitalization,Small Course ( <15H )
673,40,36,4,2013,1045,0.9,90,High Digitalization,High Course ( >40H )
674,52,8,44,2013,1045,0.16,16,Low Digitalization,High Course ( >40H )
675,13,5,8,2013,1045,0.42,42,Medium-Low Digitalization,Small Course ( <15H )
676,11,8,3,2013,1045,0.7,70,Medium-High Digitalization,Small Course ( <15H )
677,28,22,6,2013,1045,0.79,79,Medium-High Digitalization,Medium Course ( >15H and <40H )
678,82,7,75,2013,1045,0.08,8,Low Digitalization,High Course ( >40H )
679,58,50,8,2013,1045,0.86,86,High Digitalization,High Course ( >40H )
680,50,8,42,2013,1045,0.15,15,Low Digitalization,High Course ( >40H )
681,70,58,12,2013,1045,0.83,83,High Digitalization,High Course ( >40H )
682,77,2,75,2013,1045,0.03,3,Low Digitalization,High Course ( >40H )
683,25,12,13,2013,1045,0.49,49,Medium-Low Digitalization,Medium Course ( >15H and <40H )
684,9,7,2,2013,1045,0.82,82,High Digitalization,Small Course ( <15H )
685,36,9,27,2013,1045,0.26,26,Medium-Low Digitalization,Medium Course ( >15H and <40H )
686,25,19,6,2013,1045,0.77,77,Medium-High Digitalization,Medium Course ( >15H and <40H )
687,84,24,60,2013,1045,0.29,28,Medium-Low Digitalization,High Course ( >40H )
688,36,17,19,2013,1045,0.48,48,Medium-Low Digitalization,Medium Course ( >15H and <40H )
689,8,8,0,2013,1045,0.95,95,High Digitalization,Small Course ( <15H )
690,58,51,7,2013,1045,0.88,88,High Digitalization,High Course ( >40H )
691,5,2,3,2013,1045,0.48,48,Medium-Low Digitalization,Small Course ( <15H )
692,13,5,8,2013,1045,0.39,39,Medium-Low Digitalization,Small Course ( <15H )
693,62,58,4,2013,1045,0.94,94,High Digitalization,High Course ( >40H )
694,80,51,29,2013,1045,0.64,64,Medium-High Digitalization,High Course ( >40H )
695,66,63,3,2013,1045,0.95,95,High Digitalization,High Course ( >40H )
696,54,49,5,2013,1045,0.91,91,High Digitalization,High Course ( >40H )
697,6,4,2,2013,1045,0.68,68,Medium-High Digitalization,Small Course ( <15H )
698,11,0,11,2013,1045,0.01,1,Low Digitalization,Small Course ( <15H )
699,15,11,4,2013,1045,0.73,73,Medium-High Digitalization,Small Course ( <15H )
700,79,47,32,2013,1045,0.6,60,Medium-High Digitalization,High Course ( >40H )
701,13,13,0,2013,1045,0.99,99,High Digitalization,Small Course ( <15H )
702,64,28,36,2013,1045,0.43,43,Medium-Low Digitalization,High Course ( >40H )
703,90,65,25,2013,1045,0.72,72,Medium-High Digitalization,High Course ( >40H )
704,87,86,1,2013,1045,0.99,99,High Digitalization,High Course ( >40H )
705,70,36,34,2013,1045,0.51,51,Medium-High Digitalization,High Course ( >40H )
706,49,13,36,2013,1045,0.26,26,Medium-Low Digitalization,High Course ( >40H )
707,7,2,5,2013,1045,0.35,35,Medium-Low Digitalization,Small Course ( <15H )
708,61,59,2,2013,1045,0.96,96,High Digitalization,High Course ( >40H )
709,77,43,34,2013,1045,0.56,56,Medium-High Digitalization,High Course ( >40H )
710,80,14,66,2013,1045,0.18,18,Low Digitalization,High Course ( >40H )
711,44,4,40,2013,1045,0.09,9,Low Digitalization,High Course ( >40H )
712,39,34,5,2013,1045,0.87,87,High Digitalization,Medium Course ( >15H and <40H )
713,12,9,3,2013,1045,0.78,78,Medium-High Digitalization,Small Course ( <15H )
714,16,10,6,2013,1045,0.6,60,Medium-High Digitalization,Medium Course ( >15H and <40H )
715,37,21,16,2013,1045,0.56,56,Medium-High Digitalization,Medium Course ( >15H and <40H )
716,42,5,37,2013,1045,0.11,11,Low Digitalization,High Course ( >40H )
717,51,12,39,2013,1045,0.23,23,Medium-Low Digitalization,High Course ( >40H )
718,20,11,9,2013,1045,0.54,54,Medium-High Digitalization,Medium Course ( >15H and <40H )
719,24,7,17,2013,1045,0.29,28,Medium-Low Digitalization,Medium Course ( >15H and <40H )
720,60,58,2,2013,1045,0.97,97,High Digitalization,High Course ( >40H )
721,85,26,59,2013,1045,0.31,31,Medium-Low Digitalization,High Course ( >40H )
722,44,33,11,2013,1045,0.75,75,Medium-High Digitalization,High Course ( >40H )
723,89,52,37,2013,1045,0.58,57,Medium-High Digitalization,High Course ( >40H )
724,33,7,26,2013,1045,0.21,21,Medium-Low Digitalization,Medium Course ( >15H and <40H )
725,73,10,63,2013,1045,0.14,14,Low Digitalization,High Course ( >40H )
726,14,14,0,2013,1045,0.97,97,High Digitalization,Small Course ( <15H )
727,15,2,13,2013,1045,0.11,11,Low Digitalization,Small Course ( <15H )
728,35,19,16,2013,1045,0.54,54,Medium-High Digitalization,Medium Course ( >15H and <40H )
729,63,32,31,2013,1045,0.51,51,Medium-High Digitalization,High Course ( >40H )
730,39,7,32,2013,1045,0.18,18,Low Digitalization,Medium Course ( >15H and <40H )
731,5,4,1,2013,1045,0.89,89,High Digitalization,Small Course ( <15H )
732,9,8,1,2013,1045,0.86,86,High Digitalization,Small Course ( <15H )
733,77,36,41,2013,1045,0.47,47,Medium-Low Digitalization,High Course ( >40H )
734,13,2,11,2013,1045,0.17,17,Low Digitalization,Small Course ( <15H )
735,9,9,0,2013,1045,0.98,98,High Digitalization,Small Course ( <15H )
736,50,38,12,2013,1045,0.75,75,Medium-High Digitalization,High Course ( >40H )
737,35,8,27,2013,1045,0.23,23,Medium-Low Digitalization,Medium Course ( >15H and <40H )
738,30,15,15,2013,1045,0.49,49,Medium-Low Digitalization,Medium Course ( >15H and <40H )
739,53,38,15,2013,1045,0.71,71,Medium-High Digitalization,High Course ( >40H )
740,27,14,13,2013,1045,0.51,51,Medium-High Digitalization,Medium Course ( >15H and <40H )
741,41,0,41,2013,1045,0.01,1,Low Digitalization,High Course ( >40H )
742,16,5,11,2013,1045,0.34,34,Medium-Low Digitalization,Medium Course ( >15H and <40H )
743,6,3,3,2013,1045,0.46,46,Medium-Low Digitalization,Small Course ( <15H )
744,60,4,56,2013,1045,0.06,6,Low Digitalization,High Course ( >40H )
745,38,31,7,2013,1045,0.81,81,High Digitalization,Medium Course ( >15H and <40H )
746,17,12,5,2013,1045,0.73,73,Medium-High Digitalization,Medium Course ( >15H and <40H )
747,9,2,7,2013,1045,0.25,25,Medium-Low Digitalization,Small Course ( <15H )
748,8,5,3,2013,1045,0.63,63,Medium-High Digitalization,Small Course ( <15H )
749,32,26,6,2013,1045,0.81,81,High Digitalization,Medium Course ( >15H and <40H )
750,7,5,2,2013,1045,0.68,68,Medium-High Digitalization,Small Course ( <15H )
751,71,67,4,2013,1045,0.94,94,High Digitalization,High Course ( >40H )
752,6,5,1,2013,1045,0.89,89,High Digitalization,Small Course ( <15H )
753,57,22,35,2013,1045,0.38,38,Medium-Low Digitalization,High Course ( >40H )
754,35,33,2,2013,1045,0.93,93,High Digitalization,Medium Course ( >15H and <40H )
755,60,28,32,2013,1045,0.47,47,Medium-Low Digitalization,High Course ( >40H )
756,7,3,4,2013,1045,0.43,43,Medium-Low Digitalization,Small Course ( <15H )
757,11,6,5,2013,1045,0.53,53,Medium-High Digitalization,Small Course ( <15H )
758,5,0,5,2013,1045,0.06,6,Low Digitalization,Small Course ( <15H )
759,5,2,3,2013,1045,0.4,40,Medium-Low Digitalization,Small Course ( <15H )
760,8,4,4,2013,1045,0.45,45,Medium-Low Digitalization,Small Course ( <15H )
761,12,10,2,2013,1045,0.87,87,High Digitalization,Small Course ( <15H )
762,43,28,15,2013,1045,0.64,64,Medium-High Digitalization,High Course ( >40H )
763,25,22,3,2013,1045,0.89,89,High Digitalization,Medium Course ( >15H and <40H )
764,56,1,55,2013,1045,0.02,2,Low Digitalization,High Course ( >40H )
765,86,54,32,2013,1045,0.63,63,Medium-High Digitalization,High Course ( >40H )
766,86,71,15,2013,1045,0.83,83,High Digitalization,High Course ( >40H )
767,12,12,0,2013,1045,0.97,97,High Digitalization,Small Course ( <15H )
768,17,3,14,2013,1045,0.15,15,Low Digitalization,Medium Course ( >15H and <40H )
769,67,11,56,2013,1045,0.17,17,Low Digitalization,High Course ( >40H )
770,5,1,4,2013,1045,0.15,15,Low Digitalization,Small Course ( <15H )
771,24,16,8,2013,1045,0.67,67,Medium-High Digitalization,Medium Course ( >15H and <40H )
772,51,34,17,2013,1045,0.67,67,Medium-High Digitalization,High Course ( >40H )
773,39,24,15,2013,1045,0.62,62,Medium-High Digitalization,Medium Course ( >15H and <40H )
774,24,3,21,2013,1045,0.14,14,Low Digitalization,Medium Course ( >15H and <40H )
775,8,1,7,2013,1045,0.17,17,Low Digitalization,Small Course ( <15H )
776,38,26,12,2013,1045,0.69,69,Medium-High Digitalization,Medium Course ( >15H and <40H )
777,11,11,0,2013,1045,0.96,96,High Digitalization,Small Course ( <15H )
778,46,9,37,2013,1045,0.2,20,Low Digitalization,High Course ( >40H )
779,57,46,11,2013,1045,0.8,80,Medium-High Digitalization,High Course ( >40H )
780,39,2,37,2013,1045,0.05,5,Low Digitalization,Medium Course ( >15H and <40H )
781,82,80,2,2013,1045,0.98,98,High Digitalization,High Course ( >40H )
782,29,23,6,2013,1045,0.79,79,Medium-High Digitalization,Medium Course ( >15H and <40H )
783,65,23,42,2013,1045,0.35,35,Medium-Low Digitalization,High Course ( >40H )
784,10,5,5,2013,1045,0.46,46,Medium-Low Digitalization,Small Course ( <15H )
785,13,7,6,2013,1045,0.54,54,Medium-High Digitalization,Small Course ( <15H )
786,6,4,2,2013,1045,0.67,67,Medium-High Digitalization,Small Course ( <15H )
787,7,2,5,2013,1045,0.22,22,Medium-Low Digitalization,Small Course ( <15H )
788,26,21,5,2013,1045,0.81,81,High Digitalization,Medium Course ( >15H and <40H )
789,77,36,41,2013,1045,0.47,47,Medium-Low Digitalization,High Course ( >40H )
790,41,21,20,2013,1045,0.51,51,Medium-High Digitalization,High Course ( >40H )
791,10,2,8,2013,1045,0.24,24,Medium-Low Digitalization,Small Course ( <15H )
792,22,18,4,2013,1045,0.84,84,High Digitalization,Medium Course ( >15H and <40H )
793,32,1,31,2013,1045,0.02,2,Low Digitalization,Medium Course ( >15H and <40H )
794,65,36,29,2013,1045,0.55,55,Medium-High Digitalization,High Course ( >40H )
795,42,5,37,2013,1045,0.12,12,Low Digitalization,High Course ( >40H )
796,53,4,49,2013,1045,0.07,7,Low Digitalization,High Course ( >40H )
797,21,5,16,2013,1045,0.25,25,Medium-Low Digitalization,Medium Course ( >15H and <40H )
798,11,7,4,2013,1045,0.64,64,Medium-High Digitalization,Small Course ( <15H )
799,45,18,27,2013,1045,0.4,40,Medium-Low Digitalization,High Course ( >40H )
800,83,45,38,2013,1045,0.54,54,Medium-High Digitalization,High Course ( >40H )
801,9,4,4,2013,1045,0.5,50,Medium-Low Digitalization,Small Course ( <15H )
802,75,59,16,2013,1045,0.79,79,Medium-High Digitalization,High Course ( >40H )
803,6,2,4,2013,1045,0.36,36,Medium-Low Digitalization,Small Course ( <15H )
804,9,1,8,2013,1045,0.15,15,Low Digitalization,Small Course ( <15H )
805,67,16,51,2013,1045,0.24,24,Medium-Low Digitalization,High Course ( >40H )
806,38,35,3,2013,1045,0.93,93,High Digitalization,Medium Course ( >15H and <40H )
807,42,39,3,2013,1045,0.94,94,High Digitalization,High Course ( >40H )
808,5,3,2,2013,1045,0.56,56,Medium-High Digitalization,Small Course ( <15H )
809,58,17,41,2013,1045,0.29,28,Medium-Low Digitalization,High Course ( >40H )
810,37,14,23,2013,1045,0.37,37,Medium-Low Digitalization,Medium Course ( >15H and <40H )
811,30,14,16,2013,1045,0.46,46,Medium-Low Digitalization,Medium Course ( >15H and <40H )
812,52,33,19,2013,1045,0.64,64,Medium-High Digitalization,High Course ( >40H )
813,52,41,11,2013,1045,0.78,78,Medium-High Digitalization,High Course ( >40H )
814,31,6,25,2013,1045,0.18,18,Low Digitalization,Medium Course ( >15H and <40H )
815,32,18,14,2013,1045,0.55,55,Medium-High Digitalization,Medium Course ( >15H and <40H )
816,68,46,22,2013,1045,0.67,67,Medium-High Digitalization,High Course ( >40H )
817,12,6,6,2013,1045,0.5,50,Medium-Low Digitalization,Small Course ( <15H )
818,17,16,1,2013,1045,0.94,94,High Digitalization,Medium Course ( >15H and <40H )
819,63,18,45,2013,1045,0.28,28,Medium-Low Digitalization,High Course ( >40H )
820,43,20,23,2013,1045,0.46,46,Medium-Low Digitalization,High Course ( >40H )
821,50,14,36,2013,1045,0.27,27,Medium-Low Digitalization,High Course ( >40H )
822,28,27,1,2013,1045,0.95,95,High Digitalization,Medium Course ( >15H and <40H )
823,64,10,54,2013,1045,0.16,16,Low Digitalization,High Course ( >40H )
824,11,7,4,2013,1045,0.68,68,Medium-High Digitalization,Small Course ( <15H )
825,36,32,4,2013,1045,0.9,90,High Digitalization,Medium Course ( >15H and <40H )
826,13,11,2,2013,1045,0.83,83,High Digitalization,Small Course ( <15H )
827,17,10,7,2013,1045,0.56,56,Medium-High Digitalization,Medium Course ( >15H and <40H )
828,61,38,23,2013,1045,0.62,62,Medium-High Digitalization,High Course ( >40H )
829,47,5,42,2013,1045,0.11,11,Low Digitalization,High Course ( >40H )
830,48,24,24,2013,1045,0.51,51,Medium-High Digitalization,High Course ( >40H )
831,72,30,42,2013,1045,0.41,41,Medium-Low Digitalization,High Course ( >40H )
832,18,8,10,2013,1045,0.42,42,Medium-Low Digitalization,Medium Course ( >15H and <40H )
833,15,6,9,2013,1045,0.4,40,Medium-Low Digitalization,Small Course ( <15H )
834,68,32,36,2013,1045,0.47,47,Medium-Low Digitalization,High Course ( >40H )
835,49,25,24,2013,1045,0.51,51,Medium-High Digitalization,High Course ( >40H )
836,8,5,3,2013,1045,0.66,66,Medium-High Digitalization,Small Course ( <15H )
837,47,24,24,2013,1045,0.5,50,Medium-Low Digitalization,High Course ( >40H )
838,21,11,10,2013,1045,0.53,53,Medium-High Digitalization,Medium Course ( >15H and <40H )
839,35,8,27,2013,1045,0.23,23,Medium-Low Digitalization,Medium Course ( >15H and <40H )
840,73,47,26,2013,1045,0.65,65,Medium-High Digitalization,High Course ( >40H )
841,37,20,17,2013,1045,0.54,54,Medium-High Digitalization,Medium Course ( >15H and <40H )
842,22,13,9,2013,1045,0.58,57,Medium-High Digitalization,Medium Course ( >15H and <40H )
843,10,7,3,2013,1045,0.7,70,Medium-High Digitalization,Small Course ( <15H )
844,41,14,27,2013,1045,0.34,34,Medium-Low Digitalization,High Course ( >40H )
845,47,32,15,2013,1045,0.68,68,Medium-High Digitalization,High Course ( >40H )
846,26,12,14,2013,1045,0.47,47,Medium-Low Digitalization,Medium Course ( >15H and <40H )
847,28,20,8,2013,1045,0.7,70,Medium-High Digitalization,Medium Course ( >15H and <40H )
848,45,35,10,2013,1045,0.78,78,Medium-High Digitalization,High Course ( >40H )
849,6,2,4,2013,1045,0.31,31,Medium-Low Digitalization,Small Course ( <15H )
850,14,3,11,2013,1045,0.21,21,Medium-Low Digitalization,Small Course ( <15H )
851,13,8,5,2013,1045,0.62,62,Medium-High Digitalization,Small Course ( <15H )
852,57,44,13,2013,1045,0.77,77,Medium-High Digitalization,High Course ( >40H )
853,30,15,15,2013,1045,0.5,50,Medium-Low Digitalization,Medium Course ( >15H and <40H )
854,9,9,0,2013,1045,0.99,99,High Digitalization,Small Course ( <15H )
855,8,5,3,2013,1045,0.57,56,Medium-High Digitalization,Small Course ( <15H )
856,59,25,34,2013,1045,0.42,42,Medium-Low Digitalization,High Course ( >40H )
857,10,6,4,2013,1045,0.62,62,Medium-High Digitalization,Small Course ( <15H )
858,24,11,13,2013,1045,0.47,47,Medium-Low Digitalization,Medium Course ( >15H and <40H )
859,10,1,9,2013,1045,0.1,10,Low Digitalization,Small Course ( <15H )
860,6,2,4,2013,1045,0.3,30,Medium-Low Digitalization,Small Course ( <15H )
861,9,1,8,2013,1045,0.11,11,Low Digitalization,Small Course ( <15H )
862,16,11,5,2013,1045,0.7,70,Medium-High Digitalization,Medium Course ( >15H and <40H )
863,53,38,15,2013,1045,0.72,72,Medium-High Digitalization,High Course ( >40H )
864,14,13,1,2013,1045,0.96,96,High Digitalization,Small Course ( <15H )
865,7,5,2,2013,1045,0.75,75,Medium-High Digitalization,Small Course ( <15H )
866,15,8,7,2013,1045,0.52,52,Medium-High Digitalization,Small Course ( <15H )
867,70,48,22,2013,1045,0.68,68,Medium-High Digitalization,High Course ( >40H )
868,74,55,19,2013,1045,0.74,74,Medium-High Digitalization,High Course ( >40H )
869,86,82,4,2013,1045,0.95,95,High Digitalization,High Course ( >40H )
870,22,2,20,2013,1045,0.11,11,Low Digitalization,Medium Course ( >15H and <40H )
871,25,21,4,2013,1045,0.84,84,High Digitalization,Medium Course ( >15H and <40H )
872,60,1,59,2013,1045,0.02,2,Low Digitalization,High Course ( >40H )
873,7,6,1,2013,1045,0.88,88,High Digitalization,Small Course ( <15H )
874,57,35,22,2013,1045,0.62,62,Medium-High Digitalization,High Course ( >40H )
875,5,0,5,2013,1045,0.09,9,Low Digitalization,Small Course ( <15H )
876,88,84,4,2013,1045,0.95,95,High Digitalization,High Course ( >40H )
877,13,2,11,2013,1045,0.18,18,Low Digitalization,Small Course ( <15H )
878,90,77,13,2013,1045,0.86,86,High Digitalization,High Course ( >40H )
879,8,0,8,2013,1045,0.03,3,Low Digitalization,Small Course ( <15H )
880,14,7,7,2013,1045,0.47,47,Medium-Low Digitalization,Small Course ( <15H )
881,14,5,9,2013,1045,0.33,33,Medium-Low Digitalization,Small Course ( <15H )
882,11,4,7,2013,1045,0.4,40,Medium-Low Digitalization,Small Course ( <15H )
883,12,1,11,2013,1045,0.1,10,Low Digitalization,Small Course ( <15H )
884,10,1,9,2013,1045,0.06,6,Low Digitalization,Small Course ( <15H )
885,50,2,48,2013,1045,0.05,5,Low Digitalization,High Course ( >40H )
886,49,12,37,2013,1045,0.24,24,Medium-Low Digitalization,High Course ( >40H )
887,12,5,7,2013,1045,0.44,44,Medium-Low Digitalization,Small Course ( <15H )
888,56,41,15,2013,1045,0.74,74,Medium-High Digitalization,High Course ( >40H )
889,14,8,6,2013,1045,0.55,55,Medium-High Digitalization,Small Course ( <15H )
890,53,4,49,2013,1045,0.07,7,Low Digitalization,High Course ( >40H )
891,50,38,12,2013,1045,0.77,77,Medium-High Digitalization,High Course ( >40H )
892,47,38,9,2013,1045,0.81,81,High Digitalization,High Course ( >40H )
893,14,10,4,2013,1045,0.68,68,Medium-High Digitalization,Small Course ( <15H )
894,13,7,6,2013,1045,0.51,51,Medium-High Digitalization,Small Course ( <15H )
895,39,11,28,2013,1045,0.27,27,Medium-Low Digitalization,Medium Course ( >15H and <40H )
896,9,8,1,2013,1045,0.94,94,High Digitalization,Small Course ( <15H )
897,79,50,29,2013,1045,0.63,63,Medium-High Digitalization,High Course ( >40H )
898,9,3,6,2013,1045,0.29,28,Medium-Low Digitalization,Small Course ( <15H )
899,7,4,3,2013,1045,0.55,55,Medium-High Digitalization,Small Course ( <15H )
900,40,24,16,2013,1045,0.6,60,Medium-High Digitalization,High Course ( >40H )
901,46,43,3,2013,1045,0.93,93,High Digitalization,High Course ( >40H )
902,58,35,23,2013,1045,0.6,60,Medium-High Digitalization,High Course ( >40H )
903,34,11,23,2013,1045,0.32,32,Medium-Low Digitalization,Medium Course ( >15H and <40H )
904,76,21,55,2013,1045,0.27,27,Medium-Low Digitalization,High Course ( >40H )
905,88,75,13,2013,1045,0.85,85,High Digitalization,High Course ( >40H )
906,7,3,4,2013,1045,0.47,47,Medium-Low Digitalization,Small Course ( <15H )
907,43,31,12,2013,1045,0.72,72,Medium-High Digitalization,High Course ( >40H )
908,57,51,6,2013,1045,0.9,90,High Digitalization,High Course ( >40H )
909,10,7,3,2013,1045,0.73,73,Medium-High Digitalization,Small Course ( <15H )
910,68,5,63,2013,1045,0.08,8,Low Digitalization,High Course ( >40H )
911,59,14,45,2013,1045,0.24,24,Medium-Low Digitalization,High Course ( >40H )
912,51,32,19,2013,1045,0.62,62,Medium-High Digitalization,High Course ( >40H )
913,68,65,3,2013,1045,0.95,95,High Digitalization,High Course ( >40H )
914,12,11,1,2013,1045,0.91,91,High Digitalization,Small Course ( <15H )
915,86,27,59,2013,1045,0.31,31,Medium-Low Digitalization,High Course ( >40H )
916,34,33,1,2013,1045,0.96,96,High Digitalization,Medium Course ( >15H and <40H )
917,27,4,23,2013,1045,0.13,13,Low Digitalization,Medium Course ( >15H and <40H )
918,43,43,0,2013,1045,0.99,99,High Digitalization,High Course ( >40H )
919,15,7,8,2013,1045,0.45,45,Medium-Low Digitalization,Small Course ( <15H )
920,11,2,9,2013,1045,0.19,19,Low Digitalization,Small Course ( <15H )
921,39,21,18,2013,1045,0.53,53,Medium-High Digitalization,Medium Course ( >15H and <40H )
922,50,13,37,2013,1045,0.26,26,Medium-Low Digitalization,High Course ( >40H )
923,8,4,4,2013,1045,0.46,46,Medium-Low Digitalization,Small Course ( <15H )
924,15,1,14,2013,1045,0.08,8,Low Digitalization,Small Course ( <15H )
925,8,6,2,2013,1045,0.78,78,Medium-High Digitalization,Small Course ( <15H )
926,11,6,5,2013,1045,0.59,59,Medium-High Digitalization,Small Course ( <15H )
927,15,11,4,2013,1045,0.73,73,Medium-High Digitalization,Small Course ( <15H )
928,75,14,61,2013,1045,0.19,19,Low Digitalization,High Course ( >40H )
929,51,26,25,2013,1045,0.51,51,Medium-High Digitalization,High Course ( >40H )
930,63,23,40,2013,1045,0.37,37,Medium-Low Digitalization,High Course ( >40H )
931,84,51,33,2013,1045,0.61,61,Medium-High Digitalization,High Course ( >40H )
932,19,15,4,2013,1045,0.81,81,High Digitalization,Medium Course ( >15H and <40H )
933,9,6,3,2013,1045,0.72,72,Medium-High Digitalization,Small Course ( <15H )
934,5,0,5,2013,1045,0.09,9,Low Digitalization,Small Course ( <15H )
935,72,2,70,2013,1045,0.03,3,Low Digitalization,High Course ( >40H )
936,71,16,55,2013,1045,0.22,22,Medium-Low Digitalization,High Course ( >40H )
937,66,7,59,2013,1045,0.1,10,Low Digitalization,High Course ( >40H )
938,40,4,36,2013,1045,0.09,9,Low Digitalization,High Course ( >40H )
939,24,5,19,2013,1045,0.21,21,Medium-Low Digitalization,Medium Course ( >15H and <40H )
940,9,7,2,2013,1045,0.79,79,Medium-High Digitalization,Small Course ( <15H )
941,14,4,10,2013,1045,0.28,28,Medium-Low Digitalization,Small Course ( <15H )
942,25,7,18,2013,1045,0.28,28,Medium-Low Digitalization,Medium Course ( >15H and <40H )
943,6,2,4,2013,1045,0.31,31,Medium-Low Digitalization,Small Course ( <15H )
944,58,16,42,2013,1045,0.27,27,Medium-Low Digitalization,High Course ( >40H )
945,70,36,34,2013,1045,0.51,51,Medium-High Digitalization,High Course ( >40H )
946,45,20,25,2013,1045,0.45,45,Medium-Low Digitalization,High Course ( >40H )
947,50,7,43,2013,1045,0.14,14,Low Digitalization,High Course ( >40H )
948,38,28,10,2013,1045,0.74,74,Medium-High Digitalization,Medium Course ( >15H and <40H )
949,41,26,15,2013,1045,0.63,63,Medium-High Digitalization,High Course ( >40H )
950,52,17,35,2013,1045,0.32,32,Medium-Low Digitalization,High Course ( >40H )
951,16,12,4,2013,1045,0.77,77,Medium-High Digitalization,Medium Course ( >15H and <40H )
952,21,5,16,2013,1045,0.24,24,Medium-Low Digitalization,Medium Course ( >15H and <40H )
953,11,8,3,2013,1045,0.71,71,Medium-High Digitalization,Small Course ( <15H )
954,9,1,8,2013,1045,0.1,10,Low Digitalization,Small Course ( <15H )
955,15,14,1,2013,1045,0.92,92,High Digitalization,Small Course ( <15H )
956,57,34,23,2013,1045,0.59,59,Medium-High Digitalization,High Course ( >40H )
957,15,11,4,2013,1045,0.75,75,Medium-High Digitalization,Small Course ( <15H )
958,49,27,22,2013,1045,0.55,55,Medium-High Digitalization,High Course ( >40H )
959,57,19,38,2013,1045,0.34,34,Medium-Low Digitalization,High Course ( >40H )
960,45,17,28,2013,1045,0.37,37,Medium-Low Digitalization,High Course ( >40H )
961,69,1,68,2013,1045,0.01,1,Low Digitalization,High Course ( >40H )
962,31,21,10,2013,1045,0.69,69,Medium-High Digitalization,Medium Course ( >15H and <40H )
963,13,1,12,2013,1045,0.08,8,Low Digitalization,Small Course ( <15H )
964,6,6,0,2013,1045,0.94,94,High Digitalization,Small Course ( <15H )
965,6,4,2,2013,1045,0.66,66,Medium-High Digitalization,Small Course ( <15H )
966,5,1,4,2013,1045,0.2,20,Low Digitalization,Small Course ( <15H )
967,7,6,1,2013,1045,0.79,79,Medium-High Digitalization,Small Course ( <15H )
968,42,11,31,2013,1045,0.27,27,Medium-Low Digitalization,High Course ( >40H )
969,13,11,2,2013,1045,0.88,88,High Digitalization,Small Course ( <15H )
970,41,2,39,2013,1045,0.06,6,Low Digitalization,High Course ( >40H )
971,59,17,42,2013,1045,0.29,28,Medium-Low Digitalization,High Course ( >40H )
972,38,32,6,2013,1045,0.85,85,High Digitalization,Medium Course ( >15H and <40H )
973,90,17,73,2013,1045,0.19,19,Low Digitalization,High Course ( >40H )
974,15,4,11,2013,1045,0.27,27,Medium-Low Digitalization,Small Course ( <15H )
975,22,18,4,2013,1045,0.82,82,High Digitalization,Medium Course ( >15H and <40H )
976,29,13,16,2013,1045,0.45,45,Medium-Low Digitalization,Medium Course ( >15H and <40H )
977,67,38,29,2013,1045,0.56,56,Medium-High Digitalization,High Course ( >40H )
978,88,33,55,2013,1045,0.37,37,Medium-Low Digitalization,High Course ( >40H )
979,49,23,26,2013,1045,0.47,47,Medium-Low Digitalization,High Course ( >40H )
980,87,20,67,2013,1045,0.23,23,Medium-Low Digitalization,High Course ( >40H )
981,72,63,9,2013,1045,0.87,87,High Digitalization,High Course ( >40H )
982,86,45,41,2013,1045,0.52,52,Medium-High Digitalization,High Course ( >40H )
983,5,4,1,2013,1045,0.75,75,Medium-High Digitalization,Small Course ( <15H )
984,37,25,12,2013,1045,0.68,68,Medium-High Digitalization,Medium Course ( >15H and <40H )
985,16,13,3,2013,1045,0.81,81,High Digitalization,Medium Course ( >15H and <40H )
986,31,12,19,2013,1045,0.39,39,Medium-Low Digitalization,Medium Course ( >15H and <40H )
987,7,6,1,2013,1045,0.88,88,High Digitalization,Small Course ( <15H )
988,11,2,9,2013,1045,0.2,20,Low Digitalization,Small Course ( <15H )
989,38,38,0,2013,1045,1.0,100,High Digitalization,Medium Course ( >15H and <40H )
990,27,18,9,2013,1045,0.65,65,Medium-High Digitalization,Medium Course ( >15H and <40H )
991,39,34,5,2013,1045,0.88,88,High Digitalization,Medium Course ( >15H and <40H )
992,54,37,17,2013,1045,0.69,69,Medium-High Digitalization,High Course ( >40H )
993,9,2,7,2013,1045,0.18,18,Low Digitalization,Small Course ( <15H )
994,45,44,1,2013,1045,0.98,98,High Digitalization,High Course ( >40H )
995,53,3,50,2013,1045,0.06,6,Low Digitalization,High Course ( >40H )
996,48,8,40,2013,1045,0.17,17,Low Digitalization,High Course ( >40H )
997,25,24,1,2013,1045,0.95,95,High Digitalization,Medium Course ( >15H and <40H )
998,14,6,8,2013,1045,0.4,40,Medium-Low Digitalization,Small Course ( <15H )
999,47,37,10,2013,1045,0.79,79,Medium-High Digitalization,High Course ( >40H )
1000,46,33,13,2013,1045,0.72,72,Medium-High Digitalization,High Course ( >40H )
1001,53,7,46,2013,1045,0.14,14,Low Digitalization,High Course ( >40H )
1002,76,31,45,2013,1045,0.41,41,Medium-Low Digitalization,High Course ( >40H )
1003,9,6,3,2013,1045,0.68,68,Medium-High Digitalization,Small Course ( <15H )
1004,28,23,5,2013,1045,0.83,83,High Digitalization,Medium Course ( >15H and <40H )
1005,42,40,2,2013,1045,0.95,95,High Digitalization,High Course ( >40H )
1006,54,1,53,2013,1045,0.01,1,Low Digitalization,High Course ( >40H )
1007,63,3,60,2013,1045,0.05,5,Low Digitalization,High Course ( >40H )
1008,9,5,4,2013,1045,0.59,59,Medium-High Digitalization,Small Course ( <15H )
1009,54,31,23,2013,1045,0.57,56,Medium-High Digitalization,High Course ( >40H )
1010,57,38,19,2013,1045,0.67,67,Medium-High Digitalization,High Course ( >40H )
1011,14,0,14,2013,1045,0.02,2,Low Digitalization,Small Course ( <15H )
1012,15,1,14,2013,1045,0.09,9,Low Digitalization,Small Course ( <15H )
1013,9,7,2,2013,1045,0.75,75,Medium-High Digitalization,Small Course ( <15H )
1014,5,0,5,2013,1045,0.06,6,Low Digitalization,Small Course ( <15H )
1015,20,10,10,2013,1045,0.49,49,Medium-Low Digitalization,Medium Course ( >15H and <40H )
1016,43,39,4,2013,1045,0.91,91,High Digitalization,High Course ( >40H )
1017,78,23,55,2013,1045,0.29,28,Medium-Low Digitalization,High Course ( >40H )
1018,32,12,20,2013,1045,0.37,37,Medium-Low Digitalization,Medium Course ( >15H and <40H )
1019,27,24,3,2013,1045,0.9,90,High Digitalization,Medium Course ( >15H and <40H )
1020,55,40,15,2013,1045,0.73,73,Medium-High Digitalization,High Course ( >40H )
1021,10,9,1,2013,1045,0.92,92,High Digitalization,Small Course ( <15H )
1022,6,2,4,2013,1045,0.4,40,Medium-Low Digitalization,Small Course ( <15H )
1023,32,19,13,2013,1045,0.59,59,Medium-High Digitalization,Medium Course ( >15H and <40H )
1024,10,3,7,2013,1045,0.3,30,Medium-Low Digitalization,Small Course ( <15H )
1025,90,31,58,2013,1045,0.35,35,Medium-Low Digitalization,High Course ( >40H )
1026,7,1,6,2013,1045,0.19,19,Low Digitalization,Small Course ( <15H )
1027,84,13,71,2013,1045,0.15,15,Low Digitalization,High Course ( >40H )
1028,51,44,7,2013,1045,0.87,87,High Digitalization,High Course ( >40H )
1029,51,17,34,2013,1045,0.34,34,Medium-Low Digitalization,High Course ( >40H )
1030,11,2,9,2013,1045,0.19,19,Low Digitalization,Small Course ( <15H )
1031,8,5,3,2013,1045,0.61,61,Medium-High Digitalization,Small Course ( <15H )
1032,7,2,5,2013,1045,0.27,27,Medium-Low Digitalization,Small Course ( <15H )
1033,10,8,2,2013,1045,0.8,80,Medium-High Digitalization,Small Course ( <15H )
1034,8,2,6,2013,1045,0.19,19,Low Digitalization,Small Course ( <15H )
1035,31,23,8,2013,1045,0.73,73,Medium-High Digitalization,Medium Course ( >15H and <40H )
1036,13,2,11,2013,1045,0.13,13,Low Digitalization,Small Course ( <15H )
1037,42,34,8,2013,1045,0.81,81,High Digitalization,High Course ( >40H )
1038,43,28,15,2013,1045,0.66,66,Medium-High Digitalization,High Course ( >40H )
1039,6,1,5,2013,1045,0.18,18,Low Digitalization,Small Course ( <15H )
1040,14,9,5,2013,1045,0.67,67,Medium-High Digitalization,Small Course ( <15H )
1041,78,62,16,2013,1045,0.79,79,Medium-High Digitalization,High Course ( >40H )
1042,10,7,3,2013,1045,0.73,73,Medium-High Digitalization,Small Course ( <15H )
1043,20,12,8,2013,1045,0.62,62,Medium-High Digitalization,Medium Course ( >15H and <40H )
1044,11,9,2,2013,1045,0.84,84,High Digitalization,Small Course ( <15H )
1045,29,17,12,2013,1045,0.6,60,Medium-High Digitalization,Medium Course ( >15H and <40H )
1046,63,56,7,2014,1042,0.89,89,High Digitalization,High Course ( >40H )
1047,5,3,2,2014,1042,0.66,66,Medium-High Digitalization,Small Course ( <15H )
1048,81,48,33,2014,1042,0.59,59,Medium-High Digitalization,High Course ( >40H )
1049,79,73,6,2014,1042,0.93,93,High Digitalization,High Course ( >40H )
1050,81,36,45,2014,1042,0.45,45,Medium-Low Digitalization,High Course ( >40H )
1051,48,3,45,2014,1042,0.07,7,Low Digitalization,High Course ( >40H )
1052,13,10,3,2014,1042,0.77,77,Medium-High Digitalization,Small Course ( <15H )
1053,35,29,6,2014,1042,0.82,82,High Digitalization,Medium Course ( >15H and <40H )
1054,21,10,11,2014,1042,0.48,48,Medium-Low Digitalization,Medium Course ( >15H and <40H )
1055,40,6,34,2014,1042,0.15,15,Low Digitalization,High Course ( >40H )
1056,23,16,7,2014,1042,0.71,71,Medium-High Digitalization,Medium Course ( >15H and <40H )
1057,86,46,40,2014,1042,0.53,53,Medium-High Digitalization,High Course ( >40H )
1058,65,32,33,2014,1042,0.49,49,Medium-Low Digitalization,High Course ( >40H )
1059,69,40,29,2014,1042,0.58,57,Medium-High Digitalization,High Course ( >40H )
1060,24,24,0,2014,1042,0.98,98,High Digitalization,Medium Course ( >15H and <40H )
1061,14,8,6,2014,1042,0.56,56,Medium-High Digitalization,Small Course ( <15H )
1062,28,11,17,2014,1042,0.38,38,Medium-Low Digitalization,Medium Course ( >15H and <40H )
1063,64,49,15,2014,1042,0.76,76,Medium-High Digitalization,High Course ( >40H )
1064,80,20,60,2014,1042,0.25,25,Medium-Low Digitalization,High Course ( >40H )
1065,78,41,37,2014,1042,0.52,52,Medium-High Digitalization,High Course ( >40H )
1066,7,4,3,2014,1042,0.64,64,Medium-High Digitalization,Small Course ( <15H )
1067,84,70,14,2014,1042,0.83,83,High Digitalization,High Course ( >40H )
1068,44,40,4,2014,1042,0.9,90,High Digitalization,High Course ( >40H )
1069,37,8,29,2014,1042,0.21,21,Medium-Low Digitalization,Medium Course ( >15H and <40H )
1070,40,30,10,2014,1042,0.74,74,Medium-High Digitalization,High Course ( >40H )
1071,89,84,5,2014,1042,0.94,94,High Digitalization,High Course ( >40H )
1072,39,0,39,2014,1042,0.01,1,Low Digitalization,Medium Course ( >15H and <40H )
1073,50,30,20,2014,1042,0.59,59,Medium-High Digitalization,High Course ( >40H )
1074,40,10,30,2014,1042,0.26,26,Medium-Low Digitalization,High Course ( >40H )
1075,10,7,3,2014,1042,0.73,73,Medium-High Digitalization,Small Course ( <15H )
1076,38,14,24,2014,1042,0.37,37,Medium-Low Digitalization,Medium Course ( >15H and <40H )
1077,25,12,13,2014,1042,0.48,48,Medium-Low Digitalization,Medium Course ( >15H and <40H )
1078,80,18,62,2014,1042,0.23,23,Medium-Low Digitalization,High Course ( >40H )
1079,22,18,4,2014,1042,0.81,81,High Digitalization,Medium Course ( >15H and <40H )
1080,21,8,13,2014,1042,0.37,37,Medium-Low Digitalization,Medium Course ( >15H and <40H )
1081,35,31,4,2014,1042,0.89,89,High Digitalization,Medium Course ( >15H and <40H )
1082,14,3,11,2014,1042,0.23,23,Medium-Low Digitalization,Small Course ( <15H )
1083,12,2,10,2014,1042,0.15,15,Low Digitalization,Small Course ( <15H )
1084,66,10,56,2014,1042,0.15,15,Low Digitalization,High Course ( >40H )
1085,81,57,24,2014,1042,0.7,70,Medium-High Digitalization,High Course ( >40H )
1086,86,25,61,2014,1042,0.29,28,Medium-Low Digitalization,High Course ( >40H )
1087,63,59,4,2014,1042,0.93,93,High Digitalization,High Course ( >40H )
1088,29,10,19,2014,1042,0.35,35,Medium-Low Digitalization,Medium Course ( >15H and <40H )
1089,6,4,2,2014,1042,0.6,60,Medium-High Digitalization,Small Course ( <15H )
1090,12,0,12,2014,1042,0.04,4,Low Digitalization,Small Course ( <15H )
1091,46,11,35,2014,1042,0.23,23,Medium-Low Digitalization,High Course ( >40H )
1092,17,12,5,2014,1042,0.73,73,Medium-High Digitalization,Medium Course ( >15H and <40H )
1093,54,18,36,2014,1042,0.33,33,Medium-Low Digitalization,High Course ( >40H )
1094,29,17,12,2014,1042,0.6,60,Medium-High Digitalization,Medium Course ( >15H and <40H )
1095,15,10,4,2014,1042,0.7,70,Medium-High Digitalization,Small Course ( <15H )
1096,49,2,47,2014,1042,0.04,4,Low Digitalization,High Course ( >40H )
1097,59,22,37,2014,1042,0.38,38,Medium-Low Digitalization,High Course ( >40H )
1098,10,2,8,2014,1042,0.15,15,Low Digitalization,Small Course ( <15H )
1099,26,6,20,2014,1042,0.24,24,Medium-Low Digitalization,Medium Course ( >15H and <40H )
1100,26,25,1,2014,1042,0.95,95,High Digitalization,Medium Course ( >15H and <40H )
1101,17,14,3,2014,1042,0.81,81,High Digitalization,Medium Course ( >15H and <40H )
1102,28,24,4,2014,1042,0.85,85,High Digitalization,Medium Course ( >15H and <40H )
1103,73,44,29,2014,1042,0.6,60,Medium-High Digitalization,High Course ( >40H )
1104,26,21,5,2014,1042,0.8,80,Medium-High Digitalization,Medium Course ( >15H and <40H )
1105,13,8,5,2014,1042,0.62,62,Medium-High Digitalization,Small Course ( <15H )
1106,8,3,5,2014,1042,0.39,39,Medium-Low Digitalization,Small Course ( <15H )
1107,34,34,0,2014,1042,1.0,100,High Digitalization,Medium Course ( >15H and <40H )
1108,11,10,1,2014,1042,0.87,87,High Digitalization,Small Course ( <15H )
1109,60,21,39,2014,1042,0.35,35,Medium-Low Digitalization,High Course ( >40H )
1110,41,34,7,2014,1042,0.83,83,High Digitalization,High Course ( >40H )
1111,61,54,7,2014,1042,0.88,88,High Digitalization,High Course ( >40H )
1112,6,1,5,2014,1042,0.13,13,Low Digitalization,Small Course ( <15H )
1113,56,29,27,2014,1042,0.52,52,Medium-High Digitalization,High Course ( >40H )
1114,73,44,29,2014,1042,0.6,60,Medium-High Digitalization,High Course ( >40H )
1115,11,7,4,2014,1042,0.61,61,Medium-High Digitalization,Small Course ( <15H )
1116,76,45,31,2014,1042,0.59,59,Medium-High Digitalization,High Course ( >40H )
1117,46,2,44,2014,1042,0.05,5,Low Digitalization,High Course ( >40H )
1118,41,32,9,2014,1042,0.77,77,Medium-High Digitalization,High Course ( >40H )
1119,43,39,4,2014,1042,0.9,90,High Digitalization,High Course ( >40H )
1120,35,12,23,2014,1042,0.35,35,Medium-Low Digitalization,Medium Course ( >15H and <40H )
1121,15,1,14,2014,1042,0.04,4,Low Digitalization,Small Course ( <15H )
1122,36,26,10,2014,1042,0.72,72,Medium-High Digitalization,Medium Course ( >15H and <40H )
1123,42,14,28,2014,1042,0.34,34,Medium-Low Digitalization,High Course ( >40H )
1124,32,30,2,2014,1042,0.94,94,High Digitalization,Medium Course ( >15H and <40H )
1125,54,7,47,2014,1042,0.13,13,Low Digitalization,High Course ( >40H )
1126,5,4,1,2014,1042,0.75,75,Medium-High Digitalization,Small Course ( <15H )
1127,58,56,2,2014,1042,0.96,96,High Digitalization,High Course ( >40H )
1128,85,23,62,2014,1042,0.27,27,Medium-Low Digitalization,High Course ( >40H )
1129,45,37,8,2014,1042,0.83,83,High Digitalization,High Course ( >40H )
1130,29,11,18,2014,1042,0.37,37,Medium-Low Digitalization,Medium Course ( >15H and <40H )
1131,34,9,25,2014,1042,0.26,26,Medium-Low Digitalization,Medium Course ( >15H and <40H )
1132,24,4,20,2014,1042,0.17,17,Low Digitalization,Medium Course ( >15H and <40H )
1133,37,16,21,2014,1042,0.42,42,Medium-Low Digitalization,Medium Course ( >15H and <40H )
1134,18,11,7,2014,1042,0.59,59,Medium-High Digitalization,Medium Course ( >15H and <40H )
1135,5,2,3,2014,1042,0.42,42,Medium-Low Digitalization,Small Course ( <15H )
1136,43,35,8,2014,1042,0.81,81,High Digitalization,High Course ( >40H )
1137,32,31,1,2014,1042,0.97,97,High Digitalization,Medium Course ( >15H and <40H )
1138,52,15,37,2014,1042,0.28,28,Medium-Low Digitalization,High Course ( >40H )
1139,66,3,63,2014,1042,0.04,4,Low Digitalization,High Course ( >40H )
1140,18,2,16,2014,1042,0.1,10,Low Digitalization,Medium Course ( >15H and <40H )
1141,12,10,2,2014,1042,0.8,80,Medium-High Digitalization,Small Course ( <15H )
1142,8,7,1,2014,1042,0.85,85,High Digitalization,Small Course ( <15H )
1143,27,10,17,2014,1042,0.36,36,Medium-Low Digitalization,Medium Course ( >15H and <40H )
1144,33,24,9,2014,1042,0.74,74,Medium-High Digitalization,Medium Course ( >15H and <40H )
1145,15,4,11,2014,1042,0.29,28,Medium-Low Digitalization,Small Course ( <15H )
1146,27,22,5,2014,1042,0.83,83,High Digitalization,Medium Course ( >15H and <40H )
1147,6,4,2,2014,1042,0.69,69,Medium-High Digitalization,Small Course ( <15H )
1148,33,4,29,2014,1042,0.11,11,Low Digitalization,Medium Course ( >15H and <40H )
1149,15,9,6,2014,1042,0.61,61,Medium-High Digitalization,Small Course ( <15H )
1150,83,46,37,2014,1042,0.56,56,Medium-High Digitalization,High Course ( >40H )
1151,6,5,1,2014,1042,0.83,83,High Digitalization,Small Course ( <15H )
1152,14,8,6,2014,1042,0.57,56,Medium-High Digitalization,Small Course ( <15H )
1153,11,9,2,2014,1042,0.81,81,High Digitalization,Small Course ( <15H )
1154,48,21,27,2014,1042,0.44,44,Medium-Low Digitalization,High Course ( >40H )
1155,88,55,33,2014,1042,0.62,62,Medium-High Digitalization,High Course ( >40H )
1156,15,6,9,2014,1042,0.39,39,Medium-Low Digitalization,Small Course ( <15H )
1157,15,13,2,2014,1042,0.85,85,High Digitalization,Small Course ( <15H )
1158,30,14,16,2014,1042,0.47,47,Medium-Low Digitalization,Medium Course ( >15H and <40H )
1159,58,2,56,2014,1042,0.04,4,Low Digitalization,High Course ( >40H )
1160,28,19,9,2014,1042,0.68,68,Medium-High Digitalization,Medium Course ( >15H and <40H )
1161,53,12,41,2014,1042,0.23,23,Medium-Low Digitalization,High Course ( >40H )
1162,87,23,64,2014,1042,0.26,26,Medium-Low Digitalization,High Course ( >40H )
1163,16,11,5,2014,1042,0.66,66,Medium-High Digitalization,Medium Course ( >15H and <40H )
1164,13,4,9,2014,1042,0.33,33,Medium-Low Digitalization,Small Course ( <15H )
1165,33,21,12,2014,1042,0.63,63,Medium-High Digitalization,Medium Course ( >15H and <40H )
1166,30,3,27,2014,1042,0.09,9,Low Digitalization,Medium Course ( >15H and <40H )
1167,55,1,54,2014,1042,0.01,1,Low Digitalization,High Course ( >40H )
1168,43,35,8,2014,1042,0.81,81,High Digitalization,High Course ( >40H )
1169,16,7,9,2014,1042,0.41,41,Medium-Low Digitalization,Medium Course ( >15H and <40H )
1170,56,56,0,2014,1042,1.0,100,High Digitalization,High Course ( >40H )
1171,8,2,6,2014,1042,0.28,28,Medium-Low Digitalization,Small Course ( <15H )
1172,53,22,31,2014,1042,0.42,42,Medium-Low Digitalization,High Course ( >40H )
1173,37,37,0,2014,1042,0.99,99,High Digitalization,Medium Course ( >15H and <40H )
1174,89,29,60,2014,1042,0.33,33,Medium-Low Digitalization,High Course ( >40H )
1175,17,6,11,2014,1042,0.34,34,Medium-Low Digitalization,Medium Course ( >15H and <40H )
1176,51,10,41,2014,1042,0.19,19,Low Digitalization,High Course ( >40H )
1177,54,19,35,2014,1042,0.36,36,Medium-Low Digitalization,High Course ( >40H )
1178,6,6,0,2014,1042,0.98,98,High Digitalization,Small Course ( <15H )
1179,13,10,3,2014,1042,0.77,77,Medium-High Digitalization,Small Course ( <15H )
1180,87,27,60,2014,1042,0.31,31,Medium-Low Digitalization,High Course ( >40H )
1181,13,1,12,2014,1042,0.09,9,Low Digitalization,Small Course ( <15H )
1182,75,7,68,2014,1042,0.09,9,Low Digitalization,High Course ( >40H )
1183,30,24,6,2014,1042,0.81,81,High Digitalization,Medium Course ( >15H and <40H )
1184,8,1,7,2014,1042,0.12,12,Low Digitalization,Small Course ( <15H )
1185,34,29,5,2014,1042,0.84,84,High Digitalization,Medium Course ( >15H and <40H )
1186,53,5,48,2014,1042,0.09,9,Low Digitalization,High Course ( >40H )
1187,25,8,17,2014,1042,0.33,33,Medium-Low Digitalization,Medium Course ( >15H and <40H )
1188,61,24,37,2014,1042,0.39,39,Medium-Low Digitalization,High Course ( >40H )
1189,90,37,53,2014,1042,0.41,41,Medium-Low Digitalization,High Course ( >40H )
1190,5,2,3,2014,1042,0.48,48,Medium-Low Digitalization,Small Course ( <15H )
1191,51,18,33,2014,1042,0.35,35,Medium-Low Digitalization,High Course ( >40H )
1192,73,5,68,2014,1042,0.07,7,Low Digitalization,High Course ( >40H )
1193,8,6,2,2014,1042,0.75,75,Medium-High Digitalization,Small Course ( <15H )
1194,11,4,7,2014,1042,0.38,38,Medium-Low Digitalization,Small Course ( <15H )
1195,5,1,4,2014,1042,0.23,23,Medium-Low Digitalization,Small Course ( <15H )
1196,16,10,6,2014,1042,0.64,64,Medium-High Digitalization,Medium Course ( >15H and <40H )
1197,63,6,57,2014,1042,0.09,9,Low Digitalization,High Course ( >40H )
1198,5,2,3,2014,1042,0.4,40,Medium-Low Digitalization,Small Course ( <15H )
1199,15,1,14,2014,1042,0.05,5,Low Digitalization,Small Course ( <15H )
1200,17,9,8,2014,1042,0.52,52,Medium-High Digitalization,Medium Course ( >15H and <40H )
1201,60,34,26,2014,1042,0.57,56,Medium-High Digitalization,High Course ( >40H )
1202,10,7,3,2014,1042,0.7,70,Medium-High Digitalization,Small Course ( <15H )
1203,10,6,4,2014,1042,0.58,57,Medium-High Digitalization,Small Course ( <15H )
1204,24,5,19,2014,1042,0.19,19,Low Digitalization,Medium Course ( >15H and <40H )
1205,15,11,4,2014,1042,0.75,75,Medium-High Digitalization,Small Course ( <15H )
1206,59,51,8,2014,1042,0.87,87,High Digitalization,High Course ( >40H )
1207,5,0,5,2014,1042,0.08,8,Low Digitalization,Small Course ( <15H )
1208,30,16,14,2014,1042,0.53,53,Medium-High Digitalization,Medium Course ( >15H and <40H )
1209,36,18,18,2014,1042,0.49,49,Medium-Low Digitalization,Medium Course ( >15H and <40H )
1210,90,21,69,2014,1042,0.23,23,Medium-Low Digitalization,High Course ( >40H )
1211,5,4,1,2014,1042,0.81,81,High Digitalization,Small Course ( <15H )
1212,67,42,25,2014,1042,0.63,63,Medium-High Digitalization,High Course ( >40H )
1213,15,3,12,2014,1042,0.23,23,Medium-Low Digitalization,Small Course ( <15H )
1214,30,16,14,2014,1042,0.52,52,Medium-High Digitalization,Medium Course ( >15H and <40H )
1215,22,6,16,2014,1042,0.27,27,Medium-Low Digitalization,Medium Course ( >15H and <40H )
1216,16,4,12,2014,1042,0.28,28,Medium-Low Digitalization,Medium Course ( >15H and <40H )
1217,47,43,4,2014,1042,0.92,92,High Digitalization,High Course ( >40H )
1218,14,12,2,2014,1042,0.84,84,High Digitalization,Small Course ( <15H )
1219,60,28,32,2014,1042,0.46,46,Medium-Low Digitalization,High Course ( >40H )
1220,20,10,10,2014,1042,0.49,49,Medium-Low Digitalization,Medium Course ( >15H and <40H )
1221,38,35,3,2014,1042,0.91,91,High Digitalization,Medium Course ( >15H and <40H )
1222,86,2,84,2014,1042,0.02,2,Low Digitalization,High Course ( >40H )
1223,39,4,35,2014,1042,0.09,9,Low Digitalization,Medium Course ( >15H and <40H )
1224,31,1,30,2014,1042,0.03,3,Low Digitalization,Medium Course ( >15H and <40H )
1225,84,45,39,2014,1042,0.54,54,Medium-High Digitalization,High Course ( >40H )
1226,14,4,10,2014,1042,0.3,30,Medium-Low Digitalization,Small Course ( <15H )
1227,32,11,21,2014,1042,0.34,34,Medium-Low Digitalization,Medium Course ( >15H and <40H )
1228,89,76,13,2014,1042,0.85,85,High Digitalization,High Course ( >40H )
1229,21,19,2,2014,1042,0.91,91,High Digitalization,Medium Course ( >15H and <40H )
1230,13,13,0,2014,1042,0.99,99,High Digitalization,Small Course ( <15H )
1231,15,9,6,2014,1042,0.58,57,Medium-High Digitalization,Small Course ( <15H )
1232,53,17,36,2014,1042,0.32,32,Medium-Low Digitalization,High Course ( >40H )
1233,10,7,3,2014,1042,0.66,66,Medium-High Digitalization,Small Course ( <15H )
1234,44,12,32,2014,1042,0.28,28,Medium-Low Digitalization,High Course ( >40H )
1235,54,13,41,2014,1042,0.24,24,Medium-Low Digitalization,High Course ( >40H )
1236,67,21,46,2014,1042,0.31,31,Medium-Low Digitalization,High Course ( >40H )
1237,8,6,2,2014,1042,0.74,74,Medium-High Digitalization,Small Course ( <15H )
1238,34,21,13,2014,1042,0.61,61,Medium-High Digitalization,Medium Course ( >15H and <40H )
1239,5,2,3,2014,1042,0.38,38,Medium-Low Digitalization,Small Course ( <15H )
1240,5,3,2,2014,1042,0.68,68,Medium-High Digitalization,Small Course ( <15H )
1241,9,7,2,2014,1042,0.76,76,Medium-High Digitalization,Small Course ( <15H )
1242,81,28,53,2014,1042,0.34,34,Medium-Low Digitalization,High Course ( >40H )
1243,12,9,3,2014,1042,0.74,74,Medium-High Digitalization,Small Course ( <15H )
1244,27,25,2,2014,1042,0.93,93,High Digitalization,Medium Course ( >15H and <40H )
1245,10,1,9,2014,1042,0.06,6,Low Digitalization,Small Course ( <15H )
1246,80,30,50,2014,1042,0.37,37,Medium-Low Digitalization,High Course ( >40H )
1247,8,2,6,2014,1042,0.23,23,Medium-Low Digitalization,Small Course ( <15H )
1248,9,3,6,2014,1042,0.38,38,Medium-Low Digitalization,Small Course ( <15H )
1249,32,4,28,2014,1042,0.11,11,Low Digitalization,Medium Course ( >15H and <40H )
1250,39,7,32,2014,1042,0.19,19,Low Digitalization,Medium Course ( >15H and <40H )
1251,35,11,24,2014,1042,0.32,32,Medium-Low Digitalization,Medium Course ( >15H and <40H )
1252,58,4,54,2014,1042,0.07,7,Low Digitalization,High Course ( >40H )
1253,17,15,2,2014,1042,0.91,91,High Digitalization,Medium Course ( >15H and <40H )
1254,15,5,10,2014,1042,0.33,33,Medium-Low Digitalization,Small Course ( <15H )
1255,77,9,68,2014,1042,0.12,12,Low Digitalization,High Course ( >40H )
1256,51,12,39,2014,1042,0.24,24,Medium-Low Digitalization,High Course ( >40H )
1257,70,11,59,2014,1042,0.16,16,Low Digitalization,High Course ( >40H )
1258,10,8,2,2014,1042,0.75,75,Medium-High Digitalization,Small Course ( <15H )
1259,35,24,10,2014,1042,0.7,70,Medium-High Digitalization,Medium Course ( >15H and <40H )
1260,38,1,37,2014,1042,0.03,3,Low Digitalization,Medium Course ( >15H and <40H )
1261,58,49,9,2014,1042,0.85,85,High Digitalization,High Course ( >40H )
1262,52,18,34,2014,1042,0.34,34,Medium-Low Digitalization,High Course ( >40H )
1263,6,3,3,2014,1042,0.43,43,Medium-Low Digitalization,Small Course ( <15H )
1264,22,17,5,2014,1042,0.79,79,Medium-High Digitalization,Medium Course ( >15H and <40H )
1265,5,1,4,2014,1042,0.22,22,Medium-Low Digitalization,Small Course ( <15H )
1266,61,41,20,2014,1042,0.67,67,Medium-High Digitalization,High Course ( >40H )
1267,67,13,54,2014,1042,0.19,19,Low Digitalization,High Course ( >40H )
1268,27,2,25,2014,1042,0.09,9,Low Digitalization,Medium Course ( >15H and <40H )
1269,86,8,78,2014,1042,0.09,9,Low Digitalization,High Course ( >40H )
1270,58,53,5,2014,1042,0.92,92,High Digitalization,High Course ( >40H )
1271,5,5,0,2014,1042,0.99,99,High Digitalization,Small Course ( <15H )
1272,53,48,5,2014,1042,0.9,90,High Digitalization,High Course ( >40H )
1273,86,61,25,2014,1042,0.71,71,Medium-High Digitalization,High Course ( >40H )
1274,35,4,31,2014,1042,0.11,11,Low Digitalization,Medium Course ( >15H and <40H )
1275,50,3,47,2014,1042,0.06,6,Low Digitalization,High Course ( >40H )
1276,26,21,5,2014,1042,0.82,82,High Digitalization,Medium Course ( >15H and <40H )
1277,74,70,4,2014,1042,0.95,95,High Digitalization,High Course ( >40H )
1278,38,11,27,2014,1042,0.3,30,Medium-Low Digitalization,Medium Course ( >15H and <40H )
1279,70,49,21,2014,1042,0.7,70,Medium-High Digitalization,High Course ( >40H )
1280,50,34,16,2014,1042,0.69,69,Medium-High Digitalization,High Course ( >40H )
1281,25,5,20,2014,1042,0.2,20,Low Digitalization,Medium Course ( >15H and <40H )
1282,15,2,13,2014,1042,0.12,12,Low Digitalization,Small Course ( <15H )
1283,44,38,6,2014,1042,0.87,87,High Digitalization,High Course ( >40H )
1284,14,9,5,2014,1042,0.62,62,Medium-High Digitalization,Small Course ( <15H )
1285,35,29,6,2014,1042,0.83,83,High Digitalization,Medium Course ( >15H and <40H )
1286,20,5,15,2014,1042,0.26,26,Medium-Low Digitalization,Medium Course ( >15H and <40H )
1287,34,26,8,2014,1042,0.77,77,Medium-High Digitalization,Medium Course ( >15H and <40H )
1288,15,10,5,2014,1042,0.68,68,Medium-High Digitalization,Small Course ( <15H )
1289,9,8,1,2014,1042,0.93,93,High Digitalization,Small Course ( <15H )
1290,16,9,7,2014,1042,0.59,59,Medium-High Digitalization,Medium Course ( >15H and <40H )
1291,5,2,3,2014,1042,0.48,48,Medium-Low Digitalization,Small Course ( <15H )
1292,16,12,4,2014,1042,0.77,77,Medium-High Digitalization,Medium Course ( >15H and <40H )
1293,12,7,5,2014,1042,0.55,55,Medium-High Digitalization,Small Course ( <15H )
1294,14,8,6,2014,1042,0.58,57,Medium-High Digitalization,Small Course ( <15H )
1295,49,15,34,2014,1042,0.3,30,Medium-Low Digitalization,High Course ( >40H )
1296,83,48,35,2014,1042,0.58,57,Medium-High Digitalization,High Course ( >40H )
1297,57,26,31,2014,1042,0.45,45,Medium-Low Digitalization,High Course ( >40H )
1298,30,19,11,2014,1042,0.63,63,Medium-High Digitalization,Medium Course ( >15H and <40H )
1299,68,10,58,2014,1042,0.15,15,Low Digitalization,High Course ( >40H )
1300,53,30,23,2014,1042,0.57,56,Medium-High Digitalization,High Course ( >40H )
1301,51,40,11,2014,1042,0.78,78,Medium-High Digitalization,High Course ( >40H )
1302,11,9,2,2014,1042,0.79,79,Medium-High Digitalization,Small Course ( <15H )
1303,15,1,14,2014,1042,0.05,5,Low Digitalization,Small Course ( <15H )
1304,22,9,13,2014,1042,0.42,42,Medium-Low Digitalization,Medium Course ( >15H and <40H )
1305,89,45,44,2014,1042,0.51,51,Medium-High Digitalization,High Course ( >40H )
1306,7,4,3,2014,1042,0.63,63,Medium-High Digitalization,Small Course ( <15H )
1307,40,13,27,2014,1042,0.32,32,Medium-Low Digitalization,High Course ( >40H )
1308,18,18,0,2014,1042,0.99,99,High Digitalization,Medium Course ( >15H and <40H )
1309,16,10,6,2014,1042,0.65,65,Medium-High Digitalization,Medium Course ( >15H and <40H )
1310,15,4,11,2014,1042,0.24,24,Medium-Low Digitalization,Small Course ( <15H )
1311,49,26,23,2014,1042,0.54,54,Medium-High Digitalization,High Course ( >40H )
1312,75,15,60,2014,1042,0.2,20,Low Digitalization,High Course ( >40H )
1313,82,18,64,2014,1042,0.22,22,Medium-Low Digitalization,High Course ( >40H )
1314,54,14,40,2014,1042,0.25,25,Medium-Low Digitalization,High Course ( >40H )
1315,41,16,25,2014,1042,0.39,39,Medium-Low Digitalization,High Course ( >40H )
1316,72,45,27,2014,1042,0.62,62,Medium-High Digitalization,High Course ( >40H )
1317,22,3,19,2014,1042,0.13,13,Low Digitalization,Medium Course ( >15H and <40H )
1318,88,68,20,2014,1042,0.77,77,Medium-High Digitalization,High Course ( >40H )
1319,10,5,5,2014,1042,0.46,46,Medium-Low Digitalization,Small Course ( <15H )
1320,54,7,47,2014,1042,0.13,13,Low Digitalization,High Course ( >40H )
1321,79,8,71,2014,1042,0.1,10,Low Digitalization,High Course ( >40H )
1322,86,53,33,2014,1042,0.62,62,Medium-High Digitalization,High Course ( >40H )
1323,20,0,20,2014,1042,0.0,0,Low Digitalization,Medium Course ( >15H and <40H )
1324,9,7,2,2014,1042,0.78,78,Medium-High Digitalization,Small Course ( <15H )
1325,10,4,6,2014,1042,0.38,38,Medium-Low Digitalization,Small Course ( <15H )
1326,59,11,48,2014,1042,0.19,19,Low Digitalization,High Course ( >40H )
1327,5,2,3,2014,1042,0.42,42,Medium-Low Digitalization,Small Course ( <15H )
1328,60,50,10,2014,1042,0.84,84,High Digitalization,High Course ( >40H )
1329,41,40,1,2014,1042,0.97,97,High Digitalization,High Course ( >40H )
1330,6,2,4,2014,1042,0.35,35,Medium-Low Digitalization,Small Course ( <15H )
1331,90,58,32,2014,1042,0.64,64,Medium-High Digitalization,High Course ( >40H )
1332,15,13,2,2014,1042,0.89,89,High Digitalization,Small Course ( <15H )
1333,44,33,11,2014,1042,0.75,75,Medium-High Digitalization,High Course ( >40H )
1334,41,11,30,2014,1042,0.26,26,Medium-Low Digitalization,High Course ( >40H )
1335,56,22,34,2014,1042,0.4,40,Medium-Low Digitalization,High Course ( >40H )
1336,8,1,7,2014,1042,0.08,8,Low Digitalization,Small Course ( <15H )
1337,28,24,4,2014,1042,0.86,86,High Digitalization,Medium Course ( >15H and <40H )
1338,18,2,16,2014,1042,0.11,11,Low Digitalization,Medium Course ( >15H and <40H )
1339,12,7,5,2014,1042,0.62,62,Medium-High Digitalization,Small Course ( <15H )
1340,35,22,13,2014,1042,0.64,64,Medium-High Digitalization,Medium Course ( >15H and <40H )
1341,9,8,1,2014,1042,0.88,88,High Digitalization,Small Course ( <15H )
1342,12,11,1,2014,1042,0.91,91,High Digitalization,Small Course ( <15H )
1343,13,3,10,2014,1042,0.23,23,Medium-Low Digitalization,Small Course ( <15H )
1344,24,15,9,2014,1042,0.62,62,Medium-High Digitalization,Medium Course ( >15H and <40H )
1345,78,44,34,2014,1042,0.57,56,Medium-High Digitalization,High Course ( >40H )
1346,15,5,10,2014,1042,0.31,31,Medium-Low Digitalization,Small Course ( <15H )
1347,18,1,17,2014,1042,0.05,5,Low Digitalization,Medium Course ( >15H and <40H )
1348,57,46,11,2014,1042,0.81,81,High Digitalization,High Course ( >40H )
1349,21,0,21,2014,1042,0.01,1,Low Digitalization,Medium Course ( >15H and <40H )
1350,56,39,17,2014,1042,0.7,70,Medium-High Digitalization,High Course ( >40H )
1351,15,3,12,2014,1042,0.19,19,Low Digitalization,Small Course ( <15H )
1352,9,7,2,2014,1042,0.79,79,Medium-High Digitalization,Small Course ( <15H )
1353,45,7,38,2014,1042,0.16,16,Low Digitalization,High Course ( >40H )
1354,5,4,1,2014,1042,0.75,75,Medium-High Digitalization,Small Course ( <15H )
1355,8,2,6,2014,1042,0.31,31,Medium-Low Digitalization,Small Course ( <15H )
1356,9,4,5,2014,1042,0.4,40,Medium-Low Digitalization,Small Course ( <15H )
1357,32,11,21,2014,1042,0.33,33,Medium-Low Digitalization,Medium Course ( >15H and <40H )
1358,65,40,25,2014,1042,0.61,61,Medium-High Digitalization,High Course ( >40H )
1359,59,22,37,2014,1042,0.37,37,Medium-Low Digitalization,High Course ( >40H )
1360,15,0,15,2014,1042,0.03,3,Low Digitalization,Small Course ( <15H )
1361,14,6,8,2014,1042,0.43,43,Medium-Low Digitalization,Small Course ( <15H )
1362,9,6,3,2014,1042,0.62,62,Medium-High Digitalization,Small Course ( <15H )
1363,13,2,11,2014,1042,0.15,15,Low Digitalization,Small Course ( <15H )
1364,23,10,13,2014,1042,0.42,42,Medium-Low Digitalization,Medium Course ( >15H and <40H )
1365,9,6,3,2014,1042,0.71,71,Medium-High Digitalization,Small Course ( <15H )
1366,45,29,16,2014,1042,0.65,65,Medium-High Digitalization,High Course ( >40H )
1367,47,20,27,2014,1042,0.42,42,Medium-Low Digitalization,High Course ( >40H )
1368,22,0,22,2014,1042,0.0,0,Low Digitalization,Medium Course ( >15H and <40H )
1369,64,13,51,2014,1042,0.21,21,Medium-Low Digitalization,High Course ( >40H )
1370,5,3,2,2014,1042,0.65,65,Medium-High Digitalization,Small Course ( <15H )
1371,89,9,80,2014,1042,0.1,10,Low Digitalization,High Course ( >40H )
1372,66,54,12,2014,1042,0.82,82,High Digitalization,High Course ( >40H )
1373,41,19,22,2014,1042,0.46,46,Medium-Low Digitalization,High Course ( >40H )
1374,6,5,1,2014,1042,0.9,90,High Digitalization,Small Course ( <15H )
1375,9,3,6,2014,1042,0.37,37,Medium-Low Digitalization,Small Course ( <15H )
1376,50,12,38,2014,1042,0.23,23,Medium-Low Digitalization,High Course ( >40H )
1377,48,14,34,2014,1042,0.29,28,Medium-Low Digitalization,High Course ( >40H )
1378,74,16,58,2014,1042,0.21,21,Medium-Low Digitalization,High Course ( >40H )
1379,9,5,4,2014,1042,0.56,56,Medium-High Digitalization,Small Course ( <15H )
1380,44,3,41,2014,1042,0.06,6,Low Digitalization,High Course ( >40H )
1381,81,46,35,2014,1042,0.57,56,Medium-High Digitalization,High Course ( >40H )
1382,33,3,30,2014,1042,0.1,10,Low Digitalization,Medium Course ( >15H and <40H )
1383,82,36,46,2014,1042,0.44,44,Medium-Low Digitalization,High Course ( >40H )
1384,5,5,0,2014,1042,0.94,94,High Digitalization,Small Course ( <15H )
1385,23,3,20,2014,1042,0.12,12,Low Digitalization,Medium Course ( >15H and <40H )
1386,39,33,6,2014,1042,0.84,84,High Digitalization,Medium Course ( >15H and <40H )
1387,32,28,4,2014,1042,0.88,88,High Digitalization,Medium Course ( >15H and <40H )
1388,55,31,24,2014,1042,0.57,56,Medium-High Digitalization,High Course ( >40H )
1389,31,19,12,2014,1042,0.61,61,Medium-High Digitalization,Medium Course ( >15H and <40H )
1390,11,0,11,2014,1042,0.03,3,Low Digitalization,Small Course ( <15H )
1391,58,2,56,2014,1042,0.04,4,Low Digitalization,High Course ( >40H )
1392,43,9,34,2014,1042,0.22,22,Medium-Low Digitalization,High Course ( >40H )
1393,82,21,61,2014,1042,0.26,26,Medium-Low Digitalization,High Course ( >40H )
1394,12,7,5,2014,1042,0.6,60,Medium-High Digitalization,Small Course ( <15H )
1395,32,7,25,2014,1042,0.21,21,Medium-Low Digitalization,Medium Course ( >15H and <40H )
1396,63,6,57,2014,1042,0.1,10,Low Digitalization,High Course ( >40H )
1397,5,1,4,2014,1042,0.18,18,Low Digitalization,Small Course ( <15H )
1398,42,18,24,2014,1042,0.42,42,Medium-Low Digitalization,High Course ( >40H )
1399,18,2,16,2014,1042,0.11,11,Low Digitalization,Medium Course ( >15H and <40H )
1400,57,28,28,2014,1042,0.5,50,Medium-Low Digitalization,High Course ( >40H )
1401,54,19,35,2014,1042,0.35,35,Medium-Low Digitalization,High Course ( >40H )
1402,33,4,29,2014,1042,0.12,12,Low Digitalization,Medium Course ( >15H and <40H )
1403,71,45,26,2014,1042,0.63,63,Medium-High Digitalization,High Course ( >40H )
1404,60,22,38,2014,1042,0.36,36,Medium-Low Digitalization,High Course ( >40H )
1405,57,47,10,2014,1042,0.83,83,High Digitalization,High Course ( >40H )
1406,10,6,4,2014,1042,0.64,64,Medium-High Digitalization,Small Course ( <15H )
1407,16,16,0,2014,1042,0.97,97,High Digitalization,Medium Course ( >15H and <40H )
1408,45,27,18,2014,1042,0.6,60,Medium-High Digitalization,High Course ( >40H )
1409,9,9,0,2014,1042,0.97,97,High Digitalization,Small Course ( <15H )
1410,12,9,3,2014,1042,0.79,79,Medium-High Digitalization,Small Course ( <15H )
1411,23,18,5,2014,1042,0.8,80,Medium-High Digitalization,Medium Course ( >15H and <40H )
1412,49,48,1,2014,1042,0.98,98,High Digitalization,High Course ( >40H )
1413,11,6,5,2014,1042,0.51,51,Medium-High Digitalization,Small Course ( <15H )
1414,10,7,3,2014,1042,0.66,66,Medium-High Digitalization,Small Course ( <15H )
1415,66,31,35,2014,1042,0.47,47,Medium-Low Digitalization,High Course ( >40H )
1416,70,23,47,2014,1042,0.33,33,Medium-Low Digitalization,High Course ( >40H )
1417,6,4,2,2014,1042,0.63,63,Medium-High Digitalization,Small Course ( <15H )
1418,12,11,1,2014,1042,0.89,89,High Digitalization,Small Course ( <15H )
1419,45,8,37,2014,1042,0.18,18,Low Digitalization,High Course ( >40H )
1420,67,22,45,2014,1042,0.33,33,Medium-Low Digitalization,High Course ( >40H )
1421,15,4,11,2014,1042,0.25,25,Medium-Low Digitalization,Small Course ( <15H )
1422,90,54,36,2014,1042,0.6,60,Medium-High Digitalization,High Course ( >40H )
1423,38,13,25,2014,1042,0.33,33,Medium-Low Digitalization,Medium Course ( >15H and <40H )
1424,6,2,4,2014,1042,0.29,28,Medium-Low Digitalization,Small Course ( <15H )
1425,13,3,10,2014,1042,0.22,22,Medium-Low Digitalization,Small Course ( <15H )
1426,13,11,2,2014,1042,0.86,86,High Digitalization,Small Course ( <15H )
1427,86,16,70,2014,1042,0.19,19,Low Digitalization,High Course ( >40H )
1428,10,1,9,2014,1042,0.08,8,Low Digitalization,Small Course ( <15H )
1429,20,17,3,2014,1042,0.83,83,High Digitalization,Medium Course ( >15H and <40H )
1430,20,9,11,2014,1042,0.44,44,Medium-Low Digitalization,Medium Course ( >15H and <40H )
1431,80,48,32,2014,1042,0.6,60,Medium-High Digitalization,High Course ( >40H )
1432,64,62,2,2014,1042,0.97,97,High Digitalization,High Course ( >40H )
1433,10,6,4,2014,1042,0.63,63,Medium-High Digitalization,Small Course ( <15H )
1434,62,24,38,2014,1042,0.39,39,Medium-Low Digitalization,High Course ( >40H )
1435,54,46,8,2014,1042,0.86,86,High Digitalization,High Course ( >40H )
1436,27,10,17,2014,1042,0.36,36,Medium-Low Digitalization,Medium Course ( >15H and <40H )
1437,40,5,35,2014,1042,0.12,12,Low Digitalization,High Course ( >40H )
1438,28,23,5,2014,1042,0.83,83,High Digitalization,Medium Course ( >15H and <40H )
1439,81,8,73,2014,1042,0.1,10,Low Digitalization,High Course ( >40H )
1440,6,1,5,2014,1042,0.21,21,Medium-Low Digitalization,Small Course ( <15H )
1441,29,0,29,2014,1042,0.0,0,Low Digitalization,Medium Course ( >15H and <40H )
1442,74,54,20,2014,1042,0.73,73,Medium-High Digitalization,High Course ( >40H )
1443,15,14,2,2014,1042,0.9,90,High Digitalization,Small Course ( <15H )
1444,60,35,25,2014,1042,0.59,59,Medium-High Digitalization,High Course ( >40H )
1445,14,5,9,2014,1042,0.39,39,Medium-Low Digitalization,Small Course ( <15H )
1446,12,1,11,2014,1042,0.07,7,Low Digitalization,Small Course ( <15H )
1447,6,2,4,2014,1042,0.34,34,Medium-Low Digitalization,Small Course ( <15H )
1448,13,11,2,2014,1042,0.83,83,High Digitalization,Small Course ( <15H )
1449,58,46,12,2014,1042,0.8,80,Medium-High Digitalization,High Course ( >40H )
1450,11,2,9,2014,1042,0.2,20,Low Digitalization,Small Course ( <15H )
1451,15,8,8,2014,1042,0.5,50,Medium-Low Digitalization,Small Course ( <15H )
1452,13,7,6,2014,1042,0.51,51,Medium-High Digitalization,Small Course ( <15H )
1453,73,55,18,2014,1042,0.75,75,Medium-High Digitalization,High Course ( >40H )
1454,79,48,31,2014,1042,0.61,61,Medium-High Digitalization,High Course ( >40H )
1455,5,3,2,2014,1042,0.67,67,Medium-High Digitalization,Small Course ( <15H )
1456,9,9,0,2014,1042,0.95,95,High Digitalization,Small Course ( <15H )
1457,9,0,9,2014,1042,0.02,2,Low Digitalization,Small Course ( <15H )
1458,19,6,13,2014,1042,0.32,32,Medium-Low Digitalization,Medium Course ( >15H and <40H )
1459,6,2,4,2014,1042,0.28,28,Medium-Low Digitalization,Small Course ( <15H )
1460,15,0,15,2014,1042,0.01,1,Low Digitalization,Small Course ( <15H )
1461,73,27,46,2014,1042,0.37,37,Medium-Low Digitalization,High Course ( >40H )
1462,60,19,41,2014,1042,0.31,31,Medium-Low Digitalization,High Course ( >40H )
1463,47,46,1,2014,1042,0.97,97,High Digitalization,High Course ( >40H )
1464,30,5,25,2014,1042,0.16,16,Low Digitalization,Medium Course ( >15H and <40H )
1465,16,16,0,2014,1042,0.98,98,High Digitalization,Medium Course ( >15H and <40H )
1466,21,7,14,2014,1042,0.33,33,Medium-Low Digitalization,Medium Course ( >15H and <40H )
1467,11,6,5,2014,1042,0.51,51,Medium-High Digitalization,Small Course ( <15H )
1468,54,10,44,2014,1042,0.19,19,Low Digitalization,High Course ( >40H )
1469,19,10,10,2014,1042,0.5,50,Medium-Low Digitalization,Medium Course ( >15H and <40H )
1470,78,37,41,2014,1042,0.48,48,Medium-Low Digitalization,High Course ( >40H )
1471,66,9,57,2014,1042,0.14,14,Low Digitalization,High Course ( >40H )
1472,9,8,1,2014,1042,0.87,87,High Digitalization,Small Course ( <15H )
1473,8,1,7,2014,1042,0.09,9,Low Digitalization,Small Course ( <15H )
1474,28,13,15,2014,1042,0.48,48,Medium-Low Digitalization,Medium Course ( >15H and <40H )
1475,14,3,11,2014,1042,0.21,21,Medium-Low Digitalization,Small Course ( <15H )
1476,6,1,5,2014,1042,0.2,20,Low Digitalization,Small Course ( <15H )
1477,87,77,10,2014,1042,0.88,88,High Digitalization,High Course ( >40H )
1478,39,13,26,2014,1042,0.34,34,Medium-Low Digitalization,Medium Course ( >15H and <40H )
1479,41,37,4,2014,1042,0.91,91,High Digitalization,High Course ( >40H )
1480,56,9,47,2014,1042,0.16,16,Low Digitalization,High Course ( >40H )
1481,83,60,23,2014,1042,0.72,72,Medium-High Digitalization,High Course ( >40H )
1482,75,32,43,2014,1042,0.43,43,Medium-Low Digitalization,High Course ( >40H )
1483,87,7,80,2014,1042,0.08,8,Low Digitalization,High Course ( >40H )
1484,7,6,1,2014,1042,0.89,89,High Digitalization,Small Course ( <15H )
1485,6,4,2,2014,1042,0.67,67,Medium-High Digitalization,Small Course ( <15H )
1486,14,5,9,2014,1042,0.36,36,Medium-Low Digitalization,Small Course ( <15H )
1487,15,8,7,2014,1042,0.52,52,Medium-High Digitalization,Small Course ( <15H )
1488,18,2,16,2014,1042,0.11,11,Low Digitalization,Medium Course ( >15H and <40H )
1489,41,33,8,2014,1042,0.81,81,High Digitalization,High Course ( >40H )
1490,6,4,2,2014,1042,0.75,75,Medium-High Digitalization,Small Course ( <15H )
1491,72,4,68,2014,1042,0.05,5,Low Digitalization,High Course ( >40H )
1492,40,32,8,2014,1042,0.79,79,Medium-High Digitalization,High Course ( >40H )
1493,14,2,12,2014,1042,0.11,11,Low Digitalization,Small Course ( <15H )
1494,13,1,12,2014,1042,0.1,10,Low Digitalization,Small Course ( <15H )
1495,64,30,34,2014,1042,0.47,47,Medium-Low Digitalization,High Course ( >40H )
1496,16,9,7,2014,1042,0.55,55,Medium-High Digitalization,Medium Course ( >15H and <40H )
1497,62,8,54,2014,1042,0.13,13,Low Digitalization,High Course ( >40H )
1498,43,35,8,2014,1042,0.82,82,High Digitalization,High Course ( >40H )
1499,12,2,10,2014,1042,0.15,15,Low Digitalization,Small Course ( <15H )
1500,48,33,15,2014,1042,0.69,69,Medium-High Digitalization,High Course ( >40H )
1501,17,2,15,2014,1042,0.11,11,Low Digitalization,Medium Course ( >15H and <40H )
1502,14,3,11,2014,1042,0.23,23,Medium-Low Digitalization,Small Course ( <15H )
1503,90,58,32,2014,1042,0.65,65,Medium-High Digitalization,High Course ( >40H )
1504,67,5,62,2014,1042,0.08,8,Low Digitalization,High Course ( >40H )
1505,33,30,3,2014,1042,0.9,90,High Digitalization,Medium Course ( >15H and <40H )
1506,57,39,18,2014,1042,0.68,68,Medium-High Digitalization,High Course ( >40H )
1507,10,0,10,2014,1042,0.05,5,Low Digitalization,Small Course ( <15H )
1508,36,1,35,2014,1042,0.03,3,Low Digitalization,Medium Course ( >15H and <40H )
1509,51,35,16,2014,1042,0.68,68,Medium-High Digitalization,High Course ( >40H )
1510,14,10,4,2014,1042,0.7,70,Medium-High Digitalization,Small Course ( <15H )
1511,43,26,17,2014,1042,0.6,60,Medium-High Digitalization,High Course ( >40H )
1512,58,49,9,2014,1042,0.84,84,High Digitalization,High Course ( >40H )
1513,31,4,27,2014,1042,0.14,14,Low Digitalization,Medium Course ( >15H and <40H )
1514,10,3,7,2014,1042,0.3,30,Medium-Low Digitalization,Small Course ( <15H )
1515,42,9,33,2014,1042,0.22,22,Medium-Low Digitalization,High Course ( >40H )
1516,87,48,39,2014,1042,0.55,55,Medium-High Digitalization,High Course ( >40H )
1517,12,9,3,2014,1042,0.77,77,Medium-High Digitalization,Small Course ( <15H )
1518,21,1,20,2014,1042,0.07,7,Low Digitalization,Medium Course ( >15H and <40H )
1519,76,14,62,2014,1042,0.18,18,Low Digitalization,High Course ( >40H )
1520,23,3,20,2014,1042,0.11,11,Low Digitalization,Medium Course ( >15H and <40H )
1521,76,16,60,2014,1042,0.21,21,Medium-Low Digitalization,High Course ( >40H )
1522,82,34,48,2014,1042,0.41,41,Medium-Low Digitalization,High Course ( >40H )
1523,6,1,5,2014,1042,0.22,22,Medium-Low Digitalization,Small Course ( <15H )
1524,20,17,3,2014,1042,0.85,85,High Digitalization,Medium Course ( >15H and <40H )
1525,9,7,2,2014,1042,0.75,75,Medium-High Digitalization,Small Course ( <15H )
1526,15,3,12,2014,1042,0.19,19,Low Digitalization,Small Course ( <15H )
1527,90,68,22,2014,1042,0.76,76,Medium-High Digitalization,High Course ( >40H )
1528,14,7,7,2014,1042,0.48,48,Medium-Low Digitalization,Small Course ( <15H )
1529,10,7,3,2014,1042,0.7,70,Medium-High Digitalization,Small Course ( <15H )
1530,62,42,20,2014,1042,0.67,67,Medium-High Digitalization,High Course ( >40H )
1531,81,9,72,2014,1042,0.11,11,Low Digitalization,High Course ( >40H )
1532,32,24,8,2014,1042,0.74,74,Medium-High Digitalization,Medium Course ( >15H and <40H )
1533,50,38,12,2014,1042,0.76,76,Medium-High Digitalization,High Course ( >40H )
1534,60,2,58,2014,1042,0.03,3,Low Digitalization,High Course ( >40H )
1535,14,11,3,2014,1042,0.79,79,Medium-High Digitalization,Small Course ( <15H )
1536,90,15,75,2014,1042,0.17,17,Low Digitalization,High Course ( >40H )
1537,30,14,16,2014,1042,0.45,45,Medium-Low Digitalization,Medium Course ( >15H and <40H )
1538,49,36,13,2014,1042,0.74,74,Medium-High Digitalization,High Course ( >40H )
1539,24,10,14,2014,1042,0.42,42,Medium-Low Digitalization,Medium Course ( >15H and <40H )
1540,36,7,29,2014,1042,0.19,19,Low Digitalization,Medium Course ( >15H and <40H )
1541,15,4,10,2014,1042,0.3,30,Medium-Low Digitalization,Small Course ( <15H )
1542,27,11,16,2014,1042,0.39,39,Medium-Low Digitalization,Medium Course ( >15H and <40H )
1543,59,29,30,2014,1042,0.49,49,Medium-Low Digitalization,High Course ( >40H )
1544,52,41,11,2014,1042,0.79,79,Medium-High Digitalization,High Course ( >40H )
1545,55,40,15,2014,1042,0.72,72,Medium-High Digitalization,High Course ( >40H )
1546,19,8,11,2014,1042,0.44,44,Medium-Low Digitalization,Medium Course ( >15H and <40H )
1547,46,38,8,2014,1042,0.82,82,High Digitalization,High Course ( >40H )
1548,19,5,14,2014,1042,0.28,28,Medium-Low Digitalization,Medium Course ( >15H and <40H )
1549,47,46,1,2014,1042,0.97,97,High Digitalization,High Course ( >40H )
1550,64,27,37,2014,1042,0.42,42,Medium-Low Digitalization,High Course ( >40H )
1551,5,2,2,2014,1042,0.5,50,Medium-Low Digitalization,Small Course ( <15H )
1552,83,74,9,2014,1042,0.89,89,High Digitalization,High Course ( >40H )
1553,20,3,17,2014,1042,0.15,15,Low Digitalization,Medium Course ( >15H and <40H )
1554,10,2,8,2014,1042,0.23,23,Medium-Low Digitalization,Small Course ( <15H )
1555,14,11,3,2014,1042,0.77,77,Medium-High Digitalization,Small Course ( <15H )
1556,6,3,3,2014,1042,0.44,44,Medium-Low Digitalization,Small Course ( <15H )
1557,61,48,13,2014,1042,0.78,78,Medium-High Digitalization,High Course ( >40H )
1558,20,11,9,2014,1042,0.55,55,Medium-High Digitalization,Medium Course ( >15H and <40H )
1559,13,0,13,2014,1042,0.03,3,Low Digitalization,Small Course ( <15H )
1560,47,45,2,2014,1042,0.96,96,High Digitalization,High Course ( >40H )
1561,66,1,65,2014,1042,0.01,1,Low Digitalization,High Course ( >40H )
1562,6,5,1,2014,1042,0.84,84,High Digitalization,Small Course ( <15H )
1563,15,9,6,2014,1042,0.59,59,Medium-High Digitalization,Small Course ( <15H )
1564,49,5,44,2014,1042,0.11,11,Low Digitalization,High Course ( >40H )
1565,60,52,8,2014,1042,0.87,87,High Digitalization,High Course ( >40H )
1566,6,5,1,2014,1042,0.84,84,High Digitalization,Small Course ( <15H )
1567,18,8,10,2014,1042,0.45,45,Medium-Low Digitalization,Medium Course ( >15H and <40H )
1568,9,0,9,2014,1042,0.01,1,Low Digitalization,Small Course ( <15H )
1569,82,30,52,2014,1042,0.36,36,Medium-Low Digitalization,High Course ( >40H )
1570,44,17,27,2014,1042,0.38,38,Medium-Low Digitalization,High Course ( >40H )
1571,22,18,4,2014,1042,0.82,82,High Digitalization,Medium Course ( >15H and <40H )
1572,37,11,26,2014,1042,0.29,28,Medium-Low Digitalization,Medium Course ( >15H and <40H )
1573,67,11,56,2014,1042,0.16,16,Low Digitalization,High Course ( >40H )
1574,19,9,10,2014,1042,0.47,47,Medium-Low Digitalization,Medium Course ( >15H and <40H )
1575,45,22,23,2014,1042,0.49,49,Medium-Low Digitalization,High Course ( >40H )
1576,69,10,59,2014,1042,0.15,15,Low Digitalization,High Course ( >40H )
1577,8,5,3,2014,1042,0.65,65,Medium-High Digitalization,Small Course ( <15H )
1578,49,24,25,2014,1042,0.48,48,Medium-Low Digitalization,High Course ( >40H )
1579,6,4,2,2014,1042,0.69,69,Medium-High Digitalization,Small Course ( <15H )
1580,72,50,22,2014,1042,0.7,70,Medium-High Digitalization,High Course ( >40H )
1581,29,3,26,2014,1042,0.12,12,Low Digitalization,Medium Course ( >15H and <40H )
1582,12,3,9,2014,1042,0.27,27,Medium-Low Digitalization,Small Course ( <15H )
1583,36,4,32,2014,1042,0.12,12,Low Digitalization,Medium Course ( >15H and <40H )
1584,22,2,20,2014,1042,0.1,10,Low Digitalization,Medium Course ( >15H and <40H )
1585,54,35,19,2014,1042,0.64,64,Medium-High Digitalization,High Course ( >40H )
1586,55,20,35,2014,1042,0.36,36,Medium-Low Digitalization,High Course ( >40H )
1587,30,10,20,2014,1042,0.35,35,Medium-Low Digitalization,Medium Course ( >15H and <40H )
1588,35,9,26,2014,1042,0.25,25,Medium-Low Digitalization,Medium Course ( >15H and <40H )
1589,50,9,41,2014,1042,0.18,18,Low Digitalization,High Course ( >40H )
1590,7,2,5,2014,1042,0.3,30,Medium-Low Digitalization,Small Course ( <15H )
1591,24,16,8,2014,1042,0.65,65,Medium-High Digitalization,Medium Course ( >15H and <40H )
1592,53,44,9,2014,1042,0.83,83,High Digitalization,High Course ( >40H )
1593,24,14,10,2014,1042,0.57,56,Medium-High Digitalization,Medium Course ( >15H and <40H )
1594,56,26,30,2014,1042,0.46,46,Medium-Low Digitalization,High Course ( >40H )
1595,49,1,48,2014,1042,0.02,2,Low Digitalization,High Course ( >40H )
1596,36,22,14,2014,1042,0.61,61,Medium-High Digitalization,Medium Course ( >15H and <40H )
1597,71,48,23,2014,1042,0.68,68,Medium-High Digitalization,High Course ( >40H )
1598,11,7,4,2014,1042,0.67,67,Medium-High Digitalization,Small Course ( <15H )
1599,7,4,3,2014,1042,0.58,57,Medium-High Digitalization,Small Course ( <15H )
1600,25,3,22,2014,1042,0.13,13,Low Digitalization,Medium Course ( >15H and <40H )
1601,41,37,4,2014,1042,0.91,91,High Digitalization,High Course ( >40H )
1602,14,13,1,2014,1042,0.95,95,High Digitalization,Small Course ( <15H )
1603,60,8,52,2014,1042,0.14,14,Low Digitalization,High Course ( >40H )
1604,64,6,58,2014,1042,0.09,9,Low Digitalization,High Course ( >40H )
1605,47,16,31,2014,1042,0.34,34,Medium-Low Digitalization,High Course ( >40H )
1606,47,42,5,2014,1042,0.89,89,High Digitalization,High Course ( >40H )
1607,8,3,5,2014,1042,0.36,36,Medium-Low Digitalization,Small Course ( <15H )
1608,8,3,5,2014,1042,0.4,40,Medium-Low Digitalization,Small Course ( <15H )
1609,52,32,20,2014,1042,0.61,61,Medium-High Digitalization,High Course ( >40H )
1610,6,3,3,2014,1042,0.51,51,Medium-High Digitalization,Small Course ( <15H )
1611,5,4,1,2014,1042,0.85,85,High Digitalization,Small Course ( <15H )
1612,10,2,8,2014,1042,0.25,25,Medium-Low Digitalization,Small Course ( <15H )
1613,67,29,38,2014,1042,0.44,44,Medium-Low Digitalization,High Course ( >40H )
1614,19,8,11,2014,1042,0.42,42,Medium-Low Digitalization,Medium Course ( >15H and <40H )
1615,62,29,33,2014,1042,0.47,47,Medium-Low Digitalization,High Course ( >40H )
1616,60,47,13,2014,1042,0.78,78,Medium-High Digitalization,High Course ( >40H )
1617,10,8,2,2014,1042,0.82,82,High Digitalization,Small Course ( <15H )
1618,60,47,13,2014,1042,0.79,79,Medium-High Digitalization,High Course ( >40H )
1619,32,18,14,2014,1042,0.55,55,Medium-High Digitalization,Medium Course ( >15H and <40H )
1620,20,20,0,2014,1042,0.99,99,High Digitalization,Medium Course ( >15H and <40H )
1621,50,22,28,2014,1042,0.44,44,Medium-Low Digitalization,High Course ( >40H )
1622,25,20,5,2014,1042,0.81,81,High Digitalization,Medium Course ( >15H and <40H )
1623,43,39,4,2014,1042,0.91,91,High Digitalization,High Course ( >40H )
1624,53,6,47,2014,1042,0.11,11,Low Digitalization,High Course ( >40H )
1625,36,17,19,2014,1042,0.47,47,Medium-Low Digitalization,Medium Course ( >15H and <40H )
1626,53,10,43,2014,1042,0.19,19,Low Digitalization,High Course ( >40H )
1627,82,44,38,2014,1042,0.54,54,Medium-High Digitalization,High Course ( >40H )
1628,30,13,17,2014,1042,0.42,42,Medium-Low Digitalization,Medium Course ( >15H and <40H )
1629,88,24,64,2014,1042,0.27,27,Medium-Low Digitalization,High Course ( >40H )
1630,46,10,36,2014,1042,0.22,22,Medium-Low Digitalization,High Course ( >40H )
1631,53,30,23,2014,1042,0.57,56,Medium-High Digitalization,High Course ( >40H )
1632,9,7,2,2014,1042,0.74,74,Medium-High Digitalization,Small Course ( <15H )
1633,76,46,30,2014,1042,0.6,60,Medium-High Digitalization,High Course ( >40H )
1634,39,23,16,2014,1042,0.6,60,Medium-High Digitalization,Medium Course ( >15H and <40H )
1635,54,16,38,2014,1042,0.3,30,Medium-Low Digitalization,High Course ( >40H )
1636,15,10,5,2014,1042,0.64,64,Medium-High Digitalization,Small Course ( <15H )
1637,52,29,23,2014,1042,0.55,55,Medium-High Digitalization,High Course ( >40H )
1638,14,10,4,2014,1042,0.68,68,Medium-High Digitalization,Small Course ( <15H )
1639,17,6,11,2014,1042,0.37,37,Medium-Low Digitalization,Medium Course ( >15H and <40H )
1640,88,39,49,2014,1042,0.44,44,Medium-Low Digitalization,High Course ( >40H )
1641,5,2,3,2014,1042,0.32,32,Medium-Low Digitalization,Small Course ( <15H )
1642,20,2,18,2014,1042,0.08,8,Low Digitalization,Medium Course ( >15H and <40H )
1643,48,36,12,2014,1042,0.76,76,Medium-High Digitalization,High Course ( >40H )
1644,32,16,16,2014,1042,0.49,49,Medium-Low Digitalization,Medium Course ( >15H and <40H )
1645,14,4,10,2014,1042,0.25,25,Medium-Low Digitalization,Small Course ( <15H )
1646,23,17,6,2014,1042,0.73,73,Medium-High Digitalization,Medium Course ( >15H and <40H )
1647,76,61,15,2014,1042,0.8,80,Medium-High Digitalization,High Course ( >40H )
1648,21,8,13,2014,1042,0.36,36,Medium-Low Digitalization,Medium Course ( >15H and <40H )
1649,27,13,14,2014,1042,0.48,48,Medium-Low Digitalization,Medium Course ( >15H and <40H )
1650,29,14,14,2014,1042,0.5,50,Medium-Low Digitalization,Medium Course ( >15H and <40H )
1651,14,5,9,2014,1042,0.36,36,Medium-Low Digitalization,Small Course ( <15H )
1652,59,15,44,2014,1042,0.25,25,Medium-Low Digitalization,High Course ( >40H )
1653,39,37,2,2014,1042,0.95,95,High Digitalization,Medium Course ( >15H and <40H )
1654,54,50,4,2014,1042,0.92,92,High Digitalization,High Course ( >40H )
1655,42,25,17,2014,1042,0.59,59,Medium-High Digitalization,High Course ( >40H )
1656,37,23,14,2014,1042,0.61,61,Medium-High Digitalization,Medium Course ( >15H and <40H )
1657,84,47,37,2014,1042,0.56,56,Medium-High Digitalization,High Course ( >40H )
1658,40,21,19,2014,1042,0.52,52,Medium-High Digitalization,High Course ( >40H )
1659,18,18,0,2014,1042,1.0,100,High Digitalization,Medium Course ( >15H and <40H )
1660,48,26,22,2014,1042,0.55,55,Medium-High Digitalization,High Course ( >40H )
1661,22,11,11,2014,1042,0.52,52,Medium-High Digitalization,Medium Course ( >15H and <40H )
1662,8,2,6,2014,1042,0.2,20,Low Digitalization,Small Course ( <15H )
1663,17,5,12,2014,1042,0.29,28,Medium-Low Digitalization,Medium Course ( >15H and <40H )
1664,41,21,20,2014,1042,0.52,52,Medium-High Digitalization,High Course ( >40H )
1665,49,45,4,2014,1042,0.92,92,High Digitalization,High Course ( >40H )
1666,35,6,29,2014,1042,0.16,16,Low Digitalization,Medium Course ( >15H and <40H )
1667,8,4,4,2014,1042,0.46,46,Medium-Low Digitalization,Small Course ( <15H )
1668,31,26,5,2014,1042,0.85,85,High Digitalization,Medium Course ( >15H and <40H )
1669,8,2,6,2014,1042,0.3,30,Medium-Low Digitalization,Small Course ( <15H )
1670,60,34,26,2014,1042,0.56,56,Medium-High Digitalization,High Course ( >40H )
1671,52,18,34,2014,1042,0.34,34,Medium-Low Digitalization,High Course ( >40H )
1672,54,51,3,2014,1042,0.95,95,High Digitalization,High Course ( >40H )
1673,46,10,36,2014,1042,0.22,22,Medium-Low Digitalization,High Course ( >40H )
1674,9,5,4,2014,1042,0.53,53,Medium-High Digitalization,Small Course ( <15H )
1675,13,0,13,2014,1042,0.01,1,Low Digitalization,Small Course ( <15H )
1676,60,44,16,2014,1042,0.73,73,Medium-High Digitalization,High Course ( >40H )
1677,53,39,14,2014,1042,0.74,74,Medium-High Digitalization,High Course ( >40H )
1678,42,16,26,2014,1042,0.39,39,Medium-Low Digitalization,High Course ( >40H )
1679,10,5,5,2014,1042,0.5,50,Medium-Low Digitalization,Small Course ( <15H )
1680,41,10,31,2014,1042,0.24,24,Medium-Low Digitalization,High Course ( >40H )
1681,86,61,25,2014,1042,0.71,71,Medium-High Digitalization,High Course ( >40H )
1682,79,4,75,2014,1042,0.05,5,Low Digitalization,High Course ( >40H )
1683,84,71,13,2014,1042,0.84,84,High Digitalization,High Course ( >40H )
1684,78,41,37,2014,1042,0.53,53,Medium-High Digitalization,High Course ( >40H )
1685,21,4,17,2014,1042,0.17,17,Low Digitalization,Medium Course ( >15H and <40H )
1686,6,5,1,2014,1042,0.82,82,High Digitalization,Small Course ( <15H )
1687,60,4,56,2014,1042,0.06,6,Low Digitalization,High Course ( >40H )
1688,49,9,40,2014,1042,0.19,19,Low Digitalization,High Course ( >40H )
1689,79,7,72,2014,1042,0.09,9,Low Digitalization,High Course ( >40H )
1690,11,5,6,2014,1042,0.47,47,Medium-Low Digitalization,Small Course ( <15H )
1691,31,2,29,2014,1042,0.06,6,Low Digitalization,Medium Course ( >15H and <40H )
1692,6,5,1,2014,1042,0.79,79,Medium-High Digitalization,Small Course ( <15H )
1693,70,70,0,2014,1042,1.0,100,High Digitalization,High Course ( >40H )
1694,82,80,2,2014,1042,0.98,98,High Digitalization,High Course ( >40H )
1695,62,4,58,2014,1042,0.06,6,Low Digitalization,High Course ( >40H )
1696,86,9,77,2014,1042,0.11,11,Low Digitalization,High Course ( >40H )
1697,7,2,5,2014,1042,0.33,33,Medium-Low Digitalization,Small Course ( <15H )
1698,86,46,40,2014,1042,0.53,53,Medium-High Digitalization,High Course ( >40H )
1699,78,40,38,2014,1042,0.51,51,Medium-High Digitalization,High Course ( >40H )
1700,46,11,35,2014,1042,0.23,23,Medium-Low Digitalization,High Course ( >40H )
1701,83,6,77,2014,1042,0.07,7,Low Digitalization,High Course ( >40H )
1702,61,8,53,2014,1042,0.13,13,Low Digitalization,High Course ( >40H )
1703,9,9,0,2014,1042,1.0,100,High Digitalization,Small Course ( <15H )
1704,51,17,34,2014,1042,0.33,33,Medium-Low Digitalization,High Course ( >40H )
1705,11,3,8,2014,1042,0.29,28,Medium-Low Digitalization,Small Course ( <15H )
1706,56,23,33,2014,1042,0.41,41,Medium-Low Digitalization,High Course ( >40H )
1707,11,3,8,2014,1042,0.24,24,Medium-Low Digitalization,Small Course ( <15H )
1708,10,5,5,2014,1042,0.54,54,Medium-High Digitalization,Small Course ( <15H )
1709,50,41,9,2014,1042,0.82,82,High Digitalization,High Course ( >40H )
1710,50,28,22,2014,1042,0.57,56,Medium-High Digitalization,High Course ( >40H )
1711,68,14,54,2014,1042,0.21,21,Medium-Low Digitalization,High Course ( >40H )
1712,29,25,4,2014,1042,0.87,87,High Digitalization,Medium Course ( >15H and <40H )
1713,68,7,61,2014,1042,0.1,10,Low Digitalization,High Course ( >40H )
1714,48,18,30,2014,1042,0.38,38,Medium-Low Digitalization,High Course ( >40H )
1715,7,4,3,2014,1042,0.64,64,Medium-High Digitalization,Small Course ( <15H )
1716,37,35,2,2014,1042,0.94,94,High Digitalization,Medium Course ( >15H and <40H )
1717,12,4,8,2014,1042,0.36,36,Medium-Low Digitalization,Small Course ( <15H )
1718,9,1,8,2014,1042,0.06,6,Low Digitalization,Small Course ( <15H )
1719,47,40,7,2014,1042,0.85,85,High Digitalization,High Course ( >40H )
1720,43,25,18,2014,1042,0.59,59,Medium-High Digitalization,High Course ( >40H )
1721,52,18,34,2014,1042,0.34,34,Medium-Low Digitalization,High Course ( >40H )
1722,6,2,4,2014,1042,0.34,34,Medium-Low Digitalization,Small Course ( <15H )
1723,6,1,5,2014,1042,0.16,16,Low Digitalization,Small Course ( <15H )
1724,14,13,1,2014,1042,0.96,96,High Digitalization,Small Course ( <15H )
1725,8,0,8,2014,1042,0.03,3,Low Digitalization,Small Course ( <15H )
1726,11,1,10,2014,1042,0.1,10,Low Digitalization,Small Course ( <15H )
1727,55,3,52,2014,1042,0.05,5,Low Digitalization,High Course ( >40H )
1728,52,33,19,2014,1042,0.64,64,Medium-High Digitalization,High Course ( >40H )
1729,66,64,2,2014,1042,0.97,97,High Digitalization,High Course ( >40H )
1730,22,7,15,2014,1042,0.3,30,Medium-Low Digitalization,Medium Course ( >15H and <40H )
1731,44,43,1,2014,1042,0.98,98,High Digitalization,High Course ( >40H )
1732,61,43,18,2014,1042,0.71,71,Medium-High Digitalization,High Course ( >40H )
1733,8,0,8,2014,1042,0.06,6,Low Digitalization,Small Course ( <15H )
1734,15,8,7,2014,1042,0.51,51,Medium-High Digitalization,Small Course ( <15H )
1735,27,25,2,2014,1042,0.94,94,High Digitalization,Medium Course ( >15H and <40H )
1736,46,24,22,2014,1042,0.53,53,Medium-High Digitalization,High Course ( >40H )
1737,84,57,27,2014,1042,0.68,68,Medium-High Digitalization,High Course ( >40H )
1738,13,8,5,2014,1042,0.61,61,Medium-High Digitalization,Small Course ( <15H )
1739,12,1,11,2014,1042,0.07,7,Low Digitalization,Small Course ( <15H )
1740,45,26,19,2014,1042,0.58,57,Medium-High Digitalization,High Course ( >40H )
1741,13,4,9,2014,1042,0.28,28,Medium-Low Digitalization,Small Course ( <15H )
1742,11,0,11,2014,1042,0.03,3,Low Digitalization,Small Course ( <15H )
1743,57,44,13,2014,1042,0.77,77,Medium-High Digitalization,High Course ( >40H )
1744,14,5,9,2014,1042,0.37,37,Medium-Low Digitalization,Small Course ( <15H )
1745,13,9,4,2014,1042,0.69,69,Medium-High Digitalization,Small Course ( <15H )
1746,15,1,14,2014,1042,0.05,5,Low Digitalization,Small Course ( <15H )
1747,53,43,10,2014,1042,0.82,82,High Digitalization,High Course ( >40H )
1748,55,39,16,2014,1042,0.71,71,Medium-High Digitalization,High Course ( >40H )
1749,15,15,0,2014,1042,0.97,97,High Digitalization,Small Course ( <15H )
1750,59,39,20,2014,1042,0.66,66,Medium-High Digitalization,High Course ( >40H )
1751,51,35,16,2014,1042,0.68,68,Medium-High Digitalization,High Course ( >40H )
1752,28,2,26,2014,1042,0.07,7,Low Digitalization,Medium Course ( >15H and <40H )
1753,39,13,26,2014,1042,0.34,34,Medium-Low Digitalization,Medium Course ( >15H and <40H )
1754,24,17,7,2014,1042,0.7,70,Medium-High Digitalization,Medium Course ( >15H and <40H )
1755,42,26,16,2014,1042,0.63,63,Medium-High Digitalization,High Course ( >40H )
1756,46,14,32,2014,1042,0.3,30,Medium-Low Digitalization,High Course ( >40H )
1757,7,7,0,2014,1042,0.96,96,High Digitalization,Small Course ( <15H )
1758,9,1,8,2014,1042,0.07,7,Low Digitalization,Small Course ( <15H )
1759,46,42,4,2014,1042,0.91,91,High Digitalization,High Course ( >40H )
1760,10,0,10,2014,1042,0.04,4,Low Digitalization,Small Course ( <15H )
1761,6,3,3,2014,1042,0.43,43,Medium-Low Digitalization,Small Course ( <15H )
1762,46,12,34,2014,1042,0.27,27,Medium-Low Digitalization,High Course ( >40H )
1763,5,1,4,2014,1042,0.27,27,Medium-Low Digitalization,Small Course ( <15H )
1764,35,23,12,2014,1042,0.67,67,Medium-High Digitalization,Medium Course ( >15H and <40H )
1765,11,5,6,2014,1042,0.46,46,Medium-Low Digitalization,Small Course ( <15H )
1766,57,17,40,2014,1042,0.29,28,Medium-Low Digitalization,High Course ( >40H )
1767,67,17,50,2014,1042,0.25,25,Medium-Low Digitalization,High Course ( >40H )
1768,23,15,8,2014,1042,0.65,65,Medium-High Digitalization,Medium Course ( >15H and <40H )
1769,79,73,6,2014,1042,0.92,92,High Digitalization,High Course ( >40H )
1770,52,34,18,2014,1042,0.66,66,Medium-High Digitalization,High Course ( >40H )
1771,26,22,4,2014,1042,0.85,85,High Digitalization,Medium Course ( >15H and <40H )
1772,44,13,31,2014,1042,0.3,30,Medium-Low Digitalization,High Course ( >40H )
1773,53,47,6,2014,1042,0.88,88,High Digitalization,High Course ( >40H )
1774,13,2,11,2014,1042,0.13,13,Low Digitalization,Small Course ( <15H )
1775,76,18,58,2014,1042,0.24,24,Medium-Low Digitalization,High Course ( >40H )
1776,52,36,16,2014,1042,0.69,69,Medium-High Digitalization,High Course ( >40H )
1777,5,3,2,2014,1042,0.68,68,Medium-High Digitalization,Small Course ( <15H )
1778,22,3,19,2014,1042,0.14,14,Low Digitalization,Medium Course ( >15H and <40H )
1779,9,4,5,2014,1042,0.49,49,Medium-Low Digitalization,Small Course ( <15H )
1780,52,36,16,2014,1042,0.7,70,Medium-High Digitalization,High Course ( >40H )
1781,54,40,14,2014,1042,0.74,74,Medium-High Digitalization,High Course ( >40H )
1782,85,71,14,2014,1042,0.84,84,High Digitalization,High Course ( >40H )
1783,11,0,11,2014,1042,0.02,2,Low Digitalization,Small Course ( <15H )
1784,90,72,18,2014,1042,0.8,80,Medium-High Digitalization,High Course ( >40H )
1785,83,37,46,2014,1042,0.44,44,Medium-Low Digitalization,High Course ( >40H )
1786,6,3,3,2014,1042,0.44,44,Medium-Low Digitalization,Small Course ( <15H )
1787,68,18,50,2014,1042,0.27,27,Medium-Low Digitalization,High Course ( >40H )
1788,18,6,12,2014,1042,0.33,33,Medium-Low Digitalization,Medium Course ( >15H and <40H )
1789,11,3,8,2014,1042,0.23,23,Medium-Low Digitalization,Small Course ( <15H )
1790,18,16,2,2014,1042,0.9,90,High Digitalization,Medium Course ( >15H and <40H )
1791,84,68,16,2014,1042,0.81,81,High Digitalization,High Course ( >40H )
1792,17,5,12,2014,1042,0.32,32,Medium-Low Digitalization,Medium Course ( >15H and <40H )
1793,54,25,29,2014,1042,0.47,47,Medium-Low Digitalization,High Course ( >40H )
1794,42,14,28,2014,1042,0.33,33,Medium-Low Digitalization,High Course ( >40H )
1795,60,52,8,2014,1042,0.86,86,High Digitalization,High Course ( >40H )
1796,13,6,7,2014,1042,0.48,48,Medium-Low Digitalization,Small Course ( <15H )
1797,56,10,46,2014,1042,0.18,18,Low Digitalization,High Course ( >40H )
1798,15,7,8,2014,1042,0.46,46,Medium-Low Digitalization,Small Course ( <15H )
1799,84,26,58,2014,1042,0.31,31,Medium-Low Digitalization,High Course ( >40H )
1800,39,20,20,2014,1042,0.5,50,Medium-Low Digitalization,Medium Course ( >15H and <40H )
1801,12,2,10,2014,1042,0.16,16,Low Digitalization,Small Course ( <15H )
1802,14,7,7,2014,1042,0.48,48,Medium-Low Digitalization,Small Course ( <15H )
1803,54,27,27,2014,1042,0.5,50,Medium-Low Digitalization,High Course ( >40H )
1804,69,28,41,2014,1042,0.4,40,Medium-Low Digitalization,High Course ( >40H )
1805,71,31,40,2014,1042,0.43,43,Medium-Low Digitalization,High Course ( >40H )
1806,55,1,54,2014,1042,0.02,2,Low Digitalization,High Course ( >40H )
1807,44,33,11,2014,1042,0.75,75,Medium-High Digitalization,High Course ( >40H )
1808,57,55,2,2014,1042,0.96,96,High Digitalization,High Course ( >40H )
1809,16,9,7,2014,1042,0.54,54,Medium-High Digitalization,Medium Course ( >15H and <40H )
1810,38,21,17,2014,1042,0.54,54,Medium-High Digitalization,Medium Course ( >15H and <40H )
1811,46,29,17,2014,1042,0.62,62,Medium-High Digitalization,High Course ( >40H )
1812,59,59,0,2014,1042,1.0,100,High Digitalization,High Course ( >40H )
1813,12,8,4,2014,1042,0.65,65,Medium-High Digitalization,Small Course ( <15H )
1814,16,10,6,2014,1042,0.62,62,Medium-High Digitalization,Medium Course ( >15H and <40H )
1815,57,31,26,2014,1042,0.54,54,Medium-High Digitalization,High Course ( >40H )
1816,6,4,2,2014,1042,0.63,63,Medium-High Digitalization,Small Course ( <15H )
1817,49,43,6,2014,1042,0.87,87,High Digitalization,High Course ( >40H )
1818,25,2,22,2014,1042,0.1,10,Low Digitalization,Medium Course ( >15H and <40H )
1819,14,10,4,2014,1042,0.71,71,Medium-High Digitalization,Small Course ( <15H )
1820,15,7,8,2014,1042,0.48,48,Medium-Low Digitalization,Small Course ( <15H )
1821,13,13,0,2014,1042,0.99,99,High Digitalization,Small Course ( <15H )
1822,20,9,11,2014,1042,0.44,44,Medium-Low Digitalization,Medium Course ( >15H and <40H )
1823,11,10,1,2014,1042,0.95,95,High Digitalization,Small Course ( <15H )
1824,11,10,1,2014,1042,0.89,89,High Digitalization,Small Course ( <15H )
1825,53,1,52,2014,1042,0.02,2,Low Digitalization,High Course ( >40H )
1826,23,16,7,2014,1042,0.69,69,Medium-High Digitalization,Medium Course ( >15H and <40H )
1827,14,5,9,2014,1042,0.39,39,Medium-Low Digitalization,Small Course ( <15H )
1828,20,19,1,2014,1042,0.93,93,High Digitalization,Medium Course ( >15H and <40H )
1829,13,2,11,2014,1042,0.16,16,Low Digitalization,Small Course ( <15H )
1830,33,5,28,2014,1042,0.14,14,Low Digitalization,Medium Course ( >15H and <40H )
1831,14,10,4,2014,1042,0.71,71,Medium-High Digitalization,Small Course ( <15H )
1832,84,4,80,2014,1042,0.05,5,Low Digitalization,High Course ( >40H )
1833,27,6,21,2014,1042,0.23,23,Medium-Low Digitalization,Medium Course ( >15H and <40H )
1834,81,69,12,2014,1042,0.85,85,High Digitalization,High Course ( >40H )
1835,18,1,17,2014,1042,0.05,5,Low Digitalization,Medium Course ( >15H and <40H )
1836,35,2,33,2014,1042,0.05,5,Low Digitalization,Medium Course ( >15H and <40H )
1837,47,36,11,2014,1042,0.76,76,Medium-High Digitalization,High Course ( >40H )
1838,12,0,12,2014,1042,0.01,1,Low Digitalization,Small Course ( <15H )
1839,20,5,15,2014,1042,0.23,23,Medium-Low Digitalization,Medium Course ( >15H and <40H )
1840,27,15,12,2014,1042,0.56,56,Medium-High Digitalization,Medium Course ( >15H and <40H )
1841,22,20,2,2014,1042,0.91,91,High Digitalization,Medium Course ( >15H and <40H )
1842,23,10,13,2014,1042,0.45,45,Medium-Low Digitalization,Medium Course ( >15H and <40H )
1843,57,54,3,2014,1042,0.95,95,High Digitalization,High Course ( >40H )
1844,35,26,9,2014,1042,0.74,74,Medium-High Digitalization,Medium Course ( >15H and <40H )
1845,20,10,10,2014,1042,0.48,48,Medium-Low Digitalization,Medium Course ( >15H and <40H )
1846,15,14,1,2014,1042,0.92,92,High Digitalization,Small Course ( <15H )
1847,8,5,3,2014,1042,0.64,64,Medium-High Digitalization,Small Course ( <15H )
1848,27,11,16,2014,1042,0.42,42,Medium-Low Digitalization,Medium Course ( >15H and <40H )
1849,32,26,6,2014,1042,0.82,82,High Digitalization,Medium Course ( >15H and <40H )
1850,40,10,30,2014,1042,0.24,24,Medium-Low Digitalization,High Course ( >40H )
1851,66,20,46,2014,1042,0.3,30,Medium-Low Digitalization,High Course ( >40H )
1852,6,3,3,2014,1042,0.5,50,Medium-Low Digitalization,Small Course ( <15H )
1853,81,40,40,2014,1042,0.5,50,Medium-Low Digitalization,High Course ( >40H )
1854,59,3,56,2014,1042,0.05,5,Low Digitalization,High Course ( >40H )
1855,85,31,54,2014,1042,0.37,37,Medium-Low Digitalization,High Course ( >40H )
1856,35,18,17,2014,1042,0.51,51,Medium-High Digitalization,Medium Course ( >15H and <40H )
1857,24,19,5,2014,1042,0.8,80,Medium-High Digitalization,Medium Course ( >15H and <40H )
1858,24,21,3,2014,1042,0.89,89,High Digitalization,Medium Course ( >15H and <40H )
1859,16,6,10,2014,1042,0.35,35,Medium-Low Digitalization,Medium Course ( >15H and <40H )
1860,30,16,14,2014,1042,0.53,53,Medium-High Digitalization,Medium Course ( >15H and <40H )
1861,5,0,5,2014,1042,0.07,7,Low Digitalization,Small Course ( <15H )
1862,88,56,32,2014,1042,0.64,64,Medium-High Digitalization,High Course ( >40H )
1863,66,4,62,2014,1042,0.06,6,Low Digitalization,High Course ( >40H )
1864,6,6,0,2014,1042,0.96,96,High Digitalization,Small Course ( <15H )
1865,61,3,58,2014,1042,0.05,5,Low Digitalization,High Course ( >40H )
1866,38,2,36,2014,1042,0.06,6,Low Digitalization,Medium Course ( >15H and <40H )
1867,48,20,28,2014,1042,0.41,41,Medium-Low Digitalization,High Course ( >40H )
1868,28,7,21,2014,1042,0.24,24,Medium-Low Digitalization,Medium Course ( >15H and <40H )
1869,48,12,36,2014,1042,0.26,26,Medium-Low Digitalization,High Course ( >40H )
1870,46,16,30,2014,1042,0.34,34,Medium-Low Digitalization,High Course ( >40H )
1871,33,25,8,2014,1042,0.75,75,Medium-High Digitalization,Medium Course ( >15H and <40H )
1872,14,1,13,2014,1042,0.08,8,Low Digitalization,Small Course ( <15H )
1873,6,0,6,2014,1042,0.04,4,Low Digitalization,Small Course ( <15H )
1874,27,23,4,2014,1042,0.84,84,High Digitalization,Medium Course ( >15H and <40H )
1875,75,50,26,2014,1042,0.66,66,Medium-High Digitalization,High Course ( >40H )
1876,40,20,20,2014,1042,0.5,50,Medium-Low Digitalization,High Course ( >40H )
1877,21,11,10,2014,1042,0.52,52,Medium-High Digitalization,Medium Course ( >15H and <40H )
1878,22,6,16,2014,1042,0.28,28,Medium-Low Digitalization,Medium Course ( >15H and <40H )
1879,30,20,10,2014,1042,0.65,65,Medium-High Digitalization,Medium Course ( >15H and <40H )
1880,11,6,5,2014,1042,0.56,56,Medium-High Digitalization,Small Course ( <15H )
1881,13,7,6,2014,1042,0.52,52,Medium-High Digitalization,Small Course ( <15H )
1882,15,9,6,2014,1042,0.58,57,Medium-High Digitalization,Small Course ( <15H )
1883,7,6,1,2014,1042,0.83,83,High Digitalization,Small Course ( <15H )
1884,73,58,15,2014,1042,0.79,79,Medium-High Digitalization,High Course ( >40H )
1885,11,7,4,2014,1042,0.65,65,Medium-High Digitalization,Small Course ( <15H )
1886,7,3,4,2014,1042,0.47,47,Medium-Low Digitalization,Small Course ( <15H )
1887,24,2,22,2014,1042,0.08,8,Low Digitalization,Medium Course ( >15H and <40H )
1888,66,15,51,2014,1042,0.23,23,Medium-Low Digitalization,High Course ( >40H )
1889,41,33,8,2014,1042,0.81,81,High Digitalization,High Course ( >40H )
1890,64,8,56,2014,1042,0.12,12,Low Digitalization,High Course ( >40H )
1891,58,24,34,2014,1042,0.42,42,Medium-Low Digitalization,High Course ( >40H )
1892,33,12,21,2014,1042,0.37,37,Medium-Low Digitalization,Medium Course ( >15H and <40H )
1893,11,1,10,2014,1042,0.05,5,Low Digitalization,Small Course ( <15H )
1894,27,5,22,2014,1042,0.2,20,Low Digitalization,Medium Course ( >15H and <40H )
1895,20,16,4,2014,1042,0.8,80,Medium-High Digitalization,Medium Course ( >15H and <40H )
1896,46,3,43,2014,1042,0.06,6,Low Digitalization,High Course ( >40H )
1897,43,42,1,2014,1042,0.97,97,High Digitalization,High Course ( >40H )
1898,11,9,2,2014,1042,0.82,82,High Digitalization,Small Course ( <15H )
1899,15,7,8,2014,1042,0.44,44,Medium-Low Digitalization,Small Course ( <15H )
1900,9,4,5,2014,1042,0.41,41,Medium-Low Digitalization,Small Course ( <15H )
1901,40,30,10,2014,1042,0.75,75,Medium-High Digitalization,High Course ( >40H )
1902,90,39,51,2014,1042,0.43,43,Medium-Low Digitalization,High Course ( >40H )
1903,31,5,26,2014,1042,0.17,17,Low Digitalization,Medium Course ( >15H and <40H )
1904,78,14,64,2014,1042,0.18,18,Low Digitalization,High Course ( >40H )
1905,18,3,15,2014,1042,0.17,17,Low Digitalization,Medium Course ( >15H and <40H )
1906,13,1,12,2014,1042,0.11,11,Low Digitalization,Small Course ( <15H )
1907,52,43,9,2014,1042,0.83,83,High Digitalization,High Course ( >40H )
1908,52,2,50,2014,1042,0.04,4,Low Digitalization,High Course ( >40H )
1909,7,0,7,2014,1042,0.06,6,Low Digitalization,Small Course ( <15H )
1910,87,21,66,2014,1042,0.24,24,Medium-Low Digitalization,High Course ( >40H )
1911,6,4,2,2014,1042,0.73,73,Medium-High Digitalization,Small Course ( <15H )
1912,32,8,24,2014,1042,0.26,26,Medium-Low Digitalization,Medium Course ( >15H and <40H )
1913,15,10,5,2014,1042,0.66,66,Medium-High Digitalization,Small Course ( <15H )
1914,16,6,10,2014,1042,0.38,38,Medium-Low Digitalization,Medium Course ( >15H and <40H )
1915,14,6,8,2014,1042,0.45,45,Medium-Low Digitalization,Small Course ( <15H )
1916,9,2,7,2014,1042,0.27,27,Medium-Low Digitalization,Small Course ( <15H )
1917,80,33,47,2014,1042,0.41,41,Medium-Low Digitalization,High Course ( >40H )
1918,42,28,14,2014,1042,0.66,66,Medium-High Digitalization,High Course ( >40H )
1919,38,1,37,2014,1042,0.03,3,Low Digitalization,Medium Course ( >15H and <40H )
1920,13,0,13,2014,1042,0.02,2,Low Digitalization,Small Course ( <15H )
1921,23,7,16,2014,1042,0.3,30,Medium-Low Digitalization,Medium Course ( >15H and <40H )
1922,13,1,12,2014,1042,0.09,9,Low Digitalization,Small Course ( <15H )
1923,35,13,22,2014,1042,0.38,38,Medium-Low Digitalization,Medium Course ( >15H and <40H )
1924,15,8,7,2014,1042,0.54,54,Medium-High Digitalization,Small Course ( <15H )
1925,29,25,4,2014,1042,0.86,86,High Digitalization,Medium Course ( >15H and <40H )
1926,60,29,31,2014,1042,0.49,49,Medium-Low Digitalization,High Course ( >40H )
1927,7,3,4,2014,1042,0.45,45,Medium-Low Digitalization,Small Course ( <15H )
1928,50,8,42,2014,1042,0.17,17,Low Digitalization,High Course ( >40H )
1929,33,26,7,2014,1042,0.78,78,Medium-High Digitalization,Medium Course ( >15H and <40H )
1930,47,15,32,2014,1042,0.32,32,Medium-Low Digitalization,High Course ( >40H )
1931,19,15,4,2014,1042,0.8,80,Medium-High Digitalization,Medium Course ( >15H and <40H )
1932,46,43,3,2014,1042,0.94,94,High Digitalization,High Course ( >40H )
1933,60,7,53,2014,1042,0.12,12,Low Digitalization,High Course ( >40H )
1934,71,10,61,2014,1042,0.14,14,Low Digitalization,High Course ( >40H )
1935,48,21,27,2014,1042,0.44,44,Medium-Low Digitalization,High Course ( >40H )
1936,20,15,5,2014,1042,0.77,77,Medium-High Digitalization,Medium Course ( >15H and <40H )
1937,6,4,2,2014,1042,0.63,63,Medium-High Digitalization,Small Course ( <15H )
1938,56,47,9,2014,1042,0.84,84,High Digitalization,High Course ( >40H )
1939,26,9,17,2014,1042,0.33,33,Medium-Low Digitalization,Medium Course ( >15H and <40H )
1940,10,4,6,2014,1042,0.4,40,Medium-Low Digitalization,Small Course ( <15H )
1941,50,39,11,2014,1042,0.78,78,Medium-High Digitalization,High Course ( >40H )
1942,10,0,10,2014,1042,0.04,4,Low Digitalization,Small Course ( <15H )
1943,61,23,38,2014,1042,0.38,38,Medium-Low Digitalization,High Course ( >40H )
1944,15,7,8,2014,1042,0.48,48,Medium-Low Digitalization,Small Course ( <15H )
1945,85,59,26,2014,1042,0.69,69,Medium-High Digitalization,High Course ( >40H )
1946,28,2,26,2014,1042,0.06,6,Low Digitalization,Medium Course ( >15H and <40H )
1947,12,2,10,2014,1042,0.15,15,Low Digitalization,Small Course ( <15H )
1948,42,13,29,2014,1042,0.31,31,Medium-Low Digitalization,High Course ( >40H )
1949,60,2,58,2014,1042,0.03,3,Low Digitalization,High Course ( >40H )
1950,44,37,7,2014,1042,0.83,83,High Digitalization,High Course ( >40H )
1951,56,34,22,2014,1042,0.6,60,Medium-High Digitalization,High Course ( >40H )
1952,8,3,5,2014,1042,0.39,39,Medium-Low Digitalization,Small Course ( <15H )
1953,19,18,1,2014,1042,0.94,94,High Digitalization,Medium Course ( >15H and <40H )
1954,85,51,34,2014,1042,0.6,60,Medium-High Digitalization,High Course ( >40H )
1955,17,1,16,2014,1042,0.04,4,Low Digitalization,Medium Course ( >15H and <40H )
1956,42,2,40,2014,1042,0.05,5,Low Digitalization,High Course ( >40H )
1957,28,26,2,2014,1042,0.92,92,High Digitalization,Medium Course ( >15H and <40H )
1958,42,24,18,2014,1042,0.57,56,Medium-High Digitalization,High Course ( >40H )
1959,59,55,4,2014,1042,0.94,94,High Digitalization,High Course ( >40H )
1960,23,19,4,2014,1042,0.83,83,High Digitalization,Medium Course ( >15H and <40H )
1961,42,7,35,2014,1042,0.16,16,Low Digitalization,High Course ( >40H )
1962,9,2,7,2014,1042,0.22,22,Medium-Low Digitalization,Small Course ( <15H )
1963,52,3,49,2014,1042,0.05,5,Low Digitalization,High Course ( >40H )
1964,9,2,7,2014,1042,0.22,22,Medium-Low Digitalization,Small Course ( <15H )
1965,29,5,24,2014,1042,0.18,18,Low Digitalization,Medium Course ( >15H and <40H )
1966,25,22,3,2014,1042,0.89,89,High Digitalization,Medium Course ( >15H and <40H )
1967,51,2,49,2014,1042,0.03,3,Low Digitalization,High Course ( >40H )
1968,11,10,1,2014,1042,0.92,92,High Digitalization,Small Course ( <15H )
1969,40,39,1,2014,1042,0.98,98,High Digitalization,High Course ( >40H )
1970,37,30,7,2014,1042,0.82,82,High Digitalization,Medium Course ( >15H and <40H )
1971,22,13,9,2014,1042,0.59,59,Medium-High Digitalization,Medium Course ( >15H and <40H )
1972,14,1,13,2014,1042,0.04,4,Low Digitalization,Small Course ( <15H )
1973,49,9,40,2014,1042,0.18,18,Low Digitalization,High Course ( >40H )
1974,54,12,42,2014,1042,0.22,22,Medium-Low Digitalization,High Course ( >40H )
1975,14,13,1,2014,1042,0.95,95,High Digitalization,Small Course ( <15H )
1976,6,2,4,2014,1042,0.31,31,Medium-Low Digitalization,Small Course ( <15H )
1977,68,36,32,2014,1042,0.53,53,Medium-High Digitalization,High Course ( >40H )
1978,59,4,55,2014,1042,0.07,7,Low Digitalization,High Course ( >40H )
1979,55,7,48,2014,1042,0.13,13,Low Digitalization,High Course ( >40H )
1980,8,7,1,2014,1042,0.86,86,High Digitalization,Small Course ( <15H )
1981,6,1,5,2014,1042,0.09,9,Low Digitalization,Small Course ( <15H )
1982,58,45,13,2014,1042,0.78,78,Medium-High Digitalization,High Course ( >40H )
1983,79,58,21,2014,1042,0.74,74,Medium-High Digitalization,High Course ( >40H )
1984,26,23,3,2014,1042,0.88,88,High Digitalization,Medium Course ( >15H and <40H )
1985,76,57,19,2014,1042,0.75,75,Medium-High Digitalization,High Course ( >40H )
1986,16,16,0,2014,1042,0.98,98,High Digitalization,Medium Course ( >15H and <40H )
1987,11,11,0,2014,1042,0.97,97,High Digitalization,Small Course ( <15H )
1988,33,11,22,2014,1042,0.34,34,Medium-Low Digitalization,Medium Course ( >15H and <40H )
1989,8,6,2,2014,1042,0.78,78,Medium-High Digitalization,Small Course ( <15H )
1990,26,19,7,2014,1042,0.72,72,Medium-High Digitalization,Medium Course ( >15H and <40H )
1991,87,70,17,2014,1042,0.81,81,High Digitalization,High Course ( >40H )
1992,73,26,47,2014,1042,0.36,36,Medium-Low Digitalization,High Course ( >40H )
1993,67,35,32,2014,1042,0.52,52,Medium-High Digitalization,High Course ( >40H )
1994,34,1,33,2014,1042,0.02,2,Low Digitalization,Medium Course ( >15H and <40H )
1995,13,6,7,2014,1042,0.46,46,Medium-Low Digitalization,Small Course ( <15H )
1996,12,9,3,2014,1042,0.76,76,Medium-High Digitalization,Small Course ( <15H )
1997,76,57,19,2014,1042,0.75,75,Medium-High Digitalization,High Course ( >40H )
1998,7,3,4,2014,1042,0.48,48,Medium-Low Digitalization,Small Course ( <15H )
1999,10,0,10,2014,1042,0.04,4,Low Digitalization,Small Course ( <15H )
2000,63,22,41,2014,1042,0.35,35,Medium-Low Digitalization,High Course ( >40H )
2001,34,6,28,2014,1042,0.19,19,Low Digitalization,Medium Course ( >15H and <40H )
2002,11,3,8,2014,1042,0.26,26,Medium-Low Digitalization,Small Course ( <15H )
2003,56,20,36,2014,1042,0.35,35,Medium-Low Digitalization,High Course ( >40H )
2004,16,13,3,2014,1042,0.82,82,High Digitalization,Medium Course ( >15H and <40H )
2005,20,6,14,2014,1042,0.32,32,Medium-Low Digitalization,Medium Course ( >15H and <40H )
2006,72,24,48,2014,1042,0.34,34,Medium-Low Digitalization,High Course ( >40H )
2007,15,2,13,2014,1042,0.16,16,Low Digitalization,Small Course ( <15H )
2008,49,36,13,2014,1042,0.74,74,Medium-High Digitalization,High Course ( >40H )
2009,6,5,1,2014,1042,0.85,85,High Digitalization,Small Course ( <15H )
2010,20,18,2,2014,1042,0.92,92,High Digitalization,Medium Course ( >15H and <40H )
2011,45,22,22,2014,1042,0.5,50,Medium-Low Digitalization,High Course ( >40H )
2012,14,7,7,2014,1042,0.48,48,Medium-Low Digitalization,Small Course ( <15H )
2013,6,2,4,2014,1042,0.39,39,Medium-Low Digitalization,Small Course ( <15H )
2014,49,7,42,2014,1042,0.14,14,Low Digitalization,High Course ( >40H )
2015,10,8,2,2014,1042,0.78,78,Medium-High Digitalization,Small Course ( <15H )
2016,46,3,43,2014,1042,0.06,6,Low Digitalization,High Course ( >40H )
2017,13,6,7,2014,1042,0.47,47,Medium-Low Digitalization,Small Course ( <15H )
2018,52,22,30,2014,1042,0.42,42,Medium-Low Digitalization,High Course ( >40H )
2019,9,4,5,2014,1042,0.45,45,Medium-Low Digitalization,Small Course ( <15H )
2020,43,22,21,2014,1042,0.51,51,Medium-High Digitalization,High Course ( >40H )
2021,13,0,13,2014,1042,0.03,3,Low Digitalization,Small Course ( <15H )
2022,60,25,35,2014,1042,0.41,41,Medium-Low Digitalization,High Course ( >40H )
2023,37,14,23,2014,1042,0.39,39,Medium-Low Digitalization,Medium Course ( >15H and <40H )
2024,68,22,46,2014,1042,0.32,32,Medium-Low Digitalization,High Course ( >40H )
2025,79,14,65,2014,1042,0.18,18,Low Digitalization,High Course ( >40H )
2026,37,8,29,2014,1042,0.22,22,Medium-Low Digitalization,Medium Course ( >15H and <40H )
2027,16,7,9,2014,1042,0.46,46,Medium-Low Digitalization,Medium Course ( >15H and <40H )
2028,28,24,4,2014,1042,0.85,85,High Digitalization,Medium Course ( >15H and <40H )
2029,50,4,46,2014,1042,0.09,9,Low Digitalization,High Course ( >40H )
2030,88,18,70,2014,1042,0.2,20,Low Digitalization,High Course ( >40H )
2031,75,58,17,2014,1042,0.77,77,Medium-High Digitalization,High Course ( >40H )
2032,6,2,4,2014,1042,0.36,36,Medium-Low Digitalization,Small Course ( <15H )
2033,54,27,27,2014,1042,0.5,50,Medium-Low Digitalization,High Course ( >40H )
2034,79,31,48,2014,1042,0.39,39,Medium-Low Digitalization,High Course ( >40H )
2035,88,15,73,2014,1042,0.17,17,Low Digitalization,High Course ( >40H )
2036,14,6,8,2014,1042,0.43,43,Medium-Low Digitalization,Small Course ( <15H )
2037,15,11,4,2014,1042,0.71,71,Medium-High Digitalization,Small Course ( <15H )
2038,35,10,25,2014,1042,0.28,28,Medium-Low Digitalization,Medium Course ( >15H and <40H )
2039,15,14,1,2014,1042,0.92,92,High Digitalization,Small Course ( <15H )
2040,27,20,7,2014,1042,0.74,74,Medium-High Digitalization,Medium Course ( >15H and <40H )
2041,5,1,4,2014,1042,0.17,17,Low Digitalization,Small Course ( <15H )
2042,65,18,47,2014,1042,0.28,28,Medium-Low Digitalization,High Course ( >40H )
2043,13,4,9,2014,1042,0.32,32,Medium-Low Digitalization,Small Course ( <15H )
2044,8,5,3,2014,1042,0.59,59,Medium-High Digitalization,Small Course ( <15H )
2045,71,34,37,2014,1042,0.48,48,Medium-Low Digitalization,High Course ( >40H )
2046,20,11,9,2014,1042,0.57,56,Medium-High Digitalization,Medium Course ( >15H and <40H )
2047,51,37,14,2014,1042,0.72,72,Medium-High Digitalization,High Course ( >40H )
2048,43,28,15,2014,1042,0.64,64,Medium-High Digitalization,High Course ( >40H )
2049,75,11,64,2014,1042,0.14,14,Low Digitalization,High Course ( >40H )
2050,58,35,23,2014,1042,0.61,61,Medium-High Digitalization,High Course ( >40H )
2051,16,10,6,2014,1042,0.61,61,Medium-High Digitalization,Medium Course ( >15H and <40H )
2052,86,17,69,2014,1042,0.2,20,Low Digitalization,High Course ( >40H )
2053,83,25,58,2014,1042,0.3,30,Medium-Low Digitalization,High Course ( >40H )
2054,90,87,3,2014,1042,0.97,97,High Digitalization,High Course ( >40H )
2055,11,1,10,2014,1042,0.13,13,Low Digitalization,Small Course ( <15H )
2056,33,12,21,2014,1042,0.35,35,Medium-Low Digitalization,Medium Course ( >15H and <40H )
2057,20,4,16,2014,1042,0.21,21,Medium-Low Digitalization,Medium Course ( >15H and <40H )
2058,74,24,50,2014,1042,0.33,33,Medium-Low Digitalization,High Course ( >40H )
2059,43,12,31,2014,1042,0.28,28,Medium-Low Digitalization,High Course ( >40H )
2060,51,1,50,2014,1042,0.01,1,Low Digitalization,High Course ( >40H )
2061,41,34,7,2014,1042,0.84,84,High Digitalization,High Course ( >40H )
2062,83,28,55,2014,1042,0.34,34,Medium-Low Digitalization,High Course ( >40H )
2063,11,8,3,2014,1042,0.76,76,Medium-High Digitalization,Small Course ( <15H )
2064,42,31,11,2014,1042,0.73,73,Medium-High Digitalization,High Course ( >40H )
2065,53,38,15,2014,1042,0.71,71,Medium-High Digitalization,High Course ( >40H )
2066,60,59,1,2014,1042,0.99,99,High Digitalization,High Course ( >40H )
2067,60,37,23,2014,1042,0.62,62,Medium-High Digitalization,High Course ( >40H )
2068,50,8,42,2014,1042,0.17,17,Low Digitalization,High Course ( >40H )
2069,12,11,1,2014,1042,0.89,89,High Digitalization,Small Course ( <15H )
2070,44,1,43,2014,1042,0.03,3,Low Digitalization,High Course ( >40H )
2071,10,6,4,2014,1042,0.57,56,Medium-High Digitalization,Small Course ( <15H )
2072,15,7,8,2014,1042,0.47,47,Medium-Low Digitalization,Small Course ( <15H )
2073,10,1,9,2014,1042,0.09,9,Low Digitalization,Small Course ( <15H )
2074,24,22,2,2014,1042,0.93,93,High Digitalization,Medium Course ( >15H and <40H )
2075,11,2,9,2014,1042,0.18,18,Low Digitalization,Small Course ( <15H )
2076,44,29,15,2014,1042,0.66,66,Medium-High Digitalization,High Course ( >40H )
2077,33,29,4,2014,1042,0.88,88,High Digitalization,Medium Course ( >15H and <40H )
2078,40,8,32,2014,1042,0.19,19,Low Digitalization,High Course ( >40H )
2079,37,14,23,2014,1042,0.38,38,Medium-Low Digitalization,Medium Course ( >15H and <40H )
2080,12,6,6,2014,1042,0.48,48,Medium-Low Digitalization,Small Course ( <15H )
2081,10,8,2,2014,1042,0.77,77,Medium-High Digitalization,Small Course ( <15H )
2082,48,19,29,2014,1042,0.4,40,Medium-Low Digitalization,High Course ( >40H )
2083,35,34,1,2014,1042,0.96,96,High Digitalization,Medium Course ( >15H and <40H )
2084,47,28,19,2014,1042,0.6,60,Medium-High Digitalization,High Course ( >40H )
2085,14,2,12,2014,1042,0.17,17,Low Digitalization,Small Course ( <15H )
2086,11,4,7,2014,1042,0.33,33,Medium-Low Digitalization,Small Course ( <15H )
2087,38,11,27,2014,1042,0.29,28,Medium-Low Digitalization,Medium Course ( >15H and <40H )
2088,45,8,37,2015,1016,0.17,17,Low Digitalization,High Course ( >40H )
2089,83,37,46,2015,1016,0.45,45,Medium-Low Digitalization,High Course ( >40H )
2090,43,39,4,2015,1016,0.9,90,High Digitalization,High Course ( >40H )
2091,50,20,30,2015,1016,0.41,41,Medium-Low Digitalization,High Course ( >40H )
2092,11,4,7,2015,1016,0.33,33,Medium-Low Digitalization,Small Course ( <15H )
2093,81,80,1,2015,1016,0.99,99,High Digitalization,High Course ( >40H )
2094,83,19,64,2015,1016,0.23,23,Medium-Low Digitalization,High Course ( >40H )
2095,23,7,16,2015,1016,0.31,31,Medium-Low Digitalization,Medium Course ( >15H and <40H )
2096,18,4,14,2015,1016,0.2,20,Low Digitalization,Medium Course ( >15H and <40H )
2097,37,24,13,2015,1016,0.66,66,Medium-High Digitalization,Medium Course ( >15H and <40H )
2098,79,51,28,2015,1016,0.65,65,Medium-High Digitalization,High Course ( >40H )
2099,86,29,57,2015,1016,0.34,34,Medium-Low Digitalization,High Course ( >40H )
2100,60,3,57,2015,1016,0.05,5,Low Digitalization,High Course ( >40H )
2101,11,9,2,2015,1016,0.83,83,High Digitalization,Small Course ( <15H )
2102,35,29,6,2015,1016,0.84,84,High Digitalization,Medium Course ( >15H and <40H )
2103,16,15,1,2015,1016,0.91,91,High Digitalization,Medium Course ( >15H and <40H )
2104,18,15,3,2015,1016,0.84,84,High Digitalization,Medium Course ( >15H and <40H )
2105,14,13,1,2015,1016,0.9,90,High Digitalization,Small Course ( <15H )
2106,71,45,26,2015,1016,0.64,64,Medium-High Digitalization,High Course ( >40H )
2107,22,22,0,2015,1016,0.98,98,High Digitalization,Medium Course ( >15H and <40H )
2108,67,18,49,2015,1016,0.27,27,Medium-Low Digitalization,High Course ( >40H )
2109,44,33,11,2015,1016,0.74,74,Medium-High Digitalization,High Course ( >40H )
2110,17,3,14,2015,1016,0.16,16,Low Digitalization,Medium Course ( >15H and <40H )
2111,12,1,11,2015,1016,0.07,7,Low Digitalization,Small Course ( <15H )
2112,88,1,87,2015,1016,0.01,1,Low Digitalization,High Course ( >40H )
2113,17,2,15,2015,1016,0.13,13,Low Digitalization,Medium Course ( >15H and <40H )
2114,63,56,7,2015,1016,0.89,89,High Digitalization,High Course ( >40H )
2115,58,34,24,2015,1016,0.59,59,Medium-High Digitalization,High Course ( >40H )
2116,7,3,4,2015,1016,0.39,39,Medium-Low Digitalization,Small Course ( <15H )
2117,44,23,21,2015,1016,0.52,52,Medium-High Digitalization,High Course ( >40H )
2118,45,41,4,2015,1016,0.91,91,High Digitalization,High Course ( >40H )
2119,66,66,0,2015,1016,1.0,100,High Digitalization,High Course ( >40H )
2120,84,78,6,2015,1016,0.93,93,High Digitalization,High Course ( >40H )
2121,8,0,8,2015,1016,0.01,1,Low Digitalization,Small Course ( <15H )
2122,15,14,1,2015,1016,0.91,91,High Digitalization,Small Course ( <15H )
2123,16,6,10,2015,1016,0.38,38,Medium-Low Digitalization,Medium Course ( >15H and <40H )
2124,18,3,15,2015,1016,0.18,18,Low Digitalization,Medium Course ( >15H and <40H )
2125,48,18,30,2015,1016,0.38,38,Medium-Low Digitalization,High Course ( >40H )
2126,9,9,0,2015,1016,0.99,99,High Digitalization,Small Course ( <15H )
2127,58,32,26,2015,1016,0.55,55,Medium-High Digitalization,High Course ( >40H )
2128,15,3,12,2015,1016,0.22,22,Medium-Low Digitalization,Small Course ( <15H )
2129,41,32,9,2015,1016,0.78,78,Medium-High Digitalization,High Course ( >40H )
2130,30,23,7,2015,1016,0.78,78,Medium-High Digitalization,Medium Course ( >15H and <40H )
2131,44,22,22,2015,1016,0.49,49,Medium-Low Digitalization,High Course ( >40H )
2132,33,7,26,2015,1016,0.21,21,Medium-Low Digitalization,Medium Course ( >15H and <40H )
2133,27,21,6,2015,1016,0.77,77,Medium-High Digitalization,Medium Course ( >15H and <40H )
2134,15,13,2,2015,1016,0.88,88,High Digitalization,Small Course ( <15H )
2135,26,9,17,2015,1016,0.34,34,Medium-Low Digitalization,Medium Course ( >15H and <40H )
2136,65,57,8,2015,1016,0.88,88,High Digitalization,High Course ( >40H )
2137,43,14,29,2015,1016,0.32,32,Medium-Low Digitalization,High Course ( >40H )
2138,50,26,24,2015,1016,0.53,53,Medium-High Digitalization,High Course ( >40H )
2139,69,32,37,2015,1016,0.46,46,Medium-Low Digitalization,High Course ( >40H )
2140,21,20,1,2015,1016,0.94,94,High Digitalization,Medium Course ( >15H and <40H )
2141,19,12,7,2015,1016,0.62,62,Medium-High Digitalization,Medium Course ( >15H and <40H )
2142,17,6,11,2015,1016,0.33,33,Medium-Low Digitalization,Medium Course ( >15H and <40H )
2143,13,5,8,2015,1016,0.39,39,Medium-Low Digitalization,Small Course ( <15H )
2144,39,24,15,2015,1016,0.62,62,Medium-High Digitalization,Medium Course ( >15H and <40H )
2145,29,23,6,2015,1016,0.78,78,Medium-High Digitalization,Medium Course ( >15H and <40H )
2146,37,3,34,2015,1016,0.09,9,Low Digitalization,Medium Course ( >15H and <40H )
2147,88,62,26,2015,1016,0.7,70,Medium-High Digitalization,High Course ( >40H )
2148,63,14,49,2015,1016,0.22,22,Medium-Low Digitalization,High Course ( >40H )
2149,71,34,37,2015,1016,0.48,48,Medium-Low Digitalization,High Course ( >40H )
2150,83,15,68,2015,1016,0.18,18,Low Digitalization,High Course ( >40H )
2151,83,2,81,2015,1016,0.03,3,Low Digitalization,High Course ( >40H )
2152,17,15,2,2015,1016,0.9,90,High Digitalization,Medium Course ( >15H and <40H )
2153,19,0,19,2015,1016,0.02,2,Low Digitalization,Medium Course ( >15H and <40H )
2154,14,9,5,2015,1016,0.61,61,Medium-High Digitalization,Small Course ( <15H )
2155,76,46,30,2015,1016,0.61,61,Medium-High Digitalization,High Course ( >40H )
2156,35,19,16,2015,1016,0.54,54,Medium-High Digitalization,Medium Course ( >15H and <40H )
2157,33,20,13,2015,1016,0.61,61,Medium-High Digitalization,Medium Course ( >15H and <40H )
2158,13,4,9,2015,1016,0.3,30,Medium-Low Digitalization,Small Course ( <15H )
2159,28,19,9,2015,1016,0.69,69,Medium-High Digitalization,Medium Course ( >15H and <40H )
2160,78,17,61,2015,1016,0.22,22,Medium-Low Digitalization,High Course ( >40H )
2161,35,26,9,2015,1016,0.74,74,Medium-High Digitalization,Medium Course ( >15H and <40H )
2162,14,9,5,2015,1016,0.67,67,Medium-High Digitalization,Small Course ( <15H )
2163,15,3,12,2015,1016,0.19,19,Low Digitalization,Small Course ( <15H )
2164,14,10,4,2015,1016,0.69,69,Medium-High Digitalization,Small Course ( <15H )
2165,5,1,4,2015,1016,0.19,19,Low Digitalization,Small Course ( <15H )
2166,22,11,11,2015,1016,0.5,50,Medium-Low Digitalization,Medium Course ( >15H and <40H )
2167,70,37,33,2015,1016,0.53,53,Medium-High Digitalization,High Course ( >40H )
2168,67,56,11,2015,1016,0.84,84,High Digitalization,High Course ( >40H )
2169,14,13,1,2015,1016,0.95,95,High Digitalization,Small Course ( <15H )
2170,10,6,4,2015,1016,0.62,62,Medium-High Digitalization,Small Course ( <15H )
2171,53,11,42,2015,1016,0.2,20,Low Digitalization,High Course ( >40H )
2172,15,1,14,2015,1016,0.09,9,Low Digitalization,Small Course ( <15H )
2173,10,4,6,2015,1016,0.36,36,Medium-Low Digitalization,Small Course ( <15H )
2174,46,33,13,2015,1016,0.71,71,Medium-High Digitalization,High Course ( >40H )
2175,14,3,11,2015,1016,0.21,21,Medium-Low Digitalization,Small Course ( <15H )
2176,40,2,38,2015,1016,0.04,4,Low Digitalization,High Course ( >40H )
2177,43,43,0,2015,1016,0.99,99,High Digitalization,High Course ( >40H )
2178,6,2,4,2015,1016,0.37,37,Medium-Low Digitalization,Small Course ( <15H )
2179,53,32,21,2015,1016,0.61,61,Medium-High Digitalization,High Course ( >40H )
2180,13,7,6,2015,1016,0.53,53,Medium-High Digitalization,Small Course ( <15H )
2181,11,6,6,2015,1016,0.5,50,Medium-Low Digitalization,Small Course ( <15H )
2182,65,29,36,2015,1016,0.44,44,Medium-Low Digitalization,High Course ( >40H )
2183,12,11,1,2015,1016,0.94,94,High Digitalization,Small Course ( <15H )
2184,32,7,25,2015,1016,0.22,22,Medium-Low Digitalization,Medium Course ( >15H and <40H )
2185,11,1,10,2015,1016,0.12,12,Low Digitalization,Small Course ( <15H )
2186,25,18,6,2015,1016,0.74,74,Medium-High Digitalization,Medium Course ( >15H and <40H )
2187,66,25,41,2015,1016,0.38,38,Medium-Low Digitalization,High Course ( >40H )
2188,27,18,9,2015,1016,0.66,66,Medium-High Digitalization,Medium Course ( >15H and <40H )
2189,89,55,34,2015,1016,0.62,62,Medium-High Digitalization,High Course ( >40H )
2190,54,33,21,2015,1016,0.61,61,Medium-High Digitalization,High Course ( >40H )
2191,68,29,39,2015,1016,0.42,42,Medium-Low Digitalization,High Course ( >40H )
2192,77,64,13,2015,1016,0.83,83,High Digitalization,High Course ( >40H )
2193,6,2,4,2015,1016,0.3,30,Medium-Low Digitalization,Small Course ( <15H )
2194,11,10,1,2015,1016,0.89,89,High Digitalization,Small Course ( <15H )
2195,23,22,1,2015,1016,0.97,97,High Digitalization,Medium Course ( >15H and <40H )
2196,89,38,51,2015,1016,0.43,43,Medium-Low Digitalization,High Course ( >40H )
2197,55,32,23,2015,1016,0.59,59,Medium-High Digitalization,High Course ( >40H )
2198,12,3,9,2015,1016,0.23,23,Medium-Low Digitalization,Small Course ( <15H )
2199,28,6,22,2015,1016,0.2,20,Low Digitalization,Medium Course ( >15H and <40H )
2200,67,60,7,2015,1016,0.9,90,High Digitalization,High Course ( >40H )
2201,83,2,81,2015,1016,0.02,2,Low Digitalization,High Course ( >40H )
2202,34,32,2,2015,1016,0.93,93,High Digitalization,Medium Course ( >15H and <40H )
2203,56,36,20,2015,1016,0.65,65,Medium-High Digitalization,High Course ( >40H )
2204,62,23,39,2015,1016,0.37,37,Medium-Low Digitalization,High Course ( >40H )
2205,40,23,17,2015,1016,0.58,57,Medium-High Digitalization,High Course ( >40H )
2206,29,19,10,2015,1016,0.66,66,Medium-High Digitalization,Medium Course ( >15H and <40H )
2207,18,9,9,2015,1016,0.52,52,Medium-High Digitalization,Medium Course ( >15H and <40H )
2208,27,13,14,2015,1016,0.47,47,Medium-Low Digitalization,Medium Course ( >15H and <40H )
2209,15,14,1,2015,1016,0.96,96,High Digitalization,Small Course ( <15H )
2210,52,38,14,2015,1016,0.73,73,Medium-High Digitalization,High Course ( >40H )
2211,33,12,21,2015,1016,0.35,35,Medium-Low Digitalization,Medium Course ( >15H and <40H )
2212,80,25,55,2015,1016,0.31,31,Medium-Low Digitalization,High Course ( >40H )
2213,13,6,7,2015,1016,0.47,47,Medium-Low Digitalization,Small Course ( <15H )
2214,71,70,1,2015,1016,0.99,99,High Digitalization,High Course ( >40H )
2215,32,10,22,2015,1016,0.32,32,Medium-Low Digitalization,Medium Course ( >15H and <40H )
2216,33,13,20,2015,1016,0.4,40,Medium-Low Digitalization,Medium Course ( >15H and <40H )
2217,68,51,17,2015,1016,0.75,75,Medium-High Digitalization,High Course ( >40H )
2218,64,34,30,2015,1016,0.53,53,Medium-High Digitalization,High Course ( >40H )
2219,51,38,13,2015,1016,0.75,75,Medium-High Digitalization,High Course ( >40H )
2220,15,12,3,2015,1016,0.81,81,High Digitalization,Small Course ( <15H )
2221,14,7,7,2015,1016,0.5,50,Medium-Low Digitalization,Small Course ( <15H )
2222,5,5,0,2015,1016,0.96,96,High Digitalization,Small Course ( <15H )
2223,39,21,18,2015,1016,0.53,53,Medium-High Digitalization,Medium Course ( >15H and <40H )
2224,11,0,11,2015,1016,0.02,2,Low Digitalization,Small Course ( <15H )
2225,20,18,2,2015,1016,0.92,92,High Digitalization,Medium Course ( >15H and <40H )
2226,48,37,11,2015,1016,0.78,78,Medium-High Digitalization,High Course ( >40H )
2227,46,2,44,2015,1016,0.04,4,Low Digitalization,High Course ( >40H )
2228,20,2,18,2015,1016,0.12,12,Low Digitalization,Medium Course ( >15H and <40H )
2229,57,5,52,2015,1016,0.08,8,Low Digitalization,High Course ( >40H )
2230,42,22,20,2015,1016,0.52,52,Medium-High Digitalization,High Course ( >40H )
2231,77,31,46,2015,1016,0.4,40,Medium-Low Digitalization,High Course ( >40H )
2232,5,4,1,2015,1016,0.82,82,High Digitalization,Small Course ( <15H )
2233,43,16,27,2015,1016,0.37,37,Medium-Low Digitalization,High Course ( >40H )
2234,52,34,18,2015,1016,0.66,66,Medium-High Digitalization,High Course ( >40H )
2235,71,33,38,2015,1016,0.46,46,Medium-Low Digitalization,High Course ( >40H )
2236,77,36,41,2015,1016,0.47,47,Medium-Low Digitalization,High Course ( >40H )
2237,9,7,2,2015,1016,0.79,79,Medium-High Digitalization,Small Course ( <15H )
2238,7,2,5,2015,1016,0.33,33,Medium-Low Digitalization,Small Course ( <15H )
2239,11,7,4,2015,1016,0.68,68,Medium-High Digitalization,Small Course ( <15H )
2240,60,12,48,2015,1016,0.2,20,Low Digitalization,High Course ( >40H )
2241,13,5,8,2015,1016,0.37,37,Medium-Low Digitalization,Small Course ( <15H )
2242,75,46,28,2015,1016,0.62,62,Medium-High Digitalization,High Course ( >40H )
2243,62,30,32,2015,1016,0.49,49,Medium-Low Digitalization,High Course ( >40H )
2244,40,31,9,2015,1016,0.77,77,Medium-High Digitalization,High Course ( >40H )
2245,55,14,41,2015,1016,0.26,26,Medium-Low Digitalization,High Course ( >40H )
2246,14,13,1,2015,1016,0.96,96,High Digitalization,Small Course ( <15H )
2247,6,5,1,2015,1016,0.9,90,High Digitalization,Small Course ( <15H )
2248,5,3,2,2015,1016,0.66,66,Medium-High Digitalization,Small Course ( <15H )
2249,22,13,9,2015,1016,0.6,60,Medium-High Digitalization,Medium Course ( >15H and <40H )
2250,50,22,28,2015,1016,0.44,44,Medium-Low Digitalization,High Course ( >40H )
2251,12,2,10,2015,1016,0.17,17,Low Digitalization,Small Course ( <15H )
2252,34,19,15,2015,1016,0.55,55,Medium-High Digitalization,Medium Course ( >15H and <40H )
2253,48,46,2,2015,1016,0.96,96,High Digitalization,High Course ( >40H )
2254,90,56,34,2015,1016,0.62,62,Medium-High Digitalization,High Course ( >40H )
2255,28,6,22,2015,1016,0.21,21,Medium-Low Digitalization,Medium Course ( >15H and <40H )
2256,58,37,21,2015,1016,0.64,64,Medium-High Digitalization,High Course ( >40H )
2257,17,16,1,2015,1016,0.93,93,High Digitalization,Medium Course ( >15H and <40H )
2258,11,5,6,2015,1016,0.48,48,Medium-Low Digitalization,Small Course ( <15H )
2259,40,29,11,2015,1016,0.73,73,Medium-High Digitalization,High Course ( >40H )
2260,46,13,33,2015,1016,0.28,28,Medium-Low Digitalization,High Course ( >40H )
2261,6,5,1,2015,1016,0.81,81,High Digitalization,Small Course ( <15H )
2262,74,56,18,2015,1016,0.76,76,Medium-High Digitalization,High Course ( >40H )
2263,49,43,6,2015,1016,0.88,88,High Digitalization,High Course ( >40H )
2264,78,76,2,2015,1016,0.98,98,High Digitalization,High Course ( >40H )
2265,25,22,3,2015,1016,0.88,88,High Digitalization,Medium Course ( >15H and <40H )
2266,12,1,11,2015,1016,0.07,7,Low Digitalization,Small Course ( <15H )
2267,53,45,8,2015,1016,0.85,85,High Digitalization,High Course ( >40H )
2268,8,2,6,2015,1016,0.19,19,Low Digitalization,Small Course ( <15H )
2269,42,10,32,2015,1016,0.23,23,Medium-Low Digitalization,High Course ( >40H )
2270,67,16,51,2015,1016,0.24,24,Medium-Low Digitalization,High Course ( >40H )
2271,67,49,18,2015,1016,0.73,73,Medium-High Digitalization,High Course ( >40H )
2272,32,20,12,2015,1016,0.62,62,Medium-High Digitalization,Medium Course ( >15H and <40H )
2273,30,4,26,2015,1016,0.14,14,Low Digitalization,Medium Course ( >15H and <40H )
2274,89,40,49,2015,1016,0.45,45,Medium-Low Digitalization,High Course ( >40H )
2275,69,6,63,2015,1016,0.09,9,Low Digitalization,High Course ( >40H )
2276,88,60,28,2015,1016,0.68,68,Medium-High Digitalization,High Course ( >40H )
2277,25,23,2,2015,1016,0.93,93,High Digitalization,Medium Course ( >15H and <40H )
2278,6,3,3,2015,1016,0.45,45,Medium-Low Digitalization,Small Course ( <15H )
2279,14,9,5,2015,1016,0.61,61,Medium-High Digitalization,Small Course ( <15H )
2280,88,77,11,2015,1016,0.88,88,High Digitalization,High Course ( >40H )
2281,8,8,0,2015,1016,0.99,99,High Digitalization,Small Course ( <15H )
2282,18,13,5,2015,1016,0.74,74,Medium-High Digitalization,Medium Course ( >15H and <40H )
2283,61,48,13,2015,1016,0.79,79,Medium-High Digitalization,High Course ( >40H )
2284,76,58,18,2015,1016,0.76,76,Medium-High Digitalization,High Course ( >40H )
2285,14,7,7,2015,1016,0.52,52,Medium-High Digitalization,Small Course ( <15H )
2286,90,42,48,2015,1016,0.47,47,Medium-Low Digitalization,High Course ( >40H )
2287,65,8,57,2015,1016,0.13,13,Low Digitalization,High Course ( >40H )
2288,81,58,23,2015,1016,0.72,72,Medium-High Digitalization,High Course ( >40H )
2289,17,1,16,2015,1016,0.05,5,Low Digitalization,Medium Course ( >15H and <40H )
2290,77,54,23,2015,1016,0.7,70,Medium-High Digitalization,High Course ( >40H )
2291,15,3,12,2015,1016,0.19,19,Low Digitalization,Small Course ( <15H )
2292,8,5,3,2015,1016,0.66,66,Medium-High Digitalization,Small Course ( <15H )
2293,26,18,8,2015,1016,0.7,70,Medium-High Digitalization,Medium Course ( >15H and <40H )
2294,87,39,48,2015,1016,0.45,45,Medium-Low Digitalization,High Course ( >40H )
2295,12,4,8,2015,1016,0.37,37,Medium-Low Digitalization,Small Course ( <15H )
2296,44,20,24,2015,1016,0.45,45,Medium-Low Digitalization,High Course ( >40H )
2297,33,33,0,2015,1016,0.99,99,High Digitalization,Medium Course ( >15H and <40H )
2298,38,27,11,2015,1016,0.72,72,Medium-High Digitalization,Medium Course ( >15H and <40H )
2299,6,1,5,2015,1016,0.17,17,Low Digitalization,Small Course ( <15H )
2300,76,27,49,2015,1016,0.35,35,Medium-Low Digitalization,High Course ( >40H )
2301,89,44,44,2015,1016,0.5,50,Medium-Low Digitalization,High Course ( >40H )
2302,47,9,38,2015,1016,0.19,19,Low Digitalization,High Course ( >40H )
2303,11,4,7,2015,1016,0.37,37,Medium-Low Digitalization,Small Course ( <15H )
2304,5,2,3,2015,1016,0.35,35,Medium-Low Digitalization,Small Course ( <15H )
2305,6,0,6,2015,1016,0.01,1,Low Digitalization,Small Course ( <15H )
2306,75,32,44,2015,1016,0.42,42,Medium-Low Digitalization,High Course ( >40H )
2307,12,2,10,2015,1016,0.15,15,Low Digitalization,Small Course ( <15H )
2308,55,10,45,2015,1016,0.19,19,Low Digitalization,High Course ( >40H )
2309,17,7,10,2015,1016,0.42,42,Medium-Low Digitalization,Medium Course ( >15H and <40H )
2310,54,15,39,2015,1016,0.28,28,Medium-Low Digitalization,High Course ( >40H )
2311,9,5,4,2015,1016,0.57,56,Medium-High Digitalization,Small Course ( <15H )
2312,83,16,67,2015,1016,0.19,19,Low Digitalization,High Course ( >40H )
2313,31,26,5,2015,1016,0.85,85,High Digitalization,Medium Course ( >15H and <40H )
2314,36,30,6,2015,1016,0.84,84,High Digitalization,Medium Course ( >15H and <40H )
2315,54,6,48,2015,1016,0.11,11,Low Digitalization,High Course ( >40H )
2316,28,19,9,2015,1016,0.68,68,Medium-High Digitalization,Medium Course ( >15H and <40H )
2317,78,47,31,2015,1016,0.6,60,Medium-High Digitalization,High Course ( >40H )
2318,27,2,25,2015,1016,0.08,8,Low Digitalization,Medium Course ( >15H and <40H )
2319,83,57,26,2015,1016,0.69,69,Medium-High Digitalization,High Course ( >40H )
2320,9,2,7,2015,1016,0.22,22,Medium-Low Digitalization,Small Course ( <15H )
2321,51,35,16,2015,1016,0.68,68,Medium-High Digitalization,High Course ( >40H )
2322,39,38,1,2015,1016,0.97,97,High Digitalization,Medium Course ( >15H and <40H )
2323,13,3,10,2015,1016,0.2,20,Low Digitalization,Small Course ( <15H )
2324,28,12,16,2015,1016,0.44,44,Medium-Low Digitalization,Medium Course ( >15H and <40H )
2325,9,6,3,2015,1016,0.67,67,Medium-High Digitalization,Small Course ( <15H )
2326,13,4,9,2015,1016,0.34,34,Medium-Low Digitalization,Small Course ( <15H )
2327,47,34,13,2015,1016,0.73,73,Medium-High Digitalization,High Course ( >40H )
2328,15,1,14,2015,1016,0.05,5,Low Digitalization,Small Course ( <15H )
2329,6,2,4,2015,1016,0.34,34,Medium-Low Digitalization,Small Course ( <15H )
2330,5,1,4,2015,1016,0.18,18,Low Digitalization,Small Course ( <15H )
2331,48,44,4,2015,1016,0.92,92,High Digitalization,High Course ( >40H )
2332,15,14,1,2015,1016,0.91,91,High Digitalization,Small Course ( <15H )
2333,29,19,10,2015,1016,0.65,65,Medium-High Digitalization,Medium Course ( >15H and <40H )
2334,72,48,24,2015,1016,0.67,67,Medium-High Digitalization,High Course ( >40H )
2335,90,53,37,2015,1016,0.59,59,Medium-High Digitalization,High Course ( >40H )
2336,11,10,1,2015,1016,0.91,91,High Digitalization,Small Course ( <15H )
2337,40,31,9,2015,1016,0.77,77,Medium-High Digitalization,High Course ( >40H )
2338,30,6,24,2015,1016,0.21,21,Medium-Low Digitalization,Medium Course ( >15H and <40H )
2339,68,1,67,2015,1016,0.01,1,Low Digitalization,High Course ( >40H )
2340,54,36,18,2015,1016,0.66,66,Medium-High Digitalization,High Course ( >40H )
2341,37,7,30,2015,1016,0.18,18,Low Digitalization,Medium Course ( >15H and <40H )
2342,73,18,55,2015,1016,0.25,25,Medium-Low Digitalization,High Course ( >40H )
2343,67,38,29,2015,1016,0.56,56,Medium-High Digitalization,High Course ( >40H )
2344,30,19,11,2015,1016,0.62,62,Medium-High Digitalization,Medium Course ( >15H and <40H )
2345,40,33,7,2015,1016,0.83,83,High Digitalization,High Course ( >40H )
2346,25,21,4,2015,1016,0.84,84,High Digitalization,Medium Course ( >15H and <40H )
2347,73,46,27,2015,1016,0.63,63,Medium-High Digitalization,High Course ( >40H )
2348,11,8,3,2015,1016,0.7,70,Medium-High Digitalization,Small Course ( <15H )
2349,32,4,28,2015,1016,0.14,14,Low Digitalization,Medium Course ( >15H and <40H )
2350,35,26,9,2015,1016,0.74,74,Medium-High Digitalization,Medium Course ( >15H and <40H )
2351,28,5,23,2015,1016,0.18,18,Low Digitalization,Medium Course ( >15H and <40H )
2352,36,10,26,2015,1016,0.29,28,Medium-Low Digitalization,Medium Course ( >15H and <40H )
2353,19,8,11,2015,1016,0.4,40,Medium-Low Digitalization,Medium Course ( >15H and <40H )
2354,55,6,50,2015,1016,0.1,10,Low Digitalization,High Course ( >40H )
2355,12,10,2,2015,1016,0.84,84,High Digitalization,Small Course ( <15H )
2356,12,2,10,2015,1016,0.19,19,Low Digitalization,Small Course ( <15H )
2357,19,8,11,2015,1016,0.43,43,Medium-Low Digitalization,Medium Course ( >15H and <40H )
2358,32,2,30,2015,1016,0.07,7,Low Digitalization,Medium Course ( >15H and <40H )
2359,90,68,22,2015,1016,0.76,76,Medium-High Digitalization,High Course ( >40H )
2360,28,20,8,2015,1016,0.7,70,Medium-High Digitalization,Medium Course ( >15H and <40H )
2361,36,32,4,2015,1016,0.9,90,High Digitalization,Medium Course ( >15H and <40H )
2362,27,11,16,2015,1016,0.42,42,Medium-Low Digitalization,Medium Course ( >15H and <40H )
2363,53,10,43,2015,1016,0.19,19,Low Digitalization,High Course ( >40H )
2364,10,3,7,2015,1016,0.27,27,Medium-Low Digitalization,Small Course ( <15H )
2365,8,5,3,2015,1016,0.63,63,Medium-High Digitalization,Small Course ( <15H )
2366,21,0,21,2015,1016,0.02,2,Low Digitalization,Medium Course ( >15H and <40H )
2367,87,42,45,2015,1016,0.48,48,Medium-Low Digitalization,High Course ( >40H )
2368,73,70,3,2015,1016,0.96,96,High Digitalization,High Course ( >40H )
2369,57,32,25,2015,1016,0.56,56,Medium-High Digitalization,High Course ( >40H )
2370,35,1,34,2015,1016,0.04,4,Low Digitalization,Medium Course ( >15H and <40H )
2371,21,15,6,2015,1016,0.7,70,Medium-High Digitalization,Medium Course ( >15H and <40H )
2372,41,40,1,2015,1016,0.97,97,High Digitalization,High Course ( >40H )
2373,8,5,3,2015,1016,0.61,61,Medium-High Digitalization,Small Course ( <15H )
2374,10,9,1,2015,1016,0.89,89,High Digitalization,Small Course ( <15H )
2375,65,42,23,2015,1016,0.64,64,Medium-High Digitalization,High Course ( >40H )
2376,5,4,1,2015,1016,0.73,73,Medium-High Digitalization,Small Course ( <15H )
2377,17,3,14,2015,1016,0.18,18,Low Digitalization,Medium Course ( >15H and <40H )
2378,51,28,23,2015,1016,0.54,54,Medium-High Digitalization,High Course ( >40H )
2379,79,7,72,2015,1016,0.09,9,Low Digitalization,High Course ( >40H )
2380,47,21,26,2015,1016,0.44,44,Medium-Low Digitalization,High Course ( >40H )
2381,15,14,1,2015,1016,0.91,91,High Digitalization,Small Course ( <15H )
2382,37,4,33,2015,1016,0.11,11,Low Digitalization,Medium Course ( >15H and <40H )
2383,46,42,4,2015,1016,0.91,91,High Digitalization,High Course ( >40H )
2384,15,1,14,2015,1016,0.06,6,Low Digitalization,Small Course ( <15H )
2385,52,51,1,2015,1016,0.98,98,High Digitalization,High Course ( >40H )
2386,10,1,9,2015,1016,0.09,9,Low Digitalization,Small Course ( <15H )
2387,30,8,22,2015,1016,0.27,27,Medium-Low Digitalization,Medium Course ( >15H and <40H )
2388,38,33,5,2015,1016,0.88,88,High Digitalization,Medium Course ( >15H and <40H )
2389,20,15,5,2015,1016,0.77,77,Medium-High Digitalization,Medium Course ( >15H and <40H )
2390,7,1,6,2015,1016,0.08,8,Low Digitalization,Small Course ( <15H )
2391,27,7,20,2015,1016,0.25,25,Medium-Low Digitalization,Medium Course ( >15H and <40H )
2392,25,4,21,2015,1016,0.15,15,Low Digitalization,Medium Course ( >15H and <40H )
2393,46,25,21,2015,1016,0.54,54,Medium-High Digitalization,High Course ( >40H )
2394,5,2,3,2015,1016,0.41,41,Medium-Low Digitalization,Small Course ( <15H )
2395,51,3,48,2015,1016,0.06,6,Low Digitalization,High Course ( >40H )
2396,23,23,0,2015,1016,0.98,98,High Digitalization,Medium Course ( >15H and <40H )
2397,34,6,28,2015,1016,0.19,19,Low Digitalization,Medium Course ( >15H and <40H )
2398,33,6,27,2015,1016,0.18,18,Low Digitalization,Medium Course ( >15H and <40H )
2399,7,2,5,2015,1016,0.27,27,Medium-Low Digitalization,Small Course ( <15H )
2400,12,3,9,2015,1016,0.28,28,Medium-Low Digitalization,Small Course ( <15H )
2401,26,1,25,2015,1016,0.04,4,Low Digitalization,Medium Course ( >15H and <40H )
2402,7,4,3,2015,1016,0.51,51,Medium-High Digitalization,Small Course ( <15H )
2403,32,13,19,2015,1016,0.41,41,Medium-Low Digitalization,Medium Course ( >15H and <40H )
2404,43,38,5,2015,1016,0.88,88,High Digitalization,High Course ( >40H )
2405,7,0,7,2015,1016,0.06,6,Low Digitalization,Small Course ( <15H )
2406,9,8,1,2015,1016,0.9,90,High Digitalization,Small Course ( <15H )
2407,72,4,68,2015,1016,0.05,5,Low Digitalization,High Course ( >40H )
2408,7,3,4,2015,1016,0.42,42,Medium-Low Digitalization,Small Course ( <15H )
2409,10,2,8,2015,1016,0.22,22,Medium-Low Digitalization,Small Course ( <15H )
2410,55,44,11,2015,1016,0.8,80,Medium-High Digitalization,High Course ( >40H )
2411,88,63,25,2015,1016,0.72,72,Medium-High Digitalization,High Course ( >40H )
2412,11,6,5,2015,1016,0.54,54,Medium-High Digitalization,Small Course ( <15H )
2413,74,48,26,2015,1016,0.65,65,Medium-High Digitalization,High Course ( >40H )
2414,74,7,67,2015,1016,0.09,9,Low Digitalization,High Course ( >40H )
2415,11,4,7,2015,1016,0.34,34,Medium-Low Digitalization,Small Course ( <15H )
2416,49,20,29,2015,1016,0.41,41,Medium-Low Digitalization,High Course ( >40H )
2417,57,10,47,2015,1016,0.18,18,Low Digitalization,High Course ( >40H )
2418,13,10,3,2015,1016,0.76,76,Medium-High Digitalization,Small Course ( <15H )
2419,24,23,1,2015,1016,0.97,97,High Digitalization,Medium Course ( >15H and <40H )
2420,17,7,10,2015,1016,0.43,43,Medium-Low Digitalization,Medium Course ( >15H and <40H )
2421,18,16,2,2015,1016,0.9,90,High Digitalization,Medium Course ( >15H and <40H )
2422,82,79,3,2015,1016,0.96,96,High Digitalization,High Course ( >40H )
2423,38,15,23,2015,1016,0.4,40,Medium-Low Digitalization,Medium Course ( >15H and <40H )
2424,65,41,24,2015,1016,0.63,63,Medium-High Digitalization,High Course ( >40H )
2425,44,31,13,2015,1016,0.7,70,Medium-High Digitalization,High Course ( >40H )
2426,67,3,64,2015,1016,0.05,5,Low Digitalization,High Course ( >40H )
2427,52,28,24,2015,1016,0.53,53,Medium-High Digitalization,High Course ( >40H )
2428,16,4,12,2015,1016,0.28,28,Medium-Low Digitalization,Medium Course ( >15H and <40H )
2429,5,1,4,2015,1016,0.29,28,Medium-Low Digitalization,Small Course ( <15H )
2430,19,14,5,2015,1016,0.72,72,Medium-High Digitalization,Medium Course ( >15H and <40H )
2431,59,18,41,2015,1016,0.3,30,Medium-Low Digitalization,High Course ( >40H )
2432,47,39,8,2015,1016,0.84,84,High Digitalization,High Course ( >40H )
2433,39,0,39,2015,1016,0.01,1,Low Digitalization,Medium Course ( >15H and <40H )
2434,46,11,35,2015,1016,0.23,23,Medium-Low Digitalization,High Course ( >40H )
2435,34,29,5,2015,1016,0.85,85,High Digitalization,Medium Course ( >15H and <40H )
2436,41,26,15,2015,1016,0.63,63,Medium-High Digitalization,High Course ( >40H )
2437,53,17,36,2015,1016,0.32,32,Medium-Low Digitalization,High Course ( >40H )
2438,58,40,18,2015,1016,0.69,69,Medium-High Digitalization,High Course ( >40H )
2439,10,2,8,2015,1016,0.15,15,Low Digitalization,Small Course ( <15H )
2440,57,15,42,2015,1016,0.27,27,Medium-Low Digitalization,High Course ( >40H )
2441,12,9,3,2015,1016,0.76,76,Medium-High Digitalization,Small Course ( <15H )
2442,84,20,64,2015,1016,0.24,24,Medium-Low Digitalization,High Course ( >40H )
2443,77,55,22,2015,1016,0.72,72,Medium-High Digitalization,High Course ( >40H )
2444,13,13,0,2015,1016,0.97,97,High Digitalization,Small Course ( <15H )
2445,24,12,12,2015,1016,0.52,52,Medium-High Digitalization,Medium Course ( >15H and <40H )
2446,60,26,34,2015,1016,0.44,44,Medium-Low Digitalization,High Course ( >40H )
2447,38,6,32,2015,1016,0.17,17,Low Digitalization,Medium Course ( >15H and <40H )
2448,30,22,8,2015,1016,0.73,73,Medium-High Digitalization,Medium Course ( >15H and <40H )
2449,37,17,20,2015,1016,0.46,46,Medium-Low Digitalization,Medium Course ( >15H and <40H )
2450,12,3,9,2015,1016,0.24,24,Medium-Low Digitalization,Small Course ( <15H )
2451,22,2,20,2015,1016,0.07,7,Low Digitalization,Medium Course ( >15H and <40H )
2452,44,17,27,2015,1016,0.38,38,Medium-Low Digitalization,High Course ( >40H )
2453,48,17,31,2015,1016,0.35,35,Medium-Low Digitalization,High Course ( >40H )
2454,69,64,5,2015,1016,0.93,93,High Digitalization,High Course ( >40H )
2455,27,1,26,2015,1016,0.03,3,Low Digitalization,Medium Course ( >15H and <40H )
2456,44,24,20,2015,1016,0.55,55,Medium-High Digitalization,High Course ( >40H )
2457,40,34,6,2015,1016,0.85,85,High Digitalization,High Course ( >40H )
2458,33,10,23,2015,1016,0.29,28,Medium-Low Digitalization,Medium Course ( >15H and <40H )
2459,57,23,34,2015,1016,0.41,41,Medium-Low Digitalization,High Course ( >40H )
2460,6,3,3,2015,1016,0.53,53,Medium-High Digitalization,Small Course ( <15H )
2461,6,5,1,2015,1016,0.76,76,Medium-High Digitalization,Small Course ( <15H )
2462,56,2,54,2015,1016,0.03,3,Low Digitalization,High Course ( >40H )
2463,68,0,68,2015,1016,0.0,0,Low Digitalization,High Course ( >40H )
2464,5,4,1,2015,1016,0.79,79,Medium-High Digitalization,Small Course ( <15H )
2465,6,4,2,2015,1016,0.74,74,Medium-High Digitalization,Small Course ( <15H )
2466,42,38,4,2015,1016,0.9,90,High Digitalization,High Course ( >40H )
2467,57,55,2,2015,1016,0.96,96,High Digitalization,High Course ( >40H )
2468,14,13,1,2015,1016,0.91,91,High Digitalization,Small Course ( <15H )
2469,6,2,4,2015,1016,0.38,38,Medium-Low Digitalization,Small Course ( <15H )
2470,49,31,18,2015,1016,0.63,63,Medium-High Digitalization,High Course ( >40H )
2471,8,4,4,2015,1016,0.47,47,Medium-Low Digitalization,Small Course ( <15H )
2472,30,27,3,2015,1016,0.89,89,High Digitalization,Medium Course ( >15H and <40H )
2473,53,20,33,2015,1016,0.37,37,Medium-Low Digitalization,High Course ( >40H )
2474,83,35,48,2015,1016,0.42,42,Medium-Low Digitalization,High Course ( >40H )
2475,57,13,44,2015,1016,0.22,22,Medium-Low Digitalization,High Course ( >40H )
2476,11,5,6,2015,1016,0.43,43,Medium-Low Digitalization,Small Course ( <15H )
2477,71,25,46,2015,1016,0.35,35,Medium-Low Digitalization,High Course ( >40H )
2478,60,50,10,2015,1016,0.84,84,High Digitalization,High Course ( >40H )
2479,55,49,6,2015,1016,0.89,89,High Digitalization,High Course ( >40H )
2480,54,4,50,2015,1016,0.07,7,Low Digitalization,High Course ( >40H )
2481,90,66,24,2015,1016,0.73,73,Medium-High Digitalization,High Course ( >40H )
2482,24,4,20,2015,1016,0.17,17,Low Digitalization,Medium Course ( >15H and <40H )
2483,30,10,20,2015,1016,0.35,35,Medium-Low Digitalization,Medium Course ( >15H and <40H )
2484,26,22,4,2015,1016,0.86,86,High Digitalization,Medium Course ( >15H and <40H )
2485,37,30,7,2015,1016,0.8,80,Medium-High Digitalization,Medium Course ( >15H and <40H )
2486,6,2,4,2015,1016,0.38,38,Medium-Low Digitalization,Small Course ( <15H )
2487,24,6,18,2015,1016,0.24,24,Medium-Low Digitalization,Medium Course ( >15H and <40H )
2488,7,1,6,2015,1016,0.12,12,Low Digitalization,Small Course ( <15H )
2489,67,23,44,2015,1016,0.34,34,Medium-Low Digitalization,High Course ( >40H )
2490,47,40,7,2015,1016,0.85,85,High Digitalization,High Course ( >40H )
2491,21,2,19,2015,1016,0.1,10,Low Digitalization,Medium Course ( >15H and <40H )
2492,33,19,14,2015,1016,0.59,59,Medium-High Digitalization,Medium Course ( >15H and <40H )
2493,12,10,2,2015,1016,0.86,86,High Digitalization,Small Course ( <15H )
2494,62,40,22,2015,1016,0.65,65,Medium-High Digitalization,High Course ( >40H )
2495,47,13,34,2015,1016,0.27,27,Medium-Low Digitalization,High Course ( >40H )
2496,82,29,53,2015,1016,0.35,35,Medium-Low Digitalization,High Course ( >40H )
2497,28,15,13,2015,1016,0.52,52,Medium-High Digitalization,Medium Course ( >15H and <40H )
2498,12,1,11,2015,1016,0.07,7,Low Digitalization,Small Course ( <15H )
2499,70,35,35,2015,1016,0.5,50,Medium-Low Digitalization,High Course ( >40H )
2500,15,12,3,2015,1016,0.83,83,High Digitalization,Small Course ( <15H )
2501,61,57,4,2015,1016,0.94,94,High Digitalization,High Course ( >40H )
2502,12,6,6,2015,1016,0.52,52,Medium-High Digitalization,Small Course ( <15H )
2503,6,5,1,2015,1016,0.83,83,High Digitalization,Small Course ( <15H )
2504,5,0,5,2015,1016,0.03,3,Low Digitalization,Small Course ( <15H )
2505,31,28,3,2015,1016,0.89,89,High Digitalization,Medium Course ( >15H and <40H )
2506,84,22,62,2015,1016,0.26,26,Medium-Low Digitalization,High Course ( >40H )
2507,15,1,14,2015,1016,0.07,7,Low Digitalization,Small Course ( <15H )
2508,44,24,20,2015,1016,0.55,55,Medium-High Digitalization,High Course ( >40H )
2509,36,0,36,2015,1016,0.0,0,Low Digitalization,Medium Course ( >15H and <40H )
2510,26,12,14,2015,1016,0.45,45,Medium-Low Digitalization,Medium Course ( >15H and <40H )
2511,77,55,22,2015,1016,0.72,72,Medium-High Digitalization,High Course ( >40H )
2512,11,3,8,2015,1016,0.26,26,Medium-Low Digitalization,Small Course ( <15H )
2513,18,4,14,2015,1016,0.24,24,Medium-Low Digitalization,Medium Course ( >15H and <40H )
2514,15,15,0,2015,1016,0.99,99,High Digitalization,Small Course ( <15H )
2515,65,24,41,2015,1016,0.37,37,Medium-Low Digitalization,High Course ( >40H )
2516,60,43,17,2015,1016,0.72,72,Medium-High Digitalization,High Course ( >40H )
2517,6,3,3,2015,1016,0.57,56,Medium-High Digitalization,Small Course ( <15H )
2518,24,5,19,2015,1016,0.22,22,Medium-Low Digitalization,Medium Course ( >15H and <40H )
2519,32,8,24,2015,1016,0.26,26,Medium-Low Digitalization,Medium Course ( >15H and <40H )
2520,30,4,26,2015,1016,0.13,13,Low Digitalization,Medium Course ( >15H and <40H )
2521,62,23,39,2015,1016,0.37,37,Medium-Low Digitalization,High Course ( >40H )
2522,48,29,19,2015,1016,0.6,60,Medium-High Digitalization,High Course ( >40H )
2523,42,34,8,2015,1016,0.82,82,High Digitalization,High Course ( >40H )
2524,36,35,1,2015,1016,0.98,98,High Digitalization,Medium Course ( >15H and <40H )
2525,10,7,3,2015,1016,0.69,69,Medium-High Digitalization,Small Course ( <15H )
2526,5,0,5,2015,1016,0.03,3,Low Digitalization,Small Course ( <15H )
2527,29,26,3,2015,1016,0.91,91,High Digitalization,Medium Course ( >15H and <40H )
2528,12,1,11,2015,1016,0.05,5,Low Digitalization,Small Course ( <15H )
2529,12,5,7,2015,1016,0.43,43,Medium-Low Digitalization,Small Course ( <15H )
2530,15,9,6,2015,1016,0.63,63,Medium-High Digitalization,Small Course ( <15H )
2531,12,6,6,2015,1016,0.53,53,Medium-High Digitalization,Small Course ( <15H )
2532,55,14,41,2015,1016,0.25,25,Medium-Low Digitalization,High Course ( >40H )
2533,74,47,27,2015,1016,0.64,64,Medium-High Digitalization,High Course ( >40H )
2534,29,4,25,2015,1016,0.14,14,Low Digitalization,Medium Course ( >15H and <40H )
2535,5,0,5,2015,1016,0.03,3,Low Digitalization,Small Course ( <15H )
2536,5,5,0,2015,1016,0.92,92,High Digitalization,Small Course ( <15H )
2537,36,4,32,2015,1016,0.12,12,Low Digitalization,Medium Course ( >15H and <40H )
2538,17,16,1,2015,1016,0.97,97,High Digitalization,Medium Course ( >15H and <40H )
2539,49,30,19,2015,1016,0.62,62,Medium-High Digitalization,High Course ( >40H )
2540,9,6,3,2015,1016,0.65,65,Medium-High Digitalization,Small Course ( <15H )
2541,49,16,33,2015,1016,0.33,33,Medium-Low Digitalization,High Course ( >40H )
2542,46,30,16,2015,1016,0.65,65,Medium-High Digitalization,High Course ( >40H )
2543,68,6,62,2015,1016,0.09,9,Low Digitalization,High Course ( >40H )
2544,51,32,19,2015,1016,0.63,63,Medium-High Digitalization,High Course ( >40H )
2545,12,12,0,2015,1016,0.99,99,High Digitalization,Small Course ( <15H )
2546,5,4,1,2015,1016,0.88,88,High Digitalization,Small Course ( <15H )
2547,8,5,3,2015,1016,0.62,62,Medium-High Digitalization,Small Course ( <15H )
2548,66,33,33,2015,1016,0.5,50,Medium-Low Digitalization,High Course ( >40H )
2549,82,76,6,2015,1016,0.93,93,High Digitalization,High Course ( >40H )
2550,8,8,0,2015,1016,0.95,95,High Digitalization,Small Course ( <15H )
2551,35,30,5,2015,1016,0.85,85,High Digitalization,Medium Course ( >15H and <40H )
2552,15,0,15,2015,1016,0.03,3,Low Digitalization,Small Course ( <15H )
2553,6,1,5,2015,1016,0.11,11,Low Digitalization,Small Course ( <15H )
2554,25,13,12,2015,1016,0.53,53,Medium-High Digitalization,Medium Course ( >15H and <40H )
2555,9,3,6,2015,1016,0.31,31,Medium-Low Digitalization,Small Course ( <15H )
2556,29,18,11,2015,1016,0.61,61,Medium-High Digitalization,Medium Course ( >15H and <40H )
2557,14,9,5,2015,1016,0.61,61,Medium-High Digitalization,Small Course ( <15H )
2558,22,9,13,2015,1016,0.42,42,Medium-Low Digitalization,Medium Course ( >15H and <40H )
2559,38,20,18,2015,1016,0.53,53,Medium-High Digitalization,Medium Course ( >15H and <40H )
2560,42,42,0,2015,1016,0.99,99,High Digitalization,High Course ( >40H )
2561,58,24,34,2015,1016,0.41,41,Medium-Low Digitalization,High Course ( >40H )
2562,6,0,6,2015,1016,0.05,5,Low Digitalization,Small Course ( <15H )
2563,53,36,17,2015,1016,0.68,68,Medium-High Digitalization,High Course ( >40H )
2564,14,10,4,2015,1016,0.71,71,Medium-High Digitalization,Small Course ( <15H )
2565,88,73,15,2015,1016,0.83,83,High Digitalization,High Course ( >40H )
2566,6,1,5,2015,1016,0.1,10,Low Digitalization,Small Course ( <15H )
2567,72,46,26,2015,1016,0.64,64,Medium-High Digitalization,High Course ( >40H )
2568,15,2,13,2015,1016,0.13,13,Low Digitalization,Small Course ( <15H )
2569,15,13,2,2015,1016,0.84,84,High Digitalization,Small Course ( <15H )
2570,69,67,2,2015,1016,0.97,97,High Digitalization,High Course ( >40H )
2571,80,36,44,2015,1016,0.45,45,Medium-Low Digitalization,High Course ( >40H )
2572,51,13,38,2015,1016,0.25,25,Medium-Low Digitalization,High Course ( >40H )
2573,52,49,3,2015,1016,0.95,95,High Digitalization,High Course ( >40H )
2574,90,5,85,2015,1016,0.06,6,Low Digitalization,High Course ( >40H )
2575,56,3,53,2015,1016,0.06,6,Low Digitalization,High Course ( >40H )
2576,9,1,8,2015,1016,0.09,9,Low Digitalization,Small Course ( <15H )
2577,6,6,0,2015,1016,0.99,99,High Digitalization,Small Course ( <15H )
2578,89,88,1,2015,1016,0.99,99,High Digitalization,High Course ( >40H )
2579,11,1,10,2015,1016,0.07,7,Low Digitalization,Small Course ( <15H )
2580,72,66,6,2015,1016,0.91,91,High Digitalization,High Course ( >40H )
2581,7,5,2,2015,1016,0.67,67,Medium-High Digitalization,Small Course ( <15H )
2582,11,6,5,2015,1016,0.58,57,Medium-High Digitalization,Small Course ( <15H )
2583,21,17,4,2015,1016,0.8,80,Medium-High Digitalization,Medium Course ( >15H and <40H )
2584,16,6,10,2015,1016,0.38,38,Medium-Low Digitalization,Medium Course ( >15H and <40H )
2585,30,0,30,2015,1016,0.0,0,Low Digitalization,Medium Course ( >15H and <40H )
2586,33,3,30,2015,1016,0.08,8,Low Digitalization,Medium Course ( >15H and <40H )
2587,47,4,43,2015,1016,0.09,9,Low Digitalization,High Course ( >40H )
2588,44,4,40,2015,1016,0.09,9,Low Digitalization,High Course ( >40H )
2589,36,24,12,2015,1016,0.68,68,Medium-High Digitalization,Medium Course ( >15H and <40H )
2590,16,1,15,2015,1016,0.08,8,Low Digitalization,Medium Course ( >15H and <40H )
2591,10,1,9,2015,1016,0.07,7,Low Digitalization,Small Course ( <15H )
2592,29,5,24,2015,1016,0.17,17,Low Digitalization,Medium Course ( >15H and <40H )
2593,66,13,53,2015,1016,0.19,19,Low Digitalization,High Course ( >40H )
2594,30,3,27,2015,1016,0.09,9,Low Digitalization,Medium Course ( >15H and <40H )
2595,10,5,5,2015,1016,0.47,47,Medium-Low Digitalization,Small Course ( <15H )
2596,15,5,10,2015,1016,0.35,35,Medium-Low Digitalization,Small Course ( <15H )
2597,5,4,0,2015,1016,0.9,90,High Digitalization,Small Course ( <15H )
2598,34,18,16,2015,1016,0.54,54,Medium-High Digitalization,Medium Course ( >15H and <40H )
2599,8,7,1,2015,1016,0.89,89,High Digitalization,Small Course ( <15H )
2600,31,19,12,2015,1016,0.6,60,Medium-High Digitalization,Medium Course ( >15H and <40H )
2601,50,10,40,2015,1016,0.19,19,Low Digitalization,High Course ( >40H )
2602,72,39,33,2015,1016,0.54,54,Medium-High Digitalization,High Course ( >40H )
2603,14,9,5,2015,1016,0.61,61,Medium-High Digitalization,Small Course ( <15H )
2604,37,11,26,2015,1016,0.29,28,Medium-Low Digitalization,Medium Course ( >15H and <40H )
2605,11,1,10,2015,1016,0.12,12,Low Digitalization,Small Course ( <15H )
2606,7,7,0,2015,1016,0.94,94,High Digitalization,Small Course ( <15H )
2607,8,4,4,2015,1016,0.54,54,Medium-High Digitalization,Small Course ( <15H )
2608,45,33,12,2015,1016,0.74,74,Medium-High Digitalization,High Course ( >40H )
2609,7,5,2,2015,1016,0.77,77,Medium-High Digitalization,Small Course ( <15H )
2610,10,5,5,2015,1016,0.5,50,Medium-Low Digitalization,Small Course ( <15H )
2611,23,5,18,2015,1016,0.23,23,Medium-Low Digitalization,Medium Course ( >15H and <40H )
2612,76,30,46,2015,1016,0.4,40,Medium-Low Digitalization,High Course ( >40H )
2613,46,22,24,2015,1016,0.47,47,Medium-Low Digitalization,High Course ( >40H )
2614,8,2,6,2015,1016,0.21,21,Medium-Low Digitalization,Small Course ( <15H )
2615,5,1,4,2015,1016,0.17,17,Low Digitalization,Small Course ( <15H )
2616,8,8,0,2015,1016,0.97,97,High Digitalization,Small Course ( <15H )
2617,67,15,52,2015,1016,0.22,22,Medium-Low Digitalization,High Course ( >40H )
2618,7,6,1,2015,1016,0.82,82,High Digitalization,Small Course ( <15H )
2619,57,51,6,2015,1016,0.9,90,High Digitalization,High Course ( >40H )
2620,52,35,17,2015,1016,0.68,68,Medium-High Digitalization,High Course ( >40H )
2621,23,20,3,2015,1016,0.85,85,High Digitalization,Medium Course ( >15H and <40H )
2622,57,11,46,2015,1016,0.19,19,Low Digitalization,High Course ( >40H )
2623,85,52,33,2015,1016,0.61,61,Medium-High Digitalization,High Course ( >40H )
2624,11,0,11,2015,1016,0.03,3,Low Digitalization,Small Course ( <15H )
2625,20,10,10,2015,1016,0.5,50,Medium-Low Digitalization,Medium Course ( >15H and <40H )
2626,84,81,3,2015,1016,0.96,96,High Digitalization,High Course ( >40H )
2627,21,13,8,2015,1016,0.62,62,Medium-High Digitalization,Medium Course ( >15H and <40H )
2628,15,14,1,2015,1016,0.91,91,High Digitalization,Small Course ( <15H )
2629,50,6,44,2015,1016,0.12,12,Low Digitalization,High Course ( >40H )
2630,11,8,3,2015,1016,0.77,77,Medium-High Digitalization,Small Course ( <15H )
2631,45,36,9,2015,1016,0.8,80,Medium-High Digitalization,High Course ( >40H )
2632,43,27,16,2015,1016,0.63,63,Medium-High Digitalization,High Course ( >40H )
2633,38,24,14,2015,1016,0.62,62,Medium-High Digitalization,Medium Course ( >15H and <40H )
2634,8,1,7,2015,1016,0.09,9,Low Digitalization,Small Course ( <15H )
2635,8,7,1,2015,1016,0.87,87,High Digitalization,Small Course ( <15H )
2636,74,48,26,2015,1016,0.65,65,Medium-High Digitalization,High Course ( >40H )
2637,41,17,24,2015,1016,0.42,42,Medium-Low Digitalization,High Course ( >40H )
2638,22,5,17,2015,1016,0.24,24,Medium-Low Digitalization,Medium Course ( >15H and <40H )
2639,6,4,2,2015,1016,0.61,61,Medium-High Digitalization,Small Course ( <15H )
2640,84,11,73,2015,1016,0.13,13,Low Digitalization,High Course ( >40H )
2641,51,43,8,2015,1016,0.85,85,High Digitalization,High Course ( >40H )
2642,25,20,5,2015,1016,0.79,79,Medium-High Digitalization,Medium Course ( >15H and <40H )
2643,56,13,43,2015,1016,0.24,24,Medium-Low Digitalization,High Course ( >40H )
2644,74,24,50,2015,1016,0.33,33,Medium-Low Digitalization,High Course ( >40H )
2645,14,6,8,2015,1016,0.46,46,Medium-Low Digitalization,Small Course ( <15H )
2646,12,10,2,2015,1016,0.84,84,High Digitalization,Small Course ( <15H )
2647,8,6,2,2015,1016,0.7,70,Medium-High Digitalization,Small Course ( <15H )
2648,26,3,23,2015,1016,0.1,10,Low Digitalization,Medium Course ( >15H and <40H )
2649,10,7,3,2015,1016,0.67,67,Medium-High Digitalization,Small Course ( <15H )
2650,43,14,29,2015,1016,0.32,32,Medium-Low Digitalization,High Course ( >40H )
2651,20,17,3,2015,1016,0.86,86,High Digitalization,Medium Course ( >15H and <40H )
2652,85,76,9,2015,1016,0.89,89,High Digitalization,High Course ( >40H )
2653,28,16,12,2015,1016,0.57,56,Medium-High Digitalization,Medium Course ( >15H and <40H )
2654,31,22,9,2015,1016,0.71,71,Medium-High Digitalization,Medium Course ( >15H and <40H )
2655,17,10,7,2015,1016,0.58,57,Medium-High Digitalization,Medium Course ( >15H and <40H )
2656,13,11,2,2015,1016,0.87,87,High Digitalization,Small Course ( <15H )
2657,13,5,8,2015,1016,0.4,40,Medium-Low Digitalization,Small Course ( <15H )
2658,11,0,11,2015,1016,0.02,2,Low Digitalization,Small Course ( <15H )
2659,7,0,7,2015,1016,0.0,0,Low Digitalization,Small Course ( <15H )
2660,20,1,19,2015,1016,0.06,6,Low Digitalization,Medium Course ( >15H and <40H )
2661,76,66,10,2015,1016,0.87,87,High Digitalization,High Course ( >40H )
2662,41,29,12,2015,1016,0.7,70,Medium-High Digitalization,High Course ( >40H )
2663,72,17,55,2015,1016,0.23,23,Medium-Low Digitalization,High Course ( >40H )
2664,13,6,7,2015,1016,0.48,48,Medium-Low Digitalization,Small Course ( <15H )
2665,7,4,4,2015,1016,0.5,50,Medium-Low Digitalization,Small Course ( <15H )
2666,5,3,2,2015,1016,0.59,59,Medium-High Digitalization,Small Course ( <15H )
2667,63,28,35,2015,1016,0.45,45,Medium-Low Digitalization,High Course ( >40H )
2668,57,54,3,2015,1016,0.94,94,High Digitalization,High Course ( >40H )
2669,68,55,13,2015,1016,0.81,81,High Digitalization,High Course ( >40H )
2670,90,31,59,2015,1016,0.34,34,Medium-Low Digitalization,High Course ( >40H )
2671,32,15,17,2015,1016,0.46,46,Medium-Low Digitalization,Medium Course ( >15H and <40H )
2672,17,1,16,2015,1016,0.04,4,Low Digitalization,Medium Course ( >15H and <40H )
2673,11,5,6,2015,1016,0.46,46,Medium-Low Digitalization,Small Course ( <15H )
2674,19,2,17,2015,1016,0.09,9,Low Digitalization,Medium Course ( >15H and <40H )
2675,11,3,8,2015,1016,0.3,30,Medium-Low Digitalization,Small Course ( <15H )
2676,43,37,6,2015,1016,0.86,86,High Digitalization,High Course ( >40H )
2677,6,5,1,2015,1016,0.77,77,Medium-High Digitalization,Small Course ( <15H )
2678,12,1,11,2015,1016,0.12,12,Low Digitalization,Small Course ( <15H )
2679,12,10,2,2015,1016,0.87,87,High Digitalization,Small Course ( <15H )
2680,11,4,7,2015,1016,0.35,35,Medium-Low Digitalization,Small Course ( <15H )
2681,35,12,23,2015,1016,0.35,35,Medium-Low Digitalization,Medium Course ( >15H and <40H )
2682,23,14,9,2015,1016,0.6,60,Medium-High Digitalization,Medium Course ( >15H and <40H )
2683,69,45,24,2015,1016,0.65,65,Medium-High Digitalization,High Course ( >40H )
2684,6,3,3,2015,1016,0.52,52,Medium-High Digitalization,Small Course ( <15H )
2685,57,0,57,2015,1016,0.0,0,Low Digitalization,High Course ( >40H )
2686,15,9,6,2015,1016,0.59,59,Medium-High Digitalization,Small Course ( <15H )
2687,62,53,9,2015,1016,0.85,85,High Digitalization,High Course ( >40H )
2688,12,7,5,2015,1016,0.58,57,Medium-High Digitalization,Small Course ( <15H )
2689,6,6,0,2015,1016,1.0,100,High Digitalization,Small Course ( <15H )
2690,6,2,4,2015,1016,0.39,39,Medium-Low Digitalization,Small Course ( <15H )
2691,12,3,9,2015,1016,0.24,24,Medium-Low Digitalization,Small Course ( <15H )
2692,7,4,3,2015,1016,0.63,63,Medium-High Digitalization,Small Course ( <15H )
2693,47,16,31,2015,1016,0.33,33,Medium-Low Digitalization,High Course ( >40H )
2694,58,41,17,2015,1016,0.71,71,Medium-High Digitalization,High Course ( >40H )
2695,82,67,15,2015,1016,0.82,82,High Digitalization,High Course ( >40H )
2696,61,52,9,2015,1016,0.85,85,High Digitalization,High Course ( >40H )
2697,20,0,20,2015,1016,0.01,1,Low Digitalization,Medium Course ( >15H and <40H )
2698,70,4,66,2015,1016,0.05,5,Low Digitalization,High Course ( >40H )
2699,18,1,17,2015,1016,0.08,8,Low Digitalization,Medium Course ( >15H and <40H )
2700,5,1,4,2015,1016,0.29,28,Medium-Low Digitalization,Small Course ( <15H )
2701,20,16,4,2015,1016,0.78,78,Medium-High Digitalization,Medium Course ( >15H and <40H )
2702,79,51,28,2015,1016,0.64,64,Medium-High Digitalization,High Course ( >40H )
2703,14,12,2,2015,1016,0.86,86,High Digitalization,Small Course ( <15H )
2704,26,5,21,2015,1016,0.21,21,Medium-Low Digitalization,Medium Course ( >15H and <40H )
2705,47,45,2,2015,1016,0.95,95,High Digitalization,High Course ( >40H )
2706,8,7,1,2015,1016,0.82,82,High Digitalization,Small Course ( <15H )
2707,29,27,2,2015,1016,0.92,92,High Digitalization,Medium Course ( >15H and <40H )
2708,88,48,40,2015,1016,0.55,55,Medium-High Digitalization,High Course ( >40H )
2709,59,18,41,2015,1016,0.31,31,Medium-Low Digitalization,High Course ( >40H )
2710,47,43,4,2015,1016,0.91,91,High Digitalization,High Course ( >40H )
2711,48,6,42,2015,1016,0.12,12,Low Digitalization,High Course ( >40H )
2712,7,1,6,2015,1016,0.16,16,Low Digitalization,Small Course ( <15H )
2713,54,24,30,2015,1016,0.45,45,Medium-Low Digitalization,High Course ( >40H )
2714,7,4,3,2015,1016,0.54,54,Medium-High Digitalization,Small Course ( <15H )
2715,31,21,10,2015,1016,0.68,68,Medium-High Digitalization,Medium Course ( >15H and <40H )
2716,50,48,2,2015,1016,0.96,96,High Digitalization,High Course ( >40H )
2717,9,1,8,2015,1016,0.11,11,Low Digitalization,Small Course ( <15H )
2718,81,57,24,2015,1016,0.7,70,Medium-High Digitalization,High Course ( >40H )
2719,76,62,14,2015,1016,0.82,82,High Digitalization,High Course ( >40H )
2720,11,10,1,2015,1016,0.92,92,High Digitalization,Small Course ( <15H )
2721,32,24,8,2015,1016,0.76,76,Medium-High Digitalization,Medium Course ( >15H and <40H )
2722,17,10,7,2015,1016,0.57,56,Medium-High Digitalization,Medium Course ( >15H and <40H )
2723,73,1,72,2015,1016,0.01,1,Low Digitalization,High Course ( >40H )
2724,53,25,28,2015,1016,0.47,47,Medium-Low Digitalization,High Course ( >40H )
2725,29,6,23,2015,1016,0.21,21,Medium-Low Digitalization,Medium Course ( >15H and <40H )
2726,47,14,33,2015,1016,0.3,30,Medium-Low Digitalization,High Course ( >40H )
2727,42,18,24,2015,1016,0.43,43,Medium-Low Digitalization,High Course ( >40H )
2728,12,1,11,2015,1016,0.09,9,Low Digitalization,Small Course ( <15H )
2729,40,25,15,2015,1016,0.62,62,Medium-High Digitalization,High Course ( >40H )
2730,70,29,41,2015,1016,0.42,42,Medium-Low Digitalization,High Course ( >40H )
2731,15,1,14,2015,1016,0.05,5,Low Digitalization,Small Course ( <15H )
2732,11,6,5,2015,1016,0.59,59,Medium-High Digitalization,Small Course ( <15H )
2733,15,14,1,2015,1016,0.92,92,High Digitalization,Small Course ( <15H )
2734,58,50,8,2015,1016,0.87,87,High Digitalization,High Course ( >40H )
2735,18,12,6,2015,1016,0.66,66,Medium-High Digitalization,Medium Course ( >15H and <40H )
2736,50,17,33,2015,1016,0.34,34,Medium-Low Digitalization,High Course ( >40H )
2737,35,19,16,2015,1016,0.53,53,Medium-High Digitalization,Medium Course ( >15H and <40H )
2738,46,24,22,2015,1016,0.53,53,Medium-High Digitalization,High Course ( >40H )
2739,82,48,34,2015,1016,0.59,59,Medium-High Digitalization,High Course ( >40H )
2740,27,1,26,2015,1016,0.05,5,Low Digitalization,Medium Course ( >15H and <40H )
2741,22,16,6,2015,1016,0.73,73,Medium-High Digitalization,Medium Course ( >15H and <40H )
2742,13,2,11,2015,1016,0.16,16,Low Digitalization,Small Course ( <15H )
2743,13,5,8,2015,1016,0.36,36,Medium-Low Digitalization,Small Course ( <15H )
2744,37,9,28,2015,1016,0.25,25,Medium-Low Digitalization,Medium Course ( >15H and <40H )
2745,14,13,1,2015,1016,0.94,94,High Digitalization,Small Course ( <15H )
2746,59,25,34,2015,1016,0.42,42,Medium-Low Digitalization,High Course ( >40H )
2747,8,4,4,2015,1016,0.46,46,Medium-Low Digitalization,Small Course ( <15H )
2748,25,10,14,2015,1016,0.42,42,Medium-Low Digitalization,Medium Course ( >15H and <40H )
2749,78,22,56,2015,1016,0.28,28,Medium-Low Digitalization,High Course ( >40H )
2750,80,73,7,2015,1016,0.91,91,High Digitalization,High Course ( >40H )
2751,61,28,33,2015,1016,0.46,46,Medium-Low Digitalization,High Course ( >40H )
2752,54,5,49,2015,1016,0.09,9,Low Digitalization,High Course ( >40H )
2753,7,6,1,2015,1016,0.83,83,High Digitalization,Small Course ( <15H )
2754,73,57,16,2015,1016,0.78,78,Medium-High Digitalization,High Course ( >40H )
2755,5,4,1,2015,1016,0.85,85,High Digitalization,Small Course ( <15H )
2756,88,74,14,2015,1016,0.84,84,High Digitalization,High Course ( >40H )
2757,16,12,4,2015,1016,0.74,74,Medium-High Digitalization,Medium Course ( >15H and <40H )
2758,20,9,11,2015,1016,0.46,46,Medium-Low Digitalization,Medium Course ( >15H and <40H )
2759,27,14,13,2015,1016,0.53,53,Medium-High Digitalization,Medium Course ( >15H and <40H )
2760,47,36,11,2015,1016,0.77,77,Medium-High Digitalization,High Course ( >40H )
2761,35,17,18,2015,1016,0.48,48,Medium-Low Digitalization,Medium Course ( >15H and <40H )
2762,64,15,49,2015,1016,0.23,23,Medium-Low Digitalization,High Course ( >40H )
2763,5,1,4,2015,1016,0.27,27,Medium-Low Digitalization,Small Course ( <15H )
2764,63,60,3,2015,1016,0.96,96,High Digitalization,High Course ( >40H )
2765,58,19,39,2015,1016,0.32,32,Medium-Low Digitalization,High Course ( >40H )
2766,10,2,8,2015,1016,0.19,19,Low Digitalization,Small Course ( <15H )
2767,34,0,34,2015,1016,0.01,1,Low Digitalization,Medium Course ( >15H and <40H )
2768,15,6,9,2015,1016,0.41,41,Medium-Low Digitalization,Small Course ( <15H )
2769,28,19,9,2015,1016,0.69,69,Medium-High Digitalization,Medium Course ( >15H and <40H )
2770,41,40,1,2015,1016,0.98,98,High Digitalization,High Course ( >40H )
2771,77,74,3,2015,1016,0.96,96,High Digitalization,High Course ( >40H )
2772,89,11,78,2015,1016,0.12,12,Low Digitalization,High Course ( >40H )
2773,33,14,19,2015,1016,0.41,41,Medium-Low Digitalization,Medium Course ( >15H and <40H )
2774,89,44,45,2015,1016,0.49,49,Medium-Low Digitalization,High Course ( >40H )
2775,23,12,12,2015,1016,0.5,50,Medium-Low Digitalization,Medium Course ( >15H and <40H )
2776,10,9,1,2015,1016,0.94,94,High Digitalization,Small Course ( <15H )
2777,21,15,6,2015,1016,0.72,72,Medium-High Digitalization,Medium Course ( >15H and <40H )
2778,17,6,11,2015,1016,0.36,36,Medium-Low Digitalization,Medium Course ( >15H and <40H )
2779,9,7,2,2015,1016,0.76,76,Medium-High Digitalization,Small Course ( <15H )
2780,13,8,5,2015,1016,0.62,62,Medium-High Digitalization,Small Course ( <15H )
2781,15,7,8,2015,1016,0.49,49,Medium-Low Digitalization,Small Course ( <15H )
2782,12,6,6,2015,1016,0.51,51,Medium-High Digitalization,Small Course ( <15H )
2783,15,7,8,2015,1016,0.46,46,Medium-Low Digitalization,Small Course ( <15H )
2784,29,10,19,2015,1016,0.33,33,Medium-Low Digitalization,Medium Course ( >15H and <40H )
2785,7,7,0,2015,1016,0.98,98,High Digitalization,Small Course ( <15H )
2786,35,12,23,2015,1016,0.35,35,Medium-Low Digitalization,Medium Course ( >15H and <40H )
2787,14,12,2,2015,1016,0.83,83,High Digitalization,Small Course ( <15H )
2788,14,1,13,2015,1016,0.09,9,Low Digitalization,Small Course ( <15H )
2789,37,28,9,2015,1016,0.75,75,Medium-High Digitalization,Medium Course ( >15H and <40H )
2790,10,3,7,2015,1016,0.32,32,Medium-Low Digitalization,Small Course ( <15H )
2791,60,46,14,2015,1016,0.77,77,Medium-High Digitalization,High Course ( >40H )
2792,59,36,23,2015,1016,0.61,61,Medium-High Digitalization,High Course ( >40H )
2793,50,32,18,2015,1016,0.65,65,Medium-High Digitalization,High Course ( >40H )
2794,7,7,0,2015,1016,0.94,94,High Digitalization,Small Course ( <15H )
2795,8,5,3,2015,1016,0.57,56,Medium-High Digitalization,Small Course ( <15H )
2796,36,14,22,2015,1016,0.4,40,Medium-Low Digitalization,Medium Course ( >15H and <40H )
2797,8,6,2,2015,1016,0.8,80,Medium-High Digitalization,Small Course ( <15H )
2798,13,2,11,2015,1016,0.15,15,Low Digitalization,Small Course ( <15H )
2799,90,60,30,2015,1016,0.67,67,Medium-High Digitalization,High Course ( >40H )
2800,58,24,34,2015,1016,0.41,41,Medium-Low Digitalization,High Course ( >40H )
2801,69,4,65,2015,1016,0.06,6,Low Digitalization,High Course ( >40H )
2802,78,2,76,2015,1016,0.02,2,Low Digitalization,High Course ( >40H )
2803,8,5,3,2015,1016,0.67,67,Medium-High Digitalization,Small Course ( <15H )
2804,9,7,2,2015,1016,0.75,75,Medium-High Digitalization,Small Course ( <15H )
2805,67,57,10,2015,1016,0.85,85,High Digitalization,High Course ( >40H )
2806,22,18,4,2015,1016,0.82,82,High Digitalization,Medium Course ( >15H and <40H )
2807,44,11,33,2015,1016,0.26,26,Medium-Low Digitalization,High Course ( >40H )
2808,7,5,2,2015,1016,0.68,68,Medium-High Digitalization,Small Course ( <15H )
2809,5,1,4,2015,1016,0.26,26,Medium-Low Digitalization,Small Course ( <15H )
2810,8,0,8,2015,1016,0.02,2,Low Digitalization,Small Course ( <15H )
2811,25,6,19,2015,1016,0.25,25,Medium-Low Digitalization,Medium Course ( >15H and <40H )
2812,7,4,3,2015,1016,0.59,59,Medium-High Digitalization,Small Course ( <15H )
2813,6,5,1,2015,1016,0.79,79,Medium-High Digitalization,Small Course ( <15H )
2814,87,34,53,2015,1016,0.39,39,Medium-Low Digitalization,High Course ( >40H )
2815,13,12,1,2015,1016,0.95,95,High Digitalization,Small Course ( <15H )
2816,33,27,6,2015,1016,0.81,81,High Digitalization,Medium Course ( >15H and <40H )
2817,40,32,8,2015,1016,0.8,80,Medium-High Digitalization,High Course ( >40H )
2818,84,71,13,2015,1016,0.85,85,High Digitalization,High Course ( >40H )
2819,42,25,17,2015,1016,0.6,60,Medium-High Digitalization,High Course ( >40H )
2820,23,9,14,2015,1016,0.37,37,Medium-Low Digitalization,Medium Course ( >15H and <40H )
2821,68,44,24,2015,1016,0.64,64,Medium-High Digitalization,High Course ( >40H )
2822,35,4,31,2015,1016,0.11,11,Low Digitalization,Medium Course ( >15H and <40H )
2823,34,27,7,2015,1016,0.8,80,Medium-High Digitalization,Medium Course ( >15H and <40H )
2824,8,7,1,2015,1016,0.86,86,High Digitalization,Small Course ( <15H )
2825,55,13,42,2015,1016,0.24,24,Medium-Low Digitalization,High Course ( >40H )
2826,18,17,1,2015,1016,0.96,96,High Digitalization,Medium Course ( >15H and <40H )
2827,12,6,6,2015,1016,0.48,48,Medium-Low Digitalization,Small Course ( <15H )
2828,72,11,61,2015,1016,0.15,15,Low Digitalization,High Course ( >40H )
2829,58,15,43,2015,1016,0.26,26,Medium-Low Digitalization,High Course ( >40H )
2830,11,3,8,2015,1016,0.29,28,Medium-Low Digitalization,Small Course ( <15H )
2831,48,25,23,2015,1016,0.52,52,Medium-High Digitalization,High Course ( >40H )
2832,52,8,44,2015,1016,0.16,16,Low Digitalization,High Course ( >40H )
2833,17,7,10,2015,1016,0.44,44,Medium-Low Digitalization,Medium Course ( >15H and <40H )
2834,76,6,70,2015,1016,0.08,8,Low Digitalization,High Course ( >40H )
2835,51,36,15,2015,1016,0.71,71,Medium-High Digitalization,High Course ( >40H )
2836,83,66,17,2015,1016,0.8,80,Medium-High Digitalization,High Course ( >40H )
2837,40,8,32,2015,1016,0.19,19,Low Digitalization,High Course ( >40H )
2838,12,0,12,2015,1016,0.01,1,Low Digitalization,Small Course ( <15H )
2839,36,2,34,2015,1016,0.05,5,Low Digitalization,Medium Course ( >15H and <40H )
2840,68,12,56,2015,1016,0.18,18,Low Digitalization,High Course ( >40H )
2841,83,33,50,2015,1016,0.4,40,Medium-Low Digitalization,High Course ( >40H )
2842,58,29,29,2015,1016,0.5,50,Medium-Low Digitalization,High Course ( >40H )
2843,9,7,2,2015,1016,0.76,76,Medium-High Digitalization,Small Course ( <15H )
2844,18,14,4,2015,1016,0.75,75,Medium-High Digitalization,Medium Course ( >15H and <40H )
2845,26,10,16,2015,1016,0.39,39,Medium-Low Digitalization,Medium Course ( >15H and <40H )
2846,36,2,34,2015,1016,0.06,6,Low Digitalization,Medium Course ( >15H and <40H )
2847,67,52,15,2015,1016,0.78,78,Medium-High Digitalization,High Course ( >40H )
2848,80,8,72,2015,1016,0.1,10,Low Digitalization,High Course ( >40H )
2849,76,70,6,2015,1016,0.92,92,High Digitalization,High Course ( >40H )
2850,7,3,4,2015,1016,0.37,37,Medium-Low Digitalization,Small Course ( <15H )
2851,30,12,18,2015,1016,0.41,41,Medium-Low Digitalization,Medium Course ( >15H and <40H )
2852,86,29,57,2015,1016,0.34,34,Medium-Low Digitalization,High Course ( >40H )
2853,72,22,50,2015,1016,0.3,30,Medium-Low Digitalization,High Course ( >40H )
2854,13,3,10,2015,1016,0.23,23,Medium-Low Digitalization,Small Course ( <15H )
2855,89,36,53,2015,1016,0.41,41,Medium-Low Digitalization,High Course ( >40H )
2856,52,7,45,2015,1016,0.13,13,Low Digitalization,High Course ( >40H )
2857,34,27,7,2015,1016,0.8,80,Medium-High Digitalization,Medium Course ( >15H and <40H )
2858,61,33,28,2015,1016,0.54,54,Medium-High Digitalization,High Course ( >40H )
2859,64,28,36,2015,1016,0.44,44,Medium-Low Digitalization,High Course ( >40H )
2860,49,19,30,2015,1016,0.38,38,Medium-Low Digitalization,High Course ( >40H )
2861,84,73,11,2015,1016,0.87,87,High Digitalization,High Course ( >40H )
2862,20,12,8,2015,1016,0.58,57,Medium-High Digitalization,Medium Course ( >15H and <40H )
2863,68,0,68,2015,1016,0.0,0,Low Digitalization,High Course ( >40H )
2864,14,1,13,2015,1016,0.06,6,Low Digitalization,Small Course ( <15H )
2865,8,6,2,2015,1016,0.78,78,Medium-High Digitalization,Small Course ( <15H )
2866,27,3,24,2015,1016,0.11,11,Low Digitalization,Medium Course ( >15H and <40H )
2867,7,6,1,2015,1016,0.92,92,High Digitalization,Small Course ( <15H )
2868,11,6,5,2015,1016,0.52,52,Medium-High Digitalization,Small Course ( <15H )
2869,14,10,4,2015,1016,0.68,68,Medium-High Digitalization,Small Course ( <15H )
2870,65,38,27,2015,1016,0.58,57,Medium-High Digitalization,High Course ( >40H )
2871,16,3,13,2015,1016,0.16,16,Low Digitalization,Medium Course ( >15H and <40H )
2872,85,37,48,2015,1016,0.43,43,Medium-Low Digitalization,High Course ( >40H )
2873,33,22,11,2015,1016,0.66,66,Medium-High Digitalization,Medium Course ( >15H and <40H )
2874,41,14,27,2015,1016,0.33,33,Medium-Low Digitalization,High Course ( >40H )
2875,5,2,4,2015,1016,0.3,30,Medium-Low Digitalization,Small Course ( <15H )
2876,55,25,30,2015,1016,0.45,45,Medium-Low Digitalization,High Course ( >40H )
2877,11,8,3,2015,1016,0.69,69,Medium-High Digitalization,Small Course ( <15H )
2878,14,3,11,2015,1016,0.22,22,Medium-Low Digitalization,Small Course ( <15H )
2879,60,5,55,2015,1016,0.08,8,Low Digitalization,High Course ( >40H )
2880,13,8,5,2015,1016,0.65,65,Medium-High Digitalization,Small Course ( <15H )
2881,10,1,9,2015,1016,0.07,7,Low Digitalization,Small Course ( <15H )
2882,10,6,4,2015,1016,0.61,61,Medium-High Digitalization,Small Course ( <15H )
2883,82,11,71,2015,1016,0.14,14,Low Digitalization,High Course ( >40H )
2884,5,3,2,2015,1016,0.6,60,Medium-High Digitalization,Small Course ( <15H )
2885,54,8,46,2015,1016,0.15,15,Low Digitalization,High Course ( >40H )
2886,39,30,9,2015,1016,0.78,78,Medium-High Digitalization,Medium Course ( >15H and <40H )
2887,53,12,41,2015,1016,0.22,22,Medium-Low Digitalization,High Course ( >40H )
2888,14,8,6,2015,1016,0.54,54,Medium-High Digitalization,Small Course ( <15H )
2889,53,21,32,2015,1016,0.39,39,Medium-Low Digitalization,High Course ( >40H )
2890,15,2,14,2015,1016,0.1,10,Low Digitalization,Small Course ( <15H )
2891,55,1,54,2015,1016,0.01,1,Low Digitalization,High Course ( >40H )
2892,33,21,12,2015,1016,0.64,64,Medium-High Digitalization,Medium Course ( >15H and <40H )
2893,19,17,2,2015,1016,0.92,92,High Digitalization,Medium Course ( >15H and <40H )
2894,89,80,9,2015,1016,0.9,90,High Digitalization,High Course ( >40H )
2895,9,9,0,2015,1016,0.95,95,High Digitalization,Small Course ( <15H )
2896,47,18,29,2015,1016,0.38,38,Medium-Low Digitalization,High Course ( >40H )
2897,20,1,19,2015,1016,0.05,5,Low Digitalization,Medium Course ( >15H and <40H )
2898,8,5,3,2015,1016,0.64,64,Medium-High Digitalization,Small Course ( <15H )
2899,48,44,4,2015,1016,0.92,92,High Digitalization,High Course ( >40H )
2900,24,19,5,2015,1016,0.78,78,Medium-High Digitalization,Medium Course ( >15H and <40H )
2901,26,4,22,2015,1016,0.16,16,Low Digitalization,Medium Course ( >15H and <40H )
2902,16,14,2,2015,1016,0.9,90,High Digitalization,Medium Course ( >15H and <40H )
2903,56,27,29,2015,1016,0.48,48,Medium-Low Digitalization,High Course ( >40H )
2904,17,5,12,2015,1016,0.29,28,Medium-Low Digitalization,Medium Course ( >15H and <40H )
2905,6,5,1,2015,1016,0.82,82,High Digitalization,Small Course ( <15H )
2906,20,5,15,2015,1016,0.23,23,Medium-Low Digitalization,Medium Course ( >15H and <40H )
2907,12,1,11,2015,1016,0.09,9,Low Digitalization,Small Course ( <15H )
2908,5,0,5,2015,1016,0.07,7,Low Digitalization,Small Course ( <15H )
2909,12,9,3,2015,1016,0.76,76,Medium-High Digitalization,Small Course ( <15H )
2910,55,33,22,2015,1016,0.6,60,Medium-High Digitalization,High Course ( >40H )
2911,74,1,73,2015,1016,0.02,2,Low Digitalization,High Course ( >40H )
2912,66,20,46,2015,1016,0.3,30,Medium-Low Digitalization,High Course ( >40H )
2913,15,9,6,2015,1016,0.59,59,Medium-High Digitalization,Small Course ( <15H )
2914,54,6,48,2015,1016,0.12,12,Low Digitalization,High Course ( >40H )
2915,15,0,15,2015,1016,0.0,0,Low Digitalization,Small Course ( <15H )
2916,78,22,56,2015,1016,0.28,28,Medium-Low Digitalization,High Course ( >40H )
2917,69,3,66,2015,1016,0.05,5,Low Digitalization,High Course ( >40H )
2918,41,23,18,2015,1016,0.56,56,Medium-High Digitalization,High Course ( >40H )
2919,28,14,14,2015,1016,0.5,50,Medium-Low Digitalization,Medium Course ( >15H and <40H )
2920,79,60,19,2015,1016,0.76,76,Medium-High Digitalization,High Course ( >40H )
2921,59,30,29,2015,1016,0.51,51,Medium-High Digitalization,High Course ( >40H )
2922,6,3,3,2015,1016,0.42,42,Medium-Low Digitalization,Small Course ( <15H )
2923,20,5,15,2015,1016,0.25,25,Medium-Low Digitalization,Medium Course ( >15H and <40H )
2924,78,63,15,2015,1016,0.81,81,High Digitalization,High Course ( >40H )
2925,61,43,18,2015,1016,0.7,70,Medium-High Digitalization,High Course ( >40H )
2926,32,6,26,2015,1016,0.19,19,Low Digitalization,Medium Course ( >15H and <40H )
2927,13,3,10,2015,1016,0.25,25,Medium-Low Digitalization,Small Course ( <15H )
2928,44,11,33,2015,1016,0.26,26,Medium-Low Digitalization,High Course ( >40H )
2929,67,53,14,2015,1016,0.79,79,Medium-High Digitalization,High Course ( >40H )
2930,37,12,25,2015,1016,0.33,33,Medium-Low Digitalization,Medium Course ( >15H and <40H )
2931,62,30,32,2015,1016,0.49,49,Medium-Low Digitalization,High Course ( >40H )
2932,60,45,15,2015,1016,0.75,75,Medium-High Digitalization,High Course ( >40H )
2933,40,22,18,2015,1016,0.54,54,Medium-High Digitalization,High Course ( >40H )
2934,56,7,49,2015,1016,0.13,13,Low Digitalization,High Course ( >40H )
2935,7,7,0,2015,1016,0.95,95,High Digitalization,Small Course ( <15H )
2936,11,2,9,2015,1016,0.2,20,Low Digitalization,Small Course ( <15H )
2937,23,22,1,2015,1016,0.97,97,High Digitalization,Medium Course ( >15H and <40H )
2938,54,52,2,2015,1016,0.97,97,High Digitalization,High Course ( >40H )
2939,31,22,9,2015,1016,0.7,70,Medium-High Digitalization,Medium Course ( >15H and <40H )
2940,90,58,32,2015,1016,0.65,65,Medium-High Digitalization,High Course ( >40H )
2941,42,2,40,2015,1016,0.05,5,Low Digitalization,High Course ( >40H )
2942,5,3,2,2015,1016,0.63,63,Medium-High Digitalization,Small Course ( <15H )
2943,34,15,19,2015,1016,0.44,44,Medium-Low Digitalization,Medium Course ( >15H and <40H )
2944,34,28,6,2015,1016,0.82,82,High Digitalization,Medium Course ( >15H and <40H )
2945,63,56,7,2015,1016,0.89,89,High Digitalization,High Course ( >40H )
2946,56,40,16,2015,1016,0.71,71,Medium-High Digitalization,High Course ( >40H )
2947,32,17,15,2015,1016,0.54,54,Medium-High Digitalization,Medium Course ( >15H and <40H )
2948,20,8,12,2015,1016,0.42,42,Medium-Low Digitalization,Medium Course ( >15H and <40H )
2949,9,8,1,2015,1016,0.86,86,High Digitalization,Small Course ( <15H )
2950,83,71,12,2015,1016,0.85,85,High Digitalization,High Course ( >40H )
2951,54,37,17,2015,1016,0.69,69,Medium-High Digitalization,High Course ( >40H )
2952,47,20,27,2015,1016,0.43,43,Medium-Low Digitalization,High Course ( >40H )
2953,16,5,11,2015,1016,0.29,28,Medium-Low Digitalization,Medium Course ( >15H and <40H )
2954,29,3,26,2015,1016,0.11,11,Low Digitalization,Medium Course ( >15H and <40H )
2955,12,7,5,2015,1016,0.6,60,Medium-High Digitalization,Small Course ( <15H )
2956,5,4,1,2015,1016,0.88,88,High Digitalization,Small Course ( <15H )
2957,64,4,60,2015,1016,0.06,6,Low Digitalization,High Course ( >40H )
2958,29,7,22,2015,1016,0.24,24,Medium-Low Digitalization,Medium Course ( >15H and <40H )
2959,8,3,5,2015,1016,0.43,43,Medium-Low Digitalization,Small Course ( <15H )
2960,21,12,9,2015,1016,0.59,59,Medium-High Digitalization,Medium Course ( >15H and <40H )
2961,25,24,1,2015,1016,0.95,95,High Digitalization,Medium Course ( >15H and <40H )
2962,56,18,38,2015,1016,0.33,33,Medium-Low Digitalization,High Course ( >40H )
2963,10,3,7,2015,1016,0.26,26,Medium-Low Digitalization,Small Course ( <15H )
2964,88,29,59,2015,1016,0.33,33,Medium-Low Digitalization,High Course ( >40H )
2965,58,34,24,2015,1016,0.59,59,Medium-High Digitalization,High Course ( >40H )
2966,28,17,11,2015,1016,0.59,59,Medium-High Digitalization,Medium Course ( >15H and <40H )
2967,76,36,40,2015,1016,0.47,47,Medium-Low Digitalization,High Course ( >40H )
2968,32,6,26,2015,1016,0.18,18,Low Digitalization,Medium Course ( >15H and <40H )
2969,11,7,4,2015,1016,0.68,68,Medium-High Digitalization,Small Course ( <15H )
2970,54,26,28,2015,1016,0.49,49,Medium-Low Digitalization,High Course ( >40H )
2971,17,17,0,2015,1016,0.98,98,High Digitalization,Medium Course ( >15H and <40H )
2972,7,4,3,2015,1016,0.55,55,Medium-High Digitalization,Small Course ( <15H )
2973,8,2,6,2015,1016,0.3,30,Medium-Low Digitalization,Small Course ( <15H )
2974,57,36,21,2015,1016,0.63,63,Medium-High Digitalization,High Course ( >40H )
2975,33,3,30,2015,1016,0.1,10,Low Digitalization,Medium Course ( >15H and <40H )
2976,67,15,52,2015,1016,0.23,23,Medium-Low Digitalization,High Course ( >40H )
2977,16,7,9,2015,1016,0.46,46,Medium-Low Digitalization,Medium Course ( >15H and <40H )
2978,68,66,2,2015,1016,0.97,97,High Digitalization,High Course ( >40H )
2979,31,5,26,2015,1016,0.15,15,Low Digitalization,Medium Course ( >15H and <40H )
2980,55,18,37,2015,1016,0.32,32,Medium-Low Digitalization,High Course ( >40H )
2981,21,13,8,2015,1016,0.62,62,Medium-High Digitalization,Medium Course ( >15H and <40H )
2982,85,20,65,2015,1016,0.24,24,Medium-Low Digitalization,High Course ( >40H )
2983,22,9,13,2015,1016,0.42,42,Medium-Low Digitalization,Medium Course ( >15H and <40H )
2984,55,16,38,2015,1016,0.3,30,Medium-Low Digitalization,High Course ( >40H )
2985,83,19,64,2015,1016,0.23,23,Medium-Low Digitalization,High Course ( >40H )
2986,5,3,2,2015,1016,0.68,68,Medium-High Digitalization,Small Course ( <15H )
2987,8,6,2,2015,1016,0.76,76,Medium-High Digitalization,Small Course ( <15H )
2988,24,13,11,2015,1016,0.56,56,Medium-High Digitalization,Medium Course ( >15H and <40H )
2989,82,2,80,2015,1016,0.02,2,Low Digitalization,High Course ( >40H )
2990,53,17,36,2015,1016,0.33,33,Medium-Low Digitalization,High Course ( >40H )
2991,47,14,33,2015,1016,0.3,30,Medium-Low Digitalization,High Course ( >40H )
2992,8,8,0,2015,1016,0.94,94,High Digitalization,Small Course ( <15H )
2993,6,4,2,2015,1016,0.66,66,Medium-High Digitalization,Small Course ( <15H )
2994,32,3,29,2015,1016,0.09,9,Low Digitalization,Medium Course ( >15H and <40H )
2995,74,64,10,2015,1016,0.86,86,High Digitalization,High Course ( >40H )
2996,86,74,12,2015,1016,0.86,86,High Digitalization,High Course ( >40H )
2997,58,8,50,2015,1016,0.13,13,Low Digitalization,High Course ( >40H )
2998,90,54,36,2015,1016,0.6,60,Medium-High Digitalization,High Course ( >40H )
2999,5,5,0,2015,1016,0.96,96,High Digitalization,Small Course ( <15H )
3000,43,20,23,2015,1016,0.46,46,Medium-Low Digitalization,High Course ( >40H )
3001,56,10,46,2015,1016,0.18,18,Low Digitalization,High Course ( >40H )
3002,51,34,17,2015,1016,0.66,66,Medium-High Digitalization,High Course ( >40H )
3003,18,10,8,2015,1016,0.56,56,Medium-High Digitalization,Medium Course ( >15H and <40H )
3004,85,53,32,2015,1016,0.62,62,Medium-High Digitalization,High Course ( >40H )
3005,22,19,3,2015,1016,0.88,88,High Digitalization,Medium Course ( >15H and <40H )
3006,17,16,1,2015,1016,0.94,94,High Digitalization,Medium Course ( >15H and <40H )
3007,52,34,18,2015,1016,0.65,65,Medium-High Digitalization,High Course ( >40H )
3008,38,9,29,2015,1016,0.24,24,Medium-Low Digitalization,Medium Course ( >15H and <40H )
3009,7,1,6,2015,1016,0.13,13,Low Digitalization,Small Course ( <15H )
3010,40,17,23,2015,1016,0.43,43,Medium-Low Digitalization,High Course ( >40H )
3011,63,50,13,2015,1016,0.8,80,Medium-High Digitalization,High Course ( >40H )
3012,28,25,3,2015,1016,0.89,89,High Digitalization,Medium Course ( >15H and <40H )
3013,12,9,3,2015,1016,0.73,73,Medium-High Digitalization,Small Course ( <15H )
3014,33,5,28,2015,1016,0.16,16,Low Digitalization,Medium Course ( >15H and <40H )
3015,86,35,51,2015,1016,0.41,41,Medium-Low Digitalization,High Course ( >40H )
3016,89,16,73,2015,1016,0.18,18,Low Digitalization,High Course ( >40H )
3017,62,30,32,2015,1016,0.48,48,Medium-Low Digitalization,High Course ( >40H )
3018,26,20,6,2015,1016,0.76,76,Medium-High Digitalization,Medium Course ( >15H and <40H )
3019,8,0,8,2015,1016,0.06,6,Low Digitalization,Small Course ( <15H )
3020,46,37,9,2015,1016,0.8,80,Medium-High Digitalization,High Course ( >40H )
3021,21,9,12,2015,1016,0.43,43,Medium-Low Digitalization,Medium Course ( >15H and <40H )
3022,46,29,17,2015,1016,0.63,63,Medium-High Digitalization,High Course ( >40H )
3023,9,7,2,2015,1016,0.81,81,High Digitalization,Small Course ( <15H )
3024,64,47,17,2015,1016,0.73,73,Medium-High Digitalization,High Course ( >40H )
3025,38,33,5,2015,1016,0.88,88,High Digitalization,Medium Course ( >15H and <40H )
3026,35,24,11,2015,1016,0.69,69,Medium-High Digitalization,Medium Course ( >15H and <40H )
3027,8,6,2,2015,1016,0.74,74,Medium-High Digitalization,Small Course ( <15H )
3028,13,3,10,2015,1016,0.24,24,Medium-Low Digitalization,Small Course ( <15H )
3029,9,3,6,2015,1016,0.36,36,Medium-Low Digitalization,Small Course ( <15H )
3030,49,5,44,2015,1016,0.11,11,Low Digitalization,High Course ( >40H )
3031,53,45,8,2015,1016,0.85,85,High Digitalization,High Course ( >40H )
3032,90,70,20,2015,1016,0.78,78,Medium-High Digitalization,High Course ( >40H )
3033,25,4,20,2015,1016,0.18,18,Low Digitalization,Medium Course ( >15H and <40H )
3034,32,22,10,2015,1016,0.7,70,Medium-High Digitalization,Medium Course ( >15H and <40H )
3035,17,13,4,2015,1016,0.75,75,Medium-High Digitalization,Medium Course ( >15H and <40H )
3036,74,45,29,2015,1016,0.61,61,Medium-High Digitalization,High Course ( >40H )
3037,38,10,28,2015,1016,0.27,27,Medium-Low Digitalization,Medium Course ( >15H and <40H )
3038,7,3,4,2015,1016,0.46,46,Medium-Low Digitalization,Small Course ( <15H )
3039,56,14,42,2015,1016,0.25,25,Medium-Low Digitalization,High Course ( >40H )
3040,15,11,4,2015,1016,0.71,71,Medium-High Digitalization,Small Course ( <15H )
3041,34,1,33,2015,1016,0.04,4,Low Digitalization,Medium Course ( >15H and <40H )
3042,36,34,2,2015,1016,0.95,95,High Digitalization,Medium Course ( >15H and <40H )
3043,60,23,37,2015,1016,0.38,38,Medium-Low Digitalization,High Course ( >40H )
3044,9,5,4,2015,1016,0.61,61,Medium-High Digitalization,Small Course ( <15H )
3045,14,3,11,2015,1016,0.23,23,Medium-Low Digitalization,Small Course ( <15H )
3046,13,2,11,2015,1016,0.15,15,Low Digitalization,Small Course ( <15H )
3047,8,5,3,2015,1016,0.57,56,Medium-High Digitalization,Small Course ( <15H )
3048,52,24,28,2015,1016,0.47,47,Medium-Low Digitalization,High Course ( >40H )
3049,54,36,18,2015,1016,0.66,66,Medium-High Digitalization,High Course ( >40H )
3050,15,0,15,2015,1016,0.02,2,Low Digitalization,Small Course ( <15H )
3051,8,5,3,2015,1016,0.61,61,Medium-High Digitalization,Small Course ( <15H )
3052,90,52,38,2015,1016,0.58,57,Medium-High Digitalization,High Course ( >40H )
3053,58,44,14,2015,1016,0.75,75,Medium-High Digitalization,High Course ( >40H )
3054,12,12,0,2015,1016,0.99,99,High Digitalization,Small Course ( <15H )
3055,15,12,3,2015,1016,0.77,77,Medium-High Digitalization,Small Course ( <15H )
3056,12,5,7,2015,1016,0.43,43,Medium-Low Digitalization,Small Course ( <15H )
3057,38,35,3,2015,1016,0.93,93,High Digitalization,Medium Course ( >15H and <40H )
3058,52,24,28,2015,1016,0.47,47,Medium-Low Digitalization,High Course ( >40H )
3059,52,49,3,2015,1016,0.95,95,High Digitalization,High Course ( >40H )
3060,53,31,22,2015,1016,0.59,59,Medium-High Digitalization,High Course ( >40H )
3061,76,53,23,2015,1016,0.7,70,Medium-High Digitalization,High Course ( >40H )
3062,26,1,25,2015,1016,0.02,2,Low Digitalization,Medium Course ( >15H and <40H )
3063,33,33,0,2015,1016,0.99,99,High Digitalization,Medium Course ( >15H and <40H )
3064,81,13,68,2015,1016,0.16,16,Low Digitalization,High Course ( >40H )
3065,78,8,70,2015,1016,0.1,10,Low Digitalization,High Course ( >40H )
3066,25,12,12,2015,1016,0.5,50,Medium-Low Digitalization,Medium Course ( >15H and <40H )
3067,30,26,4,2015,1016,0.87,87,High Digitalization,Medium Course ( >15H and <40H )
3068,14,5,9,2015,1016,0.34,34,Medium-Low Digitalization,Small Course ( <15H )
3069,39,18,21,2015,1016,0.45,45,Medium-Low Digitalization,Medium Course ( >15H and <40H )
3070,71,62,9,2015,1016,0.87,87,High Digitalization,High Course ( >40H )
3071,17,10,7,2015,1016,0.56,56,Medium-High Digitalization,Medium Course ( >15H and <40H )
3072,33,5,28,2015,1016,0.14,14,Low Digitalization,Medium Course ( >15H and <40H )
3073,67,33,34,2015,1016,0.49,49,Medium-Low Digitalization,High Course ( >40H )
3074,35,5,30,2015,1016,0.14,14,Low Digitalization,Medium Course ( >15H and <40H )
3075,14,8,6,2015,1016,0.55,55,Medium-High Digitalization,Small Course ( <15H )
3076,85,48,37,2015,1016,0.57,56,Medium-High Digitalization,High Course ( >40H )
3077,75,9,66,2015,1016,0.12,12,Low Digitalization,High Course ( >40H )
3078,5,3,2,2015,1016,0.66,66,Medium-High Digitalization,Small Course ( <15H )
3079,66,11,55,2015,1016,0.17,17,Low Digitalization,High Course ( >40H )
3080,73,45,28,2015,1016,0.62,62,Medium-High Digitalization,High Course ( >40H )
3081,85,55,30,2015,1016,0.65,65,Medium-High Digitalization,High Course ( >40H )
3082,76,2,74,2015,1016,0.02,2,Low Digitalization,High Course ( >40H )
3083,78,9,69,2015,1016,0.12,12,Low Digitalization,High Course ( >40H )
3084,13,6,7,2015,1016,0.44,44,Medium-Low Digitalization,Small Course ( <15H )
3085,52,25,27,2015,1016,0.49,49,Medium-Low Digitalization,High Course ( >40H )
3086,5,0,5,2015,1016,0.06,6,Low Digitalization,Small Course ( <15H )
3087,81,9,72,2015,1016,0.11,11,Low Digitalization,High Course ( >40H )
3088,11,3,8,2015,1016,0.29,28,Medium-Low Digitalization,Small Course ( <15H )
3089,9,5,4,2015,1016,0.59,59,Medium-High Digitalization,Small Course ( <15H )
3090,78,67,11,2015,1016,0.86,86,High Digitalization,High Course ( >40H )
3091,21,8,13,2015,1016,0.4,40,Medium-Low Digitalization,Medium Course ( >15H and <40H )
3092,64,6,58,2015,1016,0.1,10,Low Digitalization,High Course ( >40H )
3093,31,6,25,2015,1016,0.2,20,Low Digitalization,Medium Course ( >15H and <40H )
3094,38,0,38,2015,1016,0.01,1,Low Digitalization,Medium Course ( >15H and <40H )
3095,24,19,5,2015,1016,0.8,80,Medium-High Digitalization,Medium Course ( >15H and <40H )
3096,28,14,14,2015,1016,0.51,51,Medium-High Digitalization,Medium Course ( >15H and <40H )
3097,13,11,2,2015,1016,0.87,87,High Digitalization,Small Course ( <15H )
3098,36,0,36,2015,1016,0.0,0,Low Digitalization,Medium Course ( >15H and <40H )
3099,53,32,21,2015,1016,0.6,60,Medium-High Digitalization,High Course ( >40H )
3100,12,7,5,2015,1016,0.56,56,Medium-High Digitalization,Small Course ( <15H )
3101,20,10,10,2015,1016,0.52,52,Medium-High Digitalization,Medium Course ( >15H and <40H )
3102,14,11,3,2015,1016,0.76,76,Medium-High Digitalization,Small Course ( <15H )
3103,37,7,30,2015,1016,0.19,19,Low Digitalization,Medium Course ( >15H and <40H )
3104,59,35,24,2016,1093,0.59,59,Medium-High Digitalization,High Course ( >40H )
3105,38,25,13,2016,1093,0.66,66,Medium-High Digitalization,Medium Course ( >15H and <40H )
3106,44,32,12,2016,1093,0.72,72,Medium-High Digitalization,High Course ( >40H )
3107,5,1,4,2016,1093,0.11,11,Low Digitalization,Small Course ( <15H )
3108,15,9,6,2016,1093,0.61,61,Medium-High Digitalization,Small Course ( <15H )
3109,36,0,36,2016,1093,0.01,1,Low Digitalization,Medium Course ( >15H and <40H )
3110,77,7,70,2016,1093,0.09,9,Low Digitalization,High Course ( >40H )
3111,36,20,16,2016,1093,0.56,56,Medium-High Digitalization,Medium Course ( >15H and <40H )
3112,14,12,2,2016,1093,0.85,85,High Digitalization,Small Course ( <15H )
3113,39,16,23,2016,1093,0.41,41,Medium-Low Digitalization,Medium Course ( >15H and <40H )
3114,7,6,1,2016,1093,0.84,84,High Digitalization,Small Course ( <15H )
3115,50,49,1,2016,1093,0.98,98,High Digitalization,High Course ( >40H )
3116,24,22,2,2016,1093,0.9,90,High Digitalization,Medium Course ( >15H and <40H )
3117,53,25,28,2016,1093,0.48,48,Medium-Low Digitalization,High Course ( >40H )
3118,8,4,4,2016,1093,0.44,44,Medium-Low Digitalization,Small Course ( <15H )
3119,37,2,35,2016,1093,0.06,6,Low Digitalization,Medium Course ( >15H and <40H )
3120,15,9,6,2016,1093,0.6,60,Medium-High Digitalization,Small Course ( <15H )
3121,60,37,23,2016,1093,0.61,61,Medium-High Digitalization,High Course ( >40H )
3122,18,16,2,2016,1093,0.89,89,High Digitalization,Medium Course ( >15H and <40H )
3123,27,19,8,2016,1093,0.72,72,Medium-High Digitalization,Medium Course ( >15H and <40H )
3124,15,5,10,2016,1093,0.34,34,Medium-Low Digitalization,Small Course ( <15H )
3125,54,48,6,2016,1093,0.89,89,High Digitalization,High Course ( >40H )
3126,84,39,45,2016,1093,0.47,47,Medium-Low Digitalization,High Course ( >40H )
3127,12,2,10,2016,1093,0.13,13,Low Digitalization,Small Course ( <15H )
3128,74,38,36,2016,1093,0.51,51,Medium-High Digitalization,High Course ( >40H )
3129,74,56,18,2016,1093,0.75,75,Medium-High Digitalization,High Course ( >40H )
3130,11,4,7,2016,1093,0.38,38,Medium-Low Digitalization,Small Course ( <15H )
3131,89,78,11,2016,1093,0.88,88,High Digitalization,High Course ( >40H )
3132,54,42,12,2016,1093,0.78,78,Medium-High Digitalization,High Course ( >40H )
3133,10,4,6,2016,1093,0.35,35,Medium-Low Digitalization,Small Course ( <15H )
3134,61,41,20,2016,1093,0.67,67,Medium-High Digitalization,High Course ( >40H )
3135,55,40,15,2016,1093,0.73,73,Medium-High Digitalization,High Course ( >40H )
3136,39,33,6,2016,1093,0.84,84,High Digitalization,Medium Course ( >15H and <40H )
3137,64,10,54,2016,1093,0.15,15,Low Digitalization,High Course ( >40H )
3138,52,1,51,2016,1093,0.02,2,Low Digitalization,High Course ( >40H )
3139,15,12,3,2016,1093,0.83,83,High Digitalization,Small Course ( <15H )
3140,41,21,20,2016,1093,0.51,51,Medium-High Digitalization,High Course ( >40H )
3141,12,4,8,2016,1093,0.32,32,Medium-Low Digitalization,Small Course ( <15H )
3142,65,21,44,2016,1093,0.33,33,Medium-Low Digitalization,High Course ( >40H )
3143,70,42,28,2016,1093,0.6,60,Medium-High Digitalization,High Course ( >40H )
3144,80,62,18,2016,1093,0.77,77,Medium-High Digitalization,High Course ( >40H )
3145,13,11,2,2016,1093,0.85,85,High Digitalization,Small Course ( <15H )
3146,11,5,6,2016,1093,0.49,49,Medium-Low Digitalization,Small Course ( <15H )
3147,33,17,16,2016,1093,0.52,52,Medium-High Digitalization,Medium Course ( >15H and <40H )
3148,56,38,18,2016,1093,0.68,68,Medium-High Digitalization,High Course ( >40H )
3149,59,53,6,2016,1093,0.9,90,High Digitalization,High Course ( >40H )
3150,80,78,2,2016,1093,0.98,98,High Digitalization,High Course ( >40H )
3151,23,8,15,2016,1093,0.33,33,Medium-Low Digitalization,Medium Course ( >15H and <40H )
3152,34,4,30,2016,1093,0.12,12,Low Digitalization,Medium Course ( >15H and <40H )
3153,19,7,12,2016,1093,0.37,37,Medium-Low Digitalization,Medium Course ( >15H and <40H )
3154,11,2,9,2016,1093,0.17,17,Low Digitalization,Small Course ( <15H )
3155,34,20,14,2016,1093,0.58,57,Medium-High Digitalization,Medium Course ( >15H and <40H )
3156,46,15,31,2016,1093,0.33,33,Medium-Low Digitalization,High Course ( >40H )
3157,19,11,8,2016,1093,0.6,60,Medium-High Digitalization,Medium Course ( >15H and <40H )
3158,9,5,4,2016,1093,0.6,60,Medium-High Digitalization,Small Course ( <15H )
3159,52,25,27,2016,1093,0.48,48,Medium-Low Digitalization,High Course ( >40H )
3160,45,27,18,2016,1093,0.61,61,Medium-High Digitalization,High Course ( >40H )
3161,13,4,9,2016,1093,0.28,28,Medium-Low Digitalization,Small Course ( <15H )
3162,48,32,16,2016,1093,0.66,66,Medium-High Digitalization,High Course ( >40H )
3163,16,14,2,2016,1093,0.9,90,High Digitalization,Medium Course ( >15H and <40H )
3164,14,2,12,2016,1093,0.14,14,Low Digitalization,Small Course ( <15H )
3165,14,3,11,2016,1093,0.22,22,Medium-Low Digitalization,Small Course ( <15H )
3166,43,22,21,2016,1093,0.51,51,Medium-High Digitalization,High Course ( >40H )
3167,14,9,5,2016,1093,0.61,61,Medium-High Digitalization,Small Course ( <15H )
3168,58,5,53,2016,1093,0.09,9,Low Digitalization,High Course ( >40H )
3169,16,10,6,2016,1093,0.63,63,Medium-High Digitalization,Medium Course ( >15H and <40H )
3170,52,23,29,2016,1093,0.44,44,Medium-Low Digitalization,High Course ( >40H )
3171,14,3,11,2016,1093,0.24,24,Medium-Low Digitalization,Small Course ( <15H )
3172,29,21,8,2016,1093,0.71,71,Medium-High Digitalization,Medium Course ( >15H and <40H )
3173,20,17,3,2016,1093,0.87,87,High Digitalization,Medium Course ( >15H and <40H )
3174,57,49,8,2016,1093,0.86,86,High Digitalization,High Course ( >40H )
3175,85,46,39,2016,1093,0.54,54,Medium-High Digitalization,High Course ( >40H )
3176,80,62,18,2016,1093,0.77,77,Medium-High Digitalization,High Course ( >40H )
3177,74,73,1,2016,1093,0.98,98,High Digitalization,High Course ( >40H )
3178,10,6,4,2016,1093,0.61,61,Medium-High Digitalization,Small Course ( <15H )
3179,14,12,2,2016,1093,0.89,89,High Digitalization,Small Course ( <15H )
3180,8,4,4,2016,1093,0.45,45,Medium-Low Digitalization,Small Course ( <15H )
3181,9,7,2,2016,1093,0.77,77,Medium-High Digitalization,Small Course ( <15H )
3182,16,11,5,2016,1093,0.69,69,Medium-High Digitalization,Medium Course ( >15H and <40H )
3183,58,7,51,2016,1093,0.12,12,Low Digitalization,High Course ( >40H )
3184,17,3,14,2016,1093,0.15,15,Low Digitalization,Medium Course ( >15H and <40H )
3185,37,23,14,2016,1093,0.61,61,Medium-High Digitalization,Medium Course ( >15H and <40H )
3186,14,3,11,2016,1093,0.24,24,Medium-Low Digitalization,Small Course ( <15H )
3187,81,3,78,2016,1093,0.04,4,Low Digitalization,High Course ( >40H )
3188,37,6,31,2016,1093,0.16,16,Low Digitalization,Medium Course ( >15H and <40H )
3189,88,60,28,2016,1093,0.68,68,Medium-High Digitalization,High Course ( >40H )
3190,24,8,16,2016,1093,0.33,33,Medium-Low Digitalization,Medium Course ( >15H and <40H )
3191,15,9,6,2016,1093,0.61,61,Medium-High Digitalization,Small Course ( <15H )
3192,70,58,12,2016,1093,0.83,83,High Digitalization,High Course ( >40H )
3193,15,14,1,2016,1093,0.93,93,High Digitalization,Small Course ( <15H )
3194,38,29,9,2016,1093,0.76,76,Medium-High Digitalization,Medium Course ( >15H and <40H )
3195,66,61,5,2016,1093,0.92,92,High Digitalization,High Course ( >40H )
3196,29,3,26,2016,1093,0.09,9,Low Digitalization,Medium Course ( >15H and <40H )
3197,71,21,50,2016,1093,0.3,30,Medium-Low Digitalization,High Course ( >40H )
3198,58,31,27,2016,1093,0.54,54,Medium-High Digitalization,High Course ( >40H )
3199,30,15,15,2016,1093,0.51,51,Medium-High Digitalization,Medium Course ( >15H and <40H )
3200,43,30,13,2016,1093,0.69,69,Medium-High Digitalization,High Course ( >40H )
3201,22,20,2,2016,1093,0.89,89,High Digitalization,Medium Course ( >15H and <40H )
3202,45,4,41,2016,1093,0.09,9,Low Digitalization,High Course ( >40H )
3203,8,3,5,2016,1093,0.42,42,Medium-Low Digitalization,Small Course ( <15H )
3204,40,10,30,2016,1093,0.25,25,Medium-Low Digitalization,High Course ( >40H )
3205,12,5,7,2016,1093,0.4,40,Medium-Low Digitalization,Small Course ( <15H )
3206,14,9,5,2016,1093,0.66,66,Medium-High Digitalization,Small Course ( <15H )
3207,14,8,6,2016,1093,0.59,59,Medium-High Digitalization,Small Course ( <15H )
3208,25,15,10,2016,1093,0.61,61,Medium-High Digitalization,Medium Course ( >15H and <40H )
3209,5,3,2,2016,1093,0.6,60,Medium-High Digitalization,Small Course ( <15H )
3210,13,6,7,2016,1093,0.47,47,Medium-Low Digitalization,Small Course ( <15H )
3211,60,10,50,2016,1093,0.17,17,Low Digitalization,High Course ( >40H )
3212,29,23,6,2016,1093,0.78,78,Medium-High Digitalization,Medium Course ( >15H and <40H )
3213,15,1,14,2016,1093,0.05,5,Low Digitalization,Small Course ( <15H )
3214,28,10,18,2016,1093,0.35,35,Medium-Low Digitalization,Medium Course ( >15H and <40H )
3215,10,1,9,2016,1093,0.11,11,Low Digitalization,Small Course ( <15H )
3216,5,2,3,2016,1093,0.31,31,Medium-Low Digitalization,Small Course ( <15H )
3217,77,37,40,2016,1093,0.48,48,Medium-Low Digitalization,High Course ( >40H )
3218,76,54,22,2016,1093,0.71,71,Medium-High Digitalization,High Course ( >40H )
3219,6,4,2,2016,1093,0.64,64,Medium-High Digitalization,Small Course ( <15H )
3220,50,25,25,2016,1093,0.5,50,Medium-Low Digitalization,High Course ( >40H )
3221,25,22,4,2016,1093,0.86,86,High Digitalization,Medium Course ( >15H and <40H )
3222,24,0,24,2016,1093,0.01,1,Low Digitalization,Medium Course ( >15H and <40H )
3223,58,51,7,2016,1093,0.88,88,High Digitalization,High Course ( >40H )
3224,14,11,3,2016,1093,0.78,78,Medium-High Digitalization,Small Course ( <15H )
3225,19,9,10,2016,1093,0.46,46,Medium-Low Digitalization,Medium Course ( >15H and <40H )
3226,49,2,47,2016,1093,0.05,5,Low Digitalization,High Course ( >40H )
3227,10,9,1,2016,1093,0.86,86,High Digitalization,Small Course ( <15H )
3228,46,19,27,2016,1093,0.41,41,Medium-Low Digitalization,High Course ( >40H )
3229,6,0,6,2016,1093,0.06,6,Low Digitalization,Small Course ( <15H )
3230,8,5,3,2016,1093,0.63,63,Medium-High Digitalization,Small Course ( <15H )
3231,11,11,0,2016,1093,0.99,99,High Digitalization,Small Course ( <15H )
3232,7,5,2,2016,1093,0.68,68,Medium-High Digitalization,Small Course ( <15H )
3233,49,14,35,2016,1093,0.28,28,Medium-Low Digitalization,High Course ( >40H )
3234,53,32,21,2016,1093,0.6,60,Medium-High Digitalization,High Course ( >40H )
3235,25,9,16,2016,1093,0.35,35,Medium-Low Digitalization,Medium Course ( >15H and <40H )
3236,67,20,47,2016,1093,0.3,30,Medium-Low Digitalization,High Course ( >40H )
3237,48,18,30,2016,1093,0.37,37,Medium-Low Digitalization,High Course ( >40H )
3238,42,31,11,2016,1093,0.74,74,Medium-High Digitalization,High Course ( >40H )
3239,50,35,15,2016,1093,0.7,70,Medium-High Digitalization,High Course ( >40H )
3240,53,52,1,2016,1093,0.98,98,High Digitalization,High Course ( >40H )
3241,56,11,45,2016,1093,0.2,20,Low Digitalization,High Course ( >40H )
3242,40,8,32,2016,1093,0.19,19,Low Digitalization,High Course ( >40H )
3243,22,4,18,2016,1093,0.19,19,Low Digitalization,Medium Course ( >15H and <40H )
3244,47,6,41,2016,1093,0.12,12,Low Digitalization,High Course ( >40H )
3245,24,6,18,2016,1093,0.24,24,Medium-Low Digitalization,Medium Course ( >15H and <40H )
3246,7,0,7,2016,1093,0.0,0,Low Digitalization,Small Course ( <15H )
3247,10,5,5,2016,1093,0.54,54,Medium-High Digitalization,Small Course ( <15H )
3248,55,47,8,2016,1093,0.86,86,High Digitalization,High Course ( >40H )
3249,34,4,30,2016,1093,0.12,12,Low Digitalization,Medium Course ( >15H and <40H )
3250,29,18,11,2016,1093,0.62,62,Medium-High Digitalization,Medium Course ( >15H and <40H )
3251,71,13,58,2016,1093,0.18,18,Low Digitalization,High Course ( >40H )
3252,6,6,0,2016,1093,0.93,93,High Digitalization,Small Course ( <15H )
3253,57,25,32,2016,1093,0.43,43,Medium-Low Digitalization,High Course ( >40H )
3254,60,7,53,2016,1093,0.11,11,Low Digitalization,High Course ( >40H )
3255,82,28,54,2016,1093,0.34,34,Medium-Low Digitalization,High Course ( >40H )
3256,40,3,37,2016,1093,0.08,8,Low Digitalization,High Course ( >40H )
3257,65,25,40,2016,1093,0.38,38,Medium-Low Digitalization,High Course ( >40H )
3258,76,46,30,2016,1093,0.6,60,Medium-High Digitalization,High Course ( >40H )
3259,28,14,14,2016,1093,0.5,50,Medium-Low Digitalization,Medium Course ( >15H and <40H )
3260,12,11,1,2016,1093,0.9,90,High Digitalization,Small Course ( <15H )
3261,46,42,4,2016,1093,0.92,92,High Digitalization,High Course ( >40H )
3262,31,21,10,2016,1093,0.68,68,Medium-High Digitalization,Medium Course ( >15H and <40H )
3263,8,5,3,2016,1093,0.63,63,Medium-High Digitalization,Small Course ( <15H )
3264,88,85,3,2016,1093,0.97,97,High Digitalization,High Course ( >40H )
3265,76,35,41,2016,1093,0.46,46,Medium-Low Digitalization,High Course ( >40H )
3266,55,26,29,2016,1093,0.48,48,Medium-Low Digitalization,High Course ( >40H )
3267,15,9,6,2016,1093,0.63,63,Medium-High Digitalization,Small Course ( <15H )
3268,32,31,1,2016,1093,0.98,98,High Digitalization,Medium Course ( >15H and <40H )
3269,60,9,51,2016,1093,0.15,15,Low Digitalization,High Course ( >40H )
3270,5,1,4,2016,1093,0.11,11,Low Digitalization,Small Course ( <15H )
3271,68,46,22,2016,1093,0.68,68,Medium-High Digitalization,High Course ( >40H )
3272,54,11,43,2016,1093,0.21,21,Medium-Low Digitalization,High Course ( >40H )
3273,57,41,16,2016,1093,0.72,72,Medium-High Digitalization,High Course ( >40H )
3274,58,3,55,2016,1093,0.06,6,Low Digitalization,High Course ( >40H )
3275,60,33,27,2016,1093,0.55,55,Medium-High Digitalization,High Course ( >40H )
3276,65,32,32,2016,1093,0.5,50,Medium-Low Digitalization,High Course ( >40H )
3277,58,49,9,2016,1093,0.84,84,High Digitalization,High Course ( >40H )
3278,80,42,38,2016,1093,0.53,53,Medium-High Digitalization,High Course ( >40H )
3279,41,8,33,2016,1093,0.2,20,Low Digitalization,High Course ( >40H )
3280,39,29,10,2016,1093,0.75,75,Medium-High Digitalization,Medium Course ( >15H and <40H )
3281,76,14,62,2016,1093,0.19,19,Low Digitalization,High Course ( >40H )
3282,11,4,7,2016,1093,0.38,38,Medium-Low Digitalization,Small Course ( <15H )
3283,39,8,31,2016,1093,0.2,20,Low Digitalization,Medium Course ( >15H and <40H )
3284,29,21,8,2016,1093,0.74,74,Medium-High Digitalization,Medium Course ( >15H and <40H )
3285,46,22,24,2016,1093,0.47,47,Medium-Low Digitalization,High Course ( >40H )
3286,87,32,55,2016,1093,0.37,37,Medium-Low Digitalization,High Course ( >40H )
3287,8,3,5,2016,1093,0.34,34,Medium-Low Digitalization,Small Course ( <15H )
3288,12,6,6,2016,1093,0.47,47,Medium-Low Digitalization,Small Course ( <15H )
3289,9,4,5,2016,1093,0.46,46,Medium-Low Digitalization,Small Course ( <15H )
3290,29,1,28,2016,1093,0.05,5,Low Digitalization,Medium Course ( >15H and <40H )
3291,85,54,31,2016,1093,0.64,64,Medium-High Digitalization,High Course ( >40H )
3292,86,10,76,2016,1093,0.12,12,Low Digitalization,High Course ( >40H )
3293,55,2,53,2016,1093,0.04,4,Low Digitalization,High Course ( >40H )
3294,42,23,19,2016,1093,0.54,54,Medium-High Digitalization,High Course ( >40H )
3295,28,21,7,2016,1093,0.76,76,Medium-High Digitalization,Medium Course ( >15H and <40H )
3296,39,27,12,2016,1093,0.68,68,Medium-High Digitalization,Medium Course ( >15H and <40H )
3297,47,12,35,2016,1093,0.26,26,Medium-Low Digitalization,High Course ( >40H )
3298,61,55,6,2016,1093,0.9,90,High Digitalization,High Course ( >40H )
3299,51,41,10,2016,1093,0.8,80,Medium-High Digitalization,High Course ( >40H )
3300,38,17,21,2016,1093,0.46,46,Medium-Low Digitalization,Medium Course ( >15H and <40H )
3301,12,9,3,2016,1093,0.77,77,Medium-High Digitalization,Small Course ( <15H )
3302,20,14,6,2016,1093,0.69,69,Medium-High Digitalization,Medium Course ( >15H and <40H )
3303,41,5,36,2016,1093,0.12,12,Low Digitalization,High Course ( >40H )
3304,79,70,9,2016,1093,0.88,88,High Digitalization,High Course ( >40H )
3305,23,21,2,2016,1093,0.92,92,High Digitalization,Medium Course ( >15H and <40H )
3306,58,17,41,2016,1093,0.29,28,Medium-Low Digitalization,High Course ( >40H )
3307,12,5,7,2016,1093,0.41,41,Medium-Low Digitalization,Small Course ( <15H )
3308,33,27,6,2016,1093,0.82,82,High Digitalization,Medium Course ( >15H and <40H )
3309,24,2,22,2016,1093,0.09,9,Low Digitalization,Medium Course ( >15H and <40H )
3310,23,13,10,2016,1093,0.58,57,Medium-High Digitalization,Medium Course ( >15H and <40H )
3311,79,62,17,2016,1093,0.79,79,Medium-High Digitalization,High Course ( >40H )
3312,63,32,32,2016,1093,0.5,50,Medium-Low Digitalization,High Course ( >40H )
3313,12,3,9,2016,1093,0.28,28,Medium-Low Digitalization,Small Course ( <15H )
3314,81,63,18,2016,1093,0.78,78,Medium-High Digitalization,High Course ( >40H )
3315,12,8,4,2016,1093,0.63,63,Medium-High Digitalization,Small Course ( <15H )
3316,83,42,41,2016,1093,0.51,51,Medium-High Digitalization,High Course ( >40H )
3317,8,4,4,2016,1093,0.53,53,Medium-High Digitalization,Small Course ( <15H )
3318,46,27,19,2016,1093,0.58,57,Medium-High Digitalization,High Course ( >40H )
3319,15,11,4,2016,1093,0.76,76,Medium-High Digitalization,Small Course ( <15H )
3320,13,12,1,2016,1093,0.92,92,High Digitalization,Small Course ( <15H )
3321,54,47,7,2016,1093,0.87,87,High Digitalization,High Course ( >40H )
3322,9,7,2,2016,1093,0.73,73,Medium-High Digitalization,Small Course ( <15H )
3323,77,32,45,2016,1093,0.42,42,Medium-Low Digitalization,High Course ( >40H )
3324,77,71,6,2016,1093,0.92,92,High Digitalization,High Course ( >40H )
3325,87,37,50,2016,1093,0.42,42,Medium-Low Digitalization,High Course ( >40H )
3326,27,22,5,2016,1093,0.8,80,Medium-High Digitalization,Medium Course ( >15H and <40H )
3327,82,11,71,2016,1093,0.13,13,Low Digitalization,High Course ( >40H )
3328,36,6,30,2016,1093,0.17,17,Low Digitalization,Medium Course ( >15H and <40H )
3329,6,3,3,2016,1093,0.5,50,Medium-Low Digitalization,Small Course ( <15H )
3330,79,39,40,2016,1093,0.49,49,Medium-Low Digitalization,High Course ( >40H )
3331,14,1,13,2016,1093,0.06,6,Low Digitalization,Small Course ( <15H )
3332,46,44,2,2016,1093,0.96,96,High Digitalization,High Course ( >40H )
3333,74,66,8,2016,1093,0.89,89,High Digitalization,High Course ( >40H )
3334,36,34,2,2016,1093,0.94,94,High Digitalization,Medium Course ( >15H and <40H )
3335,70,62,8,2016,1093,0.89,89,High Digitalization,High Course ( >40H )
3336,22,2,20,2016,1093,0.09,9,Low Digitalization,Medium Course ( >15H and <40H )
3337,16,12,4,2016,1093,0.78,78,Medium-High Digitalization,Medium Course ( >15H and <40H )
3338,62,12,50,2016,1093,0.2,20,Low Digitalization,High Course ( >40H )
3339,11,10,1,2016,1093,0.87,87,High Digitalization,Small Course ( <15H )
3340,34,2,32,2016,1093,0.05,5,Low Digitalization,Medium Course ( >15H and <40H )
3341,15,12,3,2016,1093,0.81,81,High Digitalization,Small Course ( <15H )
3342,41,34,7,2016,1093,0.82,82,High Digitalization,High Course ( >40H )
3343,56,20,36,2016,1093,0.35,35,Medium-Low Digitalization,High Course ( >40H )
3344,10,8,2,2016,1093,0.79,79,Medium-High Digitalization,Small Course ( <15H )
3345,67,42,25,2016,1093,0.63,63,Medium-High Digitalization,High Course ( >40H )
3346,55,53,2,2016,1093,0.96,96,High Digitalization,High Course ( >40H )
3347,70,6,64,2016,1093,0.09,9,Low Digitalization,High Course ( >40H )
3348,69,58,11,2016,1093,0.84,84,High Digitalization,High Course ( >40H )
3349,46,37,9,2016,1093,0.81,81,High Digitalization,High Course ( >40H )
3350,90,86,4,2016,1093,0.96,96,High Digitalization,High Course ( >40H )
3351,22,19,3,2016,1093,0.88,88,High Digitalization,Medium Course ( >15H and <40H )
3352,48,35,13,2016,1093,0.72,72,Medium-High Digitalization,High Course ( >40H )
3353,84,13,71,2016,1093,0.16,16,Low Digitalization,High Course ( >40H )
3354,27,16,11,2016,1093,0.59,59,Medium-High Digitalization,Medium Course ( >15H and <40H )
3355,36,3,33,2016,1093,0.07,7,Low Digitalization,Medium Course ( >15H and <40H )
3356,88,11,77,2016,1093,0.13,13,Low Digitalization,High Course ( >40H )
3357,55,53,2,2016,1093,0.97,97,High Digitalization,High Course ( >40H )
3358,29,15,14,2016,1093,0.53,53,Medium-High Digitalization,Medium Course ( >15H and <40H )
3359,31,19,12,2016,1093,0.61,61,Medium-High Digitalization,Medium Course ( >15H and <40H )
3360,48,13,35,2016,1093,0.28,28,Medium-Low Digitalization,High Course ( >40H )
3361,24,6,18,2016,1093,0.24,24,Medium-Low Digitalization,Medium Course ( >15H and <40H )
3362,7,2,5,2016,1093,0.25,25,Medium-Low Digitalization,Small Course ( <15H )
3363,21,17,4,2016,1093,0.82,82,High Digitalization,Medium Course ( >15H and <40H )
3364,29,11,18,2016,1093,0.39,39,Medium-Low Digitalization,Medium Course ( >15H and <40H )
3365,13,10,3,2016,1093,0.79,79,Medium-High Digitalization,Small Course ( <15H )
3366,10,9,1,2016,1093,0.91,91,High Digitalization,Small Course ( <15H )
3367,39,21,18,2016,1093,0.53,53,Medium-High Digitalization,Medium Course ( >15H and <40H )
3368,18,16,2,2016,1093,0.9,90,High Digitalization,Medium Course ( >15H and <40H )
3369,67,14,53,2016,1093,0.21,21,Medium-Low Digitalization,High Course ( >40H )
3370,5,3,2,2016,1093,0.6,60,Medium-High Digitalization,Small Course ( <15H )
3371,22,9,13,2016,1093,0.41,41,Medium-Low Digitalization,Medium Course ( >15H and <40H )
3372,43,17,26,2016,1093,0.39,39,Medium-Low Digitalization,High Course ( >40H )
3373,14,2,12,2016,1093,0.14,14,Low Digitalization,Small Course ( <15H )
3374,56,54,2,2016,1093,0.97,97,High Digitalization,High Course ( >40H )
3375,82,6,76,2016,1093,0.07,7,Low Digitalization,High Course ( >40H )
3376,7,1,6,2016,1093,0.16,16,Low Digitalization,Small Course ( <15H )
3377,18,10,8,2016,1093,0.54,54,Medium-High Digitalization,Medium Course ( >15H and <40H )
3378,54,45,9,2016,1093,0.84,84,High Digitalization,High Course ( >40H )
3379,51,50,1,2016,1093,0.98,98,High Digitalization,High Course ( >40H )
3380,17,11,6,2016,1093,0.62,62,Medium-High Digitalization,Medium Course ( >15H and <40H )
3381,49,5,44,2016,1093,0.11,11,Low Digitalization,High Course ( >40H )
3382,9,7,2,2016,1093,0.82,82,High Digitalization,Small Course ( <15H )
3383,26,12,14,2016,1093,0.46,46,Medium-Low Digitalization,Medium Course ( >15H and <40H )
3384,52,3,49,2016,1093,0.06,6,Low Digitalization,High Course ( >40H )
3385,55,46,9,2016,1093,0.83,83,High Digitalization,High Course ( >40H )
3386,24,20,4,2016,1093,0.82,82,High Digitalization,Medium Course ( >15H and <40H )
3387,15,5,10,2016,1093,0.32,32,Medium-Low Digitalization,Small Course ( <15H )
3388,88,57,31,2016,1093,0.65,65,Medium-High Digitalization,High Course ( >40H )
3389,89,85,4,2016,1093,0.95,95,High Digitalization,High Course ( >40H )
3390,43,21,22,2016,1093,0.48,48,Medium-Low Digitalization,High Course ( >40H )
3391,54,18,36,2016,1093,0.34,34,Medium-Low Digitalization,High Course ( >40H )
3392,45,34,11,2016,1093,0.76,76,Medium-High Digitalization,High Course ( >40H )
3393,37,30,7,2016,1093,0.82,82,High Digitalization,Medium Course ( >15H and <40H )
3394,50,7,43,2016,1093,0.14,14,Low Digitalization,High Course ( >40H )
3395,7,4,3,2016,1093,0.53,53,Medium-High Digitalization,Small Course ( <15H )
3396,78,55,23,2016,1093,0.71,71,Medium-High Digitalization,High Course ( >40H )
3397,6,0,6,2016,1093,0.06,6,Low Digitalization,Small Course ( <15H )
3398,6,3,3,2016,1093,0.45,45,Medium-Low Digitalization,Small Course ( <15H )
3399,36,8,28,2016,1093,0.21,21,Medium-Low Digitalization,Medium Course ( >15H and <40H )
3400,5,5,0,2016,1093,0.95,95,High Digitalization,Small Course ( <15H )
3401,8,4,4,2016,1093,0.52,52,Medium-High Digitalization,Small Course ( <15H )
3402,31,20,11,2016,1093,0.65,65,Medium-High Digitalization,Medium Course ( >15H and <40H )
3403,28,8,20,2016,1093,0.28,28,Medium-Low Digitalization,Medium Course ( >15H and <40H )
3404,15,10,5,2016,1093,0.67,67,Medium-High Digitalization,Small Course ( <15H )
3405,54,15,39,2016,1093,0.28,28,Medium-Low Digitalization,High Course ( >40H )
3406,20,12,8,2016,1093,0.59,59,Medium-High Digitalization,Medium Course ( >15H and <40H )
3407,20,6,14,2016,1093,0.28,28,Medium-Low Digitalization,Medium Course ( >15H and <40H )
3408,9,3,6,2016,1093,0.28,28,Medium-Low Digitalization,Small Course ( <15H )
3409,60,19,41,2016,1093,0.32,32,Medium-Low Digitalization,High Course ( >40H )
3410,66,44,22,2016,1093,0.67,67,Medium-High Digitalization,High Course ( >40H )
3411,14,1,13,2016,1093,0.06,6,Low Digitalization,Small Course ( <15H )
3412,12,2,10,2016,1093,0.13,13,Low Digitalization,Small Course ( <15H )
3413,23,13,10,2016,1093,0.57,56,Medium-High Digitalization,Medium Course ( >15H and <40H )
3414,66,42,24,2016,1093,0.64,64,Medium-High Digitalization,High Course ( >40H )
3415,47,25,22,2016,1093,0.54,54,Medium-High Digitalization,High Course ( >40H )
3416,40,26,14,2016,1093,0.65,65,Medium-High Digitalization,High Course ( >40H )
3417,8,2,6,2016,1093,0.28,28,Medium-Low Digitalization,Small Course ( <15H )
3418,14,13,1,2016,1093,0.96,96,High Digitalization,Small Course ( <15H )
3419,70,38,32,2016,1093,0.54,54,Medium-High Digitalization,High Course ( >40H )
3420,10,2,8,2016,1093,0.2,20,Low Digitalization,Small Course ( <15H )
3421,11,3,8,2016,1093,0.3,30,Medium-Low Digitalization,Small Course ( <15H )
3422,15,4,11,2016,1093,0.25,25,Medium-Low Digitalization,Small Course ( <15H )
3423,52,21,31,2016,1093,0.4,40,Medium-Low Digitalization,High Course ( >40H )
3424,6,1,5,2016,1093,0.1,10,Low Digitalization,Small Course ( <15H )
3425,8,7,1,2016,1093,0.83,83,High Digitalization,Small Course ( <15H )
3426,21,8,13,2016,1093,0.36,36,Medium-Low Digitalization,Medium Course ( >15H and <40H )
3427,6,1,5,2016,1093,0.21,21,Medium-Low Digitalization,Small Course ( <15H )
3428,11,2,9,2016,1093,0.17,17,Low Digitalization,Small Course ( <15H )
3429,58,26,32,2016,1093,0.45,45,Medium-Low Digitalization,High Course ( >40H )
3430,36,27,9,2016,1093,0.75,75,Medium-High Digitalization,Medium Course ( >15H and <40H )
3431,47,12,35,2016,1093,0.25,25,Medium-Low Digitalization,High Course ( >40H )
3432,61,33,28,2016,1093,0.54,54,Medium-High Digitalization,High Course ( >40H )
3433,54,36,18,2016,1093,0.66,66,Medium-High Digitalization,High Course ( >40H )
3434,47,13,34,2016,1093,0.27,27,Medium-Low Digitalization,High Course ( >40H )
3435,74,29,45,2016,1093,0.39,39,Medium-Low Digitalization,High Course ( >40H )
3436,86,55,31,2016,1093,0.64,64,Medium-High Digitalization,High Course ( >40H )
3437,51,48,3,2016,1093,0.95,95,High Digitalization,High Course ( >40H )
3438,52,3,49,2016,1093,0.06,6,Low Digitalization,High Course ( >40H )
3439,15,6,9,2016,1093,0.4,40,Medium-Low Digitalization,Small Course ( <15H )
3440,10,1,9,2016,1093,0.06,6,Low Digitalization,Small Course ( <15H )
3441,29,7,22,2016,1093,0.24,24,Medium-Low Digitalization,Medium Course ( >15H and <40H )
3442,72,42,30,2016,1093,0.58,57,Medium-High Digitalization,High Course ( >40H )
3443,37,1,36,2016,1093,0.04,4,Low Digitalization,Medium Course ( >15H and <40H )
3444,10,9,1,2016,1093,0.92,92,High Digitalization,Small Course ( <15H )
3445,56,38,18,2016,1093,0.67,67,Medium-High Digitalization,High Course ( >40H )
3446,35,34,1,2016,1093,0.97,97,High Digitalization,Medium Course ( >15H and <40H )
3447,47,41,6,2016,1093,0.87,87,High Digitalization,High Course ( >40H )
3448,19,0,19,2016,1093,0.02,2,Low Digitalization,Medium Course ( >15H and <40H )
3449,11,9,2,2016,1093,0.8,80,Medium-High Digitalization,Small Course ( <15H )
3450,82,40,42,2016,1093,0.49,49,Medium-Low Digitalization,High Course ( >40H )
3451,16,5,11,2016,1093,0.32,32,Medium-Low Digitalization,Medium Course ( >15H and <40H )
3452,28,4,24,2016,1093,0.16,16,Low Digitalization,Medium Course ( >15H and <40H )
3453,7,1,6,2016,1093,0.18,18,Low Digitalization,Small Course ( <15H )
3454,34,27,7,2016,1093,0.78,78,Medium-High Digitalization,Medium Course ( >15H and <40H )
3455,51,2,49,2016,1093,0.03,3,Low Digitalization,High Course ( >40H )
3456,8,2,6,2016,1093,0.2,20,Low Digitalization,Small Course ( <15H )
3457,72,18,54,2016,1093,0.25,25,Medium-Low Digitalization,High Course ( >40H )
3458,43,18,25,2016,1093,0.41,41,Medium-Low Digitalization,High Course ( >40H )
3459,14,10,4,2016,1093,0.75,75,Medium-High Digitalization,Small Course ( <15H )
3460,55,31,24,2016,1093,0.57,56,Medium-High Digitalization,High Course ( >40H )
3461,48,47,1,2016,1093,0.98,98,High Digitalization,High Course ( >40H )
3462,12,3,9,2016,1093,0.25,25,Medium-Low Digitalization,Small Course ( <15H )
3463,6,4,2,2016,1093,0.68,68,Medium-High Digitalization,Small Course ( <15H )
3464,59,18,41,2016,1093,0.3,30,Medium-Low Digitalization,High Course ( >40H )
3465,7,4,3,2016,1093,0.57,56,Medium-High Digitalization,Small Course ( <15H )
3466,83,69,14,2016,1093,0.83,83,High Digitalization,High Course ( >40H )
3467,59,20,39,2016,1093,0.34,34,Medium-Low Digitalization,High Course ( >40H )
3468,23,18,5,2016,1093,0.8,80,Medium-High Digitalization,Medium Course ( >15H and <40H )
3469,44,16,28,2016,1093,0.36,36,Medium-Low Digitalization,High Course ( >40H )
3470,46,30,16,2016,1093,0.66,66,Medium-High Digitalization,High Course ( >40H )
3471,52,33,19,2016,1093,0.63,63,Medium-High Digitalization,High Course ( >40H )
3472,89,86,3,2016,1093,0.97,97,High Digitalization,High Course ( >40H )
3473,46,46,0,2016,1093,1.0,100,High Digitalization,High Course ( >40H )
3474,90,25,65,2016,1093,0.28,28,Medium-Low Digitalization,High Course ( >40H )
3475,62,47,15,2016,1093,0.76,76,Medium-High Digitalization,High Course ( >40H )
3476,86,15,71,2016,1093,0.18,18,Low Digitalization,High Course ( >40H )
3477,45,13,32,2016,1093,0.28,28,Medium-Low Digitalization,High Course ( >40H )
3478,51,18,33,2016,1093,0.35,35,Medium-Low Digitalization,High Course ( >40H )
3479,71,36,36,2016,1093,0.5,50,Medium-Low Digitalization,High Course ( >40H )
3480,44,21,23,2016,1093,0.48,48,Medium-Low Digitalization,High Course ( >40H )
3481,25,8,17,2016,1093,0.31,31,Medium-Low Digitalization,Medium Course ( >15H and <40H )
3482,33,12,21,2016,1093,0.37,37,Medium-Low Digitalization,Medium Course ( >15H and <40H )
3483,11,5,6,2016,1093,0.44,44,Medium-Low Digitalization,Small Course ( <15H )
3484,74,46,28,2016,1093,0.62,62,Medium-High Digitalization,High Course ( >40H )
3485,18,10,8,2016,1093,0.57,56,Medium-High Digitalization,Medium Course ( >15H and <40H )
3486,63,51,12,2016,1093,0.81,81,High Digitalization,High Course ( >40H )
3487,7,5,2,2016,1093,0.67,67,Medium-High Digitalization,Small Course ( <15H )
3488,46,37,9,2016,1093,0.8,80,Medium-High Digitalization,High Course ( >40H )
3489,34,18,16,2016,1093,0.52,52,Medium-High Digitalization,Medium Course ( >15H and <40H )
3490,68,31,37,2016,1093,0.46,46,Medium-Low Digitalization,High Course ( >40H )
3491,12,11,1,2016,1093,0.92,92,High Digitalization,Small Course ( <15H )
3492,16,16,0,2016,1093,0.97,97,High Digitalization,Medium Course ( >15H and <40H )
3493,62,42,20,2016,1093,0.67,67,Medium-High Digitalization,High Course ( >40H )
3494,9,7,2,2016,1093,0.76,76,Medium-High Digitalization,Small Course ( <15H )
3495,21,17,4,2016,1093,0.83,83,High Digitalization,Medium Course ( >15H and <40H )
3496,32,21,11,2016,1093,0.66,66,Medium-High Digitalization,Medium Course ( >15H and <40H )
3497,46,37,9,2016,1093,0.81,81,High Digitalization,High Course ( >40H )
3498,44,27,17,2016,1093,0.61,61,Medium-High Digitalization,High Course ( >40H )
3499,9,7,2,2016,1093,0.75,75,Medium-High Digitalization,Small Course ( <15H )
3500,47,41,6,2016,1093,0.87,87,High Digitalization,High Course ( >40H )
3501,57,27,30,2016,1093,0.48,48,Medium-Low Digitalization,High Course ( >40H )
3502,42,26,16,2016,1093,0.61,61,Medium-High Digitalization,High Course ( >40H )
3503,8,4,4,2016,1093,0.44,44,Medium-Low Digitalization,Small Course ( <15H )
3504,73,26,47,2016,1093,0.35,35,Medium-Low Digitalization,High Course ( >40H )
3505,32,26,6,2016,1093,0.8,80,Medium-High Digitalization,Medium Course ( >15H and <40H )
3506,67,58,9,2016,1093,0.86,86,High Digitalization,High Course ( >40H )
3507,76,36,40,2016,1093,0.47,47,Medium-Low Digitalization,High Course ( >40H )
3508,33,3,30,2016,1093,0.09,9,Low Digitalization,Medium Course ( >15H and <40H )
3509,85,38,47,2016,1093,0.45,45,Medium-Low Digitalization,High Course ( >40H )
3510,55,37,18,2016,1093,0.67,67,Medium-High Digitalization,High Course ( >40H )
3511,6,6,0,2016,1093,1.0,100,High Digitalization,Small Course ( <15H )
3512,59,40,19,2016,1093,0.68,68,Medium-High Digitalization,High Course ( >40H )
3513,52,18,34,2016,1093,0.35,35,Medium-Low Digitalization,High Course ( >40H )
3514,22,6,16,2016,1093,0.29,28,Medium-Low Digitalization,Medium Course ( >15H and <40H )
3515,47,10,37,2016,1093,0.22,22,Medium-Low Digitalization,High Course ( >40H )
3516,20,8,12,2016,1093,0.4,40,Medium-Low Digitalization,Medium Course ( >15H and <40H )
3517,14,5,9,2016,1093,0.33,33,Medium-Low Digitalization,Small Course ( <15H )
3518,20,5,15,2016,1093,0.25,25,Medium-Low Digitalization,Medium Course ( >15H and <40H )
3519,50,8,42,2016,1093,0.17,17,Low Digitalization,High Course ( >40H )
3520,6,0,6,2016,1093,0.05,5,Low Digitalization,Small Course ( <15H )
3521,32,24,8,2016,1093,0.74,74,Medium-High Digitalization,Medium Course ( >15H and <40H )
3522,11,2,9,2016,1093,0.16,16,Low Digitalization,Small Course ( <15H )
3523,72,51,21,2016,1093,0.71,71,Medium-High Digitalization,High Course ( >40H )
3524,9,5,4,2016,1093,0.61,61,Medium-High Digitalization,Small Course ( <15H )
3525,15,2,13,2016,1093,0.14,14,Low Digitalization,Small Course ( <15H )
3526,9,1,8,2016,1093,0.09,9,Low Digitalization,Small Course ( <15H )
3527,16,3,13,2016,1093,0.16,16,Low Digitalization,Medium Course ( >15H and <40H )
3528,14,9,5,2016,1093,0.64,64,Medium-High Digitalization,Small Course ( <15H )
3529,31,24,7,2016,1093,0.79,79,Medium-High Digitalization,Medium Course ( >15H and <40H )
3530,60,1,59,2016,1093,0.01,1,Low Digitalization,High Course ( >40H )
3531,59,31,28,2016,1093,0.53,53,Medium-High Digitalization,High Course ( >40H )
3532,7,1,6,2016,1093,0.2,20,Low Digitalization,Small Course ( <15H )
3533,70,58,12,2016,1093,0.83,83,High Digitalization,High Course ( >40H )
3534,55,20,35,2016,1093,0.36,36,Medium-Low Digitalization,High Course ( >40H )
3535,59,8,51,2016,1093,0.14,14,Low Digitalization,High Course ( >40H )
3536,17,3,14,2016,1093,0.18,18,Low Digitalization,Medium Course ( >15H and <40H )
3537,27,10,17,2016,1093,0.37,37,Medium-Low Digitalization,Medium Course ( >15H and <40H )
3538,60,30,30,2016,1093,0.5,50,Medium-Low Digitalization,High Course ( >40H )
3539,15,1,14,2016,1093,0.06,6,Low Digitalization,Small Course ( <15H )
3540,52,15,37,2016,1093,0.29,28,Medium-Low Digitalization,High Course ( >40H )
3541,12,0,12,2016,1093,0.03,3,Low Digitalization,Small Course ( <15H )
3542,28,2,26,2016,1093,0.07,7,Low Digitalization,Medium Course ( >15H and <40H )
3543,51,1,50,2016,1093,0.02,2,Low Digitalization,High Course ( >40H )
3544,10,3,7,2016,1093,0.3,30,Medium-Low Digitalization,Small Course ( <15H )
3545,64,61,3,2016,1093,0.96,96,High Digitalization,High Course ( >40H )
3546,13,4,9,2016,1093,0.34,34,Medium-Low Digitalization,Small Course ( <15H )
3547,29,19,10,2016,1093,0.64,64,Medium-High Digitalization,Medium Course ( >15H and <40H )
3548,24,18,6,2016,1093,0.76,76,Medium-High Digitalization,Medium Course ( >15H and <40H )
3549,11,3,8,2016,1093,0.25,25,Medium-Low Digitalization,Small Course ( <15H )
3550,59,40,19,2016,1093,0.68,68,Medium-High Digitalization,High Course ( >40H )
3551,37,15,22,2016,1093,0.41,41,Medium-Low Digitalization,Medium Course ( >15H and <40H )
3552,88,37,51,2016,1093,0.42,42,Medium-Low Digitalization,High Course ( >40H )
3553,73,6,67,2016,1093,0.08,8,Low Digitalization,High Course ( >40H )
3554,37,9,28,2016,1093,0.23,23,Medium-Low Digitalization,Medium Course ( >15H and <40H )
3555,45,4,41,2016,1093,0.09,9,Low Digitalization,High Course ( >40H )
3556,11,4,7,2016,1093,0.37,37,Medium-Low Digitalization,Small Course ( <15H )
3557,39,9,30,2016,1093,0.24,24,Medium-Low Digitalization,Medium Course ( >15H and <40H )
3558,15,5,10,2016,1093,0.32,32,Medium-Low Digitalization,Small Course ( <15H )
3559,14,7,7,2016,1093,0.49,49,Medium-Low Digitalization,Small Course ( <15H )
3560,51,6,45,2016,1093,0.12,12,Low Digitalization,High Course ( >40H )
3561,12,4,8,2016,1093,0.31,31,Medium-Low Digitalization,Small Course ( <15H )
3562,6,6,0,2016,1093,0.98,98,High Digitalization,Small Course ( <15H )
3563,8,1,7,2016,1093,0.16,16,Low Digitalization,Small Course ( <15H )
3564,54,25,29,2016,1093,0.47,47,Medium-Low Digitalization,High Course ( >40H )
3565,66,65,1,2016,1093,0.98,98,High Digitalization,High Course ( >40H )
3566,19,7,12,2016,1093,0.38,38,Medium-Low Digitalization,Medium Course ( >15H and <40H )
3567,60,57,3,2016,1093,0.95,95,High Digitalization,High Course ( >40H )
3568,64,41,23,2016,1093,0.64,64,Medium-High Digitalization,High Course ( >40H )
3569,64,38,26,2016,1093,0.59,59,Medium-High Digitalization,High Course ( >40H )
3570,5,4,1,2016,1093,0.79,79,Medium-High Digitalization,Small Course ( <15H )
3571,55,15,40,2016,1093,0.28,28,Medium-Low Digitalization,High Course ( >40H )
3572,89,71,18,2016,1093,0.8,80,Medium-High Digitalization,High Course ( >40H )
3573,72,9,63,2016,1093,0.12,12,Low Digitalization,High Course ( >40H )
3574,41,1,40,2016,1093,0.03,3,Low Digitalization,High Course ( >40H )
3575,7,4,3,2016,1093,0.54,54,Medium-High Digitalization,Small Course ( <15H )
3576,9,5,4,2016,1093,0.6,60,Medium-High Digitalization,Small Course ( <15H )
3577,15,9,6,2016,1093,0.62,62,Medium-High Digitalization,Small Course ( <15H )
3578,10,0,10,2016,1093,0.02,2,Low Digitalization,Small Course ( <15H )
3579,64,38,26,2016,1093,0.6,60,Medium-High Digitalization,High Course ( >40H )
3580,15,7,8,2016,1093,0.45,45,Medium-Low Digitalization,Small Course ( <15H )
3581,84,54,30,2016,1093,0.64,64,Medium-High Digitalization,High Course ( >40H )
3582,56,31,25,2016,1093,0.55,55,Medium-High Digitalization,High Course ( >40H )
3583,14,12,2,2016,1093,0.85,85,High Digitalization,Small Course ( <15H )
3584,90,19,71,2016,1093,0.21,21,Medium-Low Digitalization,High Course ( >40H )
3585,52,35,17,2016,1093,0.67,67,Medium-High Digitalization,High Course ( >40H )
3586,43,21,22,2016,1093,0.49,49,Medium-Low Digitalization,High Course ( >40H )
3587,80,64,16,2016,1093,0.8,80,Medium-High Digitalization,High Course ( >40H )
3588,60,17,43,2016,1093,0.28,28,Medium-Low Digitalization,High Course ( >40H )
3589,28,25,3,2016,1093,0.91,91,High Digitalization,Medium Course ( >15H and <40H )
3590,53,51,2,2016,1093,0.96,96,High Digitalization,High Course ( >40H )
3591,13,9,4,2016,1093,0.72,72,Medium-High Digitalization,Small Course ( <15H )
3592,65,49,16,2016,1093,0.75,75,Medium-High Digitalization,High Course ( >40H )
3593,48,19,29,2016,1093,0.4,40,Medium-Low Digitalization,High Course ( >40H )
3594,90,66,24,2016,1093,0.73,73,Medium-High Digitalization,High Course ( >40H )
3595,88,8,80,2016,1093,0.09,9,Low Digitalization,High Course ( >40H )
3596,8,1,7,2016,1093,0.14,14,Low Digitalization,Small Course ( <15H )
3597,8,2,6,2016,1093,0.25,25,Medium-Low Digitalization,Small Course ( <15H )
3598,16,11,5,2016,1093,0.71,71,Medium-High Digitalization,Medium Course ( >15H and <40H )
3599,87,2,85,2016,1093,0.02,2,Low Digitalization,High Course ( >40H )
3600,86,15,71,2016,1093,0.17,17,Low Digitalization,High Course ( >40H )
3601,11,10,1,2016,1093,0.89,89,High Digitalization,Small Course ( <15H )
3602,26,7,19,2016,1093,0.27,27,Medium-Low Digitalization,Medium Course ( >15H and <40H )
3603,12,2,10,2016,1093,0.17,17,Low Digitalization,Small Course ( <15H )
3604,24,19,5,2016,1093,0.8,80,Medium-High Digitalization,Medium Course ( >15H and <40H )
3605,59,37,22,2016,1093,0.63,63,Medium-High Digitalization,High Course ( >40H )
3606,8,2,6,2016,1093,0.23,23,Medium-Low Digitalization,Small Course ( <15H )
3607,81,14,67,2016,1093,0.17,17,Low Digitalization,High Course ( >40H )
3608,14,4,10,2016,1093,0.25,25,Medium-Low Digitalization,Small Course ( <15H )
3609,58,41,17,2016,1093,0.71,71,Medium-High Digitalization,High Course ( >40H )
3610,32,31,1,2016,1093,0.96,96,High Digitalization,Medium Course ( >15H and <40H )
3611,7,0,7,2016,1093,0.02,2,Low Digitalization,Small Course ( <15H )
3612,33,23,10,2016,1093,0.71,71,Medium-High Digitalization,Medium Course ( >15H and <40H )
3613,32,29,3,2016,1093,0.92,92,High Digitalization,Medium Course ( >15H and <40H )
3614,12,3,9,2016,1093,0.23,23,Medium-Low Digitalization,Small Course ( <15H )
3615,63,15,48,2016,1093,0.24,24,Medium-Low Digitalization,High Course ( >40H )
3616,18,8,10,2016,1093,0.44,44,Medium-Low Digitalization,Medium Course ( >15H and <40H )
3617,50,36,14,2016,1093,0.73,73,Medium-High Digitalization,High Course ( >40H )
3618,6,3,3,2016,1093,0.45,45,Medium-Low Digitalization,Small Course ( <15H )
3619,84,70,14,2016,1093,0.83,83,High Digitalization,High Course ( >40H )
3620,24,14,10,2016,1093,0.57,56,Medium-High Digitalization,Medium Course ( >15H and <40H )
3621,77,52,25,2016,1093,0.68,68,Medium-High Digitalization,High Course ( >40H )
3622,20,17,3,2016,1093,0.84,84,High Digitalization,Medium Course ( >15H and <40H )
3623,47,33,14,2016,1093,0.71,71,Medium-High Digitalization,High Course ( >40H )
3624,14,14,0,2016,1093,0.98,98,High Digitalization,Small Course ( <15H )
3625,65,62,3,2016,1093,0.96,96,High Digitalization,High Course ( >40H )
3626,28,4,24,2016,1093,0.15,15,Low Digitalization,Medium Course ( >15H and <40H )
3627,38,19,19,2016,1093,0.5,50,Medium-Low Digitalization,Medium Course ( >15H and <40H )
3628,65,42,23,2016,1093,0.65,65,Medium-High Digitalization,High Course ( >40H )
3629,58,44,14,2016,1093,0.75,75,Medium-High Digitalization,High Course ( >40H )
3630,55,2,53,2016,1093,0.04,4,Low Digitalization,High Course ( >40H )
3631,75,30,45,2016,1093,0.4,40,Medium-Low Digitalization,High Course ( >40H )
3632,52,43,9,2016,1093,0.83,83,High Digitalization,High Course ( >40H )
3633,14,10,4,2016,1093,0.73,73,Medium-High Digitalization,Small Course ( <15H )
3634,12,7,5,2016,1093,0.59,59,Medium-High Digitalization,Small Course ( <15H )
3635,68,41,27,2016,1093,0.61,61,Medium-High Digitalization,High Course ( >40H )
3636,6,3,3,2016,1093,0.56,56,Medium-High Digitalization,Small Course ( <15H )
3637,81,79,2,2016,1093,0.97,97,High Digitalization,High Course ( >40H )
3638,43,30,13,2016,1093,0.7,70,Medium-High Digitalization,High Course ( >40H )
3639,10,1,9,2016,1093,0.09,9,Low Digitalization,Small Course ( <15H )
3640,20,8,12,2016,1093,0.4,40,Medium-Low Digitalization,Medium Course ( >15H and <40H )
3641,62,57,5,2016,1093,0.92,92,High Digitalization,High Course ( >40H )
3642,45,34,11,2016,1093,0.76,76,Medium-High Digitalization,High Course ( >40H )
3643,72,50,22,2016,1093,0.7,70,Medium-High Digitalization,High Course ( >40H )
3644,9,4,5,2016,1093,0.46,46,Medium-Low Digitalization,Small Course ( <15H )
3645,59,21,38,2016,1093,0.35,35,Medium-Low Digitalization,High Course ( >40H )
3646,30,26,4,2016,1093,0.88,88,High Digitalization,Medium Course ( >15H and <40H )
3647,9,5,4,2016,1093,0.61,61,Medium-High Digitalization,Small Course ( <15H )
3648,39,19,20,2016,1093,0.49,49,Medium-Low Digitalization,Medium Course ( >15H and <40H )
3649,71,5,66,2016,1093,0.07,7,Low Digitalization,High Course ( >40H )
3650,37,23,14,2016,1093,0.63,63,Medium-High Digitalization,Medium Course ( >15H and <40H )
3651,11,7,4,2016,1093,0.66,66,Medium-High Digitalization,Small Course ( <15H )
3652,30,12,18,2016,1093,0.4,40,Medium-Low Digitalization,Medium Course ( >15H and <40H )
3653,11,2,9,2016,1093,0.21,21,Medium-Low Digitalization,Small Course ( <15H )
3654,81,74,7,2016,1093,0.91,91,High Digitalization,High Course ( >40H )
3655,35,10,25,2016,1093,0.29,28,Medium-Low Digitalization,Medium Course ( >15H and <40H )
3656,8,7,1,2016,1093,0.86,86,High Digitalization,Small Course ( <15H )
3657,42,42,0,2016,1093,0.99,99,High Digitalization,High Course ( >40H )
3658,89,53,36,2016,1093,0.6,60,Medium-High Digitalization,High Course ( >40H )
3659,5,0,5,2016,1093,0.09,9,Low Digitalization,Small Course ( <15H )
3660,33,16,17,2016,1093,0.47,47,Medium-Low Digitalization,Medium Course ( >15H and <40H )
3661,7,4,3,2016,1093,0.63,63,Medium-High Digitalization,Small Course ( <15H )
3662,7,6,1,2016,1093,0.87,87,High Digitalization,Small Course ( <15H )
3663,11,7,4,2016,1093,0.68,68,Medium-High Digitalization,Small Course ( <15H )
3664,13,6,7,2016,1093,0.43,43,Medium-Low Digitalization,Small Course ( <15H )
3665,10,0,10,2016,1093,0.05,5,Low Digitalization,Small Course ( <15H )
3666,17,9,8,2016,1093,0.53,53,Medium-High Digitalization,Medium Course ( >15H and <40H )
3667,64,58,6,2016,1093,0.9,90,High Digitalization,High Course ( >40H )
3668,52,51,1,2016,1093,0.99,99,High Digitalization,High Course ( >40H )
3669,18,10,8,2016,1093,0.57,56,Medium-High Digitalization,Medium Course ( >15H and <40H )
3670,8,6,2,2016,1093,0.81,81,High Digitalization,Small Course ( <15H )
3671,5,4,1,2016,1093,0.75,75,Medium-High Digitalization,Small Course ( <15H )
3672,38,29,9,2016,1093,0.77,77,Medium-High Digitalization,Medium Course ( >15H and <40H )
3673,37,26,11,2016,1093,0.69,69,Medium-High Digitalization,Medium Course ( >15H and <40H )
3674,53,34,19,2016,1093,0.64,64,Medium-High Digitalization,High Course ( >40H )
3675,35,25,10,2016,1093,0.71,71,Medium-High Digitalization,Medium Course ( >15H and <40H )
3676,8,3,5,2016,1093,0.39,39,Medium-Low Digitalization,Small Course ( <15H )
3677,58,26,32,2016,1093,0.44,44,Medium-Low Digitalization,High Course ( >40H )
3678,67,8,59,2016,1093,0.12,12,Low Digitalization,High Course ( >40H )
3679,59,35,24,2016,1093,0.59,59,Medium-High Digitalization,High Course ( >40H )
3680,33,21,12,2016,1093,0.63,63,Medium-High Digitalization,Medium Course ( >15H and <40H )
3681,68,7,61,2016,1093,0.1,10,Low Digitalization,High Course ( >40H )
3682,9,9,0,2016,1093,0.99,99,High Digitalization,Small Course ( <15H )
3683,87,65,22,2016,1093,0.75,75,Medium-High Digitalization,High Course ( >40H )
3684,8,6,2,2016,1093,0.7,70,Medium-High Digitalization,Small Course ( <15H )
3685,66,2,64,2016,1093,0.03,3,Low Digitalization,High Course ( >40H )
3686,11,3,8,2016,1093,0.23,23,Medium-Low Digitalization,Small Course ( <15H )
3687,52,10,42,2016,1093,0.19,19,Low Digitalization,High Course ( >40H )
3688,13,2,11,2016,1093,0.19,19,Low Digitalization,Small Course ( <15H )
3689,15,9,6,2016,1093,0.57,56,Medium-High Digitalization,Small Course ( <15H )
3690,15,7,8,2016,1093,0.45,45,Medium-Low Digitalization,Small Course ( <15H )
3691,19,7,12,2016,1093,0.39,39,Medium-Low Digitalization,Medium Course ( >15H and <40H )
3692,41,13,28,2016,1093,0.32,32,Medium-Low Digitalization,High Course ( >40H )
3693,65,10,55,2016,1093,0.15,15,Low Digitalization,High Course ( >40H )
3694,8,0,8,2016,1093,0.05,5,Low Digitalization,Small Course ( <15H )
3695,71,48,23,2016,1093,0.68,68,Medium-High Digitalization,High Course ( >40H )
3696,13,10,3,2016,1093,0.78,78,Medium-High Digitalization,Small Course ( <15H )
3697,9,7,2,2016,1093,0.77,77,Medium-High Digitalization,Small Course ( <15H )
3698,42,6,36,2016,1093,0.14,14,Low Digitalization,High Course ( >40H )
3699,85,14,71,2016,1093,0.16,16,Low Digitalization,High Course ( >40H )
3700,12,7,5,2016,1093,0.56,56,Medium-High Digitalization,Small Course ( <15H )
3701,8,5,3,2016,1093,0.57,56,Medium-High Digitalization,Small Course ( <15H )
3702,29,23,6,2016,1093,0.79,79,Medium-High Digitalization,Medium Course ( >15H and <40H )
3703,13,9,4,2016,1093,0.67,67,Medium-High Digitalization,Small Course ( <15H )
3704,85,82,3,2016,1093,0.96,96,High Digitalization,High Course ( >40H )
3705,75,2,73,2016,1093,0.03,3,Low Digitalization,High Course ( >40H )
3706,34,12,22,2016,1093,0.35,35,Medium-Low Digitalization,Medium Course ( >15H and <40H )
3707,28,23,5,2016,1093,0.83,83,High Digitalization,Medium Course ( >15H and <40H )
3708,24,12,12,2016,1093,0.52,52,Medium-High Digitalization,Medium Course ( >15H and <40H )
3709,46,24,22,2016,1093,0.53,53,Medium-High Digitalization,High Course ( >40H )
3710,9,5,4,2016,1093,0.56,56,Medium-High Digitalization,Small Course ( <15H )
3711,76,24,52,2016,1093,0.31,31,Medium-Low Digitalization,High Course ( >40H )
3712,20,5,15,2016,1093,0.26,26,Medium-Low Digitalization,Medium Course ( >15H and <40H )
3713,35,0,35,2016,1093,0.01,1,Low Digitalization,Medium Course ( >15H and <40H )
3714,8,6,2,2016,1093,0.74,74,Medium-High Digitalization,Small Course ( <15H )
3715,71,45,26,2016,1093,0.63,63,Medium-High Digitalization,High Course ( >40H )
3716,22,15,7,2016,1093,0.7,70,Medium-High Digitalization,Medium Course ( >15H and <40H )
3717,17,13,4,2016,1093,0.78,78,Medium-High Digitalization,Medium Course ( >15H and <40H )
3718,48,46,2,2016,1093,0.95,95,High Digitalization,High Course ( >40H )
3719,26,19,7,2016,1093,0.73,73,Medium-High Digitalization,Medium Course ( >15H and <40H )
3720,28,14,14,2016,1093,0.5,50,Medium-Low Digitalization,Medium Course ( >15H and <40H )
3721,54,18,36,2016,1093,0.33,33,Medium-Low Digitalization,High Course ( >40H )
3722,13,1,12,2016,1093,0.09,9,Low Digitalization,Small Course ( <15H )
3723,15,7,8,2016,1093,0.47,47,Medium-Low Digitalization,Small Course ( <15H )
3724,53,10,43,2016,1093,0.18,18,Low Digitalization,High Course ( >40H )
3725,46,29,17,2016,1093,0.62,62,Medium-High Digitalization,High Course ( >40H )
3726,20,11,9,2016,1093,0.55,55,Medium-High Digitalization,Medium Course ( >15H and <40H )
3727,50,36,14,2016,1093,0.73,73,Medium-High Digitalization,High Course ( >40H )
3728,16,3,13,2016,1093,0.2,20,Low Digitalization,Medium Course ( >15H and <40H )
3729,82,65,17,2016,1093,0.79,79,Medium-High Digitalization,High Course ( >40H )
3730,85,38,47,2016,1093,0.45,45,Medium-Low Digitalization,High Course ( >40H )
3731,5,0,5,2016,1093,0.08,8,Low Digitalization,Small Course ( <15H )
3732,5,1,4,2016,1093,0.2,20,Low Digitalization,Small Course ( <15H )
3733,13,6,7,2016,1093,0.48,48,Medium-Low Digitalization,Small Course ( <15H )
3734,52,2,50,2016,1093,0.03,3,Low Digitalization,High Course ( >40H )
3735,13,11,2,2016,1093,0.81,81,High Digitalization,Small Course ( <15H )
3736,29,21,8,2016,1093,0.74,74,Medium-High Digitalization,Medium Course ( >15H and <40H )
3737,84,29,55,2016,1093,0.34,34,Medium-Low Digitalization,High Course ( >40H )
3738,39,16,23,2016,1093,0.42,42,Medium-Low Digitalization,Medium Course ( >15H and <40H )
3739,53,12,41,2016,1093,0.23,23,Medium-Low Digitalization,High Course ( >40H )
3740,55,2,53,2016,1093,0.04,4,Low Digitalization,High Course ( >40H )
3741,35,4,32,2016,1093,0.1,10,Low Digitalization,Medium Course ( >15H and <40H )
3742,36,5,31,2016,1093,0.14,14,Low Digitalization,Medium Course ( >15H and <40H )
3743,10,2,8,2016,1093,0.17,17,Low Digitalization,Small Course ( <15H )
3744,55,31,24,2016,1093,0.56,56,Medium-High Digitalization,High Course ( >40H )
3745,87,66,21,2016,1093,0.76,76,Medium-High Digitalization,High Course ( >40H )
3746,7,2,5,2016,1093,0.22,22,Medium-Low Digitalization,Small Course ( <15H )
3747,52,45,7,2016,1093,0.87,87,High Digitalization,High Course ( >40H )
3748,23,7,16,2016,1093,0.29,28,Medium-Low Digitalization,Medium Course ( >15H and <40H )
3749,9,1,8,2016,1093,0.13,13,Low Digitalization,Small Course ( <15H )
3750,59,47,12,2016,1093,0.8,80,Medium-High Digitalization,High Course ( >40H )
3751,52,31,21,2016,1093,0.59,59,Medium-High Digitalization,High Course ( >40H )
3752,18,10,8,2016,1093,0.54,54,Medium-High Digitalization,Medium Course ( >15H and <40H )
3753,75,59,16,2016,1093,0.79,79,Medium-High Digitalization,High Course ( >40H )
3754,84,18,66,2016,1093,0.22,22,Medium-Low Digitalization,High Course ( >40H )
3755,33,11,22,2016,1093,0.33,33,Medium-Low Digitalization,Medium Course ( >15H and <40H )
3756,32,16,16,2016,1093,0.51,51,Medium-High Digitalization,Medium Course ( >15H and <40H )
3757,14,2,12,2016,1093,0.13,13,Low Digitalization,Small Course ( <15H )
3758,17,8,9,2016,1093,0.49,49,Medium-Low Digitalization,Medium Course ( >15H and <40H )
3759,23,6,17,2016,1093,0.24,24,Medium-Low Digitalization,Medium Course ( >15H and <40H )
3760,31,25,6,2016,1093,0.81,81,High Digitalization,Medium Course ( >15H and <40H )
3761,29,14,15,2016,1093,0.49,49,Medium-Low Digitalization,Medium Course ( >15H and <40H )
3762,40,8,32,2016,1093,0.21,21,Medium-Low Digitalization,High Course ( >40H )
3763,5,4,1,2016,1093,0.75,75,Medium-High Digitalization,Small Course ( <15H )
3764,60,26,34,2016,1093,0.44,44,Medium-Low Digitalization,High Course ( >40H )
3765,57,14,43,2016,1093,0.24,24,Medium-Low Digitalization,High Course ( >40H )
3766,43,9,34,2016,1093,0.2,20,Low Digitalization,High Course ( >40H )
3767,68,15,53,2016,1093,0.22,22,Medium-Low Digitalization,High Course ( >40H )
3768,35,7,28,2016,1093,0.19,19,Low Digitalization,Medium Course ( >15H and <40H )
3769,14,2,12,2016,1093,0.17,17,Low Digitalization,Small Course ( <15H )
3770,56,5,51,2016,1093,0.09,9,Low Digitalization,High Course ( >40H )
3771,28,3,25,2016,1093,0.1,10,Low Digitalization,Medium Course ( >15H and <40H )
3772,9,7,2,2016,1093,0.82,82,High Digitalization,Small Course ( <15H )
3773,14,13,1,2016,1093,0.92,92,High Digitalization,Small Course ( <15H )
3774,9,3,6,2016,1093,0.28,28,Medium-Low Digitalization,Small Course ( <15H )
3775,41,27,14,2016,1093,0.65,65,Medium-High Digitalization,High Course ( >40H )
3776,5,2,3,2016,1093,0.43,43,Medium-Low Digitalization,Small Course ( <15H )
3777,31,4,27,2016,1093,0.12,12,Low Digitalization,Medium Course ( >15H and <40H )
3778,27,23,4,2016,1093,0.85,85,High Digitalization,Medium Course ( >15H and <40H )
3779,10,5,5,2016,1093,0.51,51,Medium-High Digitalization,Small Course ( <15H )
3780,11,3,8,2016,1093,0.23,23,Medium-Low Digitalization,Small Course ( <15H )
3781,40,36,4,2016,1093,0.91,91,High Digitalization,High Course ( >40H )
3782,39,37,2,2016,1093,0.96,96,High Digitalization,Medium Course ( >15H and <40H )
3783,11,10,1,2016,1093,0.87,87,High Digitalization,Small Course ( <15H )
3784,74,35,39,2016,1093,0.47,47,Medium-Low Digitalization,High Course ( >40H )
3785,57,47,10,2016,1093,0.82,82,High Digitalization,High Course ( >40H )
3786,49,44,5,2016,1093,0.89,89,High Digitalization,High Course ( >40H )
3787,60,16,44,2016,1093,0.26,26,Medium-Low Digitalization,High Course ( >40H )
3788,7,2,5,2016,1093,0.35,35,Medium-Low Digitalization,Small Course ( <15H )
3789,12,9,3,2016,1093,0.73,73,Medium-High Digitalization,Small Course ( <15H )
3790,31,6,25,2016,1093,0.18,18,Low Digitalization,Medium Course ( >15H and <40H )
3791,33,3,30,2016,1093,0.1,10,Low Digitalization,Medium Course ( >15H and <40H )
3792,51,27,24,2016,1093,0.53,53,Medium-High Digitalization,High Course ( >40H )
3793,35,15,20,2016,1093,0.42,42,Medium-Low Digitalization,Medium Course ( >15H and <40H )
3794,19,12,7,2016,1093,0.62,62,Medium-High Digitalization,Medium Course ( >15H and <40H )
3795,48,44,4,2016,1093,0.91,91,High Digitalization,High Course ( >40H )
3796,77,22,55,2016,1093,0.29,28,Medium-Low Digitalization,High Course ( >40H )
3797,5,0,5,2016,1093,0.09,9,Low Digitalization,Small Course ( <15H )
3798,12,0,12,2016,1093,0.01,1,Low Digitalization,Small Course ( <15H )
3799,44,41,3,2016,1093,0.94,94,High Digitalization,High Course ( >40H )
3800,46,6,40,2016,1093,0.14,14,Low Digitalization,High Course ( >40H )
3801,7,3,4,2016,1093,0.43,43,Medium-Low Digitalization,Small Course ( <15H )
3802,11,11,0,2016,1093,0.96,96,High Digitalization,Small Course ( <15H )
3803,6,5,1,2016,1093,0.88,88,High Digitalization,Small Course ( <15H )
3804,79,73,6,2016,1093,0.92,92,High Digitalization,High Course ( >40H )
3805,82,50,32,2016,1093,0.61,61,Medium-High Digitalization,High Course ( >40H )
3806,15,3,12,2016,1093,0.19,19,Low Digitalization,Small Course ( <15H )
3807,22,17,5,2016,1093,0.76,76,Medium-High Digitalization,Medium Course ( >15H and <40H )
3808,32,28,4,2016,1093,0.89,89,High Digitalization,Medium Course ( >15H and <40H )
3809,13,13,0,2016,1093,0.98,98,High Digitalization,Small Course ( <15H )
3810,56,15,41,2016,1093,0.27,27,Medium-Low Digitalization,High Course ( >40H )
3811,6,4,2,2016,1093,0.74,74,Medium-High Digitalization,Small Course ( <15H )
3812,15,2,13,2016,1093,0.14,14,Low Digitalization,Small Course ( <15H )
3813,16,8,8,2016,1093,0.47,47,Medium-Low Digitalization,Medium Course ( >15H and <40H )
3814,64,21,43,2016,1093,0.33,33,Medium-Low Digitalization,High Course ( >40H )
3815,55,41,14,2016,1093,0.75,75,Medium-High Digitalization,High Course ( >40H )
3816,24,11,13,2016,1093,0.44,44,Medium-Low Digitalization,Medium Course ( >15H and <40H )
3817,21,6,15,2016,1093,0.27,27,Medium-Low Digitalization,Medium Course ( >15H and <40H )
3818,13,7,6,2016,1093,0.51,51,Medium-High Digitalization,Small Course ( <15H )
3819,52,36,16,2016,1093,0.69,69,Medium-High Digitalization,High Course ( >40H )
3820,31,11,20,2016,1093,0.35,35,Medium-Low Digitalization,Medium Course ( >15H and <40H )
3821,67,23,44,2016,1093,0.35,35,Medium-Low Digitalization,High Course ( >40H )
3822,5,0,5,2016,1093,0.0,0,Low Digitalization,Small Course ( <15H )
3823,45,10,35,2016,1093,0.23,23,Medium-Low Digitalization,High Course ( >40H )
3824,54,14,40,2016,1093,0.25,25,Medium-Low Digitalization,High Course ( >40H )
3825,13,10,3,2016,1093,0.79,79,Medium-High Digitalization,Small Course ( <15H )
3826,44,38,6,2016,1093,0.86,86,High Digitalization,High Course ( >40H )
3827,10,8,2,2016,1093,0.79,79,Medium-High Digitalization,Small Course ( <15H )
3828,10,7,3,2016,1093,0.69,69,Medium-High Digitalization,Small Course ( <15H )
3829,60,53,7,2016,1093,0.88,88,High Digitalization,High Course ( >40H )
3830,48,25,23,2016,1093,0.53,53,Medium-High Digitalization,High Course ( >40H )
3831,50,34,16,2016,1093,0.68,68,Medium-High Digitalization,High Course ( >40H )
3832,6,1,5,2016,1093,0.23,23,Medium-Low Digitalization,Small Course ( <15H )
3833,20,20,0,2016,1093,0.98,98,High Digitalization,Medium Course ( >15H and <40H )
3834,80,45,35,2016,1093,0.56,56,Medium-High Digitalization,High Course ( >40H )
3835,48,21,27,2016,1093,0.44,44,Medium-Low Digitalization,High Course ( >40H )
3836,20,20,0,2016,1093,0.98,98,High Digitalization,Medium Course ( >15H and <40H )
3837,74,8,66,2016,1093,0.11,11,Low Digitalization,High Course ( >40H )
3838,45,12,33,2016,1093,0.27,27,Medium-Low Digitalization,High Course ( >40H )
3839,59,37,22,2016,1093,0.62,62,Medium-High Digitalization,High Course ( >40H )
3840,10,7,3,2016,1093,0.7,70,Medium-High Digitalization,Small Course ( <15H )
3841,51,11,40,2016,1093,0.22,22,Medium-Low Digitalization,High Course ( >40H )
3842,28,7,21,2016,1093,0.25,25,Medium-Low Digitalization,Medium Course ( >15H and <40H )
3843,73,26,47,2016,1093,0.36,36,Medium-Low Digitalization,High Course ( >40H )
3844,21,7,14,2016,1093,0.34,34,Medium-Low Digitalization,Medium Course ( >15H and <40H )
3845,89,86,3,2016,1093,0.97,97,High Digitalization,High Course ( >40H )
3846,33,26,7,2016,1093,0.8,80,Medium-High Digitalization,Medium Course ( >15H and <40H )
3847,88,14,74,2016,1093,0.16,16,Low Digitalization,High Course ( >40H )
3848,30,0,30,2016,1093,0.0,0,Low Digitalization,Medium Course ( >15H and <40H )
3849,7,0,7,2016,1093,0.07,7,Low Digitalization,Small Course ( <15H )
3850,81,28,53,2016,1093,0.34,34,Medium-Low Digitalization,High Course ( >40H )
3851,19,2,17,2016,1093,0.08,8,Low Digitalization,Medium Course ( >15H and <40H )
3852,43,3,40,2016,1093,0.06,6,Low Digitalization,High Course ( >40H )
3853,22,9,13,2016,1093,0.42,42,Medium-Low Digitalization,Medium Course ( >15H and <40H )
3854,48,29,19,2016,1093,0.6,60,Medium-High Digitalization,High Course ( >40H )
3855,66,44,22,2016,1093,0.67,67,Medium-High Digitalization,High Course ( >40H )
3856,27,16,11,2016,1093,0.59,59,Medium-High Digitalization,Medium Course ( >15H and <40H )
3857,15,14,1,2016,1093,0.95,95,High Digitalization,Small Course ( <15H )
3858,13,5,8,2016,1093,0.39,39,Medium-Low Digitalization,Small Course ( <15H )
3859,6,4,2,2016,1093,0.66,66,Medium-High Digitalization,Small Course ( <15H )
3860,21,5,16,2016,1093,0.25,25,Medium-Low Digitalization,Medium Course ( >15H and <40H )
3861,57,55,2,2016,1093,0.96,96,High Digitalization,High Course ( >40H )
3862,7,7,0,2016,1093,0.99,99,High Digitalization,Small Course ( <15H )
3863,17,3,14,2016,1093,0.18,18,Low Digitalization,Medium Course ( >15H and <40H )
3864,19,10,9,2016,1093,0.53,53,Medium-High Digitalization,Medium Course ( >15H and <40H )
3865,48,32,16,2016,1093,0.66,66,Medium-High Digitalization,High Course ( >40H )
3866,32,20,12,2016,1093,0.61,61,Medium-High Digitalization,Medium Course ( >15H and <40H )
3867,67,29,38,2016,1093,0.44,44,Medium-Low Digitalization,High Course ( >40H )
3868,20,19,1,2016,1093,0.93,93,High Digitalization,Medium Course ( >15H and <40H )
3869,82,32,50,2016,1093,0.39,39,Medium-Low Digitalization,High Course ( >40H )
3870,86,66,20,2016,1093,0.77,77,Medium-High Digitalization,High Course ( >40H )
3871,81,20,61,2016,1093,0.25,25,Medium-Low Digitalization,High Course ( >40H )
3872,90,39,51,2016,1093,0.43,43,Medium-Low Digitalization,High Course ( >40H )
3873,15,4,11,2016,1093,0.26,26,Medium-Low Digitalization,Small Course ( <15H )
3874,7,4,3,2016,1093,0.62,62,Medium-High Digitalization,Small Course ( <15H )
3875,31,7,24,2016,1093,0.21,21,Medium-Low Digitalization,Medium Course ( >15H and <40H )
3876,59,0,59,2016,1093,0.0,0,Low Digitalization,High Course ( >40H )
3877,50,3,47,2016,1093,0.06,6,Low Digitalization,High Course ( >40H )
3878,41,21,20,2016,1093,0.52,52,Medium-High Digitalization,High Course ( >40H )
3879,31,11,20,2016,1093,0.36,36,Medium-Low Digitalization,Medium Course ( >15H and <40H )
3880,44,29,15,2016,1093,0.66,66,Medium-High Digitalization,High Course ( >40H )
3881,32,21,11,2016,1093,0.66,66,Medium-High Digitalization,Medium Course ( >15H and <40H )
3882,75,48,27,2016,1093,0.64,64,Medium-High Digitalization,High Course ( >40H )
3883,7,3,4,2016,1093,0.45,45,Medium-Low Digitalization,Small Course ( <15H )
3884,60,2,58,2016,1093,0.04,4,Low Digitalization,High Course ( >40H )
3885,6,4,2,2016,1093,0.6,60,Medium-High Digitalization,Small Course ( <15H )
3886,31,27,4,2016,1093,0.86,86,High Digitalization,Medium Course ( >15H and <40H )
3887,43,34,9,2016,1093,0.79,79,Medium-High Digitalization,High Course ( >40H )
3888,78,35,43,2016,1093,0.45,45,Medium-Low Digitalization,High Course ( >40H )
3889,87,4,83,2016,1093,0.05,5,Low Digitalization,High Course ( >40H )
3890,78,19,59,2016,1093,0.24,24,Medium-Low Digitalization,High Course ( >40H )
3891,52,42,10,2016,1093,0.81,81,High Digitalization,High Course ( >40H )
3892,63,43,20,2016,1093,0.68,68,Medium-High Digitalization,High Course ( >40H )
3893,9,6,3,2016,1093,0.69,69,Medium-High Digitalization,Small Course ( <15H )
3894,53,15,38,2016,1093,0.29,28,Medium-Low Digitalization,High Course ( >40H )
3895,15,6,9,2016,1093,0.37,37,Medium-Low Digitalization,Small Course ( <15H )
3896,59,51,8,2016,1093,0.87,87,High Digitalization,High Course ( >40H )
3897,12,3,9,2016,1093,0.23,23,Medium-Low Digitalization,Small Course ( <15H )
3898,11,4,7,2016,1093,0.36,36,Medium-Low Digitalization,Small Course ( <15H )
3899,39,28,11,2016,1093,0.71,71,Medium-High Digitalization,Medium Course ( >15H and <40H )
3900,36,15,21,2016,1093,0.43,43,Medium-Low Digitalization,Medium Course ( >15H and <40H )
3901,24,15,9,2016,1093,0.64,64,Medium-High Digitalization,Medium Course ( >15H and <40H )
3902,76,22,54,2016,1093,0.29,28,Medium-Low Digitalization,High Course ( >40H )
3903,79,77,2,2016,1093,0.97,97,High Digitalization,High Course ( >40H )
3904,34,27,7,2016,1093,0.79,79,Medium-High Digitalization,Medium Course ( >15H and <40H )
3905,75,53,22,2016,1093,0.71,71,Medium-High Digitalization,High Course ( >40H )
3906,89,4,85,2016,1093,0.04,4,Low Digitalization,High Course ( >40H )
3907,54,19,35,2016,1093,0.36,36,Medium-Low Digitalization,High Course ( >40H )
3908,10,9,1,2016,1093,0.94,94,High Digitalization,Small Course ( <15H )
3909,33,19,14,2016,1093,0.59,59,Medium-High Digitalization,Medium Course ( >15H and <40H )
3910,17,4,13,2016,1093,0.22,22,Medium-Low Digitalization,Medium Course ( >15H and <40H )
3911,33,11,22,2016,1093,0.33,33,Medium-Low Digitalization,Medium Course ( >15H and <40H )
3912,15,8,7,2016,1093,0.51,51,Medium-High Digitalization,Small Course ( <15H )
3913,50,2,48,2016,1093,0.05,5,Low Digitalization,High Course ( >40H )
3914,63,43,20,2016,1093,0.69,69,Medium-High Digitalization,High Course ( >40H )
3915,44,29,15,2016,1093,0.67,67,Medium-High Digitalization,High Course ( >40H )
3916,56,20,36,2016,1093,0.35,35,Medium-Low Digitalization,High Course ( >40H )
3917,58,49,9,2016,1093,0.85,85,High Digitalization,High Course ( >40H )
3918,52,24,28,2016,1093,0.46,46,Medium-Low Digitalization,High Course ( >40H )
3919,14,10,4,2016,1093,0.71,71,Medium-High Digitalization,Small Course ( <15H )
3920,62,17,45,2016,1093,0.27,27,Medium-Low Digitalization,High Course ( >40H )
3921,7,5,2,2016,1093,0.73,73,Medium-High Digitalization,Small Course ( <15H )
3922,31,12,19,2016,1093,0.39,39,Medium-Low Digitalization,Medium Course ( >15H and <40H )
3923,58,8,50,2016,1093,0.13,13,Low Digitalization,High Course ( >40H )
3924,12,8,4,2016,1093,0.68,68,Medium-High Digitalization,Small Course ( <15H )
3925,87,11,76,2016,1093,0.13,13,Low Digitalization,High Course ( >40H )
3926,41,26,15,2016,1093,0.63,63,Medium-High Digitalization,High Course ( >40H )
3927,9,7,2,2016,1093,0.76,76,Medium-High Digitalization,Small Course ( <15H )
3928,31,1,30,2016,1093,0.02,2,Low Digitalization,Medium Course ( >15H and <40H )
3929,7,4,3,2016,1093,0.54,54,Medium-High Digitalization,Small Course ( <15H )
3930,62,14,48,2016,1093,0.23,23,Medium-Low Digitalization,High Course ( >40H )
3931,9,5,4,2016,1093,0.55,55,Medium-High Digitalization,Small Course ( <15H )
3932,51,29,22,2016,1093,0.56,56,Medium-High Digitalization,High Course ( >40H )
3933,88,15,73,2016,1093,0.17,17,Low Digitalization,High Course ( >40H )
3934,10,0,10,2016,1093,0.05,5,Low Digitalization,Small Course ( <15H )
3935,82,13,69,2016,1093,0.16,16,Low Digitalization,High Course ( >40H )
3936,28,23,5,2016,1093,0.81,81,High Digitalization,Medium Course ( >15H and <40H )
3937,56,34,22,2016,1093,0.61,61,Medium-High Digitalization,High Course ( >40H )
3938,85,13,72,2016,1093,0.15,15,Low Digitalization,High Course ( >40H )
3939,40,38,2,2016,1093,0.96,96,High Digitalization,High Course ( >40H )
3940,34,29,5,2016,1093,0.85,85,High Digitalization,Medium Course ( >15H and <40H )
3941,72,6,66,2016,1093,0.08,8,Low Digitalization,High Course ( >40H )
3942,52,9,43,2016,1093,0.17,17,Low Digitalization,High Course ( >40H )
3943,8,6,2,2016,1093,0.78,78,Medium-High Digitalization,Small Course ( <15H )
3944,12,1,11,2016,1093,0.09,9,Low Digitalization,Small Course ( <15H )
3945,7,0,7,2016,1093,0.05,5,Low Digitalization,Small Course ( <15H )
3946,20,18,2,2016,1093,0.9,90,High Digitalization,Medium Course ( >15H and <40H )
3947,11,9,2,2016,1093,0.86,86,High Digitalization,Small Course ( <15H )
3948,23,16,7,2016,1093,0.69,69,Medium-High Digitalization,Medium Course ( >15H and <40H )
3949,34,17,17,2016,1093,0.51,51,Medium-High Digitalization,Medium Course ( >15H and <40H )
3950,9,8,1,2016,1093,0.84,84,High Digitalization,Small Course ( <15H )
3951,56,14,42,2016,1093,0.25,25,Medium-Low Digitalization,High Course ( >40H )
3952,11,7,4,2016,1093,0.68,68,Medium-High Digitalization,Small Course ( <15H )
3953,12,4,8,2016,1093,0.36,36,Medium-Low Digitalization,Small Course ( <15H )
3954,9,2,7,2016,1093,0.22,22,Medium-Low Digitalization,Small Course ( <15H )
3955,54,4,50,2016,1093,0.08,8,Low Digitalization,High Course ( >40H )
3956,17,14,3,2016,1093,0.82,82,High Digitalization,Medium Course ( >15H and <40H )
3957,14,9,5,2016,1093,0.66,66,Medium-High Digitalization,Small Course ( <15H )
3958,20,20,0,2016,1093,0.99,99,High Digitalization,Medium Course ( >15H and <40H )
3959,11,1,10,2016,1093,0.1,10,Low Digitalization,Small Course ( <15H )
3960,15,13,2,2016,1093,0.86,86,High Digitalization,Small Course ( <15H )
3961,33,32,1,2016,1093,0.97,97,High Digitalization,Medium Course ( >15H and <40H )
3962,15,15,0,2016,1093,0.97,97,High Digitalization,Small Course ( <15H )
3963,67,19,48,2016,1093,0.29,28,Medium-Low Digitalization,High Course ( >40H )
3964,24,13,11,2016,1093,0.53,53,Medium-High Digitalization,Medium Course ( >15H and <40H )
3965,78,49,29,2016,1093,0.63,63,Medium-High Digitalization,High Course ( >40H )
3966,8,7,1,2016,1093,0.82,82,High Digitalization,Small Course ( <15H )
3967,33,17,16,2016,1093,0.53,53,Medium-High Digitalization,Medium Course ( >15H and <40H )
3968,64,51,13,2016,1093,0.8,80,Medium-High Digitalization,High Course ( >40H )
3969,52,2,50,2016,1093,0.03,3,Low Digitalization,High Course ( >40H )
3970,82,75,7,2016,1093,0.92,92,High Digitalization,High Course ( >40H )
3971,21,1,20,2016,1093,0.05,5,Low Digitalization,Medium Course ( >15H and <40H )
3972,59,1,58,2016,1093,0.02,2,Low Digitalization,High Course ( >40H )
3973,76,74,2,2016,1093,0.97,97,High Digitalization,High Course ( >40H )
3974,14,7,7,2016,1093,0.51,51,Medium-High Digitalization,Small Course ( <15H )
3975,82,75,7,2016,1093,0.91,91,High Digitalization,High Course ( >40H )
3976,10,5,5,2016,1093,0.47,47,Medium-Low Digitalization,Small Course ( <15H )
3977,28,2,26,2016,1093,0.07,7,Low Digitalization,Medium Course ( >15H and <40H )
3978,33,1,32,2016,1093,0.04,4,Low Digitalization,Medium Course ( >15H and <40H )
3979,52,3,49,2016,1093,0.05,5,Low Digitalization,High Course ( >40H )
3980,74,70,4,2016,1093,0.95,95,High Digitalization,High Course ( >40H )
3981,61,58,3,2016,1093,0.95,95,High Digitalization,High Course ( >40H )
3982,60,30,30,2016,1093,0.5,50,Medium-Low Digitalization,High Course ( >40H )
3983,5,2,3,2016,1093,0.31,31,Medium-Low Digitalization,Small Course ( <15H )
3984,43,43,0,2016,1093,1.0,100,High Digitalization,High Course ( >40H )
3985,21,12,9,2016,1093,0.58,57,Medium-High Digitalization,Medium Course ( >15H and <40H )
3986,16,11,5,2016,1093,0.67,67,Medium-High Digitalization,Medium Course ( >15H and <40H )
3987,46,16,30,2016,1093,0.34,34,Medium-Low Digitalization,High Course ( >40H )
3988,73,65,8,2016,1093,0.89,89,High Digitalization,High Course ( >40H )
3989,13,7,6,2016,1093,0.55,55,Medium-High Digitalization,Small Course ( <15H )
3990,20,4,16,2016,1093,0.2,20,Low Digitalization,Medium Course ( >15H and <40H )
3991,43,25,18,2016,1093,0.57,56,Medium-High Digitalization,High Course ( >40H )
3992,15,10,5,2016,1093,0.64,64,Medium-High Digitalization,Small Course ( <15H )
3993,9,4,5,2016,1093,0.49,49,Medium-Low Digitalization,Small Course ( <15H )
3994,86,78,8,2016,1093,0.91,91,High Digitalization,High Course ( >40H )
3995,6,2,4,2016,1093,0.38,38,Medium-Low Digitalization,Small Course ( <15H )
3996,52,47,5,2016,1093,0.9,90,High Digitalization,High Course ( >40H )
3997,84,65,19,2016,1093,0.77,77,Medium-High Digitalization,High Course ( >40H )
3998,59,42,17,2016,1093,0.72,72,Medium-High Digitalization,High Course ( >40H )
3999,7,1,6,2016,1093,0.09,9,Low Digitalization,Small Course ( <15H )
4000,15,5,10,2016,1093,0.34,34,Medium-Low Digitalization,Small Course ( <15H )
4001,53,9,44,2016,1093,0.17,17,Low Digitalization,High Course ( >40H )
4002,74,50,24,2016,1093,0.67,67,Medium-High Digitalization,High Course ( >40H )
4003,16,8,8,2016,1093,0.47,47,Medium-Low Digitalization,Medium Course ( >15H and <40H )
4004,6,3,3,2016,1093,0.49,49,Medium-Low Digitalization,Small Course ( <15H )
4005,10,9,1,2016,1093,0.9,90,High Digitalization,Small Course ( <15H )
4006,22,3,19,2016,1093,0.12,12,Low Digitalization,Medium Course ( >15H and <40H )
4007,71,10,61,2016,1093,0.14,14,Low Digitalization,High Course ( >40H )
4008,80,26,54,2016,1093,0.32,32,Medium-Low Digitalization,High Course ( >40H )
4009,8,4,4,2016,1093,0.56,56,Medium-High Digitalization,Small Course ( <15H )
4010,9,2,7,2016,1093,0.27,27,Medium-Low Digitalization,Small Course ( <15H )
4011,11,5,6,2016,1093,0.41,41,Medium-Low Digitalization,Small Course ( <15H )
4012,36,36,0,2016,1093,0.99,99,High Digitalization,Medium Course ( >15H and <40H )
4013,55,29,26,2016,1093,0.52,52,Medium-High Digitalization,High Course ( >40H )
4014,5,4,1,2016,1093,0.87,87,High Digitalization,Small Course ( <15H )
4015,35,30,5,2016,1093,0.85,85,High Digitalization,Medium Course ( >15H and <40H )
4016,72,58,14,2016,1093,0.81,81,High Digitalization,High Course ( >40H )
4017,16,8,8,2016,1093,0.47,47,Medium-Low Digitalization,Medium Course ( >15H and <40H )
4018,83,61,22,2016,1093,0.73,73,Medium-High Digitalization,High Course ( >40H )
4019,12,0,12,2016,1093,0.02,2,Low Digitalization,Small Course ( <15H )
4020,31,17,14,2016,1093,0.55,55,Medium-High Digitalization,Medium Course ( >15H and <40H )
4021,14,9,5,2016,1093,0.66,66,Medium-High Digitalization,Small Course ( <15H )
4022,58,24,34,2016,1093,0.41,41,Medium-Low Digitalization,High Course ( >40H )
4023,13,9,4,2016,1093,0.66,66,Medium-High Digitalization,Small Course ( <15H )
4024,14,5,9,2016,1093,0.38,38,Medium-Low Digitalization,Small Course ( <15H )
4025,53,18,35,2016,1093,0.34,34,Medium-Low Digitalization,High Course ( >40H )
4026,74,53,21,2016,1093,0.72,72,Medium-High Digitalization,High Course ( >40H )
4027,32,13,19,2016,1093,0.42,42,Medium-Low Digitalization,Medium Course ( >15H and <40H )
4028,23,14,9,2016,1093,0.63,63,Medium-High Digitalization,Medium Course ( >15H and <40H )
4029,68,10,58,2016,1093,0.14,14,Low Digitalization,High Course ( >40H )
4030,34,2,32,2016,1093,0.05,5,Low Digitalization,Medium Course ( >15H and <40H )
4031,86,6,80,2016,1093,0.07,7,Low Digitalization,High Course ( >40H )
4032,12,12,0,2016,1093,0.99,99,High Digitalization,Small Course ( <15H )
4033,54,2,52,2016,1093,0.04,4,Low Digitalization,High Course ( >40H )
4034,68,58,10,2016,1093,0.86,86,High Digitalization,High Course ( >40H )
4035,32,2,30,2016,1093,0.07,7,Low Digitalization,Medium Course ( >15H and <40H )
4036,28,21,7,2016,1093,0.74,74,Medium-High Digitalization,Medium Course ( >15H and <40H )
4037,46,8,38,2016,1093,0.17,17,Low Digitalization,High Course ( >40H )
4038,25,19,6,2016,1093,0.76,76,Medium-High Digitalization,Medium Course ( >15H and <40H )
4039,19,13,6,2016,1093,0.68,68,Medium-High Digitalization,Medium Course ( >15H and <40H )
4040,8,5,3,2016,1093,0.63,63,Medium-High Digitalization,Small Course ( <15H )
4041,12,2,10,2016,1093,0.16,16,Low Digitalization,Small Course ( <15H )
4042,60,52,8,2016,1093,0.87,87,High Digitalization,High Course ( >40H )
4043,47,32,15,2016,1093,0.69,69,Medium-High Digitalization,High Course ( >40H )
4044,19,7,12,2016,1093,0.38,38,Medium-Low Digitalization,Medium Course ( >15H and <40H )
4045,7,6,1,2016,1093,0.91,91,High Digitalization,Small Course ( <15H )
4046,85,26,59,2016,1093,0.31,31,Medium-Low Digitalization,High Course ( >40H )
4047,26,21,5,2016,1093,0.82,82,High Digitalization,Medium Course ( >15H and <40H )
4048,83,70,13,2016,1093,0.84,84,High Digitalization,High Course ( >40H )
4049,88,46,42,2016,1093,0.52,52,Medium-High Digitalization,High Course ( >40H )
4050,39,23,16,2016,1093,0.58,57,Medium-High Digitalization,Medium Course ( >15H and <40H )
4051,8,5,3,2016,1093,0.62,62,Medium-High Digitalization,Small Course ( <15H )
4052,46,3,43,2016,1093,0.06,6,Low Digitalization,High Course ( >40H )
4053,18,17,1,2016,1093,0.94,94,High Digitalization,Medium Course ( >15H and <40H )
4054,7,6,1,2016,1093,0.9,90,High Digitalization,Small Course ( <15H )
4055,45,16,29,2016,1093,0.36,36,Medium-Low Digitalization,High Course ( >40H )
4056,52,26,26,2016,1093,0.5,50,Medium-Low Digitalization,High Course ( >40H )
4057,12,12,0,2016,1093,0.98,98,High Digitalization,Small Course ( <15H )
4058,55,50,5,2016,1093,0.91,91,High Digitalization,High Course ( >40H )
4059,56,11,45,2016,1093,0.2,20,Low Digitalization,High Course ( >40H )
4060,8,5,3,2016,1093,0.61,61,Medium-High Digitalization,Small Course ( <15H )
4061,48,46,2,2016,1093,0.95,95,High Digitalization,High Course ( >40H )
4062,7,2,5,2016,1093,0.25,25,Medium-Low Digitalization,Small Course ( <15H )
4063,10,6,4,2016,1093,0.63,63,Medium-High Digitalization,Small Course ( <15H )
4064,46,46,0,2016,1093,0.99,99,High Digitalization,High Course ( >40H )
4065,5,2,3,2016,1093,0.37,37,Medium-Low Digitalization,Small Course ( <15H )
4066,33,13,20,2016,1093,0.38,38,Medium-Low Digitalization,Medium Course ( >15H and <40H )
4067,28,15,13,2016,1093,0.55,55,Medium-High Digitalization,Medium Course ( >15H and <40H )
4068,13,7,6,2016,1093,0.51,51,Medium-High Digitalization,Small Course ( <15H )
4069,27,14,14,2016,1093,0.5,50,Medium-Low Digitalization,Medium Course ( >15H and <40H )
4070,69,1,68,2016,1093,0.02,2,Low Digitalization,High Course ( >40H )
4071,79,66,13,2016,1093,0.83,83,High Digitalization,High Course ( >40H )
4072,76,11,65,2016,1093,0.15,15,Low Digitalization,High Course ( >40H )
4073,42,25,17,2016,1093,0.6,60,Medium-High Digitalization,High Course ( >40H )
4074,60,46,14,2016,1093,0.77,77,Medium-High Digitalization,High Course ( >40H )
4075,12,9,3,2016,1093,0.78,78,Medium-High Digitalization,Small Course ( <15H )
4076,16,11,5,2016,1093,0.69,69,Medium-High Digitalization,Medium Course ( >15H and <40H )
4077,83,79,4,2016,1093,0.95,95,High Digitalization,High Course ( >40H )
4078,18,10,8,2016,1093,0.55,55,Medium-High Digitalization,Medium Course ( >15H and <40H )
4079,55,29,26,2016,1093,0.53,53,Medium-High Digitalization,High Course ( >40H )
4080,48,42,6,2016,1093,0.88,88,High Digitalization,High Course ( >40H )
4081,15,8,7,2016,1093,0.53,53,Medium-High Digitalization,Small Course ( <15H )
4082,22,18,4,2016,1093,0.82,82,High Digitalization,Medium Course ( >15H and <40H )
4083,12,9,3,2016,1093,0.73,73,Medium-High Digitalization,Small Course ( <15H )
4084,30,24,6,2016,1093,0.79,79,Medium-High Digitalization,Medium Course ( >15H and <40H )
4085,26,11,15,2016,1093,0.41,41,Medium-Low Digitalization,Medium Course ( >15H and <40H )
4086,17,14,3,2016,1093,0.81,81,High Digitalization,Medium Course ( >15H and <40H )
4087,62,18,44,2016,1093,0.29,28,Medium-Low Digitalization,High Course ( >40H )
4088,81,50,31,2016,1093,0.62,62,Medium-High Digitalization,High Course ( >40H )
4089,9,5,4,2016,1093,0.52,52,Medium-High Digitalization,Small Course ( <15H )
4090,9,6,3,2016,1093,0.71,71,Medium-High Digitalization,Small Course ( <15H )
4091,51,1,50,2016,1093,0.02,2,Low Digitalization,High Course ( >40H )
4092,90,60,30,2016,1093,0.67,67,Medium-High Digitalization,High Course ( >40H )
4093,43,38,5,2016,1093,0.88,88,High Digitalization,High Course ( >40H )
4094,21,3,18,2016,1093,0.15,15,Low Digitalization,Medium Course ( >15H and <40H )
4095,65,63,2,2016,1093,0.97,97,High Digitalization,High Course ( >40H )
4096,18,8,10,2016,1093,0.44,44,Medium-Low Digitalization,Medium Course ( >15H and <40H )
4097,53,5,48,2016,1093,0.1,10,Low Digitalization,High Course ( >40H )
4098,27,17,10,2016,1093,0.64,64,Medium-High Digitalization,Medium Course ( >15H and <40H )
4099,64,61,3,2016,1093,0.95,95,High Digitalization,High Course ( >40H )
4100,10,4,6,2016,1093,0.44,44,Medium-Low Digitalization,Small Course ( <15H )
4101,25,21,4,2016,1093,0.83,83,High Digitalization,Medium Course ( >15H and <40H )
4102,36,6,30,2016,1093,0.17,17,Low Digitalization,Medium Course ( >15H and <40H )
4103,8,5,3,2016,1093,0.67,67,Medium-High Digitalization,Small Course ( <15H )
4104,40,20,20,2016,1093,0.49,49,Medium-Low Digitalization,High Course ( >40H )
4105,13,5,8,2016,1093,0.38,38,Medium-Low Digitalization,Small Course ( <15H )
4106,13,7,6,2016,1093,0.55,55,Medium-High Digitalization,Small Course ( <15H )
4107,13,4,9,2016,1093,0.29,28,Medium-Low Digitalization,Small Course ( <15H )
4108,71,11,60,2016,1093,0.15,15,Low Digitalization,High Course ( >40H )
4109,84,25,59,2016,1093,0.3,30,Medium-Low Digitalization,High Course ( >40H )
4110,52,30,22,2016,1093,0.58,57,Medium-High Digitalization,High Course ( >40H )
4111,14,6,8,2016,1093,0.42,42,Medium-Low Digitalization,Small Course ( <15H )
4112,25,8,17,2016,1093,0.33,33,Medium-Low Digitalization,Medium Course ( >15H and <40H )
4113,19,14,5,2016,1093,0.76,76,Medium-High Digitalization,Medium Course ( >15H and <40H )
4114,43,12,31,2016,1093,0.29,28,Medium-Low Digitalization,High Course ( >40H )
4115,29,12,17,2016,1093,0.42,42,Medium-Low Digitalization,Medium Course ( >15H and <40H )
4116,7,5,2,2016,1093,0.72,72,Medium-High Digitalization,Small Course ( <15H )
4117,8,5,3,2016,1093,0.6,60,Medium-High Digitalization,Small Course ( <15H )
4118,5,4,1,2016,1093,0.73,73,Medium-High Digitalization,Small Course ( <15H )
4119,5,4,1,2016,1093,0.8,80,Medium-High Digitalization,Small Course ( <15H )
4120,46,41,5,2016,1093,0.89,89,High Digitalization,High Course ( >40H )
4121,17,11,6,2016,1093,0.67,67,Medium-High Digitalization,Medium Course ( >15H and <40H )
4122,9,6,3,2016,1093,0.68,68,Medium-High Digitalization,Small Course ( <15H )
4123,64,14,50,2016,1093,0.22,22,Medium-Low Digitalization,High Course ( >40H )
4124,44,24,20,2016,1093,0.55,55,Medium-High Digitalization,High Course ( >40H )
4125,42,18,24,2016,1093,0.42,42,Medium-Low Digitalization,High Course ( >40H )
4126,74,66,8,2016,1093,0.89,89,High Digitalization,High Course ( >40H )
4127,30,7,23,2016,1093,0.23,23,Medium-Low Digitalization,Medium Course ( >15H and <40H )
4128,5,1,4,2016,1093,0.29,28,Medium-Low Digitalization,Small Course ( <15H )
4129,65,59,6,2016,1093,0.91,91,High Digitalization,High Course ( >40H )
4130,15,11,4,2016,1093,0.74,74,Medium-High Digitalization,Small Course ( <15H )
4131,9,3,6,2016,1093,0.3,30,Medium-Low Digitalization,Small Course ( <15H )
4132,86,42,44,2016,1093,0.49,49,Medium-Low Digitalization,High Course ( >40H )
4133,9,7,2,2016,1093,0.73,73,Medium-High Digitalization,Small Course ( <15H )
4134,41,36,5,2016,1093,0.87,87,High Digitalization,High Course ( >40H )
4135,62,21,41,2016,1093,0.34,34,Medium-Low Digitalization,High Course ( >40H )
4136,27,5,22,2016,1093,0.18,18,Low Digitalization,Medium Course ( >15H and <40H )
4137,16,3,13,2016,1093,0.16,16,Low Digitalization,Medium Course ( >15H and <40H )
4138,62,21,41,2016,1093,0.34,34,Medium-Low Digitalization,High Course ( >40H )
4139,8,4,4,2016,1093,0.47,47,Medium-Low Digitalization,Small Course ( <15H )
4140,28,26,2,2016,1093,0.92,92,High Digitalization,Medium Course ( >15H and <40H )
4141,87,23,64,2016,1093,0.27,27,Medium-Low Digitalization,High Course ( >40H )
4142,31,3,28,2016,1093,0.1,10,Low Digitalization,Medium Course ( >15H and <40H )
4143,8,2,6,2016,1093,0.29,28,Medium-Low Digitalization,Small Course ( <15H )
4144,12,5,7,2016,1093,0.38,38,Medium-Low Digitalization,Small Course ( <15H )
4145,16,8,8,2016,1093,0.47,47,Medium-Low Digitalization,Medium Course ( >15H and <40H )
4146,87,57,30,2016,1093,0.65,65,Medium-High Digitalization,High Course ( >40H )
4147,36,34,2,2016,1093,0.95,95,High Digitalization,Medium Course ( >15H and <40H )
4148,52,44,8,2016,1093,0.85,85,High Digitalization,High Course ( >40H )
4149,24,11,13,2016,1093,0.44,44,Medium-Low Digitalization,Medium Course ( >15H and <40H )
4150,20,1,19,2016,1093,0.06,6,Low Digitalization,Medium Course ( >15H and <40H )
4151,35,34,1,2016,1093,0.97,97,High Digitalization,Medium Course ( >15H and <40H )
4152,85,53,32,2016,1093,0.62,62,Medium-High Digitalization,High Course ( >40H )
4153,15,14,1,2016,1093,0.94,94,High Digitalization,Small Course ( <15H )
4154,16,13,3,2016,1093,0.83,83,High Digitalization,Medium Course ( >15H and <40H )
4155,17,11,6,2016,1093,0.63,63,Medium-High Digitalization,Medium Course ( >15H and <40H )
4156,15,6,9,2016,1093,0.38,38,Medium-Low Digitalization,Small Course ( <15H )
4157,19,7,12,2016,1093,0.37,37,Medium-Low Digitalization,Medium Course ( >15H and <40H )
4158,8,6,2,2016,1093,0.78,78,Medium-High Digitalization,Small Course ( <15H )
4159,39,3,36,2016,1093,0.08,8,Low Digitalization,Medium Course ( >15H and <40H )
4160,9,1,8,2016,1093,0.14,14,Low Digitalization,Small Course ( <15H )
4161,90,22,68,2016,1093,0.25,25,Medium-Low Digitalization,High Course ( >40H )
4162,20,11,9,2016,1093,0.55,55,Medium-High Digitalization,Medium Course ( >15H and <40H )
4163,9,3,6,2016,1093,0.35,35,Medium-Low Digitalization,Small Course ( <15H )
4164,40,38,2,2016,1093,0.96,96,High Digitalization,High Course ( >40H )
4165,12,9,3,2016,1093,0.71,71,Medium-High Digitalization,Small Course ( <15H )
4166,5,3,2,2016,1093,0.52,52,Medium-High Digitalization,Small Course ( <15H )
4167,15,12,3,2016,1093,0.81,81,High Digitalization,Small Course ( <15H )
4168,48,18,30,2016,1093,0.37,37,Medium-Low Digitalization,High Course ( >40H )
4169,20,17,3,2016,1093,0.87,87,High Digitalization,Medium Course ( >15H and <40H )
4170,68,33,35,2016,1093,0.49,49,Medium-Low Digitalization,High Course ( >40H )
4171,37,24,13,2016,1093,0.66,66,Medium-High Digitalization,Medium Course ( >15H and <40H )
4172,5,2,3,2016,1093,0.34,34,Medium-Low Digitalization,Small Course ( <15H )
4173,12,1,11,2016,1093,0.06,6,Low Digitalization,Small Course ( <15H )
4174,20,8,12,2016,1093,0.38,38,Medium-Low Digitalization,Medium Course ( >15H and <40H )
4175,11,5,6,2016,1093,0.42,42,Medium-Low Digitalization,Small Course ( <15H )
4176,31,14,17,2016,1093,0.45,45,Medium-Low Digitalization,Medium Course ( >15H and <40H )
4177,60,0,60,2016,1093,0.0,0,Low Digitalization,High Course ( >40H )
4178,23,12,11,2016,1093,0.51,51,Medium-High Digitalization,Medium Course ( >15H and <40H )
4179,40,34,6,2016,1093,0.85,85,High Digitalization,High Course ( >40H )
4180,28,25,3,2016,1093,0.88,88,High Digitalization,Medium Course ( >15H and <40H )
4181,71,49,22,2016,1093,0.69,69,Medium-High Digitalization,High Course ( >40H )
4182,52,4,48,2016,1093,0.08,8,Low Digitalization,High Course ( >40H )
4183,38,22,16,2016,1093,0.59,59,Medium-High Digitalization,Medium Course ( >15H and <40H )
4184,31,24,7,2016,1093,0.77,77,Medium-High Digitalization,Medium Course ( >15H and <40H )
4185,18,17,1,2016,1093,0.92,92,High Digitalization,Medium Course ( >15H and <40H )
4186,6,3,3,2016,1093,0.44,44,Medium-Low Digitalization,Small Course ( <15H )
4187,17,7,10,2016,1093,0.43,43,Medium-Low Digitalization,Medium Course ( >15H and <40H )
4188,11,0,11,2016,1093,0.0,0,Low Digitalization,Small Course ( <15H )
4189,31,6,25,2016,1093,0.2,20,Low Digitalization,Medium Course ( >15H and <40H )
4190,40,35,5,2016,1093,0.88,88,High Digitalization,High Course ( >40H )
4191,15,15,0,2016,1093,0.97,97,High Digitalization,Small Course ( <15H )
4192,74,52,22,2016,1093,0.7,70,Medium-High Digitalization,High Course ( >40H )
4193,51,6,45,2016,1093,0.11,11,Low Digitalization,High Course ( >40H )
4194,63,31,32,2016,1093,0.49,49,Medium-Low Digitalization,High Course ( >40H )
4195,9,9,0,2016,1093,0.98,98,High Digitalization,Small Course ( <15H )
4196,44,14,30,2016,1093,0.32,32,Medium-Low Digitalization,High Course ( >40H )
4197,56,18,38,2017,1007,0.32,32,Medium-Low Digitalization,High Course ( >40H )
4198,44,29,15,2017,1007,0.65,65,Medium-High Digitalization,High Course ( >40H )
4199,20,2,18,2017,1007,0.09,9,Low Digitalization,Medium Course ( >15H and <40H )
4200,15,5,10,2017,1007,0.33,33,Medium-Low Digitalization,Small Course ( <15H )
4201,39,22,17,2017,1007,0.56,56,Medium-High Digitalization,Medium Course ( >15H and <40H )
4202,16,3,13,2017,1007,0.19,19,Low Digitalization,Medium Course ( >15H and <40H )
4203,77,12,65,2017,1007,0.15,15,Low Digitalization,High Course ( >40H )
4204,6,2,4,2017,1007,0.36,36,Medium-Low Digitalization,Small Course ( <15H )
4205,64,55,9,2017,1007,0.86,86,High Digitalization,High Course ( >40H )
4206,74,58,16,2017,1007,0.78,78,Medium-High Digitalization,High Course ( >40H )
4207,35,8,27,2017,1007,0.22,22,Medium-Low Digitalization,Medium Course ( >15H and <40H )
4208,12,8,4,2017,1007,0.64,64,Medium-High Digitalization,Small Course ( <15H )
4209,11,0,11,2017,1007,0.04,4,Low Digitalization,Small Course ( <15H )
4210,15,9,6,2017,1007,0.57,56,Medium-High Digitalization,Small Course ( <15H )
4211,12,6,6,2017,1007,0.47,47,Medium-Low Digitalization,Small Course ( <15H )
4212,60,47,13,2017,1007,0.78,78,Medium-High Digitalization,High Course ( >40H )
4213,16,4,12,2017,1007,0.27,27,Medium-Low Digitalization,Medium Course ( >15H and <40H )
4214,38,21,17,2017,1007,0.54,54,Medium-High Digitalization,Medium Course ( >15H and <40H )
4215,37,4,33,2017,1007,0.12,12,Low Digitalization,Medium Course ( >15H and <40H )
4216,10,1,9,2017,1007,0.07,7,Low Digitalization,Small Course ( <15H )
4217,10,6,4,2017,1007,0.58,57,Medium-High Digitalization,Small Course ( <15H )
4218,17,7,10,2017,1007,0.43,43,Medium-Low Digitalization,Medium Course ( >15H and <40H )
4219,5,4,1,2017,1007,0.87,87,High Digitalization,Small Course ( <15H )
4220,68,32,36,2017,1007,0.47,47,Medium-Low Digitalization,High Course ( >40H )
4221,9,0,9,2017,1007,0.01,1,Low Digitalization,Small Course ( <15H )
4222,16,4,12,2017,1007,0.24,24,Medium-Low Digitalization,Medium Course ( >15H and <40H )
4223,70,38,32,2017,1007,0.54,54,Medium-High Digitalization,High Course ( >40H )
4224,29,16,13,2017,1007,0.56,56,Medium-High Digitalization,Medium Course ( >15H and <40H )
4225,21,5,16,2017,1007,0.24,24,Medium-Low Digitalization,Medium Course ( >15H and <40H )
4226,17,14,3,2017,1007,0.84,84,High Digitalization,Medium Course ( >15H and <40H )
4227,45,41,4,2017,1007,0.91,91,High Digitalization,High Course ( >40H )
4228,45,5,40,2017,1007,0.11,11,Low Digitalization,High Course ( >40H )
4229,54,37,17,2017,1007,0.69,69,Medium-High Digitalization,High Course ( >40H )
4230,84,77,7,2017,1007,0.92,92,High Digitalization,High Course ( >40H )
4231,50,8,42,2017,1007,0.16,16,Low Digitalization,High Course ( >40H )
4232,50,42,8,2017,1007,0.85,85,High Digitalization,High Course ( >40H )
4233,12,7,5,2017,1007,0.59,59,Medium-High Digitalization,Small Course ( <15H )
4234,41,27,14,2017,1007,0.66,66,Medium-High Digitalization,High Course ( >40H )
4235,14,9,5,2017,1007,0.62,62,Medium-High Digitalization,Small Course ( <15H )
4236,9,6,3,2017,1007,0.63,63,Medium-High Digitalization,Small Course ( <15H )
4237,50,21,29,2017,1007,0.42,42,Medium-Low Digitalization,High Course ( >40H )
4238,20,3,17,2017,1007,0.13,13,Low Digitalization,Medium Course ( >15H and <40H )
4239,8,7,1,2017,1007,0.88,88,High Digitalization,Small Course ( <15H )
4240,8,8,0,2017,1007,0.97,97,High Digitalization,Small Course ( <15H )
4241,13,1,12,2017,1007,0.1,10,Low Digitalization,Small Course ( <15H )
4242,10,6,4,2017,1007,0.65,65,Medium-High Digitalization,Small Course ( <15H )
4243,5,4,1,2017,1007,0.75,75,Medium-High Digitalization,Small Course ( <15H )
4244,33,33,0,2017,1007,1.0,100,High Digitalization,Medium Course ( >15H and <40H )
4245,52,31,21,2017,1007,0.59,59,Medium-High Digitalization,High Course ( >40H )
4246,54,47,7,2017,1007,0.87,87,High Digitalization,High Course ( >40H )
4247,68,46,22,2017,1007,0.67,67,Medium-High Digitalization,High Course ( >40H )
4248,59,38,21,2017,1007,0.64,64,Medium-High Digitalization,High Course ( >40H )
4249,44,25,19,2017,1007,0.57,56,Medium-High Digitalization,High Course ( >40H )
4250,7,5,2,2017,1007,0.69,69,Medium-High Digitalization,Small Course ( <15H )
4251,55,25,30,2017,1007,0.46,46,Medium-Low Digitalization,High Course ( >40H )
4252,48,12,36,2017,1007,0.25,25,Medium-Low Digitalization,High Course ( >40H )
4253,7,4,3,2017,1007,0.63,63,Medium-High Digitalization,Small Course ( <15H )
4254,89,19,70,2017,1007,0.21,21,Medium-Low Digitalization,High Course ( >40H )
4255,10,5,5,2017,1007,0.51,51,Medium-High Digitalization,Small Course ( <15H )
4256,12,6,6,2017,1007,0.54,54,Medium-High Digitalization,Small Course ( <15H )
4257,29,10,19,2017,1007,0.33,33,Medium-Low Digitalization,Medium Course ( >15H and <40H )
4258,14,6,8,2017,1007,0.45,45,Medium-Low Digitalization,Small Course ( <15H )
4259,8,7,1,2017,1007,0.88,88,High Digitalization,Small Course ( <15H )
4260,19,2,17,2017,1007,0.12,12,Low Digitalization,Medium Course ( >15H and <40H )
4261,35,8,27,2017,1007,0.23,23,Medium-Low Digitalization,Medium Course ( >15H and <40H )
4262,11,4,7,2017,1007,0.38,38,Medium-Low Digitalization,Small Course ( <15H )
4263,7,6,1,2017,1007,0.87,87,High Digitalization,Small Course ( <15H )
4264,88,84,4,2017,1007,0.95,95,High Digitalization,High Course ( >40H )
4265,21,21,0,2017,1007,0.98,98,High Digitalization,Medium Course ( >15H and <40H )
4266,33,26,7,2017,1007,0.79,79,Medium-High Digitalization,Medium Course ( >15H and <40H )
4267,31,18,13,2017,1007,0.58,57,Medium-High Digitalization,Medium Course ( >15H and <40H )
4268,70,45,25,2017,1007,0.64,64,Medium-High Digitalization,High Course ( >40H )
4269,35,11,24,2017,1007,0.32,32,Medium-Low Digitalization,Medium Course ( >15H and <40H )
4270,42,34,8,2017,1007,0.82,82,High Digitalization,High Course ( >40H )
4271,42,3,39,2017,1007,0.06,6,Low Digitalization,High Course ( >40H )
4272,60,40,20,2017,1007,0.66,66,Medium-High Digitalization,High Course ( >40H )
4273,63,3,60,2017,1007,0.04,4,Low Digitalization,High Course ( >40H )
4274,7,1,6,2017,1007,0.11,11,Low Digitalization,Small Course ( <15H )
4275,6,5,1,2017,1007,0.87,87,High Digitalization,Small Course ( <15H )
4276,31,0,31,2017,1007,0.01,1,Low Digitalization,Medium Course ( >15H and <40H )
4277,45,4,41,2017,1007,0.08,8,Low Digitalization,High Course ( >40H )
4278,53,32,21,2017,1007,0.61,61,Medium-High Digitalization,High Course ( >40H )
4279,33,26,7,2017,1007,0.78,78,Medium-High Digitalization,Medium Course ( >15H and <40H )
4280,80,14,66,2017,1007,0.18,18,Low Digitalization,High Course ( >40H )
4281,12,3,9,2017,1007,0.26,26,Medium-Low Digitalization,Small Course ( <15H )
4282,54,49,5,2017,1007,0.91,91,High Digitalization,High Course ( >40H )
4283,80,27,53,2017,1007,0.34,34,Medium-Low Digitalization,High Course ( >40H )
4284,14,9,5,2017,1007,0.66,66,Medium-High Digitalization,Small Course ( <15H )
4285,41,8,33,2017,1007,0.19,19,Low Digitalization,High Course ( >40H )
4286,15,11,4,2017,1007,0.74,74,Medium-High Digitalization,Small Course ( <15H )
4287,38,27,11,2017,1007,0.7,70,Medium-High Digitalization,Medium Course ( >15H and <40H )
4288,75,8,68,2017,1007,0.1,10,Low Digitalization,High Course ( >40H )
4289,12,6,6,2017,1007,0.48,48,Medium-Low Digitalization,Small Course ( <15H )
4290,15,8,8,2017,1007,0.5,50,Medium-Low Digitalization,Small Course ( <15H )
4291,58,52,6,2017,1007,0.89,89,High Digitalization,High Course ( >40H )
4292,6,6,0,2017,1007,0.95,95,High Digitalization,Small Course ( <15H )
4293,13,11,2,2017,1007,0.85,85,High Digitalization,Small Course ( <15H )
4294,8,1,7,2017,1007,0.11,11,Low Digitalization,Small Course ( <15H )
4295,53,20,33,2017,1007,0.38,38,Medium-Low Digitalization,High Course ( >40H )
4296,82,23,59,2017,1007,0.28,28,Medium-Low Digitalization,High Course ( >40H )
4297,21,7,14,2017,1007,0.32,32,Medium-Low Digitalization,Medium Course ( >15H and <40H )
4298,64,23,41,2017,1007,0.36,36,Medium-Low Digitalization,High Course ( >40H )
4299,44,15,29,2017,1007,0.34,34,Medium-Low Digitalization,High Course ( >40H )
4300,5,1,4,2017,1007,0.17,17,Low Digitalization,Small Course ( <15H )
4301,11,3,8,2017,1007,0.27,27,Medium-Low Digitalization,Small Course ( <15H )
4302,56,32,24,2017,1007,0.58,57,Medium-High Digitalization,High Course ( >40H )
4303,31,21,10,2017,1007,0.69,69,Medium-High Digitalization,Medium Course ( >15H and <40H )
4304,88,26,62,2017,1007,0.3,30,Medium-Low Digitalization,High Course ( >40H )
4305,13,5,8,2017,1007,0.35,35,Medium-Low Digitalization,Small Course ( <15H )
4306,15,7,8,2017,1007,0.48,48,Medium-Low Digitalization,Small Course ( <15H )
4307,6,0,6,2017,1007,0.06,6,Low Digitalization,Small Course ( <15H )
4308,72,55,17,2017,1007,0.77,77,Medium-High Digitalization,High Course ( >40H )
4309,18,13,5,2017,1007,0.7,70,Medium-High Digitalization,Medium Course ( >15H and <40H )
4310,6,2,4,2017,1007,0.31,31,Medium-Low Digitalization,Small Course ( <15H )
4311,13,11,2,2017,1007,0.87,87,High Digitalization,Small Course ( <15H )
4312,44,38,6,2017,1007,0.86,86,High Digitalization,High Course ( >40H )
4313,42,19,23,2017,1007,0.46,46,Medium-Low Digitalization,High Course ( >40H )
4314,5,0,5,2017,1007,0.0,0,Low Digitalization,Small Course ( <15H )
4315,8,5,3,2017,1007,0.67,67,Medium-High Digitalization,Small Course ( <15H )
4316,27,27,0,2017,1007,0.99,99,High Digitalization,Medium Course ( >15H and <40H )
4317,8,2,6,2017,1007,0.3,30,Medium-Low Digitalization,Small Course ( <15H )
4318,42,19,23,2017,1007,0.45,45,Medium-Low Digitalization,High Course ( >40H )
4319,51,46,5,2017,1007,0.91,91,High Digitalization,High Course ( >40H )
4320,64,35,29,2017,1007,0.55,55,Medium-High Digitalization,High Course ( >40H )
4321,20,4,16,2017,1007,0.22,22,Medium-Low Digitalization,Medium Course ( >15H and <40H )
4322,19,8,11,2017,1007,0.42,42,Medium-Low Digitalization,Medium Course ( >15H and <40H )
4323,25,0,24,2017,1007,0.02,2,Low Digitalization,Medium Course ( >15H and <40H )
4324,84,2,82,2017,1007,0.02,2,Low Digitalization,High Course ( >40H )
4325,25,6,19,2017,1007,0.24,24,Medium-Low Digitalization,Medium Course ( >15H and <40H )
4326,29,24,5,2017,1007,0.83,83,High Digitalization,Medium Course ( >15H and <40H )
4327,60,44,16,2017,1007,0.74,74,Medium-High Digitalization,High Course ( >40H )
4328,10,2,8,2017,1007,0.23,23,Medium-Low Digitalization,Small Course ( <15H )
4329,7,6,1,2017,1007,0.88,88,High Digitalization,Small Course ( <15H )
4330,13,2,11,2017,1007,0.13,13,Low Digitalization,Small Course ( <15H )
4331,75,22,53,2017,1007,0.29,28,Medium-Low Digitalization,High Course ( >40H )
4332,40,6,34,2017,1007,0.16,16,Low Digitalization,High Course ( >40H )
4333,36,2,34,2017,1007,0.06,6,Low Digitalization,Medium Course ( >15H and <40H )
4334,46,23,23,2017,1007,0.51,51,Medium-High Digitalization,High Course ( >40H )
4335,15,9,6,2017,1007,0.63,63,Medium-High Digitalization,Small Course ( <15H )
4336,81,12,69,2017,1007,0.15,15,Low Digitalization,High Course ( >40H )
4337,60,31,29,2017,1007,0.51,51,Medium-High Digitalization,High Course ( >40H )
4338,14,2,12,2017,1007,0.15,15,Low Digitalization,Small Course ( <15H )
4339,61,15,46,2017,1007,0.24,24,Medium-Low Digitalization,High Course ( >40H )
4340,6,5,1,2017,1007,0.78,78,Medium-High Digitalization,Small Course ( <15H )
4341,13,6,7,2017,1007,0.48,48,Medium-Low Digitalization,Small Course ( <15H )
4342,24,10,14,2017,1007,0.4,40,Medium-Low Digitalization,Medium Course ( >15H and <40H )
4343,49,9,40,2017,1007,0.19,19,Low Digitalization,High Course ( >40H )
4344,10,1,9,2017,1007,0.07,7,Low Digitalization,Small Course ( <15H )
4345,10,4,6,2017,1007,0.41,41,Medium-Low Digitalization,Small Course ( <15H )
4346,57,9,48,2017,1007,0.15,15,Low Digitalization,High Course ( >40H )
4347,22,21,1,2017,1007,0.95,95,High Digitalization,Medium Course ( >15H and <40H )
4348,32,6,26,2017,1007,0.18,18,Low Digitalization,Medium Course ( >15H and <40H )
4349,15,14,1,2017,1007,0.94,94,High Digitalization,Small Course ( <15H )
4350,10,6,4,2017,1007,0.61,61,Medium-High Digitalization,Small Course ( <15H )
4351,72,71,1,2017,1007,0.99,99,High Digitalization,High Course ( >40H )
4352,24,9,15,2017,1007,0.39,39,Medium-Low Digitalization,Medium Course ( >15H and <40H )
4353,9,2,7,2017,1007,0.27,27,Medium-Low Digitalization,Small Course ( <15H )
4354,14,13,1,2017,1007,0.91,91,High Digitalization,Small Course ( <15H )
4355,67,1,66,2017,1007,0.01,1,Low Digitalization,High Course ( >40H )
4356,8,2,6,2017,1007,0.2,20,Low Digitalization,Small Course ( <15H )
4357,43,32,11,2017,1007,0.75,75,Medium-High Digitalization,High Course ( >40H )
4358,32,6,26,2017,1007,0.2,20,Low Digitalization,Medium Course ( >15H and <40H )
4359,80,58,22,2017,1007,0.73,73,Medium-High Digitalization,High Course ( >40H )
4360,12,1,11,2017,1007,0.07,7,Low Digitalization,Small Course ( <15H )
4361,17,17,0,2017,1007,0.99,99,High Digitalization,Medium Course ( >15H and <40H )
4362,20,3,17,2017,1007,0.16,16,Low Digitalization,Medium Course ( >15H and <40H )
4363,8,2,6,2017,1007,0.25,25,Medium-Low Digitalization,Small Course ( <15H )
4364,86,28,58,2017,1007,0.33,33,Medium-Low Digitalization,High Course ( >40H )
4365,7,2,5,2017,1007,0.35,35,Medium-Low Digitalization,Small Course ( <15H )
4366,28,24,4,2017,1007,0.86,86,High Digitalization,Medium Course ( >15H and <40H )
4367,70,69,1,2017,1007,0.99,99,High Digitalization,High Course ( >40H )
4368,21,18,3,2017,1007,0.85,85,High Digitalization,Medium Course ( >15H and <40H )
4369,6,3,3,2017,1007,0.53,53,Medium-High Digitalization,Small Course ( <15H )
4370,19,17,2,2017,1007,0.92,92,High Digitalization,Medium Course ( >15H and <40H )
4371,15,1,14,2017,1007,0.08,8,Low Digitalization,Small Course ( <15H )
4372,19,7,12,2017,1007,0.39,39,Medium-Low Digitalization,Medium Course ( >15H and <40H )
4373,9,1,8,2017,1007,0.14,14,Low Digitalization,Small Course ( <15H )
4374,11,7,4,2017,1007,0.68,68,Medium-High Digitalization,Small Course ( <15H )
4375,59,50,9,2017,1007,0.84,84,High Digitalization,High Course ( >40H )
4376,89,60,29,2017,1007,0.67,67,Medium-High Digitalization,High Course ( >40H )
4377,34,12,22,2017,1007,0.35,35,Medium-Low Digitalization,Medium Course ( >15H and <40H )
4378,22,21,1,2017,1007,0.94,94,High Digitalization,Medium Course ( >15H and <40H )
4379,7,0,7,2017,1007,0.0,0,Low Digitalization,Small Course ( <15H )
4380,53,21,32,2017,1007,0.39,39,Medium-Low Digitalization,High Course ( >40H )
4381,13,10,3,2017,1007,0.78,78,Medium-High Digitalization,Small Course ( <15H )
4382,39,6,33,2017,1007,0.15,15,Low Digitalization,Medium Course ( >15H and <40H )
4383,60,41,19,2017,1007,0.69,69,Medium-High Digitalization,High Course ( >40H )
4384,57,38,19,2017,1007,0.67,67,Medium-High Digitalization,High Course ( >40H )
4385,14,2,12,2017,1007,0.17,17,Low Digitalization,Small Course ( <15H )
4386,90,65,25,2017,1007,0.72,72,Medium-High Digitalization,High Course ( >40H )
4387,17,16,1,2017,1007,0.92,92,High Digitalization,Medium Course ( >15H and <40H )
4388,5,2,2,2017,1007,0.5,50,Medium-Low Digitalization,Small Course ( <15H )
4389,88,65,23,2017,1007,0.74,74,Medium-High Digitalization,High Course ( >40H )
4390,40,38,2,2017,1007,0.96,96,High Digitalization,High Course ( >40H )
4391,9,1,8,2017,1007,0.14,14,Low Digitalization,Small Course ( <15H )
4392,54,38,16,2017,1007,0.71,71,Medium-High Digitalization,High Course ( >40H )
4393,59,35,24,2017,1007,0.59,59,Medium-High Digitalization,High Course ( >40H )
4394,14,8,6,2017,1007,0.59,59,Medium-High Digitalization,Small Course ( <15H )
4395,39,34,5,2017,1007,0.86,86,High Digitalization,Medium Course ( >15H and <40H )
4396,51,42,9,2017,1007,0.83,83,High Digitalization,High Course ( >40H )
4397,30,1,29,2017,1007,0.04,4,Low Digitalization,Medium Course ( >15H and <40H )
4398,42,32,10,2017,1007,0.77,77,Medium-High Digitalization,High Course ( >40H )
4399,61,2,59,2017,1007,0.03,3,Low Digitalization,High Course ( >40H )
4400,50,40,10,2017,1007,0.79,79,Medium-High Digitalization,High Course ( >40H )
4401,6,4,2,2017,1007,0.7,70,Medium-High Digitalization,Small Course ( <15H )
4402,70,50,20,2017,1007,0.72,72,Medium-High Digitalization,High Course ( >40H )
4403,25,18,7,2017,1007,0.71,71,Medium-High Digitalization,Medium Course ( >15H and <40H )
4404,65,43,22,2017,1007,0.66,66,Medium-High Digitalization,High Course ( >40H )
4405,56,30,26,2017,1007,0.53,53,Medium-High Digitalization,High Course ( >40H )
4406,5,1,4,2017,1007,0.16,16,Low Digitalization,Small Course ( <15H )
4407,65,42,23,2017,1007,0.65,65,Medium-High Digitalization,High Course ( >40H )
4408,51,1,50,2017,1007,0.01,1,Low Digitalization,High Course ( >40H )
4409,34,12,22,2017,1007,0.34,34,Medium-Low Digitalization,Medium Course ( >15H and <40H )
4410,24,2,22,2017,1007,0.1,10,Low Digitalization,Medium Course ( >15H and <40H )
4411,77,61,16,2017,1007,0.79,79,Medium-High Digitalization,High Course ( >40H )
4412,9,2,7,2017,1007,0.26,26,Medium-Low Digitalization,Small Course ( <15H )
4413,12,7,5,2017,1007,0.58,57,Medium-High Digitalization,Small Course ( <15H )
4414,12,1,11,2017,1007,0.1,10,Low Digitalization,Small Course ( <15H )
4415,81,76,5,2017,1007,0.94,94,High Digitalization,High Course ( >40H )
4416,8,3,5,2017,1007,0.41,41,Medium-Low Digitalization,Small Course ( <15H )
4417,28,0,28,2017,1007,0.01,1,Low Digitalization,Medium Course ( >15H and <40H )
4418,49,37,12,2017,1007,0.75,75,Medium-High Digitalization,High Course ( >40H )
4419,15,6,9,2017,1007,0.43,43,Medium-Low Digitalization,Small Course ( <15H )
4420,13,6,6,2017,1007,0.5,50,Medium-Low Digitalization,Small Course ( <15H )
4421,5,3,2,2017,1007,0.58,57,Medium-High Digitalization,Small Course ( <15H )
4422,12,10,2,2017,1007,0.86,86,High Digitalization,Small Course ( <15H )
4423,50,49,1,2017,1007,0.98,98,High Digitalization,High Course ( >40H )
4424,12,3,9,2017,1007,0.27,27,Medium-Low Digitalization,Small Course ( <15H )
4425,19,14,5,2017,1007,0.75,75,Medium-High Digitalization,Medium Course ( >15H and <40H )
4426,12,4,8,2017,1007,0.31,31,Medium-Low Digitalization,Small Course ( <15H )
4427,39,21,18,2017,1007,0.53,53,Medium-High Digitalization,Medium Course ( >15H and <40H )
4428,11,4,7,2017,1007,0.34,34,Medium-Low Digitalization,Small Course ( <15H )
4429,76,37,39,2017,1007,0.49,49,Medium-Low Digitalization,High Course ( >40H )
4430,23,6,17,2017,1007,0.28,28,Medium-Low Digitalization,Medium Course ( >15H and <40H )
4431,36,24,12,2017,1007,0.66,66,Medium-High Digitalization,Medium Course ( >15H and <40H )
4432,28,28,0,2017,1007,0.99,99,High Digitalization,Medium Course ( >15H and <40H )
4433,62,56,6,2017,1007,0.9,90,High Digitalization,High Course ( >40H )
4434,9,8,1,2017,1007,0.84,84,High Digitalization,Small Course ( <15H )
4435,57,37,20,2017,1007,0.65,65,Medium-High Digitalization,High Course ( >40H )
4436,17,8,9,2017,1007,0.48,48,Medium-Low Digitalization,Medium Course ( >15H and <40H )
4437,50,14,36,2017,1007,0.29,28,Medium-Low Digitalization,High Course ( >40H )
4438,10,7,3,2017,1007,0.7,70,Medium-High Digitalization,Small Course ( <15H )
4439,9,3,6,2017,1007,0.38,38,Medium-Low Digitalization,Small Course ( <15H )
4440,62,5,57,2017,1007,0.08,8,Low Digitalization,High Course ( >40H )
4441,7,4,3,2017,1007,0.52,52,Medium-High Digitalization,Small Course ( <15H )
4442,51,49,2,2017,1007,0.96,96,High Digitalization,High Course ( >40H )
4443,9,8,1,2017,1007,0.85,85,High Digitalization,Small Course ( <15H )
4444,28,18,10,2017,1007,0.63,63,Medium-High Digitalization,Medium Course ( >15H and <40H )
4445,29,25,4,2017,1007,0.87,87,High Digitalization,Medium Course ( >15H and <40H )
4446,10,3,7,2017,1007,0.26,26,Medium-Low Digitalization,Small Course ( <15H )
4447,16,0,16,2017,1007,0.02,2,Low Digitalization,Medium Course ( >15H and <40H )
4448,5,1,4,2017,1007,0.21,21,Medium-Low Digitalization,Small Course ( <15H )
4449,44,29,15,2017,1007,0.65,65,Medium-High Digitalization,High Course ( >40H )
4450,13,13,0,2017,1007,0.99,99,High Digitalization,Small Course ( <15H )
4451,33,33,0,2017,1007,0.99,99,High Digitalization,Medium Course ( >15H and <40H )
4452,85,71,14,2017,1007,0.83,83,High Digitalization,High Course ( >40H )
4453,26,1,25,2017,1007,0.02,2,Low Digitalization,Medium Course ( >15H and <40H )
4454,30,11,19,2017,1007,0.37,37,Medium-Low Digitalization,Medium Course ( >15H and <40H )
4455,7,0,7,2017,1007,0.07,7,Low Digitalization,Small Course ( <15H )
4456,6,2,4,2017,1007,0.39,39,Medium-Low Digitalization,Small Course ( <15H )
4457,48,4,44,2017,1007,0.08,8,Low Digitalization,High Course ( >40H )
4458,9,7,2,2017,1007,0.8,80,Medium-High Digitalization,Small Course ( <15H )
4459,76,31,45,2017,1007,0.41,41,Medium-Low Digitalization,High Course ( >40H )
4460,13,3,10,2017,1007,0.25,25,Medium-Low Digitalization,Small Course ( <15H )
4461,67,57,10,2017,1007,0.85,85,High Digitalization,High Course ( >40H )
4462,5,2,3,2017,1007,0.47,47,Medium-Low Digitalization,Small Course ( <15H )
4463,31,11,20,2017,1007,0.36,36,Medium-Low Digitalization,Medium Course ( >15H and <40H )
4464,68,45,23,2017,1007,0.66,66,Medium-High Digitalization,High Course ( >40H )
4465,15,2,13,2017,1007,0.13,13,Low Digitalization,Small Course ( <15H )
4466,13,6,7,2017,1007,0.46,46,Medium-Low Digitalization,Small Course ( <15H )
4467,90,9,81,2017,1007,0.1,10,Low Digitalization,High Course ( >40H )
4468,14,10,4,2017,1007,0.68,68,Medium-High Digitalization,Small Course ( <15H )
4469,15,10,5,2017,1007,0.65,65,Medium-High Digitalization,Small Course ( <15H )
4470,60,8,52,2017,1007,0.13,13,Low Digitalization,High Course ( >40H )
4471,37,37,0,2017,1007,1.0,100,High Digitalization,Medium Course ( >15H and <40H )
4472,48,11,37,2017,1007,0.22,22,Medium-Low Digitalization,High Course ( >40H )
4473,30,12,18,2017,1007,0.4,40,Medium-Low Digitalization,Medium Course ( >15H and <40H )
4474,65,34,31,2017,1007,0.53,53,Medium-High Digitalization,High Course ( >40H )
4475,35,2,33,2017,1007,0.07,7,Low Digitalization,Medium Course ( >15H and <40H )
4476,17,7,10,2017,1007,0.44,44,Medium-Low Digitalization,Medium Course ( >15H and <40H )
4477,7,1,6,2017,1007,0.14,14,Low Digitalization,Small Course ( <15H )
4478,25,2,23,2017,1007,0.09,9,Low Digitalization,Medium Course ( >15H and <40H )
4479,34,31,3,2017,1007,0.9,90,High Digitalization,Medium Course ( >15H and <40H )
4480,78,73,5,2017,1007,0.93,93,High Digitalization,High Course ( >40H )
4481,8,4,4,2017,1007,0.56,56,Medium-High Digitalization,Small Course ( <15H )
4482,84,52,32,2017,1007,0.62,62,Medium-High Digitalization,High Course ( >40H )
4483,8,8,0,2017,1007,0.95,95,High Digitalization,Small Course ( <15H )
4484,24,1,23,2017,1007,0.03,3,Low Digitalization,Medium Course ( >15H and <40H )
4485,9,4,5,2017,1007,0.48,48,Medium-Low Digitalization,Small Course ( <15H )
4486,33,11,22,2017,1007,0.32,32,Medium-Low Digitalization,Medium Course ( >15H and <40H )
4487,43,33,10,2017,1007,0.76,76,Medium-High Digitalization,High Course ( >40H )
4488,23,1,22,2017,1007,0.03,3,Low Digitalization,Medium Course ( >15H and <40H )
4489,55,42,13,2017,1007,0.77,77,Medium-High Digitalization,High Course ( >40H )
4490,11,5,6,2017,1007,0.46,46,Medium-Low Digitalization,Small Course ( <15H )
4491,53,14,39,2017,1007,0.27,27,Medium-Low Digitalization,High Course ( >40H )
4492,15,11,4,2017,1007,0.72,72,Medium-High Digitalization,Small Course ( <15H )
4493,15,9,6,2017,1007,0.63,63,Medium-High Digitalization,Small Course ( <15H )
4494,44,28,16,2017,1007,0.64,64,Medium-High Digitalization,High Course ( >40H )
4495,12,4,8,2017,1007,0.35,35,Medium-Low Digitalization,Small Course ( <15H )
4496,14,12,2,2017,1007,0.88,88,High Digitalization,Small Course ( <15H )
4497,33,9,24,2017,1007,0.26,26,Medium-Low Digitalization,Medium Course ( >15H and <40H )
4498,5,4,1,2017,1007,0.85,85,High Digitalization,Small Course ( <15H )
4499,81,42,39,2017,1007,0.52,52,Medium-High Digitalization,High Course ( >40H )
4500,12,1,11,2017,1007,0.1,10,Low Digitalization,Small Course ( <15H )
4501,81,58,23,2017,1007,0.71,71,Medium-High Digitalization,High Course ( >40H )
4502,8,6,2,2017,1007,0.71,71,Medium-High Digitalization,Small Course ( <15H )
4503,8,4,4,2017,1007,0.44,44,Medium-Low Digitalization,Small Course ( <15H )
4504,13,1,12,2017,1007,0.09,9,Low Digitalization,Small Course ( <15H )
4505,9,6,3,2017,1007,0.64,64,Medium-High Digitalization,Small Course ( <15H )
4506,10,0,10,2017,1007,0.03,3,Low Digitalization,Small Course ( <15H )
4507,20,1,19,2017,1007,0.05,5,Low Digitalization,Medium Course ( >15H and <40H )
4508,42,30,12,2017,1007,0.72,72,Medium-High Digitalization,High Course ( >40H )
4509,11,2,9,2017,1007,0.16,16,Low Digitalization,Small Course ( <15H )
4510,36,22,14,2017,1007,0.62,62,Medium-High Digitalization,Medium Course ( >15H and <40H )
4511,78,27,51,2017,1007,0.35,35,Medium-Low Digitalization,High Course ( >40H )
4512,15,11,4,2017,1007,0.75,75,Medium-High Digitalization,Small Course ( <15H )
4513,38,6,32,2017,1007,0.17,17,Low Digitalization,Medium Course ( >15H and <40H )
4514,60,54,6,2017,1007,0.9,90,High Digitalization,High Course ( >40H )
4515,15,1,14,2017,1007,0.04,4,Low Digitalization,Small Course ( <15H )
4516,55,24,31,2017,1007,0.43,43,Medium-Low Digitalization,High Course ( >40H )
4517,15,7,8,2017,1007,0.47,47,Medium-Low Digitalization,Small Course ( <15H )
4518,22,20,2,2017,1007,0.93,93,High Digitalization,Medium Course ( >15H and <40H )
4519,13,13,0,2017,1007,0.98,98,High Digitalization,Small Course ( <15H )
4520,34,13,21,2017,1007,0.39,39,Medium-Low Digitalization,Medium Course ( >15H and <40H )
4521,13,5,8,2017,1007,0.38,38,Medium-Low Digitalization,Small Course ( <15H )
4522,75,60,15,2017,1007,0.8,80,Medium-High Digitalization,High Course ( >40H )
4523,84,23,61,2017,1007,0.27,27,Medium-Low Digitalization,High Course ( >40H )
4524,64,2,62,2017,1007,0.03,3,Low Digitalization,High Course ( >40H )
4525,85,76,9,2017,1007,0.89,89,High Digitalization,High Course ( >40H )
4526,43,1,42,2017,1007,0.03,3,Low Digitalization,High Course ( >40H )
4527,57,8,49,2017,1007,0.14,14,Low Digitalization,High Course ( >40H )
4528,5,2,3,2017,1007,0.49,49,Medium-Low Digitalization,Small Course ( <15H )
4529,37,25,12,2017,1007,0.68,68,Medium-High Digitalization,Medium Course ( >15H and <40H )
4530,58,30,28,2017,1007,0.52,52,Medium-High Digitalization,High Course ( >40H )
4531,10,2,8,2017,1007,0.2,20,Low Digitalization,Small Course ( <15H )
4532,8,5,3,2017,1007,0.64,64,Medium-High Digitalization,Small Course ( <15H )
4533,60,4,56,2017,1007,0.06,6,Low Digitalization,High Course ( >40H )
4534,82,39,43,2017,1007,0.47,47,Medium-Low Digitalization,High Course ( >40H )
4535,65,55,10,2017,1007,0.84,84,High Digitalization,High Course ( >40H )
4536,11,2,9,2017,1007,0.2,20,Low Digitalization,Small Course ( <15H )
4537,72,28,44,2017,1007,0.39,39,Medium-Low Digitalization,High Course ( >40H )
4538,5,5,0,2017,1007,0.93,93,High Digitalization,Small Course ( <15H )
4539,9,3,6,2017,1007,0.38,38,Medium-Low Digitalization,Small Course ( <15H )
4540,42,24,18,2017,1007,0.58,57,Medium-High Digitalization,High Course ( >40H )
4541,15,4,11,2017,1007,0.24,24,Medium-Low Digitalization,Small Course ( <15H )
4542,59,7,52,2017,1007,0.12,12,Low Digitalization,High Course ( >40H )
4543,27,16,11,2017,1007,0.61,61,Medium-High Digitalization,Medium Course ( >15H and <40H )
4544,57,55,2,2017,1007,0.96,96,High Digitalization,High Course ( >40H )
4545,45,11,34,2017,1007,0.25,25,Medium-Low Digitalization,High Course ( >40H )
4546,13,0,13,2017,1007,0.03,3,Low Digitalization,Small Course ( <15H )
4547,37,34,3,2017,1007,0.92,92,High Digitalization,Medium Course ( >15H and <40H )
4548,27,9,18,2017,1007,0.35,35,Medium-Low Digitalization,Medium Course ( >15H and <40H )
4549,64,51,13,2017,1007,0.8,80,Medium-High Digitalization,High Course ( >40H )
4550,76,74,2,2017,1007,0.97,97,High Digitalization,High Course ( >40H )
4551,73,12,61,2017,1007,0.17,17,Low Digitalization,High Course ( >40H )
4552,12,7,5,2017,1007,0.58,57,Medium-High Digitalization,Small Course ( <15H )
4553,71,31,40,2017,1007,0.43,43,Medium-Low Digitalization,High Course ( >40H )
4554,75,7,68,2017,1007,0.09,9,Low Digitalization,High Course ( >40H )
4555,5,1,4,2017,1007,0.16,16,Low Digitalization,Small Course ( <15H )
4556,6,3,3,2017,1007,0.58,57,Medium-High Digitalization,Small Course ( <15H )
4557,89,83,6,2017,1007,0.93,93,High Digitalization,High Course ( >40H )
4558,26,4,22,2017,1007,0.16,16,Low Digitalization,Medium Course ( >15H and <40H )
4559,76,14,62,2017,1007,0.19,19,Low Digitalization,High Course ( >40H )
4560,45,5,40,2017,1007,0.12,12,Low Digitalization,High Course ( >40H )
4561,76,44,32,2017,1007,0.58,57,Medium-High Digitalization,High Course ( >40H )
4562,44,23,21,2017,1007,0.52,52,Medium-High Digitalization,High Course ( >40H )
4563,57,46,11,2017,1007,0.81,81,High Digitalization,High Course ( >40H )
4564,18,12,6,2017,1007,0.65,65,Medium-High Digitalization,Medium Course ( >15H and <40H )
4565,34,30,4,2017,1007,0.88,88,High Digitalization,Medium Course ( >15H and <40H )
4566,68,61,7,2017,1007,0.89,89,High Digitalization,High Course ( >40H )
4567,23,16,7,2017,1007,0.69,69,Medium-High Digitalization,Medium Course ( >15H and <40H )
4568,55,33,22,2017,1007,0.6,60,Medium-High Digitalization,High Course ( >40H )
4569,16,14,2,2017,1007,0.86,86,High Digitalization,Medium Course ( >15H and <40H )
4570,26,23,3,2017,1007,0.89,89,High Digitalization,Medium Course ( >15H and <40H )
4571,49,36,13,2017,1007,0.74,74,Medium-High Digitalization,High Course ( >40H )
4572,21,11,10,2017,1007,0.52,52,Medium-High Digitalization,Medium Course ( >15H and <40H )
4573,59,15,44,2017,1007,0.26,26,Medium-Low Digitalization,High Course ( >40H )
4574,6,0,6,2017,1007,0.04,4,Low Digitalization,Small Course ( <15H )
4575,13,8,5,2017,1007,0.6,60,Medium-High Digitalization,Small Course ( <15H )
4576,17,4,13,2017,1007,0.25,25,Medium-Low Digitalization,Medium Course ( >15H and <40H )
4577,46,42,4,2017,1007,0.91,91,High Digitalization,High Course ( >40H )
4578,26,9,17,2017,1007,0.35,35,Medium-Low Digitalization,Medium Course ( >15H and <40H )
4579,6,4,2,2017,1007,0.66,66,Medium-High Digitalization,Small Course ( <15H )
4580,77,72,5,2017,1007,0.94,94,High Digitalization,High Course ( >40H )
4581,12,1,11,2017,1007,0.05,5,Low Digitalization,Small Course ( <15H )
4582,70,62,8,2017,1007,0.88,88,High Digitalization,High Course ( >40H )
4583,72,14,58,2017,1007,0.19,19,Low Digitalization,High Course ( >40H )
4584,5,2,3,2017,1007,0.39,39,Medium-Low Digitalization,Small Course ( <15H )
4585,28,3,25,2017,1007,0.12,12,Low Digitalization,Medium Course ( >15H and <40H )
4586,74,53,21,2017,1007,0.71,71,Medium-High Digitalization,High Course ( >40H )
4587,57,8,49,2017,1007,0.14,14,Low Digitalization,High Course ( >40H )
4588,11,8,3,2017,1007,0.71,71,Medium-High Digitalization,Small Course ( <15H )
4589,37,18,18,2017,1007,0.5,50,Medium-Low Digitalization,Medium Course ( >15H and <40H )
4590,90,87,3,2017,1007,0.97,97,High Digitalization,High Course ( >40H )
4591,6,1,5,2017,1007,0.15,15,Low Digitalization,Small Course ( <15H )
4592,46,13,33,2017,1007,0.28,28,Medium-Low Digitalization,High Course ( >40H )
4593,65,7,58,2017,1007,0.11,11,Low Digitalization,High Course ( >40H )
4594,27,18,9,2017,1007,0.65,65,Medium-High Digitalization,Medium Course ( >15H and <40H )
4595,82,46,36,2017,1007,0.56,56,Medium-High Digitalization,High Course ( >40H )
4596,77,28,49,2017,1007,0.36,36,Medium-Low Digitalization,High Course ( >40H )
4597,25,19,6,2017,1007,0.76,76,Medium-High Digitalization,Medium Course ( >15H and <40H )
4598,30,2,28,2017,1007,0.06,6,Low Digitalization,Medium Course ( >15H and <40H )
4599,31,29,2,2017,1007,0.94,94,High Digitalization,Medium Course ( >15H and <40H )
4600,90,76,14,2017,1007,0.85,85,High Digitalization,High Course ( >40H )
4601,10,7,3,2017,1007,0.74,74,Medium-High Digitalization,Small Course ( <15H )
4602,7,5,2,2017,1007,0.7,70,Medium-High Digitalization,Small Course ( <15H )
4603,52,45,7,2017,1007,0.86,86,High Digitalization,High Course ( >40H )
4604,10,4,6,2017,1007,0.41,41,Medium-Low Digitalization,Small Course ( <15H )
4605,73,2,71,2017,1007,0.03,3,Low Digitalization,High Course ( >40H )
4606,27,22,5,2017,1007,0.81,81,High Digitalization,Medium Course ( >15H and <40H )
4607,37,1,36,2017,1007,0.04,4,Low Digitalization,Medium Course ( >15H and <40H )
4608,12,0,12,2017,1007,0.0,0,Low Digitalization,Small Course ( <15H )
4609,32,9,23,2017,1007,0.27,27,Medium-Low Digitalization,Medium Course ( >15H and <40H )
4610,10,2,8,2017,1007,0.22,22,Medium-Low Digitalization,Small Course ( <15H )
4611,86,2,84,2017,1007,0.02,2,Low Digitalization,High Course ( >40H )
4612,26,17,9,2017,1007,0.66,66,Medium-High Digitalization,Medium Course ( >15H and <40H )
4613,90,22,68,2017,1007,0.24,24,Medium-Low Digitalization,High Course ( >40H )
4614,5,4,1,2017,1007,0.79,79,Medium-High Digitalization,Small Course ( <15H )
4615,86,11,75,2017,1007,0.13,13,Low Digitalization,High Course ( >40H )
4616,15,12,3,2017,1007,0.78,78,Medium-High Digitalization,Small Course ( <15H )
4617,57,44,13,2017,1007,0.78,78,Medium-High Digitalization,High Course ( >40H )
4618,89,79,10,2017,1007,0.89,89,High Digitalization,High Course ( >40H )
4619,73,40,33,2017,1007,0.55,55,Medium-High Digitalization,High Course ( >40H )
4620,14,4,10,2017,1007,0.26,26,Medium-Low Digitalization,Small Course ( <15H )
4621,15,14,1,2017,1007,0.93,93,High Digitalization,Small Course ( <15H )
4622,31,23,8,2017,1007,0.75,75,Medium-High Digitalization,Medium Course ( >15H and <40H )
4623,70,56,14,2017,1007,0.8,80,Medium-High Digitalization,High Course ( >40H )
4624,72,60,12,2017,1007,0.84,84,High Digitalization,High Course ( >40H )
4625,82,16,66,2017,1007,0.2,20,Low Digitalization,High Course ( >40H )
4626,50,34,16,2017,1007,0.69,69,Medium-High Digitalization,High Course ( >40H )
4627,11,8,3,2017,1007,0.7,70,Medium-High Digitalization,Small Course ( <15H )
4628,37,26,11,2017,1007,0.7,70,Medium-High Digitalization,Medium Course ( >15H and <40H )
4629,20,9,11,2017,1007,0.46,46,Medium-Low Digitalization,Medium Course ( >15H and <40H )
4630,15,8,7,2017,1007,0.55,55,Medium-High Digitalization,Small Course ( <15H )
4631,9,8,1,2017,1007,0.92,92,High Digitalization,Small Course ( <15H )
4632,28,15,13,2017,1007,0.55,55,Medium-High Digitalization,Medium Course ( >15H and <40H )
4633,55,17,38,2017,1007,0.31,31,Medium-Low Digitalization,High Course ( >40H )
4634,43,14,29,2017,1007,0.33,33,Medium-Low Digitalization,High Course ( >40H )
4635,43,5,38,2017,1007,0.11,11,Low Digitalization,High Course ( >40H )
4636,23,17,6,2017,1007,0.73,73,Medium-High Digitalization,Medium Course ( >15H and <40H )
4637,57,11,46,2017,1007,0.2,20,Low Digitalization,High Course ( >40H )
4638,69,46,23,2017,1007,0.67,67,Medium-High Digitalization,High Course ( >40H )
4639,53,9,44,2017,1007,0.17,17,Low Digitalization,High Course ( >40H )
4640,6,5,1,2017,1007,0.78,78,Medium-High Digitalization,Small Course ( <15H )
4641,55,35,20,2017,1007,0.64,64,Medium-High Digitalization,High Course ( >40H )
4642,10,0,10,2017,1007,0.01,1,Low Digitalization,Small Course ( <15H )
4643,37,11,26,2017,1007,0.31,31,Medium-Low Digitalization,Medium Course ( >15H and <40H )
4644,7,5,2,2017,1007,0.77,77,Medium-High Digitalization,Small Course ( <15H )
4645,54,49,5,2017,1007,0.9,90,High Digitalization,High Course ( >40H )
4646,33,16,16,2017,1007,0.5,50,Medium-Low Digitalization,Medium Course ( >15H and <40H )
4647,18,3,15,2017,1007,0.17,17,Low Digitalization,Medium Course ( >15H and <40H )
4648,61,23,38,2017,1007,0.38,38,Medium-Low Digitalization,High Course ( >40H )
4649,45,15,30,2017,1007,0.33,33,Medium-Low Digitalization,High Course ( >40H )
4650,31,22,9,2017,1007,0.71,71,Medium-High Digitalization,Medium Course ( >15H and <40H )
4651,72,46,26,2017,1007,0.64,64,Medium-High Digitalization,High Course ( >40H )
4652,7,3,4,2017,1007,0.45,45,Medium-Low Digitalization,Small Course ( <15H )
4653,88,74,14,2017,1007,0.84,84,High Digitalization,High Course ( >40H )
4654,33,32,1,2017,1007,0.98,98,High Digitalization,Medium Course ( >15H and <40H )
4655,73,67,6,2017,1007,0.92,92,High Digitalization,High Course ( >40H )
4656,17,5,12,2017,1007,0.31,31,Medium-Low Digitalization,Medium Course ( >15H and <40H )
4657,50,21,29,2017,1007,0.42,42,Medium-Low Digitalization,High Course ( >40H )
4658,84,76,8,2017,1007,0.91,91,High Digitalization,High Course ( >40H )
4659,12,10,2,2017,1007,0.8,80,Medium-High Digitalization,Small Course ( <15H )
4660,15,11,4,2017,1007,0.71,71,Medium-High Digitalization,Small Course ( <15H )
4661,5,2,3,2017,1007,0.39,39,Medium-Low Digitalization,Small Course ( <15H )
4662,47,4,43,2017,1007,0.08,8,Low Digitalization,High Course ( >40H )
4663,87,83,4,2017,1007,0.95,95,High Digitalization,High Course ( >40H )
4664,56,24,32,2017,1007,0.43,43,Medium-Low Digitalization,High Course ( >40H )
4665,41,30,11,2017,1007,0.72,72,Medium-High Digitalization,High Course ( >40H )
4666,63,52,11,2017,1007,0.82,82,High Digitalization,High Course ( >40H )
4667,10,6,4,2017,1007,0.57,56,Medium-High Digitalization,Small Course ( <15H )
4668,31,25,6,2017,1007,0.82,82,High Digitalization,Medium Course ( >15H and <40H )
4669,50,14,36,2017,1007,0.27,27,Medium-Low Digitalization,High Course ( >40H )
4670,19,5,14,2017,1007,0.24,24,Medium-Low Digitalization,Medium Course ( >15H and <40H )
4671,90,13,77,2017,1007,0.14,14,Low Digitalization,High Course ( >40H )
4672,8,2,6,2017,1007,0.22,22,Medium-Low Digitalization,Small Course ( <15H )
4673,18,17,1,2017,1007,0.93,93,High Digitalization,Medium Course ( >15H and <40H )
4674,50,46,4,2017,1007,0.92,92,High Digitalization,High Course ( >40H )
4675,38,22,16,2017,1007,0.57,56,Medium-High Digitalization,Medium Course ( >15H and <40H )
4676,57,1,56,2017,1007,0.02,2,Low Digitalization,High Course ( >40H )
4677,70,43,27,2017,1007,0.61,61,Medium-High Digitalization,High Course ( >40H )
4678,21,1,20,2017,1007,0.07,7,Low Digitalization,Medium Course ( >15H and <40H )
4679,36,19,17,2017,1007,0.53,53,Medium-High Digitalization,Medium Course ( >15H and <40H )
4680,13,2,11,2017,1007,0.14,14,Low Digitalization,Small Course ( <15H )
4681,41,11,30,2017,1007,0.28,28,Medium-Low Digitalization,High Course ( >40H )
4682,15,2,13,2017,1007,0.16,16,Low Digitalization,Small Course ( <15H )
4683,74,49,25,2017,1007,0.66,66,Medium-High Digitalization,High Course ( >40H )
4684,89,85,4,2017,1007,0.95,95,High Digitalization,High Course ( >40H )
4685,12,5,7,2017,1007,0.41,41,Medium-Low Digitalization,Small Course ( <15H )
4686,61,7,54,2017,1007,0.11,11,Low Digitalization,High Course ( >40H )
4687,8,7,1,2017,1007,0.92,92,High Digitalization,Small Course ( <15H )
4688,56,21,35,2017,1007,0.38,38,Medium-Low Digitalization,High Course ( >40H )
4689,21,15,6,2017,1007,0.73,73,Medium-High Digitalization,Medium Course ( >15H and <40H )
4690,15,8,7,2017,1007,0.54,54,Medium-High Digitalization,Small Course ( <15H )
4691,57,40,17,2017,1007,0.71,71,Medium-High Digitalization,High Course ( >40H )
4692,16,13,3,2017,1007,0.82,82,High Digitalization,Medium Course ( >15H and <40H )
4693,44,32,12,2017,1007,0.72,72,Medium-High Digitalization,High Course ( >40H )
4694,10,4,6,2017,1007,0.4,40,Medium-Low Digitalization,Small Course ( <15H )
4695,88,28,60,2017,1007,0.32,32,Medium-Low Digitalization,High Course ( >40H )
4696,18,3,15,2017,1007,0.16,16,Low Digitalization,Medium Course ( >15H and <40H )
4697,27,14,14,2017,1007,0.5,50,Medium-Low Digitalization,Medium Course ( >15H and <40H )
4698,8,7,1,2017,1007,0.86,86,High Digitalization,Small Course ( <15H )
4699,24,19,5,2017,1007,0.79,79,Medium-High Digitalization,Medium Course ( >15H and <40H )
4700,13,9,4,2017,1007,0.73,73,Medium-High Digitalization,Small Course ( <15H )
4701,8,3,5,2017,1007,0.32,32,Medium-Low Digitalization,Small Course ( <15H )
4702,78,46,32,2017,1007,0.59,59,Medium-High Digitalization,High Course ( >40H )
4703,75,4,70,2017,1007,0.06,6,Low Digitalization,High Course ( >40H )
4704,24,23,1,2017,1007,0.96,96,High Digitalization,Medium Course ( >15H and <40H )
4705,7,2,5,2017,1007,0.27,27,Medium-Low Digitalization,Small Course ( <15H )
4706,47,11,36,2017,1007,0.23,23,Medium-Low Digitalization,High Course ( >40H )
4707,39,12,27,2017,1007,0.3,30,Medium-Low Digitalization,Medium Course ( >15H and <40H )
4708,15,10,4,2017,1007,0.7,70,Medium-High Digitalization,Small Course ( <15H )
4709,90,43,47,2017,1007,0.48,48,Medium-Low Digitalization,High Course ( >40H )
4710,12,4,8,2017,1007,0.36,36,Medium-Low Digitalization,Small Course ( <15H )
4711,23,20,3,2017,1007,0.86,86,High Digitalization,Medium Course ( >15H and <40H )
4712,14,13,1,2017,1007,0.9,90,High Digitalization,Small Course ( <15H )
4713,66,40,26,2017,1007,0.6,60,Medium-High Digitalization,High Course ( >40H )
4714,5,3,2,2017,1007,0.52,52,Medium-High Digitalization,Small Course ( <15H )
4715,20,12,8,2017,1007,0.58,57,Medium-High Digitalization,Medium Course ( >15H and <40H )
4716,71,6,65,2017,1007,0.09,9,Low Digitalization,High Course ( >40H )
4717,73,50,23,2017,1007,0.68,68,Medium-High Digitalization,High Course ( >40H )
4718,75,3,72,2017,1007,0.04,4,Low Digitalization,High Course ( >40H )
4719,83,55,28,2017,1007,0.66,66,Medium-High Digitalization,High Course ( >40H )
4720,8,0,8,2017,1007,0.05,5,Low Digitalization,Small Course ( <15H )
4721,82,10,72,2017,1007,0.12,12,Low Digitalization,High Course ( >40H )
4722,62,2,60,2017,1007,0.04,4,Low Digitalization,High Course ( >40H )
4723,14,13,1,2017,1007,0.94,94,High Digitalization,Small Course ( <15H )
4724,59,51,8,2017,1007,0.87,87,High Digitalization,High Course ( >40H )
4725,37,31,6,2017,1007,0.83,83,High Digitalization,Medium Course ( >15H and <40H )
4726,12,8,4,2017,1007,0.7,70,Medium-High Digitalization,Small Course ( <15H )
4727,81,65,16,2017,1007,0.8,80,Medium-High Digitalization,High Course ( >40H )
4728,15,11,4,2017,1007,0.74,74,Medium-High Digitalization,Small Course ( <15H )
4729,25,4,20,2017,1007,0.18,18,Low Digitalization,Medium Course ( >15H and <40H )
4730,11,8,3,2017,1007,0.7,70,Medium-High Digitalization,Small Course ( <15H )
4731,21,13,8,2017,1007,0.6,60,Medium-High Digitalization,Medium Course ( >15H and <40H )
4732,31,19,12,2017,1007,0.61,61,Medium-High Digitalization,Medium Course ( >15H and <40H )
4733,58,35,23,2017,1007,0.61,61,Medium-High Digitalization,High Course ( >40H )
4734,50,14,36,2017,1007,0.29,28,Medium-Low Digitalization,High Course ( >40H )
4735,77,75,2,2017,1007,0.97,97,High Digitalization,High Course ( >40H )
4736,9,4,5,2017,1007,0.4,40,Medium-Low Digitalization,Small Course ( <15H )
4737,32,14,18,2017,1007,0.43,43,Medium-Low Digitalization,Medium Course ( >15H and <40H )
4738,7,1,6,2017,1007,0.15,15,Low Digitalization,Small Course ( <15H )
4739,6,1,5,2017,1007,0.18,18,Low Digitalization,Small Course ( <15H )
4740,8,5,3,2017,1007,0.61,61,Medium-High Digitalization,Small Course ( <15H )
4741,84,8,76,2017,1007,0.09,9,Low Digitalization,High Course ( >40H )
4742,55,53,2,2017,1007,0.97,97,High Digitalization,High Course ( >40H )
4743,55,36,19,2017,1007,0.66,66,Medium-High Digitalization,High Course ( >40H )
4744,18,12,6,2017,1007,0.64,64,Medium-High Digitalization,Medium Course ( >15H and <40H )
4745,49,35,14,2017,1007,0.71,71,Medium-High Digitalization,High Course ( >40H )
4746,72,66,6,2017,1007,0.92,92,High Digitalization,High Course ( >40H )
4747,57,7,50,2017,1007,0.12,12,Low Digitalization,High Course ( >40H )
4748,12,4,8,2017,1007,0.34,34,Medium-Low Digitalization,Small Course ( <15H )
4749,9,8,1,2017,1007,0.89,89,High Digitalization,Small Course ( <15H )
4750,10,8,2,2017,1007,0.79,79,Medium-High Digitalization,Small Course ( <15H )
4751,60,26,34,2017,1007,0.43,43,Medium-Low Digitalization,High Course ( >40H )
4752,80,7,73,2017,1007,0.09,9,Low Digitalization,High Course ( >40H )
4753,31,12,19,2017,1007,0.38,38,Medium-Low Digitalization,Medium Course ( >15H and <40H )
4754,5,3,2,2017,1007,0.55,55,Medium-High Digitalization,Small Course ( <15H )
4755,45,27,18,2017,1007,0.6,60,Medium-High Digitalization,High Course ( >40H )
4756,5,1,4,2017,1007,0.14,14,Low Digitalization,Small Course ( <15H )
4757,55,35,20,2017,1007,0.64,64,Medium-High Digitalization,High Course ( >40H )
4758,68,54,14,2017,1007,0.8,80,Medium-High Digitalization,High Course ( >40H )
4759,49,6,43,2017,1007,0.13,13,Low Digitalization,High Course ( >40H )
4760,49,20,29,2017,1007,0.4,40,Medium-Low Digitalization,High Course ( >40H )
4761,5,1,4,2017,1007,0.11,11,Low Digitalization,Small Course ( <15H )
4762,60,10,50,2017,1007,0.17,17,Low Digitalization,High Course ( >40H )
4763,13,8,5,2017,1007,0.62,62,Medium-High Digitalization,Small Course ( <15H )
4764,57,34,23,2017,1007,0.6,60,Medium-High Digitalization,High Course ( >40H )
4765,52,1,51,2017,1007,0.01,1,Low Digitalization,High Course ( >40H )
4766,83,29,54,2017,1007,0.35,35,Medium-Low Digitalization,High Course ( >40H )
4767,11,8,3,2017,1007,0.73,73,Medium-High Digitalization,Small Course ( <15H )
4768,40,33,7,2017,1007,0.82,82,High Digitalization,High Course ( >40H )
4769,60,5,55,2017,1007,0.08,8,Low Digitalization,High Course ( >40H )
4770,13,6,7,2017,1007,0.47,47,Medium-Low Digitalization,Small Course ( <15H )
4771,8,6,2,2017,1007,0.76,76,Medium-High Digitalization,Small Course ( <15H )
4772,11,3,8,2017,1007,0.31,31,Medium-Low Digitalization,Small Course ( <15H )
4773,40,27,13,2017,1007,0.68,68,Medium-High Digitalization,High Course ( >40H )
4774,76,2,74,2017,1007,0.02,2,Low Digitalization,High Course ( >40H )
4775,64,24,40,2017,1007,0.37,37,Medium-Low Digitalization,High Course ( >40H )
4776,12,4,8,2017,1007,0.35,35,Medium-Low Digitalization,Small Course ( <15H )
4777,74,56,18,2017,1007,0.76,76,Medium-High Digitalization,High Course ( >40H )
4778,46,25,21,2017,1007,0.54,54,Medium-High Digitalization,High Course ( >40H )
4779,69,67,2,2017,1007,0.97,97,High Digitalization,High Course ( >40H )
4780,55,16,39,2017,1007,0.29,28,Medium-Low Digitalization,High Course ( >40H )
4781,6,3,3,2017,1007,0.54,54,Medium-High Digitalization,Small Course ( <15H )
4782,5,2,3,2017,1007,0.34,34,Medium-Low Digitalization,Small Course ( <15H )
4783,60,34,26,2017,1007,0.56,56,Medium-High Digitalization,High Course ( >40H )
4784,12,10,2,2017,1007,0.87,87,High Digitalization,Small Course ( <15H )
4785,14,11,3,2017,1007,0.78,78,Medium-High Digitalization,Small Course ( <15H )
4786,60,25,35,2017,1007,0.42,42,Medium-Low Digitalization,High Course ( >40H )
4787,7,7,0,2017,1007,0.96,96,High Digitalization,Small Course ( <15H )
4788,11,5,6,2017,1007,0.48,48,Medium-Low Digitalization,Small Course ( <15H )
4789,11,0,11,2017,1007,0.01,1,Low Digitalization,Small Course ( <15H )
4790,36,1,35,2017,1007,0.03,3,Low Digitalization,Medium Course ( >15H and <40H )
4791,39,1,38,2017,1007,0.02,2,Low Digitalization,Medium Course ( >15H and <40H )
4792,23,3,20,2017,1007,0.11,11,Low Digitalization,Medium Course ( >15H and <40H )
4793,13,13,0,2017,1007,0.98,98,High Digitalization,Small Course ( <15H )
4794,81,42,39,2017,1007,0.52,52,Medium-High Digitalization,High Course ( >40H )
4795,87,30,57,2017,1007,0.35,35,Medium-Low Digitalization,High Course ( >40H )
4796,18,16,2,2017,1007,0.9,90,High Digitalization,Medium Course ( >15H and <40H )
4797,59,11,48,2017,1007,0.19,19,Low Digitalization,High Course ( >40H )
4798,52,40,12,2017,1007,0.76,76,Medium-High Digitalization,High Course ( >40H )
4799,18,9,9,2017,1007,0.48,48,Medium-Low Digitalization,Medium Course ( >15H and <40H )
4800,30,17,13,2017,1007,0.58,57,Medium-High Digitalization,Medium Course ( >15H and <40H )
4801,39,27,12,2017,1007,0.68,68,Medium-High Digitalization,Medium Course ( >15H and <40H )
4802,25,4,20,2017,1007,0.18,18,Low Digitalization,Medium Course ( >15H and <40H )
4803,13,8,5,2017,1007,0.58,57,Medium-High Digitalization,Small Course ( <15H )
4804,10,8,2,2017,1007,0.83,83,High Digitalization,Small Course ( <15H )
4805,10,5,5,2017,1007,0.47,47,Medium-Low Digitalization,Small Course ( <15H )
4806,71,11,60,2017,1007,0.16,16,Low Digitalization,High Course ( >40H )
4807,5,0,5,2017,1007,0.06,6,Low Digitalization,Small Course ( <15H )
4808,66,44,22,2017,1007,0.67,67,Medium-High Digitalization,High Course ( >40H )
4809,6,4,2,2017,1007,0.62,62,Medium-High Digitalization,Small Course ( <15H )
4810,41,32,9,2017,1007,0.78,78,Medium-High Digitalization,High Course ( >40H )
4811,77,28,49,2017,1007,0.37,37,Medium-Low Digitalization,High Course ( >40H )
4812,78,23,55,2017,1007,0.3,30,Medium-Low Digitalization,High Course ( >40H )
4813,72,18,54,2017,1007,0.25,25,Medium-Low Digitalization,High Course ( >40H )
4814,8,3,5,2017,1007,0.38,38,Medium-Low Digitalization,Small Course ( <15H )
4815,5,4,1,2017,1007,0.77,77,Medium-High Digitalization,Small Course ( <15H )
4816,9,4,4,2017,1007,0.5,50,Medium-Low Digitalization,Small Course ( <15H )
4817,27,15,12,2017,1007,0.57,56,Medium-High Digitalization,Medium Course ( >15H and <40H )
4818,38,23,15,2017,1007,0.6,60,Medium-High Digitalization,Medium Course ( >15H and <40H )
4819,69,39,30,2017,1007,0.56,56,Medium-High Digitalization,High Course ( >40H )
4820,31,2,29,2017,1007,0.08,8,Low Digitalization,Medium Course ( >15H and <40H )
4821,13,1,12,2017,1007,0.06,6,Low Digitalization,Small Course ( <15H )
4822,22,17,5,2017,1007,0.78,78,Medium-High Digitalization,Medium Course ( >15H and <40H )
4823,22,1,21,2017,1007,0.05,5,Low Digitalization,Medium Course ( >15H and <40H )
4824,74,7,67,2017,1007,0.1,10,Low Digitalization,High Course ( >40H )
4825,11,11,0,2017,1007,0.96,96,High Digitalization,Small Course ( <15H )
4826,64,57,7,2017,1007,0.89,89,High Digitalization,High Course ( >40H )
4827,28,11,17,2017,1007,0.39,39,Medium-Low Digitalization,Medium Course ( >15H and <40H )
4828,50,37,13,2017,1007,0.74,74,Medium-High Digitalization,High Course ( >40H )
4829,76,20,56,2017,1007,0.26,26,Medium-Low Digitalization,High Course ( >40H )
4830,13,2,11,2017,1007,0.18,18,Low Digitalization,Small Course ( <15H )
4831,6,1,5,2017,1007,0.2,20,Low Digitalization,Small Course ( <15H )
4832,15,10,5,2017,1007,0.68,68,Medium-High Digitalization,Small Course ( <15H )
4833,86,19,67,2017,1007,0.22,22,Medium-Low Digitalization,High Course ( >40H )
4834,27,5,22,2017,1007,0.2,20,Low Digitalization,Medium Course ( >15H and <40H )
4835,51,40,11,2017,1007,0.79,79,Medium-High Digitalization,High Course ( >40H )
4836,52,31,21,2017,1007,0.6,60,Medium-High Digitalization,High Course ( >40H )
4837,8,3,5,2017,1007,0.39,39,Medium-Low Digitalization,Small Course ( <15H )
4838,19,14,5,2017,1007,0.75,75,Medium-High Digitalization,Medium Course ( >15H and <40H )
4839,12,3,9,2017,1007,0.21,21,Medium-Low Digitalization,Small Course ( <15H )
4840,89,85,4,2017,1007,0.96,96,High Digitalization,High Course ( >40H )
4841,11,9,2,2017,1007,0.81,81,High Digitalization,Small Course ( <15H )
4842,33,10,23,2017,1007,0.31,31,Medium-Low Digitalization,Medium Course ( >15H and <40H )
4843,53,24,29,2017,1007,0.45,45,Medium-Low Digitalization,High Course ( >40H )
4844,58,8,50,2017,1007,0.14,14,Low Digitalization,High Course ( >40H )
4845,15,2,13,2017,1007,0.16,16,Low Digitalization,Small Course ( <15H )
4846,78,23,55,2017,1007,0.29,28,Medium-Low Digitalization,High Course ( >40H )
4847,61,12,49,2017,1007,0.19,19,Low Digitalization,High Course ( >40H )
4848,13,6,7,2017,1007,0.45,45,Medium-Low Digitalization,Small Course ( <15H )
4849,65,51,14,2017,1007,0.78,78,Medium-High Digitalization,High Course ( >40H )
4850,11,4,7,2017,1007,0.35,35,Medium-Low Digitalization,Small Course ( <15H )
4851,9,0,9,2017,1007,0.01,1,Low Digitalization,Small Course ( <15H )
4852,36,36,0,2017,1007,0.99,99,High Digitalization,Medium Course ( >15H and <40H )
4853,10,5,5,2017,1007,0.54,54,Medium-High Digitalization,Small Course ( <15H )
4854,29,8,21,2017,1007,0.28,28,Medium-Low Digitalization,Medium Course ( >15H and <40H )
4855,63,15,48,2017,1007,0.24,24,Medium-Low Digitalization,High Course ( >40H )
4856,56,23,33,2017,1007,0.41,41,Medium-Low Digitalization,High Course ( >40H )
4857,23,11,12,2017,1007,0.46,46,Medium-Low Digitalization,Medium Course ( >15H and <40H )
4858,18,6,12,2017,1007,0.33,33,Medium-Low Digitalization,Medium Course ( >15H and <40H )
4859,7,6,1,2017,1007,0.81,81,High Digitalization,Small Course ( <15H )
4860,6,1,5,2017,1007,0.12,12,Low Digitalization,Small Course ( <15H )
4861,13,4,9,2017,1007,0.32,32,Medium-Low Digitalization,Small Course ( <15H )
4862,6,0,6,2017,1007,0.07,7,Low Digitalization,Small Course ( <15H )
4863,55,30,25,2017,1007,0.54,54,Medium-High Digitalization,High Course ( >40H )
4864,69,19,50,2017,1007,0.27,27,Medium-Low Digitalization,High Course ( >40H )
4865,32,4,28,2017,1007,0.14,14,Low Digitalization,Medium Course ( >15H and <40H )
4866,8,1,7,2017,1007,0.08,8,Low Digitalization,Small Course ( <15H )
4867,12,11,1,2017,1007,0.88,88,High Digitalization,Small Course ( <15H )
4868,83,68,15,2017,1007,0.82,82,High Digitalization,High Course ( >40H )
4869,28,6,22,2017,1007,0.21,21,Medium-Low Digitalization,Medium Course ( >15H and <40H )
4870,9,2,7,2017,1007,0.21,21,Medium-Low Digitalization,Small Course ( <15H )
4871,37,3,34,2017,1007,0.09,9,Low Digitalization,Medium Course ( >15H and <40H )
4872,60,41,19,2017,1007,0.69,69,Medium-High Digitalization,High Course ( >40H )
4873,75,68,8,2017,1007,0.9,90,High Digitalization,High Course ( >40H )
4874,8,7,1,2017,1007,0.85,85,High Digitalization,Small Course ( <15H )
4875,11,8,3,2017,1007,0.7,70,Medium-High Digitalization,Small Course ( <15H )
4876,45,42,3,2017,1007,0.93,93,High Digitalization,High Course ( >40H )
4877,60,44,16,2017,1007,0.73,73,Medium-High Digitalization,High Course ( >40H )
4878,40,19,21,2017,1007,0.47,47,Medium-Low Digitalization,High Course ( >40H )
4879,18,4,14,2017,1007,0.23,23,Medium-Low Digitalization,Medium Course ( >15H and <40H )
4880,40,30,10,2017,1007,0.75,75,Medium-High Digitalization,High Course ( >40H )
4881,75,6,69,2017,1007,0.08,8,Low Digitalization,High Course ( >40H )
4882,21,19,2,2017,1007,0.9,90,High Digitalization,Medium Course ( >15H and <40H )
4883,45,3,42,2017,1007,0.06,6,Low Digitalization,High Course ( >40H )
4884,9,5,4,2017,1007,0.6,60,Medium-High Digitalization,Small Course ( <15H )
4885,19,9,10,2017,1007,0.49,49,Medium-Low Digitalization,Medium Course ( >15H and <40H )
4886,73,23,50,2017,1007,0.32,32,Medium-Low Digitalization,High Course ( >40H )
4887,68,53,15,2017,1007,0.78,78,Medium-High Digitalization,High Course ( >40H )
4888,9,1,8,2017,1007,0.09,9,Low Digitalization,Small Course ( <15H )
4889,10,4,6,2017,1007,0.44,44,Medium-Low Digitalization,Small Course ( <15H )
4890,39,18,21,2017,1007,0.47,47,Medium-Low Digitalization,Medium Course ( >15H and <40H )
4891,89,77,12,2017,1007,0.87,87,High Digitalization,High Course ( >40H )
4892,14,1,13,2017,1007,0.08,8,Low Digitalization,Small Course ( <15H )
4893,40,28,12,2017,1007,0.69,69,Medium-High Digitalization,High Course ( >40H )
4894,80,28,52,2017,1007,0.35,35,Medium-Low Digitalization,High Course ( >40H )
4895,85,70,15,2017,1007,0.82,82,High Digitalization,High Course ( >40H )
4896,68,63,5,2017,1007,0.92,92,High Digitalization,High Course ( >40H )
4897,74,71,3,2017,1007,0.96,96,High Digitalization,High Course ( >40H )
4898,75,58,16,2017,1007,0.78,78,Medium-High Digitalization,High Course ( >40H )
4899,55,16,38,2017,1007,0.3,30,Medium-Low Digitalization,High Course ( >40H )
4900,42,41,1,2017,1007,0.97,97,High Digitalization,High Course ( >40H )
4901,15,10,5,2017,1007,0.66,66,Medium-High Digitalization,Small Course ( <15H )
4902,55,8,47,2017,1007,0.14,14,Low Digitalization,High Course ( >40H )
4903,14,13,1,2017,1007,0.94,94,High Digitalization,Small Course ( <15H )
4904,81,49,32,2017,1007,0.61,61,Medium-High Digitalization,High Course ( >40H )
4905,37,27,10,2017,1007,0.73,73,Medium-High Digitalization,Medium Course ( >15H and <40H )
4906,68,65,3,2017,1007,0.96,96,High Digitalization,High Course ( >40H )
4907,41,34,7,2017,1007,0.83,83,High Digitalization,High Course ( >40H )
4908,70,50,20,2017,1007,0.71,71,Medium-High Digitalization,High Course ( >40H )
4909,48,12,36,2017,1007,0.24,24,Medium-Low Digitalization,High Course ( >40H )
4910,8,6,2,2017,1007,0.73,73,Medium-High Digitalization,Small Course ( <15H )
4911,31,16,15,2017,1007,0.52,52,Medium-High Digitalization,Medium Course ( >15H and <40H )
4912,82,55,27,2017,1007,0.67,67,Medium-High Digitalization,High Course ( >40H )
4913,13,5,8,2017,1007,0.39,39,Medium-Low Digitalization,Small Course ( <15H )
4914,57,17,40,2017,1007,0.3,30,Medium-Low Digitalization,High Course ( >40H )
4915,17,6,11,2017,1007,0.34,34,Medium-Low Digitalization,Medium Course ( >15H and <40H )
4916,76,60,16,2017,1007,0.79,79,Medium-High Digitalization,High Course ( >40H )
4917,49,11,38,2017,1007,0.22,22,Medium-Low Digitalization,High Course ( >40H )
4918,24,6,18,2017,1007,0.26,26,Medium-Low Digitalization,Medium Course ( >15H and <40H )
4919,72,27,45,2017,1007,0.37,37,Medium-Low Digitalization,High Course ( >40H )
4920,57,53,4,2017,1007,0.93,93,High Digitalization,High Course ( >40H )
4921,9,3,6,2017,1007,0.28,28,Medium-Low Digitalization,Small Course ( <15H )
4922,13,9,4,2017,1007,0.71,71,Medium-High Digitalization,Small Course ( <15H )
4923,10,6,4,2017,1007,0.65,65,Medium-High Digitalization,Small Course ( <15H )
4924,56,9,47,2017,1007,0.16,16,Low Digitalization,High Course ( >40H )
4925,23,6,17,2017,1007,0.26,26,Medium-Low Digitalization,Medium Course ( >15H and <40H )
4926,12,4,8,2017,1007,0.32,32,Medium-Low Digitalization,Small Course ( <15H )
4927,37,16,21,2017,1007,0.42,42,Medium-Low Digitalization,Medium Course ( >15H and <40H )
4928,28,18,10,2017,1007,0.64,64,Medium-High Digitalization,Medium Course ( >15H and <40H )
4929,35,33,2,2017,1007,0.93,93,High Digitalization,Medium Course ( >15H and <40H )
4930,32,29,3,2017,1007,0.91,91,High Digitalization,Medium Course ( >15H and <40H )
4931,11,10,1,2017,1007,0.89,89,High Digitalization,Small Course ( <15H )
4932,69,23,46,2017,1007,0.34,34,Medium-Low Digitalization,High Course ( >40H )
4933,9,2,7,2017,1007,0.17,17,Low Digitalization,Small Course ( <15H )
4934,24,11,13,2017,1007,0.47,47,Medium-Low Digitalization,Medium Course ( >15H and <40H )
4935,26,4,22,2017,1007,0.16,16,Low Digitalization,Medium Course ( >15H and <40H )
4936,20,9,11,2017,1007,0.43,43,Medium-Low Digitalization,Medium Course ( >15H and <40H )
4937,61,26,35,2017,1007,0.43,43,Medium-Low Digitalization,High Course ( >40H )
4938,36,3,33,2017,1007,0.08,8,Low Digitalization,Medium Course ( >15H and <40H )
4939,8,1,7,2017,1007,0.1,10,Low Digitalization,Small Course ( <15H )
4940,7,1,6,2017,1007,0.17,17,Low Digitalization,Small Course ( <15H )
4941,17,6,11,2017,1007,0.34,34,Medium-Low Digitalization,Medium Course ( >15H and <40H )
4942,87,37,50,2017,1007,0.42,42,Medium-Low Digitalization,High Course ( >40H )
4943,59,21,38,2017,1007,0.36,36,Medium-Low Digitalization,High Course ( >40H )
4944,34,19,15,2017,1007,0.56,56,Medium-High Digitalization,Medium Course ( >15H and <40H )
4945,40,6,34,2017,1007,0.16,16,Low Digitalization,High Course ( >40H )
4946,10,8,2,2017,1007,0.8,80,Medium-High Digitalization,Small Course ( <15H )
4947,56,20,36,2017,1007,0.35,35,Medium-Low Digitalization,High Course ( >40H )
4948,41,38,3,2017,1007,0.92,92,High Digitalization,High Course ( >40H )
4949,52,2,50,2017,1007,0.03,3,Low Digitalization,High Course ( >40H )
4950,31,11,20,2017,1007,0.35,35,Medium-Low Digitalization,Medium Course ( >15H and <40H )
4951,43,17,26,2017,1007,0.39,39,Medium-Low Digitalization,High Course ( >40H )
4952,54,21,33,2017,1007,0.38,38,Medium-Low Digitalization,High Course ( >40H )
4953,18,7,11,2017,1007,0.37,37,Medium-Low Digitalization,Medium Course ( >15H and <40H )
4954,38,10,28,2017,1007,0.26,26,Medium-Low Digitalization,Medium Course ( >15H and <40H )
4955,36,5,31,2017,1007,0.14,14,Low Digitalization,Medium Course ( >15H and <40H )
4956,51,27,24,2017,1007,0.53,53,Medium-High Digitalization,High Course ( >40H )
4957,17,11,6,2017,1007,0.67,67,Medium-High Digitalization,Medium Course ( >15H and <40H )
4958,27,13,14,2017,1007,0.47,47,Medium-Low Digitalization,Medium Course ( >15H and <40H )
4959,11,7,4,2017,1007,0.6,60,Medium-High Digitalization,Small Course ( <15H )
4960,87,68,19,2017,1007,0.78,78,Medium-High Digitalization,High Course ( >40H )
4961,9,1,8,2017,1007,0.06,6,Low Digitalization,Small Course ( <15H )
4962,10,3,7,2017,1007,0.28,28,Medium-Low Digitalization,Small Course ( <15H )
4963,22,5,17,2017,1007,0.24,24,Medium-Low Digitalization,Medium Course ( >15H and <40H )
4964,31,19,12,2017,1007,0.6,60,Medium-High Digitalization,Medium Course ( >15H and <40H )
4965,52,7,45,2017,1007,0.13,13,Low Digitalization,High Course ( >40H )
4966,6,4,2,2017,1007,0.67,67,Medium-High Digitalization,Small Course ( <15H )
4967,56,28,28,2017,1007,0.5,50,Medium-Low Digitalization,High Course ( >40H )
4968,20,18,2,2017,1007,0.9,90,High Digitalization,Medium Course ( >15H and <40H )
4969,7,4,3,2017,1007,0.64,64,Medium-High Digitalization,Small Course ( <15H )
4970,55,41,14,2017,1007,0.74,74,Medium-High Digitalization,High Course ( >40H )
4971,6,4,2,2017,1007,0.59,59,Medium-High Digitalization,Small Course ( <15H )
4972,50,2,48,2017,1007,0.03,3,Low Digitalization,High Course ( >40H )
4973,25,11,14,2017,1007,0.44,44,Medium-Low Digitalization,Medium Course ( >15H and <40H )
4974,16,7,9,2017,1007,0.44,44,Medium-Low Digitalization,Medium Course ( >15H and <40H )
4975,74,30,44,2017,1007,0.41,41,Medium-Low Digitalization,High Course ( >40H )
4976,5,3,2,2017,1007,0.61,61,Medium-High Digitalization,Small Course ( <15H )
4977,20,0,20,2017,1007,0.0,0,Low Digitalization,Medium Course ( >15H and <40H )
4978,6,1,5,2017,1007,0.18,18,Low Digitalization,Small Course ( <15H )
4979,29,10,19,2017,1007,0.34,34,Medium-Low Digitalization,Medium Course ( >15H and <40H )
4980,61,43,18,2017,1007,0.71,71,Medium-High Digitalization,High Course ( >40H )
4981,24,1,23,2017,1007,0.04,4,Low Digitalization,Medium Course ( >15H and <40H )
4982,47,35,12,2017,1007,0.74,74,Medium-High Digitalization,High Course ( >40H )
4983,50,36,14,2017,1007,0.71,71,Medium-High Digitalization,High Course ( >40H )
4984,8,0,8,2017,1007,0.05,5,Low Digitalization,Small Course ( <15H )
4985,8,3,5,2017,1007,0.37,37,Medium-Low Digitalization,Small Course ( <15H )
4986,14,10,4,2017,1007,0.72,72,Medium-High Digitalization,Small Course ( <15H )
4987,22,1,21,2017,1007,0.03,3,Low Digitalization,Medium Course ( >15H and <40H )
4988,34,22,12,2017,1007,0.65,65,Medium-High Digitalization,Medium Course ( >15H and <40H )
4989,20,11,9,2017,1007,0.57,56,Medium-High Digitalization,Medium Course ( >15H and <40H )
4990,67,14,53,2017,1007,0.21,21,Medium-Low Digitalization,High Course ( >40H )
4991,67,13,54,2017,1007,0.19,19,Low Digitalization,High Course ( >40H )
4992,32,15,17,2017,1007,0.46,46,Medium-Low Digitalization,Medium Course ( >15H and <40H )
4993,56,36,20,2017,1007,0.65,65,Medium-High Digitalization,High Course ( >40H )
4994,26,13,13,2017,1007,0.51,51,Medium-High Digitalization,Medium Course ( >15H and <40H )
4995,61,59,2,2017,1007,0.96,96,High Digitalization,High Course ( >40H )
4996,23,19,4,2017,1007,0.82,82,High Digitalization,Medium Course ( >15H and <40H )
4997,80,22,58,2017,1007,0.27,27,Medium-Low Digitalization,High Course ( >40H )
4998,11,2,9,2017,1007,0.16,16,Low Digitalization,Small Course ( <15H )
4999,11,7,4,2017,1007,0.66,66,Medium-High Digitalization,Small Course ( <15H )
5000,27,9,18,2017,1007,0.33,33,Medium-Low Digitalization,Medium Course ( >15H and <40H )
5001,39,3,36,2017,1007,0.07,7,Low Digitalization,Medium Course ( >15H and <40H )
5002,45,0,45,2017,1007,0.0,0,Low Digitalization,High Course ( >40H )
5003,81,49,32,2017,1007,0.61,61,Medium-High Digitalization,High Course ( >40H )
5004,77,67,10,2017,1007,0.87,87,High Digitalization,High Course ( >40H )
5005,88,36,52,2017,1007,0.41,41,Medium-Low Digitalization,High Course ( >40H )
5006,33,24,9,2017,1007,0.74,74,Medium-High Digitalization,Medium Course ( >15H and <40H )
5007,89,41,48,2017,1007,0.46,46,Medium-Low Digitalization,High Course ( >40H )
5008,26,19,7,2017,1007,0.73,73,Medium-High Digitalization,Medium Course ( >15H and <40H )
5009,17,7,10,2017,1007,0.4,40,Medium-Low Digitalization,Medium Course ( >15H and <40H )
5010,40,21,19,2017,1007,0.53,53,Medium-High Digitalization,High Course ( >40H )
5011,88,11,77,2017,1007,0.13,13,Low Digitalization,High Course ( >40H )
5012,59,58,1,2017,1007,0.98,98,High Digitalization,High Course ( >40H )
5013,46,26,20,2017,1007,0.57,56,Medium-High Digitalization,High Course ( >40H )
5014,69,59,10,2017,1007,0.85,85,High Digitalization,High Course ( >40H )
5015,7,2,5,2017,1007,0.31,31,Medium-Low Digitalization,Small Course ( <15H )
5016,7,4,3,2017,1007,0.6,60,Medium-High Digitalization,Small Course ( <15H )
5017,22,22,0,2017,1007,1.0,100,High Digitalization,Medium Course ( >15H and <40H )
5018,85,68,17,2017,1007,0.8,80,Medium-High Digitalization,High Course ( >40H )
5019,68,54,14,2017,1007,0.8,80,Medium-High Digitalization,High Course ( >40H )
5020,10,4,6,2017,1007,0.45,45,Medium-Low Digitalization,Small Course ( <15H )
5021,58,10,48,2017,1007,0.18,18,Low Digitalization,High Course ( >40H )
5022,15,6,9,2017,1007,0.39,39,Medium-Low Digitalization,Small Course ( <15H )
5023,26,7,19,2017,1007,0.28,28,Medium-Low Digitalization,Medium Course ( >15H and <40H )
5024,74,2,72,2017,1007,0.03,3,Low Digitalization,High Course ( >40H )
5025,47,38,9,2017,1007,0.81,81,High Digitalization,High Course ( >40H )
5026,71,59,12,2017,1007,0.83,83,High Digitalization,High Course ( >40H )
5027,84,53,31,2017,1007,0.63,63,Medium-High Digitalization,High Course ( >40H )
5028,53,45,8,2017,1007,0.84,84,High Digitalization,High Course ( >40H )
5029,60,53,7,2017,1007,0.89,89,High Digitalization,High Course ( >40H )
5030,60,37,23,2017,1007,0.62,62,Medium-High Digitalization,High Course ( >40H )
5031,14,6,8,2017,1007,0.4,40,Medium-Low Digitalization,Small Course ( <15H )
5032,49,21,28,2017,1007,0.43,43,Medium-Low Digitalization,High Course ( >40H )
5033,61,13,48,2017,1007,0.21,21,Medium-Low Digitalization,High Course ( >40H )
5034,48,1,47,2017,1007,0.02,2,Low Digitalization,High Course ( >40H )
5035,15,14,2,2017,1007,0.9,90,High Digitalization,Small Course ( <15H )
5036,11,5,6,2017,1007,0.43,43,Medium-Low Digitalization,Small Course ( <15H )
5037,39,36,3,2017,1007,0.93,93,High Digitalization,Medium Course ( >15H and <40H )
5038,52,29,23,2017,1007,0.55,55,Medium-High Digitalization,High Course ( >40H )
5039,34,6,28,2017,1007,0.18,18,Low Digitalization,Medium Course ( >15H and <40H )
5040,31,1,30,2017,1007,0.04,4,Low Digitalization,Medium Course ( >15H and <40H )
5041,41,1,40,2017,1007,0.03,3,Low Digitalization,High Course ( >40H )
5042,37,27,10,2017,1007,0.73,73,Medium-High Digitalization,Medium Course ( >15H and <40H )
5043,63,38,25,2017,1007,0.61,61,Medium-High Digitalization,High Course ( >40H )
5044,46,12,34,2017,1007,0.26,26,Medium-Low Digitalization,High Course ( >40H )
5045,12,9,3,2017,1007,0.76,76,Medium-High Digitalization,Small Course ( <15H )
5046,9,5,4,2017,1007,0.55,55,Medium-High Digitalization,Small Course ( <15H )
5047,60,43,17,2017,1007,0.71,71,Medium-High Digitalization,High Course ( >40H )
5048,38,25,13,2017,1007,0.65,65,Medium-High Digitalization,Medium Course ( >15H and <40H )
5049,32,17,15,2017,1007,0.53,53,Medium-High Digitalization,Medium Course ( >15H and <40H )
5050,60,26,34,2017,1007,0.43,43,Medium-Low Digitalization,High Course ( >40H )
5051,19,7,12,2017,1007,0.36,36,Medium-Low Digitalization,Medium Course ( >15H and <40H )
5052,9,1,8,2017,1007,0.16,16,Low Digitalization,Small Course ( <15H )
5053,13,2,11,2017,1007,0.13,13,Low Digitalization,Small Course ( <15H )
5054,13,13,0,2017,1007,1.0,100,High Digitalization,Small Course ( <15H )
5055,35,10,25,2017,1007,0.29,28,Medium-Low Digitalization,Medium Course ( >15H and <40H )
5056,88,25,63,2017,1007,0.28,28,Medium-Low Digitalization,High Course ( >40H )
5057,40,12,28,2017,1007,0.3,30,Medium-Low Digitalization,High Course ( >40H )
5058,65,31,34,2017,1007,0.47,47,Medium-Low Digitalization,High Course ( >40H )
5059,21,19,2,2017,1007,0.89,89,High Digitalization,Medium Course ( >15H and <40H )
5060,10,4,6,2017,1007,0.35,35,Medium-Low Digitalization,Small Course ( <15H )
5061,15,3,12,2017,1007,0.2,20,Low Digitalization,Small Course ( <15H )
5062,41,18,23,2017,1007,0.43,43,Medium-Low Digitalization,High Course ( >40H )
5063,53,45,8,2017,1007,0.84,84,High Digitalization,High Course ( >40H )
5064,5,1,4,2017,1007,0.18,18,Low Digitalization,Small Course ( <15H )
5065,22,7,15,2017,1007,0.33,33,Medium-Low Digitalization,Medium Course ( >15H and <40H )
5066,21,20,1,2017,1007,0.93,93,High Digitalization,Medium Course ( >15H and <40H )
5067,14,13,1,2017,1007,0.93,93,High Digitalization,Small Course ( <15H )
5068,60,16,44,2017,1007,0.26,26,Medium-Low Digitalization,High Course ( >40H )
5069,14,6,8,2017,1007,0.4,40,Medium-Low Digitalization,Small Course ( <15H )
5070,54,22,32,2017,1007,0.4,40,Medium-Low Digitalization,High Course ( >40H )
5071,59,44,15,2017,1007,0.75,75,Medium-High Digitalization,High Course ( >40H )
5072,60,46,14,2017,1007,0.76,76,Medium-High Digitalization,High Course ( >40H )
5073,62,43,19,2017,1007,0.69,69,Medium-High Digitalization,High Course ( >40H )
5074,8,7,1,2017,1007,0.93,93,High Digitalization,Small Course ( <15H )
5075,42,24,18,2017,1007,0.57,56,Medium-High Digitalization,High Course ( >40H )
5076,51,22,29,2017,1007,0.43,43,Medium-Low Digitalization,High Course ( >40H )
5077,25,15,10,2017,1007,0.59,59,Medium-High Digitalization,Medium Course ( >15H and <40H )
5078,27,7,20,2017,1007,0.26,26,Medium-Low Digitalization,Medium Course ( >15H and <40H )
5079,15,2,13,2017,1007,0.14,14,Low Digitalization,Small Course ( <15H )
5080,15,14,1,2017,1007,0.96,96,High Digitalization,Small Course ( <15H )
5081,72,43,29,2017,1007,0.6,60,Medium-High Digitalization,High Course ( >40H )
5082,34,14,20,2017,1007,0.42,42,Medium-Low Digitalization,Medium Course ( >15H and <40H )
5083,6,3,3,2017,1007,0.55,55,Medium-High Digitalization,Small Course ( <15H )
5084,12,5,7,2017,1007,0.39,39,Medium-Low Digitalization,Small Course ( <15H )
5085,10,9,1,2017,1007,0.87,87,High Digitalization,Small Course ( <15H )
5086,39,26,13,2017,1007,0.67,67,Medium-High Digitalization,Medium Course ( >15H and <40H )
5087,41,32,9,2017,1007,0.78,78,Medium-High Digitalization,High Course ( >40H )
5088,7,2,5,2017,1007,0.28,28,Medium-Low Digitalization,Small Course ( <15H )
5089,36,27,9,2017,1007,0.76,76,Medium-High Digitalization,Medium Course ( >15H and <40H )
5090,60,11,49,2017,1007,0.19,19,Low Digitalization,High Course ( >40H )
5091,18,17,1,2017,1007,0.92,92,High Digitalization,Medium Course ( >15H and <40H )
5092,51,4,47,2017,1007,0.08,8,Low Digitalization,High Course ( >40H )
5093,14,5,9,2017,1007,0.33,33,Medium-Low Digitalization,Small Course ( <15H )
5094,60,26,34,2017,1007,0.44,44,Medium-Low Digitalization,High Course ( >40H )
5095,56,15,41,2017,1007,0.27,27,Medium-Low Digitalization,High Course ( >40H )
5096,15,4,11,2017,1007,0.24,24,Medium-Low Digitalization,Small Course ( <15H )
5097,81,32,49,2017,1007,0.39,39,Medium-Low Digitalization,High Course ( >40H )
5098,43,28,15,2017,1007,0.64,64,Medium-High Digitalization,High Course ( >40H )
5099,7,3,4,2017,1007,0.37,37,Medium-Low Digitalization,Small Course ( <15H )
5100,21,7,14,2017,1007,0.35,35,Medium-Low Digitalization,Medium Course ( >15H and <40H )
5101,78,15,63,2017,1007,0.19,19,Low Digitalization,High Course ( >40H )
5102,72,2,70,2017,1007,0.03,3,Low Digitalization,High Course ( >40H )
5103,13,6,7,2017,1007,0.46,46,Medium-Low Digitalization,Small Course ( <15H )
5104,57,20,37,2017,1007,0.35,35,Medium-Low Digitalization,High Course ( >40H )
5105,43,15,28,2017,1007,0.34,34,Medium-Low Digitalization,High Course ( >40H )
5106,62,32,30,2017,1007,0.52,52,Medium-High Digitalization,High Course ( >40H )
5107,78,74,4,2017,1007,0.95,95,High Digitalization,High Course ( >40H )
5108,11,3,8,2017,1007,0.28,28,Medium-Low Digitalization,Small Course ( <15H )
5109,7,7,0,2017,1007,0.95,95,High Digitalization,Small Course ( <15H )
5110,11,9,2,2017,1007,0.78,78,Medium-High Digitalization,Small Course ( <15H )
5111,77,58,19,2017,1007,0.75,75,Medium-High Digitalization,High Course ( >40H )
5112,29,27,2,2017,1007,0.93,93,High Digitalization,Medium Course ( >15H and <40H )
5113,62,27,35,2017,1007,0.43,43,Medium-Low Digitalization,High Course ( >40H )
5114,56,8,48,2017,1007,0.14,14,Low Digitalization,High Course ( >40H )
5115,23,18,5,2017,1007,0.79,79,Medium-High Digitalization,Medium Course ( >15H and <40H )
5116,6,3,3,2017,1007,0.45,45,Medium-Low Digitalization,Small Course ( <15H )
5117,60,1,59,2017,1007,0.01,1,Low Digitalization,High Course ( >40H )
5118,26,14,12,2017,1007,0.54,54,Medium-High Digitalization,Medium Course ( >15H and <40H )
5119,19,2,17,2017,1007,0.13,13,Low Digitalization,Medium Course ( >15H and <40H )
5120,53,48,5,2017,1007,0.91,91,High Digitalization,High Course ( >40H )
5121,20,7,13,2017,1007,0.33,33,Medium-Low Digitalization,Medium Course ( >15H and <40H )
5122,70,34,36,2017,1007,0.48,48,Medium-Low Digitalization,High Course ( >40H )
5123,65,57,8,2017,1007,0.87,87,High Digitalization,High Course ( >40H )
5124,6,0,6,2017,1007,0.01,1,Low Digitalization,Small Course ( <15H )
5125,35,6,29,2017,1007,0.18,18,Low Digitalization,Medium Course ( >15H and <40H )
5126,74,9,65,2017,1007,0.12,12,Low Digitalization,High Course ( >40H )
5127,40,15,25,2017,1007,0.37,37,Medium-Low Digitalization,High Course ( >40H )
5128,22,14,8,2017,1007,0.62,62,Medium-High Digitalization,Medium Course ( >15H and <40H )
5129,12,5,7,2017,1007,0.41,41,Medium-Low Digitalization,Small Course ( <15H )
5130,40,18,22,2017,1007,0.46,46,Medium-Low Digitalization,High Course ( >40H )
5131,15,2,14,2017,1007,0.1,10,Low Digitalization,Small Course ( <15H )
5132,18,13,5,2017,1007,0.7,70,Medium-High Digitalization,Medium Course ( >15H and <40H )
5133,9,9,0,2017,1007,0.95,95,High Digitalization,Small Course ( <15H )
5134,24,16,8,2017,1007,0.66,66,Medium-High Digitalization,Medium Course ( >15H and <40H )
5135,9,4,5,2017,1007,0.47,47,Medium-Low Digitalization,Small Course ( <15H )
5136,6,4,2,2017,1007,0.63,63,Medium-High Digitalization,Small Course ( <15H )
5137,34,29,5,2017,1007,0.86,86,High Digitalization,Medium Course ( >15H and <40H )
5138,11,2,9,2017,1007,0.16,16,Low Digitalization,Small Course ( <15H )
5139,32,24,8,2017,1007,0.76,76,Medium-High Digitalization,Medium Course ( >15H and <40H )
5140,73,58,15,2017,1007,0.8,80,Medium-High Digitalization,High Course ( >40H )
5141,11,8,3,2017,1007,0.74,74,Medium-High Digitalization,Small Course ( <15H )
5142,26,6,20,2017,1007,0.25,25,Medium-Low Digitalization,Medium Course ( >15H and <40H )
5143,77,51,26,2017,1007,0.66,66,Medium-High Digitalization,High Course ( >40H )
5144,34,17,17,2017,1007,0.5,50,Medium-Low Digitalization,Medium Course ( >15H and <40H )
5145,11,10,1,2017,1007,0.94,94,High Digitalization,Small Course ( <15H )
5146,9,6,3,2017,1007,0.68,68,Medium-High Digitalization,Small Course ( <15H )
5147,41,40,1,2017,1007,0.98,98,High Digitalization,High Course ( >40H )
5148,26,20,6,2017,1007,0.77,77,Medium-High Digitalization,Medium Course ( >15H and <40H )
5149,15,6,9,2017,1007,0.43,43,Medium-Low Digitalization,Small Course ( <15H )
5150,22,17,5,2017,1007,0.78,78,Medium-High Digitalization,Medium Course ( >15H and <40H )
5151,30,14,16,2017,1007,0.47,47,Medium-Low Digitalization,Medium Course ( >15H and <40H )
5152,12,11,1,2017,1007,0.93,93,High Digitalization,Small Course ( <15H )
5153,38,17,21,2017,1007,0.46,46,Medium-Low Digitalization,Medium Course ( >15H and <40H )
5154,8,4,4,2017,1007,0.47,47,Medium-Low Digitalization,Small Course ( <15H )
5155,29,17,12,2017,1007,0.58,57,Medium-High Digitalization,Medium Course ( >15H and <40H )
5156,82,75,7,2017,1007,0.91,91,High Digitalization,High Course ( >40H )
5157,60,47,13,2017,1007,0.78,78,Medium-High Digitalization,High Course ( >40H )
5158,12,8,4,2017,1007,0.69,69,Medium-High Digitalization,Small Course ( <15H )
5159,22,6,16,2017,1007,0.26,26,Medium-Low Digitalization,Medium Course ( >15H and <40H )
5160,14,7,7,2017,1007,0.48,48,Medium-Low Digitalization,Small Course ( <15H )
5161,9,0,9,2017,1007,0.03,3,Low Digitalization,Small Course ( <15H )
5162,6,2,4,2017,1007,0.35,35,Medium-Low Digitalization,Small Course ( <15H )
5163,36,9,27,2017,1007,0.24,24,Medium-Low Digitalization,Medium Course ( >15H and <40H )
5164,56,48,8,2017,1007,0.86,86,High Digitalization,High Course ( >40H )
5165,6,2,4,2017,1007,0.36,36,Medium-Low Digitalization,Small Course ( <15H )
5166,22,9,13,2017,1007,0.41,41,Medium-Low Digitalization,Medium Course ( >15H and <40H )
5167,57,52,5,2017,1007,0.91,91,High Digitalization,High Course ( >40H )
5168,42,38,4,2017,1007,0.9,90,High Digitalization,High Course ( >40H )
5169,48,22,26,2017,1007,0.45,45,Medium-Low Digitalization,High Course ( >40H )
5170,45,17,28,2017,1007,0.37,37,Medium-Low Digitalization,High Course ( >40H )
5171,10,6,4,2017,1007,0.63,63,Medium-High Digitalization,Small Course ( <15H )
5172,82,36,46,2017,1007,0.44,44,Medium-Low Digitalization,High Course ( >40H )
5173,7,2,5,2017,1007,0.24,24,Medium-Low Digitalization,Small Course ( <15H )
5174,18,0,18,2017,1007,0.01,1,Low Digitalization,Medium Course ( >15H and <40H )
5175,13,3,10,2017,1007,0.2,20,Low Digitalization,Small Course ( <15H )
5176,19,1,18,2017,1007,0.03,3,Low Digitalization,Medium Course ( >15H and <40H )
5177,9,3,6,2017,1007,0.31,31,Medium-Low Digitalization,Small Course ( <15H )
5178,7,1,6,2017,1007,0.21,21,Medium-Low Digitalization,Small Course ( <15H )
5179,11,5,6,2017,1007,0.47,47,Medium-Low Digitalization,Small Course ( <15H )
5180,28,18,10,2017,1007,0.63,63,Medium-High Digitalization,Medium Course ( >15H and <40H )
5181,81,9,72,2017,1007,0.11,11,Low Digitalization,High Course ( >40H )
5182,82,78,4,2017,1007,0.95,95,High Digitalization,High Course ( >40H )
5183,9,8,1,2017,1007,0.93,93,High Digitalization,Small Course ( <15H )
5184,8,8,0,2017,1007,0.97,97,High Digitalization,Small Course ( <15H )
5185,51,2,49,2017,1007,0.03,3,Low Digitalization,High Course ( >40H )
5186,38,2,36,2017,1007,0.04,4,Low Digitalization,Medium Course ( >15H and <40H )
5187,49,28,21,2017,1007,0.58,57,Medium-High Digitalization,High Course ( >40H )
5188,75,74,1,2017,1007,0.99,99,High Digitalization,High Course ( >40H )
5189,88,77,11,2017,1007,0.87,87,High Digitalization,High Course ( >40H )
5190,6,2,4,2017,1007,0.26,26,Medium-Low Digitalization,Small Course ( <15H )
5191,12,0,12,2017,1007,0.04,4,Low Digitalization,Small Course ( <15H )
5192,87,29,58,2017,1007,0.33,33,Medium-Low Digitalization,High Course ( >40H )
5193,14,12,2,2017,1007,0.88,88,High Digitalization,Small Course ( <15H )
5194,9,7,2,2017,1007,0.76,76,Medium-High Digitalization,Small Course ( <15H )
5195,10,5,5,2017,1007,0.5,50,Medium-Low Digitalization,Small Course ( <15H )
5196,18,11,7,2017,1007,0.6,60,Medium-High Digitalization,Medium Course ( >15H and <40H )
5197,42,22,20,2017,1007,0.53,53,Medium-High Digitalization,High Course ( >40H )
5198,26,1,25,2017,1007,0.02,2,Low Digitalization,Medium Course ( >15H and <40H )
5199,49,35,14,2017,1007,0.72,72,Medium-High Digitalization,High Course ( >40H )
5200,14,4,10,2017,1007,0.27,27,Medium-Low Digitalization,Small Course ( <15H )
5201,10,8,2,2017,1007,0.83,83,High Digitalization,Small Course ( <15H )
5202,6,0,6,2017,1007,0.01,1,Low Digitalization,Small Course ( <15H )
5203,34,15,19,2017,1007,0.45,45,Medium-Low Digitalization,Medium Course ( >15H and <40H )
5204,69,50,19,2018,1043,0.72,72,Medium-High Digitalization,High Course ( >40H )
5205,39,11,28,2018,1043,0.28,28,Medium-Low Digitalization,Medium Course ( >15H and <40H )
5206,52,2,50,2018,1043,0.03,3,Low Digitalization,High Course ( >40H )
5207,27,10,17,2018,1043,0.36,36,Medium-Low Digitalization,Medium Course ( >15H and <40H )
5208,54,49,5,2018,1043,0.9,90,High Digitalization,High Course ( >40H )
5209,42,36,6,2018,1043,0.86,86,High Digitalization,High Course ( >40H )
5210,86,28,58,2018,1043,0.32,32,Medium-Low Digitalization,High Course ( >40H )
5211,81,19,62,2018,1043,0.24,24,Medium-Low Digitalization,High Course ( >40H )
5212,49,41,8,2018,1043,0.84,84,High Digitalization,High Course ( >40H )
5213,7,4,3,2018,1043,0.55,55,Medium-High Digitalization,Small Course ( <15H )
5214,70,60,10,2018,1043,0.86,86,High Digitalization,High Course ( >40H )
5215,34,24,10,2018,1043,0.71,71,Medium-High Digitalization,Medium Course ( >15H and <40H )
5216,7,4,3,2018,1043,0.52,52,Medium-High Digitalization,Small Course ( <15H )
5217,8,7,1,2018,1043,0.86,86,High Digitalization,Small Course ( <15H )
5218,88,19,69,2018,1043,0.22,22,Medium-Low Digitalization,High Course ( >40H )
5219,60,17,43,2018,1043,0.28,28,Medium-Low Digitalization,High Course ( >40H )
5220,58,40,18,2018,1043,0.69,69,Medium-High Digitalization,High Course ( >40H )
5221,58,43,15,2018,1043,0.74,74,Medium-High Digitalization,High Course ( >40H )
5222,87,36,51,2018,1043,0.41,41,Medium-Low Digitalization,High Course ( >40H )
5223,15,13,2,2018,1043,0.88,88,High Digitalization,Small Course ( <15H )
5224,73,50,23,2018,1043,0.68,68,Medium-High Digitalization,High Course ( >40H )
5225,42,21,21,2018,1043,0.5,50,Medium-Low Digitalization,High Course ( >40H )
5226,39,2,37,2018,1043,0.05,5,Low Digitalization,Medium Course ( >15H and <40H )
5227,76,59,17,2018,1043,0.78,78,Medium-High Digitalization,High Course ( >40H )
5228,45,31,14,2018,1043,0.69,69,Medium-High Digitalization,High Course ( >40H )
5229,15,10,5,2018,1043,0.65,65,Medium-High Digitalization,Small Course ( <15H )
5230,16,5,11,2018,1043,0.3,30,Medium-Low Digitalization,Medium Course ( >15H and <40H )
5231,13,6,7,2018,1043,0.47,47,Medium-Low Digitalization,Small Course ( <15H )
5232,58,21,37,2018,1043,0.37,37,Medium-Low Digitalization,High Course ( >40H )
5233,25,22,2,2018,1043,0.9,90,High Digitalization,Medium Course ( >15H and <40H )
5234,7,4,3,2018,1043,0.53,53,Medium-High Digitalization,Small Course ( <15H )
5235,7,6,1,2018,1043,0.89,89,High Digitalization,Small Course ( <15H )
5236,30,18,12,2018,1043,0.61,61,Medium-High Digitalization,Medium Course ( >15H and <40H )
5237,55,30,25,2018,1043,0.54,54,Medium-High Digitalization,High Course ( >40H )
5238,70,18,52,2018,1043,0.25,25,Medium-Low Digitalization,High Course ( >40H )
5239,60,14,46,2018,1043,0.23,23,Medium-Low Digitalization,High Course ( >40H )
5240,38,21,17,2018,1043,0.56,56,Medium-High Digitalization,Medium Course ( >15H and <40H )
5241,68,1,67,2018,1043,0.02,2,Low Digitalization,High Course ( >40H )
5242,14,9,5,2018,1043,0.63,63,Medium-High Digitalization,Small Course ( <15H )
5243,17,2,15,2018,1043,0.1,10,Low Digitalization,Medium Course ( >15H and <40H )
5244,79,11,68,2018,1043,0.14,14,Low Digitalization,High Course ( >40H )
5245,49,29,20,2018,1043,0.6,60,Medium-High Digitalization,High Course ( >40H )
5246,78,3,75,2018,1043,0.04,4,Low Digitalization,High Course ( >40H )
5247,49,23,26,2018,1043,0.46,46,Medium-Low Digitalization,High Course ( >40H )
5248,60,25,35,2018,1043,0.41,41,Medium-Low Digitalization,High Course ( >40H )
5249,46,46,0,2018,1043,0.99,99,High Digitalization,High Course ( >40H )
5250,35,10,25,2018,1043,0.29,28,Medium-Low Digitalization,Medium Course ( >15H and <40H )
5251,7,6,1,2018,1043,0.82,82,High Digitalization,Small Course ( <15H )
5252,10,0,10,2018,1043,0.01,1,Low Digitalization,Small Course ( <15H )
5253,47,22,25,2018,1043,0.47,47,Medium-Low Digitalization,High Course ( >40H )
5254,11,6,5,2018,1043,0.58,57,Medium-High Digitalization,Small Course ( <15H )
5255,15,8,7,2018,1043,0.51,51,Medium-High Digitalization,Small Course ( <15H )
5256,10,2,8,2018,1043,0.23,23,Medium-Low Digitalization,Small Course ( <15H )
5257,33,16,17,2018,1043,0.49,49,Medium-Low Digitalization,Medium Course ( >15H and <40H )
5258,46,40,6,2018,1043,0.87,87,High Digitalization,High Course ( >40H )
5259,75,39,36,2018,1043,0.52,52,Medium-High Digitalization,High Course ( >40H )
5260,8,0,8,2018,1043,0.04,4,Low Digitalization,Small Course ( <15H )
5261,38,5,33,2018,1043,0.12,12,Low Digitalization,Medium Course ( >15H and <40H )
5262,12,0,12,2018,1043,0.04,4,Low Digitalization,Small Course ( <15H )
5263,10,8,2,2018,1043,0.79,79,Medium-High Digitalization,Small Course ( <15H )
5264,9,0,9,2018,1043,0.05,5,Low Digitalization,Small Course ( <15H )
5265,48,38,10,2018,1043,0.79,79,Medium-High Digitalization,High Course ( >40H )
5266,12,6,6,2018,1043,0.48,48,Medium-Low Digitalization,Small Course ( <15H )
5267,11,10,1,2018,1043,0.92,92,High Digitalization,Small Course ( <15H )
5268,9,8,1,2018,1043,0.92,92,High Digitalization,Small Course ( <15H )
5269,44,44,0,2018,1043,1.0,100,High Digitalization,High Course ( >40H )
5270,24,16,8,2018,1043,0.68,68,Medium-High Digitalization,Medium Course ( >15H and <40H )
5271,11,10,1,2018,1043,0.92,92,High Digitalization,Small Course ( <15H )
5272,90,38,52,2018,1043,0.42,42,Medium-Low Digitalization,High Course ( >40H )
5273,47,14,33,2018,1043,0.29,28,Medium-Low Digitalization,High Course ( >40H )
5274,39,17,22,2018,1043,0.44,44,Medium-Low Digitalization,Medium Course ( >15H and <40H )
5275,10,5,5,2018,1043,0.52,52,Medium-High Digitalization,Small Course ( <15H )
5276,41,41,0,2018,1043,0.99,99,High Digitalization,High Course ( >40H )
5277,32,22,10,2018,1043,0.68,68,Medium-High Digitalization,Medium Course ( >15H and <40H )
5278,11,3,8,2018,1043,0.23,23,Medium-Low Digitalization,Small Course ( <15H )
5279,90,18,72,2018,1043,0.2,20,Low Digitalization,High Course ( >40H )
5280,49,37,12,2018,1043,0.75,75,Medium-High Digitalization,High Course ( >40H )
5281,7,1,6,2018,1043,0.15,15,Low Digitalization,Small Course ( <15H )
5282,44,11,33,2018,1043,0.25,25,Medium-Low Digitalization,High Course ( >40H )
5283,33,33,0,2018,1043,0.99,99,High Digitalization,Medium Course ( >15H and <40H )
5284,18,14,4,2018,1043,0.77,77,Medium-High Digitalization,Medium Course ( >15H and <40H )
5285,10,3,7,2018,1043,0.3,30,Medium-Low Digitalization,Small Course ( <15H )
5286,60,37,23,2018,1043,0.61,61,Medium-High Digitalization,High Course ( >40H )
5287,15,13,2,2018,1043,0.88,88,High Digitalization,Small Course ( <15H )
5288,12,8,4,2018,1043,0.66,66,Medium-High Digitalization,Small Course ( <15H )
5289,47,4,43,2018,1043,0.09,9,Low Digitalization,High Course ( >40H )
5290,21,12,9,2018,1043,0.55,55,Medium-High Digitalization,Medium Course ( >15H and <40H )
5291,18,16,2,2018,1043,0.88,88,High Digitalization,Medium Course ( >15H and <40H )
5292,74,24,50,2018,1043,0.32,32,Medium-Low Digitalization,High Course ( >40H )
5293,22,8,14,2018,1043,0.36,36,Medium-Low Digitalization,Medium Course ( >15H and <40H )
5294,36,1,35,2018,1043,0.04,4,Low Digitalization,Medium Course ( >15H and <40H )
5295,90,73,17,2018,1043,0.81,81,High Digitalization,High Course ( >40H )
5296,75,56,20,2018,1043,0.74,74,Medium-High Digitalization,High Course ( >40H )
5297,36,31,5,2018,1043,0.87,87,High Digitalization,Medium Course ( >15H and <40H )
5298,6,2,4,2018,1043,0.4,40,Medium-Low Digitalization,Small Course ( <15H )
5299,37,25,12,2018,1043,0.68,68,Medium-High Digitalization,Medium Course ( >15H and <40H )
5300,82,52,30,2018,1043,0.64,64,Medium-High Digitalization,High Course ( >40H )
5301,47,40,7,2018,1043,0.85,85,High Digitalization,High Course ( >40H )
5302,90,46,44,2018,1043,0.51,51,Medium-High Digitalization,High Course ( >40H )
5303,47,31,16,2018,1043,0.67,67,Medium-High Digitalization,High Course ( >40H )
5304,53,11,42,2018,1043,0.21,21,Medium-Low Digitalization,High Course ( >40H )
5305,84,47,37,2018,1043,0.56,56,Medium-High Digitalization,High Course ( >40H )
5306,74,53,21,2018,1043,0.72,72,Medium-High Digitalization,High Course ( >40H )
5307,48,43,5,2018,1043,0.89,89,High Digitalization,High Course ( >40H )
5308,13,2,11,2018,1043,0.19,19,Low Digitalization,Small Course ( <15H )
5309,19,14,5,2018,1043,0.72,72,Medium-High Digitalization,Medium Course ( >15H and <40H )
5310,42,29,13,2018,1043,0.7,70,Medium-High Digitalization,High Course ( >40H )
5311,45,31,14,2018,1043,0.68,68,Medium-High Digitalization,High Course ( >40H )
5312,80,30,50,2018,1043,0.37,37,Medium-Low Digitalization,High Course ( >40H )
5313,15,12,3,2018,1043,0.8,80,Medium-High Digitalization,Small Course ( <15H )
5314,7,0,7,2018,1043,0.02,2,Low Digitalization,Small Course ( <15H )
5315,17,3,14,2018,1043,0.18,18,Low Digitalization,Medium Course ( >15H and <40H )
5316,83,2,81,2018,1043,0.02,2,Low Digitalization,High Course ( >40H )
5317,48,33,15,2018,1043,0.69,69,Medium-High Digitalization,High Course ( >40H )
5318,20,15,5,2018,1043,0.75,75,Medium-High Digitalization,Medium Course ( >15H and <40H )
5319,65,57,8,2018,1043,0.88,88,High Digitalization,High Course ( >40H )
5320,18,13,5,2018,1043,0.7,70,Medium-High Digitalization,Medium Course ( >15H and <40H )
5321,79,10,69,2018,1043,0.13,13,Low Digitalization,High Course ( >40H )
5322,49,11,38,2018,1043,0.23,23,Medium-Low Digitalization,High Course ( >40H )
5323,21,19,2,2018,1043,0.89,89,High Digitalization,Medium Course ( >15H and <40H )
5324,14,14,0,2018,1043,0.99,99,High Digitalization,Small Course ( <15H )
5325,15,12,3,2018,1043,0.79,79,Medium-High Digitalization,Small Course ( <15H )
5326,54,29,25,2018,1043,0.54,54,Medium-High Digitalization,High Course ( >40H )
5327,64,10,54,2018,1043,0.15,15,Low Digitalization,High Course ( >40H )
5328,9,5,4,2018,1043,0.57,56,Medium-High Digitalization,Small Course ( <15H )
5329,10,2,8,2018,1043,0.22,22,Medium-Low Digitalization,Small Course ( <15H )
5330,86,7,79,2018,1043,0.08,8,Low Digitalization,High Course ( >40H )
5331,15,13,2,2018,1043,0.88,88,High Digitalization,Small Course ( <15H )
5332,82,26,56,2018,1043,0.32,32,Medium-Low Digitalization,High Course ( >40H )
5333,78,36,42,2018,1043,0.46,46,Medium-Low Digitalization,High Course ( >40H )
5334,58,54,4,2018,1043,0.93,93,High Digitalization,High Course ( >40H )
5335,8,5,3,2018,1043,0.65,65,Medium-High Digitalization,Small Course ( <15H )
5336,65,62,3,2018,1043,0.96,96,High Digitalization,High Course ( >40H )
5337,82,31,51,2018,1043,0.38,38,Medium-Low Digitalization,High Course ( >40H )
5338,49,37,12,2018,1043,0.76,76,Medium-High Digitalization,High Course ( >40H )
5339,26,8,18,2018,1043,0.31,31,Medium-Low Digitalization,Medium Course ( >15H and <40H )
5340,14,14,0,2018,1043,0.99,99,High Digitalization,Small Course ( <15H )
5341,59,56,3,2018,1043,0.95,95,High Digitalization,High Course ( >40H )
5342,65,62,3,2018,1043,0.95,95,High Digitalization,High Course ( >40H )
5343,71,54,17,2018,1043,0.76,76,Medium-High Digitalization,High Course ( >40H )
5344,12,6,6,2018,1043,0.47,47,Medium-Low Digitalization,Small Course ( <15H )
5345,5,0,5,2018,1043,0.0,0,Low Digitalization,Small Course ( <15H )
5346,69,34,34,2018,1043,0.5,50,Medium-Low Digitalization,High Course ( >40H )
5347,14,6,8,2018,1043,0.46,46,Medium-Low Digitalization,Small Course ( <15H )
5348,62,52,10,2018,1043,0.84,84,High Digitalization,High Course ( >40H )
5349,6,0,6,2018,1043,0.07,7,Low Digitalization,Small Course ( <15H )
5350,18,0,18,2018,1043,0.02,2,Low Digitalization,Medium Course ( >15H and <40H )
5351,30,17,13,2018,1043,0.56,56,Medium-High Digitalization,Medium Course ( >15H and <40H )
5352,69,1,68,2018,1043,0.01,1,Low Digitalization,High Course ( >40H )
5353,80,19,61,2018,1043,0.24,24,Medium-Low Digitalization,High Course ( >40H )
5354,58,19,39,2018,1043,0.33,33,Medium-Low Digitalization,High Course ( >40H )
5355,34,9,25,2018,1043,0.27,27,Medium-Low Digitalization,Medium Course ( >15H and <40H )
5356,77,49,28,2018,1043,0.63,63,Medium-High Digitalization,High Course ( >40H )
5357,56,15,41,2018,1043,0.26,26,Medium-Low Digitalization,High Course ( >40H )
5358,20,14,6,2018,1043,0.69,69,Medium-High Digitalization,Medium Course ( >15H and <40H )
5359,5,1,4,2018,1043,0.26,26,Medium-Low Digitalization,Small Course ( <15H )
5360,9,7,2,2018,1043,0.73,73,Medium-High Digitalization,Small Course ( <15H )
5361,49,0,49,2018,1043,0.0,0,Low Digitalization,High Course ( >40H )
5362,10,6,4,2018,1043,0.64,64,Medium-High Digitalization,Small Course ( <15H )
5363,15,2,14,2018,1043,0.1,10,Low Digitalization,Small Course ( <15H )
5364,29,23,6,2018,1043,0.81,81,High Digitalization,Medium Course ( >15H and <40H )
5365,38,16,22,2018,1043,0.42,42,Medium-Low Digitalization,Medium Course ( >15H and <40H )
5366,18,6,12,2018,1043,0.33,33,Medium-Low Digitalization,Medium Course ( >15H and <40H )
5367,5,5,0,2018,1043,0.98,98,High Digitalization,Small Course ( <15H )
5368,32,14,18,2018,1043,0.45,45,Medium-Low Digitalization,Medium Course ( >15H and <40H )
5369,10,7,3,2018,1043,0.74,74,Medium-High Digitalization,Small Course ( <15H )
5370,21,3,18,2018,1043,0.12,12,Low Digitalization,Medium Course ( >15H and <40H )
5371,48,1,47,2018,1043,0.03,3,Low Digitalization,High Course ( >40H )
5372,33,29,4,2018,1043,0.87,87,High Digitalization,Medium Course ( >15H and <40H )
5373,41,20,21,2018,1043,0.49,49,Medium-Low Digitalization,High Course ( >40H )
5374,21,1,20,2018,1043,0.06,6,Low Digitalization,Medium Course ( >15H and <40H )
5375,11,5,6,2018,1043,0.45,45,Medium-Low Digitalization,Small Course ( <15H )
5376,58,26,32,2018,1043,0.45,45,Medium-Low Digitalization,High Course ( >40H )
5377,12,7,5,2018,1043,0.58,57,Medium-High Digitalization,Small Course ( <15H )
5378,90,15,75,2018,1043,0.17,17,Low Digitalization,High Course ( >40H )
5379,86,52,34,2018,1043,0.61,61,Medium-High Digitalization,High Course ( >40H )
5380,29,1,28,2018,1043,0.04,4,Low Digitalization,Medium Course ( >15H and <40H )
5381,53,26,26,2018,1043,0.5,50,Medium-Low Digitalization,High Course ( >40H )
5382,85,65,20,2018,1043,0.76,76,Medium-High Digitalization,High Course ( >40H )
5383,50,14,36,2018,1043,0.28,28,Medium-Low Digitalization,High Course ( >40H )
5384,13,10,3,2018,1043,0.75,75,Medium-High Digitalization,Small Course ( <15H )
5385,17,0,17,2018,1043,0.01,1,Low Digitalization,Medium Course ( >15H and <40H )
5386,70,62,8,2018,1043,0.89,89,High Digitalization,High Course ( >40H )
5387,15,13,2,2018,1043,0.86,86,High Digitalization,Small Course ( <15H )
5388,5,3,2,2018,1043,0.59,59,Medium-High Digitalization,Small Course ( <15H )
5389,13,1,12,2018,1043,0.11,11,Low Digitalization,Small Course ( <15H )
5390,8,7,1,2018,1043,0.85,85,High Digitalization,Small Course ( <15H )
5391,21,11,10,2018,1043,0.52,52,Medium-High Digitalization,Medium Course ( >15H and <40H )
5392,8,2,6,2018,1043,0.22,22,Medium-Low Digitalization,Small Course ( <15H )
5393,13,11,2,2018,1043,0.87,87,High Digitalization,Small Course ( <15H )
5394,45,14,32,2018,1043,0.3,30,Medium-Low Digitalization,High Course ( >40H )
5395,25,14,11,2018,1043,0.56,56,Medium-High Digitalization,Medium Course ( >15H and <40H )
5396,8,6,2,2018,1043,0.7,70,Medium-High Digitalization,Small Course ( <15H )
5397,65,51,14,2018,1043,0.79,79,Medium-High Digitalization,High Course ( >40H )
5398,14,9,5,2018,1043,0.66,66,Medium-High Digitalization,Small Course ( <15H )
5399,7,1,6,2018,1043,0.17,17,Low Digitalization,Small Course ( <15H )
5400,15,4,11,2018,1043,0.27,27,Medium-Low Digitalization,Small Course ( <15H )
5401,45,3,42,2018,1043,0.07,7,Low Digitalization,High Course ( >40H )
5402,60,7,53,2018,1043,0.12,12,Low Digitalization,High Course ( >40H )
5403,33,16,16,2018,1043,0.5,50,Medium-Low Digitalization,Medium Course ( >15H and <40H )
5404,64,28,36,2018,1043,0.43,43,Medium-Low Digitalization,High Course ( >40H )
5405,11,11,0,2018,1043,0.97,97,High Digitalization,Small Course ( <15H )
5406,41,11,30,2018,1043,0.26,26,Medium-Low Digitalization,High Course ( >40H )
5407,16,8,8,2018,1043,0.49,49,Medium-Low Digitalization,Medium Course ( >15H and <40H )
5408,23,4,19,2018,1043,0.19,19,Low Digitalization,Medium Course ( >15H and <40H )
5409,21,4,17,2018,1043,0.21,21,Medium-Low Digitalization,Medium Course ( >15H and <40H )
5410,19,13,6,2018,1043,0.68,68,Medium-High Digitalization,Medium Course ( >15H and <40H )
5411,9,0,9,2018,1043,0.04,4,Low Digitalization,Small Course ( <15H )
5412,11,5,6,2018,1043,0.41,41,Medium-Low Digitalization,Small Course ( <15H )
5413,31,13,18,2018,1043,0.41,41,Medium-Low Digitalization,Medium Course ( >15H and <40H )
5414,55,17,38,2018,1043,0.31,31,Medium-Low Digitalization,High Course ( >40H )
5415,28,20,8,2018,1043,0.7,70,Medium-High Digitalization,Medium Course ( >15H and <40H )
5416,14,9,5,2018,1043,0.61,61,Medium-High Digitalization,Small Course ( <15H )
5417,13,3,10,2018,1043,0.22,22,Medium-Low Digitalization,Small Course ( <15H )
5418,64,12,52,2018,1043,0.18,18,Low Digitalization,High Course ( >40H )
5419,87,51,36,2018,1043,0.59,59,Medium-High Digitalization,High Course ( >40H )
5420,41,30,11,2018,1043,0.73,73,Medium-High Digitalization,High Course ( >40H )
5421,8,6,2,2018,1043,0.81,81,High Digitalization,Small Course ( <15H )
5422,15,6,9,2018,1043,0.39,39,Medium-Low Digitalization,Small Course ( <15H )
5423,10,5,5,2018,1043,0.54,54,Medium-High Digitalization,Small Course ( <15H )
5424,7,2,5,2018,1043,0.32,32,Medium-Low Digitalization,Small Course ( <15H )
5425,84,10,74,2018,1043,0.12,12,Low Digitalization,High Course ( >40H )
5426,74,52,22,2018,1043,0.7,70,Medium-High Digitalization,High Course ( >40H )
5427,7,3,4,2018,1043,0.43,43,Medium-Low Digitalization,Small Course ( <15H )
5428,38,13,25,2018,1043,0.34,34,Medium-Low Digitalization,Medium Course ( >15H and <40H )
5429,38,2,36,2018,1043,0.05,5,Low Digitalization,Medium Course ( >15H and <40H )
5430,32,3,29,2018,1043,0.09,9,Low Digitalization,Medium Course ( >15H and <40H )
5431,15,11,4,2018,1043,0.73,73,Medium-High Digitalization,Small Course ( <15H )
5432,12,5,7,2018,1043,0.45,45,Medium-Low Digitalization,Small Course ( <15H )
5433,81,79,2,2018,1043,0.97,97,High Digitalization,High Course ( >40H )
5434,50,2,48,2018,1043,0.05,5,Low Digitalization,High Course ( >40H )
5435,14,12,2,2018,1043,0.83,83,High Digitalization,Small Course ( <15H )
5436,41,31,10,2018,1043,0.75,75,Medium-High Digitalization,High Course ( >40H )
5437,5,5,0,2018,1043,0.96,96,High Digitalization,Small Course ( <15H )
5438,42,28,14,2018,1043,0.66,66,Medium-High Digitalization,High Course ( >40H )
5439,27,23,4,2018,1043,0.85,85,High Digitalization,Medium Course ( >15H and <40H )
5440,39,11,28,2018,1043,0.27,27,Medium-Low Digitalization,Medium Course ( >15H and <40H )
5441,40,22,18,2018,1043,0.56,56,Medium-High Digitalization,High Course ( >40H )
5442,84,50,34,2018,1043,0.6,60,Medium-High Digitalization,High Course ( >40H )
5443,55,39,16,2018,1043,0.71,71,Medium-High Digitalization,High Course ( >40H )
5444,77,33,44,2018,1043,0.43,43,Medium-Low Digitalization,High Course ( >40H )
5445,16,8,8,2018,1043,0.5,50,Medium-Low Digitalization,Medium Course ( >15H and <40H )
5446,36,30,6,2018,1043,0.83,83,High Digitalization,Medium Course ( >15H and <40H )
5447,76,11,65,2018,1043,0.14,14,Low Digitalization,High Course ( >40H )
5448,6,2,4,2018,1043,0.28,28,Medium-Low Digitalization,Small Course ( <15H )
5449,10,9,1,2018,1043,0.92,92,High Digitalization,Small Course ( <15H )
5450,12,5,7,2018,1043,0.38,38,Medium-Low Digitalization,Small Course ( <15H )
5451,14,8,6,2018,1043,0.54,54,Medium-High Digitalization,Small Course ( <15H )
5452,52,11,41,2018,1043,0.21,21,Medium-Low Digitalization,High Course ( >40H )
5453,50,0,50,2018,1043,0.01,1,Low Digitalization,High Course ( >40H )
5454,13,11,2,2018,1043,0.85,85,High Digitalization,Small Course ( <15H )
5455,10,2,8,2018,1043,0.18,18,Low Digitalization,Small Course ( <15H )
5456,7,2,5,2018,1043,0.23,23,Medium-Low Digitalization,Small Course ( <15H )
5457,14,9,5,2018,1043,0.66,66,Medium-High Digitalization,Small Course ( <15H )
5458,82,47,35,2018,1043,0.57,56,Medium-High Digitalization,High Course ( >40H )
5459,14,3,11,2018,1043,0.19,19,Low Digitalization,Small Course ( <15H )
5460,6,1,5,2018,1043,0.23,23,Medium-Low Digitalization,Small Course ( <15H )
5461,26,7,19,2018,1043,0.26,26,Medium-Low Digitalization,Medium Course ( >15H and <40H )
5462,6,4,2,2018,1043,0.62,62,Medium-High Digitalization,Small Course ( <15H )
5463,60,46,14,2018,1043,0.76,76,Medium-High Digitalization,High Course ( >40H )
5464,32,2,30,2018,1043,0.07,7,Low Digitalization,Medium Course ( >15H and <40H )
5465,48,44,4,2018,1043,0.91,91,High Digitalization,High Course ( >40H )
5466,51,8,43,2018,1043,0.16,16,Low Digitalization,High Course ( >40H )
5467,53,30,23,2018,1043,0.57,56,Medium-High Digitalization,High Course ( >40H )
5468,28,15,13,2018,1043,0.54,54,Medium-High Digitalization,Medium Course ( >15H and <40H )
5469,22,20,2,2018,1043,0.89,89,High Digitalization,Medium Course ( >15H and <40H )
5470,60,56,4,2018,1043,0.94,94,High Digitalization,High Course ( >40H )
5471,12,4,8,2018,1043,0.31,31,Medium-Low Digitalization,Small Course ( <15H )
5472,84,53,31,2018,1043,0.63,63,Medium-High Digitalization,High Course ( >40H )
5473,80,63,17,2018,1043,0.79,79,Medium-High Digitalization,High Course ( >40H )
5474,67,65,2,2018,1043,0.97,97,High Digitalization,High Course ( >40H )
5475,61,12,49,2018,1043,0.2,20,Low Digitalization,High Course ( >40H )
5476,17,16,1,2018,1043,0.96,96,High Digitalization,Medium Course ( >15H and <40H )
5477,18,1,17,2018,1043,0.06,6,Low Digitalization,Medium Course ( >15H and <40H )
5478,56,6,50,2018,1043,0.1,10,Low Digitalization,High Course ( >40H )
5479,12,9,3,2018,1043,0.76,76,Medium-High Digitalization,Small Course ( <15H )
5480,7,5,2,2018,1043,0.71,71,Medium-High Digitalization,Small Course ( <15H )
5481,62,51,11,2018,1043,0.83,83,High Digitalization,High Course ( >40H )
5482,8,0,8,2018,1043,0.05,5,Low Digitalization,Small Course ( <15H )
5483,23,3,20,2018,1043,0.15,15,Low Digitalization,Medium Course ( >15H and <40H )
5484,5,3,2,2018,1043,0.57,56,Medium-High Digitalization,Small Course ( <15H )
5485,10,6,4,2018,1043,0.65,65,Medium-High Digitalization,Small Course ( <15H )
5486,6,4,2,2018,1043,0.65,65,Medium-High Digitalization,Small Course ( <15H )
5487,14,6,8,2018,1043,0.44,44,Medium-Low Digitalization,Small Course ( <15H )
5488,14,2,12,2018,1043,0.14,14,Low Digitalization,Small Course ( <15H )
5489,9,9,0,2018,1043,0.97,97,High Digitalization,Small Course ( <15H )
5490,5,4,1,2018,1043,0.85,85,High Digitalization,Small Course ( <15H )
5491,60,17,43,2018,1043,0.29,28,Medium-Low Digitalization,High Course ( >40H )
5492,76,59,17,2018,1043,0.78,78,Medium-High Digitalization,High Course ( >40H )
5493,15,3,12,2018,1043,0.17,17,Low Digitalization,Small Course ( <15H )
5494,54,15,39,2018,1043,0.28,28,Medium-Low Digitalization,High Course ( >40H )
5495,14,7,7,2018,1043,0.51,51,Medium-High Digitalization,Small Course ( <15H )
5496,5,2,3,2018,1043,0.37,37,Medium-Low Digitalization,Small Course ( <15H )
5497,25,14,11,2018,1043,0.55,55,Medium-High Digitalization,Medium Course ( >15H and <40H )
5498,68,65,3,2018,1043,0.96,96,High Digitalization,High Course ( >40H )
5499,89,18,71,2018,1043,0.2,20,Low Digitalization,High Course ( >40H )
5500,45,13,32,2018,1043,0.29,28,Medium-Low Digitalization,High Course ( >40H )
5501,5,4,1,2018,1043,0.78,78,Medium-High Digitalization,Small Course ( <15H )
5502,8,6,2,2018,1043,0.7,70,Medium-High Digitalization,Small Course ( <15H )
5503,17,12,5,2018,1043,0.68,68,Medium-High Digitalization,Medium Course ( >15H and <40H )
5504,23,21,2,2018,1043,0.9,90,High Digitalization,Medium Course ( >15H and <40H )
5505,26,2,24,2018,1043,0.07,7,Low Digitalization,Medium Course ( >15H and <40H )
5506,13,6,7,2018,1043,0.49,49,Medium-Low Digitalization,Small Course ( <15H )
5507,6,0,6,2018,1043,0.07,7,Low Digitalization,Small Course ( <15H )
5508,9,8,1,2018,1043,0.94,94,High Digitalization,Small Course ( <15H )
5509,60,32,28,2018,1043,0.53,53,Medium-High Digitalization,High Course ( >40H )
5510,15,14,1,2018,1043,0.91,91,High Digitalization,Small Course ( <15H )
5511,45,40,5,2018,1043,0.89,89,High Digitalization,High Course ( >40H )
5512,36,12,24,2018,1043,0.34,34,Medium-Low Digitalization,Medium Course ( >15H and <40H )
5513,14,10,4,2018,1043,0.74,74,Medium-High Digitalization,Small Course ( <15H )
5514,19,16,3,2018,1043,0.84,84,High Digitalization,Medium Course ( >15H and <40H )
5515,64,26,38,2018,1043,0.4,40,Medium-Low Digitalization,High Course ( >40H )
5516,12,2,10,2018,1043,0.14,14,Low Digitalization,Small Course ( <15H )
5517,42,32,10,2018,1043,0.75,75,Medium-High Digitalization,High Course ( >40H )
5518,10,6,4,2018,1043,0.58,57,Medium-High Digitalization,Small Course ( <15H )
5519,8,3,5,2018,1043,0.38,38,Medium-Low Digitalization,Small Course ( <15H )
5520,39,15,24,2018,1043,0.39,39,Medium-Low Digitalization,Medium Course ( >15H and <40H )
5521,83,82,1,2018,1043,0.99,99,High Digitalization,High Course ( >40H )
5522,35,3,32,2018,1043,0.08,8,Low Digitalization,Medium Course ( >15H and <40H )
5523,15,1,14,2018,1043,0.07,7,Low Digitalization,Small Course ( <15H )
5524,13,9,4,2018,1043,0.67,67,Medium-High Digitalization,Small Course ( <15H )
5525,79,21,58,2018,1043,0.27,27,Medium-Low Digitalization,High Course ( >40H )
5526,66,54,12,2018,1043,0.82,82,High Digitalization,High Course ( >40H )
5527,46,0,46,2018,1043,0.0,0,Low Digitalization,High Course ( >40H )
5528,10,8,2,2018,1043,0.81,81,High Digitalization,Small Course ( <15H )
5529,88,56,32,2018,1043,0.64,64,Medium-High Digitalization,High Course ( >40H )
5530,53,3,50,2018,1043,0.06,6,Low Digitalization,High Course ( >40H )
5531,65,14,51,2018,1043,0.22,22,Medium-Low Digitalization,High Course ( >40H )
5532,29,28,1,2018,1043,0.95,95,High Digitalization,Medium Course ( >15H and <40H )
5533,46,41,5,2018,1043,0.9,90,High Digitalization,High Course ( >40H )
5534,43,10,33,2018,1043,0.23,23,Medium-Low Digitalization,High Course ( >40H )
5535,24,6,18,2018,1043,0.25,25,Medium-Low Digitalization,Medium Course ( >15H and <40H )
5536,37,30,7,2018,1043,0.81,81,High Digitalization,Medium Course ( >15H and <40H )
5537,11,5,6,2018,1043,0.44,44,Medium-Low Digitalization,Small Course ( <15H )
5538,21,20,1,2018,1043,0.97,97,High Digitalization,Medium Course ( >15H and <40H )
5539,47,33,14,2018,1043,0.7,70,Medium-High Digitalization,High Course ( >40H )
5540,30,14,16,2018,1043,0.47,47,Medium-Low Digitalization,Medium Course ( >15H and <40H )
5541,75,29,46,2018,1043,0.39,39,Medium-Low Digitalization,High Course ( >40H )
5542,38,26,12,2018,1043,0.68,68,Medium-High Digitalization,Medium Course ( >15H and <40H )
5543,60,21,39,2018,1043,0.35,35,Medium-Low Digitalization,High Course ( >40H )
5544,18,1,17,2018,1043,0.06,6,Low Digitalization,Medium Course ( >15H and <40H )
5545,11,6,5,2018,1043,0.59,59,Medium-High Digitalization,Small Course ( <15H )
5546,10,7,3,2018,1043,0.69,69,Medium-High Digitalization,Small Course ( <15H )
5547,6,2,4,2018,1043,0.29,28,Medium-Low Digitalization,Small Course ( <15H )
5548,6,0,6,2018,1043,0.05,5,Low Digitalization,Small Course ( <15H )
5549,12,5,7,2018,1043,0.39,39,Medium-Low Digitalization,Small Course ( <15H )
5550,6,3,3,2018,1043,0.52,52,Medium-High Digitalization,Small Course ( <15H )
5551,89,38,51,2018,1043,0.43,43,Medium-Low Digitalization,High Course ( >40H )
5552,10,5,5,2018,1043,0.49,49,Medium-Low Digitalization,Small Course ( <15H )
5553,84,5,79,2018,1043,0.06,6,Low Digitalization,High Course ( >40H )
5554,50,30,20,2018,1043,0.59,59,Medium-High Digitalization,High Course ( >40H )
5555,15,14,1,2018,1043,0.92,92,High Digitalization,Small Course ( <15H )
5556,28,3,25,2018,1043,0.09,9,Low Digitalization,Medium Course ( >15H and <40H )
5557,22,1,21,2018,1043,0.04,4,Low Digitalization,Medium Course ( >15H and <40H )
5558,83,22,61,2018,1043,0.27,27,Medium-Low Digitalization,High Course ( >40H )
5559,6,2,4,2018,1043,0.35,35,Medium-Low Digitalization,Small Course ( <15H )
5560,86,40,46,2018,1043,0.47,47,Medium-Low Digitalization,High Course ( >40H )
5561,24,16,8,2018,1043,0.66,66,Medium-High Digitalization,Medium Course ( >15H and <40H )
5562,5,1,4,2018,1043,0.16,16,Low Digitalization,Small Course ( <15H )
5563,30,5,25,2018,1043,0.17,17,Low Digitalization,Medium Course ( >15H and <40H )
5564,74,5,69,2018,1043,0.07,7,Low Digitalization,High Course ( >40H )
5565,9,1,8,2018,1043,0.12,12,Low Digitalization,Small Course ( <15H )
5566,60,25,35,2018,1043,0.42,42,Medium-Low Digitalization,High Course ( >40H )
5567,54,35,19,2018,1043,0.65,65,Medium-High Digitalization,High Course ( >40H )
5568,46,36,10,2018,1043,0.78,78,Medium-High Digitalization,High Course ( >40H )
5569,5,1,4,2018,1043,0.11,11,Low Digitalization,Small Course ( <15H )
5570,34,33,1,2018,1043,0.98,98,High Digitalization,Medium Course ( >15H and <40H )
5571,57,11,46,2018,1043,0.19,19,Low Digitalization,High Course ( >40H )
5572,25,9,16,2018,1043,0.37,37,Medium-Low Digitalization,Medium Course ( >15H and <40H )
5573,30,3,27,2018,1043,0.09,9,Low Digitalization,Medium Course ( >15H and <40H )
5574,67,54,13,2018,1043,0.8,80,Medium-High Digitalization,High Course ( >40H )
5575,19,7,12,2018,1043,0.39,39,Medium-Low Digitalization,Medium Course ( >15H and <40H )
5576,38,12,26,2018,1043,0.32,32,Medium-Low Digitalization,Medium Course ( >15H and <40H )
5577,43,5,38,2018,1043,0.12,12,Low Digitalization,High Course ( >40H )
5578,69,28,41,2018,1043,0.4,40,Medium-Low Digitalization,High Course ( >40H )
5579,40,38,2,2018,1043,0.94,94,High Digitalization,High Course ( >40H )
5580,15,7,8,2018,1043,0.45,45,Medium-Low Digitalization,Small Course ( <15H )
5581,8,0,8,2018,1043,0.05,5,Low Digitalization,Small Course ( <15H )
5582,26,19,7,2018,1043,0.72,72,Medium-High Digitalization,Medium Course ( >15H and <40H )
5583,25,4,21,2018,1043,0.16,16,Low Digitalization,Medium Course ( >15H and <40H )
5584,57,35,22,2018,1043,0.61,61,Medium-High Digitalization,High Course ( >40H )
5585,28,22,6,2018,1043,0.8,80,Medium-High Digitalization,Medium Course ( >15H and <40H )
5586,19,17,2,2018,1043,0.87,87,High Digitalization,Medium Course ( >15H and <40H )
5587,18,1,17,2018,1043,0.07,7,Low Digitalization,Medium Course ( >15H and <40H )
5588,37,23,14,2018,1043,0.63,63,Medium-High Digitalization,Medium Course ( >15H and <40H )
5589,15,12,3,2018,1043,0.81,81,High Digitalization,Small Course ( <15H )
5590,36,33,3,2018,1043,0.91,91,High Digitalization,Medium Course ( >15H and <40H )
5591,23,5,18,2018,1043,0.23,23,Medium-Low Digitalization,Medium Course ( >15H and <40H )
5592,42,14,28,2018,1043,0.34,34,Medium-Low Digitalization,High Course ( >40H )
5593,60,43,17,2018,1043,0.71,71,Medium-High Digitalization,High Course ( >40H )
5594,34,30,4,2018,1043,0.88,88,High Digitalization,Medium Course ( >15H and <40H )
5595,57,34,23,2018,1043,0.59,59,Medium-High Digitalization,High Course ( >40H )
5596,47,23,24,2018,1043,0.49,49,Medium-Low Digitalization,High Course ( >40H )
5597,18,6,12,2018,1043,0.36,36,Medium-Low Digitalization,Medium Course ( >15H and <40H )
5598,16,12,4,2018,1043,0.75,75,Medium-High Digitalization,Medium Course ( >15H and <40H )
5599,86,39,47,2018,1043,0.45,45,Medium-Low Digitalization,High Course ( >40H )
5600,90,83,7,2018,1043,0.92,92,High Digitalization,High Course ( >40H )
5601,8,8,0,2018,1043,0.98,98,High Digitalization,Small Course ( <15H )
5602,13,6,7,2018,1043,0.48,48,Medium-Low Digitalization,Small Course ( <15H )
5603,18,0,18,2018,1043,0.02,2,Low Digitalization,Medium Course ( >15H and <40H )
5604,29,12,17,2018,1043,0.41,41,Medium-Low Digitalization,Medium Course ( >15H and <40H )
5605,41,32,9,2018,1043,0.77,77,Medium-High Digitalization,High Course ( >40H )
5606,8,4,4,2018,1043,0.52,52,Medium-High Digitalization,Small Course ( <15H )
5607,80,32,48,2018,1043,0.4,40,Medium-Low Digitalization,High Course ( >40H )
5608,43,9,34,2018,1043,0.2,20,Low Digitalization,High Course ( >40H )
5609,21,9,12,2018,1043,0.43,43,Medium-Low Digitalization,Medium Course ( >15H and <40H )
5610,89,59,30,2018,1043,0.66,66,Medium-High Digitalization,High Course ( >40H )
5611,53,8,45,2018,1043,0.16,16,Low Digitalization,High Course ( >40H )
5612,87,30,57,2018,1043,0.34,34,Medium-Low Digitalization,High Course ( >40H )
5613,87,85,2,2018,1043,0.98,98,High Digitalization,High Course ( >40H )
5614,10,2,8,2018,1043,0.16,16,Low Digitalization,Small Course ( <15H )
5615,83,32,51,2018,1043,0.38,38,Medium-Low Digitalization,High Course ( >40H )
5616,19,19,0,2018,1043,0.98,98,High Digitalization,Medium Course ( >15H and <40H )
5617,42,19,23,2018,1043,0.46,46,Medium-Low Digitalization,High Course ( >40H )
5618,33,22,11,2018,1043,0.68,68,Medium-High Digitalization,Medium Course ( >15H and <40H )
5619,8,3,5,2018,1043,0.43,43,Medium-Low Digitalization,Small Course ( <15H )
5620,44,18,26,2018,1043,0.42,42,Medium-Low Digitalization,High Course ( >40H )
5621,10,4,6,2018,1043,0.42,42,Medium-Low Digitalization,Small Course ( <15H )
5622,87,44,43,2018,1043,0.51,51,Medium-High Digitalization,High Course ( >40H )
5623,81,10,71,2018,1043,0.12,12,Low Digitalization,High Course ( >40H )
5624,35,6,29,2018,1043,0.16,16,Low Digitalization,Medium Course ( >15H and <40H )
5625,9,8,1,2018,1043,0.88,88,High Digitalization,Small Course ( <15H )
5626,10,1,9,2018,1043,0.1,10,Low Digitalization,Small Course ( <15H )
5627,8,2,6,2018,1043,0.31,31,Medium-Low Digitalization,Small Course ( <15H )
5628,20,3,17,2018,1043,0.16,16,Low Digitalization,Medium Course ( >15H and <40H )
5629,90,14,76,2018,1043,0.15,15,Low Digitalization,High Course ( >40H )
5630,38,5,33,2018,1043,0.13,13,Low Digitalization,Medium Course ( >15H and <40H )
5631,73,56,17,2018,1043,0.77,77,Medium-High Digitalization,High Course ( >40H )
5632,74,27,47,2018,1043,0.36,36,Medium-Low Digitalization,High Course ( >40H )
5633,25,12,14,2018,1043,0.46,46,Medium-Low Digitalization,Medium Course ( >15H and <40H )
5634,14,4,10,2018,1043,0.25,25,Medium-Low Digitalization,Small Course ( <15H )
5635,68,35,33,2018,1043,0.51,51,Medium-High Digitalization,High Course ( >40H )
5636,5,2,3,2018,1043,0.4,40,Medium-Low Digitalization,Small Course ( <15H )
5637,23,0,23,2018,1043,0.02,2,Low Digitalization,Medium Course ( >15H and <40H )
5638,47,41,6,2018,1043,0.88,88,High Digitalization,High Course ( >40H )
5639,42,42,0,2018,1043,1.0,100,High Digitalization,High Course ( >40H )
5640,7,7,0,2018,1043,0.95,95,High Digitalization,Small Course ( <15H )
5641,43,25,18,2018,1043,0.59,59,Medium-High Digitalization,High Course ( >40H )
5642,84,76,8,2018,1043,0.9,90,High Digitalization,High Course ( >40H )
5643,5,5,0,2018,1043,0.91,91,High Digitalization,Small Course ( <15H )
5644,21,1,20,2018,1043,0.06,6,Low Digitalization,Medium Course ( >15H and <40H )
5645,87,10,77,2018,1043,0.12,12,Low Digitalization,High Course ( >40H )
5646,21,17,4,2018,1043,0.81,81,High Digitalization,Medium Course ( >15H and <40H )
5647,14,5,9,2018,1043,0.35,35,Medium-Low Digitalization,Small Course ( <15H )
5648,10,7,3,2018,1043,0.7,70,Medium-High Digitalization,Small Course ( <15H )
5649,43,27,16,2018,1043,0.62,62,Medium-High Digitalization,High Course ( >40H )
5650,26,11,15,2018,1043,0.41,41,Medium-Low Digitalization,Medium Course ( >15H and <40H )
5651,10,1,9,2018,1043,0.13,13,Low Digitalization,Small Course ( <15H )
5652,79,73,6,2018,1043,0.92,92,High Digitalization,High Course ( >40H )
5653,8,3,5,2018,1043,0.33,33,Medium-Low Digitalization,Small Course ( <15H )
5654,29,0,29,2018,1043,0.0,0,Low Digitalization,Medium Course ( >15H and <40H )
5655,63,49,14,2018,1043,0.78,78,Medium-High Digitalization,High Course ( >40H )
5656,34,10,24,2018,1043,0.3,30,Medium-Low Digitalization,Medium Course ( >15H and <40H )
5657,26,21,5,2018,1043,0.8,80,Medium-High Digitalization,Medium Course ( >15H and <40H )
5658,52,28,24,2018,1043,0.53,53,Medium-High Digitalization,High Course ( >40H )
5659,20,7,13,2018,1043,0.34,34,Medium-Low Digitalization,Medium Course ( >15H and <40H )
5660,50,5,45,2018,1043,0.1,10,Low Digitalization,High Course ( >40H )
5661,25,5,20,2018,1043,0.19,19,Low Digitalization,Medium Course ( >15H and <40H )
5662,12,8,4,2018,1043,0.64,64,Medium-High Digitalization,Small Course ( <15H )
5663,15,2,13,2018,1043,0.13,13,Low Digitalization,Small Course ( <15H )
5664,77,46,31,2018,1043,0.6,60,Medium-High Digitalization,High Course ( >40H )
5665,56,38,18,2018,1043,0.67,67,Medium-High Digitalization,High Course ( >40H )
5666,90,62,28,2018,1043,0.69,69,Medium-High Digitalization,High Course ( >40H )
5667,11,7,4,2018,1043,0.65,65,Medium-High Digitalization,Small Course ( <15H )
5668,36,8,28,2018,1043,0.22,22,Medium-Low Digitalization,Medium Course ( >15H and <40H )
5669,78,73,5,2018,1043,0.94,94,High Digitalization,High Course ( >40H )
5670,15,2,13,2018,1043,0.15,15,Low Digitalization,Small Course ( <15H )
5671,45,40,4,2018,1043,0.9,90,High Digitalization,High Course ( >40H )
5672,35,16,19,2018,1043,0.46,46,Medium-Low Digitalization,Medium Course ( >15H and <40H )
5673,31,30,1,2018,1043,0.96,96,High Digitalization,Medium Course ( >15H and <40H )
5674,6,2,4,2018,1043,0.31,31,Medium-Low Digitalization,Small Course ( <15H )
5675,76,74,2,2018,1043,0.97,97,High Digitalization,High Course ( >40H )
5676,14,3,11,2018,1043,0.21,21,Medium-Low Digitalization,Small Course ( <15H )
5677,53,25,28,2018,1043,0.48,48,Medium-Low Digitalization,High Course ( >40H )
5678,35,22,13,2018,1043,0.64,64,Medium-High Digitalization,Medium Course ( >15H and <40H )
5679,12,3,9,2018,1043,0.21,21,Medium-Low Digitalization,Small Course ( <15H )
5680,81,59,22,2018,1043,0.73,73,Medium-High Digitalization,High Course ( >40H )
5681,21,4,17,2018,1043,0.21,21,Medium-Low Digitalization,Medium Course ( >15H and <40H )
5682,39,24,15,2018,1043,0.61,61,Medium-High Digitalization,Medium Course ( >15H and <40H )
5683,14,1,13,2018,1043,0.07,7,Low Digitalization,Small Course ( <15H )
5684,84,45,39,2018,1043,0.54,54,Medium-High Digitalization,High Course ( >40H )
5685,30,18,12,2018,1043,0.6,60,Medium-High Digitalization,Medium Course ( >15H and <40H )
5686,15,10,5,2018,1043,0.68,68,Medium-High Digitalization,Small Course ( <15H )
5687,74,24,50,2018,1043,0.32,32,Medium-Low Digitalization,High Course ( >40H )
5688,82,57,25,2018,1043,0.69,69,Medium-High Digitalization,High Course ( >40H )
5689,58,10,48,2018,1043,0.18,18,Low Digitalization,High Course ( >40H )
5690,19,5,14,2018,1043,0.28,28,Medium-Low Digitalization,Medium Course ( >15H and <40H )
5691,79,47,32,2018,1043,0.59,59,Medium-High Digitalization,High Course ( >40H )
5692,50,29,21,2018,1043,0.58,57,Medium-High Digitalization,High Course ( >40H )
5693,10,2,8,2018,1043,0.17,17,Low Digitalization,Small Course ( <15H )
5694,41,11,30,2018,1043,0.28,28,Medium-Low Digitalization,High Course ( >40H )
5695,14,11,3,2018,1043,0.78,78,Medium-High Digitalization,Small Course ( <15H )
5696,9,1,8,2018,1043,0.11,11,Low Digitalization,Small Course ( <15H )
5697,37,27,10,2018,1043,0.72,72,Medium-High Digitalization,Medium Course ( >15H and <40H )
5698,17,1,16,2018,1043,0.07,7,Low Digitalization,Medium Course ( >15H and <40H )
5699,35,16,19,2018,1043,0.46,46,Medium-Low Digitalization,Medium Course ( >15H and <40H )
5700,34,3,31,2018,1043,0.09,9,Low Digitalization,Medium Course ( >15H and <40H )
5701,35,14,21,2018,1043,0.39,39,Medium-Low Digitalization,Medium Course ( >15H and <40H )
5702,11,2,9,2018,1043,0.15,15,Low Digitalization,Small Course ( <15H )
5703,20,16,4,2018,1043,0.79,79,Medium-High Digitalization,Medium Course ( >15H and <40H )
5704,15,14,1,2018,1043,0.91,91,High Digitalization,Small Course ( <15H )
5705,14,2,12,2018,1043,0.17,17,Low Digitalization,Small Course ( <15H )
5706,35,20,15,2018,1043,0.56,56,Medium-High Digitalization,Medium Course ( >15H and <40H )
5707,60,28,32,2018,1043,0.47,47,Medium-Low Digitalization,High Course ( >40H )
5708,69,30,39,2018,1043,0.44,44,Medium-Low Digitalization,High Course ( >40H )
5709,6,5,1,2018,1043,0.91,91,High Digitalization,Small Course ( <15H )
5710,10,7,3,2018,1043,0.72,72,Medium-High Digitalization,Small Course ( <15H )
5711,39,38,1,2018,1043,0.98,98,High Digitalization,Medium Course ( >15H and <40H )
5712,9,4,5,2018,1043,0.39,39,Medium-Low Digitalization,Small Course ( <15H )
5713,55,35,20,2018,1043,0.63,63,Medium-High Digitalization,High Course ( >40H )
5714,15,3,12,2018,1043,0.17,17,Low Digitalization,Small Course ( <15H )
5715,17,2,15,2018,1043,0.09,9,Low Digitalization,Medium Course ( >15H and <40H )
5716,59,59,0,2018,1043,1.0,100,High Digitalization,High Course ( >40H )
5717,33,19,14,2018,1043,0.58,57,Medium-High Digitalization,Medium Course ( >15H and <40H )
5718,50,8,42,2018,1043,0.17,17,Low Digitalization,High Course ( >40H )
5719,72,18,54,2018,1043,0.25,25,Medium-Low Digitalization,High Course ( >40H )
5720,59,38,21,2018,1043,0.65,65,Medium-High Digitalization,High Course ( >40H )
5721,10,9,1,2018,1043,0.89,89,High Digitalization,Small Course ( <15H )
5722,10,1,9,2018,1043,0.09,9,Low Digitalization,Small Course ( <15H )
5723,12,11,1,2018,1043,0.94,94,High Digitalization,Small Course ( <15H )
5724,15,3,12,2018,1043,0.23,23,Medium-Low Digitalization,Small Course ( <15H )
5725,59,1,58,2018,1043,0.02,2,Low Digitalization,High Course ( >40H )
5726,15,13,2,2018,1043,0.84,84,High Digitalization,Small Course ( <15H )
5727,6,3,3,2018,1043,0.54,54,Medium-High Digitalization,Small Course ( <15H )
5728,40,8,32,2018,1043,0.21,21,Medium-Low Digitalization,High Course ( >40H )
5729,79,48,31,2018,1043,0.61,61,Medium-High Digitalization,High Course ( >40H )
5730,11,9,2,2018,1043,0.81,81,High Digitalization,Small Course ( <15H )
5731,89,8,81,2018,1043,0.09,9,Low Digitalization,High Course ( >40H )
5732,37,5,32,2018,1043,0.14,14,Low Digitalization,Medium Course ( >15H and <40H )
5733,62,29,33,2018,1043,0.47,47,Medium-Low Digitalization,High Course ( >40H )
5734,47,32,15,2018,1043,0.69,69,Medium-High Digitalization,High Course ( >40H )
5735,66,15,51,2018,1043,0.22,22,Medium-Low Digitalization,High Course ( >40H )
5736,28,3,25,2018,1043,0.11,11,Low Digitalization,Medium Course ( >15H and <40H )
5737,46,36,10,2018,1043,0.79,79,Medium-High Digitalization,High Course ( >40H )
5738,41,36,5,2018,1043,0.88,88,High Digitalization,High Course ( >40H )
5739,60,29,31,2018,1043,0.48,48,Medium-Low Digitalization,High Course ( >40H )
5740,13,2,11,2018,1043,0.13,13,Low Digitalization,Small Course ( <15H )
5741,37,36,1,2018,1043,0.96,96,High Digitalization,Medium Course ( >15H and <40H )
5742,10,5,5,2018,1043,0.51,51,Medium-High Digitalization,Small Course ( <15H )
5743,32,18,14,2018,1043,0.55,55,Medium-High Digitalization,Medium Course ( >15H and <40H )
5744,9,3,6,2018,1043,0.37,37,Medium-Low Digitalization,Small Course ( <15H )
5745,85,79,6,2018,1043,0.93,93,High Digitalization,High Course ( >40H )
5746,44,3,41,2018,1043,0.06,6,Low Digitalization,High Course ( >40H )
5747,20,9,11,2018,1043,0.43,43,Medium-Low Digitalization,Medium Course ( >15H and <40H )
5748,10,2,8,2018,1043,0.24,24,Medium-Low Digitalization,Small Course ( <15H )
5749,47,3,44,2018,1043,0.06,6,Low Digitalization,High Course ( >40H )
5750,22,1,21,2018,1043,0.06,6,Low Digitalization,Medium Course ( >15H and <40H )
5751,51,39,12,2018,1043,0.76,76,Medium-High Digitalization,High Course ( >40H )
5752,60,59,1,2018,1043,0.98,98,High Digitalization,High Course ( >40H )
5753,13,7,6,2018,1043,0.52,52,Medium-High Digitalization,Small Course ( <15H )
5754,57,16,41,2018,1043,0.28,28,Medium-Low Digitalization,High Course ( >40H )
5755,40,14,26,2018,1043,0.36,36,Medium-Low Digitalization,High Course ( >40H )
5756,6,4,2,2018,1043,0.68,68,Medium-High Digitalization,Small Course ( <15H )
5757,12,3,9,2018,1043,0.27,27,Medium-Low Digitalization,Small Course ( <15H )
5758,14,7,7,2018,1043,0.48,48,Medium-Low Digitalization,Small Course ( <15H )
5759,15,8,8,2018,1043,0.5,50,Medium-Low Digitalization,Small Course ( <15H )
5760,12,9,3,2018,1043,0.73,73,Medium-High Digitalization,Small Course ( <15H )
5761,9,7,2,2018,1043,0.8,80,Medium-High Digitalization,Small Course ( <15H )
5762,30,8,22,2018,1043,0.26,26,Medium-Low Digitalization,Medium Course ( >15H and <40H )
5763,52,41,11,2018,1043,0.78,78,Medium-High Digitalization,High Course ( >40H )
5764,11,8,3,2018,1043,0.75,75,Medium-High Digitalization,Small Course ( <15H )
5765,36,24,12,2018,1043,0.68,68,Medium-High Digitalization,Medium Course ( >15H and <40H )
5766,40,25,15,2018,1043,0.62,62,Medium-High Digitalization,High Course ( >40H )
5767,53,5,48,2018,1043,0.1,10,Low Digitalization,High Course ( >40H )
5768,26,8,18,2018,1043,0.31,31,Medium-Low Digitalization,Medium Course ( >15H and <40H )
5769,6,5,1,2018,1043,0.86,86,High Digitalization,Small Course ( <15H )
5770,12,11,1,2018,1043,0.89,89,High Digitalization,Small Course ( <15H )
5771,52,19,33,2018,1043,0.36,36,Medium-Low Digitalization,High Course ( >40H )
5772,45,13,32,2018,1043,0.28,28,Medium-Low Digitalization,High Course ( >40H )
5773,16,10,6,2018,1043,0.61,61,Medium-High Digitalization,Medium Course ( >15H and <40H )
5774,55,33,22,2018,1043,0.6,60,Medium-High Digitalization,High Course ( >40H )
5775,64,44,20,2018,1043,0.69,69,Medium-High Digitalization,High Course ( >40H )
5776,6,2,4,2018,1043,0.27,27,Medium-Low Digitalization,Small Course ( <15H )
5777,87,34,53,2018,1043,0.39,39,Medium-Low Digitalization,High Course ( >40H )
5778,15,2,14,2018,1043,0.1,10,Low Digitalization,Small Course ( <15H )
5779,29,23,6,2018,1043,0.8,80,Medium-High Digitalization,Medium Course ( >15H and <40H )
5780,25,10,15,2018,1043,0.39,39,Medium-Low Digitalization,Medium Course ( >15H and <40H )
5781,86,14,72,2018,1043,0.16,16,Low Digitalization,High Course ( >40H )
5782,28,10,18,2018,1043,0.36,36,Medium-Low Digitalization,Medium Course ( >15H and <40H )
5783,59,37,22,2018,1043,0.63,63,Medium-High Digitalization,High Course ( >40H )
5784,7,4,3,2018,1043,0.54,54,Medium-High Digitalization,Small Course ( <15H )
5785,20,12,8,2018,1043,0.58,57,Medium-High Digitalization,Medium Course ( >15H and <40H )
5786,89,59,30,2018,1043,0.66,66,Medium-High Digitalization,High Course ( >40H )
5787,27,13,14,2018,1043,0.48,48,Medium-Low Digitalization,Medium Course ( >15H and <40H )
5788,85,57,28,2018,1043,0.67,67,Medium-High Digitalization,High Course ( >40H )
5789,26,7,19,2018,1043,0.27,27,Medium-Low Digitalization,Medium Course ( >15H and <40H )
5790,40,34,6,2018,1043,0.84,84,High Digitalization,High Course ( >40H )
5791,47,47,0,2018,1043,1.0,100,High Digitalization,High Course ( >40H )
5792,57,39,18,2018,1043,0.68,68,Medium-High Digitalization,High Course ( >40H )
5793,8,5,3,2018,1043,0.57,56,Medium-High Digitalization,Small Course ( <15H )
5794,33,28,5,2018,1043,0.85,85,High Digitalization,Medium Course ( >15H and <40H )
5795,36,30,6,2018,1043,0.83,83,High Digitalization,Medium Course ( >15H and <40H )
5796,33,17,16,2018,1043,0.51,51,Medium-High Digitalization,Medium Course ( >15H and <40H )
5797,66,41,25,2018,1043,0.62,62,Medium-High Digitalization,High Course ( >40H )
5798,36,19,17,2018,1043,0.53,53,Medium-High Digitalization,Medium Course ( >15H and <40H )
5799,42,9,33,2018,1043,0.22,22,Medium-Low Digitalization,High Course ( >40H )
5800,9,8,1,2018,1043,0.93,93,High Digitalization,Small Course ( <15H )
5801,30,19,11,2018,1043,0.63,63,Medium-High Digitalization,Medium Course ( >15H and <40H )
5802,30,16,14,2018,1043,0.53,53,Medium-High Digitalization,Medium Course ( >15H and <40H )
5803,7,6,1,2018,1043,0.89,89,High Digitalization,Small Course ( <15H )
5804,80,51,29,2018,1043,0.64,64,Medium-High Digitalization,High Course ( >40H )
5805,26,13,13,2018,1043,0.5,50,Medium-Low Digitalization,Medium Course ( >15H and <40H )
5806,15,11,4,2018,1043,0.72,72,Medium-High Digitalization,Small Course ( <15H )
5807,15,6,9,2018,1043,0.42,42,Medium-Low Digitalization,Small Course ( <15H )
5808,30,17,13,2018,1043,0.57,56,Medium-High Digitalization,Medium Course ( >15H and <40H )
5809,9,6,3,2018,1043,0.7,70,Medium-High Digitalization,Small Course ( <15H )
5810,8,1,7,2018,1043,0.16,16,Low Digitalization,Small Course ( <15H )
5811,8,7,1,2018,1043,0.85,85,High Digitalization,Small Course ( <15H )
5812,40,2,38,2018,1043,0.04,4,Low Digitalization,High Course ( >40H )
5813,12,5,7,2018,1043,0.44,44,Medium-Low Digitalization,Small Course ( <15H )
5814,78,62,16,2018,1043,0.8,80,Medium-High Digitalization,High Course ( >40H )
5815,24,23,1,2018,1043,0.96,96,High Digitalization,Medium Course ( >15H and <40H )
5816,42,8,34,2018,1043,0.18,18,Low Digitalization,High Course ( >40H )
5817,5,4,1,2018,1043,0.71,71,Medium-High Digitalization,Small Course ( <15H )
5818,36,17,19,2018,1043,0.46,46,Medium-Low Digitalization,Medium Course ( >15H and <40H )
5819,25,20,5,2018,1043,0.79,79,Medium-High Digitalization,Medium Course ( >15H and <40H )
5820,29,17,12,2018,1043,0.6,60,Medium-High Digitalization,Medium Course ( >15H and <40H )
5821,49,15,34,2018,1043,0.3,30,Medium-Low Digitalization,High Course ( >40H )
5822,12,1,11,2018,1043,0.12,12,Low Digitalization,Small Course ( <15H )
5823,85,71,14,2018,1043,0.83,83,High Digitalization,High Course ( >40H )
5824,16,9,7,2018,1043,0.54,54,Medium-High Digitalization,Medium Course ( >15H and <40H )
5825,22,10,12,2018,1043,0.45,45,Medium-Low Digitalization,Medium Course ( >15H and <40H )
5826,31,8,23,2018,1043,0.26,26,Medium-Low Digitalization,Medium Course ( >15H and <40H )
5827,55,13,42,2018,1043,0.23,23,Medium-Low Digitalization,High Course ( >40H )
5828,50,8,42,2018,1043,0.15,15,Low Digitalization,High Course ( >40H )
5829,57,14,43,2018,1043,0.25,25,Medium-Low Digitalization,High Course ( >40H )
5830,15,13,2,2018,1043,0.84,84,High Digitalization,Small Course ( <15H )
5831,66,46,20,2018,1043,0.69,69,Medium-High Digitalization,High Course ( >40H )
5832,15,1,14,2018,1043,0.05,5,Low Digitalization,Small Course ( <15H )
5833,42,13,29,2018,1043,0.31,31,Medium-Low Digitalization,High Course ( >40H )
5834,39,31,8,2018,1043,0.79,79,Medium-High Digitalization,Medium Course ( >15H and <40H )
5835,41,7,34,2018,1043,0.18,18,Low Digitalization,High Course ( >40H )
5836,25,17,8,2018,1043,0.69,69,Medium-High Digitalization,Medium Course ( >15H and <40H )
5837,30,21,9,2018,1043,0.7,70,Medium-High Digitalization,Medium Course ( >15H and <40H )
5838,85,4,81,2018,1043,0.05,5,Low Digitalization,High Course ( >40H )
5839,34,6,28,2018,1043,0.18,18,Low Digitalization,Medium Course ( >15H and <40H )
5840,18,10,8,2018,1043,0.57,56,Medium-High Digitalization,Medium Course ( >15H and <40H )
5841,68,52,16,2018,1043,0.77,77,Medium-High Digitalization,High Course ( >40H )
5842,48,30,18,2018,1043,0.63,63,Medium-High Digitalization,High Course ( >40H )
5843,78,22,56,2018,1043,0.28,28,Medium-Low Digitalization,High Course ( >40H )
5844,84,24,60,2018,1043,0.28,28,Medium-Low Digitalization,High Course ( >40H )
5845,20,14,6,2018,1043,0.72,72,Medium-High Digitalization,Medium Course ( >15H and <40H )
5846,46,13,33,2018,1043,0.28,28,Medium-Low Digitalization,High Course ( >40H )
5847,88,9,79,2018,1043,0.1,10,Low Digitalization,High Course ( >40H )
5848,79,40,39,2018,1043,0.51,51,Medium-High Digitalization,High Course ( >40H )
5849,38,20,18,2018,1043,0.53,53,Medium-High Digitalization,Medium Course ( >15H and <40H )
5850,42,7,35,2018,1043,0.16,16,Low Digitalization,High Course ( >40H )
5851,71,41,30,2018,1043,0.58,57,Medium-High Digitalization,High Course ( >40H )
5852,39,31,8,2018,1043,0.8,80,Medium-High Digitalization,Medium Course ( >15H and <40H )
5853,38,22,16,2018,1043,0.58,57,Medium-High Digitalization,Medium Course ( >15H and <40H )
5854,14,4,10,2018,1043,0.25,25,Medium-Low Digitalization,Small Course ( <15H )
5855,54,29,25,2018,1043,0.53,53,Medium-High Digitalization,High Course ( >40H )
5856,53,20,33,2018,1043,0.37,37,Medium-Low Digitalization,High Course ( >40H )
5857,10,6,4,2018,1043,0.57,56,Medium-High Digitalization,Small Course ( <15H )
5858,57,56,1,2018,1043,0.99,99,High Digitalization,High Course ( >40H )
5859,24,3,21,2018,1043,0.13,13,Low Digitalization,Medium Course ( >15H and <40H )
5860,18,14,4,2018,1043,0.75,75,Medium-High Digitalization,Medium Course ( >15H and <40H )
5861,33,7,26,2018,1043,0.2,20,Low Digitalization,Medium Course ( >15H and <40H )
5862,7,5,2,2018,1043,0.74,74,Medium-High Digitalization,Small Course ( <15H )
5863,15,4,11,2018,1043,0.25,25,Medium-Low Digitalization,Small Course ( <15H )
5864,15,3,12,2018,1043,0.22,22,Medium-Low Digitalization,Small Course ( <15H )
5865,39,15,24,2018,1043,0.39,39,Medium-Low Digitalization,Medium Course ( >15H and <40H )
5866,47,0,47,2018,1043,0.01,1,Low Digitalization,High Course ( >40H )
5867,83,22,61,2018,1043,0.26,26,Medium-Low Digitalization,High Course ( >40H )
5868,80,42,38,2018,1043,0.53,53,Medium-High Digitalization,High Course ( >40H )
5869,54,51,3,2018,1043,0.95,95,High Digitalization,High Course ( >40H )
5870,36,17,19,2018,1043,0.48,48,Medium-Low Digitalization,Medium Course ( >15H and <40H )
5871,41,31,10,2018,1043,0.76,76,Medium-High Digitalization,High Course ( >40H )
5872,52,40,12,2018,1043,0.76,76,Medium-High Digitalization,High Course ( >40H )
5873,15,0,15,2018,1043,0.02,2,Low Digitalization,Small Course ( <15H )
5874,35,17,18,2018,1043,0.48,48,Medium-Low Digitalization,Medium Course ( >15H and <40H )
5875,41,9,32,2018,1043,0.22,22,Medium-Low Digitalization,High Course ( >40H )
5876,29,3,26,2018,1043,0.1,10,Low Digitalization,Medium Course ( >15H and <40H )
5877,35,30,5,2018,1043,0.85,85,High Digitalization,Medium Course ( >15H and <40H )
5878,43,35,8,2018,1043,0.81,81,High Digitalization,High Course ( >40H )
5879,71,63,8,2018,1043,0.89,89,High Digitalization,High Course ( >40H )
5880,46,27,19,2018,1043,0.58,57,Medium-High Digitalization,High Course ( >40H )
5881,10,3,7,2018,1043,0.32,32,Medium-Low Digitalization,Small Course ( <15H )
5882,10,8,2,2018,1043,0.81,81,High Digitalization,Small Course ( <15H )
5883,85,53,32,2018,1043,0.62,62,Medium-High Digitalization,High Course ( >40H )
5884,15,4,11,2018,1043,0.28,28,Medium-Low Digitalization,Small Course ( <15H )
5885,7,3,4,2018,1043,0.46,46,Medium-Low Digitalization,Small Course ( <15H )
5886,5,2,4,2018,1043,0.3,30,Medium-Low Digitalization,Small Course ( <15H )
5887,5,4,1,2018,1043,0.87,87,High Digitalization,Small Course ( <15H )
5888,49,23,26,2018,1043,0.46,46,Medium-Low Digitalization,High Course ( >40H )
5889,12,12,0,2018,1043,0.99,99,High Digitalization,Small Course ( <15H )
5890,23,17,6,2018,1043,0.74,74,Medium-High Digitalization,Medium Course ( >15H and <40H )
5891,6,6,0,2018,1043,0.94,94,High Digitalization,Small Course ( <15H )
5892,18,1,17,2018,1043,0.08,8,Low Digitalization,Medium Course ( >15H and <40H )
5893,5,2,3,2018,1043,0.45,45,Medium-Low Digitalization,Small Course ( <15H )
5894,12,5,7,2018,1043,0.4,40,Medium-Low Digitalization,Small Course ( <15H )
5895,36,24,12,2018,1043,0.66,66,Medium-High Digitalization,Medium Course ( >15H and <40H )
5896,9,3,6,2018,1043,0.38,38,Medium-Low Digitalization,Small Course ( <15H )
5897,67,61,6,2018,1043,0.91,91,High Digitalization,High Course ( >40H )
5898,32,13,19,2018,1043,0.41,41,Medium-Low Digitalization,Medium Course ( >15H and <40H )
5899,24,3,21,2018,1043,0.12,12,Low Digitalization,Medium Course ( >15H and <40H )
5900,5,2,3,2018,1043,0.38,38,Medium-Low Digitalization,Small Course ( <15H )
5901,6,0,6,2018,1043,0.07,7,Low Digitalization,Small Course ( <15H )
5902,64,40,24,2018,1043,0.62,62,Medium-High Digitalization,High Course ( >40H )
5903,53,53,0,2018,1043,1.0,100,High Digitalization,High Course ( >40H )
5904,35,23,12,2018,1043,0.65,65,Medium-High Digitalization,Medium Course ( >15H and <40H )
5905,15,14,1,2018,1043,0.95,95,High Digitalization,Small Course ( <15H )
5906,43,1,42,2018,1043,0.03,3,Low Digitalization,High Course ( >40H )
5907,7,2,5,2018,1043,0.25,25,Medium-Low Digitalization,Small Course ( <15H )
5908,16,16,0,2018,1043,0.97,97,High Digitalization,Medium Course ( >15H and <40H )
5909,12,6,6,2018,1043,0.46,46,Medium-Low Digitalization,Small Course ( <15H )
5910,29,14,15,2018,1043,0.47,47,Medium-Low Digitalization,Medium Course ( >15H and <40H )
5911,63,54,9,2018,1043,0.86,86,High Digitalization,High Course ( >40H )
5912,46,30,16,2018,1043,0.66,66,Medium-High Digitalization,High Course ( >40H )
5913,13,8,5,2018,1043,0.62,62,Medium-High Digitalization,Small Course ( <15H )
5914,83,8,75,2018,1043,0.1,10,Low Digitalization,High Course ( >40H )
5915,45,36,9,2018,1043,0.8,80,Medium-High Digitalization,High Course ( >40H )
5916,27,16,11,2018,1043,0.58,57,Medium-High Digitalization,Medium Course ( >15H and <40H )
5917,51,9,42,2018,1043,0.17,17,Low Digitalization,High Course ( >40H )
5918,10,6,4,2018,1043,0.61,61,Medium-High Digitalization,Small Course ( <15H )
5919,53,3,50,2018,1043,0.06,6,Low Digitalization,High Course ( >40H )
5920,10,4,6,2018,1043,0.35,35,Medium-Low Digitalization,Small Course ( <15H )
5921,21,20,1,2018,1043,0.94,94,High Digitalization,Medium Course ( >15H and <40H )
5922,41,39,2,2018,1043,0.96,96,High Digitalization,High Course ( >40H )
5923,40,17,23,2018,1043,0.42,42,Medium-Low Digitalization,High Course ( >40H )
5924,56,35,21,2018,1043,0.62,62,Medium-High Digitalization,High Course ( >40H )
5925,54,53,1,2018,1043,0.99,99,High Digitalization,High Course ( >40H )
5926,6,5,1,2018,1043,0.9,90,High Digitalization,Small Course ( <15H )
5927,52,27,25,2018,1043,0.52,52,Medium-High Digitalization,High Course ( >40H )
5928,5,2,3,2018,1043,0.41,41,Medium-Low Digitalization,Small Course ( <15H )
5929,13,3,10,2018,1043,0.24,24,Medium-Low Digitalization,Small Course ( <15H )
5930,5,2,3,2018,1043,0.41,41,Medium-Low Digitalization,Small Course ( <15H )
5931,70,59,11,2018,1043,0.84,84,High Digitalization,High Course ( >40H )
5932,66,59,7,2018,1043,0.9,90,High Digitalization,High Course ( >40H )
5933,63,56,7,2018,1043,0.89,89,High Digitalization,High Course ( >40H )
5934,90,31,58,2018,1043,0.35,35,Medium-Low Digitalization,High Course ( >40H )
5935,14,11,3,2018,1043,0.8,80,Medium-High Digitalization,Small Course ( <15H )
5936,16,15,1,2018,1043,0.92,92,High Digitalization,Medium Course ( >15H and <40H )
5937,38,36,2,2018,1043,0.95,95,High Digitalization,Medium Course ( >15H and <40H )
5938,57,25,32,2018,1043,0.44,44,Medium-Low Digitalization,High Course ( >40H )
5939,75,56,20,2018,1043,0.74,74,Medium-High Digitalization,High Course ( >40H )
5940,20,3,17,2018,1043,0.13,13,Low Digitalization,Medium Course ( >15H and <40H )
5941,5,4,1,2018,1043,0.79,79,Medium-High Digitalization,Small Course ( <15H )
5942,13,5,8,2018,1043,0.35,35,Medium-Low Digitalization,Small Course ( <15H )
5943,44,20,24,2018,1043,0.46,46,Medium-Low Digitalization,High Course ( >40H )
5944,36,13,23,2018,1043,0.37,37,Medium-Low Digitalization,Medium Course ( >15H and <40H )
5945,8,2,6,2018,1043,0.2,20,Low Digitalization,Small Course ( <15H )
5946,32,14,18,2018,1043,0.44,44,Medium-Low Digitalization,Medium Course ( >15H and <40H )
5947,6,0,6,2018,1043,0.05,5,Low Digitalization,Small Course ( <15H )
5948,47,37,10,2018,1043,0.78,78,Medium-High Digitalization,High Course ( >40H )
5949,42,31,11,2018,1043,0.74,74,Medium-High Digitalization,High Course ( >40H )
5950,77,19,58,2018,1043,0.25,25,Medium-Low Digitalization,High Course ( >40H )
5951,19,15,4,2018,1043,0.79,79,Medium-High Digitalization,Medium Course ( >15H and <40H )
5952,12,2,10,2018,1043,0.14,14,Low Digitalization,Small Course ( <15H )
5953,38,37,1,2018,1043,0.98,98,High Digitalization,Medium Course ( >15H and <40H )
5954,68,2,66,2018,1043,0.03,3,Low Digitalization,High Course ( >40H )
5955,35,21,14,2018,1043,0.61,61,Medium-High Digitalization,Medium Course ( >15H and <40H )
5956,48,28,20,2018,1043,0.58,57,Medium-High Digitalization,High Course ( >40H )
5957,10,5,5,2018,1043,0.52,52,Medium-High Digitalization,Small Course ( <15H )
5958,15,5,10,2018,1043,0.36,36,Medium-Low Digitalization,Small Course ( <15H )
5959,68,22,46,2018,1043,0.32,32,Medium-Low Digitalization,High Course ( >40H )
5960,40,40,0,2018,1043,0.99,99,High Digitalization,High Course ( >40H )
5961,23,16,7,2018,1043,0.69,69,Medium-High Digitalization,Medium Course ( >15H and <40H )
5962,37,13,24,2018,1043,0.34,34,Medium-Low Digitalization,Medium Course ( >15H and <40H )
5963,15,13,2,2018,1043,0.86,86,High Digitalization,Small Course ( <15H )
5964,22,5,17,2018,1043,0.24,24,Medium-Low Digitalization,Medium Course ( >15H and <40H )
5965,5,1,4,2018,1043,0.17,17,Low Digitalization,Small Course ( <15H )
5966,5,3,2,2018,1043,0.55,55,Medium-High Digitalization,Small Course ( <15H )
5967,19,15,4,2018,1043,0.77,77,Medium-High Digitalization,Medium Course ( >15H and <40H )
5968,63,42,21,2018,1043,0.67,67,Medium-High Digitalization,High Course ( >40H )
5969,53,33,20,2018,1043,0.63,63,Medium-High Digitalization,High Course ( >40H )
5970,15,5,10,2018,1043,0.31,31,Medium-Low Digitalization,Small Course ( <15H )
5971,20,19,1,2018,1043,0.97,97,High Digitalization,Medium Course ( >15H and <40H )
5972,56,3,53,2018,1043,0.05,5,Low Digitalization,High Course ( >40H )
5973,25,4,22,2018,1043,0.14,14,Low Digitalization,Medium Course ( >15H and <40H )
5974,59,32,27,2018,1043,0.54,54,Medium-High Digitalization,High Course ( >40H )
5975,32,16,16,2018,1043,0.51,51,Medium-High Digitalization,Medium Course ( >15H and <40H )
5976,9,2,7,2018,1043,0.26,26,Medium-Low Digitalization,Small Course ( <15H )
5977,11,8,3,2018,1043,0.75,75,Medium-High Digitalization,Small Course ( <15H )
5978,59,33,26,2018,1043,0.56,56,Medium-High Digitalization,High Course ( >40H )
5979,53,20,33,2018,1043,0.38,38,Medium-Low Digitalization,High Course ( >40H )
5980,33,2,31,2018,1043,0.07,7,Low Digitalization,Medium Course ( >15H and <40H )
5981,31,20,11,2018,1043,0.65,65,Medium-High Digitalization,Medium Course ( >15H and <40H )
5982,8,6,2,2018,1043,0.71,71,Medium-High Digitalization,Small Course ( <15H )
5983,16,10,6,2018,1043,0.6,60,Medium-High Digitalization,Medium Course ( >15H and <40H )
5984,69,30,39,2018,1043,0.44,44,Medium-Low Digitalization,High Course ( >40H )
5985,11,2,9,2018,1043,0.16,16,Low Digitalization,Small Course ( <15H )
5986,13,10,3,2018,1043,0.8,80,Medium-High Digitalization,Small Course ( <15H )
5987,24,8,16,2018,1043,0.34,34,Medium-Low Digitalization,Medium Course ( >15H and <40H )
5988,70,37,33,2018,1043,0.53,53,Medium-High Digitalization,High Course ( >40H )
5989,6,3,3,2018,1043,0.57,56,Medium-High Digitalization,Small Course ( <15H )
5990,67,58,9,2018,1043,0.86,86,High Digitalization,High Course ( >40H )
5991,45,44,1,2018,1043,0.98,98,High Digitalization,High Course ( >40H )
5992,10,4,6,2018,1043,0.45,45,Medium-Low Digitalization,Small Course ( <15H )
5993,5,4,1,2018,1043,0.73,73,Medium-High Digitalization,Small Course ( <15H )
5994,42,20,22,2018,1043,0.47,47,Medium-Low Digitalization,High Course ( >40H )
5995,79,5,74,2018,1043,0.06,6,Low Digitalization,High Course ( >40H )
5996,72,22,50,2018,1043,0.31,31,Medium-Low Digitalization,High Course ( >40H )
5997,42,1,41,2018,1043,0.03,3,Low Digitalization,High Course ( >40H )
5998,83,35,48,2018,1043,0.42,42,Medium-Low Digitalization,High Course ( >40H )
5999,9,6,3,2018,1043,0.65,65,Medium-High Digitalization,Small Course ( <15H )
6000,13,9,4,2018,1043,0.72,72,Medium-High Digitalization,Small Course ( <15H )
6001,34,29,5,2018,1043,0.84,84,High Digitalization,Medium Course ( >15H and <40H )
6002,45,17,28,2018,1043,0.37,37,Medium-Low Digitalization,High Course ( >40H )
6003,22,17,5,2018,1043,0.77,77,Medium-High Digitalization,Medium Course ( >15H and <40H )
6004,78,23,55,2018,1043,0.3,30,Medium-Low Digitalization,High Course ( >40H )
6005,18,16,2,2018,1043,0.91,91,High Digitalization,Medium Course ( >15H and <40H )
6006,12,4,8,2018,1043,0.33,33,Medium-Low Digitalization,Small Course ( <15H )
6007,20,8,12,2018,1043,0.39,39,Medium-Low Digitalization,Medium Course ( >15H and <40H )
6008,79,66,13,2018,1043,0.84,84,High Digitalization,High Course ( >40H )
6009,82,28,54,2018,1043,0.34,34,Medium-Low Digitalization,High Course ( >40H )
6010,47,16,31,2018,1043,0.35,35,Medium-Low Digitalization,High Course ( >40H )
6011,7,3,4,2018,1043,0.48,48,Medium-Low Digitalization,Small Course ( <15H )
6012,57,4,53,2018,1043,0.07,7,Low Digitalization,High Course ( >40H )
6013,42,2,40,2018,1043,0.04,4,Low Digitalization,High Course ( >40H )
6014,12,10,2,2018,1043,0.84,84,High Digitalization,Small Course ( <15H )
6015,62,23,39,2018,1043,0.37,37,Medium-Low Digitalization,High Course ( >40H )
6016,21,12,9,2018,1043,0.58,57,Medium-High Digitalization,Medium Course ( >15H and <40H )
6017,62,1,61,2018,1043,0.02,2,Low Digitalization,High Course ( >40H )
6018,70,27,43,2018,1043,0.39,39,Medium-Low Digitalization,High Course ( >40H )
6019,51,32,19,2018,1043,0.62,62,Medium-High Digitalization,High Course ( >40H )
6020,7,0,7,2018,1043,0.05,5,Low Digitalization,Small Course ( <15H )
6021,7,1,6,2018,1043,0.08,8,Low Digitalization,Small Course ( <15H )
6022,60,24,36,2018,1043,0.4,40,Medium-Low Digitalization,High Course ( >40H )
6023,56,38,18,2018,1043,0.68,68,Medium-High Digitalization,High Course ( >40H )
6024,90,58,32,2018,1043,0.64,64,Medium-High Digitalization,High Course ( >40H )
6025,23,7,16,2018,1043,0.29,28,Medium-Low Digitalization,Medium Course ( >15H and <40H )
6026,29,3,26,2018,1043,0.12,12,Low Digitalization,Medium Course ( >15H and <40H )
6027,31,29,2,2018,1043,0.93,93,High Digitalization,Medium Course ( >15H and <40H )
6028,38,4,34,2018,1043,0.11,11,Low Digitalization,Medium Course ( >15H and <40H )
6029,36,33,3,2018,1043,0.93,93,High Digitalization,Medium Course ( >15H and <40H )
6030,35,32,3,2018,1043,0.92,92,High Digitalization,Medium Course ( >15H and <40H )
6031,38,4,34,2018,1043,0.1,10,Low Digitalization,Medium Course ( >15H and <40H )
6032,60,3,57,2018,1043,0.05,5,Low Digitalization,High Course ( >40H )
6033,40,19,21,2018,1043,0.48,48,Medium-Low Digitalization,High Course ( >40H )
6034,8,4,4,2018,1043,0.45,45,Medium-Low Digitalization,Small Course ( <15H )
6035,14,12,2,2018,1043,0.86,86,High Digitalization,Small Course ( <15H )
6036,6,3,3,2018,1043,0.53,53,Medium-High Digitalization,Small Course ( <15H )
6037,5,4,1,2018,1043,0.73,73,Medium-High Digitalization,Small Course ( <15H )
6038,9,4,5,2018,1043,0.39,39,Medium-Low Digitalization,Small Course ( <15H )
6039,56,49,7,2018,1043,0.88,88,High Digitalization,High Course ( >40H )
6040,5,0,5,2018,1043,0.04,4,Low Digitalization,Small Course ( <15H )
6041,6,4,2,2018,1043,0.69,69,Medium-High Digitalization,Small Course ( <15H )
6042,7,1,6,2018,1043,0.13,13,Low Digitalization,Small Course ( <15H )
6043,13,2,11,2018,1043,0.18,18,Low Digitalization,Small Course ( <15H )
6044,65,11,54,2018,1043,0.17,17,Low Digitalization,High Course ( >40H )
6045,74,53,21,2018,1043,0.72,72,Medium-High Digitalization,High Course ( >40H )
6046,8,1,7,2018,1043,0.13,13,Low Digitalization,Small Course ( <15H )
6047,79,78,1,2018,1043,0.99,99,High Digitalization,High Course ( >40H )
6048,26,22,4,2018,1043,0.86,86,High Digitalization,Medium Course ( >15H and <40H )
6049,11,6,5,2018,1043,0.56,56,Medium-High Digitalization,Small Course ( <15H )
6050,19,11,8,2018,1043,0.59,59,Medium-High Digitalization,Medium Course ( >15H and <40H )
6051,82,66,16,2018,1043,0.81,81,High Digitalization,High Course ( >40H )
6052,49,42,7,2018,1043,0.86,86,High Digitalization,High Course ( >40H )
6053,25,20,5,2018,1043,0.8,80,Medium-High Digitalization,Medium Course ( >15H and <40H )
6054,48,4,44,2018,1043,0.08,8,Low Digitalization,High Course ( >40H )
6055,37,9,28,2018,1043,0.23,23,Medium-Low Digitalization,Medium Course ( >15H and <40H )
6056,59,3,56,2018,1043,0.05,5,Low Digitalization,High Course ( >40H )
6057,55,22,33,2018,1043,0.4,40,Medium-Low Digitalization,High Course ( >40H )
6058,77,75,2,2018,1043,0.98,98,High Digitalization,High Course ( >40H )
6059,33,30,3,2018,1043,0.9,90,High Digitalization,Medium Course ( >15H and <40H )
6060,11,6,5,2018,1043,0.56,56,Medium-High Digitalization,Small Course ( <15H )
6061,51,15,36,2018,1043,0.29,28,Medium-Low Digitalization,High Course ( >40H )
6062,24,22,2,2018,1043,0.9,90,High Digitalization,Medium Course ( >15H and <40H )
6063,34,34,0,2018,1043,0.99,99,High Digitalization,Medium Course ( >15H and <40H )
6064,56,29,27,2018,1043,0.51,51,Medium-High Digitalization,High Course ( >40H )
6065,54,14,40,2018,1043,0.25,25,Medium-Low Digitalization,High Course ( >40H )
6066,6,2,4,2018,1043,0.31,31,Medium-Low Digitalization,Small Course ( <15H )
6067,78,49,29,2018,1043,0.63,63,Medium-High Digitalization,High Course ( >40H )
6068,41,19,22,2018,1043,0.46,46,Medium-Low Digitalization,High Course ( >40H )
6069,54,30,24,2018,1043,0.56,56,Medium-High Digitalization,High Course ( >40H )
6070,11,7,4,2018,1043,0.64,64,Medium-High Digitalization,Small Course ( <15H )
6071,35,0,35,2018,1043,0.0,0,Low Digitalization,Medium Course ( >15H and <40H )
6072,8,5,3,2018,1043,0.59,59,Medium-High Digitalization,Small Course ( <15H )
6073,35,25,10,2018,1043,0.71,71,Medium-High Digitalization,Medium Course ( >15H and <40H )
6074,50,14,36,2018,1043,0.28,28,Medium-Low Digitalization,High Course ( >40H )
6075,24,20,4,2018,1043,0.83,83,High Digitalization,Medium Course ( >15H and <40H )
6076,10,5,5,2018,1043,0.51,51,Medium-High Digitalization,Small Course ( <15H )
6077,35,32,3,2018,1043,0.91,91,High Digitalization,Medium Course ( >15H and <40H )
6078,84,55,29,2018,1043,0.66,66,Medium-High Digitalization,High Course ( >40H )
6079,69,59,10,2018,1043,0.86,86,High Digitalization,High Course ( >40H )
6080,78,37,41,2018,1043,0.47,47,Medium-Low Digitalization,High Course ( >40H )
6081,10,2,8,2018,1043,0.24,24,Medium-Low Digitalization,Small Course ( <15H )
6082,84,58,26,2018,1043,0.69,69,Medium-High Digitalization,High Course ( >40H )
6083,54,37,17,2018,1043,0.69,69,Medium-High Digitalization,High Course ( >40H )
6084,71,38,33,2018,1043,0.54,54,Medium-High Digitalization,High Course ( >40H )
6085,18,17,1,2018,1043,0.93,93,High Digitalization,Medium Course ( >15H and <40H )
6086,11,7,4,2018,1043,0.65,65,Medium-High Digitalization,Small Course ( <15H )
6087,14,11,3,2018,1043,0.78,78,Medium-High Digitalization,Small Course ( <15H )
6088,6,3,3,2018,1043,0.54,54,Medium-High Digitalization,Small Course ( <15H )
6089,11,6,6,2018,1043,0.5,50,Medium-Low Digitalization,Small Course ( <15H )
6090,11,2,9,2018,1043,0.2,20,Low Digitalization,Small Course ( <15H )
6091,38,18,20,2018,1043,0.47,47,Medium-Low Digitalization,Medium Course ( >15H and <40H )
6092,10,3,7,2018,1043,0.26,26,Medium-Low Digitalization,Small Course ( <15H )
6093,27,23,4,2018,1043,0.87,87,High Digitalization,Medium Course ( >15H and <40H )
6094,23,15,8,2018,1043,0.65,65,Medium-High Digitalization,Medium Course ( >15H and <40H )
6095,48,19,29,2018,1043,0.39,39,Medium-Low Digitalization,High Course ( >40H )
6096,8,3,5,2018,1043,0.36,36,Medium-Low Digitalization,Small Course ( <15H )
6097,57,32,25,2018,1043,0.56,56,Medium-High Digitalization,High Course ( >40H )
6098,8,6,2,2018,1043,0.73,73,Medium-High Digitalization,Small Course ( <15H )
6099,13,10,3,2018,1043,0.79,79,Medium-High Digitalization,Small Course ( <15H )
6100,5,0,5,2018,1043,0.0,0,Low Digitalization,Small Course ( <15H )
6101,40,15,25,2018,1043,0.38,38,Medium-Low Digitalization,High Course ( >40H )
6102,17,10,7,2018,1043,0.59,59,Medium-High Digitalization,Medium Course ( >15H and <40H )
6103,6,6,0,2018,1043,0.92,92,High Digitalization,Small Course ( <15H )
6104,51,13,38,2018,1043,0.26,26,Medium-Low Digitalization,High Course ( >40H )
6105,39,32,7,2018,1043,0.82,82,High Digitalization,Medium Course ( >15H and <40H )
6106,70,69,1,2018,1043,0.99,99,High Digitalization,High Course ( >40H )
6107,12,1,11,2018,1043,0.12,12,Low Digitalization,Small Course ( <15H )
6108,86,33,53,2018,1043,0.38,38,Medium-Low Digitalization,High Course ( >40H )
6109,25,12,12,2018,1043,0.5,50,Medium-Low Digitalization,Medium Course ( >15H and <40H )
6110,48,32,16,2018,1043,0.67,67,Medium-High Digitalization,High Course ( >40H )
6111,25,14,11,2018,1043,0.58,57,Medium-High Digitalization,Medium Course ( >15H and <40H )
6112,47,13,34,2018,1043,0.27,27,Medium-Low Digitalization,High Course ( >40H )
6113,69,37,32,2018,1043,0.54,54,Medium-High Digitalization,High Course ( >40H )
6114,66,33,33,2018,1043,0.5,50,Medium-Low Digitalization,High Course ( >40H )
6115,35,32,3,2018,1043,0.91,91,High Digitalization,Medium Course ( >15H and <40H )
6116,5,2,3,2018,1043,0.32,32,Medium-Low Digitalization,Small Course ( <15H )
6117,10,7,3,2018,1043,0.7,70,Medium-High Digitalization,Small Course ( <15H )
6118,8,8,0,2018,1043,1.0,100,High Digitalization,Small Course ( <15H )
6119,8,2,6,2018,1043,0.25,25,Medium-Low Digitalization,Small Course ( <15H )
6120,66,45,21,2018,1043,0.68,68,Medium-High Digitalization,High Course ( >40H )
6121,48,37,11,2018,1043,0.78,78,Medium-High Digitalization,High Course ( >40H )
6122,60,40,20,2018,1043,0.67,67,Medium-High Digitalization,High Course ( >40H )
6123,56,44,12,2018,1043,0.78,78,Medium-High Digitalization,High Course ( >40H )
6124,7,2,5,2018,1043,0.22,22,Medium-Low Digitalization,Small Course ( <15H )
6125,10,1,9,2018,1043,0.07,7,Low Digitalization,Small Course ( <15H )
6126,20,7,13,2018,1043,0.33,33,Medium-Low Digitalization,Medium Course ( >15H and <40H )
6127,9,8,1,2018,1043,0.84,84,High Digitalization,Small Course ( <15H )
6128,9,5,4,2018,1043,0.61,61,Medium-High Digitalization,Small Course ( <15H )
6129,20,18,2,2018,1043,0.88,88,High Digitalization,Medium Course ( >15H and <40H )
6130,8,7,1,2018,1043,0.86,86,High Digitalization,Small Course ( <15H )
6131,35,20,15,2018,1043,0.56,56,Medium-High Digitalization,Medium Course ( >15H and <40H )
6132,21,11,10,2018,1043,0.53,53,Medium-High Digitalization,Medium Course ( >15H and <40H )
6133,43,15,28,2018,1043,0.35,35,Medium-Low Digitalization,High Course ( >40H )
6134,87,43,44,2018,1043,0.49,49,Medium-Low Digitalization,High Course ( >40H )
6135,16,3,13,2018,1043,0.2,20,Low Digitalization,Medium Course ( >15H and <40H )
6136,23,8,15,2018,1043,0.35,35,Medium-Low Digitalization,Medium Course ( >15H and <40H )
6137,40,11,29,2018,1043,0.27,27,Medium-Low Digitalization,High Course ( >40H )
6138,15,4,11,2018,1043,0.28,28,Medium-Low Digitalization,Small Course ( <15H )
6139,33,22,11,2018,1043,0.68,68,Medium-High Digitalization,Medium Course ( >15H and <40H )
6140,38,29,9,2018,1043,0.76,76,Medium-High Digitalization,Medium Course ( >15H and <40H )
6141,25,1,24,2018,1043,0.04,4,Low Digitalization,Medium Course ( >15H and <40H )
6142,28,18,10,2018,1043,0.65,65,Medium-High Digitalization,Medium Course ( >15H and <40H )
6143,15,6,9,2018,1043,0.43,43,Medium-Low Digitalization,Small Course ( <15H )
6144,53,46,7,2018,1043,0.86,86,High Digitalization,High Course ( >40H )
6145,10,6,4,2018,1043,0.65,65,Medium-High Digitalization,Small Course ( <15H )
6146,22,1,21,2018,1043,0.05,5,Low Digitalization,Medium Course ( >15H and <40H )
6147,46,23,23,2018,1043,0.5,50,Medium-Low Digitalization,High Course ( >40H )
6148,21,9,12,2018,1043,0.43,43,Medium-Low Digitalization,Medium Course ( >15H and <40H )
6149,10,4,6,2018,1043,0.37,37,Medium-Low Digitalization,Small Course ( <15H )
6150,8,3,5,2018,1043,0.39,39,Medium-Low Digitalization,Small Course ( <15H )
6151,29,10,19,2018,1043,0.33,33,Medium-Low Digitalization,Medium Course ( >15H and <40H )
6152,39,9,30,2018,1043,0.23,23,Medium-Low Digitalization,Medium Course ( >15H and <40H )
6153,56,50,6,2018,1043,0.89,89,High Digitalization,High Course ( >40H )
6154,5,2,3,2018,1043,0.34,34,Medium-Low Digitalization,Small Course ( <15H )
6155,52,40,12,2018,1043,0.77,77,Medium-High Digitalization,High Course ( >40H )
6156,40,14,26,2018,1043,0.35,35,Medium-Low Digitalization,High Course ( >40H )
6157,8,5,3,2018,1043,0.67,67,Medium-High Digitalization,Small Course ( <15H )
6158,57,19,38,2018,1043,0.33,33,Medium-Low Digitalization,High Course ( >40H )
6159,15,15,0,2018,1043,1.0,100,High Digitalization,Small Course ( <15H )
6160,88,53,35,2018,1043,0.6,60,Medium-High Digitalization,High Course ( >40H )
6161,53,5,48,2018,1043,0.1,10,Low Digitalization,High Course ( >40H )
6162,36,35,1,2018,1043,0.96,96,High Digitalization,Medium Course ( >15H and <40H )
6163,69,66,3,2018,1043,0.96,96,High Digitalization,High Course ( >40H )
6164,5,2,3,2018,1043,0.34,34,Medium-Low Digitalization,Small Course ( <15H )
6165,36,24,12,2018,1043,0.67,67,Medium-High Digitalization,Medium Course ( >15H and <40H )
6166,33,6,27,2018,1043,0.18,18,Low Digitalization,Medium Course ( >15H and <40H )
6167,15,13,2,2018,1043,0.88,88,High Digitalization,Small Course ( <15H )
6168,5,2,3,2018,1043,0.32,32,Medium-Low Digitalization,Small Course ( <15H )
6169,50,22,28,2018,1043,0.44,44,Medium-Low Digitalization,High Course ( >40H )
6170,13,13,0,2018,1043,0.99,99,High Digitalization,Small Course ( <15H )
6171,45,43,2,2018,1043,0.96,96,High Digitalization,High Course ( >40H )
6172,15,6,9,2018,1043,0.39,39,Medium-Low Digitalization,Small Course ( <15H )
6173,8,8,0,2018,1043,0.97,97,High Digitalization,Small Course ( <15H )
6174,25,24,1,2018,1043,0.97,97,High Digitalization,Medium Course ( >15H and <40H )
6175,7,0,7,2018,1043,0.04,4,Low Digitalization,Small Course ( <15H )
6176,19,8,11,2018,1043,0.42,42,Medium-Low Digitalization,Medium Course ( >15H and <40H )
6177,48,45,3,2018,1043,0.93,93,High Digitalization,High Course ( >40H )
6178,8,1,7,2018,1043,0.16,16,Low Digitalization,Small Course ( <15H )
6179,26,13,13,2018,1043,0.51,51,Medium-High Digitalization,Medium Course ( >15H and <40H )
6180,63,23,40,2018,1043,0.37,37,Medium-Low Digitalization,High Course ( >40H )
6181,57,54,3,2018,1043,0.94,94,High Digitalization,High Course ( >40H )
6182,11,6,6,2018,1043,0.5,50,Medium-Low Digitalization,Small Course ( <15H )
6183,14,9,5,2018,1043,0.61,61,Medium-High Digitalization,Small Course ( <15H )
6184,10,3,7,2018,1043,0.27,27,Medium-Low Digitalization,Small Course ( <15H )
6185,60,5,55,2018,1043,0.09,9,Low Digitalization,High Course ( >40H )
6186,25,16,8,2018,1043,0.66,66,Medium-High Digitalization,Medium Course ( >15H and <40H )
6187,58,55,3,2018,1043,0.95,95,High Digitalization,High Course ( >40H )
6188,89,6,83,2018,1043,0.07,7,Low Digitalization,High Course ( >40H )
6189,68,0,68,2018,1043,0.0,0,Low Digitalization,High Course ( >40H )
6190,15,5,10,2018,1043,0.33,33,Medium-Low Digitalization,Small Course ( <15H )
6191,28,1,27,2018,1043,0.04,4,Low Digitalization,Medium Course ( >15H and <40H )
6192,28,19,9,2018,1043,0.68,68,Medium-High Digitalization,Medium Course ( >15H and <40H )
6193,9,5,4,2018,1043,0.55,55,Medium-High Digitalization,Small Course ( <15H )
6194,12,6,6,2018,1043,0.49,49,Medium-Low Digitalization,Small Course ( <15H )
6195,54,46,8,2018,1043,0.85,85,High Digitalization,High Course ( >40H )
6196,84,32,52,2018,1043,0.38,38,Medium-Low Digitalization,High Course ( >40H )
6197,11,8,3,2018,1043,0.77,77,Medium-High Digitalization,Small Course ( <15H )
6198,37,0,37,2018,1043,0.0,0,Low Digitalization,Medium Course ( >15H and <40H )
6199,44,4,40,2018,1043,0.09,9,Low Digitalization,High Course ( >40H )
6200,14,8,6,2018,1043,0.54,54,Medium-High Digitalization,Small Course ( <15H )
6201,8,5,3,2018,1043,0.58,57,Medium-High Digitalization,Small Course ( <15H )
6202,8,4,4,2018,1043,0.45,45,Medium-Low Digitalization,Small Course ( <15H )
6203,13,11,2,2018,1043,0.86,86,High Digitalization,Small Course ( <15H )
6204,55,22,33,2018,1043,0.4,40,Medium-Low Digitalization,High Course ( >40H )
6205,22,7,15,2018,1043,0.32,32,Medium-Low Digitalization,Medium Course ( >15H and <40H )
6206,60,4,56,2018,1043,0.07,7,Low Digitalization,High Course ( >40H )
6207,43,22,22,2018,1043,0.5,50,Medium-Low Digitalization,High Course ( >40H )
6208,60,46,14,2018,1043,0.77,77,Medium-High Digitalization,High Course ( >40H )
6209,6,0,6,2018,1043,0.0,0,Low Digitalization,Small Course ( <15H )
6210,52,19,33,2018,1043,0.36,36,Medium-Low Digitalization,High Course ( >40H )
6211,33,22,11,2018,1043,0.66,66,Medium-High Digitalization,Medium Course ( >15H and <40H )
6212,33,14,19,2018,1043,0.43,43,Medium-Low Digitalization,Medium Course ( >15H and <40H )
6213,29,21,8,2018,1043,0.73,73,Medium-High Digitalization,Medium Course ( >15H and <40H )
6214,52,6,46,2018,1043,0.12,12,Low Digitalization,High Course ( >40H )
6215,57,30,27,2018,1043,0.52,52,Medium-High Digitalization,High Course ( >40H )
6216,10,7,3,2018,1043,0.73,73,Medium-High Digitalization,Small Course ( <15H )
6217,29,14,15,2018,1043,0.48,48,Medium-Low Digitalization,Medium Course ( >15H and <40H )
6218,67,50,17,2018,1043,0.74,74,Medium-High Digitalization,High Course ( >40H )
6219,60,3,57,2018,1043,0.05,5,Low Digitalization,High Course ( >40H )
6220,39,21,18,2018,1043,0.55,55,Medium-High Digitalization,Medium Course ( >15H and <40H )
6221,32,8,24,2018,1043,0.24,24,Medium-Low Digitalization,Medium Course ( >15H and <40H )
6222,60,19,41,2018,1043,0.32,32,Medium-Low Digitalization,High Course ( >40H )
6223,9,6,3,2018,1043,0.65,65,Medium-High Digitalization,Small Course ( <15H )
6224,66,18,48,2018,1043,0.27,27,Medium-Low Digitalization,High Course ( >40H )
6225,34,5,29,2018,1043,0.15,15,Low Digitalization,Medium Course ( >15H and <40H )
6226,58,31,27,2018,1043,0.54,54,Medium-High Digitalization,High Course ( >40H )
6227,67,25,42,2018,1043,0.37,37,Medium-Low Digitalization,High Course ( >40H )
6228,60,19,41,2018,1043,0.31,31,Medium-Low Digitalization,High Course ( >40H )
6229,5,3,2,2018,1043,0.51,51,Medium-High Digitalization,Small Course ( <15H )
6230,52,24,28,2018,1043,0.47,47,Medium-Low Digitalization,High Course ( >40H )
6231,82,35,47,2018,1043,0.43,43,Medium-Low Digitalization,High Course ( >40H )
6232,30,25,5,2018,1043,0.84,84,High Digitalization,Medium Course ( >15H and <40H )
6233,22,8,14,2018,1043,0.35,35,Medium-Low Digitalization,Medium Course ( >15H and <40H )
6234,15,1,14,2018,1043,0.05,5,Low Digitalization,Small Course ( <15H )
6235,61,46,15,2018,1043,0.75,75,Medium-High Digitalization,High Course ( >40H )
6236,45,34,11,2018,1043,0.76,76,Medium-High Digitalization,High Course ( >40H )
6237,6,1,5,2018,1043,0.16,16,Low Digitalization,Small Course ( <15H )
6238,31,24,7,2018,1043,0.77,77,Medium-High Digitalization,Medium Course ( >15H and <40H )
6239,9,4,5,2018,1043,0.45,45,Medium-Low Digitalization,Small Course ( <15H )
6240,23,6,17,2018,1043,0.26,26,Medium-Low Digitalization,Medium Course ( >15H and <40H )
6241,51,17,34,2018,1043,0.34,34,Medium-Low Digitalization,High Course ( >40H )
6242,14,9,5,2018,1043,0.67,67,Medium-High Digitalization,Small Course ( <15H )
6243,56,38,18,2018,1043,0.68,68,Medium-High Digitalization,High Course ( >40H )
6244,14,5,9,2018,1043,0.38,38,Medium-Low Digitalization,Small Course ( <15H )
6245,10,9,1,2018,1043,0.92,92,High Digitalization,Small Course ( <15H )
6246,34,12,22,2018,1043,0.35,35,Medium-Low Digitalization,Medium Course ( >15H and <40H )
6247,27,5,22,2019,1084,0.18,18,Low Digitalization,Medium Course ( >15H and <40H )
6248,12,1,11,2019,1084,0.05,5,Low Digitalization,Small Course ( <15H )
6249,25,8,17,2019,1084,0.32,32,Medium-Low Digitalization,Medium Course ( >15H and <40H )
6250,9,0,9,2019,1084,0.03,3,Low Digitalization,Small Course ( <15H )
6251,85,48,37,2019,1084,0.57,56,Medium-High Digitalization,High Course ( >40H )
6252,11,2,9,2019,1084,0.19,19,Low Digitalization,Small Course ( <15H )
6253,6,2,4,2019,1084,0.32,32,Medium-Low Digitalization,Small Course ( <15H )
6254,73,34,39,2019,1084,0.46,46,Medium-Low Digitalization,High Course ( >40H )
6255,7,0,7,2019,1084,0.0,0,Low Digitalization,Small Course ( <15H )
6256,45,19,26,2019,1084,0.43,43,Medium-Low Digitalization,High Course ( >40H )
6257,13,11,2,2019,1084,0.81,81,High Digitalization,Small Course ( <15H )
6258,6,4,2,2019,1084,0.74,74,Medium-High Digitalization,Small Course ( <15H )
6259,51,37,14,2019,1084,0.72,72,Medium-High Digitalization,High Course ( >40H )
6260,5,4,1,2019,1084,0.82,82,High Digitalization,Small Course ( <15H )
6261,86,32,54,2019,1084,0.37,37,Medium-Low Digitalization,High Course ( >40H )
6262,33,10,23,2019,1084,0.29,28,Medium-Low Digitalization,Medium Course ( >15H and <40H )
6263,74,4,70,2019,1084,0.05,5,Low Digitalization,High Course ( >40H )
6264,22,4,18,2019,1084,0.2,20,Low Digitalization,Medium Course ( >15H and <40H )
6265,66,40,26,2019,1084,0.6,60,Medium-High Digitalization,High Course ( >40H )
6266,7,5,2,2019,1084,0.76,76,Medium-High Digitalization,Small Course ( <15H )
6267,12,8,4,2019,1084,0.67,67,Medium-High Digitalization,Small Course ( <15H )
6268,60,10,50,2019,1084,0.17,17,Low Digitalization,High Course ( >40H )
6269,40,12,28,2019,1084,0.3,30,Medium-Low Digitalization,High Course ( >40H )
6270,7,7,0,2019,1084,0.99,99,High Digitalization,Small Course ( <15H )
6271,12,2,10,2019,1084,0.15,15,Low Digitalization,Small Course ( <15H )
6272,43,29,14,2019,1084,0.67,67,Medium-High Digitalization,High Course ( >40H )
6273,51,18,33,2019,1084,0.35,35,Medium-Low Digitalization,High Course ( >40H )
6274,13,6,7,2019,1084,0.48,48,Medium-Low Digitalization,Small Course ( <15H )
6275,6,3,3,2019,1084,0.54,54,Medium-High Digitalization,Small Course ( <15H )
6276,48,18,30,2019,1084,0.37,37,Medium-Low Digitalization,High Course ( >40H )
6277,6,0,6,2019,1084,0.06,6,Low Digitalization,Small Course ( <15H )
6278,90,20,70,2019,1084,0.22,22,Medium-Low Digitalization,High Course ( >40H )
6279,10,3,7,2019,1084,0.27,27,Medium-Low Digitalization,Small Course ( <15H )
6280,76,16,60,2019,1084,0.21,21,Medium-Low Digitalization,High Course ( >40H )
6281,75,40,34,2019,1084,0.54,54,Medium-High Digitalization,High Course ( >40H )
6282,52,31,21,2019,1084,0.6,60,Medium-High Digitalization,High Course ( >40H )
6283,7,0,7,2019,1084,0.06,6,Low Digitalization,Small Course ( <15H )
6284,48,44,4,2019,1084,0.91,91,High Digitalization,High Course ( >40H )
6285,11,10,1,2019,1084,0.93,93,High Digitalization,Small Course ( <15H )
6286,10,6,4,2019,1084,0.63,63,Medium-High Digitalization,Small Course ( <15H )
6287,29,18,11,2019,1084,0.61,61,Medium-High Digitalization,Medium Course ( >15H and <40H )
6288,11,5,6,2019,1084,0.44,44,Medium-Low Digitalization,Small Course ( <15H )
6289,21,4,17,2019,1084,0.17,17,Low Digitalization,Medium Course ( >15H and <40H )
6290,17,4,13,2019,1084,0.23,23,Medium-Low Digitalization,Medium Course ( >15H and <40H )
6291,73,15,58,2019,1084,0.2,20,Low Digitalization,High Course ( >40H )
6292,28,25,3,2019,1084,0.9,90,High Digitalization,Medium Course ( >15H and <40H )
6293,73,39,34,2019,1084,0.53,53,Medium-High Digitalization,High Course ( >40H )
6294,65,14,51,2019,1084,0.22,22,Medium-Low Digitalization,High Course ( >40H )
6295,59,19,40,2019,1084,0.32,32,Medium-Low Digitalization,High Course ( >40H )
6296,63,34,29,2019,1084,0.54,54,Medium-High Digitalization,High Course ( >40H )
6297,45,20,25,2019,1084,0.45,45,Medium-Low Digitalization,High Course ( >40H )
6298,48,3,45,2019,1084,0.06,6,Low Digitalization,High Course ( >40H )
6299,32,1,31,2019,1084,0.02,2,Low Digitalization,Medium Course ( >15H and <40H )
6300,86,29,57,2019,1084,0.34,34,Medium-Low Digitalization,High Course ( >40H )
6301,20,17,3,2019,1084,0.87,87,High Digitalization,Medium Course ( >15H and <40H )
6302,81,16,65,2019,1084,0.2,20,Low Digitalization,High Course ( >40H )
6303,15,15,0,2019,1084,1.0,100,High Digitalization,Small Course ( <15H )
6304,65,38,27,2019,1084,0.58,57,Medium-High Digitalization,High Course ( >40H )
6305,70,6,64,2019,1084,0.09,9,Low Digitalization,High Course ( >40H )
6306,14,11,3,2019,1084,0.8,80,Medium-High Digitalization,Small Course ( <15H )
6307,12,6,6,2019,1084,0.46,46,Medium-Low Digitalization,Small Course ( <15H )
6308,72,55,17,2019,1084,0.76,76,Medium-High Digitalization,High Course ( >40H )
6309,52,7,45,2019,1084,0.14,14,Low Digitalization,High Course ( >40H )
6310,9,4,5,2019,1084,0.46,46,Medium-Low Digitalization,Small Course ( <15H )
6311,44,6,38,2019,1084,0.13,13,Low Digitalization,High Course ( >40H )
6312,39,8,31,2019,1084,0.2,20,Low Digitalization,Medium Course ( >15H and <40H )
6313,13,5,8,2019,1084,0.39,39,Medium-Low Digitalization,Small Course ( <15H )
6314,78,73,5,2019,1084,0.94,94,High Digitalization,High Course ( >40H )
6315,51,46,5,2019,1084,0.91,91,High Digitalization,High Course ( >40H )
6316,10,9,1,2019,1084,0.87,87,High Digitalization,Small Course ( <15H )
6317,75,1,74,2019,1084,0.01,1,Low Digitalization,High Course ( >40H )
6318,37,25,12,2019,1084,0.67,67,Medium-High Digitalization,Medium Course ( >15H and <40H )
6319,44,15,29,2019,1084,0.35,35,Medium-Low Digitalization,High Course ( >40H )
6320,8,6,2,2019,1084,0.78,78,Medium-High Digitalization,Small Course ( <15H )
6321,78,43,35,2019,1084,0.55,55,Medium-High Digitalization,High Course ( >40H )
6322,18,6,12,2019,1084,0.32,32,Medium-Low Digitalization,Medium Course ( >15H and <40H )
6323,40,26,14,2019,1084,0.66,66,Medium-High Digitalization,High Course ( >40H )
6324,48,13,35,2019,1084,0.28,28,Medium-Low Digitalization,High Course ( >40H )
6325,84,71,13,2019,1084,0.85,85,High Digitalization,High Course ( >40H )
6326,77,66,11,2019,1084,0.86,86,High Digitalization,High Course ( >40H )
6327,85,50,35,2019,1084,0.59,59,Medium-High Digitalization,High Course ( >40H )
6328,7,7,0,2019,1084,0.93,93,High Digitalization,Small Course ( <15H )
6329,29,17,12,2019,1084,0.58,57,Medium-High Digitalization,Medium Course ( >15H and <40H )
6330,80,38,42,2019,1084,0.48,48,Medium-Low Digitalization,High Course ( >40H )
6331,15,13,2,2019,1084,0.86,86,High Digitalization,Small Course ( <15H )
6332,6,1,5,2019,1084,0.24,24,Medium-Low Digitalization,Small Course ( <15H )
6333,13,7,6,2019,1084,0.54,54,Medium-High Digitalization,Small Course ( <15H )
6334,84,77,7,2019,1084,0.92,92,High Digitalization,High Course ( >40H )
6335,14,4,10,2019,1084,0.32,32,Medium-Low Digitalization,Small Course ( <15H )
6336,72,4,68,2019,1084,0.05,5,Low Digitalization,High Course ( >40H )
6337,15,2,13,2019,1084,0.13,13,Low Digitalization,Small Course ( <15H )
6338,44,18,26,2019,1084,0.4,40,Medium-Low Digitalization,High Course ( >40H )
6339,20,2,18,2019,1084,0.09,9,Low Digitalization,Medium Course ( >15H and <40H )
6340,7,5,2,2019,1084,0.67,67,Medium-High Digitalization,Small Course ( <15H )
6341,5,0,5,2019,1084,0.05,5,Low Digitalization,Small Course ( <15H )
6342,81,21,60,2019,1084,0.26,26,Medium-Low Digitalization,High Course ( >40H )
6343,10,6,4,2019,1084,0.55,55,Medium-High Digitalization,Small Course ( <15H )
6344,22,1,21,2019,1084,0.06,6,Low Digitalization,Medium Course ( >15H and <40H )
6345,7,5,2,2019,1084,0.75,75,Medium-High Digitalization,Small Course ( <15H )
6346,7,6,1,2019,1084,0.8,80,Medium-High Digitalization,Small Course ( <15H )
6347,20,0,20,2019,1084,0.02,2,Low Digitalization,Medium Course ( >15H and <40H )
6348,47,29,18,2019,1084,0.61,61,Medium-High Digitalization,High Course ( >40H )
6349,22,3,19,2019,1084,0.14,14,Low Digitalization,Medium Course ( >15H and <40H )
6350,89,69,20,2019,1084,0.77,77,Medium-High Digitalization,High Course ( >40H )
6351,12,7,5,2019,1084,0.58,57,Medium-High Digitalization,Small Course ( <15H )
6352,6,3,3,2019,1084,0.45,45,Medium-Low Digitalization,Small Course ( <15H )
6353,43,13,30,2019,1084,0.3,30,Medium-Low Digitalization,High Course ( >40H )
6354,85,39,46,2019,1084,0.46,46,Medium-Low Digitalization,High Course ( >40H )
6355,60,45,15,2019,1084,0.75,75,Medium-High Digitalization,High Course ( >40H )
6356,34,22,12,2019,1084,0.66,66,Medium-High Digitalization,Medium Course ( >15H and <40H )
6357,8,7,1,2019,1084,0.87,87,High Digitalization,Small Course ( <15H )
6358,20,9,11,2019,1084,0.45,45,Medium-Low Digitalization,Medium Course ( >15H and <40H )
6359,81,42,39,2019,1084,0.52,52,Medium-High Digitalization,High Course ( >40H )
6360,5,2,3,2019,1084,0.43,43,Medium-Low Digitalization,Small Course ( <15H )
6361,59,4,55,2019,1084,0.06,6,Low Digitalization,High Course ( >40H )
6362,19,2,17,2019,1084,0.12,12,Low Digitalization,Medium Course ( >15H and <40H )
6363,42,7,35,2019,1084,0.16,16,Low Digitalization,High Course ( >40H )
6364,77,2,75,2019,1084,0.03,3,Low Digitalization,High Course ( >40H )
6365,9,2,7,2019,1084,0.22,22,Medium-Low Digitalization,Small Course ( <15H )
6366,71,62,9,2019,1084,0.88,88,High Digitalization,High Course ( >40H )
6367,5,1,4,2019,1084,0.19,19,Low Digitalization,Small Course ( <15H )
6368,32,3,29,2019,1084,0.1,10,Low Digitalization,Medium Course ( >15H and <40H )
6369,40,33,7,2019,1084,0.83,83,High Digitalization,High Course ( >40H )
6370,8,2,6,2019,1084,0.23,23,Medium-Low Digitalization,Small Course ( <15H )
6371,82,31,51,2019,1084,0.38,38,Medium-Low Digitalization,High Course ( >40H )
6372,38,10,28,2019,1084,0.27,27,Medium-Low Digitalization,Medium Course ( >15H and <40H )
6373,5,5,0,2019,1084,0.94,94,High Digitalization,Small Course ( <15H )
6374,13,10,3,2019,1084,0.76,76,Medium-High Digitalization,Small Course ( <15H )
6375,27,13,14,2019,1084,0.48,48,Medium-Low Digitalization,Medium Course ( >15H and <40H )
6376,5,2,3,2019,1084,0.46,46,Medium-Low Digitalization,Small Course ( <15H )
6377,31,29,2,2019,1084,0.92,92,High Digitalization,Medium Course ( >15H and <40H )
6378,11,0,11,2019,1084,0.03,3,Low Digitalization,Small Course ( <15H )
6379,25,17,8,2019,1084,0.68,68,Medium-High Digitalization,Medium Course ( >15H and <40H )
6380,45,35,10,2019,1084,0.78,78,Medium-High Digitalization,High Course ( >40H )
6381,62,17,45,2019,1084,0.27,27,Medium-Low Digitalization,High Course ( >40H )
6382,90,59,31,2019,1084,0.66,66,Medium-High Digitalization,High Course ( >40H )
6383,46,17,29,2019,1084,0.37,37,Medium-Low Digitalization,High Course ( >40H )
6384,88,74,14,2019,1084,0.84,84,High Digitalization,High Course ( >40H )
6385,33,12,21,2019,1084,0.36,36,Medium-Low Digitalization,Medium Course ( >15H and <40H )
6386,14,3,11,2019,1084,0.21,21,Medium-Low Digitalization,Small Course ( <15H )
6387,75,4,70,2019,1084,0.06,6,Low Digitalization,High Course ( >40H )
6388,20,15,5,2019,1084,0.77,77,Medium-High Digitalization,Medium Course ( >15H and <40H )
6389,24,9,15,2019,1084,0.38,38,Medium-Low Digitalization,Medium Course ( >15H and <40H )
6390,7,5,2,2019,1084,0.72,72,Medium-High Digitalization,Small Course ( <15H )
6391,62,49,13,2019,1084,0.79,79,Medium-High Digitalization,High Course ( >40H )
6392,61,51,10,2019,1084,0.84,84,High Digitalization,High Course ( >40H )
6393,12,1,11,2019,1084,0.05,5,Low Digitalization,Small Course ( <15H )
6394,87,82,5,2019,1084,0.94,94,High Digitalization,High Course ( >40H )
6395,37,24,13,2019,1084,0.66,66,Medium-High Digitalization,Medium Course ( >15H and <40H )
6396,65,61,4,2019,1084,0.94,94,High Digitalization,High Course ( >40H )
6397,13,4,9,2019,1084,0.31,31,Medium-Low Digitalization,Small Course ( <15H )
6398,8,0,8,2019,1084,0.06,6,Low Digitalization,Small Course ( <15H )
6399,8,3,5,2019,1084,0.42,42,Medium-Low Digitalization,Small Course ( <15H )
6400,27,8,19,2019,1084,0.29,28,Medium-Low Digitalization,Medium Course ( >15H and <40H )
6401,19,8,11,2019,1084,0.4,40,Medium-Low Digitalization,Medium Course ( >15H and <40H )
6402,11,5,6,2019,1084,0.44,44,Medium-Low Digitalization,Small Course ( <15H )
6403,39,20,19,2019,1084,0.51,51,Medium-High Digitalization,Medium Course ( >15H and <40H )
6404,7,1,6,2019,1084,0.08,8,Low Digitalization,Small Course ( <15H )
6405,38,13,25,2019,1084,0.33,33,Medium-Low Digitalization,Medium Course ( >15H and <40H )
6406,12,7,5,2019,1084,0.62,62,Medium-High Digitalization,Small Course ( <15H )
6407,6,4,2,2019,1084,0.68,68,Medium-High Digitalization,Small Course ( <15H )
6408,8,7,1,2019,1084,0.82,82,High Digitalization,Small Course ( <15H )
6409,39,28,11,2019,1084,0.71,71,Medium-High Digitalization,Medium Course ( >15H and <40H )
6410,36,27,9,2019,1084,0.75,75,Medium-High Digitalization,Medium Course ( >15H and <40H )
6411,55,39,16,2019,1084,0.71,71,Medium-High Digitalization,High Course ( >40H )
6412,38,34,4,2019,1084,0.9,90,High Digitalization,Medium Course ( >15H and <40H )
6413,48,20,28,2019,1084,0.41,41,Medium-Low Digitalization,High Course ( >40H )
6414,55,21,34,2019,1084,0.39,39,Medium-Low Digitalization,High Course ( >40H )
6415,31,18,13,2019,1084,0.59,59,Medium-High Digitalization,Medium Course ( >15H and <40H )
6416,81,68,13,2019,1084,0.84,84,High Digitalization,High Course ( >40H )
6417,29,23,6,2019,1084,0.78,78,Medium-High Digitalization,Medium Course ( >15H and <40H )
6418,8,3,5,2019,1084,0.39,39,Medium-Low Digitalization,Small Course ( <15H )
6419,11,8,3,2019,1084,0.71,71,Medium-High Digitalization,Small Course ( <15H )
6420,15,4,11,2019,1084,0.29,28,Medium-Low Digitalization,Small Course ( <15H )
6421,54,27,27,2019,1084,0.5,50,Medium-Low Digitalization,High Course ( >40H )
6422,33,23,10,2019,1084,0.71,71,Medium-High Digitalization,Medium Course ( >15H and <40H )
6423,28,22,6,2019,1084,0.8,80,Medium-High Digitalization,Medium Course ( >15H and <40H )
6424,28,2,26,2019,1084,0.07,7,Low Digitalization,Medium Course ( >15H and <40H )
6425,60,48,12,2019,1084,0.8,80,Medium-High Digitalization,High Course ( >40H )
6426,7,5,2,2019,1084,0.7,70,Medium-High Digitalization,Small Course ( <15H )
6427,12,7,5,2019,1084,0.61,61,Medium-High Digitalization,Small Course ( <15H )
6428,11,9,2,2019,1084,0.81,81,High Digitalization,Small Course ( <15H )
6429,20,18,2,2019,1084,0.92,92,High Digitalization,Medium Course ( >15H and <40H )
6430,47,7,40,2019,1084,0.15,15,Low Digitalization,High Course ( >40H )
6431,5,1,4,2019,1084,0.22,22,Medium-Low Digitalization,Small Course ( <15H )
6432,34,17,17,2019,1084,0.49,49,Medium-Low Digitalization,Medium Course ( >15H and <40H )
6433,12,6,6,2019,1084,0.49,49,Medium-Low Digitalization,Small Course ( <15H )
6434,36,15,21,2019,1084,0.41,41,Medium-Low Digitalization,Medium Course ( >15H and <40H )
6435,85,22,63,2019,1084,0.26,26,Medium-Low Digitalization,High Course ( >40H )
6436,71,69,2,2019,1084,0.97,97,High Digitalization,High Course ( >40H )
6437,15,15,0,2019,1084,0.98,98,High Digitalization,Small Course ( <15H )
6438,24,18,6,2019,1084,0.74,74,Medium-High Digitalization,Medium Course ( >15H and <40H )
6439,59,50,9,2019,1084,0.85,85,High Digitalization,High Course ( >40H )
6440,5,1,4,2019,1084,0.12,12,Low Digitalization,Small Course ( <15H )
6441,34,7,27,2019,1084,0.22,22,Medium-Low Digitalization,Medium Course ( >15H and <40H )
6442,47,38,9,2019,1084,0.81,81,High Digitalization,High Course ( >40H )
6443,7,6,1,2019,1084,0.8,80,Medium-High Digitalization,Small Course ( <15H )
6444,63,25,38,2019,1084,0.39,39,Medium-Low Digitalization,High Course ( >40H )
6445,67,5,62,2019,1084,0.07,7,Low Digitalization,High Course ( >40H )
6446,17,2,15,2019,1084,0.1,10,Low Digitalization,Medium Course ( >15H and <40H )
6447,24,20,4,2019,1084,0.83,83,High Digitalization,Medium Course ( >15H and <40H )
6448,26,25,1,2019,1084,0.96,96,High Digitalization,Medium Course ( >15H and <40H )
6449,32,30,2,2019,1084,0.94,94,High Digitalization,Medium Course ( >15H and <40H )
6450,87,25,62,2019,1084,0.29,28,Medium-Low Digitalization,High Course ( >40H )
6451,32,8,24,2019,1084,0.25,25,Medium-Low Digitalization,Medium Course ( >15H and <40H )
6452,15,13,2,2019,1084,0.85,85,High Digitalization,Small Course ( <15H )
6453,15,14,1,2019,1084,0.93,93,High Digitalization,Small Course ( <15H )
6454,30,20,10,2019,1084,0.68,68,Medium-High Digitalization,Medium Course ( >15H and <40H )
6455,5,1,4,2019,1084,0.28,28,Medium-Low Digitalization,Small Course ( <15H )
6456,21,16,5,2019,1084,0.77,77,Medium-High Digitalization,Medium Course ( >15H and <40H )
6457,74,25,49,2019,1084,0.34,34,Medium-Low Digitalization,High Course ( >40H )
6458,12,0,12,2019,1084,0.0,0,Low Digitalization,Small Course ( <15H )
6459,59,9,50,2019,1084,0.16,16,Low Digitalization,High Course ( >40H )
6460,51,17,34,2019,1084,0.33,33,Medium-Low Digitalization,High Course ( >40H )
6461,39,16,23,2019,1084,0.42,42,Medium-Low Digitalization,Medium Course ( >15H and <40H )
6462,72,3,69,2019,1084,0.04,4,Low Digitalization,High Course ( >40H )
6463,10,8,2,2019,1084,0.79,79,Medium-High Digitalization,Small Course ( <15H )
6464,6,3,3,2019,1084,0.48,48,Medium-Low Digitalization,Small Course ( <15H )
6465,59,29,30,2019,1084,0.49,49,Medium-Low Digitalization,High Course ( >40H )
6466,12,12,0,2019,1084,1.0,100,High Digitalization,Small Course ( <15H )
6467,66,66,0,2019,1084,1.0,100,High Digitalization,High Course ( >40H )
6468,81,58,23,2019,1084,0.71,71,Medium-High Digitalization,High Course ( >40H )
6469,10,3,7,2019,1084,0.31,31,Medium-Low Digitalization,Small Course ( <15H )
6470,8,3,5,2019,1084,0.43,43,Medium-Low Digitalization,Small Course ( <15H )
6471,46,14,32,2019,1084,0.3,30,Medium-Low Digitalization,High Course ( >40H )
6472,15,14,1,2019,1084,0.91,91,High Digitalization,Small Course ( <15H )
6473,28,18,10,2019,1084,0.64,64,Medium-High Digitalization,Medium Course ( >15H and <40H )
6474,33,28,5,2019,1084,0.84,84,High Digitalization,Medium Course ( >15H and <40H )
6475,31,8,23,2019,1084,0.26,26,Medium-Low Digitalization,Medium Course ( >15H and <40H )
6476,51,26,26,2019,1084,0.5,50,Medium-Low Digitalization,High Course ( >40H )
6477,6,3,3,2019,1084,0.58,57,Medium-High Digitalization,Small Course ( <15H )
6478,85,54,31,2019,1084,0.64,64,Medium-High Digitalization,High Course ( >40H )
6479,8,8,0,2019,1084,0.94,94,High Digitalization,Small Course ( <15H )
6480,45,15,30,2019,1084,0.33,33,Medium-Low Digitalization,High Course ( >40H )
6481,21,16,5,2019,1084,0.77,77,Medium-High Digitalization,Medium Course ( >15H and <40H )
6482,41,7,34,2019,1084,0.18,18,Low Digitalization,High Course ( >40H )
6483,35,1,34,2019,1084,0.03,3,Low Digitalization,Medium Course ( >15H and <40H )
6484,5,3,2,2019,1084,0.67,67,Medium-High Digitalization,Small Course ( <15H )
6485,45,13,32,2019,1084,0.28,28,Medium-Low Digitalization,High Course ( >40H )
6486,30,9,21,2019,1084,0.29,28,Medium-Low Digitalization,Medium Course ( >15H and <40H )
6487,76,59,17,2019,1084,0.78,78,Medium-High Digitalization,High Course ( >40H )
6488,9,1,8,2019,1084,0.11,11,Low Digitalization,Small Course ( <15H )
6489,24,12,12,2019,1084,0.49,49,Medium-Low Digitalization,Medium Course ( >15H and <40H )
6490,34,18,16,2019,1084,0.52,52,Medium-High Digitalization,Medium Course ( >15H and <40H )
6491,21,18,3,2019,1084,0.84,84,High Digitalization,Medium Course ( >15H and <40H )
6492,84,45,39,2019,1084,0.54,54,Medium-High Digitalization,High Course ( >40H )
6493,73,70,3,2019,1084,0.96,96,High Digitalization,High Course ( >40H )
6494,14,12,2,2019,1084,0.89,89,High Digitalization,Small Course ( <15H )
6495,60,46,14,2019,1084,0.77,77,Medium-High Digitalization,High Course ( >40H )
6496,33,32,1,2019,1084,0.98,98,High Digitalization,Medium Course ( >15H and <40H )
6497,32,7,25,2019,1084,0.22,22,Medium-Low Digitalization,Medium Course ( >15H and <40H )
6498,14,1,13,2019,1084,0.09,9,Low Digitalization,Small Course ( <15H )
6499,12,11,1,2019,1084,0.92,92,High Digitalization,Small Course ( <15H )
6500,63,47,16,2019,1084,0.75,75,Medium-High Digitalization,High Course ( >40H )
6501,33,8,25,2019,1084,0.25,25,Medium-Low Digitalization,Medium Course ( >15H and <40H )
6502,52,12,40,2019,1084,0.23,23,Medium-Low Digitalization,High Course ( >40H )
6503,90,59,31,2019,1084,0.66,66,Medium-High Digitalization,High Course ( >40H )
6504,57,47,10,2019,1084,0.82,82,High Digitalization,High Course ( >40H )
6505,80,13,67,2019,1084,0.16,16,Low Digitalization,High Course ( >40H )
6506,9,0,9,2019,1084,0.0,0,Low Digitalization,Small Course ( <15H )
6507,27,21,6,2019,1084,0.79,79,Medium-High Digitalization,Medium Course ( >15H and <40H )
6508,7,4,3,2019,1084,0.58,57,Medium-High Digitalization,Small Course ( <15H )
6509,28,11,17,2019,1084,0.4,40,Medium-Low Digitalization,Medium Course ( >15H and <40H )
6510,60,55,5,2019,1084,0.91,91,High Digitalization,High Course ( >40H )
6511,29,20,9,2019,1084,0.7,70,Medium-High Digitalization,Medium Course ( >15H and <40H )
6512,5,0,5,2019,1084,0.02,2,Low Digitalization,Small Course ( <15H )
6513,11,8,3,2019,1084,0.75,75,Medium-High Digitalization,Small Course ( <15H )
6514,23,16,7,2019,1084,0.71,71,Medium-High Digitalization,Medium Course ( >15H and <40H )
6515,56,53,3,2019,1084,0.94,94,High Digitalization,High Course ( >40H )
6516,13,13,0,2019,1084,0.97,97,High Digitalization,Small Course ( <15H )
6517,18,3,15,2019,1084,0.19,19,Low Digitalization,Medium Course ( >15H and <40H )
6518,70,70,0,2019,1084,1.0,100,High Digitalization,High Course ( >40H )
6519,12,1,11,2019,1084,0.1,10,Low Digitalization,Small Course ( <15H )
6520,8,5,3,2019,1084,0.62,62,Medium-High Digitalization,Small Course ( <15H )
6521,48,12,36,2019,1084,0.24,24,Medium-Low Digitalization,High Course ( >40H )
6522,17,5,12,2019,1084,0.3,30,Medium-Low Digitalization,Medium Course ( >15H and <40H )
6523,9,4,5,2019,1084,0.41,41,Medium-Low Digitalization,Small Course ( <15H )
6524,12,9,3,2019,1084,0.73,73,Medium-High Digitalization,Small Course ( <15H )
6525,8,7,1,2019,1084,0.83,83,High Digitalization,Small Course ( <15H )
6526,11,5,6,2019,1084,0.48,48,Medium-Low Digitalization,Small Course ( <15H )
6527,6,3,3,2019,1084,0.49,49,Medium-Low Digitalization,Small Course ( <15H )
6528,25,6,19,2019,1084,0.23,23,Medium-Low Digitalization,Medium Course ( >15H and <40H )
6529,14,11,3,2019,1084,0.76,76,Medium-High Digitalization,Small Course ( <15H )
6530,81,23,58,2019,1084,0.29,28,Medium-Low Digitalization,High Course ( >40H )
6531,40,17,23,2019,1084,0.42,42,Medium-Low Digitalization,High Course ( >40H )
6532,6,4,2,2019,1084,0.71,71,Medium-High Digitalization,Small Course ( <15H )
6533,36,3,33,2019,1084,0.07,7,Low Digitalization,Medium Course ( >15H and <40H )
6534,8,8,0,2019,1084,0.94,94,High Digitalization,Small Course ( <15H )
6535,31,16,15,2019,1084,0.53,53,Medium-High Digitalization,Medium Course ( >15H and <40H )
6536,27,26,1,2019,1084,0.95,95,High Digitalization,Medium Course ( >15H and <40H )
6537,16,12,4,2019,1084,0.73,73,Medium-High Digitalization,Medium Course ( >15H and <40H )
6538,45,43,2,2019,1084,0.96,96,High Digitalization,High Course ( >40H )
6539,52,37,15,2019,1084,0.71,71,Medium-High Digitalization,High Course ( >40H )
6540,7,0,7,2019,1084,0.05,5,Low Digitalization,Small Course ( <15H )
6541,24,7,17,2019,1084,0.28,28,Medium-Low Digitalization,Medium Course ( >15H and <40H )
6542,38,28,10,2019,1084,0.75,75,Medium-High Digitalization,Medium Course ( >15H and <40H )
6543,54,35,19,2019,1084,0.65,65,Medium-High Digitalization,High Course ( >40H )
6544,48,23,25,2019,1084,0.47,47,Medium-Low Digitalization,High Course ( >40H )
6545,10,5,5,2019,1084,0.47,47,Medium-Low Digitalization,Small Course ( <15H )
6546,53,48,5,2019,1084,0.9,90,High Digitalization,High Course ( >40H )
6547,58,28,30,2019,1084,0.48,48,Medium-Low Digitalization,High Course ( >40H )
6548,13,11,2,2019,1084,0.86,86,High Digitalization,Small Course ( <15H )
6549,59,58,1,2019,1084,0.98,98,High Digitalization,High Course ( >40H )
6550,75,8,68,2019,1084,0.1,10,Low Digitalization,High Course ( >40H )
6551,7,6,1,2019,1084,0.91,91,High Digitalization,Small Course ( <15H )
6552,31,6,25,2019,1084,0.19,19,Low Digitalization,Medium Course ( >15H and <40H )
6553,55,26,29,2019,1084,0.47,47,Medium-Low Digitalization,High Course ( >40H )
6554,7,0,7,2019,1084,0.0,0,Low Digitalization,Small Course ( <15H )
6555,32,4,28,2019,1084,0.13,13,Low Digitalization,Medium Course ( >15H and <40H )
6556,72,58,14,2019,1084,0.8,80,Medium-High Digitalization,High Course ( >40H )
6557,48,10,38,2019,1084,0.21,21,Medium-Low Digitalization,High Course ( >40H )
6558,36,3,33,2019,1084,0.09,9,Low Digitalization,Medium Course ( >15H and <40H )
6559,17,12,5,2019,1084,0.68,68,Medium-High Digitalization,Medium Course ( >15H and <40H )
6560,14,3,11,2019,1084,0.21,21,Medium-Low Digitalization,Small Course ( <15H )
6561,70,66,4,2019,1084,0.95,95,High Digitalization,High Course ( >40H )
6562,11,5,6,2019,1084,0.43,43,Medium-Low Digitalization,Small Course ( <15H )
6563,40,2,38,2019,1084,0.05,5,Low Digitalization,High Course ( >40H )
6564,5,1,4,2019,1084,0.25,25,Medium-Low Digitalization,Small Course ( <15H )
6565,88,22,66,2019,1084,0.25,25,Medium-Low Digitalization,High Course ( >40H )
6566,18,17,1,2019,1084,0.96,96,High Digitalization,Medium Course ( >15H and <40H )
6567,52,16,36,2019,1084,0.3,30,Medium-Low Digitalization,High Course ( >40H )
6568,12,4,8,2019,1084,0.35,35,Medium-Low Digitalization,Small Course ( <15H )
6569,38,30,8,2019,1084,0.79,79,Medium-High Digitalization,Medium Course ( >15H and <40H )
6570,45,32,13,2019,1084,0.72,72,Medium-High Digitalization,High Course ( >40H )
6571,26,18,8,2019,1084,0.7,70,Medium-High Digitalization,Medium Course ( >15H and <40H )
6572,84,9,75,2019,1084,0.11,11,Low Digitalization,High Course ( >40H )
6573,60,38,22,2019,1084,0.64,64,Medium-High Digitalization,High Course ( >40H )
6574,15,11,4,2019,1084,0.76,76,Medium-High Digitalization,Small Course ( <15H )
6575,22,19,3,2019,1084,0.87,87,High Digitalization,Medium Course ( >15H and <40H )
6576,42,37,5,2019,1084,0.89,89,High Digitalization,High Course ( >40H )
6577,21,8,13,2019,1084,0.39,39,Medium-Low Digitalization,Medium Course ( >15H and <40H )
6578,54,19,35,2019,1084,0.35,35,Medium-Low Digitalization,High Course ( >40H )
6579,54,5,49,2019,1084,0.09,9,Low Digitalization,High Course ( >40H )
6580,64,41,23,2019,1084,0.64,64,Medium-High Digitalization,High Course ( >40H )
6581,82,56,26,2019,1084,0.68,68,Medium-High Digitalization,High Course ( >40H )
6582,43,34,9,2019,1084,0.79,79,Medium-High Digitalization,High Course ( >40H )
6583,60,59,1,2019,1084,0.98,98,High Digitalization,High Course ( >40H )
6584,7,5,2,2019,1084,0.65,65,Medium-High Digitalization,Small Course ( <15H )
6585,22,8,14,2019,1084,0.37,37,Medium-Low Digitalization,Medium Course ( >15H and <40H )
6586,42,13,29,2019,1084,0.32,32,Medium-Low Digitalization,High Course ( >40H )
6587,15,8,7,2019,1084,0.53,53,Medium-High Digitalization,Small Course ( <15H )
6588,27,25,2,2019,1084,0.93,93,High Digitalization,Medium Course ( >15H and <40H )
6589,49,15,34,2019,1084,0.3,30,Medium-Low Digitalization,High Course ( >40H )
6590,66,34,32,2019,1084,0.51,51,Medium-High Digitalization,High Course ( >40H )
6591,10,4,6,2019,1084,0.41,41,Medium-Low Digitalization,Small Course ( <15H )
6592,20,10,10,2019,1084,0.49,49,Medium-Low Digitalization,Medium Course ( >15H and <40H )
6593,38,24,14,2019,1084,0.62,62,Medium-High Digitalization,Medium Course ( >15H and <40H )
6594,70,30,40,2019,1084,0.43,43,Medium-Low Digitalization,High Course ( >40H )
6595,89,6,83,2019,1084,0.07,7,Low Digitalization,High Course ( >40H )
6596,70,60,10,2019,1084,0.86,86,High Digitalization,High Course ( >40H )
6597,55,40,15,2019,1084,0.72,72,Medium-High Digitalization,High Course ( >40H )
6598,9,0,9,2019,1084,0.03,3,Low Digitalization,Small Course ( <15H )
6599,59,46,13,2019,1084,0.78,78,Medium-High Digitalization,High Course ( >40H )
6600,39,16,23,2019,1084,0.42,42,Medium-Low Digitalization,Medium Course ( >15H and <40H )
6601,32,2,30,2019,1084,0.07,7,Low Digitalization,Medium Course ( >15H and <40H )
6602,7,5,2,2019,1084,0.65,65,Medium-High Digitalization,Small Course ( <15H )
6603,52,8,44,2019,1084,0.15,15,Low Digitalization,High Course ( >40H )
6604,14,9,5,2019,1084,0.65,65,Medium-High Digitalization,Small Course ( <15H )
6605,36,25,11,2019,1084,0.69,69,Medium-High Digitalization,Medium Course ( >15H and <40H )
6606,20,19,1,2019,1084,0.94,94,High Digitalization,Medium Course ( >15H and <40H )
6607,11,10,1,2019,1084,0.91,91,High Digitalization,Small Course ( <15H )
6608,34,17,17,2019,1084,0.49,49,Medium-Low Digitalization,Medium Course ( >15H and <40H )
6609,34,26,8,2019,1084,0.75,75,Medium-High Digitalization,Medium Course ( >15H and <40H )
6610,30,2,28,2019,1084,0.08,8,Low Digitalization,Medium Course ( >15H and <40H )
6611,14,8,6,2019,1084,0.56,56,Medium-High Digitalization,Small Course ( <15H )
6612,8,4,4,2019,1084,0.5,50,Medium-Low Digitalization,Small Course ( <15H )
6613,56,51,5,2019,1084,0.91,91,High Digitalization,High Course ( >40H )
6614,32,29,3,2019,1084,0.9,90,High Digitalization,Medium Course ( >15H and <40H )
6615,89,69,20,2019,1084,0.78,78,Medium-High Digitalization,High Course ( >40H )
6616,38,5,33,2019,1084,0.13,13,Low Digitalization,Medium Course ( >15H and <40H )
6617,6,3,3,2019,1084,0.43,43,Medium-Low Digitalization,Small Course ( <15H )
6618,32,31,1,2019,1084,0.97,97,High Digitalization,Medium Course ( >15H and <40H )
6619,51,47,4,2019,1084,0.92,92,High Digitalization,High Course ( >40H )
6620,31,2,29,2019,1084,0.08,8,Low Digitalization,Medium Course ( >15H and <40H )
6621,12,11,1,2019,1084,0.88,88,High Digitalization,Small Course ( <15H )
6622,49,49,0,2019,1084,1.0,100,High Digitalization,High Course ( >40H )
6623,7,4,3,2019,1084,0.53,53,Medium-High Digitalization,Small Course ( <15H )
6624,15,6,9,2019,1084,0.41,41,Medium-Low Digitalization,Small Course ( <15H )
6625,38,28,10,2019,1084,0.73,73,Medium-High Digitalization,Medium Course ( >15H and <40H )
6626,5,1,4,2019,1084,0.23,23,Medium-Low Digitalization,Small Course ( <15H )
6627,76,62,14,2019,1084,0.81,81,High Digitalization,High Course ( >40H )
6628,48,41,7,2019,1084,0.85,85,High Digitalization,High Course ( >40H )
6629,15,12,3,2019,1084,0.82,82,High Digitalization,Small Course ( <15H )
6630,55,14,41,2019,1084,0.26,26,Medium-Low Digitalization,High Course ( >40H )
6631,10,4,6,2019,1084,0.41,41,Medium-Low Digitalization,Small Course ( <15H )
6632,24,18,6,2019,1084,0.75,75,Medium-High Digitalization,Medium Course ( >15H and <40H )
6633,13,12,1,2019,1084,0.96,96,High Digitalization,Small Course ( <15H )
6634,52,45,7,2019,1084,0.86,86,High Digitalization,High Course ( >40H )
6635,24,15,9,2019,1084,0.62,62,Medium-High Digitalization,Medium Course ( >15H and <40H )
6636,52,8,44,2019,1084,0.15,15,Low Digitalization,High Course ( >40H )
6637,13,8,5,2019,1084,0.58,57,Medium-High Digitalization,Small Course ( <15H )
6638,61,57,4,2019,1084,0.94,94,High Digitalization,High Course ( >40H )
6639,45,14,31,2019,1084,0.32,32,Medium-Low Digitalization,High Course ( >40H )
6640,20,14,6,2019,1084,0.71,71,Medium-High Digitalization,Medium Course ( >15H and <40H )
6641,56,3,53,2019,1084,0.06,6,Low Digitalization,High Course ( >40H )
6642,34,3,31,2019,1084,0.09,9,Low Digitalization,Medium Course ( >15H and <40H )
6643,19,6,13,2019,1084,0.29,28,Medium-Low Digitalization,Medium Course ( >15H and <40H )
6644,34,23,11,2019,1084,0.67,67,Medium-High Digitalization,Medium Course ( >15H and <40H )
6645,15,1,14,2019,1084,0.06,6,Low Digitalization,Small Course ( <15H )
6646,41,16,25,2019,1084,0.39,39,Medium-Low Digitalization,High Course ( >40H )
6647,57,7,50,2019,1084,0.13,13,Low Digitalization,High Course ( >40H )
6648,55,44,11,2019,1084,0.8,80,Medium-High Digitalization,High Course ( >40H )
6649,53,44,9,2019,1084,0.83,83,High Digitalization,High Course ( >40H )
6650,69,22,47,2019,1084,0.32,32,Medium-Low Digitalization,High Course ( >40H )
6651,40,35,5,2019,1084,0.88,88,High Digitalization,High Course ( >40H )
6652,7,3,4,2019,1084,0.46,46,Medium-Low Digitalization,Small Course ( <15H )
6653,33,31,2,2019,1084,0.94,94,High Digitalization,Medium Course ( >15H and <40H )
6654,21,6,15,2019,1084,0.29,28,Medium-Low Digitalization,Medium Course ( >15H and <40H )
6655,45,5,40,2019,1084,0.12,12,Low Digitalization,High Course ( >40H )
6656,48,39,9,2019,1084,0.81,81,High Digitalization,High Course ( >40H )
6657,36,6,30,2019,1084,0.18,18,Low Digitalization,Medium Course ( >15H and <40H )
6658,7,1,6,2019,1084,0.08,8,Low Digitalization,Small Course ( <15H )
6659,7,3,4,2019,1084,0.43,43,Medium-Low Digitalization,Small Course ( <15H )
6660,66,61,5,2019,1084,0.92,92,High Digitalization,High Course ( >40H )
6661,56,18,38,2019,1084,0.33,33,Medium-Low Digitalization,High Course ( >40H )
6662,9,0,9,2019,1084,0.01,1,Low Digitalization,Small Course ( <15H )
6663,69,41,28,2019,1084,0.6,60,Medium-High Digitalization,High Course ( >40H )
6664,6,3,3,2019,1084,0.43,43,Medium-Low Digitalization,Small Course ( <15H )
6665,65,47,18,2019,1084,0.72,72,Medium-High Digitalization,High Course ( >40H )
6666,38,5,33,2019,1084,0.13,13,Low Digitalization,Medium Course ( >15H and <40H )
6667,67,64,3,2019,1084,0.96,96,High Digitalization,High Course ( >40H )
6668,40,9,31,2019,1084,0.23,23,Medium-Low Digitalization,High Course ( >40H )
6669,44,42,2,2019,1084,0.95,95,High Digitalization,High Course ( >40H )
6670,42,25,17,2019,1084,0.59,59,Medium-High Digitalization,High Course ( >40H )
6671,71,45,26,2019,1084,0.63,63,Medium-High Digitalization,High Course ( >40H )
6672,11,1,10,2019,1084,0.13,13,Low Digitalization,Small Course ( <15H )
6673,11,0,11,2019,1084,0.02,2,Low Digitalization,Small Course ( <15H )
6674,11,10,1,2019,1084,0.91,91,High Digitalization,Small Course ( <15H )
6675,75,2,74,2019,1084,0.02,2,Low Digitalization,High Course ( >40H )
6676,13,8,5,2019,1084,0.64,64,Medium-High Digitalization,Small Course ( <15H )
6677,14,3,11,2019,1084,0.18,18,Low Digitalization,Small Course ( <15H )
6678,76,51,25,2019,1084,0.67,67,Medium-High Digitalization,High Course ( >40H )
6679,15,6,9,2019,1084,0.37,37,Medium-Low Digitalization,Small Course ( <15H )
6680,42,22,20,2019,1084,0.52,52,Medium-High Digitalization,High Course ( >40H )
6681,13,11,2,2019,1084,0.83,83,High Digitalization,Small Course ( <15H )
6682,69,47,22,2019,1084,0.68,68,Medium-High Digitalization,High Course ( >40H )
6683,8,5,3,2019,1084,0.68,68,Medium-High Digitalization,Small Course ( <15H )
6684,64,54,10,2019,1084,0.84,84,High Digitalization,High Course ( >40H )
6685,5,2,2,2019,1084,0.5,50,Medium-Low Digitalization,Small Course ( <15H )
6686,19,8,11,2019,1084,0.4,40,Medium-Low Digitalization,Medium Course ( >15H and <40H )
6687,51,3,48,2019,1084,0.05,5,Low Digitalization,High Course ( >40H )
6688,13,13,0,2019,1084,1.0,100,High Digitalization,Small Course ( <15H )
6689,77,12,65,2019,1084,0.15,15,Low Digitalization,High Course ( >40H )
6690,12,8,4,2019,1084,0.63,63,Medium-High Digitalization,Small Course ( <15H )
6691,71,58,13,2019,1084,0.82,82,High Digitalization,High Course ( >40H )
6692,39,32,7,2019,1084,0.83,83,High Digitalization,Medium Course ( >15H and <40H )
6693,10,3,7,2019,1084,0.34,34,Medium-Low Digitalization,Small Course ( <15H )
6694,60,44,16,2019,1084,0.73,73,Medium-High Digitalization,High Course ( >40H )
6695,80,29,51,2019,1084,0.36,36,Medium-Low Digitalization,High Course ( >40H )
6696,9,7,2,2019,1084,0.78,78,Medium-High Digitalization,Small Course ( <15H )
6697,17,2,15,2019,1084,0.12,12,Low Digitalization,Medium Course ( >15H and <40H )
6698,58,57,1,2019,1084,0.98,98,High Digitalization,High Course ( >40H )
6699,47,7,40,2019,1084,0.14,14,Low Digitalization,High Course ( >40H )
6700,57,4,53,2019,1084,0.07,7,Low Digitalization,High Course ( >40H )
6701,32,1,31,2019,1084,0.03,3,Low Digitalization,Medium Course ( >15H and <40H )
6702,27,16,11,2019,1084,0.6,60,Medium-High Digitalization,Medium Course ( >15H and <40H )
6703,28,26,2,2019,1084,0.93,93,High Digitalization,Medium Course ( >15H and <40H )
6704,29,29,0,2019,1084,0.99,99,High Digitalization,Medium Course ( >15H and <40H )
6705,69,50,19,2019,1084,0.73,73,Medium-High Digitalization,High Course ( >40H )
6706,37,25,12,2019,1084,0.68,68,Medium-High Digitalization,Medium Course ( >15H and <40H )
6707,49,11,38,2019,1084,0.23,23,Medium-Low Digitalization,High Course ( >40H )
6708,11,7,4,2019,1084,0.64,64,Medium-High Digitalization,Small Course ( <15H )
6709,88,69,19,2019,1084,0.78,78,Medium-High Digitalization,High Course ( >40H )
6710,11,10,1,2019,1084,0.91,91,High Digitalization,Small Course ( <15H )
6711,36,29,7,2019,1084,0.8,80,Medium-High Digitalization,Medium Course ( >15H and <40H )
6712,36,16,20,2019,1084,0.45,45,Medium-Low Digitalization,Medium Course ( >15H and <40H )
6713,6,6,0,2019,1084,0.94,94,High Digitalization,Small Course ( <15H )
6714,14,3,11,2019,1084,0.24,24,Medium-Low Digitalization,Small Course ( <15H )
6715,15,3,12,2019,1084,0.2,20,Low Digitalization,Small Course ( <15H )
6716,9,8,1,2019,1084,0.85,85,High Digitalization,Small Course ( <15H )
6717,81,54,27,2019,1084,0.67,67,Medium-High Digitalization,High Course ( >40H )
6718,12,9,3,2019,1084,0.79,79,Medium-High Digitalization,Small Course ( <15H )
6719,15,14,1,2019,1084,0.95,95,High Digitalization,Small Course ( <15H )
6720,47,15,32,2019,1084,0.31,31,Medium-Low Digitalization,High Course ( >40H )
6721,31,26,5,2019,1084,0.85,85,High Digitalization,Medium Course ( >15H and <40H )
6722,22,17,5,2019,1084,0.79,79,Medium-High Digitalization,Medium Course ( >15H and <40H )
6723,12,9,3,2019,1084,0.77,77,Medium-High Digitalization,Small Course ( <15H )
6724,76,41,35,2019,1084,0.54,54,Medium-High Digitalization,High Course ( >40H )
6725,8,8,0,2019,1084,0.97,97,High Digitalization,Small Course ( <15H )
6726,54,41,13,2019,1084,0.76,76,Medium-High Digitalization,High Course ( >40H )
6727,27,1,26,2019,1084,0.04,4,Low Digitalization,Medium Course ( >15H and <40H )
6728,77,19,58,2019,1084,0.25,25,Medium-Low Digitalization,High Course ( >40H )
6729,70,44,26,2019,1084,0.63,63,Medium-High Digitalization,High Course ( >40H )
6730,47,9,38,2019,1084,0.19,19,Low Digitalization,High Course ( >40H )
6731,8,2,6,2019,1084,0.31,31,Medium-Low Digitalization,Small Course ( <15H )
6732,84,2,82,2019,1084,0.02,2,Low Digitalization,High Course ( >40H )
6733,43,36,7,2019,1084,0.83,83,High Digitalization,High Course ( >40H )
6734,13,12,1,2019,1084,0.95,95,High Digitalization,Small Course ( <15H )
6735,88,40,48,2019,1084,0.45,45,Medium-Low Digitalization,High Course ( >40H )
6736,13,5,8,2019,1084,0.38,38,Medium-Low Digitalization,Small Course ( <15H )
6737,72,22,50,2019,1084,0.31,31,Medium-Low Digitalization,High Course ( >40H )
6738,62,47,15,2019,1084,0.76,76,Medium-High Digitalization,High Course ( >40H )
6739,6,5,1,2019,1084,0.79,79,Medium-High Digitalization,Small Course ( <15H )
6740,50,33,17,2019,1084,0.66,66,Medium-High Digitalization,High Course ( >40H )
6741,7,5,2,2019,1084,0.71,71,Medium-High Digitalization,Small Course ( <15H )
6742,85,17,68,2019,1084,0.2,20,Low Digitalization,High Course ( >40H )
6743,45,11,34,2019,1084,0.25,25,Medium-Low Digitalization,High Course ( >40H )
6744,27,9,18,2019,1084,0.35,35,Medium-Low Digitalization,Medium Course ( >15H and <40H )
6745,38,0,38,2019,1084,0.01,1,Low Digitalization,Medium Course ( >15H and <40H )
6746,35,22,13,2019,1084,0.64,64,Medium-High Digitalization,Medium Course ( >15H and <40H )
6747,29,6,23,2019,1084,0.19,19,Low Digitalization,Medium Course ( >15H and <40H )
6748,43,34,9,2019,1084,0.78,78,Medium-High Digitalization,High Course ( >40H )
6749,75,4,71,2019,1084,0.05,5,Low Digitalization,High Course ( >40H )
6750,21,5,16,2019,1084,0.25,25,Medium-Low Digitalization,Medium Course ( >15H and <40H )
6751,10,0,10,2019,1084,0.02,2,Low Digitalization,Small Course ( <15H )
6752,57,17,40,2019,1084,0.29,28,Medium-Low Digitalization,High Course ( >40H )
6753,11,7,4,2019,1084,0.6,60,Medium-High Digitalization,Small Course ( <15H )
6754,8,1,7,2019,1084,0.17,17,Low Digitalization,Small Course ( <15H )
6755,34,24,10,2019,1084,0.7,70,Medium-High Digitalization,Medium Course ( >15H and <40H )
6756,7,6,1,2019,1084,0.82,82,High Digitalization,Small Course ( <15H )
6757,24,23,1,2019,1084,0.94,94,High Digitalization,Medium Course ( >15H and <40H )
6758,23,20,3,2019,1084,0.86,86,High Digitalization,Medium Course ( >15H and <40H )
6759,60,40,20,2019,1084,0.67,67,Medium-High Digitalization,High Course ( >40H )
6760,15,12,3,2019,1084,0.78,78,Medium-High Digitalization,Small Course ( <15H )
6761,9,2,7,2019,1084,0.2,20,Low Digitalization,Small Course ( <15H )
6762,18,3,15,2019,1084,0.15,15,Low Digitalization,Medium Course ( >15H and <40H )
6763,10,3,7,2019,1084,0.3,30,Medium-Low Digitalization,Small Course ( <15H )
6764,42,13,29,2019,1084,0.32,32,Medium-Low Digitalization,High Course ( >40H )
6765,22,14,8,2019,1084,0.63,63,Medium-High Digitalization,Medium Course ( >15H and <40H )
6766,61,59,2,2019,1084,0.96,96,High Digitalization,High Course ( >40H )
6767,43,3,40,2019,1084,0.06,6,Low Digitalization,High Course ( >40H )
6768,6,3,3,2019,1084,0.54,54,Medium-High Digitalization,Small Course ( <15H )
6769,41,32,9,2019,1084,0.77,77,Medium-High Digitalization,High Course ( >40H )
6770,74,6,68,2019,1084,0.08,8,Low Digitalization,High Course ( >40H )
6771,14,1,13,2019,1084,0.09,9,Low Digitalization,Small Course ( <15H )
6772,72,27,45,2019,1084,0.38,38,Medium-Low Digitalization,High Course ( >40H )
6773,34,17,17,2019,1084,0.49,49,Medium-Low Digitalization,Medium Course ( >15H and <40H )
6774,77,69,8,2019,1084,0.9,90,High Digitalization,High Course ( >40H )
6775,8,7,1,2019,1084,0.88,88,High Digitalization,Small Course ( <15H )
6776,5,3,2,2019,1084,0.69,69,Medium-High Digitalization,Small Course ( <15H )
6777,76,40,36,2019,1084,0.53,53,Medium-High Digitalization,High Course ( >40H )
6778,40,19,21,2019,1084,0.48,48,Medium-Low Digitalization,High Course ( >40H )
6779,60,44,16,2019,1084,0.74,74,Medium-High Digitalization,High Course ( >40H )
6780,8,7,1,2019,1084,0.89,89,High Digitalization,Small Course ( <15H )
6781,15,9,6,2019,1084,0.59,59,Medium-High Digitalization,Small Course ( <15H )
6782,53,40,13,2019,1084,0.76,76,Medium-High Digitalization,High Course ( >40H )
6783,52,1,51,2019,1084,0.02,2,Low Digitalization,High Course ( >40H )
6784,14,3,11,2019,1084,0.18,18,Low Digitalization,Small Course ( <15H )
6785,19,6,13,2019,1084,0.29,28,Medium-Low Digitalization,Medium Course ( >15H and <40H )
6786,17,10,7,2019,1084,0.59,59,Medium-High Digitalization,Medium Course ( >15H and <40H )
6787,19,1,18,2019,1084,0.07,7,Low Digitalization,Medium Course ( >15H and <40H )
6788,14,2,12,2019,1084,0.14,14,Low Digitalization,Small Course ( <15H )
6789,8,6,2,2019,1084,0.8,80,Medium-High Digitalization,Small Course ( <15H )
6790,14,7,7,2019,1084,0.47,47,Medium-Low Digitalization,Small Course ( <15H )
6791,76,16,60,2019,1084,0.21,21,Medium-Low Digitalization,High Course ( >40H )
6792,40,20,20,2019,1084,0.49,49,Medium-Low Digitalization,High Course ( >40H )
6793,23,3,20,2019,1084,0.13,13,Low Digitalization,Medium Course ( >15H and <40H )
6794,8,6,2,2019,1084,0.78,78,Medium-High Digitalization,Small Course ( <15H )
6795,79,22,57,2019,1084,0.28,28,Medium-Low Digitalization,High Course ( >40H )
6796,32,16,16,2019,1084,0.51,51,Medium-High Digitalization,Medium Course ( >15H and <40H )
6797,10,0,10,2019,1084,0.0,0,Low Digitalization,Small Course ( <15H )
6798,67,35,32,2019,1084,0.52,52,Medium-High Digitalization,High Course ( >40H )
6799,67,61,6,2019,1084,0.91,91,High Digitalization,High Course ( >40H )
6800,50,20,30,2019,1084,0.4,40,Medium-Low Digitalization,High Course ( >40H )
6801,40,18,22,2019,1084,0.45,45,Medium-Low Digitalization,High Course ( >40H )
6802,41,23,18,2019,1084,0.55,55,Medium-High Digitalization,High Course ( >40H )
6803,12,6,6,2019,1084,0.49,49,Medium-Low Digitalization,Small Course ( <15H )
6804,27,6,21,2019,1084,0.24,24,Medium-Low Digitalization,Medium Course ( >15H and <40H )
6805,34,12,22,2019,1084,0.34,34,Medium-Low Digitalization,Medium Course ( >15H and <40H )
6806,59,15,44,2019,1084,0.26,26,Medium-Low Digitalization,High Course ( >40H )
6807,22,14,8,2019,1084,0.62,62,Medium-High Digitalization,Medium Course ( >15H and <40H )
6808,9,3,6,2019,1084,0.38,38,Medium-Low Digitalization,Small Course ( <15H )
6809,59,8,51,2019,1084,0.14,14,Low Digitalization,High Course ( >40H )
6810,6,1,5,2019,1084,0.1,10,Low Digitalization,Small Course ( <15H )
6811,7,2,5,2019,1084,0.32,32,Medium-Low Digitalization,Small Course ( <15H )
6812,41,24,17,2019,1084,0.59,59,Medium-High Digitalization,High Course ( >40H )
6813,38,19,19,2019,1084,0.5,50,Medium-Low Digitalization,Medium Course ( >15H and <40H )
6814,28,8,20,2019,1084,0.3,30,Medium-Low Digitalization,Medium Course ( >15H and <40H )
6815,11,6,5,2019,1084,0.58,57,Medium-High Digitalization,Small Course ( <15H )
6816,9,9,0,2019,1084,0.99,99,High Digitalization,Small Course ( <15H )
6817,19,10,10,2019,1084,0.5,50,Medium-Low Digitalization,Medium Course ( >15H and <40H )
6818,44,11,33,2019,1084,0.25,25,Medium-Low Digitalization,High Course ( >40H )
6819,12,9,3,2019,1084,0.74,74,Medium-High Digitalization,Small Course ( <15H )
6820,66,27,39,2019,1084,0.41,41,Medium-Low Digitalization,High Course ( >40H )
6821,86,12,74,2019,1084,0.14,14,Low Digitalization,High Course ( >40H )
6822,9,2,7,2019,1084,0.18,18,Low Digitalization,Small Course ( <15H )
6823,57,32,25,2019,1084,0.57,56,Medium-High Digitalization,High Course ( >40H )
6824,8,1,7,2019,1084,0.11,11,Low Digitalization,Small Course ( <15H )
6825,60,30,30,2019,1084,0.5,50,Medium-Low Digitalization,High Course ( >40H )
6826,79,28,51,2019,1084,0.35,35,Medium-Low Digitalization,High Course ( >40H )
6827,7,1,6,2019,1084,0.09,9,Low Digitalization,Small Course ( <15H )
6828,81,8,73,2019,1084,0.1,10,Low Digitalization,High Course ( >40H )
6829,50,37,13,2019,1084,0.74,74,Medium-High Digitalization,High Course ( >40H )
6830,24,8,16,2019,1084,0.35,35,Medium-Low Digitalization,Medium Course ( >15H and <40H )
6831,42,3,39,2019,1084,0.06,6,Low Digitalization,High Course ( >40H )
6832,5,4,1,2019,1084,0.88,88,High Digitalization,Small Course ( <15H )
6833,14,2,12,2019,1084,0.15,15,Low Digitalization,Small Course ( <15H )
6834,55,36,19,2019,1084,0.65,65,Medium-High Digitalization,High Course ( >40H )
6835,80,11,69,2019,1084,0.14,14,Low Digitalization,High Course ( >40H )
6836,22,13,9,2019,1084,0.57,56,Medium-High Digitalization,Medium Course ( >15H and <40H )
6837,42,11,31,2019,1084,0.26,26,Medium-Low Digitalization,High Course ( >40H )
6838,20,5,15,2019,1084,0.23,23,Medium-Low Digitalization,Medium Course ( >15H and <40H )
6839,25,4,21,2019,1084,0.17,17,Low Digitalization,Medium Course ( >15H and <40H )
6840,21,19,2,2019,1084,0.9,90,High Digitalization,Medium Course ( >15H and <40H )
6841,54,44,10,2019,1084,0.82,82,High Digitalization,High Course ( >40H )
6842,12,12,0,2019,1084,0.99,99,High Digitalization,Small Course ( <15H )
6843,58,42,16,2019,1084,0.72,72,Medium-High Digitalization,High Course ( >40H )
6844,14,4,10,2019,1084,0.3,30,Medium-Low Digitalization,Small Course ( <15H )
6845,13,5,8,2019,1084,0.38,38,Medium-Low Digitalization,Small Course ( <15H )
6846,75,10,65,2019,1084,0.13,13,Low Digitalization,High Course ( >40H )
6847,47,6,41,2019,1084,0.12,12,Low Digitalization,High Course ( >40H )
6848,9,2,7,2019,1084,0.18,18,Low Digitalization,Small Course ( <15H )
6849,35,17,18,2019,1084,0.48,48,Medium-Low Digitalization,Medium Course ( >15H and <40H )
6850,19,7,12,2019,1084,0.37,37,Medium-Low Digitalization,Medium Course ( >15H and <40H )
6851,8,0,8,2019,1084,0.0,0,Low Digitalization,Small Course ( <15H )
6852,13,9,4,2019,1084,0.71,71,Medium-High Digitalization,Small Course ( <15H )
6853,10,4,6,2019,1084,0.42,42,Medium-Low Digitalization,Small Course ( <15H )
6854,36,9,27,2019,1084,0.26,26,Medium-Low Digitalization,Medium Course ( >15H and <40H )
6855,34,29,5,2019,1084,0.84,84,High Digitalization,Medium Course ( >15H and <40H )
6856,48,4,44,2019,1084,0.09,9,Low Digitalization,High Course ( >40H )
6857,49,47,2,2019,1084,0.96,96,High Digitalization,High Course ( >40H )
6858,86,34,52,2019,1084,0.39,39,Medium-Low Digitalization,High Course ( >40H )
6859,10,6,4,2019,1084,0.63,63,Medium-High Digitalization,Small Course ( <15H )
6860,16,7,9,2019,1084,0.45,45,Medium-Low Digitalization,Medium Course ( >15H and <40H )
6861,33,21,12,2019,1084,0.63,63,Medium-High Digitalization,Medium Course ( >15H and <40H )
6862,51,32,19,2019,1084,0.62,62,Medium-High Digitalization,High Course ( >40H )
6863,71,60,11,2019,1084,0.84,84,High Digitalization,High Course ( >40H )
6864,26,22,4,2019,1084,0.83,83,High Digitalization,Medium Course ( >15H and <40H )
6865,7,7,0,2019,1084,0.99,99,High Digitalization,Small Course ( <15H )
6866,34,10,24,2019,1084,0.29,28,Medium-Low Digitalization,Medium Course ( >15H and <40H )
6867,35,20,15,2019,1084,0.56,56,Medium-High Digitalization,Medium Course ( >15H and <40H )
6868,30,30,0,2019,1084,0.99,99,High Digitalization,Medium Course ( >15H and <40H )
6869,10,2,8,2019,1084,0.24,24,Medium-Low Digitalization,Small Course ( <15H )
6870,88,11,77,2019,1084,0.13,13,Low Digitalization,High Course ( >40H )
6871,64,45,19,2019,1084,0.7,70,Medium-High Digitalization,High Course ( >40H )
6872,52,10,42,2019,1084,0.2,20,Low Digitalization,High Course ( >40H )
6873,19,15,4,2019,1084,0.79,79,Medium-High Digitalization,Medium Course ( >15H and <40H )
6874,49,0,49,2019,1084,0.01,1,Low Digitalization,High Course ( >40H )
6875,25,6,19,2019,1084,0.23,23,Medium-Low Digitalization,Medium Course ( >15H and <40H )
6876,29,14,15,2019,1084,0.49,49,Medium-Low Digitalization,Medium Course ( >15H and <40H )
6877,14,3,11,2019,1084,0.2,20,Low Digitalization,Small Course ( <15H )
6878,12,7,5,2019,1084,0.61,61,Medium-High Digitalization,Small Course ( <15H )
6879,23,1,22,2019,1084,0.06,6,Low Digitalization,Medium Course ( >15H and <40H )
6880,13,10,3,2019,1084,0.74,74,Medium-High Digitalization,Small Course ( <15H )
6881,44,26,18,2019,1084,0.58,57,Medium-High Digitalization,High Course ( >40H )
6882,70,51,19,2019,1084,0.73,73,Medium-High Digitalization,High Course ( >40H )
6883,8,4,4,2019,1084,0.55,55,Medium-High Digitalization,Small Course ( <15H )
6884,20,11,9,2019,1084,0.55,55,Medium-High Digitalization,Medium Course ( >15H and <40H )
6885,38,36,2,2019,1084,0.96,96,High Digitalization,Medium Course ( >15H and <40H )
6886,12,12,0,2019,1084,0.97,97,High Digitalization,Small Course ( <15H )
6887,55,40,15,2019,1084,0.73,73,Medium-High Digitalization,High Course ( >40H )
6888,5,4,1,2019,1084,0.82,82,High Digitalization,Small Course ( <15H )
6889,54,12,42,2019,1084,0.23,23,Medium-Low Digitalization,High Course ( >40H )
6890,8,2,6,2019,1084,0.23,23,Medium-Low Digitalization,Small Course ( <15H )
6891,11,1,10,2019,1084,0.11,11,Low Digitalization,Small Course ( <15H )
6892,34,32,2,2019,1084,0.95,95,High Digitalization,Medium Course ( >15H and <40H )
6893,29,26,3,2019,1084,0.89,89,High Digitalization,Medium Course ( >15H and <40H )
6894,13,6,7,2019,1084,0.47,47,Medium-Low Digitalization,Small Course ( <15H )
6895,82,75,7,2019,1084,0.92,92,High Digitalization,High Course ( >40H )
6896,80,70,10,2019,1084,0.87,87,High Digitalization,High Course ( >40H )
6897,63,62,1,2019,1084,0.99,99,High Digitalization,High Course ( >40H )
6898,14,10,4,2019,1084,0.7,70,Medium-High Digitalization,Small Course ( <15H )
6899,57,22,35,2019,1084,0.38,38,Medium-Low Digitalization,High Course ( >40H )
6900,21,7,14,2019,1084,0.34,34,Medium-Low Digitalization,Medium Course ( >15H and <40H )
6901,12,0,12,2019,1084,0.02,2,Low Digitalization,Small Course ( <15H )
6902,27,0,27,2019,1084,0.01,1,Low Digitalization,Medium Course ( >15H and <40H )
6903,11,6,5,2019,1084,0.58,57,Medium-High Digitalization,Small Course ( <15H )
6904,89,68,21,2019,1084,0.76,76,Medium-High Digitalization,High Course ( >40H )
6905,42,8,34,2019,1084,0.18,18,Low Digitalization,High Course ( >40H )
6906,9,0,9,2019,1084,0.02,2,Low Digitalization,Small Course ( <15H )
6907,55,2,53,2019,1084,0.03,3,Low Digitalization,High Course ( >40H )
6908,43,3,40,2019,1084,0.08,8,Low Digitalization,High Course ( >40H )
6909,62,53,9,2019,1084,0.85,85,High Digitalization,High Course ( >40H )
6910,11,8,3,2019,1084,0.77,77,Medium-High Digitalization,Small Course ( <15H )
6911,15,8,7,2019,1084,0.56,56,Medium-High Digitalization,Small Course ( <15H )
6912,17,2,15,2019,1084,0.12,12,Low Digitalization,Medium Course ( >15H and <40H )
6913,7,1,6,2019,1084,0.19,19,Low Digitalization,Small Course ( <15H )
6914,75,32,43,2019,1084,0.43,43,Medium-Low Digitalization,High Course ( >40H )
6915,8,1,7,2019,1084,0.08,8,Low Digitalization,Small Course ( <15H )
6916,88,55,33,2019,1084,0.63,63,Medium-High Digitalization,High Course ( >40H )
6917,35,22,13,2019,1084,0.62,62,Medium-High Digitalization,Medium Course ( >15H and <40H )
6918,41,21,20,2019,1084,0.52,52,Medium-High Digitalization,High Course ( >40H )
6919,15,8,7,2019,1084,0.53,53,Medium-High Digitalization,Small Course ( <15H )
6920,62,57,5,2019,1084,0.92,92,High Digitalization,High Course ( >40H )
6921,27,26,1,2019,1084,0.95,95,High Digitalization,Medium Course ( >15H and <40H )
6922,31,6,25,2019,1084,0.19,19,Low Digitalization,Medium Course ( >15H and <40H )
6923,43,40,3,2019,1084,0.94,94,High Digitalization,High Course ( >40H )
6924,9,4,5,2019,1084,0.42,42,Medium-Low Digitalization,Small Course ( <15H )
6925,74,14,60,2019,1084,0.19,19,Low Digitalization,High Course ( >40H )
6926,33,13,20,2019,1084,0.39,39,Medium-Low Digitalization,Medium Course ( >15H and <40H )
6927,5,1,4,2019,1084,0.12,12,Low Digitalization,Small Course ( <15H )
6928,60,4,56,2019,1084,0.07,7,Low Digitalization,High Course ( >40H )
6929,29,26,3,2019,1084,0.89,89,High Digitalization,Medium Course ( >15H and <40H )
6930,14,11,3,2019,1084,0.77,77,Medium-High Digitalization,Small Course ( <15H )
6931,9,8,1,2019,1084,0.91,91,High Digitalization,Small Course ( <15H )
6932,36,16,20,2019,1084,0.45,45,Medium-Low Digitalization,Medium Course ( >15H and <40H )
6933,10,2,8,2019,1084,0.23,23,Medium-Low Digitalization,Small Course ( <15H )
6934,24,18,6,2019,1084,0.75,75,Medium-High Digitalization,Medium Course ( >15H and <40H )
6935,11,7,4,2019,1084,0.67,67,Medium-High Digitalization,Small Course ( <15H )
6936,82,77,5,2019,1084,0.94,94,High Digitalization,High Course ( >40H )
6937,69,14,55,2019,1084,0.21,21,Medium-Low Digitalization,High Course ( >40H )
6938,7,6,1,2019,1084,0.86,86,High Digitalization,Small Course ( <15H )
6939,39,18,21,2019,1084,0.45,45,Medium-Low Digitalization,Medium Course ( >15H and <40H )
6940,87,50,37,2019,1084,0.58,57,Medium-High Digitalization,High Course ( >40H )
6941,12,9,3,2019,1084,0.71,71,Medium-High Digitalization,Small Course ( <15H )
6942,81,76,5,2019,1084,0.94,94,High Digitalization,High Course ( >40H )
6943,41,10,31,2019,1084,0.25,25,Medium-Low Digitalization,High Course ( >40H )
6944,24,13,11,2019,1084,0.53,53,Medium-High Digitalization,Medium Course ( >15H and <40H )
6945,7,4,3,2019,1084,0.54,54,Medium-High Digitalization,Small Course ( <15H )
6946,87,45,42,2019,1084,0.52,52,Medium-High Digitalization,High Course ( >40H )
6947,12,2,10,2019,1084,0.2,20,Low Digitalization,Small Course ( <15H )
6948,80,48,32,2019,1084,0.6,60,Medium-High Digitalization,High Course ( >40H )
6949,81,54,27,2019,1084,0.67,67,Medium-High Digitalization,High Course ( >40H )
6950,59,21,38,2019,1084,0.36,36,Medium-Low Digitalization,High Course ( >40H )
6951,34,14,20,2019,1084,0.42,42,Medium-Low Digitalization,Medium Course ( >15H and <40H )
6952,6,1,5,2019,1084,0.19,19,Low Digitalization,Small Course ( <15H )
6953,15,6,9,2019,1084,0.39,39,Medium-Low Digitalization,Small Course ( <15H )
6954,15,12,3,2019,1084,0.82,82,High Digitalization,Small Course ( <15H )
6955,10,5,5,2019,1084,0.52,52,Medium-High Digitalization,Small Course ( <15H )
6956,13,13,0,2019,1084,0.97,97,High Digitalization,Small Course ( <15H )
6957,59,37,22,2019,1084,0.62,62,Medium-High Digitalization,High Course ( >40H )
6958,6,5,1,2019,1084,0.85,85,High Digitalization,Small Course ( <15H )
6959,41,25,16,2019,1084,0.62,62,Medium-High Digitalization,High Course ( >40H )
6960,15,5,10,2019,1084,0.36,36,Medium-Low Digitalization,Small Course ( <15H )
6961,86,36,50,2019,1084,0.42,42,Medium-Low Digitalization,High Course ( >40H )
6962,46,37,9,2019,1084,0.81,81,High Digitalization,High Course ( >40H )
6963,40,33,7,2019,1084,0.82,82,High Digitalization,High Course ( >40H )
6964,61,21,40,2019,1084,0.35,35,Medium-Low Digitalization,High Course ( >40H )
6965,40,11,29,2019,1084,0.27,27,Medium-Low Digitalization,High Course ( >40H )
6966,5,2,3,2019,1084,0.31,31,Medium-Low Digitalization,Small Course ( <15H )
6967,77,13,64,2019,1084,0.17,17,Low Digitalization,High Course ( >40H )
6968,6,2,4,2019,1084,0.3,30,Medium-Low Digitalization,Small Course ( <15H )
6969,25,10,15,2019,1084,0.41,41,Medium-Low Digitalization,Medium Course ( >15H and <40H )
6970,42,34,8,2019,1084,0.82,82,High Digitalization,High Course ( >40H )
6971,7,2,5,2019,1084,0.24,24,Medium-Low Digitalization,Small Course ( <15H )
6972,31,17,14,2019,1084,0.54,54,Medium-High Digitalization,Medium Course ( >15H and <40H )
6973,12,7,5,2019,1084,0.55,55,Medium-High Digitalization,Small Course ( <15H )
6974,55,38,17,2019,1084,0.69,69,Medium-High Digitalization,High Course ( >40H )
6975,49,46,3,2019,1084,0.94,94,High Digitalization,High Course ( >40H )
6976,64,48,16,2019,1084,0.75,75,Medium-High Digitalization,High Course ( >40H )
6977,14,2,12,2019,1084,0.14,14,Low Digitalization,Small Course ( <15H )
6978,85,73,12,2019,1084,0.86,86,High Digitalization,High Course ( >40H )
6979,30,23,7,2019,1084,0.76,76,Medium-High Digitalization,Medium Course ( >15H and <40H )
6980,26,14,12,2019,1084,0.54,54,Medium-High Digitalization,Medium Course ( >15H and <40H )
6981,5,5,0,2019,1084,0.98,98,High Digitalization,Small Course ( <15H )
6982,17,3,14,2019,1084,0.18,18,Low Digitalization,Medium Course ( >15H and <40H )
6983,9,8,1,2019,1084,0.9,90,High Digitalization,Small Course ( <15H )
6984,14,3,11,2019,1084,0.2,20,Low Digitalization,Small Course ( <15H )
6985,17,15,2,2019,1084,0.87,87,High Digitalization,Medium Course ( >15H and <40H )
6986,5,3,2,2019,1084,0.6,60,Medium-High Digitalization,Small Course ( <15H )
6987,10,5,5,2019,1084,0.52,52,Medium-High Digitalization,Small Course ( <15H )
6988,20,16,4,2019,1084,0.78,78,Medium-High Digitalization,Medium Course ( >15H and <40H )
6989,80,46,34,2019,1084,0.57,56,Medium-High Digitalization,High Course ( >40H )
6990,23,21,2,2019,1084,0.92,92,High Digitalization,Medium Course ( >15H and <40H )
6991,84,66,18,2019,1084,0.78,78,Medium-High Digitalization,High Course ( >40H )
6992,41,34,7,2019,1084,0.83,83,High Digitalization,High Course ( >40H )
6993,63,20,43,2019,1084,0.32,32,Medium-Low Digitalization,High Course ( >40H )
6994,72,63,9,2019,1084,0.87,87,High Digitalization,High Course ( >40H )
6995,36,17,19,2019,1084,0.48,48,Medium-Low Digitalization,Medium Course ( >15H and <40H )
6996,12,9,3,2019,1084,0.74,74,Medium-High Digitalization,Small Course ( <15H )
6997,31,20,11,2019,1084,0.65,65,Medium-High Digitalization,Medium Course ( >15H and <40H )
6998,52,37,15,2019,1084,0.72,72,Medium-High Digitalization,High Course ( >40H )
6999,15,5,10,2019,1084,0.35,35,Medium-Low Digitalization,Small Course ( <15H )
7000,21,18,3,2019,1084,0.87,87,High Digitalization,Medium Course ( >15H and <40H )
7001,34,32,2,2019,1084,0.94,94,High Digitalization,Medium Course ( >15H and <40H )
7002,46,26,20,2019,1084,0.56,56,Medium-High Digitalization,High Course ( >40H )
7003,10,2,8,2019,1084,0.22,22,Medium-Low Digitalization,Small Course ( <15H )
7004,7,6,1,2019,1084,0.79,79,Medium-High Digitalization,Small Course ( <15H )
7005,75,63,12,2019,1084,0.84,84,High Digitalization,High Course ( >40H )
7006,14,7,7,2019,1084,0.52,52,Medium-High Digitalization,Small Course ( <15H )
7007,7,5,2,2019,1084,0.75,75,Medium-High Digitalization,Small Course ( <15H )
7008,8,5,3,2019,1084,0.63,63,Medium-High Digitalization,Small Course ( <15H )
7009,26,9,17,2019,1084,0.33,33,Medium-Low Digitalization,Medium Course ( >15H and <40H )
7010,5,4,1,2019,1084,0.82,82,High Digitalization,Small Course ( <15H )
7011,31,26,5,2019,1084,0.85,85,High Digitalization,Medium Course ( >15H and <40H )
7012,29,23,6,2019,1084,0.8,80,Medium-High Digitalization,Medium Course ( >15H and <40H )
7013,42,28,14,2019,1084,0.67,67,Medium-High Digitalization,High Course ( >40H )
7014,19,4,15,2019,1084,0.22,22,Medium-Low Digitalization,Medium Course ( >15H and <40H )
7015,30,22,8,2019,1084,0.72,72,Medium-High Digitalization,Medium Course ( >15H and <40H )
7016,67,40,27,2019,1084,0.59,59,Medium-High Digitalization,High Course ( >40H )
7017,44,25,19,2019,1084,0.56,56,Medium-High Digitalization,High Course ( >40H )
7018,9,0,9,2019,1084,0.02,2,Low Digitalization,Small Course ( <15H )
7019,9,2,7,2019,1084,0.17,17,Low Digitalization,Small Course ( <15H )
7020,19,9,10,2019,1084,0.46,46,Medium-Low Digitalization,Medium Course ( >15H and <40H )
7021,15,2,13,2019,1084,0.11,11,Low Digitalization,Small Course ( <15H )
7022,15,11,4,2019,1084,0.73,73,Medium-High Digitalization,Small Course ( <15H )
7023,15,3,12,2019,1084,0.19,19,Low Digitalization,Small Course ( <15H )
7024,19,13,6,2019,1084,0.69,69,Medium-High Digitalization,Medium Course ( >15H and <40H )
7025,77,20,57,2019,1084,0.26,26,Medium-Low Digitalization,High Course ( >40H )
7026,15,4,10,2019,1084,0.3,30,Medium-Low Digitalization,Small Course ( <15H )
7027,7,3,4,2019,1084,0.39,39,Medium-Low Digitalization,Small Course ( <15H )
7028,88,61,27,2019,1084,0.69,69,Medium-High Digitalization,High Course ( >40H )
7029,6,4,2,2019,1084,0.69,69,Medium-High Digitalization,Small Course ( <15H )
7030,77,63,14,2019,1084,0.82,82,High Digitalization,High Course ( >40H )
7031,7,2,5,2019,1084,0.3,30,Medium-Low Digitalization,Small Course ( <15H )
7032,10,7,3,2019,1084,0.67,67,Medium-High Digitalization,Small Course ( <15H )
7033,19,2,17,2019,1084,0.13,13,Low Digitalization,Medium Course ( >15H and <40H )
7034,53,4,49,2019,1084,0.08,8,Low Digitalization,High Course ( >40H )
7035,12,7,5,2019,1084,0.6,60,Medium-High Digitalization,Small Course ( <15H )
7036,43,35,8,2019,1084,0.82,82,High Digitalization,High Course ( >40H )
7037,29,14,15,2019,1084,0.48,48,Medium-Low Digitalization,Medium Course ( >15H and <40H )
7038,30,3,27,2019,1084,0.09,9,Low Digitalization,Medium Course ( >15H and <40H )
7039,16,14,2,2019,1084,0.85,85,High Digitalization,Medium Course ( >15H and <40H )
7040,87,47,40,2019,1084,0.54,54,Medium-High Digitalization,High Course ( >40H )
7041,13,6,7,2019,1084,0.49,49,Medium-Low Digitalization,Small Course ( <15H )
7042,36,8,28,2019,1084,0.21,21,Medium-Low Digitalization,Medium Course ( >15H and <40H )
7043,9,4,4,2019,1084,0.5,50,Medium-Low Digitalization,Small Course ( <15H )
7044,9,4,5,2019,1084,0.49,49,Medium-Low Digitalization,Small Course ( <15H )
7045,56,11,45,2019,1084,0.19,19,Low Digitalization,High Course ( >40H )
7046,8,5,3,2019,1084,0.62,62,Medium-High Digitalization,Small Course ( <15H )
7047,47,31,16,2019,1084,0.66,66,Medium-High Digitalization,High Course ( >40H )
7048,88,73,15,2019,1084,0.83,83,High Digitalization,High Course ( >40H )
7049,69,52,17,2019,1084,0.75,75,Medium-High Digitalization,High Course ( >40H )
7050,55,44,11,2019,1084,0.8,80,Medium-High Digitalization,High Course ( >40H )
7051,12,10,2,2019,1084,0.86,86,High Digitalization,Small Course ( <15H )
7052,26,8,18,2019,1084,0.3,30,Medium-Low Digitalization,Medium Course ( >15H and <40H )
7053,5,1,4,2019,1084,0.25,25,Medium-Low Digitalization,Small Course ( <15H )
7054,50,19,31,2019,1084,0.38,38,Medium-Low Digitalization,High Course ( >40H )
7055,17,3,14,2019,1084,0.15,15,Low Digitalization,Medium Course ( >15H and <40H )
7056,36,27,9,2019,1084,0.75,75,Medium-High Digitalization,Medium Course ( >15H and <40H )
7057,45,31,14,2019,1084,0.7,70,Medium-High Digitalization,High Course ( >40H )
7058,11,1,10,2019,1084,0.11,11,Low Digitalization,Small Course ( <15H )
7059,5,2,3,2019,1084,0.34,34,Medium-Low Digitalization,Small Course ( <15H )
7060,87,60,27,2019,1084,0.69,69,Medium-High Digitalization,High Course ( >40H )
7061,48,48,0,2019,1084,0.99,99,High Digitalization,High Course ( >40H )
7062,88,36,52,2019,1084,0.41,41,Medium-Low Digitalization,High Course ( >40H )
7063,5,2,3,2019,1084,0.32,32,Medium-Low Digitalization,Small Course ( <15H )
7064,76,50,26,2019,1084,0.66,66,Medium-High Digitalization,High Course ( >40H )
7065,54,1,53,2019,1084,0.02,2,Low Digitalization,High Course ( >40H )
7066,11,9,2,2019,1084,0.84,84,High Digitalization,Small Course ( <15H )
7067,24,1,23,2019,1084,0.06,6,Low Digitalization,Medium Course ( >15H and <40H )
7068,56,6,50,2019,1084,0.11,11,Low Digitalization,High Course ( >40H )
7069,63,1,62,2019,1084,0.02,2,Low Digitalization,High Course ( >40H )
7070,19,9,10,2019,1084,0.47,47,Medium-Low Digitalization,Medium Course ( >15H and <40H )
7071,41,39,2,2019,1084,0.94,94,High Digitalization,High Course ( >40H )
7072,79,47,32,2019,1084,0.59,59,Medium-High Digitalization,High Course ( >40H )
7073,47,36,11,2019,1084,0.76,76,Medium-High Digitalization,High Course ( >40H )
7074,14,9,5,2019,1084,0.64,64,Medium-High Digitalization,Small Course ( <15H )
7075,71,53,18,2019,1084,0.74,74,Medium-High Digitalization,High Course ( >40H )
7076,8,2,6,2019,1084,0.2,20,Low Digitalization,Small Course ( <15H )
7077,33,26,7,2019,1084,0.79,79,Medium-High Digitalization,Medium Course ( >15H and <40H )
7078,38,30,8,2019,1084,0.8,80,Medium-High Digitalization,Medium Course ( >15H and <40H )
7079,65,60,5,2019,1084,0.93,93,High Digitalization,High Course ( >40H )
7080,30,17,13,2019,1084,0.56,56,Medium-High Digitalization,Medium Course ( >15H and <40H )
7081,67,45,22,2019,1084,0.67,67,Medium-High Digitalization,High Course ( >40H )
7082,8,2,6,2019,1084,0.26,26,Medium-Low Digitalization,Small Course ( <15H )
7083,62,6,56,2019,1084,0.09,9,Low Digitalization,High Course ( >40H )
7084,22,17,5,2019,1084,0.77,77,Medium-High Digitalization,Medium Course ( >15H and <40H )
7085,51,24,27,2019,1084,0.48,48,Medium-Low Digitalization,High Course ( >40H )
7086,21,17,4,2019,1084,0.83,83,High Digitalization,Medium Course ( >15H and <40H )
7087,71,50,21,2019,1084,0.71,71,Medium-High Digitalization,High Course ( >40H )
7088,24,21,3,2019,1084,0.86,86,High Digitalization,Medium Course ( >15H and <40H )
7089,6,2,4,2019,1084,0.29,28,Medium-Low Digitalization,Small Course ( <15H )
7090,81,8,73,2019,1084,0.1,10,Low Digitalization,High Course ( >40H )
7091,11,2,9,2019,1084,0.21,21,Medium-Low Digitalization,Small Course ( <15H )
7092,74,62,12,2019,1084,0.84,84,High Digitalization,High Course ( >40H )
7093,14,12,2,2019,1084,0.88,88,High Digitalization,Small Course ( <15H )
7094,11,2,9,2019,1084,0.21,21,Medium-Low Digitalization,Small Course ( <15H )
7095,11,8,3,2019,1084,0.7,70,Medium-High Digitalization,Small Course ( <15H )
7096,58,57,1,2019,1084,0.99,99,High Digitalization,High Course ( >40H )
7097,74,46,28,2019,1084,0.62,62,Medium-High Digitalization,High Course ( >40H )
7098,75,11,64,2019,1084,0.14,14,Low Digitalization,High Course ( >40H )
7099,23,6,17,2019,1084,0.24,24,Medium-Low Digitalization,Medium Course ( >15H and <40H )
7100,15,15,0,2019,1084,1.0,100,High Digitalization,Small Course ( <15H )
7101,56,26,30,2019,1084,0.46,46,Medium-Low Digitalization,High Course ( >40H )
7102,57,26,31,2019,1084,0.46,46,Medium-Low Digitalization,High Course ( >40H )
7103,68,35,33,2019,1084,0.52,52,Medium-High Digitalization,High Course ( >40H )
7104,80,39,41,2019,1084,0.49,49,Medium-Low Digitalization,High Course ( >40H )
7105,81,32,49,2019,1084,0.39,39,Medium-Low Digitalization,High Course ( >40H )
7106,22,17,5,2019,1084,0.76,76,Medium-High Digitalization,Medium Course ( >15H and <40H )
7107,33,31,2,2019,1084,0.94,94,High Digitalization,Medium Course ( >15H and <40H )
7108,9,0,9,2019,1084,0.04,4,Low Digitalization,Small Course ( <15H )
7109,41,13,28,2019,1084,0.31,31,Medium-Low Digitalization,High Course ( >40H )
7110,9,3,6,2019,1084,0.37,37,Medium-Low Digitalization,Small Course ( <15H )
7111,8,7,1,2019,1084,0.85,85,High Digitalization,Small Course ( <15H )
7112,34,15,19,2019,1084,0.43,43,Medium-Low Digitalization,Medium Course ( >15H and <40H )
7113,90,81,9,2019,1084,0.9,90,High Digitalization,High Course ( >40H )
7114,21,10,11,2019,1084,0.48,48,Medium-Low Digitalization,Medium Course ( >15H and <40H )
7115,12,8,4,2019,1084,0.69,69,Medium-High Digitalization,Small Course ( <15H )
7116,14,7,7,2019,1084,0.5,50,Medium-Low Digitalization,Small Course ( <15H )
7117,52,17,35,2019,1084,0.32,32,Medium-Low Digitalization,High Course ( >40H )
7118,5,4,1,2019,1084,0.76,76,Medium-High Digitalization,Small Course ( <15H )
7119,20,18,2,2019,1084,0.9,90,High Digitalization,Medium Course ( >15H and <40H )
7120,7,4,3,2019,1084,0.63,63,Medium-High Digitalization,Small Course ( <15H )
7121,74,29,45,2019,1084,0.39,39,Medium-Low Digitalization,High Course ( >40H )
7122,60,24,36,2019,1084,0.4,40,Medium-Low Digitalization,High Course ( >40H )
7123,39,22,17,2019,1084,0.57,56,Medium-High Digitalization,Medium Course ( >15H and <40H )
7124,53,2,51,2019,1084,0.04,4,Low Digitalization,High Course ( >40H )
7125,23,3,20,2019,1084,0.12,12,Low Digitalization,Medium Course ( >15H and <40H )
7126,53,19,34,2019,1084,0.35,35,Medium-Low Digitalization,High Course ( >40H )
7127,52,47,5,2019,1084,0.9,90,High Digitalization,High Course ( >40H )
7128,44,34,10,2019,1084,0.78,78,Medium-High Digitalization,High Course ( >40H )
7129,44,31,13,2019,1084,0.71,71,Medium-High Digitalization,High Course ( >40H )
7130,17,17,0,2019,1084,0.98,98,High Digitalization,Medium Course ( >15H and <40H )
7131,58,37,21,2019,1084,0.64,64,Medium-High Digitalization,High Course ( >40H )
7132,5,5,0,2019,1084,0.93,93,High Digitalization,Small Course ( <15H )
7133,6,5,1,2019,1084,0.81,81,High Digitalization,Small Course ( <15H )
7134,39,24,15,2019,1084,0.62,62,Medium-High Digitalization,Medium Course ( >15H and <40H )
7135,12,12,0,2019,1084,0.98,98,High Digitalization,Small Course ( <15H )
7136,75,28,47,2019,1084,0.37,37,Medium-Low Digitalization,High Course ( >40H )
7137,39,32,7,2019,1084,0.82,82,High Digitalization,Medium Course ( >15H and <40H )
7138,81,63,18,2019,1084,0.78,78,Medium-High Digitalization,High Course ( >40H )
7139,35,22,13,2019,1084,0.64,64,Medium-High Digitalization,Medium Course ( >15H and <40H )
7140,13,11,2,2019,1084,0.88,88,High Digitalization,Small Course ( <15H )
7141,20,6,14,2019,1084,0.31,31,Medium-Low Digitalization,Medium Course ( >15H and <40H )
7142,34,30,4,2019,1084,0.88,88,High Digitalization,Medium Course ( >15H and <40H )
7143,85,14,71,2019,1084,0.17,17,Low Digitalization,High Course ( >40H )
7144,33,20,13,2019,1084,0.6,60,Medium-High Digitalization,Medium Course ( >15H and <40H )
7145,8,7,1,2019,1084,0.87,87,High Digitalization,Small Course ( <15H )
7146,13,7,6,2019,1084,0.56,56,Medium-High Digitalization,Small Course ( <15H )
7147,21,17,4,2019,1084,0.82,82,High Digitalization,Medium Course ( >15H and <40H )
7148,11,9,2,2019,1084,0.8,80,Medium-High Digitalization,Small Course ( <15H )
7149,11,5,6,2019,1084,0.47,47,Medium-Low Digitalization,Small Course ( <15H )
7150,12,6,6,2019,1084,0.53,53,Medium-High Digitalization,Small Course ( <15H )
7151,65,56,9,2019,1084,0.86,86,High Digitalization,High Course ( >40H )
7152,76,63,13,2019,1084,0.83,83,High Digitalization,High Course ( >40H )
7153,35,7,28,2019,1084,0.2,20,Low Digitalization,Medium Course ( >15H and <40H )
7154,9,7,2,2019,1084,0.77,77,Medium-High Digitalization,Small Course ( <15H )
7155,15,14,1,2019,1084,0.92,92,High Digitalization,Small Course ( <15H )
7156,60,8,52,2019,1084,0.13,13,Low Digitalization,High Course ( >40H )
7157,59,47,12,2019,1084,0.8,80,Medium-High Digitalization,High Course ( >40H )
7158,50,34,16,2019,1084,0.69,69,Medium-High Digitalization,High Course ( >40H )
7159,88,44,44,2019,1084,0.5,50,Medium-Low Digitalization,High Course ( >40H )
7160,14,2,12,2019,1084,0.14,14,Low Digitalization,Small Course ( <15H )
7161,48,43,5,2019,1084,0.9,90,High Digitalization,High Course ( >40H )
7162,6,2,4,2019,1084,0.34,34,Medium-Low Digitalization,Small Course ( <15H )
7163,13,8,5,2019,1084,0.58,57,Medium-High Digitalization,Small Course ( <15H )
7164,32,0,32,2019,1084,0.01,1,Low Digitalization,Medium Course ( >15H and <40H )
7165,80,67,13,2019,1084,0.84,84,High Digitalization,High Course ( >40H )
7166,9,8,1,2019,1084,0.86,86,High Digitalization,Small Course ( <15H )
7167,35,18,17,2019,1084,0.52,52,Medium-High Digitalization,Medium Course ( >15H and <40H )
7168,30,1,29,2019,1084,0.02,2,Low Digitalization,Medium Course ( >15H and <40H )
7169,25,6,19,2019,1084,0.24,24,Medium-Low Digitalization,Medium Course ( >15H and <40H )
7170,76,27,49,2019,1084,0.36,36,Medium-Low Digitalization,High Course ( >40H )
7171,12,5,7,2019,1084,0.45,45,Medium-Low Digitalization,Small Course ( <15H )
7172,23,9,14,2019,1084,0.41,41,Medium-Low Digitalization,Medium Course ( >15H and <40H )
7173,60,24,36,2019,1084,0.4,40,Medium-Low Digitalization,High Course ( >40H )
7174,7,5,2,2019,1084,0.76,76,Medium-High Digitalization,Small Course ( <15H )
7175,9,1,8,2019,1084,0.09,9,Low Digitalization,Small Course ( <15H )
7176,6,6,0,2019,1084,0.97,97,High Digitalization,Small Course ( <15H )
7177,7,3,4,2019,1084,0.46,46,Medium-Low Digitalization,Small Course ( <15H )
7178,59,34,25,2019,1084,0.57,56,Medium-High Digitalization,High Course ( >40H )
7179,71,59,12,2019,1084,0.83,83,High Digitalization,High Course ( >40H )
7180,14,4,10,2019,1084,0.27,27,Medium-Low Digitalization,Small Course ( <15H )
7181,13,4,9,2019,1084,0.34,34,Medium-Low Digitalization,Small Course ( <15H )
7182,28,8,20,2019,1084,0.28,28,Medium-Low Digitalization,Medium Course ( >15H and <40H )
7183,5,2,3,2019,1084,0.48,48,Medium-Low Digitalization,Small Course ( <15H )
7184,8,6,2,2019,1084,0.72,72,Medium-High Digitalization,Small Course ( <15H )
7185,12,8,4,2019,1084,0.63,63,Medium-High Digitalization,Small Course ( <15H )
7186,22,6,16,2019,1084,0.27,27,Medium-Low Digitalization,Medium Course ( >15H and <40H )
7187,62,51,11,2019,1084,0.82,82,High Digitalization,High Course ( >40H )
7188,32,7,25,2019,1084,0.22,22,Medium-Low Digitalization,Medium Course ( >15H and <40H )
7189,20,11,9,2019,1084,0.55,55,Medium-High Digitalization,Medium Course ( >15H and <40H )
7190,10,5,5,2019,1084,0.46,46,Medium-Low Digitalization,Small Course ( <15H )
7191,38,25,13,2019,1084,0.65,65,Medium-High Digitalization,Medium Course ( >15H and <40H )
7192,59,35,24,2019,1084,0.59,59,Medium-High Digitalization,High Course ( >40H )
7193,44,35,9,2019,1084,0.8,80,Medium-High Digitalization,High Course ( >40H )
7194,50,11,39,2019,1084,0.22,22,Medium-Low Digitalization,High Course ( >40H )
7195,81,64,17,2019,1084,0.79,79,Medium-High Digitalization,High Course ( >40H )
7196,70,5,65,2019,1084,0.07,7,Low Digitalization,High Course ( >40H )
7197,55,43,12,2019,1084,0.79,79,Medium-High Digitalization,High Course ( >40H )
7198,6,1,5,2019,1084,0.18,18,Low Digitalization,Small Course ( <15H )
7199,20,5,15,2019,1084,0.27,27,Medium-Low Digitalization,Medium Course ( >15H and <40H )
7200,29,14,14,2019,1084,0.5,50,Medium-Low Digitalization,Medium Course ( >15H and <40H )
7201,37,30,7,2019,1084,0.82,82,High Digitalization,Medium Course ( >15H and <40H )
7202,36,10,26,2019,1084,0.27,27,Medium-Low Digitalization,Medium Course ( >15H and <40H )
7203,13,8,5,2019,1084,0.64,64,Medium-High Digitalization,Small Course ( <15H )
7204,17,7,10,2019,1084,0.4,40,Medium-Low Digitalization,Medium Course ( >15H and <40H )
7205,35,18,17,2019,1084,0.51,51,Medium-High Digitalization,Medium Course ( >15H and <40H )
7206,8,2,6,2019,1084,0.3,30,Medium-Low Digitalization,Small Course ( <15H )
7207,8,1,7,2019,1084,0.15,15,Low Digitalization,Small Course ( <15H )
7208,36,21,15,2019,1084,0.59,59,Medium-High Digitalization,Medium Course ( >15H and <40H )
7209,35,20,15,2019,1084,0.56,56,Medium-High Digitalization,Medium Course ( >15H and <40H )
7210,59,6,53,2019,1084,0.11,11,Low Digitalization,High Course ( >40H )
7211,89,63,26,2019,1084,0.71,71,Medium-High Digitalization,High Course ( >40H )
7212,67,53,14,2019,1084,0.79,79,Medium-High Digitalization,High Course ( >40H )
7213,12,8,4,2019,1084,0.7,70,Medium-High Digitalization,Small Course ( <15H )
7214,10,2,8,2019,1084,0.19,19,Low Digitalization,Small Course ( <15H )
7215,23,14,9,2019,1084,0.61,61,Medium-High Digitalization,Medium Course ( >15H and <40H )
7216,87,70,17,2019,1084,0.81,81,High Digitalization,High Course ( >40H )
7217,20,9,11,2019,1084,0.46,46,Medium-Low Digitalization,Medium Course ( >15H and <40H )
7218,85,5,80,2019,1084,0.06,6,Low Digitalization,High Course ( >40H )
7219,61,47,14,2019,1084,0.77,77,Medium-High Digitalization,High Course ( >40H )
7220,32,29,3,2019,1084,0.91,91,High Digitalization,Medium Course ( >15H and <40H )
7221,62,46,16,2019,1084,0.74,74,Medium-High Digitalization,High Course ( >40H )
7222,11,3,8,2019,1084,0.28,28,Medium-Low Digitalization,Small Course ( <15H )
7223,89,56,33,2019,1084,0.63,63,Medium-High Digitalization,High Course ( >40H )
7224,36,10,26,2019,1084,0.27,27,Medium-Low Digitalization,Medium Course ( >15H and <40H )
7225,8,1,7,2019,1084,0.11,11,Low Digitalization,Small Course ( <15H )
7226,12,11,1,2019,1084,0.9,90,High Digitalization,Small Course ( <15H )
7227,50,26,24,2019,1084,0.53,53,Medium-High Digitalization,High Course ( >40H )
7228,22,8,14,2019,1084,0.35,35,Medium-Low Digitalization,Medium Course ( >15H and <40H )
7229,79,71,8,2019,1084,0.9,90,High Digitalization,High Course ( >40H )
7230,58,37,21,2019,1084,0.63,63,Medium-High Digitalization,High Course ( >40H )
7231,28,20,8,2019,1084,0.7,70,Medium-High Digitalization,Medium Course ( >15H and <40H )
7232,5,0,5,2019,1084,0.01,1,Low Digitalization,Small Course ( <15H )
7233,85,62,23,2019,1084,0.73,73,Medium-High Digitalization,High Course ( >40H )
7234,22,12,10,2019,1084,0.56,56,Medium-High Digitalization,Medium Course ( >15H and <40H )
7235,9,9,0,2019,1084,0.95,95,High Digitalization,Small Course ( <15H )
7236,12,8,4,2019,1084,0.69,69,Medium-High Digitalization,Small Course ( <15H )
7237,71,11,60,2019,1084,0.15,15,Low Digitalization,High Course ( >40H )
7238,11,6,6,2019,1084,0.5,50,Medium-Low Digitalization,Small Course ( <15H )
7239,9,0,9,2019,1084,0.0,0,Low Digitalization,Small Course ( <15H )
7240,75,67,8,2019,1084,0.89,89,High Digitalization,High Course ( >40H )
7241,83,25,58,2019,1084,0.3,30,Medium-Low Digitalization,High Course ( >40H )
7242,34,8,26,2019,1084,0.24,24,Medium-Low Digitalization,Medium Course ( >15H and <40H )
7243,37,20,17,2019,1084,0.54,54,Medium-High Digitalization,Medium Course ( >15H and <40H )
7244,81,72,9,2019,1084,0.89,89,High Digitalization,High Course ( >40H )
7245,7,2,5,2019,1084,0.29,28,Medium-Low Digitalization,Small Course ( <15H )
7246,18,8,10,2019,1084,0.47,47,Medium-Low Digitalization,Medium Course ( >15H and <40H )
7247,69,50,19,2019,1084,0.72,72,Medium-High Digitalization,High Course ( >40H )
7248,90,14,76,2019,1084,0.15,15,Low Digitalization,High Course ( >40H )
7249,42,14,28,2019,1084,0.33,33,Medium-Low Digitalization,High Course ( >40H )
7250,21,18,3,2019,1084,0.88,88,High Digitalization,Medium Course ( >15H and <40H )
7251,59,35,24,2019,1084,0.6,60,Medium-High Digitalization,High Course ( >40H )
7252,9,4,5,2019,1084,0.48,48,Medium-Low Digitalization,Small Course ( <15H )
7253,9,2,7,2019,1084,0.25,25,Medium-Low Digitalization,Small Course ( <15H )
7254,36,8,28,2019,1084,0.22,22,Medium-Low Digitalization,Medium Course ( >15H and <40H )
7255,11,10,1,2019,1084,0.88,88,High Digitalization,Small Course ( <15H )
7256,24,10,14,2019,1084,0.42,42,Medium-Low Digitalization,Medium Course ( >15H and <40H )
7257,43,16,27,2019,1084,0.37,37,Medium-Low Digitalization,High Course ( >40H )
7258,77,70,7,2019,1084,0.91,91,High Digitalization,High Course ( >40H )
7259,22,2,20,2019,1084,0.09,9,Low Digitalization,Medium Course ( >15H and <40H )
7260,11,5,6,2019,1084,0.46,46,Medium-Low Digitalization,Small Course ( <15H )
7261,59,41,18,2019,1084,0.7,70,Medium-High Digitalization,High Course ( >40H )
7262,13,13,0,2019,1084,0.97,97,High Digitalization,Small Course ( <15H )
7263,15,0,15,2019,1084,0.03,3,Low Digitalization,Small Course ( <15H )
7264,79,58,21,2019,1084,0.74,74,Medium-High Digitalization,High Course ( >40H )
7265,12,8,4,2019,1084,0.67,67,Medium-High Digitalization,Small Course ( <15H )
7266,10,6,4,2019,1084,0.6,60,Medium-High Digitalization,Small Course ( <15H )
7267,10,3,7,2019,1084,0.3,30,Medium-Low Digitalization,Small Course ( <15H )
7268,81,9,72,2019,1084,0.11,11,Low Digitalization,High Course ( >40H )
7269,45,37,8,2019,1084,0.82,82,High Digitalization,High Course ( >40H )
7270,30,20,10,2019,1084,0.65,65,Medium-High Digitalization,Medium Course ( >15H and <40H )
7271,11,9,2,2019,1084,0.83,83,High Digitalization,Small Course ( <15H )
7272,81,1,80,2019,1084,0.01,1,Low Digitalization,High Course ( >40H )
7273,72,18,54,2019,1084,0.25,25,Medium-Low Digitalization,High Course ( >40H )
7274,13,0,13,2019,1084,0.01,1,Low Digitalization,Small Course ( <15H )
7275,48,33,15,2019,1084,0.68,68,Medium-High Digitalization,High Course ( >40H )
7276,5,4,1,2019,1084,0.74,74,Medium-High Digitalization,Small Course ( <15H )
7277,31,9,22,2019,1084,0.3,30,Medium-Low Digitalization,Medium Course ( >15H and <40H )
7278,11,8,3,2019,1084,0.7,70,Medium-High Digitalization,Small Course ( <15H )
7279,19,16,3,2019,1084,0.82,82,High Digitalization,Medium Course ( >15H and <40H )
7280,25,20,6,2019,1084,0.78,78,Medium-High Digitalization,Medium Course ( >15H and <40H )
7281,57,53,4,2019,1084,0.93,93,High Digitalization,High Course ( >40H )
7282,44,9,35,2019,1084,0.2,20,Low Digitalization,High Course ( >40H )
7283,7,1,6,2019,1084,0.18,18,Low Digitalization,Small Course ( <15H )
7284,78,16,62,2019,1084,0.2,20,Low Digitalization,High Course ( >40H )
7285,43,42,1,2019,1084,0.98,98,High Digitalization,High Course ( >40H )
7286,46,5,41,2019,1084,0.11,11,Low Digitalization,High Course ( >40H )
7287,7,3,4,2019,1084,0.48,48,Medium-Low Digitalization,Small Course ( <15H )
7288,15,7,8,2019,1084,0.45,45,Medium-Low Digitalization,Small Course ( <15H )
7289,23,15,8,2019,1084,0.65,65,Medium-High Digitalization,Medium Course ( >15H and <40H )
7290,87,15,72,2019,1084,0.17,17,Low Digitalization,High Course ( >40H )
7291,36,17,19,2019,1084,0.46,46,Medium-Low Digitalization,Medium Course ( >15H and <40H )
7292,19,7,12,2019,1084,0.38,38,Medium-Low Digitalization,Medium Course ( >15H and <40H )
7293,15,5,10,2019,1084,0.35,35,Medium-Low Digitalization,Small Course ( <15H )
7294,18,0,18,2019,1084,0.01,1,Low Digitalization,Medium Course ( >15H and <40H )
7295,49,2,47,2019,1084,0.05,5,Low Digitalization,High Course ( >40H )
7296,59,31,28,2019,1084,0.52,52,Medium-High Digitalization,High Course ( >40H )
7297,54,25,29,2019,1084,0.47,47,Medium-Low Digitalization,High Course ( >40H )
7298,10,3,7,2019,1084,0.29,28,Medium-Low Digitalization,Small Course ( <15H )
7299,26,17,9,2019,1084,0.67,67,Medium-High Digitalization,Medium Course ( >15H and <40H )
7300,8,6,2,2019,1084,0.75,75,Medium-High Digitalization,Small Course ( <15H )
7301,8,2,6,2019,1084,0.27,27,Medium-Low Digitalization,Small Course ( <15H )
7302,85,53,32,2019,1084,0.62,62,Medium-High Digitalization,High Course ( >40H )
7303,5,3,2,2019,1084,0.66,66,Medium-High Digitalization,Small Course ( <15H )
7304,55,2,53,2019,1084,0.03,3,Low Digitalization,High Course ( >40H )
7305,70,15,55,2019,1084,0.21,21,Medium-Low Digitalization,High Course ( >40H )
7306,35,8,27,2019,1084,0.23,23,Medium-Low Digitalization,Medium Course ( >15H and <40H )
7307,19,0,19,2019,1084,0.01,1,Low Digitalization,Medium Course ( >15H and <40H )
7308,67,19,48,2019,1084,0.28,28,Medium-Low Digitalization,High Course ( >40H )
7309,43,18,25,2019,1084,0.41,41,Medium-Low Digitalization,High Course ( >40H )
7310,15,4,10,2019,1084,0.3,30,Medium-Low Digitalization,Small Course ( <15H )
7311,5,4,1,2019,1084,0.81,81,High Digitalization,Small Course ( <15H )
7312,23,21,2,2019,1084,0.91,91,High Digitalization,Medium Course ( >15H and <40H )
7313,30,28,2,2019,1084,0.92,92,High Digitalization,Medium Course ( >15H and <40H )
7314,6,4,2,2019,1084,0.64,64,Medium-High Digitalization,Small Course ( <15H )
7315,31,22,9,2019,1084,0.72,72,Medium-High Digitalization,Medium Course ( >15H and <40H )
7316,15,4,11,2019,1084,0.26,26,Medium-Low Digitalization,Small Course ( <15H )
7317,82,48,34,2019,1084,0.59,59,Medium-High Digitalization,High Course ( >40H )
7318,60,41,19,2019,1084,0.69,69,Medium-High Digitalization,High Course ( >40H )
7319,40,29,11,2019,1084,0.73,73,Medium-High Digitalization,High Course ( >40H )
7320,30,26,4,2019,1084,0.85,85,High Digitalization,Medium Course ( >15H and <40H )
7321,38,36,2,2019,1084,0.94,94,High Digitalization,Medium Course ( >15H and <40H )
7322,18,3,15,2019,1084,0.18,18,Low Digitalization,Medium Course ( >15H and <40H )
7323,26,20,6,2019,1084,0.75,75,Medium-High Digitalization,Medium Course ( >15H and <40H )
7324,26,6,20,2019,1084,0.25,25,Medium-Low Digitalization,Medium Course ( >15H and <40H )
7325,12,12,0,2019,1084,0.98,98,High Digitalization,Small Course ( <15H )
7326,54,30,24,2019,1084,0.55,55,Medium-High Digitalization,High Course ( >40H )
7327,13,4,9,2019,1084,0.3,30,Medium-Low Digitalization,Small Course ( <15H )
7328,5,3,2,2019,1084,0.58,57,Medium-High Digitalization,Small Course ( <15H )
7329,15,14,1,2019,1084,0.91,91,High Digitalization,Small Course ( <15H )
7330,21,14,7,2019,1084,0.68,68,Medium-High Digitalization,Medium Course ( >15H and <40H )
7331,65,6,58,2020,977,0.1,10,Low Digitalization,High Course ( >40H )
7332,8,6,2,2020,977,0.79,79,Medium-High Digitalization,Small Course ( <15H )
7333,28,16,12,2020,977,0.58,57,Medium-High Digitalization,Medium Course ( >15H and <40H )
7334,8,2,6,2020,977,0.27,27,Medium-Low Digitalization,Small Course ( <15H )
7335,33,4,29,2020,977,0.13,13,Low Digitalization,Medium Course ( >15H and <40H )
7336,76,14,62,2020,977,0.18,18,Low Digitalization,High Course ( >40H )
7337,65,20,46,2020,977,0.3,30,Medium-Low Digitalization,High Course ( >40H )
7338,11,2,9,2020,977,0.18,18,Low Digitalization,Small Course ( <15H )
7339,8,2,6,2020,977,0.25,25,Medium-Low Digitalization,Small Course ( <15H )
7340,25,2,22,2020,977,0.1,10,Low Digitalization,Medium Course ( >15H and <40H )
7341,84,24,60,2020,977,0.28,28,Medium-Low Digitalization,High Course ( >40H )
7342,8,2,6,2020,977,0.23,23,Medium-Low Digitalization,Small Course ( <15H )
7343,12,10,2,2020,977,0.85,85,High Digitalization,Small Course ( <15H )
7344,15,3,12,2020,977,0.2,20,Low Digitalization,Small Course ( <15H )
7345,42,21,21,2020,977,0.49,49,Medium-Low Digitalization,High Course ( >40H )
7346,19,18,1,2020,977,0.97,97,High Digitalization,Medium Course ( >15H and <40H )
7347,12,7,5,2020,977,0.55,55,Medium-High Digitalization,Small Course ( <15H )
7348,77,69,8,2020,977,0.9,90,High Digitalization,High Course ( >40H )
7349,51,34,17,2020,977,0.67,67,Medium-High Digitalization,High Course ( >40H )
7350,12,5,7,2020,977,0.4,40,Medium-Low Digitalization,Small Course ( <15H )
7351,50,42,8,2020,977,0.84,84,High Digitalization,High Course ( >40H )
7352,8,7,1,2020,977,0.82,82,High Digitalization,Small Course ( <15H )
7353,42,21,21,2020,977,0.5,50,Medium-Low Digitalization,High Course ( >40H )
7354,44,29,15,2020,977,0.66,66,Medium-High Digitalization,High Course ( >40H )
7355,22,11,11,2020,977,0.51,51,Medium-High Digitalization,Medium Course ( >15H and <40H )
7356,10,2,8,2020,977,0.24,24,Medium-Low Digitalization,Small Course ( <15H )
7357,25,19,6,2020,977,0.77,77,Medium-High Digitalization,Medium Course ( >15H and <40H )
7358,51,8,43,2020,977,0.16,16,Low Digitalization,High Course ( >40H )
7359,47,37,10,2020,977,0.79,79,Medium-High Digitalization,High Course ( >40H )
7360,82,66,16,2020,977,0.81,81,High Digitalization,High Course ( >40H )
7361,85,33,52,2020,977,0.39,39,Medium-Low Digitalization,High Course ( >40H )
7362,6,4,2,2020,977,0.62,62,Medium-High Digitalization,Small Course ( <15H )
7363,74,69,5,2020,977,0.93,93,High Digitalization,High Course ( >40H )
7364,6,3,3,2020,977,0.5,50,Medium-Low Digitalization,Small Course ( <15H )
7365,83,28,55,2020,977,0.34,34,Medium-Low Digitalization,High Course ( >40H )
7366,47,34,13,2020,977,0.73,73,Medium-High Digitalization,High Course ( >40H )
7367,34,32,2,2020,977,0.93,93,High Digitalization,Medium Course ( >15H and <40H )
7368,72,63,9,2020,977,0.88,88,High Digitalization,High Course ( >40H )
7369,48,25,23,2020,977,0.53,53,Medium-High Digitalization,High Course ( >40H )
7370,47,34,13,2020,977,0.73,73,Medium-High Digitalization,High Course ( >40H )
7371,74,46,28,2020,977,0.62,62,Medium-High Digitalization,High Course ( >40H )
7372,78,65,13,2020,977,0.83,83,High Digitalization,High Course ( >40H )
7373,89,48,41,2020,977,0.54,54,Medium-High Digitalization,High Course ( >40H )
7374,10,0,10,2020,977,0.02,2,Low Digitalization,Small Course ( <15H )
7375,50,34,16,2020,977,0.67,67,Medium-High Digitalization,High Course ( >40H )
7376,36,30,6,2020,977,0.84,84,High Digitalization,Medium Course ( >15H and <40H )
7377,26,22,4,2020,977,0.83,83,High Digitalization,Medium Course ( >15H and <40H )
7378,19,14,5,2020,977,0.72,72,Medium-High Digitalization,Medium Course ( >15H and <40H )
7379,20,9,11,2020,977,0.46,46,Medium-Low Digitalization,Medium Course ( >15H and <40H )
7380,11,4,7,2020,977,0.34,34,Medium-Low Digitalization,Small Course ( <15H )
7381,78,61,17,2020,977,0.78,78,Medium-High Digitalization,High Course ( >40H )
7382,58,17,41,2020,977,0.29,28,Medium-Low Digitalization,High Course ( >40H )
7383,7,3,4,2020,977,0.42,42,Medium-Low Digitalization,Small Course ( <15H )
7384,29,23,6,2020,977,0.78,78,Medium-High Digitalization,Medium Course ( >15H and <40H )
7385,41,8,33,2020,977,0.2,20,Low Digitalization,High Course ( >40H )
7386,35,4,32,2020,977,0.1,10,Low Digitalization,Medium Course ( >15H and <40H )
7387,9,1,8,2020,977,0.11,11,Low Digitalization,Small Course ( <15H )
7388,43,28,15,2020,977,0.64,64,Medium-High Digitalization,High Course ( >40H )
7389,11,3,8,2020,977,0.27,27,Medium-Low Digitalization,Small Course ( <15H )
7390,43,40,3,2020,977,0.92,92,High Digitalization,High Course ( >40H )
7391,46,9,37,2020,977,0.19,19,Low Digitalization,High Course ( >40H )
7392,10,5,5,2020,977,0.48,48,Medium-Low Digitalization,Small Course ( <15H )
7393,35,28,7,2020,977,0.79,79,Medium-High Digitalization,Medium Course ( >15H and <40H )
7394,11,10,1,2020,977,0.94,94,High Digitalization,Small Course ( <15H )
7395,90,5,85,2020,977,0.06,6,Low Digitalization,High Course ( >40H )
7396,46,30,16,2020,977,0.65,65,Medium-High Digitalization,High Course ( >40H )
7397,8,2,6,2020,977,0.2,20,Low Digitalization,Small Course ( <15H )
7398,25,20,5,2020,977,0.81,81,High Digitalization,Medium Course ( >15H and <40H )
7399,39,2,37,2020,977,0.04,4,Low Digitalization,Medium Course ( >15H and <40H )
7400,11,7,4,2020,977,0.65,65,Medium-High Digitalization,Small Course ( <15H )
7401,43,19,24,2020,977,0.44,44,Medium-Low Digitalization,High Course ( >40H )
7402,49,4,45,2020,977,0.08,8,Low Digitalization,High Course ( >40H )
7403,31,18,13,2020,977,0.59,59,Medium-High Digitalization,Medium Course ( >15H and <40H )
7404,35,12,23,2020,977,0.35,35,Medium-Low Digitalization,Medium Course ( >15H and <40H )
7405,13,9,4,2020,977,0.68,68,Medium-High Digitalization,Small Course ( <15H )
7406,58,39,19,2020,977,0.67,67,Medium-High Digitalization,High Course ( >40H )
7407,16,14,2,2020,977,0.9,90,High Digitalization,Medium Course ( >15H and <40H )
7408,40,19,21,2020,977,0.48,48,Medium-Low Digitalization,High Course ( >40H )
7409,14,6,8,2020,977,0.45,45,Medium-Low Digitalization,Small Course ( <15H )
7410,11,1,10,2020,977,0.08,8,Low Digitalization,Small Course ( <15H )
7411,24,21,3,2020,977,0.86,86,High Digitalization,Medium Course ( >15H and <40H )
7412,87,33,54,2020,977,0.38,38,Medium-Low Digitalization,High Course ( >40H )
7413,49,18,31,2020,977,0.36,36,Medium-Low Digitalization,High Course ( >40H )
7414,12,12,0,2020,977,0.99,99,High Digitalization,Small Course ( <15H )
7415,53,4,49,2020,977,0.07,7,Low Digitalization,High Course ( >40H )
7416,15,3,12,2020,977,0.17,17,Low Digitalization,Small Course ( <15H )
7417,5,1,4,2020,977,0.23,23,Medium-Low Digitalization,Small Course ( <15H )
7418,5,4,1,2020,977,0.76,76,Medium-High Digitalization,Small Course ( <15H )
7419,26,15,11,2020,977,0.58,57,Medium-High Digitalization,Medium Course ( >15H and <40H )
7420,76,34,42,2020,977,0.45,45,Medium-Low Digitalization,High Course ( >40H )
7421,59,38,21,2020,977,0.64,64,Medium-High Digitalization,High Course ( >40H )
7422,36,2,34,2020,977,0.05,5,Low Digitalization,Medium Course ( >15H and <40H )
7423,29,24,5,2020,977,0.84,84,High Digitalization,Medium Course ( >15H and <40H )
7424,45,7,38,2020,977,0.15,15,Low Digitalization,High Course ( >40H )
7425,79,18,61,2020,977,0.23,23,Medium-Low Digitalization,High Course ( >40H )
7426,29,14,15,2020,977,0.48,48,Medium-Low Digitalization,Medium Course ( >15H and <40H )
7427,67,24,43,2020,977,0.36,36,Medium-Low Digitalization,High Course ( >40H )
7428,13,3,10,2020,977,0.23,23,Medium-Low Digitalization,Small Course ( <15H )
7429,21,15,6,2020,977,0.73,73,Medium-High Digitalization,Medium Course ( >15H and <40H )
7430,53,34,19,2020,977,0.64,64,Medium-High Digitalization,High Course ( >40H )
7431,18,10,8,2020,977,0.58,57,Medium-High Digitalization,Medium Course ( >15H and <40H )
7432,47,19,28,2020,977,0.4,40,Medium-Low Digitalization,High Course ( >40H )
7433,78,69,9,2020,977,0.88,88,High Digitalization,High Course ( >40H )
7434,72,66,6,2020,977,0.92,92,High Digitalization,High Course ( >40H )
7435,28,21,7,2020,977,0.76,76,Medium-High Digitalization,Medium Course ( >15H and <40H )
7436,29,17,12,2020,977,0.58,57,Medium-High Digitalization,Medium Course ( >15H and <40H )
7437,60,25,35,2020,977,0.42,42,Medium-Low Digitalization,High Course ( >40H )
7438,78,62,16,2020,977,0.8,80,Medium-High Digitalization,High Course ( >40H )
7439,50,36,14,2020,977,0.72,72,Medium-High Digitalization,High Course ( >40H )
7440,52,19,33,2020,977,0.36,36,Medium-Low Digitalization,High Course ( >40H )
7441,71,46,25,2020,977,0.65,65,Medium-High Digitalization,High Course ( >40H )
7442,83,2,81,2020,977,0.03,3,Low Digitalization,High Course ( >40H )
7443,36,9,27,2020,977,0.25,25,Medium-Low Digitalization,Medium Course ( >15H and <40H )
7444,86,26,60,2020,977,0.3,30,Medium-Low Digitalization,High Course ( >40H )
7445,65,55,10,2020,977,0.85,85,High Digitalization,High Course ( >40H )
7446,52,1,51,2020,977,0.01,1,Low Digitalization,High Course ( >40H )
7447,14,11,3,2020,977,0.77,77,Medium-High Digitalization,Small Course ( <15H )
7448,42,3,39,2020,977,0.07,7,Low Digitalization,High Course ( >40H )
7449,36,14,22,2020,977,0.38,38,Medium-Low Digitalization,Medium Course ( >15H and <40H )
7450,27,8,19,2020,977,0.31,31,Medium-Low Digitalization,Medium Course ( >15H and <40H )
7451,11,6,6,2020,977,0.5,50,Medium-Low Digitalization,Small Course ( <15H )
7452,13,10,3,2020,977,0.74,74,Medium-High Digitalization,Small Course ( <15H )
7453,73,66,7,2020,977,0.9,90,High Digitalization,High Course ( >40H )
7454,75,23,52,2020,977,0.31,31,Medium-Low Digitalization,High Course ( >40H )
7455,43,33,10,2020,977,0.77,77,Medium-High Digitalization,High Course ( >40H )
7456,57,47,10,2020,977,0.82,82,High Digitalization,High Course ( >40H )
7457,60,53,7,2020,977,0.88,88,High Digitalization,High Course ( >40H )
7458,50,26,24,2020,977,0.51,51,Medium-High Digitalization,High Course ( >40H )
7459,82,76,6,2020,977,0.93,93,High Digitalization,High Course ( >40H )
7460,11,9,2,2020,977,0.8,80,Medium-High Digitalization,Small Course ( <15H )
7461,45,22,23,2020,977,0.48,48,Medium-Low Digitalization,High Course ( >40H )
7462,41,25,16,2020,977,0.62,62,Medium-High Digitalization,High Course ( >40H )
7463,81,32,49,2020,977,0.4,40,Medium-Low Digitalization,High Course ( >40H )
7464,84,56,28,2020,977,0.67,67,Medium-High Digitalization,High Course ( >40H )
7465,89,36,53,2020,977,0.41,41,Medium-Low Digitalization,High Course ( >40H )
7466,7,2,5,2020,977,0.28,28,Medium-Low Digitalization,Small Course ( <15H )
7467,26,13,13,2020,977,0.49,49,Medium-Low Digitalization,Medium Course ( >15H and <40H )
7468,18,7,11,2020,977,0.41,41,Medium-Low Digitalization,Medium Course ( >15H and <40H )
7469,65,1,64,2020,977,0.01,1,Low Digitalization,High Course ( >40H )
7470,15,7,8,2020,977,0.44,44,Medium-Low Digitalization,Small Course ( <15H )
7471,75,43,32,2020,977,0.57,56,Medium-High Digitalization,High Course ( >40H )
7472,8,2,6,2020,977,0.19,19,Low Digitalization,Small Course ( <15H )
7473,46,38,8,2020,977,0.83,83,High Digitalization,High Course ( >40H )
7474,6,3,3,2020,977,0.48,48,Medium-Low Digitalization,Small Course ( <15H )
7475,10,4,6,2020,977,0.43,43,Medium-Low Digitalization,Small Course ( <15H )
7476,38,23,15,2020,977,0.6,60,Medium-High Digitalization,Medium Course ( >15H and <40H )
7477,12,6,6,2020,977,0.51,51,Medium-High Digitalization,Small Course ( <15H )
7478,15,5,10,2020,977,0.35,35,Medium-Low Digitalization,Small Course ( <15H )
7479,82,72,10,2020,977,0.88,88,High Digitalization,High Course ( >40H )
7480,88,18,70,2020,977,0.2,20,Low Digitalization,High Course ( >40H )
7481,13,7,6,2020,977,0.54,54,Medium-High Digitalization,Small Course ( <15H )
7482,5,1,4,2020,977,0.11,11,Low Digitalization,Small Course ( <15H )
7483,13,1,12,2020,977,0.08,8,Low Digitalization,Small Course ( <15H )
7484,15,0,15,2020,977,0.03,3,Low Digitalization,Small Course ( <15H )
7485,13,5,8,2020,977,0.35,35,Medium-Low Digitalization,Small Course ( <15H )
7486,78,43,35,2020,977,0.55,55,Medium-High Digitalization,High Course ( >40H )
7487,60,15,45,2020,977,0.25,25,Medium-Low Digitalization,High Course ( >40H )
7488,46,20,26,2020,977,0.44,44,Medium-Low Digitalization,High Course ( >40H )
7489,9,2,7,2020,977,0.21,21,Medium-Low Digitalization,Small Course ( <15H )
7490,71,23,48,2020,977,0.32,32,Medium-Low Digitalization,High Course ( >40H )
7491,13,9,4,2020,977,0.71,71,Medium-High Digitalization,Small Course ( <15H )
7492,29,28,1,2020,977,0.96,96,High Digitalization,Medium Course ( >15H and <40H )
7493,8,4,4,2020,977,0.49,49,Medium-Low Digitalization,Small Course ( <15H )
7494,56,39,17,2020,977,0.7,70,Medium-High Digitalization,High Course ( >40H )
7495,76,17,59,2020,977,0.23,23,Medium-Low Digitalization,High Course ( >40H )
7496,36,7,29,2020,977,0.2,20,Low Digitalization,Medium Course ( >15H and <40H )
7497,9,7,2,2020,977,0.83,83,High Digitalization,Small Course ( <15H )
7498,44,41,3,2020,977,0.94,94,High Digitalization,High Course ( >40H )
7499,29,15,14,2020,977,0.53,53,Medium-High Digitalization,Medium Course ( >15H and <40H )
7500,8,8,0,2020,977,0.96,96,High Digitalization,Small Course ( <15H )
7501,37,3,34,2020,977,0.08,8,Low Digitalization,Medium Course ( >15H and <40H )
7502,22,13,9,2020,977,0.57,56,Medium-High Digitalization,Medium Course ( >15H and <40H )
7503,26,15,11,2020,977,0.59,59,Medium-High Digitalization,Medium Course ( >15H and <40H )
7504,42,18,24,2020,977,0.42,42,Medium-Low Digitalization,High Course ( >40H )
7505,21,21,0,2020,977,0.98,98,High Digitalization,Medium Course ( >15H and <40H )
7506,19,17,2,2020,977,0.9,90,High Digitalization,Medium Course ( >15H and <40H )
7507,49,34,15,2020,977,0.7,70,Medium-High Digitalization,High Course ( >40H )
7508,78,12,66,2020,977,0.16,16,Low Digitalization,High Course ( >40H )
7509,5,3,2,2020,977,0.52,52,Medium-High Digitalization,Small Course ( <15H )
7510,30,7,23,2020,977,0.23,23,Medium-Low Digitalization,Medium Course ( >15H and <40H )
7511,79,9,70,2020,977,0.12,12,Low Digitalization,High Course ( >40H )
7512,37,0,37,2020,977,0.01,1,Low Digitalization,Medium Course ( >15H and <40H )
7513,40,0,40,2020,977,0.01,1,Low Digitalization,High Course ( >40H )
7514,53,48,5,2020,977,0.9,90,High Digitalization,High Course ( >40H )
7515,69,66,3,2020,977,0.96,96,High Digitalization,High Course ( >40H )
7516,71,71,0,2020,977,1.0,100,High Digitalization,High Course ( >40H )
7517,9,4,5,2020,977,0.39,39,Medium-Low Digitalization,Small Course ( <15H )
7518,49,14,35,2020,977,0.29,28,Medium-Low Digitalization,High Course ( >40H )
7519,68,51,17,2020,977,0.75,75,Medium-High Digitalization,High Course ( >40H )
7520,6,4,2,2020,977,0.65,65,Medium-High Digitalization,Small Course ( <15H )
7521,29,5,24,2020,977,0.18,18,Low Digitalization,Medium Course ( >15H and <40H )
7522,14,1,13,2020,977,0.04,4,Low Digitalization,Small Course ( <15H )
7523,55,34,21,2020,977,0.61,61,Medium-High Digitalization,High Course ( >40H )
7524,18,4,14,2020,977,0.2,20,Low Digitalization,Medium Course ( >15H and <40H )
7525,6,0,6,2020,977,0.06,6,Low Digitalization,Small Course ( <15H )
7526,15,3,12,2020,977,0.19,19,Low Digitalization,Small Course ( <15H )
7527,12,6,6,2020,977,0.53,53,Medium-High Digitalization,Small Course ( <15H )
7528,14,14,0,2020,977,0.98,98,High Digitalization,Small Course ( <15H )
7529,36,24,12,2020,977,0.67,67,Medium-High Digitalization,Medium Course ( >15H and <40H )
7530,58,31,27,2020,977,0.54,54,Medium-High Digitalization,High Course ( >40H )
7531,34,1,33,2020,977,0.03,3,Low Digitalization,Medium Course ( >15H and <40H )
7532,87,77,10,2020,977,0.89,89,High Digitalization,High Course ( >40H )
7533,65,25,40,2020,977,0.39,39,Medium-Low Digitalization,High Course ( >40H )
7534,53,46,7,2020,977,0.87,87,High Digitalization,High Course ( >40H )
7535,76,35,41,2020,977,0.46,46,Medium-Low Digitalization,High Course ( >40H )
7536,30,8,22,2020,977,0.28,28,Medium-Low Digitalization,Medium Course ( >15H and <40H )
7537,7,7,0,2020,977,0.96,96,High Digitalization,Small Course ( <15H )
7538,53,21,32,2020,977,0.4,40,Medium-Low Digitalization,High Course ( >40H )
7539,37,37,0,2020,977,0.99,99,High Digitalization,Medium Course ( >15H and <40H )
7540,21,19,2,2020,977,0.9,90,High Digitalization,Medium Course ( >15H and <40H )
7541,14,5,9,2020,977,0.38,38,Medium-Low Digitalization,Small Course ( <15H )
7542,37,32,5,2020,977,0.86,86,High Digitalization,Medium Course ( >15H and <40H )
7543,22,1,21,2020,977,0.04,4,Low Digitalization,Medium Course ( >15H and <40H )
7544,30,3,27,2020,977,0.11,11,Low Digitalization,Medium Course ( >15H and <40H )
7545,13,12,1,2020,977,0.92,92,High Digitalization,Small Course ( <15H )
7546,16,2,14,2020,977,0.13,13,Low Digitalization,Medium Course ( >15H and <40H )
7547,20,12,8,2020,977,0.61,61,Medium-High Digitalization,Medium Course ( >15H and <40H )
7548,55,29,26,2020,977,0.53,53,Medium-High Digitalization,High Course ( >40H )
7549,33,24,9,2020,977,0.74,74,Medium-High Digitalization,Medium Course ( >15H and <40H )
7550,38,10,28,2020,977,0.26,26,Medium-Low Digitalization,Medium Course ( >15H and <40H )
7551,8,6,2,2020,977,0.79,79,Medium-High Digitalization,Small Course ( <15H )
7552,21,9,12,2020,977,0.45,45,Medium-Low Digitalization,Medium Course ( >15H and <40H )
7553,88,11,77,2020,977,0.12,12,Low Digitalization,High Course ( >40H )
7554,61,41,20,2020,977,0.67,67,Medium-High Digitalization,High Course ( >40H )
7555,60,2,58,2020,977,0.03,3,Low Digitalization,High Course ( >40H )
7556,87,35,52,2020,977,0.4,40,Medium-Low Digitalization,High Course ( >40H )
7557,41,31,10,2020,977,0.75,75,Medium-High Digitalization,High Course ( >40H )
7558,9,2,7,2020,977,0.21,21,Medium-Low Digitalization,Small Course ( <15H )
7559,19,9,10,2020,977,0.48,48,Medium-Low Digitalization,Medium Course ( >15H and <40H )
7560,10,3,7,2020,977,0.28,28,Medium-Low Digitalization,Small Course ( <15H )
7561,20,2,18,2020,977,0.1,10,Low Digitalization,Medium Course ( >15H and <40H )
7562,37,3,34,2020,977,0.08,8,Low Digitalization,Medium Course ( >15H and <40H )
7563,22,15,7,2020,977,0.68,68,Medium-High Digitalization,Medium Course ( >15H and <40H )
7564,57,31,26,2020,977,0.54,54,Medium-High Digitalization,High Course ( >40H )
7565,36,35,1,2020,977,0.98,98,High Digitalization,Medium Course ( >15H and <40H )
7566,39,21,18,2020,977,0.53,53,Medium-High Digitalization,Medium Course ( >15H and <40H )
7567,37,21,16,2020,977,0.56,56,Medium-High Digitalization,Medium Course ( >15H and <40H )
7568,19,12,7,2020,977,0.65,65,Medium-High Digitalization,Medium Course ( >15H and <40H )
7569,60,57,3,2020,977,0.95,95,High Digitalization,High Course ( >40H )
7570,41,31,10,2020,977,0.76,76,Medium-High Digitalization,High Course ( >40H )
7571,49,43,6,2020,977,0.87,87,High Digitalization,High Course ( >40H )
7572,55,7,48,2020,977,0.12,12,Low Digitalization,High Course ( >40H )
7573,15,8,7,2020,977,0.52,52,Medium-High Digitalization,Small Course ( <15H )
7574,54,19,35,2020,977,0.35,35,Medium-Low Digitalization,High Course ( >40H )
7575,8,4,4,2020,977,0.47,47,Medium-Low Digitalization,Small Course ( <15H )
7576,26,9,17,2020,977,0.34,34,Medium-Low Digitalization,Medium Course ( >15H and <40H )
7577,23,7,16,2020,977,0.32,32,Medium-Low Digitalization,Medium Course ( >15H and <40H )
7578,66,53,13,2020,977,0.8,80,Medium-High Digitalization,High Course ( >40H )
7579,30,11,19,2020,977,0.37,37,Medium-Low Digitalization,Medium Course ( >15H and <40H )
7580,85,78,7,2020,977,0.92,92,High Digitalization,High Course ( >40H )
7581,72,15,57,2020,977,0.21,21,Medium-Low Digitalization,High Course ( >40H )
7582,14,12,2,2020,977,0.83,83,High Digitalization,Small Course ( <15H )
7583,6,3,3,2020,977,0.52,52,Medium-High Digitalization,Small Course ( <15H )
7584,10,7,3,2020,977,0.74,74,Medium-High Digitalization,Small Course ( <15H )
7585,9,3,6,2020,977,0.33,33,Medium-Low Digitalization,Small Course ( <15H )
7586,19,17,2,2020,977,0.92,92,High Digitalization,Medium Course ( >15H and <40H )
7587,10,4,6,2020,977,0.39,39,Medium-Low Digitalization,Small Course ( <15H )
7588,33,7,26,2020,977,0.22,22,Medium-Low Digitalization,Medium Course ( >15H and <40H )
7589,14,7,7,2020,977,0.47,47,Medium-Low Digitalization,Small Course ( <15H )
7590,39,13,26,2020,977,0.34,34,Medium-Low Digitalization,Medium Course ( >15H and <40H )
7591,10,2,8,2020,977,0.16,16,Low Digitalization,Small Course ( <15H )
7592,72,32,40,2020,977,0.44,44,Medium-Low Digitalization,High Course ( >40H )
7593,40,39,1,2020,977,0.97,97,High Digitalization,High Course ( >40H )
7594,34,17,17,2020,977,0.51,51,Medium-High Digitalization,Medium Course ( >15H and <40H )
7595,29,11,18,2020,977,0.37,37,Medium-Low Digitalization,Medium Course ( >15H and <40H )
7596,75,16,58,2020,977,0.22,22,Medium-Low Digitalization,High Course ( >40H )
7597,14,1,13,2020,977,0.08,8,Low Digitalization,Small Course ( <15H )
7598,42,29,13,2020,977,0.68,68,Medium-High Digitalization,High Course ( >40H )
7599,11,5,6,2020,977,0.48,48,Medium-Low Digitalization,Small Course ( <15H )
7600,11,1,10,2020,977,0.13,13,Low Digitalization,Small Course ( <15H )
7601,7,2,5,2020,977,0.22,22,Medium-Low Digitalization,Small Course ( <15H )
7602,46,38,8,2020,977,0.82,82,High Digitalization,High Course ( >40H )
7603,28,2,26,2020,977,0.08,8,Low Digitalization,Medium Course ( >15H and <40H )
7604,23,13,10,2020,977,0.57,56,Medium-High Digitalization,Medium Course ( >15H and <40H )
7605,24,17,7,2020,977,0.7,70,Medium-High Digitalization,Medium Course ( >15H and <40H )
7606,47,10,37,2020,977,0.21,21,Medium-Low Digitalization,High Course ( >40H )
7607,45,25,20,2020,977,0.56,56,Medium-High Digitalization,High Course ( >40H )
7608,5,5,0,2020,977,0.93,93,High Digitalization,Small Course ( <15H )
7609,9,1,8,2020,977,0.15,15,Low Digitalization,Small Course ( <15H )
7610,45,34,11,2020,977,0.75,75,Medium-High Digitalization,High Course ( >40H )
7611,39,32,7,2020,977,0.82,82,High Digitalization,Medium Course ( >15H and <40H )
7612,36,30,6,2020,977,0.84,84,High Digitalization,Medium Course ( >15H and <40H )
7613,29,17,12,2020,977,0.59,59,Medium-High Digitalization,Medium Course ( >15H and <40H )
7614,35,32,3,2020,977,0.92,92,High Digitalization,Medium Course ( >15H and <40H )
7615,17,9,8,2020,977,0.54,54,Medium-High Digitalization,Medium Course ( >15H and <40H )
7616,11,11,0,2020,977,0.97,97,High Digitalization,Small Course ( <15H )
7617,45,14,31,2020,977,0.31,31,Medium-Low Digitalization,High Course ( >40H )
7618,15,13,2,2020,977,0.87,87,High Digitalization,Small Course ( <15H )
7619,81,23,58,2020,977,0.28,28,Medium-Low Digitalization,High Course ( >40H )
7620,10,3,7,2020,977,0.29,28,Medium-Low Digitalization,Small Course ( <15H )
7621,44,4,40,2020,977,0.09,9,Low Digitalization,High Course ( >40H )
7622,18,8,10,2020,977,0.43,43,Medium-Low Digitalization,Medium Course ( >15H and <40H )
7623,54,30,24,2020,977,0.55,55,Medium-High Digitalization,High Course ( >40H )
7624,45,13,32,2020,977,0.28,28,Medium-Low Digitalization,High Course ( >40H )
7625,76,16,60,2020,977,0.21,21,Medium-Low Digitalization,High Course ( >40H )
7626,6,2,4,2020,977,0.3,30,Medium-Low Digitalization,Small Course ( <15H )
7627,55,6,50,2020,977,0.1,10,Low Digitalization,High Course ( >40H )
7628,11,0,11,2020,977,0.0,0,Low Digitalization,Small Course ( <15H )
7629,13,4,9,2020,977,0.28,28,Medium-Low Digitalization,Small Course ( <15H )
7630,5,4,1,2020,977,0.84,84,High Digitalization,Small Course ( <15H )
7631,9,4,5,2020,977,0.46,46,Medium-Low Digitalization,Small Course ( <15H )
7632,75,43,32,2020,977,0.57,56,Medium-High Digitalization,High Course ( >40H )
7633,86,60,26,2020,977,0.7,70,Medium-High Digitalization,High Course ( >40H )
7634,75,12,63,2020,977,0.16,16,Low Digitalization,High Course ( >40H )
7635,10,3,7,2020,977,0.3,30,Medium-Low Digitalization,Small Course ( <15H )
7636,47,9,38,2020,977,0.19,19,Low Digitalization,High Course ( >40H )
7637,37,20,17,2020,977,0.54,54,Medium-High Digitalization,Medium Course ( >15H and <40H )
7638,52,24,28,2020,977,0.47,47,Medium-Low Digitalization,High Course ( >40H )
7639,7,1,6,2020,977,0.16,16,Low Digitalization,Small Course ( <15H )
7640,10,8,2,2020,977,0.76,76,Medium-High Digitalization,Small Course ( <15H )
7641,23,1,22,2020,977,0.06,6,Low Digitalization,Medium Course ( >15H and <40H )
7642,35,8,27,2020,977,0.22,22,Medium-Low Digitalization,Medium Course ( >15H and <40H )
7643,15,2,13,2020,977,0.15,15,Low Digitalization,Small Course ( <15H )
7644,18,15,3,2020,977,0.82,82,High Digitalization,Medium Course ( >15H and <40H )
7645,25,23,2,2020,977,0.93,93,High Digitalization,Medium Course ( >15H and <40H )
7646,67,34,33,2020,977,0.51,51,Medium-High Digitalization,High Course ( >40H )
7647,42,14,28,2020,977,0.33,33,Medium-Low Digitalization,High Course ( >40H )
7648,13,6,6,2020,977,0.5,50,Medium-Low Digitalization,Small Course ( <15H )
7649,15,9,6,2020,977,0.62,62,Medium-High Digitalization,Small Course ( <15H )
7650,65,31,34,2020,977,0.48,48,Medium-Low Digitalization,High Course ( >40H )
7651,7,2,5,2020,977,0.29,28,Medium-Low Digitalization,Small Course ( <15H )
7652,70,46,24,2020,977,0.66,66,Medium-High Digitalization,High Course ( >40H )
7653,55,38,16,2020,977,0.7,70,Medium-High Digitalization,High Course ( >40H )
7654,58,27,31,2020,977,0.46,46,Medium-Low Digitalization,High Course ( >40H )
7655,11,7,4,2020,977,0.62,62,Medium-High Digitalization,Small Course ( <15H )
7656,57,27,30,2020,977,0.48,48,Medium-Low Digitalization,High Course ( >40H )
7657,13,8,5,2020,977,0.65,65,Medium-High Digitalization,Small Course ( <15H )
7658,25,21,4,2020,977,0.84,84,High Digitalization,Medium Course ( >15H and <40H )
7659,65,32,33,2020,977,0.49,49,Medium-Low Digitalization,High Course ( >40H )
7660,48,0,48,2020,977,0.0,0,Low Digitalization,High Course ( >40H )
7661,47,17,30,2020,977,0.37,37,Medium-Low Digitalization,High Course ( >40H )
7662,58,9,49,2020,977,0.16,16,Low Digitalization,High Course ( >40H )
7663,21,7,14,2020,977,0.32,32,Medium-Low Digitalization,Medium Course ( >15H and <40H )
7664,55,25,30,2020,977,0.46,46,Medium-Low Digitalization,High Course ( >40H )
7665,34,18,16,2020,977,0.53,53,Medium-High Digitalization,Medium Course ( >15H and <40H )
7666,36,11,25,2020,977,0.31,31,Medium-Low Digitalization,Medium Course ( >15H and <40H )
7667,15,0,15,2020,977,0.0,0,Low Digitalization,Small Course ( <15H )
7668,9,2,7,2020,977,0.24,24,Medium-Low Digitalization,Small Course ( <15H )
7669,9,0,9,2020,977,0.01,1,Low Digitalization,Small Course ( <15H )
7670,28,26,2,2020,977,0.94,94,High Digitalization,Medium Course ( >15H and <40H )
7671,29,24,5,2020,977,0.82,82,High Digitalization,Medium Course ( >15H and <40H )
7672,80,74,6,2020,977,0.93,93,High Digitalization,High Course ( >40H )
7673,75,26,50,2020,977,0.34,34,Medium-Low Digitalization,High Course ( >40H )
7674,7,5,2,2020,977,0.72,72,Medium-High Digitalization,Small Course ( <15H )
7675,61,55,6,2020,977,0.9,90,High Digitalization,High Course ( >40H )
7676,13,10,3,2020,977,0.79,79,Medium-High Digitalization,Small Course ( <15H )
7677,7,0,7,2020,977,0.03,3,Low Digitalization,Small Course ( <15H )
7678,85,46,39,2020,977,0.54,54,Medium-High Digitalization,High Course ( >40H )
7679,30,26,4,2020,977,0.86,86,High Digitalization,Medium Course ( >15H and <40H )
7680,16,4,12,2020,977,0.24,24,Medium-Low Digitalization,Medium Course ( >15H and <40H )
7681,18,10,8,2020,977,0.57,56,Medium-High Digitalization,Medium Course ( >15H and <40H )
7682,15,6,9,2020,977,0.41,41,Medium-Low Digitalization,Small Course ( <15H )
7683,44,43,1,2020,977,0.98,98,High Digitalization,High Course ( >40H )
7684,40,1,39,2020,977,0.03,3,Low Digitalization,High Course ( >40H )
7685,6,5,1,2020,977,0.76,76,Medium-High Digitalization,Small Course ( <15H )
7686,6,2,4,2020,977,0.39,39,Medium-Low Digitalization,Small Course ( <15H )
7687,31,2,29,2020,977,0.07,7,Low Digitalization,Medium Course ( >15H and <40H )
7688,5,4,1,2020,977,0.83,83,High Digitalization,Small Course ( <15H )
7689,5,5,0,2020,977,0.96,96,High Digitalization,Small Course ( <15H )
7690,36,10,26,2020,977,0.28,28,Medium-Low Digitalization,Medium Course ( >15H and <40H )
7691,14,4,10,2020,977,0.26,26,Medium-Low Digitalization,Small Course ( <15H )
7692,33,0,33,2020,977,0.01,1,Low Digitalization,Medium Course ( >15H and <40H )
7693,74,1,73,2020,977,0.01,1,Low Digitalization,High Course ( >40H )
7694,13,1,12,2020,977,0.06,6,Low Digitalization,Small Course ( <15H )
7695,52,0,52,2020,977,0.0,0,Low Digitalization,High Course ( >40H )
7696,73,0,73,2020,977,0.0,0,Low Digitalization,High Course ( >40H )
7697,11,1,10,2020,977,0.12,12,Low Digitalization,Small Course ( <15H )
7698,24,11,13,2020,977,0.44,44,Medium-Low Digitalization,Medium Course ( >15H and <40H )
7699,72,68,4,2020,977,0.95,95,High Digitalization,High Course ( >40H )
7700,15,4,11,2020,977,0.29,28,Medium-Low Digitalization,Small Course ( <15H )
7701,14,5,9,2020,977,0.36,36,Medium-Low Digitalization,Small Course ( <15H )
7702,53,19,34,2020,977,0.36,36,Medium-Low Digitalization,High Course ( >40H )
7703,65,1,64,2020,977,0.02,2,Low Digitalization,High Course ( >40H )
7704,32,13,19,2020,977,0.41,41,Medium-Low Digitalization,Medium Course ( >15H and <40H )
7705,36,11,25,2020,977,0.31,31,Medium-Low Digitalization,Medium Course ( >15H and <40H )
7706,56,52,4,2020,977,0.92,92,High Digitalization,High Course ( >40H )
7707,29,12,17,2020,977,0.43,43,Medium-Low Digitalization,Medium Course ( >15H and <40H )
7708,28,12,16,2020,977,0.43,43,Medium-Low Digitalization,Medium Course ( >15H and <40H )
7709,57,48,9,2020,977,0.84,84,High Digitalization,High Course ( >40H )
7710,14,9,5,2020,977,0.66,66,Medium-High Digitalization,Small Course ( <15H )
7711,11,7,4,2020,977,0.65,65,Medium-High Digitalization,Small Course ( <15H )
7712,8,1,7,2020,977,0.18,18,Low Digitalization,Small Course ( <15H )
7713,33,7,26,2020,977,0.22,22,Medium-Low Digitalization,Medium Course ( >15H and <40H )
7714,73,15,58,2020,977,0.21,21,Medium-Low Digitalization,High Course ( >40H )
7715,67,48,19,2020,977,0.72,72,Medium-High Digitalization,High Course ( >40H )
7716,42,14,28,2020,977,0.34,34,Medium-Low Digitalization,High Course ( >40H )
7717,73,23,50,2020,977,0.31,31,Medium-Low Digitalization,High Course ( >40H )
7718,82,64,18,2020,977,0.78,78,Medium-High Digitalization,High Course ( >40H )
7719,9,2,7,2020,977,0.18,18,Low Digitalization,Small Course ( <15H )
7720,7,7,0,2020,977,0.95,95,High Digitalization,Small Course ( <15H )
7721,16,6,10,2020,977,0.36,36,Medium-Low Digitalization,Medium Course ( >15H and <40H )
7722,15,8,7,2020,977,0.52,52,Medium-High Digitalization,Small Course ( <15H )
7723,15,4,11,2020,977,0.27,27,Medium-Low Digitalization,Small Course ( <15H )
7724,41,16,25,2020,977,0.39,39,Medium-Low Digitalization,High Course ( >40H )
7725,50,8,42,2020,977,0.15,15,Low Digitalization,High Course ( >40H )
7726,12,3,9,2020,977,0.26,26,Medium-Low Digitalization,Small Course ( <15H )
7727,5,2,3,2020,977,0.4,40,Medium-Low Digitalization,Small Course ( <15H )
7728,53,16,37,2020,977,0.3,30,Medium-Low Digitalization,High Course ( >40H )
7729,26,17,9,2020,977,0.67,67,Medium-High Digitalization,Medium Course ( >15H and <40H )
7730,11,2,9,2020,977,0.18,18,Low Digitalization,Small Course ( <15H )
7731,68,36,32,2020,977,0.53,53,Medium-High Digitalization,High Course ( >40H )
7732,6,3,3,2020,977,0.53,53,Medium-High Digitalization,Small Course ( <15H )
7733,15,7,8,2020,977,0.45,45,Medium-Low Digitalization,Small Course ( <15H )
7734,56,53,3,2020,977,0.95,95,High Digitalization,High Course ( >40H )
7735,11,7,4,2020,977,0.66,66,Medium-High Digitalization,Small Course ( <15H )
7736,48,9,39,2020,977,0.18,18,Low Digitalization,High Course ( >40H )
7737,26,11,15,2020,977,0.43,43,Medium-Low Digitalization,Medium Course ( >15H and <40H )
7738,85,76,9,2020,977,0.89,89,High Digitalization,High Course ( >40H )
7739,60,38,22,2020,977,0.64,64,Medium-High Digitalization,High Course ( >40H )
7740,6,5,1,2020,977,0.85,85,High Digitalization,Small Course ( <15H )
7741,50,2,48,2020,977,0.03,3,Low Digitalization,High Course ( >40H )
7742,8,3,5,2020,977,0.39,39,Medium-Low Digitalization,Small Course ( <15H )
7743,61,25,36,2020,977,0.41,41,Medium-Low Digitalization,High Course ( >40H )
7744,40,26,14,2020,977,0.65,65,Medium-High Digitalization,High Course ( >40H )
7745,10,6,4,2020,977,0.55,55,Medium-High Digitalization,Small Course ( <15H )
7746,88,70,18,2020,977,0.79,79,Medium-High Digitalization,High Course ( >40H )
7747,26,1,25,2020,977,0.03,3,Low Digitalization,Medium Course ( >15H and <40H )
7748,73,60,13,2020,977,0.82,82,High Digitalization,High Course ( >40H )
7749,55,29,26,2020,977,0.52,52,Medium-High Digitalization,High Course ( >40H )
7750,68,54,14,2020,977,0.79,79,Medium-High Digitalization,High Course ( >40H )
7751,57,3,54,2020,977,0.05,5,Low Digitalization,High Course ( >40H )
7752,78,73,5,2020,977,0.94,94,High Digitalization,High Course ( >40H )
7753,21,1,20,2020,977,0.03,3,Low Digitalization,Medium Course ( >15H and <40H )
7754,30,13,17,2020,977,0.43,43,Medium-Low Digitalization,Medium Course ( >15H and <40H )
7755,82,17,65,2020,977,0.21,21,Medium-Low Digitalization,High Course ( >40H )
7756,14,13,1,2020,977,0.95,95,High Digitalization,Small Course ( <15H )
7757,19,12,7,2020,977,0.65,65,Medium-High Digitalization,Medium Course ( >15H and <40H )
7758,72,62,10,2020,977,0.86,86,High Digitalization,High Course ( >40H )
7759,6,3,3,2020,977,0.49,49,Medium-Low Digitalization,Small Course ( <15H )
7760,76,53,23,2020,977,0.7,70,Medium-High Digitalization,High Course ( >40H )
7761,6,4,2,2020,977,0.59,59,Medium-High Digitalization,Small Course ( <15H )
7762,11,4,7,2020,977,0.33,33,Medium-Low Digitalization,Small Course ( <15H )
7763,16,2,14,2020,977,0.13,13,Low Digitalization,Medium Course ( >15H and <40H )
7764,7,1,6,2020,977,0.19,19,Low Digitalization,Small Course ( <15H )
7765,47,35,12,2020,977,0.74,74,Medium-High Digitalization,High Course ( >40H )
7766,54,29,25,2020,977,0.53,53,Medium-High Digitalization,High Course ( >40H )
7767,11,7,4,2020,977,0.62,62,Medium-High Digitalization,Small Course ( <15H )
7768,80,51,29,2020,977,0.64,64,Medium-High Digitalization,High Course ( >40H )
7769,66,34,32,2020,977,0.51,51,Medium-High Digitalization,High Course ( >40H )
7770,15,5,10,2020,977,0.33,33,Medium-Low Digitalization,Small Course ( <15H )
7771,59,9,50,2020,977,0.16,16,Low Digitalization,High Course ( >40H )
7772,79,51,28,2020,977,0.64,64,Medium-High Digitalization,High Course ( >40H )
7773,54,51,3,2020,977,0.94,94,High Digitalization,High Course ( >40H )
7774,11,7,4,2020,977,0.6,60,Medium-High Digitalization,Small Course ( <15H )
7775,56,46,10,2020,977,0.82,82,High Digitalization,High Course ( >40H )
7776,7,6,1,2020,977,0.79,79,Medium-High Digitalization,Small Course ( <15H )
7777,85,12,73,2020,977,0.14,14,Low Digitalization,High Course ( >40H )
7778,8,3,5,2020,977,0.38,38,Medium-Low Digitalization,Small Course ( <15H )
7779,19,12,7,2020,977,0.62,62,Medium-High Digitalization,Medium Course ( >15H and <40H )
7780,8,2,6,2020,977,0.2,20,Low Digitalization,Small Course ( <15H )
7781,48,43,5,2020,977,0.89,89,High Digitalization,High Course ( >40H )
7782,9,3,6,2020,977,0.35,35,Medium-Low Digitalization,Small Course ( <15H )
7783,61,24,37,2020,977,0.39,39,Medium-Low Digitalization,High Course ( >40H )
7784,79,54,25,2020,977,0.68,68,Medium-High Digitalization,High Course ( >40H )
7785,46,12,34,2020,977,0.25,25,Medium-Low Digitalization,High Course ( >40H )
7786,59,6,53,2020,977,0.1,10,Low Digitalization,High Course ( >40H )
7787,42,40,2,2020,977,0.95,95,High Digitalization,High Course ( >40H )
7788,80,50,30,2020,977,0.63,63,Medium-High Digitalization,High Course ( >40H )
7789,21,8,13,2020,977,0.39,39,Medium-Low Digitalization,Medium Course ( >15H and <40H )
7790,12,5,7,2020,977,0.42,42,Medium-Low Digitalization,Small Course ( <15H )
7791,81,3,78,2020,977,0.04,4,Low Digitalization,High Course ( >40H )
7792,22,7,15,2020,977,0.32,32,Medium-Low Digitalization,Medium Course ( >15H and <40H )
7793,47,25,22,2020,977,0.53,53,Medium-High Digitalization,High Course ( >40H )
7794,28,23,5,2020,977,0.83,83,High Digitalization,Medium Course ( >15H and <40H )
7795,36,12,24,2020,977,0.34,34,Medium-Low Digitalization,Medium Course ( >15H and <40H )
7796,5,0,5,2020,977,0.08,8,Low Digitalization,Small Course ( <15H )
7797,42,32,10,2020,977,0.77,77,Medium-High Digitalization,High Course ( >40H )
7798,27,0,27,2020,977,0.01,1,Low Digitalization,Medium Course ( >15H and <40H )
7799,39,3,36,2020,977,0.08,8,Low Digitalization,Medium Course ( >15H and <40H )
7800,19,18,1,2020,977,0.96,96,High Digitalization,Medium Course ( >15H and <40H )
7801,15,5,10,2020,977,0.36,36,Medium-Low Digitalization,Small Course ( <15H )
7802,14,9,5,2020,977,0.67,67,Medium-High Digitalization,Small Course ( <15H )
7803,15,4,11,2020,977,0.29,28,Medium-Low Digitalization,Small Course ( <15H )
7804,9,1,8,2020,977,0.14,14,Low Digitalization,Small Course ( <15H )
7805,10,1,9,2020,977,0.14,14,Low Digitalization,Small Course ( <15H )
7806,60,21,39,2020,977,0.35,35,Medium-Low Digitalization,High Course ( >40H )
7807,7,4,3,2020,977,0.57,56,Medium-High Digitalization,Small Course ( <15H )
7808,43,6,37,2020,977,0.13,13,Low Digitalization,High Course ( >40H )
7809,47,26,21,2020,977,0.56,56,Medium-High Digitalization,High Course ( >40H )
7810,7,7,0,2020,977,1.0,100,High Digitalization,Small Course ( <15H )
7811,19,14,5,2020,977,0.75,75,Medium-High Digitalization,Medium Course ( >15H and <40H )
7812,53,4,49,2020,977,0.08,8,Low Digitalization,High Course ( >40H )
7813,43,20,23,2020,977,0.47,47,Medium-Low Digitalization,High Course ( >40H )
7814,11,7,4,2020,977,0.64,64,Medium-High Digitalization,Small Course ( <15H )
7815,42,7,35,2020,977,0.17,17,Low Digitalization,High Course ( >40H )
7816,43,30,13,2020,977,0.7,70,Medium-High Digitalization,High Course ( >40H )
7817,53,37,16,2020,977,0.7,70,Medium-High Digitalization,High Course ( >40H )
7818,12,3,9,2020,977,0.26,26,Medium-Low Digitalization,Small Course ( <15H )
7819,60,17,43,2020,977,0.29,28,Medium-Low Digitalization,High Course ( >40H )
7820,52,21,31,2020,977,0.41,41,Medium-Low Digitalization,High Course ( >40H )
7821,38,32,6,2020,977,0.84,84,High Digitalization,Medium Course ( >15H and <40H )
7822,47,5,42,2020,977,0.1,10,Low Digitalization,High Course ( >40H )
7823,31,10,21,2020,977,0.31,31,Medium-Low Digitalization,Medium Course ( >15H and <40H )
7824,39,33,6,2020,977,0.84,84,High Digitalization,Medium Course ( >15H and <40H )
7825,23,7,16,2020,977,0.31,31,Medium-Low Digitalization,Medium Course ( >15H and <40H )
7826,61,57,4,2020,977,0.94,94,High Digitalization,High Course ( >40H )
7827,39,2,37,2020,977,0.05,5,Low Digitalization,Medium Course ( >15H and <40H )
7828,17,12,5,2020,977,0.71,71,Medium-High Digitalization,Medium Course ( >15H and <40H )
7829,10,3,7,2020,977,0.27,27,Medium-Low Digitalization,Small Course ( <15H )
7830,6,1,5,2020,977,0.1,10,Low Digitalization,Small Course ( <15H )
7831,32,14,18,2020,977,0.43,43,Medium-Low Digitalization,Medium Course ( >15H and <40H )
7832,16,13,3,2020,977,0.81,81,High Digitalization,Medium Course ( >15H and <40H )
7833,15,2,13,2020,977,0.16,16,Low Digitalization,Small Course ( <15H )
7834,12,7,5,2020,977,0.6,60,Medium-High Digitalization,Small Course ( <15H )
7835,6,1,5,2020,977,0.09,9,Low Digitalization,Small Course ( <15H )
7836,58,16,42,2020,977,0.28,28,Medium-Low Digitalization,High Course ( >40H )
7837,15,13,2,2020,977,0.87,87,High Digitalization,Small Course ( <15H )
7838,32,7,25,2020,977,0.21,21,Medium-Low Digitalization,Medium Course ( >15H and <40H )
7839,36,25,11,2020,977,0.7,70,Medium-High Digitalization,Medium Course ( >15H and <40H )
7840,9,7,2,2020,977,0.79,79,Medium-High Digitalization,Small Course ( <15H )
7841,60,19,41,2020,977,0.32,32,Medium-Low Digitalization,High Course ( >40H )
7842,66,42,24,2020,977,0.64,64,Medium-High Digitalization,High Course ( >40H )
7843,50,24,26,2020,977,0.48,48,Medium-Low Digitalization,High Course ( >40H )
7844,20,10,10,2020,977,0.51,51,Medium-High Digitalization,Medium Course ( >15H and <40H )
7845,33,20,13,2020,977,0.61,61,Medium-High Digitalization,Medium Course ( >15H and <40H )
7846,33,19,14,2020,977,0.57,56,Medium-High Digitalization,Medium Course ( >15H and <40H )
7847,11,10,1,2020,977,0.91,91,High Digitalization,Small Course ( <15H )
7848,51,28,23,2020,977,0.55,55,Medium-High Digitalization,High Course ( >40H )
7849,36,27,9,2020,977,0.76,76,Medium-High Digitalization,Medium Course ( >15H and <40H )
7850,29,26,3,2020,977,0.89,89,High Digitalization,Medium Course ( >15H and <40H )
7851,42,29,13,2020,977,0.68,68,Medium-High Digitalization,High Course ( >40H )
7852,46,13,33,2020,977,0.28,28,Medium-Low Digitalization,High Course ( >40H )
7853,15,14,2,2020,977,0.9,90,High Digitalization,Small Course ( <15H )
7854,88,57,31,2020,977,0.65,65,Medium-High Digitalization,High Course ( >40H )
7855,8,2,6,2020,977,0.28,28,Medium-Low Digitalization,Small Course ( <15H )
7856,57,19,38,2020,977,0.33,33,Medium-Low Digitalization,High Course ( >40H )
7857,48,28,20,2020,977,0.59,59,Medium-High Digitalization,High Course ( >40H )
7858,52,20,32,2020,977,0.39,39,Medium-Low Digitalization,High Course ( >40H )
7859,36,18,18,2020,977,0.5,50,Medium-Low Digitalization,Medium Course ( >15H and <40H )
7860,6,4,2,2020,977,0.71,71,Medium-High Digitalization,Small Course ( <15H )
7861,87,17,70,2020,977,0.19,19,Low Digitalization,High Course ( >40H )
7862,59,34,25,2020,977,0.57,56,Medium-High Digitalization,High Course ( >40H )
7863,9,4,5,2020,977,0.42,42,Medium-Low Digitalization,Small Course ( <15H )
7864,49,49,0,2020,977,1.0,100,High Digitalization,High Course ( >40H )
7865,29,12,17,2020,977,0.4,40,Medium-Low Digitalization,Medium Course ( >15H and <40H )
7866,22,0,22,2020,977,0.01,1,Low Digitalization,Medium Course ( >15H and <40H )
7867,7,3,4,2020,977,0.36,36,Medium-Low Digitalization,Small Course ( <15H )
7868,12,4,8,2020,977,0.3,30,Medium-Low Digitalization,Small Course ( <15H )
7869,88,82,6,2020,977,0.93,93,High Digitalization,High Course ( >40H )
7870,22,1,21,2020,977,0.05,5,Low Digitalization,Medium Course ( >15H and <40H )
7871,5,5,0,2020,977,0.99,99,High Digitalization,Small Course ( <15H )
7872,25,18,7,2020,977,0.71,71,Medium-High Digitalization,Medium Course ( >15H and <40H )
7873,15,5,10,2020,977,0.31,31,Medium-Low Digitalization,Small Course ( <15H )
7874,46,31,15,2020,977,0.68,68,Medium-High Digitalization,High Course ( >40H )
7875,58,57,1,2020,977,0.99,99,High Digitalization,High Course ( >40H )
7876,72,70,2,2020,977,0.97,97,High Digitalization,High Course ( >40H )
7877,35,11,24,2020,977,0.32,32,Medium-Low Digitalization,Medium Course ( >15H and <40H )
7878,11,11,0,2020,977,0.99,99,High Digitalization,Small Course ( <15H )
7879,14,4,10,2020,977,0.31,31,Medium-Low Digitalization,Small Course ( <15H )
7880,59,44,15,2020,977,0.74,74,Medium-High Digitalization,High Course ( >40H )
7881,51,26,25,2020,977,0.51,51,Medium-High Digitalization,High Course ( >40H )
7882,87,14,73,2020,977,0.16,16,Low Digitalization,High Course ( >40H )
7883,88,25,63,2020,977,0.28,28,Medium-Low Digitalization,High Course ( >40H )
7884,20,6,14,2020,977,0.3,30,Medium-Low Digitalization,Medium Course ( >15H and <40H )
7885,19,1,18,2020,977,0.06,6,Low Digitalization,Medium Course ( >15H and <40H )
7886,60,20,40,2020,977,0.33,33,Medium-Low Digitalization,High Course ( >40H )
7887,55,35,20,2020,977,0.63,63,Medium-High Digitalization,High Course ( >40H )
7888,21,0,21,2020,977,0.01,1,Low Digitalization,Medium Course ( >15H and <40H )
7889,7,3,4,2020,977,0.48,48,Medium-Low Digitalization,Small Course ( <15H )
7890,34,20,14,2020,977,0.6,60,Medium-High Digitalization,Medium Course ( >15H and <40H )
7891,5,2,4,2020,977,0.3,30,Medium-Low Digitalization,Small Course ( <15H )
7892,77,8,69,2020,977,0.11,11,Low Digitalization,High Course ( >40H )
7893,7,1,6,2020,977,0.11,11,Low Digitalization,Small Course ( <15H )
7894,71,4,67,2020,977,0.06,6,Low Digitalization,High Course ( >40H )
7895,16,12,4,2020,977,0.72,72,Medium-High Digitalization,Medium Course ( >15H and <40H )
7896,23,11,12,2020,977,0.48,48,Medium-Low Digitalization,Medium Course ( >15H and <40H )
7897,18,10,8,2020,977,0.55,55,Medium-High Digitalization,Medium Course ( >15H and <40H )
7898,21,8,13,2020,977,0.4,40,Medium-Low Digitalization,Medium Course ( >15H and <40H )
7899,55,18,37,2020,977,0.33,33,Medium-Low Digitalization,High Course ( >40H )
7900,74,31,43,2020,977,0.42,42,Medium-Low Digitalization,High Course ( >40H )
7901,15,8,7,2020,977,0.55,55,Medium-High Digitalization,Small Course ( <15H )
7902,57,28,29,2020,977,0.49,49,Medium-Low Digitalization,High Course ( >40H )
7903,14,1,13,2020,977,0.04,4,Low Digitalization,Small Course ( <15H )
7904,73,22,51,2020,977,0.3,30,Medium-Low Digitalization,High Course ( >40H )
7905,35,7,28,2020,977,0.21,21,Medium-Low Digitalization,Medium Course ( >15H and <40H )
7906,5,4,1,2020,977,0.77,77,Medium-High Digitalization,Small Course ( <15H )
7907,51,10,41,2020,977,0.2,20,Low Digitalization,High Course ( >40H )
7908,51,35,16,2020,977,0.69,69,Medium-High Digitalization,High Course ( >40H )
7909,57,40,17,2020,977,0.7,70,Medium-High Digitalization,High Course ( >40H )
7910,54,38,16,2020,977,0.71,71,Medium-High Digitalization,High Course ( >40H )
7911,43,10,33,2020,977,0.23,23,Medium-Low Digitalization,High Course ( >40H )
7912,11,2,9,2020,977,0.19,19,Low Digitalization,Small Course ( <15H )
7913,67,49,18,2020,977,0.73,73,Medium-High Digitalization,High Course ( >40H )
7914,9,6,3,2020,977,0.64,64,Medium-High Digitalization,Small Course ( <15H )
7915,22,14,8,2020,977,0.65,65,Medium-High Digitalization,Medium Course ( >15H and <40H )
7916,16,15,1,2020,977,0.93,93,High Digitalization,Medium Course ( >15H and <40H )
7917,46,5,41,2020,977,0.1,10,Low Digitalization,High Course ( >40H )
7918,12,7,5,2020,977,0.61,61,Medium-High Digitalization,Small Course ( <15H )
7919,31,12,19,2020,977,0.39,39,Medium-Low Digitalization,Medium Course ( >15H and <40H )
7920,15,9,6,2020,977,0.59,59,Medium-High Digitalization,Small Course ( <15H )
7921,27,11,16,2020,977,0.4,40,Medium-Low Digitalization,Medium Course ( >15H and <40H )
7922,56,46,10,2020,977,0.82,82,High Digitalization,High Course ( >40H )
7923,5,2,3,2020,977,0.37,37,Medium-Low Digitalization,Small Course ( <15H )
7924,23,0,23,2020,977,0.01,1,Low Digitalization,Medium Course ( >15H and <40H )
7925,71,16,55,2020,977,0.22,22,Medium-Low Digitalization,High Course ( >40H )
7926,21,9,12,2020,977,0.41,41,Medium-Low Digitalization,Medium Course ( >15H and <40H )
7927,6,4,2,2020,977,0.64,64,Medium-High Digitalization,Small Course ( <15H )
7928,11,9,2,2020,977,0.78,78,Medium-High Digitalization,Small Course ( <15H )
7929,22,10,12,2020,977,0.45,45,Medium-Low Digitalization,Medium Course ( >15H and <40H )
7930,58,52,6,2020,977,0.9,90,High Digitalization,High Course ( >40H )
7931,6,5,1,2020,977,0.85,85,High Digitalization,Small Course ( <15H )
7932,44,12,32,2020,977,0.27,27,Medium-Low Digitalization,High Course ( >40H )
7933,15,14,1,2020,977,0.96,96,High Digitalization,Small Course ( <15H )
7934,50,3,47,2020,977,0.06,6,Low Digitalization,High Course ( >40H )
7935,89,60,29,2020,977,0.67,67,Medium-High Digitalization,High Course ( >40H )
7936,14,13,1,2020,977,0.93,93,High Digitalization,Small Course ( <15H )
7937,64,61,3,2020,977,0.95,95,High Digitalization,High Course ( >40H )
7938,68,65,3,2020,977,0.95,95,High Digitalization,High Course ( >40H )
7939,37,0,37,2020,977,0.01,1,Low Digitalization,Medium Course ( >15H and <40H )
7940,8,1,7,2020,977,0.16,16,Low Digitalization,Small Course ( <15H )
7941,30,23,7,2020,977,0.78,78,Medium-High Digitalization,Medium Course ( >15H and <40H )
7942,17,1,16,2020,977,0.04,4,Low Digitalization,Medium Course ( >15H and <40H )
7943,89,2,87,2020,977,0.02,2,Low Digitalization,High Course ( >40H )
7944,11,4,7,2020,977,0.4,40,Medium-Low Digitalization,Small Course ( <15H )
7945,19,5,14,2020,977,0.26,26,Medium-Low Digitalization,Medium Course ( >15H and <40H )
7946,58,7,51,2020,977,0.12,12,Low Digitalization,High Course ( >40H )
7947,59,37,22,2020,977,0.63,63,Medium-High Digitalization,High Course ( >40H )
7948,59,14,45,2020,977,0.24,24,Medium-Low Digitalization,High Course ( >40H )
7949,10,3,7,2020,977,0.3,30,Medium-Low Digitalization,Small Course ( <15H )
7950,40,37,3,2020,977,0.92,92,High Digitalization,High Course ( >40H )
7951,80,22,58,2020,977,0.27,27,Medium-Low Digitalization,High Course ( >40H )
7952,39,25,14,2020,977,0.64,64,Medium-High Digitalization,Medium Course ( >15H and <40H )
7953,11,9,2,2020,977,0.82,82,High Digitalization,Small Course ( <15H )
7954,12,6,6,2020,977,0.5,50,Medium-Low Digitalization,Small Course ( <15H )
7955,48,13,35,2020,977,0.27,27,Medium-Low Digitalization,High Course ( >40H )
7956,6,2,4,2020,977,0.26,26,Medium-Low Digitalization,Small Course ( <15H )
7957,16,13,3,2020,977,0.81,81,High Digitalization,Medium Course ( >15H and <40H )
7958,5,2,3,2020,977,0.33,33,Medium-Low Digitalization,Small Course ( <15H )
7959,19,17,2,2020,977,0.91,91,High Digitalization,Medium Course ( >15H and <40H )
7960,48,27,21,2020,977,0.56,56,Medium-High Digitalization,High Course ( >40H )
7961,14,10,4,2020,977,0.71,71,Medium-High Digitalization,Small Course ( <15H )
7962,21,15,6,2020,977,0.72,72,Medium-High Digitalization,Medium Course ( >15H and <40H )
7963,15,4,11,2020,977,0.25,25,Medium-Low Digitalization,Small Course ( <15H )
7964,12,8,4,2020,977,0.7,70,Medium-High Digitalization,Small Course ( <15H )
7965,15,11,4,2020,977,0.74,74,Medium-High Digitalization,Small Course ( <15H )
7966,85,74,11,2020,977,0.87,87,High Digitalization,High Course ( >40H )
7967,13,0,13,2020,977,0.0,0,Low Digitalization,Small Course ( <15H )
7968,44,9,35,2020,977,0.2,20,Low Digitalization,High Course ( >40H )
7969,22,0,22,2020,977,0.02,2,Low Digitalization,Medium Course ( >15H and <40H )
7970,79,67,12,2020,977,0.85,85,High Digitalization,High Course ( >40H )
7971,14,5,9,2020,977,0.38,38,Medium-Low Digitalization,Small Course ( <15H )
7972,20,17,3,2020,977,0.83,83,High Digitalization,Medium Course ( >15H and <40H )
7973,45,22,22,2020,977,0.5,50,Medium-Low Digitalization,High Course ( >40H )
7974,52,34,18,2020,977,0.66,66,Medium-High Digitalization,High Course ( >40H )
7975,87,11,76,2020,977,0.13,13,Low Digitalization,High Course ( >40H )
7976,66,12,54,2020,977,0.18,18,Low Digitalization,High Course ( >40H )
7977,9,9,0,2020,977,0.99,99,High Digitalization,Small Course ( <15H )
7978,6,5,1,2020,977,0.85,85,High Digitalization,Small Course ( <15H )
7979,56,38,18,2020,977,0.68,68,Medium-High Digitalization,High Course ( >40H )
7980,49,20,29,2020,977,0.4,40,Medium-Low Digitalization,High Course ( >40H )
7981,29,19,10,2020,977,0.65,65,Medium-High Digitalization,Medium Course ( >15H and <40H )
7982,8,4,4,2020,977,0.52,52,Medium-High Digitalization,Small Course ( <15H )
7983,50,25,25,2020,977,0.5,50,Medium-Low Digitalization,High Course ( >40H )
7984,43,36,7,2020,977,0.83,83,High Digitalization,High Course ( >40H )
7985,60,46,14,2020,977,0.76,76,Medium-High Digitalization,High Course ( >40H )
7986,12,2,10,2020,977,0.14,14,Low Digitalization,Small Course ( <15H )
7987,60,29,31,2020,977,0.48,48,Medium-Low Digitalization,High Course ( >40H )
7988,11,4,7,2020,977,0.36,36,Medium-Low Digitalization,Small Course ( <15H )
7989,13,4,9,2020,977,0.31,31,Medium-Low Digitalization,Small Course ( <15H )
7990,38,35,3,2020,977,0.92,92,High Digitalization,Medium Course ( >15H and <40H )
7991,79,13,66,2020,977,0.16,16,Low Digitalization,High Course ( >40H )
7992,12,9,3,2020,977,0.76,76,Medium-High Digitalization,Small Course ( <15H )
7993,79,26,53,2020,977,0.33,33,Medium-Low Digitalization,High Course ( >40H )
7994,31,15,16,2020,977,0.48,48,Medium-Low Digitalization,Medium Course ( >15H and <40H )
7995,67,11,56,2020,977,0.17,17,Low Digitalization,High Course ( >40H )
7996,44,26,18,2020,977,0.58,57,Medium-High Digitalization,High Course ( >40H )
7997,8,2,6,2020,977,0.25,25,Medium-Low Digitalization,Small Course ( <15H )
7998,25,12,14,2020,977,0.46,46,Medium-Low Digitalization,Medium Course ( >15H and <40H )
7999,8,0,8,2020,977,0.02,2,Low Digitalization,Small Course ( <15H )
8000,9,1,8,2020,977,0.07,7,Low Digitalization,Small Course ( <15H )
8001,32,10,22,2020,977,0.32,32,Medium-Low Digitalization,Medium Course ( >15H and <40H )
8002,5,2,3,2020,977,0.47,47,Medium-Low Digitalization,Small Course ( <15H )
8003,38,4,34,2020,977,0.11,11,Low Digitalization,Medium Course ( >15H and <40H )
8004,17,1,16,2020,977,0.08,8,Low Digitalization,Medium Course ( >15H and <40H )
8005,12,1,11,2020,977,0.07,7,Low Digitalization,Small Course ( <15H )
8006,89,61,28,2020,977,0.69,69,Medium-High Digitalization,High Course ( >40H )
8007,26,9,17,2020,977,0.35,35,Medium-Low Digitalization,Medium Course ( >15H and <40H )
8008,8,2,6,2020,977,0.28,28,Medium-Low Digitalization,Small Course ( <15H )
8009,61,54,7,2020,977,0.88,88,High Digitalization,High Course ( >40H )
8010,27,6,21,2020,977,0.24,24,Medium-Low Digitalization,Medium Course ( >15H and <40H )
8011,33,4,29,2020,977,0.11,11,Low Digitalization,Medium Course ( >15H and <40H )
8012,8,6,2,2020,977,0.74,74,Medium-High Digitalization,Small Course ( <15H )
8013,12,6,6,2020,977,0.48,48,Medium-Low Digitalization,Small Course ( <15H )
8014,59,8,51,2020,977,0.14,14,Low Digitalization,High Course ( >40H )
8015,36,25,11,2020,977,0.7,70,Medium-High Digitalization,Medium Course ( >15H and <40H )
8016,34,30,4,2020,977,0.87,87,High Digitalization,Medium Course ( >15H and <40H )
8017,90,68,22,2020,977,0.76,76,Medium-High Digitalization,High Course ( >40H )
8018,43,0,43,2020,977,0.0,0,Low Digitalization,High Course ( >40H )
8019,19,18,1,2020,977,0.94,94,High Digitalization,Medium Course ( >15H and <40H )
8020,9,4,5,2020,977,0.45,45,Medium-Low Digitalization,Small Course ( <15H )
8021,78,12,66,2020,977,0.16,16,Low Digitalization,High Course ( >40H )
8022,26,11,15,2020,977,0.43,43,Medium-Low Digitalization,Medium Course ( >15H and <40H )
8023,32,20,12,2020,977,0.64,64,Medium-High Digitalization,Medium Course ( >15H and <40H )
8024,75,68,8,2020,977,0.9,90,High Digitalization,High Course ( >40H )
8025,20,4,16,2020,977,0.2,20,Low Digitalization,Medium Course ( >15H and <40H )
8026,78,24,54,2020,977,0.31,31,Medium-Low Digitalization,High Course ( >40H )
8027,77,32,45,2020,977,0.42,42,Medium-Low Digitalization,High Course ( >40H )
8028,16,2,14,2020,977,0.13,13,Low Digitalization,Medium Course ( >15H and <40H )
8029,85,45,40,2020,977,0.53,53,Medium-High Digitalization,High Course ( >40H )
8030,7,3,4,2020,977,0.41,41,Medium-Low Digitalization,Small Course ( <15H )
8031,54,33,21,2020,977,0.61,61,Medium-High Digitalization,High Course ( >40H )
8032,49,10,39,2020,977,0.21,21,Medium-Low Digitalization,High Course ( >40H )
8033,53,24,29,2020,977,0.45,45,Medium-Low Digitalization,High Course ( >40H )
8034,67,27,40,2020,977,0.4,40,Medium-Low Digitalization,High Course ( >40H )
8035,6,2,4,2020,977,0.33,33,Medium-Low Digitalization,Small Course ( <15H )
8036,53,5,48,2020,977,0.1,10,Low Digitalization,High Course ( >40H )
8037,9,0,9,2020,977,0.05,5,Low Digitalization,Small Course ( <15H )
8038,9,6,3,2020,977,0.68,68,Medium-High Digitalization,Small Course ( <15H )
8039,15,13,2,2020,977,0.86,86,High Digitalization,Small Course ( <15H )
8040,40,15,25,2020,977,0.38,38,Medium-Low Digitalization,High Course ( >40H )
8041,20,5,15,2020,977,0.24,24,Medium-Low Digitalization,Medium Course ( >15H and <40H )
8042,44,24,20,2020,977,0.55,55,Medium-High Digitalization,High Course ( >40H )
8043,17,1,16,2020,977,0.05,5,Low Digitalization,Medium Course ( >15H and <40H )
8044,28,16,12,2020,977,0.57,56,Medium-High Digitalization,Medium Course ( >15H and <40H )
8045,84,24,60,2020,977,0.29,28,Medium-Low Digitalization,High Course ( >40H )
8046,44,27,17,2020,977,0.61,61,Medium-High Digitalization,High Course ( >40H )
8047,62,13,49,2020,977,0.21,21,Medium-Low Digitalization,High Course ( >40H )
8048,50,18,32,2020,977,0.36,36,Medium-Low Digitalization,High Course ( >40H )
8049,14,5,9,2020,977,0.34,34,Medium-Low Digitalization,Small Course ( <15H )
8050,56,24,32,2020,977,0.43,43,Medium-Low Digitalization,High Course ( >40H )
8051,51,31,20,2020,977,0.6,60,Medium-High Digitalization,High Course ( >40H )
8052,59,39,20,2020,977,0.66,66,Medium-High Digitalization,High Course ( >40H )
8053,31,13,18,2020,977,0.42,42,Medium-Low Digitalization,Medium Course ( >15H and <40H )
8054,70,17,53,2020,977,0.24,24,Medium-Low Digitalization,High Course ( >40H )
8055,77,14,63,2020,977,0.18,18,Low Digitalization,High Course ( >40H )
8056,86,68,18,2020,977,0.79,79,Medium-High Digitalization,High Course ( >40H )
8057,87,7,80,2020,977,0.08,8,Low Digitalization,High Course ( >40H )
8058,43,41,2,2020,977,0.96,96,High Digitalization,High Course ( >40H )
8059,34,30,4,2020,977,0.89,89,High Digitalization,Medium Course ( >15H and <40H )
8060,45,13,32,2020,977,0.28,28,Medium-Low Digitalization,High Course ( >40H )
8061,8,7,1,2020,977,0.89,89,High Digitalization,Small Course ( <15H )
8062,15,10,5,2020,977,0.65,65,Medium-High Digitalization,Small Course ( <15H )
8063,52,7,45,2020,977,0.14,14,Low Digitalization,High Course ( >40H )
8064,64,44,20,2020,977,0.69,69,Medium-High Digitalization,High Course ( >40H )
8065,34,18,16,2020,977,0.54,54,Medium-High Digitalization,Medium Course ( >15H and <40H )
8066,74,12,62,2020,977,0.16,16,Low Digitalization,High Course ( >40H )
8067,15,10,5,2020,977,0.67,67,Medium-High Digitalization,Small Course ( <15H )
8068,79,73,6,2020,977,0.92,92,High Digitalization,High Course ( >40H )
8069,12,5,7,2020,977,0.4,40,Medium-Low Digitalization,Small Course ( <15H )
8070,81,33,48,2020,977,0.41,41,Medium-Low Digitalization,High Course ( >40H )
8071,78,73,5,2020,977,0.93,93,High Digitalization,High Course ( >40H )
8072,56,33,23,2020,977,0.59,59,Medium-High Digitalization,High Course ( >40H )
8073,55,16,38,2020,977,0.3,30,Medium-Low Digitalization,High Course ( >40H )
8074,57,14,43,2020,977,0.25,25,Medium-Low Digitalization,High Course ( >40H )
8075,31,14,17,2020,977,0.46,46,Medium-Low Digitalization,Medium Course ( >15H and <40H )
8076,25,4,21,2020,977,0.16,16,Low Digitalization,Medium Course ( >15H and <40H )
8077,21,13,8,2020,977,0.6,60,Medium-High Digitalization,Medium Course ( >15H and <40H )
8078,48,36,12,2020,977,0.76,76,Medium-High Digitalization,High Course ( >40H )
8079,26,2,24,2020,977,0.08,8,Low Digitalization,Medium Course ( >15H and <40H )
8080,10,9,1,2020,977,0.86,86,High Digitalization,Small Course ( <15H )
8081,12,8,4,2020,977,0.68,68,Medium-High Digitalization,Small Course ( <15H )
8082,5,4,1,2020,977,0.8,80,Medium-High Digitalization,Small Course ( <15H )
8083,77,72,5,2020,977,0.93,93,High Digitalization,High Course ( >40H )
8084,34,5,29,2020,977,0.15,15,Low Digitalization,Medium Course ( >15H and <40H )
8085,7,0,7,2020,977,0.04,4,Low Digitalization,Small Course ( <15H )
8086,67,47,20,2020,977,0.7,70,Medium-High Digitalization,High Course ( >40H )
8087,31,22,9,2020,977,0.7,70,Medium-High Digitalization,Medium Course ( >15H and <40H )
8088,13,5,8,2020,977,0.36,36,Medium-Low Digitalization,Small Course ( <15H )
8089,82,41,41,2020,977,0.5,50,Medium-Low Digitalization,High Course ( >40H )
8090,38,21,17,2020,977,0.55,55,Medium-High Digitalization,Medium Course ( >15H and <40H )
8091,16,16,0,2020,977,0.99,99,High Digitalization,Medium Course ( >15H and <40H )
8092,22,7,15,2020,977,0.3,30,Medium-Low Digitalization,Medium Course ( >15H and <40H )
8093,7,3,4,2020,977,0.42,42,Medium-Low Digitalization,Small Course ( <15H )
8094,53,48,5,2020,977,0.9,90,High Digitalization,High Course ( >40H )
8095,5,2,3,2020,977,0.48,48,Medium-Low Digitalization,Small Course ( <15H )
8096,16,10,6,2020,977,0.62,62,Medium-High Digitalization,Medium Course ( >15H and <40H )
8097,30,10,20,2020,977,0.35,35,Medium-Low Digitalization,Medium Course ( >15H and <40H )
8098,12,12,0,2020,977,1.0,100,High Digitalization,Small Course ( <15H )
8099,55,25,30,2020,977,0.45,45,Medium-Low Digitalization,High Course ( >40H )
8100,46,25,21,2020,977,0.55,55,Medium-High Digitalization,High Course ( >40H )
8101,15,6,9,2020,977,0.38,38,Medium-Low Digitalization,Small Course ( <15H )
8102,27,16,11,2020,977,0.61,61,Medium-High Digitalization,Medium Course ( >15H and <40H )
8103,42,35,7,2020,977,0.83,83,High Digitalization,High Course ( >40H )
8104,55,20,35,2020,977,0.36,36,Medium-Low Digitalization,High Course ( >40H )
8105,22,11,11,2020,977,0.51,51,Medium-High Digitalization,Medium Course ( >15H and <40H )
8106,55,51,4,2020,977,0.92,92,High Digitalization,High Course ( >40H )
8107,11,3,8,2020,977,0.27,27,Medium-Low Digitalization,Small Course ( <15H )
8108,5,3,2,2020,977,0.61,61,Medium-High Digitalization,Small Course ( <15H )
8109,19,13,6,2020,977,0.68,68,Medium-High Digitalization,Medium Course ( >15H and <40H )
8110,29,14,14,2020,977,0.5,50,Medium-Low Digitalization,Medium Course ( >15H and <40H )
8111,11,10,1,2020,977,0.95,95,High Digitalization,Small Course ( <15H )
8112,67,44,23,2020,977,0.65,65,Medium-High Digitalization,High Course ( >40H )
8113,25,2,22,2020,977,0.1,10,Low Digitalization,Medium Course ( >15H and <40H )
8114,23,15,8,2020,977,0.65,65,Medium-High Digitalization,Medium Course ( >15H and <40H )
8115,5,0,5,2020,977,0.06,6,Low Digitalization,Small Course ( <15H )
8116,39,35,4,2020,977,0.9,90,High Digitalization,Medium Course ( >15H and <40H )
8117,60,50,10,2020,977,0.84,84,High Digitalization,High Course ( >40H )
8118,27,9,18,2020,977,0.35,35,Medium-Low Digitalization,Medium Course ( >15H and <40H )
8119,9,6,3,2020,977,0.65,65,Medium-High Digitalization,Small Course ( <15H )
8120,27,25,2,2020,977,0.94,94,High Digitalization,Medium Course ( >15H and <40H )
8121,57,4,53,2020,977,0.07,7,Low Digitalization,High Course ( >40H )
8122,35,10,25,2020,977,0.29,28,Medium-Low Digitalization,Medium Course ( >15H and <40H )
8123,7,5,2,2020,977,0.74,74,Medium-High Digitalization,Small Course ( <15H )
8124,15,3,12,2020,977,0.17,17,Low Digitalization,Small Course ( <15H )
8125,28,16,12,2020,977,0.58,57,Medium-High Digitalization,Medium Course ( >15H and <40H )
8126,6,2,4,2020,977,0.39,39,Medium-Low Digitalization,Small Course ( <15H )
8127,56,23,33,2020,977,0.41,41,Medium-Low Digitalization,High Course ( >40H )
8128,33,14,19,2020,977,0.41,41,Medium-Low Digitalization,Medium Course ( >15H and <40H )
8129,8,2,6,2020,977,0.27,27,Medium-Low Digitalization,Small Course ( <15H )
8130,51,5,46,2020,977,0.1,10,Low Digitalization,High Course ( >40H )
8131,75,22,53,2020,977,0.29,28,Medium-Low Digitalization,High Course ( >40H )
8132,46,39,7,2020,977,0.84,84,High Digitalization,High Course ( >40H )
8133,46,36,10,2020,977,0.78,78,Medium-High Digitalization,High Course ( >40H )
8134,49,20,29,2020,977,0.4,40,Medium-Low Digitalization,High Course ( >40H )
8135,50,28,22,2020,977,0.56,56,Medium-High Digitalization,High Course ( >40H )
8136,45,14,31,2020,977,0.32,32,Medium-Low Digitalization,High Course ( >40H )
8137,74,44,30,2020,977,0.59,59,Medium-High Digitalization,High Course ( >40H )
8138,56,21,35,2020,977,0.38,38,Medium-Low Digitalization,High Course ( >40H )
8139,60,58,2,2020,977,0.96,96,High Digitalization,High Course ( >40H )
8140,14,11,3,2020,977,0.8,80,Medium-High Digitalization,Small Course ( <15H )
8141,16,1,15,2020,977,0.07,7,Low Digitalization,Medium Course ( >15H and <40H )
8142,20,10,10,2020,977,0.49,49,Medium-Low Digitalization,Medium Course ( >15H and <40H )
8143,57,16,41,2020,977,0.28,28,Medium-Low Digitalization,High Course ( >40H )
8144,30,9,21,2020,977,0.29,28,Medium-Low Digitalization,Medium Course ( >15H and <40H )
8145,28,9,19,2020,977,0.32,32,Medium-Low Digitalization,Medium Course ( >15H and <40H )
8146,21,20,1,2020,977,0.94,94,High Digitalization,Medium Course ( >15H and <40H )
8147,55,36,19,2020,977,0.65,65,Medium-High Digitalization,High Course ( >40H )
8148,7,1,6,2020,977,0.08,8,Low Digitalization,Small Course ( <15H )
8149,48,11,37,2020,977,0.22,22,Medium-Low Digitalization,High Course ( >40H )
8150,27,25,2,2020,977,0.92,92,High Digitalization,Medium Course ( >15H and <40H )
8151,15,10,5,2020,977,0.66,66,Medium-High Digitalization,Small Course ( <15H )
8152,39,17,22,2020,977,0.43,43,Medium-Low Digitalization,Medium Course ( >15H and <40H )
8153,51,39,12,2020,977,0.77,77,Medium-High Digitalization,High Course ( >40H )
8154,69,19,50,2020,977,0.27,27,Medium-Low Digitalization,High Course ( >40H )
8155,32,13,19,2020,977,0.42,42,Medium-Low Digitalization,Medium Course ( >15H and <40H )
8156,24,6,18,2020,977,0.27,27,Medium-Low Digitalization,Medium Course ( >15H and <40H )
8157,56,53,3,2020,977,0.94,94,High Digitalization,High Course ( >40H )
8158,45,14,32,2020,977,0.3,30,Medium-Low Digitalization,High Course ( >40H )
8159,51,39,12,2020,977,0.76,76,Medium-High Digitalization,High Course ( >40H )
8160,15,14,1,2020,977,0.94,94,High Digitalization,Small Course ( <15H )
8161,12,8,4,2020,977,0.67,67,Medium-High Digitalization,Small Course ( <15H )
8162,51,26,26,2020,977,0.5,50,Medium-Low Digitalization,High Course ( >40H )
8163,72,6,66,2020,977,0.08,8,Low Digitalization,High Course ( >40H )
8164,6,2,4,2020,977,0.31,31,Medium-Low Digitalization,Small Course ( <15H )
8165,46,40,6,2020,977,0.86,86,High Digitalization,High Course ( >40H )
8166,10,0,10,2020,977,0.0,0,Low Digitalization,Small Course ( <15H )
8167,76,62,14,2020,977,0.81,81,High Digitalization,High Course ( >40H )
8168,35,25,10,2020,977,0.71,71,Medium-High Digitalization,Medium Course ( >15H and <40H )
8169,42,36,6,2020,977,0.86,86,High Digitalization,High Course ( >40H )
8170,6,3,3,2020,977,0.51,51,Medium-High Digitalization,Small Course ( <15H )
8171,36,36,0,2020,977,1.0,100,High Digitalization,Medium Course ( >15H and <40H )
8172,6,5,1,2020,977,0.89,89,High Digitalization,Small Course ( <15H )
8173,53,30,23,2020,977,0.56,56,Medium-High Digitalization,High Course ( >40H )
8174,62,28,34,2020,977,0.45,45,Medium-Low Digitalization,High Course ( >40H )
8175,58,43,15,2020,977,0.74,74,Medium-High Digitalization,High Course ( >40H )
8176,68,41,27,2020,977,0.6,60,Medium-High Digitalization,High Course ( >40H )
8177,51,29,22,2020,977,0.56,56,Medium-High Digitalization,High Course ( >40H )
8178,18,11,7,2020,977,0.59,59,Medium-High Digitalization,Medium Course ( >15H and <40H )
8179,15,5,10,2020,977,0.36,36,Medium-Low Digitalization,Small Course ( <15H )
8180,56,56,0,2020,977,1.0,100,High Digitalization,High Course ( >40H )
8181,50,34,16,2020,977,0.68,68,Medium-High Digitalization,High Course ( >40H )
8182,6,1,5,2020,977,0.15,15,Low Digitalization,Small Course ( <15H )
8183,70,10,60,2020,977,0.15,15,Low Digitalization,High Course ( >40H )
8184,5,4,1,2020,977,0.89,89,High Digitalization,Small Course ( <15H )
8185,75,24,51,2020,977,0.32,32,Medium-Low Digitalization,High Course ( >40H )
8186,83,32,51,2020,977,0.38,38,Medium-Low Digitalization,High Course ( >40H )
8187,56,43,13,2020,977,0.76,76,Medium-High Digitalization,High Course ( >40H )
8188,5,1,4,2020,977,0.23,23,Medium-Low Digitalization,Small Course ( <15H )
8189,70,20,50,2020,977,0.29,28,Medium-Low Digitalization,High Course ( >40H )
8190,57,42,15,2020,977,0.74,74,Medium-High Digitalization,High Course ( >40H )
8191,7,6,1,2020,977,0.86,86,High Digitalization,Small Course ( <15H )
8192,15,13,2,2020,977,0.89,89,High Digitalization,Small Course ( <15H )
8193,33,11,22,2020,977,0.34,34,Medium-Low Digitalization,Medium Course ( >15H and <40H )
8194,23,19,4,2020,977,0.83,83,High Digitalization,Medium Course ( >15H and <40H )
8195,75,44,31,2020,977,0.59,59,Medium-High Digitalization,High Course ( >40H )
8196,9,7,2,2020,977,0.73,73,Medium-High Digitalization,Small Course ( <15H )
8197,77,27,50,2020,977,0.35,35,Medium-Low Digitalization,High Course ( >40H )
8198,46,7,39,2020,977,0.15,15,Low Digitalization,High Course ( >40H )
8199,9,7,2,2020,977,0.79,79,Medium-High Digitalization,Small Course ( <15H )
8200,75,68,8,2020,977,0.9,90,High Digitalization,High Course ( >40H )
8201,15,4,11,2020,977,0.29,28,Medium-Low Digitalization,Small Course ( <15H )
8202,73,12,61,2020,977,0.17,17,Low Digitalization,High Course ( >40H )
8203,52,37,15,2020,977,0.71,71,Medium-High Digitalization,High Course ( >40H )
8204,15,6,9,2020,977,0.37,37,Medium-Low Digitalization,Small Course ( <15H )
8205,23,17,6,2020,977,0.72,72,Medium-High Digitalization,Medium Course ( >15H and <40H )
8206,41,5,36,2020,977,0.13,13,Low Digitalization,High Course ( >40H )
8207,8,7,1,2020,977,0.86,86,High Digitalization,Small Course ( <15H )
8208,11,6,5,2020,977,0.52,52,Medium-High Digitalization,Small Course ( <15H )
8209,90,34,56,2020,977,0.38,38,Medium-Low Digitalization,High Course ( >40H )
8210,8,4,4,2020,977,0.47,47,Medium-Low Digitalization,Small Course ( <15H )
8211,56,46,10,2020,977,0.82,82,High Digitalization,High Course ( >40H )
8212,21,4,17,2020,977,0.17,17,Low Digitalization,Medium Course ( >15H and <40H )
8213,71,68,3,2020,977,0.96,96,High Digitalization,High Course ( >40H )
8214,16,15,1,2020,977,0.92,92,High Digitalization,Medium Course ( >15H and <40H )
8215,23,4,19,2020,977,0.18,18,Low Digitalization,Medium Course ( >15H and <40H )
8216,39,24,15,2020,977,0.61,61,Medium-High Digitalization,Medium Course ( >15H and <40H )
8217,21,16,5,2020,977,0.78,78,Medium-High Digitalization,Medium Course ( >15H and <40H )
8218,60,5,55,2020,977,0.08,8,Low Digitalization,High Course ( >40H )
8219,11,2,9,2020,977,0.16,16,Low Digitalization,Small Course ( <15H )
8220,47,16,31,2020,977,0.33,33,Medium-Low Digitalization,High Course ( >40H )
8221,11,9,2,2020,977,0.85,85,High Digitalization,Small Course ( <15H )
8222,5,3,2,2020,977,0.6,60,Medium-High Digitalization,Small Course ( <15H )
8223,14,11,3,2020,977,0.78,78,Medium-High Digitalization,Small Course ( <15H )
8224,40,1,39,2020,977,0.03,3,Low Digitalization,High Course ( >40H )
8225,83,27,56,2020,977,0.33,33,Medium-Low Digitalization,High Course ( >40H )
8226,43,43,0,2020,977,1.0,100,High Digitalization,High Course ( >40H )
8227,68,11,57,2020,977,0.16,16,Low Digitalization,High Course ( >40H )
8228,35,9,26,2020,977,0.25,25,Medium-Low Digitalization,Medium Course ( >15H and <40H )
8229,8,7,1,2020,977,0.83,83,High Digitalization,Small Course ( <15H )
8230,15,5,10,2020,977,0.34,34,Medium-Low Digitalization,Small Course ( <15H )
8231,9,4,4,2020,977,0.5,50,Medium-Low Digitalization,Small Course ( <15H )
8232,35,2,33,2020,977,0.07,7,Low Digitalization,Medium Course ( >15H and <40H )
8233,7,2,5,2020,977,0.32,32,Medium-Low Digitalization,Small Course ( <15H )
8234,43,11,32,2020,977,0.26,26,Medium-Low Digitalization,High Course ( >40H )
8235,23,10,13,2020,977,0.42,42,Medium-Low Digitalization,Medium Course ( >15H and <40H )
8236,12,5,7,2020,977,0.42,42,Medium-Low Digitalization,Small Course ( <15H )
8237,43,40,3,2020,977,0.93,93,High Digitalization,High Course ( >40H )
8238,54,22,32,2020,977,0.4,40,Medium-Low Digitalization,High Course ( >40H )
8239,67,54,13,2020,977,0.81,81,High Digitalization,High Course ( >40H )
8240,37,3,34,2020,977,0.08,8,Low Digitalization,Medium Course ( >15H and <40H )
8241,46,42,4,2020,977,0.91,91,High Digitalization,High Course ( >40H )
8242,53,52,1,2020,977,0.98,98,High Digitalization,High Course ( >40H )
8243,55,24,31,2020,977,0.44,44,Medium-Low Digitalization,High Course ( >40H )
8244,68,12,56,2020,977,0.18,18,Low Digitalization,High Course ( >40H )
8245,72,38,34,2020,977,0.53,53,Medium-High Digitalization,High Course ( >40H )
8246,37,28,9,2020,977,0.76,76,Medium-High Digitalization,Medium Course ( >15H and <40H )
8247,7,3,4,2020,977,0.43,43,Medium-Low Digitalization,Small Course ( <15H )
8248,40,24,16,2020,977,0.59,59,Medium-High Digitalization,High Course ( >40H )
8249,53,51,2,2020,977,0.96,96,High Digitalization,High Course ( >40H )
8250,7,6,1,2020,977,0.83,83,High Digitalization,Small Course ( <15H )
8251,62,29,33,2020,977,0.47,47,Medium-Low Digitalization,High Course ( >40H )
8252,6,4,2,2020,977,0.69,69,Medium-High Digitalization,Small Course ( <15H )
8253,17,14,3,2020,977,0.85,85,High Digitalization,Medium Course ( >15H and <40H )
8254,72,12,60,2020,977,0.16,16,Low Digitalization,High Course ( >40H )
8255,54,28,26,2020,977,0.52,52,Medium-High Digitalization,High Course ( >40H )
8256,15,9,6,2020,977,0.59,59,Medium-High Digitalization,Small Course ( <15H )
8257,30,27,3,2020,977,0.9,90,High Digitalization,Medium Course ( >15H and <40H )
8258,6,4,2,2020,977,0.72,72,Medium-High Digitalization,Small Course ( <15H )
8259,78,51,27,2020,977,0.65,65,Medium-High Digitalization,High Course ( >40H )
8260,37,2,35,2020,977,0.05,5,Low Digitalization,Medium Course ( >15H and <40H )
8261,11,10,1,2020,977,0.88,88,High Digitalization,Small Course ( <15H )
8262,58,12,46,2020,977,0.2,20,Low Digitalization,High Course ( >40H )
8263,12,5,7,2020,977,0.45,45,Medium-Low Digitalization,Small Course ( <15H )
8264,79,13,66,2020,977,0.16,16,Low Digitalization,High Course ( >40H )
8265,24,18,6,2020,977,0.77,77,Medium-High Digitalization,Medium Course ( >15H and <40H )
8266,29,10,19,2020,977,0.33,33,Medium-Low Digitalization,Medium Course ( >15H and <40H )
8267,41,31,10,2020,977,0.76,76,Medium-High Digitalization,High Course ( >40H )
8268,11,8,3,2020,977,0.73,73,Medium-High Digitalization,Small Course ( <15H )
8269,8,0,8,2020,977,0.05,5,Low Digitalization,Small Course ( <15H )
8270,85,63,22,2020,977,0.74,74,Medium-High Digitalization,High Course ( >40H )
8271,8,2,6,2020,977,0.22,22,Medium-Low Digitalization,Small Course ( <15H )
8272,6,4,2,2020,977,0.59,59,Medium-High Digitalization,Small Course ( <15H )
8273,12,4,8,2020,977,0.36,36,Medium-Low Digitalization,Small Course ( <15H )
8274,15,6,9,2020,977,0.43,43,Medium-Low Digitalization,Small Course ( <15H )
8275,15,9,6,2020,977,0.63,63,Medium-High Digitalization,Small Course ( <15H )
8276,39,10,29,2020,977,0.25,25,Medium-Low Digitalization,Medium Course ( >15H and <40H )
8277,44,18,26,2020,977,0.4,40,Medium-Low Digitalization,High Course ( >40H )
8278,13,7,6,2020,977,0.54,54,Medium-High Digitalization,Small Course ( <15H )
8279,84,25,59,2020,977,0.3,30,Medium-Low Digitalization,High Course ( >40H )
8280,36,8,28,2020,977,0.23,23,Medium-Low Digitalization,Medium Course ( >15H and <40H )
8281,10,6,4,2020,977,0.58,57,Medium-High Digitalization,Small Course ( <15H )
8282,33,30,3,2020,977,0.92,92,High Digitalization,Medium Course ( >15H and <40H )
8283,66,15,51,2020,977,0.23,23,Medium-Low Digitalization,High Course ( >40H )
8284,42,33,9,2020,977,0.78,78,Medium-High Digitalization,High Course ( >40H )
8285,7,3,4,2020,977,0.49,49,Medium-Low Digitalization,Small Course ( <15H )
8286,5,3,2,2020,977,0.61,61,Medium-High Digitalization,Small Course ( <15H )
8287,55,23,32,2020,977,0.41,41,Medium-Low Digitalization,High Course ( >40H )
8288,41,35,6,2020,977,0.85,85,High Digitalization,High Course ( >40H )
8289,48,29,19,2020,977,0.6,60,Medium-High Digitalization,High Course ( >40H )
8290,31,10,21,2020,977,0.32,32,Medium-Low Digitalization,Medium Course ( >15H and <40H )
8291,86,9,77,2020,977,0.11,11,Low Digitalization,High Course ( >40H )
8292,15,1,14,2020,977,0.07,7,Low Digitalization,Small Course ( <15H )
8293,28,12,16,2020,977,0.44,44,Medium-Low Digitalization,Medium Course ( >15H and <40H )
8294,53,23,30,2020,977,0.43,43,Medium-Low Digitalization,High Course ( >40H )
8295,20,3,17,2020,977,0.16,16,Low Digitalization,Medium Course ( >15H and <40H )
8296,6,5,1,2020,977,0.86,86,High Digitalization,Small Course ( <15H )
8297,90,28,62,2020,977,0.31,31,Medium-Low Digitalization,High Course ( >40H )
8298,15,12,3,2020,977,0.77,77,Medium-High Digitalization,Small Course ( <15H )
8299,80,59,21,2020,977,0.74,74,Medium-High Digitalization,High Course ( >40H )
8300,7,3,4,2020,977,0.42,42,Medium-Low Digitalization,Small Course ( <15H )
8301,36,24,12,2020,977,0.66,66,Medium-High Digitalization,Medium Course ( >15H and <40H )
8302,12,7,5,2020,977,0.58,57,Medium-High Digitalization,Small Course ( <15H )
8303,12,4,8,2020,977,0.32,32,Medium-Low Digitalization,Small Course ( <15H )
8304,56,22,34,2020,977,0.4,40,Medium-Low Digitalization,High Course ( >40H )
8305,17,16,1,2020,977,0.96,96,High Digitalization,Medium Course ( >15H and <40H )
8306,26,19,7,2020,977,0.73,73,Medium-High Digitalization,Medium Course ( >15H and <40H )
8307,30,27,3,2020,977,0.89,89,High Digitalization,Medium Course ( >15H and <40H )
