,Year,Departement,Module_ID,Module,Chapter_ID,Chapter,Quiz_perChapter,Quizz_ID,Rank_onChapter,Quizz_Type,Slip,Guess,Success_Prct,Success_Attempts,Failure_Attempts,Number_Attempts,UniQ_Learner,Sucessful_Learners,Unsucessful_Learners,Avg_Attempts,Percent_Learners_Success,Predict_Difficulty,Correct_Difficulty,Score,Difficulty_String,Difficulty,Department
0,2015,Droit,1,Histoire du Droit,1,La Grèce,9,1,1,QCU,0.22,0.51,53.77,8,6,14,10,8,2,1.4,80.0,Facile,Moyen,-1,Plus Difficile,Pas Adapte,Law
1124,2016,Droit,1,Histoire du Droit,1,La Grèce,9,1,1,QCU,0.08,0.99,99.63,12,0,12,12,12,0,1.0,100.0,Facile,Facile,0,Meme Difficulté,Pas Adapte,Law
2248,2017,Droit,1,Histoire du Droit,1,La Grèce,9,1,1,QCU,0.47,0.27,9.03,1,9,10,4,1,3,2.5,25.0,Moyen,Difficile,-1,Plus Difficile,Pas Adapte,Law
3372,2018,Droit,1,Histoire du Droit,1,La Grèce,9,1,1,QCU,0.58,0.22,25.82,2,6,8,3,2,1,2.67,66.67,Moyen,Difficile,-1,Plus Difficile,Pas Adapte,Law
4496,2019,Droit,1,Histoire du Droit,1,La Grèce,9,1,1,QCU,0.53,0.3,8.29,1,8,9,8,1,7,1.12,12.5,Moyen,Difficile,-1,Plus Difficile,Pas Adapte,Law
5620,2020,Droit,1,Histoire du Droit,1,La Grèce,9,1,1,QCU,0.64,0.31,26.08,2,7,9,3,2,1,3.0,66.67,Difficile,Difficile,0,Meme Difficulté,Pas Adapte,Law
1,2015,Droit,1,Histoire du Droit,1,La Grèce,9,2,2,QCU,0.68,0.27,18.34,4,19,23,13,4,9,1.77,30.77,Difficile,Difficile,0,Meme Difficulté,Pas Adapte,Law
1125,2016,Droit,1,Histoire du Droit,1,La Grèce,9,2,2,QCU,0.35,0.62,58.53,13,9,22,18,13,5,1.22,72.22,Difficile,Moyen,1,Plus Facile,Pas Adapte,Law
2249,2017,Droit,1,Histoire du Droit,1,La Grèce,9,2,2,QCU,0.72,0.24,34.66,8,16,24,23,8,15,1.04,34.78,Facile,Difficile,-2,Beaucoup plus Difficile,Pas Adapte,Law
3373,2018,Droit,1,Histoire du Droit,1,La Grèce,9,2,2,QCU,0.69,0.37,31.41,8,17,25,17,8,9,1.47,47.06,Facile,Difficile,-2,Beaucoup plus Difficile,Pas Adapte,Law
4497,2019,Droit,1,Histoire du Droit,1,La Grèce,9,2,2,QCU,0.73,0.3,21.23,6,22,28,16,6,10,1.75,37.5,Moyen,Difficile,-1,Plus Difficile,Pas Adapte,Law
5621,2020,Droit,1,Histoire du Droit,1,La Grèce,9,2,2,QCU,0.14,0.82,70.85,19,8,27,23,19,4,1.17,82.61,Facile,Facile,0,Meme Difficulté,Adapte,Law
2,2015,Droit,1,Histoire du Droit,1,La Grèce,9,3,3,QCM,0.1,0.99,82.42,41,9,50,47,41,6,1.06,87.23,Moyen,Facile,1,Plus Facile,Pas Adapte,Law
1126,2016,Droit,1,Histoire du Droit,1,La Grèce,9,3,3,QCM,0.55,0.23,11.28,5,42,47,41,5,36,1.15,12.2,Facile,Difficile,-2,Beaucoup plus Difficile,Pas Adapte,Law
2250,2017,Droit,1,Histoire du Droit,1,La Grèce,9,3,3,QCM,0.48,0.45,36.8,17,29,46,25,17,8,1.84,68.0,Facile,Moyen,-1,Plus Difficile,Pas Adapte,Law
3374,2018,Droit,1,Histoire du Droit,1,La Grèce,9,3,3,QCM,0.15,0.92,84.79,33,6,39,39,33,6,1.0,84.62,Difficile,Facile,2,Beaucoup plus Facile,Pas Adapte,Law
4498,2019,Droit,1,Histoire du Droit,1,La Grèce,9,3,3,QCM,0.14,0.73,98.21,37,1,38,38,37,1,1.0,97.37,Facile,Facile,0,Meme Difficulté,Pas Adapte,Law
5622,2020,Droit,1,Histoire du Droit,1,La Grèce,9,3,3,QCM,0.79,0.25,13.65,5,31,36,15,5,10,2.4,33.33,Facile,Difficile,-2,Beaucoup plus Difficile,Pas Adapte,Law
3,2015,Droit,1,Histoire du Droit,1,La Grèce,9,4,4,QCM,0.66,0.2,11.5,6,44,50,28,6,22,1.79,21.43,Difficile,Difficile,0,Meme Difficulté,Pas Adapte,Law
1127,2016,Droit,1,Histoire du Droit,1,La Grèce,9,4,4,QCM,0.72,0.17,31.86,17,36,53,26,17,9,2.04,65.38,Difficile,Difficile,0,Meme Difficulté,Pas Adapte,Law
2251,2017,Droit,1,Histoire du Droit,1,La Grèce,9,4,4,QCM,0.7,0.19,25.33,12,36,48,43,12,31,1.12,27.91,Moyen,Difficile,-1,Plus Difficile,Pas Adapte,Law
3375,2018,Droit,1,Histoire du Droit,1,La Grèce,9,4,4,QCM,0.66,0.25,28.97,14,33,47,27,14,13,1.74,51.85,Difficile,Difficile,0,Meme Difficulté,Pas Adapte,Law
4499,2019,Droit,1,Histoire du Droit,1,La Grèce,9,4,4,QCM,0.46,0.36,55.74,30,23,53,31,30,1,1.71,96.77,Difficile,Moyen,1,Plus Facile,Pas Adapte,Law
5623,2020,Droit,1,Histoire du Droit,1,La Grèce,9,4,4,QCM,0.49,0.3,49.39,26,26,52,31,26,5,1.68,83.87,Difficile,Moyen,1,Plus Facile,Pas Adapte,Law
4,2015,Droit,1,Histoire du Droit,1,La Grèce,9,5,5,QCU,0.18,0.91,68.8,59,27,86,74,59,15,1.16,79.73,Difficile,Facile,2,Beaucoup plus Facile,Adapte,Law
1128,2016,Droit,1,Histoire du Droit,1,La Grèce,9,5,5,QCU,0.08,0.92,68.8,56,25,81,78,56,22,1.04,71.79,Facile,Facile,0,Meme Difficulté,Adapte,Law
2252,2017,Droit,1,Histoire du Droit,1,La Grèce,9,5,5,QCU,0.04,0.89,68.8,61,27,88,63,61,2,1.4,96.83,Facile,Facile,0,Meme Difficulté,Adapte,Law
3376,2018,Droit,1,Histoire du Droit,1,La Grèce,9,5,5,QCU,0.06,0.82,68.8,58,27,85,59,58,1,1.44,98.31,Facile,Facile,0,Meme Difficulté,Adapte,Law
4500,2019,Droit,1,Histoire du Droit,1,La Grèce,9,5,5,QCU,0.07,0.79,68.8,65,29,94,86,65,21,1.09,75.58,Facile,Facile,0,Meme Difficulté,Adapte,Law
5624,2020,Droit,1,Histoire du Droit,1,La Grèce,9,5,5,QCU,0.19,0.79,68.8,55,25,80,73,55,18,1.1,75.34,Facile,Facile,0,Meme Difficulté,Adapte,Law
5,2015,Droit,1,Histoire du Droit,1,La Grèce,9,6,6,QCM,0.17,0.92,99.18,70,1,71,71,70,1,1.0,98.59,Moyen,Facile,1,Plus Facile,Pas Adapte,Law
1129,2016,Droit,1,Histoire du Droit,1,La Grèce,9,6,6,QCM,0.61,0.21,17.26,13,63,76,49,13,36,1.55,26.53,Facile,Difficile,-2,Beaucoup plus Difficile,Pas Adapte,Law
2253,2017,Droit,1,Histoire du Droit,1,La Grèce,9,6,6,QCM,0.14,0.97,86.34,66,11,77,69,66,3,1.12,95.65,Moyen,Facile,1,Plus Facile,Pas Adapte,Law
3377,2018,Droit,1,Histoire du Droit,1,La Grèce,9,6,6,QCM,0.1,0.86,84.95,59,10,69,66,59,7,1.05,89.39,Difficile,Facile,2,Beaucoup plus Facile,Pas Adapte,Law
4501,2019,Droit,1,Histoire du Droit,1,La Grèce,9,6,6,QCU,0.32,0.6,52.98,35,31,66,36,35,1,1.83,97.22,Facile,Moyen,-1,Plus Difficile,Pas Adapte,Law
5625,2020,Droit,1,Histoire du Droit,1,La Grèce,9,6,6,QCU,0.32,0.48,53.03,36,32,68,50,36,14,1.36,72.0,Difficile,Moyen,1,Plus Facile,Pas Adapte,Law
6,2015,Droit,1,Histoire du Droit,1,La Grèce,9,7,7,QCM,0.01,0.72,79.99,49,12,61,53,49,4,1.15,92.45,Facile,Facile,0,Meme Difficulté,Pas Adapte,Law
1130,2016,Droit,1,Histoire du Droit,1,La Grèce,9,7,7,QCM,0.69,0.17,31.27,21,47,68,55,21,34,1.24,38.18,Difficile,Difficile,0,Meme Difficulté,Pas Adapte,Law
2254,2017,Droit,1,Histoire du Droit,1,La Grèce,9,7,7,QCM,0.78,0.18,9.06,6,65,71,52,6,46,1.37,11.54,Difficile,Difficile,0,Meme Difficulté,Pas Adapte,Law
3378,2018,Droit,1,Histoire du Droit,1,La Grèce,9,7,7,QCM,0.62,0.23,18.71,14,59,73,29,14,15,2.52,48.28,Facile,Difficile,-2,Beaucoup plus Difficile,Pas Adapte,Law
4502,2019,Droit,1,Histoire du Droit,1,La Grèce,9,7,7,QCM,0.51,0.19,32.12,24,52,76,54,24,30,1.41,44.44,Facile,Difficile,-2,Beaucoup plus Difficile,Pas Adapte,Law
5626,2020,Droit,1,Histoire du Droit,1,La Grèce,9,7,7,QCM,0.06,0.76,70.96,53,22,75,54,53,1,1.39,98.15,Difficile,Facile,2,Beaucoup plus Facile,Adapte,Law
7,2015,Droit,1,Histoire du Droit,1,La Grèce,9,8,8,QCM,0.53,0.19,32.08,18,37,55,31,18,13,1.77,58.06,Difficile,Difficile,0,Meme Difficulté,Pas Adapte,Law
1131,2016,Droit,1,Histoire du Droit,1,La Grèce,9,8,8,QCM,0.71,0.25,30.79,16,37,53,43,16,27,1.23,37.21,Difficile,Difficile,0,Meme Difficulté,Pas Adapte,Law
2255,2017,Droit,1,Histoire du Droit,1,La Grèce,9,8,8,QCM,0.34,0.57,57.57,28,20,48,38,28,10,1.26,73.68,Difficile,Moyen,1,Plus Facile,Pas Adapte,Law
3379,2018,Droit,1,Histoire du Droit,1,La Grèce,9,8,8,QCM,0.62,0.25,26.11,14,38,52,26,14,12,2.0,53.85,Moyen,Difficile,-1,Plus Difficile,Pas Adapte,Law
4503,2019,Droit,1,Histoire du Droit,1,La Grèce,9,8,8,QCM,0.42,0.69,61.13,31,19,50,46,31,15,1.09,67.39,Facile,Moyen,-1,Plus Difficile,Adapte,Law
5627,2020,Droit,1,Histoire du Droit,1,La Grèce,9,8,8,QROC,0.49,0.25,61.13,34,22,56,49,34,15,1.14,69.39,Moyen,Moyen,0,Meme Difficulté,Adapte,Law
8,2015,Droit,1,Histoire du Droit,1,La Grèce,9,9,9,QO,0.75,0.06,26.61,13,36,49,38,13,25,1.29,34.21,Difficile,Difficile,0,Meme Difficulté,Pas Adapte,Law
1132,2016,Droit,1,Histoire du Droit,1,La Grèce,9,9,9,QO,0.32,0.27,63.9,34,19,53,42,34,8,1.26,80.95,Difficile,Moyen,1,Plus Facile,Adapte,Law
2256,2017,Droit,1,Histoire du Droit,1,La Grèce,9,9,9,QO,0.57,0.26,63.9,33,19,52,33,33,0,1.58,100.0,Moyen,Moyen,0,Meme Difficulté,Adapte,Law
3380,2018,Droit,1,Histoire du Droit,1,La Grèce,9,9,9,QO,0.64,0.18,63.9,29,16,45,30,29,1,1.5,96.67,Moyen,Moyen,0,Meme Difficulté,Adapte,Law
4504,2019,Droit,1,Histoire du Droit,1,La Grèce,9,9,9,QO,0.48,0.24,63.9,26,14,40,31,26,5,1.29,83.87,Moyen,Moyen,0,Meme Difficulté,Adapte,Law
5628,2020,Droit,1,Histoire du Droit,1,La Grèce,9,9,9,QCM,0.33,0.49,63.9,27,15,42,34,27,7,1.24,79.41,Moyen,Moyen,0,Meme Difficulté,Adapte,Law
9,2015,Droit,1,Histoire du Droit,2,L'Italie,8,10,1,QROC,0.71,0.16,10.95,2,13,15,6,2,4,2.5,33.33,Facile,Difficile,-2,Beaucoup plus Difficile,Pas Adapte,Law
1133,2016,Droit,1,Histoire du Droit,2,L'Italie,8,10,1,QROC,0.15,0.51,74.17,10,3,13,12,10,2,1.08,83.33,Difficile,Facile,2,Beaucoup plus Facile,Adapte,Law
2257,2017,Droit,1,Histoire du Droit,2,L'Italie,8,10,1,QROC,0.15,0.45,74.17,11,4,15,11,11,0,1.36,100.0,Facile,Facile,0,Meme Difficulté,Adapte,Law
3381,2018,Droit,1,Histoire du Droit,2,L'Italie,8,10,1,QROC,0.15,0.74,74.17,12,4,16,14,12,2,1.14,85.71,Facile,Facile,0,Meme Difficulté,Adapte,Law
4505,2019,Droit,1,Histoire du Droit,2,L'Italie,8,10,1,QROC,0.17,0.5,74.17,11,4,15,13,11,2,1.15,84.62,Facile,Facile,0,Meme Difficulté,Adapte,Law
5629,2020,Droit,1,Histoire du Droit,2,L'Italie,8,10,1,QROC,0.07,0.74,74.17,10,4,14,12,10,2,1.17,83.33,Facile,Facile,0,Meme Difficulté,Adapte,Law
10,2015,Droit,1,Histoire du Droit,2,L'Italie,8,11,2,QCM,0.05,0.74,97.03,31,1,32,32,31,1,1.0,96.88,Moyen,Facile,1,Plus Facile,Pas Adapte,Law
1134,2016,Droit,1,Histoire du Droit,2,L'Italie,8,11,2,QCM,0.0,0.99,97.6,32,1,33,32,32,0,1.03,100.0,Difficile,Facile,2,Beaucoup plus Facile,Pas Adapte,Law
2258,2017,Droit,1,Histoire du Droit,2,L'Italie,8,11,2,QCM,0.19,0.82,90.84,26,3,29,28,26,2,1.04,92.86,Moyen,Facile,1,Plus Facile,Pas Adapte,Law
3382,2018,Droit,1,Histoire du Droit,2,L'Italie,8,11,2,QCU,0.66,0.31,22.17,6,19,25,16,6,10,1.56,37.5,Facile,Difficile,-2,Beaucoup plus Difficile,Pas Adapte,Law
4506,2019,Droit,1,Histoire du Droit,2,L'Italie,8,11,2,QCU,0.04,0.94,89.31,20,2,22,21,20,1,1.05,95.24,Difficile,Facile,2,Beaucoup plus Facile,Pas Adapte,Law
5630,2020,Droit,1,Histoire du Droit,2,L'Italie,8,11,2,QCU,0.24,0.49,51.34,13,12,25,21,13,8,1.19,61.9,Moyen,Moyen,0,Meme Difficulté,Pas Adapte,Law
11,2015,Droit,1,Histoire du Droit,2,L'Italie,8,12,3,QCU,0.16,0.88,82.21,49,11,60,58,49,9,1.03,84.48,Moyen,Facile,1,Plus Facile,Pas Adapte,Law
1135,2016,Droit,1,Histoire du Droit,2,L'Italie,8,12,3,QO,0.75,0.14,20.8,12,48,60,35,12,23,1.71,34.29,Difficile,Difficile,0,Meme Difficulté,Pas Adapte,Law
2259,2017,Droit,1,Histoire du Droit,2,L'Italie,8,12,3,QO,0.05,0.59,72.35,43,17,60,47,43,4,1.28,91.49,Difficile,Facile,2,Beaucoup plus Facile,Adapte,Law
3383,2018,Droit,1,Histoire du Droit,2,L'Italie,8,12,3,QCU,0.1,0.8,72.35,47,18,65,60,47,13,1.08,78.33,Facile,Facile,0,Meme Difficulté,Adapte,Law
4507,2019,Droit,1,Histoire du Droit,2,L'Italie,8,12,3,QCU,0.01,0.98,72.35,45,17,62,47,45,2,1.32,95.74,Facile,Facile,0,Meme Difficulté,Adapte,Law
5631,2020,Droit,1,Histoire du Droit,2,L'Italie,8,12,3,QCU,0.14,0.91,72.35,43,16,59,50,43,7,1.18,86.0,Facile,Facile,0,Meme Difficulté,Adapte,Law
12,2015,Droit,1,Histoire du Droit,2,L'Italie,8,13,4,QO,0.12,0.61,99.68,25,0,25,25,25,0,1.0,100.0,Facile,Facile,0,Meme Difficulté,Pas Adapte,Law
1136,2016,Droit,1,Histoire du Droit,2,L'Italie,8,13,4,QROC,0.61,0.2,22.77,6,19,25,14,6,8,1.79,42.86,Moyen,Difficile,-1,Plus Difficile,Pas Adapte,Law
2260,2017,Droit,1,Histoire du Droit,2,L'Italie,8,13,4,QROC,0.23,0.34,53.54,12,11,23,14,12,2,1.64,85.71,Moyen,Moyen,0,Meme Difficulté,Pas Adapte,Law
3384,2018,Droit,1,Histoire du Droit,2,L'Italie,8,13,4,QROC,0.89,0.18,25.85,7,19,26,19,7,12,1.37,36.84,Moyen,Difficile,-1,Plus Difficile,Pas Adapte,Law
4508,2019,Droit,1,Histoire du Droit,2,L'Italie,8,13,4,QROC,0.02,0.76,77.89,20,6,26,21,20,1,1.24,95.24,Difficile,Facile,2,Beaucoup plus Facile,Pas Adapte,Law
5632,2020,Droit,1,Histoire du Droit,2,L'Italie,8,13,4,QROC,0.68,0.19,24.25,6,17,23,16,6,10,1.44,37.5,Moyen,Difficile,-1,Plus Difficile,Pas Adapte,Law
13,2015,Droit,1,Histoire du Droit,2,L'Italie,8,14,5,QCM,0.14,0.87,99.5,19,0,19,19,19,0,1.0,100.0,Facile,Facile,0,Meme Difficulté,Pas Adapte,Law
1137,2016,Droit,1,Histoire du Droit,2,L'Italie,8,14,5,QROC,0.5,0.35,44.61,9,12,21,9,9,0,2.33,100.0,Difficile,Moyen,1,Plus Facile,Pas Adapte,Law
2261,2017,Droit,1,Histoire du Droit,2,L'Italie,8,14,5,QROC,0.63,0.13,32.69,6,12,18,8,6,2,2.25,75.0,Moyen,Difficile,-1,Plus Difficile,Pas Adapte,Law
3385,2018,Droit,1,Histoire du Droit,2,L'Italie,8,14,5,QROC,0.08,0.94,96.92,16,0,16,16,16,0,1.0,100.0,Facile,Facile,0,Meme Difficulté,Pas Adapte,Law
4509,2019,Droit,1,Histoire du Droit,2,L'Italie,8,14,5,QROC,0.77,0.05,9.11,1,14,15,13,1,12,1.15,7.69,Facile,Difficile,-2,Beaucoup plus Difficile,Pas Adapte,Law
5633,2020,Droit,1,Histoire du Droit,2,L'Italie,8,14,5,QROC,0.13,0.41,70.77,9,4,13,13,9,4,1.0,69.23,Moyen,Facile,1,Plus Facile,Adapte,Law
14,2015,Droit,1,Histoire du Droit,2,L'Italie,8,15,6,QCM,0.72,0.29,3.79,1,36,37,20,1,19,1.85,5.0,Moyen,Difficile,-1,Plus Difficile,Pas Adapte,Law
1138,2016,Droit,1,Histoire du Droit,2,L'Italie,8,15,6,QCM,0.12,0.77,68.38,25,12,37,35,25,10,1.06,71.43,Moyen,Facile,1,Plus Facile,Adapte,Law
2262,2017,Droit,1,Histoire du Droit,2,L'Italie,8,15,6,QCM,0.04,0.78,68.38,23,11,34,26,23,3,1.31,88.46,Facile,Facile,0,Meme Difficulté,Adapte,Law
3386,2018,Droit,1,Histoire du Droit,2,L'Italie,8,15,6,QCM,0.07,0.76,68.38,21,9,30,28,21,7,1.07,75.0,Facile,Facile,0,Meme Difficulté,Adapte,Law
4510,2019,Droit,1,Histoire du Droit,2,L'Italie,8,15,6,QCM,0.04,0.96,68.38,18,9,27,22,18,4,1.23,81.82,Facile,Facile,0,Meme Difficulté,Adapte,Law
5634,2020,Droit,1,Histoire du Droit,2,L'Italie,8,15,6,QCM,0.12,0.75,68.38,19,9,28,22,19,3,1.27,86.36,Facile,Facile,0,Meme Difficulté,Adapte,Law
15,2015,Droit,1,Histoire du Droit,2,L'Italie,8,16,7,QCM,0.72,0.21,30.37,10,23,33,25,10,15,1.32,40.0,Moyen,Difficile,-1,Plus Difficile,Pas Adapte,Law
1139,2016,Droit,1,Histoire du Droit,2,L'Italie,8,16,7,QCM,0.52,0.16,29.8,11,26,37,23,11,12,1.61,47.83,Facile,Difficile,-2,Beaucoup plus Difficile,Pas Adapte,Law
2263,2017,Droit,1,Histoire du Droit,2,L'Italie,8,16,7,QCM,0.11,0.93,76.79,25,8,33,26,25,1,1.27,96.15,Moyen,Facile,1,Plus Facile,Pas Adapte,Law
3387,2018,Droit,1,Histoire du Droit,2,L'Italie,8,16,7,QCM,0.13,0.89,77.91,26,7,33,29,26,3,1.14,89.66,Moyen,Facile,1,Plus Facile,Pas Adapte,Law
4511,2019,Droit,1,Histoire du Droit,2,L'Italie,8,16,7,QCM,0.2,0.36,64.1,21,11,32,22,21,1,1.45,95.45,Facile,Moyen,-1,Plus Difficile,Adapte,Law
5635,2020,Droit,1,Histoire du Droit,2,L'Italie,8,16,7,QCU,0.24,0.5,64.1,22,13,35,23,22,1,1.52,95.65,Moyen,Moyen,0,Meme Difficulté,Adapte,Law
16,2015,Droit,1,Histoire du Droit,2,L'Italie,8,17,8,QCU,0.05,0.87,71.66,11,5,16,15,11,4,1.07,73.33,Moyen,Facile,1,Plus Facile,Adapte,Law
1140,2016,Droit,1,Histoire du Droit,2,L'Italie,8,17,8,QCU,0.14,0.76,71.66,10,4,14,13,10,3,1.08,76.92,Facile,Facile,0,Meme Difficulté,Adapte,Law
2264,2017,Droit,1,Histoire du Droit,2,L'Italie,8,17,8,QCU,0.08,0.77,71.66,10,4,14,10,10,0,1.4,100.0,Facile,Facile,0,Meme Difficulté,Adapte,Law
3388,2018,Droit,1,Histoire du Droit,2,L'Italie,8,17,8,QCU,0.09,0.77,71.66,11,4,15,14,11,3,1.07,78.57,Facile,Facile,0,Meme Difficulté,Adapte,Law
4512,2019,Droit,1,Histoire du Droit,2,L'Italie,8,17,8,QCU,0.15,0.75,71.66,12,5,17,16,12,4,1.06,75.0,Facile,Facile,0,Meme Difficulté,Adapte,Law
5636,2020,Droit,1,Histoire du Droit,2,L'Italie,8,17,8,QCU,0.14,0.95,71.66,14,6,20,20,14,6,1.0,70.0,Facile,Facile,0,Meme Difficulté,Adapte,Law
17,2015,Droit,2,Introduction Historique au Droit,1,L'Ancien Regime,5,18,1,QO,0.37,0.24,36.68,4,8,12,10,4,6,1.2,40.0,Moyen,Moyen,0,Meme Difficulté,Pas Adapte,Law
1141,2016,Droit,2,Introduction Historique au Droit,1,L'Ancien Regime,5,18,1,QO,0.03,0.89,93.94,9,1,10,10,9,1,1.0,90.0,Moyen,Facile,1,Plus Facile,Pas Adapte,Law
2265,2017,Droit,2,Introduction Historique au Droit,1,L'Ancien Regime,5,18,1,QROC,0.97,0.11,8.74,1,11,12,10,1,9,1.2,10.0,Moyen,Difficile,-1,Plus Difficile,Pas Adapte,Law
3389,2018,Droit,2,Introduction Historique au Droit,1,L'Ancien Regime,5,18,1,QROC,0.79,0.01,26.01,3,9,12,12,3,9,1.0,25.0,Moyen,Difficile,-1,Plus Difficile,Pas Adapte,Law
4513,2019,Droit,2,Introduction Historique au Droit,1,L'Ancien Regime,5,18,1,QROC,0.12,0.54,99.62,11,0,11,11,11,0,1.0,100.0,Facile,Facile,0,Meme Difficulté,Pas Adapte,Law
5637,2020,Droit,2,Introduction Historique au Droit,1,L'Ancien Regime,5,18,1,QROC,0.8,0.08,9.62,1,8,9,6,1,5,1.5,16.67,Moyen,Difficile,-1,Plus Difficile,Pas Adapte,Law
18,2015,Droit,2,Introduction Historique au Droit,1,L'Ancien Regime,5,19,2,QCM,0.19,0.93,76.41,48,15,63,59,48,11,1.07,81.36,Difficile,Facile,2,Beaucoup plus Facile,Pas Adapte,Law
1142,2016,Droit,2,Introduction Historique au Droit,1,L'Ancien Regime,5,19,2,QCM,0.43,0.56,58.56,34,24,58,50,34,16,1.16,68.0,Facile,Moyen,-1,Plus Difficile,Pas Adapte,Law
2266,2017,Droit,2,Introduction Historique au Droit,1,L'Ancien Regime,5,19,2,QCM,0.14,0.91,93.26,62,4,66,65,62,3,1.02,95.38,Difficile,Facile,2,Beaucoup plus Facile,Pas Adapte,Law
3390,2018,Droit,2,Introduction Historique au Droit,1,L'Ancien Regime,5,19,2,QCM,0.12,0.96,97.0,58,2,60,58,58,0,1.03,100.0,Difficile,Facile,2,Beaucoup plus Facile,Pas Adapte,Law
4514,2019,Droit,2,Introduction Historique au Droit,1,L'Ancien Regime,5,19,2,QCM,0.3,0.54,56.14,38,29,67,61,38,23,1.1,62.3,Facile,Moyen,-1,Plus Difficile,Pas Adapte,Law
5638,2020,Droit,2,Introduction Historique au Droit,1,L'Ancien Regime,5,19,2,QCM,0.41,0.59,50.64,33,33,66,47,33,14,1.4,70.21,Difficile,Moyen,1,Plus Facile,Pas Adapte,Law
19,2015,Droit,2,Introduction Historique au Droit,1,L'Ancien Regime,5,20,3,QROC,0.76,0.12,3.24,1,34,35,33,1,32,1.06,3.03,Difficile,Difficile,0,Meme Difficulté,Pas Adapte,Law
1143,2016,Droit,2,Introduction Historique au Droit,1,L'Ancien Regime,5,20,3,QROC,0.02,0.67,68.27,26,12,38,33,26,7,1.15,78.79,Difficile,Facile,2,Beaucoup plus Facile,Adapte,Law
2267,2017,Droit,2,Introduction Historique au Droit,1,L'Ancien Regime,5,20,3,QROC,0.11,0.95,68.27,29,13,42,29,29,0,1.45,100.0,Facile,Facile,0,Meme Difficulté,Adapte,Law
3391,2018,Droit,2,Introduction Historique au Droit,1,L'Ancien Regime,5,20,3,QROC,0.03,0.72,68.27,25,12,37,35,25,10,1.06,71.43,Facile,Facile,0,Meme Difficulté,Adapte,Law
4515,2019,Droit,2,Introduction Historique au Droit,1,L'Ancien Regime,5,20,3,QROC,0.17,0.92,68.27,29,14,43,38,29,9,1.13,76.32,Facile,Facile,0,Meme Difficulté,Adapte,Law
5639,2020,Droit,2,Introduction Historique au Droit,1,L'Ancien Regime,5,20,3,QROC,0.02,0.52,68.27,32,15,47,47,32,15,1.0,68.09,Facile,Facile,0,Meme Difficulté,Adapte,Law
20,2015,Droit,2,Introduction Historique au Droit,1,L'Ancien Regime,5,21,4,QCM,0.14,0.91,72.87,31,11,42,36,31,5,1.17,86.11,Difficile,Facile,2,Beaucoup plus Facile,Adapte,Law
1144,2016,Droit,2,Introduction Historique au Droit,1,L'Ancien Regime,5,21,4,QCM,0.07,0.86,72.87,35,13,48,38,35,3,1.26,92.11,Facile,Facile,0,Meme Difficulté,Adapte,Law
2268,2017,Droit,2,Introduction Historique au Droit,1,L'Ancien Regime,5,21,4,QCM,0.03,0.83,72.87,37,14,51,37,37,0,1.38,100.0,Facile,Facile,0,Meme Difficulté,Adapte,Law
3392,2018,Droit,2,Introduction Historique au Droit,1,L'Ancien Regime,5,21,4,QCM,0.09,1.0,72.87,38,14,52,51,38,13,1.02,74.51,Facile,Facile,0,Meme Difficulté,Adapte,Law
4516,2019,Droit,2,Introduction Historique au Droit,1,L'Ancien Regime,5,21,4,QCM,0.16,0.88,72.87,35,13,48,39,35,4,1.23,89.74,Facile,Facile,0,Meme Difficulté,Adapte,Law
5640,2020,Droit,2,Introduction Historique au Droit,1,L'Ancien Regime,5,21,4,QCU,0.18,0.94,72.87,30,11,41,32,30,2,1.28,93.75,Facile,Facile,0,Meme Difficulté,Adapte,Law
21,2015,Droit,2,Introduction Historique au Droit,1,L'Ancien Regime,5,22,5,QCU,0.14,0.78,80.32,51,13,64,63,51,12,1.02,80.95,Moyen,Facile,1,Plus Facile,Pas Adapte,Law
1145,2016,Droit,2,Introduction Historique au Droit,1,L'Ancien Regime,5,22,5,QCU,0.74,0.32,10.43,6,56,62,42,6,36,1.48,14.29,Facile,Difficile,-2,Beaucoup plus Difficile,Pas Adapte,Law
2269,2017,Droit,2,Introduction Historique au Droit,1,L'Ancien Regime,5,22,5,QCU,0.56,0.39,13.21,8,55,63,24,8,16,2.62,33.33,Moyen,Difficile,-1,Plus Difficile,Pas Adapte,Law
3393,2018,Droit,2,Introduction Historique au Droit,1,L'Ancien Regime,5,22,5,QCU,0.17,0.81,81.22,44,10,54,47,44,3,1.15,93.62,Facile,Facile,0,Meme Difficulté,Pas Adapte,Law
4517,2019,Droit,2,Introduction Historique au Droit,1,L'Ancien Regime,5,22,5,QCM,0.06,0.74,97.63,45,1,46,45,45,0,1.02,100.0,Facile,Facile,0,Meme Difficulté,Pas Adapte,Law
5641,2020,Droit,2,Introduction Historique au Droit,1,L'Ancien Regime,5,22,5,QCM,0.02,0.71,77.95,37,11,48,38,37,1,1.26,97.37,Difficile,Facile,2,Beaucoup plus Facile,Pas Adapte,Law
22,2015,Droit,2,Introduction Historique au Droit,2,La Contestation du Regime Feodal,7,23,1,QCU,0.14,0.91,76.1,16,5,21,18,16,2,1.17,88.89,Facile,Facile,0,Meme Difficulté,Pas Adapte,Law
1146,2016,Droit,2,Introduction Historique au Droit,2,La Contestation du Regime Feodal,7,23,1,QCM,0.31,0.41,43.8,8,11,19,8,8,0,2.38,100.0,Difficile,Moyen,1,Plus Facile,Pas Adapte,Law
2270,2017,Droit,2,Introduction Historique au Droit,2,La Contestation du Regime Feodal,7,23,1,QCM,0.15,1.0,74.37,16,5,21,17,16,1,1.24,94.12,Moyen,Facile,1,Plus Facile,Adapte,Law
3394,2018,Droit,2,Introduction Historique au Droit,2,La Contestation du Regime Feodal,7,23,1,QCM,0.05,0.91,74.37,14,5,19,16,14,2,1.19,87.5,Facile,Facile,0,Meme Difficulté,Adapte,Law
4518,2019,Droit,2,Introduction Historique au Droit,2,La Contestation du Regime Feodal,7,23,1,QROC,0.0,0.71,74.37,14,5,19,18,14,4,1.06,77.78,Facile,Facile,0,Meme Difficulté,Adapte,Law
5642,2020,Droit,2,Introduction Historique au Droit,2,La Contestation du Regime Feodal,7,23,1,QROC,0.04,0.79,74.37,16,5,21,20,16,4,1.05,80.0,Facile,Facile,0,Meme Difficulté,Adapte,Law
23,2015,Droit,2,Introduction Historique au Droit,2,La Contestation du Regime Feodal,7,24,2,QCU,0.31,0.47,42.82,13,17,30,30,13,17,1.0,43.33,Facile,Moyen,-1,Plus Difficile,Pas Adapte,Law
1147,2016,Droit,2,Introduction Historique au Droit,2,La Contestation du Regime Feodal,7,24,2,QCU,0.51,0.39,4.39,1,28,29,13,1,12,2.23,7.69,Difficile,Difficile,0,Meme Difficulté,Pas Adapte,Law
2271,2017,Droit,2,Introduction Historique au Droit,2,La Contestation du Regime Feodal,7,24,2,QCU,0.16,0.95,67.24,19,9,28,22,19,3,1.27,86.36,Moyen,Facile,1,Plus Facile,Adapte,Law
3395,2018,Droit,2,Introduction Historique au Droit,2,La Contestation du Regime Feodal,7,24,2,QROC,0.19,0.86,67.24,16,8,24,20,16,4,1.2,80.0,Facile,Facile,0,Meme Difficulté,Adapte,Law
4519,2019,Droit,2,Introduction Historique au Droit,2,La Contestation du Regime Feodal,7,24,2,QO,0.08,0.65,67.24,18,9,27,25,18,7,1.08,72.0,Facile,Facile,0,Meme Difficulté,Adapte,Law
5643,2020,Droit,2,Introduction Historique au Droit,2,La Contestation du Regime Feodal,7,24,2,QO,0.2,0.58,67.24,21,10,31,23,21,2,1.35,91.3,Facile,Facile,0,Meme Difficulté,Adapte,Law
24,2015,Droit,2,Introduction Historique au Droit,2,La Contestation du Regime Feodal,7,25,3,QCU,0.34,0.71,45.3,22,26,48,37,22,15,1.3,59.46,Moyen,Moyen,0,Meme Difficulté,Pas Adapte,Law
1148,2016,Droit,2,Introduction Historique au Droit,2,La Contestation du Regime Feodal,7,25,3,QCU,0.66,0.21,23.77,11,36,47,20,11,9,2.35,55.0,Difficile,Difficile,0,Meme Difficulté,Pas Adapte,Law
2272,2017,Droit,2,Introduction Historique au Droit,2,La Contestation du Regime Feodal,7,25,3,QCU,0.21,0.71,35.38,19,35,54,37,19,18,1.46,51.35,Difficile,Moyen,1,Plus Facile,Pas Adapte,Law
3396,2018,Droit,2,Introduction Historique au Droit,2,La Contestation du Regime Feodal,7,25,3,QCM,0.71,0.23,31.49,18,38,56,22,18,4,2.55,81.82,Difficile,Difficile,0,Meme Difficulté,Pas Adapte,Law
4520,2019,Droit,2,Introduction Historique au Droit,2,La Contestation du Regime Feodal,7,25,3,QCM,0.38,0.32,44.42,21,27,48,29,21,8,1.66,72.41,Facile,Moyen,-1,Plus Difficile,Pas Adapte,Law
5644,2020,Droit,2,Introduction Historique au Droit,2,La Contestation du Regime Feodal,7,25,3,QCM,0.52,0.19,26.52,13,35,48,46,13,33,1.04,28.26,Facile,Difficile,-2,Beaucoup plus Difficile,Pas Adapte,Law
25,2015,Droit,2,Introduction Historique au Droit,2,La Contestation du Regime Feodal,7,26,4,QCU,0.1,0.96,86.23,39,6,45,42,39,3,1.07,92.86,Moyen,Facile,1,Plus Facile,Pas Adapte,Law
1149,2016,Droit,2,Introduction Historique au Droit,2,La Contestation du Regime Feodal,7,26,4,QCU,0.15,0.76,94.15,48,3,51,50,48,2,1.02,96.0,Facile,Facile,0,Meme Difficulté,Pas Adapte,Law
2273,2017,Droit,2,Introduction Historique au Droit,2,La Contestation du Regime Feodal,7,26,4,QCU,0.39,0.69,50.88,24,24,48,35,24,11,1.37,68.57,Facile,Moyen,-1,Plus Difficile,Pas Adapte,Law
3397,2018,Droit,2,Introduction Historique au Droit,2,La Contestation du Regime Feodal,7,26,4,QCU,0.69,0.28,14.46,7,43,50,34,7,27,1.47,20.59,Facile,Difficile,-2,Beaucoup plus Difficile,Pas Adapte,Law
4521,2019,Droit,2,Introduction Historique au Droit,2,La Contestation du Regime Feodal,7,26,4,QCU,0.12,0.99,69.96,33,14,47,41,33,8,1.15,80.49,Moyen,Facile,1,Plus Facile,Adapte,Law
5645,2020,Droit,2,Introduction Historique au Droit,2,La Contestation du Regime Feodal,7,26,4,QCU,0.11,0.96,69.96,32,14,46,38,32,6,1.21,84.21,Facile,Facile,0,Meme Difficulté,Adapte,Law
26,2015,Droit,2,Introduction Historique au Droit,2,La Contestation du Regime Feodal,7,27,5,QROC,0.11,0.68,92.38,24,2,26,26,24,2,1.0,92.31,Moyen,Facile,1,Plus Facile,Pas Adapte,Law
1150,2016,Droit,2,Introduction Historique au Droit,2,La Contestation du Regime Feodal,7,27,5,QROC,0.69,0.06,10.53,3,22,25,11,3,8,2.27,27.27,Difficile,Difficile,0,Meme Difficulté,Pas Adapte,Law
2274,2017,Droit,2,Introduction Historique au Droit,2,La Contestation du Regime Feodal,7,27,5,QROC,0.51,0.31,63.19,15,8,23,16,15,1,1.44,93.75,Facile,Moyen,-1,Plus Difficile,Adapte,Law
3398,2018,Droit,2,Introduction Historique au Droit,2,La Contestation du Regime Feodal,7,27,5,QROC,0.45,0.32,63.19,15,8,23,21,15,6,1.1,71.43,Moyen,Moyen,0,Meme Difficulté,Adapte,Law
4522,2019,Droit,2,Introduction Historique au Droit,2,La Contestation du Regime Feodal,7,27,5,QROC,0.5,0.37,63.19,16,10,26,25,16,9,1.04,64.0,Moyen,Moyen,0,Meme Difficulté,Adapte,Law
5646,2020,Droit,2,Introduction Historique au Droit,2,La Contestation du Regime Feodal,7,27,5,QROC,0.5,0.28,63.19,16,10,26,24,16,8,1.08,66.67,Moyen,Moyen,0,Meme Difficulté,Adapte,Law
27,2015,Droit,2,Introduction Historique au Droit,2,La Contestation du Regime Feodal,7,28,6,QROC,0.56,0.37,60.92,10,7,17,13,10,3,1.31,76.92,Moyen,Moyen,0,Meme Difficulté,Adapte,Law
1151,2016,Droit,2,Introduction Historique au Droit,2,La Contestation du Regime Feodal,7,28,6,QROC,0.54,0.29,60.92,9,6,15,11,9,2,1.36,81.82,Moyen,Moyen,0,Meme Difficulté,Adapte,Law
2275,2017,Droit,2,Introduction Historique au Droit,2,La Contestation du Regime Feodal,7,28,6,QROC,0.57,0.33,60.92,8,5,13,8,8,0,1.62,100.0,Moyen,Moyen,0,Meme Difficulté,Adapte,Law
3399,2018,Droit,2,Introduction Historique au Droit,2,La Contestation du Regime Feodal,7,28,6,QROC,0.55,0.35,60.92,7,4,11,9,7,2,1.22,77.78,Moyen,Moyen,0,Meme Difficulté,Adapte,Law
4523,2019,Droit,2,Introduction Historique au Droit,2,La Contestation du Regime Feodal,7,28,6,QROC,0.38,0.32,60.92,5,4,9,8,5,3,1.12,62.5,Moyen,Moyen,0,Meme Difficulté,Adapte,Law
5647,2020,Droit,2,Introduction Historique au Droit,2,La Contestation du Regime Feodal,7,28,6,QROC,0.38,0.33,60.92,5,4,9,6,5,1,1.5,83.33,Moyen,Moyen,0,Meme Difficulté,Adapte,Law
28,2015,Droit,2,Introduction Historique au Droit,2,La Contestation du Regime Feodal,7,29,7,QROC,0.15,0.78,71.65,52,20,72,71,52,19,1.01,73.24,Facile,Facile,0,Meme Difficulté,Adapte,Law
1152,2016,Droit,2,Introduction Historique au Droit,2,La Contestation du Regime Feodal,7,29,7,QROC,0.1,0.67,71.65,47,18,65,52,47,5,1.25,90.38,Facile,Facile,0,Meme Difficulté,Adapte,Law
2276,2017,Droit,2,Introduction Historique au Droit,2,La Contestation du Regime Feodal,7,29,7,QROC,0.19,0.98,71.65,48,19,67,64,48,16,1.05,75.0,Facile,Facile,0,Meme Difficulté,Adapte,Law
3400,2018,Droit,2,Introduction Historique au Droit,2,La Contestation du Regime Feodal,7,29,7,QROC,0.0,0.82,71.65,43,17,60,44,43,1,1.36,97.73,Facile,Facile,0,Meme Difficulté,Adapte,Law
4524,2019,Droit,2,Introduction Historique au Droit,2,La Contestation du Regime Feodal,7,29,7,QROC,0.18,0.64,71.65,46,18,64,57,46,11,1.12,80.7,Facile,Facile,0,Meme Difficulté,Adapte,Law
5648,2020,Droit,2,Introduction Historique au Droit,2,La Contestation du Regime Feodal,7,29,7,QROC,0.14,0.6,71.65,51,20,71,60,51,9,1.18,85.0,Facile,Facile,0,Meme Difficulté,Adapte,Law
29,2015,Droit,2,Introduction Historique au Droit,3,La Crise de l'Ancien Regime,5,30,1,QO,0.04,0.68,99.93,72,0,72,72,72,0,1.0,100.0,Difficile,Facile,2,Beaucoup plus Facile,Pas Adapte,Law
1153,2016,Droit,2,Introduction Historique au Droit,3,La Crise de l'Ancien Regime,5,30,1,QO,0.51,0.19,36.76,28,48,76,71,28,43,1.07,39.44,Moyen,Moyen,0,Meme Difficulté,Pas Adapte,Law
2277,2017,Droit,2,Introduction Historique au Droit,3,La Crise de l'Ancien Regime,5,30,1,QO,0.35,0.29,64.56,56,31,87,82,56,26,1.06,68.29,Facile,Moyen,-1,Plus Difficile,Adapte,Law
3401,2018,Droit,2,Introduction Historique au Droit,3,La Crise de l'Ancien Regime,5,30,1,QO,0.67,0.21,64.56,50,28,78,50,50,0,1.56,100.0,Moyen,Moyen,0,Meme Difficulté,Adapte,Law
4525,2019,Droit,2,Introduction Historique au Droit,3,La Crise de l'Ancien Regime,5,30,1,QO,0.57,0.27,64.56,45,24,69,62,45,17,1.11,72.58,Moyen,Moyen,0,Meme Difficulté,Adapte,Law
5649,2020,Droit,2,Introduction Historique au Droit,3,La Crise de l'Ancien Regime,5,30,1,QO,0.72,0.15,64.56,43,23,66,59,43,16,1.12,72.88,Moyen,Moyen,0,Meme Difficulté,Adapte,Law
30,2015,Droit,2,Introduction Historique au Droit,3,La Crise de l'Ancien Regime,5,31,2,QCM,0.17,0.7,74.79,19,7,26,20,19,1,1.3,95.0,Facile,Facile,0,Meme Difficulté,Adapte,Law
1154,2016,Droit,2,Introduction Historique au Droit,3,La Crise de l'Ancien Regime,5,31,2,QCM,0.1,0.97,74.79,21,7,28,24,21,3,1.17,87.5,Facile,Facile,0,Meme Difficulté,Adapte,Law
2278,2017,Droit,2,Introduction Historique au Droit,3,La Crise de l'Ancien Regime,5,31,2,QCM,0.01,0.88,74.79,23,8,31,26,23,3,1.19,88.46,Facile,Facile,0,Meme Difficulté,Adapte,Law
3402,2018,Droit,2,Introduction Historique au Droit,3,La Crise de l'Ancien Regime,5,31,2,QCM,0.08,0.96,74.79,19,7,26,24,19,5,1.08,79.17,Facile,Facile,0,Meme Difficulté,Adapte,Law
4526,2019,Droit,2,Introduction Historique au Droit,3,La Crise de l'Ancien Regime,5,31,2,QCM,0.07,0.81,74.79,22,8,30,29,22,7,1.03,75.86,Facile,Facile,0,Meme Difficulté,Adapte,Law
5650,2020,Droit,2,Introduction Historique au Droit,3,La Crise de l'Ancien Regime,5,31,2,QCM,0.19,0.71,74.79,25,8,33,30,25,5,1.1,83.33,Facile,Facile,0,Meme Difficulté,Adapte,Law
31,2015,Droit,2,Introduction Historique au Droit,3,La Crise de l'Ancien Regime,5,32,3,QCU,0.29,0.61,58.98,55,39,94,84,55,29,1.12,65.48,Facile,Moyen,-1,Plus Difficile,Pas Adapte,Law
1155,2016,Droit,2,Introduction Historique au Droit,3,La Crise de l'Ancien Regime,5,32,3,QCU,0.34,0.69,56.38,47,37,84,80,47,33,1.05,58.75,Moyen,Moyen,0,Meme Difficulté,Pas Adapte,Law
2279,2017,Droit,2,Introduction Historique au Droit,3,La Crise de l'Ancien Regime,5,32,3,QCU,0.21,0.44,51.26,48,45,93,83,48,35,1.12,57.83,Difficile,Moyen,1,Plus Facile,Pas Adapte,Law
3403,2018,Droit,2,Introduction Historique au Droit,3,La Crise de l'Ancien Regime,5,32,3,QCU,0.06,0.94,95.89,76,3,79,77,76,1,1.03,98.7,Facile,Facile,0,Meme Difficulté,Pas Adapte,Law
4527,2019,Droit,2,Introduction Historique au Droit,3,La Crise de l'Ancien Regime,5,32,3,QCU,0.74,0.38,24.38,21,64,85,42,21,21,2.02,50.0,Difficile,Difficile,0,Meme Difficulté,Pas Adapte,Law
5651,2020,Droit,2,Introduction Historique au Droit,3,La Crise de l'Ancien Regime,5,32,3,QCU,0.05,0.99,65.23,54,29,83,58,54,4,1.43,93.1,Facile,Facile,0,Meme Difficulté,Adapte,Law
32,2015,Droit,2,Introduction Historique au Droit,3,La Crise de l'Ancien Regime,5,33,4,QCM,0.24,0.56,46.49,25,28,53,49,25,24,1.08,51.02,Facile,Moyen,-1,Plus Difficile,Pas Adapte,Law
1156,2016,Droit,2,Introduction Historique au Droit,3,La Crise de l'Ancien Regime,5,33,4,QCM,0.29,0.48,46.74,25,28,53,43,25,18,1.23,58.14,Difficile,Moyen,1,Plus Facile,Pas Adapte,Law
2280,2017,Droit,2,Introduction Historique au Droit,3,La Crise de l'Ancien Regime,5,33,4,QO,0.93,0.07,24.24,13,41,54,29,13,16,1.86,44.83,Facile,Difficile,-2,Beaucoup plus Difficile,Pas Adapte,Law
3404,2018,Droit,2,Introduction Historique au Droit,3,La Crise de l'Ancien Regime,5,33,4,QO,0.85,0.06,23.34,12,41,53,30,12,18,1.77,40.0,Difficile,Difficile,0,Meme Difficulté,Pas Adapte,Law
4528,2019,Droit,2,Introduction Historique au Droit,3,La Crise de l'Ancien Regime,5,33,4,QO,0.68,0.16,47.5,26,28,54,27,26,1,2.0,96.3,Difficile,Moyen,1,Plus Facile,Pas Adapte,Law
5652,2020,Droit,2,Introduction Historique au Droit,3,La Crise de l'Ancien Regime,5,33,4,QO,0.58,0.24,53.96,28,24,52,29,28,1,1.79,96.55,Moyen,Moyen,0,Meme Difficulté,Pas Adapte,Law
33,2015,Droit,2,Introduction Historique au Droit,3,La Crise de l'Ancien Regime,5,34,5,QO,0.91,0.14,25.53,23,66,89,87,23,64,1.02,26.44,Moyen,Difficile,-1,Plus Difficile,Pas Adapte,Law
1157,2016,Droit,2,Introduction Historique au Droit,3,La Crise de l'Ancien Regime,5,34,5,QO,0.66,0.24,43.22,34,45,79,58,34,24,1.36,58.62,Facile,Moyen,-1,Plus Difficile,Pas Adapte,Law
2281,2017,Droit,2,Introduction Historique au Droit,3,La Crise de l'Ancien Regime,5,34,5,QO,0.8,0.07,8.89,7,73,80,46,7,39,1.74,15.22,Facile,Difficile,-2,Beaucoup plus Difficile,Pas Adapte,Law
3405,2018,Droit,2,Introduction Historique au Droit,3,La Crise de l'Ancien Regime,5,34,5,QO,0.18,0.31,68.79,54,24,78,55,54,1,1.42,98.18,Difficile,Facile,2,Beaucoup plus Facile,Adapte,Law
4529,2019,Droit,2,Introduction Historique au Droit,3,La Crise de l'Ancien Regime,5,34,5,QCM,0.15,0.82,68.79,47,21,68,63,47,16,1.08,74.6,Facile,Facile,0,Meme Difficulté,Adapte,Law
5653,2020,Droit,2,Introduction Historique au Droit,3,La Crise de l'Ancien Regime,5,34,5,QCU,0.04,0.99,68.79,41,19,60,46,41,5,1.3,89.13,Facile,Facile,0,Meme Difficulté,Adapte,Law
34,2015,Droit,2,Introduction Historique au Droit,4,"La Revolution Francaise, l'Affirmation du Liberalisme",5,35,1,QO,0.0,0.89,74.51,75,25,100,82,75,7,1.22,91.46,Moyen,Facile,1,Plus Facile,Adapte,Law
1158,2016,Droit,2,Introduction Historique au Droit,4,"La Revolution Francaise, l'Affirmation du Liberalisme",5,35,1,QROC,0.17,0.78,74.51,84,29,113,94,84,10,1.2,89.36,Facile,Facile,0,Meme Difficulté,Adapte,Law
2282,2017,Droit,2,Introduction Historique au Droit,4,"La Revolution Francaise, l'Affirmation du Liberalisme",5,35,1,QROC,0.04,0.74,74.51,81,28,109,87,81,6,1.25,93.1,Facile,Facile,0,Meme Difficulté,Adapte,Law
3406,2018,Droit,2,Introduction Historique au Droit,4,"La Revolution Francaise, l'Affirmation du Liberalisme",5,35,1,QROC,0.11,1.0,74.51,73,25,98,79,73,6,1.24,92.41,Facile,Facile,0,Meme Difficulté,Adapte,Law
4530,2019,Droit,2,Introduction Historique au Droit,4,"La Revolution Francaise, l'Affirmation du Liberalisme",5,35,1,QROC,0.14,0.66,74.51,84,29,113,95,84,11,1.19,88.42,Facile,Facile,0,Meme Difficulté,Adapte,Law
5654,2020,Droit,2,Introduction Historique au Droit,4,"La Revolution Francaise, l'Affirmation du Liberalisme",5,35,1,QROC,0.08,0.52,74.51,72,25,97,81,72,9,1.2,88.89,Facile,Facile,0,Meme Difficulté,Adapte,Law
35,2015,Droit,2,Introduction Historique au Droit,4,"La Revolution Francaise, l'Affirmation du Liberalisme",5,36,2,QROC,0.73,0.12,30.31,10,23,33,32,10,22,1.03,31.25,Difficile,Difficile,0,Meme Difficulté,Pas Adapte,Law
1159,2016,Droit,2,Introduction Historique au Droit,4,"La Revolution Francaise, l'Affirmation du Liberalisme",5,36,2,QROC,0.17,0.94,79.45,22,6,28,27,22,5,1.04,81.48,Difficile,Facile,2,Beaucoup plus Facile,Pas Adapte,Law
2283,2017,Droit,2,Introduction Historique au Droit,4,"La Revolution Francaise, l'Affirmation du Liberalisme",5,36,2,QROC,0.52,0.36,40.14,11,16,27,20,11,9,1.35,55.0,Facile,Moyen,-1,Plus Difficile,Pas Adapte,Law
3407,2018,Droit,2,Introduction Historique au Droit,4,"La Revolution Francaise, l'Affirmation du Liberalisme",5,36,2,QO,0.37,0.29,43.44,12,15,27,20,12,8,1.35,60.0,Moyen,Moyen,0,Meme Difficulté,Pas Adapte,Law
4531,2019,Droit,2,Introduction Historique au Droit,4,"La Revolution Francaise, l'Affirmation du Liberalisme",5,36,2,QCM,0.51,0.28,13.75,4,26,30,14,4,10,2.14,28.57,Difficile,Difficile,0,Meme Difficulté,Pas Adapte,Law
5655,2020,Droit,2,Introduction Historique au Droit,4,"La Revolution Francaise, l'Affirmation du Liberalisme",5,36,2,QCM,0.74,0.21,5.98,2,32,34,14,2,12,2.43,14.29,Moyen,Difficile,-1,Plus Difficile,Pas Adapte,Law
36,2015,Droit,2,Introduction Historique au Droit,4,"La Revolution Francaise, l'Affirmation du Liberalisme",5,37,3,QCU,0.39,0.41,48.85,41,42,83,45,41,4,1.84,91.11,Moyen,Moyen,0,Meme Difficulté,Pas Adapte,Law
1160,2016,Droit,2,Introduction Historique au Droit,4,"La Revolution Francaise, l'Affirmation du Liberalisme",5,37,3,QCU,0.54,0.25,2.33,2,70,72,67,2,65,1.07,2.99,Difficile,Difficile,0,Meme Difficulté,Pas Adapte,Law
2284,2017,Droit,2,Introduction Historique au Droit,4,"La Revolution Francaise, l'Affirmation du Liberalisme",5,37,3,QCU,0.64,0.21,32.35,24,49,73,48,24,24,1.52,50.0,Difficile,Difficile,0,Meme Difficulté,Pas Adapte,Law
3408,2018,Droit,2,Introduction Historique au Droit,4,"La Revolution Francaise, l'Affirmation du Liberalisme",5,37,3,QCU,0.36,0.52,36.8,25,44,69,30,25,5,2.3,83.33,Moyen,Moyen,0,Meme Difficulté,Pas Adapte,Law
4532,2019,Droit,2,Introduction Historique au Droit,4,"La Revolution Francaise, l'Affirmation du Liberalisme",5,37,3,QCU,0.68,0.29,9.14,7,65,72,33,7,26,2.18,21.21,Facile,Difficile,-2,Beaucoup plus Difficile,Pas Adapte,Law
5656,2020,Droit,2,Introduction Historique au Droit,4,"La Revolution Francaise, l'Affirmation du Liberalisme",5,37,3,QCU,0.11,0.9,84.13,59,11,70,63,59,4,1.11,93.65,Moyen,Facile,1,Plus Facile,Pas Adapte,Law
37,2015,Droit,2,Introduction Historique au Droit,4,"La Revolution Francaise, l'Affirmation du Liberalisme",5,38,4,QCU,0.31,0.7,38.31,24,39,63,59,24,35,1.07,40.68,Moyen,Moyen,0,Meme Difficulté,Pas Adapte,Law
1161,2016,Droit,2,Introduction Historique au Droit,4,"La Revolution Francaise, l'Affirmation du Liberalisme",5,38,4,QCU,0.53,0.24,7.73,4,54,58,56,4,52,1.04,7.14,Difficile,Difficile,0,Meme Difficulté,Pas Adapte,Law
2285,2017,Droit,2,Introduction Historique au Droit,4,"La Revolution Francaise, l'Affirmation du Liberalisme",5,38,4,QCM,0.6,0.2,32.9,20,40,60,41,20,21,1.46,48.78,Difficile,Difficile,0,Meme Difficulté,Pas Adapte,Law
3409,2018,Droit,2,Introduction Historique au Droit,4,"La Revolution Francaise, l'Affirmation du Liberalisme",5,38,4,QCM,0.79,0.22,4.12,2,55,57,37,2,35,1.54,5.41,Moyen,Difficile,-1,Plus Difficile,Pas Adapte,Law
4533,2019,Droit,2,Introduction Historique au Droit,4,"La Revolution Francaise, l'Affirmation du Liberalisme",5,38,4,QCM,0.24,0.41,63.73,38,22,60,45,38,7,1.33,84.44,Facile,Moyen,-1,Plus Difficile,Adapte,Law
5657,2020,Droit,2,Introduction Historique au Droit,4,"La Revolution Francaise, l'Affirmation du Liberalisme",5,38,4,QCM,0.27,0.36,63.73,37,21,58,43,37,6,1.35,86.05,Moyen,Moyen,0,Meme Difficulté,Adapte,Law
38,2015,Droit,2,Introduction Historique au Droit,4,"La Revolution Francaise, l'Affirmation du Liberalisme",5,39,5,QCM,0.12,0.96,96.29,90,3,93,92,90,2,1.01,97.83,Facile,Facile,0,Meme Difficulté,Pas Adapte,Law
1162,2016,Droit,2,Introduction Historique au Droit,4,"La Revolution Francaise, l'Affirmation du Liberalisme",5,39,5,QCM,0.42,0.42,35.15,36,66,102,49,36,13,2.08,73.47,Moyen,Moyen,0,Meme Difficulté,Pas Adapte,Law
2286,2017,Droit,2,Introduction Historique au Droit,4,"La Revolution Francaise, l'Affirmation du Liberalisme",5,39,5,QCM,0.73,0.27,27.22,32,85,117,55,32,23,2.13,58.18,Difficile,Difficile,0,Meme Difficulté,Pas Adapte,Law
3410,2018,Droit,2,Introduction Historique au Droit,4,"La Revolution Francaise, l'Affirmation du Liberalisme",5,39,5,QCU,0.11,0.81,96.83,98,3,101,99,98,1,1.02,98.99,Moyen,Facile,1,Plus Facile,Pas Adapte,Law
4534,2019,Droit,2,Introduction Historique au Droit,4,"La Revolution Francaise, l'Affirmation du Liberalisme",5,39,5,QCU,0.49,0.39,23.75,23,72,95,92,23,69,1.03,25.0,Facile,Difficile,-2,Beaucoup plus Difficile,Pas Adapte,Law
5658,2020,Droit,2,Introduction Historique au Droit,4,"La Revolution Francaise, l'Affirmation du Liberalisme",5,39,5,QCU,0.23,0.6,47.7,43,48,91,72,43,29,1.26,59.72,Difficile,Moyen,1,Plus Facile,Pas Adapte,Law
39,2015,Droit,2,Introduction Historique au Droit,5,L'Amenagement du Liberalisme,7,40,1,QCU,0.26,0.68,43.57,27,34,61,39,27,12,1.56,69.23,Moyen,Moyen,0,Meme Difficulté,Pas Adapte,Law
1163,2016,Droit,2,Introduction Historique au Droit,5,L'Amenagement du Liberalisme,7,40,1,QCU,0.08,0.95,91.14,54,5,59,57,54,3,1.04,94.74,Difficile,Facile,2,Beaucoup plus Facile,Pas Adapte,Law
2287,2017,Droit,2,Introduction Historique au Droit,5,L'Amenagement du Liberalisme,7,40,1,QROC,0.58,0.27,40.51,26,38,64,41,26,15,1.56,63.41,Moyen,Moyen,0,Meme Difficulté,Pas Adapte,Law
3411,2018,Droit,2,Introduction Historique au Droit,5,L'Amenagement du Liberalisme,7,40,1,QO,0.06,0.4,74.01,54,19,73,67,54,13,1.09,80.6,Moyen,Facile,1,Plus Facile,Adapte,Law
4535,2019,Droit,2,Introduction Historique au Droit,5,L'Amenagement du Liberalisme,7,40,1,QO,0.04,0.62,74.01,47,17,64,57,47,10,1.12,82.46,Facile,Facile,0,Meme Difficulté,Adapte,Law
5659,2020,Droit,2,Introduction Historique au Droit,5,L'Amenagement du Liberalisme,7,40,1,QCM,0.03,0.99,74.01,53,19,72,67,53,14,1.07,79.1,Facile,Facile,0,Meme Difficulté,Adapte,Law
40,2015,Droit,2,Introduction Historique au Droit,5,L'Amenagement du Liberalisme,7,41,2,QCU,0.23,0.49,37.06,3,4,7,4,3,1,1.75,75.0,Facile,Moyen,-1,Plus Difficile,Pas Adapte,Law
1164,2016,Droit,2,Introduction Historique au Droit,5,L'Amenagement du Liberalisme,7,41,2,QCU,0.0,0.85,96.06,6,0,6,6,6,0,1.0,100.0,Moyen,Facile,1,Plus Facile,Pas Adapte,Law
2288,2017,Droit,2,Introduction Historique au Droit,5,L'Amenagement du Liberalisme,7,41,2,QCU,0.02,0.99,70.78,4,2,6,5,4,1,1.2,80.0,Moyen,Facile,1,Plus Facile,Adapte,Law
3412,2018,Droit,2,Introduction Historique au Droit,5,L'Amenagement du Liberalisme,7,41,2,QO,0.18,0.7,70.78,4,2,6,5,4,1,1.2,80.0,Facile,Facile,0,Meme Difficulté,Adapte,Law
4536,2019,Droit,2,Introduction Historique au Droit,5,L'Amenagement du Liberalisme,7,41,2,QO,0.11,0.89,70.78,5,2,7,6,5,1,1.17,83.33,Facile,Facile,0,Meme Difficulté,Adapte,Law
5660,2020,Droit,2,Introduction Historique au Droit,5,L'Amenagement du Liberalisme,7,41,2,QO,0.08,0.4,70.78,4,2,6,5,4,1,1.2,80.0,Facile,Facile,0,Meme Difficulté,Adapte,Law
41,2015,Droit,2,Introduction Historique au Droit,5,L'Amenagement du Liberalisme,7,42,3,QCM,0.42,0.33,53.15,45,40,85,78,45,33,1.09,57.69,Difficile,Moyen,1,Plus Facile,Pas Adapte,Law
1165,2016,Droit,2,Introduction Historique au Droit,5,L'Amenagement du Liberalisme,7,42,3,QCM,0.27,0.54,35.31,34,61,95,83,34,49,1.14,40.96,Facile,Moyen,-1,Plus Difficile,Pas Adapte,Law
2289,2017,Droit,2,Introduction Historique au Droit,5,L'Amenagement du Liberalisme,7,42,3,QCM,0.5,0.39,59.08,63,44,107,74,63,11,1.45,85.14,Facile,Moyen,-1,Plus Difficile,Pas Adapte,Law
3413,2018,Droit,2,Introduction Historique au Droit,5,L'Amenagement du Liberalisme,7,42,3,QCM,0.47,0.42,48.49,51,54,105,58,51,7,1.81,87.93,Facile,Moyen,-1,Plus Difficile,Pas Adapte,Law
4537,2019,Droit,2,Introduction Historique au Droit,5,L'Amenagement du Liberalisme,7,42,3,QCM,0.75,0.26,16.31,15,76,91,28,15,13,3.25,53.57,Facile,Difficile,-2,Beaucoup plus Difficile,Pas Adapte,Law
5661,2020,Droit,2,Introduction Historique au Droit,5,L'Amenagement du Liberalisme,7,42,3,QCM,0.77,0.16,14.33,14,83,97,64,14,50,1.52,21.88,Difficile,Difficile,0,Meme Difficulté,Pas Adapte,Law
42,2015,Droit,2,Introduction Historique au Droit,5,L'Amenagement du Liberalisme,7,43,4,QCM,0.47,0.42,36.78,13,22,35,33,13,20,1.06,39.39,Difficile,Moyen,1,Plus Facile,Pas Adapte,Law
1166,2016,Droit,2,Introduction Historique au Droit,5,L'Amenagement du Liberalisme,7,43,4,QCM,0.39,0.65,50.17,15,15,30,28,15,13,1.07,53.57,Moyen,Moyen,0,Meme Difficulté,Pas Adapte,Law
2290,2017,Droit,2,Introduction Historique au Droit,5,L'Amenagement du Liberalisme,7,43,4,QCM,0.3,0.65,64.27,17,10,27,21,17,4,1.29,80.95,Facile,Moyen,-1,Plus Difficile,Adapte,Law
3414,2018,Droit,2,Introduction Historique au Droit,5,L'Amenagement du Liberalisme,7,43,4,QCM,0.42,0.36,64.27,18,10,28,21,18,3,1.33,85.71,Moyen,Moyen,0,Meme Difficulté,Adapte,Law
4538,2019,Droit,2,Introduction Historique au Droit,5,L'Amenagement du Liberalisme,7,43,4,QCM,0.44,0.41,64.27,21,11,32,31,21,10,1.03,67.74,Moyen,Moyen,0,Meme Difficulté,Adapte,Law
5662,2020,Droit,2,Introduction Historique au Droit,5,L'Amenagement du Liberalisme,7,43,4,QCM,0.34,0.51,64.27,24,13,37,35,24,11,1.06,68.57,Moyen,Moyen,0,Meme Difficulté,Adapte,Law
43,2015,Droit,2,Introduction Historique au Droit,5,L'Amenagement du Liberalisme,7,44,5,QCU,0.57,0.29,4.73,2,46,48,27,2,25,1.78,7.41,Difficile,Difficile,0,Meme Difficulté,Pas Adapte,Law
1167,2016,Droit,2,Introduction Historique au Droit,5,L'Amenagement du Liberalisme,7,44,5,QCU,0.02,0.92,81.29,43,10,53,50,43,7,1.06,86.0,Moyen,Facile,1,Plus Facile,Pas Adapte,Law
2291,2017,Droit,2,Introduction Historique au Droit,5,L'Amenagement du Liberalisme,7,44,5,QCU,0.24,0.61,62.15,35,22,57,38,35,3,1.5,92.11,Moyen,Moyen,0,Meme Difficulté,Adapte,Law
3415,2018,Droit,2,Introduction Historique au Droit,5,L'Amenagement du Liberalisme,7,44,5,QCU,0.26,0.63,62.15,36,22,58,53,36,17,1.09,67.92,Moyen,Moyen,0,Meme Difficulté,Adapte,Law
4539,2019,Droit,2,Introduction Historique au Droit,5,L'Amenagement du Liberalisme,7,44,5,QCU,0.29,0.56,62.15,36,22,58,50,36,14,1.16,72.0,Moyen,Moyen,0,Meme Difficulté,Adapte,Law
5663,2020,Droit,2,Introduction Historique au Droit,5,L'Amenagement du Liberalisme,7,44,5,QCU,0.25,0.48,62.15,34,20,54,41,34,7,1.32,82.93,Moyen,Moyen,0,Meme Difficulté,Adapte,Law
44,2015,Droit,2,Introduction Historique au Droit,5,L'Amenagement du Liberalisme,7,45,6,QROC,0.54,0.33,58.6,40,29,69,42,40,2,1.64,95.24,Difficile,Moyen,1,Plus Facile,Pas Adapte,Law
1168,2016,Droit,2,Introduction Historique au Droit,5,L'Amenagement du Liberalisme,7,45,6,QROC,0.48,0.35,46.86,37,41,78,65,37,28,1.2,56.92,Moyen,Moyen,0,Meme Difficulté,Pas Adapte,Law
2292,2017,Droit,2,Introduction Historique au Droit,5,L'Amenagement du Liberalisme,7,45,6,QROC,0.65,0.09,2.68,2,71,73,52,2,50,1.4,3.85,Moyen,Difficile,-1,Plus Difficile,Pas Adapte,Law
3416,2018,Droit,2,Introduction Historique au Droit,5,L'Amenagement du Liberalisme,7,45,6,QROC,0.84,0.11,16.67,14,69,83,39,14,25,2.13,35.9,Facile,Difficile,-2,Beaucoup plus Difficile,Pas Adapte,Law
4540,2019,Droit,2,Introduction Historique au Droit,5,L'Amenagement du Liberalisme,7,45,6,QROC,0.52,0.28,48.65,37,39,76,51,37,14,1.49,72.55,Difficile,Moyen,1,Plus Facile,Pas Adapte,Law
5664,2020,Droit,2,Introduction Historique au Droit,5,L'Amenagement du Liberalisme,7,45,6,QROC,0.42,0.34,54.2,37,32,69,59,37,22,1.17,62.71,Facile,Moyen,-1,Plus Difficile,Pas Adapte,Law
45,2015,Droit,2,Introduction Historique au Droit,5,L'Amenagement du Liberalisme,7,46,7,QCM,0.29,0.43,50.6,24,23,47,37,24,13,1.27,64.86,Facile,Moyen,-1,Plus Difficile,Pas Adapte,Law
1169,2016,Droit,2,Introduction Historique au Droit,5,L'Amenagement du Liberalisme,7,46,7,QCM,0.01,0.83,96.66,41,1,42,41,41,0,1.02,100.0,Difficile,Facile,2,Beaucoup plus Facile,Pas Adapte,Law
2293,2017,Droit,2,Introduction Historique au Droit,5,L'Amenagement du Liberalisme,7,46,7,QCM,0.18,0.98,85.04,34,6,40,36,34,2,1.11,94.44,Moyen,Facile,1,Plus Facile,Pas Adapte,Law
3417,2018,Droit,2,Introduction Historique au Droit,5,L'Amenagement du Liberalisme,7,46,7,QCM,0.11,0.86,77.17,31,9,40,31,31,0,1.29,100.0,Difficile,Facile,2,Beaucoup plus Facile,Pas Adapte,Law
4541,2019,Droit,2,Introduction Historique au Droit,5,L'Amenagement du Liberalisme,7,46,7,QCM,0.71,0.27,13.69,6,40,46,23,6,17,2.0,26.09,Facile,Difficile,-2,Beaucoup plus Difficile,Pas Adapte,Law
5665,2020,Droit,2,Introduction Historique au Droit,5,L'Amenagement du Liberalisme,7,46,7,QCM,0.56,0.17,21.03,9,36,45,24,9,15,1.88,37.5,Facile,Difficile,-2,Beaucoup plus Difficile,Pas Adapte,Law
46,2015,Droit,3,Relations Internationales,1,Introduction,14,47,1,QCM,0.05,0.82,99.47,60,0,60,60,60,0,1.0,100.0,Moyen,Facile,1,Plus Facile,Pas Adapte,Law
1170,2016,Droit,3,Relations Internationales,1,Introduction,14,47,1,QCM,0.23,0.41,38.9,25,40,65,50,25,25,1.3,50.0,Facile,Moyen,-1,Plus Difficile,Pas Adapte,Law
2294,2017,Droit,3,Relations Internationales,1,Introduction,14,47,1,QCM,0.69,0.21,4.79,3,62,65,19,3,16,3.42,15.79,Facile,Difficile,-2,Beaucoup plus Difficile,Pas Adapte,Law
3418,2018,Droit,3,Relations Internationales,1,Introduction,14,47,1,QCM,0.25,0.44,47.82,33,37,70,52,33,19,1.35,63.46,Moyen,Moyen,0,Meme Difficulté,Pas Adapte,Law
4542,2019,Droit,3,Relations Internationales,1,Introduction,14,47,1,QCM,0.66,0.18,16.0,12,65,77,67,12,55,1.15,17.91,Moyen,Difficile,-1,Plus Difficile,Pas Adapte,Law
5666,2020,Droit,3,Relations Internationales,1,Introduction,14,47,1,QCM,0.09,0.92,65.64,45,23,68,47,45,2,1.45,95.74,Moyen,Facile,1,Plus Facile,Adapte,Law
47,2015,Droit,3,Relations Internationales,1,Introduction,14,48,2,QCU,0.13,0.98,80.28,28,7,35,34,28,6,1.03,82.35,Moyen,Facile,1,Plus Facile,Pas Adapte,Law
1171,2016,Droit,3,Relations Internationales,1,Introduction,14,48,2,QCU,0.07,0.9,79.55,28,7,35,35,28,7,1.0,80.0,Facile,Facile,0,Meme Difficulté,Pas Adapte,Law
2295,2017,Droit,3,Relations Internationales,1,Introduction,14,48,2,QCU,0.41,0.38,15.81,6,34,40,27,6,21,1.48,22.22,Facile,Difficile,-2,Beaucoup plus Difficile,Pas Adapte,Law
3419,2018,Droit,3,Relations Internationales,1,Introduction,14,48,2,QCU,0.1,0.82,95.38,33,2,35,34,33,1,1.03,97.06,Difficile,Facile,2,Beaucoup plus Facile,Pas Adapte,Law
4543,2019,Droit,3,Relations Internationales,1,Introduction,14,48,2,QCU,0.04,0.76,96.52,34,1,35,34,34,0,1.03,100.0,Difficile,Facile,2,Beaucoup plus Facile,Pas Adapte,Law
5667,2020,Droit,3,Relations Internationales,1,Introduction,14,48,2,QCU,0.2,0.97,99.85,32,0,32,32,32,0,1.0,100.0,Difficile,Facile,2,Beaucoup plus Facile,Pas Adapte,Law
48,2015,Droit,3,Relations Internationales,1,Introduction,14,49,3,QCU,0.1,0.81,91.35,26,3,29,27,26,1,1.07,96.3,Difficile,Facile,2,Beaucoup plus Facile,Pas Adapte,Law
1172,2016,Droit,3,Relations Internationales,1,Introduction,14,49,3,QCU,0.02,0.93,83.85,26,5,31,29,26,3,1.07,89.66,Moyen,Facile,1,Plus Facile,Pas Adapte,Law
2296,2017,Droit,3,Relations Internationales,1,Introduction,14,49,3,QCM,0.77,0.18,6.13,2,32,34,22,2,20,1.55,9.09,Moyen,Difficile,-1,Plus Difficile,Pas Adapte,Law
3420,2018,Droit,3,Relations Internationales,1,Introduction,14,49,3,QCM,0.5,0.24,29.5,10,24,34,31,10,21,1.1,32.26,Moyen,Difficile,-1,Plus Difficile,Pas Adapte,Law
4544,2019,Droit,3,Relations Internationales,1,Introduction,14,49,3,QCM,0.29,0.5,49.08,17,17,34,31,17,14,1.1,54.84,Facile,Moyen,-1,Plus Difficile,Pas Adapte,Law
5668,2020,Droit,3,Relations Internationales,1,Introduction,14,49,3,QCM,0.07,0.9,87.61,32,5,37,33,32,1,1.12,96.97,Facile,Facile,0,Meme Difficulté,Pas Adapte,Law
49,2015,Droit,3,Relations Internationales,1,Introduction,14,50,4,QCU,0.27,0.67,56.04,37,29,66,58,37,21,1.14,63.79,Facile,Moyen,-1,Plus Difficile,Pas Adapte,Law
1173,2016,Droit,3,Relations Internationales,1,Introduction,14,50,4,QCU,0.5,0.2,30.19,18,42,60,48,18,30,1.25,37.5,Moyen,Difficile,-1,Plus Difficile,Pas Adapte,Law
2297,2017,Droit,3,Relations Internationales,1,Introduction,14,50,4,QROC,0.14,0.7,88.62,51,6,57,56,51,5,1.02,91.07,Moyen,Facile,1,Plus Facile,Pas Adapte,Law
3421,2018,Droit,3,Relations Internationales,1,Introduction,14,50,4,QROC,0.04,0.83,67.71,38,18,56,48,38,10,1.17,79.17,Moyen,Facile,1,Plus Facile,Adapte,Law
4545,2019,Droit,3,Relations Internationales,1,Introduction,14,50,4,QROC,0.15,0.82,67.71,40,19,59,43,40,3,1.37,93.02,Facile,Facile,0,Meme Difficulté,Adapte,Law
5669,2020,Droit,3,Relations Internationales,1,Introduction,14,50,4,QROC,0.13,0.68,67.71,42,20,62,62,42,20,1.0,67.74,Facile,Facile,0,Meme Difficulté,Adapte,Law
50,2015,Droit,3,Relations Internationales,1,Introduction,14,51,5,QCU,0.36,0.57,53.93,12,11,23,20,12,8,1.15,60.0,Difficile,Moyen,1,Plus Facile,Pas Adapte,Law
1174,2016,Droit,3,Relations Internationales,1,Introduction,14,51,5,QCU,0.28,0.65,41.02,10,14,24,14,10,4,1.71,71.43,Facile,Moyen,-1,Plus Difficile,Pas Adapte,Law
2298,2017,Droit,3,Relations Internationales,1,Introduction,14,51,5,QCU,0.23,0.59,57.19,15,11,26,22,15,7,1.18,68.18,Moyen,Moyen,0,Meme Difficulté,Pas Adapte,Law
3422,2018,Droit,3,Relations Internationales,1,Introduction,14,51,5,QCU,0.35,0.69,40.86,9,13,22,21,9,12,1.05,42.86,Difficile,Moyen,1,Plus Facile,Pas Adapte,Law
4546,2019,Droit,3,Relations Internationales,1,Introduction,14,51,5,QCU,0.69,0.39,14.6,4,20,24,11,4,7,2.18,36.36,Difficile,Difficile,0,Meme Difficulté,Pas Adapte,Law
5670,2020,Droit,3,Relations Internationales,1,Introduction,14,51,5,QCU,0.02,0.77,74.24,19,7,26,20,19,1,1.3,95.0,Difficile,Facile,2,Beaucoup plus Facile,Adapte,Law
51,2015,Droit,3,Relations Internationales,1,Introduction,14,52,6,QCM,0.62,0.28,3.44,2,53,55,18,2,16,3.06,11.11,Difficile,Difficile,0,Meme Difficulté,Pas Adapte,Law
1175,2016,Droit,3,Relations Internationales,1,Introduction,14,52,6,QCM,0.07,0.77,85.51,47,8,55,48,47,1,1.15,97.92,Difficile,Facile,2,Beaucoup plus Facile,Pas Adapte,Law
2299,2017,Droit,3,Relations Internationales,1,Introduction,14,52,6,QCM,0.34,0.53,42.12,20,28,48,48,20,28,1.0,41.67,Difficile,Moyen,1,Plus Facile,Pas Adapte,Law
3423,2018,Droit,3,Relations Internationales,1,Introduction,14,52,6,QCM,0.31,0.49,59.77,25,17,42,38,25,13,1.11,65.79,Moyen,Moyen,0,Meme Difficulté,Pas Adapte,Law
4547,2019,Droit,3,Relations Internationales,1,Introduction,14,52,6,QCM,0.05,0.8,96.61,43,1,44,44,43,1,1.0,97.73,Moyen,Facile,1,Plus Facile,Pas Adapte,Law
5671,2020,Droit,3,Relations Internationales,1,Introduction,14,52,6,QCU,0.26,0.46,56.44,22,17,39,25,22,3,1.56,88.0,Facile,Moyen,-1,Plus Difficile,Pas Adapte,Law
52,2015,Droit,3,Relations Internationales,1,Introduction,14,53,7,QCM,0.33,0.4,37.72,8,14,22,14,8,6,1.57,57.14,Facile,Moyen,-1,Plus Difficile,Pas Adapte,Law
1176,2016,Droit,3,Relations Internationales,1,Introduction,14,53,7,QCM,0.78,0.25,6.27,2,23,25,20,2,18,1.25,10.0,Difficile,Difficile,0,Meme Difficulté,Pas Adapte,Law
2300,2017,Droit,3,Relations Internationales,1,Introduction,14,53,7,QCM,0.51,0.15,4.44,1,23,24,12,1,11,2.0,8.33,Difficile,Difficile,0,Meme Difficulté,Pas Adapte,Law
3424,2018,Droit,3,Relations Internationales,1,Introduction,14,53,7,QCM,0.5,0.62,62.82,13,7,20,20,13,7,1.0,65.0,Difficile,Moyen,1,Plus Facile,Adapte,Law
4548,2019,Droit,3,Relations Internationales,1,Introduction,14,53,7,QCM,0.37,0.34,62.82,12,7,19,12,12,0,1.58,100.0,Moyen,Moyen,0,Meme Difficulté,Adapte,Law
5672,2020,Droit,3,Relations Internationales,1,Introduction,14,53,7,QCM,0.42,0.41,62.82,14,8,22,14,14,0,1.57,100.0,Moyen,Moyen,0,Meme Difficulté,Adapte,Law
53,2015,Droit,3,Relations Internationales,1,Introduction,14,54,8,QROC,0.22,0.33,42.94,3,4,7,4,3,1,1.75,75.0,Facile,Moyen,-1,Plus Difficile,Pas Adapte,Law
1177,2016,Droit,3,Relations Internationales,1,Introduction,14,54,8,QROC,0.45,0.32,41.67,3,3,6,4,3,1,1.5,75.0,Facile,Moyen,-1,Plus Difficile,Pas Adapte,Law
2301,2017,Droit,3,Relations Internationales,1,Introduction,14,54,8,QROC,0.62,0.08,33.94,2,4,6,3,2,1,2.0,66.67,Moyen,Difficile,-1,Plus Difficile,Pas Adapte,Law
3425,2018,Droit,3,Relations Internationales,1,Introduction,14,54,8,QO,0.46,0.26,57.08,3,2,5,3,3,0,1.67,100.0,Moyen,Moyen,0,Meme Difficulté,Pas Adapte,Law
4549,2019,Droit,3,Relations Internationales,1,Introduction,14,54,8,QROC,0.19,0.99,68.74,3,2,5,5,3,2,1.0,60.0,Facile,Facile,0,Meme Difficulté,Adapte,Law
5673,2020,Droit,3,Relations Internationales,1,Introduction,14,54,8,QROC,0.16,0.76,68.74,3,2,5,5,3,2,1.0,60.0,Facile,Facile,0,Meme Difficulté,Adapte,Law
54,2015,Droit,3,Relations Internationales,1,Introduction,14,55,9,QCU,0.38,0.57,60.26,7,5,12,7,7,0,1.71,100.0,Moyen,Moyen,0,Meme Difficulté,Adapte,Law
1178,2016,Droit,3,Relations Internationales,1,Introduction,14,55,9,QCU,0.23,0.54,60.26,8,6,14,9,8,1,1.56,88.89,Moyen,Moyen,0,Meme Difficulté,Adapte,Law
2302,2017,Droit,3,Relations Internationales,1,Introduction,14,55,9,QCU,0.34,0.53,60.26,8,6,14,12,8,4,1.17,66.67,Moyen,Moyen,0,Meme Difficulté,Adapte,Law
3426,2018,Droit,3,Relations Internationales,1,Introduction,14,55,9,QCU,0.34,0.52,60.26,10,6,16,14,10,4,1.14,71.43,Moyen,Moyen,0,Meme Difficulté,Adapte,Law
4550,2019,Droit,3,Relations Internationales,1,Introduction,14,55,9,QCU,0.33,0.4,60.26,9,6,15,12,9,3,1.25,75.0,Moyen,Moyen,0,Meme Difficulté,Adapte,Law
5674,2020,Droit,3,Relations Internationales,1,Introduction,14,55,9,QCU,0.33,0.46,60.26,8,5,13,11,8,3,1.18,72.73,Moyen,Moyen,0,Meme Difficulté,Adapte,Law
55,2015,Droit,3,Relations Internationales,1,Introduction,14,56,10,QCU,0.64,0.21,23.57,22,71,93,84,22,62,1.11,26.19,Moyen,Difficile,-1,Plus Difficile,Pas Adapte,Law
1179,2016,Droit,3,Relations Internationales,1,Introduction,14,56,10,QCU,0.31,0.56,61.14,60,38,98,81,60,21,1.21,74.07,Difficile,Moyen,1,Plus Facile,Adapte,Law
2303,2017,Droit,3,Relations Internationales,1,Introduction,14,56,10,QCM,0.24,0.57,61.14,53,34,87,73,53,20,1.19,72.6,Moyen,Moyen,0,Meme Difficulté,Adapte,Law
3427,2018,Droit,3,Relations Internationales,1,Introduction,14,56,10,QCU,0.34,0.6,61.14,54,35,89,60,54,6,1.48,90.0,Moyen,Moyen,0,Meme Difficulté,Adapte,Law
4551,2019,Droit,3,Relations Internationales,1,Introduction,14,56,10,QCU,0.21,0.48,61.14,53,34,87,71,53,18,1.23,74.65,Moyen,Moyen,0,Meme Difficulté,Adapte,Law
5675,2020,Droit,3,Relations Internationales,1,Introduction,14,56,10,QCU,0.31,0.54,61.14,58,37,95,89,58,31,1.07,65.17,Moyen,Moyen,0,Meme Difficulté,Adapte,Law
56,2015,Droit,3,Relations Internationales,1,Introduction,14,57,11,QCU,0.26,0.75,56.36,51,39,90,68,51,17,1.32,75.0,Difficile,Moyen,1,Plus Facile,Pas Adapte,Law
1180,2016,Droit,3,Relations Internationales,1,Introduction,14,57,11,QCU,0.19,0.8,69.38,58,26,84,75,58,17,1.12,77.33,Facile,Facile,0,Meme Difficulté,Adapte,Law
2304,2017,Droit,3,Relations Internationales,1,Introduction,14,57,11,QCU,0.01,0.99,69.38,56,24,80,76,56,20,1.05,73.68,Facile,Facile,0,Meme Difficulté,Adapte,Law
3428,2018,Droit,3,Relations Internationales,1,Introduction,14,57,11,QROC,0.14,0.87,69.38,49,22,71,66,49,17,1.08,74.24,Facile,Facile,0,Meme Difficulté,Adapte,Law
4552,2019,Droit,3,Relations Internationales,1,Introduction,14,57,11,QROC,0.08,0.79,69.38,51,22,73,62,51,11,1.18,82.26,Facile,Facile,0,Meme Difficulté,Adapte,Law
5676,2020,Droit,3,Relations Internationales,1,Introduction,14,57,11,QROC,0.2,0.48,69.38,57,25,82,65,57,8,1.26,87.69,Facile,Facile,0,Meme Difficulté,Adapte,Law
57,2015,Droit,3,Relations Internationales,1,Introduction,14,58,12,QCU,0.36,0.69,59.21,40,28,68,49,40,9,1.39,81.63,Difficile,Moyen,1,Plus Facile,Pas Adapte,Law
1181,2016,Droit,3,Relations Internationales,1,Introduction,14,58,12,QCU,0.36,0.6,38.99,30,46,76,33,30,3,2.3,90.91,Difficile,Moyen,1,Plus Facile,Pas Adapte,Law
2305,2017,Droit,3,Relations Internationales,1,Introduction,14,58,12,QCU,0.37,0.51,41.16,35,51,86,82,35,47,1.05,42.68,Facile,Moyen,-1,Plus Difficile,Pas Adapte,Law
3429,2018,Droit,3,Relations Internationales,1,Introduction,14,58,12,QCU,0.39,0.57,53.82,51,43,94,83,51,32,1.13,61.45,Facile,Moyen,-1,Plus Difficile,Pas Adapte,Law
4553,2019,Droit,3,Relations Internationales,1,Introduction,14,58,12,QCU,0.22,0.62,58.05,57,42,99,78,57,21,1.27,73.08,Moyen,Moyen,0,Meme Difficulté,Pas Adapte,Law
5677,2020,Droit,3,Relations Internationales,1,Introduction,14,58,12,QCU,0.02,0.84,80.39,74,18,92,84,74,10,1.1,88.1,Facile,Facile,0,Meme Difficulté,Pas Adapte,Law
58,2015,Droit,3,Relations Internationales,1,Introduction,14,59,13,QCU,0.2,0.89,68.76,34,15,49,38,34,4,1.29,89.47,Difficile,Facile,2,Beaucoup plus Facile,Adapte,Law
1182,2016,Droit,3,Relations Internationales,1,Introduction,14,59,13,QCU,0.11,0.89,68.76,35,16,51,42,35,7,1.21,83.33,Facile,Facile,0,Meme Difficulté,Adapte,Law
2306,2017,Droit,3,Relations Internationales,1,Introduction,14,59,13,QCM,0.14,0.85,68.76,33,15,48,38,33,5,1.26,86.84,Facile,Facile,0,Meme Difficulté,Adapte,Law
3430,2018,Droit,3,Relations Internationales,1,Introduction,14,59,13,QCM,0.08,0.78,68.76,31,14,45,35,31,4,1.29,88.57,Facile,Facile,0,Meme Difficulté,Adapte,Law
4554,2019,Droit,3,Relations Internationales,1,Introduction,14,59,13,QCM,0.03,0.79,68.76,31,14,45,34,31,3,1.32,91.18,Facile,Facile,0,Meme Difficulté,Adapte,Law
5678,2020,Droit,3,Relations Internationales,1,Introduction,14,59,13,QCU,0.04,0.89,68.76,28,13,41,31,28,3,1.32,90.32,Facile,Facile,0,Meme Difficulté,Adapte,Law
59,2015,Droit,3,Relations Internationales,1,Introduction,14,60,14,QCU,0.3,0.66,55.24,35,28,63,50,35,15,1.26,70.0,Facile,Moyen,-1,Plus Difficile,Pas Adapte,Law
1183,2016,Droit,3,Relations Internationales,1,Introduction,14,60,14,QCU,0.05,0.95,73.25,48,18,66,62,48,14,1.06,77.42,Facile,Facile,0,Meme Difficulté,Adapte,Law
2307,2017,Droit,3,Relations Internationales,1,Introduction,14,60,14,QCU,0.08,0.95,73.25,52,19,71,62,52,10,1.15,83.87,Facile,Facile,0,Meme Difficulté,Adapte,Law
3431,2018,Droit,3,Relations Internationales,1,Introduction,14,60,14,QCU,0.2,0.82,73.25,56,20,76,65,56,9,1.17,86.15,Facile,Facile,0,Meme Difficulté,Adapte,Law
4555,2019,Droit,3,Relations Internationales,1,Introduction,14,60,14,QROC,0.04,0.77,73.25,58,21,79,73,58,15,1.08,79.45,Facile,Facile,0,Meme Difficulté,Adapte,Law
5679,2020,Droit,3,Relations Internationales,1,Introduction,14,60,14,QROC,0.03,0.82,73.25,66,24,90,83,66,17,1.08,79.52,Facile,Facile,0,Meme Difficulté,Adapte,Law
60,2015,Droit,3,Relations Internationales,2,Les Acteurs des Relations Internationales,2,61,1,QCU,0.24,0.66,37.5,13,22,35,24,13,11,1.46,54.17,Difficile,Moyen,1,Plus Facile,Pas Adapte,Law
1184,2016,Droit,3,Relations Internationales,2,Les Acteurs des Relations Internationales,2,61,1,QCU,0.01,0.75,91.29,34,3,37,34,34,0,1.09,100.0,Moyen,Facile,1,Plus Facile,Pas Adapte,Law
2308,2017,Droit,3,Relations Internationales,2,Les Acteurs des Relations Internationales,2,61,1,QCM,0.17,0.88,76.29,33,10,43,41,33,8,1.05,80.49,Facile,Facile,0,Meme Difficulté,Pas Adapte,Law
3432,2018,Droit,3,Relations Internationales,2,Les Acteurs des Relations Internationales,2,61,1,QCM,0.79,0.2,32.64,15,30,45,43,15,28,1.05,34.88,Facile,Difficile,-2,Beaucoup plus Difficile,Pas Adapte,Law
4556,2019,Droit,3,Relations Internationales,2,Les Acteurs des Relations Internationales,2,61,1,QCM,0.24,0.56,57.6,24,18,42,38,24,14,1.11,63.16,Difficile,Moyen,1,Plus Facile,Pas Adapte,Law
5680,2020,Droit,3,Relations Internationales,2,Les Acteurs des Relations Internationales,2,61,1,QCM,0.6,0.28,14.8,6,33,39,16,6,10,2.44,37.5,Facile,Difficile,-2,Beaucoup plus Difficile,Pas Adapte,Law
61,2015,Droit,3,Relations Internationales,2,Les Acteurs des Relations Internationales,2,62,2,QCM,0.59,0.24,31.07,14,30,44,23,14,9,1.91,60.87,Facile,Difficile,-2,Beaucoup plus Difficile,Pas Adapte,Law
1185,2016,Droit,3,Relations Internationales,2,Les Acteurs des Relations Internationales,2,62,2,QCM,0.68,0.23,26.99,12,31,43,31,12,19,1.39,38.71,Difficile,Difficile,0,Meme Difficulté,Pas Adapte,Law
2309,2017,Droit,3,Relations Internationales,2,Les Acteurs des Relations Internationales,2,62,2,QCM,0.48,0.33,57.63,24,17,41,36,24,12,1.14,66.67,Difficile,Moyen,1,Plus Facile,Pas Adapte,Law
3433,2018,Droit,3,Relations Internationales,2,Les Acteurs des Relations Internationales,2,62,2,QCM,0.57,0.22,0.99,0,36,36,20,0,20,1.8,0.0,Facile,Difficile,-2,Beaucoup plus Difficile,Pas Adapte,Law
4557,2019,Droit,3,Relations Internationales,2,Les Acteurs des Relations Internationales,2,62,2,QCM,0.14,0.87,90.82,32,3,35,32,32,0,1.09,100.0,Difficile,Facile,2,Beaucoup plus Facile,Pas Adapte,Law
5681,2020,Droit,3,Relations Internationales,2,Les Acteurs des Relations Internationales,2,62,2,QCM,0.03,0.81,91.21,30,3,33,31,30,1,1.06,96.77,Facile,Facile,0,Meme Difficulté,Pas Adapte,Law
62,2015,Droit,3,Relations Internationales,3,Les Grands Principes regissant les Relations Internationales,9,63,1,QCU,0.31,0.58,57.84,12,9,21,12,12,0,1.75,100.0,Moyen,Moyen,0,Meme Difficulté,Pas Adapte,Law
1186,2016,Droit,3,Relations Internationales,3,Les Grands Principes regissant les Relations Internationales,9,63,1,QCU,0.34,0.42,36.09,6,12,18,15,6,9,1.2,40.0,Moyen,Moyen,0,Meme Difficulté,Pas Adapte,Law
2310,2017,Droit,3,Relations Internationales,3,Les Grands Principes regissant les Relations Internationales,9,63,1,QCU,0.34,0.56,56.33,10,8,18,14,10,4,1.29,71.43,Difficile,Moyen,1,Plus Facile,Pas Adapte,Law
3434,2018,Droit,3,Relations Internationales,3,Les Grands Principes regissant les Relations Internationales,9,63,1,QCU,0.19,0.94,80.44,15,4,19,18,15,3,1.06,83.33,Moyen,Facile,1,Plus Facile,Pas Adapte,Law
4558,2019,Droit,3,Relations Internationales,3,Les Grands Principes regissant les Relations Internationales,9,63,1,QCM,0.43,0.68,39.06,8,13,21,16,8,8,1.31,50.0,Moyen,Moyen,0,Meme Difficulté,Pas Adapte,Law
5682,2020,Droit,3,Relations Internationales,3,Les Grands Principes regissant les Relations Internationales,9,63,1,QCM,0.56,0.29,29.71,5,13,18,10,5,5,1.8,50.0,Moyen,Difficile,-1,Plus Difficile,Pas Adapte,Law
63,2015,Droit,3,Relations Internationales,3,Les Grands Principes regissant les Relations Internationales,9,64,2,QCU,0.58,0.28,33.5,25,51,76,48,25,23,1.58,52.08,Moyen,Difficile,-1,Plus Difficile,Pas Adapte,Law
1187,2016,Droit,3,Relations Internationales,3,Les Grands Principes regissant les Relations Internationales,9,64,2,QCU,0.19,0.93,94.17,78,5,83,82,78,4,1.01,95.12,Facile,Facile,0,Meme Difficulté,Pas Adapte,Law
2311,2017,Droit,3,Relations Internationales,3,Les Grands Principes regissant les Relations Internationales,9,64,2,QCU,0.7,0.26,8.59,7,79,86,52,7,45,1.65,13.46,Difficile,Difficile,0,Meme Difficulté,Pas Adapte,Law
3435,2018,Droit,3,Relations Internationales,3,Les Grands Principes regissant les Relations Internationales,9,64,2,QCU,0.16,0.76,83.45,73,14,87,85,73,12,1.02,85.88,Facile,Facile,0,Meme Difficulté,Pas Adapte,Law
4559,2019,Droit,3,Relations Internationales,3,Les Grands Principes regissant les Relations Internationales,9,64,2,QCU,0.54,0.27,4.0,3,83,86,54,3,51,1.59,5.56,Facile,Difficile,-2,Beaucoup plus Difficile,Pas Adapte,Law
5683,2020,Droit,3,Relations Internationales,3,Les Grands Principes regissant les Relations Internationales,9,64,2,QCU,0.12,0.89,87.73,81,11,92,88,81,7,1.05,92.05,Moyen,Facile,1,Plus Facile,Pas Adapte,Law
64,2015,Droit,3,Relations Internationales,3,Les Grands Principes regissant les Relations Internationales,9,65,3,QCU,0.25,0.53,46.41,21,24,45,40,21,19,1.12,52.5,Facile,Moyen,-1,Plus Difficile,Pas Adapte,Law
1188,2016,Droit,3,Relations Internationales,3,Les Grands Principes regissant les Relations Internationales,9,65,3,QCU,0.4,0.65,45.89,19,23,42,20,19,1,2.1,95.0,Moyen,Moyen,0,Meme Difficulté,Pas Adapte,Law
2312,2017,Droit,3,Relations Internationales,3,Les Grands Principes regissant les Relations Internationales,9,65,3,QCU,0.14,0.8,79.17,37,10,47,41,37,4,1.15,90.24,Difficile,Facile,2,Beaucoup plus Facile,Pas Adapte,Law
3436,2018,Droit,3,Relations Internationales,3,Les Grands Principes regissant les Relations Internationales,9,65,3,QCU,0.34,0.53,43.09,21,28,49,34,21,13,1.44,61.76,Facile,Moyen,-1,Plus Difficile,Pas Adapte,Law
4560,2019,Droit,3,Relations Internationales,3,Les Grands Principes regissant les Relations Internationales,9,65,3,QCU,0.03,0.86,78.63,42,12,54,46,42,4,1.17,91.3,Facile,Facile,0,Meme Difficulté,Pas Adapte,Law
5684,2020,Droit,3,Relations Internationales,3,Les Grands Principes regissant les Relations Internationales,9,65,3,QCU,0.12,0.89,78.79,46,12,58,51,46,5,1.14,90.2,Moyen,Facile,1,Plus Facile,Pas Adapte,Law
65,2015,Droit,3,Relations Internationales,3,Les Grands Principes regissant les Relations Internationales,9,66,4,QO,0.63,0.16,36.92,2,4,6,4,2,2,1.5,50.0,Difficile,Moyen,1,Plus Facile,Pas Adapte,Law
1189,2016,Droit,3,Relations Internationales,3,Les Grands Principes regissant les Relations Internationales,9,66,4,QO,0.89,0.13,20.14,1,6,7,5,1,4,1.4,20.0,Moyen,Difficile,-1,Plus Difficile,Pas Adapte,Law
2313,2017,Droit,3,Relations Internationales,3,Les Grands Principes regissant les Relations Internationales,9,66,4,QO,0.84,0.11,13.98,1,6,7,5,1,4,1.4,20.0,Difficile,Difficile,0,Meme Difficulté,Pas Adapte,Law
3437,2018,Droit,3,Relations Internationales,3,Les Grands Principes regissant les Relations Internationales,9,66,4,QO,0.48,0.28,39.29,3,5,8,4,3,1,2.0,75.0,Facile,Moyen,-1,Plus Difficile,Pas Adapte,Law
4561,2019,Droit,3,Relations Internationales,3,Les Grands Principes regissant les Relations Internationales,9,66,4,QCM,0.03,0.76,97.05,9,0,9,9,9,0,1.0,100.0,Difficile,Facile,2,Beaucoup plus Facile,Pas Adapte,Law
5685,2020,Droit,3,Relations Internationales,3,Les Grands Principes regissant les Relations Internationales,9,66,4,QCM,0.56,0.18,2.15,0,10,10,6,0,6,1.67,0.0,Facile,Difficile,-2,Beaucoup plus Difficile,Pas Adapte,Law
66,2015,Droit,3,Relations Internationales,3,Les Grands Principes regissant les Relations Internationales,9,67,5,QCM,0.17,0.71,74.45,33,11,44,34,33,1,1.29,97.06,Moyen,Facile,1,Plus Facile,Adapte,Law
1190,2016,Droit,3,Relations Internationales,3,Les Grands Principes regissant les Relations Internationales,9,67,5,QCM,0.11,0.75,74.45,37,13,50,41,37,4,1.22,90.24,Facile,Facile,0,Meme Difficulté,Adapte,Law
2314,2017,Droit,3,Relations Internationales,3,Les Grands Principes regissant les Relations Internationales,9,67,5,QCM,0.17,0.81,74.45,42,14,56,46,42,4,1.22,91.3,Facile,Facile,0,Meme Difficulté,Adapte,Law
3438,2018,Droit,3,Relations Internationales,3,Les Grands Principes regissant les Relations Internationales,9,67,5,QCM,0.19,0.74,74.45,40,14,54,54,40,14,1.0,74.07,Facile,Facile,0,Meme Difficulté,Adapte,Law
4562,2019,Droit,3,Relations Internationales,3,Les Grands Principes regissant les Relations Internationales,9,67,5,QCM,0.12,0.75,74.45,37,13,50,45,37,8,1.11,82.22,Facile,Facile,0,Meme Difficulté,Adapte,Law
5686,2020,Droit,3,Relations Internationales,3,Les Grands Principes regissant les Relations Internationales,9,67,5,QCM,0.09,0.81,74.45,38,13,51,45,38,7,1.13,84.44,Facile,Facile,0,Meme Difficulté,Adapte,Law
67,2015,Droit,3,Relations Internationales,3,Les Grands Principes regissant les Relations Internationales,9,68,6,QCU,0.36,0.68,40.14,25,37,62,48,25,23,1.29,52.08,Facile,Moyen,-1,Plus Difficile,Pas Adapte,Law
1191,2016,Droit,3,Relations Internationales,3,Les Grands Principes regissant les Relations Internationales,9,68,6,QCU,0.1,0.82,72.28,44,17,61,52,44,8,1.17,84.62,Difficile,Facile,2,Beaucoup plus Facile,Adapte,Law
2315,2017,Droit,3,Relations Internationales,3,Les Grands Principes regissant les Relations Internationales,9,68,6,QCU,0.11,0.99,72.28,40,16,56,42,40,2,1.33,95.24,Facile,Facile,0,Meme Difficulté,Adapte,Law
3439,2018,Droit,3,Relations Internationales,3,Les Grands Principes regissant les Relations Internationales,9,68,6,QCU,0.0,0.77,72.28,38,15,53,40,38,2,1.32,95.0,Facile,Facile,0,Meme Difficulté,Adapte,Law
4563,2019,Droit,3,Relations Internationales,3,Les Grands Principes regissant les Relations Internationales,9,68,6,QCU,0.08,0.76,72.28,43,16,59,48,43,5,1.23,89.58,Facile,Facile,0,Meme Difficulté,Adapte,Law
5687,2020,Droit,3,Relations Internationales,3,Les Grands Principes regissant les Relations Internationales,9,68,6,QCU,0.11,0.93,72.28,42,16,58,56,42,14,1.04,75.0,Facile,Facile,0,Meme Difficulté,Adapte,Law
68,2015,Droit,3,Relations Internationales,3,Les Grands Principes regissant les Relations Internationales,9,69,7,QCU,0.08,0.8,88.32,42,6,48,44,42,2,1.09,95.45,Facile,Facile,0,Meme Difficulté,Pas Adapte,Law
1192,2016,Droit,3,Relations Internationales,3,Les Grands Principes regissant les Relations Internationales,9,69,7,QCU,0.02,0.98,66.05,27,14,41,32,27,5,1.28,84.38,Moyen,Facile,1,Plus Facile,Adapte,Law
2316,2017,Droit,3,Relations Internationales,3,Les Grands Principes regissant les Relations Internationales,9,69,7,QCM,0.03,0.96,66.05,28,14,42,38,28,10,1.11,73.68,Facile,Facile,0,Meme Difficulté,Adapte,Law
3440,2018,Droit,3,Relations Internationales,3,Les Grands Principes regissant les Relations Internationales,9,69,7,QCM,0.11,0.91,66.05,24,12,36,25,24,1,1.44,96.0,Facile,Facile,0,Meme Difficulté,Adapte,Law
4564,2019,Droit,3,Relations Internationales,3,Les Grands Principes regissant les Relations Internationales,9,69,7,QCM,0.12,0.97,66.05,26,14,40,37,26,11,1.08,70.27,Facile,Facile,0,Meme Difficulté,Adapte,Law
5688,2020,Droit,3,Relations Internationales,3,Les Grands Principes regissant les Relations Internationales,9,69,7,QCM,0.02,0.76,66.05,26,13,39,31,26,5,1.26,83.87,Facile,Facile,0,Meme Difficulté,Adapte,Law
69,2015,Droit,3,Relations Internationales,3,Les Grands Principes regissant les Relations Internationales,9,70,8,QCM,0.7,0.19,26.0,11,32,43,19,11,8,2.26,57.89,Facile,Difficile,-2,Beaucoup plus Difficile,Pas Adapte,Law
1193,2016,Droit,3,Relations Internationales,3,Les Grands Principes regissant les Relations Internationales,9,70,8,QCM,0.27,0.35,48.67,22,24,46,42,22,20,1.1,52.38,Moyen,Moyen,0,Meme Difficulté,Pas Adapte,Law
2317,2017,Droit,3,Relations Internationales,3,Les Grands Principes regissant les Relations Internationales,9,70,8,QCM,0.17,0.87,76.4,37,11,48,43,37,6,1.12,86.05,Facile,Facile,0,Meme Difficulté,Pas Adapte,Law
3441,2018,Droit,3,Relations Internationales,3,Les Grands Principes regissant les Relations Internationales,9,70,8,QCM,0.67,0.17,22.31,12,42,54,31,12,19,1.74,38.71,Difficile,Difficile,0,Meme Difficulté,Pas Adapte,Law
4565,2019,Droit,3,Relations Internationales,3,Les Grands Principes regissant les Relations Internationales,9,70,8,QCU,0.44,0.27,30.01,14,34,48,37,14,23,1.3,37.84,Difficile,Difficile,0,Meme Difficulté,Pas Adapte,Law
5689,2020,Droit,3,Relations Internationales,3,Les Grands Principes regissant les Relations Internationales,9,70,8,QCM,0.62,0.27,24.98,13,38,51,19,13,6,2.68,68.42,Difficile,Difficile,0,Meme Difficulté,Pas Adapte,Law
70,2015,Droit,3,Relations Internationales,3,Les Grands Principes regissant les Relations Internationales,9,71,9,QCM,0.16,0.74,85.65,63,11,74,73,63,10,1.01,86.3,Difficile,Facile,2,Beaucoup plus Facile,Pas Adapte,Law
1194,2016,Droit,3,Relations Internationales,3,Les Grands Principes regissant les Relations Internationales,9,71,9,QCM,0.56,0.26,21.91,16,55,71,67,16,51,1.06,23.88,Moyen,Difficile,-1,Plus Difficile,Pas Adapte,Law
2318,2017,Droit,3,Relations Internationales,3,Les Grands Principes regissant les Relations Internationales,9,71,9,QCM,0.4,0.35,58.85,44,31,75,71,44,27,1.06,61.97,Moyen,Moyen,0,Meme Difficulté,Pas Adapte,Law
3442,2018,Droit,3,Relations Internationales,3,Les Grands Principes regissant les Relations Internationales,9,71,9,QCM,0.57,0.16,29.24,23,54,77,32,23,9,2.41,71.88,Moyen,Difficile,-1,Plus Difficile,Pas Adapte,Law
4566,2019,Droit,3,Relations Internationales,3,Les Grands Principes regissant les Relations Internationales,9,71,9,QCM,0.33,0.45,64.25,54,30,84,73,54,19,1.15,73.97,Facile,Moyen,-1,Plus Difficile,Adapte,Law
5690,2020,Droit,3,Relations Internationales,3,Les Grands Principes regissant les Relations Internationales,9,71,9,QCM,0.26,0.45,64.25,53,29,82,75,53,22,1.09,70.67,Moyen,Moyen,0,Meme Difficulté,Adapte,Law
71,2015,Droit,4,Proces et Institution Juridictionnelles,1,Introduction,9,72,1,QCM,0.76,0.29,3.04,2,66,68,59,2,57,1.15,3.39,Moyen,Difficile,-1,Plus Difficile,Pas Adapte,Law
1195,2016,Droit,4,Proces et Institution Juridictionnelles,1,Introduction,9,72,1,QCM,0.19,0.95,86.5,67,11,78,70,67,3,1.11,95.71,Difficile,Facile,2,Beaucoup plus Facile,Pas Adapte,Law
2319,2017,Droit,4,Proces et Institution Juridictionnelles,1,Introduction,9,72,1,QCM,0.16,0.79,70.78,62,26,88,69,62,7,1.28,89.86,Moyen,Facile,1,Plus Facile,Adapte,Law
3443,2018,Droit,4,Proces et Institution Juridictionnelles,1,Introduction,9,72,1,QCM,0.01,0.81,70.78,56,23,79,60,56,4,1.32,93.33,Facile,Facile,0,Meme Difficulté,Adapte,Law
4567,2019,Droit,4,Proces et Institution Juridictionnelles,1,Introduction,9,72,1,QCM,0.11,0.9,70.78,64,27,91,84,64,20,1.08,76.19,Facile,Facile,0,Meme Difficulté,Adapte,Law
5691,2020,Droit,4,Proces et Institution Juridictionnelles,1,Introduction,9,72,1,QCM,0.01,0.85,70.78,55,23,78,70,55,15,1.11,78.57,Facile,Facile,0,Meme Difficulté,Adapte,Law
72,2015,Droit,4,Proces et Institution Juridictionnelles,1,Introduction,9,73,2,QCU,0.56,0.29,18.51,11,51,62,47,11,36,1.32,23.4,Moyen,Difficile,-1,Plus Difficile,Pas Adapte,Law
1196,2016,Droit,4,Proces et Institution Juridictionnelles,1,Introduction,9,73,2,QCU,0.25,0.45,38.76,22,36,58,35,22,13,1.66,62.86,Moyen,Moyen,0,Meme Difficulté,Pas Adapte,Law
2320,2017,Droit,4,Proces et Institution Juridictionnelles,1,Introduction,9,73,2,QCU,0.16,0.94,78.49,39,11,50,46,39,7,1.09,84.78,Facile,Facile,0,Meme Difficulté,Pas Adapte,Law
3444,2018,Droit,4,Proces et Institution Juridictionnelles,1,Introduction,9,73,2,QCU,0.17,0.94,73.44,40,15,55,42,40,2,1.31,95.24,Moyen,Facile,1,Plus Facile,Adapte,Law
4568,2019,Droit,4,Proces et Institution Juridictionnelles,1,Introduction,9,73,2,QCU,0.19,0.86,73.44,42,15,57,55,42,13,1.04,76.36,Facile,Facile,0,Meme Difficulté,Adapte,Law
5692,2020,Droit,4,Proces et Institution Juridictionnelles,1,Introduction,9,73,2,QCU,0.08,0.78,73.44,45,16,61,49,45,4,1.24,91.84,Facile,Facile,0,Meme Difficulté,Adapte,Law
73,2015,Droit,4,Proces et Institution Juridictionnelles,1,Introduction,9,74,3,QCU,0.61,0.27,3.79,1,13,14,6,1,5,2.33,16.67,Difficile,Difficile,0,Meme Difficulté,Pas Adapte,Law
1197,2016,Droit,4,Proces et Institution Juridictionnelles,1,Introduction,9,74,3,QCU,0.48,0.33,3.38,1,15,16,6,1,5,2.67,16.67,Facile,Difficile,-2,Beaucoup plus Difficile,Pas Adapte,Law
2321,2017,Droit,4,Proces et Institution Juridictionnelles,1,Introduction,9,74,3,QCU,0.11,0.91,96.25,14,1,15,14,14,0,1.07,100.0,Difficile,Facile,2,Beaucoup plus Facile,Pas Adapte,Law
3445,2018,Droit,4,Proces et Institution Juridictionnelles,1,Introduction,9,74,3,QCU,0.03,0.89,79.7,14,3,17,16,14,2,1.06,87.5,Moyen,Facile,1,Plus Facile,Pas Adapte,Law
4569,2019,Droit,4,Proces et Institution Juridictionnelles,1,Introduction,9,74,3,QCU,0.04,0.84,81.01,16,4,20,18,16,2,1.11,88.89,Facile,Facile,0,Meme Difficulté,Pas Adapte,Law
5693,2020,Droit,4,Proces et Institution Juridictionnelles,1,Introduction,9,74,3,QCU,0.26,0.71,58.46,12,8,20,14,12,2,1.43,85.71,Difficile,Moyen,1,Plus Facile,Pas Adapte,Law
74,2015,Droit,4,Proces et Institution Juridictionnelles,1,Introduction,9,75,4,QCU,0.58,0.38,14.43,12,71,83,50,12,38,1.66,24.0,Difficile,Difficile,0,Meme Difficulté,Pas Adapte,Law
1198,2016,Droit,4,Proces et Institution Juridictionnelles,1,Introduction,9,75,4,QCU,0.24,0.56,57.46,43,32,75,55,43,12,1.36,78.18,Facile,Moyen,-1,Plus Difficile,Pas Adapte,Law
2322,2017,Droit,4,Proces et Institution Juridictionnelles,1,Introduction,9,75,4,QCU,0.09,0.93,86.78,67,10,77,72,67,5,1.07,93.06,Moyen,Facile,1,Plus Facile,Pas Adapte,Law
3446,2018,Droit,4,Proces et Institution Juridictionnelles,1,Introduction,9,75,4,QCU,0.31,0.68,57.26,49,37,86,67,49,18,1.28,73.13,Moyen,Moyen,0,Meme Difficulté,Pas Adapte,Law
4570,2019,Droit,4,Proces et Institution Juridictionnelles,1,Introduction,9,75,4,QCU,0.72,0.33,33.91,30,58,88,60,30,30,1.47,50.0,Facile,Difficile,-2,Beaucoup plus Difficile,Pas Adapte,Law
5694,2020,Droit,4,Proces et Institution Juridictionnelles,1,Introduction,9,75,4,QCU,0.59,0.25,20.88,19,72,91,88,19,69,1.03,21.59,Difficile,Difficile,0,Meme Difficulté,Pas Adapte,Law
75,2015,Droit,4,Proces et Institution Juridictionnelles,1,Introduction,9,76,5,QCU,0.28,0.47,35.53,13,24,37,28,13,15,1.32,46.43,Moyen,Moyen,0,Meme Difficulté,Pas Adapte,Law
1199,2016,Droit,4,Proces et Institution Juridictionnelles,1,Introduction,9,76,5,QCM,0.32,0.66,45.9,19,23,42,24,19,5,1.75,79.17,Facile,Moyen,-1,Plus Difficile,Pas Adapte,Law
2323,2017,Droit,4,Proces et Institution Juridictionnelles,1,Introduction,9,76,5,QCM,0.42,0.52,64.81,23,13,36,33,23,10,1.09,69.7,Facile,Moyen,-1,Plus Difficile,Adapte,Law
3447,2018,Droit,4,Proces et Institution Juridictionnelles,1,Introduction,9,76,5,QCM,0.37,0.65,64.81,21,11,32,22,21,1,1.45,95.45,Moyen,Moyen,0,Meme Difficulté,Adapte,Law
4571,2019,Droit,4,Proces et Institution Juridictionnelles,1,Introduction,9,76,5,QCM,0.26,0.69,64.81,17,10,27,18,17,1,1.5,94.44,Moyen,Moyen,0,Meme Difficulté,Adapte,Law
5695,2020,Droit,4,Proces et Institution Juridictionnelles,1,Introduction,9,76,5,QCM,0.22,0.68,64.81,16,9,25,25,16,9,1.0,64.0,Moyen,Moyen,0,Meme Difficulté,Adapte,Law
76,2015,Droit,4,Proces et Institution Juridictionnelles,1,Introduction,9,77,6,QCU,0.15,0.8,69.28,33,15,48,35,33,2,1.37,94.29,Moyen,Facile,1,Plus Facile,Adapte,Law
1200,2016,Droit,4,Proces et Institution Juridictionnelles,1,Introduction,9,77,6,QCU,0.11,0.92,69.28,36,16,52,41,36,5,1.27,87.8,Facile,Facile,0,Meme Difficulté,Adapte,Law
2324,2017,Droit,4,Proces et Institution Juridictionnelles,1,Introduction,9,77,6,QCU,0.18,0.94,69.28,33,15,48,37,33,4,1.3,89.19,Facile,Facile,0,Meme Difficulté,Adapte,Law
3448,2018,Droit,4,Proces et Institution Juridictionnelles,1,Introduction,9,77,6,QCU,0.08,0.87,69.28,34,15,49,47,34,13,1.04,72.34,Facile,Facile,0,Meme Difficulté,Adapte,Law
4572,2019,Droit,4,Proces et Institution Juridictionnelles,1,Introduction,9,77,6,QCU,0.05,0.78,69.28,38,17,55,51,38,13,1.08,74.51,Facile,Facile,0,Meme Difficulté,Adapte,Law
5696,2020,Droit,4,Proces et Institution Juridictionnelles,1,Introduction,9,77,6,QCU,0.13,0.77,69.28,40,18,58,55,40,15,1.05,72.73,Facile,Facile,0,Meme Difficulté,Adapte,Law
77,2015,Droit,4,Proces et Institution Juridictionnelles,1,Introduction,9,78,7,QCU,0.29,0.69,35.84,6,12,18,10,6,4,1.8,60.0,Facile,Moyen,-1,Plus Difficile,Pas Adapte,Law
1201,2016,Droit,4,Proces et Institution Juridictionnelles,1,Introduction,9,78,7,QCU,0.21,0.44,35.77,7,13,20,15,7,8,1.33,46.67,Moyen,Moyen,0,Meme Difficulté,Pas Adapte,Law
2325,2017,Droit,4,Proces et Institution Juridictionnelles,1,Introduction,9,78,7,QCM,0.03,0.72,79.47,14,4,18,16,14,2,1.12,87.5,Moyen,Facile,1,Plus Facile,Pas Adapte,Law
3449,2018,Droit,4,Proces et Institution Juridictionnelles,1,Introduction,9,78,7,QCM,0.01,0.79,95.3,17,1,18,17,17,0,1.06,100.0,Facile,Facile,0,Meme Difficulté,Pas Adapte,Law
4573,2019,Droit,4,Proces et Institution Juridictionnelles,1,Introduction,9,78,7,QCU,0.44,0.26,3.4,1,16,17,16,1,15,1.06,6.25,Facile,Difficile,-2,Beaucoup plus Difficile,Pas Adapte,Law
5697,2020,Droit,4,Proces et Institution Juridictionnelles,1,Introduction,9,78,7,QCU,0.51,0.33,2.78,0,16,16,10,0,10,1.6,0.0,Moyen,Difficile,-1,Plus Difficile,Pas Adapte,Law
78,2015,Droit,4,Proces et Institution Juridictionnelles,1,Introduction,9,79,8,QCM,0.16,0.94,80.76,21,5,26,25,21,4,1.04,84.0,Moyen,Facile,1,Plus Facile,Pas Adapte,Law
1202,2016,Droit,4,Proces et Institution Juridictionnelles,1,Introduction,9,79,8,QCU,0.52,0.37,7.64,2,24,26,25,2,23,1.04,8.0,Difficile,Difficile,0,Meme Difficulté,Pas Adapte,Law
2326,2017,Droit,4,Proces et Institution Juridictionnelles,1,Introduction,9,79,8,QCU,0.24,0.54,47.3,10,12,22,18,10,8,1.22,55.56,Difficile,Moyen,1,Plus Facile,Pas Adapte,Law
3450,2018,Droit,4,Proces et Institution Juridictionnelles,1,Introduction,9,79,8,QCU,0.28,0.71,55.66,13,10,23,17,13,4,1.35,76.47,Moyen,Moyen,0,Meme Difficulté,Pas Adapte,Law
4574,2019,Droit,4,Proces et Institution Juridictionnelles,1,Introduction,9,79,8,QCU,0.28,0.66,52.96,12,11,23,22,12,10,1.05,54.55,Facile,Moyen,-1,Plus Difficile,Pas Adapte,Law
5698,2020,Droit,4,Proces et Institution Juridictionnelles,1,Introduction,9,79,8,QCU,0.64,0.31,0.29,0,22,22,19,0,19,1.16,0.0,Moyen,Difficile,-1,Plus Difficile,Pas Adapte,Law
79,2015,Droit,4,Proces et Institution Juridictionnelles,1,Introduction,9,80,9,QCU,0.59,0.3,12.75,5,38,43,36,5,31,1.19,13.89,Moyen,Difficile,-1,Plus Difficile,Pas Adapte,Law
1203,2016,Droit,4,Proces et Institution Juridictionnelles,1,Introduction,9,80,9,QCU,0.39,0.69,61.91,27,16,43,27,27,0,1.59,100.0,Difficile,Moyen,1,Plus Facile,Adapte,Law
2327,2017,Droit,4,Proces et Institution Juridictionnelles,1,Introduction,9,80,9,QO,0.67,0.25,61.91,25,16,41,40,25,15,1.02,62.5,Moyen,Moyen,0,Meme Difficulté,Adapte,Law
3451,2018,Droit,4,Proces et Institution Juridictionnelles,1,Introduction,9,80,9,QO,0.61,0.26,61.91,29,18,47,44,29,15,1.07,65.91,Moyen,Moyen,0,Meme Difficulté,Adapte,Law
4575,2019,Droit,4,Proces et Institution Juridictionnelles,1,Introduction,9,80,9,QO,0.69,0.21,61.91,25,16,41,30,25,5,1.37,83.33,Moyen,Moyen,0,Meme Difficulté,Adapte,Law
5699,2020,Droit,4,Proces et Institution Juridictionnelles,1,Introduction,9,80,9,QO,0.74,0.17,61.91,27,16,43,40,27,13,1.07,67.5,Moyen,Moyen,0,Meme Difficulté,Adapte,Law
80,2015,Droit,4,Proces et Institution Juridictionnelles,2,La Trame de la Scene Judiciaire,13,81,1,QCU,0.21,0.66,36.68,35,60,95,62,35,27,1.53,56.45,Moyen,Moyen,0,Meme Difficulté,Pas Adapte,Law
1204,2016,Droit,4,Proces et Institution Juridictionnelles,2,La Trame de la Scene Judiciaire,13,81,1,QCU,0.48,0.36,6.96,6,86,92,82,6,76,1.12,7.32,Difficile,Difficile,0,Meme Difficulté,Pas Adapte,Law
2328,2017,Droit,4,Proces et Institution Juridictionnelles,2,La Trame de la Scene Judiciaire,13,81,1,QCU,0.5,0.25,26.62,22,60,82,60,22,38,1.37,36.67,Difficile,Difficile,0,Meme Difficulté,Pas Adapte,Law
3452,2018,Droit,4,Proces et Institution Juridictionnelles,2,La Trame de la Scene Judiciaire,13,81,1,QCU,0.07,0.83,93.63,74,5,79,74,74,0,1.07,100.0,Moyen,Facile,1,Plus Facile,Pas Adapte,Law
4576,2019,Droit,4,Proces et Institution Juridictionnelles,2,La Trame de la Scene Judiciaire,13,81,1,QCM,0.09,0.77,78.88,55,15,70,63,55,8,1.11,87.3,Facile,Facile,0,Meme Difficulté,Pas Adapte,Law
5700,2020,Droit,4,Proces et Institution Juridictionnelles,2,La Trame de la Scene Judiciaire,13,81,1,QCM,0.18,0.8,86.2,67,11,78,77,67,10,1.01,87.01,Facile,Facile,0,Meme Difficulté,Pas Adapte,Law
81,2015,Droit,4,Proces et Institution Juridictionnelles,2,La Trame de la Scene Judiciaire,13,82,2,QROC,0.83,0.03,14.05,5,29,34,14,5,9,2.43,35.71,Moyen,Difficile,-1,Plus Difficile,Pas Adapte,Law
1205,2016,Droit,4,Proces et Institution Juridictionnelles,2,La Trame de la Scene Judiciaire,13,82,2,QROC,0.02,0.55,79.41,25,6,31,29,25,4,1.07,86.21,Facile,Facile,0,Meme Difficulté,Pas Adapte,Law
2329,2017,Droit,4,Proces et Institution Juridictionnelles,2,La Trame de la Scene Judiciaire,13,82,2,QROC,0.19,0.76,69.24,23,10,33,31,23,8,1.06,74.19,Moyen,Facile,1,Plus Facile,Adapte,Law
3453,2018,Droit,4,Proces et Institution Juridictionnelles,2,La Trame de la Scene Judiciaire,13,82,2,QROC,0.09,0.72,69.24,19,9,28,22,19,3,1.27,86.36,Facile,Facile,0,Meme Difficulté,Adapte,Law
4577,2019,Droit,4,Proces et Institution Juridictionnelles,2,La Trame de la Scene Judiciaire,13,82,2,QROC,0.12,0.69,69.24,21,9,30,29,21,8,1.03,72.41,Facile,Facile,0,Meme Difficulté,Adapte,Law
5701,2020,Droit,4,Proces et Institution Juridictionnelles,2,La Trame de la Scene Judiciaire,13,82,2,QROC,0.06,0.67,69.24,21,9,30,24,21,3,1.25,87.5,Facile,Facile,0,Meme Difficulté,Adapte,Law
82,2015,Droit,4,Proces et Institution Juridictionnelles,2,La Trame de la Scene Judiciaire,13,83,3,QCM,0.31,0.58,55.46,49,39,88,51,49,2,1.73,96.08,Moyen,Moyen,0,Meme Difficulté,Pas Adapte,Law
1206,2016,Droit,4,Proces et Institution Juridictionnelles,2,La Trame de la Scene Judiciaire,13,83,3,QCM,0.33,0.36,54.89,43,35,78,72,43,29,1.08,59.72,Facile,Moyen,-1,Plus Difficile,Pas Adapte,Law
2330,2017,Droit,4,Proces et Institution Juridictionnelles,2,La Trame de la Scene Judiciaire,13,83,3,QCM,0.21,0.59,38.19,30,49,79,38,30,8,2.08,78.95,Moyen,Moyen,0,Meme Difficulté,Pas Adapte,Law
3454,2018,Droit,4,Proces et Institution Juridictionnelles,2,La Trame de la Scene Judiciaire,13,83,3,QCU,0.12,0.91,88.04,62,8,70,67,62,5,1.04,92.54,Facile,Facile,0,Meme Difficulté,Pas Adapte,Law
4578,2019,Droit,4,Proces et Institution Juridictionnelles,2,La Trame de la Scene Judiciaire,13,83,3,QCU,0.08,0.98,68.03,42,20,62,44,42,2,1.41,95.45,Facile,Facile,0,Meme Difficulté,Adapte,Law
5702,2020,Droit,4,Proces et Institution Juridictionnelles,2,La Trame de la Scene Judiciaire,13,83,3,QCU,0.14,0.79,68.03,44,21,65,61,44,17,1.07,72.13,Facile,Facile,0,Meme Difficulté,Adapte,Law
83,2015,Droit,4,Proces et Institution Juridictionnelles,2,La Trame de la Scene Judiciaire,13,84,4,QCU,0.43,0.35,14.26,2,13,15,12,2,10,1.25,16.67,Moyen,Difficile,-1,Plus Difficile,Pas Adapte,Law
1207,2016,Droit,4,Proces et Institution Juridictionnelles,2,La Trame de la Scene Judiciaire,13,84,4,QCU,0.15,0.82,78.8,13,3,16,15,13,2,1.07,86.67,Difficile,Facile,2,Beaucoup plus Facile,Pas Adapte,Law
2331,2017,Droit,4,Proces et Institution Juridictionnelles,2,La Trame de la Scene Judiciaire,13,84,4,QCU,0.21,0.46,39.71,7,10,17,13,7,6,1.31,53.85,Moyen,Moyen,0,Meme Difficulté,Pas Adapte,Law
3455,2018,Droit,4,Proces et Institution Juridictionnelles,2,La Trame de la Scene Judiciaire,13,84,4,QCU,0.26,0.45,60.78,12,8,20,14,12,2,1.43,85.71,Moyen,Moyen,0,Meme Difficulté,Adapte,Law
4579,2019,Droit,4,Proces et Institution Juridictionnelles,2,La Trame de la Scene Judiciaire,13,84,4,QCM,0.44,0.38,60.78,13,8,21,21,13,8,1.0,61.9,Moyen,Moyen,0,Meme Difficulté,Adapte,Law
5703,2020,Droit,4,Proces et Institution Juridictionnelles,2,La Trame de la Scene Judiciaire,13,84,4,QCM,0.49,0.31,60.78,12,8,20,18,12,6,1.11,66.67,Moyen,Moyen,0,Meme Difficulté,Adapte,Law
84,2015,Droit,4,Proces et Institution Juridictionnelles,2,La Trame de la Scene Judiciaire,13,85,5,QCM,0.58,0.25,14.34,3,20,23,22,3,19,1.05,13.64,Facile,Difficile,-2,Beaucoup plus Difficile,Pas Adapte,Law
1208,2016,Droit,4,Proces et Institution Juridictionnelles,2,La Trame de la Scene Judiciaire,13,85,5,QCM,0.12,0.96,78.12,16,5,21,18,16,2,1.17,88.89,Facile,Facile,0,Meme Difficulté,Pas Adapte,Law
2332,2017,Droit,4,Proces et Institution Juridictionnelles,2,La Trame de la Scene Judiciaire,13,85,5,QCM,0.2,0.99,78.1,18,5,23,18,18,0,1.28,100.0,Facile,Facile,0,Meme Difficulté,Pas Adapte,Law
3456,2018,Droit,4,Proces et Institution Juridictionnelles,2,La Trame de la Scene Judiciaire,13,85,5,QCM,0.67,0.24,17.3,4,21,25,15,4,11,1.67,26.67,Difficile,Difficile,0,Meme Difficulté,Pas Adapte,Law
4580,2019,Droit,4,Proces et Institution Juridictionnelles,2,La Trame de la Scene Judiciaire,13,85,5,QCU,0.12,0.79,66.17,14,7,21,20,14,6,1.05,70.0,Facile,Facile,0,Meme Difficulté,Adapte,Law
5704,2020,Droit,4,Proces et Institution Juridictionnelles,2,La Trame de la Scene Judiciaire,13,85,5,QCU,0.19,0.91,66.17,12,6,18,13,12,1,1.38,92.31,Facile,Facile,0,Meme Difficulté,Adapte,Law
85,2015,Droit,4,Proces et Institution Juridictionnelles,2,La Trame de la Scene Judiciaire,13,86,6,QCU,0.74,0.23,5.85,3,45,48,32,3,29,1.5,9.38,Moyen,Difficile,-1,Plus Difficile,Pas Adapte,Law
1209,2016,Droit,4,Proces et Institution Juridictionnelles,2,La Trame de la Scene Judiciaire,13,86,6,QCM,0.49,0.42,47.43,20,22,42,28,20,8,1.5,71.43,Moyen,Moyen,0,Meme Difficulté,Pas Adapte,Law
2333,2017,Droit,4,Proces et Institution Juridictionnelles,2,La Trame de la Scene Judiciaire,13,86,6,QCM,0.25,0.36,49.09,20,21,41,31,20,11,1.32,64.52,Moyen,Moyen,0,Meme Difficulté,Pas Adapte,Law
3457,2018,Droit,4,Proces et Institution Juridictionnelles,2,La Trame de la Scene Judiciaire,13,86,6,QCM,0.39,0.42,53.57,25,21,46,26,25,1,1.77,96.15,Moyen,Moyen,0,Meme Difficulté,Pas Adapte,Law
4581,2019,Droit,4,Proces et Institution Juridictionnelles,2,La Trame de la Scene Judiciaire,13,86,6,QCM,0.16,0.74,99.77,39,0,39,39,39,0,1.0,100.0,Difficile,Facile,2,Beaucoup plus Facile,Pas Adapte,Law
5705,2020,Droit,4,Proces et Institution Juridictionnelles,2,La Trame de la Scene Judiciaire,13,86,6,QCU,0.11,0.75,94.03,35,2,37,37,35,2,1.0,94.59,Moyen,Facile,1,Plus Facile,Pas Adapte,Law
86,2015,Droit,4,Proces et Institution Juridictionnelles,2,La Trame de la Scene Judiciaire,13,87,7,QCU,0.5,0.24,0.06,0,79,79,78,0,78,1.01,0.0,Difficile,Difficile,0,Meme Difficulté,Pas Adapte,Law
1210,2016,Droit,4,Proces et Institution Juridictionnelles,2,La Trame de la Scene Judiciaire,13,87,7,QCU,0.2,0.88,87.18,72,11,83,76,72,4,1.09,94.74,Facile,Facile,0,Meme Difficulté,Pas Adapte,Law
2334,2017,Droit,4,Proces et Institution Juridictionnelles,2,La Trame de la Scene Judiciaire,13,87,7,QCU,0.09,0.81,73.23,58,21,79,67,58,9,1.18,86.57,Moyen,Facile,1,Plus Facile,Adapte,Law
3458,2018,Droit,4,Proces et Institution Juridictionnelles,2,La Trame de la Scene Judiciaire,13,87,7,QCU,0.14,0.76,73.23,65,24,89,87,65,22,1.02,74.71,Facile,Facile,0,Meme Difficulté,Adapte,Law
4582,2019,Droit,4,Proces et Institution Juridictionnelles,2,La Trame de la Scene Judiciaire,13,87,7,QCU,0.05,0.89,73.23,72,26,98,93,72,21,1.05,77.42,Facile,Facile,0,Meme Difficulté,Adapte,Law
5706,2020,Droit,4,Proces et Institution Juridictionnelles,2,La Trame de la Scene Judiciaire,13,87,7,QCU,0.07,0.95,73.23,62,23,85,80,62,18,1.06,77.5,Facile,Facile,0,Meme Difficulté,Adapte,Law
87,2015,Droit,4,Proces et Institution Juridictionnelles,2,La Trame de la Scene Judiciaire,13,88,8,QCM,0.43,0.53,39.0,16,25,41,19,16,3,2.16,84.21,Difficile,Moyen,1,Plus Facile,Pas Adapte,Law
1211,2016,Droit,4,Proces et Institution Juridictionnelles,2,La Trame de la Scene Judiciaire,13,88,8,QCU,0.13,0.83,81.6,32,7,39,33,32,1,1.18,96.97,Facile,Facile,0,Meme Difficulté,Pas Adapte,Law
2335,2017,Droit,4,Proces et Institution Juridictionnelles,2,La Trame de la Scene Judiciaire,13,88,8,QCM,0.79,0.22,13.02,6,39,45,26,6,20,1.73,23.08,Moyen,Difficile,-1,Plus Difficile,Pas Adapte,Law
3459,2018,Droit,4,Proces et Institution Juridictionnelles,2,La Trame de la Scene Judiciaire,13,88,8,QCM,0.79,0.28,31.8,12,26,38,26,12,14,1.46,46.15,Moyen,Difficile,-1,Plus Difficile,Pas Adapte,Law
4583,2019,Droit,4,Proces et Institution Juridictionnelles,2,La Trame de la Scene Judiciaire,13,88,8,QCM,0.05,0.8,69.03,25,11,36,27,25,2,1.33,92.59,Difficile,Facile,2,Beaucoup plus Facile,Adapte,Law
5707,2020,Droit,4,Proces et Institution Juridictionnelles,2,La Trame de la Scene Judiciaire,13,88,8,QCM,0.11,0.82,69.03,26,11,37,35,26,9,1.06,74.29,Facile,Facile,0,Meme Difficulté,Adapte,Law
88,2015,Droit,4,Proces et Institution Juridictionnelles,2,La Trame de la Scene Judiciaire,13,89,9,QCM,0.27,0.37,63.02,21,12,33,33,21,12,1.0,63.64,Difficile,Moyen,1,Plus Facile,Adapte,Law
1212,2016,Droit,4,Proces et Institution Juridictionnelles,2,La Trame de la Scene Judiciaire,13,89,9,QROC,0.36,0.36,63.02,20,12,32,20,20,0,1.6,100.0,Moyen,Moyen,0,Meme Difficulté,Adapte,Law
2336,2017,Droit,4,Proces et Institution Juridictionnelles,2,La Trame de la Scene Judiciaire,13,89,9,QROC,0.34,0.3,63.02,20,12,32,24,20,4,1.33,83.33,Moyen,Moyen,0,Meme Difficulté,Adapte,Law
3460,2018,Droit,4,Proces et Institution Juridictionnelles,2,La Trame de la Scene Judiciaire,13,89,9,QCM,0.22,0.48,63.02,17,10,27,20,17,3,1.35,85.0,Moyen,Moyen,0,Meme Difficulté,Adapte,Law
4584,2019,Droit,4,Proces et Institution Juridictionnelles,2,La Trame de la Scene Judiciaire,13,89,9,QCM,0.26,0.33,63.02,16,9,25,21,16,5,1.19,76.19,Moyen,Moyen,0,Meme Difficulté,Adapte,Law
5708,2020,Droit,4,Proces et Institution Juridictionnelles,2,La Trame de la Scene Judiciaire,13,89,9,QCM,0.47,0.52,63.02,18,10,28,23,18,5,1.22,78.26,Moyen,Moyen,0,Meme Difficulté,Adapte,Law
89,2015,Droit,4,Proces et Institution Juridictionnelles,2,La Trame de la Scene Judiciaire,13,90,10,QCM,0.17,0.78,97.37,21,1,22,21,21,0,1.05,100.0,Difficile,Facile,2,Beaucoup plus Facile,Pas Adapte,Law
1213,2016,Droit,4,Proces et Institution Juridictionnelles,2,La Trame de la Scene Judiciaire,13,90,10,QCM,0.27,0.57,58.42,11,8,19,12,11,1,1.58,91.67,Moyen,Moyen,0,Meme Difficulté,Pas Adapte,Law
2337,2017,Droit,4,Proces et Institution Juridictionnelles,2,La Trame de la Scene Judiciaire,13,90,10,QCM,0.62,0.22,16.11,3,18,21,8,3,5,2.62,37.5,Facile,Difficile,-2,Beaucoup plus Difficile,Pas Adapte,Law
3461,2018,Droit,4,Proces et Institution Juridictionnelles,2,La Trame de la Scene Judiciaire,13,90,10,QCM,0.01,0.73,88.87,19,2,21,21,19,2,1.0,90.48,Facile,Facile,0,Meme Difficulté,Pas Adapte,Law
4585,2019,Droit,4,Proces et Institution Juridictionnelles,2,La Trame de la Scene Judiciaire,13,90,10,QCM,0.59,0.21,0.1,0,21,21,7,0,7,3.0,0.0,Facile,Difficile,-2,Beaucoup plus Difficile,Pas Adapte,Law
5709,2020,Droit,4,Proces et Institution Juridictionnelles,2,La Trame de la Scene Judiciaire,13,90,10,QCM,0.3,0.59,64.54,12,7,19,17,12,5,1.12,70.59,Difficile,Moyen,1,Plus Facile,Adapte,Law
90,2015,Droit,4,Proces et Institution Juridictionnelles,2,La Trame de la Scene Judiciaire,13,91,11,QO,0.93,0.13,6.33,4,57,61,49,4,45,1.24,8.16,Difficile,Difficile,0,Meme Difficulté,Pas Adapte,Law
1214,2016,Droit,4,Proces et Institution Juridictionnelles,2,La Trame de la Scene Judiciaire,13,91,11,QO,0.14,0.54,81.4,43,10,53,46,43,3,1.15,93.48,Difficile,Facile,2,Beaucoup plus Facile,Pas Adapte,Law
2338,2017,Droit,4,Proces et Institution Juridictionnelles,2,La Trame de la Scene Judiciaire,13,91,11,QO,0.77,0.03,0.13,0,59,59,36,0,36,1.64,0.0,Moyen,Difficile,-1,Plus Difficile,Pas Adapte,Law
3462,2018,Droit,4,Proces et Institution Juridictionnelles,2,La Trame de la Scene Judiciaire,13,91,11,QO,0.31,0.27,54.19,28,24,52,34,28,6,1.53,82.35,Moyen,Moyen,0,Meme Difficulté,Pas Adapte,Law
4586,2019,Droit,4,Proces et Institution Juridictionnelles,2,La Trame de la Scene Judiciaire,13,91,11,QO,0.97,0.11,34.27,18,35,53,49,18,31,1.08,36.73,Facile,Difficile,-2,Beaucoup plus Difficile,Pas Adapte,Law
5710,2020,Droit,4,Proces et Institution Juridictionnelles,2,La Trame de la Scene Judiciaire,13,91,11,QO,0.55,0.16,46.72,22,25,47,25,22,3,1.88,88.0,Moyen,Moyen,0,Meme Difficulté,Pas Adapte,Law
91,2015,Droit,4,Proces et Institution Juridictionnelles,2,La Trame de la Scene Judiciaire,13,92,12,QCU,0.22,0.56,36.45,35,60,95,54,35,19,1.76,64.81,Facile,Moyen,-1,Plus Difficile,Pas Adapte,Law
1215,2016,Droit,4,Proces et Institution Juridictionnelles,2,La Trame de la Scene Judiciaire,13,92,12,QCU,0.07,0.99,97.97,87,2,89,87,87,0,1.02,100.0,Facile,Facile,0,Meme Difficulté,Pas Adapte,Law
2339,2017,Droit,4,Proces et Institution Juridictionnelles,2,La Trame de la Scene Judiciaire,13,92,12,QCU,0.52,0.3,0.07,0,84,84,73,0,73,1.15,0.0,Facile,Difficile,-2,Beaucoup plus Difficile,Pas Adapte,Law
3463,2018,Droit,4,Proces et Institution Juridictionnelles,2,La Trame de la Scene Judiciaire,13,92,12,QCU,0.13,0.81,76.21,68,21,89,78,68,10,1.14,87.18,Difficile,Facile,2,Beaucoup plus Facile,Pas Adapte,Law
4587,2019,Droit,4,Proces et Institution Juridictionnelles,2,La Trame de la Scene Judiciaire,13,92,12,QCU,0.07,0.79,70.51,54,23,77,76,54,22,1.01,71.05,Facile,Facile,0,Meme Difficulté,Adapte,Law
5711,2020,Droit,4,Proces et Institution Juridictionnelles,2,La Trame de la Scene Judiciaire,13,92,12,QCM,0.01,0.88,70.51,55,23,78,78,55,23,1.0,70.51,Facile,Facile,0,Meme Difficulté,Adapte,Law
92,2015,Droit,4,Proces et Institution Juridictionnelles,2,La Trame de la Scene Judiciaire,13,93,13,QCU,0.68,0.31,1.38,1,94,95,33,1,32,2.88,3.03,Difficile,Difficile,0,Meme Difficulté,Pas Adapte,Law
1216,2016,Droit,4,Proces et Institution Juridictionnelles,2,La Trame de la Scene Judiciaire,13,93,13,QCU,0.14,0.85,96.61,102,4,106,103,102,1,1.03,99.03,Facile,Facile,0,Meme Difficulté,Pas Adapte,Law
2340,2017,Droit,4,Proces et Institution Juridictionnelles,2,La Trame de la Scene Judiciaire,13,93,13,QCU,0.25,0.48,49.71,61,61,122,122,61,61,1.0,50.0,Facile,Moyen,-1,Plus Difficile,Pas Adapte,Law
3464,2018,Droit,4,Proces et Institution Juridictionnelles,2,La Trame de la Scene Judiciaire,13,93,13,QCU,0.07,0.87,67.87,95,45,140,127,95,32,1.1,74.8,Difficile,Facile,2,Beaucoup plus Facile,Adapte,Law
4588,2019,Droit,4,Proces et Institution Juridictionnelles,2,La Trame de la Scene Judiciaire,13,93,13,QCU,0.14,0.9,67.87,88,42,130,94,88,6,1.38,93.62,Facile,Facile,0,Meme Difficulté,Adapte,Law
5712,2020,Droit,4,Proces et Institution Juridictionnelles,2,La Trame de la Scene Judiciaire,13,93,13,QCU,0.09,0.81,67.87,100,47,147,109,100,9,1.35,91.74,Facile,Facile,0,Meme Difficulté,Adapte,Law
93,2015,Droit,4,Proces et Institution Juridictionnelles,3,Le Theatre de la Scene Judiciaire,3,94,1,QCM,0.1,0.75,71.2,6,2,8,7,6,1,1.14,85.71,Moyen,Facile,1,Plus Facile,Adapte,Law
1217,2016,Droit,4,Proces et Institution Juridictionnelles,3,Le Theatre de la Scene Judiciaire,3,94,1,QCM,0.12,0.85,71.2,6,3,9,6,6,0,1.5,100.0,Facile,Facile,0,Meme Difficulté,Adapte,Law
2341,2017,Droit,4,Proces et Institution Juridictionnelles,3,Le Theatre de la Scene Judiciaire,3,94,1,QCM,0.01,0.71,71.2,6,2,8,7,6,1,1.14,85.71,Facile,Facile,0,Meme Difficulté,Adapte,Law
3465,2018,Droit,4,Proces et Institution Juridictionnelles,3,Le Theatre de la Scene Judiciaire,3,94,1,QCM,0.16,0.77,71.2,6,2,8,7,6,1,1.14,85.71,Facile,Facile,0,Meme Difficulté,Adapte,Law
4589,2019,Droit,4,Proces et Institution Juridictionnelles,3,Le Theatre de la Scene Judiciaire,3,94,1,QCM,0.05,0.94,71.2,6,3,9,7,6,1,1.29,85.71,Facile,Facile,0,Meme Difficulté,Adapte,Law
5713,2020,Droit,4,Proces et Institution Juridictionnelles,3,Le Theatre de la Scene Judiciaire,3,94,1,QCM,0.14,0.93,71.2,6,3,9,7,6,1,1.29,85.71,Facile,Facile,0,Meme Difficulté,Adapte,Law
94,2015,Droit,4,Proces et Institution Juridictionnelles,3,Le Theatre de la Scene Judiciaire,3,95,2,QCM,0.08,0.79,86.85,19,3,22,20,19,1,1.1,95.0,Moyen,Facile,1,Plus Facile,Pas Adapte,Law
1218,2016,Droit,4,Proces et Institution Juridictionnelles,3,Le Theatre de la Scene Judiciaire,3,95,2,QCM,0.76,0.19,4.14,1,20,21,8,1,7,2.62,12.5,Facile,Difficile,-2,Beaucoup plus Difficile,Pas Adapte,Law
2342,2017,Droit,4,Proces et Institution Juridictionnelles,3,Le Theatre de la Scene Judiciaire,3,95,2,QCM,0.06,0.81,99.28,23,0,23,23,23,0,1.0,100.0,Facile,Facile,0,Meme Difficulté,Pas Adapte,Law
3466,2018,Droit,4,Proces et Institution Juridictionnelles,3,Le Theatre de la Scene Judiciaire,3,95,2,QCM,0.22,0.63,62.31,12,8,20,16,12,4,1.25,75.0,Moyen,Moyen,0,Meme Difficulté,Adapte,Law
4590,2019,Droit,4,Proces et Institution Juridictionnelles,3,Le Theatre de la Scene Judiciaire,3,95,2,QCM,0.3,0.5,62.31,11,7,18,18,11,7,1.0,61.11,Moyen,Moyen,0,Meme Difficulté,Adapte,Law
5714,2020,Droit,4,Proces et Institution Juridictionnelles,3,Le Theatre de la Scene Judiciaire,3,95,2,QCM,0.5,0.44,62.31,9,6,15,13,9,4,1.15,69.23,Moyen,Moyen,0,Meme Difficulté,Adapte,Law
95,2015,Droit,4,Proces et Institution Juridictionnelles,3,Le Theatre de la Scene Judiciaire,3,96,3,QCM,0.14,0.96,98.36,66,1,67,67,66,1,1.0,98.51,Facile,Facile,0,Meme Difficulté,Pas Adapte,Law
1219,2016,Droit,4,Proces et Institution Juridictionnelles,3,Le Theatre de la Scene Judiciaire,3,96,3,QO,0.26,0.16,59.88,41,28,69,65,41,24,1.06,63.08,Facile,Moyen,-1,Plus Difficile,Pas Adapte,Law
2343,2017,Droit,4,Proces et Institution Juridictionnelles,3,Le Theatre de la Scene Judiciaire,3,96,3,QO,0.81,0.01,10.82,8,66,74,41,8,33,1.8,19.51,Moyen,Difficile,-1,Plus Difficile,Pas Adapte,Law
3467,2018,Droit,4,Proces et Institution Juridictionnelles,3,Le Theatre de la Scene Judiciaire,3,96,3,QO,0.37,0.21,60.56,39,26,65,57,39,18,1.14,68.42,Moyen,Moyen,0,Meme Difficulté,Adapte,Law
4591,2019,Droit,4,Proces et Institution Juridictionnelles,3,Le Theatre de la Scene Judiciaire,3,96,3,QO,0.43,0.26,60.56,39,25,64,42,39,3,1.52,92.86,Moyen,Moyen,0,Meme Difficulté,Adapte,Law
5715,2020,Droit,4,Proces et Institution Juridictionnelles,3,Le Theatre de la Scene Judiciaire,3,96,3,QO,0.5,0.26,60.56,38,25,63,62,38,24,1.02,61.29,Moyen,Moyen,0,Meme Difficulté,Adapte,Law
96,2015,Droit,5,Constitution de la Cinquieme Republique,1,"La Cinquieme Republique, une Conception du Pouvoir",5,97,1,QCU,0.3,0.48,37.91,6,11,17,8,6,2,2.12,75.0,Facile,Moyen,-1,Plus Difficile,Pas Adapte,Law
1220,2016,Droit,5,Constitution de la Cinquieme Republique,1,"La Cinquieme Republique, une Conception du Pouvoir",5,97,1,QCU,0.42,0.32,31.31,5,12,17,9,5,4,1.89,55.56,Difficile,Difficile,0,Meme Difficulté,Pas Adapte,Law
2344,2017,Droit,5,Constitution de la Cinquieme Republique,1,"La Cinquieme Republique, une Conception du Pouvoir",5,97,1,QCU,0.53,0.28,20.18,4,15,19,9,4,5,2.11,44.44,Difficile,Difficile,0,Meme Difficulté,Pas Adapte,Law
3468,2018,Droit,5,Constitution de la Cinquieme Republique,1,"La Cinquieme Republique, une Conception du Pouvoir",5,97,1,QCU,0.05,0.94,71.33,13,5,18,18,13,5,1.0,72.22,Moyen,Facile,1,Plus Facile,Adapte,Law
4592,2019,Droit,5,Constitution de la Cinquieme Republique,1,"La Cinquieme Republique, une Conception du Pouvoir",5,97,1,QCU,0.07,0.97,71.33,15,6,21,16,15,1,1.31,93.75,Facile,Facile,0,Meme Difficulté,Adapte,Law
5716,2020,Droit,5,Constitution de la Cinquieme Republique,1,"La Cinquieme Republique, une Conception du Pouvoir",5,97,1,QCU,0.02,0.88,71.33,14,5,19,18,14,4,1.06,77.78,Facile,Facile,0,Meme Difficulté,Adapte,Law
97,2015,Droit,5,Constitution de la Cinquieme Republique,1,"La Cinquieme Republique, une Conception du Pouvoir",5,98,2,QCM,0.55,0.2,10.75,10,85,95,95,10,85,1.0,10.53,Moyen,Difficile,-1,Plus Difficile,Pas Adapte,Law
1221,2016,Droit,5,Constitution de la Cinquieme Republique,1,"La Cinquieme Republique, une Conception du Pouvoir",5,98,2,QCM,0.77,0.19,0.66,1,82,83,51,1,50,1.63,1.96,Difficile,Difficile,0,Meme Difficulté,Pas Adapte,Law
2345,2017,Droit,5,Constitution de la Cinquieme Republique,1,"La Cinquieme Republique, une Conception du Pouvoir",5,98,2,QCM,0.05,0.97,96.79,82,3,85,82,82,0,1.04,100.0,Facile,Facile,0,Meme Difficulté,Pas Adapte,Law
3469,2018,Droit,5,Constitution de la Cinquieme Republique,1,"La Cinquieme Republique, une Conception du Pouvoir",5,98,2,QCM,0.21,0.41,57.48,42,31,73,46,42,4,1.59,91.3,Difficile,Moyen,1,Plus Facile,Pas Adapte,Law
4593,2019,Droit,5,Constitution de la Cinquieme Republique,1,"La Cinquieme Republique, une Conception du Pouvoir",5,98,2,QCM,0.08,0.88,85.78,57,9,66,63,57,6,1.05,90.48,Facile,Facile,0,Meme Difficulté,Pas Adapte,Law
5717,2020,Droit,5,Constitution de la Cinquieme Republique,1,"La Cinquieme Republique, une Conception du Pouvoir",5,98,2,QCM,0.46,0.49,51.74,30,28,58,48,30,18,1.21,62.5,Facile,Moyen,-1,Plus Difficile,Pas Adapte,Law
98,2015,Droit,5,Constitution de la Cinquieme Republique,1,"La Cinquieme Republique, une Conception du Pouvoir",5,99,3,QCM,0.18,0.94,96.95,95,3,98,97,95,2,1.01,97.94,Moyen,Facile,1,Plus Facile,Pas Adapte,Law
1222,2016,Droit,5,Constitution de la Cinquieme Republique,1,"La Cinquieme Republique, une Conception du Pouvoir",5,99,3,QCM,0.05,0.72,92.36,87,7,94,93,87,6,1.01,93.55,Moyen,Facile,1,Plus Facile,Pas Adapte,Law
2346,2017,Droit,5,Constitution de la Cinquieme Republique,1,"La Cinquieme Republique, une Conception du Pouvoir",5,99,3,QCM,0.62,0.24,13.07,14,93,107,98,14,84,1.09,14.29,Moyen,Difficile,-1,Plus Difficile,Pas Adapte,Law
3470,2018,Droit,5,Constitution de la Cinquieme Republique,1,"La Cinquieme Republique, une Conception du Pouvoir",5,99,3,QCM,0.43,0.37,48.71,55,58,113,111,55,56,1.02,49.55,Difficile,Moyen,1,Plus Facile,Pas Adapte,Law
4594,2019,Droit,5,Constitution de la Cinquieme Republique,1,"La Cinquieme Republique, une Conception du Pouvoir",5,99,3,QCU,0.23,0.4,51.94,62,57,119,96,62,34,1.24,64.58,Facile,Moyen,-1,Plus Difficile,Pas Adapte,Law
5718,2020,Droit,5,Constitution de la Cinquieme Republique,1,"La Cinquieme Republique, une Conception du Pouvoir",5,99,3,QCU,0.27,0.67,62.42,84,50,134,125,84,41,1.07,67.2,Difficile,Moyen,1,Plus Facile,Adapte,Law
99,2015,Droit,5,Constitution de la Cinquieme Republique,1,"La Cinquieme Republique, une Conception du Pouvoir",5,100,4,QCM,0.15,0.89,92.73,22,2,24,24,22,2,1.0,91.67,Moyen,Facile,1,Plus Facile,Pas Adapte,Law
1223,2016,Droit,5,Constitution de la Cinquieme Republique,1,"La Cinquieme Republique, une Conception du Pouvoir",5,100,4,QCM,0.35,0.39,35.63,9,16,25,17,9,8,1.47,52.94,Moyen,Moyen,0,Meme Difficulté,Pas Adapte,Law
2347,2017,Droit,5,Constitution de la Cinquieme Republique,1,"La Cinquieme Republique, une Conception du Pouvoir",5,100,4,QCM,0.68,0.29,1.7,0,22,22,19,0,19,1.16,0.0,Difficile,Difficile,0,Meme Difficulté,Pas Adapte,Law
3471,2018,Droit,5,Constitution de la Cinquieme Republique,1,"La Cinquieme Republique, une Conception du Pouvoir",5,100,4,QCM,0.6,0.21,15.17,3,17,20,9,3,6,2.22,33.33,Facile,Difficile,-2,Beaucoup plus Difficile,Pas Adapte,Law
4595,2019,Droit,5,Constitution de la Cinquieme Republique,1,"La Cinquieme Republique, une Conception du Pouvoir",5,100,4,QROC,0.4,0.3,41.39,8,11,19,14,8,6,1.36,57.14,Facile,Moyen,-1,Plus Difficile,Pas Adapte,Law
5719,2020,Droit,5,Constitution de la Cinquieme Republique,1,"La Cinquieme Republique, une Conception du Pouvoir",5,100,4,QROC,0.61,0.14,25.37,5,16,21,15,5,10,1.4,33.33,Moyen,Difficile,-1,Plus Difficile,Pas Adapte,Law
100,2015,Droit,5,Constitution de la Cinquieme Republique,1,"La Cinquieme Republique, une Conception du Pouvoir",5,101,5,QCU,0.73,0.26,22.16,7,25,32,15,7,8,2.13,46.67,Facile,Difficile,-2,Beaucoup plus Difficile,Pas Adapte,Law
1224,2016,Droit,5,Constitution de la Cinquieme Republique,1,"La Cinquieme Republique, une Conception du Pouvoir",5,101,5,QCU,0.69,0.21,16.64,6,28,34,26,6,20,1.31,23.08,Moyen,Difficile,-1,Plus Difficile,Pas Adapte,Law
2348,2017,Droit,5,Constitution de la Cinquieme Republique,1,"La Cinquieme Republique, une Conception du Pouvoir",5,101,5,QCU,0.33,0.71,58.65,19,13,32,22,19,3,1.45,86.36,Difficile,Moyen,1,Plus Facile,Pas Adapte,Law
3472,2018,Droit,5,Constitution de la Cinquieme Republique,1,"La Cinquieme Republique, une Conception du Pouvoir",5,101,5,QCM,0.23,0.52,61.95,19,11,30,24,19,5,1.25,79.17,Moyen,Moyen,0,Meme Difficulté,Adapte,Law
4596,2019,Droit,5,Constitution de la Cinquieme Republique,1,"La Cinquieme Republique, une Conception du Pouvoir",5,101,5,QCM,0.3,0.34,61.95,16,10,26,18,16,2,1.44,88.89,Moyen,Moyen,0,Meme Difficulté,Adapte,Law
5720,2020,Droit,5,Constitution de la Cinquieme Republique,1,"La Cinquieme Republique, une Conception du Pouvoir",5,101,5,QCM,0.42,0.34,61.95,14,8,22,20,14,6,1.1,70.0,Moyen,Moyen,0,Meme Difficulté,Adapte,Law
101,2015,Droit,5,Constitution de la Cinquieme Republique,2,Le Pouvoir Gouvernant,7,102,1,QCM,0.03,0.7,81.58,62,14,76,74,62,12,1.03,83.78,Moyen,Facile,1,Plus Facile,Pas Adapte,Law
1225,2016,Droit,5,Constitution de la Cinquieme Republique,2,Le Pouvoir Gouvernant,7,102,1,QCU,0.5,0.31,8.06,6,69,75,37,6,31,2.03,16.22,Difficile,Difficile,0,Meme Difficulté,Pas Adapte,Law
2349,2017,Droit,5,Constitution de la Cinquieme Republique,2,Le Pouvoir Gouvernant,7,102,1,QCU,0.1,0.79,81.04,52,12,64,56,52,4,1.14,92.86,Facile,Facile,0,Meme Difficulté,Pas Adapte,Law
3473,2018,Droit,5,Constitution de la Cinquieme Republique,2,Le Pouvoir Gouvernant,7,102,1,QCU,0.26,0.56,60.72,45,29,74,48,45,3,1.54,93.75,Difficile,Moyen,1,Plus Facile,Adapte,Law
4597,2019,Droit,5,Constitution de la Cinquieme Republique,2,Le Pouvoir Gouvernant,7,102,1,QCU,0.3,0.57,60.72,46,30,76,48,46,2,1.58,95.83,Moyen,Moyen,0,Meme Difficulté,Adapte,Law
5721,2020,Droit,5,Constitution de la Cinquieme Republique,2,Le Pouvoir Gouvernant,7,102,1,QCM,0.38,0.35,60.72,44,28,72,49,44,5,1.47,89.8,Moyen,Moyen,0,Meme Difficulté,Adapte,Law
102,2015,Droit,5,Constitution de la Cinquieme Republique,2,Le Pouvoir Gouvernant,7,103,2,QCU,0.56,0.28,24.34,10,32,42,36,10,26,1.17,27.78,Facile,Difficile,-2,Beaucoup plus Difficile,Pas Adapte,Law
1226,2016,Droit,5,Constitution de la Cinquieme Republique,2,Le Pouvoir Gouvernant,7,103,2,QCU,0.05,1.0,98.79,39,0,39,39,39,0,1.0,100.0,Moyen,Facile,1,Plus Facile,Pas Adapte,Law
2350,2017,Droit,5,Constitution de la Cinquieme Republique,2,Le Pouvoir Gouvernant,7,103,2,QCU,0.47,0.3,5.89,2,34,36,26,2,24,1.38,7.69,Difficile,Difficile,0,Meme Difficulté,Pas Adapte,Law
3474,2018,Droit,5,Constitution de la Cinquieme Republique,2,Le Pouvoir Gouvernant,7,103,2,QCU,0.17,0.81,84.52,33,6,39,33,33,0,1.18,100.0,Facile,Facile,0,Meme Difficulté,Pas Adapte,Law
4598,2019,Droit,5,Constitution de la Cinquieme Republique,2,Le Pouvoir Gouvernant,7,103,2,QCU,0.33,0.5,42.52,15,20,35,35,15,20,1.0,42.86,Facile,Moyen,-1,Plus Difficile,Pas Adapte,Law
5722,2020,Droit,5,Constitution de la Cinquieme Republique,2,Le Pouvoir Gouvernant,7,103,2,QCU,0.09,0.83,67.54,24,11,35,28,24,4,1.25,85.71,Difficile,Facile,2,Beaucoup plus Facile,Adapte,Law
103,2015,Droit,5,Constitution de la Cinquieme Republique,2,Le Pouvoir Gouvernant,7,104,3,QCM,0.14,0.79,95.45,61,3,64,62,61,1,1.03,98.39,Facile,Facile,0,Meme Difficulté,Pas Adapte,Law
1227,2016,Droit,5,Constitution de la Cinquieme Republique,2,Le Pouvoir Gouvernant,7,104,3,QCM,0.34,0.67,37.81,23,37,60,56,23,33,1.07,41.07,Difficile,Moyen,1,Plus Facile,Pas Adapte,Law
2351,2017,Droit,5,Constitution de la Cinquieme Republique,2,Le Pouvoir Gouvernant,7,104,3,QCU,0.08,0.78,78.17,41,12,53,49,41,8,1.08,83.67,Difficile,Facile,2,Beaucoup plus Facile,Pas Adapte,Law
3475,2018,Droit,5,Constitution de la Cinquieme Republique,2,Le Pouvoir Gouvernant,7,104,3,QCU,0.23,0.61,38.74,17,28,45,23,17,6,1.96,73.91,Difficile,Moyen,1,Plus Facile,Pas Adapte,Law
4599,2019,Droit,5,Constitution de la Cinquieme Republique,2,Le Pouvoir Gouvernant,7,104,3,QCU,0.25,0.69,36.66,14,25,39,20,14,6,1.95,70.0,Difficile,Moyen,1,Plus Facile,Pas Adapte,Law
5723,2020,Droit,5,Constitution de la Cinquieme Republique,2,Le Pouvoir Gouvernant,7,104,3,QCU,0.12,0.89,96.43,41,1,42,41,41,0,1.02,100.0,Moyen,Facile,1,Plus Facile,Pas Adapte,Law
104,2015,Droit,5,Constitution de la Cinquieme Republique,2,Le Pouvoir Gouvernant,7,105,4,QCU,0.3,0.74,63.1,10,6,16,12,10,2,1.33,83.33,Moyen,Moyen,0,Meme Difficulté,Adapte,Law
1228,2016,Droit,5,Constitution de la Cinquieme Republique,2,Le Pouvoir Gouvernant,7,105,4,QCU,0.24,0.73,63.1,11,7,18,14,11,3,1.29,78.57,Moyen,Moyen,0,Meme Difficulté,Adapte,Law
2352,2017,Droit,5,Constitution de la Cinquieme Republique,2,Le Pouvoir Gouvernant,7,105,4,QCU,0.3,0.48,63.1,13,8,21,17,13,4,1.24,76.47,Moyen,Moyen,0,Meme Difficulté,Adapte,Law
3476,2018,Droit,5,Constitution de la Cinquieme Republique,2,Le Pouvoir Gouvernant,7,105,4,QCU,0.35,0.42,63.1,13,8,21,19,13,6,1.11,68.42,Moyen,Moyen,0,Meme Difficulté,Adapte,Law
4600,2019,Droit,5,Constitution de la Cinquieme Republique,2,Le Pouvoir Gouvernant,7,105,4,QCU,0.21,0.67,63.1,13,8,21,15,13,2,1.4,86.67,Moyen,Moyen,0,Meme Difficulté,Adapte,Law
5724,2020,Droit,5,Constitution de la Cinquieme Republique,2,Le Pouvoir Gouvernant,7,105,4,QCU,0.24,0.43,63.1,12,7,19,15,12,3,1.27,80.0,Moyen,Moyen,0,Meme Difficulté,Adapte,Law
105,2015,Droit,5,Constitution de la Cinquieme Republique,2,Le Pouvoir Gouvernant,7,106,5,QCU,0.34,0.73,36.29,28,50,78,45,28,17,1.73,62.22,Facile,Moyen,-1,Plus Difficile,Pas Adapte,Law
1229,2016,Droit,5,Constitution de la Cinquieme Republique,2,Le Pouvoir Gouvernant,7,106,5,QCM,0.38,0.41,55.8,42,33,75,48,42,6,1.56,87.5,Facile,Moyen,-1,Plus Difficile,Pas Adapte,Law
2353,2017,Droit,5,Constitution de la Cinquieme Republique,2,Le Pouvoir Gouvernant,7,106,5,QROC,0.83,0.12,2.16,1,65,66,46,1,45,1.43,2.17,Difficile,Difficile,0,Meme Difficulté,Pas Adapte,Law
3477,2018,Droit,5,Constitution de la Cinquieme Republique,2,Le Pouvoir Gouvernant,7,106,5,QO,1.0,0.06,4.6,3,56,59,52,3,49,1.13,5.77,Moyen,Difficile,-1,Plus Difficile,Pas Adapte,Law
4601,2019,Droit,5,Constitution de la Cinquieme Republique,2,Le Pouvoir Gouvernant,7,106,5,QO,0.5,0.22,35.62,23,41,64,40,23,17,1.6,57.5,Moyen,Moyen,0,Meme Difficulté,Pas Adapte,Law
5725,2020,Droit,5,Constitution de la Cinquieme Republique,2,Le Pouvoir Gouvernant,7,106,5,QO,0.66,0.27,62.5,44,27,71,50,44,6,1.42,88.0,Moyen,Moyen,0,Meme Difficulté,Adapte,Law
106,2015,Droit,5,Constitution de la Cinquieme Republique,2,Le Pouvoir Gouvernant,7,107,6,QCM,0.72,0.25,32.02,21,46,67,49,21,28,1.37,42.86,Facile,Difficile,-2,Beaucoup plus Difficile,Pas Adapte,Law
1230,2016,Droit,5,Constitution de la Cinquieme Republique,2,Le Pouvoir Gouvernant,7,107,6,QCM,0.41,0.42,52.49,30,27,57,32,30,2,1.78,93.75,Difficile,Moyen,1,Plus Facile,Pas Adapte,Law
2354,2017,Droit,5,Constitution de la Cinquieme Republique,2,Le Pouvoir Gouvernant,7,107,6,QCU,0.68,0.25,22.79,13,45,58,54,13,41,1.07,24.07,Moyen,Difficile,-1,Plus Difficile,Pas Adapte,Law
3478,2018,Droit,5,Constitution de la Cinquieme Republique,2,Le Pouvoir Gouvernant,7,107,6,QCU,0.03,0.76,91.48,54,5,59,58,54,4,1.02,93.1,Moyen,Facile,1,Plus Facile,Pas Adapte,Law
4602,2019,Droit,5,Constitution de la Cinquieme Republique,2,Le Pouvoir Gouvernant,7,107,6,QCU,0.37,0.47,50.03,28,28,56,32,28,4,1.75,87.5,Moyen,Moyen,0,Meme Difficulté,Pas Adapte,Law
5726,2020,Droit,5,Constitution de la Cinquieme Republique,2,Le Pouvoir Gouvernant,7,107,6,QCU,0.03,0.94,76.63,43,13,56,45,43,2,1.24,95.56,Facile,Facile,0,Meme Difficulté,Pas Adapte,Law
107,2015,Droit,5,Constitution de la Cinquieme Republique,2,Le Pouvoir Gouvernant,7,108,7,QCM,0.18,0.96,83.07,82,17,99,89,82,7,1.11,92.13,Facile,Facile,0,Meme Difficulté,Pas Adapte,Law
1231,2016,Droit,5,Constitution de la Cinquieme Republique,2,Le Pouvoir Gouvernant,7,108,7,QCM,0.28,0.41,56.25,51,39,90,77,51,26,1.17,66.23,Facile,Moyen,-1,Plus Difficile,Pas Adapte,Law
2355,2017,Droit,5,Constitution de la Cinquieme Republique,2,Le Pouvoir Gouvernant,7,108,7,QCM,0.5,0.25,3.61,4,98,102,29,4,25,3.52,13.79,Facile,Difficile,-2,Beaucoup plus Difficile,Pas Adapte,Law
3479,2018,Droit,5,Constitution de la Cinquieme Republique,2,Le Pouvoir Gouvernant,7,108,7,QCM,0.14,0.8,83.9,86,17,103,96,86,10,1.07,89.58,Difficile,Facile,2,Beaucoup plus Facile,Pas Adapte,Law
4603,2019,Droit,5,Constitution de la Cinquieme Republique,2,Le Pouvoir Gouvernant,7,108,7,QCM,0.36,0.53,35.38,39,72,111,102,39,63,1.09,38.24,Facile,Moyen,-1,Plus Difficile,Pas Adapte,Law
5727,2020,Droit,5,Constitution de la Cinquieme Republique,2,Le Pouvoir Gouvernant,7,108,7,QCM,0.01,0.75,91.97,104,9,113,111,104,7,1.02,93.69,Moyen,Facile,1,Plus Facile,Pas Adapte,Law
108,2015,Droit,5,Constitution de la Cinquieme Republique,3,Le Pouvoir Legislatif,7,109,1,QCM,0.07,1.0,93.02,92,7,99,94,92,2,1.05,97.87,Facile,Facile,0,Meme Difficulté,Pas Adapte,Law
1232,2016,Droit,5,Constitution de la Cinquieme Republique,3,Le Pouvoir Legislatif,7,109,1,QCM,0.1,0.71,72.74,71,27,98,72,71,1,1.36,98.61,Facile,Facile,0,Meme Difficulté,Adapte,Law
2356,2017,Droit,5,Constitution de la Cinquieme Republique,3,Le Pouvoir Legislatif,7,109,1,QCU,0.04,0.81,72.74,81,30,111,84,81,3,1.32,96.43,Facile,Facile,0,Meme Difficulté,Adapte,Law
3480,2018,Droit,5,Constitution de la Cinquieme Republique,3,Le Pouvoir Legislatif,7,109,1,QCU,0.01,0.77,72.74,76,29,105,98,76,22,1.07,77.55,Facile,Facile,0,Meme Difficulté,Adapte,Law
4604,2019,Droit,5,Constitution de la Cinquieme Republique,3,Le Pouvoir Legislatif,7,109,1,QCU,0.02,0.97,72.74,83,31,114,113,83,30,1.01,73.45,Facile,Facile,0,Meme Difficulté,Adapte,Law
5728,2020,Droit,5,Constitution de la Cinquieme Republique,3,Le Pouvoir Legislatif,7,109,1,QCU,0.05,0.81,72.74,84,32,116,109,84,25,1.06,77.06,Facile,Facile,0,Meme Difficulté,Adapte,Law
109,2015,Droit,5,Constitution de la Cinquieme Republique,3,Le Pouvoir Legislatif,7,110,2,QO,0.65,0.18,64.8,19,11,30,24,19,5,1.25,79.17,Difficile,Moyen,1,Plus Facile,Adapte,Law
1233,2016,Droit,5,Constitution de la Cinquieme Republique,3,Le Pouvoir Legislatif,7,110,2,QCU,0.27,0.65,64.8,17,9,26,17,17,0,1.53,100.0,Moyen,Moyen,0,Meme Difficulté,Adapte,Law
2357,2017,Droit,5,Constitution de la Cinquieme Republique,3,Le Pouvoir Legislatif,7,110,2,QCU,0.38,0.63,64.8,15,8,23,18,15,3,1.28,83.33,Moyen,Moyen,0,Meme Difficulté,Adapte,Law
3481,2018,Droit,5,Constitution de la Cinquieme Republique,3,Le Pouvoir Legislatif,7,110,2,QCU,0.26,0.73,64.8,17,9,26,22,17,5,1.18,77.27,Moyen,Moyen,0,Meme Difficulté,Adapte,Law
4605,2019,Droit,5,Constitution de la Cinquieme Republique,3,Le Pouvoir Legislatif,7,110,2,QCU,0.38,0.58,64.8,18,10,28,26,18,8,1.08,69.23,Moyen,Moyen,0,Meme Difficulté,Adapte,Law
5729,2020,Droit,5,Constitution de la Cinquieme Republique,3,Le Pouvoir Legislatif,7,110,2,QCU,0.4,0.44,64.8,16,8,24,18,16,2,1.33,88.89,Moyen,Moyen,0,Meme Difficulté,Adapte,Law
110,2015,Droit,5,Constitution de la Cinquieme Republique,3,Le Pouvoir Legislatif,7,111,3,QCU,0.47,0.38,21.61,21,76,97,38,21,17,2.55,55.26,Moyen,Difficile,-1,Plus Difficile,Pas Adapte,Law
1234,2016,Droit,5,Constitution de la Cinquieme Republique,3,Le Pouvoir Legislatif,7,111,3,QCU,0.09,0.76,93.87,95,6,101,99,95,4,1.02,95.96,Moyen,Facile,1,Plus Facile,Pas Adapte,Law
2358,2017,Droit,5,Constitution de la Cinquieme Republique,3,Le Pouvoir Legislatif,7,111,3,QCU,0.24,0.59,36.83,35,59,94,90,35,55,1.04,38.89,Facile,Moyen,-1,Plus Difficile,Pas Adapte,Law
3482,2018,Droit,5,Constitution de la Cinquieme Republique,3,Le Pouvoir Legislatif,7,111,3,QCU,0.04,0.93,78.12,79,22,101,86,79,7,1.17,91.86,Difficile,Facile,2,Beaucoup plus Facile,Pas Adapte,Law
4606,2019,Droit,5,Constitution de la Cinquieme Republique,3,Le Pouvoir Legislatif,7,111,3,QCU,0.31,0.41,60.72,53,34,87,66,53,13,1.32,80.3,Difficile,Moyen,1,Plus Facile,Adapte,Law
5730,2020,Droit,5,Constitution de la Cinquieme Republique,3,Le Pouvoir Legislatif,7,111,3,QCU,0.22,0.53,60.72,52,33,85,83,52,31,1.02,62.65,Moyen,Moyen,0,Meme Difficulté,Adapte,Law
111,2015,Droit,5,Constitution de la Cinquieme Republique,3,Le Pouvoir Legislatif,7,112,4,QROC,0.38,0.31,41.49,14,19,33,21,14,7,1.57,66.67,Difficile,Moyen,1,Plus Facile,Pas Adapte,Law
1235,2016,Droit,5,Constitution de la Cinquieme Republique,3,Le Pouvoir Legislatif,7,112,4,QROC,0.52,0.35,36.45,13,24,37,18,13,5,2.06,72.22,Facile,Moyen,-1,Plus Difficile,Pas Adapte,Law
2359,2017,Droit,5,Constitution de la Cinquieme Republique,3,Le Pouvoir Legislatif,7,112,4,QROC,0.14,0.94,79.6,25,7,32,31,25,6,1.03,80.65,Moyen,Facile,1,Plus Facile,Pas Adapte,Law
3483,2018,Droit,5,Constitution de la Cinquieme Republique,3,Le Pouvoir Legislatif,7,112,4,QROC,0.63,0.2,33.55,12,24,36,30,12,18,1.2,40.0,Difficile,Difficile,0,Meme Difficulté,Pas Adapte,Law
4607,2019,Droit,5,Constitution de la Cinquieme Republique,3,Le Pouvoir Legislatif,7,112,4,QROC,0.74,0.17,30.64,10,22,32,28,10,18,1.14,35.71,Moyen,Difficile,-1,Plus Difficile,Pas Adapte,Law
5731,2020,Droit,5,Constitution de la Cinquieme Republique,3,Le Pouvoir Legislatif,7,112,4,QROC,0.63,0.21,12.84,4,28,32,32,4,28,1.0,12.5,Facile,Difficile,-2,Beaucoup plus Difficile,Pas Adapte,Law
112,2015,Droit,5,Constitution de la Cinquieme Republique,3,Le Pouvoir Legislatif,7,113,5,QCU,0.48,0.35,5.73,2,33,35,29,2,27,1.21,6.9,Moyen,Difficile,-1,Plus Difficile,Pas Adapte,Law
1236,2016,Droit,5,Constitution de la Cinquieme Republique,3,Le Pouvoir Legislatif,7,113,5,QCU,0.0,0.92,70.11,27,11,38,32,27,5,1.19,84.38,Facile,Facile,0,Meme Difficulté,Adapte,Law
2360,2017,Droit,5,Constitution de la Cinquieme Republique,3,Le Pouvoir Legislatif,7,113,5,QCU,0.04,0.76,70.11,25,10,35,31,25,6,1.13,80.65,Facile,Facile,0,Meme Difficulté,Adapte,Law
3484,2018,Droit,5,Constitution de la Cinquieme Republique,3,Le Pouvoir Legislatif,7,113,5,QCU,0.05,0.77,70.11,27,11,38,32,27,5,1.19,84.38,Facile,Facile,0,Meme Difficulté,Adapte,Law
4608,2019,Droit,5,Constitution de la Cinquieme Republique,3,Le Pouvoir Legislatif,7,113,5,QCU,0.03,0.77,70.11,29,12,41,37,29,8,1.11,78.38,Facile,Facile,0,Meme Difficulté,Adapte,Law
5732,2020,Droit,5,Constitution de la Cinquieme Republique,3,Le Pouvoir Legislatif,7,113,5,QCU,0.04,0.97,70.11,27,11,38,36,27,9,1.06,75.0,Facile,Facile,0,Meme Difficulté,Adapte,Law
113,2015,Droit,5,Constitution de la Cinquieme Republique,3,Le Pouvoir Legislatif,7,114,6,QCM,0.09,0.92,73.87,40,14,54,45,40,5,1.2,88.89,Moyen,Facile,1,Plus Facile,Adapte,Law
1237,2016,Droit,5,Constitution de la Cinquieme Republique,3,Le Pouvoir Legislatif,7,114,6,QCM,0.11,0.75,73.87,36,13,49,38,36,2,1.29,94.74,Facile,Facile,0,Meme Difficulté,Adapte,Law
2361,2017,Droit,5,Constitution de la Cinquieme Republique,3,Le Pouvoir Legislatif,7,114,6,QCM,0.1,0.76,73.87,38,13,51,39,38,1,1.31,97.44,Facile,Facile,0,Meme Difficulté,Adapte,Law
3485,2018,Droit,5,Constitution de la Cinquieme Republique,3,Le Pouvoir Legislatif,7,114,6,QCM,0.05,0.87,73.87,39,14,53,46,39,7,1.15,84.78,Facile,Facile,0,Meme Difficulté,Adapte,Law
4609,2019,Droit,5,Constitution de la Cinquieme Republique,3,Le Pouvoir Legislatif,7,114,6,QCM,0.17,0.78,73.87,33,12,45,41,33,8,1.1,80.49,Facile,Facile,0,Meme Difficulté,Adapte,Law
5733,2020,Droit,5,Constitution de la Cinquieme Republique,3,Le Pouvoir Legislatif,7,114,6,QCM,0.17,0.85,73.87,34,12,46,36,34,2,1.28,94.44,Facile,Facile,0,Meme Difficulté,Adapte,Law
114,2015,Droit,5,Constitution de la Cinquieme Republique,3,Le Pouvoir Legislatif,7,115,7,QCU,0.58,0.29,33.13,14,28,42,21,14,7,2.0,66.67,Difficile,Difficile,0,Meme Difficulté,Pas Adapte,Law
1238,2016,Droit,5,Constitution de la Cinquieme Republique,3,Le Pouvoir Legislatif,7,115,7,QCU,0.74,0.38,18.9,9,37,46,21,9,12,2.19,42.86,Facile,Difficile,-2,Beaucoup plus Difficile,Pas Adapte,Law
2362,2017,Droit,5,Constitution de la Cinquieme Republique,3,Le Pouvoir Legislatif,7,115,7,QCU,0.63,0.39,25.48,10,30,40,18,10,8,2.22,55.56,Difficile,Difficile,0,Meme Difficulté,Pas Adapte,Law
3486,2018,Droit,5,Constitution de la Cinquieme Republique,3,Le Pouvoir Legislatif,7,115,7,QCM,0.64,0.23,15.18,5,30,35,18,5,13,1.94,27.78,Difficile,Difficile,0,Meme Difficulté,Pas Adapte,Law
4610,2019,Droit,5,Constitution de la Cinquieme Republique,3,Le Pouvoir Legislatif,7,115,7,QCM,0.18,0.72,78.48,27,7,34,34,27,7,1.0,79.41,Difficile,Facile,2,Beaucoup plus Facile,Pas Adapte,Law
5734,2020,Droit,5,Constitution de la Cinquieme Republique,3,Le Pouvoir Legislatif,7,115,7,QCM,0.1,0.73,75.52,26,8,34,29,26,3,1.17,89.66,Difficile,Facile,2,Beaucoup plus Facile,Pas Adapte,Law
115,2015,Droit,5,Constitution de la Cinquieme Republique,4,Le Controle de Constitutionnalite,4,116,1,QCU,0.1,0.91,86.35,25,4,29,25,25,0,1.16,100.0,Moyen,Facile,1,Plus Facile,Pas Adapte,Law
1239,2016,Droit,5,Constitution de la Cinquieme Republique,4,Le Controle de Constitutionnalite,4,116,1,QCU,0.48,0.2,32.77,10,22,32,18,10,8,1.78,55.56,Moyen,Difficile,-1,Plus Difficile,Pas Adapte,Law
2363,2017,Droit,5,Constitution de la Cinquieme Republique,4,Le Controle de Constitutionnalite,4,116,1,QCM,0.36,0.62,42.22,14,20,34,15,14,1,2.27,93.33,Moyen,Moyen,0,Meme Difficulté,Pas Adapte,Law
3487,2018,Droit,5,Constitution de la Cinquieme Republique,4,Le Controle de Constitutionnalite,4,116,1,QCU,0.22,0.6,38.5,13,22,35,32,13,19,1.09,40.62,Difficile,Moyen,1,Plus Facile,Pas Adapte,Law
4611,2019,Droit,5,Constitution de la Cinquieme Republique,4,Le Controle de Constitutionnalite,4,116,1,QCM,0.42,0.39,38.84,15,24,39,37,15,22,1.05,40.54,Moyen,Moyen,0,Meme Difficulté,Pas Adapte,Law
5735,2020,Droit,5,Constitution de la Cinquieme Republique,4,Le Controle de Constitutionnalite,4,116,1,QCM,0.66,0.27,16.9,6,27,33,13,6,7,2.54,46.15,Difficile,Difficile,0,Meme Difficulté,Pas Adapte,Law
116,2015,Droit,5,Constitution de la Cinquieme Republique,4,Le Controle de Constitutionnalite,4,117,2,QCU,0.43,0.25,27.45,13,34,47,44,13,31,1.07,29.55,Moyen,Difficile,-1,Plus Difficile,Pas Adapte,Law
1240,2016,Droit,5,Constitution de la Cinquieme Republique,4,Le Controle de Constitutionnalite,4,117,2,QCU,0.61,0.27,12.81,6,37,43,23,6,17,1.87,26.09,Moyen,Difficile,-1,Plus Difficile,Pas Adapte,Law
2364,2017,Droit,5,Constitution de la Cinquieme Republique,4,Le Controle de Constitutionnalite,4,117,2,QCU,0.72,0.34,3.49,2,43,45,43,2,41,1.05,4.65,Facile,Difficile,-2,Beaucoup plus Difficile,Pas Adapte,Law
3488,2018,Droit,5,Constitution de la Cinquieme Republique,4,Le Controle de Constitutionnalite,4,117,2,QCU,0.16,0.94,92.21,40,3,43,41,40,1,1.05,97.56,Moyen,Facile,1,Plus Facile,Pas Adapte,Law
4612,2019,Droit,5,Constitution de la Cinquieme Republique,4,Le Controle de Constitutionnalite,4,117,2,QCM,0.66,0.26,14.65,6,34,40,38,6,32,1.05,15.79,Facile,Difficile,-2,Beaucoup plus Difficile,Pas Adapte,Law
5736,2020,Droit,5,Constitution de la Cinquieme Republique,4,Le Controle de Constitutionnalite,4,117,2,QCM,0.05,0.75,93.49,41,3,44,42,41,1,1.05,97.62,Difficile,Facile,2,Beaucoup plus Facile,Pas Adapte,Law
117,2015,Droit,5,Constitution de la Cinquieme Republique,4,Le Controle de Constitutionnalite,4,118,3,QO,0.01,0.98,77.31,38,11,49,48,38,10,1.02,79.17,Difficile,Facile,2,Beaucoup plus Facile,Pas Adapte,Law
1241,2016,Droit,5,Constitution de la Cinquieme Republique,4,Le Controle de Constitutionnalite,4,118,3,QO,0.02,0.58,71.8,38,15,53,46,38,8,1.15,82.61,Moyen,Facile,1,Plus Facile,Adapte,Law
2365,2017,Droit,5,Constitution de la Cinquieme Republique,4,Le Controle de Constitutionnalite,4,118,3,QO,0.08,0.64,71.8,41,16,57,52,41,11,1.1,78.85,Facile,Facile,0,Meme Difficulté,Adapte,Law
3489,2018,Droit,5,Constitution de la Cinquieme Republique,4,Le Controle de Constitutionnalite,4,118,3,QO,0.1,0.86,71.8,39,15,54,41,39,2,1.32,95.12,Facile,Facile,0,Meme Difficulté,Adapte,Law
4613,2019,Droit,5,Constitution de la Cinquieme Republique,4,Le Controle de Constitutionnalite,4,118,3,QO,0.05,0.46,71.8,44,17,61,50,44,6,1.22,88.0,Facile,Facile,0,Meme Difficulté,Adapte,Law
5737,2020,Droit,5,Constitution de la Cinquieme Republique,4,Le Controle de Constitutionnalite,4,118,3,QO,0.05,0.92,71.8,46,18,64,63,46,17,1.02,73.02,Facile,Facile,0,Meme Difficulté,Adapte,Law
118,2015,Droit,5,Constitution de la Cinquieme Republique,4,Le Controle de Constitutionnalite,4,119,4,QCU,0.71,0.35,33.58,7,14,21,17,7,10,1.24,41.18,Facile,Difficile,-2,Beaucoup plus Difficile,Pas Adapte,Law
1242,2016,Droit,5,Constitution de la Cinquieme Republique,4,Le Controle de Constitutionnalite,4,119,4,QCU,0.19,0.89,76.29,18,6,24,22,18,4,1.09,81.82,Moyen,Facile,1,Plus Facile,Pas Adapte,Law
2366,2017,Droit,5,Constitution de la Cinquieme Republique,4,Le Controle de Constitutionnalite,4,119,4,QCU,0.4,0.26,16.91,4,19,23,16,4,12,1.44,25.0,Difficile,Difficile,0,Meme Difficulté,Pas Adapte,Law
3490,2018,Droit,5,Constitution de la Cinquieme Republique,4,Le Controle de Constitutionnalite,4,119,4,QCU,0.19,0.94,82.27,21,4,25,22,21,1,1.14,95.45,Moyen,Facile,1,Plus Facile,Pas Adapte,Law
4614,2019,Droit,5,Constitution de la Cinquieme Republique,4,Le Controle de Constitutionnalite,4,119,4,QCU,0.61,0.38,0.33,0,26,26,26,0,26,1.0,0.0,Facile,Difficile,-2,Beaucoup plus Difficile,Pas Adapte,Law
5738,2020,Droit,5,Constitution de la Cinquieme Republique,4,Le Controle de Constitutionnalite,4,119,4,QCU,0.33,0.62,58.62,18,12,30,24,18,6,1.25,75.0,Difficile,Moyen,1,Plus Facile,Pas Adapte,Law
119,2015,Économie,1,L'Economie et son Domaine,1,L'Objet de la Science Economique,12,120,1,QCU,0.67,0.22,26.13,6,17,23,8,6,2,2.88,75.0,Facile,Difficile,-2,Beaucoup plus Difficile,Pas Adapte,Economy
1243,2016,Économie,1,L'Economie et son Domaine,1,L'Objet de la Science Economique,12,120,1,QROC,0.81,0.04,29.43,7,18,25,24,7,17,1.04,29.17,Difficile,Difficile,0,Meme Difficulté,Pas Adapte,Economy
2367,2017,Économie,1,L'Economie et son Domaine,1,L'Objet de la Science Economique,12,120,1,QROC,0.19,0.64,76.02,21,6,27,23,21,2,1.17,91.3,Moyen,Facile,1,Plus Facile,Pas Adapte,Economy
3491,2018,Économie,1,L'Economie et son Domaine,1,L'Objet de la Science Economique,12,120,1,QROC,0.1,0.58,76.45,18,6,24,21,18,3,1.14,85.71,Facile,Facile,0,Meme Difficulté,Pas Adapte,Economy
4615,2019,Économie,1,L'Economie et son Domaine,1,L'Objet de la Science Economique,12,120,1,QROC,0.16,0.52,76.16,21,7,28,21,21,0,1.33,100.0,Moyen,Facile,1,Plus Facile,Pas Adapte,Economy
5739,2020,Économie,1,L'Economie et son Domaine,1,L'Objet de la Science Economique,12,120,1,QO,0.13,0.81,68.88,19,8,27,22,19,3,1.23,86.36,Moyen,Facile,1,Plus Facile,Adapte,Economy
120,2015,Économie,1,L'Economie et son Domaine,1,L'Objet de la Science Economique,12,121,2,QCU,0.59,0.39,16.08,8,40,48,41,8,33,1.17,19.51,Difficile,Difficile,0,Meme Difficulté,Pas Adapte,Economy
1244,2016,Économie,1,L'Economie et son Domaine,1,L'Objet de la Science Economique,12,121,2,QCU,0.01,0.95,85.06,44,8,52,44,44,0,1.18,100.0,Facile,Facile,0,Meme Difficulté,Pas Adapte,Economy
2368,2017,Économie,1,L'Economie et son Domaine,1,L'Objet de la Science Economique,12,121,2,QCU,0.11,0.87,86.48,40,6,46,43,40,3,1.07,93.02,Facile,Facile,0,Meme Difficulté,Pas Adapte,Economy
3492,2018,Économie,1,L'Economie et son Domaine,1,L'Objet de la Science Economique,12,121,2,QCU,0.1,0.97,65.27,25,14,39,31,25,6,1.26,80.65,Moyen,Facile,1,Plus Facile,Adapte,Economy
4616,2019,Économie,1,L'Economie et son Domaine,1,L'Objet de la Science Economique,12,121,2,QCU,0.15,0.9,65.27,27,15,42,35,27,8,1.2,77.14,Facile,Facile,0,Meme Difficulté,Adapte,Economy
5740,2020,Économie,1,L'Economie et son Domaine,1,L'Objet de la Science Economique,12,121,2,QCU,0.08,0.93,65.27,23,13,36,35,23,12,1.03,65.71,Facile,Facile,0,Meme Difficulté,Adapte,Economy
121,2015,Économie,1,L'Economie et son Domaine,1,L'Objet de la Science Economique,12,122,3,QCM,0.75,0.17,11.61,8,60,68,60,8,52,1.13,13.33,Facile,Difficile,-2,Beaucoup plus Difficile,Pas Adapte,Economy
1245,2016,Économie,1,L'Economie et son Domaine,1,L'Objet de la Science Economique,12,122,3,QCM,0.2,0.31,45.95,29,34,63,50,29,21,1.26,58.0,Facile,Moyen,-1,Plus Difficile,Pas Adapte,Economy
2369,2017,Économie,1,L'Economie et son Domaine,1,L'Objet de la Science Economique,12,122,3,QCM,0.05,0.74,80.69,52,13,65,63,52,11,1.03,82.54,Difficile,Facile,2,Beaucoup plus Facile,Pas Adapte,Economy
3493,2018,Économie,1,L'Economie et son Domaine,1,L'Objet de la Science Economique,12,122,3,QCM,0.01,0.74,84.98,61,11,72,65,61,4,1.11,93.85,Difficile,Facile,2,Beaucoup plus Facile,Pas Adapte,Economy
4617,2019,Économie,1,L'Economie et son Domaine,1,L'Objet de la Science Economique,12,122,3,QCM,0.43,0.41,50.38,38,37,75,39,38,1,1.92,97.44,Facile,Moyen,-1,Plus Difficile,Pas Adapte,Economy
5741,2020,Économie,1,L'Economie et son Domaine,1,L'Objet de la Science Economique,12,122,3,QCM,0.26,0.42,37.45,27,46,73,39,27,12,1.87,69.23,Moyen,Moyen,0,Meme Difficulté,Pas Adapte,Economy
122,2015,Économie,1,L'Economie et son Domaine,1,L'Objet de la Science Economique,12,123,4,QCU,0.11,0.97,87.67,6,1,7,6,6,0,1.17,100.0,Difficile,Facile,2,Beaucoup plus Facile,Pas Adapte,Economy
1246,2016,Économie,1,L'Economie et son Domaine,1,L'Objet de la Science Economique,12,123,4,QCU,0.16,0.99,73.25,4,2,6,6,4,2,1.0,66.67,Difficile,Facile,2,Beaucoup plus Facile,Adapte,Economy
2370,2017,Économie,1,L'Economie et son Domaine,1,L'Objet de la Science Economique,12,123,4,QCU,0.16,0.76,73.25,5,2,7,6,5,1,1.17,83.33,Facile,Facile,0,Meme Difficulté,Adapte,Economy
3494,2018,Économie,1,L'Economie et son Domaine,1,L'Objet de la Science Economique,12,123,4,QCU,0.04,0.89,73.25,5,2,7,7,5,2,1.0,71.43,Facile,Facile,0,Meme Difficulté,Adapte,Economy
4618,2019,Économie,1,L'Economie et son Domaine,1,L'Objet de la Science Economique,12,123,4,QCU,0.01,0.76,73.25,6,2,8,8,6,2,1.0,75.0,Facile,Facile,0,Meme Difficulté,Adapte,Economy
5742,2020,Économie,1,L'Economie et son Domaine,1,L'Objet de la Science Economique,12,123,4,QCU,0.2,0.99,73.25,5,2,7,6,5,1,1.17,83.33,Facile,Facile,0,Meme Difficulté,Adapte,Economy
123,2015,Économie,1,L'Economie et son Domaine,1,L'Objet de la Science Economique,12,124,5,QCU,0.25,0.44,52.63,43,39,82,78,43,35,1.05,55.13,Difficile,Moyen,1,Plus Facile,Pas Adapte,Economy
1247,2016,Économie,1,L'Economie et son Domaine,1,L'Objet de la Science Economique,12,124,5,QCU,0.15,0.79,67.38,63,30,93,83,63,20,1.12,75.9,Moyen,Facile,1,Plus Facile,Adapte,Economy
2371,2017,Économie,1,L'Economie et son Domaine,1,L'Objet de la Science Economique,12,124,5,QCM,0.14,0.77,67.38,61,29,90,84,61,23,1.07,72.62,Facile,Facile,0,Meme Difficulté,Adapte,Economy
3495,2018,Économie,1,L'Economie et son Domaine,1,L'Objet de la Science Economique,12,124,5,QCM,0.03,0.87,67.38,59,28,87,83,59,24,1.05,71.08,Facile,Facile,0,Meme Difficulté,Adapte,Economy
4619,2019,Économie,1,L'Economie et son Domaine,1,L'Objet de la Science Economique,12,124,5,QCU,0.1,0.98,67.38,55,27,82,58,55,3,1.41,94.83,Facile,Facile,0,Meme Difficulté,Adapte,Economy
5743,2020,Économie,1,L'Economie et son Domaine,1,L'Objet de la Science Economique,12,124,5,QCU,0.04,0.89,67.38,47,23,70,67,47,20,1.04,70.15,Facile,Facile,0,Meme Difficulté,Adapte,Economy
124,2015,Économie,1,L'Economie et son Domaine,1,L'Objet de la Science Economique,12,125,6,QCU,0.25,0.46,54.21,5,4,9,6,5,1,1.5,83.33,Difficile,Moyen,1,Plus Facile,Pas Adapte,Economy
1248,2016,Économie,1,L'Economie et son Domaine,1,L'Objet de la Science Economique,12,125,6,QCM,0.42,0.38,54.33,4,4,8,7,4,3,1.14,57.14,Facile,Moyen,-1,Plus Difficile,Pas Adapte,Economy
2372,2017,Économie,1,L'Economie et son Domaine,1,L'Objet de la Science Economique,12,125,6,QCM,0.77,0.28,2.44,0,8,8,6,0,6,1.33,0.0,Difficile,Difficile,0,Meme Difficulté,Pas Adapte,Economy
3496,2018,Économie,1,L'Economie et son Domaine,1,L'Objet de la Science Economique,12,125,6,QCM,0.65,0.23,29.55,3,6,9,5,3,2,1.8,60.0,Moyen,Difficile,-1,Plus Difficile,Pas Adapte,Economy
4620,2019,Économie,1,L'Economie et son Domaine,1,L'Objet de la Science Economique,12,125,6,QCM,0.7,0.22,3.27,0,8,8,6,0,6,1.33,0.0,Facile,Difficile,-2,Beaucoup plus Difficile,Pas Adapte,Economy
5744,2020,Économie,1,L'Economie et son Domaine,1,L'Objet de la Science Economique,12,125,6,QCM,0.13,0.79,90.98,8,1,9,9,8,1,1.0,88.89,Difficile,Facile,2,Beaucoup plus Facile,Pas Adapte,Economy
125,2015,Économie,1,L'Economie et son Domaine,1,L'Objet de la Science Economique,12,126,7,QCU,0.14,0.98,89.32,8,1,9,9,8,1,1.0,88.89,Facile,Facile,0,Meme Difficulté,Pas Adapte,Economy
1249,2016,Économie,1,L'Economie et son Domaine,1,L'Objet de la Science Economique,12,126,7,QO,0.09,0.39,80.5,6,2,8,6,6,0,1.33,100.0,Facile,Facile,0,Meme Difficulté,Pas Adapte,Economy
2373,2017,Économie,1,L'Economie et son Domaine,1,L'Objet de la Science Economique,12,126,7,QO,0.23,0.16,42.25,3,5,8,7,3,4,1.14,42.86,Moyen,Moyen,0,Meme Difficulté,Pas Adapte,Economy
3497,2018,Économie,1,L'Economie et son Domaine,1,L'Objet de la Science Economique,12,126,7,QROC,0.57,0.37,56.06,4,4,8,6,4,2,1.33,66.67,Difficile,Moyen,1,Plus Facile,Pas Adapte,Economy
4621,2019,Économie,1,L'Economie et son Domaine,1,L'Objet de la Science Economique,12,126,7,QROC,0.82,0.05,11.58,1,8,9,5,1,4,1.8,20.0,Difficile,Difficile,0,Meme Difficulté,Pas Adapte,Economy
5745,2020,Économie,1,L'Economie et son Domaine,1,L'Objet de la Science Economique,12,126,7,QROC,0.78,0.07,11.73,1,9,10,5,1,4,2.0,20.0,Difficile,Difficile,0,Meme Difficulté,Pas Adapte,Economy
126,2015,Économie,1,L'Economie et son Domaine,1,L'Objet de la Science Economique,12,127,8,QCU,0.09,0.89,93.71,22,2,24,23,22,1,1.04,95.65,Moyen,Facile,1,Plus Facile,Pas Adapte,Economy
1250,2016,Économie,1,L'Economie et son Domaine,1,L'Objet de la Science Economique,12,127,8,QCU,0.06,0.9,93.34,22,2,24,22,22,0,1.09,100.0,Moyen,Facile,1,Plus Facile,Pas Adapte,Economy
2374,2017,Économie,1,L'Economie et son Domaine,1,L'Objet de la Science Economique,12,127,8,QCU,0.14,0.8,84.28,22,4,26,23,22,1,1.13,95.65,Facile,Facile,0,Meme Difficulté,Pas Adapte,Economy
3498,2018,Économie,1,L'Economie et son Domaine,1,L'Objet de la Science Economique,12,127,8,QCM,0.3,0.38,42.96,12,15,27,14,12,2,1.93,85.71,Facile,Moyen,-1,Plus Difficile,Pas Adapte,Economy
4622,2019,Économie,1,L'Economie et son Domaine,1,L'Objet de la Science Economique,12,127,8,QCM,0.22,0.3,57.02,14,11,25,24,14,10,1.04,58.33,Moyen,Moyen,0,Meme Difficulté,Pas Adapte,Economy
5746,2020,Économie,1,L'Economie et son Domaine,1,L'Objet de la Science Economique,12,127,8,QCM,0.07,0.99,85.55,21,3,24,22,21,1,1.09,95.45,Difficile,Facile,2,Beaucoup plus Facile,Pas Adapte,Economy
127,2015,Économie,1,L'Economie et son Domaine,1,L'Objet de la Science Economique,12,128,9,QCM,0.67,0.2,11.6,4,33,37,17,4,13,2.18,23.53,Moyen,Difficile,-1,Plus Difficile,Pas Adapte,Economy
1251,2016,Économie,1,L'Economie et son Domaine,1,L'Objet de la Science Economique,12,128,9,QCM,0.44,0.4,42.06,17,23,40,29,17,12,1.38,58.62,Difficile,Moyen,1,Plus Facile,Pas Adapte,Economy
2375,2017,Économie,1,L'Economie et son Domaine,1,L'Objet de la Science Economique,12,128,9,QROC,0.43,0.33,62.7,22,13,35,24,22,2,1.46,91.67,Moyen,Moyen,0,Meme Difficulté,Adapte,Economy
3499,2018,Économie,1,L'Economie et son Domaine,1,L'Objet de la Science Economique,12,128,9,QROC,0.59,0.28,62.7,23,14,37,25,23,2,1.48,92.0,Moyen,Moyen,0,Meme Difficulté,Adapte,Economy
4623,2019,Économie,1,L'Economie et son Domaine,1,L'Objet de la Science Economique,12,128,9,QROC,0.42,0.38,62.7,22,13,35,25,22,3,1.4,88.0,Moyen,Moyen,0,Meme Difficulté,Adapte,Economy
5747,2020,Économie,1,L'Economie et son Domaine,1,L'Objet de la Science Economique,12,128,9,QROC,0.41,0.3,62.7,23,14,37,32,23,9,1.16,71.88,Moyen,Moyen,0,Meme Difficulté,Adapte,Economy
128,2015,Économie,1,L'Economie et son Domaine,1,L'Objet de la Science Economique,12,129,10,QCU,0.63,0.31,12.35,4,32,36,19,4,15,1.89,21.05,Difficile,Difficile,0,Meme Difficulté,Pas Adapte,Economy
1252,2016,Économie,1,L'Economie et son Domaine,1,L'Objet de la Science Economique,12,129,10,QCU,0.49,0.22,18.13,6,28,34,12,6,6,2.83,50.0,Difficile,Difficile,0,Meme Difficulté,Pas Adapte,Economy
2376,2017,Économie,1,L'Economie et son Domaine,1,L'Objet de la Science Economique,12,129,10,QCU,0.62,0.29,15.26,6,31,37,27,6,21,1.37,22.22,Moyen,Difficile,-1,Plus Difficile,Pas Adapte,Economy
3500,2018,Économie,1,L'Economie et son Domaine,1,L'Objet de la Science Economique,12,129,10,QCU,0.4,0.23,5.64,2,41,43,22,2,20,1.95,9.09,Facile,Difficile,-2,Beaucoup plus Difficile,Pas Adapte,Economy
4624,2019,Économie,1,L'Economie et son Domaine,1,L'Objet de la Science Economique,12,129,10,QCU,0.34,0.47,42.3,17,24,41,30,17,13,1.37,56.67,Difficile,Moyen,1,Plus Facile,Pas Adapte,Economy
5748,2020,Économie,1,L'Economie et son Domaine,1,L'Objet de la Science Economique,12,129,10,QCU,0.56,0.35,26.06,11,30,41,24,11,13,1.71,45.83,Facile,Difficile,-2,Beaucoup plus Difficile,Pas Adapte,Economy
129,2015,Économie,1,L'Economie et son Domaine,1,L'Objet de la Science Economique,12,130,11,QCU,0.14,0.83,66.48,64,33,97,96,64,32,1.01,66.67,Facile,Facile,0,Meme Difficulté,Adapte,Economy
1253,2016,Économie,1,L'Economie et son Domaine,1,L'Objet de la Science Economique,12,130,11,QCU,0.19,0.99,66.48,64,33,97,68,64,4,1.43,94.12,Facile,Facile,0,Meme Difficulté,Adapte,Economy
2377,2017,Économie,1,L'Economie et son Domaine,1,L'Objet de la Science Economique,12,130,11,QCU,0.16,0.97,66.48,61,31,92,85,61,24,1.08,71.76,Facile,Facile,0,Meme Difficulté,Adapte,Economy
3501,2018,Économie,1,L'Economie et son Domaine,1,L'Objet de la Science Economique,12,130,11,QCU,0.03,0.89,66.48,63,32,95,88,63,25,1.08,71.59,Facile,Facile,0,Meme Difficulté,Adapte,Economy
4625,2019,Économie,1,L'Economie et son Domaine,1,L'Objet de la Science Economique,12,130,11,QCU,0.01,0.85,66.48,59,30,89,60,59,1,1.48,98.33,Facile,Facile,0,Meme Difficulté,Adapte,Economy
5749,2020,Économie,1,L'Economie et son Domaine,1,L'Objet de la Science Economique,12,130,11,QCU,0.08,0.97,66.48,55,28,83,68,55,13,1.22,80.88,Facile,Facile,0,Meme Difficulté,Adapte,Economy
130,2015,Économie,1,L'Economie et son Domaine,1,L'Objet de la Science Economique,12,131,12,QCU,0.16,0.98,70.06,64,28,92,71,64,7,1.3,90.14,Difficile,Facile,2,Beaucoup plus Facile,Adapte,Economy
1254,2016,Économie,1,L'Economie et son Domaine,1,L'Objet de la Science Economique,12,131,12,QCU,0.07,0.77,70.06,55,23,78,71,55,16,1.1,77.46,Facile,Facile,0,Meme Difficulté,Adapte,Economy
2378,2017,Économie,1,L'Economie et son Domaine,1,L'Objet de la Science Economique,12,131,12,QCM,0.08,0.77,70.06,62,26,88,62,62,0,1.42,100.0,Facile,Facile,0,Meme Difficulté,Adapte,Economy
3502,2018,Économie,1,L'Economie et son Domaine,1,L'Objet de la Science Economique,12,131,12,QCM,0.05,0.84,70.06,55,24,79,57,55,2,1.39,96.49,Facile,Facile,0,Meme Difficulté,Adapte,Economy
4626,2019,Économie,1,L'Economie et son Domaine,1,L'Objet de la Science Economique,12,131,12,QCU,0.19,0.77,70.06,55,23,78,61,55,6,1.28,90.16,Facile,Facile,0,Meme Difficulté,Adapte,Economy
5750,2020,Économie,1,L'Economie et son Domaine,1,L'Objet de la Science Economique,12,131,12,QCU,0.02,0.89,70.06,55,24,79,74,55,19,1.07,74.32,Facile,Facile,0,Meme Difficulté,Adapte,Economy
131,2015,Économie,1,L'Economie et son Domaine,2,Les Grands Courants de la Pensee Economique,12,132,1,QROC,0.09,0.68,94.96,26,1,27,27,26,1,1.0,96.3,Facile,Facile,0,Meme Difficulté,Pas Adapte,Economy
1255,2016,Économie,1,L'Economie et son Domaine,2,Les Grands Courants de la Pensee Economique,12,132,1,QROC,0.96,0.04,10.57,3,27,30,17,3,14,1.76,17.65,Moyen,Difficile,-1,Plus Difficile,Pas Adapte,Economy
2379,2017,Économie,1,L'Economie et son Domaine,2,Les Grands Courants de la Pensee Economique,12,132,1,QROC,0.03,0.64,68.72,23,10,33,29,23,6,1.14,79.31,Facile,Facile,0,Meme Difficulté,Adapte,Economy
3503,2018,Économie,1,L'Economie et son Domaine,2,Les Grands Courants de la Pensee Economique,12,132,1,QROC,0.07,0.8,68.72,26,12,38,37,26,11,1.03,70.27,Facile,Facile,0,Meme Difficulté,Adapte,Economy
4627,2019,Économie,1,L'Economie et son Domaine,2,Les Grands Courants de la Pensee Economique,12,132,1,QO,0.19,0.94,68.72,28,13,41,31,28,3,1.32,90.32,Facile,Facile,0,Meme Difficulté,Adapte,Economy
5751,2020,Économie,1,L'Economie et son Domaine,2,Les Grands Courants de la Pensee Economique,12,132,1,QO,0.03,0.38,68.72,31,14,45,45,31,14,1.0,68.89,Facile,Facile,0,Meme Difficulté,Adapte,Economy
132,2015,Économie,1,L'Economie et son Domaine,2,Les Grands Courants de la Pensee Economique,12,133,2,QCU,0.11,0.89,65.02,52,28,80,66,52,14,1.21,78.79,Facile,Facile,0,Meme Difficulté,Adapte,Economy
1256,2016,Économie,1,L'Economie et son Domaine,2,Les Grands Courants de la Pensee Economique,12,133,2,QCU,0.08,0.84,65.02,47,26,73,70,47,23,1.04,67.14,Facile,Facile,0,Meme Difficulté,Adapte,Economy
2380,2017,Économie,1,L'Economie et son Domaine,2,Les Grands Courants de la Pensee Economique,12,133,2,QCU,0.13,0.89,65.02,44,24,68,63,44,19,1.08,69.84,Facile,Facile,0,Meme Difficulté,Adapte,Economy
3504,2018,Économie,1,L'Economie et son Domaine,2,Les Grands Courants de la Pensee Economique,12,133,2,QCU,0.07,0.85,65.02,50,27,77,65,50,15,1.18,76.92,Facile,Facile,0,Meme Difficulté,Adapte,Economy
4628,2019,Économie,1,L'Economie et son Domaine,2,Les Grands Courants de la Pensee Economique,12,133,2,QCU,0.2,0.96,65.02,42,23,65,54,42,12,1.2,77.78,Facile,Facile,0,Meme Difficulté,Adapte,Economy
5752,2020,Économie,1,L'Economie et son Domaine,2,Les Grands Courants de la Pensee Economique,12,133,2,QCM,0.13,0.73,65.02,42,22,64,50,42,8,1.28,84.0,Facile,Facile,0,Meme Difficulté,Adapte,Economy
133,2015,Économie,1,L'Economie et son Domaine,2,Les Grands Courants de la Pensee Economique,12,134,3,QCU,0.11,0.85,94.41,78,5,83,80,78,2,1.04,97.5,Difficile,Facile,2,Beaucoup plus Facile,Pas Adapte,Economy
1257,2016,Économie,1,L'Economie et son Domaine,2,Les Grands Courants de la Pensee Economique,12,134,3,QCM,0.01,0.77,71.46,52,21,73,58,52,6,1.26,89.66,Difficile,Facile,2,Beaucoup plus Facile,Adapte,Economy
2381,2017,Économie,1,L'Economie et son Domaine,2,Les Grands Courants de la Pensee Economique,12,134,3,QCM,0.17,0.89,71.46,44,18,62,61,44,17,1.02,72.13,Facile,Facile,0,Meme Difficulté,Adapte,Economy
3505,2018,Économie,1,L'Economie et son Domaine,2,Les Grands Courants de la Pensee Economique,12,134,3,QCM,0.11,0.79,71.46,43,17,60,59,43,16,1.02,72.88,Facile,Facile,0,Meme Difficulté,Adapte,Economy
4629,2019,Économie,1,L'Economie et son Domaine,2,Les Grands Courants de la Pensee Economique,12,134,3,QCM,0.07,0.71,71.46,40,16,56,42,40,2,1.33,95.24,Facile,Facile,0,Meme Difficulté,Adapte,Economy
5753,2020,Économie,1,L'Economie et son Domaine,2,Les Grands Courants de la Pensee Economique,12,134,3,QCU,0.06,0.94,71.46,36,14,50,39,36,3,1.28,92.31,Facile,Facile,0,Meme Difficulté,Adapte,Economy
134,2015,Économie,1,L'Economie et son Domaine,2,Les Grands Courants de la Pensee Economique,12,135,4,QCM,0.39,0.33,54.01,35,30,65,41,35,6,1.59,85.37,Facile,Moyen,-1,Plus Difficile,Pas Adapte,Economy
1258,2016,Économie,1,L'Economie et son Domaine,2,Les Grands Courants de la Pensee Economique,12,135,4,QCM,0.51,0.2,9.84,7,63,70,53,7,46,1.32,13.21,Facile,Difficile,-2,Beaucoup plus Difficile,Pas Adapte,Economy
2382,2017,Économie,1,L'Economie et son Domaine,2,Les Grands Courants de la Pensee Economique,12,135,4,QCM,0.25,0.68,62.21,37,23,60,53,37,16,1.13,69.81,Moyen,Moyen,0,Meme Difficulté,Adapte,Economy
3506,2018,Économie,1,L'Economie et son Domaine,2,Les Grands Courants de la Pensee Economique,12,135,4,QCM,0.47,0.54,62.21,42,26,68,44,42,2,1.55,95.45,Moyen,Moyen,0,Meme Difficulté,Adapte,Economy
4630,2019,Économie,1,L'Economie et son Domaine,2,Les Grands Courants de la Pensee Economique,12,135,4,QCM,0.36,0.3,62.21,39,24,63,63,39,24,1.0,61.9,Moyen,Moyen,0,Meme Difficulté,Adapte,Economy
5754,2020,Économie,1,L'Economie et son Domaine,2,Les Grands Courants de la Pensee Economique,12,135,4,QCM,0.49,0.38,62.21,36,22,58,48,36,12,1.21,75.0,Moyen,Moyen,0,Meme Difficulté,Adapte,Economy
135,2015,Économie,1,L'Economie et son Domaine,2,Les Grands Courants de la Pensee Economique,12,136,5,QCM,0.75,0.24,29.41,17,42,59,31,17,14,1.9,54.84,Difficile,Difficile,0,Meme Difficulté,Pas Adapte,Economy
1259,2016,Économie,1,L'Economie et son Domaine,2,Les Grands Courants de la Pensee Economique,12,136,5,QCM,0.3,0.6,39.59,24,36,60,41,24,17,1.46,58.54,Facile,Moyen,-1,Plus Difficile,Pas Adapte,Economy
2383,2017,Économie,1,L'Economie et son Domaine,2,Les Grands Courants de la Pensee Economique,12,136,5,QCM,0.49,0.61,50.56,28,28,56,53,28,25,1.06,52.83,Facile,Moyen,-1,Plus Difficile,Pas Adapte,Economy
3507,2018,Économie,1,L'Economie et son Domaine,2,Les Grands Courants de la Pensee Economique,12,136,5,QCM,0.08,0.96,92.5,53,4,57,54,53,1,1.06,98.15,Moyen,Facile,1,Plus Facile,Pas Adapte,Economy
4631,2019,Économie,1,L'Economie et son Domaine,2,Les Grands Courants de la Pensee Economique,12,136,5,QCM,0.33,0.37,61.28,33,21,54,38,33,5,1.42,86.84,Difficile,Moyen,1,Plus Facile,Adapte,Economy
5755,2020,Économie,1,L'Economie et son Domaine,2,Les Grands Courants de la Pensee Economique,12,136,5,QCM,0.37,0.56,61.28,34,22,56,38,34,4,1.47,89.47,Moyen,Moyen,0,Meme Difficulté,Adapte,Economy
136,2015,Économie,1,L'Economie et son Domaine,2,Les Grands Courants de la Pensee Economique,12,137,6,QCM,0.52,0.16,27.27,19,52,71,38,19,19,1.87,50.0,Facile,Difficile,-2,Beaucoup plus Difficile,Pas Adapte,Economy
1260,2016,Économie,1,L'Economie et son Domaine,2,Les Grands Courants de la Pensee Economique,12,137,6,QCM,0.76,0.23,13.17,10,66,76,69,10,59,1.1,14.49,Facile,Difficile,-2,Beaucoup plus Difficile,Pas Adapte,Economy
2384,2017,Économie,1,L'Economie et son Domaine,2,Les Grands Courants de la Pensee Economique,12,137,6,QCM,0.65,0.22,1.66,1,71,72,56,1,55,1.29,1.79,Facile,Difficile,-2,Beaucoup plus Difficile,Pas Adapte,Economy
3508,2018,Économie,1,L'Economie et son Domaine,2,Les Grands Courants de la Pensee Economique,12,137,6,QROC,0.99,0.23,0.05,0,80,80,56,0,56,1.43,0.0,Facile,Difficile,-2,Beaucoup plus Difficile,Pas Adapte,Economy
4632,2019,Économie,1,L'Economie et son Domaine,2,Les Grands Courants de la Pensee Economique,12,137,6,QROC,0.18,0.46,67.09,55,27,82,81,55,26,1.01,67.9,Difficile,Facile,2,Beaucoup plus Facile,Adapte,Economy
5756,2020,Économie,1,L'Economie et son Domaine,2,Les Grands Courants de la Pensee Economique,12,137,6,QROC,0.04,0.62,67.09,52,25,77,62,52,10,1.24,83.87,Facile,Facile,0,Meme Difficulté,Adapte,Economy
137,2015,Économie,1,L'Economie et son Domaine,2,Les Grands Courants de la Pensee Economique,12,138,7,QO,0.33,0.3,52.83,5,4,9,6,5,1,1.5,83.33,Facile,Moyen,-1,Plus Difficile,Pas Adapte,Economy
1261,2016,Économie,1,L'Economie et son Domaine,2,Les Grands Courants de la Pensee Economique,12,138,7,QROC,0.04,0.49,82.65,8,2,10,9,8,1,1.11,88.89,Difficile,Facile,2,Beaucoup plus Facile,Pas Adapte,Economy
2385,2017,Économie,1,L'Economie et son Domaine,2,Les Grands Courants de la Pensee Economique,12,138,7,QROC,0.35,0.35,35.22,3,6,9,7,3,4,1.29,42.86,Difficile,Moyen,1,Plus Facile,Pas Adapte,Economy
3509,2018,Économie,1,L'Economie et son Domaine,2,Les Grands Courants de la Pensee Economique,12,138,7,QROC,0.19,0.82,77.29,8,2,10,10,8,2,1.0,80.0,Difficile,Facile,2,Beaucoup plus Facile,Pas Adapte,Economy
4633,2019,Économie,1,L'Economie et son Domaine,2,Les Grands Courants de la Pensee Economique,12,138,7,QROC,0.44,0.32,42.08,4,5,9,8,4,4,1.12,50.0,Facile,Moyen,-1,Plus Difficile,Pas Adapte,Economy
5757,2020,Économie,1,L'Economie et son Domaine,2,Les Grands Courants de la Pensee Economique,12,138,7,QROC,0.64,0.08,0.69,0,10,10,7,0,7,1.43,0.0,Facile,Difficile,-2,Beaucoup plus Difficile,Pas Adapte,Economy
138,2015,Économie,1,L'Economie et son Domaine,2,Les Grands Courants de la Pensee Economique,12,139,8,QROC,0.72,0.19,18.24,9,38,47,19,9,10,2.47,47.37,Facile,Difficile,-2,Beaucoup plus Difficile,Pas Adapte,Economy
1262,2016,Économie,1,L'Economie et son Domaine,2,Les Grands Courants de la Pensee Economique,12,139,8,QROC,0.28,0.33,64.46,28,16,44,42,28,14,1.05,66.67,Facile,Moyen,-1,Plus Difficile,Adapte,Economy
2386,2017,Économie,1,L'Economie et son Domaine,2,Les Grands Courants de la Pensee Economique,12,139,8,QROC,0.27,0.27,64.46,24,13,37,37,24,13,1.0,64.86,Moyen,Moyen,0,Meme Difficulté,Adapte,Economy
3510,2018,Économie,1,L'Economie et son Domaine,2,Les Grands Courants de la Pensee Economique,12,139,8,QROC,0.42,0.3,64.46,26,15,41,27,26,1,1.52,96.3,Moyen,Moyen,0,Meme Difficulté,Adapte,Economy
4634,2019,Économie,1,L'Economie et son Domaine,2,Les Grands Courants de la Pensee Economique,12,139,8,QROC,0.33,0.29,64.46,26,15,41,40,26,14,1.02,65.0,Moyen,Moyen,0,Meme Difficulté,Adapte,Economy
5758,2020,Économie,1,L'Economie et son Domaine,2,Les Grands Courants de la Pensee Economique,12,139,8,QROC,0.56,0.28,64.46,27,15,42,41,27,14,1.02,65.85,Moyen,Moyen,0,Meme Difficulté,Adapte,Economy
139,2015,Économie,1,L'Economie et son Domaine,2,Les Grands Courants de la Pensee Economique,12,140,9,QCM,0.1,0.96,96.17,40,2,42,40,40,0,1.05,100.0,Facile,Facile,0,Meme Difficulté,Pas Adapte,Economy
1263,2016,Économie,1,L'Economie et son Domaine,2,Les Grands Courants de la Pensee Economique,12,140,9,QCM,0.08,0.7,86.73,40,6,46,44,40,4,1.05,90.91,Facile,Facile,0,Meme Difficulté,Pas Adapte,Economy
2387,2017,Économie,1,L'Economie et son Domaine,2,Les Grands Courants de la Pensee Economique,12,140,9,QCM,0.78,0.27,28.07,13,33,46,45,13,32,1.02,28.89,Moyen,Difficile,-1,Plus Difficile,Pas Adapte,Economy
3511,2018,Économie,1,L'Economie et son Domaine,2,Les Grands Courants de la Pensee Economique,12,140,9,QCM,0.77,0.29,33.48,15,31,46,29,15,14,1.59,51.72,Moyen,Difficile,-1,Plus Difficile,Pas Adapte,Economy
4635,2019,Économie,1,L'Economie et son Domaine,2,Les Grands Courants de la Pensee Economique,12,140,9,QCM,0.07,0.74,90.86,44,4,48,47,44,3,1.02,93.62,Difficile,Facile,2,Beaucoup plus Facile,Pas Adapte,Economy
5759,2020,Économie,1,L'Economie et son Domaine,2,Les Grands Courants de la Pensee Economique,12,140,9,QCU,0.5,0.34,20.02,10,40,50,44,10,34,1.14,22.73,Moyen,Difficile,-1,Plus Difficile,Pas Adapte,Economy
140,2015,Économie,1,L'Economie et son Domaine,2,Les Grands Courants de la Pensee Economique,12,141,10,QROC,0.65,0.06,9.49,2,19,21,15,2,13,1.4,13.33,Difficile,Difficile,0,Meme Difficulté,Pas Adapte,Economy
1264,2016,Économie,1,L'Economie et son Domaine,2,Les Grands Courants de la Pensee Economique,12,141,10,QROC,0.06,0.96,94.11,21,1,22,22,21,1,1.0,95.45,Facile,Facile,0,Meme Difficulté,Pas Adapte,Economy
2388,2017,Économie,1,L'Economie et son Domaine,2,Les Grands Courants de la Pensee Economique,12,141,10,QROC,0.42,0.39,59.44,15,10,25,19,15,4,1.32,78.95,Moyen,Moyen,0,Meme Difficulté,Pas Adapte,Economy
3512,2018,Économie,1,L'Economie et son Domaine,2,Les Grands Courants de la Pensee Economique,12,141,10,QCM,0.44,0.66,48.1,13,14,27,21,13,8,1.29,61.9,Difficile,Moyen,1,Plus Facile,Pas Adapte,Economy
4636,2019,Économie,1,L'Economie et son Domaine,2,Les Grands Courants de la Pensee Economique,12,141,10,QCM,0.41,0.63,43.4,10,13,23,16,10,6,1.44,62.5,Moyen,Moyen,0,Meme Difficulté,Pas Adapte,Economy
5760,2020,Économie,1,L'Economie et son Domaine,2,Les Grands Courants de la Pensee Economique,12,141,10,QCM,0.55,0.17,22.34,4,16,20,17,4,13,1.18,23.53,Difficile,Difficile,0,Meme Difficulté,Pas Adapte,Economy
141,2015,Économie,1,L'Economie et son Domaine,2,Les Grands Courants de la Pensee Economique,12,142,11,QCU,0.26,0.47,64.12,17,10,27,20,17,3,1.35,85.0,Moyen,Moyen,0,Meme Difficulté,Adapte,Economy
1265,2016,Économie,1,L'Economie et son Domaine,2,Les Grands Courants de la Pensee Economique,12,142,11,QROC,0.54,0.39,64.12,20,11,31,23,20,3,1.35,86.96,Moyen,Moyen,0,Meme Difficulté,Adapte,Economy
2389,2017,Économie,1,L'Economie et son Domaine,2,Les Grands Courants de la Pensee Economique,12,142,11,QROC,0.33,0.38,64.12,22,12,34,26,22,4,1.31,84.62,Moyen,Moyen,0,Meme Difficulté,Adapte,Economy
3513,2018,Économie,1,L'Economie et son Domaine,2,Les Grands Courants de la Pensee Economique,12,142,11,QROC,0.21,0.26,64.12,22,13,35,23,22,1,1.52,95.65,Moyen,Moyen,0,Meme Difficulté,Adapte,Economy
4637,2019,Économie,1,L'Economie et son Domaine,2,Les Grands Courants de la Pensee Economique,12,142,11,QROC,0.3,0.39,64.12,21,12,33,33,21,12,1.0,63.64,Moyen,Moyen,0,Meme Difficulté,Adapte,Economy
5761,2020,Économie,1,L'Economie et son Domaine,2,Les Grands Courants de la Pensee Economique,12,142,11,QROC,0.34,0.32,64.12,22,12,34,31,22,9,1.1,70.97,Moyen,Moyen,0,Meme Difficulté,Adapte,Economy
142,2015,Économie,1,L'Economie et son Domaine,2,Les Grands Courants de la Pensee Economique,12,143,12,QCM,0.72,0.2,29.87,3,6,9,4,3,1,2.25,75.0,Difficile,Difficile,0,Meme Difficulté,Pas Adapte,Economy
1266,2016,Économie,1,L'Economie et son Domaine,2,Les Grands Courants de la Pensee Economique,12,143,12,QCM,0.06,0.91,94.63,9,1,10,10,9,1,1.0,90.0,Difficile,Facile,2,Beaucoup plus Facile,Pas Adapte,Economy
2390,2017,Économie,1,L'Economie et son Domaine,2,Les Grands Courants de la Pensee Economique,12,143,12,QCM,0.72,0.23,25.27,2,6,8,3,2,1,2.67,66.67,Moyen,Difficile,-1,Plus Difficile,Pas Adapte,Economy
3514,2018,Économie,1,L'Economie et son Domaine,2,Les Grands Courants de la Pensee Economique,12,143,12,QCM,0.12,0.89,76.76,5,2,7,7,5,2,1.0,71.43,Moyen,Facile,1,Plus Facile,Pas Adapte,Economy
4638,2019,Économie,1,L'Economie et son Domaine,2,Les Grands Courants de la Pensee Economique,12,143,12,QCM,0.04,0.91,74.01,5,2,7,6,5,1,1.17,83.33,Facile,Facile,0,Meme Difficulté,Adapte,Economy
5762,2020,Économie,1,L'Economie et son Domaine,2,Les Grands Courants de la Pensee Economique,12,143,12,QCM,0.1,0.89,74.01,5,2,7,6,5,1,1.17,83.33,Facile,Facile,0,Meme Difficulté,Adapte,Economy
143,2015,Économie,1,L'Economie et son Domaine,3,Modele d'Organisation de la Societe et Systeme Economique,6,144,1,QCM,0.09,0.84,74.08,6,2,8,7,6,1,1.14,85.71,Difficile,Facile,2,Beaucoup plus Facile,Adapte,Economy
1267,2016,Économie,1,L'Economie et son Domaine,3,Modele d'Organisation de la Societe et Systeme Economique,6,144,1,QCM,0.01,0.82,74.08,5,2,7,5,5,0,1.4,100.0,Facile,Facile,0,Meme Difficulté,Adapte,Economy
2391,2017,Économie,1,L'Economie et son Domaine,3,Modele d'Organisation de la Societe et Systeme Economique,6,144,1,QCM,0.13,0.91,74.08,6,2,8,7,6,1,1.14,85.71,Facile,Facile,0,Meme Difficulté,Adapte,Economy
3515,2018,Économie,1,L'Economie et son Domaine,3,Modele d'Organisation de la Societe et Systeme Economique,6,144,1,QCU,0.19,0.85,74.08,6,2,8,6,6,0,1.33,100.0,Facile,Facile,0,Meme Difficulté,Adapte,Economy
4639,2019,Économie,1,L'Economie et son Domaine,3,Modele d'Organisation de la Societe et Systeme Economique,6,144,1,QCU,0.12,0.99,74.08,5,2,7,7,5,2,1.0,71.43,Facile,Facile,0,Meme Difficulté,Adapte,Economy
5763,2020,Économie,1,L'Economie et son Domaine,3,Modele d'Organisation de la Societe et Systeme Economique,6,144,1,QCU,0.01,0.91,74.08,4,2,6,5,4,1,1.2,80.0,Facile,Facile,0,Meme Difficulté,Adapte,Economy
144,2015,Économie,1,L'Economie et son Domaine,3,Modele d'Organisation de la Societe et Systeme Economique,6,145,2,QCU,0.55,0.28,14.38,14,82,96,68,14,54,1.41,20.59,Moyen,Difficile,-1,Plus Difficile,Pas Adapte,Economy
1268,2016,Économie,1,L'Economie et son Domaine,3,Modele d'Organisation de la Societe et Systeme Economique,6,145,2,QCU,0.26,0.71,59.84,65,43,108,66,65,1,1.64,98.48,Facile,Moyen,-1,Plus Difficile,Pas Adapte,Economy
2392,2017,Économie,1,L'Economie et son Domaine,3,Modele d'Organisation de la Societe et Systeme Economique,6,145,2,QCU,0.43,0.4,14.02,15,95,110,47,15,32,2.34,31.91,Difficile,Difficile,0,Meme Difficulté,Pas Adapte,Economy
3516,2018,Économie,1,L'Economie et son Domaine,3,Modele d'Organisation de la Societe et Systeme Economique,6,145,2,QCU,0.13,0.92,77.63,80,23,103,89,80,9,1.16,89.89,Facile,Facile,0,Meme Difficulté,Pas Adapte,Economy
4640,2019,Économie,1,L'Economie et son Domaine,3,Modele d'Organisation de la Societe et Systeme Economique,6,145,2,QCU,0.23,0.69,60.11,55,36,91,65,55,10,1.4,84.62,Facile,Moyen,-1,Plus Difficile,Adapte,Economy
5764,2020,Économie,1,L'Economie et son Domaine,3,Modele d'Organisation de la Societe et Systeme Economique,6,145,2,QCU,0.34,0.72,60.11,52,34,86,79,52,27,1.09,65.82,Moyen,Moyen,0,Meme Difficulté,Adapte,Economy
145,2015,Économie,1,L'Economie et son Domaine,3,Modele d'Organisation de la Societe et Systeme Economique,6,146,3,QCM,0.69,0.23,27.19,5,14,19,8,5,3,2.38,62.5,Difficile,Difficile,0,Meme Difficulté,Pas Adapte,Economy
1269,2016,Économie,1,L'Economie et son Domaine,3,Modele d'Organisation de la Societe et Systeme Economique,6,146,3,QCM,0.36,0.3,60.1,11,7,18,14,11,3,1.29,78.57,Moyen,Moyen,0,Meme Difficulté,Adapte,Economy
2393,2017,Économie,1,L'Economie et son Domaine,3,Modele d'Organisation de la Societe et Systeme Economique,6,146,3,QCM,0.4,0.36,60.1,11,8,19,11,11,0,1.73,100.0,Moyen,Moyen,0,Meme Difficulté,Adapte,Economy
3517,2018,Économie,1,L'Economie et son Domaine,3,Modele d'Organisation de la Societe et Systeme Economique,6,146,3,QCM,0.32,0.55,60.1,10,7,17,11,10,1,1.55,90.91,Moyen,Moyen,0,Meme Difficulté,Adapte,Economy
4641,2019,Économie,1,L'Economie et son Domaine,3,Modele d'Organisation de la Societe et Systeme Economique,6,146,3,QCM,0.29,0.43,60.1,10,6,16,14,10,4,1.14,71.43,Moyen,Moyen,0,Meme Difficulté,Adapte,Economy
5765,2020,Économie,1,L'Economie et son Domaine,3,Modele d'Organisation de la Societe et Systeme Economique,6,146,3,QCM,0.23,0.37,60.1,8,6,14,13,8,5,1.08,61.54,Moyen,Moyen,0,Meme Difficulté,Adapte,Economy
146,2015,Économie,1,L'Economie et son Domaine,3,Modele d'Organisation de la Societe et Systeme Economique,6,147,4,QROC,0.37,0.31,49.23,32,32,64,37,32,5,1.73,86.49,Difficile,Moyen,1,Plus Facile,Pas Adapte,Economy
1270,2016,Économie,1,L'Economie et son Domaine,3,Modele d'Organisation de la Societe et Systeme Economique,6,147,4,QROC,0.11,0.78,65.79,41,22,63,61,41,20,1.03,67.21,Difficile,Facile,2,Beaucoup plus Facile,Adapte,Economy
2394,2017,Économie,1,L'Economie et son Domaine,3,Modele d'Organisation de la Societe et Systeme Economique,6,147,4,QROC,0.0,0.75,65.79,42,22,64,64,42,22,1.0,65.62,Facile,Facile,0,Meme Difficulté,Adapte,Economy
3518,2018,Économie,1,L'Economie et son Domaine,3,Modele d'Organisation de la Societe et Systeme Economique,6,147,4,QROC,0.02,0.63,65.79,36,19,55,46,36,10,1.2,78.26,Facile,Facile,0,Meme Difficulté,Adapte,Economy
4642,2019,Économie,1,L'Economie et son Domaine,3,Modele d'Organisation de la Societe et Systeme Economique,6,147,4,QROC,0.16,0.86,65.79,38,20,58,38,38,0,1.53,100.0,Facile,Facile,0,Meme Difficulté,Adapte,Economy
5766,2020,Économie,1,L'Economie et son Domaine,3,Modele d'Organisation de la Societe et Systeme Economique,6,147,4,QROC,0.07,0.99,65.79,44,23,67,52,44,8,1.29,84.62,Facile,Facile,0,Meme Difficulté,Adapte,Economy
147,2015,Économie,1,L'Economie et son Domaine,3,Modele d'Organisation de la Societe et Systeme Economique,6,148,5,QCM,0.75,0.29,29.72,19,45,64,57,19,38,1.12,33.33,Moyen,Difficile,-1,Plus Difficile,Pas Adapte,Economy
1271,2016,Économie,1,L'Economie et son Domaine,3,Modele d'Organisation de la Societe et Systeme Economique,6,148,5,QCM,0.05,0.84,73.6,50,18,68,54,50,4,1.26,92.59,Difficile,Facile,2,Beaucoup plus Facile,Adapte,Economy
2395,2017,Économie,1,L'Economie et son Domaine,3,Modele d'Organisation de la Societe et Systeme Economique,6,148,5,QCM,0.04,0.99,73.6,53,19,72,56,53,3,1.29,94.64,Facile,Facile,0,Meme Difficulté,Adapte,Economy
3519,2018,Économie,1,L'Economie et son Domaine,3,Modele d'Organisation de la Societe et Systeme Economique,6,148,5,QCM,0.04,0.94,73.6,51,18,69,67,51,16,1.03,76.12,Facile,Facile,0,Meme Difficulté,Adapte,Economy
4643,2019,Économie,1,L'Economie et son Domaine,3,Modele d'Organisation de la Societe et Systeme Economique,6,148,5,QCM,0.1,0.74,73.6,44,16,60,47,44,3,1.28,93.62,Facile,Facile,0,Meme Difficulté,Adapte,Economy
5767,2020,Économie,1,L'Economie et son Domaine,3,Modele d'Organisation de la Societe et Systeme Economique,6,148,5,QCM,0.05,0.87,73.6,49,18,67,64,49,15,1.05,76.56,Facile,Facile,0,Meme Difficulté,Adapte,Economy
148,2015,Économie,1,L'Economie et son Domaine,3,Modele d'Organisation de la Societe et Systeme Economique,6,149,6,QCU,0.33,0.56,41.83,27,38,65,47,27,20,1.38,57.45,Moyen,Moyen,0,Meme Difficulté,Pas Adapte,Economy
1272,2016,Économie,1,L'Economie et son Domaine,3,Modele d'Organisation de la Societe et Systeme Economique,6,149,6,QCU,0.42,0.31,4.6,3,70,73,42,3,39,1.74,7.14,Moyen,Difficile,-1,Plus Difficile,Pas Adapte,Economy
2396,2017,Économie,1,L'Economie et son Domaine,3,Modele d'Organisation de la Societe et Systeme Economique,6,149,6,QCU,0.14,0.81,82.04,51,11,62,55,51,4,1.13,92.73,Difficile,Facile,2,Beaucoup plus Facile,Pas Adapte,Economy
3520,2018,Économie,1,L'Economie et son Domaine,3,Modele d'Organisation de la Societe et Systeme Economique,6,149,6,QCU,0.41,0.35,27.11,17,47,64,42,17,25,1.52,40.48,Facile,Difficile,-2,Beaucoup plus Difficile,Pas Adapte,Economy
4644,2019,Économie,1,L'Economie et son Domaine,3,Modele d'Organisation de la Societe et Systeme Economique,6,149,6,QCU,0.41,0.21,5.95,4,67,71,46,4,42,1.54,8.7,Facile,Difficile,-2,Beaucoup plus Difficile,Pas Adapte,Economy
5768,2020,Économie,1,L'Economie et son Domaine,3,Modele d'Organisation de la Societe et Systeme Economique,6,149,6,QCU,0.49,0.36,16.77,13,63,76,50,13,37,1.52,26.0,Difficile,Difficile,0,Meme Difficulté,Pas Adapte,Economy
149,2015,Économie,2,La Representation de l'Activite Economique: Le Circuit Economique,1,Les Agents Economiques et leurs Operations,6,150,1,QCM,0.27,0.5,41.45,5,6,11,7,5,2,1.57,71.43,Difficile,Moyen,1,Plus Facile,Pas Adapte,Economy
1273,2016,Économie,2,La Representation de l'Activite Economique: Le Circuit Economique,1,Les Agents Economiques et leurs Operations,6,150,1,QCM,0.58,0.29,29.39,3,8,11,6,3,3,1.83,50.0,Facile,Difficile,-2,Beaucoup plus Difficile,Pas Adapte,Economy
2397,2017,Économie,2,La Representation de l'Activite Economique: Le Circuit Economique,1,Les Agents Economiques et leurs Operations,6,150,1,QCM,0.7,0.29,26.92,3,9,12,6,3,3,2.0,50.0,Facile,Difficile,-2,Beaucoup plus Difficile,Pas Adapte,Economy
3521,2018,Économie,2,La Representation de l'Activite Economique: Le Circuit Economique,1,Les Agents Economiques et leurs Operations,6,150,1,QCM,0.24,0.46,52.24,6,5,11,11,6,5,1.0,54.55,Moyen,Moyen,0,Meme Difficulté,Pas Adapte,Economy
4645,2019,Économie,2,La Representation de l'Activite Economique: Le Circuit Economique,1,Les Agents Economiques et leurs Operations,6,150,1,QCM,0.5,0.39,35.56,5,8,13,9,5,4,1.44,55.56,Facile,Moyen,-1,Plus Difficile,Pas Adapte,Economy
5769,2020,Économie,2,La Representation de l'Activite Economique: Le Circuit Economique,1,Les Agents Economiques et leurs Operations,6,150,1,QCM,0.72,0.16,21.85,3,11,14,8,3,5,1.75,37.5,Moyen,Difficile,-1,Plus Difficile,Pas Adapte,Economy
150,2015,Économie,2,La Representation de l'Activite Economique: Le Circuit Economique,1,Les Agents Economiques et leurs Operations,6,151,2,QCM,0.15,0.88,78.9,73,20,93,78,73,5,1.19,93.59,Facile,Facile,0,Meme Difficulté,Pas Adapte,Economy
1274,2016,Économie,2,La Representation de l'Activite Economique: Le Circuit Economique,1,Les Agents Economiques et leurs Operations,6,151,2,QCM,0.18,0.83,66.81,67,33,100,99,67,32,1.01,67.68,Difficile,Facile,2,Beaucoup plus Facile,Adapte,Economy
2398,2017,Économie,2,La Representation de l'Activite Economique: Le Circuit Economique,1,Les Agents Economiques et leurs Operations,6,151,2,QCM,0.11,0.74,66.81,57,28,85,66,57,9,1.29,86.36,Facile,Facile,0,Meme Difficulté,Adapte,Economy
3522,2018,Économie,2,La Representation de l'Activite Economique: Le Circuit Economique,1,Les Agents Economiques et leurs Operations,6,151,2,QCM,0.15,0.88,66.81,49,24,73,51,49,2,1.43,96.08,Facile,Facile,0,Meme Difficulté,Adapte,Economy
4646,2019,Économie,2,La Representation de l'Activite Economique: Le Circuit Economique,1,Les Agents Economiques et leurs Operations,6,151,2,QCM,0.02,0.75,66.81,43,22,65,49,43,6,1.33,87.76,Facile,Facile,0,Meme Difficulté,Adapte,Economy
5770,2020,Économie,2,La Representation de l'Activite Economique: Le Circuit Economique,1,Les Agents Economiques et leurs Operations,6,151,2,QCM,0.02,0.78,66.81,43,21,64,61,43,18,1.05,70.49,Facile,Facile,0,Meme Difficulté,Adapte,Economy
151,2015,Économie,2,La Representation de l'Activite Economique: Le Circuit Economique,1,Les Agents Economiques et leurs Operations,6,152,3,QROC,0.51,0.3,38.04,33,55,88,68,33,35,1.29,48.53,Difficile,Moyen,1,Plus Facile,Pas Adapte,Economy
1275,2016,Économie,2,La Representation de l'Activite Economique: Le Circuit Economique,1,Les Agents Economiques et leurs Operations,6,152,3,QO,0.76,0.12,1.1,1,100,101,72,1,71,1.4,1.39,Facile,Difficile,-2,Beaucoup plus Difficile,Pas Adapte,Economy
2399,2017,Économie,2,La Representation de l'Activite Economique: Le Circuit Economique,1,Les Agents Economiques et leurs Operations,6,152,3,QROC,0.99,0.23,21.66,23,82,105,98,23,75,1.07,23.47,Facile,Difficile,-2,Beaucoup plus Difficile,Pas Adapte,Economy
3523,2018,Économie,2,La Representation de l'Activite Economique: Le Circuit Economique,1,Les Agents Economiques et leurs Operations,6,152,3,QROC,0.95,0.11,30.49,27,62,89,79,27,52,1.13,34.18,Facile,Difficile,-2,Beaucoup plus Difficile,Pas Adapte,Economy
4647,2019,Économie,2,La Representation de l'Activite Economique: Le Circuit Economique,1,Les Agents Economiques et leurs Operations,6,152,3,QCU,0.06,0.82,89.61,86,10,96,96,86,10,1.0,89.58,Moyen,Facile,1,Plus Facile,Pas Adapte,Economy
5771,2020,Économie,2,La Representation de l'Activite Economique: Le Circuit Economique,1,Les Agents Economiques et leurs Operations,6,152,3,QCU,0.55,0.26,23.23,25,82,107,52,25,27,2.06,48.08,Moyen,Difficile,-1,Plus Difficile,Pas Adapte,Economy
152,2015,Économie,2,La Representation de l'Activite Economique: Le Circuit Economique,1,Les Agents Economiques et leurs Operations,6,153,4,QCU,0.2,0.72,58.31,10,8,18,10,10,0,1.8,100.0,Difficile,Moyen,1,Plus Facile,Pas Adapte,Economy
1276,2016,Économie,2,La Representation de l'Activite Economique: Le Circuit Economique,1,Les Agents Economiques et leurs Operations,6,153,4,QCU,0.39,0.6,42.48,7,10,17,11,7,4,1.55,63.64,Facile,Moyen,-1,Plus Difficile,Pas Adapte,Economy
2400,2017,Économie,2,La Representation de l'Activite Economique: Le Circuit Economique,1,Les Agents Economiques et leurs Operations,6,153,4,QCU,0.15,0.78,70.68,14,6,20,16,14,2,1.25,87.5,Facile,Facile,0,Meme Difficulté,Adapte,Economy
3524,2018,Économie,2,La Representation de l'Activite Economique: Le Circuit Economique,1,Les Agents Economiques et leurs Operations,6,153,4,QCU,0.18,0.86,70.68,13,6,19,15,13,2,1.27,86.67,Facile,Facile,0,Meme Difficulté,Adapte,Economy
4648,2019,Économie,2,La Representation de l'Activite Economique: Le Circuit Economique,1,Les Agents Economiques et leurs Operations,6,153,4,QCM,0.02,0.7,70.68,13,6,19,17,13,4,1.12,76.47,Facile,Facile,0,Meme Difficulté,Adapte,Economy
5772,2020,Économie,2,La Representation de l'Activite Economique: Le Circuit Economique,1,Les Agents Economiques et leurs Operations,6,153,4,QCM,0.1,0.97,70.68,13,6,19,13,13,0,1.46,100.0,Facile,Facile,0,Meme Difficulté,Adapte,Economy
153,2015,Économie,2,La Representation de l'Activite Economique: Le Circuit Economique,1,Les Agents Economiques et leurs Operations,6,154,5,QCU,0.1,0.88,77.86,19,5,24,21,19,2,1.14,90.48,Difficile,Facile,2,Beaucoup plus Facile,Pas Adapte,Economy
1277,2016,Économie,2,La Representation de l'Activite Economique: Le Circuit Economique,1,Les Agents Economiques et leurs Operations,6,154,5,QCU,0.35,0.44,48.31,11,11,22,13,11,2,1.69,84.62,Facile,Moyen,-1,Plus Difficile,Pas Adapte,Economy
2401,2017,Économie,2,La Representation de l'Activite Economique: Le Circuit Economique,1,Les Agents Economiques et leurs Operations,6,154,5,QCU,0.42,0.33,9.07,2,19,21,8,2,6,2.62,25.0,Difficile,Difficile,0,Meme Difficulté,Pas Adapte,Economy
3525,2018,Économie,2,La Representation de l'Activite Economique: Le Circuit Economique,1,Les Agents Economiques et leurs Operations,6,154,5,QCU,0.28,0.41,51.45,11,10,21,14,11,3,1.5,78.57,Moyen,Moyen,0,Meme Difficulté,Pas Adapte,Economy
4649,2019,Économie,2,La Representation de l'Activite Economique: Le Circuit Economique,1,Les Agents Economiques et leurs Operations,6,154,5,QCU,0.18,0.83,90.64,21,2,23,22,21,1,1.05,95.45,Difficile,Facile,2,Beaucoup plus Facile,Pas Adapte,Economy
5773,2020,Économie,2,La Representation de l'Activite Economique: Le Circuit Economique,1,Les Agents Economiques et leurs Operations,6,154,5,QCU,0.57,0.4,7.81,2,18,20,19,2,17,1.05,10.53,Facile,Difficile,-2,Beaucoup plus Difficile,Pas Adapte,Economy
154,2015,Économie,2,La Representation de l'Activite Economique: Le Circuit Economique,1,Les Agents Economiques et leurs Operations,6,155,6,QCM,0.53,0.28,13.67,2,14,16,9,2,7,1.78,22.22,Facile,Difficile,-2,Beaucoup plus Difficile,Pas Adapte,Economy
1278,2016,Économie,2,La Representation de l'Activite Economique: Le Circuit Economique,1,Les Agents Economiques et leurs Operations,6,155,6,QCM,0.66,0.22,28.29,5,12,17,9,5,4,1.89,55.56,Difficile,Difficile,0,Meme Difficulté,Pas Adapte,Economy
2402,2017,Économie,2,La Representation de l'Activite Economique: Le Circuit Economique,1,Les Agents Economiques et leurs Operations,6,155,6,QCU,0.04,0.83,78.76,11,3,14,13,11,2,1.08,84.62,Moyen,Facile,1,Plus Facile,Pas Adapte,Economy
3526,2018,Économie,2,La Representation de l'Activite Economique: Le Circuit Economique,1,Les Agents Economiques et leurs Operations,6,155,6,QCU,0.15,0.8,68.19,9,4,13,12,9,3,1.08,75.0,Moyen,Facile,1,Plus Facile,Adapte,Economy
4650,2019,Économie,2,La Representation de l'Activite Economique: Le Circuit Economique,1,Les Agents Economiques et leurs Operations,6,155,6,QCU,0.18,0.8,68.19,10,4,14,13,10,3,1.08,76.92,Facile,Facile,0,Meme Difficulté,Adapte,Economy
5774,2020,Économie,2,La Representation de l'Activite Economique: Le Circuit Economique,1,Les Agents Economiques et leurs Operations,6,155,6,QCU,0.14,0.8,68.19,8,4,12,10,8,2,1.2,80.0,Facile,Facile,0,Meme Difficulté,Adapte,Economy
155,2015,Économie,2,La Representation de l'Activite Economique: Le Circuit Economique,2,Le Circuit Economique dans le Cadre National,11,156,1,QCM,0.39,0.56,48.27,17,19,36,20,17,3,1.8,85.0,Facile,Moyen,-1,Plus Difficile,Pas Adapte,Economy
1279,2016,Économie,2,La Representation de l'Activite Economique: Le Circuit Economique,2,Le Circuit Economique dans le Cadre National,11,156,1,QCM,0.2,0.98,95.01,38,2,40,38,38,0,1.05,100.0,Facile,Facile,0,Meme Difficulté,Pas Adapte,Economy
2403,2017,Économie,2,La Representation de l'Activite Economique: Le Circuit Economique,2,Le Circuit Economique dans le Cadre National,11,156,1,QCM,0.63,0.17,10.59,4,35,39,29,4,25,1.34,13.79,Moyen,Difficile,-1,Plus Difficile,Pas Adapte,Economy
3527,2018,Économie,2,La Representation de l'Activite Economique: Le Circuit Economique,2,Le Circuit Economique dans le Cadre National,11,156,1,QCM,0.27,0.44,46.93,20,22,42,40,20,20,1.05,50.0,Difficile,Moyen,1,Plus Facile,Pas Adapte,Economy
4651,2019,Économie,2,La Representation de l'Activite Economique: Le Circuit Economique,2,Le Circuit Economique dans le Cadre National,11,156,1,QCM,0.41,0.59,45.13,18,21,39,31,18,13,1.26,58.06,Difficile,Moyen,1,Plus Facile,Pas Adapte,Economy
5775,2020,Économie,2,La Representation de l'Activite Economique: Le Circuit Economique,2,Le Circuit Economique dans le Cadre National,11,156,1,QCM,0.71,0.24,13.94,6,38,44,13,6,7,3.38,46.15,Moyen,Difficile,-1,Plus Difficile,Pas Adapte,Economy
156,2015,Économie,2,La Representation de l'Activite Economique: Le Circuit Economique,2,Le Circuit Economique dans le Cadre National,11,157,2,QCM,0.34,0.7,52.32,29,26,55,52,29,23,1.06,55.77,Facile,Moyen,-1,Plus Difficile,Pas Adapte,Economy
1280,2016,Économie,2,La Representation de l'Activite Economique: Le Circuit Economique,2,Le Circuit Economique dans le Cadre National,11,157,2,QCM,0.23,0.41,52.13,31,28,59,49,31,18,1.2,63.27,Difficile,Moyen,1,Plus Facile,Pas Adapte,Economy
2404,2017,Économie,2,La Representation de l'Activite Economique: Le Circuit Economique,2,Le Circuit Economique dans le Cadre National,11,157,2,QCM,0.33,0.37,46.98,29,32,61,59,29,30,1.03,49.15,Moyen,Moyen,0,Meme Difficulté,Pas Adapte,Economy
3528,2018,Économie,2,La Representation de l'Activite Economique: Le Circuit Economique,2,Le Circuit Economique dans le Cadre National,11,157,2,QCM,0.08,0.78,97.09,57,2,59,58,57,1,1.02,98.28,Moyen,Facile,1,Plus Facile,Pas Adapte,Economy
4652,2019,Économie,2,La Representation de l'Activite Economique: Le Circuit Economique,2,Le Circuit Economique dans le Cadre National,11,157,2,QCM,0.74,0.28,18.24,12,56,68,28,12,16,2.43,42.86,Difficile,Difficile,0,Meme Difficulté,Pas Adapte,Economy
5776,2020,Économie,2,La Representation de l'Activite Economique: Le Circuit Economique,2,Le Circuit Economique dans le Cadre National,11,157,2,QCM,0.13,0.81,74.92,53,18,71,64,53,11,1.11,82.81,Moyen,Facile,1,Plus Facile,Adapte,Economy
157,2015,Économie,2,La Representation de l'Activite Economique: Le Circuit Economique,2,Le Circuit Economique dans le Cadre National,11,158,3,QROC,0.09,0.57,66.39,36,18,54,49,36,13,1.1,73.47,Difficile,Facile,2,Beaucoup plus Facile,Adapte,Economy
1281,2016,Économie,2,La Representation de l'Activite Economique: Le Circuit Economique,2,Le Circuit Economique dans le Cadre National,11,158,3,QROC,0.11,0.5,66.39,37,18,55,47,37,10,1.17,78.72,Facile,Facile,0,Meme Difficulté,Adapte,Economy
2405,2017,Économie,2,La Representation de l'Activite Economique: Le Circuit Economique,2,Le Circuit Economique dans le Cadre National,11,158,3,QO,0.13,0.91,66.39,37,19,56,49,37,12,1.14,75.51,Facile,Facile,0,Meme Difficulté,Adapte,Economy
3529,2018,Économie,2,La Representation de l'Activite Economique: Le Circuit Economique,2,Le Circuit Economique dans le Cadre National,11,158,3,QCU,0.03,0.92,66.39,32,16,48,41,32,9,1.17,78.05,Facile,Facile,0,Meme Difficulté,Adapte,Economy
4653,2019,Économie,2,La Representation de l'Activite Economique: Le Circuit Economique,2,Le Circuit Economique dans le Cadre National,11,158,3,QCU,0.01,0.89,66.39,27,14,41,27,27,0,1.52,100.0,Facile,Facile,0,Meme Difficulté,Adapte,Economy
5777,2020,Économie,2,La Representation de l'Activite Economique: Le Circuit Economique,2,Le Circuit Economique dans le Cadre National,11,158,3,QCU,0.04,0.95,66.39,25,13,38,28,25,3,1.36,89.29,Facile,Facile,0,Meme Difficulté,Adapte,Economy
158,2015,Économie,2,La Representation de l'Activite Economique: Le Circuit Economique,2,Le Circuit Economique dans le Cadre National,11,159,4,QCU,0.03,0.97,83.09,37,7,44,37,37,0,1.19,100.0,Difficile,Facile,2,Beaucoup plus Facile,Pas Adapte,Economy
1282,2016,Économie,2,La Representation de l'Activite Economique: Le Circuit Economique,2,Le Circuit Economique dans le Cadre National,11,159,4,QCU,0.25,0.41,37.03,18,31,49,22,18,4,2.23,81.82,Difficile,Moyen,1,Plus Facile,Pas Adapte,Economy
2406,2017,Économie,2,La Representation de l'Activite Economique: Le Circuit Economique,2,Le Circuit Economique dans le Cadre National,11,159,4,QCU,0.14,0.84,75.67,38,12,50,42,38,4,1.19,90.48,Facile,Facile,0,Meme Difficulté,Pas Adapte,Economy
3530,2018,Économie,2,La Representation de l'Activite Economique: Le Circuit Economique,2,Le Circuit Economique dans le Cadre National,11,159,4,QCM,0.5,0.35,42.64,21,29,50,28,21,7,1.79,75.0,Facile,Moyen,-1,Plus Difficile,Pas Adapte,Economy
4654,2019,Économie,2,La Representation de l'Activite Economique: Le Circuit Economique,2,Le Circuit Economique dans le Cadre National,11,159,4,QCU,0.63,0.22,4.7,3,54,57,24,3,21,2.38,12.5,Moyen,Difficile,-1,Plus Difficile,Pas Adapte,Economy
5778,2020,Économie,2,La Representation de l'Activite Economique: Le Circuit Economique,2,Le Circuit Economique dans le Cadre National,11,159,4,QCU,0.01,0.88,84.21,54,10,64,57,54,3,1.12,94.74,Difficile,Facile,2,Beaucoup plus Facile,Pas Adapte,Economy
159,2015,Économie,2,La Representation de l'Activite Economique: Le Circuit Economique,2,Le Circuit Economique dans le Cadre National,11,160,5,QCU,0.04,0.89,72.3,63,24,87,81,63,18,1.07,77.78,Facile,Facile,0,Meme Difficulté,Adapte,Economy
1283,2016,Économie,2,La Representation de l'Activite Economique: Le Circuit Economique,2,Le Circuit Economique dans le Cadre National,11,160,5,QCU,0.17,0.84,72.3,69,27,96,74,69,5,1.3,93.24,Facile,Facile,0,Meme Difficulté,Adapte,Economy
2407,2017,Économie,2,La Representation de l'Activite Economique: Le Circuit Economique,2,Le Circuit Economique dans le Cadre National,11,160,5,QCU,0.15,0.91,72.3,74,29,103,94,74,20,1.1,78.72,Facile,Facile,0,Meme Difficulté,Adapte,Economy
3531,2018,Économie,2,La Representation de l'Activite Economique: Le Circuit Economique,2,Le Circuit Economique dans le Cadre National,11,160,5,QCU,0.07,0.75,72.3,71,27,98,92,71,21,1.07,77.17,Facile,Facile,0,Meme Difficulté,Adapte,Economy
4655,2019,Économie,2,La Representation de l'Activite Economique: Le Circuit Economique,2,Le Circuit Economique dans le Cadre National,11,160,5,QCU,0.02,0.93,72.3,66,25,91,88,66,22,1.03,75.0,Facile,Facile,0,Meme Difficulté,Adapte,Economy
5779,2020,Économie,2,La Representation de l'Activite Economique: Le Circuit Economique,2,Le Circuit Economique dans le Cadre National,11,160,5,QCM,0.05,0.81,72.3,69,27,96,95,69,26,1.01,72.63,Facile,Facile,0,Meme Difficulté,Adapte,Economy
160,2015,Économie,2,La Representation de l'Activite Economique: Le Circuit Economique,2,Le Circuit Economique dans le Cadre National,11,161,6,QCU,0.04,0.89,90.94,71,7,78,73,71,2,1.07,97.26,Moyen,Facile,1,Plus Facile,Pas Adapte,Economy
1284,2016,Économie,2,La Representation de l'Activite Economique: Le Circuit Economique,2,Le Circuit Economique dans le Cadre National,11,161,6,QCU,0.21,0.67,43.32,33,44,77,59,33,26,1.31,55.93,Moyen,Moyen,0,Meme Difficulté,Pas Adapte,Economy
2408,2017,Économie,2,La Representation de l'Activite Economique: Le Circuit Economique,2,Le Circuit Economique dans le Cadre National,11,161,6,QCU,0.44,0.21,15.87,14,74,88,39,14,25,2.26,35.9,Facile,Difficile,-2,Beaucoup plus Difficile,Pas Adapte,Economy
3532,2018,Économie,2,La Representation de l'Activite Economique: Le Circuit Economique,2,Le Circuit Economique dans le Cadre National,11,161,6,QCU,0.36,0.73,55.11,43,35,78,51,43,8,1.53,84.31,Facile,Moyen,-1,Plus Difficile,Pas Adapte,Economy
4656,2019,Économie,2,La Representation de l'Activite Economique: Le Circuit Economique,2,Le Circuit Economique dans le Cadre National,11,161,6,QCM,0.55,0.15,21.63,16,58,74,43,16,27,1.72,37.21,Facile,Difficile,-2,Beaucoup plus Difficile,Pas Adapte,Economy
5780,2020,Économie,2,La Representation de l'Activite Economique: Le Circuit Economique,2,Le Circuit Economique dans le Cadre National,11,161,6,QCM,0.56,0.21,6.07,4,59,63,36,4,32,1.75,11.11,Difficile,Difficile,0,Meme Difficulté,Pas Adapte,Economy
161,2015,Économie,2,La Representation de l'Activite Economique: Le Circuit Economique,2,Le Circuit Economique dans le Cadre National,11,162,7,QCU,0.16,0.96,86.22,35,6,41,41,35,6,1.0,85.37,Difficile,Facile,2,Beaucoup plus Facile,Pas Adapte,Economy
1285,2016,Économie,2,La Representation de l'Activite Economique: Le Circuit Economique,2,Le Circuit Economique dans le Cadre National,11,162,7,QCU,0.36,0.57,38.01,17,28,45,24,17,7,1.88,70.83,Difficile,Moyen,1,Plus Facile,Pas Adapte,Economy
2409,2017,Économie,2,La Representation de l'Activite Economique: Le Circuit Economique,2,Le Circuit Economique dans le Cadre National,11,162,7,QCU,0.07,0.78,85.23,43,8,51,50,43,7,1.02,86.0,Facile,Facile,0,Meme Difficulté,Pas Adapte,Economy
3533,2018,Économie,2,La Representation de l'Activite Economique: Le Circuit Economique,2,Le Circuit Economique dans le Cadre National,11,162,7,QCU,0.26,0.43,61.36,33,21,54,39,33,6,1.38,84.62,Difficile,Moyen,1,Plus Facile,Adapte,Economy
4657,2019,Économie,2,La Representation de l'Activite Economique: Le Circuit Economique,2,Le Circuit Economique dans le Cadre National,11,162,7,QCU,0.31,0.62,61.36,37,24,61,60,37,23,1.02,61.67,Moyen,Moyen,0,Meme Difficulté,Adapte,Economy
5781,2020,Économie,2,La Representation de l'Activite Economique: Le Circuit Economique,2,Le Circuit Economique dans le Cadre National,11,162,7,QCU,0.29,0.44,61.36,39,25,64,55,39,16,1.16,70.91,Moyen,Moyen,0,Meme Difficulté,Adapte,Economy
162,2015,Économie,2,La Representation de l'Activite Economique: Le Circuit Economique,2,Le Circuit Economique dans le Cadre National,11,163,8,QCU,0.62,0.34,3.43,2,51,53,35,2,33,1.51,5.71,Moyen,Difficile,-1,Plus Difficile,Pas Adapte,Economy
1286,2016,Économie,2,La Representation de l'Activite Economique: Le Circuit Economique,2,Le Circuit Economique dans le Cadre National,11,163,8,QCU,0.41,0.28,32.22,19,40,59,25,19,6,2.36,76.0,Difficile,Difficile,0,Meme Difficulté,Pas Adapte,Economy
2410,2017,Économie,2,La Representation de l'Activite Economique: Le Circuit Economique,2,Le Circuit Economique dans le Cadre National,11,163,8,QCU,0.1,0.84,69.03,36,16,52,48,36,12,1.08,75.0,Difficile,Facile,2,Beaucoup plus Facile,Adapte,Economy
3534,2018,Économie,2,La Representation de l'Activite Economique: Le Circuit Economique,2,Le Circuit Economique dans le Cadre National,11,163,8,QCU,0.08,0.94,69.03,33,15,48,33,33,0,1.45,100.0,Facile,Facile,0,Meme Difficulté,Adapte,Economy
4658,2019,Économie,2,La Representation de l'Activite Economique: Le Circuit Economique,2,Le Circuit Economique dans le Cadre National,11,163,8,QCU,0.04,0.92,69.03,31,14,45,44,31,13,1.02,70.45,Facile,Facile,0,Meme Difficulté,Adapte,Economy
5782,2020,Économie,2,La Representation de l'Activite Economique: Le Circuit Economique,2,Le Circuit Economique dans le Cadre National,11,163,8,QCU,0.03,0.82,69.03,35,15,50,42,35,7,1.19,83.33,Facile,Facile,0,Meme Difficulté,Adapte,Economy
163,2015,Économie,2,La Representation de l'Activite Economique: Le Circuit Economique,2,Le Circuit Economique dans le Cadre National,11,164,9,QCU,0.32,0.45,50.57,6,5,11,7,6,1,1.57,85.71,Difficile,Moyen,1,Plus Facile,Pas Adapte,Economy
1287,2016,Économie,2,La Representation de l'Activite Economique: Le Circuit Economique,2,Le Circuit Economique dans le Cadre National,11,164,9,QCU,0.06,0.98,76.44,10,3,13,10,10,0,1.3,100.0,Difficile,Facile,2,Beaucoup plus Facile,Pas Adapte,Economy
2411,2017,Économie,2,La Representation de l'Activite Economique: Le Circuit Economique,2,Le Circuit Economique dans le Cadre National,11,164,9,QCU,0.19,0.78,89.44,12,1,13,12,12,0,1.08,100.0,Moyen,Facile,1,Plus Facile,Pas Adapte,Economy
3535,2018,Économie,2,La Representation de l'Activite Economique: Le Circuit Economique,2,Le Circuit Economique dans le Cadre National,11,164,9,QO,0.09,0.66,93.5,10,1,11,11,10,1,1.0,90.91,Moyen,Facile,1,Plus Facile,Pas Adapte,Economy
4659,2019,Économie,2,La Representation de l'Activite Economique: Le Circuit Economique,2,Le Circuit Economique dans le Cadre National,11,164,9,QO,0.29,0.17,39.22,5,8,13,11,5,6,1.18,45.45,Difficile,Moyen,1,Plus Facile,Pas Adapte,Economy
5783,2020,Économie,2,La Representation de l'Activite Economique: Le Circuit Economique,2,Le Circuit Economique dans le Cadre National,11,164,9,QO,0.8,0.1,4.29,0,11,11,8,0,8,1.38,0.0,Moyen,Difficile,-1,Plus Difficile,Pas Adapte,Economy
164,2015,Économie,2,La Representation de l'Activite Economique: Le Circuit Economique,2,Le Circuit Economique dans le Cadre National,11,165,10,QCU,0.06,0.95,95.23,90,5,95,91,90,1,1.04,98.9,Facile,Facile,0,Meme Difficulté,Pas Adapte,Economy
1288,2016,Économie,2,La Representation de l'Activite Economique: Le Circuit Economique,2,Le Circuit Economique dans le Cadre National,11,165,10,QCU,0.17,0.81,85.04,82,14,96,95,82,13,1.01,86.32,Facile,Facile,0,Meme Difficulté,Pas Adapte,Economy
2412,2017,Économie,2,La Representation de l'Activite Economique: Le Circuit Economique,2,Le Circuit Economique dans le Cadre National,11,165,10,QCU,0.54,0.39,21.98,23,80,103,52,23,29,1.98,44.23,Facile,Difficile,-2,Beaucoup plus Difficile,Pas Adapte,Economy
3536,2018,Économie,2,La Representation de l'Activite Economique: Le Circuit Economique,2,Le Circuit Economique dans le Cadre National,11,165,10,QCU,0.14,0.78,94.2,96,6,102,101,96,5,1.01,95.05,Facile,Facile,0,Meme Difficulté,Pas Adapte,Economy
4660,2019,Économie,2,La Representation de l'Activite Economique: Le Circuit Economique,2,Le Circuit Economique dans le Cadre National,11,165,10,QCU,0.24,0.58,36.17,37,65,102,87,37,50,1.17,42.53,Facile,Moyen,-1,Plus Difficile,Pas Adapte,Economy
5784,2020,Économie,2,La Representation de l'Activite Economique: Le Circuit Economique,2,Le Circuit Economique dans le Cadre National,11,165,10,QCU,0.3,0.61,38.91,42,65,107,66,42,24,1.62,63.64,Facile,Moyen,-1,Plus Difficile,Pas Adapte,Economy
165,2015,Économie,2,La Representation de l'Activite Economique: Le Circuit Economique,2,Le Circuit Economique dans le Cadre National,11,166,11,QCU,0.69,0.38,22.84,9,29,38,18,9,9,2.11,50.0,Moyen,Difficile,-1,Plus Difficile,Pas Adapte,Economy
1289,2016,Économie,2,La Representation de l'Activite Economique: Le Circuit Economique,2,Le Circuit Economique dans le Cadre National,11,166,11,QCU,0.16,0.96,99.61,35,0,35,35,35,0,1.0,100.0,Difficile,Facile,2,Beaucoup plus Facile,Pas Adapte,Economy
2413,2017,Économie,2,La Representation de l'Activite Economique: Le Circuit Economique,2,Le Circuit Economique dans le Cadre National,11,166,11,QCU,0.36,0.59,61.77,23,15,38,25,23,2,1.52,92.0,Facile,Moyen,-1,Plus Difficile,Adapte,Economy
3537,2018,Économie,2,La Representation de l'Activite Economique: Le Circuit Economique,2,Le Circuit Economique dans le Cadre National,11,166,11,QCU,0.22,0.44,61.77,27,16,43,32,27,5,1.34,84.38,Moyen,Moyen,0,Meme Difficulté,Adapte,Economy
4661,2019,Économie,2,La Representation de l'Activite Economique: Le Circuit Economique,2,Le Circuit Economique dans le Cadre National,11,166,11,QCU,0.34,0.68,61.77,28,18,46,41,28,13,1.12,68.29,Moyen,Moyen,0,Meme Difficulté,Adapte,Economy
5785,2020,Économie,2,La Representation de l'Activite Economique: Le Circuit Economique,2,Le Circuit Economique dans le Cadre National,11,166,11,QCU,0.22,0.64,61.77,25,15,40,28,25,3,1.43,89.29,Moyen,Moyen,0,Meme Difficulté,Adapte,Economy
166,2015,Économie,2,La Representation de l'Activite Economique: Le Circuit Economique,3,Les Interdependances Economiques entre les Nations,3,167,1,QCU,0.28,0.56,51.88,18,17,35,22,18,4,1.59,81.82,Difficile,Moyen,1,Plus Facile,Pas Adapte,Economy
1290,2016,Économie,2,La Representation de l'Activite Economique: Le Circuit Economique,3,Les Interdependances Economiques entre les Nations,3,167,1,QCU,0.1,0.89,97.89,29,1,30,29,29,0,1.03,100.0,Difficile,Facile,2,Beaucoup plus Facile,Pas Adapte,Economy
2414,2017,Économie,2,La Representation de l'Activite Economique: Le Circuit Economique,3,Les Interdependances Economiques entre les Nations,3,167,1,QCU,0.58,0.28,31.68,10,23,33,32,10,22,1.03,31.25,Moyen,Difficile,-1,Plus Difficile,Pas Adapte,Economy
3538,2018,Économie,2,La Representation de l'Activite Economique: Le Circuit Economique,3,Les Interdependances Economiques entre les Nations,3,167,1,QCU,0.12,0.85,83.88,28,5,33,31,28,3,1.06,90.32,Facile,Facile,0,Meme Difficulté,Pas Adapte,Economy
4662,2019,Économie,2,La Representation de l'Activite Economique: Le Circuit Economique,3,Les Interdependances Economiques entre les Nations,3,167,1,QCU,0.41,0.22,31.62,11,25,36,25,11,14,1.44,44.0,Difficile,Difficile,0,Meme Difficulté,Pas Adapte,Economy
5786,2020,Économie,2,La Representation de l'Activite Economique: Le Circuit Economique,3,Les Interdependances Economiques entre les Nations,3,167,1,QCU,0.44,0.27,1.45,1,35,36,15,1,14,2.4,6.67,Difficile,Difficile,0,Meme Difficulté,Pas Adapte,Economy
167,2015,Économie,2,La Representation de l'Activite Economique: Le Circuit Economique,3,Les Interdependances Economiques entre les Nations,3,168,2,QCM,0.02,0.81,94.51,15,1,16,16,15,1,1.0,93.75,Difficile,Facile,2,Beaucoup plus Facile,Pas Adapte,Economy
1291,2016,Économie,2,La Representation de l'Activite Economique: Le Circuit Economique,3,Les Interdependances Economiques entre les Nations,3,168,2,QCM,0.78,0.19,13.58,2,14,16,7,2,5,2.29,28.57,Moyen,Difficile,-1,Plus Difficile,Pas Adapte,Economy
2415,2017,Économie,2,La Representation de l'Activite Economique: Le Circuit Economique,3,Les Interdependances Economiques entre les Nations,3,168,2,QCM,0.55,0.26,4.61,1,14,15,4,1,3,3.75,25.0,Moyen,Difficile,-1,Plus Difficile,Pas Adapte,Economy
3539,2018,Économie,2,La Representation de l'Activite Economique: Le Circuit Economique,3,Les Interdependances Economiques entre les Nations,3,168,2,QCM,0.08,0.84,89.95,12,1,13,12,12,0,1.08,100.0,Difficile,Facile,2,Beaucoup plus Facile,Pas Adapte,Economy
4663,2019,Économie,2,La Representation de l'Activite Economique: Le Circuit Economique,3,Les Interdependances Economiques entre les Nations,3,168,2,QCM,0.32,0.37,62.72,9,6,15,9,9,0,1.67,100.0,Moyen,Moyen,0,Meme Difficulté,Adapte,Economy
5787,2020,Économie,2,La Representation de l'Activite Economique: Le Circuit Economique,3,Les Interdependances Economiques entre les Nations,3,168,2,QCM,0.43,0.53,62.72,9,6,15,12,9,3,1.25,75.0,Moyen,Moyen,0,Meme Difficulté,Adapte,Economy
168,2015,Économie,2,La Representation de l'Activite Economique: Le Circuit Economique,3,Les Interdependances Economiques entre les Nations,3,169,3,QROC,0.4,0.32,59.09,30,20,50,35,30,5,1.43,85.71,Moyen,Moyen,0,Meme Difficulté,Pas Adapte,Economy
1292,2016,Économie,2,La Representation de l'Activite Economique: Le Circuit Economique,3,Les Interdependances Economiques entre les Nations,3,169,3,QROC,0.11,0.79,93.45,47,3,50,48,47,1,1.04,97.92,Facile,Facile,0,Meme Difficulté,Pas Adapte,Economy
2416,2017,Économie,2,La Representation de l'Activite Economique: Le Circuit Economique,3,Les Interdependances Economiques entre les Nations,3,169,3,QROC,0.04,0.42,74.72,35,12,47,46,35,11,1.02,76.09,Facile,Facile,0,Meme Difficulté,Adapte,Economy
3540,2018,Économie,2,La Representation de l'Activite Economique: Le Circuit Economique,3,Les Interdependances Economiques entre les Nations,3,169,3,QROC,0.01,0.67,74.72,33,11,44,40,33,7,1.1,82.5,Facile,Facile,0,Meme Difficulté,Adapte,Economy
4664,2019,Économie,2,La Representation de l'Activite Economique: Le Circuit Economique,3,Les Interdependances Economiques entre les Nations,3,169,3,QO,0.14,0.85,74.72,37,13,50,42,37,5,1.19,88.1,Facile,Facile,0,Meme Difficulté,Adapte,Economy
5788,2020,Économie,2,La Representation de l'Activite Economique: Le Circuit Economique,3,Les Interdependances Economiques entre les Nations,3,169,3,QO,0.01,0.4,74.72,41,14,55,54,41,13,1.02,75.93,Facile,Facile,0,Meme Difficulté,Adapte,Economy
169,2015,Économie,3,La Production,1,La Notion de Production,5,170,1,QCM,0.69,0.2,7.64,4,44,48,22,4,18,2.18,18.18,Difficile,Difficile,0,Meme Difficulté,Pas Adapte,Economy
1293,2016,Économie,3,La Production,1,La Notion de Production,5,170,1,QCM,0.71,0.3,12.79,7,48,55,28,7,21,1.96,25.0,Difficile,Difficile,0,Meme Difficulté,Pas Adapte,Economy
2417,2017,Économie,3,La Production,1,La Notion de Production,5,170,1,QCM,0.55,0.21,25.78,14,42,56,41,14,27,1.37,34.15,Moyen,Difficile,-1,Plus Difficile,Pas Adapte,Economy
3541,2018,Économie,3,La Production,1,La Notion de Production,5,170,1,QCM,0.04,0.9,78.66,46,12,58,54,46,8,1.07,85.19,Difficile,Facile,2,Beaucoup plus Facile,Pas Adapte,Economy
4665,2019,Économie,3,La Production,1,La Notion de Production,5,170,1,QCM,0.4,0.48,35.54,20,36,56,55,20,35,1.02,36.36,Moyen,Moyen,0,Meme Difficulté,Pas Adapte,Economy
5789,2020,Économie,3,La Production,1,La Notion de Production,5,170,1,QCM,0.58,0.23,20.23,12,45,57,40,12,28,1.43,30.0,Facile,Difficile,-2,Beaucoup plus Difficile,Pas Adapte,Economy
170,2015,Économie,3,La Production,1,La Notion de Production,5,171,2,QCM,0.66,0.16,10.53,4,31,35,30,4,26,1.17,13.33,Facile,Difficile,-2,Beaucoup plus Difficile,Pas Adapte,Economy
1294,2016,Économie,3,La Production,1,La Notion de Production,5,171,2,QROC,0.65,0.17,22.46,7,23,30,19,7,12,1.58,36.84,Moyen,Difficile,-1,Plus Difficile,Pas Adapte,Economy
2418,2017,Économie,3,La Production,1,La Notion de Production,5,171,2,QROC,0.09,0.95,90.61,27,3,30,29,27,2,1.03,93.1,Facile,Facile,0,Meme Difficulté,Pas Adapte,Economy
3542,2018,Économie,3,La Production,1,La Notion de Production,5,171,2,QROC,0.52,0.33,49.25,17,17,34,22,17,5,1.55,77.27,Facile,Moyen,-1,Plus Difficile,Pas Adapte,Economy
4666,2019,Économie,3,La Production,1,La Notion de Production,5,171,2,QROC,0.02,0.67,79.28,25,7,32,29,25,4,1.1,86.21,Moyen,Facile,1,Plus Facile,Pas Adapte,Economy
5790,2020,Économie,3,La Production,1,La Notion de Production,5,171,2,QROC,0.19,1.0,96.85,33,1,34,34,33,1,1.0,97.06,Difficile,Facile,2,Beaucoup plus Facile,Pas Adapte,Economy
171,2015,Économie,3,La Production,1,La Notion de Production,5,172,3,QCU,0.5,0.27,34.02,34,65,99,91,34,57,1.09,37.36,Facile,Difficile,-2,Beaucoup plus Difficile,Pas Adapte,Economy
1295,2016,Économie,3,La Production,1,La Notion de Production,5,172,3,QCU,0.75,0.23,7.7,8,94,102,66,8,58,1.55,12.12,Moyen,Difficile,-1,Plus Difficile,Pas Adapte,Economy
2419,2017,Économie,3,La Production,1,La Notion de Production,5,172,3,QCM,0.57,0.26,27.45,30,80,110,105,30,75,1.05,28.57,Facile,Difficile,-2,Beaucoup plus Difficile,Pas Adapte,Economy
3543,2018,Économie,3,La Production,1,La Notion de Production,5,172,3,QCM,0.09,0.74,87.72,87,12,99,91,87,4,1.09,95.6,Moyen,Facile,1,Plus Facile,Pas Adapte,Economy
4667,2019,Économie,3,La Production,1,La Notion de Production,5,172,3,QCM,0.15,0.82,66.76,75,37,112,107,75,32,1.05,70.09,Facile,Facile,0,Meme Difficulté,Adapte,Economy
5791,2020,Économie,3,La Production,1,La Notion de Production,5,172,3,QCM,0.14,0.93,66.76,81,40,121,85,81,4,1.42,95.29,Facile,Facile,0,Meme Difficulté,Adapte,Economy
172,2015,Économie,3,La Production,1,La Notion de Production,5,173,4,QCU,0.2,0.92,93.86,89,6,95,93,89,4,1.02,95.7,Facile,Facile,0,Meme Difficulté,Pas Adapte,Economy
1296,2016,Économie,3,La Production,1,La Notion de Production,5,173,4,QCU,0.73,0.24,33.86,35,68,103,46,35,11,2.24,76.09,Facile,Difficile,-2,Beaucoup plus Difficile,Pas Adapte,Economy
2420,2017,Économie,3,La Production,1,La Notion de Production,5,173,4,QCM,0.38,0.51,37.88,39,65,104,66,39,27,1.58,59.09,Facile,Moyen,-1,Plus Difficile,Pas Adapte,Economy
3544,2018,Économie,3,La Production,1,La Notion de Production,5,173,4,QCM,0.06,0.96,72.21,79,31,110,88,79,9,1.25,89.77,Difficile,Facile,2,Beaucoup plus Facile,Adapte,Economy
4668,2019,Économie,3,La Production,1,La Notion de Production,5,173,4,QCM,0.02,0.81,72.21,68,26,94,73,68,5,1.29,93.15,Facile,Facile,0,Meme Difficulté,Adapte,Economy
5792,2020,Économie,3,La Production,1,La Notion de Production,5,173,4,QCM,0.09,0.82,72.21,59,23,82,79,59,20,1.04,74.68,Facile,Facile,0,Meme Difficulté,Adapte,Economy
173,2015,Économie,3,La Production,1,La Notion de Production,5,174,5,QCU,0.1,0.78,89.67,54,6,60,59,54,5,1.02,91.53,Facile,Facile,0,Meme Difficulté,Pas Adapte,Economy
1297,2016,Économie,3,La Production,1,La Notion de Production,5,174,5,QCU,0.45,0.32,0.14,0,68,68,52,0,52,1.31,0.0,Moyen,Difficile,-1,Plus Difficile,Pas Adapte,Economy
2421,2017,Économie,3,La Production,1,La Notion de Production,5,174,5,QCU,0.14,0.91,68.4,42,19,61,47,42,5,1.3,89.36,Facile,Facile,0,Meme Difficulté,Adapte,Economy
3545,2018,Économie,3,La Production,1,La Notion de Production,5,174,5,QCU,0.09,0.87,68.4,40,18,58,46,40,6,1.26,86.96,Facile,Facile,0,Meme Difficulté,Adapte,Economy
4669,2019,Économie,3,La Production,1,La Notion de Production,5,174,5,QCU,0.09,0.84,68.4,35,16,51,46,35,11,1.11,76.09,Facile,Facile,0,Meme Difficulté,Adapte,Economy
5793,2020,Économie,3,La Production,1,La Notion de Production,5,174,5,QCU,0.08,0.86,68.4,38,17,55,49,38,11,1.12,77.55,Facile,Facile,0,Meme Difficulté,Adapte,Economy
174,2015,Économie,3,La Production,2,L'Importance de la Production Marchande et de la Production Non-Marchande,8,175,1,QCM,0.68,0.16,13.72,3,16,19,14,3,11,1.36,21.43,Difficile,Difficile,0,Meme Difficulté,Pas Adapte,Economy
1298,2016,Économie,3,La Production,2,L'Importance de la Production Marchande et de la Production Non-Marchande,8,175,1,QCM,0.3,0.5,57.97,11,8,19,17,11,6,1.12,64.71,Moyen,Moyen,0,Meme Difficulté,Pas Adapte,Economy
2422,2017,Économie,3,La Production,2,L'Importance de la Production Marchande et de la Production Non-Marchande,8,175,1,QCM,0.46,0.7,49.25,9,10,19,12,9,3,1.58,75.0,Difficile,Moyen,1,Plus Facile,Pas Adapte,Economy
3546,2018,Économie,3,La Production,2,L'Importance de la Production Marchande et de la Production Non-Marchande,8,175,1,QCM,0.19,0.75,76.68,16,5,21,17,16,1,1.24,94.12,Moyen,Facile,1,Plus Facile,Pas Adapte,Economy
4670,2019,Économie,3,La Production,2,L'Importance de la Production Marchande et de la Production Non-Marchande,8,175,1,QCM,0.15,0.71,69.23,13,6,19,17,13,4,1.12,76.47,Difficile,Facile,2,Beaucoup plus Facile,Adapte,Economy
5794,2020,Économie,3,La Production,2,L'Importance de la Production Marchande et de la Production Non-Marchande,8,175,1,QCM,0.1,0.91,69.23,13,6,19,15,13,2,1.27,86.67,Facile,Facile,0,Meme Difficulté,Adapte,Economy
175,2015,Économie,3,La Production,2,L'Importance de la Production Marchande et de la Production Non-Marchande,8,176,2,QCM,0.25,0.31,37.11,3,5,8,4,3,1,2.0,75.0,Moyen,Moyen,0,Meme Difficulté,Pas Adapte,Economy
1299,2016,Économie,3,La Production,2,L'Importance de la Production Marchande et de la Production Non-Marchande,8,176,2,QCM,0.16,0.74,87.66,6,1,7,6,6,0,1.17,100.0,Difficile,Facile,2,Beaucoup plus Facile,Pas Adapte,Economy
2423,2017,Économie,3,La Production,2,L'Importance de la Production Marchande et de la Production Non-Marchande,8,176,2,QCM,0.74,0.26,25.46,2,4,6,3,2,1,2.0,66.67,Facile,Difficile,-2,Beaucoup plus Difficile,Pas Adapte,Economy
3547,2018,Économie,3,La Production,2,L'Importance de la Production Marchande et de la Production Non-Marchande,8,176,2,QCM,0.78,0.27,0.35,0,6,6,2,0,2,3.0,0.0,Difficile,Difficile,0,Meme Difficulté,Pas Adapte,Economy
4671,2019,Économie,3,La Production,2,L'Importance de la Production Marchande et de la Production Non-Marchande,8,176,2,QCM,0.66,0.23,24.59,1,5,6,3,1,2,2.0,33.33,Difficile,Difficile,0,Meme Difficulté,Pas Adapte,Economy
5795,2020,Économie,3,La Production,2,L'Importance de la Production Marchande et de la Production Non-Marchande,8,176,2,QCU,0.39,0.51,57.93,3,2,5,4,3,1,1.25,75.0,Facile,Moyen,-1,Plus Difficile,Pas Adapte,Economy
176,2015,Économie,3,La Production,2,L'Importance de la Production Marchande et de la Production Non-Marchande,8,177,3,QCU,0.61,0.28,25.51,15,44,59,54,15,39,1.09,27.78,Moyen,Difficile,-1,Plus Difficile,Pas Adapte,Economy
1300,2016,Économie,3,La Production,2,L'Importance de la Production Marchande et de la Production Non-Marchande,8,177,3,QCU,0.25,0.65,50.57,29,28,57,52,29,23,1.1,55.77,Facile,Moyen,-1,Plus Difficile,Pas Adapte,Economy
2424,2017,Économie,3,La Production,2,L'Importance de la Production Marchande et de la Production Non-Marchande,8,177,3,QCU,0.12,0.99,73.35,40,15,55,49,40,9,1.12,81.63,Moyen,Facile,1,Plus Facile,Adapte,Economy
3548,2018,Économie,3,La Production,2,L'Importance de la Production Marchande et de la Production Non-Marchande,8,177,3,QCU,0.05,0.83,73.35,34,13,47,36,34,2,1.31,94.44,Facile,Facile,0,Meme Difficulté,Adapte,Economy
4672,2019,Économie,3,La Production,2,L'Importance de la Production Marchande et de la Production Non-Marchande,8,177,3,QCU,0.01,0.97,73.35,35,13,48,41,35,6,1.17,85.37,Facile,Facile,0,Meme Difficulté,Adapte,Economy
5796,2020,Économie,3,La Production,2,L'Importance de la Production Marchande et de la Production Non-Marchande,8,177,3,QCU,0.12,0.83,73.35,40,15,55,50,40,10,1.1,80.0,Facile,Facile,0,Meme Difficulté,Adapte,Economy
177,2015,Économie,3,La Production,2,L'Importance de la Production Marchande et de la Production Non-Marchande,8,178,4,QROC,0.96,0.16,28.58,4,10,14,13,4,9,1.08,30.77,Difficile,Difficile,0,Meme Difficulté,Pas Adapte,Economy
1301,2016,Économie,3,La Production,2,L'Importance de la Production Marchande et de la Production Non-Marchande,8,178,4,QROC,0.31,0.38,47.21,7,8,15,9,7,2,1.67,77.78,Difficile,Moyen,1,Plus Facile,Pas Adapte,Economy
2425,2017,Économie,3,La Production,2,L'Importance de la Production Marchande et de la Production Non-Marchande,8,178,4,QROC,0.05,0.77,98.68,17,0,17,17,17,0,1.0,100.0,Moyen,Facile,1,Plus Facile,Pas Adapte,Economy
3549,2018,Économie,3,La Production,2,L'Importance de la Production Marchande et de la Production Non-Marchande,8,178,4,QROC,0.06,0.9,96.53,17,1,18,17,17,0,1.06,100.0,Difficile,Facile,2,Beaucoup plus Facile,Pas Adapte,Economy
4673,2019,Économie,3,La Production,2,L'Importance de la Production Marchande et de la Production Non-Marchande,8,178,4,QROC,0.32,0.3,58.13,9,6,15,12,9,3,1.25,75.0,Facile,Moyen,-1,Plus Difficile,Pas Adapte,Economy
5797,2020,Économie,3,La Production,2,L'Importance de la Production Marchande et de la Production Non-Marchande,8,178,4,QROC,0.82,0.12,33.63,5,10,15,11,5,6,1.36,45.45,Facile,Difficile,-2,Beaucoup plus Difficile,Pas Adapte,Economy
178,2015,Économie,3,La Production,2,L'Importance de la Production Marchande et de la Production Non-Marchande,8,179,5,QO,0.57,0.24,49.99,37,37,74,43,37,6,1.72,86.05,Facile,Moyen,-1,Plus Difficile,Pas Adapte,Economy
1302,2016,Économie,3,La Production,2,L'Importance de la Production Marchande et de la Production Non-Marchande,8,179,5,QO,0.87,0.12,11.27,8,66,74,70,8,62,1.06,11.43,Difficile,Difficile,0,Meme Difficulté,Pas Adapte,Economy
2426,2017,Économie,3,La Production,2,L'Importance de la Production Marchande et de la Production Non-Marchande,8,179,5,QO,0.93,0.13,26.07,21,58,79,70,21,49,1.13,30.0,Moyen,Difficile,-1,Plus Difficile,Pas Adapte,Economy
3550,2018,Économie,3,La Production,2,L'Importance de la Production Marchande et de la Production Non-Marchande,8,179,5,QCU,0.13,0.87,79.34,64,17,81,65,64,1,1.25,98.46,Facile,Facile,0,Meme Difficulté,Pas Adapte,Economy
4674,2019,Économie,3,La Production,2,L'Importance de la Production Marchande et de la Production Non-Marchande,8,179,5,QCU,0.6,0.24,18.17,14,64,78,65,14,51,1.2,21.54,Difficile,Difficile,0,Meme Difficulté,Pas Adapte,Economy
5798,2020,Économie,3,La Production,2,L'Importance de la Production Marchande et de la Production Non-Marchande,8,179,5,QCU,0.04,0.91,84.45,69,13,82,79,69,10,1.04,87.34,Facile,Facile,0,Meme Difficulté,Pas Adapte,Economy
179,2015,Économie,3,La Production,2,L'Importance de la Production Marchande et de la Production Non-Marchande,8,180,6,QCM,0.1,0.94,74.12,32,11,43,34,32,2,1.26,94.12,Facile,Facile,0,Meme Difficulté,Adapte,Economy
1303,2016,Économie,3,La Production,2,L'Importance de la Production Marchande et de la Production Non-Marchande,8,180,6,QCM,0.17,0.94,74.12,33,11,44,36,33,3,1.22,91.67,Facile,Facile,0,Meme Difficulté,Adapte,Economy
2427,2017,Économie,3,La Production,2,L'Importance de la Production Marchande et de la Production Non-Marchande,8,180,6,QCM,0.02,0.87,74.12,27,10,37,33,27,6,1.12,81.82,Facile,Facile,0,Meme Difficulté,Adapte,Economy
3551,2018,Économie,3,La Production,2,L'Importance de la Production Marchande et de la Production Non-Marchande,8,180,6,QCM,0.17,0.85,74.12,23,8,31,24,23,1,1.29,95.83,Facile,Facile,0,Meme Difficulté,Adapte,Economy
4675,2019,Économie,3,La Production,2,L'Importance de la Production Marchande et de la Production Non-Marchande,8,180,6,QCM,0.08,0.78,74.12,22,8,30,26,22,4,1.15,84.62,Facile,Facile,0,Meme Difficulté,Adapte,Economy
5799,2020,Économie,3,La Production,2,L'Importance de la Production Marchande et de la Production Non-Marchande,8,180,6,QCM,0.19,0.73,74.12,22,8,30,26,22,4,1.15,84.62,Facile,Facile,0,Meme Difficulté,Adapte,Economy
180,2015,Économie,3,La Production,2,L'Importance de la Production Marchande et de la Production Non-Marchande,8,181,7,QO,0.83,0.04,13.67,7,45,52,31,7,24,1.68,22.58,Facile,Difficile,-2,Beaucoup plus Difficile,Pas Adapte,Economy
1304,2016,Économie,3,La Production,2,L'Importance de la Production Marchande et de la Production Non-Marchande,8,181,7,QO,0.19,0.48,78.19,46,13,59,56,46,10,1.05,82.14,Facile,Facile,0,Meme Difficulté,Pas Adapte,Economy
2428,2017,Économie,3,La Production,2,L'Importance de la Production Marchande et de la Production Non-Marchande,8,181,7,QO,0.79,0.07,10.0,6,50,56,49,6,43,1.14,12.24,Facile,Difficile,-2,Beaucoup plus Difficile,Pas Adapte,Economy
3552,2018,Économie,3,La Production,2,L'Importance de la Production Marchande et de la Production Non-Marchande,8,181,7,QO,0.11,0.55,87.31,47,7,54,48,47,1,1.12,97.92,Facile,Facile,0,Meme Difficulté,Pas Adapte,Economy
4676,2019,Économie,3,La Production,2,L'Importance de la Production Marchande et de la Production Non-Marchande,8,181,7,QO,0.06,0.5,82.03,39,9,48,41,39,2,1.17,95.12,Facile,Facile,0,Meme Difficulté,Pas Adapte,Economy
5800,2020,Économie,3,La Production,2,L'Importance de la Production Marchande et de la Production Non-Marchande,8,181,7,QO,0.61,0.25,47.19,22,24,46,37,22,15,1.24,59.46,Facile,Moyen,-1,Plus Difficile,Pas Adapte,Economy
181,2015,Économie,3,La Production,2,L'Importance de la Production Marchande et de la Production Non-Marchande,8,182,8,QCM,0.79,0.16,24.86,8,26,34,29,8,21,1.17,27.59,Moyen,Difficile,-1,Plus Difficile,Pas Adapte,Economy
1305,2016,Économie,3,La Production,2,L'Importance de la Production Marchande et de la Production Non-Marchande,8,182,8,QCM,0.27,0.52,36.65,14,25,39,32,14,18,1.22,43.75,Difficile,Moyen,1,Plus Facile,Pas Adapte,Economy
2429,2017,Économie,3,La Production,2,L'Importance de la Production Marchande et de la Production Non-Marchande,8,182,8,QCM,0.56,0.18,0.34,0,33,33,29,0,29,1.14,0.0,Facile,Difficile,-2,Beaucoup plus Difficile,Pas Adapte,Economy
3553,2018,Économie,3,La Production,2,L'Importance de la Production Marchande et de la Production Non-Marchande,8,182,8,QCM,0.48,0.35,59.94,22,14,36,24,22,2,1.5,91.67,Difficile,Moyen,1,Plus Facile,Pas Adapte,Economy
4677,2019,Économie,3,La Production,2,L'Importance de la Production Marchande et de la Production Non-Marchande,8,182,8,QCM,0.68,0.26,12.75,5,32,37,29,5,24,1.28,17.24,Facile,Difficile,-2,Beaucoup plus Difficile,Pas Adapte,Economy
5801,2020,Économie,3,La Production,2,L'Importance de la Production Marchande et de la Production Non-Marchande,8,182,8,QCM,0.17,0.81,84.43,29,5,34,32,29,3,1.06,90.62,Moyen,Facile,1,Plus Facile,Pas Adapte,Economy
182,2015,Économie,3,La Production,3,Valeur Ajouee et Mesure de la Richesse,7,183,1,QCU,0.38,0.53,39.15,19,30,49,43,19,24,1.14,44.19,Difficile,Moyen,1,Plus Facile,Pas Adapte,Economy
1306,2016,Économie,3,La Production,3,Valeur Ajouee et Mesure de la Richesse,7,183,1,QCU,0.02,0.88,93.22,47,3,50,48,47,1,1.04,97.92,Moyen,Facile,1,Plus Facile,Pas Adapte,Economy
2430,2017,Économie,3,La Production,3,Valeur Ajouee et Mesure de la Richesse,7,183,1,QCU,0.45,0.39,22.93,13,42,55,44,13,31,1.25,29.55,Moyen,Difficile,-1,Plus Difficile,Pas Adapte,Economy
3554,2018,Économie,3,La Production,3,Valeur Ajouee et Mesure de la Richesse,7,183,1,QCU,0.33,0.49,56.45,32,24,56,43,32,11,1.3,74.42,Difficile,Moyen,1,Plus Facile,Pas Adapte,Economy
4678,2019,Économie,3,La Production,3,Valeur Ajouee et Mesure de la Richesse,7,183,1,QCU,0.1,0.9,74.69,44,15,59,54,44,10,1.09,81.48,Difficile,Facile,2,Beaucoup plus Facile,Adapte,Economy
5802,2020,Économie,3,La Production,3,Valeur Ajouee et Mesure de la Richesse,7,183,1,QCU,0.17,0.98,74.69,46,16,62,61,46,15,1.02,75.41,Facile,Facile,0,Meme Difficulté,Adapte,Economy
183,2015,Économie,3,La Production,3,Valeur Ajouee et Mesure de la Richesse,7,184,2,QCU,0.46,0.2,32.08,27,56,83,72,27,45,1.15,37.5,Facile,Difficile,-2,Beaucoup plus Difficile,Pas Adapte,Economy
1307,2016,Économie,3,La Production,3,Valeur Ajouee et Mesure de la Richesse,7,184,2,QCU,0.07,0.91,77.06,72,22,94,93,72,21,1.01,77.42,Moyen,Facile,1,Plus Facile,Pas Adapte,Economy
2431,2017,Économie,3,La Production,3,Valeur Ajouee et Mesure de la Richesse,7,184,2,QCU,0.5,0.31,12.77,12,85,97,96,12,84,1.01,12.5,Difficile,Difficile,0,Meme Difficulté,Pas Adapte,Economy
3555,2018,Économie,3,La Production,3,Valeur Ajouee et Mesure de la Richesse,7,184,2,QCU,0.45,0.22,0.16,0,107,107,67,0,67,1.6,0.0,Moyen,Difficile,-1,Plus Difficile,Pas Adapte,Economy
4679,2019,Économie,3,La Production,3,Valeur Ajouee et Mesure de la Richesse,7,184,2,QCU,0.4,0.62,64.63,76,42,118,102,76,26,1.16,74.51,Difficile,Moyen,1,Plus Facile,Adapte,Economy
5803,2020,Économie,3,La Production,3,Valeur Ajouee et Mesure de la Richesse,7,184,2,QCU,0.31,0.54,64.63,69,38,107,96,69,27,1.11,71.88,Moyen,Moyen,0,Meme Difficulté,Adapte,Economy
184,2015,Économie,3,La Production,3,Valeur Ajouee et Mesure de la Richesse,7,185,3,QCU,0.02,0.92,66.62,17,8,25,19,17,2,1.32,89.47,Moyen,Facile,1,Plus Facile,Adapte,Economy
1308,2016,Économie,3,La Production,3,Valeur Ajouee et Mesure de la Richesse,7,185,3,QCU,0.02,0.78,66.62,19,10,29,19,19,0,1.53,100.0,Facile,Facile,0,Meme Difficulté,Adapte,Economy
2432,2017,Économie,3,La Production,3,Valeur Ajouee et Mesure de la Richesse,7,185,3,QCU,0.19,0.92,66.62,20,10,30,29,20,9,1.03,68.97,Facile,Facile,0,Meme Difficulté,Adapte,Economy
3556,2018,Économie,3,La Production,3,Valeur Ajouee et Mesure de la Richesse,7,185,3,QCU,0.0,0.93,66.62,19,10,29,24,19,5,1.21,79.17,Facile,Facile,0,Meme Difficulté,Adapte,Economy
4680,2019,Économie,3,La Production,3,Valeur Ajouee et Mesure de la Richesse,7,185,3,QCU,0.08,1.0,66.62,17,8,25,19,17,2,1.32,89.47,Facile,Facile,0,Meme Difficulté,Adapte,Economy
5804,2020,Économie,3,La Production,3,Valeur Ajouee et Mesure de la Richesse,7,185,3,QCM,0.13,0.91,66.62,14,7,21,19,14,5,1.11,73.68,Facile,Facile,0,Meme Difficulté,Adapte,Economy
185,2015,Économie,3,La Production,3,Valeur Ajouee et Mesure de la Richesse,7,186,4,QROC,0.67,0.22,12.04,10,75,85,39,10,29,2.18,25.64,Facile,Difficile,-2,Beaucoup plus Difficile,Pas Adapte,Economy
1309,2016,Économie,3,La Production,3,Valeur Ajouee et Mesure de la Richesse,7,186,4,QROC,0.51,0.26,36.0,26,46,72,65,26,39,1.11,40.0,Difficile,Moyen,1,Plus Facile,Pas Adapte,Economy
2433,2017,Économie,3,La Production,3,Valeur Ajouee et Mesure de la Richesse,7,186,4,QROC,0.41,0.3,63.66,41,23,64,41,41,0,1.56,100.0,Facile,Moyen,-1,Plus Difficile,Adapte,Economy
3557,2018,Économie,3,La Production,3,Valeur Ajouee et Mesure de la Richesse,7,186,4,QROC,0.23,0.27,63.66,41,23,64,49,41,8,1.31,83.67,Moyen,Moyen,0,Meme Difficulté,Adapte,Economy
4681,2019,Économie,3,La Production,3,Valeur Ajouee et Mesure de la Richesse,7,186,4,QROC,0.25,0.26,63.66,36,21,57,56,36,20,1.02,64.29,Moyen,Moyen,0,Meme Difficulté,Adapte,Economy
5805,2020,Économie,3,La Production,3,Valeur Ajouee et Mesure de la Richesse,7,186,4,QROC,0.33,0.36,63.66,42,24,66,62,42,20,1.06,67.74,Moyen,Moyen,0,Meme Difficulté,Adapte,Economy
186,2015,Économie,3,La Production,3,Valeur Ajouee et Mesure de la Richesse,7,187,5,QCU,0.61,0.4,25.57,21,61,82,40,21,19,2.05,52.5,Moyen,Difficile,-1,Plus Difficile,Pas Adapte,Economy
1310,2016,Économie,3,La Production,3,Valeur Ajouee et Mesure de la Richesse,7,187,5,QCU,0.03,0.87,93.81,83,5,88,86,83,3,1.02,96.51,Difficile,Facile,2,Beaucoup plus Facile,Pas Adapte,Economy
2434,2017,Économie,3,La Production,3,Valeur Ajouee et Mesure de la Richesse,7,187,5,QCU,0.63,0.38,24.03,20,65,85,66,20,46,1.29,30.3,Difficile,Difficile,0,Meme Difficulté,Pas Adapte,Economy
3558,2018,Économie,3,La Production,3,Valeur Ajouee et Mesure de la Richesse,7,187,5,QCU,0.29,0.4,38.72,33,52,85,83,33,50,1.02,39.76,Facile,Moyen,-1,Plus Difficile,Pas Adapte,Economy
4682,2019,Économie,3,La Production,3,Valeur Ajouee et Mesure de la Richesse,7,187,5,QCU,0.29,0.63,55.02,46,38,84,73,46,27,1.15,63.01,Difficile,Moyen,1,Plus Facile,Pas Adapte,Economy
5806,2020,Économie,3,La Production,3,Valeur Ajouee et Mesure de la Richesse,7,187,5,QCU,0.32,0.54,37.7,29,49,78,41,29,12,1.9,70.73,Facile,Moyen,-1,Plus Difficile,Pas Adapte,Economy
187,2015,Économie,3,La Production,3,Valeur Ajouee et Mesure de la Richesse,7,188,6,QCM,0.6,0.29,3.21,1,24,25,19,1,18,1.32,5.26,Facile,Difficile,-2,Beaucoup plus Difficile,Pas Adapte,Economy
1311,2016,Économie,3,La Production,3,Valeur Ajouee et Mesure de la Richesse,7,188,6,QCM,0.09,0.8,91.18,22,2,24,24,22,2,1.0,91.67,Moyen,Facile,1,Plus Facile,Pas Adapte,Economy
2435,2017,Économie,3,La Production,3,Valeur Ajouee et Mesure de la Richesse,7,188,6,QCM,0.15,0.9,70.94,16,6,22,16,16,0,1.38,100.0,Facile,Facile,0,Meme Difficulté,Adapte,Economy
3559,2018,Économie,3,La Production,3,Valeur Ajouee et Mesure de la Richesse,7,188,6,QCM,0.01,0.75,70.94,17,7,24,23,17,6,1.04,73.91,Facile,Facile,0,Meme Difficulté,Adapte,Economy
4683,2019,Économie,3,La Production,3,Valeur Ajouee et Mesure de la Richesse,7,188,6,QCM,0.17,0.72,70.94,14,6,20,16,14,2,1.25,87.5,Facile,Facile,0,Meme Difficulté,Adapte,Economy
5807,2020,Économie,3,La Production,3,Valeur Ajouee et Mesure de la Richesse,7,188,6,QCM,0.19,0.95,70.94,16,7,23,22,16,6,1.05,72.73,Facile,Facile,0,Meme Difficulté,Adapte,Economy
188,2015,Économie,3,La Production,3,Valeur Ajouee et Mesure de la Richesse,7,189,7,QCU,0.63,0.23,24.98,14,41,55,39,14,25,1.41,35.9,Facile,Difficile,-2,Beaucoup plus Difficile,Pas Adapte,Economy
1312,2016,Économie,3,La Production,3,Valeur Ajouee et Mesure de la Richesse,7,189,7,QROC,0.48,0.32,62.58,31,19,50,48,31,17,1.04,64.58,Facile,Moyen,-1,Plus Difficile,Adapte,Economy
2436,2017,Économie,3,La Production,3,Valeur Ajouee et Mesure de la Richesse,7,189,7,QROC,0.24,0.4,62.58,33,19,52,34,33,1,1.53,97.06,Moyen,Moyen,0,Meme Difficulté,Adapte,Economy
3560,2018,Économie,3,La Production,3,Valeur Ajouee et Mesure de la Richesse,7,189,7,QROC,0.41,0.33,62.58,34,21,55,35,34,1,1.57,97.14,Moyen,Moyen,0,Meme Difficulté,Adapte,Economy
4684,2019,Économie,3,La Production,3,Valeur Ajouee et Mesure de la Richesse,7,189,7,QO,0.46,0.22,62.58,39,23,62,57,39,18,1.09,68.42,Moyen,Moyen,0,Meme Difficulté,Adapte,Economy
5808,2020,Économie,3,La Production,3,Valeur Ajouee et Mesure de la Richesse,7,189,7,QO,0.57,0.19,62.58,39,23,62,44,39,5,1.41,88.64,Moyen,Moyen,0,Meme Difficulté,Adapte,Economy
189,2015,Économie,3,La Production,4,Les Limites de la Mesure de la Production,12,190,1,QCU,0.06,0.94,74.35,50,17,67,53,50,3,1.26,94.34,Moyen,Facile,1,Plus Facile,Adapte,Economy
1313,2016,Économie,3,La Production,4,Les Limites de la Mesure de la Production,12,190,1,QCU,0.07,0.83,74.35,51,17,68,59,51,8,1.15,86.44,Facile,Facile,0,Meme Difficulté,Adapte,Economy
2437,2017,Économie,3,La Production,4,Les Limites de la Mesure de la Production,12,190,1,QCM,0.02,0.72,74.35,55,19,74,58,55,3,1.28,94.83,Facile,Facile,0,Meme Difficulté,Adapte,Economy
3561,2018,Économie,3,La Production,4,Les Limites de la Mesure de la Production,12,190,1,QCM,0.08,0.88,74.35,62,22,84,72,62,10,1.17,86.11,Facile,Facile,0,Meme Difficulté,Adapte,Economy
4685,2019,Économie,3,La Production,4,Les Limites de la Mesure de la Production,12,190,1,QO,0.04,0.48,74.35,72,25,97,92,72,20,1.05,78.26,Facile,Facile,0,Meme Difficulté,Adapte,Economy
5809,2020,Économie,3,La Production,4,Les Limites de la Mesure de la Production,12,190,1,QO,0.08,0.35,74.35,83,29,112,89,83,6,1.26,93.26,Facile,Facile,0,Meme Difficulté,Adapte,Economy
190,2015,Économie,3,La Production,4,Les Limites de la Mesure de la Production,12,191,2,QCU,0.42,0.37,25.46,10,28,38,31,10,21,1.23,32.26,Facile,Difficile,-2,Beaucoup plus Difficile,Pas Adapte,Economy
1314,2016,Économie,3,La Production,4,Les Limites de la Mesure de la Production,12,191,2,QCU,0.07,0.88,97.12,34,1,35,34,34,0,1.03,100.0,Difficile,Facile,2,Beaucoup plus Facile,Pas Adapte,Economy
2438,2017,Économie,3,La Production,4,Les Limites de la Mesure de la Production,12,191,2,QCU,0.26,0.63,36.4,11,19,30,27,11,16,1.11,40.74,Difficile,Moyen,1,Plus Facile,Pas Adapte,Economy
3562,2018,Économie,3,La Production,4,Les Limites de la Mesure de la Production,12,191,2,QCU,0.4,0.57,63.08,21,13,34,22,21,1,1.55,95.45,Facile,Moyen,-1,Plus Difficile,Adapte,Economy
4686,2019,Économie,3,La Production,4,Les Limites de la Mesure de la Production,12,191,2,QCU,0.37,0.55,63.08,22,13,35,32,22,10,1.09,68.75,Moyen,Moyen,0,Meme Difficulté,Adapte,Economy
5810,2020,Économie,3,La Production,4,Les Limites de la Mesure de la Production,12,191,2,QCU,0.27,0.55,63.08,25,15,40,29,25,4,1.38,86.21,Moyen,Moyen,0,Meme Difficulté,Adapte,Economy
191,2015,Économie,3,La Production,4,Les Limites de la Mesure de la Production,12,192,3,QCM,0.01,0.96,88.73,22,3,25,23,22,1,1.09,95.65,Facile,Facile,0,Meme Difficulté,Pas Adapte,Economy
1315,2016,Économie,3,La Production,4,Les Limites de la Mesure de la Production,12,192,3,QCM,0.22,0.53,59.16,15,10,25,17,15,2,1.47,88.24,Difficile,Moyen,1,Plus Facile,Pas Adapte,Economy
2439,2017,Économie,3,La Production,4,Les Limites de la Mesure de la Production,12,192,3,QCM,0.07,0.98,87.41,25,4,29,25,25,0,1.16,100.0,Difficile,Facile,2,Beaucoup plus Facile,Pas Adapte,Economy
3563,2018,Économie,3,La Production,4,Les Limites de la Mesure de la Production,12,192,3,QCM,0.52,0.29,0.14,0,30,30,29,0,29,1.03,0.0,Difficile,Difficile,0,Meme Difficulté,Pas Adapte,Economy
4687,2019,Économie,3,La Production,4,Les Limites de la Mesure de la Production,12,192,3,QCM,0.03,0.91,93.59,26,2,28,28,26,2,1.0,92.86,Moyen,Facile,1,Plus Facile,Pas Adapte,Economy
5811,2020,Économie,3,La Production,4,Les Limites de la Mesure de la Production,12,192,3,QCU,0.32,0.44,54.46,14,11,25,24,14,10,1.04,58.33,Difficile,Moyen,1,Plus Facile,Pas Adapte,Economy
192,2015,Économie,3,La Production,4,Les Limites de la Mesure de la Production,12,193,4,QCU,0.41,0.37,7.27,1,7,8,7,1,6,1.14,14.29,Moyen,Difficile,-1,Plus Difficile,Pas Adapte,Economy
1316,2016,Économie,3,La Production,4,Les Limites de la Mesure de la Production,12,193,4,QCU,0.15,0.85,66.39,5,2,7,7,5,2,1.0,71.43,Difficile,Facile,2,Beaucoup plus Facile,Adapte,Economy
2440,2017,Économie,3,La Production,4,Les Limites de la Mesure de la Production,12,193,4,QCU,0.01,0.77,66.39,5,3,8,5,5,0,1.6,100.0,Facile,Facile,0,Meme Difficulté,Adapte,Economy
3564,2018,Économie,3,La Production,4,Les Limites de la Mesure de la Production,12,193,4,QCU,0.12,0.82,66.39,5,3,8,7,5,2,1.14,71.43,Facile,Facile,0,Meme Difficulté,Adapte,Economy
4688,2019,Économie,3,La Production,4,Les Limites de la Mesure de la Production,12,193,4,QCU,0.19,0.78,66.39,6,3,9,7,6,1,1.29,85.71,Facile,Facile,0,Meme Difficulté,Adapte,Economy
5812,2020,Économie,3,La Production,4,Les Limites de la Mesure de la Production,12,193,4,QROC,0.18,0.83,66.39,7,3,10,8,7,1,1.25,87.5,Facile,Facile,0,Meme Difficulté,Adapte,Economy
193,2015,Économie,3,La Production,4,Les Limites de la Mesure de la Production,12,194,5,QROC,0.06,0.55,95.38,20,1,21,20,20,0,1.05,100.0,Moyen,Facile,1,Plus Facile,Pas Adapte,Economy
1317,2016,Économie,3,La Production,4,Les Limites de la Mesure de la Production,12,194,5,QROC,0.36,0.3,59.31,13,9,22,15,13,2,1.47,86.67,Moyen,Moyen,0,Meme Difficulté,Pas Adapte,Economy
2441,2017,Économie,3,La Production,4,Les Limites de la Mesure de la Production,12,194,5,QROC,0.67,0.03,7.05,2,23,25,21,2,19,1.19,9.52,Difficile,Difficile,0,Meme Difficulté,Pas Adapte,Economy
3565,2018,Économie,3,La Production,4,Les Limites de la Mesure de la Production,12,194,5,QROC,0.48,0.38,41.93,10,15,25,18,10,8,1.39,55.56,Difficile,Moyen,1,Plus Facile,Pas Adapte,Economy
4689,2019,Économie,3,La Production,4,Les Limites de la Mesure de la Production,12,194,5,QO,0.94,0.01,12.2,3,20,23,19,3,16,1.21,15.79,Facile,Difficile,-2,Beaucoup plus Difficile,Pas Adapte,Economy
5813,2020,Économie,3,La Production,4,Les Limites de la Mesure de la Production,12,194,5,QO,0.87,0.02,19.31,4,16,20,15,4,11,1.33,26.67,Facile,Difficile,-2,Beaucoup plus Difficile,Pas Adapte,Economy
194,2015,Économie,3,La Production,4,Les Limites de la Mesure de la Production,12,195,6,QCU,0.09,0.88,95.82,35,2,37,35,35,0,1.06,100.0,Difficile,Facile,2,Beaucoup plus Facile,Pas Adapte,Economy
1318,2016,Économie,3,La Production,4,Les Limites de la Mesure de la Production,12,195,6,QCM,0.15,0.75,76.42,32,10,42,37,32,5,1.14,86.49,Facile,Facile,0,Meme Difficulté,Pas Adapte,Economy
2442,2017,Économie,3,La Production,4,Les Limites de la Mesure de la Production,12,195,6,QCM,0.19,0.9,94.95,35,2,37,35,35,0,1.06,100.0,Facile,Facile,0,Meme Difficulté,Pas Adapte,Economy
3566,2018,Économie,3,La Production,4,Les Limites de la Mesure de la Production,12,195,6,QCM,0.37,0.39,64.08,28,15,43,40,28,12,1.07,70.0,Moyen,Moyen,0,Meme Difficulté,Adapte,Economy
4690,2019,Économie,3,La Production,4,Les Limites de la Mesure de la Production,12,195,6,QCM,0.24,0.3,64.08,26,15,41,35,26,9,1.17,74.29,Moyen,Moyen,0,Meme Difficulté,Adapte,Economy
5814,2020,Économie,3,La Production,4,Les Limites de la Mesure de la Production,12,195,6,QCM,0.4,0.47,64.08,22,13,35,28,22,6,1.25,78.57,Moyen,Moyen,0,Meme Difficulté,Adapte,Economy
195,2015,Économie,3,La Production,4,Les Limites de la Mesure de la Production,12,196,7,QCU,0.7,0.22,31.94,2,5,7,4,2,2,1.75,50.0,Difficile,Difficile,0,Meme Difficulté,Pas Adapte,Economy
1319,2016,Économie,3,La Production,4,Les Limites de la Mesure de la Production,12,196,7,QCU,0.18,0.79,96.83,8,0,8,8,8,0,1.0,100.0,Moyen,Facile,1,Plus Facile,Pas Adapte,Economy
2443,2017,Économie,3,La Production,4,Les Limites de la Mesure de la Production,12,196,7,QCU,0.12,0.92,82.2,7,1,8,8,7,1,1.0,87.5,Facile,Facile,0,Meme Difficulté,Pas Adapte,Economy
3567,2018,Économie,3,La Production,4,Les Limites de la Mesure de la Production,12,196,7,QCU,0.03,0.76,67.03,6,3,9,7,6,1,1.29,85.71,Moyen,Facile,1,Plus Facile,Adapte,Economy
4691,2019,Économie,3,La Production,4,Les Limites de la Mesure de la Production,12,196,7,QCU,0.07,0.94,67.03,5,3,8,7,5,2,1.14,71.43,Facile,Facile,0,Meme Difficulté,Adapte,Economy
5815,2020,Économie,3,La Production,4,Les Limites de la Mesure de la Production,12,196,7,QCU,0.12,0.98,67.03,6,3,9,7,6,1,1.29,85.71,Facile,Facile,0,Meme Difficulté,Adapte,Economy
196,2015,Économie,3,La Production,4,Les Limites de la Mesure de la Production,12,197,8,QROC,0.25,0.38,60.04,22,14,36,24,22,2,1.5,91.67,Facile,Moyen,-1,Plus Difficile,Adapte,Economy
1320,2016,Économie,3,La Production,4,Les Limites de la Mesure de la Production,12,197,8,QROC,0.27,0.32,60.04,23,16,39,38,23,15,1.03,60.53,Moyen,Moyen,0,Meme Difficulté,Adapte,Economy
2444,2017,Économie,3,La Production,4,Les Limites de la Mesure de la Production,12,197,8,QO,0.52,0.22,60.04,21,14,35,31,21,10,1.13,67.74,Moyen,Moyen,0,Meme Difficulté,Adapte,Economy
3568,2018,Économie,3,La Production,4,Les Limites de la Mesure de la Production,12,197,8,QO,0.51,0.27,60.04,20,14,34,33,20,13,1.03,60.61,Moyen,Moyen,0,Meme Difficulté,Adapte,Economy
4692,2019,Économie,3,La Production,4,Les Limites de la Mesure de la Production,12,197,8,QO,0.75,0.21,60.04,19,12,31,26,19,7,1.19,73.08,Moyen,Moyen,0,Meme Difficulté,Adapte,Economy
5816,2020,Économie,3,La Production,4,Les Limites de la Mesure de la Production,12,197,8,QROC,0.6,0.27,60.04,19,13,32,30,19,11,1.07,63.33,Moyen,Moyen,0,Meme Difficulté,Adapte,Economy
197,2015,Économie,3,La Production,4,Les Limites de la Mesure de la Production,12,198,9,QCU,0.4,0.39,26.76,25,69,94,38,25,13,2.47,65.79,Facile,Difficile,-2,Beaucoup plus Difficile,Pas Adapte,Economy
1321,2016,Économie,3,La Production,4,Les Limites de la Mesure de la Production,12,198,9,QCU,0.14,0.89,72.77,60,22,82,79,60,19,1.04,75.95,Facile,Facile,0,Meme Difficulté,Adapte,Economy
2445,2017,Économie,3,La Production,4,Les Limites de la Mesure de la Production,12,198,9,QROC,0.15,0.69,72.77,57,21,78,71,57,14,1.1,80.28,Facile,Facile,0,Meme Difficulté,Adapte,Economy
3569,2018,Économie,3,La Production,4,Les Limites de la Mesure de la Production,12,198,9,QO,0.16,0.61,72.77,62,23,85,63,62,1,1.35,98.41,Facile,Facile,0,Meme Difficulté,Adapte,Economy
4693,2019,Économie,3,La Production,4,Les Limites de la Mesure de la Production,12,198,9,QO,0.1,0.82,72.77,71,27,98,97,71,26,1.01,73.2,Facile,Facile,0,Meme Difficulté,Adapte,Economy
5817,2020,Économie,3,La Production,4,Les Limites de la Mesure de la Production,12,198,9,QO,0.16,0.85,72.77,72,27,99,77,72,5,1.29,93.51,Facile,Facile,0,Meme Difficulté,Adapte,Economy
198,2015,Économie,3,La Production,4,Les Limites de la Mesure de la Production,12,199,10,QROC,0.24,0.33,52.71,32,29,61,56,32,24,1.09,57.14,Facile,Moyen,-1,Plus Difficile,Pas Adapte,Economy
1322,2016,Économie,3,La Production,4,Les Limites de la Mesure de la Production,12,199,10,QROC,0.85,0.22,0.97,1,56,57,38,1,37,1.5,2.63,Difficile,Difficile,0,Meme Difficulté,Pas Adapte,Economy
2446,2017,Économie,3,La Production,4,Les Limites de la Mesure de la Production,12,199,10,QROC,0.45,0.28,53.55,26,22,48,30,26,4,1.6,86.67,Moyen,Moyen,0,Meme Difficulté,Pas Adapte,Economy
3570,2018,Économie,3,La Production,4,Les Limites de la Mesure de la Production,12,199,10,QROC,0.21,0.32,59.46,26,17,43,33,26,7,1.3,78.79,Difficile,Moyen,1,Plus Facile,Pas Adapte,Economy
4694,2019,Économie,3,La Production,4,Les Limites de la Mesure de la Production,12,199,10,QROC,0.3,0.33,56.21,21,16,37,36,21,15,1.03,58.33,Difficile,Moyen,1,Plus Facile,Pas Adapte,Economy
5818,2020,Économie,3,La Production,4,Les Limites de la Mesure de la Production,12,199,10,QROC,0.92,0.12,11.9,4,32,36,25,4,21,1.44,16.0,Facile,Difficile,-2,Beaucoup plus Difficile,Pas Adapte,Economy
199,2015,Économie,3,La Production,4,Les Limites de la Mesure de la Production,12,200,11,QCU,0.57,0.32,11.24,3,22,25,19,3,16,1.32,15.79,Moyen,Difficile,-1,Plus Difficile,Pas Adapte,Economy
1323,2016,Économie,3,La Production,4,Les Limites de la Mesure de la Production,12,200,11,QCU,0.16,0.86,75.79,16,5,21,16,16,0,1.31,100.0,Moyen,Facile,1,Plus Facile,Pas Adapte,Economy
2447,2017,Économie,3,La Production,4,Les Limites de la Mesure de la Production,12,200,11,QCU,0.26,0.67,60.07,11,7,18,14,11,3,1.29,78.57,Facile,Moyen,-1,Plus Difficile,Adapte,Economy
3571,2018,Économie,3,La Production,4,Les Limites de la Mesure de la Production,12,200,11,QCU,0.4,0.45,60.07,13,8,21,20,13,7,1.05,65.0,Moyen,Moyen,0,Meme Difficulté,Adapte,Economy
4695,2019,Économie,3,La Production,4,Les Limites de la Mesure de la Production,12,200,11,QCU,0.33,0.65,60.07,12,8,20,14,12,2,1.43,85.71,Moyen,Moyen,0,Meme Difficulté,Adapte,Economy
5819,2020,Économie,3,La Production,4,Les Limites de la Mesure de la Production,12,200,11,QCU,0.33,0.44,60.07,13,8,21,16,13,3,1.31,81.25,Moyen,Moyen,0,Meme Difficulté,Adapte,Economy
200,2015,Économie,3,La Production,4,Les Limites de la Mesure de la Production,12,201,12,QROC,0.13,0.65,69.86,43,18,61,57,43,14,1.07,75.44,Moyen,Facile,1,Plus Facile,Adapte,Economy
1324,2016,Économie,3,La Production,4,Les Limites de la Mesure de la Production,12,201,12,QROC,0.16,0.92,69.86,37,16,53,47,37,10,1.13,78.72,Facile,Facile,0,Meme Difficulté,Adapte,Economy
2448,2017,Économie,3,La Production,4,Les Limites de la Mesure de la Production,12,201,12,QROC,0.12,0.66,69.86,43,18,61,47,43,4,1.3,91.49,Facile,Facile,0,Meme Difficulté,Adapte,Economy
3572,2018,Économie,3,La Production,4,Les Limites de la Mesure de la Production,12,201,12,QO,0.05,0.79,69.86,44,19,63,57,44,13,1.11,77.19,Facile,Facile,0,Meme Difficulté,Adapte,Economy
4696,2019,Économie,3,La Production,4,Les Limites de la Mesure de la Production,12,201,12,QO,0.01,0.33,69.86,48,20,68,49,48,1,1.39,97.96,Facile,Facile,0,Meme Difficulté,Adapte,Economy
5820,2020,Économie,3,La Production,4,Les Limites de la Mesure de la Production,12,201,12,QO,0.17,0.83,69.86,53,23,76,53,53,0,1.43,100.0,Facile,Facile,0,Meme Difficulté,Adapte,Economy
201,2015,Économie,4,Le Travail,1,Les Aspects Quantitatifs et Qualitatifs du Travail,9,202,1,QCU,0.47,0.39,20.85,1,4,5,5,1,4,1.0,20.0,Difficile,Difficile,0,Meme Difficulté,Pas Adapte,Economy
1325,2016,Économie,4,Le Travail,1,Les Aspects Quantitatifs et Qualitatifs du Travail,9,202,1,QCU,0.65,0.39,26.51,1,3,4,4,1,3,1.0,25.0,Facile,Difficile,-2,Beaucoup plus Difficile,Pas Adapte,Economy
2449,2017,Économie,4,Le Travail,1,Les Aspects Quantitatifs et Qualitatifs du Travail,9,202,1,QCU,0.28,0.53,58.6,2,2,4,2,2,0,2.0,100.0,Moyen,Moyen,0,Meme Difficulté,Pas Adapte,Economy
3573,2018,Économie,4,Le Travail,1,Les Aspects Quantitatifs et Qualitatifs du Travail,9,202,1,QCU,0.19,0.99,83.05,2,1,3,2,2,0,1.5,100.0,Facile,Facile,0,Meme Difficulté,Pas Adapte,Economy
4697,2019,Économie,4,Le Travail,1,Les Aspects Quantitatifs et Qualitatifs du Travail,9,202,1,QCU,0.18,1.0,94.5,3,0,3,3,3,0,1.0,100.0,Moyen,Facile,1,Plus Facile,Pas Adapte,Economy
5821,2020,Économie,4,Le Travail,1,Les Aspects Quantitatifs et Qualitatifs du Travail,9,202,1,QCU,0.24,0.66,62.42,2,1,3,3,2,1,1.0,66.67,Moyen,Moyen,0,Meme Difficulté,Adapte,Economy
202,2015,Économie,4,Le Travail,1,Les Aspects Quantitatifs et Qualitatifs du Travail,9,203,2,QCU,0.39,0.66,64.36,42,23,65,55,42,13,1.18,76.36,Facile,Moyen,-1,Plus Difficile,Adapte,Economy
1326,2016,Économie,4,Le Travail,1,Les Aspects Quantitatifs et Qualitatifs du Travail,9,203,2,QCU,0.36,0.72,64.36,35,20,55,50,35,15,1.1,70.0,Moyen,Moyen,0,Meme Difficulté,Adapte,Economy
2450,2017,Économie,4,Le Travail,1,Les Aspects Quantitatifs et Qualitatifs du Travail,9,203,2,QCU,0.33,0.63,64.36,38,21,59,50,38,12,1.18,76.0,Moyen,Moyen,0,Meme Difficulté,Adapte,Economy
3574,2018,Économie,4,Le Travail,1,Les Aspects Quantitatifs et Qualitatifs du Travail,9,203,2,QCU,0.28,0.69,64.36,38,21,59,56,38,18,1.05,67.86,Moyen,Moyen,0,Meme Difficulté,Adapte,Economy
4698,2019,Économie,4,Le Travail,1,Les Aspects Quantitatifs et Qualitatifs du Travail,9,203,2,QCM,0.46,0.32,64.36,32,18,50,41,32,9,1.22,78.05,Moyen,Moyen,0,Meme Difficulté,Adapte,Economy
5822,2020,Économie,4,Le Travail,1,Les Aspects Quantitatifs et Qualitatifs du Travail,9,203,2,QCM,0.49,0.42,64.36,32,18,50,40,32,8,1.25,80.0,Moyen,Moyen,0,Meme Difficulté,Adapte,Economy
203,2015,Économie,4,Le Travail,1,Les Aspects Quantitatifs et Qualitatifs du Travail,9,204,3,QO,0.8,0.1,24.16,8,27,35,24,8,16,1.46,33.33,Facile,Difficile,-2,Beaucoup plus Difficile,Pas Adapte,Economy
1327,2016,Économie,4,Le Travail,1,Les Aspects Quantitatifs et Qualitatifs du Travail,9,204,3,QO,0.14,0.62,90.46,27,3,30,30,27,3,1.0,90.0,Facile,Facile,0,Meme Difficulté,Pas Adapte,Economy
2451,2017,Économie,4,Le Travail,1,Les Aspects Quantitatifs et Qualitatifs du Travail,9,204,3,QO,0.93,0.01,8.2,3,29,32,18,3,15,1.78,16.67,Difficile,Difficile,0,Meme Difficulté,Pas Adapte,Economy
3575,2018,Économie,4,Le Travail,1,Les Aspects Quantitatifs et Qualitatifs du Travail,9,204,3,QO,0.3,0.29,41.44,15,20,35,22,15,7,1.59,68.18,Moyen,Moyen,0,Meme Difficulté,Pas Adapte,Economy
4699,2019,Économie,4,Le Travail,1,Les Aspects Quantitatifs et Qualitatifs du Travail,9,204,3,QO,0.5,0.19,60.06,22,14,36,30,22,8,1.2,73.33,Difficile,Moyen,1,Plus Facile,Adapte,Economy
5823,2020,Économie,4,Le Travail,1,Les Aspects Quantitatifs et Qualitatifs du Travail,9,204,3,QROC,0.43,0.33,60.06,23,16,39,24,23,1,1.62,95.83,Moyen,Moyen,0,Meme Difficulté,Adapte,Economy
204,2015,Économie,4,Le Travail,1,Les Aspects Quantitatifs et Qualitatifs du Travail,9,205,4,QROC,0.4,0.34,37.76,22,35,57,43,22,21,1.33,51.16,Facile,Moyen,-1,Plus Difficile,Pas Adapte,Economy
1328,2016,Économie,4,Le Travail,1,Les Aspects Quantitatifs et Qualitatifs du Travail,9,205,4,QO,0.04,0.7,99.33,63,0,63,63,63,0,1.0,100.0,Facile,Facile,0,Meme Difficulté,Pas Adapte,Economy
2452,2017,Économie,4,Le Travail,1,Les Aspects Quantitatifs et Qualitatifs du Travail,9,205,4,QO,0.17,0.57,82.84,54,11,65,61,54,7,1.07,88.52,Facile,Facile,0,Meme Difficulté,Pas Adapte,Economy
3576,2018,Économie,4,Le Travail,1,Les Aspects Quantitatifs et Qualitatifs du Travail,9,205,4,QO,0.78,0.14,20.62,13,52,65,55,13,42,1.18,23.64,Difficile,Difficile,0,Meme Difficulté,Pas Adapte,Economy
4700,2019,Économie,4,Le Travail,1,Les Aspects Quantitatifs et Qualitatifs du Travail,9,205,4,QO,0.05,0.73,95.88,57,2,59,57,57,0,1.04,100.0,Moyen,Facile,1,Plus Facile,Pas Adapte,Economy
5824,2020,Économie,4,Le Travail,1,Les Aspects Quantitatifs et Qualitatifs du Travail,9,205,4,QO,0.52,0.2,46.41,26,31,57,55,26,29,1.04,47.27,Facile,Moyen,-1,Plus Difficile,Pas Adapte,Economy
205,2015,Économie,4,Le Travail,1,Les Aspects Quantitatifs et Qualitatifs du Travail,9,206,5,QCM,0.12,0.87,77.12,35,11,46,44,35,9,1.05,79.55,Moyen,Facile,1,Plus Facile,Pas Adapte,Economy
1329,2016,Économie,4,Le Travail,1,Les Aspects Quantitatifs et Qualitatifs du Travail,9,206,5,QCM,0.42,0.55,64.12,26,14,40,28,26,2,1.43,92.86,Difficile,Moyen,1,Plus Facile,Adapte,Economy
2453,2017,Économie,4,Le Travail,1,Les Aspects Quantitatifs et Qualitatifs du Travail,9,206,5,QCM,0.34,0.31,64.12,29,16,45,41,29,12,1.1,70.73,Moyen,Moyen,0,Meme Difficulté,Adapte,Economy
3577,2018,Économie,4,Le Travail,1,Les Aspects Quantitatifs et Qualitatifs du Travail,9,206,5,QCM,0.3,0.37,64.12,26,15,41,33,26,7,1.24,78.79,Moyen,Moyen,0,Meme Difficulté,Adapte,Economy
4701,2019,Économie,4,Le Travail,1,Les Aspects Quantitatifs et Qualitatifs du Travail,9,206,5,QCM,0.43,0.53,64.12,25,14,39,32,25,7,1.22,78.12,Moyen,Moyen,0,Meme Difficulté,Adapte,Economy
5825,2020,Économie,4,Le Travail,1,Les Aspects Quantitatifs et Qualitatifs du Travail,9,206,5,QCM,0.42,0.53,64.12,29,16,45,31,29,2,1.45,93.55,Moyen,Moyen,0,Meme Difficulté,Adapte,Economy
206,2015,Économie,4,Le Travail,1,Les Aspects Quantitatifs et Qualitatifs du Travail,9,207,6,QCM,0.39,0.67,50.9,7,7,14,9,7,2,1.56,77.78,Facile,Moyen,-1,Plus Difficile,Pas Adapte,Economy
1330,2016,Économie,4,Le Travail,1,Les Aspects Quantitatifs et Qualitatifs du Travail,9,207,6,QCM,0.63,0.18,10.47,1,13,14,8,1,7,1.75,12.5,Difficile,Difficile,0,Meme Difficulté,Pas Adapte,Economy
2454,2017,Économie,4,Le Travail,1,Les Aspects Quantitatifs et Qualitatifs du Travail,9,207,6,QCM,0.01,0.7,89.19,12,2,14,14,12,2,1.0,85.71,Moyen,Facile,1,Plus Facile,Pas Adapte,Economy
3578,2018,Économie,4,Le Travail,1,Les Aspects Quantitatifs et Qualitatifs du Travail,9,207,6,QCM,0.19,0.86,83.52,13,3,16,16,13,3,1.0,81.25,Facile,Facile,0,Meme Difficulté,Pas Adapte,Economy
4702,2019,Économie,4,Le Travail,1,Les Aspects Quantitatifs et Qualitatifs du Travail,9,207,6,QROC,0.93,0.12,30.61,4,10,14,12,4,8,1.17,33.33,Facile,Difficile,-2,Beaucoup plus Difficile,Pas Adapte,Economy
5826,2020,Économie,4,Le Travail,1,Les Aspects Quantitatifs et Qualitatifs du Travail,9,207,6,QROC,0.3,0.25,39.09,5,7,12,5,5,0,2.4,100.0,Difficile,Moyen,1,Plus Facile,Pas Adapte,Economy
207,2015,Économie,4,Le Travail,1,Les Aspects Quantitatifs et Qualitatifs du Travail,9,208,7,QO,0.29,0.26,59.77,59,40,99,63,59,4,1.57,93.65,Difficile,Moyen,1,Plus Facile,Pas Adapte,Economy
1331,2016,Économie,4,Le Travail,1,Les Aspects Quantitatifs et Qualitatifs du Travail,9,208,7,QO,0.59,0.22,45.98,49,57,106,105,49,56,1.01,46.67,Facile,Moyen,-1,Plus Difficile,Pas Adapte,Economy
2455,2017,Économie,4,Le Travail,1,Les Aspects Quantitatifs et Qualitatifs du Travail,9,208,7,QO,0.75,0.01,30.79,28,64,92,56,28,28,1.64,50.0,Difficile,Difficile,0,Meme Difficulté,Pas Adapte,Economy
3579,2018,Économie,4,Le Travail,1,Les Aspects Quantitatifs et Qualitatifs du Travail,9,208,7,QO,0.07,0.63,71.18,56,22,78,71,56,15,1.1,78.87,Difficile,Facile,2,Beaucoup plus Facile,Adapte,Economy
4703,2019,Économie,4,Le Travail,1,Les Aspects Quantitatifs et Qualitatifs du Travail,9,208,7,QO,0.09,0.39,71.18,53,21,74,60,53,7,1.23,88.33,Facile,Facile,0,Meme Difficulté,Adapte,Economy
5827,2020,Économie,4,Le Travail,1,Les Aspects Quantitatifs et Qualitatifs du Travail,9,208,7,QO,0.16,0.96,71.18,46,18,64,51,46,5,1.25,90.2,Facile,Facile,0,Meme Difficulté,Adapte,Economy
208,2015,Économie,4,Le Travail,1,Les Aspects Quantitatifs et Qualitatifs du Travail,9,209,8,QCU,0.61,0.33,16.24,6,34,40,17,6,11,2.35,35.29,Facile,Difficile,-2,Beaucoup plus Difficile,Pas Adapte,Economy
1332,2016,Économie,4,Le Travail,1,Les Aspects Quantitatifs et Qualitatifs du Travail,9,209,8,QCU,0.01,0.8,77.77,30,8,38,31,30,1,1.23,96.77,Moyen,Facile,1,Plus Facile,Pas Adapte,Economy
2456,2017,Économie,4,Le Travail,1,Les Aspects Quantitatifs et Qualitatifs du Travail,9,209,8,QCU,0.18,0.78,72.91,26,10,36,31,26,5,1.16,83.87,Moyen,Facile,1,Plus Facile,Adapte,Economy
3580,2018,Économie,4,Le Travail,1,Les Aspects Quantitatifs et Qualitatifs du Travail,9,209,8,QCU,0.16,0.93,72.91,23,9,32,25,23,2,1.28,92.0,Facile,Facile,0,Meme Difficulté,Adapte,Economy
4704,2019,Économie,4,Le Travail,1,Les Aspects Quantitatifs et Qualitatifs du Travail,9,209,8,QCU,0.2,0.86,72.91,26,10,36,35,26,9,1.03,74.29,Facile,Facile,0,Meme Difficulté,Adapte,Economy
5828,2020,Économie,4,Le Travail,1,Les Aspects Quantitatifs et Qualitatifs du Travail,9,209,8,QCU,0.2,0.8,72.91,28,10,38,28,28,0,1.36,100.0,Facile,Facile,0,Meme Difficulté,Adapte,Economy
209,2015,Économie,4,Le Travail,1,Les Aspects Quantitatifs et Qualitatifs du Travail,9,210,9,QROC,0.5,0.39,41.66,8,11,19,16,8,8,1.19,50.0,Facile,Moyen,-1,Plus Difficile,Pas Adapte,Economy
1333,2016,Économie,4,Le Travail,1,Les Aspects Quantitatifs et Qualitatifs du Travail,9,210,9,QO,0.89,0.14,23.1,5,17,22,17,5,12,1.29,29.41,Facile,Difficile,-2,Beaucoup plus Difficile,Pas Adapte,Economy
2457,2017,Économie,4,Le Travail,1,Les Aspects Quantitatifs et Qualitatifs du Travail,9,210,9,QO,0.96,0.04,30.07,6,14,20,18,6,12,1.11,33.33,Difficile,Difficile,0,Meme Difficulté,Pas Adapte,Economy
3581,2018,Économie,4,Le Travail,1,Les Aspects Quantitatifs et Qualitatifs du Travail,9,210,9,QO,0.55,0.19,53.83,10,8,18,11,10,1,1.64,90.91,Facile,Moyen,-1,Plus Difficile,Pas Adapte,Economy
4705,2019,Économie,4,Le Travail,1,Les Aspects Quantitatifs et Qualitatifs du Travail,9,210,9,QO,0.45,0.17,53.68,11,10,21,14,11,3,1.5,78.57,Difficile,Moyen,1,Plus Facile,Pas Adapte,Economy
5829,2020,Économie,4,Le Travail,1,Les Aspects Quantitatifs et Qualitatifs du Travail,9,210,9,QO,0.03,0.41,81.4,15,3,18,18,15,3,1.0,83.33,Facile,Facile,0,Meme Difficulté,Pas Adapte,Economy
210,2015,Économie,4,Le Travail,2,La Productivite du Travail et la Notion de Capital Humain,8,211,1,QCM,0.52,0.2,7.99,5,61,66,52,5,47,1.27,9.62,Facile,Difficile,-2,Beaucoup plus Difficile,Pas Adapte,Economy
1334,2016,Économie,4,Le Travail,2,La Productivite du Travail et la Notion de Capital Humain,8,211,1,QCM,0.72,0.18,32.09,23,50,73,27,23,4,2.7,85.19,Facile,Difficile,-2,Beaucoup plus Difficile,Pas Adapte,Economy
2458,2017,Économie,4,Le Travail,2,La Productivite du Travail et la Notion de Capital Humain,8,211,1,QCM,0.28,0.52,58.06,39,29,68,45,39,6,1.51,86.67,Moyen,Moyen,0,Meme Difficulté,Pas Adapte,Economy
3582,2018,Économie,4,Le Travail,2,La Productivite du Travail et la Notion de Capital Humain,8,211,1,QCM,0.53,0.27,13.37,9,61,70,53,9,44,1.32,16.98,Moyen,Difficile,-1,Plus Difficile,Pas Adapte,Economy
4706,2019,Économie,4,Le Travail,2,La Productivite du Travail et la Notion de Capital Humain,8,211,1,QCU,0.68,0.25,27.29,21,56,77,57,21,36,1.35,36.84,Moyen,Difficile,-1,Plus Difficile,Pas Adapte,Economy
5830,2020,Économie,4,Le Travail,2,La Productivite du Travail et la Notion de Capital Humain,8,211,1,QCU,0.66,0.4,16.44,14,74,88,40,14,26,2.2,35.0,Difficile,Difficile,0,Meme Difficulté,Pas Adapte,Economy
211,2015,Économie,4,Le Travail,2,La Productivite du Travail et la Notion de Capital Humain,8,212,2,QCU,0.18,0.85,82.91,58,12,70,65,58,7,1.08,89.23,Facile,Facile,0,Meme Difficulté,Pas Adapte,Economy
1335,2016,Économie,4,Le Travail,2,La Productivite du Travail et la Notion de Capital Humain,8,212,2,QCU,0.14,0.9,72.63,58,22,80,65,58,7,1.23,89.23,Facile,Facile,0,Meme Difficulté,Adapte,Economy
2459,2017,Économie,4,Le Travail,2,La Productivite du Travail et la Notion de Capital Humain,8,212,2,QCU,0.04,0.88,72.63,59,22,81,61,59,2,1.33,96.72,Facile,Facile,0,Meme Difficulté,Adapte,Economy
3583,2018,Économie,4,Le Travail,2,La Productivite du Travail et la Notion de Capital Humain,8,212,2,QCU,0.19,0.88,72.63,55,21,76,75,55,20,1.01,73.33,Facile,Facile,0,Meme Difficulté,Adapte,Economy
4707,2019,Économie,4,Le Travail,2,La Productivite du Travail et la Notion de Capital Humain,8,212,2,QCU,0.13,0.8,72.63,58,22,80,77,58,19,1.04,75.32,Facile,Facile,0,Meme Difficulté,Adapte,Economy
5831,2020,Économie,4,Le Travail,2,La Productivite du Travail et la Notion de Capital Humain,8,212,2,QCU,0.04,0.83,72.63,66,25,91,75,66,9,1.21,88.0,Facile,Facile,0,Meme Difficulté,Adapte,Economy
212,2015,Économie,4,Le Travail,2,La Productivite du Travail et la Notion de Capital Humain,8,213,3,QROC,0.31,0.4,35.22,17,31,48,25,17,8,1.92,68.0,Difficile,Moyen,1,Plus Facile,Pas Adapte,Economy
1336,2016,Économie,4,Le Travail,2,La Productivite du Travail et la Notion de Capital Humain,8,213,3,QO,0.61,0.16,51.64,25,23,48,39,25,14,1.23,64.1,Facile,Moyen,-1,Plus Difficile,Pas Adapte,Economy
2460,2017,Économie,4,Le Travail,2,La Productivite du Travail et la Notion de Capital Humain,8,213,3,QO,0.63,0.25,52.66,28,25,53,48,28,20,1.1,58.33,Facile,Moyen,-1,Plus Difficile,Pas Adapte,Economy
3584,2018,Économie,4,Le Travail,2,La Productivite du Travail et la Notion de Capital Humain,8,213,3,QO,0.86,0.08,22.12,11,37,48,45,11,34,1.07,24.44,Difficile,Difficile,0,Meme Difficulté,Pas Adapte,Economy
4708,2019,Économie,4,Le Travail,2,La Productivite du Travail et la Notion de Capital Humain,8,213,3,QO,0.18,0.37,81.93,43,9,52,47,43,4,1.11,91.49,Difficile,Facile,2,Beaucoup plus Facile,Pas Adapte,Economy
5832,2020,Économie,4,Le Travail,2,La Productivite du Travail et la Notion de Capital Humain,8,213,3,QCM,0.59,0.21,24.21,11,33,44,14,11,3,3.14,78.57,Moyen,Difficile,-1,Plus Difficile,Pas Adapte,Economy
213,2015,Économie,4,Le Travail,2,La Productivite du Travail et la Notion de Capital Humain,8,214,4,QROC,0.09,0.96,69.53,61,27,88,66,61,5,1.33,92.42,Facile,Facile,0,Meme Difficulté,Adapte,Economy
1337,2016,Économie,4,Le Travail,2,La Productivite du Travail et la Notion de Capital Humain,8,214,4,QROC,0.06,0.59,69.53,59,26,85,71,59,12,1.2,83.1,Facile,Facile,0,Meme Difficulté,Adapte,Economy
2461,2017,Économie,4,Le Travail,2,La Productivite du Travail et la Notion de Capital Humain,8,214,4,QROC,0.05,0.49,69.53,63,28,91,89,63,26,1.02,70.79,Facile,Facile,0,Meme Difficulté,Adapte,Economy
3585,2018,Économie,4,Le Travail,2,La Productivite du Travail et la Notion de Capital Humain,8,214,4,QROC,0.01,0.66,69.53,58,26,84,63,58,5,1.33,92.06,Facile,Facile,0,Meme Difficulté,Adapte,Economy
4709,2019,Économie,4,Le Travail,2,La Productivite du Travail et la Notion de Capital Humain,8,214,4,QROC,0.16,0.56,69.53,50,22,72,58,50,8,1.24,86.21,Facile,Facile,0,Meme Difficulté,Adapte,Economy
5833,2020,Économie,4,Le Travail,2,La Productivite du Travail et la Notion de Capital Humain,8,214,4,QROC,0.18,0.7,69.53,44,19,63,58,44,14,1.09,75.86,Facile,Facile,0,Meme Difficulté,Adapte,Economy
214,2015,Économie,4,Le Travail,2,La Productivite du Travail et la Notion de Capital Humain,8,215,5,QCM,0.78,0.16,11.51,1,4,5,3,1,2,1.67,33.33,Moyen,Difficile,-1,Plus Difficile,Pas Adapte,Economy
1338,2016,Économie,4,Le Travail,2,La Productivite du Travail et la Notion de Capital Humain,8,215,5,QCM,0.14,1.0,68.78,3,1,4,4,3,1,1.0,75.0,Moyen,Facile,1,Plus Facile,Adapte,Economy
2462,2017,Économie,4,Le Travail,2,La Productivite du Travail et la Notion de Capital Humain,8,215,5,QCM,0.04,0.76,68.78,2,1,3,2,2,0,1.5,100.0,Facile,Facile,0,Meme Difficulté,Adapte,Economy
3586,2018,Économie,4,Le Travail,2,La Productivite du Travail et la Notion de Capital Humain,8,215,5,QCM,0.07,0.82,68.78,2,1,3,2,2,0,1.5,100.0,Facile,Facile,0,Meme Difficulté,Adapte,Economy
4710,2019,Économie,4,Le Travail,2,La Productivite du Travail et la Notion de Capital Humain,8,215,5,QCM,0.12,0.89,68.78,2,1,3,2,2,0,1.5,100.0,Facile,Facile,0,Meme Difficulté,Adapte,Economy
5834,2020,Économie,4,Le Travail,2,La Productivite du Travail et la Notion de Capital Humain,8,215,5,QROC,0.13,0.94,68.78,2,1,3,3,2,1,1.0,66.67,Facile,Facile,0,Meme Difficulté,Adapte,Economy
215,2015,Économie,4,Le Travail,2,La Productivite du Travail et la Notion de Capital Humain,8,216,6,QCM,0.54,0.16,22.45,12,41,53,30,12,18,1.77,40.0,Difficile,Difficile,0,Meme Difficulté,Pas Adapte,Economy
1339,2016,Économie,4,Le Travail,2,La Productivite du Travail et la Notion de Capital Humain,8,216,6,QCM,0.25,0.65,39.16,21,33,54,33,21,12,1.64,63.64,Moyen,Moyen,0,Meme Difficulté,Pas Adapte,Economy
2463,2017,Économie,4,Le Travail,2,La Productivite du Travail et la Notion de Capital Humain,8,216,6,QCM,0.02,0.74,82.67,38,8,46,39,38,1,1.18,97.44,Difficile,Facile,2,Beaucoup plus Facile,Pas Adapte,Economy
3587,2018,Économie,4,Le Travail,2,La Productivite du Travail et la Notion de Capital Humain,8,216,6,QCM,0.58,0.26,0.09,0,52,52,51,0,51,1.02,0.0,Facile,Difficile,-2,Beaucoup plus Difficile,Pas Adapte,Economy
4711,2019,Économie,4,Le Travail,2,La Productivite du Travail et la Notion de Capital Humain,8,216,6,QCU,0.07,0.87,97.37,57,2,59,58,57,1,1.02,98.28,Facile,Facile,0,Meme Difficulté,Pas Adapte,Economy
5835,2020,Économie,4,Le Travail,2,La Productivite du Travail et la Notion de Capital Humain,8,216,6,QCU,0.38,0.45,45.08,27,32,59,31,27,4,1.9,87.1,Difficile,Moyen,1,Plus Facile,Pas Adapte,Economy
216,2015,Économie,4,Le Travail,2,La Productivite du Travail et la Notion de Capital Humain,8,217,7,QCM,0.12,0.75,89.11,13,2,15,14,13,1,1.07,92.86,Facile,Facile,0,Meme Difficulté,Pas Adapte,Economy
1340,2016,Économie,4,Le Travail,2,La Productivite du Travail et la Notion de Capital Humain,8,217,7,QCM,0.74,0.25,5.97,1,16,17,14,1,13,1.21,7.14,Facile,Difficile,-2,Beaucoup plus Difficile,Pas Adapte,Economy
2464,2017,Économie,4,Le Travail,2,La Productivite du Travail et la Notion de Capital Humain,8,217,7,QCM,0.3,0.45,48.75,9,10,19,14,9,5,1.36,64.29,Facile,Moyen,-1,Plus Difficile,Pas Adapte,Economy
3588,2018,Économie,4,Le Travail,2,La Productivite du Travail et la Notion de Capital Humain,8,217,7,QROC,0.06,0.65,94.07,19,1,20,19,19,0,1.05,100.0,Moyen,Facile,1,Plus Facile,Pas Adapte,Economy
4712,2019,Économie,4,Le Travail,2,La Productivite du Travail et la Notion de Capital Humain,8,217,7,QO,0.89,0.12,10.82,2,21,23,20,2,18,1.15,10.0,Moyen,Difficile,-1,Plus Difficile,Pas Adapte,Economy
5836,2020,Économie,4,Le Travail,2,La Productivite du Travail et la Notion de Capital Humain,8,217,7,QO,0.14,0.74,68.65,15,7,22,19,15,4,1.16,78.95,Facile,Facile,0,Meme Difficulté,Adapte,Economy
217,2015,Économie,4,Le Travail,2,La Productivite du Travail et la Notion de Capital Humain,8,218,8,QCM,0.06,0.92,69.34,25,11,36,28,25,3,1.29,89.29,Moyen,Facile,1,Plus Facile,Adapte,Economy
1341,2016,Économie,4,Le Travail,2,La Productivite du Travail et la Notion de Capital Humain,8,218,8,QCM,0.18,0.76,69.34,28,13,41,41,28,13,1.0,68.29,Facile,Facile,0,Meme Difficulté,Adapte,Economy
2465,2017,Économie,4,Le Travail,2,La Productivite du Travail et la Notion de Capital Humain,8,218,8,QCM,0.18,0.73,69.34,24,11,35,24,24,0,1.46,100.0,Facile,Facile,0,Meme Difficulté,Adapte,Economy
3589,2018,Économie,4,Le Travail,2,La Productivite du Travail et la Notion de Capital Humain,8,218,8,QCM,0.04,0.75,69.34,24,11,35,34,24,10,1.03,70.59,Facile,Facile,0,Meme Difficulté,Adapte,Economy
4713,2019,Économie,4,Le Travail,2,La Productivite du Travail et la Notion de Capital Humain,8,218,8,QCM,0.08,0.95,69.34,21,10,31,24,21,3,1.29,87.5,Facile,Facile,0,Meme Difficulté,Adapte,Economy
5837,2020,Économie,4,Le Travail,2,La Productivite du Travail et la Notion de Capital Humain,8,218,8,QROC,0.05,0.68,69.34,24,11,35,25,24,1,1.4,96.0,Facile,Facile,0,Meme Difficulté,Adapte,Economy
218,2015,Économie,5,Le Capital et le Progres Technique,1,Le Capital et l'Investissement,7,219,1,QO,0.02,0.75,95.83,5,0,5,5,5,0,1.0,100.0,Moyen,Facile,1,Plus Facile,Pas Adapte,Economy
1342,2016,Économie,5,Le Capital et le Progres Technique,1,Le Capital et l'Investissement,7,219,1,QO,0.55,0.25,62.83,3,2,5,5,3,2,1.0,60.0,Moyen,Moyen,0,Meme Difficulté,Adapte,Economy
2466,2017,Économie,5,Le Capital et le Progres Technique,1,Le Capital et l'Investissement,7,219,1,QROC,0.49,0.27,62.83,4,2,6,6,4,2,1.0,66.67,Moyen,Moyen,0,Meme Difficulté,Adapte,Economy
3590,2018,Économie,5,Le Capital et le Progres Technique,1,Le Capital et l'Investissement,7,219,1,QROC,0.38,0.28,62.83,4,2,6,4,4,0,1.5,100.0,Moyen,Moyen,0,Meme Difficulté,Adapte,Economy
4714,2019,Économie,5,Le Capital et le Progres Technique,1,Le Capital et l'Investissement,7,219,1,QROC,0.57,0.3,62.83,4,3,7,6,4,2,1.17,66.67,Moyen,Moyen,0,Meme Difficulté,Adapte,Economy
5838,2020,Économie,5,Le Capital et le Progres Technique,1,Le Capital et l'Investissement,7,219,1,QROC,0.49,0.3,62.83,4,3,7,6,4,2,1.17,66.67,Moyen,Moyen,0,Meme Difficulté,Adapte,Economy
219,2015,Économie,5,Le Capital et le Progres Technique,1,Le Capital et l'Investissement,7,220,2,QCM,0.31,0.62,43.13,29,38,67,43,29,14,1.56,67.44,Difficile,Moyen,1,Plus Facile,Pas Adapte,Economy
1343,2016,Économie,5,Le Capital et le Progres Technique,1,Le Capital et l'Investissement,7,220,2,QCU,0.03,0.77,94.11,56,3,59,58,56,2,1.02,96.55,Difficile,Facile,2,Beaucoup plus Facile,Pas Adapte,Economy
2467,2017,Économie,5,Le Capital et le Progres Technique,1,Le Capital et l'Investissement,7,220,2,QCU,0.01,0.82,93.59,50,3,53,53,50,3,1.0,94.34,Moyen,Facile,1,Plus Facile,Pas Adapte,Economy
3591,2018,Économie,5,Le Capital et le Progres Technique,1,Le Capital et l'Investissement,7,220,2,QCU,0.66,0.26,25.12,14,41,55,39,14,25,1.41,35.9,Facile,Difficile,-2,Beaucoup plus Difficile,Pas Adapte,Economy
4715,2019,Économie,5,Le Capital et le Progres Technique,1,Le Capital et l'Investissement,7,220,2,QCU,0.14,0.83,65.12,35,19,54,36,35,1,1.5,97.22,Difficile,Facile,2,Beaucoup plus Facile,Adapte,Economy
5839,2020,Économie,5,Le Capital et le Progres Technique,1,Le Capital et l'Investissement,7,220,2,QCU,0.01,0.78,65.12,33,18,51,42,33,9,1.21,78.57,Facile,Facile,0,Meme Difficulté,Adapte,Economy
220,2015,Économie,5,Le Capital et le Progres Technique,1,Le Capital et l'Investissement,7,221,3,QCU,0.09,0.82,82.37,29,6,35,33,29,4,1.06,87.88,Facile,Facile,0,Meme Difficulté,Pas Adapte,Economy
1344,2016,Économie,5,Le Capital et le Progres Technique,1,Le Capital et l'Investissement,7,221,3,QCU,0.38,0.48,38.9,12,18,30,15,12,3,2.0,80.0,Facile,Moyen,-1,Plus Difficile,Pas Adapte,Economy
2468,2017,Économie,5,Le Capital et le Progres Technique,1,Le Capital et l'Investissement,7,221,3,QCU,0.04,0.75,80.37,22,5,27,24,22,2,1.12,91.67,Difficile,Facile,2,Beaucoup plus Facile,Pas Adapte,Economy
3592,2018,Économie,5,Le Capital et le Progres Technique,1,Le Capital et l'Investissement,7,221,3,QCU,0.2,0.86,71.07,18,8,26,22,18,4,1.18,81.82,Facile,Facile,0,Meme Difficulté,Adapte,Economy
4716,2019,Économie,5,Le Capital et le Progres Technique,1,Le Capital et l'Investissement,7,221,3,QCU,0.11,0.84,71.07,21,8,29,26,21,5,1.12,80.77,Facile,Facile,0,Meme Difficulté,Adapte,Economy
5840,2020,Économie,5,Le Capital et le Progres Technique,1,Le Capital et l'Investissement,7,221,3,QCU,0.13,0.83,71.07,20,8,28,23,20,3,1.22,86.96,Facile,Facile,0,Meme Difficulté,Adapte,Economy
221,2015,Économie,5,Le Capital et le Progres Technique,1,Le Capital et l'Investissement,7,222,4,QCU,0.73,0.34,24.52,22,69,91,60,22,38,1.52,36.67,Difficile,Difficile,0,Meme Difficulté,Pas Adapte,Economy
1345,2016,Économie,5,Le Capital et le Progres Technique,1,Le Capital et l'Investissement,7,222,4,QCU,0.51,0.3,34.77,27,52,79,31,27,4,2.55,87.1,Difficile,Difficile,0,Meme Difficulté,Pas Adapte,Economy
2469,2017,Économie,5,Le Capital et le Progres Technique,1,Le Capital et l'Investissement,7,222,4,QROC,0.85,0.09,21.62,15,55,70,61,15,46,1.15,24.59,Moyen,Difficile,-1,Plus Difficile,Pas Adapte,Economy
3593,2018,Économie,5,Le Capital et le Progres Technique,1,Le Capital et l'Investissement,7,222,4,QROC,0.91,0.05,14.7,9,55,64,30,9,21,2.13,30.0,Facile,Difficile,-2,Beaucoup plus Difficile,Pas Adapte,Economy
4717,2019,Économie,5,Le Capital et le Progres Technique,1,Le Capital et l'Investissement,7,222,4,QROC,0.93,0.08,4.67,3,52,55,30,3,27,1.83,10.0,Difficile,Difficile,0,Meme Difficulté,Pas Adapte,Economy
5841,2020,Économie,5,Le Capital et le Progres Technique,1,Le Capital et l'Investissement,7,222,4,QROC,0.07,0.53,84.08,51,10,61,57,51,6,1.07,89.47,Facile,Facile,0,Meme Difficulté,Pas Adapte,Economy
222,2015,Économie,5,Le Capital et le Progres Technique,1,Le Capital et l'Investissement,7,223,5,QCU,0.22,0.51,55.56,47,37,84,68,47,21,1.24,69.12,Difficile,Moyen,1,Plus Facile,Pas Adapte,Economy
1346,2016,Économie,5,Le Capital et le Progres Technique,1,Le Capital et l'Investissement,7,223,5,QCU,0.27,0.53,40.08,38,57,95,52,38,14,1.83,73.08,Moyen,Moyen,0,Meme Difficulté,Pas Adapte,Economy
2470,2017,Économie,5,Le Capital et le Progres Technique,1,Le Capital et l'Investissement,7,223,5,QCU,0.04,0.75,83.25,78,16,94,83,78,5,1.13,93.98,Facile,Facile,0,Meme Difficulté,Pas Adapte,Economy
3594,2018,Économie,5,Le Capital et le Progres Technique,1,Le Capital et l'Investissement,7,223,5,QCU,0.08,0.79,99.41,107,1,108,107,107,0,1.01,100.0,Facile,Facile,0,Meme Difficulté,Pas Adapte,Economy
4718,2019,Économie,5,Le Capital et le Progres Technique,1,Le Capital et l'Investissement,7,223,5,QCU,0.21,0.56,46.6,46,52,98,63,46,17,1.56,73.02,Facile,Moyen,-1,Plus Difficile,Pas Adapte,Economy
5842,2020,Économie,5,Le Capital et le Progres Technique,1,Le Capital et l'Investissement,7,223,5,QCU,0.59,0.21,2.09,2,103,105,58,2,56,1.81,3.45,Moyen,Difficile,-1,Plus Difficile,Pas Adapte,Economy
223,2015,Économie,5,Le Capital et le Progres Technique,1,Le Capital et l'Investissement,7,224,6,QCU,0.35,0.44,50.5,29,28,57,39,29,10,1.46,74.36,Moyen,Moyen,0,Meme Difficulté,Pas Adapte,Economy
1347,2016,Économie,5,Le Capital et le Progres Technique,1,Le Capital et l'Investissement,7,224,6,QCU,0.12,0.95,76.03,43,13,56,54,43,11,1.04,79.63,Difficile,Facile,2,Beaucoup plus Facile,Pas Adapte,Economy
2471,2017,Économie,5,Le Capital et le Progres Technique,1,Le Capital et l'Investissement,7,224,6,QCU,0.03,1.0,81.48,44,10,54,44,44,0,1.23,100.0,Moyen,Facile,1,Plus Facile,Pas Adapte,Economy
3595,2018,Économie,5,Le Capital et le Progres Technique,1,Le Capital et l'Investissement,7,224,6,QCU,0.73,0.3,32.52,20,40,60,53,20,33,1.13,37.74,Difficile,Difficile,0,Meme Difficulté,Pas Adapte,Economy
4719,2019,Économie,5,Le Capital et le Progres Technique,1,Le Capital et l'Investissement,7,224,6,QCU,0.5,0.34,34.75,22,40,62,31,22,9,2.0,70.97,Moyen,Difficile,-1,Plus Difficile,Pas Adapte,Economy
5843,2020,Économie,5,Le Capital et le Progres Technique,1,Le Capital et l'Investissement,7,224,6,QCU,0.15,0.82,68.59,36,17,53,43,36,7,1.23,83.72,Difficile,Facile,2,Beaucoup plus Facile,Adapte,Economy
224,2015,Économie,5,Le Capital et le Progres Technique,1,Le Capital et l'Investissement,7,225,7,QCU,0.74,0.21,33.42,29,59,88,46,29,17,1.91,63.04,Facile,Difficile,-2,Beaucoup plus Difficile,Pas Adapte,Economy
1348,2016,Économie,5,Le Capital et le Progres Technique,1,Le Capital et l'Investissement,7,225,7,QCU,0.21,0.47,58.73,58,41,99,84,58,26,1.18,69.05,Difficile,Moyen,1,Plus Facile,Pas Adapte,Economy
2472,2017,Économie,5,Le Capital et le Progres Technique,1,Le Capital et l'Investissement,7,225,7,QCU,0.53,0.34,26.65,26,73,99,79,26,53,1.25,32.91,Moyen,Difficile,-1,Plus Difficile,Pas Adapte,Economy
3596,2018,Économie,5,Le Capital et le Progres Technique,1,Le Capital et l'Investissement,7,225,7,QCU,0.45,0.26,19.23,18,75,93,86,18,68,1.08,20.93,Facile,Difficile,-2,Beaucoup plus Difficile,Pas Adapte,Economy
4720,2019,Économie,5,Le Capital et le Progres Technique,1,Le Capital et l'Investissement,7,225,7,QCU,0.32,0.42,60.94,60,39,99,92,60,32,1.08,65.22,Moyen,Moyen,0,Meme Difficulté,Adapte,Economy
5844,2020,Économie,5,Le Capital et le Progres Technique,1,Le Capital et l'Investissement,7,225,7,QCM,0.49,0.51,60.94,57,37,94,86,57,29,1.09,66.28,Moyen,Moyen,0,Meme Difficulté,Adapte,Economy
225,2015,Économie,5,Le Capital et le Progres Technique,2,Le Capital: Aspect Physiques et Financiers,12,226,1,QROC,0.15,0.66,66.61,31,16,47,34,31,3,1.38,91.18,Difficile,Facile,2,Beaucoup plus Facile,Adapte,Economy
1349,2016,Économie,5,Le Capital et le Progres Technique,2,Le Capital: Aspect Physiques et Financiers,12,226,1,QROC,0.17,0.74,66.61,27,14,41,28,27,1,1.46,96.43,Facile,Facile,0,Meme Difficulté,Adapte,Economy
2473,2017,Économie,5,Le Capital et le Progres Technique,2,Le Capital: Aspect Physiques et Financiers,12,226,1,QCU,0.11,0.84,66.61,24,12,36,31,24,7,1.16,77.42,Facile,Facile,0,Meme Difficulté,Adapte,Economy
3597,2018,Économie,5,Le Capital et le Progres Technique,2,Le Capital: Aspect Physiques et Financiers,12,226,1,QCU,0.18,0.81,66.61,21,11,32,21,21,0,1.52,100.0,Facile,Facile,0,Meme Difficulté,Adapte,Economy
4721,2019,Économie,5,Le Capital et le Progres Technique,2,Le Capital: Aspect Physiques et Financiers,12,226,1,QCU,0.18,0.87,66.61,23,12,35,26,23,3,1.35,88.46,Facile,Facile,0,Meme Difficulté,Adapte,Economy
5845,2020,Économie,5,Le Capital et le Progres Technique,2,Le Capital: Aspect Physiques et Financiers,12,226,1,QROC,0.14,0.97,66.61,27,13,40,31,27,4,1.29,87.1,Facile,Facile,0,Meme Difficulté,Adapte,Economy
226,2015,Économie,5,Le Capital et le Progres Technique,2,Le Capital: Aspect Physiques et Financiers,12,227,2,QCM,0.0,0.91,90.67,51,5,56,54,51,3,1.04,94.44,Facile,Facile,0,Meme Difficulté,Pas Adapte,Economy
1350,2016,Économie,5,Le Capital et le Progres Technique,2,Le Capital: Aspect Physiques et Financiers,12,227,2,QCU,0.72,0.27,27.82,16,41,57,30,16,14,1.9,53.33,Difficile,Difficile,0,Meme Difficulté,Pas Adapte,Economy
2474,2017,Économie,5,Le Capital et le Progres Technique,2,Le Capital: Aspect Physiques et Financiers,12,227,2,QCU,0.07,0.86,67.8,43,21,64,48,43,5,1.33,89.58,Moyen,Facile,1,Plus Facile,Adapte,Economy
3598,2018,Économie,5,Le Capital et le Progres Technique,2,Le Capital: Aspect Physiques et Financiers,12,227,2,QCU,0.19,0.97,67.8,41,19,60,43,41,2,1.4,95.35,Facile,Facile,0,Meme Difficulté,Adapte,Economy
4722,2019,Économie,5,Le Capital et le Progres Technique,2,Le Capital: Aspect Physiques et Financiers,12,227,2,QCU,0.15,0.97,67.8,35,16,51,43,35,8,1.19,81.4,Facile,Facile,0,Meme Difficulté,Adapte,Economy
5846,2020,Économie,5,Le Capital et le Progres Technique,2,Le Capital: Aspect Physiques et Financiers,12,227,2,QCU,0.1,0.93,67.8,33,15,48,36,33,3,1.33,91.67,Facile,Facile,0,Meme Difficulté,Adapte,Economy
227,2015,Économie,5,Le Capital et le Progres Technique,2,Le Capital: Aspect Physiques et Financiers,12,228,3,QROC,0.36,0.34,52.97,40,36,76,74,40,34,1.03,54.05,Difficile,Moyen,1,Plus Facile,Pas Adapte,Economy
1351,2016,Économie,5,Le Capital et le Progres Technique,2,Le Capital: Aspect Physiques et Financiers,12,228,3,QCM,0.1,0.73,74.75,51,17,68,56,51,5,1.21,91.07,Moyen,Facile,1,Plus Facile,Adapte,Economy
2475,2017,Économie,5,Le Capital et le Progres Technique,2,Le Capital: Aspect Physiques et Financiers,12,228,3,QCM,0.17,0.78,74.75,47,16,63,56,47,9,1.12,83.93,Facile,Facile,0,Meme Difficulté,Adapte,Economy
3599,2018,Économie,5,Le Capital et le Progres Technique,2,Le Capital: Aspect Physiques et Financiers,12,228,3,QCM,0.13,0.83,74.75,51,17,68,61,51,10,1.11,83.61,Facile,Facile,0,Meme Difficulté,Adapte,Economy
4723,2019,Économie,5,Le Capital et le Progres Technique,2,Le Capital: Aspect Physiques et Financiers,12,228,3,QCM,0.13,0.77,74.75,44,15,59,59,44,15,1.0,74.58,Facile,Facile,0,Meme Difficulté,Adapte,Economy
5847,2020,Économie,5,Le Capital et le Progres Technique,2,Le Capital: Aspect Physiques et Financiers,12,228,3,QCM,0.18,0.74,74.75,43,14,57,46,43,3,1.24,93.48,Facile,Facile,0,Meme Difficulté,Adapte,Economy
228,2015,Économie,5,Le Capital et le Progres Technique,2,Le Capital: Aspect Physiques et Financiers,12,229,4,QCU,0.59,0.21,5.98,6,93,99,51,6,45,1.94,11.76,Facile,Difficile,-2,Beaucoup plus Difficile,Pas Adapte,Economy
1352,2016,Économie,5,Le Capital et le Progres Technique,2,Le Capital: Aspect Physiques et Financiers,12,229,4,QCU,0.01,0.83,82.94,94,19,113,105,94,11,1.08,89.52,Difficile,Facile,2,Beaucoup plus Facile,Pas Adapte,Economy
2476,2017,Économie,5,Le Capital et le Progres Technique,2,Le Capital: Aspect Physiques et Financiers,12,229,4,QCU,0.09,0.99,79.74,93,23,116,109,93,16,1.06,85.32,Difficile,Facile,2,Beaucoup plus Facile,Pas Adapte,Economy
3600,2018,Économie,5,Le Capital et le Progres Technique,2,Le Capital: Aspect Physiques et Financiers,12,229,4,QCU,0.25,0.74,60.75,75,49,124,105,75,30,1.18,71.43,Moyen,Moyen,0,Meme Difficulté,Adapte,Economy
4724,2019,Économie,5,Le Capital et le Progres Technique,2,Le Capital: Aspect Physiques et Financiers,12,229,4,QCU,0.22,0.45,60.75,72,47,119,118,72,46,1.01,61.02,Moyen,Moyen,0,Meme Difficulté,Adapte,Economy
5848,2020,Économie,5,Le Capital et le Progres Technique,2,Le Capital: Aspect Physiques et Financiers,12,229,4,QCU,0.37,0.41,60.75,65,42,107,76,65,11,1.41,85.53,Moyen,Moyen,0,Meme Difficulté,Adapte,Economy
229,2015,Économie,5,Le Capital et le Progres Technique,2,Le Capital: Aspect Physiques et Financiers,12,230,5,QCM,0.27,0.33,56.76,48,37,85,49,48,1,1.73,97.96,Moyen,Moyen,0,Meme Difficulté,Pas Adapte,Economy
1353,2016,Économie,5,Le Capital et le Progres Technique,2,Le Capital: Aspect Physiques et Financiers,12,230,5,QCM,0.49,0.37,48.59,44,46,90,82,44,38,1.1,53.66,Difficile,Moyen,1,Plus Facile,Pas Adapte,Economy
2477,2017,Économie,5,Le Capital et le Progres Technique,2,Le Capital: Aspect Physiques et Financiers,12,230,5,QCM,0.46,0.59,46.89,46,53,99,70,46,24,1.41,65.71,Facile,Moyen,-1,Plus Difficile,Pas Adapte,Economy
3601,2018,Économie,5,Le Capital et le Progres Technique,2,Le Capital: Aspect Physiques et Financiers,12,230,5,QCM,0.74,0.28,11.35,10,77,87,80,10,70,1.09,12.5,Difficile,Difficile,0,Meme Difficulté,Pas Adapte,Economy
4725,2019,Économie,5,Le Capital et le Progres Technique,2,Le Capital: Aspect Physiques et Financiers,12,230,5,QCM,0.13,0.79,79.33,75,19,94,93,75,18,1.01,80.65,Facile,Facile,0,Meme Difficulté,Pas Adapte,Economy
5849,2020,Économie,5,Le Capital et le Progres Technique,2,Le Capital: Aspect Physiques et Financiers,12,230,5,QROC,0.14,0.46,88.97,77,10,87,86,77,9,1.01,89.53,Facile,Facile,0,Meme Difficulté,Pas Adapte,Economy
230,2015,Économie,5,Le Capital et le Progres Technique,2,Le Capital: Aspect Physiques et Financiers,12,231,6,QROC,0.46,0.31,50.34,35,35,70,37,35,2,1.89,94.59,Moyen,Moyen,0,Meme Difficulté,Pas Adapte,Economy
1354,2016,Économie,5,Le Capital et le Progres Technique,2,Le Capital: Aspect Physiques et Financiers,12,231,6,QO,0.92,0.08,18.26,12,51,63,36,12,24,1.75,33.33,Facile,Difficile,-2,Beaucoup plus Difficile,Pas Adapte,Economy
2478,2017,Économie,5,Le Capital et le Progres Technique,2,Le Capital: Aspect Physiques et Financiers,12,231,6,QO,0.84,0.04,29.59,17,42,59,52,17,35,1.13,32.69,Facile,Difficile,-2,Beaucoup plus Difficile,Pas Adapte,Economy
3602,2018,Économie,5,Le Capital et le Progres Technique,2,Le Capital: Aspect Physiques et Financiers,12,231,6,QO,0.73,0.22,50.67,25,25,50,33,25,8,1.52,75.76,Moyen,Moyen,0,Meme Difficulté,Pas Adapte,Economy
4726,2019,Économie,5,Le Capital et le Progres Technique,2,Le Capital: Aspect Physiques et Financiers,12,231,6,QO,0.8,0.02,27.42,12,31,43,24,12,12,1.79,50.0,Difficile,Difficile,0,Meme Difficulté,Pas Adapte,Economy
5850,2020,Économie,5,Le Capital et le Progres Technique,2,Le Capital: Aspect Physiques et Financiers,12,231,6,QO,0.95,0.09,5.41,2,37,39,25,2,23,1.56,8.0,Difficile,Difficile,0,Meme Difficulté,Pas Adapte,Economy
231,2015,Économie,5,Le Capital et le Progres Technique,2,Le Capital: Aspect Physiques et Financiers,12,232,7,QCM,0.65,0.2,19.44,16,65,81,59,16,43,1.37,27.12,Facile,Difficile,-2,Beaucoup plus Difficile,Pas Adapte,Economy
1355,2016,Économie,5,Le Capital et le Progres Technique,2,Le Capital: Aspect Physiques et Financiers,12,232,7,QCM,0.13,0.7,65.35,51,27,78,76,51,25,1.03,67.11,Difficile,Facile,2,Beaucoup plus Facile,Adapte,Economy
2479,2017,Économie,5,Le Capital et le Progres Technique,2,Le Capital: Aspect Physiques et Financiers,12,232,7,QCM,0.06,0.74,65.35,53,28,81,66,53,13,1.23,80.3,Facile,Facile,0,Meme Difficulté,Adapte,Economy
3603,2018,Économie,5,Le Capital et le Progres Technique,2,Le Capital: Aspect Physiques et Financiers,12,232,7,QCM,0.01,0.78,65.35,54,29,83,74,54,20,1.12,72.97,Facile,Facile,0,Meme Difficulté,Adapte,Economy
4727,2019,Économie,5,Le Capital et le Progres Technique,2,Le Capital: Aspect Physiques et Financiers,12,232,7,QCM,0.13,0.78,65.35,48,26,74,63,48,15,1.17,76.19,Facile,Facile,0,Meme Difficulté,Adapte,Economy
5851,2020,Économie,5,Le Capital et le Progres Technique,2,Le Capital: Aspect Physiques et Financiers,12,232,7,QCM,0.18,0.91,65.35,41,22,63,57,41,16,1.11,71.93,Facile,Facile,0,Meme Difficulté,Adapte,Economy
232,2015,Économie,5,Le Capital et le Progres Technique,2,Le Capital: Aspect Physiques et Financiers,12,233,8,QCU,0.4,0.45,59.86,31,20,51,37,31,6,1.38,83.78,Moyen,Moyen,0,Meme Difficulté,Pas Adapte,Economy
1356,2016,Économie,5,Le Capital et le Progres Technique,2,Le Capital: Aspect Physiques et Financiers,12,233,8,QCM,0.26,0.61,56.0,25,19,44,38,25,13,1.16,65.79,Facile,Moyen,-1,Plus Difficile,Pas Adapte,Economy
2480,2017,Économie,5,Le Capital et le Progres Technique,2,Le Capital: Aspect Physiques et Financiers,12,233,8,QCM,0.18,0.92,92.35,34,3,37,35,34,1,1.06,97.14,Facile,Facile,0,Meme Difficulté,Pas Adapte,Economy
3604,2018,Économie,5,Le Capital et le Progres Technique,2,Le Capital: Aspect Physiques et Financiers,12,233,8,QCM,0.27,0.7,57.92,19,13,32,27,19,8,1.19,70.37,Moyen,Moyen,0,Meme Difficulté,Pas Adapte,Economy
4728,2019,Économie,5,Le Capital et le Progres Technique,2,Le Capital: Aspect Physiques et Financiers,12,233,8,QCM,0.67,0.28,16.48,6,29,35,19,6,13,1.84,31.58,Difficile,Difficile,0,Meme Difficulté,Pas Adapte,Economy
5852,2020,Économie,5,Le Capital et le Progres Technique,2,Le Capital: Aspect Physiques et Financiers,12,233,8,QCM,0.04,0.85,77.6,28,8,36,32,28,4,1.12,87.5,Difficile,Facile,2,Beaucoup plus Facile,Pas Adapte,Economy
233,2015,Économie,5,Le Capital et le Progres Technique,2,Le Capital: Aspect Physiques et Financiers,12,234,9,QROC,0.03,0.58,97.43,59,2,61,61,59,2,1.0,96.72,Difficile,Facile,2,Beaucoup plus Facile,Pas Adapte,Economy
1357,2016,Économie,5,Le Capital et le Progres Technique,2,Le Capital: Aspect Physiques et Financiers,12,234,9,QROC,0.07,0.94,69.77,41,18,59,54,41,13,1.09,75.93,Moyen,Facile,1,Plus Facile,Adapte,Economy
2481,2017,Économie,5,Le Capital et le Progres Technique,2,Le Capital: Aspect Physiques et Financiers,12,234,9,QROC,0.15,0.68,69.77,45,19,64,49,45,4,1.31,91.84,Facile,Facile,0,Meme Difficulté,Adapte,Economy
3605,2018,Économie,5,Le Capital et le Progres Technique,2,Le Capital: Aspect Physiques et Financiers,12,234,9,QROC,0.08,0.59,69.77,50,21,71,66,50,16,1.08,75.76,Facile,Facile,0,Meme Difficulté,Adapte,Economy
4729,2019,Économie,5,Le Capital et le Progres Technique,2,Le Capital: Aspect Physiques et Financiers,12,234,9,QROC,0.12,0.43,69.77,57,24,81,80,57,23,1.01,71.25,Facile,Facile,0,Meme Difficulté,Adapte,Economy
5853,2020,Économie,5,Le Capital et le Progres Technique,2,Le Capital: Aspect Physiques et Financiers,12,234,9,QCU,0.2,0.88,69.77,54,24,78,60,54,6,1.3,90.0,Facile,Facile,0,Meme Difficulté,Adapte,Economy
234,2015,Économie,5,Le Capital et le Progres Technique,2,Le Capital: Aspect Physiques et Financiers,12,235,10,QCM,0.09,0.96,97.9,56,1,57,56,56,0,1.02,100.0,Facile,Facile,0,Meme Difficulté,Pas Adapte,Economy
1358,2016,Économie,5,Le Capital et le Progres Technique,2,Le Capital: Aspect Physiques et Financiers,12,235,10,QCM,0.64,0.26,21.37,13,49,62,44,13,31,1.41,29.55,Difficile,Difficile,0,Meme Difficulté,Pas Adapte,Economy
2482,2017,Économie,5,Le Capital et le Progres Technique,2,Le Capital: Aspect Physiques et Financiers,12,235,10,QCU,0.75,0.36,22.22,14,50,64,41,14,27,1.56,34.15,Difficile,Difficile,0,Meme Difficulté,Pas Adapte,Economy
3606,2018,Économie,5,Le Capital et le Progres Technique,2,Le Capital: Aspect Physiques et Financiers,12,235,10,QCU,0.22,0.64,40.64,30,43,73,35,30,5,2.09,85.71,Difficile,Moyen,1,Plus Facile,Pas Adapte,Economy
4730,2019,Économie,5,Le Capital et le Progres Technique,2,Le Capital: Aspect Physiques et Financiers,12,235,10,QCU,0.37,0.44,62.73,43,26,69,49,43,6,1.41,87.76,Moyen,Moyen,0,Meme Difficulté,Adapte,Economy
5854,2020,Économie,5,Le Capital et le Progres Technique,2,Le Capital: Aspect Physiques et Financiers,12,235,10,QCU,0.22,0.75,62.73,47,28,75,53,47,6,1.42,88.68,Moyen,Moyen,0,Meme Difficulté,Adapte,Economy
235,2015,Économie,5,Le Capital et le Progres Technique,2,Le Capital: Aspect Physiques et Financiers,12,236,11,QCU,0.69,0.23,15.51,9,46,55,20,9,11,2.75,45.0,Moyen,Difficile,-1,Plus Difficile,Pas Adapte,Economy
1359,2016,Économie,5,Le Capital et le Progres Technique,2,Le Capital: Aspect Physiques et Financiers,12,236,11,QCU,0.72,0.28,20.7,12,44,56,55,12,43,1.02,21.82,Facile,Difficile,-2,Beaucoup plus Difficile,Pas Adapte,Economy
2483,2017,Économie,5,Le Capital et le Progres Technique,2,Le Capital: Aspect Physiques et Financiers,12,236,11,QCM,0.63,0.2,11.54,6,50,56,45,6,39,1.24,13.33,Facile,Difficile,-2,Beaucoup plus Difficile,Pas Adapte,Economy
3607,2018,Économie,5,Le Capital et le Progres Technique,2,Le Capital: Aspect Physiques et Financiers,12,236,11,QCM,0.67,0.18,13.95,7,46,53,49,7,42,1.08,14.29,Difficile,Difficile,0,Meme Difficulté,Pas Adapte,Economy
4731,2019,Économie,5,Le Capital et le Progres Technique,2,Le Capital: Aspect Physiques et Financiers,12,236,11,QCM,0.07,0.72,87.67,46,6,52,46,46,0,1.13,100.0,Moyen,Facile,1,Plus Facile,Pas Adapte,Economy
5855,2020,Économie,5,Le Capital et le Progres Technique,2,Le Capital: Aspect Physiques et Financiers,12,236,11,QCM,0.49,0.32,52.46,28,26,54,37,28,9,1.46,75.68,Facile,Moyen,-1,Plus Difficile,Pas Adapte,Economy
236,2015,Économie,5,Le Capital et le Progres Technique,2,Le Capital: Aspect Physiques et Financiers,12,237,12,QCU,0.1,0.97,97.91,14,0,14,14,14,0,1.0,100.0,Difficile,Facile,2,Beaucoup plus Facile,Pas Adapte,Economy
1360,2016,Économie,5,Le Capital et le Progres Technique,2,Le Capital: Aspect Physiques et Financiers,12,237,12,QCU,0.17,0.85,88.71,14,2,16,15,14,1,1.07,93.33,Facile,Facile,0,Meme Difficulté,Pas Adapte,Economy
2484,2017,Économie,5,Le Capital et le Progres Technique,2,Le Capital: Aspect Physiques et Financiers,12,237,12,QCU,0.63,0.31,24.97,4,12,16,8,4,4,2.0,50.0,Difficile,Difficile,0,Meme Difficulté,Pas Adapte,Economy
3608,2018,Économie,5,Le Capital et le Progres Technique,2,Le Capital: Aspect Physiques et Financiers,12,237,12,QCU,0.22,0.5,35.54,5,9,14,11,5,6,1.27,45.45,Facile,Moyen,-1,Plus Difficile,Pas Adapte,Economy
4732,2019,Économie,5,Le Capital et le Progres Technique,2,Le Capital: Aspect Physiques et Financiers,12,237,12,QCU,0.41,0.34,9.5,1,11,12,4,1,3,3.0,25.0,Difficile,Difficile,0,Meme Difficulté,Pas Adapte,Economy
5856,2020,Économie,5,Le Capital et le Progres Technique,2,Le Capital: Aspect Physiques et Financiers,12,237,12,QCU,0.16,0.97,78.96,11,3,14,13,11,2,1.08,84.62,Facile,Facile,0,Meme Difficulté,Pas Adapte,Economy
237,2015,Économie,5,Le Capital et le Progres Technique,3,Les Differents Types d'Investissement et le Poids de l'Investissement Immateriel,13,238,1,QCU,0.09,0.93,84.36,55,10,65,59,55,4,1.1,93.22,Facile,Facile,0,Meme Difficulté,Pas Adapte,Economy
1361,2016,Économie,5,Le Capital et le Progres Technique,3,Les Differents Types d'Investissement et le Poids de l'Investissement Immateriel,13,238,1,QCU,0.05,0.97,98.3,62,1,63,62,62,0,1.02,100.0,Difficile,Facile,2,Beaucoup plus Facile,Pas Adapte,Economy
2485,2017,Économie,5,Le Capital et le Progres Technique,3,Les Differents Types d'Investissement et le Poids de l'Investissement Immateriel,13,238,1,QCU,0.43,0.4,8.96,5,56,61,42,5,37,1.45,11.9,Difficile,Difficile,0,Meme Difficulté,Pas Adapte,Economy
3609,2018,Économie,5,Le Capital et le Progres Technique,3,Les Differents Types d'Investissement et le Poids de l'Investissement Immateriel,13,238,1,QCU,0.26,0.69,56.56,31,24,55,34,31,3,1.62,91.18,Moyen,Moyen,0,Meme Difficulté,Pas Adapte,Economy
4733,2019,Économie,5,Le Capital et le Progres Technique,3,Les Differents Types d'Investissement et le Poids de l'Investissement Immateriel,13,238,1,QCU,0.18,0.91,87.81,47,6,53,50,47,3,1.06,94.0,Facile,Facile,0,Meme Difficulté,Pas Adapte,Economy
5857,2020,Économie,5,Le Capital et le Progres Technique,3,Les Differents Types d'Investissement et le Poids de l'Investissement Immateriel,13,238,1,QCM,0.27,0.64,63.55,36,20,56,38,36,2,1.47,94.74,Moyen,Moyen,0,Meme Difficulté,Adapte,Economy
238,2015,Économie,5,Le Capital et le Progres Technique,3,Les Differents Types d'Investissement et le Poids de l'Investissement Immateriel,13,239,2,QROC,0.73,0.19,1.89,1,43,44,39,1,38,1.13,2.56,Difficile,Difficile,0,Meme Difficulté,Pas Adapte,Economy
1362,2016,Économie,5,Le Capital et le Progres Technique,3,Les Differents Types d'Investissement et le Poids de l'Investissement Immateriel,13,239,2,QROC,0.17,0.63,82.29,39,8,47,43,39,4,1.09,90.7,Moyen,Facile,1,Plus Facile,Pas Adapte,Economy
2486,2017,Économie,5,Le Capital et le Progres Technique,3,Les Differents Types d'Investissement et le Poids de l'Investissement Immateriel,13,239,2,QROC,0.92,0.13,15.45,6,35,41,32,6,26,1.28,18.75,Facile,Difficile,-2,Beaucoup plus Difficile,Pas Adapte,Economy
3610,2018,Économie,5,Le Capital et le Progres Technique,3,Les Differents Types d'Investissement et le Poids de l'Investissement Immateriel,13,239,2,QROC,0.25,0.31,61.91,26,16,42,34,26,8,1.24,76.47,Difficile,Moyen,1,Plus Facile,Adapte,Economy
4734,2019,Économie,5,Le Capital et le Progres Technique,3,Les Differents Types d'Investissement et le Poids de l'Investissement Immateriel,13,239,2,QROC,0.46,0.31,61.91,24,15,39,33,24,9,1.18,72.73,Moyen,Moyen,0,Meme Difficulté,Adapte,Economy
5858,2020,Économie,5,Le Capital et le Progres Technique,3,Les Differents Types d'Investissement et le Poids de l'Investissement Immateriel,13,239,2,QROC,0.47,0.39,61.91,22,14,36,31,22,9,1.16,70.97,Moyen,Moyen,0,Meme Difficulté,Adapte,Economy
239,2015,Économie,5,Le Capital et le Progres Technique,3,Les Differents Types d'Investissement et le Poids de l'Investissement Immateriel,13,240,3,QCU,0.59,0.24,11.14,8,62,70,41,8,33,1.71,19.51,Difficile,Difficile,0,Meme Difficulté,Pas Adapte,Economy
1363,2016,Économie,5,Le Capital et le Progres Technique,3,Les Differents Types d'Investissement et le Poids de l'Investissement Immateriel,13,240,3,QCU,0.68,0.23,29.23,21,51,72,55,21,34,1.31,38.18,Difficile,Difficile,0,Meme Difficulté,Pas Adapte,Economy
2487,2017,Économie,5,Le Capital et le Progres Technique,3,Les Differents Types d'Investissement et le Poids de l'Investissement Immateriel,13,240,3,QCU,0.61,0.21,8.02,7,76,83,37,7,30,2.24,18.92,Moyen,Difficile,-1,Plus Difficile,Pas Adapte,Economy
3611,2018,Économie,5,Le Capital et le Progres Technique,3,Les Differents Types d'Investissement et le Poids de l'Investissement Immateriel,13,240,3,QCU,0.71,0.28,12.72,12,81,93,39,12,27,2.38,30.77,Moyen,Difficile,-1,Plus Difficile,Pas Adapte,Economy
4735,2019,Économie,5,Le Capital et le Progres Technique,3,Les Differents Types d'Investissement et le Poids de l'Investissement Immateriel,13,240,3,QCU,0.09,0.94,68.12,67,31,98,69,67,2,1.42,97.1,Moyen,Facile,1,Plus Facile,Adapte,Economy
5859,2020,Économie,5,Le Capital et le Progres Technique,3,Les Differents Types d'Investissement et le Poids de l'Investissement Immateriel,13,240,3,QCU,0.05,0.88,68.12,72,33,105,98,72,26,1.07,73.47,Facile,Facile,0,Meme Difficulté,Adapte,Economy
240,2015,Économie,5,Le Capital et le Progres Technique,3,Les Differents Types d'Investissement et le Poids de l'Investissement Immateriel,13,241,4,QCM,0.25,0.44,60.29,33,22,55,40,33,7,1.38,82.5,Facile,Moyen,-1,Plus Difficile,Adapte,Economy
1364,2016,Économie,5,Le Capital et le Progres Technique,3,Les Differents Types d'Investissement et le Poids de l'Investissement Immateriel,13,241,4,QCM,0.36,0.39,60.29,35,23,58,54,35,19,1.07,64.81,Moyen,Moyen,0,Meme Difficulté,Adapte,Economy
2488,2017,Économie,5,Le Capital et le Progres Technique,3,Les Differents Types d'Investissement et le Poids de l'Investissement Immateriel,13,241,4,QROC,0.56,0.31,60.29,30,20,50,39,30,9,1.28,76.92,Moyen,Moyen,0,Meme Difficulté,Adapte,Economy
3612,2018,Économie,5,Le Capital et le Progres Technique,3,Les Differents Types d'Investissement et le Poids de l'Investissement Immateriel,13,241,4,QROC,0.42,0.34,60.29,34,22,56,48,34,14,1.17,70.83,Moyen,Moyen,0,Meme Difficulté,Adapte,Economy
4736,2019,Économie,5,Le Capital et le Progres Technique,3,Les Differents Types d'Investissement et le Poids de l'Investissement Immateriel,13,241,4,QROC,0.58,0.39,60.29,32,21,53,36,32,4,1.47,88.89,Moyen,Moyen,0,Meme Difficulté,Adapte,Economy
5860,2020,Économie,5,Le Capital et le Progres Technique,3,Les Differents Types d'Investissement et le Poids de l'Investissement Immateriel,13,241,4,QO,0.35,0.16,60.29,34,23,57,45,34,11,1.27,75.56,Moyen,Moyen,0,Meme Difficulté,Adapte,Economy
241,2015,Économie,5,Le Capital et le Progres Technique,3,Les Differents Types d'Investissement et le Poids de l'Investissement Immateriel,13,242,5,QCM,0.73,0.16,0.41,0,50,50,49,0,49,1.02,0.0,Facile,Difficile,-2,Beaucoup plus Difficile,Pas Adapte,Economy
1365,2016,Économie,5,Le Capital et le Progres Technique,3,Les Differents Types d'Investissement et le Poids de l'Investissement Immateriel,13,242,5,QCM,0.08,0.89,87.77,39,6,45,43,39,4,1.05,90.7,Moyen,Facile,1,Plus Facile,Pas Adapte,Economy
2489,2017,Économie,5,Le Capital et le Progres Technique,3,Les Differents Types d'Investissement et le Poids de l'Investissement Immateriel,13,242,5,QCM,0.04,0.84,67.18,35,17,52,46,35,11,1.13,76.09,Difficile,Facile,2,Beaucoup plus Facile,Adapte,Economy
3613,2018,Économie,5,Le Capital et le Progres Technique,3,Les Differents Types d'Investissement et le Poids de l'Investissement Immateriel,13,242,5,QCM,0.19,0.81,67.18,36,18,54,41,36,5,1.32,87.8,Facile,Facile,0,Meme Difficulté,Adapte,Economy
4737,2019,Économie,5,Le Capital et le Progres Technique,3,Les Differents Types d'Investissement et le Poids de l'Investissement Immateriel,13,242,5,QCM,0.18,0.73,67.18,34,16,50,36,34,2,1.39,94.44,Facile,Facile,0,Meme Difficulté,Adapte,Economy
5861,2020,Économie,5,Le Capital et le Progres Technique,3,Les Differents Types d'Investissement et le Poids de l'Investissement Immateriel,13,242,5,QCM,0.13,0.76,67.18,32,16,48,42,32,10,1.14,76.19,Facile,Facile,0,Meme Difficulté,Adapte,Economy
242,2015,Économie,5,Le Capital et le Progres Technique,3,Les Differents Types d'Investissement et le Poids de l'Investissement Immateriel,13,243,6,QCM,0.25,0.55,63.34,46,26,72,53,46,7,1.36,86.79,Difficile,Moyen,1,Plus Facile,Adapte,Economy
1366,2016,Économie,5,Le Capital et le Progres Technique,3,Les Differents Types d'Investissement et le Poids de l'Investissement Immateriel,13,243,6,QCM,0.4,0.55,63.34,41,23,64,60,41,19,1.07,68.33,Moyen,Moyen,0,Meme Difficulté,Adapte,Economy
2490,2017,Économie,5,Le Capital et le Progres Technique,3,Les Differents Types d'Investissement et le Poids de l'Investissement Immateriel,13,243,6,QCM,0.44,0.47,63.34,36,21,57,50,36,14,1.14,72.0,Moyen,Moyen,0,Meme Difficulté,Adapte,Economy
3614,2018,Économie,5,Le Capital et le Progres Technique,3,Les Differents Types d'Investissement et le Poids de l'Investissement Immateriel,13,243,6,QCM,0.3,0.6,63.34,31,18,49,33,31,2,1.48,93.94,Moyen,Moyen,0,Meme Difficulté,Adapte,Economy
4738,2019,Économie,5,Le Capital et le Progres Technique,3,Les Differents Types d'Investissement et le Poids de l'Investissement Immateriel,13,243,6,QCU,0.21,0.59,63.34,28,16,44,39,28,11,1.13,71.79,Moyen,Moyen,0,Meme Difficulté,Adapte,Economy
5862,2020,Économie,5,Le Capital et le Progres Technique,3,Les Differents Types d'Investissement et le Poids de l'Investissement Immateriel,13,243,6,QCU,0.38,0.46,63.34,25,14,39,38,25,13,1.03,65.79,Moyen,Moyen,0,Meme Difficulté,Adapte,Economy
243,2015,Économie,5,Le Capital et le Progres Technique,3,Les Differents Types d'Investissement et le Poids de l'Investissement Immateriel,13,244,7,QCM,0.78,0.25,27.26,9,25,34,33,9,24,1.03,27.27,Difficile,Difficile,0,Meme Difficulté,Pas Adapte,Economy
1367,2016,Économie,5,Le Capital et le Progres Technique,3,Les Differents Types d'Investissement et le Poids de l'Investissement Immateriel,13,244,7,QCM,0.24,0.64,43.64,13,17,30,19,13,6,1.58,68.42,Difficile,Moyen,1,Plus Facile,Pas Adapte,Economy
2491,2017,Économie,5,Le Capital et le Progres Technique,3,Les Differents Types d'Investissement et le Poids de l'Investissement Immateriel,13,244,7,QCM,0.42,0.31,54.78,15,13,28,17,15,2,1.65,88.24,Difficile,Moyen,1,Plus Facile,Pas Adapte,Economy
3615,2018,Économie,5,Le Capital et le Progres Technique,3,Les Differents Types d'Investissement et le Poids de l'Investissement Immateriel,13,244,7,QCM,0.62,0.19,16.15,5,24,29,23,5,18,1.26,21.74,Moyen,Difficile,-1,Plus Difficile,Pas Adapte,Economy
4739,2019,Économie,5,Le Capital et le Progres Technique,3,Les Differents Types d'Investissement et le Poids de l'Investissement Immateriel,13,244,7,QCM,0.25,0.46,52.99,14,12,26,16,14,2,1.62,87.5,Difficile,Moyen,1,Plus Facile,Pas Adapte,Economy
5863,2020,Économie,5,Le Capital et le Progres Technique,3,Les Differents Types d'Investissement et le Poids de l'Investissement Immateriel,13,244,7,QCM,0.53,0.24,25.26,6,17,23,21,6,15,1.1,28.57,Facile,Difficile,-2,Beaucoup plus Difficile,Pas Adapte,Economy
244,2015,Économie,5,Le Capital et le Progres Technique,3,Les Differents Types d'Investissement et le Poids de l'Investissement Immateriel,13,245,8,QROC,0.93,0.09,29.59,16,39,55,50,16,34,1.1,32.0,Difficile,Difficile,0,Meme Difficulté,Pas Adapte,Economy
1368,2016,Économie,5,Le Capital et le Progres Technique,3,Les Differents Types d'Investissement et le Poids de l'Investissement Immateriel,13,245,8,QROC,0.4,0.4,59.86,32,22,54,41,32,9,1.32,78.05,Moyen,Moyen,0,Meme Difficulté,Pas Adapte,Economy
2492,2017,Économie,5,Le Capital et le Progres Technique,3,Les Differents Types d'Investissement et le Poids de l'Investissement Immateriel,13,245,8,QROC,0.53,0.34,48.63,23,25,48,48,23,25,1.0,47.92,Facile,Moyen,-1,Plus Difficile,Pas Adapte,Economy
3616,2018,Économie,5,Le Capital et le Progres Technique,3,Les Differents Types d'Investissement et le Poids de l'Investissement Immateriel,13,245,8,QO,0.42,0.18,37.56,17,27,44,23,17,6,1.91,73.91,Moyen,Moyen,0,Meme Difficulté,Pas Adapte,Economy
4740,2019,Économie,5,Le Capital et le Progres Technique,3,Les Differents Types d'Investissement et le Poids de l'Investissement Immateriel,13,245,8,QO,0.67,0.19,63.53,25,15,40,38,25,13,1.05,65.79,Facile,Moyen,-1,Plus Difficile,Adapte,Economy
5864,2020,Économie,5,Le Capital et le Progres Technique,3,Les Differents Types d'Investissement et le Poids de l'Investissement Immateriel,13,245,8,QO,0.73,0.16,63.53,22,13,35,25,22,3,1.4,88.0,Moyen,Moyen,0,Meme Difficulté,Adapte,Economy
245,2015,Économie,5,Le Capital et le Progres Technique,3,Les Differents Types d'Investissement et le Poids de l'Investissement Immateriel,13,246,9,QCU,0.16,0.84,66.61,3,2,5,5,3,2,1.0,60.0,Facile,Facile,0,Meme Difficulté,Adapte,Economy
1369,2016,Économie,5,Le Capital et le Progres Technique,3,Les Differents Types d'Investissement et le Poids de l'Investissement Immateriel,13,246,9,QCU,0.15,0.84,66.61,3,1,4,3,3,0,1.33,100.0,Facile,Facile,0,Meme Difficulté,Adapte,Economy
2493,2017,Économie,5,Le Capital et le Progres Technique,3,Les Differents Types d'Investissement et le Poids de l'Investissement Immateriel,13,246,9,QCU,0.11,0.87,66.61,2,1,3,3,2,1,1.0,66.67,Facile,Facile,0,Meme Difficulté,Adapte,Economy
3617,2018,Économie,5,Le Capital et le Progres Technique,3,Les Differents Types d'Investissement et le Poids de l'Investissement Immateriel,13,246,9,QCU,0.14,0.89,66.61,2,1,3,2,2,0,1.5,100.0,Facile,Facile,0,Meme Difficulté,Adapte,Economy
4741,2019,Économie,5,Le Capital et le Progres Technique,3,Les Differents Types d'Investissement et le Poids de l'Investissement Immateriel,13,246,9,QCU,0.05,0.84,66.61,2,1,3,3,2,1,1.0,66.67,Facile,Facile,0,Meme Difficulté,Adapte,Economy
5865,2020,Économie,5,Le Capital et le Progres Technique,3,Les Differents Types d'Investissement et le Poids de l'Investissement Immateriel,13,246,9,QCU,0.03,0.76,66.61,2,1,3,2,2,0,1.5,100.0,Facile,Facile,0,Meme Difficulté,Adapte,Economy
246,2015,Économie,5,Le Capital et le Progres Technique,3,Les Differents Types d'Investissement et le Poids de l'Investissement Immateriel,13,247,10,QCU,0.09,0.88,86.19,31,5,36,35,31,4,1.03,88.57,Facile,Facile,0,Meme Difficulté,Pas Adapte,Economy
1370,2016,Économie,5,Le Capital et le Progres Technique,3,Les Differents Types d'Investissement et le Poids de l'Investissement Immateriel,13,247,10,QCU,0.48,0.27,15.53,6,35,41,39,6,33,1.05,15.38,Moyen,Difficile,-1,Plus Difficile,Pas Adapte,Economy
2494,2017,Économie,5,Le Capital et le Progres Technique,3,Les Differents Types d'Investissement et le Poids de l'Investissement Immateriel,13,247,10,QCM,0.77,0.24,25.21,9,28,37,34,9,25,1.09,26.47,Moyen,Difficile,-1,Plus Difficile,Pas Adapte,Economy
3618,2018,Économie,5,Le Capital et le Progres Technique,3,Les Differents Types d'Investissement et le Poids de l'Investissement Immateriel,13,247,10,QCM,0.14,0.72,84.51,35,7,42,39,35,4,1.08,89.74,Moyen,Facile,1,Plus Facile,Pas Adapte,Economy
4742,2019,Économie,5,Le Capital et le Progres Technique,3,Les Differents Types d'Investissement et le Poids de l'Investissement Immateriel,13,247,10,QCM,0.09,0.77,82.09,34,8,42,35,34,1,1.2,97.14,Difficile,Facile,2,Beaucoup plus Facile,Pas Adapte,Economy
5866,2020,Économie,5,Le Capital et le Progres Technique,3,Les Differents Types d'Investissement et le Poids de l'Investissement Immateriel,13,247,10,QCM,0.18,0.95,74.12,27,9,36,32,27,5,1.12,84.38,Facile,Facile,0,Meme Difficulté,Adapte,Economy
247,2015,Économie,5,Le Capital et le Progres Technique,3,Les Differents Types d'Investissement et le Poids de l'Investissement Immateriel,13,248,11,QCU,0.04,0.75,68.27,55,26,81,67,55,12,1.21,82.09,Facile,Facile,0,Meme Difficulté,Adapte,Economy
1371,2016,Économie,5,Le Capital et le Progres Technique,3,Les Differents Types d'Investissement et le Poids de l'Investissement Immateriel,13,248,11,QCU,0.08,0.81,68.27,63,30,93,91,63,28,1.02,69.23,Facile,Facile,0,Meme Difficulté,Adapte,Economy
2495,2017,Économie,5,Le Capital et le Progres Technique,3,Les Differents Types d'Investissement et le Poids de l'Investissement Immateriel,13,248,11,QCU,0.13,0.79,68.27,60,28,88,85,60,25,1.04,70.59,Facile,Facile,0,Meme Difficulté,Adapte,Economy
3619,2018,Économie,5,Le Capital et le Progres Technique,3,Les Differents Types d'Investissement et le Poids de l'Investissement Immateriel,13,248,11,QCU,0.1,0.8,68.27,53,25,78,75,53,22,1.04,70.67,Facile,Facile,0,Meme Difficulté,Adapte,Economy
4743,2019,Économie,5,Le Capital et le Progres Technique,3,Les Differents Types d'Investissement et le Poids de l'Investissement Immateriel,13,248,11,QCU,0.17,0.76,68.27,51,24,75,69,51,18,1.09,73.91,Facile,Facile,0,Meme Difficulté,Adapte,Economy
5867,2020,Économie,5,Le Capital et le Progres Technique,3,Les Differents Types d'Investissement et le Poids de l'Investissement Immateriel,13,248,11,QCU,0.06,0.86,68.27,51,24,75,63,51,12,1.19,80.95,Facile,Facile,0,Meme Difficulté,Adapte,Economy
248,2015,Économie,5,Le Capital et le Progres Technique,3,Les Differents Types d'Investissement et le Poids de l'Investissement Immateriel,13,249,12,QROC,0.88,0.07,14.0,11,67,78,40,11,29,1.95,27.5,Facile,Difficile,-2,Beaucoup plus Difficile,Pas Adapte,Economy
1372,2016,Économie,5,Le Capital et le Progres Technique,3,Les Differents Types d'Investissement et le Poids de l'Investissement Immateriel,13,249,12,QROC,0.2,0.61,71.72,64,25,89,82,64,18,1.09,78.05,Moyen,Facile,1,Plus Facile,Adapte,Economy
2496,2017,Économie,5,Le Capital et le Progres Technique,3,Les Differents Types d'Investissement et le Poids de l'Investissement Immateriel,13,249,12,QROC,0.17,0.5,71.72,60,24,84,66,60,6,1.27,90.91,Facile,Facile,0,Meme Difficulté,Adapte,Economy
3620,2018,Économie,5,Le Capital et le Progres Technique,3,Les Differents Types d'Investissement et le Poids de l'Investissement Immateriel,13,249,12,QROC,0.03,0.55,71.72,61,24,85,67,61,6,1.27,91.04,Facile,Facile,0,Meme Difficulté,Adapte,Economy
4744,2019,Économie,5,Le Capital et le Progres Technique,3,Les Differents Types d'Investissement et le Poids de l'Investissement Immateriel,13,249,12,QROC,0.1,0.6,71.72,66,26,92,81,66,15,1.14,81.48,Facile,Facile,0,Meme Difficulté,Adapte,Economy
5868,2020,Économie,5,Le Capital et le Progres Technique,3,Les Differents Types d'Investissement et le Poids de l'Investissement Immateriel,13,249,12,QROC,0.17,0.81,71.72,75,29,104,98,75,23,1.06,76.53,Facile,Facile,0,Meme Difficulté,Adapte,Economy
249,2015,Économie,5,Le Capital et le Progres Technique,3,Les Differents Types d'Investissement et le Poids de l'Investissement Immateriel,13,250,13,QCM,0.64,0.23,5.28,4,81,85,79,4,75,1.08,5.06,Difficile,Difficile,0,Meme Difficulté,Pas Adapte,Economy
1373,2016,Économie,5,Le Capital et le Progres Technique,3,Les Differents Types d'Investissement et le Poids de l'Investissement Immateriel,13,250,13,QCM,0.15,0.72,83.26,82,16,98,97,82,15,1.01,84.54,Difficile,Facile,2,Beaucoup plus Facile,Pas Adapte,Economy
2497,2017,Économie,5,Le Capital et le Progres Technique,3,Les Differents Types d'Investissement et le Poids de l'Investissement Immateriel,13,250,13,QCM,0.71,0.26,1.05,1,102,103,70,1,69,1.47,1.43,Difficile,Difficile,0,Meme Difficulté,Pas Adapte,Economy
3621,2018,Économie,5,Le Capital et le Progres Technique,3,Les Differents Types d'Investissement et le Poids de l'Investissement Immateriel,13,250,13,QCM,0.5,0.19,23.88,24,75,99,25,24,1,3.96,96.0,Moyen,Difficile,-1,Plus Difficile,Pas Adapte,Economy
4745,2019,Économie,5,Le Capital et le Progres Technique,3,Les Differents Types d'Investissement et le Poids de l'Investissement Immateriel,13,250,13,QCM,0.01,0.74,80.61,80,19,99,88,80,8,1.12,90.91,Difficile,Facile,2,Beaucoup plus Facile,Pas Adapte,Economy
5869,2020,Économie,5,Le Capital et le Progres Technique,3,Les Differents Types d'Investissement et le Poids de l'Investissement Immateriel,13,250,13,QCM,0.07,0.9,93.09,96,7,103,96,96,0,1.07,100.0,Moyen,Facile,1,Plus Facile,Pas Adapte,Economy
250,2015,Économie,5,Le Capital et le Progres Technique,4,Le Progres Technique - Nature et Role,6,251,1,QCU,0.13,0.83,77.73,40,11,51,46,40,6,1.11,86.96,Moyen,Facile,1,Plus Facile,Pas Adapte,Economy
1374,2016,Économie,5,Le Capital et le Progres Technique,4,Le Progres Technique - Nature et Role,6,251,1,QROC,0.13,0.68,99.93,50,0,50,50,50,0,1.0,100.0,Facile,Facile,0,Meme Difficulté,Pas Adapte,Economy
2498,2017,Économie,5,Le Capital et le Progres Technique,4,Le Progres Technique - Nature et Role,6,251,1,QROC,0.91,0.23,10.12,6,50,56,46,6,40,1.22,13.04,Difficile,Difficile,0,Meme Difficulté,Pas Adapte,Economy
3622,2018,Économie,5,Le Capital et le Progres Technique,4,Le Progres Technique - Nature et Role,6,251,1,QROC,0.9,0.11,26.51,14,40,54,29,14,15,1.86,48.28,Difficile,Difficile,0,Meme Difficulté,Pas Adapte,Economy
4746,2019,Économie,5,Le Capital et le Progres Technique,4,Le Progres Technique - Nature et Role,6,251,1,QROC,0.41,0.38,55.04,34,28,62,46,34,12,1.35,73.91,Difficile,Moyen,1,Plus Facile,Pas Adapte,Economy
5870,2020,Économie,5,Le Capital et le Progres Technique,4,Le Progres Technique - Nature et Role,6,251,1,QROC,0.61,0.07,15.07,8,48,56,52,8,44,1.08,15.38,Difficile,Difficile,0,Meme Difficulté,Pas Adapte,Economy
251,2015,Économie,5,Le Capital et le Progres Technique,4,Le Progres Technique - Nature et Role,6,252,2,QO,0.2,0.8,92.84,45,3,48,46,45,1,1.04,97.83,Difficile,Facile,2,Beaucoup plus Facile,Pas Adapte,Economy
1375,2016,Économie,5,Le Capital et le Progres Technique,4,Le Progres Technique - Nature et Role,6,252,2,QO,0.26,0.29,57.24,29,22,51,49,29,20,1.04,59.18,Moyen,Moyen,0,Meme Difficulté,Pas Adapte,Economy
2499,2017,Économie,5,Le Capital et le Progres Technique,4,Le Progres Technique - Nature et Role,6,252,2,QO,0.77,0.0,16.52,8,39,47,42,8,34,1.12,19.05,Difficile,Difficile,0,Meme Difficulté,Pas Adapte,Economy
3623,2018,Économie,5,Le Capital et le Progres Technique,4,Le Progres Technique - Nature et Role,6,252,2,QO,0.16,0.32,68.67,27,13,40,40,27,13,1.0,67.5,Facile,Facile,0,Meme Difficulté,Adapte,Economy
4747,2019,Économie,5,Le Capital et le Progres Technique,4,Le Progres Technique - Nature et Role,6,252,2,QO,0.14,0.52,68.67,30,14,44,31,30,1,1.42,96.77,Facile,Facile,0,Meme Difficulté,Adapte,Economy
5871,2020,Économie,5,Le Capital et le Progres Technique,4,Le Progres Technique - Nature et Role,6,252,2,QROC,0.1,0.62,68.67,27,13,40,31,27,4,1.29,87.1,Facile,Facile,0,Meme Difficulté,Adapte,Economy
252,2015,Économie,5,Le Capital et le Progres Technique,4,Le Progres Technique - Nature et Role,6,253,3,QCU,0.05,0.97,88.27,16,2,18,17,16,1,1.06,94.12,Difficile,Facile,2,Beaucoup plus Facile,Pas Adapte,Economy
1376,2016,Économie,5,Le Capital et le Progres Technique,4,Le Progres Technique - Nature et Role,6,253,3,QCU,0.62,0.21,17.44,3,15,18,7,3,4,2.57,42.86,Moyen,Difficile,-1,Plus Difficile,Pas Adapte,Economy
2500,2017,Économie,5,Le Capital et le Progres Technique,4,Le Progres Technique - Nature et Role,6,253,3,QCU,0.22,0.69,39.73,8,13,21,17,8,9,1.24,47.06,Moyen,Moyen,0,Meme Difficulté,Pas Adapte,Economy
3624,2018,Économie,5,Le Capital et le Progres Technique,4,Le Progres Technique - Nature et Role,6,253,3,QCU,0.2,0.94,74.26,16,6,22,21,16,5,1.05,76.19,Difficile,Facile,2,Beaucoup plus Facile,Adapte,Economy
4748,2019,Économie,5,Le Capital et le Progres Technique,4,Le Progres Technique - Nature et Role,6,253,3,QCU,0.01,0.76,74.26,18,6,24,22,18,4,1.09,81.82,Facile,Facile,0,Meme Difficulté,Adapte,Economy
5872,2020,Économie,5,Le Capital et le Progres Technique,4,Le Progres Technique - Nature et Role,6,253,3,QCU,0.09,0.92,74.26,19,6,25,23,19,4,1.09,82.61,Facile,Facile,0,Meme Difficulté,Adapte,Economy
253,2015,Économie,5,Le Capital et le Progres Technique,4,Le Progres Technique - Nature et Role,6,254,4,QROC,0.8,0.04,27.57,18,48,66,66,18,48,1.0,27.27,Facile,Difficile,-2,Beaucoup plus Difficile,Pas Adapte,Economy
1377,2016,Économie,5,Le Capital et le Progres Technique,4,Le Progres Technique - Nature et Role,6,254,4,QO,0.15,0.86,85.02,60,10,70,68,60,8,1.03,88.24,Facile,Facile,0,Meme Difficulté,Pas Adapte,Economy
2501,2017,Économie,5,Le Capital et le Progres Technique,4,Le Progres Technique - Nature et Role,6,254,4,QO,0.03,1.0,76.97,62,18,80,74,62,12,1.08,83.78,Facile,Facile,0,Meme Difficulté,Pas Adapte,Economy
3625,2018,Économie,5,Le Capital et le Progres Technique,4,Le Progres Technique - Nature et Role,6,254,4,QO,0.6,0.17,62.21,43,26,69,54,43,11,1.28,79.63,Facile,Moyen,-1,Plus Difficile,Adapte,Economy
4749,2019,Économie,5,Le Capital et le Progres Technique,4,Le Progres Technique - Nature et Role,6,254,4,QO,0.58,0.19,62.21,38,23,61,58,38,20,1.05,65.52,Moyen,Moyen,0,Meme Difficulté,Adapte,Economy
5873,2020,Économie,5,Le Capital et le Progres Technique,4,Le Progres Technique - Nature et Role,6,254,4,QO,0.59,0.17,62.21,41,25,66,45,41,4,1.47,91.11,Moyen,Moyen,0,Meme Difficulté,Adapte,Economy
254,2015,Économie,5,Le Capital et le Progres Technique,4,Le Progres Technique - Nature et Role,6,255,5,QCU,0.5,0.31,15.68,10,55,65,64,10,54,1.02,15.62,Facile,Difficile,-2,Beaucoup plus Difficile,Pas Adapte,Economy
1378,2016,Économie,5,Le Capital et le Progres Technique,4,Le Progres Technique - Nature et Role,6,255,5,QCU,0.72,0.21,34.88,26,48,74,57,26,31,1.3,45.61,Moyen,Difficile,-1,Plus Difficile,Pas Adapte,Economy
2502,2017,Économie,5,Le Capital et le Progres Technique,4,Le Progres Technique - Nature et Role,6,255,5,QCU,0.25,0.49,46.65,31,36,67,54,31,23,1.24,57.41,Difficile,Moyen,1,Plus Facile,Pas Adapte,Economy
3626,2018,Économie,5,Le Capital et le Progres Technique,4,Le Progres Technique - Nature et Role,6,255,5,QCM,0.36,0.52,41.54,27,37,64,27,27,0,2.37,100.0,Facile,Moyen,-1,Plus Difficile,Pas Adapte,Economy
4750,2019,Économie,5,Le Capital et le Progres Technique,4,Le Progres Technique - Nature et Role,6,255,5,QCM,0.67,0.23,31.95,24,50,74,43,24,19,1.72,55.81,Facile,Difficile,-2,Beaucoup plus Difficile,Pas Adapte,Economy
5874,2020,Économie,5,Le Capital et le Progres Technique,4,Le Progres Technique - Nature et Role,6,255,5,QCM,0.8,0.27,34.03,28,53,81,49,28,21,1.65,57.14,Moyen,Difficile,-1,Plus Difficile,Pas Adapte,Economy
255,2015,Économie,5,Le Capital et le Progres Technique,4,Le Progres Technique - Nature et Role,6,256,6,QCU,0.27,0.6,51.21,22,20,42,26,22,4,1.62,84.62,Moyen,Moyen,0,Meme Difficulté,Pas Adapte,Economy
1379,2016,Économie,5,Le Capital et le Progres Technique,4,Le Progres Technique - Nature et Role,6,256,6,QROC,0.98,0.17,11.79,5,40,45,38,5,33,1.18,13.16,Facile,Difficile,-2,Beaucoup plus Difficile,Pas Adapte,Economy
2503,2017,Économie,5,Le Capital et le Progres Technique,4,Le Progres Technique - Nature et Role,6,256,6,QROC,0.16,0.49,71.03,32,13,45,36,32,4,1.25,88.89,Facile,Facile,0,Meme Difficulté,Adapte,Economy
3627,2018,Économie,5,Le Capital et le Progres Technique,4,Le Progres Technique - Nature et Role,6,256,6,QCM,0.05,0.83,71.03,30,12,42,35,30,5,1.2,85.71,Facile,Facile,0,Meme Difficulté,Adapte,Economy
4751,2019,Économie,5,Le Capital et le Progres Technique,4,Le Progres Technique - Nature et Role,6,256,6,QCM,0.11,0.97,71.03,26,11,37,30,26,4,1.23,86.67,Facile,Facile,0,Meme Difficulté,Adapte,Economy
5875,2020,Économie,5,Le Capital et le Progres Technique,4,Le Progres Technique - Nature et Role,6,256,6,QCM,0.03,0.96,71.03,26,11,37,37,26,11,1.0,70.27,Facile,Facile,0,Meme Difficulté,Adapte,Economy
256,2015,Marketing,1,Introduction a l'Etude du Langage,1,La Nature du Langage,11,257,1,QCM,0.18,0.96,70.77,20,8,28,26,20,6,1.08,76.92,Moyen,Facile,1,Plus Facile,Adapte,Marketing
1380,2016,Marketing,1,Introduction a l'Etude du Langage,1,La Nature du Langage,11,257,1,QCM,0.08,0.83,70.77,21,9,30,29,21,8,1.03,72.41,Facile,Facile,0,Meme Difficulté,Adapte,Marketing
2504,2017,Marketing,1,Introduction a l'Etude du Langage,1,La Nature du Langage,11,257,1,QCM,0.08,0.86,70.77,18,8,26,23,18,5,1.13,78.26,Facile,Facile,0,Meme Difficulté,Adapte,Marketing
3628,2018,Marketing,1,Introduction a l'Etude du Langage,1,La Nature du Langage,11,257,1,QCM,0.01,0.87,70.77,21,8,29,25,21,4,1.16,84.0,Facile,Facile,0,Meme Difficulté,Adapte,Marketing
4752,2019,Marketing,1,Introduction a l'Etude du Langage,1,La Nature du Langage,11,257,1,QCM,0.08,0.87,70.77,21,8,29,27,21,6,1.07,77.78,Facile,Facile,0,Meme Difficulté,Adapte,Marketing
5876,2020,Marketing,1,Introduction a l'Etude du Langage,1,La Nature du Langage,11,257,1,QCM,0.03,0.75,70.77,23,10,33,30,23,7,1.1,76.67,Facile,Facile,0,Meme Difficulté,Adapte,Marketing
257,2015,Marketing,1,Introduction a l'Etude du Langage,1,La Nature du Langage,11,258,2,QCU,0.31,0.72,61.48,4,2,6,4,4,0,1.5,100.0,Facile,Moyen,-1,Plus Difficile,Adapte,Marketing
1381,2016,Marketing,1,Introduction a l'Etude du Langage,1,La Nature du Langage,11,258,2,QCU,0.26,0.58,61.48,3,2,5,5,3,2,1.0,60.0,Moyen,Moyen,0,Meme Difficulté,Adapte,Marketing
2505,2017,Marketing,1,Introduction a l'Etude du Langage,1,La Nature du Langage,11,258,2,QCU,0.26,0.53,61.48,3,2,5,4,3,1,1.25,75.0,Moyen,Moyen,0,Meme Difficulté,Adapte,Marketing
3629,2018,Marketing,1,Introduction a l'Etude du Langage,1,La Nature du Langage,11,258,2,QROC,0.26,0.37,61.48,3,2,5,4,3,1,1.25,75.0,Moyen,Moyen,0,Meme Difficulté,Adapte,Marketing
4753,2019,Marketing,1,Introduction a l'Etude du Langage,1,La Nature du Langage,11,258,2,QROC,0.2,0.29,61.48,3,2,5,4,3,1,1.25,75.0,Moyen,Moyen,0,Meme Difficulté,Adapte,Marketing
5877,2020,Marketing,1,Introduction a l'Etude du Langage,1,La Nature du Langage,11,258,2,QROC,0.21,0.26,61.48,2,2,4,3,2,1,1.33,66.67,Moyen,Moyen,0,Meme Difficulté,Adapte,Marketing
258,2015,Marketing,1,Introduction a l'Etude du Langage,1,La Nature du Langage,11,259,3,QROC,0.79,0.13,33.62,30,59,89,39,30,9,2.28,76.92,Difficile,Difficile,0,Meme Difficulté,Pas Adapte,Marketing
1382,2016,Marketing,1,Introduction a l'Etude du Langage,1,La Nature du Langage,11,259,3,QROC,0.05,0.73,84.03,75,14,89,86,75,11,1.03,87.21,Facile,Facile,0,Meme Difficulté,Pas Adapte,Marketing
2506,2017,Marketing,1,Introduction a l'Etude du Langage,1,La Nature du Langage,11,259,3,QROC,0.78,0.07,20.88,19,72,91,53,19,34,1.72,35.85,Moyen,Difficile,-1,Plus Difficile,Pas Adapte,Marketing
3630,2018,Marketing,1,Introduction a l'Etude du Langage,1,La Nature du Langage,11,259,3,QROC,0.89,0.16,31.53,28,60,88,64,28,36,1.38,43.75,Difficile,Difficile,0,Meme Difficulté,Pas Adapte,Marketing
4754,2019,Marketing,1,Introduction a l'Etude du Langage,1,La Nature du Langage,11,259,3,QCM,0.07,0.92,65.79,53,27,80,68,53,15,1.18,77.94,Difficile,Facile,2,Beaucoup plus Facile,Adapte,Marketing
5878,2020,Marketing,1,Introduction a l'Etude du Langage,1,La Nature du Langage,11,259,3,QCM,0.07,0.74,65.79,53,27,80,68,53,15,1.18,77.94,Facile,Facile,0,Meme Difficulté,Adapte,Marketing
259,2015,Marketing,1,Introduction a l'Etude du Langage,1,La Nature du Langage,11,260,4,QCU,0.51,0.33,34.9,30,57,87,57,30,27,1.53,52.63,Moyen,Difficile,-1,Plus Difficile,Pas Adapte,Marketing
1383,2016,Marketing,1,Introduction a l'Etude du Langage,1,La Nature du Langage,11,260,4,QCU,0.13,0.97,76.59,65,20,85,67,65,2,1.27,97.01,Difficile,Facile,2,Beaucoup plus Facile,Pas Adapte,Marketing
2507,2017,Marketing,1,Introduction a l'Etude du Langage,1,La Nature du Langage,11,260,4,QCU,0.35,0.67,45.09,39,48,87,64,39,25,1.36,60.94,Difficile,Moyen,1,Plus Facile,Pas Adapte,Marketing
3631,2018,Marketing,1,Introduction a l'Etude du Langage,1,La Nature du Langage,11,260,4,QCU,0.15,0.82,79.08,70,19,89,82,70,12,1.09,85.37,Facile,Facile,0,Meme Difficulté,Pas Adapte,Marketing
4755,2019,Marketing,1,Introduction a l'Etude du Langage,1,La Nature du Langage,11,260,4,QCU,0.03,0.85,92.23,92,8,100,99,92,7,1.01,92.93,Moyen,Facile,1,Plus Facile,Pas Adapte,Marketing
5879,2020,Marketing,1,Introduction a l'Etude du Langage,1,La Nature du Langage,11,260,4,QCU,0.39,0.43,55.23,54,44,98,80,54,26,1.23,67.5,Facile,Moyen,-1,Plus Difficile,Pas Adapte,Marketing
260,2015,Marketing,1,Introduction a l'Etude du Langage,1,La Nature du Langage,11,261,5,QCU,0.29,0.42,64.61,59,32,91,80,59,21,1.14,73.75,Difficile,Moyen,1,Plus Facile,Adapte,Marketing
1384,2016,Marketing,1,Introduction a l'Etude du Langage,1,La Nature du Langage,11,261,5,QCU,0.36,0.64,64.61,55,30,85,74,55,19,1.15,74.32,Moyen,Moyen,0,Meme Difficulté,Adapte,Marketing
2508,2017,Marketing,1,Introduction a l'Etude du Langage,1,La Nature du Langage,11,261,5,QCU,0.3,0.58,64.61,53,29,82,79,53,26,1.04,67.09,Moyen,Moyen,0,Meme Difficulté,Adapte,Marketing
3632,2018,Marketing,1,Introduction a l'Etude du Langage,1,La Nature du Langage,11,261,5,QCM,0.47,0.31,64.61,54,29,83,63,54,9,1.32,85.71,Moyen,Moyen,0,Meme Difficulté,Adapte,Marketing
4756,2019,Marketing,1,Introduction a l'Etude du Langage,1,La Nature du Langage,11,261,5,QCM,0.37,0.36,64.61,51,28,79,69,51,18,1.14,73.91,Moyen,Moyen,0,Meme Difficulté,Adapte,Marketing
5880,2020,Marketing,1,Introduction a l'Etude du Langage,1,La Nature du Langage,11,261,5,QCM,0.3,0.35,64.61,58,31,89,61,58,3,1.46,95.08,Moyen,Moyen,0,Meme Difficulté,Adapte,Marketing
261,2015,Marketing,1,Introduction a l'Etude du Langage,1,La Nature du Langage,11,262,6,QCU,0.31,0.42,52.95,34,30,64,52,34,18,1.23,65.38,Facile,Moyen,-1,Plus Difficile,Pas Adapte,Marketing
1385,2016,Marketing,1,Introduction a l'Etude du Langage,1,La Nature du Langage,11,262,6,QCU,0.13,0.91,91.07,62,6,68,65,62,3,1.05,95.38,Difficile,Facile,2,Beaucoup plus Facile,Pas Adapte,Marketing
2509,2017,Marketing,1,Introduction a l'Etude du Langage,1,La Nature du Langage,11,262,6,QCU,0.14,0.85,67.85,46,22,68,50,46,4,1.36,92.0,Moyen,Facile,1,Plus Facile,Adapte,Marketing
3633,2018,Marketing,1,Introduction a l'Etude du Langage,1,La Nature du Langage,11,262,6,QCU,0.14,0.83,67.85,50,24,74,52,50,2,1.42,96.15,Facile,Facile,0,Meme Difficulté,Adapte,Marketing
4757,2019,Marketing,1,Introduction a l'Etude du Langage,1,La Nature du Langage,11,262,6,QCU,0.12,0.91,67.85,47,23,70,69,47,22,1.01,68.12,Facile,Facile,0,Meme Difficulté,Adapte,Marketing
5881,2020,Marketing,1,Introduction a l'Etude du Langage,1,La Nature du Langage,11,262,6,QCU,0.05,0.85,67.85,47,22,69,68,47,21,1.01,69.12,Facile,Facile,0,Meme Difficulté,Adapte,Marketing
262,2015,Marketing,1,Introduction a l'Etude du Langage,1,La Nature du Langage,11,263,7,QCM,0.33,0.63,50.83,26,25,51,28,26,2,1.82,92.86,Difficile,Moyen,1,Plus Facile,Pas Adapte,Marketing
1386,2016,Marketing,1,Introduction a l'Etude du Langage,1,La Nature du Langage,11,263,7,QCM,0.03,0.88,95.58,48,2,50,50,48,2,1.0,96.0,Difficile,Facile,2,Beaucoup plus Facile,Pas Adapte,Marketing
2510,2017,Marketing,1,Introduction a l'Etude du Langage,1,La Nature du Langage,11,263,7,QCM,0.71,0.17,33.91,19,36,55,39,19,20,1.41,48.72,Facile,Difficile,-2,Beaucoup plus Difficile,Pas Adapte,Marketing
3634,2018,Marketing,1,Introduction a l'Etude du Langage,1,La Nature du Langage,11,263,7,QCM,0.39,0.5,61.24,33,21,54,46,33,13,1.17,71.74,Difficile,Moyen,1,Plus Facile,Adapte,Marketing
4758,2019,Marketing,1,Introduction a l'Etude du Langage,1,La Nature du Langage,11,263,7,QCM,0.35,0.45,61.24,29,19,48,33,29,4,1.45,87.88,Moyen,Moyen,0,Meme Difficulté,Adapte,Marketing
5882,2020,Marketing,1,Introduction a l'Etude du Langage,1,La Nature du Langage,11,263,7,QCM,0.39,0.67,61.24,29,19,48,35,29,6,1.37,82.86,Moyen,Moyen,0,Meme Difficulté,Adapte,Marketing
263,2015,Marketing,1,Introduction a l'Etude du Langage,1,La Nature du Langage,11,264,8,QCU,0.04,0.85,92.52,16,1,17,17,16,1,1.0,94.12,Difficile,Facile,2,Beaucoup plus Facile,Pas Adapte,Marketing
1387,2016,Marketing,1,Introduction a l'Etude du Langage,1,La Nature du Langage,11,264,8,QCU,0.27,0.42,51.68,9,9,18,16,9,7,1.12,56.25,Moyen,Moyen,0,Meme Difficulté,Pas Adapte,Marketing
2511,2017,Marketing,1,Introduction a l'Etude du Langage,1,La Nature du Langage,11,264,8,QCU,0.32,0.66,48.78,8,8,16,10,8,2,1.6,80.0,Facile,Moyen,-1,Plus Difficile,Pas Adapte,Marketing
3635,2018,Marketing,1,Introduction a l'Etude du Langage,1,La Nature du Langage,11,264,8,QCU,0.68,0.4,6.84,1,14,15,5,1,4,3.0,20.0,Moyen,Difficile,-1,Plus Difficile,Pas Adapte,Marketing
4759,2019,Marketing,1,Introduction a l'Etude du Langage,1,La Nature du Langage,11,264,8,QCU,0.1,0.91,73.82,10,4,14,13,10,3,1.08,76.92,Facile,Facile,0,Meme Difficulté,Adapte,Marketing
5883,2020,Marketing,1,Introduction a l'Etude du Langage,1,La Nature du Langage,11,264,8,QCU,0.01,0.98,73.82,11,4,15,14,11,3,1.07,78.57,Facile,Facile,0,Meme Difficulté,Adapte,Marketing
264,2015,Marketing,1,Introduction a l'Etude du Langage,1,La Nature du Langage,11,265,9,QROC,0.18,0.49,72.92,34,12,46,39,34,5,1.18,87.18,Difficile,Facile,2,Beaucoup plus Facile,Adapte,Marketing
1388,2016,Marketing,1,Introduction a l'Etude du Langage,1,La Nature du Langage,11,265,9,QROC,0.15,0.85,72.92,31,11,42,35,31,4,1.2,88.57,Facile,Facile,0,Meme Difficulté,Adapte,Marketing
2512,2017,Marketing,1,Introduction a l'Etude du Langage,1,La Nature du Langage,11,265,9,QROC,0.19,0.51,72.92,31,11,42,33,31,2,1.27,93.94,Facile,Facile,0,Meme Difficulté,Adapte,Marketing
3636,2018,Marketing,1,Introduction a l'Etude du Langage,1,La Nature du Langage,11,265,9,QO,0.09,0.82,72.92,28,10,38,31,28,3,1.23,90.32,Facile,Facile,0,Meme Difficulté,Adapte,Marketing
4760,2019,Marketing,1,Introduction a l'Etude du Langage,1,La Nature du Langage,11,265,9,QO,0.07,0.68,72.92,29,11,40,37,29,8,1.08,78.38,Facile,Facile,0,Meme Difficulté,Adapte,Marketing
5884,2020,Marketing,1,Introduction a l'Etude du Langage,1,La Nature du Langage,11,265,9,QO,0.06,0.35,72.92,34,12,46,44,34,10,1.05,77.27,Facile,Facile,0,Meme Difficulté,Adapte,Marketing
265,2015,Marketing,1,Introduction a l'Etude du Langage,1,La Nature du Langage,11,266,10,QCM,0.74,0.18,0.12,0,81,81,24,0,24,3.38,0.0,Moyen,Difficile,-1,Plus Difficile,Pas Adapte,Marketing
1389,2016,Marketing,1,Introduction a l'Etude du Langage,1,La Nature du Langage,11,266,10,QCM,0.68,0.24,19.15,17,70,87,38,17,21,2.29,44.74,Difficile,Difficile,0,Meme Difficulté,Pas Adapte,Marketing
2513,2017,Marketing,1,Introduction a l'Etude du Langage,1,La Nature du Langage,11,266,10,QCU,0.66,0.37,17.06,14,66,80,42,14,28,1.9,33.33,Moyen,Difficile,-1,Plus Difficile,Pas Adapte,Marketing
3637,2018,Marketing,1,Introduction a l'Etude du Langage,1,La Nature du Langage,11,266,10,QCU,0.2,0.5,41.46,37,52,89,42,37,5,2.12,88.1,Moyen,Moyen,0,Meme Difficulté,Pas Adapte,Marketing
4761,2019,Marketing,1,Introduction a l'Etude du Langage,1,La Nature du Langage,11,266,10,QCU,0.21,0.63,60.4,49,32,81,68,49,19,1.19,72.06,Facile,Moyen,-1,Plus Difficile,Adapte,Marketing
5885,2020,Marketing,1,Introduction a l'Etude du Langage,1,La Nature du Langage,11,266,10,QCU,0.21,0.52,60.4,44,29,73,54,44,10,1.35,81.48,Moyen,Moyen,0,Meme Difficulté,Adapte,Marketing
266,2015,Marketing,1,Introduction a l'Etude du Langage,1,La Nature du Langage,11,267,11,QCU,0.2,0.99,86.89,35,5,40,40,35,5,1.0,87.5,Facile,Facile,0,Meme Difficulté,Pas Adapte,Marketing
1390,2016,Marketing,1,Introduction a l'Etude du Langage,1,La Nature du Langage,11,267,11,QCU,0.53,0.36,27.21,11,28,39,28,11,17,1.39,39.29,Moyen,Difficile,-1,Plus Difficile,Pas Adapte,Marketing
2514,2017,Marketing,1,Introduction a l'Etude du Langage,1,La Nature du Langage,11,267,11,QCU,0.27,0.67,62.97,26,16,42,40,26,14,1.05,65.0,Difficile,Moyen,1,Plus Facile,Adapte,Marketing
3638,2018,Marketing,1,Introduction a l'Etude du Langage,1,La Nature du Langage,11,267,11,QCM,0.47,0.39,62.97,27,16,43,40,27,13,1.07,67.5,Moyen,Moyen,0,Meme Difficulté,Adapte,Marketing
4762,2019,Marketing,1,Introduction a l'Etude du Langage,1,La Nature du Langage,11,267,11,QCM,0.3,0.39,62.97,27,16,43,41,27,14,1.05,65.85,Moyen,Moyen,0,Meme Difficulté,Adapte,Marketing
5886,2020,Marketing,1,Introduction a l'Etude du Langage,1,La Nature du Langage,11,267,11,QCM,0.5,0.63,62.97,29,17,46,46,29,17,1.0,63.04,Moyen,Moyen,0,Meme Difficulté,Adapte,Marketing
267,2015,Marketing,1,Introduction a l'Etude du Langage,2,La Semiotique,8,268,1,QO,0.86,0.08,23.87,17,54,71,46,17,29,1.54,36.96,Difficile,Difficile,0,Meme Difficulté,Pas Adapte,Marketing
1391,2016,Marketing,1,Introduction a l'Etude du Langage,2,La Semiotique,8,268,1,QO,0.04,0.41,92.65,75,6,81,78,75,3,1.04,96.15,Difficile,Facile,2,Beaucoup plus Facile,Pas Adapte,Marketing
2515,2017,Marketing,1,Introduction a l'Etude du Langage,2,La Semiotique,8,268,1,QROC,0.21,0.34,64.81,49,27,76,51,49,2,1.49,96.08,Difficile,Moyen,1,Plus Facile,Adapte,Marketing
3639,2018,Marketing,1,Introduction a l'Etude du Langage,2,La Semiotique,8,268,1,QROC,0.21,0.38,64.81,52,28,80,67,52,15,1.19,77.61,Moyen,Moyen,0,Meme Difficulté,Adapte,Marketing
4763,2019,Marketing,1,Introduction a l'Etude du Langage,2,La Semiotique,8,268,1,QROC,0.35,0.32,64.81,47,25,72,72,47,25,1.0,65.28,Moyen,Moyen,0,Meme Difficulté,Adapte,Marketing
5887,2020,Marketing,1,Introduction a l'Etude du Langage,2,La Semiotique,8,268,1,QROC,0.34,0.31,64.81,45,25,70,56,45,11,1.25,80.36,Moyen,Moyen,0,Meme Difficulté,Adapte,Marketing
268,2015,Marketing,1,Introduction a l'Etude du Langage,2,La Semiotique,8,269,2,QROC,0.17,0.96,90.96,59,6,65,63,59,4,1.03,93.65,Difficile,Facile,2,Beaucoup plus Facile,Pas Adapte,Marketing
1392,2016,Marketing,1,Introduction a l'Etude du Langage,2,La Semiotique,8,269,2,QROC,0.64,0.2,3.91,3,67,70,32,3,29,2.19,9.38,Difficile,Difficile,0,Meme Difficulté,Pas Adapte,Marketing
2516,2017,Marketing,1,Introduction a l'Etude du Langage,2,La Semiotique,8,269,2,QROC,0.55,0.38,60.45,39,25,64,48,39,9,1.33,81.25,Moyen,Moyen,0,Meme Difficulté,Adapte,Marketing
3640,2018,Marketing,1,Introduction a l'Etude du Langage,2,La Semiotique,8,269,2,QROC,0.33,0.36,60.45,43,28,71,50,43,7,1.42,86.0,Moyen,Moyen,0,Meme Difficulté,Adapte,Marketing
4764,2019,Marketing,1,Introduction a l'Etude du Langage,2,La Semiotique,8,269,2,QROC,0.53,0.26,60.45,46,30,76,73,46,27,1.04,63.01,Moyen,Moyen,0,Meme Difficulté,Adapte,Marketing
5888,2020,Marketing,1,Introduction a l'Etude du Langage,2,La Semiotique,8,269,2,QROC,0.59,0.34,60.45,46,30,76,71,46,25,1.07,64.79,Moyen,Moyen,0,Meme Difficulté,Adapte,Marketing
269,2015,Marketing,1,Introduction a l'Etude du Langage,2,La Semiotique,8,270,3,QROC,0.22,0.31,39.36,3,4,7,3,3,0,2.33,100.0,Difficile,Moyen,1,Plus Facile,Pas Adapte,Marketing
1393,2016,Marketing,1,Introduction a l'Etude du Langage,2,La Semiotique,8,270,3,QROC,0.9,0.05,6.67,0,7,7,5,0,5,1.4,0.0,Difficile,Difficile,0,Meme Difficulté,Pas Adapte,Marketing
2517,2017,Marketing,1,Introduction a l'Etude du Langage,2,La Semiotique,8,270,3,QROC,0.01,0.64,90.68,5,1,6,5,5,0,1.2,100.0,Moyen,Facile,1,Plus Facile,Pas Adapte,Marketing
3641,2018,Marketing,1,Introduction a l'Etude du Langage,2,La Semiotique,8,270,3,QROC,0.15,0.7,67.05,3,2,5,5,3,2,1.0,60.0,Facile,Facile,0,Meme Difficulté,Adapte,Marketing
4765,2019,Marketing,1,Introduction a l'Etude du Langage,2,La Semiotique,8,270,3,QROC,0.05,0.91,67.05,4,2,6,5,4,1,1.2,80.0,Facile,Facile,0,Meme Difficulté,Adapte,Marketing
5889,2020,Marketing,1,Introduction a l'Etude du Langage,2,La Semiotique,8,270,3,QROC,0.18,0.92,67.05,5,2,7,7,5,2,1.0,71.43,Facile,Facile,0,Meme Difficulté,Adapte,Marketing
270,2015,Marketing,1,Introduction a l'Etude du Langage,2,La Semiotique,8,271,4,QCU,0.31,0.43,36.01,8,14,22,19,8,11,1.16,42.11,Facile,Moyen,-1,Plus Difficile,Pas Adapte,Marketing
1394,2016,Marketing,1,Introduction a l'Etude du Langage,2,La Semiotique,8,271,4,QCU,0.45,0.23,16.73,4,19,23,16,4,12,1.44,25.0,Moyen,Difficile,-1,Plus Difficile,Pas Adapte,Marketing
2518,2017,Marketing,1,Introduction a l'Etude du Langage,2,La Semiotique,8,271,4,QCM,0.71,0.17,23.68,5,18,23,6,5,1,3.83,83.33,Moyen,Difficile,-1,Plus Difficile,Pas Adapte,Marketing
3642,2018,Marketing,1,Introduction a l'Etude du Langage,2,La Semiotique,8,271,4,QCM,0.6,0.27,19.02,4,18,22,11,4,7,2.0,36.36,Moyen,Difficile,-1,Plus Difficile,Pas Adapte,Marketing
4766,2019,Marketing,1,Introduction a l'Etude du Langage,2,La Semiotique,8,271,4,QCM,0.47,0.6,62.74,14,9,23,22,14,8,1.05,63.64,Facile,Moyen,-1,Plus Difficile,Adapte,Marketing
5890,2020,Marketing,1,Introduction a l'Etude du Langage,2,La Semiotique,8,271,4,QCM,0.32,0.43,62.74,16,10,26,26,16,10,1.0,61.54,Moyen,Moyen,0,Meme Difficulté,Adapte,Marketing
271,2015,Marketing,1,Introduction a l'Etude du Langage,2,La Semiotique,8,272,5,QCU,0.35,0.51,64.62,36,20,56,37,36,1,1.51,97.3,Moyen,Moyen,0,Meme Difficulté,Adapte,Marketing
1395,2016,Marketing,1,Introduction a l'Etude du Langage,2,La Semiotique,8,272,5,QCU,0.28,0.5,64.62,39,21,60,50,39,11,1.2,78.0,Moyen,Moyen,0,Meme Difficulté,Adapte,Marketing
2519,2017,Marketing,1,Introduction a l'Etude du Langage,2,La Semiotique,8,272,5,QCM,0.25,0.39,64.62,39,21,60,45,39,6,1.33,86.67,Moyen,Moyen,0,Meme Difficulté,Adapte,Marketing
3643,2018,Marketing,1,Introduction a l'Etude du Langage,2,La Semiotique,8,272,5,QCM,0.4,0.67,64.62,39,22,61,54,39,15,1.13,72.22,Moyen,Moyen,0,Meme Difficulté,Adapte,Marketing
4767,2019,Marketing,1,Introduction a l'Etude du Langage,2,La Semiotique,8,272,5,QCM,0.24,0.6,64.62,36,19,55,37,36,1,1.49,97.3,Moyen,Moyen,0,Meme Difficulté,Adapte,Marketing
5891,2020,Marketing,1,Introduction a l'Etude du Langage,2,La Semiotique,8,272,5,QCM,0.35,0.4,64.62,34,18,52,41,34,7,1.27,82.93,Moyen,Moyen,0,Meme Difficulté,Adapte,Marketing
272,2015,Marketing,1,Introduction a l'Etude du Langage,2,La Semiotique,8,273,6,QCU,0.45,0.38,28.85,16,41,57,24,16,8,2.38,66.67,Facile,Difficile,-2,Beaucoup plus Difficile,Pas Adapte,Marketing
1396,2016,Marketing,1,Introduction a l'Etude du Langage,2,La Semiotique,8,273,6,QCU,0.11,0.97,94.31,58,3,61,59,58,1,1.03,98.31,Moyen,Facile,1,Plus Facile,Pas Adapte,Marketing
2520,2017,Marketing,1,Introduction a l'Etude du Langage,2,La Semiotique,8,273,6,QCU,0.16,0.84,95.76,56,3,59,57,56,1,1.04,98.25,Moyen,Facile,1,Plus Facile,Pas Adapte,Marketing
3644,2018,Marketing,1,Introduction a l'Etude du Langage,2,La Semiotique,8,273,6,QCU,0.44,0.33,4.69,3,51,54,29,3,26,1.86,10.34,Facile,Difficile,-2,Beaucoup plus Difficile,Pas Adapte,Marketing
4768,2019,Marketing,1,Introduction a l'Etude du Langage,2,La Semiotique,8,273,6,QCU,0.28,0.6,60.62,30,20,50,41,30,11,1.22,73.17,Difficile,Moyen,1,Plus Facile,Adapte,Marketing
5892,2020,Marketing,1,Introduction a l'Etude du Langage,2,La Semiotique,8,273,6,QCU,0.4,0.75,60.62,32,20,52,38,32,6,1.37,84.21,Moyen,Moyen,0,Meme Difficulté,Adapte,Marketing
273,2015,Marketing,1,Introduction a l'Etude du Langage,2,La Semiotique,8,274,7,QCU,0.69,0.28,29.07,13,33,46,39,13,26,1.18,33.33,Facile,Difficile,-2,Beaucoup plus Difficile,Pas Adapte,Marketing
1397,2016,Marketing,1,Introduction a l'Etude du Langage,2,La Semiotique,8,274,7,QCM,0.29,0.69,61.51,28,18,46,32,28,4,1.44,87.5,Moyen,Moyen,0,Meme Difficulté,Adapte,Marketing
2521,2017,Marketing,1,Introduction a l'Etude du Langage,2,La Semiotique,8,274,7,QCU,0.3,0.55,61.51,26,16,42,31,26,5,1.35,83.87,Moyen,Moyen,0,Meme Difficulté,Adapte,Marketing
3645,2018,Marketing,1,Introduction a l'Etude du Langage,2,La Semiotique,8,274,7,QCU,0.24,0.63,61.51,23,14,37,34,23,11,1.09,67.65,Moyen,Moyen,0,Meme Difficulté,Adapte,Marketing
4769,2019,Marketing,1,Introduction a l'Etude du Langage,2,La Semiotique,8,274,7,QCU,0.25,0.47,61.51,26,16,42,35,26,9,1.2,74.29,Moyen,Moyen,0,Meme Difficulté,Adapte,Marketing
5893,2020,Marketing,1,Introduction a l'Etude du Langage,2,La Semiotique,8,274,7,QCU,0.39,0.69,61.51,23,15,38,34,23,11,1.12,67.65,Moyen,Moyen,0,Meme Difficulté,Adapte,Marketing
274,2015,Marketing,1,Introduction a l'Etude du Langage,2,La Semiotique,8,275,8,QCU,0.68,0.23,14.03,10,64,74,39,10,29,1.9,25.64,Facile,Difficile,-2,Beaucoup plus Difficile,Pas Adapte,Marketing
1398,2016,Marketing,1,Introduction a l'Etude du Langage,2,La Semiotique,8,275,8,QCU,0.31,0.64,39.02,25,38,63,32,25,7,1.97,78.12,Moyen,Moyen,0,Meme Difficulté,Pas Adapte,Marketing
2522,2017,Marketing,1,Introduction a l'Etude du Langage,2,La Semiotique,8,275,8,QCM,0.09,0.95,93.51,50,4,54,54,50,4,1.0,92.59,Facile,Facile,0,Meme Difficulté,Pas Adapte,Marketing
3646,2018,Marketing,1,Introduction a l'Etude du Langage,2,La Semiotique,8,275,8,QCM,0.75,0.28,33.42,18,36,54,45,18,27,1.2,40.0,Difficile,Difficile,0,Meme Difficulté,Pas Adapte,Marketing
4770,2019,Marketing,1,Introduction a l'Etude du Langage,2,La Semiotique,8,275,8,QCM,0.02,0.74,87.41,40,6,46,46,40,6,1.0,86.96,Facile,Facile,0,Meme Difficulté,Pas Adapte,Marketing
5894,2020,Marketing,1,Introduction a l'Etude du Langage,2,La Semiotique,8,275,8,QCM,0.75,0.22,9.52,4,42,46,35,4,31,1.31,11.43,Facile,Difficile,-2,Beaucoup plus Difficile,Pas Adapte,Marketing
275,2015,Marketing,1,Introduction a l'Etude du Langage,3,La Morphologie,9,276,1,QROC,0.23,0.32,52.89,41,36,77,71,41,30,1.08,57.75,Difficile,Moyen,1,Plus Facile,Pas Adapte,Marketing
1399,2016,Marketing,1,Introduction a l'Etude du Langage,3,La Morphologie,9,276,1,QROC,0.75,0.19,10.32,8,67,75,41,8,33,1.83,19.51,Difficile,Difficile,0,Meme Difficulté,Pas Adapte,Marketing
2523,2017,Marketing,1,Introduction a l'Etude du Langage,3,La Morphologie,9,276,1,QROC,0.55,0.29,60.59,48,32,80,74,48,26,1.08,64.86,Difficile,Moyen,1,Plus Facile,Adapte,Marketing
3647,2018,Marketing,1,Introduction a l'Etude du Langage,3,La Morphologie,9,276,1,QROC,0.51,0.29,60.59,54,35,89,85,54,31,1.05,63.53,Moyen,Moyen,0,Meme Difficulté,Adapte,Marketing
4771,2019,Marketing,1,Introduction a l'Etude du Langage,3,La Morphologie,9,276,1,QROC,0.24,0.37,60.59,58,37,95,66,58,8,1.44,87.88,Moyen,Moyen,0,Meme Difficulté,Adapte,Marketing
5895,2020,Marketing,1,Introduction a l'Etude du Langage,3,La Morphologie,9,276,1,QROC,0.26,0.31,60.59,56,36,92,79,56,23,1.16,70.89,Moyen,Moyen,0,Meme Difficulté,Adapte,Marketing
276,2015,Marketing,1,Introduction a l'Etude du Langage,3,La Morphologie,9,277,2,QCM,0.06,0.71,93.27,8,1,9,8,8,0,1.12,100.0,Moyen,Facile,1,Plus Facile,Pas Adapte,Marketing
1400,2016,Marketing,1,Introduction a l'Etude du Langage,3,La Morphologie,9,277,2,QROC,0.07,0.89,85.35,7,1,8,7,7,0,1.14,100.0,Difficile,Facile,2,Beaucoup plus Facile,Pas Adapte,Marketing
2524,2017,Marketing,1,Introduction a l'Etude du Langage,3,La Morphologie,9,277,2,QROC,0.17,0.81,79.79,6,1,7,6,6,0,1.17,100.0,Facile,Facile,0,Meme Difficulté,Pas Adapte,Marketing
3648,2018,Marketing,1,Introduction a l'Etude du Langage,3,La Morphologie,9,277,2,QROC,0.32,0.35,55.37,3,3,6,3,3,0,2.0,100.0,Difficile,Moyen,1,Plus Facile,Pas Adapte,Marketing
4772,2019,Marketing,1,Introduction a l'Etude du Langage,3,La Morphologie,9,277,2,QROC,0.55,0.39,55.89,4,3,7,6,4,2,1.17,66.67,Difficile,Moyen,1,Plus Facile,Pas Adapte,Marketing
5896,2020,Marketing,1,Introduction a l'Etude du Langage,3,La Morphologie,9,277,2,QROC,0.61,0.1,6.26,0,6,6,3,0,3,2.0,0.0,Difficile,Difficile,0,Meme Difficulté,Pas Adapte,Marketing
277,2015,Marketing,1,Introduction a l'Etude du Langage,3,La Morphologie,9,278,3,QCM,0.62,0.18,17.75,17,77,94,91,17,74,1.03,18.68,Difficile,Difficile,0,Meme Difficulté,Pas Adapte,Marketing
1401,2016,Marketing,1,Introduction a l'Etude du Langage,3,La Morphologie,9,278,3,QCM,0.28,0.57,58.6,47,33,80,72,47,25,1.11,65.28,Moyen,Moyen,0,Meme Difficulté,Pas Adapte,Marketing
2525,2017,Marketing,1,Introduction a l'Etude du Langage,3,La Morphologie,9,278,3,QCM,0.18,0.77,79.87,55,14,69,69,55,14,1.0,79.71,Difficile,Facile,2,Beaucoup plus Facile,Pas Adapte,Marketing
3649,2018,Marketing,1,Introduction a l'Etude du Langage,3,La Morphologie,9,278,3,QCM,0.06,0.88,89.48,64,7,71,68,64,4,1.04,94.12,Moyen,Facile,1,Plus Facile,Pas Adapte,Marketing
4773,2019,Marketing,1,Introduction a l'Etude du Langage,3,La Morphologie,9,278,3,QCM,0.17,0.75,91.87,74,7,81,80,74,6,1.01,92.5,Facile,Facile,0,Meme Difficulté,Pas Adapte,Marketing
5897,2020,Marketing,1,Introduction a l'Etude du Langage,3,La Morphologie,9,278,3,QCM,0.11,0.96,86.63,77,12,89,82,77,5,1.09,93.9,Moyen,Facile,1,Plus Facile,Pas Adapte,Marketing
278,2015,Marketing,1,Introduction a l'Etude du Langage,3,La Morphologie,9,279,4,QCM,0.36,0.58,58.6,39,27,66,51,39,12,1.29,76.47,Moyen,Moyen,0,Meme Difficulté,Pas Adapte,Marketing
1402,2016,Marketing,1,Introduction a l'Etude du Langage,3,La Morphologie,9,279,4,QCM,0.55,0.27,26.48,19,53,72,50,19,31,1.44,38.0,Moyen,Difficile,-1,Plus Difficile,Pas Adapte,Marketing
2526,2017,Marketing,1,Introduction a l'Etude du Langage,3,La Morphologie,9,279,4,QCM,0.08,0.99,90.15,66,7,73,70,66,4,1.04,94.29,Moyen,Facile,1,Plus Facile,Pas Adapte,Marketing
3650,2018,Marketing,1,Introduction a l'Etude du Langage,3,La Morphologie,9,279,4,QCM,0.15,0.78,90.47,64,7,71,66,64,2,1.08,96.97,Difficile,Facile,2,Beaucoup plus Facile,Pas Adapte,Marketing
4774,2019,Marketing,1,Introduction a l'Etude du Langage,3,La Morphologie,9,279,4,QCM,0.7,0.28,14.64,11,64,75,57,11,46,1.32,19.3,Difficile,Difficile,0,Meme Difficulté,Pas Adapte,Marketing
5898,2020,Marketing,1,Introduction a l'Etude du Langage,3,La Morphologie,9,279,4,QCM,0.44,0.65,44.72,35,44,79,44,35,9,1.8,79.55,Moyen,Moyen,0,Meme Difficulté,Pas Adapte,Marketing
279,2015,Marketing,1,Introduction a l'Etude du Langage,3,La Morphologie,9,280,5,QCM,0.77,0.21,11.46,4,32,36,19,4,15,1.89,21.05,Difficile,Difficile,0,Meme Difficulté,Pas Adapte,Marketing
1403,2016,Marketing,1,Introduction a l'Etude du Langage,3,La Morphologie,9,280,5,QCM,0.63,0.25,34.08,13,26,39,32,13,19,1.22,40.62,Difficile,Difficile,0,Meme Difficulté,Pas Adapte,Marketing
2527,2017,Marketing,1,Introduction a l'Etude du Langage,3,La Morphologie,9,280,5,QCM,0.14,0.99,92.07,32,3,35,32,32,0,1.09,100.0,Difficile,Facile,2,Beaucoup plus Facile,Pas Adapte,Marketing
3651,2018,Marketing,1,Introduction a l'Etude du Langage,3,La Morphologie,9,280,5,QCM,0.08,0.91,86.09,29,5,34,30,29,1,1.13,96.67,Moyen,Facile,1,Plus Facile,Pas Adapte,Marketing
4775,2019,Marketing,1,Introduction a l'Etude du Langage,3,La Morphologie,9,280,5,QCM,0.49,0.7,49.21,17,17,34,29,17,12,1.17,58.62,Facile,Moyen,-1,Plus Difficile,Pas Adapte,Marketing
5899,2020,Marketing,1,Introduction a l'Etude du Langage,3,La Morphologie,9,280,5,QCM,0.36,0.42,48.99,19,19,38,19,19,0,2.0,100.0,Moyen,Moyen,0,Meme Difficulté,Pas Adapte,Marketing
280,2015,Marketing,1,Introduction a l'Etude du Langage,3,La Morphologie,9,281,6,QCU,0.34,0.52,41.24,29,42,71,39,29,10,1.82,74.36,Difficile,Moyen,1,Plus Facile,Pas Adapte,Marketing
1404,2016,Marketing,1,Introduction a l'Etude du Langage,3,La Morphologie,9,281,6,QCU,0.24,0.64,45.83,37,43,80,42,37,5,1.9,88.1,Facile,Moyen,-1,Plus Difficile,Pas Adapte,Marketing
2528,2017,Marketing,1,Introduction a l'Etude du Langage,3,La Morphologie,9,281,6,QCM,0.21,0.3,35.23,30,55,85,63,30,33,1.35,47.62,Moyen,Moyen,0,Meme Difficulté,Pas Adapte,Marketing
3652,2018,Marketing,1,Introduction a l'Etude du Langage,3,La Morphologie,9,281,6,QCM,0.35,0.59,51.06,47,46,93,82,47,35,1.13,57.32,Moyen,Moyen,0,Meme Difficulté,Pas Adapte,Marketing
4776,2019,Marketing,1,Introduction a l'Etude du Langage,3,La Morphologie,9,281,6,QCM,0.55,0.24,15.73,17,89,106,88,17,71,1.2,19.32,Facile,Difficile,-2,Beaucoup plus Difficile,Pas Adapte,Marketing
5900,2020,Marketing,1,Introduction a l'Etude du Langage,3,La Morphologie,9,281,6,QCM,0.56,0.24,32.24,34,73,107,94,34,60,1.14,36.17,Facile,Difficile,-2,Beaucoup plus Difficile,Pas Adapte,Marketing
281,2015,Marketing,1,Introduction a l'Etude du Langage,3,La Morphologie,9,282,7,QCU,0.02,0.92,91.15,57,6,63,61,57,4,1.03,93.44,Difficile,Facile,2,Beaucoup plus Facile,Pas Adapte,Marketing
1405,2016,Marketing,1,Introduction a l'Etude du Langage,3,La Morphologie,9,282,7,QCU,0.26,0.46,44.44,30,37,67,55,30,25,1.22,54.55,Difficile,Moyen,1,Plus Facile,Pas Adapte,Marketing
2529,2017,Marketing,1,Introduction a l'Etude du Langage,3,La Morphologie,9,282,7,QCU,0.34,0.62,52.79,31,27,58,51,31,20,1.14,60.78,Facile,Moyen,-1,Plus Difficile,Pas Adapte,Marketing
3653,2018,Marketing,1,Introduction a l'Etude du Langage,3,La Morphologie,9,282,7,QCU,0.19,0.9,71.61,39,16,55,40,39,1,1.38,97.5,Moyen,Facile,1,Plus Facile,Adapte,Marketing
4777,2019,Marketing,1,Introduction a l'Etude du Langage,3,La Morphologie,9,282,7,QCU,0.15,0.92,71.61,42,17,59,45,42,3,1.31,93.33,Facile,Facile,0,Meme Difficulté,Adapte,Marketing
5901,2020,Marketing,1,Introduction a l'Etude du Langage,3,La Morphologie,9,282,7,QCU,0.06,0.83,71.61,37,14,51,37,37,0,1.38,100.0,Facile,Facile,0,Meme Difficulté,Adapte,Marketing
282,2015,Marketing,1,Introduction a l'Etude du Langage,3,La Morphologie,9,283,8,QCU,0.67,0.29,11.64,9,71,80,63,9,54,1.27,14.29,Difficile,Difficile,0,Meme Difficulté,Pas Adapte,Marketing
1406,2016,Marketing,1,Introduction a l'Etude du Langage,3,La Morphologie,9,283,8,QCU,0.2,0.44,54.49,38,32,70,66,38,28,1.06,57.58,Difficile,Moyen,1,Plus Facile,Pas Adapte,Marketing
2530,2017,Marketing,1,Introduction a l'Etude du Langage,3,La Morphologie,9,283,8,QCU,0.05,0.91,68.25,46,22,68,57,46,11,1.19,80.7,Difficile,Facile,2,Beaucoup plus Facile,Adapte,Marketing
3654,2018,Marketing,1,Introduction a l'Etude du Langage,3,La Morphologie,9,283,8,QCU,0.15,0.92,68.25,43,20,63,56,43,13,1.12,76.79,Facile,Facile,0,Meme Difficulté,Adapte,Marketing
4778,2019,Marketing,1,Introduction a l'Etude du Langage,3,La Morphologie,9,283,8,QCU,0.1,0.77,68.25,48,23,71,58,48,10,1.22,82.76,Facile,Facile,0,Meme Difficulté,Adapte,Marketing
5902,2020,Marketing,1,Introduction a l'Etude du Langage,3,La Morphologie,9,283,8,QCU,0.02,0.96,68.25,42,20,62,44,42,2,1.41,95.45,Facile,Facile,0,Meme Difficulté,Adapte,Marketing
283,2015,Marketing,1,Introduction a l'Etude du Langage,3,La Morphologie,9,284,9,QO,0.12,0.39,82.7,22,4,26,24,22,2,1.08,91.67,Difficile,Facile,2,Beaucoup plus Facile,Pas Adapte,Marketing
1407,2016,Marketing,1,Introduction a l'Etude du Langage,3,La Morphologie,9,284,9,QROC,0.18,0.73,90.21,24,3,27,25,24,1,1.08,96.0,Moyen,Facile,1,Plus Facile,Pas Adapte,Marketing
2531,2017,Marketing,1,Introduction a l'Etude du Langage,3,La Morphologie,9,284,9,QROC,0.39,0.38,45.47,14,16,30,20,14,6,1.5,70.0,Moyen,Moyen,0,Meme Difficulté,Pas Adapte,Marketing
3655,2018,Marketing,1,Introduction a l'Etude du Langage,3,La Morphologie,9,284,9,QROC,0.49,0.34,38.27,12,19,31,13,12,1,2.38,92.31,Difficile,Moyen,1,Plus Facile,Pas Adapte,Marketing
4779,2019,Marketing,1,Introduction a l'Etude du Langage,3,La Morphologie,9,284,9,QROC,0.3,0.34,37.8,11,17,28,27,11,16,1.04,40.74,Difficile,Moyen,1,Plus Facile,Pas Adapte,Marketing
5903,2020,Marketing,1,Introduction a l'Etude du Langage,3,La Morphologie,9,284,9,QROC,0.26,0.28,62.99,18,11,29,23,18,5,1.26,78.26,Moyen,Moyen,0,Meme Difficulté,Adapte,Marketing
284,2015,Marketing,1,Introduction a l'Etude du Langage,4,La Phonetique,12,285,1,QCM,0.12,0.84,83.29,52,10,62,53,52,1,1.17,98.11,Difficile,Facile,2,Beaucoup plus Facile,Pas Adapte,Marketing
1408,2016,Marketing,1,Introduction a l'Etude du Langage,4,La Phonetique,12,285,1,QCM,0.27,0.43,46.63,26,30,56,38,26,12,1.47,68.42,Facile,Moyen,-1,Plus Difficile,Pas Adapte,Marketing
2532,2017,Marketing,1,Introduction a l'Etude du Langage,4,La Phonetique,12,285,1,QCM,0.31,0.4,44.99,25,30,55,25,25,0,2.2,100.0,Difficile,Moyen,1,Plus Facile,Pas Adapte,Marketing
3656,2018,Marketing,1,Introduction a l'Etude du Langage,4,La Phonetique,12,285,1,QCM,0.71,0.17,3.47,2,49,51,33,2,31,1.55,6.06,Difficile,Difficile,0,Meme Difficulté,Pas Adapte,Marketing
4780,2019,Marketing,1,Introduction a l'Etude du Langage,4,La Phonetique,12,285,1,QCM,0.53,0.28,1.29,1,58,59,48,1,47,1.23,2.08,Moyen,Difficile,-1,Plus Difficile,Pas Adapte,Marketing
5904,2020,Marketing,1,Introduction a l'Etude du Langage,4,La Phonetique,12,285,1,QCM,0.4,0.64,55.2,38,30,68,64,38,26,1.06,59.38,Moyen,Moyen,0,Meme Difficulté,Pas Adapte,Marketing
285,2015,Marketing,1,Introduction a l'Etude du Langage,4,La Phonetique,12,286,2,QROC,0.48,0.36,37.46,14,24,38,29,14,15,1.31,48.28,Difficile,Moyen,1,Plus Facile,Pas Adapte,Marketing
1409,2016,Marketing,1,Introduction a l'Etude du Langage,4,La Phonetique,12,286,2,QROC,0.11,0.89,87.24,38,5,43,39,38,1,1.1,97.44,Facile,Facile,0,Meme Difficulté,Pas Adapte,Marketing
2533,2017,Marketing,1,Introduction a l'Etude du Langage,4,La Phonetique,12,286,2,QROC,0.49,0.28,56.29,25,19,44,26,25,1,1.69,96.15,Facile,Moyen,-1,Plus Difficile,Pas Adapte,Marketing
3657,2018,Marketing,1,Introduction a l'Etude du Langage,4,La Phonetique,12,286,2,QROC,0.92,0.07,0.23,0,45,45,43,0,43,1.05,0.0,Moyen,Difficile,-1,Plus Difficile,Pas Adapte,Marketing
4781,2019,Marketing,1,Introduction a l'Etude du Langage,4,La Phonetique,12,286,2,QROC,0.03,0.63,73.08,36,13,49,39,36,3,1.26,92.31,Difficile,Facile,2,Beaucoup plus Facile,Adapte,Marketing
5905,2020,Marketing,1,Introduction a l'Etude du Langage,4,La Phonetique,12,286,2,QROC,0.13,0.81,73.08,37,14,51,47,37,10,1.09,78.72,Facile,Facile,0,Meme Difficulté,Adapte,Marketing
286,2015,Marketing,1,Introduction a l'Etude du Langage,4,La Phonetique,12,287,3,QROC,0.1,0.97,69.79,27,12,39,36,27,9,1.08,75.0,Difficile,Facile,2,Beaucoup plus Facile,Adapte,Marketing
1410,2016,Marketing,1,Introduction a l'Etude du Langage,4,La Phonetique,12,287,3,QROC,0.16,0.83,69.79,27,11,38,32,27,5,1.19,84.38,Facile,Facile,0,Meme Difficulté,Adapte,Marketing
2534,2017,Marketing,1,Introduction a l'Etude du Langage,4,La Phonetique,12,287,3,QROC,0.14,0.63,69.79,28,12,40,31,28,3,1.29,90.32,Facile,Facile,0,Meme Difficulté,Adapte,Marketing
3658,2018,Marketing,1,Introduction a l'Etude du Langage,4,La Phonetique,12,287,3,QO,0.12,0.5,69.79,25,11,36,32,25,7,1.12,78.12,Facile,Facile,0,Meme Difficulté,Adapte,Marketing
4782,2019,Marketing,1,Introduction a l'Etude du Langage,4,La Phonetique,12,287,3,QO,0.19,0.36,69.79,24,11,35,33,24,9,1.06,72.73,Facile,Facile,0,Meme Difficulté,Adapte,Marketing
5906,2020,Marketing,1,Introduction a l'Etude du Langage,4,La Phonetique,12,287,3,QO,0.07,0.77,69.79,23,10,33,23,23,0,1.43,100.0,Facile,Facile,0,Meme Difficulté,Adapte,Marketing
287,2015,Marketing,1,Introduction a l'Etude du Langage,4,La Phonetique,12,288,4,QCM,0.24,0.53,54.95,21,18,39,24,21,3,1.62,87.5,Difficile,Moyen,1,Plus Facile,Pas Adapte,Marketing
1411,2016,Marketing,1,Introduction a l'Etude du Langage,4,La Phonetique,12,288,4,QCM,0.38,0.59,48.76,18,19,37,20,18,2,1.85,90.0,Facile,Moyen,-1,Plus Difficile,Pas Adapte,Marketing
2535,2017,Marketing,1,Introduction a l'Etude du Langage,4,La Phonetique,12,288,4,QCM,0.46,0.56,61.0,20,13,33,30,20,10,1.1,66.67,Moyen,Moyen,0,Meme Difficulté,Adapte,Marketing
3659,2018,Marketing,1,Introduction a l'Etude du Langage,4,La Phonetique,12,288,4,QCM,0.32,0.4,61.0,23,14,37,36,23,13,1.03,63.89,Moyen,Moyen,0,Meme Difficulté,Adapte,Marketing
4783,2019,Marketing,1,Introduction a l'Etude du Langage,4,La Phonetique,12,288,4,QCM,0.44,0.4,61.0,21,13,34,22,21,1,1.55,95.45,Moyen,Moyen,0,Meme Difficulté,Adapte,Marketing
5907,2020,Marketing,1,Introduction a l'Etude du Langage,4,La Phonetique,12,288,4,QCM,0.22,0.44,61.0,18,11,29,21,18,3,1.38,85.71,Moyen,Moyen,0,Meme Difficulté,Adapte,Marketing
288,2015,Marketing,1,Introduction a l'Etude du Langage,4,La Phonetique,12,289,5,QCM,0.05,0.78,89.17,73,9,82,79,73,6,1.04,92.41,Difficile,Facile,2,Beaucoup plus Facile,Pas Adapte,Marketing
1412,2016,Marketing,1,Introduction a l'Etude du Langage,4,La Phonetique,12,289,5,QCM,0.35,0.5,42.37,32,43,75,65,32,33,1.15,49.23,Facile,Moyen,-1,Plus Difficile,Pas Adapte,Marketing
2536,2017,Marketing,1,Introduction a l'Etude du Langage,4,La Phonetique,12,289,5,QROC,0.01,0.9,87.89,73,10,83,78,73,5,1.06,93.59,Facile,Facile,0,Meme Difficulté,Pas Adapte,Marketing
3660,2018,Marketing,1,Introduction a l'Etude du Langage,4,La Phonetique,12,289,5,QO,0.95,0.12,7.1,6,81,87,62,6,56,1.4,9.68,Moyen,Difficile,-1,Plus Difficile,Pas Adapte,Marketing
4784,2019,Marketing,1,Introduction a l'Etude du Langage,4,La Phonetique,12,289,5,QO,0.97,0.01,29.59,27,64,91,57,27,30,1.6,47.37,Difficile,Difficile,0,Meme Difficulté,Pas Adapte,Marketing
5908,2020,Marketing,1,Introduction a l'Etude du Langage,4,La Phonetique,12,289,5,QO,0.33,0.2,38.04,40,65,105,55,40,15,1.91,72.73,Facile,Moyen,-1,Plus Difficile,Pas Adapte,Marketing
289,2015,Marketing,1,Introduction a l'Etude du Langage,4,La Phonetique,12,290,6,QO,0.2,0.96,97.15,27,1,28,28,27,1,1.0,96.43,Facile,Facile,0,Meme Difficulté,Pas Adapte,Marketing
1413,2016,Marketing,1,Introduction a l'Etude du Langage,4,La Phonetique,12,290,6,QO,0.04,0.35,76.88,22,6,28,28,22,6,1.0,78.57,Facile,Facile,0,Meme Difficulté,Pas Adapte,Marketing
2537,2017,Marketing,1,Introduction a l'Etude du Langage,4,La Phonetique,12,290,6,QO,0.32,0.21,55.16,14,12,26,20,14,6,1.3,70.0,Moyen,Moyen,0,Meme Difficulté,Pas Adapte,Marketing
3661,2018,Marketing,1,Introduction a l'Etude du Langage,4,La Phonetique,12,290,6,QO,0.22,0.16,38.57,9,14,23,12,9,3,1.92,75.0,Moyen,Moyen,0,Meme Difficulté,Pas Adapte,Marketing
4785,2019,Marketing,1,Introduction a l'Etude du Langage,4,La Phonetique,12,290,6,QROC,0.03,0.85,70.34,16,7,23,20,16,4,1.15,80.0,Facile,Facile,0,Meme Difficulté,Adapte,Marketing
5909,2020,Marketing,1,Introduction a l'Etude du Langage,4,La Phonetique,12,290,6,QO,0.04,0.97,70.34,15,6,21,18,15,3,1.17,83.33,Facile,Facile,0,Meme Difficulté,Adapte,Marketing
290,2015,Marketing,1,Introduction a l'Etude du Langage,4,La Phonetique,12,291,7,QCU,0.1,0.91,94.46,89,5,94,91,89,2,1.03,97.8,Difficile,Facile,2,Beaucoup plus Facile,Pas Adapte,Marketing
1414,2016,Marketing,1,Introduction a l'Etude du Langage,4,La Phonetique,12,291,7,QCU,0.21,0.52,54.12,57,49,106,64,57,7,1.66,89.06,Facile,Moyen,-1,Plus Difficile,Pas Adapte,Marketing
2538,2017,Marketing,1,Introduction a l'Etude du Langage,4,La Phonetique,12,291,7,QCU,0.08,0.82,83.88,87,17,104,94,87,7,1.11,92.55,Facile,Facile,0,Meme Difficulté,Pas Adapte,Marketing
3662,2018,Marketing,1,Introduction a l'Etude du Langage,4,La Phonetique,12,291,7,QCU,0.17,0.76,66.84,70,34,104,77,70,7,1.35,90.91,Difficile,Facile,2,Beaucoup plus Facile,Adapte,Marketing
4786,2019,Marketing,1,Introduction a l'Etude du Langage,4,La Phonetique,12,291,7,QCU,0.06,0.92,66.84,66,32,98,68,66,2,1.44,97.06,Facile,Facile,0,Meme Difficulté,Adapte,Marketing
5910,2020,Marketing,1,Introduction a l'Etude du Langage,4,La Phonetique,12,291,7,QCU,0.09,0.98,66.84,60,30,90,81,60,21,1.11,74.07,Facile,Facile,0,Meme Difficulté,Adapte,Marketing
291,2015,Marketing,1,Introduction a l'Etude du Langage,4,La Phonetique,12,292,8,QCU,0.44,0.4,24.35,4,14,18,18,4,14,1.0,22.22,Facile,Difficile,-2,Beaucoup plus Difficile,Pas Adapte,Marketing
1415,2016,Marketing,1,Introduction a l'Etude du Langage,4,La Phonetique,12,292,8,QCU,0.15,0.75,88.07,18,3,21,18,18,0,1.17,100.0,Moyen,Facile,1,Plus Facile,Pas Adapte,Marketing
2539,2017,Marketing,1,Introduction a l'Etude du Langage,4,La Phonetique,12,292,8,QCU,0.26,0.63,45.72,11,13,24,21,11,10,1.14,52.38,Facile,Moyen,-1,Plus Difficile,Pas Adapte,Marketing
3663,2018,Marketing,1,Introduction a l'Etude du Langage,4,La Phonetique,12,292,8,QCU,0.29,0.75,54.56,15,12,27,27,15,12,1.0,55.56,Difficile,Moyen,1,Plus Facile,Pas Adapte,Marketing
4787,2019,Marketing,1,Introduction a l'Etude du Langage,4,La Phonetique,12,292,8,QCU,0.46,0.23,24.63,8,23,31,27,8,19,1.15,29.63,Difficile,Difficile,0,Meme Difficulté,Pas Adapte,Marketing
5911,2020,Marketing,1,Introduction a l'Etude du Langage,4,La Phonetique,12,292,8,QCU,0.67,0.29,6.49,2,34,36,20,2,18,1.8,10.0,Difficile,Difficile,0,Meme Difficulté,Pas Adapte,Marketing
292,2015,Marketing,1,Introduction a l'Etude du Langage,4,La Phonetique,12,293,9,QCU,0.44,0.23,26.1,3,7,10,6,3,3,1.67,50.0,Facile,Difficile,-2,Beaucoup plus Difficile,Pas Adapte,Marketing
1416,2016,Marketing,1,Introduction a l'Etude du Langage,4,La Phonetique,12,293,9,QCU,0.02,0.94,89.87,7,1,8,7,7,0,1.14,100.0,Difficile,Facile,2,Beaucoup plus Facile,Pas Adapte,Marketing
2540,2017,Marketing,1,Introduction a l'Etude du Langage,4,La Phonetique,12,293,9,QROC,0.18,0.89,92.54,8,1,9,8,8,0,1.12,100.0,Facile,Facile,0,Meme Difficulté,Pas Adapte,Marketing
3664,2018,Marketing,1,Introduction a l'Etude du Langage,4,La Phonetique,12,293,9,QROC,0.11,0.79,65.94,6,3,9,9,6,3,1.0,66.67,Difficile,Facile,2,Beaucoup plus Facile,Adapte,Marketing
4788,2019,Marketing,1,Introduction a l'Etude du Langage,4,La Phonetique,12,293,9,QROC,0.1,0.89,65.94,7,3,10,10,7,3,1.0,70.0,Facile,Facile,0,Meme Difficulté,Adapte,Marketing
5912,2020,Marketing,1,Introduction a l'Etude du Langage,4,La Phonetique,12,293,9,QROC,0.15,0.98,65.94,5,3,8,6,5,1,1.33,83.33,Facile,Facile,0,Meme Difficulté,Adapte,Marketing
293,2015,Marketing,1,Introduction a l'Etude du Langage,4,La Phonetique,12,294,10,QCM,0.16,0.71,73.95,72,26,98,77,72,5,1.27,93.51,Moyen,Facile,1,Plus Facile,Adapte,Marketing
1417,2016,Marketing,1,Introduction a l'Etude du Langage,4,La Phonetique,12,294,10,QCU,0.07,0.76,73.95,65,23,88,67,65,2,1.31,97.01,Facile,Facile,0,Meme Difficulté,Adapte,Marketing
2541,2017,Marketing,1,Introduction a l'Etude du Langage,4,La Phonetique,12,294,10,QCU,0.1,0.96,73.95,67,24,91,87,67,20,1.05,77.01,Facile,Facile,0,Meme Difficulté,Adapte,Marketing
3665,2018,Marketing,1,Introduction a l'Etude du Langage,4,La Phonetique,12,294,10,QCU,0.08,0.83,73.95,69,24,93,87,69,18,1.07,79.31,Facile,Facile,0,Meme Difficulté,Adapte,Marketing
4789,2019,Marketing,1,Introduction a l'Etude du Langage,4,La Phonetique,12,294,10,QCU,0.11,0.96,73.95,76,27,103,88,76,12,1.17,86.36,Facile,Facile,0,Meme Difficulté,Adapte,Marketing
5913,2020,Marketing,1,Introduction a l'Etude du Langage,4,La Phonetique,12,294,10,QCU,0.04,0.76,73.95,68,24,92,83,68,15,1.11,81.93,Facile,Facile,0,Meme Difficulté,Adapte,Marketing
294,2015,Marketing,1,Introduction a l'Etude du Langage,4,La Phonetique,12,295,11,QO,0.16,0.82,75.72,20,7,27,24,20,4,1.12,83.33,Facile,Facile,0,Meme Difficulté,Pas Adapte,Marketing
1418,2016,Marketing,1,Introduction a l'Etude du Langage,4,La Phonetique,12,295,11,QO,0.73,0.21,52.19,13,11,24,16,13,3,1.5,81.25,Facile,Moyen,-1,Plus Difficile,Pas Adapte,Marketing
2542,2017,Marketing,1,Introduction a l'Etude du Langage,4,La Phonetique,12,295,11,QO,0.41,0.29,59.99,17,11,28,23,17,6,1.22,73.91,Moyen,Moyen,0,Meme Difficulté,Pas Adapte,Marketing
3666,2018,Marketing,1,Introduction a l'Etude du Langage,4,La Phonetique,12,295,11,QO,0.82,0.08,23.44,6,19,25,24,6,18,1.04,25.0,Difficile,Difficile,0,Meme Difficulté,Pas Adapte,Marketing
4790,2019,Marketing,1,Introduction a l'Etude du Langage,4,La Phonetique,12,295,11,QO,0.91,0.14,23.93,6,17,23,19,6,13,1.21,31.58,Facile,Difficile,-2,Beaucoup plus Difficile,Pas Adapte,Marketing
5914,2020,Marketing,1,Introduction a l'Etude du Langage,4,La Phonetique,12,295,11,QO,0.38,0.28,42.9,10,14,24,19,10,9,1.26,52.63,Difficile,Moyen,1,Plus Facile,Pas Adapte,Marketing
295,2015,Marketing,1,Introduction a l'Etude du Langage,4,La Phonetique,12,296,12,QCM,0.29,0.37,61.1,48,30,78,75,48,27,1.04,64.0,Facile,Moyen,-1,Plus Difficile,Adapte,Marketing
1419,2016,Marketing,1,Introduction a l'Etude du Langage,4,La Phonetique,12,296,12,QCU,0.4,0.52,61.1,55,35,90,70,55,15,1.29,78.57,Moyen,Moyen,0,Meme Difficulté,Adapte,Marketing
2543,2017,Marketing,1,Introduction a l'Etude du Langage,4,La Phonetique,12,296,12,QCM,0.46,0.47,61.1,50,32,82,51,50,1,1.61,98.04,Moyen,Moyen,0,Meme Difficulté,Adapte,Marketing
3667,2018,Marketing,1,Introduction a l'Etude du Langage,4,La Phonetique,12,296,12,QCM,0.49,0.58,61.1,47,30,77,49,47,2,1.57,95.92,Moyen,Moyen,0,Meme Difficulté,Adapte,Marketing
4791,2019,Marketing,1,Introduction a l'Etude du Langage,4,La Phonetique,12,296,12,QCM,0.25,0.47,61.1,43,27,70,55,43,12,1.27,78.18,Moyen,Moyen,0,Meme Difficulté,Adapte,Marketing
5915,2020,Marketing,1,Introduction a l'Etude du Langage,4,La Phonetique,12,296,12,QCM,0.23,0.52,61.1,45,29,74,51,45,6,1.45,88.24,Moyen,Moyen,0,Meme Difficulté,Adapte,Marketing
296,2015,Marketing,1,Introduction a l'Etude du Langage,5,La Phonologie,3,297,1,QCU,0.28,0.67,41.61,12,16,28,27,12,15,1.04,44.44,Difficile,Moyen,1,Plus Facile,Pas Adapte,Marketing
1420,2016,Marketing,1,Introduction a l'Etude du Langage,5,La Phonologie,3,297,1,QCU,0.65,0.35,10.95,3,26,29,24,3,21,1.21,12.5,Moyen,Difficile,-1,Plus Difficile,Pas Adapte,Marketing
2544,2017,Marketing,1,Introduction a l'Etude du Langage,5,La Phonologie,3,297,1,QCU,0.69,0.37,22.09,6,20,26,11,6,5,2.36,54.55,Facile,Difficile,-2,Beaucoup plus Difficile,Pas Adapte,Marketing
3668,2018,Marketing,1,Introduction a l'Etude du Langage,5,La Phonologie,3,297,1,QCU,0.12,0.93,82.9,21,4,25,24,21,3,1.04,87.5,Moyen,Facile,1,Plus Facile,Pas Adapte,Marketing
4792,2019,Marketing,1,Introduction a l'Etude du Langage,5,La Phonologie,3,297,1,QCU,0.13,0.88,86.94,24,4,28,25,24,1,1.12,96.0,Facile,Facile,0,Meme Difficulté,Pas Adapte,Marketing
5916,2020,Marketing,1,Introduction a l'Etude du Langage,5,La Phonologie,3,297,1,QCU,0.09,0.86,87.54,21,3,24,21,21,0,1.14,100.0,Facile,Facile,0,Meme Difficulté,Pas Adapte,Marketing
297,2015,Marketing,1,Introduction a l'Etude du Langage,5,La Phonologie,3,298,2,QCM,0.04,0.79,68.53,46,21,67,58,46,12,1.16,79.31,Difficile,Facile,2,Beaucoup plus Facile,Adapte,Marketing
1421,2016,Marketing,1,Introduction a l'Etude du Langage,5,La Phonologie,3,298,2,QCM,0.15,0.76,68.53,40,18,58,56,40,16,1.04,71.43,Facile,Facile,0,Meme Difficulté,Adapte,Marketing
2545,2017,Marketing,1,Introduction a l'Etude du Langage,5,La Phonologie,3,298,2,QCM,0.07,0.74,68.53,36,17,53,36,36,0,1.47,100.0,Facile,Facile,0,Meme Difficulté,Adapte,Marketing
3669,2018,Marketing,1,Introduction a l'Etude du Langage,5,La Phonologie,3,298,2,QCM,0.08,0.9,68.53,31,14,45,38,31,7,1.18,81.58,Facile,Facile,0,Meme Difficulté,Adapte,Marketing
4793,2019,Marketing,1,Introduction a l'Etude du Langage,5,La Phonologie,3,298,2,QCM,0.1,0.89,68.53,34,16,50,44,34,10,1.14,77.27,Facile,Facile,0,Meme Difficulté,Adapte,Marketing
5917,2020,Marketing,1,Introduction a l'Etude du Langage,5,La Phonologie,3,298,2,QCM,0.15,0.99,68.53,29,14,43,37,29,8,1.16,78.38,Facile,Facile,0,Meme Difficulté,Adapte,Marketing
298,2015,Marketing,1,Introduction a l'Etude du Langage,5,La Phonologie,3,299,3,QROC,0.12,0.53,95.91,17,1,18,17,17,0,1.06,100.0,Facile,Facile,0,Meme Difficulté,Pas Adapte,Marketing
1422,2016,Marketing,1,Introduction a l'Etude du Langage,5,La Phonologie,3,299,3,QROC,0.71,0.09,32.38,5,11,16,15,5,10,1.07,33.33,Facile,Difficile,-2,Beaucoup plus Difficile,Pas Adapte,Marketing
2546,2017,Marketing,1,Introduction a l'Etude du Langage,5,La Phonologie,3,299,3,QROC,0.91,0.18,7.83,1,14,15,15,1,14,1.0,6.67,Facile,Difficile,-2,Beaucoup plus Difficile,Pas Adapte,Marketing
3670,2018,Marketing,1,Introduction a l'Etude du Langage,5,La Phonologie,3,299,3,QROC,0.59,0.31,57.18,7,6,13,13,7,6,1.0,53.85,Difficile,Moyen,1,Plus Facile,Pas Adapte,Marketing
4794,2019,Marketing,1,Introduction a l'Etude du Langage,5,La Phonologie,3,299,3,QROC,0.76,0.09,26.4,4,10,14,7,4,3,2.0,57.14,Difficile,Difficile,0,Meme Difficulté,Pas Adapte,Marketing
5918,2020,Marketing,1,Introduction a l'Etude du Langage,5,La Phonologie,3,299,3,QO,0.93,0.11,26.01,4,12,16,15,4,11,1.07,26.67,Difficile,Difficile,0,Meme Difficulté,Pas Adapte,Marketing
299,2015,Marketing,1,Introduction a l'Etude du Langage,6,La Syntaxe,11,300,1,QROC,0.93,0.13,33.29,4,8,12,6,4,2,2.0,66.67,Moyen,Difficile,-1,Plus Difficile,Pas Adapte,Marketing
1423,2016,Marketing,1,Introduction a l'Etude du Langage,6,La Syntaxe,11,300,1,QROC,0.91,0.21,14.49,2,11,13,11,2,9,1.18,18.18,Facile,Difficile,-2,Beaucoup plus Difficile,Pas Adapte,Marketing
2547,2017,Marketing,1,Introduction a l'Etude du Langage,6,La Syntaxe,11,300,1,QROC,0.24,0.39,60.99,8,5,13,8,8,0,1.62,100.0,Facile,Moyen,-1,Plus Difficile,Adapte,Marketing
3671,2018,Marketing,1,Introduction a l'Etude du Langage,6,La Syntaxe,11,300,1,QROC,0.23,0.34,60.99,9,6,15,13,9,4,1.15,69.23,Moyen,Moyen,0,Meme Difficulté,Adapte,Marketing
4795,2019,Marketing,1,Introduction a l'Etude du Langage,6,La Syntaxe,11,300,1,QROC,0.47,0.25,60.99,10,7,17,15,10,5,1.13,66.67,Moyen,Moyen,0,Meme Difficulté,Adapte,Marketing
5919,2020,Marketing,1,Introduction a l'Etude du Langage,6,La Syntaxe,11,300,1,QROC,0.39,0.38,60.99,10,7,17,15,10,5,1.13,66.67,Moyen,Moyen,0,Meme Difficulté,Adapte,Marketing
300,2015,Marketing,1,Introduction a l'Etude du Langage,6,La Syntaxe,11,301,2,QCU,0.72,0.34,8.91,3,34,37,21,3,18,1.76,14.29,Facile,Difficile,-2,Beaucoup plus Difficile,Pas Adapte,Marketing
1424,2016,Marketing,1,Introduction a l'Etude du Langage,6,La Syntaxe,11,301,2,QCU,0.55,0.37,34.18,14,27,41,37,14,23,1.11,37.84,Moyen,Difficile,-1,Plus Difficile,Pas Adapte,Marketing
2548,2017,Marketing,1,Introduction a l'Etude du Langage,6,La Syntaxe,11,301,2,QCU,0.18,0.85,85.04,34,6,40,37,34,3,1.08,91.89,Moyen,Facile,1,Plus Facile,Pas Adapte,Marketing
3672,2018,Marketing,1,Introduction a l'Etude du Langage,6,La Syntaxe,11,301,2,QCU,0.47,0.23,12.78,5,31,36,15,5,10,2.4,33.33,Moyen,Difficile,-1,Plus Difficile,Pas Adapte,Marketing
4796,2019,Marketing,1,Introduction a l'Etude du Langage,6,La Syntaxe,11,301,2,QCU,0.2,0.91,81.88,29,7,36,34,29,5,1.06,85.29,Facile,Facile,0,Meme Difficulté,Pas Adapte,Marketing
5920,2020,Marketing,1,Introduction a l'Etude du Langage,6,La Syntaxe,11,301,2,QCU,0.46,0.37,12.97,5,34,39,35,5,30,1.11,14.29,Facile,Difficile,-2,Beaucoup plus Difficile,Pas Adapte,Marketing
301,2015,Marketing,1,Introduction a l'Etude du Langage,6,La Syntaxe,11,302,3,QCM,0.22,0.58,63.2,16,10,26,23,16,7,1.13,69.57,Facile,Moyen,-1,Plus Difficile,Adapte,Marketing
1425,2016,Marketing,1,Introduction a l'Etude du Langage,6,La Syntaxe,11,302,3,QCU,0.26,0.55,63.2,14,8,22,22,14,8,1.0,63.64,Moyen,Moyen,0,Meme Difficulté,Adapte,Marketing
2549,2017,Marketing,1,Introduction a l'Etude du Langage,6,La Syntaxe,11,302,3,QCU,0.22,0.66,63.2,16,9,25,24,16,8,1.04,66.67,Moyen,Moyen,0,Meme Difficulté,Adapte,Marketing
3673,2018,Marketing,1,Introduction a l'Etude du Langage,6,La Syntaxe,11,302,3,QCU,0.38,0.4,63.2,14,8,22,21,14,7,1.05,66.67,Moyen,Moyen,0,Meme Difficulté,Adapte,Marketing
4797,2019,Marketing,1,Introduction a l'Etude du Langage,6,La Syntaxe,11,302,3,QCU,0.2,0.69,63.2,14,8,22,21,14,7,1.05,66.67,Moyen,Moyen,0,Meme Difficulté,Adapte,Marketing
5921,2020,Marketing,1,Introduction a l'Etude du Langage,6,La Syntaxe,11,302,3,QCU,0.29,0.65,63.2,16,9,25,18,16,2,1.39,88.89,Moyen,Moyen,0,Meme Difficulté,Adapte,Marketing
302,2015,Marketing,1,Introduction a l'Etude du Langage,6,La Syntaxe,11,303,4,QCM,0.64,0.19,21.16,9,33,42,24,9,15,1.75,37.5,Difficile,Difficile,0,Meme Difficulté,Pas Adapte,Marketing
1426,2016,Marketing,1,Introduction a l'Etude du Langage,6,La Syntaxe,11,303,4,QCM,0.19,0.78,97.99,37,1,38,37,37,0,1.03,100.0,Difficile,Facile,2,Beaucoup plus Facile,Pas Adapte,Marketing
2550,2017,Marketing,1,Introduction a l'Etude du Langage,6,La Syntaxe,11,303,4,QCU,0.39,0.41,45.55,20,24,44,25,20,5,1.76,80.0,Facile,Moyen,-1,Plus Difficile,Pas Adapte,Marketing
3674,2018,Marketing,1,Introduction a l'Etude du Langage,6,La Syntaxe,11,303,4,QCM,0.54,0.21,31.46,12,26,38,35,12,23,1.09,34.29,Difficile,Difficile,0,Meme Difficulté,Pas Adapte,Marketing
4798,2019,Marketing,1,Introduction a l'Etude du Langage,6,La Syntaxe,11,303,4,QROC,0.15,0.59,88.85,37,5,42,39,37,2,1.08,94.87,Facile,Facile,0,Meme Difficulté,Pas Adapte,Marketing
5922,2020,Marketing,1,Introduction a l'Etude du Langage,6,La Syntaxe,11,303,4,QROC,0.09,0.69,73.37,32,11,43,42,32,10,1.02,76.19,Facile,Facile,0,Meme Difficulté,Adapte,Marketing
303,2015,Marketing,1,Introduction a l'Etude du Langage,6,La Syntaxe,11,304,5,QCM,0.66,0.2,15.72,2,9,11,9,2,7,1.22,22.22,Moyen,Difficile,-1,Plus Difficile,Pas Adapte,Marketing
1427,2016,Marketing,1,Introduction a l'Etude du Langage,6,La Syntaxe,11,304,5,QCM,0.16,0.86,90.19,8,1,9,8,8,0,1.12,100.0,Moyen,Facile,1,Plus Facile,Pas Adapte,Marketing
2551,2017,Marketing,1,Introduction a l'Etude du Langage,6,La Syntaxe,11,304,5,QCM,0.48,0.41,50.22,4,4,8,4,4,0,2.0,100.0,Facile,Moyen,-1,Plus Difficile,Pas Adapte,Marketing
3675,2018,Marketing,1,Introduction a l'Etude du Langage,6,La Syntaxe,11,304,5,QCM,0.31,0.46,60.25,4,3,7,4,4,0,1.75,100.0,Facile,Moyen,-1,Plus Difficile,Adapte,Marketing
4799,2019,Marketing,1,Introduction a l'Etude du Langage,6,La Syntaxe,11,304,5,QCU,0.2,0.72,60.25,4,2,6,5,4,1,1.2,80.0,Moyen,Moyen,0,Meme Difficulté,Adapte,Marketing
5923,2020,Marketing,1,Introduction a l'Etude du Langage,6,La Syntaxe,11,304,5,QCM,0.46,0.64,60.25,4,2,6,6,4,2,1.0,66.67,Moyen,Moyen,0,Meme Difficulté,Adapte,Marketing
304,2015,Marketing,1,Introduction a l'Etude du Langage,6,La Syntaxe,11,305,6,QCM,0.53,0.16,14.98,12,67,79,46,12,34,1.72,26.09,Facile,Difficile,-2,Beaucoup plus Difficile,Pas Adapte,Marketing
1428,2016,Marketing,1,Introduction a l'Etude du Langage,6,La Syntaxe,11,305,6,QCM,0.26,0.4,42.72,38,52,90,74,38,36,1.22,51.35,Facile,Moyen,-1,Plus Difficile,Pas Adapte,Marketing
2552,2017,Marketing,1,Introduction a l'Etude du Langage,6,La Syntaxe,11,305,6,QCM,0.53,0.27,0.85,1,94,95,75,1,74,1.27,1.33,Moyen,Difficile,-1,Plus Difficile,Pas Adapte,Marketing
3676,2018,Marketing,1,Introduction a l'Etude du Langage,6,La Syntaxe,11,305,6,QCM,0.55,0.26,16.84,18,89,107,61,18,43,1.75,29.51,Moyen,Difficile,-1,Plus Difficile,Pas Adapte,Marketing
4800,2019,Marketing,1,Introduction a l'Etude du Langage,6,La Syntaxe,11,305,6,QCM,0.79,0.25,21.8,21,77,98,90,21,69,1.09,23.33,Facile,Difficile,-2,Beaucoup plus Difficile,Pas Adapte,Marketing
5924,2020,Marketing,1,Introduction a l'Etude du Langage,6,La Syntaxe,11,305,6,QCM,0.02,0.95,75.41,76,25,101,99,76,23,1.02,76.77,Difficile,Facile,2,Beaucoup plus Facile,Pas Adapte,Marketing
305,2015,Marketing,1,Introduction a l'Etude du Langage,6,La Syntaxe,11,306,7,QCM,0.67,0.25,8.24,1,10,11,8,1,7,1.38,12.5,Moyen,Difficile,-1,Plus Difficile,Pas Adapte,Marketing
1429,2016,Marketing,1,Introduction a l'Etude du Langage,6,La Syntaxe,11,306,7,QCM,0.16,0.99,76.73,9,3,12,12,9,3,1.0,75.0,Facile,Facile,0,Meme Difficulté,Pas Adapte,Marketing
2553,2017,Marketing,1,Introduction a l'Etude du Langage,6,La Syntaxe,11,306,7,QCM,0.26,0.42,44.39,5,6,11,11,5,6,1.0,45.45,Difficile,Moyen,1,Plus Facile,Pas Adapte,Marketing
3677,2018,Marketing,1,Introduction a l'Etude du Langage,6,La Syntaxe,11,306,7,QCM,0.65,0.19,16.08,2,9,11,5,2,3,2.2,40.0,Moyen,Difficile,-1,Plus Difficile,Pas Adapte,Marketing
4801,2019,Marketing,1,Introduction a l'Etude du Langage,6,La Syntaxe,11,306,7,QROC,0.58,0.38,36.52,4,8,12,10,4,6,1.2,40.0,Moyen,Moyen,0,Meme Difficulté,Pas Adapte,Marketing
5925,2020,Marketing,1,Introduction a l'Etude du Langage,6,La Syntaxe,11,306,7,QROC,0.37,0.32,54.78,5,5,10,5,5,0,2.0,100.0,Moyen,Moyen,0,Meme Difficulté,Pas Adapte,Marketing
306,2015,Marketing,1,Introduction a l'Etude du Langage,6,La Syntaxe,11,307,8,QCM,0.23,0.4,37.1,32,54,86,38,32,6,2.26,84.21,Facile,Moyen,-1,Plus Difficile,Pas Adapte,Marketing
1430,2016,Marketing,1,Introduction a l'Etude du Langage,6,La Syntaxe,11,307,8,QCM,0.34,0.67,63.52,50,29,79,53,50,3,1.49,94.34,Difficile,Moyen,1,Plus Facile,Adapte,Marketing
2554,2017,Marketing,1,Introduction a l'Etude du Langage,6,La Syntaxe,11,307,8,QCM,0.49,0.68,63.52,46,26,72,57,46,11,1.26,80.7,Moyen,Moyen,0,Meme Difficulté,Adapte,Marketing
3678,2018,Marketing,1,Introduction a l'Etude du Langage,6,La Syntaxe,11,307,8,QCM,0.39,0.31,63.52,43,25,68,52,43,9,1.31,82.69,Moyen,Moyen,0,Meme Difficulté,Adapte,Marketing
4802,2019,Marketing,1,Introduction a l'Etude du Langage,6,La Syntaxe,11,307,8,QCM,0.45,0.37,63.52,39,22,61,54,39,15,1.13,72.22,Moyen,Moyen,0,Meme Difficulté,Adapte,Marketing
5926,2020,Marketing,1,Introduction a l'Etude du Langage,6,La Syntaxe,11,307,8,QCU,0.2,0.55,63.52,34,19,53,37,34,3,1.43,91.89,Moyen,Moyen,0,Meme Difficulté,Adapte,Marketing
307,2015,Marketing,1,Introduction a l'Etude du Langage,6,La Syntaxe,11,308,9,QROC,0.2,0.95,78.44,59,16,75,73,59,14,1.03,80.82,Difficile,Facile,2,Beaucoup plus Facile,Pas Adapte,Marketing
1431,2016,Marketing,1,Introduction a l'Etude du Langage,6,La Syntaxe,11,308,9,QROC,0.44,0.37,64.17,48,27,75,49,48,1,1.53,97.96,Difficile,Moyen,1,Plus Facile,Adapte,Marketing
2555,2017,Marketing,1,Introduction a l'Etude du Langage,6,La Syntaxe,11,308,9,QROC,0.31,0.26,64.17,49,27,76,74,49,25,1.03,66.22,Moyen,Moyen,0,Meme Difficulté,Adapte,Marketing
3679,2018,Marketing,1,Introduction a l'Etude du Langage,6,La Syntaxe,11,308,9,QROC,0.37,0.37,64.17,44,25,69,66,44,22,1.05,66.67,Moyen,Moyen,0,Meme Difficulté,Adapte,Marketing
4803,2019,Marketing,1,Introduction a l'Etude du Langage,6,La Syntaxe,11,308,9,QROC,0.31,0.25,64.17,42,23,65,50,42,8,1.3,84.0,Moyen,Moyen,0,Meme Difficulté,Adapte,Marketing
5927,2020,Marketing,1,Introduction a l'Etude du Langage,6,La Syntaxe,11,308,9,QROC,0.52,0.37,64.17,39,22,61,55,39,16,1.11,70.91,Moyen,Moyen,0,Meme Difficulté,Adapte,Marketing
308,2015,Marketing,1,Introduction a l'Etude du Langage,6,La Syntaxe,11,309,10,QCU,0.12,0.98,76.51,35,11,46,41,35,6,1.12,85.37,Difficile,Facile,2,Beaucoup plus Facile,Pas Adapte,Marketing
1432,2016,Marketing,1,Introduction a l'Etude du Langage,6,La Syntaxe,11,309,10,QROC,0.19,0.64,98.8,51,1,52,52,51,1,1.0,98.08,Difficile,Facile,2,Beaucoup plus Facile,Pas Adapte,Marketing
2556,2017,Marketing,1,Introduction a l'Etude du Langage,6,La Syntaxe,11,309,10,QROC,0.35,0.31,37.9,22,36,58,26,22,4,2.23,84.62,Moyen,Moyen,0,Meme Difficulté,Pas Adapte,Marketing
3680,2018,Marketing,1,Introduction a l'Etude du Langage,6,La Syntaxe,11,309,10,QROC,0.67,0.14,29.47,14,35,49,20,14,6,2.45,70.0,Difficile,Difficile,0,Meme Difficulté,Pas Adapte,Marketing
4804,2019,Marketing,1,Introduction a l'Etude du Langage,6,La Syntaxe,11,309,10,QROC,0.48,0.29,46.82,26,29,55,29,26,3,1.9,89.66,Moyen,Moyen,0,Meme Difficulté,Pas Adapte,Marketing
5928,2020,Marketing,1,Introduction a l'Etude du Langage,6,La Syntaxe,11,309,10,QROC,0.03,0.74,91.37,55,5,60,59,55,4,1.02,93.22,Difficile,Facile,2,Beaucoup plus Facile,Pas Adapte,Marketing
309,2015,Marketing,1,Introduction a l'Etude du Langage,6,La Syntaxe,11,310,11,QCU,0.46,0.31,9.02,7,74,81,76,7,69,1.07,9.21,Moyen,Difficile,-1,Plus Difficile,Pas Adapte,Marketing
1433,2016,Marketing,1,Introduction a l'Etude du Langage,6,La Syntaxe,11,310,11,QCU,0.3,0.45,49.41,40,41,81,71,40,31,1.14,56.34,Difficile,Moyen,1,Plus Facile,Pas Adapte,Marketing
2557,2017,Marketing,1,Introduction a l'Etude du Langage,6,La Syntaxe,11,310,11,QCU,0.35,0.42,41.38,32,46,78,32,32,0,2.44,100.0,Difficile,Moyen,1,Plus Facile,Pas Adapte,Marketing
3681,2018,Marketing,1,Introduction a l'Etude du Langage,6,La Syntaxe,11,310,11,QCM,0.28,0.64,48.69,38,40,78,45,38,7,1.73,84.44,Facile,Moyen,-1,Plus Difficile,Pas Adapte,Marketing
4805,2019,Marketing,1,Introduction a l'Etude du Langage,6,La Syntaxe,11,310,11,QCM,0.26,0.51,63.4,50,29,79,54,50,4,1.46,92.59,Facile,Moyen,-1,Plus Difficile,Adapte,Marketing
5929,2020,Marketing,1,Introduction a l'Etude du Langage,6,La Syntaxe,11,310,11,QCM,0.49,0.41,63.4,43,25,68,60,43,17,1.13,71.67,Moyen,Moyen,0,Meme Difficulté,Adapte,Marketing
310,2015,Marketing,1,Introduction a l'Etude du Langage,7,Le Developpement du Langage,5,311,1,QCM,0.19,0.96,73.79,61,21,82,80,61,19,1.02,76.25,Difficile,Facile,2,Beaucoup plus Facile,Adapte,Marketing
1434,2016,Marketing,1,Introduction a l'Etude du Langage,7,Le Developpement du Langage,5,311,1,QCM,0.12,0.75,73.79,60,21,81,64,60,4,1.27,93.75,Facile,Facile,0,Meme Difficulté,Adapte,Marketing
2558,2017,Marketing,1,Introduction a l'Etude du Langage,7,Le Developpement du Langage,5,311,1,QCM,0.05,0.91,73.79,55,20,75,69,55,14,1.09,79.71,Facile,Facile,0,Meme Difficulté,Adapte,Marketing
3682,2018,Marketing,1,Introduction a l'Etude du Langage,7,Le Developpement du Langage,5,311,1,QCM,0.08,0.72,73.79,63,22,85,72,63,9,1.18,87.5,Facile,Facile,0,Meme Difficulté,Adapte,Marketing
4806,2019,Marketing,1,Introduction a l'Etude du Langage,7,Le Developpement du Langage,5,311,1,QCM,0.12,0.93,73.79,56,20,76,64,56,8,1.19,87.5,Facile,Facile,0,Meme Difficulté,Adapte,Marketing
5930,2020,Marketing,1,Introduction a l'Etude du Langage,7,Le Developpement du Langage,5,311,1,QCM,0.05,0.77,73.79,51,18,69,68,51,17,1.01,75.0,Facile,Facile,0,Meme Difficulté,Adapte,Marketing
311,2015,Marketing,1,Introduction a l'Etude du Langage,7,Le Developpement du Langage,5,312,2,QCM,0.08,0.86,94.35,31,2,33,32,31,1,1.03,96.88,Difficile,Facile,2,Beaucoup plus Facile,Pas Adapte,Marketing
1435,2016,Marketing,1,Introduction a l'Etude du Langage,7,Le Developpement du Langage,5,312,2,QCM,0.79,0.27,2.74,1,32,33,10,1,9,3.3,10.0,Difficile,Difficile,0,Meme Difficulté,Pas Adapte,Marketing
2559,2017,Marketing,1,Introduction a l'Etude du Langage,7,Le Developpement du Langage,5,312,2,QCM,0.05,0.94,98.61,29,0,29,29,29,0,1.0,100.0,Difficile,Facile,2,Beaucoup plus Facile,Pas Adapte,Marketing
3683,2018,Marketing,1,Introduction a l'Etude du Langage,7,Le Developpement du Langage,5,312,2,QCM,0.51,0.24,20.44,6,22,28,27,6,21,1.04,22.22,Facile,Difficile,-2,Beaucoup plus Difficile,Pas Adapte,Marketing
4807,2019,Marketing,1,Introduction a l'Etude du Langage,7,Le Developpement du Langage,5,312,2,QCM,0.51,0.17,34.78,10,19,29,17,10,7,1.71,58.82,Facile,Difficile,-2,Beaucoup plus Difficile,Pas Adapte,Marketing
5931,2020,Marketing,1,Introduction a l'Etude du Langage,7,Le Developpement du Langage,5,312,2,QCM,0.59,0.27,22.69,6,19,25,16,6,10,1.56,37.5,Moyen,Difficile,-1,Plus Difficile,Pas Adapte,Marketing
312,2015,Marketing,1,Introduction a l'Etude du Langage,7,Le Developpement du Langage,5,313,3,QROC,0.15,0.45,72.76,31,12,43,35,31,4,1.23,88.57,Facile,Facile,0,Meme Difficulté,Adapte,Marketing
1436,2016,Marketing,1,Introduction a l'Etude du Langage,7,Le Developpement du Langage,5,313,3,QROC,0.06,0.79,72.76,29,11,40,40,29,11,1.0,72.5,Facile,Facile,0,Meme Difficulté,Adapte,Marketing
2560,2017,Marketing,1,Introduction a l'Etude du Langage,7,Le Developpement du Langage,5,313,3,QROC,0.11,0.72,72.76,31,11,42,33,31,2,1.27,93.94,Facile,Facile,0,Meme Difficulté,Adapte,Marketing
3684,2018,Marketing,1,Introduction a l'Etude du Langage,7,Le Developpement du Langage,5,313,3,QROC,0.07,0.62,72.76,28,11,39,29,28,1,1.34,96.55,Facile,Facile,0,Meme Difficulté,Adapte,Marketing
4808,2019,Marketing,1,Introduction a l'Etude du Langage,7,Le Developpement du Langage,5,313,3,QROC,0.01,0.96,72.76,24,9,33,25,24,1,1.32,96.0,Facile,Facile,0,Meme Difficulté,Adapte,Marketing
5932,2020,Marketing,1,Introduction a l'Etude du Langage,7,Le Developpement du Langage,5,313,3,QROC,0.07,0.41,72.76,27,10,37,37,27,10,1.0,72.97,Facile,Facile,0,Meme Difficulté,Adapte,Marketing
313,2015,Marketing,1,Introduction a l'Etude du Langage,7,Le Developpement du Langage,5,314,4,QCM,0.78,0.23,5.28,5,93,98,48,5,43,2.04,10.42,Facile,Difficile,-2,Beaucoup plus Difficile,Pas Adapte,Marketing
1437,2016,Marketing,1,Introduction a l'Etude du Langage,7,Le Developpement du Langage,5,314,4,QCM,0.74,0.22,27.31,28,75,103,31,28,3,3.32,90.32,Difficile,Difficile,0,Meme Difficulté,Pas Adapte,Marketing
2561,2017,Marketing,1,Introduction a l'Etude du Langage,7,Le Developpement du Langage,5,314,4,QCM,0.37,0.52,51.07,46,44,90,53,46,7,1.7,86.79,Difficile,Moyen,1,Plus Facile,Pas Adapte,Marketing
3685,2018,Marketing,1,Introduction a l'Etude du Langage,7,Le Developpement du Langage,5,314,4,QCM,0.58,0.28,16.39,15,78,93,28,15,13,3.32,53.57,Difficile,Difficile,0,Meme Difficulté,Pas Adapte,Marketing
4809,2019,Marketing,1,Introduction a l'Etude du Langage,7,Le Developpement du Langage,5,314,4,QCU,0.1,0.8,70.84,60,25,85,74,60,14,1.15,81.08,Difficile,Facile,2,Beaucoup plus Facile,Adapte,Marketing
5933,2020,Marketing,1,Introduction a l'Etude du Langage,7,Le Developpement du Langage,5,314,4,QCU,0.03,0.8,70.84,55,22,77,76,55,21,1.01,72.37,Facile,Facile,0,Meme Difficulté,Adapte,Marketing
314,2015,Marketing,1,Introduction a l'Etude du Langage,7,Le Developpement du Langage,5,315,5,QCU,0.17,0.83,68.32,31,14,45,34,31,3,1.32,91.18,Moyen,Facile,1,Plus Facile,Adapte,Marketing
1438,2016,Marketing,1,Introduction a l'Etude du Langage,7,Le Developpement du Langage,5,315,5,QCU,0.16,0.78,68.32,31,15,46,38,31,7,1.21,81.58,Facile,Facile,0,Meme Difficulté,Adapte,Marketing
2562,2017,Marketing,1,Introduction a l'Etude du Langage,7,Le Developpement du Langage,5,315,5,QCU,0.0,0.96,68.32,27,13,40,28,27,1,1.43,96.43,Facile,Facile,0,Meme Difficulté,Adapte,Marketing
3686,2018,Marketing,1,Introduction a l'Etude du Langage,7,Le Developpement du Langage,5,315,5,QCU,0.17,0.77,68.32,26,12,38,35,26,9,1.09,74.29,Facile,Facile,0,Meme Difficulté,Adapte,Marketing
4810,2019,Marketing,1,Introduction a l'Etude du Langage,7,Le Developpement du Langage,5,315,5,QCU,0.13,0.99,68.32,24,11,35,34,24,10,1.03,70.59,Facile,Facile,0,Meme Difficulté,Adapte,Marketing
5934,2020,Marketing,1,Introduction a l'Etude du Langage,7,Le Developpement du Langage,5,315,5,QCU,0.01,0.84,68.32,24,11,35,33,24,9,1.06,72.73,Facile,Facile,0,Meme Difficulté,Adapte,Marketing
315,2015,Marketing,1,Introduction a l'Etude du Langage,8,L'Apprentissage de la Langue Seconde,12,316,1,QCM,0.16,0.82,89.1,72,9,81,74,72,2,1.09,97.3,Facile,Facile,0,Meme Difficulté,Pas Adapte,Marketing
1439,2016,Marketing,1,Introduction a l'Etude du Langage,8,L'Apprentissage de la Langue Seconde,12,316,1,QCM,0.01,0.99,95.12,88,4,92,91,88,3,1.01,96.7,Difficile,Facile,2,Beaucoup plus Facile,Pas Adapte,Marketing
2563,2017,Marketing,1,Introduction a l'Etude du Langage,8,L'Apprentissage de la Langue Seconde,12,316,1,QCM,0.3,0.53,41.43,39,54,93,87,39,48,1.07,44.83,Facile,Moyen,-1,Plus Difficile,Pas Adapte,Marketing
3687,2018,Marketing,1,Introduction a l'Etude du Langage,8,L'Apprentissage de la Langue Seconde,12,316,1,QCM,0.07,0.97,67.99,72,34,106,88,72,16,1.2,81.82,Difficile,Facile,2,Beaucoup plus Facile,Adapte,Marketing
4811,2019,Marketing,1,Introduction a l'Etude du Langage,8,L'Apprentissage de la Langue Seconde,12,316,1,QCM,0.04,0.77,67.99,62,29,91,79,62,17,1.15,78.48,Facile,Facile,0,Meme Difficulté,Adapte,Marketing
5935,2020,Marketing,1,Introduction a l'Etude du Langage,8,L'Apprentissage de la Langue Seconde,12,316,1,QCM,0.13,0.8,67.99,56,26,82,78,56,22,1.05,71.79,Facile,Facile,0,Meme Difficulté,Adapte,Marketing
316,2015,Marketing,1,Introduction a l'Etude du Langage,8,L'Apprentissage de la Langue Seconde,12,317,2,QROC,0.3,0.38,49.33,24,25,49,30,24,6,1.63,80.0,Difficile,Moyen,1,Plus Facile,Pas Adapte,Marketing
1440,2016,Marketing,1,Introduction a l'Etude du Langage,8,L'Apprentissage de la Langue Seconde,12,317,2,QROC,0.88,0.24,9.77,5,50,55,38,5,33,1.45,13.16,Difficile,Difficile,0,Meme Difficulté,Pas Adapte,Marketing
2564,2017,Marketing,1,Introduction a l'Etude du Langage,8,L'Apprentissage de la Langue Seconde,12,317,2,QROC,0.72,0.05,29.9,15,34,49,46,15,31,1.07,32.61,Difficile,Difficile,0,Meme Difficulté,Pas Adapte,Marketing
3688,2018,Marketing,1,Introduction a l'Etude du Langage,8,L'Apprentissage de la Langue Seconde,12,317,2,QROC,0.45,0.35,42.91,18,25,43,33,18,15,1.3,54.55,Facile,Moyen,-1,Plus Difficile,Pas Adapte,Marketing
4812,2019,Marketing,1,Introduction a l'Etude du Langage,8,L'Apprentissage de la Langue Seconde,12,317,2,QROC,0.15,0.95,79.95,32,8,40,36,32,4,1.11,88.89,Difficile,Facile,2,Beaucoup plus Facile,Pas Adapte,Marketing
5936,2020,Marketing,1,Introduction a l'Etude du Langage,8,L'Apprentissage de la Langue Seconde,12,317,2,QROC,0.18,0.57,76.88,32,10,42,33,32,1,1.27,96.97,Difficile,Facile,2,Beaucoup plus Facile,Pas Adapte,Marketing
317,2015,Marketing,1,Introduction a l'Etude du Langage,8,L'Apprentissage de la Langue Seconde,12,318,3,QCU,0.7,0.24,11.17,6,45,51,49,6,43,1.04,12.24,Difficile,Difficile,0,Meme Difficulté,Pas Adapte,Marketing
1441,2016,Marketing,1,Introduction a l'Etude du Langage,8,L'Apprentissage de la Langue Seconde,12,318,3,QCU,0.43,0.4,23.91,13,42,55,53,13,40,1.04,24.53,Facile,Difficile,-2,Beaucoup plus Difficile,Pas Adapte,Marketing
2565,2017,Marketing,1,Introduction a l'Etude du Langage,8,L'Apprentissage de la Langue Seconde,12,318,3,QCU,0.72,0.35,29.58,15,36,51,28,15,13,1.82,53.57,Moyen,Difficile,-1,Plus Difficile,Pas Adapte,Marketing
3689,2018,Marketing,1,Introduction a l'Etude du Langage,8,L'Apprentissage de la Langue Seconde,12,318,3,QCU,0.0,0.9,71.66,42,16,58,55,42,13,1.05,76.36,Difficile,Facile,2,Beaucoup plus Facile,Adapte,Marketing
4813,2019,Marketing,1,Introduction a l'Etude du Langage,8,L'Apprentissage de la Langue Seconde,12,318,3,QO,0.1,0.66,71.66,42,16,58,47,42,5,1.23,89.36,Facile,Facile,0,Meme Difficulté,Adapte,Marketing
5937,2020,Marketing,1,Introduction a l'Etude du Langage,8,L'Apprentissage de la Langue Seconde,12,318,3,QO,0.16,0.73,71.66,42,17,59,58,42,16,1.02,72.41,Facile,Facile,0,Meme Difficulté,Adapte,Marketing
318,2015,Marketing,1,Introduction a l'Etude du Langage,8,L'Apprentissage de la Langue Seconde,12,319,4,QCM,0.03,0.83,91.86,63,6,69,63,63,0,1.1,100.0,Moyen,Facile,1,Plus Facile,Pas Adapte,Marketing
1442,2016,Marketing,1,Introduction a l'Etude du Langage,8,L'Apprentissage de la Langue Seconde,12,319,4,QCM,0.3,0.32,44.84,34,41,75,58,34,24,1.29,58.62,Moyen,Moyen,0,Meme Difficulté,Pas Adapte,Marketing
2566,2017,Marketing,1,Introduction a l'Etude du Langage,8,L'Apprentissage de la Langue Seconde,12,319,4,QCM,0.72,0.28,4.42,3,72,75,29,3,26,2.59,10.34,Moyen,Difficile,-1,Plus Difficile,Pas Adapte,Marketing
3690,2018,Marketing,1,Introduction a l'Etude du Langage,8,L'Apprentissage de la Langue Seconde,12,319,4,QCM,0.35,0.55,43.38,34,44,78,61,34,27,1.28,55.74,Difficile,Moyen,1,Plus Facile,Pas Adapte,Marketing
4814,2019,Marketing,1,Introduction a l'Etude du Langage,8,L'Apprentissage de la Langue Seconde,12,319,4,QCM,0.3,0.43,41.2,35,50,85,71,35,36,1.2,49.3,Moyen,Moyen,0,Meme Difficulté,Pas Adapte,Marketing
5938,2020,Marketing,1,Introduction a l'Etude du Langage,8,L'Apprentissage de la Langue Seconde,12,319,4,QCM,0.33,0.65,51.02,44,42,86,64,44,20,1.34,68.75,Moyen,Moyen,0,Meme Difficulté,Pas Adapte,Marketing
319,2015,Marketing,1,Introduction a l'Etude du Langage,8,L'Apprentissage de la Langue Seconde,12,320,5,QCU,0.39,0.4,47.69,17,18,35,28,17,11,1.25,60.71,Difficile,Moyen,1,Plus Facile,Pas Adapte,Marketing
1443,2016,Marketing,1,Introduction a l'Etude du Langage,8,L'Apprentissage de la Langue Seconde,12,320,5,QCU,0.46,0.37,12.23,5,35,40,27,5,22,1.48,18.52,Difficile,Difficile,0,Meme Difficulté,Pas Adapte,Marketing
2567,2017,Marketing,1,Introduction a l'Etude du Langage,8,L'Apprentissage de la Langue Seconde,12,320,5,QCU,0.24,0.5,58.91,25,18,43,29,25,4,1.48,86.21,Difficile,Moyen,1,Plus Facile,Pas Adapte,Marketing
3691,2018,Marketing,1,Introduction a l'Etude du Langage,8,L'Apprentissage de la Langue Seconde,12,320,5,QCU,0.54,0.34,22.24,11,37,48,39,11,28,1.23,28.21,Moyen,Difficile,-1,Plus Difficile,Pas Adapte,Marketing
4815,2019,Marketing,1,Introduction a l'Etude du Langage,8,L'Apprentissage de la Langue Seconde,12,320,5,QCU,0.13,0.97,90.25,44,5,49,46,44,2,1.07,95.65,Difficile,Facile,2,Beaucoup plus Facile,Pas Adapte,Marketing
5939,2020,Marketing,1,Introduction a l'Etude du Langage,8,L'Apprentissage de la Langue Seconde,12,320,5,QCU,0.61,0.25,9.26,5,44,49,21,5,16,2.33,23.81,Difficile,Difficile,0,Meme Difficulté,Pas Adapte,Marketing
320,2015,Marketing,1,Introduction a l'Etude du Langage,8,L'Apprentissage de la Langue Seconde,12,321,6,QCM,0.03,0.81,71.14,28,11,39,36,28,8,1.08,77.78,Difficile,Facile,2,Beaucoup plus Facile,Adapte,Marketing
1444,2016,Marketing,1,Introduction a l'Etude du Langage,8,L'Apprentissage de la Langue Seconde,12,321,6,QCM,0.08,0.82,71.14,30,12,42,37,30,7,1.14,81.08,Facile,Facile,0,Meme Difficulté,Adapte,Marketing
2568,2017,Marketing,1,Introduction a l'Etude du Langage,8,L'Apprentissage de la Langue Seconde,12,321,6,QCM,0.01,0.79,71.14,28,12,40,32,28,4,1.25,87.5,Facile,Facile,0,Meme Difficulté,Adapte,Marketing
3692,2018,Marketing,1,Introduction a l'Etude du Langage,8,L'Apprentissage de la Langue Seconde,12,321,6,QCM,0.13,0.98,71.14,26,11,37,28,26,2,1.32,92.86,Facile,Facile,0,Meme Difficulté,Adapte,Marketing
4816,2019,Marketing,1,Introduction a l'Etude du Langage,8,L'Apprentissage de la Langue Seconde,12,321,6,QCM,0.12,0.84,71.14,23,9,32,26,23,3,1.23,88.46,Facile,Facile,0,Meme Difficulté,Adapte,Marketing
5940,2020,Marketing,1,Introduction a l'Etude du Langage,8,L'Apprentissage de la Langue Seconde,12,321,6,QCM,0.07,0.97,71.14,22,9,31,29,22,7,1.07,75.86,Facile,Facile,0,Meme Difficulté,Adapte,Marketing
321,2015,Marketing,1,Introduction a l'Etude du Langage,8,L'Apprentissage de la Langue Seconde,12,322,7,QCU,0.32,0.45,58.36,51,36,87,79,51,28,1.1,64.56,Difficile,Moyen,1,Plus Facile,Pas Adapte,Marketing
1445,2016,Marketing,1,Introduction a l'Etude du Langage,8,L'Apprentissage de la Langue Seconde,12,322,7,QCM,0.27,0.35,52.71,39,35,74,57,39,18,1.3,68.42,Difficile,Moyen,1,Plus Facile,Pas Adapte,Marketing
2569,2017,Marketing,1,Introduction a l'Etude du Langage,8,L'Apprentissage de la Langue Seconde,12,322,7,QCU,0.58,0.28,28.45,20,50,70,52,20,32,1.35,38.46,Moyen,Difficile,-1,Plus Difficile,Pas Adapte,Marketing
3693,2018,Marketing,1,Introduction a l'Etude du Langage,8,L'Apprentissage de la Langue Seconde,12,322,7,QCU,0.75,0.32,16.1,12,61,73,30,12,18,2.43,40.0,Facile,Difficile,-2,Beaucoup plus Difficile,Pas Adapte,Marketing
4817,2019,Marketing,1,Introduction a l'Etude du Langage,8,L'Apprentissage de la Langue Seconde,12,322,7,QCU,0.67,0.39,34.3,24,46,70,66,24,42,1.06,36.36,Facile,Difficile,-2,Beaucoup plus Difficile,Pas Adapte,Marketing
5941,2020,Marketing,1,Introduction a l'Etude du Langage,8,L'Apprentissage de la Langue Seconde,12,322,7,QCU,0.3,0.48,48.27,29,31,60,41,29,12,1.46,70.73,Difficile,Moyen,1,Plus Facile,Pas Adapte,Marketing
322,2015,Marketing,1,Introduction a l'Etude du Langage,8,L'Apprentissage de la Langue Seconde,12,323,8,QCU,0.4,0.69,51.24,37,36,73,61,37,24,1.2,60.66,Moyen,Moyen,0,Meme Difficulté,Pas Adapte,Marketing
1446,2016,Marketing,1,Introduction a l'Etude du Langage,8,L'Apprentissage de la Langue Seconde,12,323,8,QCU,0.28,0.65,36.03,23,41,64,41,23,18,1.56,56.1,Difficile,Moyen,1,Plus Facile,Pas Adapte,Marketing
2570,2017,Marketing,1,Introduction a l'Etude du Langage,8,L'Apprentissage de la Langue Seconde,12,323,8,QCU,0.35,0.56,61.69,35,21,56,38,35,3,1.47,92.11,Facile,Moyen,-1,Plus Difficile,Adapte,Marketing
3694,2018,Marketing,1,Introduction a l'Etude du Langage,8,L'Apprentissage de la Langue Seconde,12,323,8,QCM,0.24,0.57,61.69,31,20,51,42,31,11,1.21,73.81,Moyen,Moyen,0,Meme Difficulté,Adapte,Marketing
4818,2019,Marketing,1,Introduction a l'Etude du Langage,8,L'Apprentissage de la Langue Seconde,12,323,8,QCM,0.42,0.51,61.69,35,21,56,52,35,17,1.08,67.31,Moyen,Moyen,0,Meme Difficulté,Adapte,Marketing
5942,2020,Marketing,1,Introduction a l'Etude du Langage,8,L'Apprentissage de la Langue Seconde,12,323,8,QCU,0.4,0.7,61.69,38,24,62,41,38,3,1.51,92.68,Moyen,Moyen,0,Meme Difficulté,Adapte,Marketing
323,2015,Marketing,1,Introduction a l'Etude du Langage,8,L'Apprentissage de la Langue Seconde,12,324,9,QCU,0.43,0.27,6.38,3,46,49,18,3,15,2.72,16.67,Moyen,Difficile,-1,Plus Difficile,Pas Adapte,Marketing
1447,2016,Marketing,1,Introduction a l'Etude du Langage,8,L'Apprentissage de la Langue Seconde,12,324,9,QCU,0.41,0.23,15.92,8,42,50,38,8,30,1.32,21.05,Difficile,Difficile,0,Meme Difficulté,Pas Adapte,Marketing
2571,2017,Marketing,1,Introduction a l'Etude du Langage,8,L'Apprentissage de la Langue Seconde,12,324,9,QCU,0.12,0.88,96.78,49,2,51,51,49,2,1.0,96.08,Difficile,Facile,2,Beaucoup plus Facile,Pas Adapte,Marketing
3695,2018,Marketing,1,Introduction a l'Etude du Langage,8,L'Apprentissage de la Langue Seconde,12,324,9,QCU,0.05,0.93,85.18,44,8,52,46,44,2,1.13,95.65,Facile,Facile,0,Meme Difficulté,Pas Adapte,Marketing
4819,2019,Marketing,1,Introduction a l'Etude du Langage,8,L'Apprentissage de la Langue Seconde,12,324,9,QCM,0.49,0.33,60.13,36,24,60,45,36,9,1.33,80.0,Difficile,Moyen,1,Plus Facile,Adapte,Marketing
5943,2020,Marketing,1,Introduction a l'Etude du Langage,8,L'Apprentissage de la Langue Seconde,12,324,9,QCM,0.42,0.65,60.13,31,21,52,43,31,12,1.21,72.09,Moyen,Moyen,0,Meme Difficulté,Adapte,Marketing
324,2015,Marketing,1,Introduction a l'Etude du Langage,8,L'Apprentissage de la Langue Seconde,12,325,10,QCM,0.32,0.47,48.1,48,51,99,58,48,10,1.71,82.76,Facile,Moyen,-1,Plus Difficile,Pas Adapte,Marketing
1448,2016,Marketing,1,Introduction a l'Etude du Langage,8,L'Apprentissage de la Langue Seconde,12,325,10,QCM,0.41,0.41,63.82,70,39,109,90,70,20,1.21,77.78,Facile,Moyen,-1,Plus Difficile,Adapte,Marketing
2572,2017,Marketing,1,Introduction a l'Etude du Langage,8,L'Apprentissage de la Langue Seconde,12,325,10,QCM,0.36,0.61,63.82,75,42,117,83,75,8,1.41,90.36,Moyen,Moyen,0,Meme Difficulté,Adapte,Marketing
3696,2018,Marketing,1,Introduction a l'Etude du Langage,8,L'Apprentissage de la Langue Seconde,12,325,10,QCM,0.39,0.49,63.82,68,38,106,92,68,24,1.15,73.91,Moyen,Moyen,0,Meme Difficulté,Adapte,Marketing
4820,2019,Marketing,1,Introduction a l'Etude du Langage,8,L'Apprentissage de la Langue Seconde,12,325,10,QCM,0.26,0.65,63.82,59,34,93,75,59,16,1.24,78.67,Moyen,Moyen,0,Meme Difficulté,Adapte,Marketing
5944,2020,Marketing,1,Introduction a l'Etude du Langage,8,L'Apprentissage de la Langue Seconde,12,325,10,QCM,0.49,0.53,63.82,68,39,107,90,68,22,1.19,75.56,Moyen,Moyen,0,Meme Difficulté,Adapte,Marketing
325,2015,Marketing,1,Introduction a l'Etude du Langage,8,L'Apprentissage de la Langue Seconde,12,326,11,QCU,0.73,0.27,21.41,2,7,9,3,2,1,3.0,66.67,Moyen,Difficile,-1,Plus Difficile,Pas Adapte,Marketing
1449,2016,Marketing,1,Introduction a l'Etude du Langage,8,L'Apprentissage de la Langue Seconde,12,326,11,QCU,0.18,0.76,96.51,10,0,10,10,10,0,1.0,100.0,Moyen,Facile,1,Plus Facile,Pas Adapte,Marketing
2573,2017,Marketing,1,Introduction a l'Etude du Langage,8,L'Apprentissage de la Langue Seconde,12,326,11,QCU,0.04,0.95,86.21,9,1,10,9,9,0,1.11,100.0,Moyen,Facile,1,Plus Facile,Pas Adapte,Marketing
3697,2018,Marketing,1,Introduction a l'Etude du Langage,8,L'Apprentissage de la Langue Seconde,12,326,11,QCU,0.59,0.39,8.44,1,9,10,9,1,8,1.11,11.11,Difficile,Difficile,0,Meme Difficulté,Pas Adapte,Marketing
4821,2019,Marketing,1,Introduction a l'Etude du Langage,8,L'Apprentissage de la Langue Seconde,12,326,11,QROC,0.18,0.9,82.62,7,2,9,7,7,0,1.29,100.0,Facile,Facile,0,Meme Difficulté,Pas Adapte,Marketing
5945,2020,Marketing,1,Introduction a l'Etude du Langage,8,L'Apprentissage de la Langue Seconde,12,326,11,QO,0.87,0.04,25.22,2,7,9,5,2,3,1.8,40.0,Facile,Difficile,-2,Beaucoup plus Difficile,Pas Adapte,Marketing
326,2015,Marketing,1,Introduction a l'Etude du Langage,8,L'Apprentissage de la Langue Seconde,12,327,12,QCM,0.24,0.53,48.92,28,30,58,29,28,1,2.0,96.55,Facile,Moyen,-1,Plus Difficile,Pas Adapte,Marketing
1450,2016,Marketing,1,Introduction a l'Etude du Langage,8,L'Apprentissage de la Langue Seconde,12,327,12,QCM,0.48,0.51,42.09,26,35,61,49,26,23,1.24,53.06,Difficile,Moyen,1,Plus Facile,Pas Adapte,Marketing
2574,2017,Marketing,1,Introduction a l'Etude du Langage,8,L'Apprentissage de la Langue Seconde,12,327,12,QCM,0.65,0.22,12.9,7,50,57,32,7,25,1.78,21.88,Difficile,Difficile,0,Meme Difficulté,Pas Adapte,Marketing
3698,2018,Marketing,1,Introduction a l'Etude du Langage,8,L'Apprentissage de la Langue Seconde,12,327,12,QCM,0.22,0.57,63.18,40,23,63,57,40,17,1.11,70.18,Difficile,Moyen,1,Plus Facile,Adapte,Marketing
4822,2019,Marketing,1,Introduction a l'Etude du Langage,8,L'Apprentissage de la Langue Seconde,12,327,12,QCM,0.32,0.46,63.18,42,25,67,65,42,23,1.03,64.62,Moyen,Moyen,0,Meme Difficulté,Adapte,Marketing
5946,2020,Marketing,1,Introduction a l'Etude du Langage,8,L'Apprentissage de la Langue Seconde,12,327,12,QCU,0.36,0.64,63.18,45,27,72,64,45,19,1.12,70.31,Moyen,Moyen,0,Meme Difficulté,Adapte,Marketing
327,2015,Marketing,1,Introduction a l'Etude du Langage,9,La Sociolinguistique et la Dialectologie,5,328,1,QCU,0.56,0.39,23.84,2,5,7,6,2,4,1.17,33.33,Moyen,Difficile,-1,Plus Difficile,Pas Adapte,Marketing
1451,2016,Marketing,1,Introduction a l'Etude du Langage,9,La Sociolinguistique et la Dialectologie,5,328,1,QCU,0.39,0.41,59.6,4,2,6,4,4,0,1.5,100.0,Difficile,Moyen,1,Plus Facile,Pas Adapte,Marketing
2575,2017,Marketing,1,Introduction a l'Etude du Langage,9,La Sociolinguistique et la Dialectologie,5,328,1,QCU,0.15,0.82,79.37,4,1,5,4,4,0,1.25,100.0,Facile,Facile,0,Meme Difficulté,Pas Adapte,Marketing
3699,2018,Marketing,1,Introduction a l'Etude du Langage,9,La Sociolinguistique et la Dialectologie,5,328,1,QCU,0.61,0.4,10.33,1,5,6,5,1,4,1.2,20.0,Difficile,Difficile,0,Meme Difficulté,Pas Adapte,Marketing
4823,2019,Marketing,1,Introduction a l'Etude du Langage,9,La Sociolinguistique et la Dialectologie,5,328,1,QCU,0.07,0.77,75.97,5,2,7,6,5,1,1.17,83.33,Moyen,Facile,1,Plus Facile,Pas Adapte,Marketing
5947,2020,Marketing,1,Introduction a l'Etude du Langage,9,La Sociolinguistique et la Dialectologie,5,328,1,QCU,0.7,0.31,20.54,1,6,7,7,1,6,1.0,14.29,Difficile,Difficile,0,Meme Difficulté,Pas Adapte,Marketing
328,2015,Marketing,1,Introduction a l'Etude du Langage,9,La Sociolinguistique et la Dialectologie,5,329,2,QROC,0.7,0.1,8.94,6,58,64,34,6,28,1.88,17.65,Moyen,Difficile,-1,Plus Difficile,Pas Adapte,Marketing
1452,2016,Marketing,1,Introduction a l'Etude du Langage,9,La Sociolinguistique et la Dialectologie,5,329,2,QROC,0.47,0.3,40.72,22,33,55,27,22,5,2.04,81.48,Facile,Moyen,-1,Plus Difficile,Pas Adapte,Marketing
2576,2017,Marketing,1,Introduction a l'Etude du Langage,9,La Sociolinguistique et la Dialectologie,5,329,2,QROC,0.49,0.35,39.85,23,34,57,25,23,2,2.28,92.0,Facile,Moyen,-1,Plus Difficile,Pas Adapte,Marketing
3700,2018,Marketing,1,Introduction a l'Etude du Langage,9,La Sociolinguistique et la Dialectologie,5,329,2,QO,0.79,0.06,15.3,8,42,50,50,8,42,1.0,16.0,Facile,Difficile,-2,Beaucoup plus Difficile,Pas Adapte,Marketing
4824,2019,Marketing,1,Introduction a l'Etude du Langage,9,La Sociolinguistique et la Dialectologie,5,329,2,QO,0.31,0.16,62.35,27,16,43,43,27,16,1.0,62.79,Difficile,Moyen,1,Plus Facile,Adapte,Marketing
5948,2020,Marketing,1,Introduction a l'Etude du Langage,9,La Sociolinguistique et la Dialectologie,5,329,2,QO,0.2,0.15,62.35,27,17,44,40,27,13,1.1,67.5,Moyen,Moyen,0,Meme Difficulté,Adapte,Marketing
329,2015,Marketing,1,Introduction a l'Etude du Langage,9,La Sociolinguistique et la Dialectologie,5,330,3,QCM,0.25,0.64,35.7,27,50,77,32,27,5,2.41,84.38,Difficile,Moyen,1,Plus Facile,Pas Adapte,Marketing
1453,2016,Marketing,1,Introduction a l'Etude du Langage,9,La Sociolinguistique et la Dialectologie,5,330,3,QCM,0.22,0.32,62.9,42,25,67,57,42,15,1.18,73.68,Difficile,Moyen,1,Plus Facile,Adapte,Marketing
2577,2017,Marketing,1,Introduction a l'Etude du Langage,9,La Sociolinguistique et la Dialectologie,5,330,3,QCM,0.46,0.63,62.9,38,23,61,52,38,14,1.17,73.08,Moyen,Moyen,0,Meme Difficulté,Adapte,Marketing
3701,2018,Marketing,1,Introduction a l'Etude du Langage,9,La Sociolinguistique et la Dialectologie,5,330,3,QCM,0.32,0.64,62.9,35,21,56,49,35,14,1.14,71.43,Moyen,Moyen,0,Meme Difficulté,Adapte,Marketing
4825,2019,Marketing,1,Introduction a l'Etude du Langage,9,La Sociolinguistique et la Dialectologie,5,330,3,QCU,0.36,0.6,62.9,34,20,54,35,34,1,1.54,97.14,Moyen,Moyen,0,Meme Difficulté,Adapte,Marketing
5949,2020,Marketing,1,Introduction a l'Etude du Langage,9,La Sociolinguistique et la Dialectologie,5,330,3,QCU,0.26,0.68,62.9,33,20,53,45,33,12,1.18,73.33,Moyen,Moyen,0,Meme Difficulté,Adapte,Marketing
330,2015,Marketing,1,Introduction a l'Etude du Langage,9,La Sociolinguistique et la Dialectologie,5,331,4,QCM,0.63,0.23,21.84,2,8,10,5,2,3,2.0,40.0,Facile,Difficile,-2,Beaucoup plus Difficile,Pas Adapte,Marketing
1454,2016,Marketing,1,Introduction a l'Etude du Langage,9,La Sociolinguistique et la Dialectologie,5,331,4,QCM,0.05,0.77,83.65,10,2,12,10,10,0,1.2,100.0,Difficile,Facile,2,Beaucoup plus Facile,Pas Adapte,Marketing
2578,2017,Marketing,1,Introduction a l'Etude du Langage,9,La Sociolinguistique et la Dialectologie,5,331,4,QCM,0.32,0.45,62.6,6,4,10,10,6,4,1.0,60.0,Facile,Moyen,-1,Plus Difficile,Adapte,Marketing
3702,2018,Marketing,1,Introduction a l'Etude du Langage,9,La Sociolinguistique et la Dialectologie,5,331,4,QCM,0.28,0.6,62.6,6,3,9,9,6,3,1.0,66.67,Moyen,Moyen,0,Meme Difficulté,Adapte,Marketing
4826,2019,Marketing,1,Introduction a l'Etude du Langage,9,La Sociolinguistique et la Dialectologie,5,331,4,QCM,0.4,0.36,62.6,6,3,9,7,6,1,1.29,85.71,Moyen,Moyen,0,Meme Difficulté,Adapte,Marketing
5950,2020,Marketing,1,Introduction a l'Etude du Langage,9,La Sociolinguistique et la Dialectologie,5,331,4,QCM,0.47,0.69,62.6,5,3,8,5,5,0,1.6,100.0,Moyen,Moyen,0,Meme Difficulté,Adapte,Marketing
331,2015,Marketing,1,Introduction a l'Etude du Langage,9,La Sociolinguistique et la Dialectologie,5,332,5,QCU,0.04,0.88,84.98,48,8,56,49,48,1,1.14,97.96,Moyen,Facile,1,Plus Facile,Pas Adapte,Marketing
1455,2016,Marketing,1,Introduction a l'Etude du Langage,9,La Sociolinguistique et la Dialectologie,5,332,5,QROC,0.03,0.83,96.4,58,2,60,59,58,1,1.02,98.31,Facile,Facile,0,Meme Difficulté,Pas Adapte,Marketing
2579,2017,Marketing,1,Introduction a l'Etude du Langage,9,La Sociolinguistique et la Dialectologie,5,332,5,QCM,0.22,0.68,41.16,25,36,61,56,25,31,1.09,44.64,Moyen,Moyen,0,Meme Difficulté,Pas Adapte,Marketing
3703,2018,Marketing,1,Introduction a l'Etude du Langage,9,La Sociolinguistique et la Dialectologie,5,332,5,QCM,0.05,0.92,97.74,65,2,67,67,65,2,1.0,97.01,Facile,Facile,0,Meme Difficulté,Pas Adapte,Marketing
4827,2019,Marketing,1,Introduction a l'Etude du Langage,9,La Sociolinguistique et la Dialectologie,5,332,5,QCM,0.07,0.99,93.28,56,4,60,58,56,2,1.03,96.55,Difficile,Facile,2,Beaucoup plus Facile,Pas Adapte,Marketing
5951,2020,Marketing,1,Introduction a l'Etude du Langage,9,La Sociolinguistique et la Dialectologie,5,332,5,QCM,0.01,0.93,78.24,43,12,55,46,43,3,1.2,93.48,Moyen,Facile,1,Plus Facile,Pas Adapte,Marketing
332,2015,Marketing,1,Introduction a l'Etude du Langage,10,L'Amenagement Linguistique,10,333,1,QCU,0.2,0.85,94.7,61,3,64,64,61,3,1.0,95.31,Difficile,Facile,2,Beaucoup plus Facile,Pas Adapte,Marketing
1456,2016,Marketing,1,Introduction a l'Etude du Langage,10,L'Amenagement Linguistique,10,333,1,QCU,0.11,0.77,87.4,60,9,69,67,60,7,1.03,89.55,Facile,Facile,0,Meme Difficulté,Pas Adapte,Marketing
2580,2017,Marketing,1,Introduction a l'Etude du Langage,10,L'Amenagement Linguistique,10,333,1,QCU,0.39,0.57,43.82,35,44,79,74,35,39,1.07,47.3,Facile,Moyen,-1,Plus Difficile,Pas Adapte,Marketing
3704,2018,Marketing,1,Introduction a l'Etude du Langage,10,L'Amenagement Linguistique,10,333,1,QCU,0.35,0.69,40.33,33,48,81,34,33,1,2.38,97.06,Facile,Moyen,-1,Plus Difficile,Pas Adapte,Marketing
4828,2019,Marketing,1,Introduction a l'Etude du Langage,10,L'Amenagement Linguistique,10,333,1,QROC,0.84,0.24,32.75,28,58,86,82,28,54,1.05,34.15,Facile,Difficile,-2,Beaucoup plus Difficile,Pas Adapte,Marketing
5952,2020,Marketing,1,Introduction a l'Etude du Langage,10,L'Amenagement Linguistique,10,333,1,QROC,0.38,0.31,36.84,36,63,99,60,36,24,1.65,60.0,Facile,Moyen,-1,Plus Difficile,Pas Adapte,Marketing
333,2015,Marketing,1,Introduction a l'Etude du Langage,10,L'Amenagement Linguistique,10,334,2,QCU,0.61,0.27,11.97,12,85,97,56,12,44,1.73,21.43,Facile,Difficile,-2,Beaucoup plus Difficile,Pas Adapte,Marketing
1457,2016,Marketing,1,Introduction a l'Etude du Langage,10,L'Amenagement Linguistique,10,334,2,QCU,0.21,0.48,60.43,50,32,82,79,50,29,1.04,63.29,Moyen,Moyen,0,Meme Difficulté,Adapte,Marketing
2581,2017,Marketing,1,Introduction a l'Etude du Langage,10,L'Amenagement Linguistique,10,334,2,QCU,0.35,0.51,60.43,42,28,70,42,42,0,1.67,100.0,Moyen,Moyen,0,Meme Difficulté,Adapte,Marketing
3705,2018,Marketing,1,Introduction a l'Etude du Langage,10,L'Amenagement Linguistique,10,334,2,QCU,0.29,0.43,60.43,44,28,72,53,44,9,1.36,83.02,Moyen,Moyen,0,Meme Difficulté,Adapte,Marketing
4829,2019,Marketing,1,Introduction a l'Etude du Langage,10,L'Amenagement Linguistique,10,334,2,QCU,0.32,0.44,60.43,44,29,73,71,44,27,1.03,61.97,Moyen,Moyen,0,Meme Difficulté,Adapte,Marketing
5953,2020,Marketing,1,Introduction a l'Etude du Langage,10,L'Amenagement Linguistique,10,334,2,QCU,0.36,0.5,60.43,38,25,63,58,38,20,1.09,65.52,Moyen,Moyen,0,Meme Difficulté,Adapte,Marketing
334,2015,Marketing,1,Introduction a l'Etude du Langage,10,L'Amenagement Linguistique,10,335,3,QO,0.28,0.16,63.94,49,28,77,63,49,14,1.22,77.78,Facile,Moyen,-1,Plus Difficile,Adapte,Marketing
1458,2016,Marketing,1,Introduction a l'Etude du Langage,10,L'Amenagement Linguistique,10,335,3,QO,0.53,0.21,63.94,54,30,84,77,54,23,1.09,70.13,Moyen,Moyen,0,Meme Difficulté,Adapte,Marketing
2582,2017,Marketing,1,Introduction a l'Etude du Langage,10,L'Amenagement Linguistique,10,335,3,QO,0.35,0.16,63.94,53,30,83,71,53,18,1.17,74.65,Moyen,Moyen,0,Meme Difficulté,Adapte,Marketing
3706,2018,Marketing,1,Introduction a l'Etude du Langage,10,L'Amenagement Linguistique,10,335,3,QO,0.73,0.24,63.94,51,28,79,78,51,27,1.01,65.38,Moyen,Moyen,0,Meme Difficulté,Adapte,Marketing
4830,2019,Marketing,1,Introduction a l'Etude du Langage,10,L'Amenagement Linguistique,10,335,3,QO,0.71,0.24,63.94,53,30,83,83,53,30,1.0,63.86,Moyen,Moyen,0,Meme Difficulté,Adapte,Marketing
5954,2020,Marketing,1,Introduction a l'Etude du Langage,10,L'Amenagement Linguistique,10,335,3,QO,0.54,0.16,63.94,51,28,79,53,51,2,1.49,96.23,Moyen,Moyen,0,Meme Difficulté,Adapte,Marketing
335,2015,Marketing,1,Introduction a l'Etude du Langage,10,L'Amenagement Linguistique,10,336,4,QCM,0.67,0.19,22.01,16,57,73,53,16,37,1.38,30.19,Facile,Difficile,-2,Beaucoup plus Difficile,Pas Adapte,Marketing
1459,2016,Marketing,1,Introduction a l'Etude du Langage,10,L'Amenagement Linguistique,10,336,4,QCM,0.33,0.62,49.48,36,37,73,69,36,33,1.06,52.17,Moyen,Moyen,0,Meme Difficulté,Pas Adapte,Marketing
2583,2017,Marketing,1,Introduction a l'Etude du Langage,10,L'Amenagement Linguistique,10,336,4,QCU,0.73,0.28,31.18,22,48,70,70,22,48,1.0,31.43,Difficile,Difficile,0,Meme Difficulté,Pas Adapte,Marketing
3707,2018,Marketing,1,Introduction a l'Etude du Langage,10,L'Amenagement Linguistique,10,336,4,QCU,0.06,0.89,72.96,50,18,68,50,50,0,1.36,100.0,Moyen,Facile,1,Plus Facile,Adapte,Marketing
4831,2019,Marketing,1,Introduction a l'Etude du Langage,10,L'Amenagement Linguistique,10,336,4,QCU,0.05,1.0,72.96,54,20,74,55,54,1,1.35,98.18,Facile,Facile,0,Meme Difficulté,Adapte,Marketing
5955,2020,Marketing,1,Introduction a l'Etude du Langage,10,L'Amenagement Linguistique,10,336,4,QCU,0.19,0.98,72.96,47,18,65,50,47,3,1.3,94.0,Facile,Facile,0,Meme Difficulté,Adapte,Marketing
336,2015,Marketing,1,Introduction a l'Etude du Langage,10,L'Amenagement Linguistique,10,337,5,QCU,0.67,0.4,34.81,11,20,31,19,11,8,1.63,57.89,Facile,Difficile,-2,Beaucoup plus Difficile,Pas Adapte,Marketing
1460,2016,Marketing,1,Introduction a l'Etude du Langage,10,L'Amenagement Linguistique,10,337,5,QCU,0.69,0.22,5.05,2,34,36,27,2,25,1.33,7.41,Facile,Difficile,-2,Beaucoup plus Difficile,Pas Adapte,Marketing
2584,2017,Marketing,1,Introduction a l'Etude du Langage,10,L'Amenagement Linguistique,10,337,5,QCU,0.6,0.23,28.73,10,25,35,32,10,22,1.09,31.25,Difficile,Difficile,0,Meme Difficulté,Pas Adapte,Marketing
3708,2018,Marketing,1,Introduction a l'Etude du Langage,10,L'Amenagement Linguistique,10,337,5,QCU,0.21,0.46,47.75,19,20,39,28,19,9,1.39,67.86,Moyen,Moyen,0,Meme Difficulté,Pas Adapte,Marketing
4832,2019,Marketing,1,Introduction a l'Etude du Langage,10,L'Amenagement Linguistique,10,337,5,QCU,0.41,0.3,1.78,1,32,33,14,1,13,2.36,7.14,Facile,Difficile,-2,Beaucoup plus Difficile,Pas Adapte,Marketing
5956,2020,Marketing,1,Introduction a l'Etude du Langage,10,L'Amenagement Linguistique,10,337,5,QCU,0.54,0.36,23.07,7,24,31,14,7,7,2.21,50.0,Difficile,Difficile,0,Meme Difficulté,Pas Adapte,Marketing
337,2015,Marketing,1,Introduction a l'Etude du Langage,10,L'Amenagement Linguistique,10,338,6,QCU,0.22,0.44,44.91,45,55,100,76,45,31,1.32,59.21,Facile,Moyen,-1,Plus Difficile,Pas Adapte,Marketing
1461,2016,Marketing,1,Introduction a l'Etude du Langage,10,L'Amenagement Linguistique,10,338,6,QCU,0.38,0.44,60.37,66,43,109,85,66,19,1.28,77.65,Facile,Moyen,-1,Plus Difficile,Adapte,Marketing
2585,2017,Marketing,1,Introduction a l'Etude du Langage,10,L'Amenagement Linguistique,10,338,6,QCU,0.32,0.44,60.37,70,46,116,110,70,40,1.05,63.64,Moyen,Moyen,0,Meme Difficulté,Adapte,Marketing
3709,2018,Marketing,1,Introduction a l'Etude du Langage,10,L'Amenagement Linguistique,10,338,6,QCU,0.35,0.71,60.37,73,48,121,92,73,19,1.32,79.35,Moyen,Moyen,0,Meme Difficulté,Adapte,Marketing
4833,2019,Marketing,1,Introduction a l'Etude du Langage,10,L'Amenagement Linguistique,10,338,6,QCU,0.37,0.7,60.37,82,53,135,132,82,50,1.02,62.12,Moyen,Moyen,0,Meme Difficulté,Adapte,Marketing
5957,2020,Marketing,1,Introduction a l'Etude du Langage,10,L'Amenagement Linguistique,10,338,6,QCU,0.22,0.53,60.37,77,51,128,96,77,19,1.33,80.21,Moyen,Moyen,0,Meme Difficulté,Adapte,Marketing
338,2015,Marketing,1,Introduction a l'Etude du Langage,10,L'Amenagement Linguistique,10,339,7,QCU,0.1,0.83,95.63,70,3,73,70,70,0,1.04,100.0,Difficile,Facile,2,Beaucoup plus Facile,Pas Adapte,Marketing
1462,2016,Marketing,1,Introduction a l'Etude du Langage,10,L'Amenagement Linguistique,10,339,7,QROC,0.67,0.21,10.1,6,56,62,53,6,47,1.17,11.32,Moyen,Difficile,-1,Plus Difficile,Pas Adapte,Marketing
2586,2017,Marketing,1,Introduction a l'Etude du Langage,10,L'Amenagement Linguistique,10,339,7,QROC,0.22,0.34,36.68,24,41,65,54,24,30,1.2,44.44,Difficile,Moyen,1,Plus Facile,Pas Adapte,Marketing
3710,2018,Marketing,1,Introduction a l'Etude du Langage,10,L'Amenagement Linguistique,10,339,7,QCU,0.09,0.8,77.44,55,16,71,57,55,2,1.25,96.49,Difficile,Facile,2,Beaucoup plus Facile,Pas Adapte,Marketing
4834,2019,Marketing,1,Introduction a l'Etude du Langage,10,L'Amenagement Linguistique,10,339,7,QCU,0.3,0.49,37.74,26,42,68,66,26,40,1.03,39.39,Facile,Moyen,-1,Plus Difficile,Pas Adapte,Marketing
5958,2020,Marketing,1,Introduction a l'Etude du Langage,10,L'Amenagement Linguistique,10,339,7,QCU,0.01,0.95,69.76,51,22,73,67,51,16,1.09,76.12,Difficile,Facile,2,Beaucoup plus Facile,Adapte,Marketing
339,2015,Marketing,1,Introduction a l'Etude du Langage,10,L'Amenagement Linguistique,10,340,8,QCM,0.57,0.25,17.29,6,27,33,11,6,5,3.0,54.55,Difficile,Difficile,0,Meme Difficulté,Pas Adapte,Marketing
1463,2016,Marketing,1,Introduction a l'Etude du Langage,10,L'Amenagement Linguistique,10,340,8,QCM,0.54,0.23,13.74,5,28,33,30,5,25,1.1,16.67,Facile,Difficile,-2,Beaucoup plus Difficile,Pas Adapte,Marketing
2587,2017,Marketing,1,Introduction a l'Etude du Langage,10,L'Amenagement Linguistique,10,340,8,QCM,0.34,0.39,45.15,13,16,29,24,13,11,1.21,54.17,Moyen,Moyen,0,Meme Difficulté,Pas Adapte,Marketing
3711,2018,Marketing,1,Introduction a l'Etude du Langage,10,L'Amenagement Linguistique,10,340,8,QCM,0.61,0.25,20.12,6,22,28,21,6,15,1.33,28.57,Facile,Difficile,-2,Beaucoup plus Difficile,Pas Adapte,Marketing
4835,2019,Marketing,1,Introduction a l'Etude du Langage,10,L'Amenagement Linguistique,10,340,8,QCM,0.16,0.75,93.58,24,2,26,25,24,1,1.04,96.0,Difficile,Facile,2,Beaucoup plus Facile,Pas Adapte,Marketing
5959,2020,Marketing,1,Introduction a l'Etude du Langage,10,L'Amenagement Linguistique,10,340,8,QCM,0.7,0.28,26.76,7,21,28,16,7,9,1.75,43.75,Facile,Difficile,-2,Beaucoup plus Difficile,Pas Adapte,Marketing
340,2015,Marketing,1,Introduction a l'Etude du Langage,10,L'Amenagement Linguistique,10,341,9,QCM,0.3,0.69,44.06,42,54,96,96,42,54,1.0,43.75,Moyen,Moyen,0,Meme Difficulté,Pas Adapte,Marketing
1464,2016,Marketing,1,Introduction a l'Etude du Langage,10,L'Amenagement Linguistique,10,341,9,QCM,0.74,0.21,8.26,8,83,91,55,8,47,1.65,14.55,Facile,Difficile,-2,Beaucoup plus Difficile,Pas Adapte,Marketing
2588,2017,Marketing,1,Introduction a l'Etude du Langage,10,L'Amenagement Linguistique,10,341,9,QCM,0.31,0.46,42.52,36,48,84,57,36,21,1.47,63.16,Difficile,Moyen,1,Plus Facile,Pas Adapte,Marketing
3712,2018,Marketing,1,Introduction a l'Etude du Langage,10,L'Amenagement Linguistique,10,341,9,QCM,0.01,0.76,99.99,79,0,79,79,79,0,1.0,100.0,Facile,Facile,0,Meme Difficulté,Pas Adapte,Marketing
4836,2019,Marketing,1,Introduction a l'Etude du Langage,10,L'Amenagement Linguistique,10,341,9,QCM,0.58,0.25,2.33,2,67,69,49,2,47,1.41,4.08,Moyen,Difficile,-1,Plus Difficile,Pas Adapte,Marketing
5960,2020,Marketing,1,Introduction a l'Etude du Langage,10,L'Amenagement Linguistique,10,341,9,QCM,0.03,0.98,73.67,48,17,65,57,48,9,1.14,84.21,Facile,Facile,0,Meme Difficulté,Adapte,Marketing
341,2015,Marketing,1,Introduction a l'Etude du Langage,10,L'Amenagement Linguistique,10,342,10,QCM,0.03,0.81,84.46,15,3,18,16,15,1,1.12,93.75,Difficile,Facile,2,Beaucoup plus Facile,Pas Adapte,Marketing
1465,2016,Marketing,1,Introduction a l'Etude du Langage,10,L'Amenagement Linguistique,10,342,10,QO,0.94,0.13,14.63,2,14,16,9,2,7,1.78,22.22,Moyen,Difficile,-1,Plus Difficile,Pas Adapte,Marketing
2589,2017,Marketing,1,Introduction a l'Etude du Langage,10,L'Amenagement Linguistique,10,342,10,QO,0.98,0.13,7.61,1,13,14,10,1,9,1.4,10.0,Difficile,Difficile,0,Meme Difficulté,Pas Adapte,Marketing
3713,2018,Marketing,1,Introduction a l'Etude du Langage,10,L'Amenagement Linguistique,10,342,10,QO,0.73,0.26,59.58,10,6,16,15,10,5,1.07,66.67,Difficile,Moyen,1,Plus Facile,Pas Adapte,Marketing
4837,2019,Marketing,1,Introduction a l'Etude du Langage,10,L'Amenagement Linguistique,10,342,10,QCM,0.37,0.58,60.19,10,6,16,14,10,4,1.14,71.43,Difficile,Moyen,1,Plus Facile,Adapte,Marketing
5961,2020,Marketing,1,Introduction a l'Etude du Langage,10,L'Amenagement Linguistique,10,342,10,QCM,0.23,0.54,60.19,10,6,16,14,10,4,1.14,71.43,Moyen,Moyen,0,Meme Difficulté,Adapte,Marketing
342,2015,Marketing,2,Grammaire Lexicale Fonctionnelle,1,Les Traits Syntaxiques,13,343,1,QCU,0.37,0.55,44.86,15,19,34,15,15,0,2.27,100.0,Facile,Moyen,-1,Plus Difficile,Pas Adapte,Marketing
1466,2016,Marketing,2,Grammaire Lexicale Fonctionnelle,1,Les Traits Syntaxiques,13,343,1,QCU,0.25,0.65,48.54,19,20,39,19,19,0,2.05,100.0,Moyen,Moyen,0,Meme Difficulté,Pas Adapte,Marketing
2590,2017,Marketing,2,Grammaire Lexicale Fonctionnelle,1,Les Traits Syntaxiques,13,343,1,QCU,0.16,0.83,70.58,25,10,35,34,25,9,1.03,73.53,Difficile,Facile,2,Beaucoup plus Facile,Adapte,Marketing
3714,2018,Marketing,2,Grammaire Lexicale Fonctionnelle,1,Les Traits Syntaxiques,13,343,1,QCU,0.19,0.88,70.58,28,12,40,30,28,2,1.33,93.33,Facile,Facile,0,Meme Difficulté,Adapte,Marketing
4838,2019,Marketing,2,Grammaire Lexicale Fonctionnelle,1,Les Traits Syntaxiques,13,343,1,QCU,0.09,1.0,70.58,28,11,39,30,28,2,1.3,93.33,Facile,Facile,0,Meme Difficulté,Adapte,Marketing
5962,2020,Marketing,2,Grammaire Lexicale Fonctionnelle,1,Les Traits Syntaxiques,13,343,1,QCU,0.2,0.95,70.58,24,10,34,30,24,6,1.13,80.0,Facile,Facile,0,Meme Difficulté,Adapte,Marketing
343,2015,Marketing,2,Grammaire Lexicale Fonctionnelle,1,Les Traits Syntaxiques,13,344,2,QCM,0.4,0.42,56.6,3,2,5,4,3,1,1.25,75.0,Difficile,Moyen,1,Plus Facile,Pas Adapte,Marketing
1467,2016,Marketing,2,Grammaire Lexicale Fonctionnelle,1,Les Traits Syntaxiques,13,344,2,QCU,0.54,0.26,9.37,1,5,6,5,1,4,1.2,20.0,Difficile,Difficile,0,Meme Difficulté,Pas Adapte,Marketing
2591,2017,Marketing,2,Grammaire Lexicale Fonctionnelle,1,Les Traits Syntaxiques,13,344,2,QCU,0.57,0.4,16.91,1,5,6,6,1,5,1.0,16.67,Difficile,Difficile,0,Meme Difficulté,Pas Adapte,Marketing
3715,2018,Marketing,2,Grammaire Lexicale Fonctionnelle,1,Les Traits Syntaxiques,13,344,2,QCU,0.21,0.57,45.26,2,3,5,4,2,2,1.25,50.0,Moyen,Moyen,0,Meme Difficulté,Pas Adapte,Marketing
4839,2019,Marketing,2,Grammaire Lexicale Fonctionnelle,1,Les Traits Syntaxiques,13,344,2,QCU,0.32,0.62,49.5,3,3,6,5,3,2,1.2,60.0,Facile,Moyen,-1,Plus Difficile,Pas Adapte,Marketing
5963,2020,Marketing,2,Grammaire Lexicale Fonctionnelle,1,Les Traits Syntaxiques,13,344,2,QCU,0.4,0.44,52.58,4,3,7,7,4,3,1.0,57.14,Difficile,Moyen,1,Plus Facile,Pas Adapte,Marketing
344,2015,Marketing,2,Grammaire Lexicale Fonctionnelle,1,Les Traits Syntaxiques,13,345,3,QCU,0.52,0.31,5.61,4,76,80,29,4,25,2.76,13.79,Difficile,Difficile,0,Meme Difficulté,Pas Adapte,Marketing
1468,2016,Marketing,2,Grammaire Lexicale Fonctionnelle,1,Les Traits Syntaxiques,13,345,3,QCU,0.56,0.33,17.46,15,69,84,40,15,25,2.1,37.5,Difficile,Difficile,0,Meme Difficulté,Pas Adapte,Marketing
2592,2017,Marketing,2,Grammaire Lexicale Fonctionnelle,1,Les Traits Syntaxiques,13,345,3,QCU,0.73,0.3,6.17,5,72,77,69,5,64,1.12,7.25,Facile,Difficile,-2,Beaucoup plus Difficile,Pas Adapte,Marketing
3716,2018,Marketing,2,Grammaire Lexicale Fonctionnelle,1,Les Traits Syntaxiques,13,345,3,QCM,0.13,0.72,83.9,65,12,77,73,65,8,1.05,89.04,Moyen,Facile,1,Plus Facile,Pas Adapte,Marketing
4840,2019,Marketing,2,Grammaire Lexicale Fonctionnelle,1,Les Traits Syntaxiques,13,345,3,QCM,0.09,0.93,68.24,46,22,68,47,46,1,1.45,97.87,Moyen,Facile,1,Plus Facile,Adapte,Marketing
5964,2020,Marketing,2,Grammaire Lexicale Fonctionnelle,1,Les Traits Syntaxiques,13,345,3,QCM,0.05,0.74,68.24,50,23,73,65,50,15,1.12,76.92,Facile,Facile,0,Meme Difficulté,Adapte,Marketing
345,2015,Marketing,2,Grammaire Lexicale Fonctionnelle,1,Les Traits Syntaxiques,13,346,4,QCU,0.05,0.81,67.42,24,11,35,31,24,7,1.13,77.42,Facile,Facile,0,Meme Difficulté,Adapte,Marketing
1469,2016,Marketing,2,Grammaire Lexicale Fonctionnelle,1,Les Traits Syntaxiques,13,346,4,QCU,0.19,1.0,67.42,21,10,31,22,21,1,1.41,95.45,Facile,Facile,0,Meme Difficulté,Adapte,Marketing
2593,2017,Marketing,2,Grammaire Lexicale Fonctionnelle,1,Les Traits Syntaxiques,13,346,4,QCM,0.1,0.8,67.42,20,9,29,28,20,8,1.04,71.43,Facile,Facile,0,Meme Difficulté,Adapte,Marketing
3717,2018,Marketing,2,Grammaire Lexicale Fonctionnelle,1,Les Traits Syntaxiques,13,346,4,QCM,0.1,0.95,67.42,17,8,25,23,17,6,1.09,73.91,Facile,Facile,0,Meme Difficulté,Adapte,Marketing
4841,2019,Marketing,2,Grammaire Lexicale Fonctionnelle,1,Les Traits Syntaxiques,13,346,4,QCU,0.01,0.99,67.42,18,8,26,23,18,5,1.13,78.26,Facile,Facile,0,Meme Difficulté,Adapte,Marketing
5965,2020,Marketing,2,Grammaire Lexicale Fonctionnelle,1,Les Traits Syntaxiques,13,346,4,QCU,0.13,0.83,67.42,15,7,22,17,15,2,1.29,88.24,Facile,Facile,0,Meme Difficulté,Adapte,Marketing
346,2015,Marketing,2,Grammaire Lexicale Fonctionnelle,1,Les Traits Syntaxiques,13,347,5,QCU,0.65,0.31,13.81,2,9,11,9,2,7,1.22,22.22,Moyen,Difficile,-1,Plus Difficile,Pas Adapte,Marketing
1470,2016,Marketing,2,Grammaire Lexicale Fonctionnelle,1,Les Traits Syntaxiques,13,347,5,QCU,0.16,0.8,67.14,8,4,12,9,8,1,1.33,88.89,Facile,Facile,0,Meme Difficulté,Adapte,Marketing
2594,2017,Marketing,2,Grammaire Lexicale Fonctionnelle,1,Les Traits Syntaxiques,13,347,5,QCU,0.09,0.81,67.14,7,3,10,9,7,2,1.11,77.78,Facile,Facile,0,Meme Difficulté,Adapte,Marketing
3718,2018,Marketing,2,Grammaire Lexicale Fonctionnelle,1,Les Traits Syntaxiques,13,347,5,QCU,0.06,0.83,67.14,6,3,9,7,6,1,1.29,85.71,Facile,Facile,0,Meme Difficulté,Adapte,Marketing
4842,2019,Marketing,2,Grammaire Lexicale Fonctionnelle,1,Les Traits Syntaxiques,13,347,5,QCU,0.16,0.86,67.14,6,3,9,6,6,0,1.5,100.0,Facile,Facile,0,Meme Difficulté,Adapte,Marketing
5966,2020,Marketing,2,Grammaire Lexicale Fonctionnelle,1,Les Traits Syntaxiques,13,347,5,QCU,0.14,0.89,67.14,7,3,10,10,7,3,1.0,70.0,Facile,Facile,0,Meme Difficulté,Adapte,Marketing
347,2015,Marketing,2,Grammaire Lexicale Fonctionnelle,1,Les Traits Syntaxiques,13,348,6,QCU,0.28,0.57,42.14,29,41,70,38,29,9,1.84,76.32,Moyen,Moyen,0,Meme Difficulté,Pas Adapte,Marketing
1471,2016,Marketing,2,Grammaire Lexicale Fonctionnelle,1,Les Traits Syntaxiques,13,348,6,QCU,0.5,0.31,3.54,2,62,64,36,2,34,1.78,5.56,Facile,Difficile,-2,Beaucoup plus Difficile,Pas Adapte,Marketing
2595,2017,Marketing,2,Grammaire Lexicale Fonctionnelle,1,Les Traits Syntaxiques,13,348,6,QCU,0.26,0.66,46.25,26,30,56,37,26,11,1.51,70.27,Facile,Moyen,-1,Plus Difficile,Pas Adapte,Marketing
3719,2018,Marketing,2,Grammaire Lexicale Fonctionnelle,1,Les Traits Syntaxiques,13,348,6,QCU,0.36,0.56,64.91,38,21,59,58,38,20,1.02,65.52,Moyen,Moyen,0,Meme Difficulté,Adapte,Marketing
4843,2019,Marketing,2,Grammaire Lexicale Fonctionnelle,1,Les Traits Syntaxiques,13,348,6,QCU,0.31,0.53,64.91,41,22,63,53,41,12,1.19,77.36,Moyen,Moyen,0,Meme Difficulté,Adapte,Marketing
5967,2020,Marketing,2,Grammaire Lexicale Fonctionnelle,1,Les Traits Syntaxiques,13,348,6,QROC,0.22,0.27,64.91,45,24,69,59,45,14,1.17,76.27,Moyen,Moyen,0,Meme Difficulté,Adapte,Marketing
348,2015,Marketing,2,Grammaire Lexicale Fonctionnelle,1,Les Traits Syntaxiques,13,349,7,QROC,0.11,0.42,73.3,70,26,96,84,70,14,1.14,83.33,Difficile,Facile,2,Beaucoup plus Facile,Adapte,Marketing
1472,2016,Marketing,2,Grammaire Lexicale Fonctionnelle,1,Les Traits Syntaxiques,13,349,7,QROC,0.18,0.83,73.3,69,25,94,73,69,4,1.29,94.52,Facile,Facile,0,Meme Difficulté,Adapte,Marketing
2596,2017,Marketing,2,Grammaire Lexicale Fonctionnelle,1,Les Traits Syntaxiques,13,349,7,QROC,0.06,0.52,73.3,74,27,101,91,74,17,1.11,81.32,Facile,Facile,0,Meme Difficulté,Adapte,Marketing
3720,2018,Marketing,2,Grammaire Lexicale Fonctionnelle,1,Les Traits Syntaxiques,13,349,7,QROC,0.05,0.65,73.3,73,26,99,91,73,18,1.09,80.22,Facile,Facile,0,Meme Difficulté,Adapte,Marketing
4844,2019,Marketing,2,Grammaire Lexicale Fonctionnelle,1,Les Traits Syntaxiques,13,349,7,QROC,0.02,0.6,73.3,73,27,100,93,73,20,1.08,78.49,Facile,Facile,0,Meme Difficulté,Adapte,Marketing
5968,2020,Marketing,2,Grammaire Lexicale Fonctionnelle,1,Les Traits Syntaxiques,13,349,7,QROC,0.11,0.57,73.3,76,28,104,96,76,20,1.08,79.17,Facile,Facile,0,Meme Difficulté,Adapte,Marketing
349,2015,Marketing,2,Grammaire Lexicale Fonctionnelle,1,Les Traits Syntaxiques,13,350,8,QROC,0.96,0.11,5.68,4,69,73,36,4,32,2.03,11.11,Facile,Difficile,-2,Beaucoup plus Difficile,Pas Adapte,Marketing
1473,2016,Marketing,2,Grammaire Lexicale Fonctionnelle,1,Les Traits Syntaxiques,13,350,8,QROC,0.03,0.46,75.17,48,16,64,49,48,1,1.31,97.96,Facile,Facile,0,Meme Difficulté,Pas Adapte,Marketing
2597,2017,Marketing,2,Grammaire Lexicale Fonctionnelle,1,Les Traits Syntaxiques,13,350,8,QROC,0.26,0.27,55.15,34,27,61,60,34,26,1.02,56.67,Facile,Moyen,-1,Plus Difficile,Pas Adapte,Marketing
3721,2018,Marketing,2,Grammaire Lexicale Fonctionnelle,1,Les Traits Syntaxiques,13,350,8,QROC,0.11,0.94,74.62,50,17,67,54,50,4,1.24,92.59,Facile,Facile,0,Meme Difficulté,Adapte,Marketing
4845,2019,Marketing,2,Grammaire Lexicale Fonctionnelle,1,Les Traits Syntaxiques,13,350,8,QROC,0.06,1.0,74.62,51,17,68,62,51,11,1.1,82.26,Facile,Facile,0,Meme Difficulté,Adapte,Marketing
5969,2020,Marketing,2,Grammaire Lexicale Fonctionnelle,1,Les Traits Syntaxiques,13,350,8,QROC,0.11,0.76,74.62,51,18,69,65,51,14,1.06,78.46,Facile,Facile,0,Meme Difficulté,Adapte,Marketing
350,2015,Marketing,2,Grammaire Lexicale Fonctionnelle,1,Les Traits Syntaxiques,13,351,9,QCM,0.1,0.72,86.26,60,10,70,67,60,7,1.04,89.55,Facile,Facile,0,Meme Difficulté,Pas Adapte,Marketing
1474,2016,Marketing,2,Grammaire Lexicale Fonctionnelle,1,Les Traits Syntaxiques,13,351,9,QCM,0.18,0.96,88.48,65,9,74,65,65,0,1.14,100.0,Facile,Facile,0,Meme Difficulté,Pas Adapte,Marketing
2598,2017,Marketing,2,Grammaire Lexicale Fonctionnelle,1,Les Traits Syntaxiques,13,351,9,QCM,0.36,0.4,60.2,46,31,77,63,46,17,1.22,73.02,Difficile,Moyen,1,Plus Facile,Adapte,Marketing
3722,2018,Marketing,2,Grammaire Lexicale Fonctionnelle,1,Les Traits Syntaxiques,13,351,9,QCM,0.26,0.55,60.2,48,32,80,53,48,5,1.51,90.57,Moyen,Moyen,0,Meme Difficulté,Adapte,Marketing
4846,2019,Marketing,2,Grammaire Lexicale Fonctionnelle,1,Les Traits Syntaxiques,13,351,9,QCM,0.36,0.61,60.2,54,36,90,59,54,5,1.53,91.53,Moyen,Moyen,0,Meme Difficulté,Adapte,Marketing
5970,2020,Marketing,2,Grammaire Lexicale Fonctionnelle,1,Les Traits Syntaxiques,13,351,9,QCM,0.34,0.58,60.2,59,39,98,72,59,13,1.36,81.94,Moyen,Moyen,0,Meme Difficulté,Adapte,Marketing
351,2015,Marketing,2,Grammaire Lexicale Fonctionnelle,1,Les Traits Syntaxiques,13,352,10,QROC,0.27,0.27,53.69,6,5,11,8,6,2,1.38,75.0,Facile,Moyen,-1,Plus Difficile,Pas Adapte,Marketing
1475,2016,Marketing,2,Grammaire Lexicale Fonctionnelle,1,Les Traits Syntaxiques,13,352,10,QROC,0.57,0.35,39.0,5,7,12,5,5,0,2.4,100.0,Facile,Moyen,-1,Plus Difficile,Pas Adapte,Marketing
2599,2017,Marketing,2,Grammaire Lexicale Fonctionnelle,1,Les Traits Syntaxiques,13,352,10,QO,0.17,0.76,85.17,12,2,14,12,12,0,1.17,100.0,Facile,Facile,0,Meme Difficulté,Pas Adapte,Marketing
3723,2018,Marketing,2,Grammaire Lexicale Fonctionnelle,1,Les Traits Syntaxiques,13,352,10,QO,0.36,0.28,38.63,5,8,13,13,5,8,1.0,38.46,Difficile,Moyen,1,Plus Facile,Pas Adapte,Marketing
4847,2019,Marketing,2,Grammaire Lexicale Fonctionnelle,1,Les Traits Syntaxiques,13,352,10,QO,0.14,0.92,84.88,13,2,15,15,13,2,1.0,86.67,Difficile,Facile,2,Beaucoup plus Facile,Pas Adapte,Marketing
5971,2020,Marketing,2,Grammaire Lexicale Fonctionnelle,1,Les Traits Syntaxiques,13,352,10,QO,0.92,0.09,3.2,0,14,14,9,0,9,1.56,0.0,Facile,Difficile,-2,Beaucoup plus Difficile,Pas Adapte,Marketing
352,2015,Marketing,2,Grammaire Lexicale Fonctionnelle,1,Les Traits Syntaxiques,13,353,11,QCU,0.62,0.32,24.92,20,59,79,56,20,36,1.41,35.71,Moyen,Difficile,-1,Plus Difficile,Pas Adapte,Marketing
1476,2016,Marketing,2,Grammaire Lexicale Fonctionnelle,1,Les Traits Syntaxiques,13,353,11,QCU,0.05,0.77,98.47,78,1,79,78,78,0,1.01,100.0,Facile,Facile,0,Meme Difficulté,Pas Adapte,Marketing
2600,2017,Marketing,2,Grammaire Lexicale Fonctionnelle,1,Les Traits Syntaxiques,13,353,11,QCU,0.39,0.73,56.43,43,34,77,60,43,17,1.28,71.67,Facile,Moyen,-1,Plus Difficile,Pas Adapte,Marketing
3724,2018,Marketing,2,Grammaire Lexicale Fonctionnelle,1,Les Traits Syntaxiques,13,353,11,QCU,0.12,0.95,98.86,86,1,87,86,86,0,1.01,100.0,Difficile,Facile,2,Beaucoup plus Facile,Pas Adapte,Marketing
4848,2019,Marketing,2,Grammaire Lexicale Fonctionnelle,1,Les Traits Syntaxiques,13,353,11,QCU,0.74,0.22,24.5,19,57,76,64,19,45,1.19,29.69,Facile,Difficile,-2,Beaucoup plus Difficile,Pas Adapte,Marketing
5972,2020,Marketing,2,Grammaire Lexicale Fonctionnelle,1,Les Traits Syntaxiques,13,353,11,QCU,0.44,0.36,22.71,16,56,72,57,16,41,1.26,28.07,Moyen,Difficile,-1,Plus Difficile,Pas Adapte,Marketing
353,2015,Marketing,2,Grammaire Lexicale Fonctionnelle,1,Les Traits Syntaxiques,13,354,12,QCM,0.08,0.81,72.16,69,26,95,71,69,2,1.34,97.18,Moyen,Facile,1,Plus Facile,Adapte,Marketing
1477,2016,Marketing,2,Grammaire Lexicale Fonctionnelle,1,Les Traits Syntaxiques,13,354,12,QCM,0.18,0.83,72.16,63,24,87,79,63,16,1.1,79.75,Facile,Facile,0,Meme Difficulté,Adapte,Marketing
2601,2017,Marketing,2,Grammaire Lexicale Fonctionnelle,1,Les Traits Syntaxiques,13,354,12,QROC,0.18,0.56,72.16,69,27,96,79,69,10,1.22,87.34,Facile,Facile,0,Meme Difficulté,Adapte,Marketing
3725,2018,Marketing,2,Grammaire Lexicale Fonctionnelle,1,Les Traits Syntaxiques,13,354,12,QROC,0.02,0.85,72.16,74,29,103,92,74,18,1.12,80.43,Facile,Facile,0,Meme Difficulté,Adapte,Marketing
4849,2019,Marketing,2,Grammaire Lexicale Fonctionnelle,1,Les Traits Syntaxiques,13,354,12,QROC,0.05,0.97,72.16,79,30,109,85,79,6,1.28,92.94,Facile,Facile,0,Meme Difficulté,Adapte,Marketing
5973,2020,Marketing,2,Grammaire Lexicale Fonctionnelle,1,Les Traits Syntaxiques,13,354,12,QROC,0.02,0.75,72.16,74,29,103,75,74,1,1.37,98.67,Facile,Facile,0,Meme Difficulté,Adapte,Marketing
354,2015,Marketing,2,Grammaire Lexicale Fonctionnelle,1,Les Traits Syntaxiques,13,355,13,QCU,0.19,0.84,89.3,89,11,100,92,89,3,1.09,96.74,Moyen,Facile,1,Plus Facile,Pas Adapte,Marketing
1478,2016,Marketing,2,Grammaire Lexicale Fonctionnelle,1,Les Traits Syntaxiques,13,355,13,QCU,0.6,0.33,18.14,18,82,100,90,18,72,1.11,20.0,Moyen,Difficile,-1,Plus Difficile,Pas Adapte,Marketing
2602,2017,Marketing,2,Grammaire Lexicale Fonctionnelle,1,Les Traits Syntaxiques,13,355,13,QCU,0.45,0.37,3.22,4,106,110,80,4,76,1.38,5.0,Difficile,Difficile,0,Meme Difficulté,Pas Adapte,Marketing
3726,2018,Marketing,2,Grammaire Lexicale Fonctionnelle,1,Les Traits Syntaxiques,13,355,13,QCU,0.12,0.86,78.17,88,25,113,92,88,4,1.23,95.65,Facile,Facile,0,Meme Difficulté,Pas Adapte,Marketing
4850,2019,Marketing,2,Grammaire Lexicale Fonctionnelle,1,Les Traits Syntaxiques,13,355,13,QCU,0.5,0.32,4.14,4,100,104,68,4,64,1.53,5.88,Difficile,Difficile,0,Meme Difficulté,Pas Adapte,Marketing
5974,2020,Marketing,2,Grammaire Lexicale Fonctionnelle,1,Les Traits Syntaxiques,13,355,13,QCM,0.19,0.82,72.73,78,29,107,99,78,21,1.08,78.79,Difficile,Facile,2,Beaucoup plus Facile,Adapte,Marketing
355,2015,Marketing,2,Grammaire Lexicale Fonctionnelle,2,Les Fonctions,9,356,1,QCU,0.37,0.7,62.54,59,36,95,76,59,17,1.25,77.63,Difficile,Moyen,1,Plus Facile,Adapte,Marketing
1479,2016,Marketing,2,Grammaire Lexicale Fonctionnelle,2,Les Fonctions,9,356,1,QCU,0.31,0.73,62.54,58,35,93,77,58,19,1.21,75.32,Moyen,Moyen,0,Meme Difficulté,Adapte,Marketing
2603,2017,Marketing,2,Grammaire Lexicale Fonctionnelle,2,Les Fonctions,9,356,1,QCU,0.35,0.62,62.54,51,30,81,75,51,24,1.08,68.0,Moyen,Moyen,0,Meme Difficulté,Adapte,Marketing
3727,2018,Marketing,2,Grammaire Lexicale Fonctionnelle,2,Les Fonctions,9,356,1,QCU,0.34,0.68,62.54,52,31,83,71,52,19,1.17,73.24,Moyen,Moyen,0,Meme Difficulté,Adapte,Marketing
4851,2019,Marketing,2,Grammaire Lexicale Fonctionnelle,2,Les Fonctions,9,356,1,QCU,0.4,0.42,62.54,55,33,88,71,55,16,1.24,77.46,Moyen,Moyen,0,Meme Difficulté,Adapte,Marketing
5975,2020,Marketing,2,Grammaire Lexicale Fonctionnelle,2,Les Fonctions,9,356,1,QCU,0.27,0.6,62.54,54,32,86,69,54,15,1.25,78.26,Moyen,Moyen,0,Meme Difficulté,Adapte,Marketing
356,2015,Marketing,2,Grammaire Lexicale Fonctionnelle,2,Les Fonctions,9,357,2,QCM,0.3,0.43,55.99,27,21,48,47,27,20,1.02,57.45,Difficile,Moyen,1,Plus Facile,Pas Adapte,Marketing
1480,2016,Marketing,2,Grammaire Lexicale Fonctionnelle,2,Les Fonctions,9,357,2,QCM,0.33,0.46,59.92,27,18,45,40,27,13,1.12,67.5,Facile,Moyen,-1,Plus Difficile,Pas Adapte,Marketing
2604,2017,Marketing,2,Grammaire Lexicale Fonctionnelle,2,Les Fonctions,9,357,2,QCU,0.11,0.92,86.92,37,6,43,42,37,5,1.02,88.1,Facile,Facile,0,Meme Difficulté,Pas Adapte,Marketing
3728,2018,Marketing,2,Grammaire Lexicale Fonctionnelle,2,Les Fonctions,9,357,2,QCU,0.53,0.22,26.96,11,31,42,36,11,25,1.17,30.56,Facile,Difficile,-2,Beaucoup plus Difficile,Pas Adapte,Marketing
4852,2019,Marketing,2,Grammaire Lexicale Fonctionnelle,2,Les Fonctions,9,357,2,QROC,0.09,0.74,69.32,28,12,40,31,28,3,1.29,90.32,Difficile,Facile,2,Beaucoup plus Facile,Adapte,Marketing
5976,2020,Marketing,2,Grammaire Lexicale Fonctionnelle,2,Les Fonctions,9,357,2,QROC,0.02,0.48,69.32,28,13,41,34,28,6,1.21,82.35,Facile,Facile,0,Meme Difficulté,Adapte,Marketing
357,2015,Marketing,2,Grammaire Lexicale Fonctionnelle,2,Les Fonctions,9,358,3,QCM,0.64,0.23,13.63,12,75,87,37,12,25,2.35,32.43,Moyen,Difficile,-1,Plus Difficile,Pas Adapte,Marketing
1481,2016,Marketing,2,Grammaire Lexicale Fonctionnelle,2,Les Fonctions,9,358,3,QCM,0.26,0.64,43.42,38,49,87,41,38,3,2.12,92.68,Moyen,Moyen,0,Meme Difficulté,Pas Adapte,Marketing
2605,2017,Marketing,2,Grammaire Lexicale Fonctionnelle,2,Les Fonctions,9,358,3,QO,0.61,0.15,55.55,42,34,76,74,42,32,1.03,56.76,Difficile,Moyen,1,Plus Facile,Pas Adapte,Marketing
3729,2018,Marketing,2,Grammaire Lexicale Fonctionnelle,2,Les Fonctions,9,358,3,QO,0.95,0.01,26.91,18,50,68,55,18,37,1.24,32.73,Moyen,Difficile,-1,Plus Difficile,Pas Adapte,Marketing
4853,2019,Marketing,2,Grammaire Lexicale Fonctionnelle,2,Les Fonctions,9,358,3,QO,0.1,0.46,76.09,52,16,68,54,52,2,1.26,96.3,Difficile,Facile,2,Beaucoup plus Facile,Pas Adapte,Marketing
5977,2020,Marketing,2,Grammaire Lexicale Fonctionnelle,2,Les Fonctions,9,358,3,QO,0.17,0.63,67.91,47,22,69,59,47,12,1.17,79.66,Difficile,Facile,2,Beaucoup plus Facile,Adapte,Marketing
358,2015,Marketing,2,Grammaire Lexicale Fonctionnelle,2,Les Fonctions,9,359,4,QCM,0.42,0.57,55.66,56,44,100,71,56,15,1.41,78.87,Moyen,Moyen,0,Meme Difficulté,Pas Adapte,Marketing
1482,2016,Marketing,2,Grammaire Lexicale Fonctionnelle,2,Les Fonctions,9,359,4,QCM,0.19,0.75,89.05,96,12,108,101,96,5,1.07,95.05,Difficile,Facile,2,Beaucoup plus Facile,Pas Adapte,Marketing
2606,2017,Marketing,2,Grammaire Lexicale Fonctionnelle,2,Les Fonctions,9,359,4,QCM,0.3,0.36,42.18,40,54,94,43,40,3,2.19,93.02,Facile,Moyen,-1,Plus Difficile,Pas Adapte,Marketing
3730,2018,Marketing,2,Grammaire Lexicale Fonctionnelle,2,Les Fonctions,9,359,4,QCM,0.14,0.88,96.86,83,3,86,85,83,2,1.01,97.65,Facile,Facile,0,Meme Difficulté,Pas Adapte,Marketing
4854,2019,Marketing,2,Grammaire Lexicale Fonctionnelle,2,Les Fonctions,9,359,4,QCM,0.24,0.38,63.95,61,34,95,81,61,20,1.17,75.31,Facile,Moyen,-1,Plus Difficile,Adapte,Marketing
5978,2020,Marketing,2,Grammaire Lexicale Fonctionnelle,2,Les Fonctions,9,359,4,QCM,0.38,0.66,63.95,54,31,85,73,54,19,1.16,73.97,Moyen,Moyen,0,Meme Difficulté,Adapte,Marketing
359,2015,Marketing,2,Grammaire Lexicale Fonctionnelle,2,Les Fonctions,9,360,5,QCU,0.62,0.3,14.59,6,36,42,36,6,30,1.17,16.67,Facile,Difficile,-2,Beaucoup plus Difficile,Pas Adapte,Marketing
1483,2016,Marketing,2,Grammaire Lexicale Fonctionnelle,2,Les Fonctions,9,360,5,QCU,0.74,0.33,20.92,8,30,38,33,8,25,1.15,24.24,Difficile,Difficile,0,Meme Difficulté,Pas Adapte,Marketing
2607,2017,Marketing,2,Grammaire Lexicale Fonctionnelle,2,Les Fonctions,9,360,5,QCU,0.32,0.58,44.01,15,18,33,19,15,4,1.74,78.95,Facile,Moyen,-1,Plus Difficile,Pas Adapte,Marketing
3731,2018,Marketing,2,Grammaire Lexicale Fonctionnelle,2,Les Fonctions,9,360,5,QCU,0.71,0.35,4.08,1,27,28,22,1,21,1.27,4.55,Moyen,Difficile,-1,Plus Difficile,Pas Adapte,Marketing
4855,2019,Marketing,2,Grammaire Lexicale Fonctionnelle,2,Les Fonctions,9,360,5,QCU,0.59,0.24,5.84,1,23,24,10,1,9,2.4,10.0,Facile,Difficile,-2,Beaucoup plus Difficile,Pas Adapte,Marketing
5979,2020,Marketing,2,Grammaire Lexicale Fonctionnelle,2,Les Fonctions,9,360,5,QCU,0.4,0.52,42.61,12,15,27,12,12,0,2.25,100.0,Moyen,Moyen,0,Meme Difficulté,Pas Adapte,Marketing
360,2015,Marketing,2,Grammaire Lexicale Fonctionnelle,2,Les Fonctions,9,361,6,QROC,0.73,0.04,16.5,9,48,57,51,9,42,1.12,17.65,Moyen,Difficile,-1,Plus Difficile,Pas Adapte,Marketing
1484,2016,Marketing,2,Grammaire Lexicale Fonctionnelle,2,Les Fonctions,9,361,6,QROC,0.9,0.21,12.93,8,51,59,41,8,33,1.44,19.51,Difficile,Difficile,0,Meme Difficulté,Pas Adapte,Marketing
2608,2017,Marketing,2,Grammaire Lexicale Fonctionnelle,2,Les Fonctions,9,361,6,QROC,0.17,0.46,71.77,39,15,54,51,39,12,1.06,76.47,Moyen,Facile,1,Plus Facile,Adapte,Marketing
3732,2018,Marketing,2,Grammaire Lexicale Fonctionnelle,2,Les Fonctions,9,361,6,QROC,0.08,0.98,71.77,34,13,47,36,34,2,1.31,94.44,Facile,Facile,0,Meme Difficulté,Adapte,Marketing
4856,2019,Marketing,2,Grammaire Lexicale Fonctionnelle,2,Les Fonctions,9,361,6,QROC,0.05,0.52,71.77,29,11,40,39,29,10,1.03,74.36,Facile,Facile,0,Meme Difficulté,Adapte,Marketing
5980,2020,Marketing,2,Grammaire Lexicale Fonctionnelle,2,Les Fonctions,9,361,6,QROC,0.16,1.0,71.77,33,13,46,42,33,9,1.1,78.57,Facile,Facile,0,Meme Difficulté,Adapte,Marketing
361,2015,Marketing,2,Grammaire Lexicale Fonctionnelle,2,Les Fonctions,9,362,7,QCM,0.12,0.9,66.5,46,23,69,64,46,18,1.08,71.88,Difficile,Facile,2,Beaucoup plus Facile,Adapte,Marketing
1485,2016,Marketing,2,Grammaire Lexicale Fonctionnelle,2,Les Fonctions,9,362,7,QCM,0.03,0.85,66.5,53,26,79,56,53,3,1.41,94.64,Facile,Facile,0,Meme Difficulté,Adapte,Marketing
2609,2017,Marketing,2,Grammaire Lexicale Fonctionnelle,2,Les Fonctions,9,362,7,QCM,0.07,0.93,66.5,49,25,74,62,49,13,1.19,79.03,Facile,Facile,0,Meme Difficulté,Adapte,Marketing
3733,2018,Marketing,2,Grammaire Lexicale Fonctionnelle,2,Les Fonctions,9,362,7,QCU,0.02,0.92,66.5,51,25,76,72,51,21,1.06,70.83,Facile,Facile,0,Meme Difficulté,Adapte,Marketing
4857,2019,Marketing,2,Grammaire Lexicale Fonctionnelle,2,Les Fonctions,9,362,7,QCU,0.09,0.81,66.5,47,24,71,65,47,18,1.09,72.31,Facile,Facile,0,Meme Difficulté,Adapte,Marketing
5981,2020,Marketing,2,Grammaire Lexicale Fonctionnelle,2,Les Fonctions,9,362,7,QCM,0.08,0.82,66.5,46,23,69,52,46,6,1.33,88.46,Facile,Facile,0,Meme Difficulté,Adapte,Marketing
362,2015,Marketing,2,Grammaire Lexicale Fonctionnelle,2,Les Fonctions,9,363,8,QCU,0.53,0.35,15.57,14,76,90,45,14,31,2.0,31.11,Facile,Difficile,-2,Beaucoup plus Difficile,Pas Adapte,Marketing
1486,2016,Marketing,2,Grammaire Lexicale Fonctionnelle,2,Les Fonctions,9,363,8,QCU,0.19,0.76,69.08,61,28,89,62,61,1,1.44,98.39,Difficile,Facile,2,Beaucoup plus Facile,Adapte,Marketing
2610,2017,Marketing,2,Grammaire Lexicale Fonctionnelle,2,Les Fonctions,9,363,8,QCU,0.14,0.94,69.08,66,30,96,92,66,26,1.04,71.74,Facile,Facile,0,Meme Difficulté,Adapte,Marketing
3734,2018,Marketing,2,Grammaire Lexicale Fonctionnelle,2,Les Fonctions,9,363,8,QCU,0.16,0.93,69.08,75,34,109,97,75,22,1.12,77.32,Facile,Facile,0,Meme Difficulté,Adapte,Marketing
4858,2019,Marketing,2,Grammaire Lexicale Fonctionnelle,2,Les Fonctions,9,363,8,QCU,0.06,1.0,69.08,86,39,125,122,86,36,1.02,70.49,Facile,Facile,0,Meme Difficulté,Adapte,Marketing
5982,2020,Marketing,2,Grammaire Lexicale Fonctionnelle,2,Les Fonctions,9,363,8,QCU,0.0,0.99,69.08,97,44,141,141,97,44,1.0,68.79,Facile,Facile,0,Meme Difficulté,Adapte,Marketing
363,2015,Marketing,2,Grammaire Lexicale Fonctionnelle,2,Les Fonctions,9,364,9,QCU,0.67,0.36,9.41,6,57,63,60,6,54,1.05,10.0,Difficile,Difficile,0,Meme Difficulté,Pas Adapte,Marketing
1487,2016,Marketing,2,Grammaire Lexicale Fonctionnelle,2,Les Fonctions,9,364,9,QCU,0.28,0.53,59.35,33,22,55,37,33,4,1.49,89.19,Difficile,Moyen,1,Plus Facile,Pas Adapte,Marketing
2611,2017,Marketing,2,Grammaire Lexicale Fonctionnelle,2,Les Fonctions,9,364,9,QCU,0.16,0.75,85.6,41,7,48,47,41,6,1.02,87.23,Facile,Facile,0,Meme Difficulté,Pas Adapte,Marketing
3735,2018,Marketing,2,Grammaire Lexicale Fonctionnelle,2,Les Fonctions,9,364,9,QCU,0.13,0.98,71.15,31,13,44,34,31,3,1.29,91.18,Moyen,Facile,1,Plus Facile,Adapte,Marketing
4859,2019,Marketing,2,Grammaire Lexicale Fonctionnelle,2,Les Fonctions,9,364,9,QCU,0.14,0.96,71.15,36,14,50,40,36,4,1.25,90.0,Facile,Facile,0,Meme Difficulté,Adapte,Marketing
5983,2020,Marketing,2,Grammaire Lexicale Fonctionnelle,2,Les Fonctions,9,364,9,QCU,0.03,0.85,71.15,33,13,46,45,33,12,1.02,73.33,Facile,Facile,0,Meme Difficulté,Adapte,Marketing
364,2015,Marketing,2,Grammaire Lexicale Fonctionnelle,3,Ecrire une Grammaire Lexicale Fonctionnelle,6,365,1,QCM,0.65,0.24,20.22,1,4,5,3,1,2,1.67,33.33,Facile,Difficile,-2,Beaucoup plus Difficile,Pas Adapte,Marketing
1488,2016,Marketing,2,Grammaire Lexicale Fonctionnelle,3,Ecrire une Grammaire Lexicale Fonctionnelle,6,365,1,QCM,0.09,0.92,76.22,5,1,6,6,5,1,1.0,83.33,Moyen,Facile,1,Plus Facile,Pas Adapte,Marketing
2612,2017,Marketing,2,Grammaire Lexicale Fonctionnelle,3,Ecrire une Grammaire Lexicale Fonctionnelle,6,365,1,QCM,0.39,0.4,63.5,3,2,5,4,3,1,1.25,75.0,Moyen,Moyen,0,Meme Difficulté,Adapte,Marketing
3736,2018,Marketing,2,Grammaire Lexicale Fonctionnelle,3,Ecrire une Grammaire Lexicale Fonctionnelle,6,365,1,QCM,0.42,0.49,63.5,4,2,6,6,4,2,1.0,66.67,Moyen,Moyen,0,Meme Difficulté,Adapte,Marketing
4860,2019,Marketing,2,Grammaire Lexicale Fonctionnelle,3,Ecrire une Grammaire Lexicale Fonctionnelle,6,365,1,QCM,0.41,0.59,63.5,4,3,7,6,4,2,1.17,66.67,Moyen,Moyen,0,Meme Difficulté,Adapte,Marketing
5984,2020,Marketing,2,Grammaire Lexicale Fonctionnelle,3,Ecrire une Grammaire Lexicale Fonctionnelle,6,365,1,QCM,0.34,0.42,63.5,4,3,7,6,4,2,1.17,66.67,Moyen,Moyen,0,Meme Difficulté,Adapte,Marketing
365,2015,Marketing,2,Grammaire Lexicale Fonctionnelle,3,Ecrire une Grammaire Lexicale Fonctionnelle,6,366,2,QCM,0.09,0.85,88.3,69,9,78,73,69,4,1.07,94.52,Facile,Facile,0,Meme Difficulté,Pas Adapte,Marketing
1489,2016,Marketing,2,Grammaire Lexicale Fonctionnelle,3,Ecrire une Grammaire Lexicale Fonctionnelle,6,366,2,QCM,0.76,0.25,15.54,13,69,82,30,13,17,2.73,43.33,Facile,Difficile,-2,Beaucoup plus Difficile,Pas Adapte,Marketing
2613,2017,Marketing,2,Grammaire Lexicale Fonctionnelle,3,Ecrire une Grammaire Lexicale Fonctionnelle,6,366,2,QCU,0.25,0.53,62.49,53,32,85,56,53,3,1.52,94.64,Facile,Moyen,-1,Plus Difficile,Adapte,Marketing
3737,2018,Marketing,2,Grammaire Lexicale Fonctionnelle,3,Ecrire une Grammaire Lexicale Fonctionnelle,6,366,2,QCU,0.35,0.65,62.49,61,37,98,79,61,18,1.24,77.22,Moyen,Moyen,0,Meme Difficulté,Adapte,Marketing
4861,2019,Marketing,2,Grammaire Lexicale Fonctionnelle,3,Ecrire une Grammaire Lexicale Fonctionnelle,6,366,2,QROC,0.57,0.35,62.49,68,41,109,72,68,4,1.51,94.44,Moyen,Moyen,0,Meme Difficulté,Adapte,Marketing
5985,2020,Marketing,2,Grammaire Lexicale Fonctionnelle,3,Ecrire une Grammaire Lexicale Fonctionnelle,6,366,2,QROC,0.36,0.3,62.49,78,47,125,79,78,1,1.58,98.73,Moyen,Moyen,0,Meme Difficulté,Adapte,Marketing
366,2015,Marketing,2,Grammaire Lexicale Fonctionnelle,3,Ecrire une Grammaire Lexicale Fonctionnelle,6,367,3,QO,0.04,0.65,77.81,67,19,86,73,67,6,1.18,91.78,Moyen,Facile,1,Plus Facile,Pas Adapte,Marketing
1490,2016,Marketing,2,Grammaire Lexicale Fonctionnelle,3,Ecrire une Grammaire Lexicale Fonctionnelle,6,367,3,QO,0.69,0.19,42.7,33,44,77,60,33,27,1.28,55.0,Facile,Moyen,-1,Plus Difficile,Pas Adapte,Marketing
2614,2017,Marketing,2,Grammaire Lexicale Fonctionnelle,3,Ecrire une Grammaire Lexicale Fonctionnelle,6,367,3,QO,0.7,0.23,37.94,27,43,70,56,27,29,1.25,48.21,Difficile,Moyen,1,Plus Facile,Pas Adapte,Marketing
3738,2018,Marketing,2,Grammaire Lexicale Fonctionnelle,3,Ecrire une Grammaire Lexicale Fonctionnelle,6,367,3,QO,0.78,0.05,31.53,19,42,61,54,19,35,1.13,35.19,Difficile,Difficile,0,Meme Difficulté,Pas Adapte,Marketing
4862,2019,Marketing,2,Grammaire Lexicale Fonctionnelle,3,Ecrire une Grammaire Lexicale Fonctionnelle,6,367,3,QO,0.93,0.04,22.52,14,50,64,42,14,28,1.52,33.33,Difficile,Difficile,0,Meme Difficulté,Pas Adapte,Marketing
5986,2020,Marketing,2,Grammaire Lexicale Fonctionnelle,3,Ecrire une Grammaire Lexicale Fonctionnelle,6,367,3,QROC,0.34,0.39,50.96,33,31,64,56,33,23,1.14,58.93,Facile,Moyen,-1,Plus Difficile,Pas Adapte,Marketing
367,2015,Marketing,2,Grammaire Lexicale Fonctionnelle,3,Ecrire une Grammaire Lexicale Fonctionnelle,6,368,4,QCM,0.56,0.26,13.67,12,78,90,56,12,44,1.61,21.43,Facile,Difficile,-2,Beaucoup plus Difficile,Pas Adapte,Marketing
1491,2016,Marketing,2,Grammaire Lexicale Fonctionnelle,3,Ecrire une Grammaire Lexicale Fonctionnelle,6,368,4,QCM,0.7,0.27,7.73,7,78,85,62,7,55,1.37,11.29,Moyen,Difficile,-1,Plus Difficile,Pas Adapte,Marketing
2615,2017,Marketing,2,Grammaire Lexicale Fonctionnelle,3,Ecrire une Grammaire Lexicale Fonctionnelle,6,368,4,QCM,0.65,0.17,11.6,8,64,72,38,8,30,1.89,21.05,Difficile,Difficile,0,Meme Difficulté,Pas Adapte,Marketing
3739,2018,Marketing,2,Grammaire Lexicale Fonctionnelle,3,Ecrire une Grammaire Lexicale Fonctionnelle,6,368,4,QCM,0.02,0.93,74.35,56,19,75,63,56,7,1.19,88.89,Difficile,Facile,2,Beaucoup plus Facile,Adapte,Marketing
4863,2019,Marketing,2,Grammaire Lexicale Fonctionnelle,3,Ecrire une Grammaire Lexicale Fonctionnelle,6,368,4,QCU,0.08,0.97,74.35,48,16,64,50,48,2,1.28,96.0,Facile,Facile,0,Meme Difficulté,Adapte,Marketing
5987,2020,Marketing,2,Grammaire Lexicale Fonctionnelle,3,Ecrire une Grammaire Lexicale Fonctionnelle,6,368,4,QCU,0.09,0.9,74.35,52,18,70,61,52,9,1.15,85.25,Facile,Facile,0,Meme Difficulté,Adapte,Marketing
368,2015,Marketing,2,Grammaire Lexicale Fonctionnelle,3,Ecrire une Grammaire Lexicale Fonctionnelle,6,369,5,QCM,0.04,0.82,87.52,47,7,54,49,47,2,1.1,95.92,Difficile,Facile,2,Beaucoup plus Facile,Pas Adapte,Marketing
1492,2016,Marketing,2,Grammaire Lexicale Fonctionnelle,3,Ecrire une Grammaire Lexicale Fonctionnelle,6,369,5,QCM,0.53,0.21,2.47,1,53,54,20,1,19,2.7,5.0,Moyen,Difficile,-1,Plus Difficile,Pas Adapte,Marketing
2616,2017,Marketing,2,Grammaire Lexicale Fonctionnelle,3,Ecrire une Grammaire Lexicale Fonctionnelle,6,369,5,QCM,0.7,0.16,21.74,13,47,60,24,13,11,2.5,54.17,Moyen,Difficile,-1,Plus Difficile,Pas Adapte,Marketing
3740,2018,Marketing,2,Grammaire Lexicale Fonctionnelle,3,Ecrire une Grammaire Lexicale Fonctionnelle,6,369,5,QCM,0.74,0.23,0.55,0,55,55,19,0,19,2.89,0.0,Difficile,Difficile,0,Meme Difficulté,Pas Adapte,Marketing
4864,2019,Marketing,2,Grammaire Lexicale Fonctionnelle,3,Ecrire une Grammaire Lexicale Fonctionnelle,6,369,5,QCM,0.31,0.48,49.51,31,32,63,56,31,25,1.12,55.36,Moyen,Moyen,0,Meme Difficulté,Pas Adapte,Marketing
5988,2020,Marketing,2,Grammaire Lexicale Fonctionnelle,3,Ecrire une Grammaire Lexicale Fonctionnelle,6,369,5,QCM,0.43,0.43,37.69,26,44,70,57,26,31,1.23,45.61,Moyen,Moyen,0,Meme Difficulté,Pas Adapte,Marketing
369,2015,Marketing,2,Grammaire Lexicale Fonctionnelle,3,Ecrire une Grammaire Lexicale Fonctionnelle,6,370,6,QCU,0.19,0.97,90.13,49,5,54,50,49,1,1.08,98.0,Facile,Facile,0,Meme Difficulté,Pas Adapte,Marketing
1493,2016,Marketing,2,Grammaire Lexicale Fonctionnelle,3,Ecrire une Grammaire Lexicale Fonctionnelle,6,370,6,QCU,0.64,0.33,29.53,17,40,57,42,17,25,1.36,40.48,Facile,Difficile,-2,Beaucoup plus Difficile,Pas Adapte,Marketing
2617,2017,Marketing,2,Grammaire Lexicale Fonctionnelle,3,Ecrire une Grammaire Lexicale Fonctionnelle,6,370,6,QCU,0.05,0.95,79.13,47,12,59,51,47,4,1.16,92.16,Difficile,Facile,2,Beaucoup plus Facile,Pas Adapte,Marketing
3741,2018,Marketing,2,Grammaire Lexicale Fonctionnelle,3,Ecrire une Grammaire Lexicale Fonctionnelle,6,370,6,QCU,0.08,0.88,72.6,49,19,68,50,49,1,1.36,98.0,Difficile,Facile,2,Beaucoup plus Facile,Adapte,Marketing
4865,2019,Marketing,2,Grammaire Lexicale Fonctionnelle,3,Ecrire une Grammaire Lexicale Fonctionnelle,6,370,6,QCU,0.18,0.78,72.6,46,17,63,63,46,17,1.0,73.02,Facile,Facile,0,Meme Difficulté,Adapte,Marketing
5989,2020,Marketing,2,Grammaire Lexicale Fonctionnelle,3,Ecrire une Grammaire Lexicale Fonctionnelle,6,370,6,QCU,0.12,0.99,72.6,44,17,61,57,44,13,1.07,77.19,Facile,Facile,0,Meme Difficulté,Adapte,Marketing
370,2015,Marketing,2,Grammaire Lexicale Fonctionnelle,4,Diversite des Fonctions Grammaticales,10,371,1,QCM,0.26,0.5,64.79,59,32,91,72,59,13,1.26,81.94,Difficile,Moyen,1,Plus Facile,Adapte,Marketing
1494,2016,Marketing,2,Grammaire Lexicale Fonctionnelle,4,Diversite des Fonctions Grammaticales,10,371,1,QCM,0.24,0.49,64.79,66,36,102,84,66,18,1.21,78.57,Moyen,Moyen,0,Meme Difficulté,Adapte,Marketing
2618,2017,Marketing,2,Grammaire Lexicale Fonctionnelle,4,Diversite des Fonctions Grammaticales,10,371,1,QCM,0.33,0.69,64.79,65,36,101,81,65,16,1.25,80.25,Moyen,Moyen,0,Meme Difficulté,Adapte,Marketing
3742,2018,Marketing,2,Grammaire Lexicale Fonctionnelle,4,Diversite des Fonctions Grammaticales,10,371,1,QCM,0.49,0.65,64.79,67,37,104,103,67,36,1.01,65.05,Moyen,Moyen,0,Meme Difficulté,Adapte,Marketing
4866,2019,Marketing,2,Grammaire Lexicale Fonctionnelle,4,Diversite des Fonctions Grammaticales,10,371,1,QCM,0.48,0.33,64.79,61,33,94,84,61,23,1.12,72.62,Moyen,Moyen,0,Meme Difficulté,Adapte,Marketing
5990,2020,Marketing,2,Grammaire Lexicale Fonctionnelle,4,Diversite des Fonctions Grammaticales,10,371,1,QCM,0.28,0.49,64.79,63,34,97,78,63,15,1.24,80.77,Moyen,Moyen,0,Meme Difficulté,Adapte,Marketing
371,2015,Marketing,2,Grammaire Lexicale Fonctionnelle,4,Diversite des Fonctions Grammaticales,10,372,2,QCU,0.07,0.82,92.65,27,2,29,28,27,1,1.04,96.43,Difficile,Facile,2,Beaucoup plus Facile,Pas Adapte,Marketing
1495,2016,Marketing,2,Grammaire Lexicale Fonctionnelle,4,Diversite des Fonctions Grammaticales,10,372,2,QCU,0.19,0.85,94.87,27,1,28,27,27,0,1.04,100.0,Moyen,Facile,1,Plus Facile,Pas Adapte,Marketing
2619,2017,Marketing,2,Grammaire Lexicale Fonctionnelle,4,Diversite des Fonctions Grammaticales,10,372,2,QROC,0.8,0.2,2.79,1,23,24,20,1,19,1.2,5.0,Facile,Difficile,-2,Beaucoup plus Difficile,Pas Adapte,Marketing
3743,2018,Marketing,2,Grammaire Lexicale Fonctionnelle,4,Diversite des Fonctions Grammaticales,10,372,2,QROC,0.02,0.59,80.6,18,4,22,22,18,4,1.0,81.82,Difficile,Facile,2,Beaucoup plus Facile,Pas Adapte,Marketing
4867,2019,Marketing,2,Grammaire Lexicale Fonctionnelle,4,Diversite des Fonctions Grammaticales,10,372,2,QROC,0.44,0.3,63.31,14,8,22,20,14,6,1.1,70.0,Facile,Moyen,-1,Plus Difficile,Adapte,Marketing
5991,2020,Marketing,2,Grammaire Lexicale Fonctionnelle,4,Diversite des Fonctions Grammaticales,10,372,2,QROC,0.29,0.32,63.31,13,7,20,13,13,0,1.54,100.0,Moyen,Moyen,0,Meme Difficulté,Adapte,Marketing
372,2015,Marketing,2,Grammaire Lexicale Fonctionnelle,4,Diversite des Fonctions Grammaticales,10,373,3,QCM,0.54,0.2,29.32,16,38,54,48,16,32,1.12,33.33,Facile,Difficile,-2,Beaucoup plus Difficile,Pas Adapte,Marketing
1496,2016,Marketing,2,Grammaire Lexicale Fonctionnelle,4,Diversite des Fonctions Grammaticales,10,373,3,QCM,0.0,0.78,73.99,34,12,46,40,34,6,1.15,85.0,Difficile,Facile,2,Beaucoup plus Facile,Adapte,Marketing
2620,2017,Marketing,2,Grammaire Lexicale Fonctionnelle,4,Diversite des Fonctions Grammaticales,10,373,3,QCM,0.12,0.92,73.99,38,13,51,47,38,9,1.09,80.85,Facile,Facile,0,Meme Difficulté,Adapte,Marketing
3744,2018,Marketing,2,Grammaire Lexicale Fonctionnelle,4,Diversite des Fonctions Grammaticales,10,373,3,QCM,0.14,0.76,73.99,42,15,57,51,42,9,1.12,82.35,Facile,Facile,0,Meme Difficulté,Adapte,Marketing
4868,2019,Marketing,2,Grammaire Lexicale Fonctionnelle,4,Diversite des Fonctions Grammaticales,10,373,3,QCM,0.08,0.89,73.99,41,14,55,47,41,6,1.17,87.23,Facile,Facile,0,Meme Difficulté,Adapte,Marketing
5992,2020,Marketing,2,Grammaire Lexicale Fonctionnelle,4,Diversite des Fonctions Grammaticales,10,373,3,QCU,0.08,0.81,73.99,38,14,52,47,38,9,1.11,80.85,Facile,Facile,0,Meme Difficulté,Adapte,Marketing
373,2015,Marketing,2,Grammaire Lexicale Fonctionnelle,4,Diversite des Fonctions Grammaticales,10,374,4,QCU,0.64,0.26,4.27,1,20,21,12,1,11,1.75,8.33,Moyen,Difficile,-1,Plus Difficile,Pas Adapte,Marketing
1497,2016,Marketing,2,Grammaire Lexicale Fonctionnelle,4,Diversite des Fonctions Grammaticales,10,374,4,QCU,0.26,0.62,45.48,9,10,19,13,9,4,1.46,69.23,Facile,Moyen,-1,Plus Difficile,Pas Adapte,Marketing
2621,2017,Marketing,2,Grammaire Lexicale Fonctionnelle,4,Diversite des Fonctions Grammaticales,10,374,4,QCU,0.62,0.35,11.67,2,14,16,10,2,8,1.6,20.0,Moyen,Difficile,-1,Plus Difficile,Pas Adapte,Marketing
3745,2018,Marketing,2,Grammaire Lexicale Fonctionnelle,4,Diversite des Fonctions Grammaticales,10,374,4,QCU,0.18,0.81,79.13,11,3,14,13,11,2,1.08,84.62,Difficile,Facile,2,Beaucoup plus Facile,Pas Adapte,Marketing
4869,2019,Marketing,2,Grammaire Lexicale Fonctionnelle,4,Diversite des Fonctions Grammaticales,10,374,4,QCM,0.01,0.87,92.89,14,1,15,15,14,1,1.0,93.33,Moyen,Facile,1,Plus Facile,Pas Adapte,Marketing
5993,2020,Marketing,2,Grammaire Lexicale Fonctionnelle,4,Diversite des Fonctions Grammaticales,10,374,4,QCM,0.78,0.16,5.42,1,14,15,7,1,6,2.14,14.29,Difficile,Difficile,0,Meme Difficulté,Pas Adapte,Marketing
374,2015,Marketing,2,Grammaire Lexicale Fonctionnelle,4,Diversite des Fonctions Grammaticales,10,375,5,QO,0.82,0.11,16.88,15,74,89,61,15,46,1.46,24.59,Moyen,Difficile,-1,Plus Difficile,Pas Adapte,Marketing
1498,2016,Marketing,2,Grammaire Lexicale Fonctionnelle,4,Diversite des Fonctions Grammaticales,10,375,5,QO,0.04,0.35,93.31,84,6,90,85,84,1,1.06,98.82,Moyen,Facile,1,Plus Facile,Pas Adapte,Marketing
2622,2017,Marketing,2,Grammaire Lexicale Fonctionnelle,4,Diversite des Fonctions Grammaticales,10,375,5,QO,0.82,0.12,13.9,12,74,86,86,12,74,1.0,13.95,Difficile,Difficile,0,Meme Difficulté,Pas Adapte,Marketing
3746,2018,Marketing,2,Grammaire Lexicale Fonctionnelle,4,Diversite des Fonctions Grammaticales,10,375,5,QO,0.1,0.89,96.24,72,3,75,72,72,0,1.04,100.0,Difficile,Facile,2,Beaucoup plus Facile,Pas Adapte,Marketing
4870,2019,Marketing,2,Grammaire Lexicale Fonctionnelle,4,Diversite des Fonctions Grammaticales,10,375,5,QO,0.75,0.09,26.69,22,61,83,64,22,42,1.3,34.38,Difficile,Difficile,0,Meme Difficulté,Pas Adapte,Marketing
5994,2020,Marketing,2,Grammaire Lexicale Fonctionnelle,4,Diversite des Fonctions Grammaticales,10,375,5,QO,0.19,0.98,72.57,62,24,86,83,62,21,1.04,74.7,Facile,Facile,0,Meme Difficulté,Adapte,Marketing
375,2015,Marketing,2,Grammaire Lexicale Fonctionnelle,4,Diversite des Fonctions Grammaticales,10,376,6,QCU,0.19,0.96,73.52,11,4,15,11,11,0,1.36,100.0,Facile,Facile,0,Meme Difficulté,Adapte,Marketing
1499,2016,Marketing,2,Grammaire Lexicale Fonctionnelle,4,Diversite des Fonctions Grammaticales,10,376,6,QCU,0.12,0.83,73.52,12,4,16,13,12,1,1.23,92.31,Facile,Facile,0,Meme Difficulté,Adapte,Marketing
2623,2017,Marketing,2,Grammaire Lexicale Fonctionnelle,4,Diversite des Fonctions Grammaticales,10,376,6,QCU,0.06,0.94,73.52,13,5,18,15,13,2,1.2,86.67,Facile,Facile,0,Meme Difficulté,Adapte,Marketing
3747,2018,Marketing,2,Grammaire Lexicale Fonctionnelle,4,Diversite des Fonctions Grammaticales,10,376,6,QCU,0.09,0.99,73.52,11,4,15,12,11,1,1.25,91.67,Facile,Facile,0,Meme Difficulté,Adapte,Marketing
4871,2019,Marketing,2,Grammaire Lexicale Fonctionnelle,4,Diversite des Fonctions Grammaticales,10,376,6,QCU,0.07,0.98,73.52,10,3,13,10,10,0,1.3,100.0,Facile,Facile,0,Meme Difficulté,Adapte,Marketing
5995,2020,Marketing,2,Grammaire Lexicale Fonctionnelle,4,Diversite des Fonctions Grammaticales,10,376,6,QROC,0.04,0.43,73.52,11,4,15,12,11,1,1.25,91.67,Facile,Facile,0,Meme Difficulté,Adapte,Marketing
376,2015,Marketing,2,Grammaire Lexicale Fonctionnelle,4,Diversite des Fonctions Grammaticales,10,377,7,QCU,0.29,0.42,47.76,33,36,69,35,33,2,1.97,94.29,Difficile,Moyen,1,Plus Facile,Pas Adapte,Marketing
1500,2016,Marketing,2,Grammaire Lexicale Fonctionnelle,4,Diversite des Fonctions Grammaticales,10,377,7,QCU,0.46,0.4,12.17,9,62,71,37,9,28,1.92,24.32,Facile,Difficile,-2,Beaucoup plus Difficile,Pas Adapte,Marketing
2624,2017,Marketing,2,Grammaire Lexicale Fonctionnelle,4,Diversite des Fonctions Grammaticales,10,377,7,QCU,0.26,0.51,61.36,39,25,64,60,39,21,1.07,65.0,Moyen,Moyen,0,Meme Difficulté,Adapte,Marketing
3748,2018,Marketing,2,Grammaire Lexicale Fonctionnelle,4,Diversite des Fonctions Grammaticales,10,377,7,QCU,0.31,0.48,61.36,44,28,72,68,44,24,1.06,64.71,Moyen,Moyen,0,Meme Difficulté,Adapte,Marketing
4872,2019,Marketing,2,Grammaire Lexicale Fonctionnelle,4,Diversite des Fonctions Grammaticales,10,377,7,QCU,0.26,0.68,61.36,41,25,66,45,41,4,1.47,91.11,Moyen,Moyen,0,Meme Difficulté,Adapte,Marketing
5996,2020,Marketing,2,Grammaire Lexicale Fonctionnelle,4,Diversite des Fonctions Grammaticales,10,377,7,QCU,0.37,0.63,61.36,39,25,64,48,39,9,1.33,81.25,Moyen,Moyen,0,Meme Difficulté,Adapte,Marketing
377,2015,Marketing,2,Grammaire Lexicale Fonctionnelle,4,Diversite des Fonctions Grammaticales,10,378,8,QCU,0.4,0.41,48.3,31,33,64,58,31,27,1.1,53.45,Moyen,Moyen,0,Meme Difficulté,Pas Adapte,Marketing
1501,2016,Marketing,2,Grammaire Lexicale Fonctionnelle,4,Diversite des Fonctions Grammaticales,10,378,8,QCU,0.02,0.79,78.47,53,15,68,55,53,2,1.24,96.36,Difficile,Facile,2,Beaucoup plus Facile,Pas Adapte,Marketing
2625,2017,Marketing,2,Grammaire Lexicale Fonctionnelle,4,Diversite des Fonctions Grammaticales,10,378,8,QROC,0.68,0.14,33.19,23,45,68,53,23,30,1.28,43.4,Difficile,Difficile,0,Meme Difficulté,Pas Adapte,Marketing
3749,2018,Marketing,2,Grammaire Lexicale Fonctionnelle,4,Diversite des Fonctions Grammaticales,10,378,8,QROC,0.02,0.44,79.11,52,14,66,64,52,12,1.03,81.25,Facile,Facile,0,Meme Difficulté,Pas Adapte,Marketing
4873,2019,Marketing,2,Grammaire Lexicale Fonctionnelle,4,Diversite des Fonctions Grammaticales,10,378,8,QROC,0.04,0.43,86.67,61,9,70,63,61,2,1.11,96.83,Facile,Facile,0,Meme Difficulté,Pas Adapte,Marketing
5997,2020,Marketing,2,Grammaire Lexicale Fonctionnelle,4,Diversite des Fonctions Grammaticales,10,378,8,QROC,0.81,0.09,24.72,20,59,79,51,20,31,1.55,39.22,Moyen,Difficile,-1,Plus Difficile,Pas Adapte,Marketing
378,2015,Marketing,2,Grammaire Lexicale Fonctionnelle,4,Diversite des Fonctions Grammaticales,10,379,9,QROC,0.34,0.36,64.13,17,10,27,18,17,1,1.5,94.44,Difficile,Moyen,1,Plus Facile,Adapte,Marketing
1502,2016,Marketing,2,Grammaire Lexicale Fonctionnelle,4,Diversite des Fonctions Grammaticales,10,379,9,QO,0.43,0.18,64.13,17,10,27,23,17,6,1.17,73.91,Moyen,Moyen,0,Meme Difficulté,Adapte,Marketing
2626,2017,Marketing,2,Grammaire Lexicale Fonctionnelle,4,Diversite des Fonctions Grammaticales,10,379,9,QO,0.49,0.29,64.13,17,10,27,20,17,3,1.35,85.0,Moyen,Moyen,0,Meme Difficulté,Adapte,Marketing
3750,2018,Marketing,2,Grammaire Lexicale Fonctionnelle,4,Diversite des Fonctions Grammaticales,10,379,9,QO,0.62,0.17,64.13,19,10,29,28,19,9,1.04,67.86,Moyen,Moyen,0,Meme Difficulté,Adapte,Marketing
4874,2019,Marketing,2,Grammaire Lexicale Fonctionnelle,4,Diversite des Fonctions Grammaticales,10,379,9,QO,0.45,0.22,64.13,16,9,25,17,16,1,1.47,94.12,Moyen,Moyen,0,Meme Difficulté,Adapte,Marketing
5998,2020,Marketing,2,Grammaire Lexicale Fonctionnelle,4,Diversite des Fonctions Grammaticales,10,379,9,QO,0.7,0.22,64.13,17,10,27,24,17,7,1.12,70.83,Moyen,Moyen,0,Meme Difficulté,Adapte,Marketing
379,2015,Marketing,2,Grammaire Lexicale Fonctionnelle,4,Diversite des Fonctions Grammaticales,10,380,10,QCM,0.47,0.6,55.67,4,3,7,4,4,0,1.75,100.0,Facile,Moyen,-1,Plus Difficile,Pas Adapte,Marketing
1503,2016,Marketing,2,Grammaire Lexicale Fonctionnelle,4,Diversite des Fonctions Grammaticales,10,380,10,QCM,0.01,0.76,88.9,5,1,6,5,5,0,1.2,100.0,Moyen,Facile,1,Plus Facile,Pas Adapte,Marketing
2627,2017,Marketing,2,Grammaire Lexicale Fonctionnelle,4,Diversite des Fonctions Grammaticales,10,380,10,QCM,0.08,0.83,99.08,5,0,5,5,5,0,1.0,100.0,Facile,Facile,0,Meme Difficulté,Pas Adapte,Marketing
3751,2018,Marketing,2,Grammaire Lexicale Fonctionnelle,4,Diversite des Fonctions Grammaticales,10,380,10,QCM,0.44,0.68,64.85,4,2,6,4,4,0,1.5,100.0,Facile,Moyen,-1,Plus Difficile,Adapte,Marketing
4875,2019,Marketing,2,Grammaire Lexicale Fonctionnelle,4,Diversite des Fonctions Grammaticales,10,380,10,QCM,0.3,0.55,64.85,4,2,6,6,4,2,1.0,66.67,Moyen,Moyen,0,Meme Difficulté,Adapte,Marketing
5999,2020,Marketing,2,Grammaire Lexicale Fonctionnelle,4,Diversite des Fonctions Grammaticales,10,380,10,QCM,0.29,0.39,64.85,4,2,6,6,4,2,1.0,66.67,Moyen,Moyen,0,Meme Difficulté,Adapte,Marketing
380,2015,Marketing,3,Grammaire et Syntaxe,1,Les Subordonnees,14,381,1,QCU,0.07,0.91,77.64,48,14,62,51,48,3,1.22,94.12,Facile,Facile,0,Meme Difficulté,Pas Adapte,Marketing
1504,2016,Marketing,3,Grammaire et Syntaxe,1,Les Subordonnees,14,381,1,QCM,0.63,0.23,7.36,5,63,68,51,5,46,1.33,9.8,Facile,Difficile,-2,Beaucoup plus Difficile,Pas Adapte,Marketing
2628,2017,Marketing,3,Grammaire et Syntaxe,1,Les Subordonnees,14,381,1,QCM,0.16,0.79,79.82,54,14,68,66,54,12,1.03,81.82,Moyen,Facile,1,Plus Facile,Pas Adapte,Marketing
3752,2018,Marketing,3,Grammaire et Syntaxe,1,Les Subordonnees,14,381,1,QCU,0.26,0.51,48.51,37,39,76,57,37,20,1.33,64.91,Difficile,Moyen,1,Plus Facile,Pas Adapte,Marketing
4876,2019,Marketing,3,Grammaire et Syntaxe,1,Les Subordonnees,14,381,1,QCU,0.2,0.61,57.0,43,32,75,60,43,17,1.25,71.67,Facile,Moyen,-1,Plus Difficile,Pas Adapte,Marketing
6000,2020,Marketing,3,Grammaire et Syntaxe,1,Les Subordonnees,14,381,1,QCU,0.71,0.28,11.18,7,58,65,58,7,51,1.12,12.07,Difficile,Difficile,0,Meme Difficulté,Pas Adapte,Marketing
381,2015,Marketing,3,Grammaire et Syntaxe,1,Les Subordonnees,14,382,2,QCU,0.69,0.3,16.25,6,29,35,29,6,23,1.21,20.69,Difficile,Difficile,0,Meme Difficulté,Pas Adapte,Marketing
1505,2016,Marketing,3,Grammaire et Syntaxe,1,Les Subordonnees,14,382,2,QCU,0.0,0.96,76.86,30,9,39,30,30,0,1.3,100.0,Facile,Facile,0,Meme Difficulté,Pas Adapte,Marketing
2629,2017,Marketing,3,Grammaire et Syntaxe,1,Les Subordonnees,14,382,2,QCU,0.08,0.98,97.41,41,1,42,42,41,1,1.0,97.62,Moyen,Facile,1,Plus Facile,Pas Adapte,Marketing
3753,2018,Marketing,3,Grammaire et Syntaxe,1,Les Subordonnees,14,382,2,QCU,0.62,0.27,31.59,12,26,38,17,12,5,2.24,70.59,Moyen,Difficile,-1,Plus Difficile,Pas Adapte,Marketing
4877,2019,Marketing,3,Grammaire et Syntaxe,1,Les Subordonnees,14,382,2,QCU,0.6,0.26,24.03,9,30,39,35,9,26,1.11,25.71,Facile,Difficile,-2,Beaucoup plus Difficile,Pas Adapte,Marketing
6001,2020,Marketing,3,Grammaire et Syntaxe,1,Les Subordonnees,14,382,2,QCU,0.27,0.48,39.66,14,21,35,24,14,10,1.46,58.33,Difficile,Moyen,1,Plus Facile,Pas Adapte,Marketing
382,2015,Marketing,3,Grammaire et Syntaxe,1,Les Subordonnees,14,383,3,QCM,0.11,0.78,73.58,50,18,68,53,50,3,1.28,94.34,Facile,Facile,0,Meme Difficulté,Adapte,Marketing
1506,2016,Marketing,3,Grammaire et Syntaxe,1,Les Subordonnees,14,383,3,QCM,0.07,0.82,73.58,57,21,78,72,57,15,1.08,79.17,Facile,Facile,0,Meme Difficulté,Adapte,Marketing
2630,2017,Marketing,3,Grammaire et Syntaxe,1,Les Subordonnees,14,383,3,QCM,0.07,0.98,73.58,62,22,84,66,62,4,1.27,93.94,Facile,Facile,0,Meme Difficulté,Adapte,Marketing
3754,2018,Marketing,3,Grammaire et Syntaxe,1,Les Subordonnees,14,383,3,QCM,0.17,0.97,73.58,64,23,87,70,64,6,1.24,91.43,Facile,Facile,0,Meme Difficulté,Adapte,Marketing
4878,2019,Marketing,3,Grammaire et Syntaxe,1,Les Subordonnees,14,383,3,QCU,0.04,0.8,73.58,68,24,92,69,68,1,1.33,98.55,Facile,Facile,0,Meme Difficulté,Adapte,Marketing
6002,2020,Marketing,3,Grammaire et Syntaxe,1,Les Subordonnees,14,383,3,QCU,0.05,0.84,73.58,66,24,90,79,66,13,1.14,83.54,Facile,Facile,0,Meme Difficulté,Adapte,Marketing
383,2015,Marketing,3,Grammaire et Syntaxe,1,Les Subordonnees,14,384,4,QO,0.82,0.12,18.44,12,55,67,47,12,35,1.43,25.53,Facile,Difficile,-2,Beaucoup plus Difficile,Pas Adapte,Marketing
1507,2016,Marketing,3,Grammaire et Syntaxe,1,Les Subordonnees,14,384,4,QO,0.1,0.93,92.0,68,6,74,73,68,5,1.01,93.15,Facile,Facile,0,Meme Difficulté,Pas Adapte,Marketing
2631,2017,Marketing,3,Grammaire et Syntaxe,1,Les Subordonnees,14,384,4,QO,0.95,0.06,21.43,16,57,73,39,16,23,1.87,41.03,Difficile,Difficile,0,Meme Difficulté,Pas Adapte,Marketing
3755,2018,Marketing,3,Grammaire et Syntaxe,1,Les Subordonnees,14,384,4,QO,0.08,0.54,77.5,50,15,65,57,50,7,1.14,87.72,Difficile,Facile,2,Beaucoup plus Facile,Pas Adapte,Marketing
4879,2019,Marketing,3,Grammaire et Syntaxe,1,Les Subordonnees,14,384,4,QO,0.08,0.78,96.35,65,2,67,65,65,0,1.03,100.0,Difficile,Facile,2,Beaucoup plus Facile,Pas Adapte,Marketing
6003,2020,Marketing,3,Grammaire et Syntaxe,1,Les Subordonnees,14,384,4,QO,0.84,0.1,7.03,5,69,74,67,5,62,1.1,7.46,Facile,Difficile,-2,Beaucoup plus Difficile,Pas Adapte,Marketing
384,2015,Marketing,3,Grammaire et Syntaxe,1,Les Subordonnees,14,385,5,QROC,0.27,0.32,60.18,51,33,84,70,51,19,1.2,72.86,Moyen,Moyen,0,Meme Difficulté,Adapte,Marketing
1508,2016,Marketing,3,Grammaire et Syntaxe,1,Les Subordonnees,14,385,5,QROC,0.33,0.4,60.18,52,35,87,64,52,12,1.36,81.25,Moyen,Moyen,0,Meme Difficulté,Adapte,Marketing
2632,2017,Marketing,3,Grammaire et Syntaxe,1,Les Subordonnees,14,385,5,QO,0.29,0.28,60.18,58,38,96,86,58,28,1.12,67.44,Moyen,Moyen,0,Meme Difficulté,Adapte,Marketing
3756,2018,Marketing,3,Grammaire et Syntaxe,1,Les Subordonnees,14,385,5,QO,0.53,0.16,60.18,54,35,89,60,54,6,1.48,90.0,Moyen,Moyen,0,Meme Difficulté,Adapte,Marketing
4880,2019,Marketing,3,Grammaire et Syntaxe,1,Les Subordonnees,14,385,5,QO,0.54,0.16,60.18,52,34,86,82,52,30,1.05,63.41,Moyen,Moyen,0,Meme Difficulté,Adapte,Marketing
6004,2020,Marketing,3,Grammaire et Syntaxe,1,Les Subordonnees,14,385,5,QO,0.54,0.22,60.18,53,35,88,67,53,14,1.31,79.1,Moyen,Moyen,0,Meme Difficulté,Adapte,Marketing
385,2015,Marketing,3,Grammaire et Syntaxe,1,Les Subordonnees,14,386,6,QCU,0.37,0.56,61.22,12,8,20,17,12,5,1.18,70.59,Difficile,Moyen,1,Plus Facile,Adapte,Marketing
1509,2016,Marketing,3,Grammaire et Syntaxe,1,Les Subordonnees,14,386,6,QCU,0.34,0.68,61.22,12,7,19,13,12,1,1.46,92.31,Moyen,Moyen,0,Meme Difficulté,Adapte,Marketing
2633,2017,Marketing,3,Grammaire et Syntaxe,1,Les Subordonnees,14,386,6,QCU,0.31,0.55,61.22,12,8,20,15,12,3,1.33,80.0,Moyen,Moyen,0,Meme Difficulté,Adapte,Marketing
3757,2018,Marketing,3,Grammaire et Syntaxe,1,Les Subordonnees,14,386,6,QCU,0.34,0.71,61.22,12,7,19,13,12,1,1.46,92.31,Moyen,Moyen,0,Meme Difficulté,Adapte,Marketing
4881,2019,Marketing,3,Grammaire et Syntaxe,1,Les Subordonnees,14,386,6,QCU,0.28,0.65,61.22,12,7,19,15,12,3,1.27,80.0,Moyen,Moyen,0,Meme Difficulté,Adapte,Marketing
6005,2020,Marketing,3,Grammaire et Syntaxe,1,Les Subordonnees,14,386,6,QCU,0.3,0.49,61.22,13,8,21,17,13,4,1.24,76.47,Moyen,Moyen,0,Meme Difficulté,Adapte,Marketing
386,2015,Marketing,3,Grammaire et Syntaxe,1,Les Subordonnees,14,387,7,QCU,0.55,0.29,10.12,7,66,73,32,7,25,2.28,21.88,Moyen,Difficile,-1,Plus Difficile,Pas Adapte,Marketing
1510,2016,Marketing,3,Grammaire et Syntaxe,1,Les Subordonnees,14,387,7,QCU,0.12,0.84,69.05,53,24,77,74,53,21,1.04,71.62,Facile,Facile,0,Meme Difficulté,Adapte,Marketing
2634,2017,Marketing,3,Grammaire et Syntaxe,1,Les Subordonnees,14,387,7,QCU,0.16,0.84,69.05,53,24,77,76,53,23,1.01,69.74,Facile,Facile,0,Meme Difficulté,Adapte,Marketing
3758,2018,Marketing,3,Grammaire et Syntaxe,1,Les Subordonnees,14,387,7,QROC,0.05,0.7,69.05,55,24,79,57,55,2,1.39,96.49,Facile,Facile,0,Meme Difficulté,Adapte,Marketing
4882,2019,Marketing,3,Grammaire et Syntaxe,1,Les Subordonnees,14,387,7,QROC,0.07,0.88,69.05,63,28,91,76,63,13,1.2,82.89,Facile,Facile,0,Meme Difficulté,Adapte,Marketing
6006,2020,Marketing,3,Grammaire et Syntaxe,1,Les Subordonnees,14,387,7,QO,0.01,0.88,69.05,54,24,78,69,54,15,1.13,78.26,Facile,Facile,0,Meme Difficulté,Adapte,Marketing
387,2015,Marketing,3,Grammaire et Syntaxe,1,Les Subordonnees,14,388,8,QCU,0.63,0.25,14.62,2,10,12,6,2,4,2.0,33.33,Facile,Difficile,-2,Beaucoup plus Difficile,Pas Adapte,Marketing
1511,2016,Marketing,3,Grammaire et Syntaxe,1,Les Subordonnees,14,388,8,QCM,0.28,0.53,52.55,6,6,12,12,6,6,1.0,50.0,Facile,Moyen,-1,Plus Difficile,Pas Adapte,Marketing
2635,2017,Marketing,3,Grammaire et Syntaxe,1,Les Subordonnees,14,388,8,QCM,0.15,0.99,82.67,8,2,10,10,8,2,1.0,80.0,Difficile,Facile,2,Beaucoup plus Facile,Pas Adapte,Marketing
3759,2018,Marketing,3,Grammaire et Syntaxe,1,Les Subordonnees,14,388,8,QO,0.8,0.04,27.08,2,7,9,8,2,6,1.12,25.0,Facile,Difficile,-2,Beaucoup plus Difficile,Pas Adapte,Marketing
4883,2019,Marketing,3,Grammaire et Syntaxe,1,Les Subordonnees,14,388,8,QO,0.13,0.97,84.39,8,1,9,9,8,1,1.0,88.89,Facile,Facile,0,Meme Difficulté,Pas Adapte,Marketing
6007,2020,Marketing,3,Grammaire et Syntaxe,1,Les Subordonnees,14,388,8,QO,0.41,0.2,45.87,4,5,9,8,4,4,1.12,50.0,Moyen,Moyen,0,Meme Difficulté,Pas Adapte,Marketing
388,2015,Marketing,3,Grammaire et Syntaxe,1,Les Subordonnees,14,389,9,QCM,0.04,0.92,73.01,12,4,16,14,12,2,1.14,85.71,Moyen,Facile,1,Plus Facile,Adapte,Marketing
1512,2016,Marketing,3,Grammaire et Syntaxe,1,Les Subordonnees,14,389,9,QCM,0.05,0.86,73.01,11,4,15,13,11,2,1.15,84.62,Facile,Facile,0,Meme Difficulté,Adapte,Marketing
2636,2017,Marketing,3,Grammaire et Syntaxe,1,Les Subordonnees,14,389,9,QCM,0.18,0.96,73.01,9,4,13,13,9,4,1.0,69.23,Facile,Facile,0,Meme Difficulté,Adapte,Marketing
3760,2018,Marketing,3,Grammaire et Syntaxe,1,Les Subordonnees,14,389,9,QROC,0.1,0.63,73.01,9,3,12,10,9,1,1.2,90.0,Facile,Facile,0,Meme Difficulté,Adapte,Marketing
4884,2019,Marketing,3,Grammaire et Syntaxe,1,Les Subordonnees,14,389,9,QROC,0.04,0.48,73.01,9,4,13,9,9,0,1.44,100.0,Facile,Facile,0,Meme Difficulté,Adapte,Marketing
6008,2020,Marketing,3,Grammaire et Syntaxe,1,Les Subordonnees,14,389,9,QROC,0.13,0.69,73.01,11,4,15,14,11,3,1.07,78.57,Facile,Facile,0,Meme Difficulté,Adapte,Marketing
389,2015,Marketing,3,Grammaire et Syntaxe,1,Les Subordonnees,14,390,10,QCM,0.61,0.29,19.53,18,72,90,50,18,32,1.8,36.0,Difficile,Difficile,0,Meme Difficulté,Pas Adapte,Marketing
1513,2016,Marketing,3,Grammaire et Syntaxe,1,Les Subordonnees,14,390,10,QCM,0.31,0.46,52.09,47,44,91,82,47,35,1.11,57.32,Difficile,Moyen,1,Plus Facile,Pas Adapte,Marketing
2637,2017,Marketing,3,Grammaire et Syntaxe,1,Les Subordonnees,14,390,10,QCM,0.36,0.51,46.19,39,46,85,49,39,10,1.73,79.59,Moyen,Moyen,0,Meme Difficulté,Pas Adapte,Marketing
3761,2018,Marketing,3,Grammaire et Syntaxe,1,Les Subordonnees,14,390,10,QCM,0.09,0.74,65.43,58,30,88,80,58,22,1.1,72.5,Facile,Facile,0,Meme Difficulté,Adapte,Marketing
4885,2019,Marketing,3,Grammaire et Syntaxe,1,Les Subordonnees,14,390,10,QCM,0.08,0.99,65.43,63,33,96,87,63,24,1.1,72.41,Facile,Facile,0,Meme Difficulté,Adapte,Marketing
6009,2020,Marketing,3,Grammaire et Syntaxe,1,Les Subordonnees,14,390,10,QCU,0.11,0.84,65.43,68,36,104,99,68,31,1.05,68.69,Facile,Facile,0,Meme Difficulté,Adapte,Marketing
390,2015,Marketing,3,Grammaire et Syntaxe,1,Les Subordonnees,14,391,11,QCM,0.03,0.96,97.52,60,2,62,60,60,0,1.03,100.0,Facile,Facile,0,Meme Difficulté,Pas Adapte,Marketing
1514,2016,Marketing,3,Grammaire et Syntaxe,1,Les Subordonnees,14,391,11,QCM,0.57,0.27,28.2,18,46,64,34,18,16,1.88,52.94,Facile,Difficile,-2,Beaucoup plus Difficile,Pas Adapte,Marketing
2638,2017,Marketing,3,Grammaire et Syntaxe,1,Les Subordonnees,14,391,11,QCM,0.01,0.97,70.17,44,19,63,56,44,12,1.12,78.57,Difficile,Facile,2,Beaucoup plus Facile,Adapte,Marketing
3762,2018,Marketing,3,Grammaire et Syntaxe,1,Les Subordonnees,14,391,11,QCM,0.14,0.74,70.17,41,17,58,46,41,5,1.26,89.13,Facile,Facile,0,Meme Difficulté,Adapte,Marketing
4886,2019,Marketing,3,Grammaire et Syntaxe,1,Les Subordonnees,14,391,11,QCM,0.19,0.88,70.17,44,18,62,51,44,7,1.22,86.27,Facile,Facile,0,Meme Difficulté,Adapte,Marketing
6010,2020,Marketing,3,Grammaire et Syntaxe,1,Les Subordonnees,14,391,11,QCU,0.17,0.9,70.17,39,16,55,41,39,2,1.34,95.12,Facile,Facile,0,Meme Difficulté,Adapte,Marketing
391,2015,Marketing,3,Grammaire et Syntaxe,1,Les Subordonnees,14,392,12,QCU,0.56,0.37,28.61,5,14,19,15,5,10,1.27,33.33,Difficile,Difficile,0,Meme Difficulté,Pas Adapte,Marketing
1515,2016,Marketing,3,Grammaire et Syntaxe,1,Les Subordonnees,14,392,12,QCU,0.04,0.84,90.15,15,2,17,17,15,2,1.0,88.24,Difficile,Facile,2,Beaucoup plus Facile,Pas Adapte,Marketing
2639,2017,Marketing,3,Grammaire et Syntaxe,1,Les Subordonnees,14,392,12,QCU,0.41,0.33,25.43,4,10,14,10,4,6,1.4,40.0,Facile,Difficile,-2,Beaucoup plus Difficile,Pas Adapte,Marketing
3763,2018,Marketing,3,Grammaire et Syntaxe,1,Les Subordonnees,14,392,12,QROC,0.75,0.04,5.85,1,14,15,6,1,5,2.5,16.67,Moyen,Difficile,-1,Plus Difficile,Pas Adapte,Marketing
4887,2019,Marketing,3,Grammaire et Syntaxe,1,Les Subordonnees,14,392,12,QROC,0.9,0.21,13.29,2,15,17,9,2,7,1.89,22.22,Difficile,Difficile,0,Meme Difficulté,Pas Adapte,Marketing
6011,2020,Marketing,3,Grammaire et Syntaxe,1,Les Subordonnees,14,392,12,QROC,0.16,0.4,65.93,11,6,17,13,11,2,1.31,84.62,Difficile,Facile,2,Beaucoup plus Facile,Adapte,Marketing
392,2015,Marketing,3,Grammaire et Syntaxe,1,Les Subordonnees,14,393,13,QROC,0.92,0.08,14.3,1,4,5,2,1,1,2.5,50.0,Facile,Difficile,-2,Beaucoup plus Difficile,Pas Adapte,Marketing
1516,2016,Marketing,3,Grammaire et Syntaxe,1,Les Subordonnees,14,393,13,QROC,0.58,0.3,43.0,2,3,5,2,2,0,2.5,100.0,Facile,Moyen,-1,Plus Difficile,Pas Adapte,Marketing
2640,2017,Marketing,3,Grammaire et Syntaxe,1,Les Subordonnees,14,393,13,QROC,0.31,0.29,35.49,2,3,5,3,2,1,1.67,66.67,Moyen,Moyen,0,Meme Difficulté,Pas Adapte,Marketing
3764,2018,Marketing,3,Grammaire et Syntaxe,1,Les Subordonnees,14,393,13,QROC,0.3,0.36,36.18,2,3,5,3,2,1,1.67,66.67,Moyen,Moyen,0,Meme Difficulté,Pas Adapte,Marketing
4888,2019,Marketing,3,Grammaire et Syntaxe,1,Les Subordonnees,14,393,13,QROC,0.0,0.82,79.73,4,1,5,4,4,0,1.25,100.0,Moyen,Facile,1,Plus Facile,Pas Adapte,Marketing
6012,2020,Marketing,3,Grammaire et Syntaxe,1,Les Subordonnees,14,393,13,QROC,0.3,0.31,51.12,3,2,5,4,3,1,1.25,75.0,Facile,Moyen,-1,Plus Difficile,Pas Adapte,Marketing
393,2015,Marketing,3,Grammaire et Syntaxe,1,Les Subordonnees,14,394,14,QCM,0.68,0.21,7.19,4,47,51,50,4,46,1.02,8.0,Difficile,Difficile,0,Meme Difficulté,Pas Adapte,Marketing
1517,2016,Marketing,3,Grammaire et Syntaxe,1,Les Subordonnees,14,394,14,QCM,0.54,0.23,10.06,5,44,49,29,5,24,1.69,17.24,Facile,Difficile,-2,Beaucoup plus Difficile,Pas Adapte,Marketing
2641,2017,Marketing,3,Grammaire et Syntaxe,1,Les Subordonnees,14,394,14,QCM,0.46,0.58,40.05,17,26,43,20,17,3,2.15,85.0,Difficile,Moyen,1,Plus Facile,Pas Adapte,Marketing
3765,2018,Marketing,3,Grammaire et Syntaxe,1,Les Subordonnees,14,394,14,QCM,0.08,0.78,98.9,44,0,44,44,44,0,1.0,100.0,Moyen,Facile,1,Plus Facile,Pas Adapte,Marketing
4889,2019,Marketing,3,Grammaire et Syntaxe,1,Les Subordonnees,14,394,14,QCM,0.1,0.94,83.57,34,7,41,39,34,5,1.05,87.18,Difficile,Facile,2,Beaucoup plus Facile,Pas Adapte,Marketing
6013,2020,Marketing,3,Grammaire et Syntaxe,1,Les Subordonnees,14,394,14,QCM,0.01,0.86,75.88,28,9,37,32,28,4,1.16,87.5,Facile,Facile,0,Meme Difficulté,Pas Adapte,Marketing
394,2015,Marketing,3,Grammaire et Syntaxe,2,La Coordination,5,395,1,QCM,0.03,0.81,76.75,17,5,22,21,17,4,1.05,80.95,Difficile,Facile,2,Beaucoup plus Facile,Pas Adapte,Marketing
1518,2016,Marketing,3,Grammaire et Syntaxe,2,La Coordination,5,395,1,QCM,0.05,0.97,95.16,23,1,24,23,23,0,1.04,100.0,Difficile,Facile,2,Beaucoup plus Facile,Pas Adapte,Marketing
2642,2017,Marketing,3,Grammaire et Syntaxe,2,La Coordination,5,395,1,QCM,0.47,0.3,63.97,17,9,26,23,17,6,1.13,73.91,Difficile,Moyen,1,Plus Facile,Adapte,Marketing
3766,2018,Marketing,3,Grammaire et Syntaxe,2,La Coordination,5,395,1,QCM,0.39,0.6,63.97,19,11,30,26,19,7,1.15,73.08,Moyen,Moyen,0,Meme Difficulté,Adapte,Marketing
4890,2019,Marketing,3,Grammaire et Syntaxe,2,La Coordination,5,395,1,QCM,0.26,0.67,63.97,17,10,27,25,17,8,1.08,68.0,Moyen,Moyen,0,Meme Difficulté,Adapte,Marketing
6014,2020,Marketing,3,Grammaire et Syntaxe,2,La Coordination,5,395,1,QCM,0.22,0.53,63.97,20,11,31,25,20,5,1.24,80.0,Moyen,Moyen,0,Meme Difficulté,Adapte,Marketing
395,2015,Marketing,3,Grammaire et Syntaxe,2,La Coordination,5,396,2,QCU,0.59,0.28,0.81,0,48,48,42,0,42,1.14,0.0,Moyen,Difficile,-1,Plus Difficile,Pas Adapte,Marketing
1519,2016,Marketing,3,Grammaire et Syntaxe,2,La Coordination,5,396,2,QCU,0.08,0.86,83.17,37,7,44,39,37,2,1.13,94.87,Facile,Facile,0,Meme Difficulté,Pas Adapte,Marketing
2643,2017,Marketing,3,Grammaire et Syntaxe,2,La Coordination,5,396,2,QCM,0.57,0.18,23.33,11,36,47,27,11,16,1.74,40.74,Facile,Difficile,-2,Beaucoup plus Difficile,Pas Adapte,Marketing
3767,2018,Marketing,3,Grammaire et Syntaxe,2,La Coordination,5,396,2,QCM,0.56,0.2,10.47,6,48,54,41,6,35,1.32,14.63,Difficile,Difficile,0,Meme Difficulté,Pas Adapte,Marketing
4891,2019,Marketing,3,Grammaire et Syntaxe,2,La Coordination,5,396,2,QCM,0.59,0.17,26.34,16,46,62,35,16,19,1.77,45.71,Facile,Difficile,-2,Beaucoup plus Difficile,Pas Adapte,Marketing
6015,2020,Marketing,3,Grammaire et Syntaxe,2,La Coordination,5,396,2,QCM,0.65,0.21,29.16,20,49,69,67,20,47,1.03,29.85,Facile,Difficile,-2,Beaucoup plus Difficile,Pas Adapte,Marketing
396,2015,Marketing,3,Grammaire et Syntaxe,2,La Coordination,5,397,3,QCM,0.34,0.48,49.94,40,40,80,48,40,8,1.67,83.33,Moyen,Moyen,0,Meme Difficulté,Pas Adapte,Marketing
1520,2016,Marketing,3,Grammaire et Syntaxe,2,La Coordination,5,397,3,QCM,0.8,0.21,6.61,5,67,72,60,5,55,1.2,8.33,Facile,Difficile,-2,Beaucoup plus Difficile,Pas Adapte,Marketing
2644,2017,Marketing,3,Grammaire et Syntaxe,2,La Coordination,5,397,3,QCM,0.02,0.7,65.32,40,22,62,44,40,4,1.41,90.91,Difficile,Facile,2,Beaucoup plus Facile,Adapte,Marketing
3768,2018,Marketing,3,Grammaire et Syntaxe,2,La Coordination,5,397,3,QCM,0.14,0.7,65.32,46,24,70,62,46,16,1.13,74.19,Facile,Facile,0,Meme Difficulté,Adapte,Marketing
4892,2019,Marketing,3,Grammaire et Syntaxe,2,La Coordination,5,397,3,QCU,0.01,0.82,65.32,42,22,64,46,42,4,1.39,91.3,Facile,Facile,0,Meme Difficulté,Adapte,Marketing
6016,2020,Marketing,3,Grammaire et Syntaxe,2,La Coordination,5,397,3,QO,0.12,0.43,65.32,41,22,63,57,41,16,1.11,71.93,Facile,Facile,0,Meme Difficulté,Adapte,Marketing
397,2015,Marketing,3,Grammaire et Syntaxe,2,La Coordination,5,398,4,QCM,0.55,0.28,14.74,4,22,26,19,4,15,1.37,21.05,Moyen,Difficile,-1,Plus Difficile,Pas Adapte,Marketing
1521,2016,Marketing,3,Grammaire et Syntaxe,2,La Coordination,5,398,4,QCM,0.49,0.31,45.26,12,14,26,19,12,7,1.37,63.16,Difficile,Moyen,1,Plus Facile,Pas Adapte,Marketing
2645,2017,Marketing,3,Grammaire et Syntaxe,2,La Coordination,5,398,4,QCM,0.12,0.92,90.86,20,2,22,21,20,1,1.05,95.24,Moyen,Facile,1,Plus Facile,Pas Adapte,Marketing
3769,2018,Marketing,3,Grammaire et Syntaxe,2,La Coordination,5,398,4,QCM,0.02,0.96,80.66,20,5,25,21,20,1,1.19,95.24,Facile,Facile,0,Meme Difficulté,Pas Adapte,Marketing
4893,2019,Marketing,3,Grammaire et Syntaxe,2,La Coordination,5,398,4,QCM,0.21,0.7,49.59,12,13,25,18,12,6,1.39,66.67,Facile,Moyen,-1,Plus Difficile,Pas Adapte,Marketing
6017,2020,Marketing,3,Grammaire et Syntaxe,2,La Coordination,5,398,4,QCM,0.4,0.55,53.64,12,10,22,21,12,9,1.05,57.14,Difficile,Moyen,1,Plus Facile,Pas Adapte,Marketing
398,2015,Marketing,3,Grammaire et Syntaxe,2,La Coordination,5,399,5,QCU,0.43,0.32,11.51,5,39,44,33,5,28,1.33,15.15,Difficile,Difficile,0,Meme Difficulté,Pas Adapte,Marketing
1522,2016,Marketing,3,Grammaire et Syntaxe,2,La Coordination,5,399,5,QCU,0.31,0.47,41.45,21,30,51,29,21,8,1.76,72.41,Moyen,Moyen,0,Meme Difficulté,Pas Adapte,Marketing
2646,2017,Marketing,3,Grammaire et Syntaxe,2,La Coordination,5,399,5,QCU,0.48,0.39,28.17,15,37,52,37,15,22,1.41,40.54,Moyen,Difficile,-1,Plus Difficile,Pas Adapte,Marketing
3770,2018,Marketing,3,Grammaire et Syntaxe,2,La Coordination,5,399,5,QCU,0.62,0.37,3.08,2,48,50,44,2,42,1.14,4.55,Facile,Difficile,-2,Beaucoup plus Difficile,Pas Adapte,Marketing
4894,2019,Marketing,3,Grammaire et Syntaxe,2,La Coordination,5,399,5,QCM,0.02,0.83,79.46,41,10,51,44,41,3,1.16,93.18,Moyen,Facile,1,Plus Facile,Pas Adapte,Marketing
6018,2020,Marketing,3,Grammaire et Syntaxe,2,La Coordination,5,399,5,QCM,0.22,0.67,57.13,33,25,58,58,33,25,1.0,56.9,Facile,Moyen,-1,Plus Difficile,Pas Adapte,Marketing
399,2015,Marketing,3,Grammaire et Syntaxe,3,Le Statut des Pronoms,9,400,1,QCU,0.02,0.93,88.86,29,4,33,30,29,1,1.1,96.67,Difficile,Facile,2,Beaucoup plus Facile,Pas Adapte,Marketing
1523,2016,Marketing,3,Grammaire et Syntaxe,3,Le Statut des Pronoms,9,400,1,QCU,0.26,0.6,35.93,13,22,35,26,13,13,1.35,50.0,Difficile,Moyen,1,Plus Facile,Pas Adapte,Marketing
2647,2017,Marketing,3,Grammaire et Syntaxe,3,Le Statut des Pronoms,9,400,1,QCU,0.44,0.24,19.07,6,25,31,26,6,20,1.19,23.08,Facile,Difficile,-2,Beaucoup plus Difficile,Pas Adapte,Marketing
3771,2018,Marketing,3,Grammaire et Syntaxe,3,Le Statut des Pronoms,9,400,1,QCU,0.5,0.24,7.85,2,24,26,22,2,20,1.18,9.09,Moyen,Difficile,-1,Plus Difficile,Pas Adapte,Marketing
4895,2019,Marketing,3,Grammaire et Syntaxe,3,Le Statut des Pronoms,9,400,1,QCU,0.32,0.63,46.59,12,14,26,19,12,7,1.37,63.16,Facile,Moyen,-1,Plus Difficile,Pas Adapte,Marketing
6019,2020,Marketing,3,Grammaire et Syntaxe,3,Le Statut des Pronoms,9,400,1,QCU,0.43,0.2,11.13,3,27,30,17,3,14,1.76,17.65,Facile,Difficile,-2,Beaucoup plus Difficile,Pas Adapte,Marketing
400,2015,Marketing,3,Grammaire et Syntaxe,3,Le Statut des Pronoms,9,401,2,QCU,0.34,0.73,40.07,39,59,98,43,39,4,2.28,90.7,Difficile,Moyen,1,Plus Facile,Pas Adapte,Marketing
1524,2016,Marketing,3,Grammaire et Syntaxe,3,Le Statut des Pronoms,9,401,2,QCU,0.52,0.35,8.76,8,88,96,95,8,87,1.01,8.42,Facile,Difficile,-2,Beaucoup plus Difficile,Pas Adapte,Marketing
2648,2017,Marketing,3,Grammaire et Syntaxe,3,Le Statut des Pronoms,9,401,2,QCU,0.07,0.87,73.97,61,22,83,77,61,16,1.08,79.22,Difficile,Facile,2,Beaucoup plus Facile,Adapte,Marketing
3772,2018,Marketing,3,Grammaire et Syntaxe,3,Le Statut des Pronoms,9,401,2,QCU,0.04,1.0,73.97,56,20,76,73,56,17,1.04,76.71,Facile,Facile,0,Meme Difficulté,Adapte,Marketing
4896,2019,Marketing,3,Grammaire et Syntaxe,3,Le Statut des Pronoms,9,401,2,QCM,0.06,0.81,73.97,61,21,82,75,61,14,1.09,81.33,Facile,Facile,0,Meme Difficulté,Adapte,Marketing
6020,2020,Marketing,3,Grammaire et Syntaxe,3,Le Statut des Pronoms,9,401,2,QCM,0.18,0.85,73.97,55,20,75,62,55,7,1.21,88.71,Facile,Facile,0,Meme Difficulté,Adapte,Marketing
401,2015,Marketing,3,Grammaire et Syntaxe,3,Le Statut des Pronoms,9,402,3,QCU,0.49,0.21,3.32,2,66,68,31,2,29,2.19,6.45,Moyen,Difficile,-1,Plus Difficile,Pas Adapte,Marketing
1525,2016,Marketing,3,Grammaire et Syntaxe,3,Le Statut des Pronoms,9,402,3,QCU,0.19,0.91,66.07,42,22,64,44,42,2,1.45,95.45,Difficile,Facile,2,Beaucoup plus Facile,Adapte,Marketing
2649,2017,Marketing,3,Grammaire et Syntaxe,3,Le Statut des Pronoms,9,402,3,QCU,0.12,0.98,66.07,39,20,59,46,39,7,1.28,84.78,Facile,Facile,0,Meme Difficulté,Adapte,Marketing
3773,2018,Marketing,3,Grammaire et Syntaxe,3,Le Statut des Pronoms,9,402,3,QCM,0.07,0.83,66.07,34,17,51,39,34,5,1.31,87.18,Facile,Facile,0,Meme Difficulté,Adapte,Marketing
4897,2019,Marketing,3,Grammaire et Syntaxe,3,Le Statut des Pronoms,9,402,3,QCU,0.12,0.88,66.07,32,17,49,37,32,5,1.32,86.49,Facile,Facile,0,Meme Difficulté,Adapte,Marketing
6021,2020,Marketing,3,Grammaire et Syntaxe,3,Le Statut des Pronoms,9,402,3,QCU,0.09,0.86,66.07,35,18,53,49,35,14,1.08,71.43,Facile,Facile,0,Meme Difficulté,Adapte,Marketing
402,2015,Marketing,3,Grammaire et Syntaxe,3,Le Statut des Pronoms,9,403,4,QCU,0.4,0.69,44.73,4,5,9,5,4,1,1.8,80.0,Facile,Moyen,-1,Plus Difficile,Pas Adapte,Marketing
1526,2016,Marketing,3,Grammaire et Syntaxe,3,Le Statut des Pronoms,9,403,4,QCU,0.16,1.0,83.42,8,2,10,9,8,1,1.11,88.89,Difficile,Facile,2,Beaucoup plus Facile,Pas Adapte,Marketing
2650,2017,Marketing,3,Grammaire et Syntaxe,3,Le Statut des Pronoms,9,403,4,QCU,0.36,0.41,49.02,5,5,10,5,5,0,2.0,100.0,Moyen,Moyen,0,Meme Difficulté,Pas Adapte,Marketing
3774,2018,Marketing,3,Grammaire et Syntaxe,3,Le Statut des Pronoms,9,403,4,QCU,0.56,0.36,33.62,3,6,9,4,3,1,2.25,75.0,Facile,Difficile,-2,Beaucoup plus Difficile,Pas Adapte,Marketing
4898,2019,Marketing,3,Grammaire et Syntaxe,3,Le Statut des Pronoms,9,403,4,QCU,0.04,0.85,90.99,9,1,10,10,9,1,1.0,90.0,Facile,Facile,0,Meme Difficulté,Pas Adapte,Marketing
6022,2020,Marketing,3,Grammaire et Syntaxe,3,Le Statut des Pronoms,9,403,4,QCU,0.36,0.57,47.5,6,6,12,10,6,4,1.2,60.0,Difficile,Moyen,1,Plus Facile,Pas Adapte,Marketing
403,2015,Marketing,3,Grammaire et Syntaxe,3,Le Statut des Pronoms,9,404,5,QCM,0.77,0.16,32.7,17,34,51,48,17,31,1.06,35.42,Facile,Difficile,-2,Beaucoup plus Difficile,Pas Adapte,Marketing
1527,2016,Marketing,3,Grammaire et Syntaxe,3,Le Statut des Pronoms,9,404,5,QCM,0.23,0.59,51.24,25,24,49,47,25,22,1.04,53.19,Difficile,Moyen,1,Plus Facile,Pas Adapte,Marketing
2651,2017,Marketing,3,Grammaire et Syntaxe,3,Le Statut des Pronoms,9,404,5,QCM,0.26,0.56,40.25,21,31,52,33,21,12,1.58,63.64,Moyen,Moyen,0,Meme Difficulté,Pas Adapte,Marketing
3775,2018,Marketing,3,Grammaire et Syntaxe,3,Le Statut des Pronoms,9,404,5,QCM,0.52,0.26,23.82,11,34,45,26,11,15,1.73,42.31,Facile,Difficile,-2,Beaucoup plus Difficile,Pas Adapte,Marketing
4899,2019,Marketing,3,Grammaire et Syntaxe,3,Le Statut des Pronoms,9,404,5,QCM,0.77,0.18,13.16,5,33,38,31,5,26,1.23,16.13,Difficile,Difficile,0,Meme Difficulté,Pas Adapte,Marketing
6023,2020,Marketing,3,Grammaire et Syntaxe,3,Le Statut des Pronoms,9,404,5,QCM,0.35,0.38,43.51,19,24,43,32,19,13,1.34,59.38,Facile,Moyen,-1,Plus Difficile,Pas Adapte,Marketing
404,2015,Marketing,3,Grammaire et Syntaxe,3,Le Statut des Pronoms,9,405,6,QROC,0.81,0.23,31.69,31,68,99,86,31,55,1.15,36.05,Difficile,Difficile,0,Meme Difficulté,Pas Adapte,Marketing
1528,2016,Marketing,3,Grammaire et Syntaxe,3,Le Statut des Pronoms,9,405,6,QROC,0.04,0.86,74.08,66,23,89,75,66,9,1.19,88.0,Moyen,Facile,1,Plus Facile,Adapte,Marketing
2652,2017,Marketing,3,Grammaire et Syntaxe,3,Le Statut des Pronoms,9,405,6,QROC,0.17,1.0,74.08,65,23,88,84,65,19,1.05,77.38,Facile,Facile,0,Meme Difficulté,Adapte,Marketing
3776,2018,Marketing,3,Grammaire et Syntaxe,3,Le Statut des Pronoms,9,405,6,QROC,0.04,0.96,74.08,74,26,100,77,74,3,1.3,96.1,Facile,Facile,0,Meme Difficulté,Adapte,Marketing
4900,2019,Marketing,3,Grammaire et Syntaxe,3,Le Statut des Pronoms,9,405,6,QROC,0.12,0.93,74.08,84,30,114,102,84,18,1.12,82.35,Facile,Facile,0,Meme Difficulté,Adapte,Marketing
6024,2020,Marketing,3,Grammaire et Syntaxe,3,Le Statut des Pronoms,9,405,6,QROC,0.11,0.7,74.08,96,34,130,115,96,19,1.13,83.48,Facile,Facile,0,Meme Difficulté,Adapte,Marketing
405,2015,Marketing,3,Grammaire et Syntaxe,3,Le Statut des Pronoms,9,406,7,QCM,0.02,0.89,73.65,69,25,94,89,69,20,1.06,77.53,Facile,Facile,0,Meme Difficulté,Adapte,Marketing
1529,2016,Marketing,3,Grammaire et Syntaxe,3,Le Statut des Pronoms,9,406,7,QCM,0.11,0.83,73.65,66,23,89,84,66,18,1.06,78.57,Facile,Facile,0,Meme Difficulté,Adapte,Marketing
2653,2017,Marketing,3,Grammaire et Syntaxe,3,Le Statut des Pronoms,9,406,7,QCM,0.12,0.73,73.65,58,21,79,66,58,8,1.2,87.88,Facile,Facile,0,Meme Difficulté,Adapte,Marketing
3777,2018,Marketing,3,Grammaire et Syntaxe,3,Le Statut des Pronoms,9,406,7,QCM,0.15,0.86,73.65,56,20,76,64,56,8,1.19,87.5,Facile,Facile,0,Meme Difficulté,Adapte,Marketing
4901,2019,Marketing,3,Grammaire et Syntaxe,3,Le Statut des Pronoms,9,406,7,QCM,0.05,0.93,73.65,58,21,79,76,58,18,1.04,76.32,Facile,Facile,0,Meme Difficulté,Adapte,Marketing
6025,2020,Marketing,3,Grammaire et Syntaxe,3,Le Statut des Pronoms,9,406,7,QCM,0.02,0.99,73.65,63,22,85,81,63,18,1.05,77.78,Facile,Facile,0,Meme Difficulté,Adapte,Marketing
406,2015,Marketing,3,Grammaire et Syntaxe,3,Le Statut des Pronoms,9,407,8,QCU,0.68,0.23,15.69,10,54,64,54,10,44,1.19,18.52,Difficile,Difficile,0,Meme Difficulté,Pas Adapte,Marketing
1530,2016,Marketing,3,Grammaire et Syntaxe,3,Le Statut des Pronoms,9,407,8,QCU,0.31,0.6,39.91,24,35,59,35,24,11,1.69,68.57,Facile,Moyen,-1,Plus Difficile,Pas Adapte,Marketing
2654,2017,Marketing,3,Grammaire et Syntaxe,3,Le Statut des Pronoms,9,407,8,QCU,0.59,0.29,11.15,7,59,66,38,7,31,1.74,18.42,Moyen,Difficile,-1,Plus Difficile,Pas Adapte,Marketing
3778,2018,Marketing,3,Grammaire et Syntaxe,3,Le Statut des Pronoms,9,407,8,QCU,0.1,0.84,88.0,56,8,64,57,56,1,1.12,98.25,Difficile,Facile,2,Beaucoup plus Facile,Pas Adapte,Marketing
4902,2019,Marketing,3,Grammaire et Syntaxe,3,Le Statut des Pronoms,9,407,8,QROC,0.31,0.27,41.68,25,35,60,38,25,13,1.58,65.79,Moyen,Moyen,0,Meme Difficulté,Pas Adapte,Marketing
6026,2020,Marketing,3,Grammaire et Syntaxe,3,Le Statut des Pronoms,9,407,8,QROC,0.96,0.18,5.35,3,51,54,27,3,24,2.0,11.11,Moyen,Difficile,-1,Plus Difficile,Pas Adapte,Marketing
407,2015,Marketing,3,Grammaire et Syntaxe,3,Le Statut des Pronoms,9,408,9,QCM,0.08,0.87,69.07,4,2,6,4,4,0,1.5,100.0,Difficile,Facile,2,Beaucoup plus Facile,Adapte,Marketing
1531,2016,Marketing,3,Grammaire et Syntaxe,3,Le Statut des Pronoms,9,408,9,QCU,0.18,0.83,69.07,3,2,5,4,3,1,1.25,75.0,Facile,Facile,0,Meme Difficulté,Adapte,Marketing
2655,2017,Marketing,3,Grammaire et Syntaxe,3,Le Statut des Pronoms,9,408,9,QCU,0.19,0.99,69.07,3,2,5,4,3,1,1.25,75.0,Facile,Facile,0,Meme Difficulté,Adapte,Marketing
3779,2018,Marketing,3,Grammaire et Syntaxe,3,Le Statut des Pronoms,9,408,9,QCU,0.1,0.98,69.07,4,2,6,6,4,2,1.0,66.67,Facile,Facile,0,Meme Difficulté,Adapte,Marketing
4903,2019,Marketing,3,Grammaire et Syntaxe,3,Le Statut des Pronoms,9,408,9,QCU,0.0,0.8,69.07,3,2,5,4,3,1,1.25,75.0,Facile,Facile,0,Meme Difficulté,Adapte,Marketing
6027,2020,Marketing,3,Grammaire et Syntaxe,3,Le Statut des Pronoms,9,408,9,QCU,0.03,0.84,69.07,3,2,5,4,3,1,1.25,75.0,Facile,Facile,0,Meme Difficulté,Adapte,Marketing
408,2015,Marketing,4,Neologie,1,Les Innovations Lexicales,3,409,1,QCM,0.01,0.73,68.7,54,25,79,56,54,2,1.41,96.43,Difficile,Facile,2,Beaucoup plus Facile,Adapte,Marketing
1532,2016,Marketing,4,Neologie,1,Les Innovations Lexicales,3,409,1,QCM,0.09,0.74,68.7,48,22,70,53,48,5,1.32,90.57,Facile,Facile,0,Meme Difficulté,Adapte,Marketing
2656,2017,Marketing,4,Neologie,1,Les Innovations Lexicales,3,409,1,QCM,0.15,0.98,68.7,41,19,60,56,41,15,1.07,73.21,Facile,Facile,0,Meme Difficulté,Adapte,Marketing
3780,2018,Marketing,4,Neologie,1,Les Innovations Lexicales,3,409,1,QCM,0.16,0.96,68.7,36,16,52,48,36,12,1.08,75.0,Facile,Facile,0,Meme Difficulté,Adapte,Marketing
4904,2019,Marketing,4,Neologie,1,Les Innovations Lexicales,3,409,1,QCM,0.18,0.93,68.7,38,17,55,52,38,14,1.06,73.08,Facile,Facile,0,Meme Difficulté,Adapte,Marketing
6028,2020,Marketing,4,Neologie,1,Les Innovations Lexicales,3,409,1,QCM,0.19,0.84,68.7,37,17,54,47,37,10,1.15,78.72,Facile,Facile,0,Meme Difficulté,Adapte,Marketing
409,2015,Marketing,4,Neologie,1,Les Innovations Lexicales,3,410,2,QCM,0.18,0.89,81.47,54,12,66,57,54,3,1.16,94.74,Difficile,Facile,2,Beaucoup plus Facile,Pas Adapte,Marketing
1533,2016,Marketing,4,Neologie,1,Les Innovations Lexicales,3,410,2,QCM,0.05,0.88,96.58,68,2,70,68,68,0,1.03,100.0,Difficile,Facile,2,Beaucoup plus Facile,Pas Adapte,Marketing
2657,2017,Marketing,4,Neologie,1,Les Innovations Lexicales,3,410,2,QCM,0.04,0.72,99.24,78,1,79,79,78,1,1.0,98.73,Difficile,Facile,2,Beaucoup plus Facile,Pas Adapte,Marketing
3781,2018,Marketing,4,Neologie,1,Les Innovations Lexicales,3,410,2,QCM,0.64,0.27,2.11,2,89,91,65,2,63,1.4,3.08,Facile,Difficile,-2,Beaucoup plus Difficile,Pas Adapte,Marketing
4905,2019,Marketing,4,Neologie,1,Les Innovations Lexicales,3,410,2,QCM,0.7,0.28,16.93,17,86,103,39,17,22,2.64,43.59,Moyen,Difficile,-1,Plus Difficile,Pas Adapte,Marketing
6029,2020,Marketing,4,Neologie,1,Les Innovations Lexicales,3,410,2,QCM,0.52,0.21,5.95,6,91,97,46,6,40,2.11,13.04,Difficile,Difficile,0,Meme Difficulté,Pas Adapte,Marketing
410,2015,Marketing,4,Neologie,1,Les Innovations Lexicales,3,411,3,QCM,0.44,0.45,64.9,46,25,71,50,46,4,1.42,92.0,Moyen,Moyen,0,Meme Difficulté,Adapte,Marketing
1534,2016,Marketing,4,Neologie,1,Les Innovations Lexicales,3,411,3,QCM,0.27,0.53,64.9,47,26,73,56,47,9,1.3,83.93,Moyen,Moyen,0,Meme Difficulté,Adapte,Marketing
2658,2017,Marketing,4,Neologie,1,Les Innovations Lexicales,3,411,3,QCM,0.33,0.31,64.9,40,22,62,49,40,9,1.27,81.63,Moyen,Moyen,0,Meme Difficulté,Adapte,Marketing
3782,2018,Marketing,4,Neologie,1,Les Innovations Lexicales,3,411,3,QCU,0.35,0.73,64.9,36,19,55,37,36,1,1.49,97.3,Moyen,Moyen,0,Meme Difficulté,Adapte,Marketing
4906,2019,Marketing,4,Neologie,1,Les Innovations Lexicales,3,411,3,QCU,0.35,0.46,64.9,34,19,53,44,34,10,1.2,77.27,Moyen,Moyen,0,Meme Difficulté,Adapte,Marketing
6030,2020,Marketing,4,Neologie,1,Les Innovations Lexicales,3,411,3,QCU,0.33,0.64,64.9,31,17,48,34,31,3,1.41,91.18,Moyen,Moyen,0,Meme Difficulté,Adapte,Marketing
411,2015,Marketing,4,Neologie,2,La Motivation Neologique,1,412,1,QCM,0.76,0.29,12.12,10,69,79,59,10,49,1.34,16.95,Difficile,Difficile,0,Meme Difficulté,Pas Adapte,Marketing
1535,2016,Marketing,4,Neologie,2,La Motivation Neologique,1,412,1,QCM,0.55,0.26,29.07,20,48,68,64,20,44,1.06,31.25,Difficile,Difficile,0,Meme Difficulté,Pas Adapte,Marketing
2659,2017,Marketing,4,Neologie,2,La Motivation Neologique,1,412,1,QCM,0.18,0.87,89.38,55,6,61,61,55,6,1.0,90.16,Facile,Facile,0,Meme Difficulté,Pas Adapte,Marketing
3783,2018,Marketing,4,Neologie,2,La Motivation Neologique,1,412,1,QCM,0.75,0.26,10.56,7,56,63,30,7,23,2.1,23.33,Difficile,Difficile,0,Meme Difficulté,Pas Adapte,Marketing
4907,2019,Marketing,4,Neologie,2,La Motivation Neologique,1,412,1,QCM,0.08,0.72,81.04,47,11,58,55,47,8,1.05,85.45,Moyen,Facile,1,Plus Facile,Pas Adapte,Marketing
6031,2020,Marketing,4,Neologie,2,La Motivation Neologique,1,412,1,QCM,0.03,0.75,88.11,47,6,53,50,47,3,1.06,94.0,Facile,Facile,0,Meme Difficulté,Pas Adapte,Marketing
412,2015,Marketing,4,Neologie,3,La Creation Neologique,12,413,1,QCU,0.39,0.51,39.88,24,35,59,30,24,6,1.97,80.0,Facile,Moyen,-1,Plus Difficile,Pas Adapte,Marketing
1536,2016,Marketing,4,Neologie,3,La Creation Neologique,12,413,1,QCU,0.14,0.78,98.46,50,1,51,51,50,1,1.0,98.04,Moyen,Facile,1,Plus Facile,Pas Adapte,Marketing
2660,2017,Marketing,4,Neologie,3,La Creation Neologique,12,413,1,QCU,0.54,0.33,16.55,8,39,47,33,8,25,1.42,24.24,Facile,Difficile,-2,Beaucoup plus Difficile,Pas Adapte,Marketing
3784,2018,Marketing,4,Neologie,3,La Creation Neologique,12,413,1,QCU,0.06,0.89,77.91,39,11,50,40,39,1,1.25,97.5,Difficile,Facile,2,Beaucoup plus Facile,Pas Adapte,Marketing
4908,2019,Marketing,4,Neologie,3,La Creation Neologique,12,413,1,QCU,0.01,0.85,93.82,41,3,44,41,41,0,1.07,100.0,Moyen,Facile,1,Plus Facile,Pas Adapte,Marketing
6032,2020,Marketing,4,Neologie,3,La Creation Neologique,12,413,1,QCU,0.0,0.93,71.13,32,13,45,41,32,9,1.1,78.05,Difficile,Facile,2,Beaucoup plus Facile,Adapte,Marketing
413,2015,Marketing,4,Neologie,3,La Creation Neologique,12,414,2,QCU,0.75,0.26,8.78,1,9,10,4,1,3,2.5,25.0,Facile,Difficile,-2,Beaucoup plus Difficile,Pas Adapte,Marketing
1537,2016,Marketing,4,Neologie,3,La Creation Neologique,12,414,2,QCU,0.56,0.37,31.02,3,7,10,9,3,6,1.11,33.33,Difficile,Difficile,0,Meme Difficulté,Pas Adapte,Marketing
2661,2017,Marketing,4,Neologie,3,La Creation Neologique,12,414,2,QCM,0.01,0.91,94.52,8,0,8,8,8,0,1.0,100.0,Difficile,Facile,2,Beaucoup plus Facile,Pas Adapte,Marketing
3785,2018,Marketing,4,Neologie,3,La Creation Neologique,12,414,2,QCU,0.43,0.37,21.93,2,5,7,6,2,4,1.17,33.33,Moyen,Difficile,-1,Plus Difficile,Pas Adapte,Marketing
4909,2019,Marketing,4,Neologie,3,La Creation Neologique,12,414,2,QCU,0.14,0.89,83.62,6,1,7,6,6,0,1.17,100.0,Moyen,Facile,1,Plus Facile,Pas Adapte,Marketing
6033,2020,Marketing,4,Neologie,3,La Creation Neologique,12,414,2,QCU,0.09,0.98,82.75,7,1,8,7,7,0,1.14,100.0,Facile,Facile,0,Meme Difficulté,Pas Adapte,Marketing
414,2015,Marketing,4,Neologie,3,La Creation Neologique,12,415,3,QCM,0.16,0.94,81.28,56,13,69,63,56,7,1.1,88.89,Moyen,Facile,1,Plus Facile,Pas Adapte,Marketing
1538,2016,Marketing,4,Neologie,3,La Creation Neologique,12,415,3,QCM,0.0,0.75,84.86,66,12,78,77,66,11,1.01,85.71,Difficile,Facile,2,Beaucoup plus Facile,Pas Adapte,Marketing
2662,2017,Marketing,4,Neologie,3,La Creation Neologique,12,415,3,QCM,0.69,0.24,12.2,10,73,83,43,10,33,1.93,23.26,Facile,Difficile,-2,Beaucoup plus Difficile,Pas Adapte,Marketing
3786,2018,Marketing,4,Neologie,3,La Creation Neologique,12,415,3,QCM,0.18,0.98,67.51,52,25,77,54,52,2,1.43,96.3,Difficile,Facile,2,Beaucoup plus Facile,Adapte,Marketing
4910,2019,Marketing,4,Neologie,3,La Creation Neologique,12,415,3,QCM,0.08,0.81,67.51,45,21,66,54,45,9,1.22,83.33,Facile,Facile,0,Meme Difficulté,Adapte,Marketing
6034,2020,Marketing,4,Neologie,3,La Creation Neologique,12,415,3,QCM,0.06,0.92,67.51,44,21,65,60,44,16,1.08,73.33,Facile,Facile,0,Meme Difficulté,Adapte,Marketing
415,2015,Marketing,4,Neologie,3,La Creation Neologique,12,416,4,QCM,0.55,0.27,13.82,7,47,54,54,7,47,1.0,12.96,Facile,Difficile,-2,Beaucoup plus Difficile,Pas Adapte,Marketing
1539,2016,Marketing,4,Neologie,3,La Creation Neologique,12,416,4,QCU,0.06,0.88,68.25,31,15,46,34,31,3,1.35,91.18,Difficile,Facile,2,Beaucoup plus Facile,Adapte,Marketing
2663,2017,Marketing,4,Neologie,3,La Creation Neologique,12,416,4,QCU,0.18,0.96,68.25,27,12,39,35,27,8,1.11,77.14,Facile,Facile,0,Meme Difficulté,Adapte,Marketing
3787,2018,Marketing,4,Neologie,3,La Creation Neologique,12,416,4,QCU,0.02,0.93,68.25,23,10,33,26,23,3,1.27,88.46,Facile,Facile,0,Meme Difficulté,Adapte,Marketing
4911,2019,Marketing,4,Neologie,3,La Creation Neologique,12,416,4,QCU,0.07,0.92,68.25,25,11,36,31,25,6,1.16,80.65,Facile,Facile,0,Meme Difficulté,Adapte,Marketing
6035,2020,Marketing,4,Neologie,3,La Creation Neologique,12,416,4,QCU,0.14,0.93,68.25,21,10,31,31,21,10,1.0,67.74,Facile,Facile,0,Meme Difficulté,Adapte,Marketing
416,2015,Marketing,4,Neologie,3,La Creation Neologique,12,417,5,QCM,0.6,0.27,1.33,0,14,14,7,0,7,2.0,0.0,Difficile,Difficile,0,Meme Difficulté,Pas Adapte,Marketing
1540,2016,Marketing,4,Neologie,3,La Creation Neologique,12,417,5,QCM,0.41,0.42,48.51,6,6,12,7,6,1,1.71,85.71,Moyen,Moyen,0,Meme Difficulté,Pas Adapte,Marketing
2664,2017,Marketing,4,Neologie,3,La Creation Neologique,12,417,5,QCM,0.16,0.87,92.26,13,1,14,14,13,1,1.0,92.86,Facile,Facile,0,Meme Difficulté,Pas Adapte,Marketing
3788,2018,Marketing,4,Neologie,3,La Creation Neologique,12,417,5,QCM,0.42,0.36,61.82,9,5,14,11,9,2,1.27,81.82,Difficile,Moyen,1,Plus Facile,Adapte,Marketing
4912,2019,Marketing,4,Neologie,3,La Creation Neologique,12,417,5,QCM,0.32,0.43,61.82,7,5,12,10,7,3,1.2,70.0,Moyen,Moyen,0,Meme Difficulté,Adapte,Marketing
6036,2020,Marketing,4,Neologie,3,La Creation Neologique,12,417,5,QO,0.47,0.27,61.82,7,4,11,7,7,0,1.57,100.0,Moyen,Moyen,0,Meme Difficulté,Adapte,Marketing
417,2015,Marketing,4,Neologie,3,La Creation Neologique,12,418,6,QCM,0.19,0.98,78.17,18,5,23,21,18,3,1.1,85.71,Moyen,Facile,1,Plus Facile,Pas Adapte,Marketing
1541,2016,Marketing,4,Neologie,3,La Creation Neologique,12,418,6,QCM,0.12,0.86,97.42,25,1,26,25,25,0,1.04,100.0,Difficile,Facile,2,Beaucoup plus Facile,Pas Adapte,Marketing
2665,2017,Marketing,4,Neologie,3,La Creation Neologique,12,418,6,QCM,0.76,0.3,32.26,7,16,23,17,7,10,1.35,41.18,Difficile,Difficile,0,Meme Difficulté,Pas Adapte,Marketing
3789,2018,Marketing,4,Neologie,3,La Creation Neologique,12,418,6,QCU,0.53,0.35,3.9,1,23,24,12,1,11,2.0,8.33,Facile,Difficile,-2,Beaucoup plus Difficile,Pas Adapte,Marketing
4913,2019,Marketing,4,Neologie,3,La Creation Neologique,12,418,6,QCU,0.6,0.4,5.89,1,19,20,16,1,15,1.25,6.25,Difficile,Difficile,0,Meme Difficulté,Pas Adapte,Marketing
6037,2020,Marketing,4,Neologie,3,La Creation Neologique,12,418,6,QCU,0.05,0.99,76.56,16,5,21,16,16,0,1.31,100.0,Moyen,Facile,1,Plus Facile,Pas Adapte,Marketing
418,2015,Marketing,4,Neologie,3,La Creation Neologique,12,419,7,QROC,0.35,0.33,53.48,36,31,67,67,36,31,1.0,53.73,Facile,Moyen,-1,Plus Difficile,Pas Adapte,Marketing
1542,2016,Marketing,4,Neologie,3,La Creation Neologique,12,419,7,QROC,0.88,0.06,33.96,22,42,64,52,22,30,1.23,42.31,Difficile,Difficile,0,Meme Difficulté,Pas Adapte,Marketing
2666,2017,Marketing,4,Neologie,3,La Creation Neologique,12,419,7,QROC,0.8,0.01,22.91,16,54,70,65,16,49,1.08,24.62,Difficile,Difficile,0,Meme Difficulté,Pas Adapte,Marketing
3790,2018,Marketing,4,Neologie,3,La Creation Neologique,12,419,7,QROC,0.82,0.01,28.7,20,48,68,30,20,10,2.27,66.67,Moyen,Difficile,-1,Plus Difficile,Pas Adapte,Marketing
4914,2019,Marketing,4,Neologie,3,La Creation Neologique,12,419,7,QROC,0.02,0.76,84.22,51,9,60,59,51,8,1.02,86.44,Facile,Facile,0,Meme Difficulté,Pas Adapte,Marketing
6038,2020,Marketing,4,Neologie,3,La Creation Neologique,12,419,7,QO,0.45,0.3,60.81,32,20,52,45,32,13,1.16,71.11,Moyen,Moyen,0,Meme Difficulté,Adapte,Marketing
419,2015,Marketing,4,Neologie,3,La Creation Neologique,12,420,8,QCM,0.5,0.67,38.05,16,27,43,32,16,16,1.34,50.0,Facile,Moyen,-1,Plus Difficile,Pas Adapte,Marketing
1543,2016,Marketing,4,Neologie,3,La Creation Neologique,12,420,8,QCM,0.6,0.23,32.51,15,32,47,21,15,6,2.24,71.43,Facile,Difficile,-2,Beaucoup plus Difficile,Pas Adapte,Marketing
2667,2017,Marketing,4,Neologie,3,La Creation Neologique,12,420,8,QCM,0.48,0.67,55.49,26,21,47,33,26,7,1.42,78.79,Facile,Moyen,-1,Plus Difficile,Pas Adapte,Marketing
3791,2018,Marketing,4,Neologie,3,La Creation Neologique,12,420,8,QCU,0.07,0.88,96.68,39,1,40,40,39,1,1.0,97.5,Moyen,Facile,1,Plus Facile,Pas Adapte,Marketing
4915,2019,Marketing,4,Neologie,3,La Creation Neologique,12,420,8,QCM,0.62,0.2,31.01,13,29,42,14,13,1,3.0,92.86,Moyen,Difficile,-1,Plus Difficile,Pas Adapte,Marketing
6039,2020,Marketing,4,Neologie,3,La Creation Neologique,12,420,8,QCM,0.66,0.25,5.85,3,42,45,27,3,24,1.67,11.11,Facile,Difficile,-2,Beaucoup plus Difficile,Pas Adapte,Marketing
420,2015,Marketing,4,Neologie,3,La Creation Neologique,12,421,9,QCM,0.6,0.16,23.83,10,31,41,16,10,6,2.56,62.5,Moyen,Difficile,-1,Plus Difficile,Pas Adapte,Marketing
1544,2016,Marketing,4,Neologie,3,La Creation Neologique,12,421,9,QCM,0.02,0.8,72.59,28,10,38,35,28,7,1.09,80.0,Facile,Facile,0,Meme Difficulté,Adapte,Marketing
2668,2017,Marketing,4,Neologie,3,La Creation Neologique,12,421,9,QCM,0.15,0.85,72.59,26,10,36,35,26,9,1.03,74.29,Facile,Facile,0,Meme Difficulté,Adapte,Marketing
3792,2018,Marketing,4,Neologie,3,La Creation Neologique,12,421,9,QCM,0.14,0.95,72.59,29,11,40,33,29,4,1.21,87.88,Facile,Facile,0,Meme Difficulté,Adapte,Marketing
4916,2019,Marketing,4,Neologie,3,La Creation Neologique,12,421,9,QCM,0.1,0.79,72.59,29,11,40,32,29,3,1.25,90.62,Facile,Facile,0,Meme Difficulté,Adapte,Marketing
6040,2020,Marketing,4,Neologie,3,La Creation Neologique,12,421,9,QCM,0.11,0.76,72.59,28,10,38,35,28,7,1.09,80.0,Facile,Facile,0,Meme Difficulté,Adapte,Marketing
421,2015,Marketing,4,Neologie,3,La Creation Neologique,12,422,10,QROC,0.75,0.23,7.2,6,78,84,66,6,60,1.27,9.09,Facile,Difficile,-2,Beaucoup plus Difficile,Pas Adapte,Marketing
1545,2016,Marketing,4,Neologie,3,La Creation Neologique,12,422,10,QROC,0.76,0.18,20.73,15,59,74,57,15,42,1.3,26.32,Difficile,Difficile,0,Meme Difficulté,Pas Adapte,Marketing
2669,2017,Marketing,4,Neologie,3,La Creation Neologique,12,422,10,QROC,0.83,0.1,6.25,5,77,82,38,5,33,2.16,13.16,Difficile,Difficile,0,Meme Difficulté,Pas Adapte,Marketing
3793,2018,Marketing,4,Neologie,3,La Creation Neologique,12,422,10,QCM,0.14,0.99,87.57,69,10,79,74,69,5,1.07,93.24,Moyen,Facile,1,Plus Facile,Pas Adapte,Marketing
4917,2019,Marketing,4,Neologie,3,La Creation Neologique,12,422,10,QCU,0.28,0.74,39.26,29,45,74,46,29,17,1.61,63.04,Facile,Moyen,-1,Plus Difficile,Pas Adapte,Marketing
6041,2020,Marketing,4,Neologie,3,La Creation Neologique,12,422,10,QCU,0.16,0.9,67.36,44,22,66,60,44,16,1.1,73.33,Moyen,Facile,1,Plus Facile,Adapte,Marketing
422,2015,Marketing,4,Neologie,3,La Creation Neologique,12,423,11,QCM,0.4,0.51,50.17,24,23,47,35,24,11,1.34,68.57,Facile,Moyen,-1,Plus Difficile,Pas Adapte,Marketing
1546,2016,Marketing,4,Neologie,3,La Creation Neologique,12,423,11,QCM,0.65,0.28,30.99,16,36,52,33,16,17,1.58,48.48,Facile,Difficile,-2,Beaucoup plus Difficile,Pas Adapte,Marketing
2670,2017,Marketing,4,Neologie,3,La Creation Neologique,12,423,11,QCM,0.49,0.61,56.96,27,21,48,37,27,10,1.3,72.97,Moyen,Moyen,0,Meme Difficulté,Pas Adapte,Marketing
3794,2018,Marketing,4,Neologie,3,La Creation Neologique,12,423,11,QO,0.43,0.27,57.19,29,22,51,35,29,6,1.46,82.86,Moyen,Moyen,0,Meme Difficulté,Pas Adapte,Marketing
4918,2019,Marketing,4,Neologie,3,La Creation Neologique,12,423,11,QO,0.37,0.2,54.93,25,20,45,39,25,14,1.15,64.1,Facile,Moyen,-1,Plus Difficile,Pas Adapte,Marketing
6042,2020,Marketing,4,Neologie,3,La Creation Neologique,12,423,11,QO,0.31,0.17,36.18,17,31,48,35,17,18,1.37,48.57,Difficile,Moyen,1,Plus Facile,Pas Adapte,Marketing
423,2015,Marketing,4,Neologie,3,La Creation Neologique,12,424,12,QCM,0.65,0.26,27.57,16,43,59,17,16,1,3.47,94.12,Difficile,Difficile,0,Meme Difficulté,Pas Adapte,Marketing
1547,2016,Marketing,4,Neologie,3,La Creation Neologique,12,424,12,QCM,0.1,0.72,85.36,55,10,65,60,55,5,1.08,91.67,Difficile,Facile,2,Beaucoup plus Facile,Pas Adapte,Marketing
2671,2017,Marketing,4,Neologie,3,La Creation Neologique,12,424,12,QCM,0.62,0.27,4.31,3,70,73,23,3,20,3.17,13.04,Facile,Difficile,-2,Beaucoup plus Difficile,Pas Adapte,Marketing
3795,2018,Marketing,4,Neologie,3,La Creation Neologique,12,424,12,QCM,0.57,0.23,28.64,19,48,67,35,19,16,1.91,54.29,Moyen,Difficile,-1,Plus Difficile,Pas Adapte,Marketing
4919,2019,Marketing,4,Neologie,3,La Creation Neologique,12,424,12,QCM,0.58,0.29,28.29,16,41,57,18,16,2,3.17,88.89,Facile,Difficile,-2,Beaucoup plus Difficile,Pas Adapte,Marketing
6043,2020,Marketing,4,Neologie,3,La Creation Neologique,12,424,12,QCM,0.19,0.77,76.11,47,15,62,56,47,9,1.11,83.93,Moyen,Facile,1,Plus Facile,Pas Adapte,Marketing
424,2015,Marketing,4,Neologie,4,Les Accidents Lexicaux,11,425,1,QCM,0.65,0.16,11.57,9,72,81,40,9,31,2.02,22.5,Difficile,Difficile,0,Meme Difficulté,Pas Adapte,Marketing
1548,2016,Marketing,4,Neologie,4,Les Accidents Lexicaux,11,425,1,QCM,0.23,0.49,45.53,39,46,85,50,39,11,1.7,78.0,Moyen,Moyen,0,Meme Difficulté,Pas Adapte,Marketing
2672,2017,Marketing,4,Neologie,4,Les Accidents Lexicaux,11,425,1,QCM,0.02,0.87,99.66,72,0,72,72,72,0,1.0,100.0,Moyen,Facile,1,Plus Facile,Pas Adapte,Marketing
3796,2018,Marketing,4,Neologie,4,Les Accidents Lexicaux,11,425,1,QCM,0.5,0.29,3.96,3,76,79,29,3,26,2.72,10.34,Moyen,Difficile,-1,Plus Difficile,Pas Adapte,Marketing
4920,2019,Marketing,4,Neologie,4,Les Accidents Lexicaux,11,425,1,QCM,0.35,0.47,63.87,45,25,70,61,45,16,1.15,73.77,Moyen,Moyen,0,Meme Difficulté,Adapte,Marketing
6044,2020,Marketing,4,Neologie,4,Les Accidents Lexicaux,11,425,1,QCM,0.43,0.68,63.87,40,22,62,55,40,15,1.13,72.73,Moyen,Moyen,0,Meme Difficulté,Adapte,Marketing
425,2015,Marketing,4,Neologie,4,Les Accidents Lexicaux,11,426,2,QCU,0.72,0.23,9.11,8,80,88,64,8,56,1.38,12.5,Difficile,Difficile,0,Meme Difficulté,Pas Adapte,Marketing
1549,2016,Marketing,4,Neologie,4,Les Accidents Lexicaux,11,426,2,QCU,0.64,0.27,6.56,6,83,89,88,6,82,1.01,6.82,Difficile,Difficile,0,Meme Difficulté,Pas Adapte,Marketing
2673,2017,Marketing,4,Neologie,4,Les Accidents Lexicaux,11,426,2,QCU,0.18,0.94,68.81,65,29,94,68,65,3,1.38,95.59,Difficile,Facile,2,Beaucoup plus Facile,Adapte,Marketing
3797,2018,Marketing,4,Neologie,4,Les Accidents Lexicaux,11,426,2,QCU,0.04,0.9,68.81,69,31,100,90,69,21,1.11,76.67,Facile,Facile,0,Meme Difficulté,Adapte,Marketing
4921,2019,Marketing,4,Neologie,4,Les Accidents Lexicaux,11,426,2,QCU,0.18,0.96,68.81,74,34,108,96,74,22,1.12,77.08,Facile,Facile,0,Meme Difficulté,Adapte,Marketing
6045,2020,Marketing,4,Neologie,4,Les Accidents Lexicaux,11,426,2,QCU,0.15,0.96,68.81,69,31,100,70,69,1,1.43,98.57,Facile,Facile,0,Meme Difficulté,Adapte,Marketing
426,2015,Marketing,4,Neologie,4,Les Accidents Lexicaux,11,427,3,QCU,0.15,0.89,71.24,33,13,46,38,33,5,1.21,86.84,Moyen,Facile,1,Plus Facile,Adapte,Marketing
1550,2016,Marketing,4,Neologie,4,Les Accidents Lexicaux,11,427,3,QCU,0.07,0.78,71.24,29,12,41,31,29,2,1.32,93.55,Facile,Facile,0,Meme Difficulté,Adapte,Marketing
2674,2017,Marketing,4,Neologie,4,Les Accidents Lexicaux,11,427,3,QCU,0.15,0.76,71.24,31,12,43,32,31,1,1.34,96.88,Facile,Facile,0,Meme Difficulté,Adapte,Marketing
3798,2018,Marketing,4,Neologie,4,Les Accidents Lexicaux,11,427,3,QCU,0.14,0.97,71.24,34,14,48,48,34,14,1.0,70.83,Facile,Facile,0,Meme Difficulté,Adapte,Marketing
4922,2019,Marketing,4,Neologie,4,Les Accidents Lexicaux,11,427,3,QCU,0.2,0.84,71.24,36,15,51,36,36,0,1.42,100.0,Facile,Facile,0,Meme Difficulté,Adapte,Marketing
6046,2020,Marketing,4,Neologie,4,Les Accidents Lexicaux,11,427,3,QCU,0.19,0.94,71.24,36,15,51,37,36,1,1.38,97.3,Facile,Facile,0,Meme Difficulté,Adapte,Marketing
427,2015,Marketing,4,Neologie,4,Les Accidents Lexicaux,11,428,4,QCU,0.2,0.57,35.16,4,7,11,10,4,6,1.1,40.0,Moyen,Moyen,0,Meme Difficulté,Pas Adapte,Marketing
1551,2016,Marketing,4,Neologie,4,Les Accidents Lexicaux,11,428,4,QCM,0.77,0.17,18.56,2,9,11,8,2,6,1.38,25.0,Facile,Difficile,-2,Beaucoup plus Difficile,Pas Adapte,Marketing
2675,2017,Marketing,4,Neologie,4,Les Accidents Lexicaux,11,428,4,QCM,0.34,0.53,39.61,4,7,11,6,4,2,1.83,66.67,Moyen,Moyen,0,Meme Difficulté,Pas Adapte,Marketing
3799,2018,Marketing,4,Neologie,4,Les Accidents Lexicaux,11,428,4,QCM,0.7,0.24,21.39,2,8,10,6,2,4,1.67,33.33,Difficile,Difficile,0,Meme Difficulté,Pas Adapte,Marketing
4923,2019,Marketing,4,Neologie,4,Les Accidents Lexicaux,11,428,4,QCU,0.17,0.77,93.31,7,1,8,7,7,0,1.14,100.0,Difficile,Facile,2,Beaucoup plus Facile,Pas Adapte,Marketing
6047,2020,Marketing,4,Neologie,4,Les Accidents Lexicaux,11,428,4,QCU,0.61,0.34,14.52,1,7,8,3,1,2,2.67,33.33,Moyen,Difficile,-1,Plus Difficile,Pas Adapte,Marketing
428,2015,Marketing,4,Neologie,4,Les Accidents Lexicaux,11,429,5,QCU,0.55,0.33,4.75,2,49,51,36,2,34,1.42,5.56,Difficile,Difficile,0,Meme Difficulté,Pas Adapte,Marketing
1552,2016,Marketing,4,Neologie,4,Les Accidents Lexicaux,11,429,5,QCU,0.12,0.94,90.85,44,4,48,45,44,1,1.07,97.78,Facile,Facile,0,Meme Difficulté,Pas Adapte,Marketing
2676,2017,Marketing,4,Neologie,4,Les Accidents Lexicaux,11,429,5,QCU,0.54,0.21,33.44,17,33,50,30,17,13,1.67,56.67,Facile,Difficile,-2,Beaucoup plus Difficile,Pas Adapte,Marketing
3800,2018,Marketing,4,Neologie,4,Les Accidents Lexicaux,11,429,5,QCU,0.14,0.83,83.49,38,7,45,42,38,4,1.07,90.48,Difficile,Facile,2,Beaucoup plus Facile,Pas Adapte,Marketing
4924,2019,Marketing,4,Neologie,4,Les Accidents Lexicaux,11,429,5,QCU,0.3,0.67,44.41,17,21,38,17,17,0,2.24,100.0,Facile,Moyen,-1,Plus Difficile,Pas Adapte,Marketing
6048,2020,Marketing,4,Neologie,4,Les Accidents Lexicaux,11,429,5,QCU,0.51,0.24,32.36,14,28,42,19,14,5,2.21,73.68,Facile,Difficile,-2,Beaucoup plus Difficile,Pas Adapte,Marketing
429,2015,Marketing,4,Neologie,4,Les Accidents Lexicaux,11,430,6,QCM,0.19,0.76,65.7,3,2,5,5,3,2,1.0,60.0,Facile,Facile,0,Meme Difficulté,Adapte,Marketing
1553,2016,Marketing,4,Neologie,4,Les Accidents Lexicaux,11,430,6,QCM,0.17,0.79,65.7,3,2,5,3,3,0,1.67,100.0,Facile,Facile,0,Meme Difficulté,Adapte,Marketing
2677,2017,Marketing,4,Neologie,4,Les Accidents Lexicaux,11,430,6,QCM,0.07,0.78,65.7,3,1,4,4,3,1,1.0,75.0,Facile,Facile,0,Meme Difficulté,Adapte,Marketing
3801,2018,Marketing,4,Neologie,4,Les Accidents Lexicaux,11,430,6,QCU,0.08,0.92,65.7,3,2,5,5,3,2,1.0,60.0,Facile,Facile,0,Meme Difficulté,Adapte,Marketing
4925,2019,Marketing,4,Neologie,4,Les Accidents Lexicaux,11,430,6,QCU,0.09,0.86,65.7,3,1,4,3,3,0,1.33,100.0,Facile,Facile,0,Meme Difficulté,Adapte,Marketing
6049,2020,Marketing,4,Neologie,4,Les Accidents Lexicaux,11,430,6,QCM,0.02,0.93,65.7,3,2,5,3,3,0,1.67,100.0,Facile,Facile,0,Meme Difficulté,Adapte,Marketing
430,2015,Marketing,4,Neologie,4,Les Accidents Lexicaux,11,431,7,QCM,0.11,0.79,71.28,48,19,67,64,48,16,1.05,75.0,Facile,Facile,0,Meme Difficulté,Adapte,Marketing
1554,2016,Marketing,4,Neologie,4,Les Accidents Lexicaux,11,431,7,QCM,0.07,0.78,71.28,48,20,68,58,48,10,1.17,82.76,Facile,Facile,0,Meme Difficulté,Adapte,Marketing
2678,2017,Marketing,4,Neologie,4,Les Accidents Lexicaux,11,431,7,QCM,0.03,0.88,71.28,44,18,62,54,44,10,1.15,81.48,Facile,Facile,0,Meme Difficulté,Adapte,Marketing
3802,2018,Marketing,4,Neologie,4,Les Accidents Lexicaux,11,431,7,QCM,0.1,0.79,71.28,39,16,55,51,39,12,1.08,76.47,Facile,Facile,0,Meme Difficulté,Adapte,Marketing
4926,2019,Marketing,4,Neologie,4,Les Accidents Lexicaux,11,431,7,QCU,0.17,0.96,71.28,42,17,59,52,42,10,1.13,80.77,Facile,Facile,0,Meme Difficulté,Adapte,Marketing
6050,2020,Marketing,4,Neologie,4,Les Accidents Lexicaux,11,431,7,QCU,0.16,0.76,71.28,37,15,52,45,37,8,1.16,82.22,Facile,Facile,0,Meme Difficulté,Adapte,Marketing
431,2015,Marketing,4,Neologie,4,Les Accidents Lexicaux,11,432,8,QCM,0.54,0.29,2.31,2,72,74,26,2,24,2.85,7.69,Difficile,Difficile,0,Meme Difficulté,Pas Adapte,Marketing
1555,2016,Marketing,4,Neologie,4,Les Accidents Lexicaux,11,432,8,QCM,0.53,0.27,34.01,26,50,76,61,26,35,1.25,42.62,Facile,Difficile,-2,Beaucoup plus Difficile,Pas Adapte,Marketing
2679,2017,Marketing,4,Neologie,4,Les Accidents Lexicaux,11,432,8,QCM,0.54,0.23,6.84,6,81,87,70,6,64,1.24,8.57,Difficile,Difficile,0,Meme Difficulté,Pas Adapte,Marketing
3803,2018,Marketing,4,Neologie,4,Les Accidents Lexicaux,11,432,8,QCM,0.06,1.0,80.33,79,19,98,83,79,4,1.18,95.18,Moyen,Facile,1,Plus Facile,Pas Adapte,Marketing
4927,2019,Marketing,4,Neologie,4,Les Accidents Lexicaux,11,432,8,QCM,0.4,0.32,61.33,63,39,102,66,63,3,1.55,95.45,Facile,Moyen,-1,Plus Difficile,Adapte,Marketing
6051,2020,Marketing,4,Neologie,4,Les Accidents Lexicaux,11,432,8,QCM,0.44,0.39,61.33,69,43,112,88,69,19,1.27,78.41,Moyen,Moyen,0,Meme Difficulté,Adapte,Marketing
432,2015,Marketing,4,Neologie,4,Les Accidents Lexicaux,11,433,9,QROC,0.01,0.47,81.5,73,17,90,82,73,9,1.1,89.02,Facile,Facile,0,Meme Difficulté,Pas Adapte,Marketing
1556,2016,Marketing,4,Neologie,4,Les Accidents Lexicaux,11,433,9,QROC,0.03,0.93,79.8,69,17,86,83,69,14,1.04,83.13,Difficile,Facile,2,Beaucoup plus Facile,Pas Adapte,Marketing
2680,2017,Marketing,4,Neologie,4,Les Accidents Lexicaux,11,433,9,QO,0.18,0.43,95.14,72,4,76,74,72,2,1.03,97.3,Moyen,Facile,1,Plus Facile,Pas Adapte,Marketing
3804,2018,Marketing,4,Neologie,4,Les Accidents Lexicaux,11,433,9,QO,0.16,0.33,83.32,61,12,73,70,61,9,1.04,87.14,Difficile,Facile,2,Beaucoup plus Facile,Pas Adapte,Marketing
4928,2019,Marketing,4,Neologie,4,Les Accidents Lexicaux,11,433,9,QO,0.84,0.01,7.49,5,58,63,37,5,32,1.7,13.51,Difficile,Difficile,0,Meme Difficulté,Pas Adapte,Marketing
6052,2020,Marketing,4,Neologie,4,Les Accidents Lexicaux,11,433,9,QO,0.14,0.64,85.96,58,10,68,67,58,9,1.01,86.57,Moyen,Facile,1,Plus Facile,Pas Adapte,Marketing
433,2015,Marketing,4,Neologie,4,Les Accidents Lexicaux,11,434,10,QCU,0.18,0.82,89.56,36,4,40,39,36,3,1.03,92.31,Moyen,Facile,1,Plus Facile,Pas Adapte,Marketing
1557,2016,Marketing,4,Neologie,4,Les Accidents Lexicaux,11,434,10,QO,0.58,0.24,43.06,17,22,39,34,17,17,1.15,50.0,Facile,Moyen,-1,Plus Difficile,Pas Adapte,Marketing
2681,2017,Marketing,4,Neologie,4,Les Accidents Lexicaux,11,434,10,QO,0.94,0.02,30.7,13,30,43,25,13,12,1.72,52.0,Facile,Difficile,-2,Beaucoup plus Difficile,Pas Adapte,Marketing
3805,2018,Marketing,4,Neologie,4,Les Accidents Lexicaux,11,434,10,QROC,0.48,0.39,54.37,24,20,44,34,24,10,1.29,70.59,Facile,Moyen,-1,Plus Difficile,Pas Adapte,Marketing
4929,2019,Marketing,4,Neologie,4,Les Accidents Lexicaux,11,434,10,QROC,0.11,0.77,84.22,38,7,45,43,38,5,1.05,88.37,Moyen,Facile,1,Plus Facile,Pas Adapte,Marketing
6053,2020,Marketing,4,Neologie,4,Les Accidents Lexicaux,11,434,10,QROC,0.7,0.01,10.17,4,35,39,33,4,29,1.18,12.12,Facile,Difficile,-2,Beaucoup plus Difficile,Pas Adapte,Marketing
434,2015,Marketing,4,Neologie,4,Les Accidents Lexicaux,11,435,11,QCM,0.36,0.68,37.02,13,21,34,14,13,1,2.43,92.86,Moyen,Moyen,0,Meme Difficulté,Pas Adapte,Marketing
1558,2016,Marketing,4,Neologie,4,Les Accidents Lexicaux,11,435,11,QCM,0.65,0.28,10.43,3,27,30,12,3,9,2.5,25.0,Difficile,Difficile,0,Meme Difficulté,Pas Adapte,Marketing
2682,2017,Marketing,4,Neologie,4,Les Accidents Lexicaux,11,435,11,QCM,0.75,0.19,8.8,3,28,31,20,3,17,1.55,15.0,Difficile,Difficile,0,Meme Difficulté,Pas Adapte,Marketing
3806,2018,Marketing,4,Neologie,4,Les Accidents Lexicaux,11,435,11,QCM,0.6,0.28,5.68,2,28,30,30,2,28,1.0,6.67,Moyen,Difficile,-1,Plus Difficile,Pas Adapte,Marketing
4930,2019,Marketing,4,Neologie,4,Les Accidents Lexicaux,11,435,11,QCM,0.77,0.15,9.07,2,24,26,20,2,18,1.3,10.0,Difficile,Difficile,0,Meme Difficulté,Pas Adapte,Marketing
6054,2020,Marketing,4,Neologie,4,Les Accidents Lexicaux,11,435,11,QCM,0.42,0.37,44.3,13,17,30,19,13,6,1.58,68.42,Difficile,Moyen,1,Plus Facile,Pas Adapte,Marketing
435,2015,Marketing,5,Construction Morphologique,1,Alterations,14,436,1,QO,0.07,0.8,83.75,20,4,24,22,20,2,1.09,90.91,Facile,Facile,0,Meme Difficulté,Pas Adapte,Marketing
1559,2016,Marketing,5,Construction Morphologique,1,Alterations,14,436,1,QO,0.92,0.03,32.68,7,13,20,11,7,4,1.82,63.64,Facile,Difficile,-2,Beaucoup plus Difficile,Pas Adapte,Marketing
2683,2017,Marketing,5,Construction Morphologique,1,Alterations,14,436,1,QROC,0.98,0.08,5.0,1,16,17,7,1,6,2.43,14.29,Difficile,Difficile,0,Meme Difficulté,Pas Adapte,Marketing
3807,2018,Marketing,5,Construction Morphologique,1,Alterations,14,436,1,QROC,0.11,0.65,81.67,12,3,15,13,12,1,1.15,92.31,Difficile,Facile,2,Beaucoup plus Facile,Pas Adapte,Marketing
4931,2019,Marketing,5,Construction Morphologique,1,Alterations,14,436,1,QO,0.2,0.81,95.58,15,1,16,15,15,0,1.07,100.0,Difficile,Facile,2,Beaucoup plus Facile,Pas Adapte,Marketing
6055,2020,Marketing,5,Construction Morphologique,1,Alterations,14,436,1,QO,0.61,0.24,44.49,8,10,18,13,8,5,1.38,61.54,Facile,Moyen,-1,Plus Difficile,Pas Adapte,Marketing
436,2015,Marketing,5,Construction Morphologique,1,Alterations,14,437,2,QCM,0.59,0.24,14.94,13,74,87,23,13,10,3.78,56.52,Facile,Difficile,-2,Beaucoup plus Difficile,Pas Adapte,Marketing
1560,2016,Marketing,5,Construction Morphologique,1,Alterations,14,437,2,QCM,0.42,0.66,36.06,35,62,97,69,35,34,1.41,50.72,Moyen,Moyen,0,Meme Difficulté,Pas Adapte,Marketing
2684,2017,Marketing,5,Construction Morphologique,1,Alterations,14,437,2,QCM,0.07,0.86,92.31,86,7,93,92,86,6,1.01,93.48,Facile,Facile,0,Meme Difficulté,Pas Adapte,Marketing
3808,2018,Marketing,5,Construction Morphologique,1,Alterations,14,437,2,QCM,0.28,0.68,51.07,43,41,84,47,43,4,1.79,91.49,Moyen,Moyen,0,Meme Difficulté,Pas Adapte,Marketing
4932,2019,Marketing,5,Construction Morphologique,1,Alterations,14,437,2,QCM,0.15,0.89,92.2,86,7,93,87,86,1,1.07,98.85,Facile,Facile,0,Meme Difficulté,Pas Adapte,Marketing
6056,2020,Marketing,5,Construction Morphologique,1,Alterations,14,437,2,QCM,0.61,0.15,27.58,28,72,100,85,28,57,1.18,32.94,Difficile,Difficile,0,Meme Difficulté,Pas Adapte,Marketing
437,2015,Marketing,5,Construction Morphologique,1,Alterations,14,438,3,QCU,0.06,0.75,86.98,52,8,60,55,52,3,1.09,94.55,Moyen,Facile,1,Plus Facile,Pas Adapte,Marketing
1561,2016,Marketing,5,Construction Morphologique,1,Alterations,14,438,3,QCU,0.09,0.92,94.37,53,3,56,54,53,1,1.04,98.15,Difficile,Facile,2,Beaucoup plus Facile,Pas Adapte,Marketing
2685,2017,Marketing,5,Construction Morphologique,1,Alterations,14,438,3,QCU,0.11,0.8,82.25,49,10,59,49,49,0,1.2,100.0,Facile,Facile,0,Meme Difficulté,Pas Adapte,Marketing
3809,2018,Marketing,5,Construction Morphologique,1,Alterations,14,438,3,QCU,0.33,0.45,45.2,28,33,61,33,28,5,1.85,84.85,Facile,Moyen,-1,Plus Difficile,Pas Adapte,Marketing
4933,2019,Marketing,5,Construction Morphologique,1,Alterations,14,438,3,QCU,0.43,0.22,33.3,22,44,66,44,22,22,1.5,50.0,Moyen,Difficile,-1,Plus Difficile,Pas Adapte,Marketing
6057,2020,Marketing,5,Construction Morphologique,1,Alterations,14,438,3,QCU,0.67,0.26,7.4,5,57,62,27,5,22,2.3,18.52,Difficile,Difficile,0,Meme Difficulté,Pas Adapte,Marketing
438,2015,Marketing,5,Construction Morphologique,1,Alterations,14,439,4,QCU,0.61,0.28,34.41,30,58,88,55,30,25,1.6,54.55,Facile,Difficile,-2,Beaucoup plus Difficile,Pas Adapte,Marketing
1562,2016,Marketing,5,Construction Morphologique,1,Alterations,14,439,4,QCU,0.61,0.33,5.32,4,80,84,54,4,50,1.56,7.41,Moyen,Difficile,-1,Plus Difficile,Pas Adapte,Marketing
2686,2017,Marketing,5,Construction Morphologique,1,Alterations,14,439,4,QCU,0.05,0.78,72.0,62,24,86,63,62,1,1.37,98.41,Moyen,Facile,1,Plus Facile,Adapte,Marketing
3810,2018,Marketing,5,Construction Morphologique,1,Alterations,14,439,4,QCU,0.07,0.88,72.0,59,23,82,61,59,2,1.34,96.72,Facile,Facile,0,Meme Difficulté,Adapte,Marketing
4934,2019,Marketing,5,Construction Morphologique,1,Alterations,14,439,4,QCU,0.19,0.88,72.0,68,26,94,85,68,17,1.11,80.0,Facile,Facile,0,Meme Difficulté,Adapte,Marketing
6058,2020,Marketing,5,Construction Morphologique,1,Alterations,14,439,4,QCU,0.03,0.85,72.0,60,23,83,78,60,18,1.06,76.92,Facile,Facile,0,Meme Difficulté,Adapte,Marketing
439,2015,Marketing,5,Construction Morphologique,1,Alterations,14,440,5,QROC,0.53,0.25,61.32,18,11,29,23,18,5,1.26,78.26,Facile,Moyen,-1,Plus Difficile,Adapte,Marketing
1563,2016,Marketing,5,Construction Morphologique,1,Alterations,14,440,5,QROC,0.52,0.29,61.32,17,11,28,18,17,1,1.56,94.44,Moyen,Moyen,0,Meme Difficulté,Adapte,Marketing
2687,2017,Marketing,5,Construction Morphologique,1,Alterations,14,440,5,QROC,0.31,0.26,61.32,15,10,25,22,15,7,1.14,68.18,Moyen,Moyen,0,Meme Difficulté,Adapte,Marketing
3811,2018,Marketing,5,Construction Morphologique,1,Alterations,14,440,5,QROC,0.56,0.27,61.32,14,9,23,21,14,7,1.1,66.67,Moyen,Moyen,0,Meme Difficulté,Adapte,Marketing
4935,2019,Marketing,5,Construction Morphologique,1,Alterations,14,440,5,QROC,0.55,0.39,61.32,14,9,23,15,14,1,1.53,93.33,Moyen,Moyen,0,Meme Difficulté,Adapte,Marketing
6059,2020,Marketing,5,Construction Morphologique,1,Alterations,14,440,5,QROC,0.43,0.31,61.32,12,8,20,19,12,7,1.05,63.16,Moyen,Moyen,0,Meme Difficulté,Adapte,Marketing
440,2015,Marketing,5,Construction Morphologique,1,Alterations,14,441,6,QCM,0.75,0.29,31.09,13,29,42,27,13,14,1.56,48.15,Facile,Difficile,-2,Beaucoup plus Difficile,Pas Adapte,Marketing
1564,2016,Marketing,5,Construction Morphologique,1,Alterations,14,441,6,QCU,0.51,0.24,21.02,10,38,48,42,10,32,1.14,23.81,Difficile,Difficile,0,Meme Difficulté,Pas Adapte,Marketing
2688,2017,Marketing,5,Construction Morphologique,1,Alterations,14,441,6,QCU,0.51,0.4,2.49,1,49,50,47,1,46,1.06,2.13,Facile,Difficile,-2,Beaucoup plus Difficile,Pas Adapte,Marketing
3812,2018,Marketing,5,Construction Morphologique,1,Alterations,14,441,6,QCU,0.13,0.95,89.7,44,5,49,44,44,0,1.11,100.0,Moyen,Facile,1,Plus Facile,Pas Adapte,Marketing
4936,2019,Marketing,5,Construction Morphologique,1,Alterations,14,441,6,QCU,0.51,0.28,18.6,8,35,43,40,8,32,1.07,20.0,Moyen,Difficile,-1,Plus Difficile,Pas Adapte,Marketing
6060,2020,Marketing,5,Construction Morphologique,1,Alterations,14,441,6,QCU,0.31,0.62,49.8,24,25,49,47,24,23,1.04,51.06,Facile,Moyen,-1,Plus Difficile,Pas Adapte,Marketing
441,2015,Marketing,5,Construction Morphologique,1,Alterations,14,442,7,QROC,0.16,0.85,93.67,90,6,96,93,90,3,1.03,96.77,Facile,Facile,0,Meme Difficulté,Pas Adapte,Marketing
1565,2016,Marketing,5,Construction Morphologique,1,Alterations,14,442,7,QROC,0.0,0.89,87.91,80,11,91,82,80,2,1.11,97.56,Difficile,Facile,2,Beaucoup plus Facile,Pas Adapte,Marketing
2689,2017,Marketing,5,Construction Morphologique,1,Alterations,14,442,7,QROC,0.52,0.34,59.11,55,38,93,68,55,13,1.37,80.88,Moyen,Moyen,0,Meme Difficulté,Pas Adapte,Marketing
3813,2018,Marketing,5,Construction Morphologique,1,Alterations,14,442,7,QROC,0.86,0.13,11.17,12,94,106,53,12,41,2.0,22.64,Difficile,Difficile,0,Meme Difficulté,Pas Adapte,Marketing
4937,2019,Marketing,5,Construction Morphologique,1,Alterations,14,442,7,QROC,0.63,0.24,8.07,9,105,114,48,9,39,2.38,18.75,Facile,Difficile,-2,Beaucoup plus Difficile,Pas Adapte,Marketing
6061,2020,Marketing,5,Construction Morphologique,1,Alterations,14,442,7,QO,0.89,0.03,23.18,27,88,115,80,27,53,1.44,33.75,Moyen,Difficile,-1,Plus Difficile,Pas Adapte,Marketing
442,2015,Marketing,5,Construction Morphologique,1,Alterations,14,443,8,QCU,0.12,0.85,94.22,70,4,74,72,70,2,1.03,97.22,Facile,Facile,0,Meme Difficulté,Pas Adapte,Marketing
1566,2016,Marketing,5,Construction Morphologique,1,Alterations,14,443,8,QCU,0.28,0.49,46.65,38,43,81,42,38,4,1.93,90.48,Moyen,Moyen,0,Meme Difficulté,Pas Adapte,Marketing
2690,2017,Marketing,5,Construction Morphologique,1,Alterations,14,443,8,QCM,0.07,0.94,90.36,72,8,80,79,72,7,1.01,91.14,Difficile,Facile,2,Beaucoup plus Facile,Pas Adapte,Marketing
3814,2018,Marketing,5,Construction Morphologique,1,Alterations,14,443,8,QCM,0.43,0.52,55.18,45,37,82,53,45,8,1.55,84.91,Difficile,Moyen,1,Plus Facile,Pas Adapte,Marketing
4938,2019,Marketing,5,Construction Morphologique,1,Alterations,14,443,8,QCM,0.71,0.26,20.51,19,74,93,25,19,6,3.72,76.0,Moyen,Difficile,-1,Plus Difficile,Pas Adapte,Marketing
6062,2020,Marketing,5,Construction Morphologique,1,Alterations,14,443,8,QCM,0.76,0.24,9.62,8,80,88,50,8,42,1.76,16.0,Moyen,Difficile,-1,Plus Difficile,Pas Adapte,Marketing
443,2015,Marketing,5,Construction Morphologique,1,Alterations,14,444,9,QCU,0.62,0.32,3.02,3,84,87,77,3,74,1.13,3.9,Facile,Difficile,-2,Beaucoup plus Difficile,Pas Adapte,Marketing
1567,2016,Marketing,5,Construction Morphologique,1,Alterations,14,444,9,QCU,0.71,0.26,11.62,12,87,99,34,12,22,2.91,35.29,Difficile,Difficile,0,Meme Difficulté,Pas Adapte,Marketing
2691,2017,Marketing,5,Construction Morphologique,1,Alterations,14,444,9,QCU,0.45,0.24,3.1,4,109,113,42,4,38,2.69,9.52,Facile,Difficile,-2,Beaucoup plus Difficile,Pas Adapte,Marketing
3815,2018,Marketing,5,Construction Morphologique,1,Alterations,14,444,9,QCU,0.04,0.84,71.72,75,30,105,77,75,2,1.36,97.4,Facile,Facile,0,Meme Difficulté,Adapte,Marketing
4939,2019,Marketing,5,Construction Morphologique,1,Alterations,14,444,9,QCU,0.04,0.82,71.72,78,31,109,95,78,17,1.15,82.11,Facile,Facile,0,Meme Difficulté,Adapte,Marketing
6063,2020,Marketing,5,Construction Morphologique,1,Alterations,14,444,9,QCM,0.06,0.96,71.72,78,31,109,95,78,17,1.15,82.11,Facile,Facile,0,Meme Difficulté,Adapte,Marketing
444,2015,Marketing,5,Construction Morphologique,1,Alterations,14,445,10,QCU,0.68,0.39,29.07,13,31,44,27,13,14,1.63,48.15,Facile,Difficile,-2,Beaucoup plus Difficile,Pas Adapte,Marketing
1568,2016,Marketing,5,Construction Morphologique,1,Alterations,14,445,10,QCU,0.58,0.28,28.85,14,33,47,27,14,13,1.74,51.85,Facile,Difficile,-2,Beaucoup plus Difficile,Pas Adapte,Marketing
2692,2017,Marketing,5,Construction Morphologique,1,Alterations,14,445,10,QCU,0.28,0.74,63.68,31,17,48,41,31,10,1.17,75.61,Difficile,Moyen,1,Plus Facile,Adapte,Marketing
3816,2018,Marketing,5,Construction Morphologique,1,Alterations,14,445,10,QCU,0.25,0.59,63.68,30,17,47,41,30,11,1.15,73.17,Moyen,Moyen,0,Meme Difficulté,Adapte,Marketing
4940,2019,Marketing,5,Construction Morphologique,1,Alterations,14,445,10,QCU,0.21,0.56,63.68,33,19,52,47,33,14,1.11,70.21,Moyen,Moyen,0,Meme Difficulté,Adapte,Marketing
6064,2020,Marketing,5,Construction Morphologique,1,Alterations,14,445,10,QCU,0.24,0.51,63.68,36,21,57,48,36,12,1.19,75.0,Moyen,Moyen,0,Meme Difficulté,Adapte,Marketing
445,2015,Marketing,5,Construction Morphologique,1,Alterations,14,446,11,QCU,0.29,0.49,61.37,39,24,63,41,39,2,1.54,95.12,Moyen,Moyen,0,Meme Difficulté,Adapte,Marketing
1569,2016,Marketing,5,Construction Morphologique,1,Alterations,14,446,11,QCU,0.33,0.68,61.37,42,26,68,58,42,16,1.17,72.41,Moyen,Moyen,0,Meme Difficulté,Adapte,Marketing
2693,2017,Marketing,5,Construction Morphologique,1,Alterations,14,446,11,QCU,0.22,0.62,61.37,44,27,71,61,44,17,1.16,72.13,Moyen,Moyen,0,Meme Difficulté,Adapte,Marketing
3817,2018,Marketing,5,Construction Morphologique,1,Alterations,14,446,11,QCM,0.4,0.55,61.37,39,24,63,47,39,8,1.34,82.98,Moyen,Moyen,0,Meme Difficulté,Adapte,Marketing
4941,2019,Marketing,5,Construction Morphologique,1,Alterations,14,446,11,QCM,0.31,0.54,61.37,34,22,56,46,34,12,1.22,73.91,Moyen,Moyen,0,Meme Difficulté,Adapte,Marketing
6065,2020,Marketing,5,Construction Morphologique,1,Alterations,14,446,11,QO,0.33,0.22,61.37,31,19,50,33,31,2,1.52,93.94,Moyen,Moyen,0,Meme Difficulté,Adapte,Marketing
446,2015,Marketing,5,Construction Morphologique,1,Alterations,14,447,12,QCM,0.38,0.42,42.2,38,53,91,67,38,29,1.36,56.72,Moyen,Moyen,0,Meme Difficulté,Pas Adapte,Marketing
1570,2016,Marketing,5,Construction Morphologique,1,Alterations,14,447,12,QCM,0.14,0.78,75.21,67,22,89,71,67,4,1.25,94.37,Facile,Facile,0,Meme Difficulté,Pas Adapte,Marketing
2694,2017,Marketing,5,Construction Morphologique,1,Alterations,14,447,12,QCM,0.16,0.8,84.09,73,14,87,77,73,4,1.13,94.81,Difficile,Facile,2,Beaucoup plus Facile,Pas Adapte,Marketing
3818,2018,Marketing,5,Construction Morphologique,1,Alterations,14,447,12,QCM,0.21,0.41,41.17,40,58,98,68,40,28,1.44,58.82,Facile,Moyen,-1,Plus Difficile,Pas Adapte,Marketing
4942,2019,Marketing,5,Construction Morphologique,1,Alterations,14,447,12,QCM,0.06,0.95,71.03,68,28,96,92,68,24,1.04,73.91,Facile,Facile,0,Meme Difficulté,Adapte,Marketing
6066,2020,Marketing,5,Construction Morphologique,1,Alterations,14,447,12,QCM,0.09,0.88,71.03,64,26,90,65,64,1,1.38,98.46,Facile,Facile,0,Meme Difficulté,Adapte,Marketing
447,2015,Marketing,5,Construction Morphologique,1,Alterations,14,448,13,QCM,0.53,0.29,16.82,7,37,44,17,7,10,2.59,41.18,Facile,Difficile,-2,Beaucoup plus Difficile,Pas Adapte,Marketing
1571,2016,Marketing,5,Construction Morphologique,1,Alterations,14,448,13,QCM,0.59,0.21,30.3,14,32,46,41,14,27,1.12,34.15,Moyen,Difficile,-1,Plus Difficile,Pas Adapte,Marketing
2695,2017,Marketing,5,Construction Morphologique,1,Alterations,14,448,13,QCM,0.53,0.2,18.65,7,33,40,22,7,15,1.82,31.82,Difficile,Difficile,0,Meme Difficulté,Pas Adapte,Marketing
3819,2018,Marketing,5,Construction Morphologique,1,Alterations,14,448,13,QCM,0.01,0.83,74.11,30,11,41,33,30,3,1.24,90.91,Moyen,Facile,1,Plus Facile,Adapte,Marketing
4943,2019,Marketing,5,Construction Morphologique,1,Alterations,14,448,13,QROC,0.0,0.51,74.11,30,11,41,34,30,4,1.21,88.24,Facile,Facile,0,Meme Difficulté,Adapte,Marketing
6067,2020,Marketing,5,Construction Morphologique,1,Alterations,14,448,13,QROC,0.06,0.95,74.11,30,10,40,33,30,3,1.21,90.91,Facile,Facile,0,Meme Difficulté,Adapte,Marketing
448,2015,Marketing,5,Construction Morphologique,1,Alterations,14,449,14,QCM,0.78,0.26,1.89,2,84,86,30,2,28,2.87,6.67,Difficile,Difficile,0,Meme Difficulté,Pas Adapte,Marketing
1572,2016,Marketing,5,Construction Morphologique,1,Alterations,14,449,14,QCM,0.58,0.23,14.56,12,68,80,27,12,15,2.96,44.44,Facile,Difficile,-2,Beaucoup plus Difficile,Pas Adapte,Marketing
2696,2017,Marketing,5,Construction Morphologique,1,Alterations,14,449,14,QCU,0.02,0.85,74.18,52,18,70,52,52,0,1.35,100.0,Facile,Facile,0,Meme Difficulté,Adapte,Marketing
3820,2018,Marketing,5,Construction Morphologique,1,Alterations,14,449,14,QCU,0.07,0.88,74.18,47,17,64,48,47,1,1.33,97.92,Facile,Facile,0,Meme Difficulté,Adapte,Marketing
4944,2019,Marketing,5,Construction Morphologique,1,Alterations,14,449,14,QCU,0.19,0.89,74.18,44,15,59,56,44,12,1.05,78.57,Facile,Facile,0,Meme Difficulté,Adapte,Marketing
6068,2020,Marketing,5,Construction Morphologique,1,Alterations,14,449,14,QCU,0.08,0.94,74.18,40,14,54,44,40,4,1.23,90.91,Facile,Facile,0,Meme Difficulté,Adapte,Marketing
449,2015,Marketing,5,Construction Morphologique,2,Transferts,13,450,1,QCM,0.33,0.6,59.66,43,29,72,65,43,22,1.11,66.15,Moyen,Moyen,0,Meme Difficulté,Pas Adapte,Marketing
1573,2016,Marketing,5,Construction Morphologique,2,Transferts,13,450,1,QCU,0.27,0.53,45.72,37,44,81,46,37,9,1.76,80.43,Moyen,Moyen,0,Meme Difficulté,Pas Adapte,Marketing
2697,2017,Marketing,5,Construction Morphologique,2,Transferts,13,450,1,QCU,0.5,0.33,33.82,29,58,87,58,29,29,1.5,50.0,Moyen,Difficile,-1,Plus Difficile,Pas Adapte,Marketing
3821,2018,Marketing,5,Construction Morphologique,2,Transferts,13,450,1,QCU,0.26,0.73,52.04,41,37,78,67,41,26,1.16,61.19,Facile,Moyen,-1,Plus Difficile,Pas Adapte,Marketing
4945,2019,Marketing,5,Construction Morphologique,2,Transferts,13,450,1,QROC,0.9,0.1,28.09,24,63,87,70,24,46,1.24,34.29,Moyen,Difficile,-1,Plus Difficile,Pas Adapte,Marketing
6069,2020,Marketing,5,Construction Morphologique,2,Transferts,13,450,1,QO,0.65,0.26,35.63,33,60,93,72,33,39,1.29,45.83,Moyen,Moyen,0,Meme Difficulté,Pas Adapte,Marketing
450,2015,Marketing,5,Construction Morphologique,2,Transferts,13,451,2,QROC,0.08,0.98,81.28,33,8,41,33,33,0,1.24,100.0,Facile,Facile,0,Meme Difficulté,Pas Adapte,Marketing
1574,2016,Marketing,5,Construction Morphologique,2,Transferts,13,451,2,QROC,0.31,0.33,54.29,24,20,44,29,24,5,1.52,82.76,Difficile,Moyen,1,Plus Facile,Pas Adapte,Marketing
2698,2017,Marketing,5,Construction Morphologique,2,Transferts,13,451,2,QCM,0.71,0.27,10.82,4,34,38,34,4,30,1.12,11.76,Difficile,Difficile,0,Meme Difficulté,Pas Adapte,Marketing
3822,2018,Marketing,5,Construction Morphologique,2,Transferts,13,451,2,QCM,0.64,0.24,10.02,4,40,44,41,4,37,1.07,9.76,Moyen,Difficile,-1,Plus Difficile,Pas Adapte,Marketing
4946,2019,Marketing,5,Construction Morphologique,2,Transferts,13,451,2,QCM,0.05,0.85,93.92,37,2,39,37,37,0,1.05,100.0,Facile,Facile,0,Meme Difficulté,Pas Adapte,Marketing
6070,2020,Marketing,5,Construction Morphologique,2,Transferts,13,451,2,QCM,0.04,0.73,83.76,28,6,34,32,28,4,1.06,87.5,Facile,Facile,0,Meme Difficulté,Pas Adapte,Marketing
451,2015,Marketing,5,Construction Morphologique,2,Transferts,13,452,3,QCU,0.29,0.43,48.18,44,48,92,90,44,46,1.02,48.89,Moyen,Moyen,0,Meme Difficulté,Pas Adapte,Marketing
1575,2016,Marketing,5,Construction Morphologique,2,Transferts,13,452,3,QCU,0.14,0.84,66.11,55,28,83,71,55,16,1.17,77.46,Facile,Facile,0,Meme Difficulté,Adapte,Marketing
2699,2017,Marketing,5,Construction Morphologique,2,Transferts,13,452,3,QCU,0.03,0.95,66.11,47,24,71,68,47,21,1.04,69.12,Facile,Facile,0,Meme Difficulté,Adapte,Marketing
3823,2018,Marketing,5,Construction Morphologique,2,Transferts,13,452,3,QCU,0.01,0.85,66.11,40,21,61,57,40,17,1.07,70.18,Facile,Facile,0,Meme Difficulté,Adapte,Marketing
4947,2019,Marketing,5,Construction Morphologique,2,Transferts,13,452,3,QCU,0.13,0.93,66.11,36,18,54,42,36,6,1.29,85.71,Facile,Facile,0,Meme Difficulté,Adapte,Marketing
6071,2020,Marketing,5,Construction Morphologique,2,Transferts,13,452,3,QCU,0.13,0.91,66.11,31,16,47,45,31,14,1.04,68.89,Facile,Facile,0,Meme Difficulté,Adapte,Marketing
452,2015,Marketing,5,Construction Morphologique,2,Transferts,13,453,4,QCU,0.36,0.73,55.09,7,5,12,11,7,4,1.09,63.64,Facile,Moyen,-1,Plus Difficile,Pas Adapte,Marketing
1576,2016,Marketing,5,Construction Morphologique,2,Transferts,13,453,4,QCU,0.19,0.78,78.73,10,3,13,13,10,3,1.0,76.92,Moyen,Facile,1,Plus Facile,Pas Adapte,Marketing
2700,2017,Marketing,5,Construction Morphologique,2,Transferts,13,453,4,QCU,0.19,0.88,94.25,14,1,15,15,14,1,1.0,93.33,Difficile,Facile,2,Beaucoup plus Facile,Pas Adapte,Marketing
3824,2018,Marketing,5,Construction Morphologique,2,Transferts,13,453,4,QCU,0.46,0.4,11.26,2,13,15,11,2,9,1.36,18.18,Difficile,Difficile,0,Meme Difficulté,Pas Adapte,Marketing
4948,2019,Marketing,5,Construction Morphologique,2,Transferts,13,453,4,QCU,0.07,0.83,99.05,14,0,14,14,14,0,1.0,100.0,Facile,Facile,0,Meme Difficulté,Pas Adapte,Marketing
6072,2020,Marketing,5,Construction Morphologique,2,Transferts,13,453,4,QCU,0.42,0.38,29.92,4,10,14,11,4,7,1.27,36.36,Moyen,Difficile,-1,Plus Difficile,Pas Adapte,Marketing
453,2015,Marketing,5,Construction Morphologique,2,Transferts,13,454,5,QCU,0.36,0.7,59.06,25,17,42,32,25,7,1.31,78.12,Facile,Moyen,-1,Plus Difficile,Pas Adapte,Marketing
1577,2016,Marketing,5,Construction Morphologique,2,Transferts,13,454,5,QCU,0.48,0.26,32.29,14,30,44,36,14,22,1.22,38.89,Facile,Difficile,-2,Beaucoup plus Difficile,Pas Adapte,Marketing
2701,2017,Marketing,5,Construction Morphologique,2,Transferts,13,454,5,QCU,0.27,0.64,52.95,20,17,37,24,20,4,1.54,83.33,Moyen,Moyen,0,Meme Difficulté,Pas Adapte,Marketing
3825,2018,Marketing,5,Construction Morphologique,2,Transferts,13,454,5,QCU,0.18,0.89,67.94,22,11,33,24,22,2,1.38,91.67,Moyen,Facile,1,Plus Facile,Adapte,Marketing
4949,2019,Marketing,5,Construction Morphologique,2,Transferts,13,454,5,QO,0.08,0.74,67.94,20,10,30,21,20,1,1.43,95.24,Facile,Facile,0,Meme Difficulté,Adapte,Marketing
6073,2020,Marketing,5,Construction Morphologique,2,Transferts,13,454,5,QO,0.17,0.53,67.94,18,8,26,20,18,2,1.3,90.0,Facile,Facile,0,Meme Difficulté,Adapte,Marketing
454,2015,Marketing,5,Construction Morphologique,2,Transferts,13,455,6,QCM,0.66,0.27,31.17,26,59,85,78,26,52,1.09,33.33,Moyen,Difficile,-1,Plus Difficile,Pas Adapte,Marketing
1578,2016,Marketing,5,Construction Morphologique,2,Transferts,13,455,6,QCM,0.28,0.69,55.43,42,33,75,47,42,5,1.6,89.36,Difficile,Moyen,1,Plus Facile,Pas Adapte,Marketing
2702,2017,Marketing,5,Construction Morphologique,2,Transferts,13,455,6,QCM,0.42,0.42,46.07,30,35,65,64,30,34,1.02,46.88,Difficile,Moyen,1,Plus Facile,Pas Adapte,Marketing
3826,2018,Marketing,5,Construction Morphologique,2,Transferts,13,455,6,QCM,0.06,1.0,95.09,55,3,58,56,55,1,1.04,98.21,Difficile,Facile,2,Beaucoup plus Facile,Pas Adapte,Marketing
4950,2019,Marketing,5,Construction Morphologique,2,Transferts,13,455,6,QCU,0.3,0.41,44.57,28,34,62,56,28,28,1.11,50.0,Moyen,Moyen,0,Meme Difficulté,Pas Adapte,Marketing
6074,2020,Marketing,5,Construction Morphologique,2,Transferts,13,455,6,QCU,0.51,0.31,12.46,8,55,63,56,8,48,1.12,14.29,Facile,Difficile,-2,Beaucoup plus Difficile,Pas Adapte,Marketing
455,2015,Marketing,5,Construction Morphologique,2,Transferts,13,456,7,QCU,0.28,0.47,47.46,17,18,35,34,17,17,1.03,50.0,Facile,Moyen,-1,Plus Difficile,Pas Adapte,Marketing
1579,2016,Marketing,5,Construction Morphologique,2,Transferts,13,456,7,QCU,0.18,0.82,83.19,30,6,36,31,30,1,1.16,96.77,Facile,Facile,0,Meme Difficulté,Pas Adapte,Marketing
2703,2017,Marketing,5,Construction Morphologique,2,Transferts,13,456,7,QCU,0.12,0.75,66.68,22,11,33,27,22,5,1.22,81.48,Moyen,Facile,1,Plus Facile,Adapte,Marketing
3827,2018,Marketing,5,Construction Morphologique,2,Transferts,13,456,7,QCU,0.16,0.94,66.68,20,10,30,27,20,7,1.11,74.07,Facile,Facile,0,Meme Difficulté,Adapte,Marketing
4951,2019,Marketing,5,Construction Morphologique,2,Transferts,13,456,7,QCU,0.02,0.9,66.68,23,11,34,29,23,6,1.17,79.31,Facile,Facile,0,Meme Difficulté,Adapte,Marketing
6075,2020,Marketing,5,Construction Morphologique,2,Transferts,13,456,7,QCU,0.18,0.92,66.68,19,10,29,21,19,2,1.38,90.48,Facile,Facile,0,Meme Difficulté,Adapte,Marketing
456,2015,Marketing,5,Construction Morphologique,2,Transferts,13,457,8,QCU,0.46,0.27,2.44,2,82,84,39,2,37,2.15,5.13,Moyen,Difficile,-1,Plus Difficile,Pas Adapte,Marketing
1580,2016,Marketing,5,Construction Morphologique,2,Transferts,13,457,8,QCM,0.11,0.95,80.27,66,16,82,81,66,15,1.01,81.48,Difficile,Facile,2,Beaucoup plus Facile,Pas Adapte,Marketing
2704,2017,Marketing,5,Construction Morphologique,2,Transferts,13,457,8,QCM,0.79,0.15,0.28,0,73,73,52,0,52,1.4,0.0,Moyen,Difficile,-1,Plus Difficile,Pas Adapte,Marketing
3828,2018,Marketing,5,Construction Morphologique,2,Transferts,13,457,8,QCM,0.02,0.85,90.64,75,8,83,80,75,5,1.04,93.75,Difficile,Facile,2,Beaucoup plus Facile,Pas Adapte,Marketing
4952,2019,Marketing,5,Construction Morphologique,2,Transferts,13,457,8,QCU,0.16,0.99,76.94,65,19,84,71,65,6,1.18,91.55,Moyen,Facile,1,Plus Facile,Pas Adapte,Marketing
6076,2020,Marketing,5,Construction Morphologique,2,Transferts,13,457,8,QCU,0.43,0.34,13.53,13,80,93,83,13,70,1.12,15.66,Moyen,Difficile,-1,Plus Difficile,Pas Adapte,Marketing
457,2015,Marketing,5,Construction Morphologique,2,Transferts,13,458,9,QCU,0.48,0.35,15.6,13,72,85,46,13,33,1.85,28.26,Moyen,Difficile,-1,Plus Difficile,Pas Adapte,Marketing
1581,2016,Marketing,5,Construction Morphologique,2,Transferts,13,458,9,QCU,0.13,0.77,89.32,76,9,85,78,76,2,1.09,97.44,Moyen,Facile,1,Plus Facile,Pas Adapte,Marketing
2705,2017,Marketing,5,Construction Morphologique,2,Transferts,13,458,9,QCU,0.54,0.24,19.0,18,76,94,33,18,15,2.85,54.55,Moyen,Difficile,-1,Plus Difficile,Pas Adapte,Marketing
3829,2018,Marketing,5,Construction Morphologique,2,Transferts,13,458,9,QCU,0.47,0.21,8.8,8,79,87,56,8,48,1.55,14.29,Difficile,Difficile,0,Meme Difficulté,Pas Adapte,Marketing
4953,2019,Marketing,5,Construction Morphologique,2,Transferts,13,458,9,QCM,0.64,0.28,9.03,7,70,77,40,7,33,1.93,17.5,Facile,Difficile,-2,Beaucoup plus Difficile,Pas Adapte,Marketing
6077,2020,Marketing,5,Construction Morphologique,2,Transferts,13,458,9,QCM,0.36,0.38,47.74,37,41,78,72,37,35,1.08,51.39,Difficile,Moyen,1,Plus Facile,Pas Adapte,Marketing
458,2015,Marketing,5,Construction Morphologique,2,Transferts,13,459,10,QCU,0.32,0.43,44.04,35,44,79,71,35,36,1.11,49.3,Facile,Moyen,-1,Plus Difficile,Pas Adapte,Marketing
1582,2016,Marketing,5,Construction Morphologique,2,Transferts,13,459,10,QO,0.66,0.21,49.0,44,46,90,54,44,10,1.67,81.48,Facile,Moyen,-1,Plus Difficile,Pas Adapte,Marketing
2706,2017,Marketing,5,Construction Morphologique,2,Transferts,13,459,10,QROC,0.39,0.25,51.02,47,45,92,91,47,44,1.01,51.65,Moyen,Moyen,0,Meme Difficulté,Pas Adapte,Marketing
3830,2018,Marketing,5,Construction Morphologique,2,Transferts,13,459,10,QO,0.14,0.57,70.98,69,28,97,96,69,27,1.01,71.88,Difficile,Facile,2,Beaucoup plus Facile,Adapte,Marketing
4954,2019,Marketing,5,Construction Morphologique,2,Transferts,13,459,10,QO,0.08,0.96,70.98,73,30,103,97,73,24,1.06,75.26,Facile,Facile,0,Meme Difficulté,Adapte,Marketing
6078,2020,Marketing,5,Construction Morphologique,2,Transferts,13,459,10,QO,0.07,0.5,70.98,64,26,90,74,64,10,1.22,86.49,Facile,Facile,0,Meme Difficulté,Adapte,Marketing
459,2015,Marketing,5,Construction Morphologique,2,Transferts,13,460,11,QCU,0.38,0.64,45.57,19,22,41,34,19,15,1.21,55.88,Moyen,Moyen,0,Meme Difficulté,Pas Adapte,Marketing
1583,2016,Marketing,5,Construction Morphologique,2,Transferts,13,460,11,QCU,0.05,0.83,73.57,30,11,41,31,30,1,1.32,96.77,Facile,Facile,0,Meme Difficulté,Adapte,Marketing
2707,2017,Marketing,5,Construction Morphologique,2,Transferts,13,460,11,QCU,0.1,0.89,73.57,26,9,35,33,26,7,1.06,78.79,Facile,Facile,0,Meme Difficulté,Adapte,Marketing
3831,2018,Marketing,5,Construction Morphologique,2,Transferts,13,460,11,QCU,0.05,0.86,73.57,23,8,31,29,23,6,1.07,79.31,Facile,Facile,0,Meme Difficulté,Adapte,Marketing
4955,2019,Marketing,5,Construction Morphologique,2,Transferts,13,460,11,QCU,0.08,0.99,73.57,19,7,26,23,19,4,1.13,82.61,Facile,Facile,0,Meme Difficulté,Adapte,Marketing
6079,2020,Marketing,5,Construction Morphologique,2,Transferts,13,460,11,QCU,0.07,0.86,73.57,20,7,27,22,20,2,1.23,90.91,Facile,Facile,0,Meme Difficulté,Adapte,Marketing
460,2015,Marketing,5,Construction Morphologique,2,Transferts,13,461,12,QCU,0.31,0.61,41.57,27,37,64,45,27,18,1.42,60.0,Difficile,Moyen,1,Plus Facile,Pas Adapte,Marketing
1584,2016,Marketing,5,Construction Morphologique,2,Transferts,13,461,12,QCU,0.05,0.8,96.32,70,3,73,71,70,1,1.03,98.59,Facile,Facile,0,Meme Difficulté,Pas Adapte,Marketing
2708,2017,Marketing,5,Construction Morphologique,2,Transferts,13,461,12,QCU,0.13,0.94,88.12,60,8,68,61,60,1,1.11,98.36,Facile,Facile,0,Meme Difficulté,Pas Adapte,Marketing
3832,2018,Marketing,5,Construction Morphologique,2,Transferts,13,461,12,QCU,0.13,0.97,72.75,56,21,77,66,56,10,1.17,84.85,Difficile,Facile,2,Beaucoup plus Facile,Adapte,Marketing
4956,2019,Marketing,5,Construction Morphologique,2,Transferts,13,461,12,QCU,0.19,0.9,72.75,63,23,86,79,63,16,1.09,79.75,Facile,Facile,0,Meme Difficulté,Adapte,Marketing
6080,2020,Marketing,5,Construction Morphologique,2,Transferts,13,461,12,QCU,0.17,0.86,72.75,70,26,96,93,70,23,1.03,75.27,Facile,Facile,0,Meme Difficulté,Adapte,Marketing
461,2015,Marketing,5,Construction Morphologique,2,Transferts,13,462,13,QCU,0.5,0.36,25.95,11,32,43,18,11,7,2.39,61.11,Difficile,Difficile,0,Meme Difficulté,Pas Adapte,Marketing
1585,2016,Marketing,5,Construction Morphologique,2,Transferts,13,462,13,QO,0.58,0.25,51.69,22,21,43,32,22,10,1.34,68.75,Difficile,Moyen,1,Plus Facile,Pas Adapte,Marketing
2709,2017,Marketing,5,Construction Morphologique,2,Transferts,13,462,13,QO,0.94,0.12,10.59,4,38,42,40,4,36,1.05,10.0,Difficile,Difficile,0,Meme Difficulté,Pas Adapte,Marketing
3833,2018,Marketing,5,Construction Morphologique,2,Transferts,13,462,13,QO,0.59,0.29,59.03,22,15,37,35,22,13,1.06,62.86,Facile,Moyen,-1,Plus Difficile,Pas Adapte,Marketing
4957,2019,Marketing,5,Construction Morphologique,2,Transferts,13,462,13,QO,0.57,0.18,54.42,23,19,42,32,23,9,1.31,71.88,Moyen,Moyen,0,Meme Difficulté,Pas Adapte,Marketing
6081,2020,Marketing,5,Construction Morphologique,2,Transferts,13,462,13,QO,0.76,0.06,1.83,1,40,41,27,1,26,1.52,3.7,Difficile,Difficile,0,Meme Difficulté,Pas Adapte,Marketing
462,2015,Marketing,5,Construction Morphologique,3,Sens Predictible et Atteste,7,463,1,QCM,0.77,0.21,16.02,12,62,74,53,12,41,1.4,22.64,Difficile,Difficile,0,Meme Difficulté,Pas Adapte,Marketing
1586,2016,Marketing,5,Construction Morphologique,3,Sens Predictible et Atteste,7,463,1,QROC,0.62,0.22,21.28,15,56,71,42,15,27,1.69,35.71,Facile,Difficile,-2,Beaucoup plus Difficile,Pas Adapte,Marketing
2710,2017,Marketing,5,Construction Morphologique,3,Sens Predictible et Atteste,7,463,1,QROC,0.07,0.97,72.54,50,19,69,53,50,3,1.3,94.34,Difficile,Facile,2,Beaucoup plus Facile,Adapte,Marketing
3834,2018,Marketing,5,Construction Morphologique,3,Sens Predictible et Atteste,7,463,1,QROC,0.18,0.89,72.54,44,17,61,53,44,9,1.15,83.02,Facile,Facile,0,Meme Difficulté,Adapte,Marketing
4958,2019,Marketing,5,Construction Morphologique,3,Sens Predictible et Atteste,7,463,1,QROC,0.06,0.73,72.54,49,19,68,58,49,9,1.17,84.48,Facile,Facile,0,Meme Difficulté,Adapte,Marketing
6082,2020,Marketing,5,Construction Morphologique,3,Sens Predictible et Atteste,7,463,1,QROC,0.08,0.5,72.54,44,16,60,53,44,9,1.13,83.02,Facile,Facile,0,Meme Difficulté,Adapte,Marketing
463,2015,Marketing,5,Construction Morphologique,3,Sens Predictible et Atteste,7,464,2,QROC,0.06,0.62,86.23,22,4,26,22,22,0,1.18,100.0,Difficile,Facile,2,Beaucoup plus Facile,Pas Adapte,Marketing
1587,2016,Marketing,5,Construction Morphologique,3,Sens Predictible et Atteste,7,464,2,QROC,0.07,0.93,82.14,20,4,24,22,20,2,1.09,90.91,Moyen,Facile,1,Plus Facile,Pas Adapte,Marketing
2711,2017,Marketing,5,Construction Morphologique,3,Sens Predictible et Atteste,7,464,2,QROC,0.24,0.29,35.4,9,17,26,20,9,11,1.3,45.0,Difficile,Moyen,1,Plus Facile,Pas Adapte,Marketing
3835,2018,Marketing,5,Construction Morphologique,3,Sens Predictible et Atteste,7,464,2,QCM,0.22,0.4,48.03,11,11,22,17,11,6,1.29,64.71,Difficile,Moyen,1,Plus Facile,Pas Adapte,Marketing
4959,2019,Marketing,5,Construction Morphologique,3,Sens Predictible et Atteste,7,464,2,QCU,0.18,0.98,78.06,19,5,24,24,19,5,1.0,79.17,Moyen,Facile,1,Plus Facile,Pas Adapte,Marketing
6083,2020,Marketing,5,Construction Morphologique,3,Sens Predictible et Atteste,7,464,2,QCU,0.65,0.26,25.67,7,20,27,25,7,18,1.08,28.0,Facile,Difficile,-2,Beaucoup plus Difficile,Pas Adapte,Marketing
464,2015,Marketing,5,Construction Morphologique,3,Sens Predictible et Atteste,7,465,3,QCM,0.73,0.21,32.08,21,44,65,25,21,4,2.6,84.0,Difficile,Difficile,0,Meme Difficulté,Pas Adapte,Marketing
1588,2016,Marketing,5,Construction Morphologique,3,Sens Predictible et Atteste,7,465,3,QCM,0.02,1.0,92.56,61,5,66,62,61,1,1.06,98.39,Moyen,Facile,1,Plus Facile,Pas Adapte,Marketing
2712,2017,Marketing,5,Construction Morphologique,3,Sens Predictible et Atteste,7,465,3,QO,0.76,0.04,21.73,16,57,73,38,16,22,1.92,42.11,Facile,Difficile,-2,Beaucoup plus Difficile,Pas Adapte,Marketing
3836,2018,Marketing,5,Construction Morphologique,3,Sens Predictible et Atteste,7,465,3,QROC,0.48,0.29,37.37,28,47,75,57,28,29,1.32,49.12,Moyen,Moyen,0,Meme Difficulté,Pas Adapte,Marketing
4960,2019,Marketing,5,Construction Morphologique,3,Sens Predictible et Atteste,7,465,3,QROC,0.87,0.06,24.76,17,53,70,50,17,33,1.4,34.0,Facile,Difficile,-2,Beaucoup plus Difficile,Pas Adapte,Marketing
6084,2020,Marketing,5,Construction Morphologique,3,Sens Predictible et Atteste,7,465,3,QROC,0.64,0.02,20.42,15,59,74,68,15,53,1.09,22.06,Moyen,Difficile,-1,Plus Difficile,Pas Adapte,Marketing
465,2015,Marketing,5,Construction Morphologique,3,Sens Predictible et Atteste,7,466,4,QCM,0.7,0.19,13.91,9,59,68,25,9,16,2.72,36.0,Difficile,Difficile,0,Meme Difficulté,Pas Adapte,Marketing
1589,2016,Marketing,5,Construction Morphologique,3,Sens Predictible et Atteste,7,466,4,QCM,0.57,0.17,10.81,6,52,58,28,6,22,2.07,21.43,Facile,Difficile,-2,Beaucoup plus Difficile,Pas Adapte,Marketing
2713,2017,Marketing,5,Construction Morphologique,3,Sens Predictible et Atteste,7,466,4,QCM,0.6,0.19,29.49,17,41,58,34,17,17,1.71,50.0,Difficile,Difficile,0,Meme Difficulté,Pas Adapte,Marketing
3837,2018,Marketing,5,Construction Morphologique,3,Sens Predictible et Atteste,7,466,4,QCU,0.27,0.7,64.87,37,20,57,55,37,18,1.04,67.27,Facile,Moyen,-1,Plus Difficile,Adapte,Marketing
4961,2019,Marketing,5,Construction Morphologique,3,Sens Predictible et Atteste,7,466,4,QCM,0.28,0.56,64.87,39,21,60,55,39,16,1.09,70.91,Moyen,Moyen,0,Meme Difficulté,Adapte,Marketing
6085,2020,Marketing,5,Construction Morphologique,3,Sens Predictible et Atteste,7,466,4,QCM,0.44,0.7,64.87,38,20,58,44,38,6,1.32,86.36,Moyen,Moyen,0,Meme Difficulté,Adapte,Marketing
466,2015,Marketing,5,Construction Morphologique,3,Sens Predictible et Atteste,7,467,5,QROC,0.11,0.81,98.88,99,1,100,99,99,0,1.01,100.0,Facile,Facile,0,Meme Difficulté,Pas Adapte,Marketing
1590,2016,Marketing,5,Construction Morphologique,3,Sens Predictible et Atteste,7,467,5,QROC,0.16,0.45,76.48,88,27,115,99,88,11,1.16,88.89,Difficile,Facile,2,Beaucoup plus Facile,Pas Adapte,Marketing
2714,2017,Marketing,5,Construction Morphologique,3,Sens Predictible et Atteste,7,467,5,QROC,0.12,0.99,72.13,77,30,107,92,77,15,1.16,83.7,Moyen,Facile,1,Plus Facile,Adapte,Marketing
3838,2018,Marketing,5,Construction Morphologique,3,Sens Predictible et Atteste,7,467,5,QROC,0.02,0.97,72.13,85,33,118,106,85,21,1.11,80.19,Facile,Facile,0,Meme Difficulté,Adapte,Marketing
4962,2019,Marketing,5,Construction Morphologique,3,Sens Predictible et Atteste,7,467,5,QROC,0.19,0.99,72.13,97,37,134,99,97,2,1.35,97.98,Facile,Facile,0,Meme Difficulté,Adapte,Marketing
6086,2020,Marketing,5,Construction Morphologique,3,Sens Predictible et Atteste,7,467,5,QROC,0.13,0.86,72.13,104,40,144,122,104,18,1.18,85.25,Facile,Facile,0,Meme Difficulté,Adapte,Marketing
467,2015,Marketing,5,Construction Morphologique,3,Sens Predictible et Atteste,7,468,6,QROC,0.0,0.78,91.28,71,7,78,77,71,6,1.01,92.21,Difficile,Facile,2,Beaucoup plus Facile,Pas Adapte,Marketing
1591,2016,Marketing,5,Construction Morphologique,3,Sens Predictible et Atteste,7,468,6,QROC,0.8,0.14,28.19,21,55,76,64,21,43,1.19,32.81,Difficile,Difficile,0,Meme Difficulté,Pas Adapte,Marketing
2715,2017,Marketing,5,Construction Morphologique,3,Sens Predictible et Atteste,7,468,6,QROC,0.65,0.12,29.69,22,53,75,38,22,16,1.97,57.89,Moyen,Difficile,-1,Plus Difficile,Pas Adapte,Marketing
3839,2018,Marketing,5,Construction Morphologique,3,Sens Predictible et Atteste,7,468,6,QROC,0.86,0.19,21.59,16,56,72,47,16,31,1.53,34.04,Facile,Difficile,-2,Beaucoup plus Difficile,Pas Adapte,Marketing
4963,2019,Marketing,5,Construction Morphologique,3,Sens Predictible et Atteste,7,468,6,QROC,0.18,0.89,99.55,74,0,74,74,74,0,1.0,100.0,Moyen,Facile,1,Plus Facile,Pas Adapte,Marketing
6087,2020,Marketing,5,Construction Morphologique,3,Sens Predictible et Atteste,7,468,6,QROC,0.64,0.12,0.49,0,70,70,40,0,40,1.75,0.0,Facile,Difficile,-2,Beaucoup plus Difficile,Pas Adapte,Marketing
468,2015,Marketing,5,Construction Morphologique,3,Sens Predictible et Atteste,7,469,7,QCM,0.64,0.16,29.8,3,6,9,9,3,6,1.0,33.33,Difficile,Difficile,0,Meme Difficulté,Pas Adapte,Marketing
1592,2016,Marketing,5,Construction Morphologique,3,Sens Predictible et Atteste,7,469,7,QCU,0.53,0.23,16.94,2,8,10,6,2,4,1.67,33.33,Moyen,Difficile,-1,Plus Difficile,Pas Adapte,Marketing
2716,2017,Marketing,5,Construction Morphologique,3,Sens Predictible et Atteste,7,469,7,QCU,0.73,0.25,9.63,1,10,11,5,1,4,2.2,20.0,Facile,Difficile,-2,Beaucoup plus Difficile,Pas Adapte,Marketing
3840,2018,Marketing,5,Construction Morphologique,3,Sens Predictible et Atteste,7,469,7,QROC,0.89,0.08,6.85,1,12,13,12,1,11,1.08,8.33,Facile,Difficile,-2,Beaucoup plus Difficile,Pas Adapte,Marketing
4964,2019,Marketing,5,Construction Morphologique,3,Sens Predictible et Atteste,7,469,7,QROC,0.1,0.95,82.53,12,3,15,12,12,0,1.25,100.0,Facile,Facile,0,Meme Difficulté,Pas Adapte,Marketing
6088,2020,Marketing,5,Construction Morphologique,3,Sens Predictible et Atteste,7,469,7,QROC,1.0,0.19,0.14,0,14,14,6,0,6,2.33,0.0,Difficile,Difficile,0,Meme Difficulté,Pas Adapte,Marketing
469,2015,Informatique,1,Generalites sur les Systeme Informatiques,1,Definitions et Vocabulaire de Base,14,470,1,QCU,0.73,0.36,2.73,2,89,91,46,2,44,1.98,4.35,Difficile,Difficile,0,Meme Difficulté,Pas Adapte,Computer Science
1593,2016,Informatique,1,Generalites sur les Systeme Informatiques,1,Definitions et Vocabulaire de Base,14,470,1,QCM,0.1,0.84,65.37,53,28,81,57,53,4,1.42,92.98,Difficile,Facile,2,Beaucoup plus Facile,Adapte,Computer Science
2717,2017,Informatique,1,Generalites sur les Systeme Informatiques,1,Definitions et Vocabulaire de Base,14,470,1,QCM,0.19,0.87,65.37,50,27,77,66,50,16,1.17,75.76,Facile,Facile,0,Meme Difficulté,Adapte,Computer Science
3841,2018,Informatique,1,Generalites sur les Systeme Informatiques,1,Definitions et Vocabulaire de Base,14,470,1,QCM,0.18,0.77,65.37,48,25,73,65,48,17,1.12,73.85,Facile,Facile,0,Meme Difficulté,Adapte,Computer Science
4965,2019,Informatique,1,Generalites sur les Systeme Informatiques,1,Definitions et Vocabulaire de Base,14,470,1,QCM,0.03,0.88,65.37,46,25,71,68,46,22,1.04,67.65,Facile,Facile,0,Meme Difficulté,Adapte,Computer Science
6089,2020,Informatique,1,Generalites sur les Systeme Informatiques,1,Definitions et Vocabulaire de Base,14,470,1,QCM,0.17,0.86,65.37,46,25,71,55,46,9,1.29,83.64,Facile,Facile,0,Meme Difficulté,Adapte,Computer Science
470,2015,Informatique,1,Generalites sur les Systeme Informatiques,1,Definitions et Vocabulaire de Base,14,471,2,QCM,0.23,0.58,57.86,5,4,9,8,5,3,1.12,62.5,Difficile,Moyen,1,Plus Facile,Pas Adapte,Computer Science
1594,2016,Informatique,1,Generalites sur les Systeme Informatiques,1,Definitions et Vocabulaire de Base,14,471,2,QCM,0.04,0.74,67.66,6,3,9,9,6,3,1.0,66.67,Facile,Facile,0,Meme Difficulté,Adapte,Computer Science
2718,2017,Informatique,1,Generalites sur les Systeme Informatiques,1,Definitions et Vocabulaire de Base,14,471,2,QCM,0.04,0.89,67.66,7,3,10,10,7,3,1.0,70.0,Facile,Facile,0,Meme Difficulté,Adapte,Computer Science
3842,2018,Informatique,1,Generalites sur les Systeme Informatiques,1,Definitions et Vocabulaire de Base,14,471,2,QCM,0.2,0.83,67.66,7,3,10,8,7,1,1.25,87.5,Facile,Facile,0,Meme Difficulté,Adapte,Computer Science
4966,2019,Informatique,1,Generalites sur les Systeme Informatiques,1,Definitions et Vocabulaire de Base,14,471,2,QCM,0.14,0.74,67.66,8,4,12,9,8,1,1.33,88.89,Facile,Facile,0,Meme Difficulté,Adapte,Computer Science
6090,2020,Informatique,1,Generalites sur les Systeme Informatiques,1,Definitions et Vocabulaire de Base,14,471,2,QCM,0.0,0.78,67.66,7,4,11,9,7,2,1.22,77.78,Facile,Facile,0,Meme Difficulté,Adapte,Computer Science
471,2015,Informatique,1,Generalites sur les Systeme Informatiques,1,Definitions et Vocabulaire de Base,14,472,3,QCM,0.03,0.82,88.82,52,6,58,55,52,3,1.05,94.55,Difficile,Facile,2,Beaucoup plus Facile,Pas Adapte,Computer Science
1595,2016,Informatique,1,Generalites sur les Systeme Informatiques,1,Definitions et Vocabulaire de Base,14,472,3,QCM,0.74,0.3,27.38,14,37,51,17,14,3,3.0,82.35,Difficile,Difficile,0,Meme Difficulté,Pas Adapte,Computer Science
2719,2017,Informatique,1,Generalites sur les Systeme Informatiques,1,Definitions et Vocabulaire de Base,14,472,3,QCM,0.74,0.19,26.36,12,33,45,16,12,4,2.81,75.0,Facile,Difficile,-2,Beaucoup plus Difficile,Pas Adapte,Computer Science
3843,2018,Informatique,1,Generalites sur les Systeme Informatiques,1,Definitions et Vocabulaire de Base,14,472,3,QCM,0.06,0.85,88.54,42,6,48,46,42,4,1.04,91.3,Moyen,Facile,1,Plus Facile,Pas Adapte,Computer Science
4967,2019,Informatique,1,Generalites sur les Systeme Informatiques,1,Definitions et Vocabulaire de Base,14,472,3,QCM,0.69,0.23,9.09,4,42,46,13,4,9,3.54,30.77,Difficile,Difficile,0,Meme Difficulté,Pas Adapte,Computer Science
6091,2020,Informatique,1,Generalites sur les Systeme Informatiques,1,Definitions et Vocabulaire de Base,14,472,3,QCU,0.55,0.29,9.24,5,45,50,41,5,36,1.22,12.2,Difficile,Difficile,0,Meme Difficulté,Pas Adapte,Computer Science
472,2015,Informatique,1,Generalites sur les Systeme Informatiques,1,Definitions et Vocabulaire de Base,14,473,4,QROC,0.11,0.55,74.91,7,2,9,8,7,1,1.12,87.5,Difficile,Facile,2,Beaucoup plus Facile,Adapte,Computer Science
1596,2016,Informatique,1,Generalites sur les Systeme Informatiques,1,Definitions et Vocabulaire de Base,14,473,4,QROC,0.19,0.85,74.91,7,3,10,8,7,1,1.25,87.5,Facile,Facile,0,Meme Difficulté,Adapte,Computer Science
2720,2017,Informatique,1,Generalites sur les Systeme Informatiques,1,Definitions et Vocabulaire de Base,14,473,4,QROC,0.03,0.64,74.91,9,3,12,11,9,2,1.09,81.82,Facile,Facile,0,Meme Difficulté,Adapte,Computer Science
3844,2018,Informatique,1,Generalites sur les Systeme Informatiques,1,Definitions et Vocabulaire de Base,14,473,4,QCM,0.07,0.9,74.91,10,4,14,13,10,3,1.08,76.92,Facile,Facile,0,Meme Difficulté,Adapte,Computer Science
4968,2019,Informatique,1,Generalites sur les Systeme Informatiques,1,Definitions et Vocabulaire de Base,14,473,4,QCM,0.1,0.79,74.91,10,3,13,12,10,2,1.08,83.33,Facile,Facile,0,Meme Difficulté,Adapte,Computer Science
6092,2020,Informatique,1,Generalites sur les Systeme Informatiques,1,Definitions et Vocabulaire de Base,14,473,4,QO,0.1,0.94,74.91,11,4,15,13,11,2,1.15,84.62,Facile,Facile,0,Meme Difficulté,Adapte,Computer Science
473,2015,Informatique,1,Generalites sur les Systeme Informatiques,1,Definitions et Vocabulaire de Base,14,474,5,QCU,0.57,0.26,30.89,13,30,43,41,13,28,1.05,31.71,Moyen,Difficile,-1,Plus Difficile,Pas Adapte,Computer Science
1597,2016,Informatique,1,Generalites sur les Systeme Informatiques,1,Definitions et Vocabulaire de Base,14,474,5,QCU,0.14,0.86,71.05,34,14,48,41,34,7,1.17,82.93,Moyen,Facile,1,Plus Facile,Adapte,Computer Science
2721,2017,Informatique,1,Generalites sur les Systeme Informatiques,1,Definitions et Vocabulaire de Base,14,474,5,QCU,0.14,0.97,71.05,36,15,51,49,36,13,1.04,73.47,Facile,Facile,0,Meme Difficulté,Adapte,Computer Science
3845,2018,Informatique,1,Generalites sur les Systeme Informatiques,1,Definitions et Vocabulaire de Base,14,474,5,QCU,0.18,0.76,71.05,37,15,52,44,37,7,1.18,84.09,Facile,Facile,0,Meme Difficulté,Adapte,Computer Science
4969,2019,Informatique,1,Generalites sur les Systeme Informatiques,1,Definitions et Vocabulaire de Base,14,474,5,QCU,0.14,0.85,71.05,32,13,45,43,32,11,1.05,74.42,Facile,Facile,0,Meme Difficulté,Adapte,Computer Science
6093,2020,Informatique,1,Generalites sur les Systeme Informatiques,1,Definitions et Vocabulaire de Base,14,474,5,QCU,0.11,0.88,71.05,31,13,44,32,31,1,1.38,96.88,Facile,Facile,0,Meme Difficulté,Adapte,Computer Science
474,2015,Informatique,1,Generalites sur les Systeme Informatiques,1,Definitions et Vocabulaire de Base,14,475,6,QO,0.98,0.15,25.86,14,39,53,39,14,25,1.36,35.9,Facile,Difficile,-2,Beaucoup plus Difficile,Pas Adapte,Computer Science
1598,2016,Informatique,1,Generalites sur les Systeme Informatiques,1,Definitions et Vocabulaire de Base,14,475,6,QCM,0.8,0.3,14.88,8,46,54,24,8,16,2.25,33.33,Moyen,Difficile,-1,Plus Difficile,Pas Adapte,Computer Science
2722,2017,Informatique,1,Generalites sur les Systeme Informatiques,1,Definitions et Vocabulaire de Base,14,475,6,QCM,0.02,0.7,91.73,44,4,48,46,44,2,1.04,95.65,Facile,Facile,0,Meme Difficulté,Pas Adapte,Computer Science
3846,2018,Informatique,1,Generalites sur les Systeme Informatiques,1,Definitions et Vocabulaire de Base,14,475,6,QCM,0.63,0.21,13.58,7,47,54,48,7,41,1.12,14.58,Moyen,Difficile,-1,Plus Difficile,Pas Adapte,Computer Science
4970,2019,Informatique,1,Generalites sur les Systeme Informatiques,1,Definitions et Vocabulaire de Base,14,475,6,QCM,0.19,0.98,65.63,30,16,46,31,30,1,1.48,96.77,Difficile,Facile,2,Beaucoup plus Facile,Adapte,Computer Science
6094,2020,Informatique,1,Generalites sur les Systeme Informatiques,1,Definitions et Vocabulaire de Base,14,475,6,QCM,0.04,0.77,65.63,34,18,52,46,34,12,1.13,73.91,Facile,Facile,0,Meme Difficulté,Adapte,Computer Science
475,2015,Informatique,1,Generalites sur les Systeme Informatiques,1,Definitions et Vocabulaire de Base,14,476,7,QCM,0.27,0.35,44.84,41,50,91,68,41,27,1.34,60.29,Moyen,Moyen,0,Meme Difficulté,Pas Adapte,Computer Science
1599,2016,Informatique,1,Generalites sur les Systeme Informatiques,1,Definitions et Vocabulaire de Base,14,476,7,QCM,0.71,0.29,30.85,32,71,103,82,32,50,1.26,39.02,Moyen,Difficile,-1,Plus Difficile,Pas Adapte,Computer Science
2723,2017,Informatique,1,Generalites sur les Systeme Informatiques,1,Definitions et Vocabulaire de Base,14,476,7,QROC,0.1,0.81,97.19,112,3,115,113,112,1,1.02,99.12,Moyen,Facile,1,Plus Facile,Pas Adapte,Computer Science
3847,2018,Informatique,1,Generalites sur les Systeme Informatiques,1,Definitions et Vocabulaire de Base,14,476,7,QCM,0.16,0.98,85.81,92,15,107,98,92,6,1.09,93.88,Facile,Facile,0,Meme Difficulté,Pas Adapte,Computer Science
4971,2019,Informatique,1,Generalites sur les Systeme Informatiques,1,Definitions et Vocabulaire de Base,14,476,7,QCM,0.38,0.44,41.08,42,60,102,83,42,41,1.23,50.6,Facile,Moyen,-1,Plus Difficile,Pas Adapte,Computer Science
6095,2020,Informatique,1,Generalites sur les Systeme Informatiques,1,Definitions et Vocabulaire de Base,14,476,7,QCM,0.04,0.74,77.98,72,20,92,84,72,12,1.1,85.71,Difficile,Facile,2,Beaucoup plus Facile,Pas Adapte,Computer Science
476,2015,Informatique,1,Generalites sur les Systeme Informatiques,1,Definitions et Vocabulaire de Base,14,477,8,QCU,0.44,0.2,12.32,3,25,28,22,3,19,1.27,13.64,Difficile,Difficile,0,Meme Difficulté,Pas Adapte,Computer Science
1600,2016,Informatique,1,Generalites sur les Systeme Informatiques,1,Definitions et Vocabulaire de Base,14,477,8,QROC,0.02,0.59,99.15,30,0,30,30,30,0,1.0,100.0,Difficile,Facile,2,Beaucoup plus Facile,Pas Adapte,Computer Science
2724,2017,Informatique,1,Generalites sur les Systeme Informatiques,1,Definitions et Vocabulaire de Base,14,477,8,QROC,0.52,0.37,44.35,14,18,32,29,14,15,1.1,48.28,Difficile,Moyen,1,Plus Facile,Pas Adapte,Computer Science
3848,2018,Informatique,1,Generalites sur les Systeme Informatiques,1,Definitions et Vocabulaire de Base,14,477,8,QROC,0.57,0.31,39.99,14,21,35,34,14,20,1.03,41.18,Moyen,Moyen,0,Meme Difficulté,Pas Adapte,Computer Science
4972,2019,Informatique,1,Generalites sur les Systeme Informatiques,1,Definitions et Vocabulaire de Base,14,477,8,QROC,0.87,0.13,11.18,4,32,36,23,4,19,1.57,17.39,Difficile,Difficile,0,Meme Difficulté,Pas Adapte,Computer Science
6096,2020,Informatique,1,Generalites sur les Systeme Informatiques,1,Definitions et Vocabulaire de Base,14,477,8,QROC,0.79,0.19,7.67,3,30,33,26,3,23,1.27,11.54,Difficile,Difficile,0,Meme Difficulté,Pas Adapte,Computer Science
477,2015,Informatique,1,Generalites sur les Systeme Informatiques,1,Definitions et Vocabulaire de Base,14,478,9,QCU,0.05,0.87,86.56,47,7,54,48,47,1,1.12,97.92,Moyen,Facile,1,Plus Facile,Pas Adapte,Computer Science
1601,2016,Informatique,1,Generalites sur les Systeme Informatiques,1,Definitions et Vocabulaire de Base,14,478,9,QCM,0.18,0.71,70.68,41,17,58,54,41,13,1.07,75.93,Facile,Facile,0,Meme Difficulté,Adapte,Computer Science
2725,2017,Informatique,1,Generalites sur les Systeme Informatiques,1,Definitions et Vocabulaire de Base,14,478,9,QCM,0.0,0.76,70.68,45,18,63,51,45,6,1.24,88.24,Facile,Facile,0,Meme Difficulté,Adapte,Computer Science
3849,2018,Informatique,1,Generalites sur les Systeme Informatiques,1,Definitions et Vocabulaire de Base,14,478,9,QCM,0.0,0.99,70.68,50,21,71,62,50,12,1.15,80.65,Facile,Facile,0,Meme Difficulté,Adapte,Computer Science
4973,2019,Informatique,1,Generalites sur les Systeme Informatiques,1,Definitions et Vocabulaire de Base,14,478,9,QCM,0.13,0.95,70.68,52,22,74,67,52,15,1.1,77.61,Facile,Facile,0,Meme Difficulté,Adapte,Computer Science
6097,2020,Informatique,1,Generalites sur les Systeme Informatiques,1,Definitions et Vocabulaire de Base,14,478,9,QCU,0.12,0.79,70.68,53,22,75,74,53,21,1.01,71.62,Facile,Facile,0,Meme Difficulté,Adapte,Computer Science
478,2015,Informatique,1,Generalites sur les Systeme Informatiques,1,Definitions et Vocabulaire de Base,14,479,10,QCU,0.39,0.48,50.38,46,46,92,60,46,14,1.53,76.67,Facile,Moyen,-1,Plus Difficile,Pas Adapte,Computer Science
1602,2016,Informatique,1,Generalites sur les Systeme Informatiques,1,Definitions et Vocabulaire de Base,14,479,10,QCU,0.35,0.54,40.68,41,61,102,51,41,10,2.0,80.39,Moyen,Moyen,0,Meme Difficulté,Pas Adapte,Computer Science
2726,2017,Informatique,1,Generalites sur les Systeme Informatiques,1,Definitions et Vocabulaire de Base,14,479,10,QCU,0.28,0.54,43.1,48,64,112,103,48,55,1.09,46.6,Facile,Moyen,-1,Plus Difficile,Pas Adapte,Computer Science
3850,2018,Informatique,1,Generalites sur les Systeme Informatiques,1,Definitions et Vocabulaire de Base,14,479,10,QCU,0.29,0.65,61.91,79,49,128,98,79,19,1.31,80.61,Difficile,Moyen,1,Plus Facile,Adapte,Computer Science
4974,2019,Informatique,1,Generalites sur les Systeme Informatiques,1,Definitions et Vocabulaire de Base,14,479,10,QCU,0.28,0.52,61.91,70,43,113,73,70,3,1.55,95.89,Moyen,Moyen,0,Meme Difficulté,Adapte,Computer Science
6098,2020,Informatique,1,Generalites sur les Systeme Informatiques,1,Definitions et Vocabulaire de Base,14,479,10,QCU,0.39,0.52,61.91,64,40,104,90,64,26,1.16,71.11,Moyen,Moyen,0,Meme Difficulté,Adapte,Computer Science
479,2015,Informatique,1,Generalites sur les Systeme Informatiques,1,Definitions et Vocabulaire de Base,14,480,11,QCU,0.68,0.36,21.46,21,78,99,91,21,70,1.09,23.08,Moyen,Difficile,-1,Plus Difficile,Pas Adapte,Computer Science
1603,2016,Informatique,1,Generalites sur les Systeme Informatiques,1,Definitions et Vocabulaire de Base,14,480,11,QCU,0.24,0.46,41.35,35,50,85,43,35,8,1.98,81.4,Facile,Moyen,-1,Plus Difficile,Pas Adapte,Computer Science
2727,2017,Informatique,1,Generalites sur les Systeme Informatiques,1,Definitions et Vocabulaire de Base,14,480,11,QCU,0.39,0.41,58.16,42,30,72,59,42,17,1.22,71.19,Moyen,Moyen,0,Meme Difficulté,Pas Adapte,Computer Science
3851,2018,Informatique,1,Generalites sur les Systeme Informatiques,1,Definitions et Vocabulaire de Base,14,480,11,QCU,0.3,0.68,44.48,27,34,61,34,27,7,1.79,79.41,Difficile,Moyen,1,Plus Facile,Pas Adapte,Computer Science
4975,2019,Informatique,1,Generalites sur les Systeme Informatiques,1,Definitions et Vocabulaire de Base,14,480,11,QCU,0.07,0.91,95.72,58,3,61,60,58,2,1.02,96.67,Facile,Facile,0,Meme Difficulté,Pas Adapte,Computer Science
6099,2020,Informatique,1,Generalites sur les Systeme Informatiques,1,Definitions et Vocabulaire de Base,14,480,11,QCU,0.29,0.55,55.2,35,29,64,36,35,1,1.78,97.22,Facile,Moyen,-1,Plus Difficile,Pas Adapte,Computer Science
480,2015,Informatique,1,Generalites sur les Systeme Informatiques,1,Definitions et Vocabulaire de Base,14,481,12,QO,0.13,0.99,96.26,49,2,51,49,49,0,1.04,100.0,Difficile,Facile,2,Beaucoup plus Facile,Pas Adapte,Computer Science
1604,2016,Informatique,1,Generalites sur les Systeme Informatiques,1,Definitions et Vocabulaire de Base,14,481,12,QO,0.97,0.02,31.72,14,30,44,26,14,12,1.69,53.85,Moyen,Difficile,-1,Plus Difficile,Pas Adapte,Computer Science
2728,2017,Informatique,1,Generalites sur les Systeme Informatiques,1,Definitions et Vocabulaire de Base,14,481,12,QO,0.69,0.24,37.06,17,29,46,33,17,16,1.39,51.52,Difficile,Moyen,1,Plus Facile,Pas Adapte,Computer Science
3852,2018,Informatique,1,Generalites sur les Systeme Informatiques,1,Definitions et Vocabulaire de Base,14,481,12,QO,0.97,0.11,15.58,7,38,45,40,7,33,1.12,17.5,Facile,Difficile,-2,Beaucoup plus Difficile,Pas Adapte,Computer Science
4976,2019,Informatique,1,Generalites sur les Systeme Informatiques,1,Definitions et Vocabulaire de Base,14,481,12,QO,0.17,0.55,76.74,39,12,51,41,39,2,1.24,95.12,Difficile,Facile,2,Beaucoup plus Facile,Pas Adapte,Computer Science
6100,2020,Informatique,1,Generalites sur les Systeme Informatiques,1,Definitions et Vocabulaire de Base,14,481,12,QO,0.17,0.5,73.92,34,12,46,42,34,8,1.1,80.95,Facile,Facile,0,Meme Difficulté,Adapte,Computer Science
481,2015,Informatique,1,Generalites sur les Systeme Informatiques,1,Definitions et Vocabulaire de Base,14,482,13,QCM,0.01,0.76,67.67,68,32,100,87,68,19,1.15,78.16,Moyen,Facile,1,Plus Facile,Adapte,Computer Science
1605,2016,Informatique,1,Generalites sur les Systeme Informatiques,1,Definitions et Vocabulaire de Base,14,482,13,QCM,0.13,0.77,67.67,63,30,93,88,63,25,1.06,71.59,Facile,Facile,0,Meme Difficulté,Adapte,Computer Science
2729,2017,Informatique,1,Generalites sur les Systeme Informatiques,1,Definitions et Vocabulaire de Base,14,482,13,QCM,0.18,0.88,67.67,55,27,82,58,55,3,1.41,94.83,Facile,Facile,0,Meme Difficulté,Adapte,Computer Science
3853,2018,Informatique,1,Generalites sur les Systeme Informatiques,1,Definitions et Vocabulaire de Base,14,482,13,QCM,0.02,0.74,67.67,57,27,84,77,57,20,1.09,74.03,Facile,Facile,0,Meme Difficulté,Adapte,Computer Science
4977,2019,Informatique,1,Generalites sur les Systeme Informatiques,1,Definitions et Vocabulaire de Base,14,482,13,QCM,0.16,0.97,67.67,66,31,97,91,66,25,1.07,72.53,Facile,Facile,0,Meme Difficulté,Adapte,Computer Science
6101,2020,Informatique,1,Generalites sur les Systeme Informatiques,1,Definitions et Vocabulaire de Base,14,482,13,QCU,0.02,0.98,67.67,59,28,87,85,59,26,1.02,69.41,Facile,Facile,0,Meme Difficulté,Adapte,Computer Science
482,2015,Informatique,1,Generalites sur les Systeme Informatiques,1,Definitions et Vocabulaire de Base,14,483,14,QCM,0.8,0.26,22.18,16,58,74,38,16,22,1.95,42.11,Moyen,Difficile,-1,Plus Difficile,Pas Adapte,Computer Science
1606,2016,Informatique,1,Generalites sur les Systeme Informatiques,1,Definitions et Vocabulaire de Base,14,483,14,QCM,0.24,0.32,43.16,35,45,80,47,35,12,1.7,74.47,Facile,Moyen,-1,Plus Difficile,Pas Adapte,Computer Science
2730,2017,Informatique,1,Generalites sur les Systeme Informatiques,1,Definitions et Vocabulaire de Base,14,483,14,QCM,0.51,0.2,1.07,1,70,71,36,1,35,1.97,2.78,Facile,Difficile,-2,Beaucoup plus Difficile,Pas Adapte,Computer Science
3854,2018,Informatique,1,Generalites sur les Systeme Informatiques,1,Definitions et Vocabulaire de Base,14,483,14,QCM,0.43,0.45,40.08,33,49,82,82,33,49,1.0,40.24,Moyen,Moyen,0,Meme Difficulté,Pas Adapte,Computer Science
4978,2019,Informatique,1,Generalites sur les Systeme Informatiques,1,Definitions et Vocabulaire de Base,14,483,14,QCM,0.16,0.89,97.57,82,2,84,84,82,2,1.0,97.62,Moyen,Facile,1,Plus Facile,Pas Adapte,Computer Science
6102,2020,Informatique,1,Generalites sur les Systeme Informatiques,1,Definitions et Vocabulaire de Base,14,483,14,QCM,0.11,0.9,66.97,50,25,75,65,50,15,1.15,76.92,Moyen,Facile,1,Plus Facile,Adapte,Computer Science
483,2015,Informatique,1,Generalites sur les Systeme Informatiques,2,Structure de l'Ordinateur,6,484,1,QCU,0.13,0.93,95.18,67,3,70,69,67,2,1.01,97.1,Facile,Facile,0,Meme Difficulté,Pas Adapte,Computer Science
1607,2016,Informatique,1,Generalites sur les Systeme Informatiques,2,Structure de l'Ordinateur,6,484,1,QCU,0.58,0.33,3.05,2,73,75,33,2,31,2.27,6.06,Moyen,Difficile,-1,Plus Difficile,Pas Adapte,Computer Science
2731,2017,Informatique,1,Generalites sur les Systeme Informatiques,2,Structure de l'Ordinateur,6,484,1,QCU,0.41,0.33,1.87,1,70,71,36,1,35,1.97,2.78,Facile,Difficile,-2,Beaucoup plus Difficile,Pas Adapte,Computer Science
3855,2018,Informatique,1,Generalites sur les Systeme Informatiques,2,Structure de l'Ordinateur,6,484,1,QCU,0.09,0.81,89.58,59,7,66,62,59,3,1.06,95.16,Moyen,Facile,1,Plus Facile,Pas Adapte,Computer Science
4979,2019,Informatique,1,Generalites sur les Systeme Informatiques,2,Structure de l'Ordinateur,6,484,1,QCU,0.34,0.61,35.66,24,44,68,34,24,10,2.0,70.59,Facile,Moyen,-1,Plus Difficile,Pas Adapte,Computer Science
6103,2020,Informatique,1,Generalites sur les Systeme Informatiques,2,Structure de l'Ordinateur,6,484,1,QCU,0.44,0.36,16.44,11,57,68,61,11,50,1.11,18.03,Facile,Difficile,-2,Beaucoup plus Difficile,Pas Adapte,Computer Science
484,2015,Informatique,1,Generalites sur les Systeme Informatiques,2,Structure de l'Ordinateur,6,485,2,QCU,0.61,0.4,19.05,12,51,63,36,12,24,1.75,33.33,Facile,Difficile,-2,Beaucoup plus Difficile,Pas Adapte,Computer Science
1608,2016,Informatique,1,Generalites sur les Systeme Informatiques,2,Structure de l'Ordinateur,6,485,2,QCU,0.22,0.58,61.42,37,24,61,45,37,8,1.36,82.22,Difficile,Moyen,1,Plus Facile,Adapte,Computer Science
2732,2017,Informatique,1,Generalites sur les Systeme Informatiques,2,Structure de l'Ordinateur,6,485,2,QCU,0.23,0.43,61.42,33,20,53,34,33,1,1.56,97.06,Moyen,Moyen,0,Meme Difficulté,Adapte,Computer Science
3856,2018,Informatique,1,Generalites sur les Systeme Informatiques,2,Structure de l'Ordinateur,6,485,2,QCU,0.36,0.6,61.42,36,23,59,47,36,11,1.26,76.6,Moyen,Moyen,0,Meme Difficulté,Adapte,Computer Science
4980,2019,Informatique,1,Generalites sur les Systeme Informatiques,2,Structure de l'Ordinateur,6,485,2,QCU,0.36,0.68,61.42,38,24,62,45,38,7,1.38,84.44,Moyen,Moyen,0,Meme Difficulté,Adapte,Computer Science
6104,2020,Informatique,1,Generalites sur les Systeme Informatiques,2,Structure de l'Ordinateur,6,485,2,QCU,0.34,0.56,61.42,33,20,53,47,33,14,1.13,70.21,Moyen,Moyen,0,Meme Difficulté,Adapte,Computer Science
485,2015,Informatique,1,Generalites sur les Systeme Informatiques,2,Structure de l'Ordinateur,6,486,3,QCU,0.07,0.79,84.46,81,15,96,93,81,12,1.03,87.1,Facile,Facile,0,Meme Difficulté,Pas Adapte,Computer Science
1609,2016,Informatique,1,Generalites sur les Systeme Informatiques,2,Structure de l'Ordinateur,6,486,3,QCU,0.74,0.3,32.34,35,73,108,96,35,61,1.12,36.46,Facile,Difficile,-2,Beaucoup plus Difficile,Pas Adapte,Computer Science
2733,2017,Informatique,1,Generalites sur les Systeme Informatiques,2,Structure de l'Ordinateur,6,486,3,QCU,0.18,0.86,76.41,93,29,122,102,93,9,1.2,91.18,Difficile,Facile,2,Beaucoup plus Facile,Pas Adapte,Computer Science
3857,2018,Informatique,1,Generalites sur les Systeme Informatiques,2,Structure de l'Ordinateur,6,486,3,QCU,0.13,0.96,66.9,84,41,125,100,84,16,1.25,84.0,Moyen,Facile,1,Plus Facile,Adapte,Computer Science
4981,2019,Informatique,1,Generalites sur les Systeme Informatiques,2,Structure de l'Ordinateur,6,486,3,QCU,0.06,0.84,66.9,87,43,130,99,87,12,1.31,87.88,Facile,Facile,0,Meme Difficulté,Adapte,Computer Science
6105,2020,Informatique,1,Generalites sur les Systeme Informatiques,2,Structure de l'Ordinateur,6,486,3,QCU,0.17,0.99,66.9,76,38,114,81,76,5,1.41,93.83,Facile,Facile,0,Meme Difficulté,Adapte,Computer Science
486,2015,Informatique,1,Generalites sur les Systeme Informatiques,2,Structure de l'Ordinateur,6,487,4,QCM,0.08,0.82,83.61,20,4,24,21,20,1,1.14,95.24,Facile,Facile,0,Meme Difficulté,Pas Adapte,Computer Science
1610,2016,Informatique,1,Generalites sur les Systeme Informatiques,2,Structure de l'Ordinateur,6,487,4,QCM,0.79,0.24,34.43,8,15,23,20,8,12,1.15,40.0,Moyen,Difficile,-1,Plus Difficile,Pas Adapte,Computer Science
2734,2017,Informatique,1,Generalites sur les Systeme Informatiques,2,Structure de l'Ordinateur,6,487,4,QCU,0.27,0.44,53.96,11,9,20,16,11,5,1.25,68.75,Moyen,Moyen,0,Meme Difficulté,Pas Adapte,Computer Science
3858,2018,Informatique,1,Generalites sur les Systeme Informatiques,2,Structure de l'Ordinateur,6,487,4,QCU,0.05,0.96,76.18,18,5,23,19,18,1,1.21,94.74,Moyen,Facile,1,Plus Facile,Pas Adapte,Computer Science
4982,2019,Informatique,1,Generalites sur les Systeme Informatiques,2,Structure de l'Ordinateur,6,487,4,QCU,0.49,0.27,20.18,4,18,22,21,4,17,1.05,19.05,Difficile,Difficile,0,Meme Difficulté,Pas Adapte,Computer Science
6106,2020,Informatique,1,Generalites sur les Systeme Informatiques,2,Structure de l'Ordinateur,6,487,4,QCU,0.69,0.37,15.71,3,17,20,12,3,9,1.67,25.0,Moyen,Difficile,-1,Plus Difficile,Pas Adapte,Computer Science
487,2015,Informatique,1,Generalites sur les Systeme Informatiques,2,Structure de l'Ordinateur,6,488,5,QROC,0.43,0.31,35.82,23,41,64,36,23,13,1.78,63.89,Difficile,Moyen,1,Plus Facile,Pas Adapte,Computer Science
1611,2016,Informatique,1,Generalites sur les Systeme Informatiques,2,Structure de l'Ordinateur,6,488,5,QROC,0.63,0.22,7.42,5,66,71,50,5,45,1.42,10.0,Facile,Difficile,-2,Beaucoup plus Difficile,Pas Adapte,Computer Science
2735,2017,Informatique,1,Generalites sur les Systeme Informatiques,2,Structure de l'Ordinateur,6,488,5,QROC,0.02,0.77,79.38,63,16,79,69,63,6,1.14,91.3,Facile,Facile,0,Meme Difficulté,Pas Adapte,Computer Science
3859,2018,Informatique,1,Generalites sur les Systeme Informatiques,2,Structure de l'Ordinateur,6,488,5,QROC,0.9,0.1,0.25,0,72,72,52,0,52,1.38,0.0,Facile,Difficile,-2,Beaucoup plus Difficile,Pas Adapte,Computer Science
4983,2019,Informatique,1,Generalites sur les Systeme Informatiques,2,Structure de l'Ordinateur,6,488,5,QROC,0.67,0.14,0.31,0,61,61,50,0,50,1.22,0.0,Moyen,Difficile,-1,Plus Difficile,Pas Adapte,Computer Science
6107,2020,Informatique,1,Generalites sur les Systeme Informatiques,2,Structure de l'Ordinateur,6,488,5,QROC,0.11,0.46,90.59,61,6,67,62,61,1,1.08,98.39,Moyen,Facile,1,Plus Facile,Pas Adapte,Computer Science
488,2015,Informatique,1,Generalites sur les Systeme Informatiques,2,Structure de l'Ordinateur,6,489,6,QO,0.14,0.74,75.7,33,10,43,38,33,5,1.13,86.84,Moyen,Facile,1,Plus Facile,Pas Adapte,Computer Science
1612,2016,Informatique,1,Generalites sur les Systeme Informatiques,2,Structure de l'Ordinateur,6,489,6,QROC,0.56,0.28,63.98,31,17,48,36,31,5,1.33,86.11,Difficile,Moyen,1,Plus Facile,Adapte,Computer Science
2736,2017,Informatique,1,Generalites sur les Systeme Informatiques,2,Structure de l'Ordinateur,6,489,6,QROC,0.53,0.4,63.98,30,17,47,42,30,12,1.12,71.43,Moyen,Moyen,0,Meme Difficulté,Adapte,Computer Science
3860,2018,Informatique,1,Generalites sur les Systeme Informatiques,2,Structure de l'Ordinateur,6,489,6,QROC,0.48,0.27,63.98,28,15,43,32,28,4,1.34,87.5,Moyen,Moyen,0,Meme Difficulté,Adapte,Computer Science
4984,2019,Informatique,1,Generalites sur les Systeme Informatiques,2,Structure de l'Ordinateur,6,489,6,QROC,0.56,0.33,63.98,27,15,42,37,27,10,1.14,72.97,Moyen,Moyen,0,Meme Difficulté,Adapte,Computer Science
6108,2020,Informatique,1,Generalites sur les Systeme Informatiques,2,Structure de l'Ordinateur,6,489,6,QROC,0.32,0.39,63.98,29,17,46,34,29,5,1.35,85.29,Moyen,Moyen,0,Meme Difficulté,Adapte,Computer Science
489,2015,Informatique,1,Generalites sur les Systeme Informatiques,3,Logiciels et Domaines d'Applicationd de l'Informatique,6,490,1,QCM,0.46,0.62,63.59,40,23,63,53,40,13,1.19,75.47,Facile,Moyen,-1,Plus Difficile,Adapte,Computer Science
1613,2016,Informatique,1,Generalites sur les Systeme Informatiques,3,Logiciels et Domaines d'Applicationd de l'Informatique,6,490,1,QCU,0.31,0.65,63.59,36,21,57,39,36,3,1.46,92.31,Moyen,Moyen,0,Meme Difficulté,Adapte,Computer Science
2737,2017,Informatique,1,Generalites sur les Systeme Informatiques,3,Logiciels et Domaines d'Applicationd de l'Informatique,6,490,1,QCM,0.4,0.43,63.59,32,18,50,44,32,12,1.14,72.73,Moyen,Moyen,0,Meme Difficulté,Adapte,Computer Science
3861,2018,Informatique,1,Generalites sur les Systeme Informatiques,3,Logiciels et Domaines d'Applicationd de l'Informatique,6,490,1,QCM,0.49,0.62,63.59,35,20,55,36,35,1,1.53,97.22,Moyen,Moyen,0,Meme Difficulté,Adapte,Computer Science
4985,2019,Informatique,1,Generalites sur les Systeme Informatiques,3,Logiciels et Domaines d'Applicationd de l'Informatique,6,490,1,QCM,0.39,0.6,63.59,32,18,50,43,32,11,1.16,74.42,Moyen,Moyen,0,Meme Difficulté,Adapte,Computer Science
6109,2020,Informatique,1,Generalites sur les Systeme Informatiques,3,Logiciels et Domaines d'Applicationd de l'Informatique,6,490,1,QCM,0.33,0.33,63.59,31,18,49,47,31,16,1.04,65.96,Moyen,Moyen,0,Meme Difficulté,Adapte,Computer Science
490,2015,Informatique,1,Generalites sur les Systeme Informatiques,3,Logiciels et Domaines d'Applicationd de l'Informatique,6,491,2,QCU,0.16,0.85,99.6,79,0,79,79,79,0,1.0,100.0,Difficile,Facile,2,Beaucoup plus Facile,Pas Adapte,Computer Science
1614,2016,Informatique,1,Generalites sur les Systeme Informatiques,3,Logiciels et Domaines d'Applicationd de l'Informatique,6,491,2,QCM,0.24,0.48,50.79,43,42,85,64,43,21,1.33,67.19,Difficile,Moyen,1,Plus Facile,Pas Adapte,Computer Science
2738,2017,Informatique,1,Generalites sur les Systeme Informatiques,3,Logiciels et Domaines d'Applicationd de l'Informatique,6,491,2,QCM,0.4,0.64,53.19,46,40,86,85,46,39,1.01,54.12,Difficile,Moyen,1,Plus Facile,Pas Adapte,Computer Science
3862,2018,Informatique,1,Generalites sur les Systeme Informatiques,3,Logiciels et Domaines d'Applicationd de l'Informatique,6,491,2,QCM,0.08,0.71,72.95,62,23,85,76,62,14,1.12,81.58,Facile,Facile,0,Meme Difficulté,Adapte,Computer Science
4986,2019,Informatique,1,Generalites sur les Systeme Informatiques,3,Logiciels et Domaines d'Applicationd de l'Informatique,6,491,2,QCM,0.06,0.95,72.95,68,25,93,72,68,4,1.29,94.44,Facile,Facile,0,Meme Difficulté,Adapte,Computer Science
6110,2020,Informatique,1,Generalites sur les Systeme Informatiques,3,Logiciels et Domaines d'Applicationd de l'Informatique,6,491,2,QCM,0.08,0.91,72.95,72,27,99,87,72,15,1.14,82.76,Facile,Facile,0,Meme Difficulté,Adapte,Computer Science
491,2015,Informatique,1,Generalites sur les Systeme Informatiques,3,Logiciels et Domaines d'Applicationd de l'Informatique,6,492,3,QCM,0.34,0.62,39.84,37,55,92,62,37,25,1.48,59.68,Moyen,Moyen,0,Meme Difficulté,Pas Adapte,Computer Science
1615,2016,Informatique,1,Generalites sur les Systeme Informatiques,3,Logiciels et Domaines d'Applicationd de l'Informatique,6,492,3,QCM,0.1,0.82,91.68,91,8,99,98,91,7,1.01,92.86,Facile,Facile,0,Meme Difficulté,Pas Adapte,Computer Science
2739,2017,Informatique,1,Generalites sur les Systeme Informatiques,3,Logiciels et Domaines d'Applicationd de l'Informatique,6,492,3,QCU,0.36,0.42,43.02,40,52,92,68,40,28,1.35,58.82,Moyen,Moyen,0,Meme Difficulté,Pas Adapte,Computer Science
3863,2018,Informatique,1,Generalites sur les Systeme Informatiques,3,Logiciels et Domaines d'Applicationd de l'Informatique,6,492,3,QCU,0.07,0.87,82.82,71,15,86,73,71,2,1.18,97.26,Moyen,Facile,1,Plus Facile,Pas Adapte,Computer Science
4987,2019,Informatique,1,Generalites sur les Systeme Informatiques,3,Logiciels et Domaines d'Applicationd de l'Informatique,6,492,3,QCU,0.45,0.21,12.72,10,71,81,61,10,51,1.33,16.39,Difficile,Difficile,0,Meme Difficulté,Pas Adapte,Computer Science
6111,2020,Informatique,1,Generalites sur les Systeme Informatiques,3,Logiciels et Domaines d'Applicationd de l'Informatique,6,492,3,QCU,0.4,0.53,53.39,43,37,80,79,43,36,1.01,54.43,Facile,Moyen,-1,Plus Difficile,Pas Adapte,Computer Science
492,2015,Informatique,1,Generalites sur les Systeme Informatiques,3,Logiciels et Domaines d'Applicationd de l'Informatique,6,493,4,QO,0.3,0.15,53.77,23,19,42,31,23,8,1.35,74.19,Difficile,Moyen,1,Plus Facile,Pas Adapte,Computer Science
1616,2016,Informatique,1,Generalites sur les Systeme Informatiques,3,Logiciels et Domaines d'Applicationd de l'Informatique,6,493,4,QO,0.89,0.03,16.67,6,32,38,29,6,23,1.31,20.69,Moyen,Difficile,-1,Plus Difficile,Pas Adapte,Computer Science
2740,2017,Informatique,1,Generalites sur les Systeme Informatiques,3,Logiciels et Domaines d'Applicationd de l'Informatique,6,493,4,QO,0.22,0.27,53.78,24,20,44,26,24,2,1.69,92.31,Moyen,Moyen,0,Meme Difficulté,Pas Adapte,Computer Science
3864,2018,Informatique,1,Generalites sur les Systeme Informatiques,3,Logiciels et Domaines d'Applicationd de l'Informatique,6,493,4,QO,0.17,0.61,93.83,38,2,40,39,38,1,1.03,97.44,Moyen,Facile,1,Plus Facile,Pas Adapte,Computer Science
4988,2019,Informatique,1,Generalites sur les Systeme Informatiques,3,Logiciels et Domaines d'Applicationd de l'Informatique,6,493,4,QO,0.93,0.14,2.24,1,37,38,29,1,28,1.31,3.45,Facile,Difficile,-2,Beaucoup plus Difficile,Pas Adapte,Computer Science
6112,2020,Informatique,1,Generalites sur les Systeme Informatiques,3,Logiciels et Domaines d'Applicationd de l'Informatique,6,493,4,QO,0.87,0.04,9.16,3,33,36,18,3,15,2.0,16.67,Difficile,Difficile,0,Meme Difficulté,Pas Adapte,Computer Science
493,2015,Informatique,1,Generalites sur les Systeme Informatiques,3,Logiciels et Domaines d'Applicationd de l'Informatique,6,494,5,QCU,0.19,0.99,67.06,45,22,67,63,45,18,1.06,71.43,Moyen,Facile,1,Plus Facile,Adapte,Computer Science
1617,2016,Informatique,1,Generalites sur les Systeme Informatiques,3,Logiciels et Domaines d'Applicationd de l'Informatique,6,494,5,QCU,0.07,0.95,67.06,44,21,65,58,44,14,1.12,75.86,Facile,Facile,0,Meme Difficulté,Adapte,Computer Science
2741,2017,Informatique,1,Generalites sur les Systeme Informatiques,3,Logiciels et Domaines d'Applicationd de l'Informatique,6,494,5,QCM,0.15,0.82,67.06,38,19,57,40,38,2,1.43,95.0,Facile,Facile,0,Meme Difficulté,Adapte,Computer Science
3865,2018,Informatique,1,Generalites sur les Systeme Informatiques,3,Logiciels et Domaines d'Applicationd de l'Informatique,6,494,5,QCM,0.02,0.71,67.06,36,17,53,48,36,12,1.1,75.0,Facile,Facile,0,Meme Difficulté,Adapte,Computer Science
4989,2019,Informatique,1,Generalites sur les Systeme Informatiques,3,Logiciels et Domaines d'Applicationd de l'Informatique,6,494,5,QCM,0.15,0.9,67.06,31,15,46,42,31,11,1.1,73.81,Facile,Facile,0,Meme Difficulté,Adapte,Computer Science
6113,2020,Informatique,1,Generalites sur les Systeme Informatiques,3,Logiciels et Domaines d'Applicationd de l'Informatique,6,494,5,QCM,0.1,0.8,67.06,34,16,50,48,34,14,1.04,70.83,Facile,Facile,0,Meme Difficulté,Adapte,Computer Science
494,2015,Informatique,1,Generalites sur les Systeme Informatiques,3,Logiciels et Domaines d'Applicationd de l'Informatique,6,495,6,QCU,0.24,0.49,52.69,4,4,8,8,4,4,1.0,50.0,Moyen,Moyen,0,Meme Difficulté,Pas Adapte,Computer Science
1618,2016,Informatique,1,Generalites sur les Systeme Informatiques,3,Logiciels et Domaines d'Applicationd de l'Informatique,6,495,6,QCU,0.69,0.2,34.32,3,6,9,5,3,2,1.8,60.0,Difficile,Difficile,0,Meme Difficulté,Pas Adapte,Computer Science
2742,2017,Informatique,1,Generalites sur les Systeme Informatiques,3,Logiciels et Domaines d'Applicationd de l'Informatique,6,495,6,QCU,0.59,0.35,31.21,3,6,9,8,3,5,1.12,37.5,Difficile,Difficile,0,Meme Difficulté,Pas Adapte,Computer Science
3866,2018,Informatique,1,Generalites sur les Systeme Informatiques,3,Logiciels et Domaines d'Applicationd de l'Informatique,6,495,6,QCU,0.1,0.92,94.58,9,1,10,10,9,1,1.0,90.0,Facile,Facile,0,Meme Difficulté,Pas Adapte,Computer Science
4990,2019,Informatique,1,Generalites sur les Systeme Informatiques,3,Logiciels et Domaines d'Applicationd de l'Informatique,6,495,6,QCU,0.12,0.85,87.48,9,1,10,9,9,0,1.11,100.0,Facile,Facile,0,Meme Difficulté,Pas Adapte,Computer Science
6114,2020,Informatique,1,Generalites sur les Systeme Informatiques,3,Logiciels et Domaines d'Applicationd de l'Informatique,6,495,6,QCU,0.18,0.76,65.42,7,3,10,9,7,2,1.11,77.78,Moyen,Facile,1,Plus Facile,Adapte,Computer Science
495,2015,Informatique,2,Les Logiciels,1,Systeme d'Exploitation,8,496,1,QCM,0.4,0.6,56.51,47,36,83,57,47,10,1.46,82.46,Difficile,Moyen,1,Plus Facile,Pas Adapte,Computer Science
1619,2016,Informatique,2,Les Logiciels,1,Systeme d'Exploitation,8,496,1,QCU,0.36,0.72,38.61,32,51,83,51,32,19,1.63,62.75,Facile,Moyen,-1,Plus Difficile,Pas Adapte,Computer Science
2743,2017,Informatique,2,Les Logiciels,1,Systeme d'Exploitation,8,496,1,QCU,0.23,0.69,58.48,49,34,83,82,49,33,1.01,59.76,Difficile,Moyen,1,Plus Facile,Pas Adapte,Computer Science
3867,2018,Informatique,2,Les Logiciels,1,Systeme d'Exploitation,8,496,1,QCU,0.2,0.83,68.54,58,26,84,71,58,13,1.18,81.69,Difficile,Facile,2,Beaucoup plus Facile,Adapte,Computer Science
4991,2019,Informatique,2,Les Logiciels,1,Systeme d'Exploitation,8,496,1,QCM,0.09,0.74,68.54,62,29,91,79,62,17,1.15,78.48,Facile,Facile,0,Meme Difficulté,Adapte,Computer Science
6115,2020,Informatique,2,Les Logiciels,1,Systeme d'Exploitation,8,496,1,QCM,0.14,0.87,68.54,61,28,89,71,61,10,1.25,85.92,Facile,Facile,0,Meme Difficulté,Adapte,Computer Science
496,2015,Informatique,2,Les Logiciels,1,Systeme d'Exploitation,8,497,2,QCM,0.06,0.76,96.25,36,1,37,37,36,1,1.0,97.3,Moyen,Facile,1,Plus Facile,Pas Adapte,Computer Science
1620,2016,Informatique,2,Les Logiciels,1,Systeme d'Exploitation,8,497,2,QCU,0.33,0.52,46.98,16,17,33,19,16,3,1.74,84.21,Moyen,Moyen,0,Meme Difficulté,Pas Adapte,Computer Science
2744,2017,Informatique,2,Les Logiciels,1,Systeme d'Exploitation,8,497,2,QCU,0.08,0.89,66.33,25,13,38,28,25,3,1.36,89.29,Difficile,Facile,2,Beaucoup plus Facile,Adapte,Computer Science
3868,2018,Informatique,2,Les Logiciels,1,Systeme d'Exploitation,8,497,2,QCU,0.1,0.99,66.33,25,13,38,30,25,5,1.27,83.33,Facile,Facile,0,Meme Difficulté,Adapte,Computer Science
4992,2019,Informatique,2,Les Logiciels,1,Systeme d'Exploitation,8,497,2,QCU,0.17,0.95,66.33,25,12,37,33,25,8,1.12,75.76,Facile,Facile,0,Meme Difficulté,Adapte,Computer Science
6116,2020,Informatique,2,Les Logiciels,1,Systeme d'Exploitation,8,497,2,QCU,0.01,0.86,66.33,22,11,33,23,22,1,1.43,95.65,Facile,Facile,0,Meme Difficulté,Adapte,Computer Science
497,2015,Informatique,2,Les Logiciels,1,Systeme d'Exploitation,8,498,3,QCU,0.08,0.9,90.34,43,5,48,45,43,2,1.07,95.56,Facile,Facile,0,Meme Difficulté,Pas Adapte,Computer Science
1621,2016,Informatique,2,Les Logiciels,1,Systeme d'Exploitation,8,498,3,QCU,0.14,0.88,89.95,40,4,44,41,40,1,1.07,97.56,Facile,Facile,0,Meme Difficulté,Pas Adapte,Computer Science
2745,2017,Informatique,2,Les Logiciels,1,Systeme d'Exploitation,8,498,3,QROC,0.9,0.22,10.65,5,45,50,40,5,35,1.25,12.5,Moyen,Difficile,-1,Plus Difficile,Pas Adapte,Computer Science
3869,2018,Informatique,2,Les Logiciels,1,Systeme d'Exploitation,8,498,3,QROC,0.11,0.63,89.28,49,6,55,54,49,5,1.02,90.74,Facile,Facile,0,Meme Difficulté,Pas Adapte,Computer Science
4993,2019,Informatique,2,Les Logiciels,1,Systeme d'Exploitation,8,498,3,QROC,0.33,0.4,45.36,23,28,51,51,23,28,1.0,45.1,Moyen,Moyen,0,Meme Difficulté,Pas Adapte,Computer Science
6117,2020,Informatique,2,Les Logiciels,1,Systeme d'Exploitation,8,498,3,QROC,0.08,0.61,86.49,42,6,48,44,42,2,1.09,95.45,Moyen,Facile,1,Plus Facile,Pas Adapte,Computer Science
498,2015,Informatique,2,Les Logiciels,1,Systeme d'Exploitation,8,499,4,QCM,0.62,0.16,9.83,3,32,35,21,3,18,1.67,14.29,Facile,Difficile,-2,Beaucoup plus Difficile,Pas Adapte,Computer Science
1622,2016,Informatique,2,Les Logiciels,1,Systeme d'Exploitation,8,499,4,QCM,0.75,0.2,29.9,11,27,38,15,11,4,2.53,73.33,Facile,Difficile,-2,Beaucoup plus Difficile,Pas Adapte,Computer Science
2746,2017,Informatique,2,Les Logiciels,1,Systeme d'Exploitation,8,499,4,QCM,0.19,0.92,65.07,25,14,39,29,25,4,1.34,86.21,Facile,Facile,0,Meme Difficulté,Adapte,Computer Science
3870,2018,Informatique,2,Les Logiciels,1,Systeme d'Exploitation,8,499,4,QCM,0.03,0.89,65.07,28,15,43,32,28,4,1.34,87.5,Facile,Facile,0,Meme Difficulté,Adapte,Computer Science
4994,2019,Informatique,2,Les Logiciels,1,Systeme d'Exploitation,8,499,4,QCM,0.07,0.92,65.07,27,14,41,28,27,1,1.46,96.43,Facile,Facile,0,Meme Difficulté,Adapte,Computer Science
6118,2020,Informatique,2,Les Logiciels,1,Systeme d'Exploitation,8,499,4,QCM,0.09,0.84,65.07,30,16,46,34,30,4,1.35,88.24,Facile,Facile,0,Meme Difficulté,Adapte,Computer Science
499,2015,Informatique,2,Les Logiciels,1,Systeme d'Exploitation,8,500,5,QCM,0.63,0.25,32.05,17,37,54,26,17,9,2.08,65.38,Moyen,Difficile,-1,Plus Difficile,Pas Adapte,Computer Science
1623,2016,Informatique,2,Les Logiciels,1,Systeme d'Exploitation,8,500,5,QCM,0.09,0.98,71.54,42,17,59,55,42,13,1.07,76.36,Facile,Facile,0,Meme Difficulté,Adapte,Computer Science
2747,2017,Informatique,2,Les Logiciels,1,Systeme d'Exploitation,8,500,5,QCM,0.17,0.83,71.54,44,17,61,59,44,15,1.03,74.58,Facile,Facile,0,Meme Difficulté,Adapte,Computer Science
3871,2018,Informatique,2,Les Logiciels,1,Systeme d'Exploitation,8,500,5,QCM,0.16,0.91,71.54,44,18,62,46,44,2,1.35,95.65,Facile,Facile,0,Meme Difficulté,Adapte,Computer Science
4995,2019,Informatique,2,Les Logiciels,1,Systeme d'Exploitation,8,500,5,QCM,0.15,0.85,71.54,41,16,57,50,41,9,1.14,82.0,Facile,Facile,0,Meme Difficulté,Adapte,Computer Science
6119,2020,Informatique,2,Les Logiciels,1,Systeme d'Exploitation,8,500,5,QCM,0.18,0.74,71.54,38,15,53,50,38,12,1.06,76.0,Facile,Facile,0,Meme Difficulté,Adapte,Computer Science
500,2015,Informatique,2,Les Logiciels,1,Systeme d'Exploitation,8,501,6,QCU,0.52,0.38,25.3,13,40,53,35,13,22,1.51,37.14,Difficile,Difficile,0,Meme Difficulté,Pas Adapte,Computer Science
1624,2016,Informatique,2,Les Logiciels,1,Systeme d'Exploitation,8,501,6,QCM,0.01,0.85,70.98,32,13,45,39,32,7,1.15,82.05,Moyen,Facile,1,Plus Facile,Adapte,Computer Science
2748,2017,Informatique,2,Les Logiciels,1,Systeme d'Exploitation,8,501,6,QCM,0.15,0.87,70.98,30,12,42,31,30,1,1.35,96.77,Facile,Facile,0,Meme Difficulté,Adapte,Computer Science
3872,2018,Informatique,2,Les Logiciels,1,Systeme d'Exploitation,8,501,6,QCM,0.04,0.77,70.98,30,12,42,42,30,12,1.0,71.43,Facile,Facile,0,Meme Difficulté,Adapte,Computer Science
4996,2019,Informatique,2,Les Logiciels,1,Systeme d'Exploitation,8,501,6,QCM,0.13,0.79,70.98,30,12,42,32,30,2,1.31,93.75,Facile,Facile,0,Meme Difficulté,Adapte,Computer Science
6120,2020,Informatique,2,Les Logiciels,1,Systeme d'Exploitation,8,501,6,QCM,0.03,0.88,70.98,26,10,36,28,26,2,1.29,92.86,Facile,Facile,0,Meme Difficulté,Adapte,Computer Science
501,2015,Informatique,2,Les Logiciels,1,Systeme d'Exploitation,8,502,7,QCM,0.35,0.51,41.02,36,52,88,57,36,21,1.54,63.16,Moyen,Moyen,0,Meme Difficulté,Pas Adapte,Computer Science
1625,2016,Informatique,2,Les Logiciels,1,Systeme d'Exploitation,8,502,7,QCM,0.64,0.16,15.24,14,81,95,80,14,66,1.19,17.5,Difficile,Difficile,0,Meme Difficulté,Pas Adapte,Computer Science
2749,2017,Informatique,2,Les Logiciels,1,Systeme d'Exploitation,8,502,7,QCM,0.01,0.94,86.19,82,13,95,86,82,4,1.1,95.35,Moyen,Facile,1,Plus Facile,Pas Adapte,Computer Science
3873,2018,Informatique,2,Les Logiciels,1,Systeme d'Exploitation,8,502,7,QCM,0.7,0.26,24.59,27,82,109,99,27,72,1.1,27.27,Difficile,Difficile,0,Meme Difficulté,Pas Adapte,Computer Science
4997,2019,Informatique,2,Les Logiciels,1,Systeme d'Exploitation,8,502,7,QCM,0.09,0.99,88.15,108,14,122,116,108,8,1.05,93.1,Difficile,Facile,2,Beaucoup plus Facile,Pas Adapte,Computer Science
6121,2020,Informatique,2,Les Logiciels,1,Systeme d'Exploitation,8,502,7,QCM,0.11,0.84,72.11,100,39,139,129,100,29,1.08,77.52,Difficile,Facile,2,Beaucoup plus Facile,Adapte,Computer Science
502,2015,Informatique,2,Les Logiciels,1,Systeme d'Exploitation,8,503,8,QCM,0.43,0.68,46.77,19,21,40,33,19,14,1.21,57.58,Difficile,Moyen,1,Plus Facile,Pas Adapte,Computer Science
1626,2016,Informatique,2,Les Logiciels,1,Systeme d'Exploitation,8,503,8,QCM,0.41,0.37,49.08,23,23,46,30,23,7,1.53,76.67,Moyen,Moyen,0,Meme Difficulté,Pas Adapte,Computer Science
2750,2017,Informatique,2,Les Logiciels,1,Systeme d'Exploitation,8,503,8,QCM,0.56,0.22,7.03,3,38,41,15,3,12,2.73,20.0,Facile,Difficile,-2,Beaucoup plus Difficile,Pas Adapte,Computer Science
3874,2018,Informatique,2,Les Logiciels,1,Systeme d'Exploitation,8,503,8,QCM,0.07,0.76,98.61,35,0,35,35,35,0,1.0,100.0,Moyen,Facile,1,Plus Facile,Pas Adapte,Computer Science
4998,2019,Informatique,2,Les Logiciels,1,Systeme d'Exploitation,8,503,8,QCM,0.72,0.28,16.62,5,26,31,20,5,15,1.55,25.0,Facile,Difficile,-2,Beaucoup plus Difficile,Pas Adapte,Computer Science
6122,2020,Informatique,2,Les Logiciels,1,Systeme d'Exploitation,8,503,8,QCM,0.22,0.56,39.74,10,16,26,22,10,12,1.18,45.45,Facile,Moyen,-1,Plus Difficile,Pas Adapte,Computer Science
503,2015,Informatique,2,Les Logiciels,2,Traitement de Texte,2,504,1,QCM,0.29,0.4,41.72,8,10,18,17,8,9,1.06,47.06,Difficile,Moyen,1,Plus Facile,Pas Adapte,Computer Science
1627,2016,Informatique,2,Les Logiciels,2,Traitement de Texte,2,504,1,QO,0.45,0.15,50.38,8,7,15,11,8,3,1.36,72.73,Difficile,Moyen,1,Plus Facile,Pas Adapte,Computer Science
2751,2017,Informatique,2,Les Logiciels,2,Traitement de Texte,2,504,1,QO,0.2,0.2,55.86,7,6,13,8,7,1,1.62,87.5,Moyen,Moyen,0,Meme Difficulté,Pas Adapte,Computer Science
3875,2018,Informatique,2,Les Logiciels,2,Traitement de Texte,2,504,1,QROC,0.55,0.28,42.51,6,7,13,7,6,1,1.86,85.71,Moyen,Moyen,0,Meme Difficulté,Pas Adapte,Computer Science
4999,2019,Informatique,2,Les Logiciels,2,Traitement de Texte,2,504,1,QROC,0.24,0.36,43.99,5,7,12,7,5,2,1.71,71.43,Facile,Moyen,-1,Plus Difficile,Pas Adapte,Computer Science
6123,2020,Informatique,2,Les Logiciels,2,Traitement de Texte,2,504,1,QROC,0.96,0.02,34.85,5,9,14,11,5,6,1.27,45.45,Difficile,Difficile,0,Meme Difficulté,Pas Adapte,Computer Science
504,2015,Informatique,2,Les Logiciels,2,Traitement de Texte,2,505,2,QCU,0.34,0.5,42.41,6,8,14,11,6,5,1.27,54.55,Difficile,Moyen,1,Plus Facile,Pas Adapte,Computer Science
1628,2016,Informatique,2,Les Logiciels,2,Traitement de Texte,2,505,2,QCU,0.51,0.23,18.55,2,10,12,10,2,8,1.2,20.0,Moyen,Difficile,-1,Plus Difficile,Pas Adapte,Computer Science
2752,2017,Informatique,2,Les Logiciels,2,Traitement de Texte,2,505,2,QCU,0.08,0.93,65.05,8,5,13,12,8,4,1.08,66.67,Facile,Facile,0,Meme Difficulté,Adapte,Computer Science
3876,2018,Informatique,2,Les Logiciels,2,Traitement de Texte,2,505,2,QCU,0.18,0.94,65.05,8,4,12,12,8,4,1.0,66.67,Facile,Facile,0,Meme Difficulté,Adapte,Computer Science
5000,2019,Informatique,2,Les Logiciels,2,Traitement de Texte,2,505,2,QCU,0.12,0.84,65.05,9,5,14,10,9,1,1.4,90.0,Facile,Facile,0,Meme Difficulté,Adapte,Computer Science
6124,2020,Informatique,2,Les Logiciels,2,Traitement de Texte,2,505,2,QCU,0.11,0.96,65.05,10,5,15,14,10,4,1.07,71.43,Facile,Facile,0,Meme Difficulté,Adapte,Computer Science
505,2015,Informatique,2,Les Logiciels,3,Les Tableurs,12,506,1,QCU,0.57,0.34,2.57,2,95,97,82,2,80,1.18,2.44,Facile,Difficile,-2,Beaucoup plus Difficile,Pas Adapte,Computer Science
1629,2016,Informatique,2,Les Logiciels,3,Les Tableurs,12,506,1,QCU,0.08,0.77,85.6,74,12,86,84,74,10,1.02,88.1,Difficile,Facile,2,Beaucoup plus Facile,Pas Adapte,Computer Science
2753,2017,Informatique,2,Les Logiciels,3,Les Tableurs,12,506,1,QCU,0.4,0.22,21.64,19,69,88,77,19,58,1.14,24.68,Facile,Difficile,-2,Beaucoup plus Difficile,Pas Adapte,Computer Science
3877,2018,Informatique,2,Les Logiciels,3,Les Tableurs,12,506,1,QCM,0.48,0.31,45.67,41,48,89,79,41,38,1.13,51.9,Facile,Moyen,-1,Plus Difficile,Pas Adapte,Computer Science
5001,2019,Informatique,2,Les Logiciels,3,Les Tableurs,12,506,1,QCM,0.56,0.18,17.06,17,84,101,99,17,82,1.02,17.17,Facile,Difficile,-2,Beaucoup plus Difficile,Pas Adapte,Computer Science
6125,2020,Informatique,2,Les Logiciels,3,Les Tableurs,12,506,1,QCM,0.42,0.56,54.07,48,40,88,69,48,21,1.28,69.57,Difficile,Moyen,1,Plus Facile,Pas Adapte,Computer Science
506,2015,Informatique,2,Les Logiciels,3,Les Tableurs,12,507,2,QCM,0.55,0.22,12.14,6,40,46,21,6,15,2.19,28.57,Moyen,Difficile,-1,Plus Difficile,Pas Adapte,Computer Science
1630,2016,Informatique,2,Les Logiciels,3,Les Tableurs,12,507,2,QCU,0.5,0.22,15.57,6,33,39,15,6,9,2.6,40.0,Moyen,Difficile,-1,Plus Difficile,Pas Adapte,Computer Science
2754,2017,Informatique,2,Les Logiciels,3,Les Tableurs,12,507,2,QCU,0.06,0.88,79.13,32,9,41,38,32,6,1.08,84.21,Facile,Facile,0,Meme Difficulté,Pas Adapte,Computer Science
3878,2018,Informatique,2,Les Logiciels,3,Les Tableurs,12,507,2,QCU,0.56,0.31,19.73,9,38,47,46,9,37,1.02,19.57,Difficile,Difficile,0,Meme Difficulté,Pas Adapte,Computer Science
5002,2019,Informatique,2,Les Logiciels,3,Les Tableurs,12,507,2,QCM,0.34,0.55,58.09,24,18,42,26,24,2,1.62,92.31,Difficile,Moyen,1,Plus Facile,Pas Adapte,Computer Science
6126,2020,Informatique,2,Les Logiciels,3,Les Tableurs,12,507,2,QCM,0.65,0.24,16.73,7,37,44,34,7,27,1.29,20.59,Moyen,Difficile,-1,Plus Difficile,Pas Adapte,Computer Science
507,2015,Informatique,2,Les Logiciels,3,Les Tableurs,12,508,3,QCM,0.05,0.77,72.16,69,26,95,75,69,6,1.27,92.0,Difficile,Facile,2,Beaucoup plus Facile,Adapte,Computer Science
1631,2016,Informatique,2,Les Logiciels,3,Les Tableurs,12,508,3,QCM,0.01,0.77,72.16,60,23,83,78,60,18,1.06,76.92,Facile,Facile,0,Meme Difficulté,Adapte,Computer Science
2755,2017,Informatique,2,Les Logiciels,3,Les Tableurs,12,508,3,QCM,0.03,0.77,72.16,52,20,72,53,52,1,1.36,98.11,Facile,Facile,0,Meme Difficulté,Adapte,Computer Science
3879,2018,Informatique,2,Les Logiciels,3,Les Tableurs,12,508,3,QCU,0.16,0.76,72.16,57,22,79,58,57,1,1.36,98.28,Facile,Facile,0,Meme Difficulté,Adapte,Computer Science
5003,2019,Informatique,2,Les Logiciels,3,Les Tableurs,12,508,3,QCU,0.08,0.9,72.16,56,22,78,68,56,12,1.15,82.35,Facile,Facile,0,Meme Difficulté,Adapte,Computer Science
6127,2020,Informatique,2,Les Logiciels,3,Les Tableurs,12,508,3,QCU,0.12,0.92,72.16,61,23,84,75,61,14,1.12,81.33,Facile,Facile,0,Meme Difficulté,Adapte,Computer Science
508,2015,Informatique,2,Les Logiciels,3,Les Tableurs,12,509,4,QCU,0.29,0.7,51.54,35,33,68,41,35,6,1.66,85.37,Facile,Moyen,-1,Plus Difficile,Pas Adapte,Computer Science
1632,2016,Informatique,2,Les Logiciels,3,Les Tableurs,12,509,4,QCM,0.0,0.89,68.87,42,19,61,45,42,3,1.36,93.33,Facile,Facile,0,Meme Difficulté,Adapte,Computer Science
2756,2017,Informatique,2,Les Logiciels,3,Les Tableurs,12,509,4,QCM,0.17,0.78,68.87,48,22,70,68,48,20,1.03,70.59,Facile,Facile,0,Meme Difficulté,Adapte,Computer Science
3880,2018,Informatique,2,Les Logiciels,3,Les Tableurs,12,509,4,QCM,0.19,0.71,68.87,52,23,75,59,52,7,1.27,88.14,Facile,Facile,0,Meme Difficulté,Adapte,Computer Science
5004,2019,Informatique,2,Les Logiciels,3,Les Tableurs,12,509,4,QROC,0.04,0.85,68.87,52,23,75,56,52,4,1.34,92.86,Facile,Facile,0,Meme Difficulté,Adapte,Computer Science
6128,2020,Informatique,2,Les Logiciels,3,Les Tableurs,12,509,4,QROC,0.08,0.82,68.87,48,22,70,62,48,14,1.13,77.42,Facile,Facile,0,Meme Difficulté,Adapte,Computer Science
509,2015,Informatique,2,Les Logiciels,3,Les Tableurs,12,510,5,QCU,0.26,0.41,63.86,42,24,66,52,42,10,1.27,80.77,Moyen,Moyen,0,Meme Difficulté,Adapte,Computer Science
1633,2016,Informatique,2,Les Logiciels,3,Les Tableurs,12,510,5,QCU,0.27,0.48,63.86,49,27,76,58,49,9,1.31,84.48,Moyen,Moyen,0,Meme Difficulté,Adapte,Computer Science
2757,2017,Informatique,2,Les Logiciels,3,Les Tableurs,12,510,5,QCU,0.21,0.62,63.86,56,31,87,86,56,30,1.01,65.12,Moyen,Moyen,0,Meme Difficulté,Adapte,Computer Science
3881,2018,Informatique,2,Les Logiciels,3,Les Tableurs,12,510,5,QCU,0.4,0.47,63.86,49,28,77,56,49,7,1.38,87.5,Moyen,Moyen,0,Meme Difficulté,Adapte,Computer Science
5005,2019,Informatique,2,Les Logiciels,3,Les Tableurs,12,510,5,QCU,0.25,0.54,63.86,52,30,82,72,52,20,1.14,72.22,Moyen,Moyen,0,Meme Difficulté,Adapte,Computer Science
6129,2020,Informatique,2,Les Logiciels,3,Les Tableurs,12,510,5,QCU,0.21,0.65,63.86,52,29,81,70,52,18,1.16,74.29,Moyen,Moyen,0,Meme Difficulté,Adapte,Computer Science
510,2015,Informatique,2,Les Logiciels,3,Les Tableurs,12,511,6,QCU,0.29,0.66,51.97,25,24,49,28,25,3,1.75,89.29,Facile,Moyen,-1,Plus Difficile,Pas Adapte,Computer Science
1634,2016,Informatique,2,Les Logiciels,3,Les Tableurs,12,511,6,QCU,0.13,0.94,91.17,41,4,45,43,41,2,1.05,95.35,Difficile,Facile,2,Beaucoup plus Facile,Pas Adapte,Computer Science
2758,2017,Informatique,2,Les Logiciels,3,Les Tableurs,12,511,6,QCU,0.35,0.61,43.01,21,28,49,26,21,5,1.88,80.77,Moyen,Moyen,0,Meme Difficulté,Pas Adapte,Computer Science
3882,2018,Informatique,2,Les Logiciels,3,Les Tableurs,12,511,6,QCU,0.37,0.66,38.72,21,33,54,29,21,8,1.86,72.41,Moyen,Moyen,0,Meme Difficulté,Pas Adapte,Computer Science
5006,2019,Informatique,2,Les Logiciels,3,Les Tableurs,12,511,6,QCU,0.71,0.28,6.8,4,53,57,39,4,35,1.46,10.26,Moyen,Difficile,-1,Plus Difficile,Pas Adapte,Computer Science
6130,2020,Informatique,2,Les Logiciels,3,Les Tableurs,12,511,6,QCM,0.15,0.93,69.89,39,17,56,52,39,13,1.08,75.0,Facile,Facile,0,Meme Difficulté,Adapte,Computer Science
511,2015,Informatique,2,Les Logiciels,3,Les Tableurs,12,512,7,QCU,0.11,0.95,88.44,20,3,23,21,20,1,1.1,95.24,Facile,Facile,0,Meme Difficulté,Pas Adapte,Computer Science
1635,2016,Informatique,2,Les Logiciels,3,Les Tableurs,12,512,7,QCM,0.08,0.85,74.97,17,6,23,19,17,2,1.21,89.47,Difficile,Facile,2,Beaucoup plus Facile,Adapte,Computer Science
2759,2017,Informatique,2,Les Logiciels,3,Les Tableurs,12,512,7,QCM,0.07,0.81,74.97,18,6,24,20,18,2,1.2,90.0,Facile,Facile,0,Meme Difficulté,Adapte,Computer Science
3883,2018,Informatique,2,Les Logiciels,3,Les Tableurs,12,512,7,QCM,0.2,0.72,74.97,15,5,20,16,15,1,1.25,93.75,Facile,Facile,0,Meme Difficulté,Adapte,Computer Science
5007,2019,Informatique,2,Les Logiciels,3,Les Tableurs,12,512,7,QCM,0.07,0.95,74.97,17,6,23,20,17,3,1.15,85.0,Facile,Facile,0,Meme Difficulté,Adapte,Computer Science
6131,2020,Informatique,2,Les Logiciels,3,Les Tableurs,12,512,7,QCM,0.07,0.97,74.97,16,5,21,16,16,0,1.31,100.0,Facile,Facile,0,Meme Difficulté,Adapte,Computer Science
512,2015,Informatique,2,Les Logiciels,3,Les Tableurs,12,513,8,QCM,0.33,0.5,38.15,26,43,69,31,26,5,2.23,83.87,Moyen,Moyen,0,Meme Difficulté,Pas Adapte,Computer Science
1636,2016,Informatique,2,Les Logiciels,3,Les Tableurs,12,513,8,QCU,0.36,0.63,51.1,32,30,62,53,32,21,1.17,60.38,Facile,Moyen,-1,Plus Difficile,Pas Adapte,Computer Science
2760,2017,Informatique,2,Les Logiciels,3,Les Tableurs,12,513,8,QROC,0.21,0.33,51.68,30,28,58,47,30,17,1.23,63.83,Facile,Moyen,-1,Plus Difficile,Pas Adapte,Computer Science
3884,2018,Informatique,2,Les Logiciels,3,Les Tableurs,12,513,8,QROC,0.51,0.38,39.16,20,30,50,35,20,15,1.43,57.14,Moyen,Moyen,0,Meme Difficulté,Pas Adapte,Computer Science
5008,2019,Informatique,2,Les Logiciels,3,Les Tableurs,12,513,8,QROC,0.79,0.23,14.73,8,43,51,26,8,18,1.96,30.77,Moyen,Difficile,-1,Plus Difficile,Pas Adapte,Computer Science
6132,2020,Informatique,2,Les Logiciels,3,Les Tableurs,12,513,8,QROC,0.42,0.38,38.25,19,31,50,35,19,16,1.43,54.29,Facile,Moyen,-1,Plus Difficile,Pas Adapte,Computer Science
513,2015,Informatique,2,Les Logiciels,3,Les Tableurs,12,514,9,QROC,0.8,0.08,13.17,10,65,75,31,10,21,2.42,32.26,Difficile,Difficile,0,Meme Difficulté,Pas Adapte,Computer Science
1637,2016,Informatique,2,Les Logiciels,3,Les Tableurs,12,514,9,QROC,0.07,0.96,85.83,71,12,83,79,71,8,1.05,89.87,Moyen,Facile,1,Plus Facile,Pas Adapte,Computer Science
2761,2017,Informatique,2,Les Logiciels,3,Les Tableurs,12,514,9,QROC,0.09,0.73,90.54,78,8,86,82,78,4,1.05,95.12,Facile,Facile,0,Meme Difficulté,Pas Adapte,Computer Science
3885,2018,Informatique,2,Les Logiciels,3,Les Tableurs,12,514,9,QROC,0.03,0.43,96.39,74,3,77,76,74,2,1.01,97.37,Moyen,Facile,1,Plus Facile,Pas Adapte,Computer Science
5009,2019,Informatique,2,Les Logiciels,3,Les Tableurs,12,514,9,QROC,0.06,0.85,79.79,71,18,89,85,71,14,1.05,83.53,Moyen,Facile,1,Plus Facile,Pas Adapte,Computer Science
6133,2020,Informatique,2,Les Logiciels,3,Les Tableurs,12,514,9,QROC,0.82,0.1,21.0,17,62,79,52,17,35,1.52,32.69,Moyen,Difficile,-1,Plus Difficile,Pas Adapte,Computer Science
514,2015,Informatique,2,Les Logiciels,3,Les Tableurs,12,515,10,QCM,0.6,0.18,3.19,2,66,68,54,2,52,1.26,3.7,Difficile,Difficile,0,Meme Difficulté,Pas Adapte,Computer Science
1638,2016,Informatique,2,Les Logiciels,3,Les Tableurs,12,515,10,QCM,0.11,0.87,84.82,56,10,66,65,56,9,1.02,86.15,Moyen,Facile,1,Plus Facile,Pas Adapte,Computer Science
2762,2017,Informatique,2,Les Logiciels,3,Les Tableurs,12,515,10,QCM,0.4,0.58,36.35,21,38,59,39,21,18,1.51,53.85,Difficile,Moyen,1,Plus Facile,Pas Adapte,Computer Science
3886,2018,Informatique,2,Les Logiciels,3,Les Tableurs,12,515,10,QCM,0.13,0.91,70.16,46,19,65,53,46,7,1.23,86.79,Difficile,Facile,2,Beaucoup plus Facile,Adapte,Computer Science
5010,2019,Informatique,2,Les Logiciels,3,Les Tableurs,12,515,10,QO,0.07,0.44,70.16,43,18,61,58,43,15,1.05,74.14,Facile,Facile,0,Meme Difficulté,Adapte,Computer Science
6134,2020,Informatique,2,Les Logiciels,3,Les Tableurs,12,515,10,QO,0.08,0.3,70.16,40,17,57,45,40,5,1.27,88.89,Facile,Facile,0,Meme Difficulté,Adapte,Computer Science
515,2015,Informatique,2,Les Logiciels,3,Les Tableurs,12,516,11,QCM,0.04,0.79,77.7,10,3,13,11,10,1,1.18,90.91,Difficile,Facile,2,Beaucoup plus Facile,Pas Adapte,Computer Science
1639,2016,Informatique,2,Les Logiciels,3,Les Tableurs,12,516,11,QCM,0.03,0.87,67.61,10,5,15,12,10,2,1.25,83.33,Difficile,Facile,2,Beaucoup plus Facile,Adapte,Computer Science
2763,2017,Informatique,2,Les Logiciels,3,Les Tableurs,12,516,11,QCM,0.03,0.86,67.61,10,5,15,13,10,3,1.15,76.92,Facile,Facile,0,Meme Difficulté,Adapte,Computer Science
3887,2018,Informatique,2,Les Logiciels,3,Les Tableurs,12,516,11,QCM,0.06,0.91,67.61,11,5,16,11,11,0,1.45,100.0,Facile,Facile,0,Meme Difficulté,Adapte,Computer Science
5011,2019,Informatique,2,Les Logiciels,3,Les Tableurs,12,516,11,QCM,0.11,0.98,67.61,11,6,17,15,11,4,1.13,73.33,Facile,Facile,0,Meme Difficulté,Adapte,Computer Science
6135,2020,Informatique,2,Les Logiciels,3,Les Tableurs,12,516,11,QCM,0.1,0.81,67.61,14,6,20,17,14,3,1.18,82.35,Facile,Facile,0,Meme Difficulté,Adapte,Computer Science
516,2015,Informatique,2,Les Logiciels,3,Les Tableurs,12,517,12,QCM,0.6,0.2,8.95,4,38,42,18,4,14,2.33,22.22,Difficile,Difficile,0,Meme Difficulté,Pas Adapte,Computer Science
1640,2016,Informatique,2,Les Logiciels,3,Les Tableurs,12,517,12,QCU,0.03,0.96,98.26,36,1,37,36,36,0,1.03,100.0,Moyen,Facile,1,Plus Facile,Pas Adapte,Computer Science
2764,2017,Informatique,2,Les Logiciels,3,Les Tableurs,12,517,12,QROC,0.7,0.05,2.35,1,35,36,20,1,19,1.8,5.0,Facile,Difficile,-2,Beaucoup plus Difficile,Pas Adapte,Computer Science
3888,2018,Informatique,2,Les Logiciels,3,Les Tableurs,12,517,12,QROC,0.98,0.07,7.56,2,30,32,23,2,21,1.39,8.7,Difficile,Difficile,0,Meme Difficulté,Pas Adapte,Computer Science
5012,2019,Informatique,2,Les Logiciels,3,Les Tableurs,12,517,12,QROC,0.53,0.36,40.07,13,19,32,17,13,4,1.88,76.47,Moyen,Moyen,0,Meme Difficulté,Pas Adapte,Computer Science
6136,2020,Informatique,2,Les Logiciels,3,Les Tableurs,12,517,12,QROC,0.98,0.02,21.41,7,24,31,25,7,18,1.24,28.0,Moyen,Difficile,-1,Plus Difficile,Pas Adapte,Computer Science
517,2015,Informatique,3,Algorithme et Programmation,1,Notion d'Algorithme,8,518,1,QO,0.8,0.14,26.09,11,32,43,40,11,29,1.07,27.5,Facile,Difficile,-2,Beaucoup plus Difficile,Pas Adapte,Computer Science
1641,2016,Informatique,3,Algorithme et Programmation,1,Notion d'Algorithme,8,518,1,QO,0.79,0.12,23.89,10,31,41,32,10,22,1.28,31.25,Moyen,Difficile,-1,Plus Difficile,Pas Adapte,Computer Science
2765,2017,Informatique,3,Algorithme et Programmation,1,Notion d'Algorithme,8,518,1,QO,0.71,0.19,49.2,17,18,35,23,17,6,1.52,73.91,Difficile,Moyen,1,Plus Facile,Pas Adapte,Computer Science
3889,2018,Informatique,3,Algorithme et Programmation,1,Notion d'Algorithme,8,518,1,QO,0.85,0.07,11.46,4,31,35,18,4,14,1.94,22.22,Facile,Difficile,-2,Beaucoup plus Difficile,Pas Adapte,Computer Science
5013,2019,Informatique,3,Algorithme et Programmation,1,Notion d'Algorithme,8,518,1,QO,0.6,0.18,59.82,22,15,37,28,22,6,1.32,78.57,Moyen,Moyen,0,Meme Difficulté,Pas Adapte,Computer Science
6137,2020,Informatique,3,Algorithme et Programmation,1,Notion d'Algorithme,8,518,1,QO,0.04,0.88,65.22,25,14,39,35,25,10,1.11,71.43,Facile,Facile,0,Meme Difficulté,Adapte,Computer Science
518,2015,Informatique,3,Algorithme et Programmation,1,Notion d'Algorithme,8,519,2,QCU,0.63,0.34,29.89,19,43,62,23,19,4,2.7,82.61,Difficile,Difficile,0,Meme Difficulté,Pas Adapte,Computer Science
1642,2016,Informatique,3,Algorithme et Programmation,1,Notion d'Algorithme,8,519,2,QCU,0.29,0.71,45.08,29,36,65,44,29,15,1.48,65.91,Difficile,Moyen,1,Plus Facile,Pas Adapte,Computer Science
2766,2017,Informatique,3,Algorithme et Programmation,1,Notion d'Algorithme,8,519,2,QCM,0.67,0.26,28.62,19,49,68,43,19,24,1.58,44.19,Difficile,Difficile,0,Meme Difficulté,Pas Adapte,Computer Science
3890,2018,Informatique,3,Algorithme et Programmation,1,Notion d'Algorithme,8,519,2,QCM,0.39,0.56,62.27,40,24,64,49,40,9,1.31,81.63,Facile,Moyen,-1,Plus Difficile,Adapte,Computer Science
5014,2019,Informatique,3,Algorithme et Programmation,1,Notion d'Algorithme,8,519,2,QCM,0.49,0.39,62.27,34,21,55,50,34,16,1.1,68.0,Moyen,Moyen,0,Meme Difficulté,Adapte,Computer Science
6138,2020,Informatique,3,Algorithme et Programmation,1,Notion d'Algorithme,8,519,2,QCM,0.39,0.56,62.27,39,23,62,52,39,13,1.19,75.0,Moyen,Moyen,0,Meme Difficulté,Adapte,Computer Science
519,2015,Informatique,3,Algorithme et Programmation,1,Notion d'Algorithme,8,520,3,QROC,0.75,0.01,1.25,0,9,9,5,0,5,1.8,0.0,Moyen,Difficile,-1,Plus Difficile,Pas Adapte,Computer Science
1643,2016,Informatique,3,Algorithme et Programmation,1,Notion d'Algorithme,8,520,3,QROC,0.76,0.18,22.75,2,6,8,6,2,4,1.33,33.33,Facile,Difficile,-2,Beaucoup plus Difficile,Pas Adapte,Computer Science
2767,2017,Informatique,3,Algorithme et Programmation,1,Notion d'Algorithme,8,520,3,QROC,0.52,0.38,50.54,4,4,8,4,4,0,2.0,100.0,Moyen,Moyen,0,Meme Difficulté,Pas Adapte,Computer Science
3891,2018,Informatique,3,Algorithme et Programmation,1,Notion d'Algorithme,8,520,3,QROC,0.57,0.35,63.25,6,3,9,7,6,1,1.29,85.71,Moyen,Moyen,0,Meme Difficulté,Adapte,Computer Science
5015,2019,Informatique,3,Algorithme et Programmation,1,Notion d'Algorithme,8,520,3,QROC,0.49,0.35,63.25,5,3,8,5,5,0,1.6,100.0,Moyen,Moyen,0,Meme Difficulté,Adapte,Computer Science
6139,2020,Informatique,3,Algorithme et Programmation,1,Notion d'Algorithme,8,520,3,QROC,0.2,0.36,63.25,5,3,8,5,5,0,1.6,100.0,Moyen,Moyen,0,Meme Difficulté,Adapte,Computer Science
520,2015,Informatique,3,Algorithme et Programmation,1,Notion d'Algorithme,8,521,4,QCM,0.17,0.91,71.64,32,13,45,39,32,7,1.15,82.05,Difficile,Facile,2,Beaucoup plus Facile,Adapte,Computer Science
1644,2016,Informatique,3,Algorithme et Programmation,1,Notion d'Algorithme,8,521,4,QCM,0.13,0.84,71.64,31,12,43,37,31,6,1.16,83.78,Facile,Facile,0,Meme Difficulté,Adapte,Computer Science
2768,2017,Informatique,3,Algorithme et Programmation,1,Notion d'Algorithme,8,521,4,QCU,0.05,0.93,71.64,29,11,40,30,29,1,1.33,96.67,Facile,Facile,0,Meme Difficulté,Adapte,Computer Science
3892,2018,Informatique,3,Algorithme et Programmation,1,Notion d'Algorithme,8,521,4,QCU,0.1,0.99,71.64,31,12,43,39,31,8,1.1,79.49,Facile,Facile,0,Meme Difficulté,Adapte,Computer Science
5016,2019,Informatique,3,Algorithme et Programmation,1,Notion d'Algorithme,8,521,4,QCU,0.12,0.93,71.64,32,12,44,41,32,9,1.07,78.05,Facile,Facile,0,Meme Difficulté,Adapte,Computer Science
6140,2020,Informatique,3,Algorithme et Programmation,1,Notion d'Algorithme,8,521,4,QCU,0.11,0.84,71.64,35,14,49,48,35,13,1.02,72.92,Facile,Facile,0,Meme Difficulté,Adapte,Computer Science
521,2015,Informatique,3,Algorithme et Programmation,1,Notion d'Algorithme,8,522,5,QCU,0.17,0.96,67.91,60,29,89,62,60,2,1.44,96.77,Facile,Facile,0,Meme Difficulté,Adapte,Computer Science
1645,2016,Informatique,3,Algorithme et Programmation,1,Notion d'Algorithme,8,522,5,QCU,0.1,0.79,67.91,68,32,100,72,68,4,1.39,94.44,Facile,Facile,0,Meme Difficulté,Adapte,Computer Science
2769,2017,Informatique,3,Algorithme et Programmation,1,Notion d'Algorithme,8,522,5,QCU,0.09,0.81,67.91,63,30,93,92,63,29,1.01,68.48,Facile,Facile,0,Meme Difficulté,Adapte,Computer Science
3893,2018,Informatique,3,Algorithme et Programmation,1,Notion d'Algorithme,8,522,5,QCU,0.08,0.99,67.91,65,31,96,87,65,22,1.1,74.71,Facile,Facile,0,Meme Difficulté,Adapte,Computer Science
5017,2019,Informatique,3,Algorithme et Programmation,1,Notion d'Algorithme,8,522,5,QCU,0.01,0.92,67.91,69,33,102,87,69,18,1.17,79.31,Facile,Facile,0,Meme Difficulté,Adapte,Computer Science
6141,2020,Informatique,3,Algorithme et Programmation,1,Notion d'Algorithme,8,522,5,QCU,0.03,0.78,67.91,77,36,113,104,77,27,1.09,74.04,Facile,Facile,0,Meme Difficulté,Adapte,Computer Science
522,2015,Informatique,3,Algorithme et Programmation,1,Notion d'Algorithme,8,523,6,QCM,0.11,0.73,99.19,25,0,25,25,25,0,1.0,100.0,Difficile,Facile,2,Beaucoup plus Facile,Pas Adapte,Computer Science
1646,2016,Informatique,3,Algorithme et Programmation,1,Notion d'Algorithme,8,523,6,QCM,0.6,0.18,11.77,3,24,27,11,3,8,2.45,27.27,Facile,Difficile,-2,Beaucoup plus Difficile,Pas Adapte,Computer Science
2770,2017,Informatique,3,Algorithme et Programmation,1,Notion d'Algorithme,8,523,6,QO,0.38,0.21,54.13,15,12,27,25,15,10,1.08,60.0,Facile,Moyen,-1,Plus Difficile,Pas Adapte,Computer Science
3894,2018,Informatique,3,Algorithme et Programmation,1,Notion d'Algorithme,8,523,6,QCM,0.71,0.24,15.7,4,22,26,13,4,9,2.0,30.77,Facile,Difficile,-2,Beaucoup plus Difficile,Pas Adapte,Computer Science
5018,2019,Informatique,3,Algorithme et Programmation,1,Notion d'Algorithme,8,523,6,QCM,0.17,0.98,95.38,23,1,24,23,23,0,1.04,100.0,Difficile,Facile,2,Beaucoup plus Facile,Pas Adapte,Computer Science
6142,2020,Informatique,3,Algorithme et Programmation,1,Notion d'Algorithme,8,523,6,QCM,0.55,0.22,16.92,4,19,23,14,4,10,1.64,28.57,Facile,Difficile,-2,Beaucoup plus Difficile,Pas Adapte,Computer Science
523,2015,Informatique,3,Algorithme et Programmation,1,Notion d'Algorithme,8,524,7,QCM,0.03,0.96,83.26,24,5,29,27,24,3,1.07,88.89,Moyen,Facile,1,Plus Facile,Pas Adapte,Computer Science
1647,2016,Informatique,3,Algorithme et Programmation,1,Notion d'Algorithme,8,524,7,QCM,0.78,0.2,29.71,10,23,33,33,10,23,1.0,30.3,Difficile,Difficile,0,Meme Difficulté,Pas Adapte,Computer Science
2771,2017,Informatique,3,Algorithme et Programmation,1,Notion d'Algorithme,8,524,7,QCU,0.64,0.36,27.25,9,23,32,16,9,7,2.0,56.25,Moyen,Difficile,-1,Plus Difficile,Pas Adapte,Computer Science
3895,2018,Informatique,3,Algorithme et Programmation,1,Notion d'Algorithme,8,524,7,QCU,0.2,0.93,71.94,19,8,27,26,19,7,1.04,73.08,Facile,Facile,0,Meme Difficulté,Adapte,Computer Science
5019,2019,Informatique,3,Algorithme et Programmation,1,Notion d'Algorithme,8,524,7,QCU,0.05,0.88,71.94,20,8,28,21,20,1,1.33,95.24,Facile,Facile,0,Meme Difficulté,Adapte,Computer Science
6143,2020,Informatique,3,Algorithme et Programmation,1,Notion d'Algorithme,8,524,7,QCU,0.14,0.97,71.94,23,9,32,27,23,4,1.19,85.19,Facile,Facile,0,Meme Difficulté,Adapte,Computer Science
524,2015,Informatique,3,Algorithme et Programmation,1,Notion d'Algorithme,8,525,8,QCM,0.02,0.89,77.39,74,22,96,93,74,19,1.03,79.57,Difficile,Facile,2,Beaucoup plus Facile,Pas Adapte,Computer Science
1648,2016,Informatique,3,Algorithme et Programmation,1,Notion d'Algorithme,8,525,8,QCM,0.17,0.79,95.05,85,4,89,87,85,2,1.02,97.7,Moyen,Facile,1,Plus Facile,Pas Adapte,Computer Science
2772,2017,Informatique,3,Algorithme et Programmation,1,Notion d'Algorithme,8,525,8,QCM,0.64,0.2,8.63,8,84,92,77,8,69,1.19,10.39,Moyen,Difficile,-1,Plus Difficile,Pas Adapte,Computer Science
3896,2018,Informatique,3,Algorithme et Programmation,1,Notion d'Algorithme,8,525,8,QCM,0.61,0.22,15.34,15,81,96,41,15,26,2.34,36.59,Moyen,Difficile,-1,Plus Difficile,Pas Adapte,Computer Science
5020,2019,Informatique,3,Algorithme et Programmation,1,Notion d'Algorithme,8,525,8,QCM,0.19,0.87,82.32,86,19,105,87,86,1,1.21,98.85,Moyen,Facile,1,Plus Facile,Pas Adapte,Computer Science
6144,2020,Informatique,3,Algorithme et Programmation,1,Notion d'Algorithme,8,525,8,QCM,0.16,0.8,96.22,109,4,113,110,109,1,1.03,99.09,Difficile,Facile,2,Beaucoup plus Facile,Pas Adapte,Computer Science
525,2015,Informatique,3,Algorithme et Programmation,2,Instruction de Base,8,526,1,QCU,0.07,0.76,74.66,43,15,58,45,43,2,1.29,95.56,Facile,Facile,0,Meme Difficulté,Adapte,Computer Science
1649,2016,Informatique,3,Algorithme et Programmation,2,Instruction de Base,8,526,1,QCU,0.15,0.8,74.66,44,15,59,45,44,1,1.31,97.78,Facile,Facile,0,Meme Difficulté,Adapte,Computer Science
2773,2017,Informatique,3,Algorithme et Programmation,2,Instruction de Base,8,526,1,QCU,0.19,0.98,74.66,43,15,58,58,43,15,1.0,74.14,Facile,Facile,0,Meme Difficulté,Adapte,Computer Science
3897,2018,Informatique,3,Algorithme et Programmation,2,Instruction de Base,8,526,1,QCU,0.16,0.91,74.66,47,16,63,48,47,1,1.31,97.92,Facile,Facile,0,Meme Difficulté,Adapte,Computer Science
5021,2019,Informatique,3,Algorithme et Programmation,2,Instruction de Base,8,526,1,QCU,0.17,0.96,74.66,45,15,60,58,45,13,1.03,77.59,Facile,Facile,0,Meme Difficulté,Adapte,Computer Science
6145,2020,Informatique,3,Algorithme et Programmation,2,Instruction de Base,8,526,1,QCU,0.08,0.79,74.66,43,15,58,52,43,9,1.12,82.69,Facile,Facile,0,Meme Difficulté,Adapte,Computer Science
526,2015,Informatique,3,Algorithme et Programmation,2,Instruction de Base,8,527,2,QO,0.68,0.23,56.28,47,37,84,67,47,20,1.25,70.15,Moyen,Moyen,0,Meme Difficulté,Pas Adapte,Computer Science
1650,2016,Informatique,3,Algorithme et Programmation,2,Instruction de Base,8,527,2,QO,0.12,0.89,97.5,79,2,81,80,79,1,1.01,98.75,Facile,Facile,0,Meme Difficulté,Pas Adapte,Computer Science
2774,2017,Informatique,3,Algorithme et Programmation,2,Instruction de Base,8,527,2,QO,0.48,0.2,60.1,50,34,84,73,50,23,1.15,68.49,Difficile,Moyen,1,Plus Facile,Adapte,Computer Science
3898,2018,Informatique,3,Algorithme et Programmation,2,Instruction de Base,8,527,2,QO,0.51,0.27,60.1,58,38,96,59,58,1,1.63,98.31,Moyen,Moyen,0,Meme Difficulté,Adapte,Computer Science
5022,2019,Informatique,3,Algorithme et Programmation,2,Instruction de Base,8,527,2,QCM,0.22,0.38,60.1,60,40,100,97,60,37,1.03,61.86,Moyen,Moyen,0,Meme Difficulté,Adapte,Computer Science
6146,2020,Informatique,3,Algorithme et Programmation,2,Instruction de Base,8,527,2,QCM,0.21,0.64,60.1,53,35,88,63,53,10,1.4,84.13,Moyen,Moyen,0,Meme Difficulté,Adapte,Computer Science
527,2015,Informatique,3,Algorithme et Programmation,2,Instruction de Base,8,528,3,QCM,0.1,0.82,92.49,48,4,52,50,48,2,1.04,96.0,Difficile,Facile,2,Beaucoup plus Facile,Pas Adapte,Computer Science
1651,2016,Informatique,3,Algorithme et Programmation,2,Instruction de Base,8,528,3,QCM,0.49,0.65,53.46,27,24,51,28,27,1,1.82,96.43,Moyen,Moyen,0,Meme Difficulté,Pas Adapte,Computer Science
2775,2017,Informatique,3,Algorithme et Programmation,2,Instruction de Base,8,528,3,QCM,0.7,0.22,26.04,13,36,49,28,13,15,1.75,46.43,Facile,Difficile,-2,Beaucoup plus Difficile,Pas Adapte,Computer Science
3899,2018,Informatique,3,Algorithme et Programmation,2,Instruction de Base,8,528,3,QCM,0.32,0.44,52.96,30,26,56,54,30,24,1.04,55.56,Facile,Moyen,-1,Plus Difficile,Pas Adapte,Computer Science
5023,2019,Informatique,3,Algorithme et Programmation,2,Instruction de Base,8,528,3,QCM,0.41,0.52,63.89,34,19,53,37,34,3,1.43,91.89,Moyen,Moyen,0,Meme Difficulté,Adapte,Computer Science
6147,2020,Informatique,3,Algorithme et Programmation,2,Instruction de Base,8,528,3,QCM,0.35,0.59,63.89,36,21,57,52,36,16,1.1,69.23,Moyen,Moyen,0,Meme Difficulté,Adapte,Computer Science
528,2015,Informatique,3,Algorithme et Programmation,2,Instruction de Base,8,529,4,QCM,0.69,0.28,22.72,8,26,34,25,8,17,1.36,32.0,Facile,Difficile,-2,Beaucoup plus Difficile,Pas Adapte,Computer Science
1652,2016,Informatique,3,Algorithme et Programmation,2,Instruction de Base,8,529,4,QCM,0.8,0.28,14.7,5,32,37,17,5,12,2.18,29.41,Facile,Difficile,-2,Beaucoup plus Difficile,Pas Adapte,Computer Science
2776,2017,Informatique,3,Algorithme et Programmation,2,Instruction de Base,8,529,4,QCM,0.01,0.71,98.79,41,0,41,41,41,0,1.0,100.0,Difficile,Facile,2,Beaucoup plus Facile,Pas Adapte,Computer Science
3900,2018,Informatique,3,Algorithme et Programmation,2,Instruction de Base,8,529,4,QCM,0.58,0.27,17.14,8,39,47,24,8,16,1.96,33.33,Difficile,Difficile,0,Meme Difficulté,Pas Adapte,Computer Science
5024,2019,Informatique,3,Algorithme et Programmation,2,Instruction de Base,8,529,4,QCM,0.23,0.6,38.95,18,29,47,20,18,2,2.35,90.0,Difficile,Moyen,1,Plus Facile,Pas Adapte,Computer Science
6148,2020,Informatique,3,Algorithme et Programmation,2,Instruction de Base,8,529,4,QCM,0.32,0.43,53.54,28,24,52,42,28,14,1.24,66.67,Facile,Moyen,-1,Plus Difficile,Pas Adapte,Computer Science
529,2015,Informatique,3,Algorithme et Programmation,2,Instruction de Base,8,530,5,QCU,0.18,0.99,88.36,27,3,30,29,27,2,1.03,93.1,Difficile,Facile,2,Beaucoup plus Facile,Pas Adapte,Computer Science
1653,2016,Informatique,3,Algorithme et Programmation,2,Instruction de Base,8,530,5,QCU,0.08,0.8,95.51,32,2,34,33,32,1,1.03,96.97,Difficile,Facile,2,Beaucoup plus Facile,Pas Adapte,Computer Science
2777,2017,Informatique,3,Algorithme et Programmation,2,Instruction de Base,8,530,5,QCU,0.02,0.82,71.89,22,9,31,24,22,2,1.29,91.67,Difficile,Facile,2,Beaucoup plus Facile,Adapte,Computer Science
3901,2018,Informatique,3,Algorithme et Programmation,2,Instruction de Base,8,530,5,QCU,0.16,0.84,71.89,22,9,31,23,22,1,1.35,95.65,Facile,Facile,0,Meme Difficulté,Adapte,Computer Science
5025,2019,Informatique,3,Algorithme et Programmation,2,Instruction de Base,8,530,5,QCU,0.09,0.98,71.89,24,10,34,32,24,8,1.06,75.0,Facile,Facile,0,Meme Difficulté,Adapte,Computer Science
6149,2020,Informatique,3,Algorithme et Programmation,2,Instruction de Base,8,530,5,QCU,0.18,0.96,71.89,27,10,37,32,27,5,1.16,84.38,Facile,Facile,0,Meme Difficulté,Adapte,Computer Science
530,2015,Informatique,3,Algorithme et Programmation,2,Instruction de Base,8,531,6,QCU,0.18,0.93,94.96,60,3,63,63,60,3,1.0,95.24,Difficile,Facile,2,Beaucoup plus Facile,Pas Adapte,Computer Science
1654,2016,Informatique,3,Algorithme et Programmation,2,Instruction de Base,8,531,6,QCU,0.36,0.69,64.68,41,22,63,47,41,6,1.34,87.23,Facile,Moyen,-1,Plus Difficile,Adapte,Computer Science
2778,2017,Informatique,3,Algorithme et Programmation,2,Instruction de Base,8,531,6,QCU,0.33,0.45,64.68,43,24,67,48,43,5,1.4,89.58,Moyen,Moyen,0,Meme Difficulté,Adapte,Computer Science
3902,2018,Informatique,3,Algorithme et Programmation,2,Instruction de Base,8,531,6,QCU,0.33,0.56,64.68,50,27,77,62,50,12,1.24,80.65,Moyen,Moyen,0,Meme Difficulté,Adapte,Computer Science
5026,2019,Informatique,3,Algorithme et Programmation,2,Instruction de Base,8,531,6,QCU,0.28,0.51,64.68,52,28,80,57,52,5,1.4,91.23,Moyen,Moyen,0,Meme Difficulté,Adapte,Computer Science
6150,2020,Informatique,3,Algorithme et Programmation,2,Instruction de Base,8,531,6,QCU,0.25,0.57,64.68,56,31,87,75,56,19,1.16,74.67,Moyen,Moyen,0,Meme Difficulté,Adapte,Computer Science
531,2015,Informatique,3,Algorithme et Programmation,2,Instruction de Base,8,532,7,QCM,0.76,0.29,32.64,4,7,11,11,4,7,1.0,36.36,Facile,Difficile,-2,Beaucoup plus Difficile,Pas Adapte,Computer Science
1655,2016,Informatique,3,Algorithme et Programmation,2,Instruction de Base,8,532,7,QCM,0.75,0.26,5.43,1,11,12,4,1,3,3.0,25.0,Moyen,Difficile,-1,Plus Difficile,Pas Adapte,Computer Science
2779,2017,Informatique,3,Algorithme et Programmation,2,Instruction de Base,8,532,7,QCM,0.59,0.29,15.37,2,12,14,13,2,11,1.08,15.38,Difficile,Difficile,0,Meme Difficulté,Pas Adapte,Computer Science
3903,2018,Informatique,3,Algorithme et Programmation,2,Instruction de Base,8,532,7,QCM,0.74,0.25,11.43,2,12,14,12,2,10,1.17,16.67,Facile,Difficile,-2,Beaucoup plus Difficile,Pas Adapte,Computer Science
5027,2019,Informatique,3,Algorithme et Programmation,2,Instruction de Base,8,532,7,QCM,0.43,0.6,54.49,7,5,12,7,7,0,1.71,100.0,Facile,Moyen,-1,Plus Difficile,Pas Adapte,Computer Science
6151,2020,Informatique,3,Algorithme et Programmation,2,Instruction de Base,8,532,7,QCM,0.1,0.94,70.68,8,3,11,11,8,3,1.0,72.73,Facile,Facile,0,Meme Difficulté,Adapte,Computer Science
532,2015,Informatique,3,Algorithme et Programmation,2,Instruction de Base,8,533,8,QCU,0.17,0.89,79.13,65,17,82,75,65,10,1.09,86.67,Difficile,Facile,2,Beaucoup plus Facile,Pas Adapte,Computer Science
1656,2016,Informatique,3,Algorithme et Programmation,2,Instruction de Base,8,533,8,QCU,0.01,0.93,80.3,63,16,79,75,63,12,1.05,84.0,Moyen,Facile,1,Plus Facile,Pas Adapte,Computer Science
2780,2017,Informatique,3,Algorithme et Programmation,2,Instruction de Base,8,533,8,QCU,0.65,0.33,3.91,3,69,72,60,3,57,1.2,5.0,Facile,Difficile,-2,Beaucoup plus Difficile,Pas Adapte,Computer Science
3904,2018,Informatique,3,Algorithme et Programmation,2,Instruction de Base,8,533,8,QCU,0.43,0.31,19.12,15,63,78,67,15,52,1.16,22.39,Moyen,Difficile,-1,Plus Difficile,Pas Adapte,Computer Science
5028,2019,Informatique,3,Algorithme et Programmation,2,Instruction de Base,8,533,8,QCU,0.01,0.88,75.49,51,16,67,62,51,11,1.08,82.26,Difficile,Facile,2,Beaucoup plus Facile,Pas Adapte,Computer Science
6152,2020,Informatique,3,Algorithme et Programmation,2,Instruction de Base,8,533,8,QO,0.69,0.25,55.67,33,27,60,46,33,13,1.3,71.74,Facile,Moyen,-1,Plus Difficile,Pas Adapte,Computer Science
533,2015,Informatique,3,Algorithme et Programmation,3,Les Langagues de Programmation,12,534,1,QCU,0.23,0.7,59.7,33,22,55,42,33,9,1.31,78.57,Difficile,Moyen,1,Plus Facile,Pas Adapte,Computer Science
1657,2016,Informatique,3,Algorithme et Programmation,3,Les Langagues de Programmation,12,534,1,QCU,0.23,0.72,39.53,19,30,49,23,19,4,2.13,82.61,Moyen,Moyen,0,Meme Difficulté,Pas Adapte,Computer Science
2781,2017,Informatique,3,Algorithme et Programmation,3,Les Langagues de Programmation,12,534,1,QCU,0.14,0.93,65.16,30,16,46,44,30,14,1.05,68.18,Facile,Facile,0,Meme Difficulté,Adapte,Computer Science
3905,2018,Informatique,3,Algorithme et Programmation,3,Les Langagues de Programmation,12,534,1,QCU,0.14,0.87,65.16,27,15,42,42,27,15,1.0,64.29,Facile,Facile,0,Meme Difficulté,Adapte,Computer Science
5029,2019,Informatique,3,Algorithme et Programmation,3,Les Langagues de Programmation,12,534,1,QCU,0.09,0.86,65.16,30,16,46,42,30,12,1.1,71.43,Facile,Facile,0,Meme Difficulté,Adapte,Computer Science
6153,2020,Informatique,3,Algorithme et Programmation,3,Les Langagues de Programmation,12,534,1,QCU,0.08,0.99,65.16,31,17,48,38,31,7,1.26,81.58,Facile,Facile,0,Meme Difficulté,Adapte,Computer Science
534,2015,Informatique,3,Algorithme et Programmation,3,Les Langagues de Programmation,12,535,2,QCM,0.14,0.87,90.5,55,6,61,56,55,1,1.09,98.21,Difficile,Facile,2,Beaucoup plus Facile,Pas Adapte,Computer Science
1658,2016,Informatique,3,Algorithme et Programmation,3,Les Langagues de Programmation,12,535,2,QCM,0.25,0.59,56.15,30,23,53,33,30,3,1.61,90.91,Difficile,Moyen,1,Plus Facile,Pas Adapte,Computer Science
2782,2017,Informatique,3,Algorithme et Programmation,3,Les Langagues de Programmation,12,535,2,QCU,0.7,0.33,15.21,9,47,56,50,9,41,1.12,18.0,Moyen,Difficile,-1,Plus Difficile,Pas Adapte,Computer Science
3906,2018,Informatique,3,Algorithme et Programmation,3,Les Langagues de Programmation,12,535,2,QCU,0.5,0.38,24.28,15,48,63,40,15,25,1.57,37.5,Facile,Difficile,-2,Beaucoup plus Difficile,Pas Adapte,Computer Science
5030,2019,Informatique,3,Algorithme et Programmation,3,Les Langagues de Programmation,12,535,2,QCU,0.13,0.85,93.95,67,4,71,68,67,1,1.04,98.53,Facile,Facile,0,Meme Difficulté,Pas Adapte,Computer Science
6154,2020,Informatique,3,Algorithme et Programmation,3,Les Langagues de Programmation,12,535,2,QCU,0.66,0.26,27.78,23,59,82,60,23,37,1.37,38.33,Facile,Difficile,-2,Beaucoup plus Difficile,Pas Adapte,Computer Science
535,2015,Informatique,3,Algorithme et Programmation,3,Les Langagues de Programmation,12,536,3,QCU,0.24,0.55,42.21,35,49,84,74,35,39,1.14,47.3,Facile,Moyen,-1,Plus Difficile,Pas Adapte,Computer Science
1659,2016,Informatique,3,Algorithme et Programmation,3,Les Langagues de Programmation,12,536,3,QCU,0.19,0.78,67.76,54,25,79,61,54,7,1.3,88.52,Facile,Facile,0,Meme Difficulté,Adapte,Computer Science
2783,2017,Informatique,3,Algorithme et Programmation,3,Les Langagues de Programmation,12,536,3,QCU,0.16,0.77,67.76,60,29,89,69,60,9,1.29,86.96,Facile,Facile,0,Meme Difficulté,Adapte,Computer Science
3907,2018,Informatique,3,Algorithme et Programmation,3,Les Langagues de Programmation,12,536,3,QCU,0.12,0.97,67.76,53,25,78,59,53,6,1.32,89.83,Facile,Facile,0,Meme Difficulté,Adapte,Computer Science
5031,2019,Informatique,3,Algorithme et Programmation,3,Les Langagues de Programmation,12,536,3,QCM,0.06,0.89,67.76,48,23,71,69,48,21,1.03,69.57,Facile,Facile,0,Meme Difficulté,Adapte,Computer Science
6155,2020,Informatique,3,Algorithme et Programmation,3,Les Langagues de Programmation,12,536,3,QCM,0.08,0.83,67.76,52,24,76,67,52,15,1.13,77.61,Facile,Facile,0,Meme Difficulté,Adapte,Computer Science
536,2015,Informatique,3,Algorithme et Programmation,3,Les Langagues de Programmation,12,537,4,QCU,0.43,0.23,11.0,6,46,52,18,6,12,2.89,33.33,Difficile,Difficile,0,Meme Difficulté,Pas Adapte,Computer Science
1660,2016,Informatique,3,Algorithme et Programmation,3,Les Langagues de Programmation,12,537,4,QCU,0.02,0.76,80.15,37,9,46,39,37,2,1.18,94.87,Moyen,Facile,1,Plus Facile,Pas Adapte,Computer Science
2784,2017,Informatique,3,Algorithme et Programmation,3,Les Langagues de Programmation,12,537,4,QCU,0.64,0.26,18.45,8,34,42,41,8,33,1.02,19.51,Facile,Difficile,-2,Beaucoup plus Difficile,Pas Adapte,Computer Science
3908,2018,Informatique,3,Algorithme et Programmation,3,Les Langagues de Programmation,12,537,4,QCU,0.25,0.68,50.92,23,23,46,42,23,19,1.1,54.76,Facile,Moyen,-1,Plus Difficile,Pas Adapte,Computer Science
5032,2019,Informatique,3,Algorithme et Programmation,3,Les Langagues de Programmation,12,537,4,QCU,0.65,0.22,14.28,7,41,48,28,7,21,1.71,25.0,Facile,Difficile,-2,Beaucoup plus Difficile,Pas Adapte,Computer Science
6156,2020,Informatique,3,Algorithme et Programmation,3,Les Langagues de Programmation,12,537,4,QCU,0.41,0.26,34.01,18,34,52,26,18,8,2.0,69.23,Difficile,Difficile,0,Meme Difficulté,Pas Adapte,Computer Science
537,2015,Informatique,3,Algorithme et Programmation,3,Les Langagues de Programmation,12,538,5,QCU,0.36,0.51,55.39,8,6,14,8,8,0,1.75,100.0,Difficile,Moyen,1,Plus Facile,Pas Adapte,Computer Science
1661,2016,Informatique,3,Algorithme et Programmation,3,Les Langagues de Programmation,12,538,5,QCU,0.24,0.73,60.81,9,6,15,11,9,2,1.36,81.82,Difficile,Moyen,1,Plus Facile,Adapte,Computer Science
2785,2017,Informatique,3,Algorithme et Programmation,3,Les Langagues de Programmation,12,538,5,QCU,0.33,0.48,60.81,10,6,16,11,10,1,1.45,90.91,Moyen,Moyen,0,Meme Difficulté,Adapte,Computer Science
3909,2018,Informatique,3,Algorithme et Programmation,3,Les Langagues de Programmation,12,538,5,QCU,0.37,0.6,60.81,10,6,16,11,10,1,1.45,90.91,Moyen,Moyen,0,Meme Difficulté,Adapte,Computer Science
5033,2019,Informatique,3,Algorithme et Programmation,3,Les Langagues de Programmation,12,538,5,QCU,0.22,0.63,60.81,10,7,17,17,10,7,1.0,58.82,Moyen,Moyen,0,Meme Difficulté,Adapte,Computer Science
6157,2020,Informatique,3,Algorithme et Programmation,3,Les Langagues de Programmation,12,538,5,QCU,0.28,0.55,60.81,12,8,20,18,12,6,1.11,66.67,Moyen,Moyen,0,Meme Difficulté,Adapte,Computer Science
538,2015,Informatique,3,Algorithme et Programmation,3,Les Langagues de Programmation,12,539,6,QROC,0.77,0.16,10.43,8,65,73,41,8,33,1.78,19.51,Facile,Difficile,-2,Beaucoup plus Difficile,Pas Adapte,Computer Science
1662,2016,Informatique,3,Algorithme et Programmation,3,Les Langagues de Programmation,12,539,6,QROC,0.76,0.12,28.24,21,54,75,69,21,48,1.09,30.43,Moyen,Difficile,-1,Plus Difficile,Pas Adapte,Computer Science
2786,2017,Informatique,3,Algorithme et Programmation,3,Les Langagues de Programmation,12,539,6,QROC,0.75,0.2,21.2,18,65,83,71,18,53,1.17,25.35,Facile,Difficile,-2,Beaucoup plus Difficile,Pas Adapte,Computer Science
3910,2018,Informatique,3,Algorithme et Programmation,3,Les Langagues de Programmation,12,539,6,QROC,0.89,0.12,14.41,14,80,94,44,14,30,2.14,31.82,Difficile,Difficile,0,Meme Difficulté,Pas Adapte,Computer Science
5034,2019,Informatique,3,Algorithme et Programmation,3,Les Langagues de Programmation,12,539,6,QROC,0.02,0.79,96.73,93,3,96,95,93,2,1.01,97.89,Moyen,Facile,1,Plus Facile,Pas Adapte,Computer Science
6158,2020,Informatique,3,Algorithme et Programmation,3,Les Langagues de Programmation,12,539,6,QROC,0.6,0.11,17.42,15,69,84,38,15,23,2.21,39.47,Moyen,Difficile,-1,Plus Difficile,Pas Adapte,Computer Science
539,2015,Informatique,3,Algorithme et Programmation,3,Les Langagues de Programmation,12,540,7,QCU,0.0,0.97,86.44,46,7,53,48,46,2,1.1,95.83,Facile,Facile,0,Meme Difficulté,Pas Adapte,Computer Science
1663,2016,Informatique,3,Algorithme et Programmation,3,Les Langagues de Programmation,12,540,7,QCU,0.56,0.26,0.92,1,54,55,21,1,20,2.62,4.76,Facile,Difficile,-2,Beaucoup plus Difficile,Pas Adapte,Computer Science
2787,2017,Informatique,3,Algorithme et Programmation,3,Les Langagues de Programmation,12,540,7,QCU,0.11,0.91,83.35,43,8,51,50,43,7,1.02,86.0,Facile,Facile,0,Meme Difficulté,Pas Adapte,Computer Science
3911,2018,Informatique,3,Algorithme et Programmation,3,Les Langagues de Programmation,12,540,7,QCU,0.07,0.77,87.16,44,6,50,46,44,2,1.09,95.65,Facile,Facile,0,Meme Difficulté,Pas Adapte,Computer Science
5035,2019,Informatique,3,Algorithme et Programmation,3,Les Langagues de Programmation,12,540,7,QCU,0.7,0.26,22.01,11,39,50,34,11,23,1.47,32.35,Difficile,Difficile,0,Meme Difficulté,Pas Adapte,Computer Science
6159,2020,Informatique,3,Algorithme et Programmation,3,Les Langagues de Programmation,12,540,7,QCU,0.72,0.33,15.28,8,42,50,45,8,37,1.11,17.78,Difficile,Difficile,0,Meme Difficulté,Pas Adapte,Computer Science
540,2015,Informatique,3,Algorithme et Programmation,3,Les Langagues de Programmation,12,541,8,QCM,0.12,0.84,75.36,14,5,19,18,14,4,1.06,77.78,Difficile,Facile,2,Beaucoup plus Facile,Pas Adapte,Computer Science
1664,2016,Informatique,3,Algorithme et Programmation,3,Les Langagues de Programmation,12,541,8,QCM,0.09,0.96,98.69,16,0,16,16,16,0,1.0,100.0,Facile,Facile,0,Meme Difficulté,Pas Adapte,Computer Science
2788,2017,Informatique,3,Algorithme et Programmation,3,Les Langagues de Programmation,12,541,8,QCM,0.46,0.65,59.38,8,6,14,10,8,2,1.4,80.0,Moyen,Moyen,0,Meme Difficulté,Pas Adapte,Computer Science
3912,2018,Informatique,3,Algorithme et Programmation,3,Les Langagues de Programmation,12,541,8,QCM,0.75,0.16,19.87,3,13,16,4,3,1,4.0,75.0,Moyen,Difficile,-1,Plus Difficile,Pas Adapte,Computer Science
5036,2019,Informatique,3,Algorithme et Programmation,3,Les Langagues de Programmation,12,541,8,QCU,0.15,0.8,81.35,15,3,18,15,15,0,1.2,100.0,Facile,Facile,0,Meme Difficulté,Pas Adapte,Computer Science
6160,2020,Informatique,3,Algorithme et Programmation,3,Les Langagues de Programmation,12,541,8,QCU,0.69,0.35,33.95,7,14,21,17,7,10,1.24,41.18,Moyen,Difficile,-1,Plus Difficile,Pas Adapte,Computer Science
541,2015,Informatique,3,Algorithme et Programmation,3,Les Langagues de Programmation,12,542,9,QCU,0.01,0.85,99.01,99,1,100,100,99,1,1.0,99.0,Facile,Facile,0,Meme Difficulté,Pas Adapte,Computer Science
1665,2016,Informatique,3,Algorithme et Programmation,3,Les Langagues de Programmation,12,542,9,QCU,0.29,0.63,54.31,60,50,110,67,60,7,1.64,89.55,Moyen,Moyen,0,Meme Difficulté,Pas Adapte,Computer Science
2789,2017,Informatique,3,Algorithme et Programmation,3,Les Langagues de Programmation,12,542,9,QCM,0.68,0.29,17.36,22,103,125,39,22,17,3.21,56.41,Facile,Difficile,-2,Beaucoup plus Difficile,Pas Adapte,Computer Science
3913,2018,Informatique,3,Algorithme et Programmation,3,Les Langagues de Programmation,12,542,9,QCM,0.43,0.51,64.1,72,41,113,94,72,22,1.2,76.6,Difficile,Moyen,1,Plus Facile,Adapte,Computer Science
5037,2019,Informatique,3,Algorithme et Programmation,3,Les Langagues de Programmation,12,542,9,QCM,0.29,0.66,64.1,83,46,129,91,83,8,1.42,91.21,Moyen,Moyen,0,Meme Difficulté,Adapte,Computer Science
6161,2020,Informatique,3,Algorithme et Programmation,3,Les Langagues de Programmation,12,542,9,QCM,0.22,0.63,64.1,95,53,148,109,95,14,1.36,87.16,Moyen,Moyen,0,Meme Difficulté,Adapte,Computer Science
542,2015,Informatique,3,Algorithme et Programmation,3,Les Langagues de Programmation,12,543,10,QROC,0.44,0.33,51.39,35,33,68,51,35,16,1.33,68.63,Difficile,Moyen,1,Plus Facile,Pas Adapte,Computer Science
1666,2016,Informatique,3,Algorithme et Programmation,3,Les Langagues de Programmation,12,543,10,QROC,0.02,0.79,75.26,50,16,66,52,50,2,1.27,96.15,Facile,Facile,0,Meme Difficulté,Pas Adapte,Computer Science
2790,2017,Informatique,3,Algorithme et Programmation,3,Les Langagues de Programmation,12,543,10,QROC,0.01,0.81,80.28,59,15,74,62,59,3,1.19,95.16,Facile,Facile,0,Meme Difficulté,Pas Adapte,Computer Science
3914,2018,Informatique,3,Algorithme et Programmation,3,Les Langagues de Programmation,12,543,10,QROC,0.42,0.31,64.51,45,24,69,50,45,5,1.38,90.0,Facile,Moyen,-1,Plus Difficile,Adapte,Computer Science
5038,2019,Informatique,3,Algorithme et Programmation,3,Les Langagues de Programmation,12,543,10,QROC,0.39,0.3,64.51,39,21,60,60,39,21,1.0,65.0,Moyen,Moyen,0,Meme Difficulté,Adapte,Computer Science
6162,2020,Informatique,3,Algorithme et Programmation,3,Les Langagues de Programmation,12,543,10,QROC,0.23,0.3,64.51,36,20,56,38,36,2,1.47,94.74,Moyen,Moyen,0,Meme Difficulté,Adapte,Computer Science
543,2015,Informatique,3,Algorithme et Programmation,3,Les Langagues de Programmation,12,544,11,QCM,0.16,0.82,88.83,68,8,76,73,68,5,1.04,93.15,Difficile,Facile,2,Beaucoup plus Facile,Pas Adapte,Computer Science
1667,2016,Informatique,3,Algorithme et Programmation,3,Les Langagues de Programmation,12,544,11,QCM,0.06,0.77,78.43,52,14,66,60,52,8,1.1,86.67,Facile,Facile,0,Meme Difficulté,Pas Adapte,Computer Science
2791,2017,Informatique,3,Algorithme et Programmation,3,Les Langagues de Programmation,12,544,11,QCM,0.07,0.76,86.2,65,10,75,73,65,8,1.03,89.04,Moyen,Facile,1,Plus Facile,Pas Adapte,Computer Science
3915,2018,Informatique,3,Algorithme et Programmation,3,Les Langagues de Programmation,12,544,11,QCM,0.14,0.76,66.6,45,23,68,64,45,19,1.06,70.31,Difficile,Facile,2,Beaucoup plus Facile,Adapte,Computer Science
5039,2019,Informatique,3,Algorithme et Programmation,3,Les Langagues de Programmation,12,544,11,QCM,0.13,0.75,66.6,49,25,74,64,49,15,1.16,76.56,Facile,Facile,0,Meme Difficulté,Adapte,Computer Science
6163,2020,Informatique,3,Algorithme et Programmation,3,Les Langagues de Programmation,12,544,11,QCM,0.1,0.7,66.6,43,22,65,48,43,5,1.35,89.58,Facile,Facile,0,Meme Difficulté,Adapte,Computer Science
544,2015,Informatique,3,Algorithme et Programmation,3,Les Langagues de Programmation,12,545,12,QO,0.55,0.2,50.33,7,6,13,13,7,6,1.0,53.85,Difficile,Moyen,1,Plus Facile,Pas Adapte,Computer Science
1668,2016,Informatique,3,Algorithme et Programmation,3,Les Langagues de Programmation,12,545,12,QO,0.92,0.02,6.61,1,11,12,7,1,6,1.71,14.29,Moyen,Difficile,-1,Plus Difficile,Pas Adapte,Computer Science
2792,2017,Informatique,3,Algorithme et Programmation,3,Les Langagues de Programmation,12,545,12,QO,0.89,0.08,30.61,3,8,11,9,3,6,1.22,33.33,Facile,Difficile,-2,Beaucoup plus Difficile,Pas Adapte,Computer Science
3916,2018,Informatique,3,Algorithme et Programmation,3,Les Langagues de Programmation,12,545,12,QO,0.56,0.23,49.35,6,7,13,9,6,3,1.44,66.67,Moyen,Moyen,0,Meme Difficulté,Pas Adapte,Computer Science
5040,2019,Informatique,3,Algorithme et Programmation,3,Les Langagues de Programmation,12,545,12,QO,0.63,0.23,49.53,6,6,12,9,6,3,1.33,66.67,Moyen,Moyen,0,Meme Difficulté,Pas Adapte,Computer Science
6164,2020,Informatique,3,Algorithme et Programmation,3,Les Langagues de Programmation,12,545,12,QO,0.4,0.2,47.28,5,6,11,10,5,5,1.1,50.0,Facile,Moyen,-1,Plus Difficile,Pas Adapte,Computer Science
545,2015,Informatique,4,Reseaux et Internet,1,Notion de Reseau Informatique,8,546,1,QCU,0.12,0.95,67.21,33,16,49,40,33,7,1.23,82.5,Moyen,Facile,1,Plus Facile,Adapte,Computer Science
1669,2016,Informatique,4,Reseaux et Internet,1,Notion de Reseau Informatique,8,546,1,QCU,0.08,0.76,67.21,32,16,48,46,32,14,1.04,69.57,Facile,Facile,0,Meme Difficulté,Adapte,Computer Science
2793,2017,Informatique,4,Reseaux et Internet,1,Notion de Reseau Informatique,8,546,1,QCU,0.19,0.91,67.21,36,17,53,49,36,13,1.08,73.47,Facile,Facile,0,Meme Difficulté,Adapte,Computer Science
3917,2018,Informatique,4,Reseaux et Internet,1,Notion de Reseau Informatique,8,546,1,QCU,0.06,0.76,67.21,36,17,53,36,36,0,1.47,100.0,Facile,Facile,0,Meme Difficulté,Adapte,Computer Science
5041,2019,Informatique,4,Reseaux et Internet,1,Notion de Reseau Informatique,8,546,1,QCU,0.09,0.9,67.21,31,15,46,34,31,3,1.35,91.18,Facile,Facile,0,Meme Difficulté,Adapte,Computer Science
6165,2020,Informatique,4,Reseaux et Internet,1,Notion de Reseau Informatique,8,546,1,QCU,0.04,0.89,67.21,29,14,43,32,29,3,1.34,90.62,Facile,Facile,0,Meme Difficulté,Adapte,Computer Science
546,2015,Informatique,4,Reseaux et Internet,1,Notion de Reseau Informatique,8,547,2,QCM,0.12,0.77,82.83,12,3,15,12,12,0,1.25,100.0,Moyen,Facile,1,Plus Facile,Pas Adapte,Computer Science
1670,2016,Informatique,4,Reseaux et Internet,1,Notion de Reseau Informatique,8,547,2,QCM,0.13,0.83,89.35,13,1,14,13,13,0,1.08,100.0,Facile,Facile,0,Meme Difficulté,Pas Adapte,Computer Science
2794,2017,Informatique,4,Reseaux et Internet,1,Notion de Reseau Informatique,8,547,2,QCM,0.57,0.27,29.37,4,9,13,12,4,8,1.08,33.33,Moyen,Difficile,-1,Plus Difficile,Pas Adapte,Computer Science
3918,2018,Informatique,4,Reseaux et Internet,1,Notion de Reseau Informatique,8,547,2,QCM,0.2,0.99,76.46,8,3,11,10,8,2,1.1,80.0,Facile,Facile,0,Meme Difficulté,Pas Adapte,Computer Science
5042,2019,Informatique,4,Reseaux et Internet,1,Notion de Reseau Informatique,8,547,2,QCM,0.42,0.65,50.81,5,5,10,7,5,2,1.43,71.43,Difficile,Moyen,1,Plus Facile,Pas Adapte,Computer Science
6166,2020,Informatique,4,Reseaux et Internet,1,Notion de Reseau Informatique,8,547,2,QCM,0.59,0.27,26.73,2,7,9,6,2,4,1.5,33.33,Facile,Difficile,-2,Beaucoup plus Difficile,Pas Adapte,Computer Science
547,2015,Informatique,4,Reseaux et Internet,1,Notion de Reseau Informatique,8,548,3,QCU,0.6,0.39,1.71,1,69,70,42,1,41,1.67,2.38,Difficile,Difficile,0,Meme Difficulté,Pas Adapte,Computer Science
1671,2016,Informatique,4,Reseaux et Internet,1,Notion de Reseau Informatique,8,548,3,QCU,0.21,0.71,64.87,49,27,76,64,49,15,1.19,76.56,Moyen,Moyen,0,Meme Difficulté,Adapte,Computer Science
2795,2017,Informatique,4,Reseaux et Internet,1,Notion de Reseau Informatique,8,548,3,QCU,0.29,0.52,64.87,49,27,76,71,49,22,1.07,69.01,Moyen,Moyen,0,Meme Difficulté,Adapte,Computer Science
3919,2018,Informatique,4,Reseaux et Internet,1,Notion de Reseau Informatique,8,548,3,QCU,0.27,0.45,64.87,52,28,80,63,52,11,1.27,82.54,Moyen,Moyen,0,Meme Difficulté,Adapte,Computer Science
5043,2019,Informatique,4,Reseaux et Internet,1,Notion de Reseau Informatique,8,548,3,QCU,0.31,0.67,64.87,56,31,87,58,56,2,1.5,96.55,Moyen,Moyen,0,Meme Difficulté,Adapte,Computer Science
6167,2020,Informatique,4,Reseaux et Internet,1,Notion de Reseau Informatique,8,548,3,QCU,0.34,0.58,64.87,52,28,80,61,52,9,1.31,85.25,Moyen,Moyen,0,Meme Difficulté,Adapte,Computer Science
548,2015,Informatique,4,Reseaux et Internet,1,Notion de Reseau Informatique,8,549,4,QCU,0.27,0.49,39.89,30,46,76,40,30,10,1.9,75.0,Moyen,Moyen,0,Meme Difficulté,Pas Adapte,Computer Science
1672,2016,Informatique,4,Reseaux et Internet,1,Notion de Reseau Informatique,8,549,4,QCU,0.13,0.94,96.95,68,2,70,69,68,1,1.01,98.55,Difficile,Facile,2,Beaucoup plus Facile,Pas Adapte,Computer Science
2796,2017,Informatique,4,Reseaux et Internet,1,Notion de Reseau Informatique,8,549,4,QCU,0.15,0.99,66.76,51,25,76,58,51,7,1.31,87.93,Difficile,Facile,2,Beaucoup plus Facile,Adapte,Computer Science
3920,2018,Informatique,4,Reseaux et Internet,1,Notion de Reseau Informatique,8,549,4,QCU,0.07,0.8,66.76,56,28,84,63,56,7,1.33,88.89,Facile,Facile,0,Meme Difficulté,Adapte,Computer Science
5044,2019,Informatique,4,Reseaux et Internet,1,Notion de Reseau Informatique,8,549,4,QCU,0.06,0.88,66.76,62,31,93,63,62,1,1.48,98.41,Facile,Facile,0,Meme Difficulté,Adapte,Computer Science
6168,2020,Informatique,4,Reseaux et Internet,1,Notion de Reseau Informatique,8,549,4,QCU,0.03,0.99,66.76,59,30,89,80,59,21,1.11,73.75,Facile,Facile,0,Meme Difficulté,Adapte,Computer Science
549,2015,Informatique,4,Reseaux et Internet,1,Notion de Reseau Informatique,8,550,5,QCM,0.16,0.78,82.11,59,13,72,65,59,6,1.11,90.77,Facile,Facile,0,Meme Difficulté,Pas Adapte,Computer Science
1673,2016,Informatique,4,Reseaux et Internet,1,Notion de Reseau Informatique,8,550,5,QCM,0.06,0.99,80.3,63,16,79,77,63,14,1.03,81.82,Facile,Facile,0,Meme Difficulté,Pas Adapte,Computer Science
2797,2017,Informatique,4,Reseaux et Internet,1,Notion de Reseau Informatique,8,550,5,QCM,0.79,0.2,1.16,1,67,68,23,1,22,2.96,4.35,Moyen,Difficile,-1,Plus Difficile,Pas Adapte,Computer Science
3921,2018,Informatique,4,Reseaux et Internet,1,Notion de Reseau Informatique,8,550,5,QCM,0.19,0.92,82.75,59,12,71,70,59,11,1.01,84.29,Difficile,Facile,2,Beaucoup plus Facile,Pas Adapte,Computer Science
5045,2019,Informatique,4,Reseaux et Internet,1,Notion de Reseau Informatique,8,550,5,QCM,0.78,0.18,15.79,10,51,61,35,10,25,1.74,28.57,Facile,Difficile,-2,Beaucoup plus Difficile,Pas Adapte,Computer Science
6169,2020,Informatique,4,Reseaux et Internet,1,Notion de Reseau Informatique,8,550,5,QCM,0.17,0.86,76.63,49,15,64,58,49,9,1.1,84.48,Facile,Facile,0,Meme Difficulté,Pas Adapte,Computer Science
550,2015,Informatique,4,Reseaux et Internet,1,Notion de Reseau Informatique,8,551,6,QCM,0.07,0.77,65.25,8,4,12,10,8,2,1.2,80.0,Moyen,Facile,1,Plus Facile,Adapte,Computer Science
1674,2016,Informatique,4,Reseaux et Internet,1,Notion de Reseau Informatique,8,551,6,QCU,0.19,0.96,65.25,8,4,12,10,8,2,1.2,80.0,Facile,Facile,0,Meme Difficulté,Adapte,Computer Science
2798,2017,Informatique,4,Reseaux et Internet,1,Notion de Reseau Informatique,8,551,6,QCU,0.0,0.78,65.25,8,4,12,11,8,3,1.09,72.73,Facile,Facile,0,Meme Difficulté,Adapte,Computer Science
3922,2018,Informatique,4,Reseaux et Internet,1,Notion de Reseau Informatique,8,551,6,QCU,0.0,0.87,65.25,7,3,10,9,7,2,1.11,77.78,Facile,Facile,0,Meme Difficulté,Adapte,Computer Science
5046,2019,Informatique,4,Reseaux et Internet,1,Notion de Reseau Informatique,8,551,6,QCU,0.18,0.97,65.25,7,3,10,9,7,2,1.11,77.78,Facile,Facile,0,Meme Difficulté,Adapte,Computer Science
6170,2020,Informatique,4,Reseaux et Internet,1,Notion de Reseau Informatique,8,551,6,QCU,0.09,0.75,65.25,5,3,8,7,5,2,1.14,71.43,Facile,Facile,0,Meme Difficulté,Adapte,Computer Science
551,2015,Informatique,4,Reseaux et Internet,1,Notion de Reseau Informatique,8,552,7,QROC,0.18,0.82,71.62,69,27,96,81,69,12,1.19,85.19,Facile,Facile,0,Meme Difficulté,Adapte,Computer Science
1675,2016,Informatique,4,Reseaux et Internet,1,Notion de Reseau Informatique,8,552,7,QROC,0.08,0.5,71.62,64,25,89,75,64,11,1.19,85.33,Facile,Facile,0,Meme Difficulté,Adapte,Computer Science
2799,2017,Informatique,4,Reseaux et Internet,1,Notion de Reseau Informatique,8,552,7,QROC,0.17,0.97,71.62,67,26,93,87,67,20,1.07,77.01,Facile,Facile,0,Meme Difficulté,Adapte,Computer Science
3923,2018,Informatique,4,Reseaux et Internet,1,Notion de Reseau Informatique,8,552,7,QROC,0.17,0.45,71.62,59,23,82,68,59,9,1.21,86.76,Facile,Facile,0,Meme Difficulté,Adapte,Computer Science
5047,2019,Informatique,4,Reseaux et Internet,1,Notion de Reseau Informatique,8,552,7,QROC,0.04,0.8,71.62,52,20,72,70,52,18,1.03,74.29,Facile,Facile,0,Meme Difficulté,Adapte,Computer Science
6171,2020,Informatique,4,Reseaux et Internet,1,Notion de Reseau Informatique,8,552,7,QROC,0.07,0.75,71.62,59,23,82,82,59,23,1.0,71.95,Facile,Facile,0,Meme Difficulté,Adapte,Computer Science
552,2015,Informatique,4,Reseaux et Internet,1,Notion de Reseau Informatique,8,553,8,QCM,0.0,0.73,78.73,74,20,94,85,74,11,1.11,87.06,Difficile,Facile,2,Beaucoup plus Facile,Pas Adapte,Computer Science
1676,2016,Informatique,4,Reseaux et Internet,1,Notion de Reseau Informatique,8,553,8,QCU,0.15,0.76,99.99,103,0,103,103,103,0,1.0,100.0,Difficile,Facile,2,Beaucoup plus Facile,Pas Adapte,Computer Science
2800,2017,Informatique,4,Reseaux et Internet,1,Notion de Reseau Informatique,8,553,8,QCU,0.64,0.36,27.99,25,65,90,50,25,25,1.8,50.0,Facile,Difficile,-2,Beaucoup plus Difficile,Pas Adapte,Computer Science
3924,2018,Informatique,4,Reseaux et Internet,1,Notion de Reseau Informatique,8,553,8,QCU,0.17,0.79,75.05,59,20,79,69,59,10,1.14,85.51,Facile,Facile,0,Meme Difficulté,Pas Adapte,Computer Science
5048,2019,Informatique,4,Reseaux et Internet,1,Notion de Reseau Informatique,8,553,8,QCU,0.2,0.84,94.63,72,4,76,74,72,2,1.03,97.3,Moyen,Facile,1,Plus Facile,Pas Adapte,Computer Science
6172,2020,Informatique,4,Reseaux et Internet,1,Notion de Reseau Informatique,8,553,8,QCU,0.16,0.79,89.74,74,8,82,76,74,2,1.08,97.37,Facile,Facile,0,Meme Difficulté,Pas Adapte,Computer Science
553,2015,Mathématiques,1,L'Algèbre Linéaire,1,Sommes de Sous Espaces,11,554,1,QCU,0.4,0.54,38.0,20,32,52,24,20,4,2.17,83.33,Facile,Moyen,-1,Plus Difficile,Pas Adapte,Mathematics
1677,2016,Mathématiques,1,L'Algèbre Linéaire,1,Sommes de Sous Espaces,11,554,1,QCU,0.37,0.7,46.0,23,27,50,48,23,25,1.04,47.92,Difficile,Moyen,1,Plus Facile,Pas Adapte,Mathematics
2801,2017,Mathématiques,1,L'Algèbre Linéaire,1,Sommes de Sous Espaces,11,554,1,QCU,0.47,0.36,17.0,7,36,43,26,7,19,1.65,26.92,Difficile,Difficile,0,Meme Difficulté,Pas Adapte,Mathematics
3925,2018,Mathématiques,1,L'Algèbre Linéaire,1,Sommes de Sous Espaces,11,554,1,QCU,0.67,0.22,23.0,10,33,43,38,10,28,1.13,26.32,Facile,Difficile,-2,Beaucoup plus Difficile,Pas Adapte,Mathematics
5049,2019,Mathématiques,1,L'Algèbre Linéaire,1,Sommes de Sous Espaces,11,554,1,QCU,0.42,0.34,10.0,5,44,49,29,5,24,1.69,17.24,Difficile,Difficile,0,Meme Difficulté,Pas Adapte,Mathematics
6173,2020,Mathématiques,1,L'Algèbre Linéaire,1,Sommes de Sous Espaces,11,554,1,QCU,0.61,0.21,4.0,2,46,48,27,2,25,1.78,7.41,Moyen,Difficile,-1,Plus Difficile,Pas Adapte,Mathematics
554,2015,Mathématiques,1,L'Algèbre Linéaire,1,Sommes de Sous Espaces,11,555,2,QCM,0.71,0.2,15.0,10,56,66,57,10,47,1.16,17.54,Difficile,Difficile,0,Meme Difficulté,Pas Adapte,Mathematics
1678,2016,Mathématiques,1,L'Algèbre Linéaire,1,Sommes de Sous Espaces,11,555,2,QCM,0.66,0.2,17.0,10,50,60,34,10,24,1.76,29.41,Difficile,Difficile,0,Meme Difficulté,Pas Adapte,Mathematics
2802,2017,Mathématiques,1,L'Algèbre Linéaire,1,Sommes de Sous Espaces,11,555,2,QCM,0.74,0.18,33.0,20,40,60,31,20,11,1.94,64.52,Difficile,Difficile,0,Meme Difficulté,Pas Adapte,Mathematics
3926,2018,Mathématiques,1,L'Algèbre Linéaire,1,Sommes de Sous Espaces,11,555,2,QCM,0.26,0.63,55.0,30,24,54,46,30,16,1.17,65.22,Difficile,Moyen,1,Plus Facile,Pas Adapte,Mathematics
5050,2019,Mathématiques,1,L'Algèbre Linéaire,1,Sommes de Sous Espaces,11,555,2,QCM,0.33,0.37,37.0,20,33,53,50,20,30,1.06,40.0,Facile,Moyen,-1,Plus Difficile,Pas Adapte,Mathematics
6174,2020,Mathématiques,1,L'Algèbre Linéaire,1,Sommes de Sous Espaces,11,555,2,QCM,0.74,0.2,34.0,19,38,57,34,19,15,1.68,55.88,Difficile,Difficile,0,Meme Difficulté,Pas Adapte,Mathematics
555,2015,Mathématiques,1,L'Algèbre Linéaire,1,Sommes de Sous Espaces,11,556,3,QCM,0.37,0.52,43.0,10,14,24,15,10,5,1.6,66.67,Facile,Moyen,-1,Plus Difficile,Pas Adapte,Mathematics
1679,2016,Mathématiques,1,L'Algèbre Linéaire,1,Sommes de Sous Espaces,11,556,3,QCM,0.79,0.22,4.0,1,23,24,8,1,7,3.0,12.5,Facile,Difficile,-2,Beaucoup plus Difficile,Pas Adapte,Mathematics
2803,2017,Mathématiques,1,L'Algèbre Linéaire,1,Sommes de Sous Espaces,11,556,3,QCM,0.63,0.21,4.0,1,22,23,18,1,17,1.28,5.56,Difficile,Difficile,0,Meme Difficulté,Pas Adapte,Mathematics
3927,2018,Mathématiques,1,L'Algèbre Linéaire,1,Sommes de Sous Espaces,11,556,3,QCM,0.61,0.3,19.0,5,20,25,9,5,4,2.78,55.56,Facile,Difficile,-2,Beaucoup plus Difficile,Pas Adapte,Mathematics
5051,2019,Mathématiques,1,L'Algèbre Linéaire,1,Sommes de Sous Espaces,11,556,3,QCM,0.58,0.17,14.0,3,19,22,13,3,10,1.69,23.08,Facile,Difficile,-2,Beaucoup plus Difficile,Pas Adapte,Mathematics
6175,2020,Mathématiques,1,L'Algèbre Linéaire,1,Sommes de Sous Espaces,11,556,3,QCM,0.57,0.25,25.0,5,15,20,12,5,7,1.67,41.67,Facile,Difficile,-2,Beaucoup plus Difficile,Pas Adapte,Mathematics
556,2015,Mathématiques,1,L'Algèbre Linéaire,1,Sommes de Sous Espaces,11,557,4,QCU,0.25,0.64,61.0,13,8,21,19,13,6,1.11,68.42,Facile,Moyen,-1,Plus Difficile,Adapte,Mathematics
1680,2016,Mathématiques,1,L'Algèbre Linéaire,1,Sommes de Sous Espaces,11,557,4,QCU,0.28,0.49,61.0,14,9,23,20,14,6,1.15,70.0,Moyen,Moyen,0,Meme Difficulté,Adapte,Mathematics
2804,2017,Mathématiques,1,L'Algèbre Linéaire,1,Sommes de Sous Espaces,11,557,4,QCU,0.3,0.61,61.0,13,9,22,21,13,8,1.05,61.9,Moyen,Moyen,0,Meme Difficulté,Adapte,Mathematics
3928,2018,Mathématiques,1,L'Algèbre Linéaire,1,Sommes de Sous Espaces,11,557,4,QCM,0.23,0.32,61.0,14,9,23,18,14,4,1.28,77.78,Moyen,Moyen,0,Meme Difficulté,Adapte,Mathematics
5052,2019,Mathématiques,1,L'Algèbre Linéaire,1,Sommes de Sous Espaces,11,557,4,QCM,0.43,0.3,61.0,15,10,25,16,15,1,1.56,93.75,Moyen,Moyen,0,Meme Difficulté,Adapte,Mathematics
6176,2020,Mathématiques,1,L'Algèbre Linéaire,1,Sommes de Sous Espaces,11,557,4,QCU,0.31,0.5,61.0,16,10,26,17,16,1,1.53,94.12,Moyen,Moyen,0,Meme Difficulté,Adapte,Mathematics
557,2015,Mathématiques,1,L'Algèbre Linéaire,1,Sommes de Sous Espaces,11,558,5,QCU,0.22,0.72,57.0,54,40,94,67,54,13,1.4,80.6,Facile,Moyen,-1,Plus Difficile,Pas Adapte,Mathematics
1681,2016,Mathématiques,1,L'Algèbre Linéaire,1,Sommes de Sous Espaces,11,558,5,QCU,0.7,0.35,0.0,0,86,86,57,0,57,1.51,0.0,Difficile,Difficile,0,Meme Difficulté,Pas Adapte,Mathematics
2805,2017,Mathématiques,1,L'Algèbre Linéaire,1,Sommes de Sous Espaces,11,558,5,QCU,0.53,0.2,29.0,28,70,98,40,28,12,2.45,70.0,Moyen,Difficile,-1,Plus Difficile,Pas Adapte,Mathematics
3929,2018,Mathématiques,1,L'Algèbre Linéaire,1,Sommes de Sous Espaces,11,558,5,QCU,0.35,0.54,53.0,48,43,91,75,48,27,1.21,64.0,Facile,Moyen,-1,Plus Difficile,Pas Adapte,Mathematics
5053,2019,Mathématiques,1,L'Algèbre Linéaire,1,Sommes de Sous Espaces,11,558,5,QCM,0.36,0.35,60.0,47,32,79,53,47,6,1.49,88.68,Difficile,Moyen,1,Plus Facile,Adapte,Mathematics
6177,2020,Mathématiques,1,L'Algèbre Linéaire,1,Sommes de Sous Espaces,11,558,5,QCM,0.24,0.36,60.0,41,27,68,67,41,26,1.01,61.19,Moyen,Moyen,0,Meme Difficulté,Adapte,Mathematics
558,2015,Mathématiques,1,L'Algèbre Linéaire,1,Sommes de Sous Espaces,11,559,6,QCM,0.6,0.19,17.0,13,62,75,28,13,15,2.68,46.43,Difficile,Difficile,0,Meme Difficulté,Pas Adapte,Mathematics
1682,2016,Mathématiques,1,L'Algèbre Linéaire,1,Sommes de Sous Espaces,11,559,6,QCM,0.3,0.39,56.0,37,29,66,46,37,9,1.43,80.43,Facile,Moyen,-1,Plus Difficile,Pas Adapte,Mathematics
2806,2017,Mathématiques,1,L'Algèbre Linéaire,1,Sommes de Sous Espaces,11,559,6,QCM,0.46,0.47,46.0,28,32,60,30,28,2,2.0,93.33,Difficile,Moyen,1,Plus Facile,Pas Adapte,Mathematics
3930,2018,Mathématiques,1,L'Algèbre Linéaire,1,Sommes de Sous Espaces,11,559,6,QCM,0.34,0.61,39.0,24,37,61,34,24,10,1.79,70.59,Facile,Moyen,-1,Plus Difficile,Pas Adapte,Mathematics
5054,2019,Mathématiques,1,L'Algèbre Linéaire,1,Sommes de Sous Espaces,11,559,6,QCM,0.41,0.42,44.0,26,33,59,39,26,13,1.51,66.67,Facile,Moyen,-1,Plus Difficile,Pas Adapte,Mathematics
6178,2020,Mathématiques,1,L'Algèbre Linéaire,1,Sommes de Sous Espaces,11,559,6,QCM,0.68,0.19,35.0,23,44,67,37,23,14,1.81,62.16,Facile,Difficile,-2,Beaucoup plus Difficile,Pas Adapte,Mathematics
559,2015,Mathématiques,1,L'Algèbre Linéaire,1,Sommes de Sous Espaces,11,560,7,QROC,0.65,0.0,23.0,18,60,78,45,18,27,1.73,40.0,Difficile,Difficile,0,Meme Difficulté,Pas Adapte,Mathematics
1683,2016,Mathématiques,1,L'Algèbre Linéaire,1,Sommes de Sous Espaces,11,560,7,QROC,0.59,0.35,43.0,31,40,71,45,31,14,1.58,68.89,Difficile,Moyen,1,Plus Facile,Pas Adapte,Mathematics
2807,2017,Mathématiques,1,L'Algèbre Linéaire,1,Sommes de Sous Espaces,11,560,7,QROC,0.74,0.01,4.0,3,62,65,42,3,39,1.55,7.14,Facile,Difficile,-2,Beaucoup plus Difficile,Pas Adapte,Mathematics
3931,2018,Mathématiques,1,L'Algèbre Linéaire,1,Sommes de Sous Espaces,11,560,7,QROC,0.23,0.39,51.0,30,29,59,53,30,23,1.11,56.6,Difficile,Moyen,1,Plus Facile,Pas Adapte,Mathematics
5055,2019,Mathématiques,1,L'Algèbre Linéaire,1,Sommes de Sous Espaces,11,560,7,QROC,0.32,0.29,62.0,42,25,67,44,42,2,1.52,95.45,Difficile,Moyen,1,Plus Facile,Adapte,Mathematics
6179,2020,Mathématiques,1,L'Algèbre Linéaire,1,Sommes de Sous Espaces,11,560,7,QO,0.39,0.17,62.0,38,24,62,47,38,9,1.32,80.85,Moyen,Moyen,0,Meme Difficulté,Adapte,Mathematics
560,2015,Mathématiques,1,L'Algèbre Linéaire,1,Sommes de Sous Espaces,11,561,8,QCM,0.31,0.39,58.0,48,35,83,57,48,9,1.46,84.21,Difficile,Moyen,1,Plus Facile,Pas Adapte,Mathematics
1684,2016,Mathématiques,1,L'Algèbre Linéaire,1,Sommes de Sous Espaces,11,561,8,QCM,0.77,0.16,17.0,13,61,74,40,13,27,1.85,32.5,Moyen,Difficile,-1,Plus Difficile,Pas Adapte,Mathematics
2808,2017,Mathématiques,1,L'Algèbre Linéaire,1,Sommes de Sous Espaces,11,561,8,QCM,0.37,0.31,42.0,31,43,74,34,31,3,2.18,91.18,Difficile,Moyen,1,Plus Facile,Pas Adapte,Mathematics
3932,2018,Mathématiques,1,L'Algèbre Linéaire,1,Sommes de Sous Espaces,11,561,8,QCM,0.74,0.24,19.0,14,61,75,39,14,25,1.92,35.9,Moyen,Difficile,-1,Plus Difficile,Pas Adapte,Mathematics
5056,2019,Mathématiques,1,L'Algèbre Linéaire,1,Sommes de Sous Espaces,11,561,8,QCU,0.23,0.45,58.0,41,30,71,71,41,30,1.0,57.75,Facile,Moyen,-1,Plus Difficile,Pas Adapte,Mathematics
6180,2020,Mathématiques,1,L'Algèbre Linéaire,1,Sommes de Sous Espaces,11,561,8,QCU,0.59,0.38,6.0,5,75,80,66,5,61,1.21,7.58,Facile,Difficile,-2,Beaucoup plus Difficile,Pas Adapte,Mathematics
561,2015,Mathématiques,1,L'Algèbre Linéaire,1,Sommes de Sous Espaces,11,562,9,QCM,0.24,0.43,40.0,40,59,99,69,40,29,1.43,57.97,Facile,Moyen,-1,Plus Difficile,Pas Adapte,Mathematics
1685,2016,Mathématiques,1,L'Algèbre Linéaire,1,Sommes de Sous Espaces,11,562,9,QCM,0.79,0.22,14.0,13,81,94,46,13,33,2.04,28.26,Difficile,Difficile,0,Meme Difficulté,Pas Adapte,Mathematics
2809,2017,Mathématiques,1,L'Algèbre Linéaire,1,Sommes de Sous Espaces,11,562,9,QCM,0.21,0.42,56.0,60,48,108,102,60,42,1.06,58.82,Facile,Moyen,-1,Plus Difficile,Pas Adapte,Mathematics
3933,2018,Mathématiques,1,L'Algèbre Linéaire,1,Sommes de Sous Espaces,11,562,9,QCM,0.47,0.59,62.0,60,37,97,91,60,31,1.07,65.93,Moyen,Moyen,0,Meme Difficulté,Adapte,Mathematics
5057,2019,Mathématiques,1,L'Algèbre Linéaire,1,Sommes de Sous Espaces,11,562,9,QCM,0.22,0.57,62.0,53,32,85,73,53,20,1.16,72.6,Moyen,Moyen,0,Meme Difficulté,Adapte,Mathematics
6181,2020,Mathématiques,1,L'Algèbre Linéaire,1,Sommes de Sous Espaces,11,562,9,QCM,0.5,0.46,62.0,54,33,87,83,54,29,1.05,65.06,Moyen,Moyen,0,Meme Difficulté,Adapte,Mathematics
562,2015,Mathématiques,1,L'Algèbre Linéaire,1,Sommes de Sous Espaces,11,563,10,QCM,0.61,0.15,18.0,14,64,78,68,14,54,1.15,20.59,Facile,Difficile,-2,Beaucoup plus Difficile,Pas Adapte,Mathematics
1686,2016,Mathématiques,1,L'Algèbre Linéaire,1,Sommes de Sous Espaces,11,563,10,QCU,0.64,0.33,3.0,2,70,72,39,2,37,1.85,5.13,Facile,Difficile,-2,Beaucoup plus Difficile,Pas Adapte,Mathematics
2810,2017,Mathématiques,1,L'Algèbre Linéaire,1,Sommes de Sous Espaces,11,563,10,QCU,0.44,0.25,9.0,7,70,77,59,7,52,1.31,11.86,Difficile,Difficile,0,Meme Difficulté,Pas Adapte,Mathematics
3934,2018,Mathématiques,1,L'Algèbre Linéaire,1,Sommes de Sous Espaces,11,563,10,QCU,0.24,0.47,51.0,41,40,81,48,41,7,1.69,85.42,Difficile,Moyen,1,Plus Facile,Pas Adapte,Mathematics
5058,2019,Mathématiques,1,L'Algèbre Linéaire,1,Sommes de Sous Espaces,11,563,10,QCU,0.29,0.74,38.0,28,45,73,61,28,33,1.2,45.9,Moyen,Moyen,0,Meme Difficulté,Pas Adapte,Mathematics
6182,2020,Mathématiques,1,L'Algèbre Linéaire,1,Sommes de Sous Espaces,11,563,10,QCU,0.66,0.34,9.0,7,66,73,56,7,49,1.3,12.5,Difficile,Difficile,0,Meme Difficulté,Pas Adapte,Mathematics
563,2015,Mathématiques,1,L'Algèbre Linéaire,1,Sommes de Sous Espaces,11,564,11,QROC,0.91,0.22,5.0,3,53,56,29,3,26,1.93,10.34,Difficile,Difficile,0,Meme Difficulté,Pas Adapte,Mathematics
1687,2016,Mathématiques,1,L'Algèbre Linéaire,1,Sommes de Sous Espaces,11,564,11,QROC,0.9,0.03,7.0,4,58,62,34,4,30,1.82,11.76,Facile,Difficile,-2,Beaucoup plus Difficile,Pas Adapte,Mathematics
2811,2017,Mathématiques,1,L'Algèbre Linéaire,1,Sommes de Sous Espaces,11,564,11,QROC,0.51,0.33,52.0,30,27,57,52,30,22,1.1,57.69,Facile,Moyen,-1,Plus Difficile,Pas Adapte,Mathematics
3935,2018,Mathématiques,1,L'Algèbre Linéaire,1,Sommes de Sous Espaces,11,564,11,QROC,0.21,0.38,51.0,32,31,63,48,32,16,1.31,66.67,Difficile,Moyen,1,Plus Facile,Pas Adapte,Mathematics
5059,2019,Mathématiques,1,L'Algèbre Linéaire,1,Sommes de Sous Espaces,11,564,11,QROC,0.61,0.22,33.0,22,45,67,41,22,19,1.63,53.66,Moyen,Difficile,-1,Plus Difficile,Pas Adapte,Mathematics
6183,2020,Mathématiques,1,L'Algèbre Linéaire,1,Sommes de Sous Espaces,11,564,11,QO,0.87,0.13,23.0,15,52,67,57,15,42,1.18,26.32,Difficile,Difficile,0,Meme Difficulté,Pas Adapte,Mathematics
564,2015,Mathématiques,1,L'Algèbre Linéaire,2,Sous Espaces Supplementaires,10,565,1,QCM,0.64,0.28,6.0,2,36,38,11,2,9,3.45,18.18,Facile,Difficile,-2,Beaucoup plus Difficile,Pas Adapte,Mathematics
1688,2016,Mathématiques,1,L'Algèbre Linéaire,2,Sous Espaces Supplementaires,10,565,1,QCM,0.43,0.52,55.0,24,20,44,39,24,15,1.13,61.54,Moyen,Moyen,0,Meme Difficulté,Pas Adapte,Mathematics
2812,2017,Mathématiques,1,L'Algèbre Linéaire,2,Sous Espaces Supplementaires,10,565,1,QCU,0.6,0.29,21.0,10,37,47,26,10,16,1.81,38.46,Facile,Difficile,-2,Beaucoup plus Difficile,Pas Adapte,Mathematics
3936,2018,Mathématiques,1,L'Algèbre Linéaire,2,Sous Espaces Supplementaires,10,565,1,QCU,0.3,0.71,60.0,25,16,41,39,25,14,1.05,64.1,Difficile,Moyen,1,Plus Facile,Adapte,Mathematics
5060,2019,Mathématiques,1,L'Algèbre Linéaire,2,Sous Espaces Supplementaires,10,565,1,QCU,0.3,0.61,60.0,26,18,44,40,26,14,1.1,65.0,Moyen,Moyen,0,Meme Difficulté,Adapte,Mathematics
6184,2020,Mathématiques,1,L'Algèbre Linéaire,2,Sous Espaces Supplementaires,10,565,1,QCU,0.39,0.47,60.0,29,20,49,39,29,10,1.26,74.36,Moyen,Moyen,0,Meme Difficulté,Adapte,Mathematics
565,2015,Mathématiques,1,L'Algèbre Linéaire,2,Sous Espaces Supplementaires,10,566,2,QCU,0.27,0.59,51.0,24,24,48,34,24,10,1.41,70.59,Facile,Moyen,-1,Plus Difficile,Pas Adapte,Mathematics
1689,2016,Mathématiques,1,L'Algèbre Linéaire,2,Sous Espaces Supplementaires,10,566,2,QCM,0.47,0.4,53.0,28,24,52,31,28,3,1.68,90.32,Moyen,Moyen,0,Meme Difficulté,Pas Adapte,Mathematics
2813,2017,Mathématiques,1,L'Algèbre Linéaire,2,Sous Espaces Supplementaires,10,566,2,QCM,0.33,0.58,48.0,22,24,46,26,22,4,1.77,84.62,Facile,Moyen,-1,Plus Difficile,Pas Adapte,Mathematics
3937,2018,Mathématiques,1,L'Algèbre Linéaire,2,Sous Espaces Supplementaires,10,566,2,QCM,0.6,0.29,7.0,3,46,49,35,3,32,1.4,8.57,Difficile,Difficile,0,Meme Difficulté,Pas Adapte,Mathematics
5061,2019,Mathématiques,1,L'Algèbre Linéaire,2,Sous Espaces Supplementaires,10,566,2,QCU,0.4,0.53,63.0,28,16,44,31,28,3,1.42,90.32,Facile,Moyen,-1,Plus Difficile,Adapte,Mathematics
6185,2020,Mathématiques,1,L'Algèbre Linéaire,2,Sous Espaces Supplementaires,10,566,2,QCU,0.33,0.49,63.0,27,16,43,40,27,13,1.07,67.5,Moyen,Moyen,0,Meme Difficulté,Adapte,Mathematics
566,2015,Mathématiques,1,L'Algèbre Linéaire,2,Sous Espaces Supplementaires,10,567,3,QCM,0.34,0.56,44.0,39,50,89,66,39,27,1.35,59.09,Facile,Moyen,-1,Plus Difficile,Pas Adapte,Mathematics
1690,2016,Mathématiques,1,L'Algèbre Linéaire,2,Sous Espaces Supplementaires,10,567,3,QCM,0.21,0.42,43.0,34,44,78,76,34,42,1.03,44.74,Difficile,Moyen,1,Plus Facile,Pas Adapte,Mathematics
2814,2017,Mathématiques,1,L'Algèbre Linéaire,2,Sous Espaces Supplementaires,10,567,3,QROC,0.63,0.08,22.0,19,69,88,81,19,62,1.09,23.46,Facile,Difficile,-2,Beaucoup plus Difficile,Pas Adapte,Mathematics
3938,2018,Mathématiques,1,L'Algèbre Linéaire,2,Sous Espaces Supplementaires,10,567,3,QROC,0.73,0.19,2.0,2,76,78,57,2,55,1.37,3.51,Facile,Difficile,-2,Beaucoup plus Difficile,Pas Adapte,Mathematics
5062,2019,Mathématiques,1,L'Algèbre Linéaire,2,Sous Espaces Supplementaires,10,567,3,QROC,0.49,0.37,47.0,35,40,75,70,35,35,1.07,50.0,Moyen,Moyen,0,Meme Difficulté,Pas Adapte,Mathematics
6186,2020,Mathématiques,1,L'Algèbre Linéaire,2,Sous Espaces Supplementaires,10,567,3,QROC,0.46,0.31,57.0,43,32,75,55,43,12,1.36,78.18,Difficile,Moyen,1,Plus Facile,Pas Adapte,Mathematics
567,2015,Mathématiques,1,L'Algèbre Linéaire,2,Sous Espaces Supplementaires,10,568,4,QCM,0.56,0.28,34.0,28,55,83,70,28,42,1.19,40.0,Difficile,Difficile,0,Meme Difficulté,Pas Adapte,Mathematics
1691,2016,Mathématiques,1,L'Algèbre Linéaire,2,Sous Espaces Supplementaires,10,568,4,QCM,0.53,0.22,0.0,0,80,80,60,0,60,1.33,0.0,Difficile,Difficile,0,Meme Difficulté,Pas Adapte,Mathematics
2815,2017,Mathématiques,1,L'Algèbre Linéaire,2,Sous Espaces Supplementaires,10,568,4,QCM,0.35,0.33,62.0,43,26,69,44,43,1,1.57,97.73,Facile,Moyen,-1,Plus Difficile,Adapte,Mathematics
3939,2018,Mathématiques,1,L'Algèbre Linéaire,2,Sous Espaces Supplementaires,10,568,4,QCM,0.49,0.46,62.0,43,26,69,62,43,19,1.11,69.35,Moyen,Moyen,0,Meme Difficulté,Adapte,Mathematics
5063,2019,Mathématiques,1,L'Algèbre Linéaire,2,Sous Espaces Supplementaires,10,568,4,QCM,0.27,0.66,62.0,46,29,75,57,46,11,1.32,80.7,Moyen,Moyen,0,Meme Difficulté,Adapte,Mathematics
6187,2020,Mathématiques,1,L'Algèbre Linéaire,2,Sous Espaces Supplementaires,10,568,4,QCM,0.27,0.38,62.0,46,28,74,48,46,2,1.54,95.83,Moyen,Moyen,0,Meme Difficulté,Adapte,Mathematics
568,2015,Mathématiques,1,L'Algèbre Linéaire,2,Sous Espaces Supplementaires,10,569,5,QROC,0.66,0.1,16.0,9,46,55,31,9,22,1.77,29.03,Difficile,Difficile,0,Meme Difficulté,Pas Adapte,Mathematics
1692,2016,Mathématiques,1,L'Algèbre Linéaire,2,Sous Espaces Supplementaires,10,569,5,QROC,0.6,0.29,54.0,27,23,50,49,27,22,1.02,55.1,Difficile,Moyen,1,Plus Facile,Pas Adapte,Mathematics
2816,2017,Mathématiques,1,L'Algèbre Linéaire,2,Sous Espaces Supplementaires,10,569,5,QROC,0.4,0.31,50.0,22,22,44,33,22,11,1.33,66.67,Moyen,Moyen,0,Meme Difficulté,Pas Adapte,Mathematics
3940,2018,Mathématiques,1,L'Algèbre Linéaire,2,Sous Espaces Supplementaires,10,569,5,QROC,0.48,0.38,55.0,28,22,50,38,28,10,1.32,73.68,Moyen,Moyen,0,Meme Difficulté,Pas Adapte,Mathematics
5064,2019,Mathématiques,1,L'Algèbre Linéaire,2,Sous Espaces Supplementaires,10,569,5,QROC,0.66,0.09,3.0,2,52,54,50,2,48,1.08,4.0,Facile,Difficile,-2,Beaucoup plus Difficile,Pas Adapte,Mathematics
6188,2020,Mathématiques,1,L'Algèbre Linéaire,2,Sous Espaces Supplementaires,10,569,5,QROC,0.65,0.12,9.0,5,55,60,24,5,19,2.5,20.83,Facile,Difficile,-2,Beaucoup plus Difficile,Pas Adapte,Mathematics
569,2015,Mathématiques,1,L'Algèbre Linéaire,2,Sous Espaces Supplementaires,10,570,6,QROC,0.31,0.32,49.0,26,28,54,30,26,4,1.8,86.67,Difficile,Moyen,1,Plus Facile,Pas Adapte,Mathematics
1693,2016,Mathématiques,1,L'Algèbre Linéaire,2,Sous Espaces Supplementaires,10,570,6,QO,0.81,0.01,8.0,4,47,51,38,4,34,1.34,10.53,Moyen,Difficile,-1,Plus Difficile,Pas Adapte,Mathematics
2817,2017,Mathématiques,1,L'Algèbre Linéaire,2,Sous Espaces Supplementaires,10,570,6,QO,0.68,0.27,42.0,25,34,59,49,25,24,1.2,51.02,Moyen,Moyen,0,Meme Difficulté,Pas Adapte,Mathematics
3941,2018,Mathématiques,1,L'Algèbre Linéaire,2,Sous Espaces Supplementaires,10,570,6,QO,0.84,0.14,33.0,18,38,56,44,18,26,1.27,40.91,Difficile,Difficile,0,Meme Difficulté,Pas Adapte,Mathematics
5065,2019,Mathématiques,1,L'Algèbre Linéaire,2,Sous Espaces Supplementaires,10,570,6,QO,0.56,0.21,38.0,23,37,60,30,23,7,2.0,76.67,Difficile,Moyen,1,Plus Facile,Pas Adapte,Mathematics
6189,2020,Mathématiques,1,L'Algèbre Linéaire,2,Sous Espaces Supplementaires,10,570,6,QO,0.58,0.16,60.0,32,21,53,36,32,4,1.47,88.89,Facile,Moyen,-1,Plus Difficile,Adapte,Mathematics
570,2015,Mathématiques,1,L'Algèbre Linéaire,2,Sous Espaces Supplementaires,10,571,7,QROC,0.92,0.06,9.0,5,53,58,48,5,43,1.21,10.42,Difficile,Difficile,0,Meme Difficulté,Pas Adapte,Mathematics
1694,2016,Mathématiques,1,L'Algèbre Linéaire,2,Sous Espaces Supplementaires,10,571,7,QROC,0.94,0.1,27.0,14,37,51,22,14,8,2.32,63.64,Facile,Difficile,-2,Beaucoup plus Difficile,Pas Adapte,Mathematics
2818,2017,Mathématiques,1,L'Algèbre Linéaire,2,Sous Espaces Supplementaires,10,571,7,QROC,0.63,0.09,10.0,6,50,56,29,6,23,1.93,20.69,Moyen,Difficile,-1,Plus Difficile,Pas Adapte,Mathematics
3942,2018,Mathématiques,1,L'Algèbre Linéaire,2,Sous Espaces Supplementaires,10,571,7,QROC,0.64,0.01,20.0,12,46,58,54,12,42,1.07,22.22,Difficile,Difficile,0,Meme Difficulté,Pas Adapte,Mathematics
5066,2019,Mathématiques,1,L'Algèbre Linéaire,2,Sous Espaces Supplementaires,10,571,7,QO,0.97,0.02,14.0,9,58,67,36,9,27,1.86,25.0,Moyen,Difficile,-1,Plus Difficile,Pas Adapte,Mathematics
6190,2020,Mathématiques,1,L'Algèbre Linéaire,2,Sous Espaces Supplementaires,10,571,7,QO,0.8,0.01,3.0,2,62,64,33,2,31,1.94,6.06,Facile,Difficile,-2,Beaucoup plus Difficile,Pas Adapte,Mathematics
571,2015,Mathématiques,1,L'Algèbre Linéaire,2,Sous Espaces Supplementaires,10,572,8,QCM,0.71,0.17,28.0,19,50,69,39,19,20,1.77,48.72,Difficile,Difficile,0,Meme Difficulté,Pas Adapte,Mathematics
1695,2016,Mathématiques,1,L'Algèbre Linéaire,2,Sous Espaces Supplementaires,10,572,8,QCM,0.23,0.42,48.0,36,39,75,51,36,15,1.47,70.59,Difficile,Moyen,1,Plus Facile,Pas Adapte,Mathematics
2819,2017,Mathématiques,1,L'Algèbre Linéaire,2,Sous Espaces Supplementaires,10,572,8,QCM,0.63,0.23,28.0,21,53,74,54,21,33,1.37,38.89,Facile,Difficile,-2,Beaucoup plus Difficile,Pas Adapte,Mathematics
3943,2018,Mathématiques,1,L'Algèbre Linéaire,2,Sous Espaces Supplementaires,10,572,8,QCM,0.34,0.69,56.0,37,29,66,52,37,15,1.27,71.15,Facile,Moyen,-1,Plus Difficile,Pas Adapte,Mathematics
5067,2019,Mathématiques,1,L'Algèbre Linéaire,2,Sous Espaces Supplementaires,10,572,8,QCM,0.79,0.16,9.0,7,68,75,39,7,32,1.92,17.95,Moyen,Difficile,-1,Plus Difficile,Pas Adapte,Mathematics
6191,2020,Mathématiques,1,L'Algèbre Linéaire,2,Sous Espaces Supplementaires,10,572,8,QCM,0.62,0.29,22.0,17,61,78,61,17,44,1.28,27.87,Difficile,Difficile,0,Meme Difficulté,Pas Adapte,Mathematics
572,2015,Mathématiques,1,L'Algèbre Linéaire,2,Sous Espaces Supplementaires,10,573,9,QROC,0.33,0.35,64.0,62,35,97,66,62,4,1.47,93.94,Moyen,Moyen,0,Meme Difficulté,Adapte,Mathematics
1696,2016,Mathématiques,1,L'Algèbre Linéaire,2,Sous Espaces Supplementaires,10,573,9,QCM,0.34,0.7,64.0,63,36,99,77,63,14,1.29,81.82,Moyen,Moyen,0,Meme Difficulté,Adapte,Mathematics
2820,2017,Mathématiques,1,L'Algèbre Linéaire,2,Sous Espaces Supplementaires,10,573,9,QCM,0.46,0.56,64.0,56,31,87,61,56,5,1.43,91.8,Moyen,Moyen,0,Meme Difficulté,Adapte,Mathematics
3944,2018,Mathématiques,1,L'Algèbre Linéaire,2,Sous Espaces Supplementaires,10,573,9,QCM,0.28,0.66,64.0,59,33,92,86,59,27,1.07,68.6,Moyen,Moyen,0,Meme Difficulté,Adapte,Mathematics
5068,2019,Mathématiques,1,L'Algèbre Linéaire,2,Sous Espaces Supplementaires,10,573,9,QCM,0.37,0.42,64.0,68,38,106,86,68,18,1.23,79.07,Moyen,Moyen,0,Meme Difficulté,Adapte,Mathematics
6192,2020,Mathématiques,1,L'Algèbre Linéaire,2,Sous Espaces Supplementaires,10,573,9,QCM,0.27,0.67,64.0,77,44,121,104,77,27,1.16,74.04,Moyen,Moyen,0,Meme Difficulté,Adapte,Mathematics
573,2015,Mathématiques,1,L'Algèbre Linéaire,2,Sous Espaces Supplementaires,10,574,10,QCU,0.6,0.31,0.0,0,94,94,49,0,49,1.92,0.0,Difficile,Difficile,0,Meme Difficulté,Pas Adapte,Mathematics
1697,2016,Mathématiques,1,L'Algèbre Linéaire,2,Sous Espaces Supplementaires,10,574,10,QCU,0.27,0.5,57.0,56,43,99,80,56,24,1.24,70.0,Moyen,Moyen,0,Meme Difficulté,Pas Adapte,Mathematics
2821,2017,Mathématiques,1,L'Algèbre Linéaire,2,Sous Espaces Supplementaires,10,574,10,QCU,0.36,0.46,39.0,39,62,101,65,39,26,1.55,60.0,Facile,Moyen,-1,Plus Difficile,Pas Adapte,Mathematics
3945,2018,Mathématiques,1,L'Algèbre Linéaire,2,Sous Espaces Supplementaires,10,574,10,QO,0.94,0.1,11.0,11,87,98,62,11,51,1.58,17.74,Difficile,Difficile,0,Meme Difficulté,Pas Adapte,Mathematics
5069,2019,Mathématiques,1,L'Algèbre Linéaire,2,Sous Espaces Supplementaires,10,574,10,QO,0.58,0.24,36.0,31,55,86,78,31,47,1.1,39.74,Facile,Moyen,-1,Plus Difficile,Pas Adapte,Mathematics
6193,2020,Mathématiques,1,L'Algèbre Linéaire,2,Sous Espaces Supplementaires,10,574,10,QO,0.99,0.1,22.0,18,62,80,51,18,33,1.57,35.29,Moyen,Difficile,-1,Plus Difficile,Pas Adapte,Mathematics
574,2015,Mathématiques,1,L'Algèbre Linéaire,3,Theoreme du Rang,3,575,1,QCM,0.56,0.2,1.0,1,68,69,33,1,32,2.09,3.03,Facile,Difficile,-2,Beaucoup plus Difficile,Pas Adapte,Mathematics
1698,2016,Mathématiques,1,L'Algèbre Linéaire,3,Theoreme du Rang,3,575,1,QCU,0.71,0.32,28.0,20,53,73,63,20,43,1.16,31.75,Moyen,Difficile,-1,Plus Difficile,Pas Adapte,Mathematics
2822,2017,Mathématiques,1,L'Algèbre Linéaire,3,Theoreme du Rang,3,575,1,QCU,0.69,0.4,8.0,6,63,69,53,6,47,1.3,11.32,Difficile,Difficile,0,Meme Difficulté,Pas Adapte,Mathematics
3946,2018,Mathématiques,1,L'Algèbre Linéaire,3,Theoreme du Rang,3,575,1,QCU,0.37,0.5,55.0,38,32,70,69,38,31,1.01,55.07,Difficile,Moyen,1,Plus Facile,Pas Adapte,Mathematics
5070,2019,Mathématiques,1,L'Algèbre Linéaire,3,Theoreme du Rang,3,575,1,QCU,0.25,0.57,44.0,27,34,61,29,27,2,2.1,93.1,Difficile,Moyen,1,Plus Facile,Pas Adapte,Mathematics
6194,2020,Mathématiques,1,L'Algèbre Linéaire,3,Theoreme du Rang,3,575,1,QCU,0.74,0.28,1.0,1,62,63,49,1,48,1.29,2.04,Difficile,Difficile,0,Meme Difficulté,Pas Adapte,Mathematics
575,2015,Mathématiques,1,L'Algèbre Linéaire,3,Theoreme du Rang,3,576,2,QROC,0.75,0.05,31.0,25,56,81,63,25,38,1.29,39.68,Difficile,Difficile,0,Meme Difficulté,Pas Adapte,Mathematics
1699,2016,Mathématiques,1,L'Algèbre Linéaire,3,Theoreme du Rang,3,576,2,QROC,0.41,0.26,61.0,46,30,76,51,46,5,1.49,90.2,Facile,Moyen,-1,Plus Difficile,Adapte,Mathematics
2823,2017,Mathématiques,1,L'Algèbre Linéaire,3,Theoreme du Rang,3,576,2,QROC,0.24,0.34,61.0,42,27,69,62,42,20,1.11,67.74,Moyen,Moyen,0,Meme Difficulté,Adapte,Mathematics
3947,2018,Mathématiques,1,L'Algèbre Linéaire,3,Theoreme du Rang,3,576,2,QROC,0.38,0.26,61.0,48,31,79,51,48,3,1.55,94.12,Moyen,Moyen,0,Meme Difficulté,Adapte,Mathematics
5071,2019,Mathématiques,1,L'Algèbre Linéaire,3,Theoreme du Rang,3,576,2,QROC,0.51,0.32,61.0,41,27,68,42,41,1,1.62,97.62,Moyen,Moyen,0,Meme Difficulté,Adapte,Mathematics
6195,2020,Mathématiques,1,L'Algèbre Linéaire,3,Theoreme du Rang,3,576,2,QROC,0.44,0.33,61.0,45,29,74,62,45,17,1.19,72.58,Moyen,Moyen,0,Meme Difficulté,Adapte,Mathematics
576,2015,Mathématiques,1,L'Algèbre Linéaire,3,Theoreme du Rang,3,577,3,QCM,0.3,0.45,58.0,5,3,8,7,5,2,1.14,71.43,Facile,Moyen,-1,Plus Difficile,Pas Adapte,Mathematics
1700,2016,Mathématiques,1,L'Algèbre Linéaire,3,Theoreme du Rang,3,577,3,QCM,0.76,0.18,8.0,1,7,8,4,1,3,2.0,25.0,Moyen,Difficile,-1,Plus Difficile,Pas Adapte,Mathematics
2824,2017,Mathématiques,1,L'Algèbre Linéaire,3,Theoreme du Rang,3,577,3,QCU,0.46,0.39,4.0,0,9,9,9,0,9,1.0,0.0,Difficile,Difficile,0,Meme Difficulté,Pas Adapte,Mathematics
3948,2018,Mathématiques,1,L'Algèbre Linéaire,3,Theoreme du Rang,3,577,3,QCU,0.54,0.31,30.0,2,6,8,5,2,3,1.6,40.0,Moyen,Difficile,-1,Plus Difficile,Pas Adapte,Mathematics
5072,2019,Mathématiques,1,L'Algèbre Linéaire,3,Theoreme du Rang,3,577,3,QCU,0.64,0.27,16.0,1,7,8,7,1,6,1.14,14.29,Moyen,Difficile,-1,Plus Difficile,Pas Adapte,Mathematics
6196,2020,Mathématiques,1,L'Algèbre Linéaire,3,Theoreme du Rang,3,577,3,QCU,0.37,0.66,49.0,3,4,7,6,3,3,1.17,50.0,Facile,Moyen,-1,Plus Difficile,Pas Adapte,Mathematics
577,2015,Mathématiques,1,L'Algèbre Linéaire,4,Projecteurs et Symetries,9,578,1,QCM,0.25,0.47,64.0,38,21,59,40,38,2,1.48,95.0,Facile,Moyen,-1,Plus Difficile,Adapte,Mathematics
1701,2016,Mathématiques,1,L'Algèbre Linéaire,4,Projecteurs et Symetries,9,578,1,QCM,0.49,0.66,64.0,35,19,54,46,35,11,1.17,76.09,Moyen,Moyen,0,Meme Difficulté,Adapte,Mathematics
2825,2017,Mathématiques,1,L'Algèbre Linéaire,4,Projecteurs et Symetries,9,578,1,QCU,0.32,0.63,64.0,32,18,50,37,32,5,1.35,86.49,Moyen,Moyen,0,Meme Difficulté,Adapte,Mathematics
3949,2018,Mathématiques,1,L'Algèbre Linéaire,4,Projecteurs et Symetries,9,578,1,QCU,0.28,0.67,64.0,30,17,47,35,30,5,1.34,85.71,Moyen,Moyen,0,Meme Difficulté,Adapte,Mathematics
5073,2019,Mathématiques,1,L'Algèbre Linéaire,4,Projecteurs et Symetries,9,578,1,QCU,0.23,0.52,64.0,31,17,48,37,31,6,1.3,83.78,Moyen,Moyen,0,Meme Difficulté,Adapte,Mathematics
6197,2020,Mathématiques,1,L'Algèbre Linéaire,4,Projecteurs et Symetries,9,578,1,QCM,0.3,0.57,64.0,30,17,47,47,30,17,1.0,63.83,Moyen,Moyen,0,Meme Difficulté,Adapte,Mathematics
578,2015,Mathématiques,1,L'Algèbre Linéaire,4,Projecteurs et Symetries,9,579,2,QROC,0.88,0.24,20.0,8,31,39,37,8,29,1.05,21.62,Facile,Difficile,-2,Beaucoup plus Difficile,Pas Adapte,Mathematics
1702,2016,Mathématiques,1,L'Algèbre Linéaire,4,Projecteurs et Symetries,9,579,2,QROC,0.32,0.29,60.0,20,14,34,32,20,12,1.06,62.5,Facile,Moyen,-1,Plus Difficile,Adapte,Mathematics
2826,2017,Mathématiques,1,L'Algèbre Linéaire,4,Projecteurs et Symetries,9,579,2,QROC,0.4,0.35,60.0,19,12,31,19,19,0,1.63,100.0,Moyen,Moyen,0,Meme Difficulté,Adapte,Mathematics
3950,2018,Mathématiques,1,L'Algèbre Linéaire,4,Projecteurs et Symetries,9,579,2,QROC,0.44,0.32,60.0,20,13,33,26,20,6,1.27,76.92,Moyen,Moyen,0,Meme Difficulté,Adapte,Mathematics
5074,2019,Mathématiques,1,L'Algèbre Linéaire,4,Projecteurs et Symetries,9,579,2,QCM,0.49,0.39,60.0,19,13,32,29,19,10,1.1,65.52,Moyen,Moyen,0,Meme Difficulté,Adapte,Mathematics
6198,2020,Mathématiques,1,L'Algèbre Linéaire,4,Projecteurs et Symetries,9,579,2,QCM,0.42,0.49,60.0,17,11,28,22,17,5,1.27,77.27,Moyen,Moyen,0,Meme Difficulté,Adapte,Mathematics
579,2015,Mathématiques,1,L'Algèbre Linéaire,4,Projecteurs et Symetries,9,580,3,QCM,0.77,0.2,15.0,13,76,89,86,13,73,1.03,15.12,Moyen,Difficile,-1,Plus Difficile,Pas Adapte,Mathematics
1703,2016,Mathématiques,1,L'Algèbre Linéaire,4,Projecteurs et Symetries,9,580,3,QCM,0.6,0.2,4.0,4,94,98,86,4,82,1.14,4.65,Difficile,Difficile,0,Meme Difficulté,Pas Adapte,Mathematics
2827,2017,Mathématiques,1,L'Algèbre Linéaire,4,Projecteurs et Symetries,9,580,3,QCM,0.65,0.21,7.0,7,97,104,85,7,78,1.22,8.24,Difficile,Difficile,0,Meme Difficulté,Pas Adapte,Mathematics
3951,2018,Mathématiques,1,L'Algèbre Linéaire,4,Projecteurs et Symetries,9,580,3,QCM,0.71,0.23,3.0,3,96,99,46,3,43,2.15,6.52,Moyen,Difficile,-1,Plus Difficile,Pas Adapte,Mathematics
5075,2019,Mathématiques,1,L'Algèbre Linéaire,4,Projecteurs et Symetries,9,580,3,QCM,0.55,0.17,35.0,30,56,86,52,30,22,1.65,57.69,Moyen,Difficile,-1,Plus Difficile,Pas Adapte,Mathematics
6199,2020,Mathématiques,1,L'Algèbre Linéaire,4,Projecteurs et Symetries,9,580,3,QCM,0.29,0.63,44.0,39,49,88,64,39,25,1.38,60.94,Moyen,Moyen,0,Meme Difficulté,Pas Adapte,Mathematics
580,2015,Mathématiques,1,L'Algèbre Linéaire,4,Projecteurs et Symetries,9,581,4,QCU,0.25,0.48,53.0,21,18,39,31,21,10,1.26,67.74,Moyen,Moyen,0,Meme Difficulté,Pas Adapte,Mathematics
1704,2016,Mathématiques,1,L'Algèbre Linéaire,4,Projecteurs et Symetries,9,581,4,QCU,0.37,0.71,64.0,29,16,45,39,29,10,1.15,74.36,Moyen,Moyen,0,Meme Difficulté,Adapte,Mathematics
2828,2017,Mathématiques,1,L'Algèbre Linéaire,4,Projecteurs et Symetries,9,581,4,QCM,0.36,0.52,64.0,31,17,48,46,31,15,1.04,67.39,Moyen,Moyen,0,Meme Difficulté,Adapte,Mathematics
3952,2018,Mathématiques,1,L'Algèbre Linéaire,4,Projecteurs et Symetries,9,581,4,QCM,0.48,0.33,64.0,28,16,44,32,28,4,1.38,87.5,Moyen,Moyen,0,Meme Difficulté,Adapte,Mathematics
5076,2019,Mathématiques,1,L'Algèbre Linéaire,4,Projecteurs et Symetries,9,581,4,QCM,0.4,0.62,64.0,28,15,43,34,28,6,1.26,82.35,Moyen,Moyen,0,Meme Difficulté,Adapte,Mathematics
6200,2020,Mathématiques,1,L'Algèbre Linéaire,4,Projecteurs et Symetries,9,581,4,QCM,0.31,0.7,64.0,31,17,48,47,31,16,1.02,65.96,Moyen,Moyen,0,Meme Difficulté,Adapte,Mathematics
581,2015,Mathématiques,1,L'Algèbre Linéaire,4,Projecteurs et Symetries,9,582,5,QCM,0.53,0.18,33.0,19,39,58,37,19,18,1.57,51.35,Moyen,Difficile,-1,Plus Difficile,Pas Adapte,Mathematics
1705,2016,Mathématiques,1,L'Algèbre Linéaire,4,Projecteurs et Symetries,9,582,5,QCM,0.74,0.21,2.0,1,54,55,38,1,37,1.45,2.63,Difficile,Difficile,0,Meme Difficulté,Pas Adapte,Mathematics
2829,2017,Mathématiques,1,L'Algèbre Linéaire,4,Projecteurs et Symetries,9,582,5,QCM,0.53,0.19,14.0,9,53,62,18,9,9,3.44,50.0,Difficile,Difficile,0,Meme Difficulté,Pas Adapte,Mathematics
3953,2018,Mathématiques,1,L'Algèbre Linéaire,4,Projecteurs et Symetries,9,582,5,QCM,0.72,0.18,2.0,1,69,70,47,1,46,1.49,2.13,Facile,Difficile,-2,Beaucoup plus Difficile,Pas Adapte,Mathematics
5077,2019,Mathématiques,1,L'Algèbre Linéaire,4,Projecteurs et Symetries,9,582,5,QCM,0.42,0.48,46.0,28,33,61,51,28,23,1.2,54.9,Difficile,Moyen,1,Plus Facile,Pas Adapte,Mathematics
6201,2020,Mathématiques,1,L'Algèbre Linéaire,4,Projecteurs et Symetries,9,582,5,QCM,0.44,0.6,56.0,37,29,66,53,37,16,1.25,69.81,Difficile,Moyen,1,Plus Facile,Pas Adapte,Mathematics
582,2015,Mathématiques,1,L'Algèbre Linéaire,4,Projecteurs et Symetries,9,583,6,QCM,0.55,0.26,25.0,20,61,81,26,20,6,3.12,76.92,Facile,Difficile,-2,Beaucoup plus Difficile,Pas Adapte,Mathematics
1706,2016,Mathématiques,1,L'Algèbre Linéaire,4,Projecteurs et Symetries,9,583,6,QCU,0.33,0.7,48.0,45,48,93,91,45,46,1.02,49.45,Facile,Moyen,-1,Plus Difficile,Pas Adapte,Mathematics
2830,2017,Mathématiques,1,L'Algèbre Linéaire,4,Projecteurs et Symetries,9,583,6,QROC,0.83,0.14,10.0,8,73,81,39,8,31,2.08,20.51,Moyen,Difficile,-1,Plus Difficile,Pas Adapte,Mathematics
3954,2018,Mathématiques,1,L'Algèbre Linéaire,4,Projecteurs et Symetries,9,583,6,QROC,0.48,0.34,64.0,58,32,90,79,58,21,1.14,73.42,Facile,Moyen,-1,Plus Difficile,Adapte,Mathematics
5078,2019,Mathématiques,1,L'Algèbre Linéaire,4,Projecteurs et Symetries,9,583,6,QO,0.5,0.25,64.0,61,35,96,84,61,23,1.14,72.62,Moyen,Moyen,0,Meme Difficulté,Adapte,Mathematics
6202,2020,Mathématiques,1,L'Algèbre Linéaire,4,Projecteurs et Symetries,9,583,6,QO,0.68,0.24,64.0,61,35,96,88,61,27,1.09,69.32,Moyen,Moyen,0,Meme Difficulté,Adapte,Mathematics
583,2015,Mathématiques,1,L'Algèbre Linéaire,4,Projecteurs et Symetries,9,584,7,QCM,0.29,0.38,59.0,56,39,95,68,56,12,1.4,82.35,Facile,Moyen,-1,Plus Difficile,Pas Adapte,Mathematics
1707,2016,Mathématiques,1,L'Algèbre Linéaire,4,Projecteurs et Symetries,9,584,7,QCM,0.57,0.17,16.0,15,78,93,35,15,20,2.66,42.86,Difficile,Difficile,0,Meme Difficulté,Pas Adapte,Mathematics
2831,2017,Mathématiques,1,L'Algèbre Linéaire,4,Projecteurs et Symetries,9,584,7,QCU,0.59,0.26,20.0,19,75,94,62,19,43,1.52,30.65,Difficile,Difficile,0,Meme Difficulté,Pas Adapte,Mathematics
3955,2018,Mathématiques,1,L'Algèbre Linéaire,4,Projecteurs et Symetries,9,584,7,QCU,0.49,0.23,31.0,29,64,93,38,29,9,2.45,76.32,Moyen,Difficile,-1,Plus Difficile,Pas Adapte,Mathematics
5079,2019,Mathématiques,1,L'Algèbre Linéaire,4,Projecteurs et Symetries,9,584,7,QCU,0.62,0.3,6.0,6,101,107,100,6,94,1.07,6.0,Facile,Difficile,-2,Beaucoup plus Difficile,Pas Adapte,Mathematics
6203,2020,Mathématiques,1,L'Algèbre Linéaire,4,Projecteurs et Symetries,9,584,7,QCU,0.58,0.22,15.0,14,79,93,36,14,22,2.58,38.89,Difficile,Difficile,0,Meme Difficulté,Pas Adapte,Mathematics
584,2015,Mathématiques,1,L'Algèbre Linéaire,4,Projecteurs et Symetries,9,585,8,QCM,0.48,0.58,64.0,13,7,20,18,13,5,1.11,72.22,Moyen,Moyen,0,Meme Difficulté,Adapte,Mathematics
1708,2016,Mathématiques,1,L'Algèbre Linéaire,4,Projecteurs et Symetries,9,585,8,QCM,0.42,0.44,64.0,15,8,23,16,15,1,1.44,93.75,Moyen,Moyen,0,Meme Difficulté,Adapte,Mathematics
2832,2017,Mathématiques,1,L'Algèbre Linéaire,4,Projecteurs et Symetries,9,585,8,QCM,0.39,0.57,64.0,13,7,20,17,13,4,1.18,76.47,Moyen,Moyen,0,Meme Difficulté,Adapte,Mathematics
3956,2018,Mathématiques,1,L'Algèbre Linéaire,4,Projecteurs et Symetries,9,585,8,QCM,0.22,0.5,64.0,14,8,22,21,14,7,1.05,66.67,Moyen,Moyen,0,Meme Difficulté,Adapte,Mathematics
5080,2019,Mathématiques,1,L'Algèbre Linéaire,4,Projecteurs et Symetries,9,585,8,QCM,0.42,0.36,64.0,15,8,23,18,15,3,1.28,83.33,Moyen,Moyen,0,Meme Difficulté,Adapte,Mathematics
6204,2020,Mathématiques,1,L'Algèbre Linéaire,4,Projecteurs et Symetries,9,585,8,QCM,0.36,0.6,64.0,16,9,25,22,16,6,1.14,72.73,Moyen,Moyen,0,Meme Difficulté,Adapte,Mathematics
585,2015,Mathématiques,1,L'Algèbre Linéaire,4,Projecteurs et Symetries,9,586,9,QCM,0.74,0.2,13.0,8,52,60,36,8,28,1.67,22.22,Facile,Difficile,-2,Beaucoup plus Difficile,Pas Adapte,Mathematics
1709,2016,Mathématiques,1,L'Algèbre Linéaire,4,Projecteurs et Symetries,9,586,9,QCU,0.64,0.39,35.0,22,42,64,58,22,36,1.1,37.93,Moyen,Difficile,-1,Plus Difficile,Pas Adapte,Mathematics
2833,2017,Mathématiques,1,L'Algèbre Linéaire,4,Projecteurs et Symetries,9,586,9,QCU,0.58,0.36,19.0,13,53,66,35,13,22,1.89,37.14,Difficile,Difficile,0,Meme Difficulté,Pas Adapte,Mathematics
3957,2018,Mathématiques,1,L'Algèbre Linéaire,4,Projecteurs et Symetries,9,586,9,QCU,0.52,0.35,3.0,2,60,62,27,2,25,2.3,7.41,Moyen,Difficile,-1,Plus Difficile,Pas Adapte,Mathematics
5081,2019,Mathématiques,1,L'Algèbre Linéaire,4,Projecteurs et Symetries,9,586,9,QCM,0.41,0.41,49.0,34,36,70,47,34,13,1.49,72.34,Facile,Moyen,-1,Plus Difficile,Pas Adapte,Mathematics
6205,2020,Mathématiques,1,L'Algèbre Linéaire,4,Projecteurs et Symetries,9,586,9,QCM,0.35,0.42,38.0,25,41,66,45,25,20,1.47,55.56,Moyen,Moyen,0,Meme Difficulté,Pas Adapte,Mathematics
586,2015,Mathématiques,1,L'Algèbre Linéaire,5,Determination et Construction d'Applications Lineaires,14,587,1,QCU,0.61,0.33,30.0,25,59,84,70,25,45,1.2,35.71,Moyen,Difficile,-1,Plus Difficile,Pas Adapte,Mathematics
1710,2016,Mathématiques,1,L'Algèbre Linéaire,5,Determination et Construction d'Applications Lineaires,14,587,1,QCU,0.4,0.29,21.0,18,70,88,42,18,24,2.1,42.86,Facile,Difficile,-2,Beaucoup plus Difficile,Pas Adapte,Mathematics
2834,2017,Mathématiques,1,L'Algèbre Linéaire,5,Determination et Construction d'Applications Lineaires,14,587,1,QCU,0.37,0.45,55.0,50,41,91,91,50,41,1.0,54.95,Moyen,Moyen,0,Meme Difficulté,Pas Adapte,Mathematics
3958,2018,Mathématiques,1,L'Algèbre Linéaire,5,Determination et Construction d'Applications Lineaires,14,587,1,QROC,1.0,0.01,11.0,9,70,79,34,9,25,2.32,26.47,Facile,Difficile,-2,Beaucoup plus Difficile,Pas Adapte,Mathematics
5082,2019,Mathématiques,1,L'Algèbre Linéaire,5,Determination et Construction d'Applications Lineaires,14,587,1,QROC,0.61,0.12,8.0,6,70,76,50,6,44,1.52,12.0,Facile,Difficile,-2,Beaucoup plus Difficile,Pas Adapte,Mathematics
6206,2020,Mathématiques,1,L'Algèbre Linéaire,5,Determination et Construction d'Applications Lineaires,14,587,1,QROC,0.83,0.01,34.0,26,49,75,56,26,30,1.34,46.43,Difficile,Difficile,0,Meme Difficulté,Pas Adapte,Mathematics
587,2015,Mathématiques,1,L'Algèbre Linéaire,5,Determination et Construction d'Applications Lineaires,14,588,2,QCU,0.65,0.22,21.0,13,51,64,44,13,31,1.45,29.55,Moyen,Difficile,-1,Plus Difficile,Pas Adapte,Mathematics
1711,2016,Mathématiques,1,L'Algèbre Linéaire,5,Determination et Construction d'Applications Lineaires,14,588,2,QCM,0.72,0.23,31.0,22,50,72,67,22,45,1.07,32.84,Difficile,Difficile,0,Meme Difficulté,Pas Adapte,Mathematics
2835,2017,Mathématiques,1,L'Algèbre Linéaire,5,Determination et Construction d'Applications Lineaires,14,588,2,QCM,0.69,0.16,15.0,12,65,77,36,12,24,2.14,33.33,Difficile,Difficile,0,Meme Difficulté,Pas Adapte,Mathematics
3959,2018,Mathématiques,1,L'Algèbre Linéaire,5,Determination et Construction d'Applications Lineaires,14,588,2,QCM,0.45,0.68,57.0,39,29,68,59,39,20,1.15,66.1,Difficile,Moyen,1,Plus Facile,Pas Adapte,Mathematics
5083,2019,Mathématiques,1,L'Algèbre Linéaire,5,Determination et Construction d'Applications Lineaires,14,588,2,QCM,0.24,0.35,50.0,33,33,66,38,33,5,1.74,86.84,Facile,Moyen,-1,Plus Difficile,Pas Adapte,Mathematics
6207,2020,Mathématiques,1,L'Algèbre Linéaire,5,Determination et Construction d'Applications Lineaires,14,588,2,QCM,0.23,0.37,47.0,32,37,69,57,32,25,1.21,56.14,Moyen,Moyen,0,Meme Difficulté,Pas Adapte,Mathematics
588,2015,Mathématiques,1,L'Algèbre Linéaire,5,Determination et Construction d'Applications Lineaires,14,589,3,QCU,0.36,0.53,40.0,34,52,86,42,34,8,2.05,80.95,Moyen,Moyen,0,Meme Difficulté,Pas Adapte,Mathematics
1712,2016,Mathématiques,1,L'Algèbre Linéaire,5,Determination et Construction d'Applications Lineaires,14,589,3,QCU,0.61,0.38,11.0,9,70,79,65,9,56,1.22,13.85,Facile,Difficile,-2,Beaucoup plus Difficile,Pas Adapte,Mathematics
2836,2017,Mathématiques,1,L'Algèbre Linéaire,5,Determination et Construction d'Applications Lineaires,14,589,3,QROC,0.66,0.01,5.0,4,77,81,70,4,66,1.16,5.71,Facile,Difficile,-2,Beaucoup plus Difficile,Pas Adapte,Mathematics
3960,2018,Mathématiques,1,L'Algèbre Linéaire,5,Determination et Construction d'Applications Lineaires,14,589,3,QCM,0.37,0.7,52.0,44,41,85,56,44,12,1.52,78.57,Facile,Moyen,-1,Plus Difficile,Pas Adapte,Mathematics
5084,2019,Mathématiques,1,L'Algèbre Linéaire,5,Determination et Construction d'Applications Lineaires,14,589,3,QCM,0.27,0.49,52.0,40,36,76,66,40,26,1.15,60.61,Difficile,Moyen,1,Plus Facile,Pas Adapte,Mathematics
6208,2020,Mathématiques,1,L'Algèbre Linéaire,5,Determination et Construction d'Applications Lineaires,14,589,3,QCM,0.78,0.23,33.0,23,47,70,37,23,14,1.89,62.16,Moyen,Difficile,-1,Plus Difficile,Pas Adapte,Mathematics
589,2015,Mathématiques,1,L'Algèbre Linéaire,5,Determination et Construction d'Applications Lineaires,14,590,4,QCM,0.65,0.16,4.0,3,74,77,72,3,69,1.07,4.17,Facile,Difficile,-2,Beaucoup plus Difficile,Pas Adapte,Mathematics
1713,2016,Mathématiques,1,L'Algèbre Linéaire,5,Determination et Construction d'Applications Lineaires,14,590,4,QCM,0.4,0.39,56.0,41,32,73,56,41,15,1.3,73.21,Facile,Moyen,-1,Plus Difficile,Pas Adapte,Mathematics
2837,2017,Mathématiques,1,L'Algèbre Linéaire,5,Determination et Construction d'Applications Lineaires,14,590,4,QCU,0.34,0.6,43.0,34,46,80,65,34,31,1.23,52.31,Facile,Moyen,-1,Plus Difficile,Pas Adapte,Mathematics
3961,2018,Mathématiques,1,L'Algèbre Linéaire,5,Determination et Construction d'Applications Lineaires,14,590,4,QCU,0.48,0.29,29.0,25,62,87,41,25,16,2.12,60.98,Moyen,Difficile,-1,Plus Difficile,Pas Adapte,Mathematics
5085,2019,Mathématiques,1,L'Algèbre Linéaire,5,Determination et Construction d'Applications Lineaires,14,590,4,QCU,0.46,0.21,19.0,15,62,77,34,15,19,2.26,44.12,Facile,Difficile,-2,Beaucoup plus Difficile,Pas Adapte,Mathematics
6209,2020,Mathématiques,1,L'Algèbre Linéaire,5,Determination et Construction d'Applications Lineaires,14,590,4,QCU,0.52,0.28,5.0,3,65,68,35,3,32,1.94,8.57,Facile,Difficile,-2,Beaucoup plus Difficile,Pas Adapte,Mathematics
590,2015,Mathématiques,1,L'Algèbre Linéaire,5,Determination et Construction d'Applications Lineaires,14,591,5,QCU,0.51,0.32,3.0,1,16,17,8,1,7,2.12,12.5,Facile,Difficile,-2,Beaucoup plus Difficile,Pas Adapte,Mathematics
1714,2016,Mathématiques,1,L'Algèbre Linéaire,5,Determination et Construction d'Applications Lineaires,14,591,5,QCU,0.29,0.66,43.0,6,9,15,10,6,4,1.5,60.0,Difficile,Moyen,1,Plus Facile,Pas Adapte,Mathematics
2838,2017,Mathématiques,1,L'Algèbre Linéaire,5,Determination et Construction d'Applications Lineaires,14,591,5,QCU,0.31,0.74,61.0,10,7,17,11,10,1,1.55,90.91,Moyen,Moyen,0,Meme Difficulté,Adapte,Mathematics
3962,2018,Mathématiques,1,L'Algèbre Linéaire,5,Determination et Construction d'Applications Lineaires,14,591,5,QCU,0.33,0.66,61.0,12,7,19,15,12,3,1.27,80.0,Moyen,Moyen,0,Meme Difficulté,Adapte,Mathematics
5086,2019,Mathématiques,1,L'Algèbre Linéaire,5,Determination et Construction d'Applications Lineaires,14,591,5,QCU,0.31,0.55,61.0,10,6,16,12,10,2,1.33,83.33,Moyen,Moyen,0,Meme Difficulté,Adapte,Mathematics
6210,2020,Mathématiques,1,L'Algèbre Linéaire,5,Determination et Construction d'Applications Lineaires,14,591,5,QCU,0.22,0.62,61.0,11,7,18,15,11,4,1.2,73.33,Moyen,Moyen,0,Meme Difficulté,Adapte,Mathematics
591,2015,Mathématiques,1,L'Algèbre Linéaire,5,Determination et Construction d'Applications Lineaires,14,592,6,QCU,0.37,0.41,64.0,50,28,78,72,50,22,1.08,69.44,Difficile,Moyen,1,Plus Facile,Adapte,Mathematics
1715,2016,Mathématiques,1,L'Algèbre Linéaire,5,Determination et Construction d'Applications Lineaires,14,592,6,QCU,0.3,0.72,64.0,55,31,86,55,55,0,1.56,100.0,Moyen,Moyen,0,Meme Difficulté,Adapte,Mathematics
2839,2017,Mathématiques,1,L'Algèbre Linéaire,5,Determination et Construction d'Applications Lineaires,14,592,6,QCU,0.38,0.61,64.0,61,35,96,76,61,15,1.26,80.26,Moyen,Moyen,0,Meme Difficulté,Adapte,Mathematics
3963,2018,Mathématiques,1,L'Algèbre Linéaire,5,Determination et Construction d'Applications Lineaires,14,592,6,QROC,0.53,0.33,64.0,56,31,87,84,56,28,1.04,66.67,Moyen,Moyen,0,Meme Difficulté,Adapte,Mathematics
5087,2019,Mathématiques,1,L'Algèbre Linéaire,5,Determination et Construction d'Applications Lineaires,14,592,6,QROC,0.24,0.26,64.0,61,34,95,73,61,12,1.3,83.56,Moyen,Moyen,0,Meme Difficulté,Adapte,Mathematics
6211,2020,Mathématiques,1,L'Algèbre Linéaire,5,Determination et Construction d'Applications Lineaires,14,592,6,QROC,0.58,0.28,64.0,53,30,83,56,53,3,1.48,94.64,Moyen,Moyen,0,Meme Difficulté,Adapte,Mathematics
592,2015,Mathématiques,1,L'Algèbre Linéaire,5,Determination et Construction d'Applications Lineaires,14,593,7,QCU,0.5,0.38,15.0,15,82,97,42,15,27,2.31,35.71,Moyen,Difficile,-1,Plus Difficile,Pas Adapte,Mathematics
1716,2016,Mathématiques,1,L'Algèbre Linéaire,5,Determination et Construction d'Applications Lineaires,14,593,7,QCU,0.28,0.41,36.0,30,54,84,61,30,31,1.38,49.18,Difficile,Moyen,1,Plus Facile,Pas Adapte,Mathematics
2840,2017,Mathématiques,1,L'Algèbre Linéaire,5,Determination et Construction d'Applications Lineaires,14,593,7,QCU,0.58,0.34,6.0,4,71,75,32,4,28,2.34,12.5,Moyen,Difficile,-1,Plus Difficile,Pas Adapte,Mathematics
3964,2018,Mathématiques,1,L'Algèbre Linéaire,5,Determination et Construction d'Applications Lineaires,14,593,7,QCU,0.6,0.28,30.0,20,45,65,26,20,6,2.5,76.92,Difficile,Difficile,0,Meme Difficulté,Pas Adapte,Mathematics
5088,2019,Mathématiques,1,L'Algèbre Linéaire,5,Determination et Construction d'Applications Lineaires,14,593,7,QCU,0.57,0.32,29.0,16,40,56,23,16,7,2.43,69.57,Facile,Difficile,-2,Beaucoup plus Difficile,Pas Adapte,Mathematics
6212,2020,Mathématiques,1,L'Algèbre Linéaire,5,Determination et Construction d'Applications Lineaires,14,593,7,QCU,0.25,0.43,36.0,20,36,56,29,20,9,1.93,68.97,Facile,Moyen,-1,Plus Difficile,Pas Adapte,Mathematics
593,2015,Mathématiques,1,L'Algèbre Linéaire,5,Determination et Construction d'Applications Lineaires,14,594,8,QCM,0.55,0.26,20.0,11,43,54,41,11,30,1.32,26.83,Facile,Difficile,-2,Beaucoup plus Difficile,Pas Adapte,Mathematics
1717,2016,Mathématiques,1,L'Algèbre Linéaire,5,Determination et Construction d'Applications Lineaires,14,594,8,QCM,0.47,0.59,47.0,23,25,48,31,23,8,1.55,74.19,Facile,Moyen,-1,Plus Difficile,Pas Adapte,Mathematics
2841,2017,Mathématiques,1,L'Algèbre Linéaire,5,Determination et Construction d'Applications Lineaires,14,594,8,QCM,0.5,0.7,48.0,25,28,53,37,25,12,1.43,67.57,Difficile,Moyen,1,Plus Facile,Pas Adapte,Mathematics
3965,2018,Mathématiques,1,L'Algèbre Linéaire,5,Determination et Construction d'Applications Lineaires,14,594,8,QCM,0.66,0.2,11.0,5,44,49,19,5,14,2.58,26.32,Difficile,Difficile,0,Meme Difficulté,Pas Adapte,Mathematics
5089,2019,Mathématiques,1,L'Algèbre Linéaire,5,Determination et Construction d'Applications Lineaires,14,594,8,QCM,0.77,0.28,20.0,10,39,49,17,10,7,2.88,58.82,Moyen,Difficile,-1,Plus Difficile,Pas Adapte,Mathematics
6213,2020,Mathématiques,1,L'Algèbre Linéaire,5,Determination et Construction d'Applications Lineaires,14,594,8,QCM,0.52,0.27,11.0,6,50,56,42,6,36,1.33,14.29,Difficile,Difficile,0,Meme Difficulté,Pas Adapte,Mathematics
594,2015,Mathématiques,1,L'Algèbre Linéaire,5,Determination et Construction d'Applications Lineaires,14,595,9,QCU,0.22,0.67,60.0,58,38,96,64,58,6,1.5,90.62,Facile,Moyen,-1,Plus Difficile,Adapte,Mathematics
1718,2016,Mathématiques,1,L'Algèbre Linéaire,5,Determination et Construction d'Applications Lineaires,14,595,9,QCU,0.36,0.49,60.0,54,36,90,58,54,4,1.55,93.1,Moyen,Moyen,0,Meme Difficulté,Adapte,Mathematics
2842,2017,Mathématiques,1,L'Algèbre Linéaire,5,Determination et Construction d'Applications Lineaires,14,595,9,QCU,0.22,0.57,60.0,59,39,98,78,59,19,1.26,75.64,Moyen,Moyen,0,Meme Difficulté,Adapte,Mathematics
3966,2018,Mathématiques,1,L'Algèbre Linéaire,5,Determination et Construction d'Applications Lineaires,14,595,9,QCU,0.22,0.51,60.0,67,44,111,87,67,20,1.28,77.01,Moyen,Moyen,0,Meme Difficulté,Adapte,Mathematics
5090,2019,Mathématiques,1,L'Algèbre Linéaire,5,Determination et Construction d'Applications Lineaires,14,595,9,QCU,0.34,0.5,60.0,67,44,111,85,67,18,1.31,78.82,Moyen,Moyen,0,Meme Difficulté,Adapte,Mathematics
6214,2020,Mathématiques,1,L'Algèbre Linéaire,5,Determination et Construction d'Applications Lineaires,14,595,9,QCU,0.21,0.73,60.0,65,43,108,81,65,16,1.33,80.25,Moyen,Moyen,0,Meme Difficulté,Adapte,Mathematics
595,2015,Mathématiques,1,L'Algèbre Linéaire,5,Determination et Construction d'Applications Lineaires,14,596,10,QCU,0.5,0.28,5.0,3,66,69,27,3,24,2.56,11.11,Difficile,Difficile,0,Meme Difficulté,Pas Adapte,Mathematics
1719,2016,Mathématiques,1,L'Algèbre Linéaire,5,Determination et Construction d'Applications Lineaires,14,596,10,QCU,0.55,0.37,29.0,20,48,68,38,20,18,1.79,52.63,Facile,Difficile,-2,Beaucoup plus Difficile,Pas Adapte,Mathematics
2843,2017,Mathématiques,1,L'Algèbre Linéaire,5,Determination et Construction d'Applications Lineaires,14,596,10,QCU,0.23,0.67,39.0,27,42,69,50,27,23,1.38,54.0,Facile,Moyen,-1,Plus Difficile,Pas Adapte,Mathematics
3967,2018,Mathématiques,1,L'Algèbre Linéaire,5,Determination et Construction d'Applications Lineaires,14,596,10,QCU,0.66,0.39,13.0,9,60,69,26,9,17,2.65,34.62,Difficile,Difficile,0,Meme Difficulté,Pas Adapte,Mathematics
5091,2019,Mathématiques,1,L'Algèbre Linéaire,5,Determination et Construction d'Applications Lineaires,14,596,10,QCU,0.2,0.67,59.0,41,29,70,46,41,5,1.52,89.13,Facile,Moyen,-1,Plus Difficile,Pas Adapte,Mathematics
6215,2020,Mathématiques,1,L'Algèbre Linéaire,5,Determination et Construction d'Applications Lineaires,14,596,10,QCM,0.6,0.27,15.0,11,65,76,70,11,59,1.09,15.71,Difficile,Difficile,0,Meme Difficulté,Pas Adapte,Mathematics
596,2015,Mathématiques,1,L'Algèbre Linéaire,5,Determination et Construction d'Applications Lineaires,14,597,11,QROC,0.27,0.31,44.0,35,45,80,59,35,24,1.36,59.32,Facile,Moyen,-1,Plus Difficile,Pas Adapte,Mathematics
1720,2016,Mathématiques,1,L'Algèbre Linéaire,5,Determination et Construction d'Applications Lineaires,14,597,11,QO,0.85,0.07,16.0,13,67,80,40,13,27,2.0,32.5,Facile,Difficile,-2,Beaucoup plus Difficile,Pas Adapte,Mathematics
2844,2017,Mathématiques,1,L'Algèbre Linéaire,5,Determination et Construction d'Applications Lineaires,14,597,11,QO,0.28,0.28,45.0,31,38,69,51,31,20,1.35,60.78,Difficile,Moyen,1,Plus Facile,Pas Adapte,Mathematics
3968,2018,Mathématiques,1,L'Algèbre Linéaire,5,Determination et Construction d'Applications Lineaires,14,597,11,QO,0.98,0.14,30.0,23,55,78,63,23,40,1.24,36.51,Difficile,Difficile,0,Meme Difficulté,Pas Adapte,Mathematics
5092,2019,Mathématiques,1,L'Algèbre Linéaire,5,Determination et Construction d'Applications Lineaires,14,597,11,QO,0.33,0.3,52.0,40,37,77,65,40,25,1.18,61.54,Facile,Moyen,-1,Plus Difficile,Pas Adapte,Mathematics
6216,2020,Mathématiques,1,L'Algèbre Linéaire,5,Determination et Construction d'Applications Lineaires,14,597,11,QO,0.54,0.29,58.0,50,36,86,64,50,14,1.34,78.12,Facile,Moyen,-1,Plus Difficile,Pas Adapte,Mathematics
597,2015,Mathématiques,1,L'Algèbre Linéaire,5,Determination et Construction d'Applications Lineaires,14,598,12,QCU,0.23,0.54,39.0,28,43,71,58,28,30,1.22,48.28,Difficile,Moyen,1,Plus Facile,Pas Adapte,Mathematics
1721,2016,Mathématiques,1,L'Algèbre Linéaire,5,Determination et Construction d'Applications Lineaires,14,598,12,QROC,0.38,0.38,36.0,27,47,74,47,27,20,1.57,57.45,Moyen,Moyen,0,Meme Difficulté,Pas Adapte,Mathematics
2845,2017,Mathématiques,1,L'Algèbre Linéaire,5,Determination et Construction d'Applications Lineaires,14,598,12,QROC,0.76,0.16,2.0,2,77,79,36,2,34,2.19,5.56,Facile,Difficile,-2,Beaucoup plus Difficile,Pas Adapte,Mathematics
3969,2018,Mathématiques,1,L'Algèbre Linéaire,5,Determination et Construction d'Applications Lineaires,14,598,12,QROC,0.45,0.33,36.0,26,47,73,40,26,14,1.82,65.0,Facile,Moyen,-1,Plus Difficile,Pas Adapte,Mathematics
5093,2019,Mathématiques,1,L'Algèbre Linéaire,5,Determination et Construction d'Applications Lineaires,14,598,12,QROC,0.52,0.32,45.0,32,39,71,61,32,29,1.16,52.46,Difficile,Moyen,1,Plus Facile,Pas Adapte,Mathematics
6217,2020,Mathématiques,1,L'Algèbre Linéaire,5,Determination et Construction d'Applications Lineaires,14,598,12,QROC,0.21,0.36,64.0,44,24,68,45,44,1,1.51,97.78,Facile,Moyen,-1,Plus Difficile,Adapte,Mathematics
598,2015,Mathématiques,1,L'Algèbre Linéaire,5,Determination et Construction d'Applications Lineaires,14,599,13,QROC,0.91,0.21,22.0,4,14,18,11,4,7,1.64,36.36,Moyen,Difficile,-1,Plus Difficile,Pas Adapte,Mathematics
1722,2016,Mathématiques,1,L'Algèbre Linéaire,5,Determination et Construction d'Applications Lineaires,14,599,13,QROC,0.73,0.19,15.0,3,15,18,9,3,6,2.0,33.33,Difficile,Difficile,0,Meme Difficulté,Pas Adapte,Mathematics
2846,2017,Mathématiques,1,L'Algèbre Linéaire,5,Determination et Construction d'Applications Lineaires,14,599,13,QROC,0.46,0.32,60.0,11,7,18,16,11,5,1.12,68.75,Difficile,Moyen,1,Plus Facile,Adapte,Mathematics
3970,2018,Mathématiques,1,L'Algèbre Linéaire,5,Determination et Construction d'Applications Lineaires,14,599,13,QROC,0.35,0.27,60.0,10,7,17,15,10,5,1.13,66.67,Moyen,Moyen,0,Meme Difficulté,Adapte,Mathematics
5094,2019,Mathématiques,1,L'Algèbre Linéaire,5,Determination et Construction d'Applications Lineaires,14,599,13,QROC,0.45,0.26,60.0,9,6,15,10,9,1,1.5,90.0,Moyen,Moyen,0,Meme Difficulté,Adapte,Mathematics
6218,2020,Mathématiques,1,L'Algèbre Linéaire,5,Determination et Construction d'Applications Lineaires,14,599,13,QROC,0.5,0.38,60.0,10,6,16,15,10,5,1.07,66.67,Moyen,Moyen,0,Meme Difficulté,Adapte,Mathematics
599,2015,Mathématiques,1,L'Algèbre Linéaire,5,Determination et Construction d'Applications Lineaires,14,600,14,QCM,0.71,0.24,19.0,6,26,32,14,6,8,2.29,42.86,Moyen,Difficile,-1,Plus Difficile,Pas Adapte,Mathematics
1723,2016,Mathématiques,1,L'Algèbre Linéaire,5,Determination et Construction d'Applications Lineaires,14,600,14,QCM,0.7,0.24,4.0,1,27,28,25,1,24,1.12,4.0,Facile,Difficile,-2,Beaucoup plus Difficile,Pas Adapte,Mathematics
2847,2017,Mathématiques,1,L'Algèbre Linéaire,5,Determination et Construction d'Applications Lineaires,14,600,14,QCM,0.67,0.16,1.0,0,29,29,19,0,19,1.53,0.0,Difficile,Difficile,0,Meme Difficulté,Pas Adapte,Mathematics
3971,2018,Mathématiques,1,L'Algèbre Linéaire,5,Determination et Construction d'Applications Lineaires,14,600,14,QCM,0.78,0.29,27.0,8,20,28,27,8,19,1.04,29.63,Facile,Difficile,-2,Beaucoup plus Difficile,Pas Adapte,Mathematics
5095,2019,Mathématiques,1,L'Algèbre Linéaire,5,Determination et Construction d'Applications Lineaires,14,600,14,QCM,0.77,0.29,26.0,7,20,27,17,7,10,1.59,41.18,Moyen,Difficile,-1,Plus Difficile,Pas Adapte,Mathematics
6219,2020,Mathématiques,1,L'Algèbre Linéaire,5,Determination et Construction d'Applications Lineaires,14,600,14,QCM,0.55,0.19,29.0,7,17,24,12,7,5,2.0,58.33,Difficile,Difficile,0,Meme Difficulté,Pas Adapte,Mathematics
600,2015,Mathématiques,1,L'Algèbre Linéaire,6,"Calcul de Dimensions et Construction de Bases, utilisant de la Dualite",7,601,1,QCM,0.55,0.19,13.0,9,61,70,54,9,45,1.3,16.67,Difficile,Difficile,0,Meme Difficulté,Pas Adapte,Mathematics
1724,2016,Mathématiques,1,L'Algèbre Linéaire,6,"Calcul de Dimensions et Construction de Bases, utilisant de la Dualite",7,601,1,QCM,0.45,0.54,61.0,38,24,62,44,38,6,1.41,86.36,Facile,Moyen,-1,Plus Difficile,Adapte,Mathematics
2848,2017,Mathématiques,1,L'Algèbre Linéaire,6,"Calcul de Dimensions et Construction de Bases, utilisant de la Dualite",7,601,1,QCM,0.49,0.49,61.0,33,21,54,45,33,12,1.2,73.33,Moyen,Moyen,0,Meme Difficulté,Adapte,Mathematics
3972,2018,Mathématiques,1,L'Algèbre Linéaire,6,"Calcul de Dimensions et Construction de Bases, utilisant de la Dualite",7,601,1,QCM,0.41,0.54,61.0,35,23,58,56,35,21,1.04,62.5,Moyen,Moyen,0,Meme Difficulté,Adapte,Mathematics
5096,2019,Mathématiques,1,L'Algèbre Linéaire,6,"Calcul de Dimensions et Construction de Bases, utilisant de la Dualite",7,601,1,QCM,0.21,0.45,61.0,36,23,59,58,36,22,1.02,62.07,Moyen,Moyen,0,Meme Difficulté,Adapte,Mathematics
6220,2020,Mathématiques,1,L'Algèbre Linéaire,6,"Calcul de Dimensions et Construction de Bases, utilisant de la Dualite",7,601,1,QCM,0.48,0.6,61.0,36,23,59,38,36,2,1.55,94.74,Moyen,Moyen,0,Meme Difficulté,Adapte,Mathematics
601,2015,Mathématiques,1,L'Algèbre Linéaire,6,"Calcul de Dimensions et Construction de Bases, utilisant de la Dualite",7,602,2,QCM,0.3,0.51,50.0,24,24,48,45,24,21,1.07,53.33,Difficile,Moyen,1,Plus Facile,Pas Adapte,Mathematics
1725,2016,Mathématiques,1,L'Algèbre Linéaire,6,"Calcul de Dimensions et Construction de Bases, utilisant de la Dualite",7,602,2,QCM,0.45,0.34,36.0,18,31,49,41,18,23,1.2,43.9,Facile,Moyen,-1,Plus Difficile,Pas Adapte,Mathematics
2849,2017,Mathématiques,1,L'Algèbre Linéaire,6,"Calcul de Dimensions et Construction de Bases, utilisant de la Dualite",7,602,2,QCM,0.32,0.63,44.0,23,30,53,36,23,13,1.47,63.89,Difficile,Moyen,1,Plus Facile,Pas Adapte,Mathematics
3973,2018,Mathématiques,1,L'Algèbre Linéaire,6,"Calcul de Dimensions et Construction de Bases, utilisant de la Dualite",7,602,2,QROC,0.41,0.25,50.0,24,24,48,29,24,5,1.66,82.76,Difficile,Moyen,1,Plus Facile,Pas Adapte,Mathematics
5097,2019,Mathématiques,1,L'Algèbre Linéaire,6,"Calcul de Dimensions et Construction de Bases, utilisant de la Dualite",7,602,2,QROC,0.69,0.11,3.0,1,45,46,34,1,33,1.35,2.94,Moyen,Difficile,-1,Plus Difficile,Pas Adapte,Mathematics
6221,2020,Mathématiques,1,L'Algèbre Linéaire,6,"Calcul de Dimensions et Construction de Bases, utilisant de la Dualite",7,602,2,QROC,0.6,0.32,63.0,29,17,46,46,29,17,1.0,63.04,Moyen,Moyen,0,Meme Difficulté,Adapte,Mathematics
602,2015,Mathématiques,1,L'Algèbre Linéaire,6,"Calcul de Dimensions et Construction de Bases, utilisant de la Dualite",7,603,3,QCU,0.54,0.32,17.0,16,79,95,86,16,70,1.1,18.6,Difficile,Difficile,0,Meme Difficulté,Pas Adapte,Mathematics
1726,2016,Mathématiques,1,L'Algèbre Linéaire,6,"Calcul de Dimensions et Construction de Bases, utilisant de la Dualite",7,603,3,QCU,0.37,0.68,48.0,48,53,101,64,48,16,1.58,75.0,Moyen,Moyen,0,Meme Difficulté,Pas Adapte,Mathematics
2850,2017,Mathématiques,1,L'Algèbre Linéaire,6,"Calcul de Dimensions et Construction de Bases, utilisant de la Dualite",7,603,3,QCU,0.59,0.28,26.0,23,64,87,39,23,16,2.23,58.97,Moyen,Difficile,-1,Plus Difficile,Pas Adapte,Mathematics
3974,2018,Mathématiques,1,L'Algèbre Linéaire,6,"Calcul de Dimensions et Construction de Bases, utilisant de la Dualite",7,603,3,QCU,0.56,0.24,7.0,7,89,96,85,7,78,1.13,8.24,Facile,Difficile,-2,Beaucoup plus Difficile,Pas Adapte,Mathematics
5098,2019,Mathématiques,1,L'Algèbre Linéaire,6,"Calcul de Dimensions et Construction de Bases, utilisant de la Dualite",7,603,3,QCU,0.66,0.38,24.0,24,78,102,49,24,25,2.08,48.98,Difficile,Difficile,0,Meme Difficulté,Pas Adapte,Mathematics
6222,2020,Mathématiques,1,L'Algèbre Linéaire,6,"Calcul de Dimensions et Construction de Bases, utilisant de la Dualite",7,603,3,QCM,0.24,0.53,36.0,39,70,109,54,39,15,2.02,72.22,Facile,Moyen,-1,Plus Difficile,Pas Adapte,Mathematics
603,2015,Mathématiques,1,L'Algèbre Linéaire,6,"Calcul de Dimensions et Construction de Bases, utilisant de la Dualite",7,604,4,QCU,0.41,0.24,12.0,5,35,40,33,5,28,1.21,15.15,Facile,Difficile,-2,Beaucoup plus Difficile,Pas Adapte,Mathematics
1727,2016,Mathématiques,1,L'Algèbre Linéaire,6,"Calcul de Dimensions et Construction de Bases, utilisant de la Dualite",7,604,4,QCU,0.27,0.61,42.0,17,24,41,23,17,6,1.78,73.91,Facile,Moyen,-1,Plus Difficile,Pas Adapte,Mathematics
2851,2017,Mathématiques,1,L'Algèbre Linéaire,6,"Calcul de Dimensions et Construction de Bases, utilisant de la Dualite",7,604,4,QCU,0.24,0.44,45.0,19,23,42,41,19,22,1.02,46.34,Facile,Moyen,-1,Plus Difficile,Pas Adapte,Mathematics
3975,2018,Mathématiques,1,L'Algèbre Linéaire,6,"Calcul de Dimensions et Construction de Bases, utilisant de la Dualite",7,604,4,QCM,0.72,0.26,7.0,3,37,40,15,3,12,2.67,20.0,Difficile,Difficile,0,Meme Difficulté,Pas Adapte,Mathematics
5099,2019,Mathématiques,1,L'Algèbre Linéaire,6,"Calcul de Dimensions et Construction de Bases, utilisant de la Dualite",7,604,4,QCM,0.21,0.52,60.0,23,16,39,34,23,11,1.15,67.65,Facile,Moyen,-1,Plus Difficile,Adapte,Mathematics
6223,2020,Mathématiques,1,L'Algèbre Linéaire,6,"Calcul de Dimensions et Construction de Bases, utilisant de la Dualite",7,604,4,QCU,0.37,0.73,60.0,26,18,44,29,26,3,1.52,89.66,Moyen,Moyen,0,Meme Difficulté,Adapte,Mathematics
604,2015,Mathématiques,1,L'Algèbre Linéaire,6,"Calcul de Dimensions et Construction de Bases, utilisant de la Dualite",7,605,5,QCU,0.74,0.3,23.0,20,69,89,40,20,20,2.23,50.0,Difficile,Difficile,0,Meme Difficulté,Pas Adapte,Mathematics
1728,2016,Mathématiques,1,L'Algèbre Linéaire,6,"Calcul de Dimensions et Construction de Bases, utilisant de la Dualite",7,605,5,QCU,0.33,0.73,42.0,37,52,89,75,37,38,1.19,49.33,Difficile,Moyen,1,Plus Facile,Pas Adapte,Mathematics
2852,2017,Mathématiques,1,L'Algèbre Linéaire,6,"Calcul de Dimensions et Construction de Bases, utilisant de la Dualite",7,605,5,QCU,0.54,0.31,6.0,5,71,76,46,5,41,1.65,10.87,Facile,Difficile,-2,Beaucoup plus Difficile,Pas Adapte,Mathematics
3976,2018,Mathématiques,1,L'Algèbre Linéaire,6,"Calcul de Dimensions et Construction de Bases, utilisant de la Dualite",7,605,5,QCU,0.4,0.41,40.0,27,41,68,61,27,34,1.11,44.26,Facile,Moyen,-1,Plus Difficile,Pas Adapte,Mathematics
5100,2019,Mathématiques,1,L'Algèbre Linéaire,6,"Calcul de Dimensions et Construction de Bases, utilisant de la Dualite",7,605,5,QCU,0.65,0.25,5.0,3,56,59,49,3,46,1.2,6.12,Difficile,Difficile,0,Meme Difficulté,Pas Adapte,Mathematics
6224,2020,Mathématiques,1,L'Algèbre Linéaire,6,"Calcul de Dimensions et Construction de Bases, utilisant de la Dualite",7,605,5,QCM,0.23,0.61,49.0,32,34,66,36,32,4,1.83,88.89,Difficile,Moyen,1,Plus Facile,Pas Adapte,Mathematics
605,2015,Mathématiques,1,L'Algèbre Linéaire,6,"Calcul de Dimensions et Construction de Bases, utilisant de la Dualite",7,606,6,QCM,0.37,0.37,53.0,6,5,11,9,6,3,1.22,66.67,Facile,Moyen,-1,Plus Difficile,Pas Adapte,Mathematics
1729,2016,Mathématiques,1,L'Algèbre Linéaire,6,"Calcul de Dimensions et Construction de Bases, utilisant de la Dualite",7,606,6,QCM,0.23,0.46,61.0,7,4,11,10,7,3,1.1,70.0,Moyen,Moyen,0,Meme Difficulté,Adapte,Mathematics
2853,2017,Mathématiques,1,L'Algèbre Linéaire,6,"Calcul de Dimensions et Construction de Bases, utilisant de la Dualite",7,606,6,QCU,0.33,0.57,61.0,8,5,13,13,8,5,1.0,61.54,Moyen,Moyen,0,Meme Difficulté,Adapte,Mathematics
3977,2018,Mathématiques,1,L'Algèbre Linéaire,6,"Calcul de Dimensions et Construction de Bases, utilisant de la Dualite",7,606,6,QCM,0.29,0.58,61.0,7,4,11,8,7,1,1.38,87.5,Moyen,Moyen,0,Meme Difficulté,Adapte,Mathematics
5101,2019,Mathématiques,1,L'Algèbre Linéaire,6,"Calcul de Dimensions et Construction de Bases, utilisant de la Dualite",7,606,6,QCM,0.37,0.49,61.0,6,4,10,7,6,1,1.43,85.71,Moyen,Moyen,0,Meme Difficulté,Adapte,Mathematics
6225,2020,Mathématiques,1,L'Algèbre Linéaire,6,"Calcul de Dimensions et Construction de Bases, utilisant de la Dualite",7,606,6,QCM,0.33,0.56,61.0,5,4,9,8,5,3,1.12,62.5,Moyen,Moyen,0,Meme Difficulté,Adapte,Mathematics
606,2015,Mathématiques,1,L'Algèbre Linéaire,6,"Calcul de Dimensions et Construction de Bases, utilisant de la Dualite",7,607,7,QCU,0.32,0.48,40.0,3,4,7,6,3,3,1.17,50.0,Facile,Moyen,-1,Plus Difficile,Pas Adapte,Mathematics
1730,2016,Mathématiques,1,L'Algèbre Linéaire,6,"Calcul de Dimensions et Construction de Bases, utilisant de la Dualite",7,607,7,QCM,0.77,0.27,23.0,1,5,6,4,1,3,1.5,25.0,Difficile,Difficile,0,Meme Difficulté,Pas Adapte,Mathematics
2854,2017,Mathématiques,1,L'Algèbre Linéaire,6,"Calcul de Dimensions et Construction de Bases, utilisant de la Dualite",7,607,7,QCM,0.22,0.32,55.0,3,2,5,3,3,0,1.67,100.0,Moyen,Moyen,0,Meme Difficulté,Pas Adapte,Mathematics
3978,2018,Mathématiques,1,L'Algèbre Linéaire,6,"Calcul de Dimensions et Construction de Bases, utilisant de la Dualite",7,607,7,QCM,0.31,0.38,40.0,2,4,6,3,2,1,2.0,66.67,Moyen,Moyen,0,Meme Difficulté,Pas Adapte,Mathematics
5102,2019,Mathématiques,1,L'Algèbre Linéaire,6,"Calcul de Dimensions et Construction de Bases, utilisant de la Dualite",7,607,7,QCM,0.31,0.31,40.0,2,4,6,2,2,0,3.0,100.0,Facile,Moyen,-1,Plus Difficile,Pas Adapte,Mathematics
6226,2020,Mathématiques,1,L'Algèbre Linéaire,6,"Calcul de Dimensions et Construction de Bases, utilisant de la Dualite",7,607,7,QCM,0.61,0.3,14.0,1,5,6,5,1,4,1.2,20.0,Moyen,Difficile,-1,Plus Difficile,Pas Adapte,Mathematics
607,2015,Mathématiques,2,Le Calcul d'Intégrale,1,Les Divers Types d'Integrale,9,608,1,QCU,0.36,0.48,61.0,34,22,56,43,34,9,1.3,79.07,Difficile,Moyen,1,Plus Facile,Adapte,Mathematics
1731,2016,Mathématiques,2,Le Calcul d'Intégrale,1,Les Divers Types d'Integrale,9,608,1,QROC,0.49,0.31,61.0,39,25,64,43,39,4,1.49,90.7,Moyen,Moyen,0,Meme Difficulté,Adapte,Mathematics
2855,2017,Mathématiques,2,Le Calcul d'Intégrale,1,Les Divers Types d'Integrale,9,608,1,QROC,0.26,0.35,61.0,36,23,59,56,36,20,1.05,64.29,Moyen,Moyen,0,Meme Difficulté,Adapte,Mathematics
3979,2018,Mathématiques,2,Le Calcul d'Intégrale,1,Les Divers Types d'Integrale,9,608,1,QROC,0.46,0.31,61.0,36,23,59,46,36,10,1.28,78.26,Moyen,Moyen,0,Meme Difficulté,Adapte,Mathematics
5103,2019,Mathématiques,2,Le Calcul d'Intégrale,1,Les Divers Types d'Integrale,9,608,1,QROC,0.47,0.4,61.0,34,22,56,35,34,1,1.6,97.14,Moyen,Moyen,0,Meme Difficulté,Adapte,Mathematics
6227,2020,Mathématiques,2,Le Calcul d'Intégrale,1,Les Divers Types d'Integrale,9,608,1,QO,0.62,0.29,61.0,36,23,59,41,36,5,1.44,87.8,Moyen,Moyen,0,Meme Difficulté,Adapte,Mathematics
608,2015,Mathématiques,2,Le Calcul d'Intégrale,1,Les Divers Types d'Integrale,9,609,2,QCM,0.76,0.19,9.0,4,35,39,10,4,6,3.9,40.0,Moyen,Difficile,-1,Plus Difficile,Pas Adapte,Mathematics
1732,2016,Mathématiques,2,Le Calcul d'Intégrale,1,Les Divers Types d'Integrale,9,609,2,QCM,0.73,0.17,6.0,2,36,38,28,2,26,1.36,7.14,Facile,Difficile,-2,Beaucoup plus Difficile,Pas Adapte,Mathematics
2856,2017,Mathématiques,2,Le Calcul d'Intégrale,1,Les Divers Types d'Integrale,9,609,2,QCM,0.2,0.67,40.0,14,22,36,16,14,2,2.25,87.5,Facile,Moyen,-1,Plus Difficile,Pas Adapte,Mathematics
3980,2018,Mathématiques,2,Le Calcul d'Intégrale,1,Les Divers Types d'Integrale,9,609,2,QCM,0.65,0.26,6.0,2,39,41,41,2,39,1.0,4.88,Difficile,Difficile,0,Meme Difficulté,Pas Adapte,Mathematics
5104,2019,Mathématiques,2,Le Calcul d'Intégrale,1,Les Divers Types d'Integrale,9,609,2,QCU,0.5,0.4,31.0,14,32,46,29,14,15,1.59,48.28,Facile,Difficile,-2,Beaucoup plus Difficile,Pas Adapte,Mathematics
6228,2020,Mathématiques,2,Le Calcul d'Intégrale,1,Les Divers Types d'Integrale,9,609,2,QO,0.21,0.2,64.0,29,16,45,43,29,14,1.05,67.44,Facile,Moyen,-1,Plus Difficile,Adapte,Mathematics
609,2015,Mathématiques,2,Le Calcul d'Intégrale,1,Les Divers Types d'Integrale,9,610,3,QCU,0.63,0.34,25.0,18,55,73,30,18,12,2.43,60.0,Facile,Difficile,-2,Beaucoup plus Difficile,Pas Adapte,Mathematics
1733,2016,Mathématiques,2,Le Calcul d'Intégrale,1,Les Divers Types d'Integrale,9,610,3,QCU,0.29,0.66,46.0,37,44,81,61,37,24,1.33,60.66,Facile,Moyen,-1,Plus Difficile,Pas Adapte,Mathematics
2857,2017,Mathématiques,2,Le Calcul d'Intégrale,1,Les Divers Types d'Integrale,9,610,3,QCU,0.39,0.47,64.0,48,27,75,63,48,15,1.19,76.19,Difficile,Moyen,1,Plus Facile,Adapte,Mathematics
3981,2018,Mathématiques,2,Le Calcul d'Intégrale,1,Les Divers Types d'Integrale,9,610,3,QCU,0.21,0.7,64.0,43,24,67,45,43,2,1.49,95.56,Moyen,Moyen,0,Meme Difficulté,Adapte,Mathematics
5105,2019,Mathématiques,2,Le Calcul d'Intégrale,1,Les Divers Types d'Integrale,9,610,3,QCU,0.36,0.46,64.0,39,22,61,55,39,16,1.11,70.91,Moyen,Moyen,0,Meme Difficulté,Adapte,Mathematics
6229,2020,Mathématiques,2,Le Calcul d'Intégrale,1,Les Divers Types d'Integrale,9,610,3,QCU,0.28,0.49,64.0,43,24,67,56,43,13,1.2,76.79,Moyen,Moyen,0,Meme Difficulté,Adapte,Mathematics
610,2015,Mathématiques,2,Le Calcul d'Intégrale,1,Les Divers Types d'Integrale,9,611,4,QCM,0.67,0.3,12.0,4,28,32,19,4,15,1.68,21.05,Moyen,Difficile,-1,Plus Difficile,Pas Adapte,Mathematics
1734,2016,Mathématiques,2,Le Calcul d'Intégrale,1,Les Divers Types d'Integrale,9,611,4,QCM,0.39,0.3,47.0,13,15,28,25,13,12,1.12,52.0,Difficile,Moyen,1,Plus Facile,Pas Adapte,Mathematics
2858,2017,Mathématiques,2,Le Calcul d'Intégrale,1,Les Divers Types d'Integrale,9,611,4,QCM,0.34,0.62,37.0,9,16,25,23,9,14,1.09,39.13,Moyen,Moyen,0,Meme Difficulté,Pas Adapte,Mathematics
3982,2018,Mathématiques,2,Le Calcul d'Intégrale,1,Les Divers Types d'Integrale,9,611,4,QCU,0.27,0.74,63.0,15,9,24,19,15,4,1.26,78.95,Facile,Moyen,-1,Plus Difficile,Adapte,Mathematics
5106,2019,Mathématiques,2,Le Calcul d'Intégrale,1,Les Divers Types d'Integrale,9,611,4,QCU,0.26,0.61,63.0,18,10,28,19,18,1,1.47,94.74,Moyen,Moyen,0,Meme Difficulté,Adapte,Mathematics
6230,2020,Mathématiques,2,Le Calcul d'Intégrale,1,Les Divers Types d'Integrale,9,611,4,QROC,0.42,0.37,63.0,20,11,31,27,20,7,1.15,74.07,Moyen,Moyen,0,Meme Difficulté,Adapte,Mathematics
611,2015,Mathématiques,2,Le Calcul d'Intégrale,1,Les Divers Types d'Integrale,9,612,5,QO,0.78,0.14,6.0,4,60,64,42,4,38,1.52,9.52,Difficile,Difficile,0,Meme Difficulté,Pas Adapte,Mathematics
1735,2016,Mathématiques,2,Le Calcul d'Intégrale,1,Les Divers Types d'Integrale,9,612,5,QO,0.88,0.04,24.0,14,44,58,43,14,29,1.35,32.56,Difficile,Difficile,0,Meme Difficulté,Pas Adapte,Mathematics
2859,2017,Mathématiques,2,Le Calcul d'Intégrale,1,Les Divers Types d'Integrale,9,612,5,QO,0.72,0.24,52.0,29,27,56,44,29,15,1.27,65.91,Facile,Moyen,-1,Plus Difficile,Pas Adapte,Mathematics
3983,2018,Mathématiques,2,Le Calcul d'Intégrale,1,Les Divers Types d'Integrale,9,612,5,QO,0.9,0.11,15.0,9,49,58,39,9,30,1.49,23.08,Facile,Difficile,-2,Beaucoup plus Difficile,Pas Adapte,Mathematics
5107,2019,Mathématiques,2,Le Calcul d'Intégrale,1,Les Divers Types d'Integrale,9,612,5,QROC,0.78,0.15,4.0,2,56,58,31,2,29,1.87,6.45,Moyen,Difficile,-1,Plus Difficile,Pas Adapte,Mathematics
6231,2020,Mathématiques,2,Le Calcul d'Intégrale,1,Les Divers Types d'Integrale,9,612,5,QROC,0.46,0.38,38.0,21,33,54,35,21,14,1.54,60.0,Facile,Moyen,-1,Plus Difficile,Pas Adapte,Mathematics
612,2015,Mathématiques,2,Le Calcul d'Intégrale,1,Les Divers Types d'Integrale,9,613,6,QCM,0.67,0.17,16.0,10,50,60,28,10,18,2.14,35.71,Moyen,Difficile,-1,Plus Difficile,Pas Adapte,Mathematics
1736,2016,Mathématiques,2,Le Calcul d'Intégrale,1,Les Divers Types d'Integrale,9,613,6,QCM,0.43,0.49,63.0,40,24,64,53,40,13,1.21,75.47,Facile,Moyen,-1,Plus Difficile,Adapte,Mathematics
2860,2017,Mathématiques,2,Le Calcul d'Intégrale,1,Les Divers Types d'Integrale,9,613,6,QCM,0.26,0.66,63.0,45,27,72,49,45,4,1.47,91.84,Moyen,Moyen,0,Meme Difficulté,Adapte,Mathematics
3984,2018,Mathématiques,2,Le Calcul d'Intégrale,1,Les Divers Types d'Integrale,9,613,6,QCM,0.38,0.65,63.0,49,29,78,67,49,18,1.16,73.13,Moyen,Moyen,0,Meme Difficulté,Adapte,Mathematics
5108,2019,Mathématiques,2,Le Calcul d'Intégrale,1,Les Divers Types d'Integrale,9,613,6,QCM,0.29,0.41,63.0,43,26,69,66,43,23,1.05,65.15,Moyen,Moyen,0,Meme Difficulté,Adapte,Mathematics
6232,2020,Mathématiques,2,Le Calcul d'Intégrale,1,Les Divers Types d'Integrale,9,613,6,QCM,0.34,0.51,63.0,37,22,59,56,37,19,1.05,66.07,Moyen,Moyen,0,Meme Difficulté,Adapte,Mathematics
613,2015,Mathématiques,2,Le Calcul d'Intégrale,1,Les Divers Types d'Integrale,9,614,7,QCM,0.46,0.58,57.0,10,8,18,17,10,7,1.06,58.82,Facile,Moyen,-1,Plus Difficile,Pas Adapte,Mathematics
1737,2016,Mathématiques,2,Le Calcul d'Intégrale,1,Les Divers Types d'Integrale,9,614,7,QCM,0.52,0.25,26.0,5,15,20,13,5,8,1.54,38.46,Difficile,Difficile,0,Meme Difficulté,Pas Adapte,Mathematics
2861,2017,Mathématiques,2,Le Calcul d'Intégrale,1,Les Divers Types d'Integrale,9,614,7,QCM,0.56,0.25,4.0,1,22,23,13,1,12,1.77,7.69,Facile,Difficile,-2,Beaucoup plus Difficile,Pas Adapte,Mathematics
3985,2018,Mathématiques,2,Le Calcul d'Intégrale,1,Les Divers Types d'Integrale,9,614,7,QROC,0.56,0.32,57.0,13,9,22,13,13,0,1.69,100.0,Facile,Moyen,-1,Plus Difficile,Pas Adapte,Mathematics
5109,2019,Mathématiques,2,Le Calcul d'Intégrale,1,Les Divers Types d'Integrale,9,614,7,QROC,0.51,0.28,48.0,10,11,21,14,10,4,1.5,71.43,Facile,Moyen,-1,Plus Difficile,Pas Adapte,Mathematics
6233,2020,Mathématiques,2,Le Calcul d'Intégrale,1,Les Divers Types d'Integrale,9,614,7,QROC,0.68,0.18,24.0,5,17,22,11,5,6,2.0,45.45,Difficile,Difficile,0,Meme Difficulté,Pas Adapte,Mathematics
614,2015,Mathématiques,2,Le Calcul d'Intégrale,1,Les Divers Types d'Integrale,9,615,8,QROC,0.47,0.3,57.0,7,6,13,9,7,2,1.44,77.78,Facile,Moyen,-1,Plus Difficile,Pas Adapte,Mathematics
1738,2016,Mathématiques,2,Le Calcul d'Intégrale,1,Les Divers Types d'Integrale,9,615,8,QROC,0.9,0.06,17.0,2,11,13,7,2,5,1.86,28.57,Moyen,Difficile,-1,Plus Difficile,Pas Adapte,Mathematics
2862,2017,Mathématiques,2,Le Calcul d'Intégrale,1,Les Divers Types d'Integrale,9,615,8,QROC,0.35,0.36,62.0,7,4,11,8,7,1,1.38,87.5,Difficile,Moyen,1,Plus Facile,Adapte,Mathematics
3986,2018,Mathématiques,2,Le Calcul d'Intégrale,1,Les Divers Types d'Integrale,9,615,8,QROC,0.39,0.36,62.0,7,4,11,8,7,1,1.38,87.5,Moyen,Moyen,0,Meme Difficulté,Adapte,Mathematics
5110,2019,Mathématiques,2,Le Calcul d'Intégrale,1,Les Divers Types d'Integrale,9,615,8,QROC,0.3,0.27,62.0,7,4,11,8,7,1,1.38,87.5,Moyen,Moyen,0,Meme Difficulté,Adapte,Mathematics
6234,2020,Mathématiques,2,Le Calcul d'Intégrale,1,Les Divers Types d'Integrale,9,615,8,QROC,0.55,0.29,62.0,8,5,13,12,8,4,1.08,66.67,Moyen,Moyen,0,Meme Difficulté,Adapte,Mathematics
615,2015,Mathématiques,2,Le Calcul d'Intégrale,1,Les Divers Types d'Integrale,9,616,9,QROC,0.35,0.34,60.0,53,35,88,86,53,33,1.02,61.63,Facile,Moyen,-1,Plus Difficile,Adapte,Mathematics
1739,2016,Mathématiques,2,Le Calcul d'Intégrale,1,Les Divers Types d'Integrale,9,616,9,QROC,0.57,0.37,60.0,58,38,96,62,58,4,1.55,93.55,Moyen,Moyen,0,Meme Difficulté,Adapte,Mathematics
2863,2017,Mathématiques,2,Le Calcul d'Intégrale,1,Les Divers Types d'Integrale,9,616,9,QROC,0.4,0.28,60.0,54,36,90,74,54,20,1.22,72.97,Moyen,Moyen,0,Meme Difficulté,Adapte,Mathematics
3987,2018,Mathématiques,2,Le Calcul d'Intégrale,1,Les Divers Types d'Integrale,9,616,9,QROC,0.25,0.34,60.0,50,33,83,78,50,28,1.06,64.1,Moyen,Moyen,0,Meme Difficulté,Adapte,Mathematics
5111,2019,Mathématiques,2,Le Calcul d'Intégrale,1,Les Divers Types d'Integrale,9,616,9,QROC,0.59,0.29,60.0,56,38,94,63,56,7,1.49,88.89,Moyen,Moyen,0,Meme Difficulté,Adapte,Mathematics
6235,2020,Mathématiques,2,Le Calcul d'Intégrale,1,Les Divers Types d'Integrale,9,616,9,QROC,0.39,0.35,60.0,52,34,86,82,52,30,1.05,63.41,Moyen,Moyen,0,Meme Difficulté,Adapte,Mathematics
616,2015,Mathématiques,2,Le Calcul d'Intégrale,2,Les Methodes Generales d'Integration,7,617,1,QCU,0.4,0.53,44.0,20,26,46,28,20,8,1.64,71.43,Facile,Moyen,-1,Plus Difficile,Pas Adapte,Mathematics
1740,2016,Mathématiques,2,Le Calcul d'Intégrale,2,Les Methodes Generales d'Integration,7,617,1,QCM,0.8,0.28,34.0,14,26,40,30,14,16,1.33,46.67,Difficile,Difficile,0,Meme Difficulté,Pas Adapte,Mathematics
2864,2017,Mathématiques,2,Le Calcul d'Intégrale,2,Les Methodes Generales d'Integration,7,617,1,QCM,0.52,0.27,22.0,9,30,39,15,9,6,2.6,60.0,Facile,Difficile,-2,Beaucoup plus Difficile,Pas Adapte,Mathematics
3988,2018,Mathématiques,2,Le Calcul d'Intégrale,2,Les Methodes Generales d'Integration,7,617,1,QCM,0.59,0.15,19.0,6,27,33,26,6,20,1.27,23.08,Difficile,Difficile,0,Meme Difficulté,Pas Adapte,Mathematics
5112,2019,Mathématiques,2,Le Calcul d'Intégrale,2,Les Methodes Generales d'Integration,7,617,1,QCM,0.7,0.25,6.0,2,36,38,27,2,25,1.41,7.41,Difficile,Difficile,0,Meme Difficulté,Pas Adapte,Mathematics
6236,2020,Mathématiques,2,Le Calcul d'Intégrale,2,Les Methodes Generales d'Integration,7,617,1,QCM,0.53,0.19,23.0,10,34,44,22,10,12,2.0,45.45,Facile,Difficile,-2,Beaucoup plus Difficile,Pas Adapte,Mathematics
617,2015,Mathématiques,2,Le Calcul d'Intégrale,2,Les Methodes Generales d'Integration,7,618,2,QCU,0.75,0.35,28.0,12,32,44,21,12,9,2.1,57.14,Moyen,Difficile,-1,Plus Difficile,Pas Adapte,Mathematics
1741,2016,Mathématiques,2,Le Calcul d'Intégrale,2,Les Methodes Generales d'Integration,7,618,2,QCU,0.29,0.54,52.0,20,19,39,28,20,8,1.39,71.43,Moyen,Moyen,0,Meme Difficulté,Pas Adapte,Mathematics
2865,2017,Mathématiques,2,Le Calcul d'Intégrale,2,Les Methodes Generales d'Integration,7,618,2,QCU,0.54,0.36,4.0,2,41,43,17,2,15,2.53,11.76,Difficile,Difficile,0,Meme Difficulté,Pas Adapte,Mathematics
3989,2018,Mathématiques,2,Le Calcul d'Intégrale,2,Les Methodes Generales d'Integration,7,618,2,QCU,0.24,0.72,43.0,16,21,37,24,16,8,1.54,66.67,Facile,Moyen,-1,Plus Difficile,Pas Adapte,Mathematics
5113,2019,Mathématiques,2,Le Calcul d'Intégrale,2,Les Methodes Generales d'Integration,7,618,2,QCU,0.38,0.51,41.0,14,19,33,30,14,16,1.1,46.67,Difficile,Moyen,1,Plus Facile,Pas Adapte,Mathematics
6237,2020,Mathématiques,2,Le Calcul d'Intégrale,2,Les Methodes Generales d'Integration,7,618,2,QCU,0.26,0.72,50.0,15,15,30,21,15,6,1.43,71.43,Facile,Moyen,-1,Plus Difficile,Pas Adapte,Mathematics
618,2015,Mathématiques,2,Le Calcul d'Intégrale,2,Les Methodes Generales d'Integration,7,619,3,QCU,0.64,0.25,7.0,6,82,88,47,6,41,1.87,12.77,Difficile,Difficile,0,Meme Difficulté,Pas Adapte,Mathematics
1742,2016,Mathématiques,2,Le Calcul d'Intégrale,2,Les Methodes Generales d'Integration,7,619,3,QCU,0.01,0.81,65.0,54,29,83,81,54,27,1.02,66.67,Difficile,Facile,2,Beaucoup plus Facile,Adapte,Mathematics
2866,2017,Mathématiques,2,Le Calcul d'Intégrale,2,Les Methodes Generales d'Integration,7,619,3,QCU,0.1,0.93,65.0,58,31,89,89,58,31,1.0,65.17,Facile,Facile,0,Meme Difficulté,Adapte,Mathematics
3990,2018,Mathématiques,2,Le Calcul d'Intégrale,2,Les Methodes Generales d'Integration,7,619,3,QROC,0.07,0.84,65.0,61,33,94,76,61,15,1.24,80.26,Facile,Facile,0,Meme Difficulté,Adapte,Mathematics
5114,2019,Mathématiques,2,Le Calcul d'Intégrale,2,Les Methodes Generales d'Integration,7,619,3,QROC,0.04,0.9,65.0,58,32,90,78,58,20,1.15,74.36,Facile,Facile,0,Meme Difficulté,Adapte,Mathematics
6238,2020,Mathématiques,2,Le Calcul d'Intégrale,2,Les Methodes Generales d'Integration,7,619,3,QROC,0.07,0.61,65.0,63,34,97,90,63,27,1.08,70.0,Facile,Facile,0,Meme Difficulté,Adapte,Mathematics
619,2015,Mathématiques,2,Le Calcul d'Intégrale,2,Les Methodes Generales d'Integration,7,620,4,QCM,0.37,0.63,51.0,25,24,49,32,25,7,1.53,78.12,Facile,Moyen,-1,Plus Difficile,Pas Adapte,Mathematics
1743,2016,Mathématiques,2,Le Calcul d'Intégrale,2,Les Methodes Generales d'Integration,7,620,4,QCM,0.76,0.21,22.0,10,37,47,26,10,16,1.81,38.46,Facile,Difficile,-2,Beaucoup plus Difficile,Pas Adapte,Mathematics
2867,2017,Mathématiques,2,Le Calcul d'Intégrale,2,Les Methodes Generales d'Integration,7,620,4,QCM,0.48,0.45,39.0,16,24,40,25,16,9,1.6,64.0,Difficile,Moyen,1,Plus Facile,Pas Adapte,Mathematics
3991,2018,Mathématiques,2,Le Calcul d'Intégrale,2,Les Methodes Generales d'Integration,7,620,4,QCM,0.68,0.21,3.0,1,34,35,25,1,24,1.4,4.0,Moyen,Difficile,-1,Plus Difficile,Pas Adapte,Mathematics
5115,2019,Mathématiques,2,Le Calcul d'Intégrale,2,Les Methodes Generales d'Integration,7,620,4,QCM,0.75,0.24,11.0,3,28,31,19,3,16,1.63,15.79,Facile,Difficile,-2,Beaucoup plus Difficile,Pas Adapte,Mathematics
6239,2020,Mathématiques,2,Le Calcul d'Intégrale,2,Les Methodes Generales d'Integration,7,620,4,QCU,0.55,0.28,32.0,9,18,27,22,9,13,1.23,40.91,Facile,Difficile,-2,Beaucoup plus Difficile,Pas Adapte,Mathematics
620,2015,Mathématiques,2,Le Calcul d'Intégrale,2,Les Methodes Generales d'Integration,7,621,5,QCU,0.25,0.72,46.0,11,13,24,18,11,7,1.33,61.11,Facile,Moyen,-1,Plus Difficile,Pas Adapte,Mathematics
1744,2016,Mathématiques,2,Le Calcul d'Intégrale,2,Les Methodes Generales d'Integration,7,621,5,QCU,0.36,0.74,53.0,13,11,24,24,13,11,1.0,54.17,Facile,Moyen,-1,Plus Difficile,Pas Adapte,Mathematics
2868,2017,Mathématiques,2,Le Calcul d'Intégrale,2,Les Methodes Generales d'Integration,7,621,5,QCU,0.44,0.3,31.0,9,19,28,23,9,14,1.22,39.13,Facile,Difficile,-2,Beaucoup plus Difficile,Pas Adapte,Mathematics
3992,2018,Mathématiques,2,Le Calcul d'Intégrale,2,Les Methodes Generales d'Integration,7,621,5,QCU,0.3,0.67,64.0,20,11,31,29,20,9,1.07,68.97,Moyen,Moyen,0,Meme Difficulté,Adapte,Mathematics
5116,2019,Mathématiques,2,Le Calcul d'Intégrale,2,Les Methodes Generales d'Integration,7,621,5,QCU,0.24,0.49,64.0,18,10,28,22,18,4,1.27,81.82,Moyen,Moyen,0,Meme Difficulté,Adapte,Mathematics
6240,2020,Mathématiques,2,Le Calcul d'Intégrale,2,Les Methodes Generales d'Integration,7,621,5,QCU,0.29,0.42,64.0,16,9,25,19,16,3,1.32,84.21,Moyen,Moyen,0,Meme Difficulté,Adapte,Mathematics
621,2015,Mathématiques,2,Le Calcul d'Intégrale,2,Les Methodes Generales d'Integration,7,622,6,QROC,0.34,0.32,37.0,6,10,16,14,6,8,1.14,42.86,Difficile,Moyen,1,Plus Facile,Pas Adapte,Mathematics
1745,2016,Mathématiques,2,Le Calcul d'Intégrale,2,Les Methodes Generales d'Integration,7,622,6,QROC,0.9,0.07,4.0,1,16,17,16,1,15,1.06,6.25,Difficile,Difficile,0,Meme Difficulté,Pas Adapte,Mathematics
2869,2017,Mathématiques,2,Le Calcul d'Intégrale,2,Les Methodes Generales d'Integration,7,622,6,QROC,0.97,0.17,27.0,5,14,19,12,5,7,1.58,41.67,Difficile,Difficile,0,Meme Difficulté,Pas Adapte,Mathematics
3993,2018,Mathématiques,2,Le Calcul d'Intégrale,2,Les Methodes Generales d'Integration,7,622,6,QROC,0.6,0.37,44.0,9,12,21,17,9,8,1.24,52.94,Facile,Moyen,-1,Plus Difficile,Pas Adapte,Mathematics
5117,2019,Mathématiques,2,Le Calcul d'Intégrale,2,Les Methodes Generales d'Integration,7,622,6,QROC,0.85,0.03,8.0,2,21,23,11,2,9,2.09,18.18,Moyen,Difficile,-1,Plus Difficile,Pas Adapte,Mathematics
6241,2020,Mathématiques,2,Le Calcul d'Intégrale,2,Les Methodes Generales d'Integration,7,622,6,QROC,0.53,0.28,37.0,10,16,26,22,10,12,1.18,45.45,Facile,Moyen,-1,Plus Difficile,Pas Adapte,Mathematics
622,2015,Mathématiques,2,Le Calcul d'Intégrale,2,Les Methodes Generales d'Integration,7,623,7,QCU,0.66,0.23,8.0,0,5,5,4,0,4,1.25,0.0,Facile,Difficile,-2,Beaucoup plus Difficile,Pas Adapte,Mathematics
1746,2016,Mathématiques,2,Le Calcul d'Intégrale,2,Les Methodes Generales d'Integration,7,623,7,QCU,0.26,0.58,43.0,2,3,5,3,2,1,1.67,66.67,Facile,Moyen,-1,Plus Difficile,Pas Adapte,Mathematics
2870,2017,Mathématiques,2,Le Calcul d'Intégrale,2,Les Methodes Generales d'Integration,7,623,7,QCU,0.65,0.39,10.0,0,5,5,5,0,5,1.0,0.0,Moyen,Difficile,-1,Plus Difficile,Pas Adapte,Mathematics
3994,2018,Mathématiques,2,Le Calcul d'Intégrale,2,Les Methodes Generales d'Integration,7,623,7,QCU,0.36,0.7,57.0,3,3,6,5,3,2,1.2,60.0,Facile,Moyen,-1,Plus Difficile,Pas Adapte,Mathematics
5118,2019,Mathématiques,2,Le Calcul d'Intégrale,2,Les Methodes Generales d'Integration,7,623,7,QCU,0.48,0.28,19.0,1,4,5,2,1,1,2.5,50.0,Moyen,Difficile,-1,Plus Difficile,Pas Adapte,Mathematics
6242,2020,Mathématiques,2,Le Calcul d'Intégrale,2,Les Methodes Generales d'Integration,7,623,7,QCU,0.37,0.55,49.0,3,3,6,4,3,1,1.5,75.0,Facile,Moyen,-1,Plus Difficile,Pas Adapte,Mathematics
623,2015,Mathématiques,2,Le Calcul d'Intégrale,3,Integration des Fractions Rationnelles,6,624,1,QCM,0.33,0.66,42.0,34,47,81,61,34,27,1.33,55.74,Moyen,Moyen,0,Meme Difficulté,Pas Adapte,Mathematics
1747,2016,Mathématiques,2,Le Calcul d'Intégrale,3,Integration des Fractions Rationnelles,6,624,1,QCM,0.4,0.58,51.0,45,44,89,87,45,42,1.02,51.72,Facile,Moyen,-1,Plus Difficile,Pas Adapte,Mathematics
2871,2017,Mathématiques,2,Le Calcul d'Intégrale,3,Integration des Fractions Rationnelles,6,624,1,QCU,0.39,0.41,55.0,56,45,101,63,56,7,1.6,88.89,Difficile,Moyen,1,Plus Facile,Pas Adapte,Mathematics
3995,2018,Mathématiques,2,Le Calcul d'Intégrale,3,Integration des Fractions Rationnelles,6,624,1,QCU,0.26,0.46,61.0,67,43,110,86,67,19,1.28,77.91,Facile,Moyen,-1,Plus Difficile,Adapte,Mathematics
5119,2019,Mathématiques,2,Le Calcul d'Intégrale,3,Integration des Fractions Rationnelles,6,624,1,QCU,0.3,0.68,61.0,76,49,125,97,76,21,1.29,78.35,Moyen,Moyen,0,Meme Difficulté,Adapte,Mathematics
6243,2020,Mathématiques,2,Le Calcul d'Intégrale,3,Integration des Fractions Rationnelles,6,624,1,QCU,0.22,0.68,61.0,74,48,122,98,74,24,1.24,75.51,Moyen,Moyen,0,Meme Difficulté,Adapte,Mathematics
624,2015,Mathématiques,2,Le Calcul d'Intégrale,3,Integration des Fractions Rationnelles,6,625,2,QCM,0.25,0.53,47.0,23,25,48,25,23,2,1.92,92.0,Facile,Moyen,-1,Plus Difficile,Pas Adapte,Mathematics
1748,2016,Mathématiques,2,Le Calcul d'Intégrale,3,Integration des Fractions Rationnelles,6,625,2,QROC,0.98,0.06,2.0,1,53,54,40,1,39,1.35,2.5,Difficile,Difficile,0,Meme Difficulté,Pas Adapte,Mathematics
2872,2017,Mathématiques,2,Le Calcul d'Intégrale,3,Integration des Fractions Rationnelles,6,625,2,QROC,0.29,0.26,55.0,29,23,52,34,29,5,1.53,85.29,Difficile,Moyen,1,Plus Facile,Pas Adapte,Mathematics
3996,2018,Mathématiques,2,Le Calcul d'Intégrale,3,Integration des Fractions Rationnelles,6,625,2,QROC,0.46,0.34,50.0,29,29,58,42,29,13,1.38,69.05,Facile,Moyen,-1,Plus Difficile,Pas Adapte,Mathematics
5120,2019,Mathématiques,2,Le Calcul d'Intégrale,3,Integration des Fractions Rationnelles,6,625,2,QROC,0.63,0.04,34.0,21,41,62,26,21,5,2.38,80.77,Moyen,Difficile,-1,Plus Difficile,Pas Adapte,Mathematics
6244,2020,Mathématiques,2,Le Calcul d'Intégrale,3,Integration des Fractions Rationnelles,6,625,2,QO,0.76,0.1,15.0,8,45,53,52,8,44,1.02,15.38,Difficile,Difficile,0,Meme Difficulté,Pas Adapte,Mathematics
625,2015,Mathématiques,2,Le Calcul d'Intégrale,3,Integration des Fractions Rationnelles,6,626,3,QCU,0.56,0.35,6.0,3,54,57,44,3,41,1.3,6.82,Facile,Difficile,-2,Beaucoup plus Difficile,Pas Adapte,Mathematics
1749,2016,Mathématiques,2,Le Calcul d'Intégrale,3,Integration des Fractions Rationnelles,6,626,3,QCU,0.54,0.24,20.0,11,44,55,37,11,26,1.49,29.73,Moyen,Difficile,-1,Plus Difficile,Pas Adapte,Mathematics
2873,2017,Mathématiques,2,Le Calcul d'Intégrale,3,Integration des Fractions Rationnelles,6,626,3,QCU,0.35,0.66,55.0,30,24,54,46,30,16,1.17,65.22,Facile,Moyen,-1,Plus Difficile,Pas Adapte,Mathematics
3997,2018,Mathématiques,2,Le Calcul d'Intégrale,3,Integration des Fractions Rationnelles,6,626,3,QCU,0.6,0.37,30.0,14,33,47,44,14,30,1.07,31.82,Moyen,Difficile,-1,Plus Difficile,Pas Adapte,Mathematics
5121,2019,Mathématiques,2,Le Calcul d'Intégrale,3,Integration des Fractions Rationnelles,6,626,3,QCU,0.34,0.48,38.0,16,25,41,35,16,19,1.17,45.71,Moyen,Moyen,0,Meme Difficulté,Pas Adapte,Mathematics
6245,2020,Mathématiques,2,Le Calcul d'Intégrale,3,Integration des Fractions Rationnelles,6,626,3,QCU,0.35,0.46,64.0,26,14,40,38,26,12,1.05,68.42,Difficile,Moyen,1,Plus Facile,Adapte,Mathematics
626,2015,Mathématiques,2,Le Calcul d'Intégrale,3,Integration des Fractions Rationnelles,6,627,4,QCM,0.32,0.43,41.0,4,5,9,6,4,2,1.5,66.67,Moyen,Moyen,0,Meme Difficulté,Pas Adapte,Mathematics
1750,2016,Mathématiques,2,Le Calcul d'Intégrale,3,Integration des Fractions Rationnelles,6,627,4,QCM,0.67,0.26,16.0,1,8,9,4,1,3,2.25,25.0,Facile,Difficile,-2,Beaucoup plus Difficile,Pas Adapte,Mathematics
2874,2017,Mathématiques,2,Le Calcul d'Intégrale,3,Integration des Fractions Rationnelles,6,627,4,QCM,0.73,0.29,13.0,1,7,8,4,1,3,2.0,25.0,Moyen,Difficile,-1,Plus Difficile,Pas Adapte,Mathematics
3998,2018,Mathématiques,2,Le Calcul d'Intégrale,3,Integration des Fractions Rationnelles,6,627,4,QCM,0.69,0.21,4.0,0,7,7,6,0,6,1.17,0.0,Difficile,Difficile,0,Meme Difficulté,Pas Adapte,Mathematics
5122,2019,Mathématiques,2,Le Calcul d'Intégrale,3,Integration des Fractions Rationnelles,6,627,4,QCM,0.62,0.29,35.0,3,5,8,3,3,0,2.67,100.0,Moyen,Difficile,-1,Plus Difficile,Pas Adapte,Mathematics
6246,2020,Mathématiques,2,Le Calcul d'Intégrale,3,Integration des Fractions Rationnelles,6,627,4,QCM,0.55,0.29,25.0,2,6,8,7,2,5,1.14,28.57,Facile,Difficile,-2,Beaucoup plus Difficile,Pas Adapte,Mathematics
627,2015,Mathématiques,2,Le Calcul d'Intégrale,3,Integration des Fractions Rationnelles,6,628,5,QROC,0.6,0.15,18.0,14,64,78,33,14,19,2.36,42.42,Facile,Difficile,-2,Beaucoup plus Difficile,Pas Adapte,Mathematics
1751,2016,Mathématiques,2,Le Calcul d'Intégrale,3,Integration des Fractions Rationnelles,6,628,5,QO,0.89,0.03,35.0,29,54,83,46,29,17,1.8,63.04,Difficile,Difficile,0,Meme Difficulté,Pas Adapte,Mathematics
2875,2017,Mathématiques,2,Le Calcul d'Intégrale,3,Integration des Fractions Rationnelles,6,628,5,QO,0.58,0.24,53.0,38,34,72,64,38,26,1.12,59.38,Difficile,Moyen,1,Plus Facile,Pas Adapte,Mathematics
3999,2018,Mathématiques,2,Le Calcul d'Intégrale,3,Integration des Fractions Rationnelles,6,628,5,QO,0.42,0.23,40.0,31,46,77,52,31,21,1.48,59.62,Facile,Moyen,-1,Plus Difficile,Pas Adapte,Mathematics
5123,2019,Mathématiques,2,Le Calcul d'Intégrale,3,Integration des Fractions Rationnelles,6,628,5,QO,0.88,0.12,20.0,14,56,70,38,14,24,1.84,36.84,Facile,Difficile,-2,Beaucoup plus Difficile,Pas Adapte,Mathematics
6247,2020,Mathématiques,2,Le Calcul d'Intégrale,3,Integration des Fractions Rationnelles,6,628,5,QCM,0.68,0.22,8.0,6,65,71,53,6,47,1.34,11.32,Moyen,Difficile,-1,Plus Difficile,Pas Adapte,Mathematics
628,2015,Mathématiques,2,Le Calcul d'Intégrale,3,Integration des Fractions Rationnelles,6,629,6,QCU,0.75,0.22,33.0,26,54,80,38,26,12,2.11,68.42,Difficile,Difficile,0,Meme Difficulté,Pas Adapte,Mathematics
1752,2016,Mathématiques,2,Le Calcul d'Intégrale,3,Integration des Fractions Rationnelles,6,629,6,QCU,0.46,0.31,3.0,3,82,85,63,3,60,1.35,4.76,Difficile,Difficile,0,Meme Difficulté,Pas Adapte,Mathematics
2876,2017,Mathématiques,2,Le Calcul d'Intégrale,3,Integration des Fractions Rationnelles,6,629,6,QCU,0.33,0.62,63.0,45,27,72,68,45,23,1.06,66.18,Moyen,Moyen,0,Meme Difficulté,Adapte,Mathematics
4000,2018,Mathématiques,2,Le Calcul d'Intégrale,3,Integration des Fractions Rationnelles,6,629,6,QCU,0.37,0.66,63.0,52,31,83,76,52,24,1.09,68.42,Moyen,Moyen,0,Meme Difficulté,Adapte,Mathematics
5124,2019,Mathématiques,2,Le Calcul d'Intégrale,3,Integration des Fractions Rationnelles,6,629,6,QCU,0.31,0.51,63.0,47,28,75,56,47,9,1.34,83.93,Moyen,Moyen,0,Meme Difficulté,Adapte,Mathematics
6248,2020,Mathématiques,2,Le Calcul d'Intégrale,3,Integration des Fractions Rationnelles,6,629,6,QCU,0.28,0.43,63.0,44,26,70,62,44,18,1.13,70.97,Moyen,Moyen,0,Meme Difficulté,Adapte,Mathematics
629,2015,Mathématiques,2,Le Calcul d'Intégrale,4,Fonction Trigonometriques,5,630,1,QCU,0.29,0.68,62.0,31,19,50,45,31,14,1.11,68.89,Moyen,Moyen,0,Meme Difficulté,Adapte,Mathematics
1753,2016,Mathématiques,2,Le Calcul d'Intégrale,4,Fonction Trigonometriques,5,630,1,QCU,0.26,0.7,62.0,29,17,46,33,29,4,1.39,87.88,Moyen,Moyen,0,Meme Difficulté,Adapte,Mathematics
2877,2017,Mathématiques,2,Le Calcul d'Intégrale,4,Fonction Trigonometriques,5,630,1,QCU,0.3,0.73,62.0,33,20,53,52,33,19,1.02,63.46,Moyen,Moyen,0,Meme Difficulté,Adapte,Mathematics
4001,2018,Mathématiques,2,Le Calcul d'Intégrale,4,Fonction Trigonometriques,5,630,1,QCU,0.3,0.43,62.0,30,18,48,48,30,18,1.0,62.5,Moyen,Moyen,0,Meme Difficulté,Adapte,Mathematics
5125,2019,Mathématiques,2,Le Calcul d'Intégrale,4,Fonction Trigonometriques,5,630,1,QCM,0.44,0.35,62.0,28,17,45,45,28,17,1.0,62.22,Moyen,Moyen,0,Meme Difficulté,Adapte,Mathematics
6249,2020,Mathématiques,2,Le Calcul d'Intégrale,4,Fonction Trigonometriques,5,630,1,QCM,0.27,0.51,62.0,24,15,39,24,24,0,1.62,100.0,Moyen,Moyen,0,Meme Difficulté,Adapte,Mathematics
630,2015,Mathématiques,2,Le Calcul d'Intégrale,4,Fonction Trigonometriques,5,631,2,QCU,0.4,0.74,48.0,41,45,86,47,41,6,1.83,87.23,Moyen,Moyen,0,Meme Difficulté,Pas Adapte,Mathematics
1754,2016,Mathématiques,2,Le Calcul d'Intégrale,4,Fonction Trigonometriques,5,631,2,QCM,0.43,0.46,38.0,32,52,84,64,32,32,1.31,50.0,Facile,Moyen,-1,Plus Difficile,Pas Adapte,Mathematics
2878,2017,Mathématiques,2,Le Calcul d'Intégrale,4,Fonction Trigonometriques,5,631,2,QCM,0.74,0.24,11.0,9,76,85,60,9,51,1.42,15.0,Moyen,Difficile,-1,Plus Difficile,Pas Adapte,Mathematics
4002,2018,Mathématiques,2,Le Calcul d'Intégrale,4,Fonction Trigonometriques,5,631,2,QCM,0.22,0.36,56.0,55,43,98,90,55,35,1.09,61.11,Difficile,Moyen,1,Plus Facile,Pas Adapte,Mathematics
5126,2019,Mathématiques,2,Le Calcul d'Intégrale,4,Fonction Trigonometriques,5,631,2,QCU,0.57,0.33,23.0,20,65,85,56,20,36,1.52,35.71,Difficile,Difficile,0,Meme Difficulté,Pas Adapte,Mathematics
6250,2020,Mathématiques,2,Le Calcul d'Intégrale,4,Fonction Trigonometriques,5,631,2,QCU,0.48,0.2,3.0,3,84,87,62,3,59,1.4,4.84,Facile,Difficile,-2,Beaucoup plus Difficile,Pas Adapte,Mathematics
631,2015,Mathématiques,2,Le Calcul d'Intégrale,4,Fonction Trigonometriques,5,632,3,QCU,0.42,0.24,24.0,9,28,37,31,9,22,1.19,29.03,Moyen,Difficile,-1,Plus Difficile,Pas Adapte,Mathematics
1755,2016,Mathématiques,2,Le Calcul d'Intégrale,4,Fonction Trigonometriques,5,632,3,QROC,0.84,0.07,0.0,0,41,41,35,0,35,1.17,0.0,Moyen,Difficile,-1,Plus Difficile,Pas Adapte,Mathematics
2879,2017,Mathématiques,2,Le Calcul d'Intégrale,4,Fonction Trigonometriques,5,632,3,QROC,0.94,0.2,4.0,2,38,40,28,2,26,1.43,7.14,Difficile,Difficile,0,Meme Difficulté,Pas Adapte,Mathematics
4003,2018,Mathématiques,2,Le Calcul d'Intégrale,4,Fonction Trigonometriques,5,632,3,QROC,0.3,0.35,45.0,15,19,34,19,15,4,1.79,78.95,Facile,Moyen,-1,Plus Difficile,Pas Adapte,Mathematics
5127,2019,Mathématiques,2,Le Calcul d'Intégrale,4,Fonction Trigonometriques,5,632,3,QCM,0.46,0.64,64.0,22,13,35,29,22,7,1.21,75.86,Difficile,Moyen,1,Plus Facile,Adapte,Mathematics
6251,2020,Mathématiques,2,Le Calcul d'Intégrale,4,Fonction Trigonometriques,5,632,3,QCM,0.31,0.68,64.0,22,13,35,29,22,7,1.21,75.86,Moyen,Moyen,0,Meme Difficulté,Adapte,Mathematics
632,2015,Mathématiques,2,Le Calcul d'Intégrale,4,Fonction Trigonometriques,5,633,4,QCM,0.68,0.17,35.0,23,44,67,58,23,35,1.16,39.66,Facile,Difficile,-2,Beaucoup plus Difficile,Pas Adapte,Mathematics
1756,2016,Mathématiques,2,Le Calcul d'Intégrale,4,Fonction Trigonometriques,5,633,4,QCU,0.54,0.32,10.0,7,60,67,23,7,16,2.91,30.43,Facile,Difficile,-2,Beaucoup plus Difficile,Pas Adapte,Mathematics
2880,2017,Mathématiques,2,Le Calcul d'Intégrale,4,Fonction Trigonometriques,5,633,4,QCU,0.04,0.88,65.0,45,24,69,59,45,14,1.17,76.27,Facile,Facile,0,Meme Difficulté,Adapte,Mathematics
4004,2018,Mathématiques,2,Le Calcul d'Intégrale,4,Fonction Trigonometriques,5,633,4,QCU,0.18,0.76,65.0,49,26,75,67,49,18,1.12,73.13,Facile,Facile,0,Meme Difficulté,Adapte,Mathematics
5128,2019,Mathématiques,2,Le Calcul d'Intégrale,4,Fonction Trigonometriques,5,633,4,QCU,0.08,0.87,65.0,51,27,78,68,51,17,1.15,75.0,Facile,Facile,0,Meme Difficulté,Adapte,Mathematics
6252,2020,Mathématiques,2,Le Calcul d'Intégrale,4,Fonction Trigonometriques,5,633,4,QCU,0.2,0.81,65.0,51,27,78,76,51,25,1.03,67.11,Facile,Facile,0,Meme Difficulté,Adapte,Mathematics
633,2015,Mathématiques,2,Le Calcul d'Intégrale,4,Fonction Trigonometriques,5,634,5,QCM,0.24,0.44,58.0,50,36,86,70,50,20,1.23,71.43,Moyen,Moyen,0,Meme Difficulté,Pas Adapte,Mathematics
1757,2016,Mathématiques,2,Le Calcul d'Intégrale,4,Fonction Trigonometriques,5,634,5,QCM,0.59,0.19,31.0,29,65,94,39,29,10,2.41,74.36,Moyen,Difficile,-1,Plus Difficile,Pas Adapte,Mathematics
2881,2017,Mathématiques,2,Le Calcul d'Intégrale,4,Fonction Trigonometriques,5,634,5,QCM,0.79,0.2,23.0,24,81,105,76,24,52,1.38,31.58,Facile,Difficile,-2,Beaucoup plus Difficile,Pas Adapte,Mathematics
4005,2018,Mathématiques,2,Le Calcul d'Intégrale,4,Fonction Trigonometriques,5,634,5,QCM,0.69,0.22,23.0,23,76,99,83,23,60,1.19,27.71,Moyen,Difficile,-1,Plus Difficile,Pas Adapte,Mathematics
5129,2019,Mathématiques,2,Le Calcul d'Intégrale,4,Fonction Trigonometriques,5,634,5,QCM,0.48,0.42,41.0,39,55,94,72,39,33,1.31,54.17,Facile,Moyen,-1,Plus Difficile,Pas Adapte,Mathematics
6253,2020,Mathématiques,2,Le Calcul d'Intégrale,4,Fonction Trigonometriques,5,634,5,QCM,0.31,0.45,51.0,44,43,87,49,44,5,1.78,89.8,Difficile,Moyen,1,Plus Facile,Pas Adapte,Mathematics
634,2015,Mathématiques,2,Le Calcul d'Intégrale,5,Integrales Abeliennes,2,635,1,QCM,0.78,0.17,0.0,0,78,78,26,0,26,3.0,0.0,Moyen,Difficile,-1,Plus Difficile,Pas Adapte,Mathematics
1758,2016,Mathématiques,2,Le Calcul d'Intégrale,5,Integrales Abeliennes,2,635,1,QCM,0.74,0.17,23.0,20,69,89,63,20,43,1.41,31.75,Facile,Difficile,-2,Beaucoup plus Difficile,Pas Adapte,Mathematics
2882,2017,Mathématiques,2,Le Calcul d'Intégrale,5,Integrales Abeliennes,2,635,1,QCM,0.54,0.25,32.0,25,53,78,72,25,47,1.08,34.72,Moyen,Difficile,-1,Plus Difficile,Pas Adapte,Mathematics
4006,2018,Mathématiques,2,Le Calcul d'Intégrale,5,Integrales Abeliennes,2,635,1,QO,0.78,0.03,27.0,20,55,75,49,20,29,1.53,40.82,Difficile,Difficile,0,Meme Difficulté,Pas Adapte,Mathematics
5130,2019,Mathématiques,2,Le Calcul d'Intégrale,5,Integrales Abeliennes,2,635,1,QROC,0.22,0.35,50.0,36,37,73,65,36,29,1.12,55.38,Difficile,Moyen,1,Plus Facile,Pas Adapte,Mathematics
6254,2020,Mathématiques,2,Le Calcul d'Intégrale,5,Integrales Abeliennes,2,635,1,QCM,0.71,0.23,14.0,11,70,81,77,11,66,1.05,14.29,Difficile,Difficile,0,Meme Difficulté,Pas Adapte,Mathematics
635,2015,Mathématiques,2,Le Calcul d'Intégrale,5,Integrales Abeliennes,2,636,2,QCU,0.56,0.36,15.0,4,24,28,16,4,12,1.75,25.0,Moyen,Difficile,-1,Plus Difficile,Pas Adapte,Mathematics
1759,2016,Mathématiques,2,Le Calcul d'Intégrale,5,Integrales Abeliennes,2,636,2,QCU,0.42,0.35,12.0,3,24,27,18,3,15,1.5,16.67,Difficile,Difficile,0,Meme Difficulté,Pas Adapte,Mathematics
2883,2017,Mathématiques,2,Le Calcul d'Intégrale,5,Integrales Abeliennes,2,636,2,QCM,0.39,0.63,50.0,14,15,29,16,14,2,1.81,87.5,Moyen,Moyen,0,Meme Difficulté,Pas Adapte,Mathematics
4007,2018,Mathématiques,2,Le Calcul d'Intégrale,5,Integrales Abeliennes,2,636,2,QCM,0.79,0.27,8.0,2,24,26,11,2,9,2.36,18.18,Difficile,Difficile,0,Meme Difficulté,Pas Adapte,Mathematics
5131,2019,Mathématiques,2,Le Calcul d'Intégrale,5,Integrales Abeliennes,2,636,2,QCM,0.76,0.26,21.0,6,21,27,9,6,3,3.0,66.67,Moyen,Difficile,-1,Plus Difficile,Pas Adapte,Mathematics
6255,2020,Mathématiques,2,Le Calcul d'Intégrale,5,Integrales Abeliennes,2,636,2,QCM,0.21,0.58,55.0,17,14,31,22,17,5,1.41,77.27,Moyen,Moyen,0,Meme Difficulté,Pas Adapte,Mathematics
636,2015,Mathématiques,2,Le Calcul d'Intégrale,6,Quelques Exemples en Maple,6,637,1,QROC,0.55,0.34,51.0,17,17,34,30,17,13,1.13,56.67,Moyen,Moyen,0,Meme Difficulté,Pas Adapte,Mathematics
1760,2016,Mathématiques,2,Le Calcul d'Intégrale,6,Quelques Exemples en Maple,6,637,1,QROC,0.61,0.2,31.0,10,21,31,29,10,19,1.07,34.48,Moyen,Difficile,-1,Plus Difficile,Pas Adapte,Mathematics
2884,2017,Mathématiques,2,Le Calcul d'Intégrale,6,Quelques Exemples en Maple,6,637,1,QROC,0.68,0.1,22.0,8,28,36,33,8,25,1.09,24.24,Moyen,Difficile,-1,Plus Difficile,Pas Adapte,Mathematics
4008,2018,Mathématiques,2,Le Calcul d'Intégrale,6,Quelques Exemples en Maple,6,637,1,QROC,0.47,0.31,40.0,13,20,33,28,13,15,1.18,46.43,Moyen,Moyen,0,Meme Difficulté,Pas Adapte,Mathematics
5132,2019,Mathématiques,2,Le Calcul d'Intégrale,6,Quelques Exemples en Maple,6,637,1,QO,0.85,0.04,34.0,11,21,32,27,11,16,1.19,40.74,Difficile,Difficile,0,Meme Difficulté,Pas Adapte,Mathematics
6256,2020,Mathématiques,2,Le Calcul d'Intégrale,6,Quelques Exemples en Maple,6,637,1,QO,0.94,0.13,21.0,7,27,34,24,7,17,1.42,29.17,Facile,Difficile,-2,Beaucoup plus Difficile,Pas Adapte,Mathematics
637,2015,Mathématiques,2,Le Calcul d'Intégrale,6,Quelques Exemples en Maple,6,638,2,QROC,0.97,0.16,33.0,12,24,36,35,12,23,1.03,34.29,Facile,Difficile,-2,Beaucoup plus Difficile,Pas Adapte,Mathematics
1761,2016,Mathématiques,2,Le Calcul d'Intégrale,6,Quelques Exemples en Maple,6,638,2,QROC,0.28,0.33,45.0,17,20,37,37,17,20,1.0,45.95,Difficile,Moyen,1,Plus Facile,Pas Adapte,Mathematics
2885,2017,Mathématiques,2,Le Calcul d'Intégrale,6,Quelques Exemples en Maple,6,638,2,QROC,0.62,0.1,23.0,9,29,38,18,9,9,2.11,50.0,Moyen,Difficile,-1,Plus Difficile,Pas Adapte,Mathematics
4009,2018,Mathématiques,2,Le Calcul d'Intégrale,6,Quelques Exemples en Maple,6,638,2,QROC,0.85,0.07,18.0,6,30,36,17,6,11,2.12,35.29,Difficile,Difficile,0,Meme Difficulté,Pas Adapte,Mathematics
5133,2019,Mathématiques,2,Le Calcul d'Intégrale,6,Quelques Exemples en Maple,6,638,2,QO,0.54,0.25,59.0,20,14,34,26,20,6,1.31,76.92,Facile,Moyen,-1,Plus Difficile,Pas Adapte,Mathematics
6257,2020,Mathématiques,2,Le Calcul d'Intégrale,6,Quelques Exemples en Maple,6,638,2,QO,0.91,0.12,23.0,7,22,29,19,7,12,1.53,36.84,Difficile,Difficile,0,Meme Difficulté,Pas Adapte,Mathematics
638,2015,Mathématiques,2,Le Calcul d'Intégrale,6,Quelques Exemples en Maple,6,639,3,QROC,0.97,0.12,13.0,12,78,90,45,12,33,2.0,26.67,Difficile,Difficile,0,Meme Difficulté,Pas Adapte,Mathematics
1762,2016,Mathématiques,2,Le Calcul d'Intégrale,6,Quelques Exemples en Maple,6,639,3,QO,0.9,0.0,2.0,2,86,88,66,2,64,1.33,3.03,Facile,Difficile,-2,Beaucoup plus Difficile,Pas Adapte,Mathematics
2886,2017,Mathématiques,2,Le Calcul d'Intégrale,6,Quelques Exemples en Maple,6,639,3,QO,0.74,0.21,37.0,33,56,89,80,33,47,1.11,41.25,Moyen,Moyen,0,Meme Difficulté,Pas Adapte,Mathematics
4010,2018,Mathématiques,2,Le Calcul d'Intégrale,6,Quelques Exemples en Maple,6,639,3,QO,0.9,0.06,13.0,10,70,80,42,10,32,1.9,23.81,Facile,Difficile,-2,Beaucoup plus Difficile,Pas Adapte,Mathematics
5134,2019,Mathématiques,2,Le Calcul d'Intégrale,6,Quelques Exemples en Maple,6,639,3,QCM,0.63,0.24,17.0,13,64,77,60,13,47,1.28,21.67,Difficile,Difficile,0,Meme Difficulté,Pas Adapte,Mathematics
6258,2020,Mathématiques,2,Le Calcul d'Intégrale,6,Quelques Exemples en Maple,6,639,3,QCU,0.51,0.39,32.0,21,46,67,41,21,20,1.63,51.22,Moyen,Difficile,-1,Plus Difficile,Pas Adapte,Mathematics
639,2015,Mathématiques,2,Le Calcul d'Intégrale,6,Quelques Exemples en Maple,6,640,4,QCU,0.25,0.44,58.0,31,22,53,50,31,19,1.06,62.0,Facile,Moyen,-1,Plus Difficile,Pas Adapte,Mathematics
1763,2016,Mathématiques,2,Le Calcul d'Intégrale,6,Quelques Exemples en Maple,6,640,4,QCU,0.45,0.2,24.0,12,36,48,22,12,10,2.18,54.55,Difficile,Difficile,0,Meme Difficulté,Pas Adapte,Mathematics
2887,2017,Mathématiques,2,Le Calcul d'Intégrale,6,Quelques Exemples en Maple,6,640,4,QCU,0.27,0.43,46.0,22,25,47,45,22,23,1.04,48.89,Difficile,Moyen,1,Plus Facile,Pas Adapte,Mathematics
4011,2018,Mathématiques,2,Le Calcul d'Intégrale,6,Quelques Exemples en Maple,6,640,4,QCU,0.42,0.35,26.0,13,37,50,23,13,10,2.17,56.52,Difficile,Difficile,0,Meme Difficulté,Pas Adapte,Mathematics
5135,2019,Mathématiques,2,Le Calcul d'Intégrale,6,Quelques Exemples en Maple,6,640,4,QCM,0.66,0.18,17.0,8,42,50,49,8,41,1.02,16.33,Facile,Difficile,-2,Beaucoup plus Difficile,Pas Adapte,Mathematics
6259,2020,Mathématiques,2,Le Calcul d'Intégrale,6,Quelques Exemples en Maple,6,640,4,QCM,0.62,0.3,12.0,6,40,46,26,6,20,1.77,23.08,Moyen,Difficile,-1,Plus Difficile,Pas Adapte,Mathematics
640,2015,Mathématiques,2,Le Calcul d'Intégrale,6,Quelques Exemples en Maple,6,641,5,QCM,0.44,0.51,45.0,42,52,94,43,42,1,2.19,97.67,Facile,Moyen,-1,Plus Difficile,Pas Adapte,Mathematics
1764,2016,Mathématiques,2,Le Calcul d'Intégrale,6,Quelques Exemples en Maple,6,641,5,QCU,0.47,0.37,3.0,3,88,91,42,3,39,2.17,7.14,Facile,Difficile,-2,Beaucoup plus Difficile,Pas Adapte,Mathematics
2888,2017,Mathématiques,2,Le Calcul d'Intégrale,6,Quelques Exemples en Maple,6,641,5,QCU,0.69,0.34,0.0,0,82,82,52,0,52,1.58,0.0,Difficile,Difficile,0,Meme Difficulté,Pas Adapte,Mathematics
4012,2018,Mathématiques,2,Le Calcul d'Intégrale,6,Quelques Exemples en Maple,6,641,5,QCM,0.43,0.57,39.0,36,56,92,39,36,3,2.36,92.31,Difficile,Moyen,1,Plus Facile,Pas Adapte,Mathematics
5136,2019,Mathématiques,2,Le Calcul d'Intégrale,6,Quelques Exemples en Maple,6,641,5,QCM,0.22,0.7,56.0,57,45,102,75,57,18,1.36,76.0,Moyen,Moyen,0,Meme Difficulté,Pas Adapte,Mathematics
6260,2020,Mathématiques,2,Le Calcul d'Intégrale,6,Quelques Exemples en Maple,6,641,5,QCM,0.6,0.26,1.0,1,106,107,51,1,50,2.1,1.96,Facile,Difficile,-2,Beaucoup plus Difficile,Pas Adapte,Mathematics
641,2015,Mathématiques,2,Le Calcul d'Intégrale,6,Quelques Exemples en Maple,6,642,6,QCU,0.46,0.29,4.0,3,81,84,67,3,64,1.25,4.48,Difficile,Difficile,0,Meme Difficulté,Pas Adapte,Mathematics
1765,2016,Mathématiques,2,Le Calcul d'Intégrale,6,Quelques Exemples en Maple,6,642,6,QCU,0.37,0.63,63.0,50,29,79,56,50,6,1.41,89.29,Moyen,Moyen,0,Meme Difficulté,Adapte,Mathematics
2889,2017,Mathématiques,2,Le Calcul d'Intégrale,6,Quelques Exemples en Maple,6,642,6,QCU,0.36,0.74,63.0,52,30,82,62,52,10,1.32,83.87,Moyen,Moyen,0,Meme Difficulté,Adapte,Mathematics
4013,2018,Mathématiques,2,Le Calcul d'Intégrale,6,Quelques Exemples en Maple,6,642,6,QCU,0.29,0.62,63.0,55,32,87,57,55,2,1.53,96.49,Moyen,Moyen,0,Meme Difficulté,Adapte,Mathematics
5137,2019,Mathématiques,2,Le Calcul d'Intégrale,6,Quelques Exemples en Maple,6,642,6,QCM,0.28,0.48,63.0,49,28,77,56,49,7,1.38,87.5,Moyen,Moyen,0,Meme Difficulté,Adapte,Mathematics
6261,2020,Mathématiques,2,Le Calcul d'Intégrale,6,Quelques Exemples en Maple,6,642,6,QCM,0.38,0.68,63.0,45,26,71,67,45,22,1.06,67.16,Moyen,Moyen,0,Meme Difficulté,Adapte,Mathematics
642,2015,Mathématiques,3,La Dérivation,1,Derivee en un Point,8,643,1,QCU,0.22,0.51,42.0,40,56,96,53,40,13,1.81,75.47,Difficile,Moyen,1,Plus Facile,Pas Adapte,Mathematics
1766,2016,Mathématiques,3,La Dérivation,1,Derivee en un Point,8,643,1,QCU,0.55,0.3,19.0,17,74,91,45,17,28,2.02,37.78,Facile,Difficile,-2,Beaucoup plus Difficile,Pas Adapte,Mathematics
2890,2017,Mathématiques,3,La Dérivation,1,Derivee en un Point,8,643,1,QCU,0.5,0.26,28.0,26,66,92,80,26,54,1.15,32.5,Difficile,Difficile,0,Meme Difficulté,Pas Adapte,Mathematics
4014,2018,Mathématiques,3,La Dérivation,1,Derivee en un Point,8,643,1,QCU,0.26,0.46,60.0,50,33,83,58,50,8,1.43,86.21,Facile,Moyen,-1,Plus Difficile,Adapte,Mathematics
5138,2019,Mathématiques,3,La Dérivation,1,Derivee en un Point,8,643,1,QCU,0.25,0.46,60.0,46,30,76,60,46,14,1.27,76.67,Moyen,Moyen,0,Meme Difficulté,Adapte,Mathematics
6262,2020,Mathématiques,3,La Dérivation,1,Derivee en un Point,8,643,1,QCU,0.36,0.55,60.0,40,27,67,43,40,3,1.56,93.02,Moyen,Moyen,0,Meme Difficulté,Adapte,Mathematics
643,2015,Mathématiques,3,La Dérivation,1,Derivee en un Point,8,644,2,QCU,0.37,0.7,40.0,12,18,30,28,12,16,1.07,42.86,Facile,Moyen,-1,Plus Difficile,Pas Adapte,Mathematics
1767,2016,Mathématiques,3,La Dérivation,1,Derivee en un Point,8,644,2,QCU,0.24,0.64,63.0,21,12,33,29,21,8,1.14,72.41,Facile,Moyen,-1,Plus Difficile,Adapte,Mathematics
2891,2017,Mathématiques,3,La Dérivation,1,Derivee en un Point,8,644,2,QCU,0.3,0.71,63.0,18,10,28,21,18,3,1.33,85.71,Moyen,Moyen,0,Meme Difficulté,Adapte,Mathematics
4015,2018,Mathématiques,3,La Dérivation,1,Derivee en un Point,8,644,2,QCU,0.32,0.47,63.0,20,12,32,26,20,6,1.23,76.92,Moyen,Moyen,0,Meme Difficulté,Adapte,Mathematics
5139,2019,Mathématiques,3,La Dérivation,1,Derivee en un Point,8,644,2,QCU,0.39,0.45,63.0,21,13,34,33,21,12,1.03,63.64,Moyen,Moyen,0,Meme Difficulté,Adapte,Mathematics
6263,2020,Mathématiques,3,La Dérivation,1,Derivee en un Point,8,644,2,QCU,0.27,0.58,63.0,19,11,30,29,19,10,1.03,65.52,Moyen,Moyen,0,Meme Difficulté,Adapte,Mathematics
644,2015,Mathématiques,3,La Dérivation,1,Derivee en un Point,8,645,3,QCM,0.47,0.67,61.0,52,34,86,78,52,26,1.1,66.67,Facile,Moyen,-1,Plus Difficile,Adapte,Mathematics
1768,2016,Mathématiques,3,La Dérivation,1,Derivee en un Point,8,645,3,QCM,0.25,0.62,61.0,58,37,95,64,58,6,1.48,90.62,Moyen,Moyen,0,Meme Difficulté,Adapte,Mathematics
2892,2017,Mathématiques,3,La Dérivation,1,Derivee en un Point,8,645,3,QCM,0.43,0.35,61.0,52,33,85,66,52,14,1.29,78.79,Moyen,Moyen,0,Meme Difficulté,Adapte,Mathematics
4016,2018,Mathématiques,3,La Dérivation,1,Derivee en un Point,8,645,3,QCM,0.36,0.54,61.0,44,28,72,51,44,7,1.41,86.27,Moyen,Moyen,0,Meme Difficulté,Adapte,Mathematics
5140,2019,Mathématiques,3,La Dérivation,1,Derivee en un Point,8,645,3,QCM,0.34,0.64,61.0,37,24,61,44,37,7,1.39,84.09,Moyen,Moyen,0,Meme Difficulté,Adapte,Mathematics
6264,2020,Mathématiques,3,La Dérivation,1,Derivee en un Point,8,645,3,QCM,0.4,0.3,61.0,35,22,57,46,35,11,1.24,76.09,Moyen,Moyen,0,Meme Difficulté,Adapte,Mathematics
645,2015,Mathématiques,3,La Dérivation,1,Derivee en un Point,8,646,4,QCU,0.45,0.2,17.0,14,70,84,59,14,45,1.42,23.73,Difficile,Difficile,0,Meme Difficulté,Pas Adapte,Mathematics
1769,2016,Mathématiques,3,La Dérivation,1,Derivee en un Point,8,646,4,QCU,0.45,0.39,1.0,1,87,88,59,1,58,1.49,1.69,Facile,Difficile,-2,Beaucoup plus Difficile,Pas Adapte,Mathematics
2893,2017,Mathématiques,3,La Dérivation,1,Derivee en un Point,8,646,4,QCU,0.22,0.58,45.0,43,52,95,83,43,40,1.14,51.81,Difficile,Moyen,1,Plus Facile,Pas Adapte,Mathematics
4017,2018,Mathématiques,3,La Dérivation,1,Derivee en un Point,8,646,4,QCM,0.56,0.25,2.0,2,93,95,68,2,66,1.4,2.94,Facile,Difficile,-2,Beaucoup plus Difficile,Pas Adapte,Mathematics
5141,2019,Mathématiques,3,La Dérivation,1,Derivee en un Point,8,646,4,QCM,0.25,0.51,44.0,36,45,81,61,36,25,1.33,59.02,Moyen,Moyen,0,Meme Difficulté,Pas Adapte,Mathematics
6265,2020,Mathématiques,3,La Dérivation,1,Derivee en un Point,8,646,4,QCM,0.22,0.52,44.0,31,40,71,35,31,4,2.03,88.57,Moyen,Moyen,0,Meme Difficulté,Pas Adapte,Mathematics
646,2015,Mathématiques,3,La Dérivation,1,Derivee en un Point,8,647,5,QCU,0.21,0.58,51.0,47,45,92,56,47,9,1.64,83.93,Facile,Moyen,-1,Plus Difficile,Pas Adapte,Mathematics
1770,2016,Mathématiques,3,La Dérivation,1,Derivee en un Point,8,647,5,QCU,0.46,0.21,25.0,24,72,96,54,24,30,1.78,44.44,Facile,Difficile,-2,Beaucoup plus Difficile,Pas Adapte,Mathematics
2894,2017,Mathématiques,3,La Dérivation,1,Derivee en un Point,8,647,5,QCU,0.52,0.35,10.0,9,78,87,65,9,56,1.34,13.85,Moyen,Difficile,-1,Plus Difficile,Pas Adapte,Mathematics
4018,2018,Mathématiques,3,La Dérivation,1,Derivee en un Point,8,647,5,QCU,0.2,0.62,62.0,54,33,87,64,54,10,1.36,84.38,Moyen,Moyen,0,Meme Difficulté,Adapte,Mathematics
5142,2019,Mathématiques,3,La Dérivation,1,Derivee en un Point,8,647,5,QCU,0.39,0.63,62.0,48,30,78,75,48,27,1.04,64.0,Moyen,Moyen,0,Meme Difficulté,Adapte,Mathematics
6266,2020,Mathématiques,3,La Dérivation,1,Derivee en un Point,8,647,5,QCU,0.34,0.51,62.0,41,25,66,44,41,3,1.5,93.18,Moyen,Moyen,0,Meme Difficulté,Adapte,Mathematics
647,2015,Mathématiques,3,La Dérivation,1,Derivee en un Point,8,648,6,QROC,0.9,0.21,16.0,15,80,95,78,15,63,1.22,19.23,Facile,Difficile,-2,Beaucoup plus Difficile,Pas Adapte,Mathematics
1771,2016,Mathématiques,3,La Dérivation,1,Derivee en un Point,8,648,6,QROC,0.63,0.25,31.0,32,70,102,88,32,56,1.16,36.36,Facile,Difficile,-2,Beaucoup plus Difficile,Pas Adapte,Mathematics
2895,2017,Mathématiques,3,La Dérivation,1,Derivee en un Point,8,648,6,QROC,0.78,0.15,29.0,29,72,101,98,29,69,1.03,29.59,Difficile,Difficile,0,Meme Difficulté,Pas Adapte,Mathematics
4019,2018,Mathématiques,3,La Dérivation,1,Derivee en un Point,8,648,6,QROC,0.97,0.17,32.0,29,62,91,83,29,54,1.1,34.94,Difficile,Difficile,0,Meme Difficulté,Pas Adapte,Mathematics
5143,2019,Mathématiques,3,La Dérivation,1,Derivee en un Point,8,648,6,QROC,0.23,0.3,48.0,39,42,81,59,39,20,1.37,66.1,Moyen,Moyen,0,Meme Difficulté,Pas Adapte,Mathematics
6267,2020,Mathématiques,3,La Dérivation,1,Derivee en un Point,8,648,6,QROC,0.21,0.25,60.0,45,30,75,71,45,26,1.06,63.38,Moyen,Moyen,0,Meme Difficulté,Adapte,Mathematics
648,2015,Mathématiques,3,La Dérivation,1,Derivee en un Point,8,649,7,QCM,0.34,0.59,40.0,33,49,82,71,33,38,1.15,46.48,Facile,Moyen,-1,Plus Difficile,Pas Adapte,Mathematics
1772,2016,Mathématiques,3,La Dérivation,1,Derivee en un Point,8,649,7,QCM,0.74,0.28,11.0,10,79,89,64,10,54,1.39,15.62,Facile,Difficile,-2,Beaucoup plus Difficile,Pas Adapte,Mathematics
2896,2017,Mathématiques,3,La Dérivation,1,Derivee en un Point,8,649,7,QCM,0.26,0.5,40.0,31,46,77,62,31,31,1.24,50.0,Difficile,Moyen,1,Plus Facile,Pas Adapte,Mathematics
4020,2018,Mathématiques,3,La Dérivation,1,Derivee en un Point,8,649,7,QCM,0.66,0.24,23.0,20,65,85,68,20,48,1.25,29.41,Facile,Difficile,-2,Beaucoup plus Difficile,Pas Adapte,Mathematics
5144,2019,Mathématiques,3,La Dérivation,1,Derivee en un Point,8,649,7,QCM,0.21,0.37,37.0,34,58,92,37,34,3,2.49,91.89,Moyen,Moyen,0,Meme Difficulté,Pas Adapte,Mathematics
6268,2020,Mathématiques,3,La Dérivation,1,Derivee en un Point,8,649,7,QCU,0.48,0.3,28.0,25,64,89,61,25,36,1.46,40.98,Difficile,Difficile,0,Meme Difficulté,Pas Adapte,Mathematics
649,2015,Mathématiques,3,La Dérivation,1,Derivee en un Point,8,650,8,QCM,0.71,0.23,22.0,11,39,50,23,11,12,2.17,47.83,Facile,Difficile,-2,Beaucoup plus Difficile,Pas Adapte,Mathematics
1773,2016,Mathématiques,3,La Dérivation,1,Derivee en un Point,8,650,8,QCU,0.12,0.82,65.0,30,16,46,40,30,10,1.15,75.0,Facile,Facile,0,Meme Difficulté,Adapte,Mathematics
2897,2017,Mathématiques,3,La Dérivation,1,Derivee en un Point,8,650,8,QCU,0.01,1.0,65.0,34,18,52,35,34,1,1.49,97.14,Facile,Facile,0,Meme Difficulté,Adapte,Mathematics
4021,2018,Mathématiques,3,La Dérivation,1,Derivee en un Point,8,650,8,QCU,0.05,0.92,65.0,29,15,44,36,29,7,1.22,80.56,Facile,Facile,0,Meme Difficulté,Adapte,Mathematics
5145,2019,Mathématiques,3,La Dérivation,1,Derivee en un Point,8,650,8,QCU,0.18,0.77,65.0,27,14,41,30,27,3,1.37,90.0,Facile,Facile,0,Meme Difficulté,Adapte,Mathematics
6269,2020,Mathématiques,3,La Dérivation,1,Derivee en un Point,8,650,8,QCU,0.08,0.86,65.0,23,13,36,25,23,2,1.44,92.0,Facile,Facile,0,Meme Difficulté,Adapte,Mathematics
650,2015,Mathématiques,3,La Dérivation,2,Derivee Globale,3,651,1,QCU,0.58,0.35,2.0,1,28,29,13,1,12,2.23,7.69,Difficile,Difficile,0,Meme Difficulté,Pas Adapte,Mathematics
1774,2016,Mathématiques,3,La Dérivation,2,Derivee Globale,3,651,1,QROC,0.98,0.22,0.0,0,26,26,16,0,16,1.62,0.0,Moyen,Difficile,-1,Plus Difficile,Pas Adapte,Mathematics
2898,2017,Mathématiques,3,La Dérivation,2,Derivee Globale,3,651,1,QROC,0.58,0.29,51.0,15,14,29,26,15,11,1.12,57.69,Moyen,Moyen,0,Meme Difficulté,Pas Adapte,Mathematics
4022,2018,Mathématiques,3,La Dérivation,2,Derivee Globale,3,651,1,QROC,0.6,0.36,43.0,13,18,31,19,13,6,1.63,68.42,Facile,Moyen,-1,Plus Difficile,Pas Adapte,Mathematics
5146,2019,Mathématiques,3,La Dérivation,2,Derivee Globale,3,651,1,QROC,0.72,0.14,31.0,8,18,26,18,8,10,1.44,44.44,Facile,Difficile,-2,Beaucoup plus Difficile,Pas Adapte,Mathematics
6270,2020,Mathématiques,3,La Dérivation,2,Derivee Globale,3,651,1,QROC,0.4,0.39,48.0,13,14,27,26,13,13,1.04,50.0,Moyen,Moyen,0,Meme Difficulté,Pas Adapte,Mathematics
651,2015,Mathématiques,3,La Dérivation,2,Derivee Globale,3,652,2,QCU,0.53,0.4,13.0,5,37,42,18,5,13,2.33,27.78,Facile,Difficile,-2,Beaucoup plus Difficile,Pas Adapte,Mathematics
1775,2016,Mathématiques,3,La Dérivation,2,Derivee Globale,3,652,2,QCU,0.48,0.27,33.0,15,30,45,45,15,30,1.0,33.33,Difficile,Difficile,0,Meme Difficulté,Pas Adapte,Mathematics
2899,2017,Mathématiques,3,La Dérivation,2,Derivee Globale,3,652,2,QROC,0.88,0.02,13.0,6,37,43,42,6,36,1.02,14.29,Difficile,Difficile,0,Meme Difficulté,Pas Adapte,Mathematics
4023,2018,Mathématiques,3,La Dérivation,2,Derivee Globale,3,652,2,QCM,0.7,0.29,25.0,12,37,49,17,12,5,2.88,70.59,Difficile,Difficile,0,Meme Difficulté,Pas Adapte,Mathematics
5147,2019,Mathématiques,3,La Dérivation,2,Derivee Globale,3,652,2,QCM,0.51,0.28,7.0,3,42,45,17,3,14,2.65,17.65,Facile,Difficile,-2,Beaucoup plus Difficile,Pas Adapte,Mathematics
6271,2020,Mathématiques,3,La Dérivation,2,Derivee Globale,3,652,2,QCM,0.37,0.61,45.0,20,25,45,30,20,10,1.5,66.67,Facile,Moyen,-1,Plus Difficile,Pas Adapte,Mathematics
652,2015,Mathématiques,3,La Dérivation,2,Derivee Globale,3,653,3,QCM,0.78,0.2,11.0,1,8,9,7,1,6,1.29,14.29,Moyen,Difficile,-1,Plus Difficile,Pas Adapte,Mathematics
1776,2016,Mathématiques,3,La Dérivation,2,Derivee Globale,3,653,3,QCM,0.32,0.68,49.0,4,4,8,6,4,2,1.33,66.67,Difficile,Moyen,1,Plus Facile,Pas Adapte,Mathematics
2900,2017,Mathématiques,3,La Dérivation,2,Derivee Globale,3,653,3,QCM,0.42,0.42,47.0,4,4,8,5,4,1,1.6,80.0,Difficile,Moyen,1,Plus Facile,Pas Adapte,Mathematics
4024,2018,Mathématiques,3,La Dérivation,2,Derivee Globale,3,653,3,QCM,0.61,0.19,30.0,3,6,9,5,3,2,1.8,60.0,Moyen,Difficile,-1,Plus Difficile,Pas Adapte,Mathematics
5148,2019,Mathématiques,3,La Dérivation,2,Derivee Globale,3,653,3,QCM,0.77,0.27,25.0,2,8,10,7,2,5,1.43,28.57,Facile,Difficile,-2,Beaucoup plus Difficile,Pas Adapte,Mathematics
6272,2020,Mathématiques,3,La Dérivation,2,Derivee Globale,3,653,3,QCM,0.47,0.44,39.0,5,7,12,8,5,3,1.5,62.5,Difficile,Moyen,1,Plus Facile,Pas Adapte,Mathematics
653,2015,Mathématiques,3,La Dérivation,3,Theroeme de Rolle et des Accroissements Finis,7,654,1,QCM,0.44,0.4,56.0,26,21,47,31,26,5,1.52,83.87,Facile,Moyen,-1,Plus Difficile,Pas Adapte,Mathematics
1777,2016,Mathématiques,3,La Dérivation,3,Theroeme de Rolle et des Accroissements Finis,7,654,1,QCM,0.29,0.39,38.0,16,25,41,18,16,2,2.28,88.89,Facile,Moyen,-1,Plus Difficile,Pas Adapte,Mathematics
2901,2017,Mathématiques,3,La Dérivation,3,Theroeme de Rolle et des Accroissements Finis,7,654,1,QCM,0.33,0.66,56.0,21,17,38,27,21,6,1.41,77.78,Moyen,Moyen,0,Meme Difficulté,Pas Adapte,Mathematics
4025,2018,Mathématiques,3,La Dérivation,3,Theroeme de Rolle et des Accroissements Finis,7,654,1,QCM,0.8,0.21,35.0,15,29,44,28,15,13,1.57,53.57,Moyen,Difficile,-1,Plus Difficile,Pas Adapte,Mathematics
5149,2019,Mathématiques,3,La Dérivation,3,Theroeme de Rolle et des Accroissements Finis,7,654,1,QCM,0.28,0.64,56.0,25,20,45,30,25,5,1.5,83.33,Facile,Moyen,-1,Plus Difficile,Pas Adapte,Mathematics
6273,2020,Mathématiques,3,La Dérivation,3,Theroeme de Rolle et des Accroissements Finis,7,654,1,QCU,0.46,0.38,3.0,2,49,51,35,2,33,1.46,5.71,Moyen,Difficile,-1,Plus Difficile,Pas Adapte,Mathematics
654,2015,Mathématiques,3,La Dérivation,3,Theroeme de Rolle et des Accroissements Finis,7,655,2,QCU,0.45,0.36,27.0,25,67,92,33,25,8,2.79,75.76,Moyen,Difficile,-1,Plus Difficile,Pas Adapte,Mathematics
1778,2016,Mathématiques,3,La Dérivation,3,Theroeme de Rolle et des Accroissements Finis,7,655,2,QCM,0.68,0.17,35.0,34,63,97,83,34,49,1.17,40.96,Difficile,Difficile,0,Meme Difficulté,Pas Adapte,Mathematics
2902,2017,Mathématiques,3,La Dérivation,3,Theroeme de Rolle et des Accroissements Finis,7,655,2,QCM,0.49,0.55,57.0,60,46,106,102,60,42,1.04,58.82,Moyen,Moyen,0,Meme Difficulté,Pas Adapte,Mathematics
4026,2018,Mathématiques,3,La Dérivation,3,Theroeme de Rolle et des Accroissements Finis,7,655,2,QROC,0.69,0.25,32.0,34,71,105,87,34,53,1.21,39.08,Moyen,Difficile,-1,Plus Difficile,Pas Adapte,Mathematics
5150,2019,Mathématiques,3,La Dérivation,3,Theroeme de Rolle et des Accroissements Finis,7,655,2,QROC,0.98,0.09,19.0,20,85,105,96,20,76,1.09,20.83,Difficile,Difficile,0,Meme Difficulté,Pas Adapte,Mathematics
6274,2020,Mathématiques,3,La Dérivation,3,Theroeme de Rolle et des Accroissements Finis,7,655,2,QROC,0.73,0.05,30.0,27,63,90,55,27,28,1.64,49.09,Difficile,Difficile,0,Meme Difficulté,Pas Adapte,Mathematics
655,2015,Mathématiques,3,La Dérivation,3,Theroeme de Rolle et des Accroissements Finis,7,656,3,QCU,0.21,0.7,44.0,3,4,7,5,3,2,1.4,60.0,Facile,Moyen,-1,Plus Difficile,Pas Adapte,Mathematics
1779,2016,Mathématiques,3,La Dérivation,3,Theroeme de Rolle et des Accroissements Finis,7,656,3,QCU,0.23,0.68,56.0,4,4,8,5,4,1,1.6,80.0,Difficile,Moyen,1,Plus Facile,Pas Adapte,Mathematics
2903,2017,Mathématiques,3,La Dérivation,3,Theroeme de Rolle et des Accroissements Finis,7,656,3,QCU,0.48,0.4,32.0,3,5,8,5,3,2,1.6,60.0,Moyen,Difficile,-1,Plus Difficile,Pas Adapte,Mathematics
4027,2018,Mathématiques,3,La Dérivation,3,Theroeme de Rolle et des Accroissements Finis,7,656,3,QCU,0.75,0.33,16.0,1,7,8,3,1,2,2.67,33.33,Facile,Difficile,-2,Beaucoup plus Difficile,Pas Adapte,Mathematics
5151,2019,Mathématiques,3,La Dérivation,3,Theroeme de Rolle et des Accroissements Finis,7,656,3,QCU,0.65,0.38,20.0,1,6,7,3,1,2,2.33,33.33,Difficile,Difficile,0,Meme Difficulté,Pas Adapte,Mathematics
6275,2020,Mathématiques,3,La Dérivation,3,Theroeme de Rolle et des Accroissements Finis,7,656,3,QCU,0.43,0.39,33.0,2,5,7,3,2,1,2.33,66.67,Difficile,Difficile,0,Meme Difficulté,Pas Adapte,Mathematics
656,2015,Mathématiques,3,La Dérivation,3,Theroeme de Rolle et des Accroissements Finis,7,657,4,QCM,0.34,0.37,50.0,14,13,27,19,14,5,1.42,73.68,Moyen,Moyen,0,Meme Difficulté,Pas Adapte,Mathematics
1780,2016,Mathématiques,3,La Dérivation,3,Theroeme de Rolle et des Accroissements Finis,7,657,4,QCM,0.24,0.36,62.0,18,11,29,27,18,9,1.07,66.67,Difficile,Moyen,1,Plus Facile,Adapte,Mathematics
2904,2017,Mathématiques,3,La Dérivation,3,Theroeme de Rolle et des Accroissements Finis,7,657,4,QCM,0.45,0.32,62.0,20,12,32,21,20,1,1.52,95.24,Moyen,Moyen,0,Meme Difficulté,Adapte,Mathematics
4028,2018,Mathématiques,3,La Dérivation,3,Theroeme de Rolle et des Accroissements Finis,7,657,4,QCM,0.42,0.38,62.0,20,12,32,31,20,11,1.03,64.52,Moyen,Moyen,0,Meme Difficulté,Adapte,Mathematics
5152,2019,Mathématiques,3,La Dérivation,3,Theroeme de Rolle et des Accroissements Finis,7,657,4,QCU,0.37,0.54,62.0,22,13,35,26,22,4,1.35,84.62,Moyen,Moyen,0,Meme Difficulté,Adapte,Mathematics
6276,2020,Mathématiques,3,La Dérivation,3,Theroeme de Rolle et des Accroissements Finis,7,657,4,QCU,0.31,0.44,62.0,19,12,31,26,19,7,1.19,73.08,Moyen,Moyen,0,Meme Difficulté,Adapte,Mathematics
657,2015,Mathématiques,3,La Dérivation,3,Theroeme de Rolle et des Accroissements Finis,7,658,5,QCM,0.54,0.21,5.0,2,46,48,19,2,17,2.53,10.53,Facile,Difficile,-2,Beaucoup plus Difficile,Pas Adapte,Mathematics
1781,2016,Mathématiques,3,La Dérivation,3,Theroeme de Rolle et des Accroissements Finis,7,658,5,QCM,0.42,0.33,45.0,23,28,51,36,23,13,1.42,63.89,Difficile,Moyen,1,Plus Facile,Pas Adapte,Mathematics
2905,2017,Mathématiques,3,La Dérivation,3,Theroeme de Rolle et des Accroissements Finis,7,658,5,QCM,0.7,0.23,27.0,16,42,58,39,16,23,1.49,41.03,Facile,Difficile,-2,Beaucoup plus Difficile,Pas Adapte,Mathematics
4029,2018,Mathématiques,3,La Dérivation,3,Theroeme de Rolle et des Accroissements Finis,7,658,5,QCU,0.04,0.98,65.0,40,21,61,49,40,9,1.24,81.63,Facile,Facile,0,Meme Difficulté,Adapte,Mathematics
5153,2019,Mathématiques,3,La Dérivation,3,Theroeme de Rolle et des Accroissements Finis,7,658,5,QCU,0.04,0.91,65.0,44,24,68,57,44,13,1.19,77.19,Facile,Facile,0,Meme Difficulté,Adapte,Mathematics
6277,2020,Mathématiques,3,La Dérivation,3,Theroeme de Rolle et des Accroissements Finis,7,658,5,QCU,0.09,0.93,65.0,42,23,65,53,42,11,1.23,79.25,Facile,Facile,0,Meme Difficulté,Adapte,Mathematics
658,2015,Mathématiques,3,La Dérivation,3,Theroeme de Rolle et des Accroissements Finis,7,659,6,QCM,0.2,0.34,47.0,21,24,45,30,21,9,1.5,70.0,Difficile,Moyen,1,Plus Facile,Pas Adapte,Mathematics
1782,2016,Mathématiques,3,La Dérivation,3,Theroeme de Rolle et des Accroissements Finis,7,659,6,QCM,0.72,0.23,11.0,5,42,47,24,5,19,1.96,20.83,Facile,Difficile,-2,Beaucoup plus Difficile,Pas Adapte,Mathematics
2906,2017,Mathématiques,3,La Dérivation,3,Theroeme de Rolle et des Accroissements Finis,7,659,6,QCM,0.47,0.48,53.0,24,22,46,29,24,5,1.59,82.76,Difficile,Moyen,1,Plus Facile,Pas Adapte,Mathematics
4030,2018,Mathématiques,3,La Dérivation,3,Theroeme de Rolle et des Accroissements Finis,7,659,6,QCM,0.7,0.17,11.0,5,44,49,16,5,11,3.06,31.25,Facile,Difficile,-2,Beaucoup plus Difficile,Pas Adapte,Mathematics
5154,2019,Mathématiques,3,La Dérivation,3,Theroeme de Rolle et des Accroissements Finis,7,659,6,QCM,0.64,0.2,5.0,2,40,42,39,2,37,1.08,5.13,Moyen,Difficile,-1,Plus Difficile,Pas Adapte,Mathematics
6278,2020,Mathématiques,3,La Dérivation,3,Theroeme de Rolle et des Accroissements Finis,7,659,6,QCM,0.58,0.26,34.0,13,25,38,27,13,14,1.41,48.15,Difficile,Difficile,0,Meme Difficulté,Pas Adapte,Mathematics
659,2015,Mathématiques,3,La Dérivation,3,Theroeme de Rolle et des Accroissements Finis,7,660,7,QCU,0.38,0.45,46.0,17,20,37,20,17,3,1.85,85.0,Facile,Moyen,-1,Plus Difficile,Pas Adapte,Mathematics
1783,2016,Mathématiques,3,La Dérivation,3,Theroeme de Rolle et des Accroissements Finis,7,660,7,QCU,0.36,0.72,45.0,18,22,40,21,18,3,1.9,85.71,Moyen,Moyen,0,Meme Difficulté,Pas Adapte,Mathematics
2907,2017,Mathématiques,3,La Dérivation,3,Theroeme de Rolle et des Accroissements Finis,7,660,7,QCM,0.31,0.69,49.0,21,22,43,25,21,4,1.72,84.0,Facile,Moyen,-1,Plus Difficile,Pas Adapte,Mathematics
4031,2018,Mathématiques,3,La Dérivation,3,Theroeme de Rolle et des Accroissements Finis,7,660,7,QCM,0.32,0.41,44.0,18,24,42,40,18,22,1.05,45.0,Facile,Moyen,-1,Plus Difficile,Pas Adapte,Mathematics
5155,2019,Mathématiques,3,La Dérivation,3,Theroeme de Rolle et des Accroissements Finis,7,660,7,QCU,0.63,0.34,26.0,10,27,37,23,10,13,1.61,43.48,Difficile,Difficile,0,Meme Difficulté,Pas Adapte,Mathematics
6279,2020,Mathématiques,3,La Dérivation,3,Theroeme de Rolle et des Accroissements Finis,7,660,7,QCU,0.4,0.71,56.0,22,17,39,26,22,4,1.5,84.62,Difficile,Moyen,1,Plus Facile,Pas Adapte,Mathematics
660,2015,Mathématiques,3,La Dérivation,4,La Fonction Exponentielle Complexe,7,661,1,QROC,0.48,0.39,57.0,52,39,91,80,52,28,1.14,65.0,Facile,Moyen,-1,Plus Difficile,Pas Adapte,Mathematics
1784,2016,Mathématiques,3,La Dérivation,4,La Fonction Exponentielle Complexe,7,661,1,QROC,0.85,0.11,4.0,3,79,82,68,3,65,1.21,4.41,Difficile,Difficile,0,Meme Difficulté,Pas Adapte,Mathematics
2908,2017,Mathématiques,3,La Dérivation,4,La Fonction Exponentielle Complexe,7,661,1,QROC,0.98,0.08,30.0,22,51,73,31,22,9,2.35,70.97,Facile,Difficile,-2,Beaucoup plus Difficile,Pas Adapte,Mathematics
4032,2018,Mathématiques,3,La Dérivation,4,La Fonction Exponentielle Complexe,7,661,1,QROC,0.95,0.07,22.0,18,64,82,42,18,24,1.95,42.86,Facile,Difficile,-2,Beaucoup plus Difficile,Pas Adapte,Mathematics
5156,2019,Mathématiques,3,La Dérivation,4,La Fonction Exponentielle Complexe,7,661,1,QROC,0.88,0.02,11.0,8,65,73,61,8,53,1.2,13.11,Difficile,Difficile,0,Meme Difficulté,Pas Adapte,Mathematics
6280,2020,Mathématiques,3,La Dérivation,4,La Fonction Exponentielle Complexe,7,661,1,QROC,0.28,0.26,61.0,51,33,84,59,51,8,1.42,86.44,Difficile,Moyen,1,Plus Facile,Adapte,Mathematics
661,2015,Mathématiques,3,La Dérivation,4,La Fonction Exponentielle Complexe,7,662,2,QCU,0.24,0.41,38.0,10,16,26,22,10,12,1.18,45.45,Difficile,Moyen,1,Plus Facile,Pas Adapte,Mathematics
1785,2016,Mathématiques,3,La Dérivation,4,La Fonction Exponentielle Complexe,7,662,2,QCU,0.52,0.27,23.0,7,22,29,12,7,5,2.42,58.33,Moyen,Difficile,-1,Plus Difficile,Pas Adapte,Mathematics
2909,2017,Mathématiques,3,La Dérivation,4,La Fonction Exponentielle Complexe,7,662,2,QO,0.31,0.22,57.0,15,11,26,15,15,0,1.73,100.0,Facile,Moyen,-1,Plus Difficile,Pas Adapte,Mathematics
4033,2018,Mathématiques,3,La Dérivation,4,La Fonction Exponentielle Complexe,7,662,2,QO,0.94,0.03,9.0,2,25,27,21,2,19,1.29,9.52,Facile,Difficile,-2,Beaucoup plus Difficile,Pas Adapte,Mathematics
5157,2019,Mathématiques,3,La Dérivation,4,La Fonction Exponentielle Complexe,7,662,2,QO,0.74,0.19,63.0,16,10,26,17,16,1,1.53,94.12,Difficile,Moyen,1,Plus Facile,Adapte,Mathematics
6281,2020,Mathématiques,3,La Dérivation,4,La Fonction Exponentielle Complexe,7,662,2,QO,0.65,0.29,63.0,17,10,27,25,17,8,1.08,68.0,Moyen,Moyen,0,Meme Difficulté,Adapte,Mathematics
662,2015,Mathématiques,3,La Dérivation,4,La Fonction Exponentielle Complexe,7,663,3,QCM,0.52,0.17,19.0,3,11,14,10,3,7,1.4,30.0,Facile,Difficile,-2,Beaucoup plus Difficile,Pas Adapte,Mathematics
1786,2016,Mathématiques,3,La Dérivation,4,La Fonction Exponentielle Complexe,7,663,3,QCM,0.57,0.23,10.0,2,13,15,4,2,2,3.75,50.0,Difficile,Difficile,0,Meme Difficulté,Pas Adapte,Mathematics
2910,2017,Mathématiques,3,La Dérivation,4,La Fonction Exponentielle Complexe,7,663,3,QCM,0.75,0.19,32.0,4,10,14,7,4,3,2.0,57.14,Difficile,Difficile,0,Meme Difficulté,Pas Adapte,Mathematics
4034,2018,Mathématiques,3,La Dérivation,4,La Fonction Exponentielle Complexe,7,663,3,QCM,0.61,0.25,2.0,0,15,15,14,0,14,1.07,0.0,Difficile,Difficile,0,Meme Difficulté,Pas Adapte,Mathematics
5158,2019,Mathématiques,3,La Dérivation,4,La Fonction Exponentielle Complexe,7,663,3,QCM,0.78,0.21,4.0,1,13,14,6,1,5,2.33,16.67,Moyen,Difficile,-1,Plus Difficile,Pas Adapte,Mathematics
6282,2020,Mathématiques,3,La Dérivation,4,La Fonction Exponentielle Complexe,7,663,3,QCU,0.65,0.3,18.0,2,11,13,6,2,4,2.17,33.33,Facile,Difficile,-2,Beaucoup plus Difficile,Pas Adapte,Mathematics
663,2015,Mathématiques,3,La Dérivation,4,La Fonction Exponentielle Complexe,7,664,4,QCM,0.68,0.27,6.0,3,43,46,45,3,42,1.02,6.67,Difficile,Difficile,0,Meme Difficulté,Pas Adapte,Mathematics
1787,2016,Mathématiques,3,La Dérivation,4,La Fonction Exponentielle Complexe,7,664,4,QCM,0.24,0.39,44.0,22,28,50,25,22,3,2.0,88.0,Moyen,Moyen,0,Meme Difficulté,Pas Adapte,Mathematics
2911,2017,Mathématiques,3,La Dérivation,4,La Fonction Exponentielle Complexe,7,664,4,QCM,0.4,0.51,62.0,32,19,51,32,32,0,1.59,100.0,Facile,Moyen,-1,Plus Difficile,Adapte,Mathematics
4035,2018,Mathématiques,3,La Dérivation,4,La Fonction Exponentielle Complexe,7,664,4,QCM,0.41,0.31,62.0,30,19,49,48,30,18,1.02,62.5,Moyen,Moyen,0,Meme Difficulté,Adapte,Mathematics
5159,2019,Mathématiques,3,La Dérivation,4,La Fonction Exponentielle Complexe,7,664,4,QCU,0.27,0.7,62.0,31,19,50,37,31,6,1.35,83.78,Moyen,Moyen,0,Meme Difficulté,Adapte,Mathematics
6283,2020,Mathématiques,3,La Dérivation,4,La Fonction Exponentielle Complexe,7,664,4,QROC,0.55,0.35,62.0,34,21,55,35,34,1,1.57,97.14,Moyen,Moyen,0,Meme Difficulté,Adapte,Mathematics
664,2015,Mathématiques,3,La Dérivation,4,La Fonction Exponentielle Complexe,7,665,5,QCU,0.41,0.24,23.0,11,35,46,35,11,24,1.31,31.43,Difficile,Difficile,0,Meme Difficulté,Pas Adapte,Mathematics
1788,2016,Mathématiques,3,La Dérivation,4,La Fonction Exponentielle Complexe,7,665,5,QCM,0.71,0.23,1.0,0,39,39,33,0,33,1.18,0.0,Difficile,Difficile,0,Meme Difficulté,Pas Adapte,Mathematics
2912,2017,Mathématiques,3,La Dérivation,4,La Fonction Exponentielle Complexe,7,665,5,QCM,0.41,0.46,59.0,24,16,40,28,24,4,1.43,85.71,Facile,Moyen,-1,Plus Difficile,Pas Adapte,Mathematics
4036,2018,Mathématiques,3,La Dérivation,4,La Fonction Exponentielle Complexe,7,665,5,QCU,0.56,0.25,35.0,13,23,36,20,13,7,1.8,65.0,Moyen,Difficile,-1,Plus Difficile,Pas Adapte,Mathematics
5160,2019,Mathématiques,3,La Dérivation,4,La Fonction Exponentielle Complexe,7,665,5,QCU,0.53,0.31,20.0,6,25,31,15,6,9,2.07,40.0,Facile,Difficile,-2,Beaucoup plus Difficile,Pas Adapte,Mathematics
6284,2020,Mathématiques,3,La Dérivation,4,La Fonction Exponentielle Complexe,7,665,5,QCU,0.71,0.38,14.0,4,25,29,17,4,13,1.71,23.53,Difficile,Difficile,0,Meme Difficulté,Pas Adapte,Mathematics
665,2015,Mathématiques,3,La Dérivation,4,La Fonction Exponentielle Complexe,7,666,6,QCM,0.25,0.54,41.0,7,11,18,10,7,3,1.8,70.0,Moyen,Moyen,0,Meme Difficulté,Pas Adapte,Mathematics
1789,2016,Mathématiques,3,La Dérivation,4,La Fonction Exponentielle Complexe,7,666,6,QCM,0.38,0.61,40.0,6,9,15,13,6,7,1.15,46.15,Facile,Moyen,-1,Plus Difficile,Pas Adapte,Mathematics
2913,2017,Mathématiques,3,La Dérivation,4,La Fonction Exponentielle Complexe,7,666,6,QCU,0.27,0.72,42.0,6,8,14,10,6,4,1.4,60.0,Difficile,Moyen,1,Plus Facile,Pas Adapte,Mathematics
4037,2018,Mathématiques,3,La Dérivation,4,La Fonction Exponentielle Complexe,7,666,6,QCU,0.34,0.59,55.0,7,6,13,10,7,3,1.3,70.0,Moyen,Moyen,0,Meme Difficulté,Pas Adapte,Mathematics
5161,2019,Mathématiques,3,La Dérivation,4,La Fonction Exponentielle Complexe,7,666,6,QCU,0.31,0.67,39.0,5,8,13,6,5,1,2.17,83.33,Difficile,Moyen,1,Plus Facile,Pas Adapte,Mathematics
6285,2020,Mathématiques,3,La Dérivation,4,La Fonction Exponentielle Complexe,7,666,6,QCU,0.66,0.27,14.0,2,12,14,5,2,3,2.8,40.0,Difficile,Difficile,0,Meme Difficulté,Pas Adapte,Mathematics
666,2015,Mathématiques,3,La Dérivation,4,La Fonction Exponentielle Complexe,7,667,7,QROC,0.62,0.16,2.0,1,43,44,41,1,40,1.07,2.44,Difficile,Difficile,0,Meme Difficulté,Pas Adapte,Mathematics
1790,2016,Mathématiques,3,La Dérivation,4,La Fonction Exponentielle Complexe,7,667,7,QROC,0.79,0.07,16.0,7,39,46,26,7,19,1.77,26.92,Moyen,Difficile,-1,Plus Difficile,Pas Adapte,Mathematics
2914,2017,Mathématiques,3,La Dérivation,4,La Fonction Exponentielle Complexe,7,667,7,QROC,0.63,0.0,5.0,3,49,52,21,3,18,2.48,14.29,Difficile,Difficile,0,Meme Difficulté,Pas Adapte,Mathematics
4038,2018,Mathématiques,3,La Dérivation,4,La Fonction Exponentielle Complexe,7,667,7,QROC,0.79,0.03,29.0,13,32,45,35,13,22,1.29,37.14,Facile,Difficile,-2,Beaucoup plus Difficile,Pas Adapte,Mathematics
5162,2019,Mathématiques,3,La Dérivation,4,La Fonction Exponentielle Complexe,7,667,7,QO,0.74,0.2,51.0,26,24,50,44,26,18,1.14,59.09,Facile,Moyen,-1,Plus Difficile,Pas Adapte,Mathematics
6286,2020,Mathématiques,3,La Dérivation,4,La Fonction Exponentielle Complexe,7,667,7,QO,0.61,0.22,36.0,17,31,48,43,17,26,1.12,39.53,Facile,Moyen,-1,Plus Difficile,Pas Adapte,Mathematics
667,2015,Mathématiques,3,La Dérivation,5,Derivees d'Ordres Superieurs,5,668,1,QCU,0.52,0.36,22.0,17,59,76,68,17,51,1.12,25.0,Moyen,Difficile,-1,Plus Difficile,Pas Adapte,Mathematics
1791,2016,Mathématiques,3,La Dérivation,5,Derivees d'Ordres Superieurs,5,668,1,QCU,0.04,0.85,65.0,56,30,86,73,56,17,1.18,76.71,Facile,Facile,0,Meme Difficulté,Adapte,Mathematics
2915,2017,Mathématiques,3,La Dérivation,5,Derivees d'Ordres Superieurs,5,668,1,QCU,0.04,0.88,65.0,47,26,73,47,47,0,1.55,100.0,Facile,Facile,0,Meme Difficulté,Adapte,Mathematics
4039,2018,Mathématiques,3,La Dérivation,5,Derivees d'Ordres Superieurs,5,668,1,QCU,0.07,0.76,65.0,49,26,75,66,49,17,1.14,74.24,Facile,Facile,0,Meme Difficulté,Adapte,Mathematics
5163,2019,Mathématiques,3,La Dérivation,5,Derivees d'Ordres Superieurs,5,668,1,QCU,0.09,0.89,65.0,53,28,81,75,53,22,1.08,70.67,Facile,Facile,0,Meme Difficulté,Adapte,Mathematics
6287,2020,Mathématiques,3,La Dérivation,5,Derivees d'Ordres Superieurs,5,668,1,QCU,0.09,0.97,65.0,55,29,84,75,55,20,1.12,73.33,Facile,Facile,0,Meme Difficulté,Adapte,Mathematics
668,2015,Mathématiques,3,La Dérivation,5,Derivees d'Ordres Superieurs,5,669,2,QO,0.62,0.17,60.0,25,16,41,38,25,13,1.08,65.79,Facile,Moyen,-1,Plus Difficile,Adapte,Mathematics
1792,2016,Mathématiques,3,La Dérivation,5,Derivees d'Ordres Superieurs,5,669,2,QO,0.54,0.21,60.0,25,17,42,37,25,12,1.14,67.57,Moyen,Moyen,0,Meme Difficulté,Adapte,Mathematics
2916,2017,Mathématiques,3,La Dérivation,5,Derivees d'Ordres Superieurs,5,669,2,QO,0.65,0.2,60.0,24,16,40,27,24,3,1.48,88.89,Moyen,Moyen,0,Meme Difficulté,Adapte,Mathematics
4040,2018,Mathématiques,3,La Dérivation,5,Derivees d'Ordres Superieurs,5,669,2,QO,0.36,0.18,60.0,25,16,41,28,25,3,1.46,89.29,Moyen,Moyen,0,Meme Difficulté,Adapte,Mathematics
5164,2019,Mathématiques,3,La Dérivation,5,Derivees d'Ordres Superieurs,5,669,2,QO,0.57,0.19,60.0,28,18,46,38,28,10,1.21,73.68,Moyen,Moyen,0,Meme Difficulté,Adapte,Mathematics
6288,2020,Mathématiques,3,La Dérivation,5,Derivees d'Ordres Superieurs,5,669,2,QROC,0.39,0.28,60.0,31,21,52,40,31,9,1.3,77.5,Moyen,Moyen,0,Meme Difficulté,Adapte,Mathematics
669,2015,Mathématiques,3,La Dérivation,5,Derivees d'Ordres Superieurs,5,670,3,QCU,0.21,0.64,45.0,29,35,64,53,29,24,1.21,54.72,Facile,Moyen,-1,Plus Difficile,Pas Adapte,Mathematics
1793,2016,Mathématiques,3,La Dérivation,5,Derivees d'Ordres Superieurs,5,670,3,QCM,0.78,0.23,12.0,9,64,73,66,9,57,1.11,13.64,Facile,Difficile,-2,Beaucoup plus Difficile,Pas Adapte,Mathematics
2917,2017,Mathématiques,3,La Dérivation,5,Derivees d'Ordres Superieurs,5,670,3,QCM,0.44,0.69,45.0,31,37,68,65,31,34,1.05,47.69,Difficile,Moyen,1,Plus Facile,Pas Adapte,Mathematics
4041,2018,Mathématiques,3,La Dérivation,5,Derivees d'Ordres Superieurs,5,670,3,QCM,0.46,0.48,39.0,30,47,77,72,30,42,1.07,41.67,Facile,Moyen,-1,Plus Difficile,Pas Adapte,Mathematics
5165,2019,Mathématiques,3,La Dérivation,5,Derivees d'Ordres Superieurs,5,670,3,QCM,0.23,0.58,54.0,48,41,89,59,48,11,1.51,81.36,Moyen,Moyen,0,Meme Difficulté,Pas Adapte,Mathematics
6289,2020,Mathématiques,3,La Dérivation,5,Derivees d'Ordres Superieurs,5,670,3,QCM,0.39,0.64,47.0,39,43,82,71,39,32,1.15,54.93,Facile,Moyen,-1,Plus Difficile,Pas Adapte,Mathematics
670,2015,Mathématiques,3,La Dérivation,5,Derivees d'Ordres Superieurs,5,671,4,QCU,0.48,0.22,29.0,19,47,66,65,19,46,1.02,29.23,Difficile,Difficile,0,Meme Difficulté,Pas Adapte,Mathematics
1794,2016,Mathématiques,3,La Dérivation,5,Derivees d'Ordres Superieurs,5,671,4,QCU,0.28,0.72,46.0,30,35,65,45,30,15,1.44,66.67,Moyen,Moyen,0,Meme Difficulté,Pas Adapte,Mathematics
2918,2017,Mathématiques,3,La Dérivation,5,Derivees d'Ordres Superieurs,5,671,4,QCM,0.44,0.53,36.0,20,36,56,21,20,1,2.67,95.24,Difficile,Moyen,1,Plus Facile,Pas Adapte,Mathematics
4042,2018,Mathématiques,3,La Dérivation,5,Derivees d'Ordres Superieurs,5,671,4,QCM,0.58,0.24,3.0,2,51,53,25,2,23,2.12,8.0,Facile,Difficile,-2,Beaucoup plus Difficile,Pas Adapte,Mathematics
5166,2019,Mathématiques,3,La Dérivation,5,Derivees d'Ordres Superieurs,5,671,4,QCM,0.39,0.34,41.0,20,29,49,20,20,0,2.45,100.0,Moyen,Moyen,0,Meme Difficulté,Pas Adapte,Mathematics
6290,2020,Mathématiques,3,La Dérivation,5,Derivees d'Ordres Superieurs,5,671,4,QCM,0.47,0.32,64.0,32,18,50,49,32,17,1.02,65.31,Facile,Moyen,-1,Plus Difficile,Adapte,Mathematics
671,2015,Mathématiques,3,La Dérivation,5,Derivees d'Ordres Superieurs,5,672,5,QCM,0.38,0.4,64.0,29,16,45,42,29,13,1.07,69.05,Facile,Moyen,-1,Plus Difficile,Adapte,Mathematics
1795,2016,Mathématiques,3,La Dérivation,5,Derivees d'Ordres Superieurs,5,672,5,QCM,0.46,0.66,64.0,26,15,41,41,26,15,1.0,63.41,Moyen,Moyen,0,Meme Difficulté,Adapte,Mathematics
2919,2017,Mathématiques,3,La Dérivation,5,Derivees d'Ordres Superieurs,5,672,5,QCM,0.45,0.52,64.0,22,13,35,26,22,4,1.35,84.62,Moyen,Moyen,0,Meme Difficulté,Adapte,Mathematics
4043,2018,Mathématiques,3,La Dérivation,5,Derivees d'Ordres Superieurs,5,672,5,QCM,0.43,0.59,64.0,22,12,34,22,22,0,1.55,100.0,Moyen,Moyen,0,Meme Difficulté,Adapte,Mathematics
5167,2019,Mathématiques,3,La Dérivation,5,Derivees d'Ordres Superieurs,5,672,5,QCU,0.25,0.53,64.0,23,13,36,30,23,7,1.2,76.67,Moyen,Moyen,0,Meme Difficulté,Adapte,Mathematics
6291,2020,Mathématiques,3,La Dérivation,5,Derivees d'Ordres Superieurs,5,672,5,QCU,0.31,0.6,64.0,24,14,38,36,24,12,1.06,66.67,Moyen,Moyen,0,Meme Difficulté,Adapte,Mathematics
672,2015,Mathématiques,3,La Dérivation,6,Classe Cn par Morceaux,6,673,1,QCM,0.67,0.29,14.0,2,9,11,10,2,8,1.1,20.0,Facile,Difficile,-2,Beaucoup plus Difficile,Pas Adapte,Mathematics
1796,2016,Mathématiques,3,La Dérivation,6,Classe Cn par Morceaux,6,673,1,QCM,0.39,0.49,47.0,6,7,13,13,6,7,1.0,46.15,Facile,Moyen,-1,Plus Difficile,Pas Adapte,Mathematics
2920,2017,Mathématiques,3,La Dérivation,6,Classe Cn par Morceaux,6,673,1,QCU,0.24,0.72,37.0,6,9,15,14,6,8,1.07,42.86,Difficile,Moyen,1,Plus Facile,Pas Adapte,Mathematics
4044,2018,Mathématiques,3,La Dérivation,6,Classe Cn par Morceaux,6,673,1,QCU,0.43,0.33,32.0,4,10,14,8,4,4,1.75,50.0,Facile,Difficile,-2,Beaucoup plus Difficile,Pas Adapte,Mathematics
5168,2019,Mathématiques,3,La Dérivation,6,Classe Cn par Morceaux,6,673,1,QCU,0.48,0.39,3.0,0,13,13,11,0,11,1.18,0.0,Facile,Difficile,-2,Beaucoup plus Difficile,Pas Adapte,Mathematics
6292,2020,Mathématiques,3,La Dérivation,6,Classe Cn par Morceaux,6,673,1,QCM,0.54,0.28,14.0,2,11,13,10,2,8,1.3,20.0,Facile,Difficile,-2,Beaucoup plus Difficile,Pas Adapte,Mathematics
673,2015,Mathématiques,3,La Dérivation,6,Classe Cn par Morceaux,6,674,2,QCU,0.25,0.64,54.0,36,30,66,61,36,25,1.08,59.02,Difficile,Moyen,1,Plus Facile,Pas Adapte,Mathematics
1797,2016,Mathématiques,3,La Dérivation,6,Classe Cn par Morceaux,6,674,2,QCM,0.69,0.23,8.0,6,66,72,53,6,47,1.36,11.32,Moyen,Difficile,-1,Plus Difficile,Pas Adapte,Mathematics
2921,2017,Mathématiques,3,La Dérivation,6,Classe Cn par Morceaux,6,674,2,QCM,0.79,0.3,15.0,12,69,81,64,12,52,1.27,18.75,Facile,Difficile,-2,Beaucoup plus Difficile,Pas Adapte,Mathematics
4045,2018,Mathématiques,3,La Dérivation,6,Classe Cn par Morceaux,6,674,2,QCU,0.43,0.24,25.0,18,56,74,52,18,34,1.42,34.62,Difficile,Difficile,0,Meme Difficulté,Pas Adapte,Mathematics
5169,2019,Mathématiques,3,La Dérivation,6,Classe Cn par Morceaux,6,674,2,QCU,0.2,0.44,51.0,43,42,85,57,43,14,1.49,75.44,Difficile,Moyen,1,Plus Facile,Pas Adapte,Mathematics
6293,2020,Mathématiques,3,La Dérivation,6,Classe Cn par Morceaux,6,674,2,QCU,0.62,0.34,20.0,20,78,98,36,20,16,2.72,55.56,Moyen,Difficile,-1,Plus Difficile,Pas Adapte,Mathematics
674,2015,Mathématiques,3,La Dérivation,6,Classe Cn par Morceaux,6,675,3,QCM,0.66,0.15,31.0,15,33,48,20,15,5,2.4,75.0,Moyen,Difficile,-1,Plus Difficile,Pas Adapte,Mathematics
1798,2016,Mathématiques,3,La Dérivation,6,Classe Cn par Morceaux,6,675,3,QCM,0.68,0.27,4.0,2,46,48,27,2,25,1.78,7.41,Difficile,Difficile,0,Meme Difficulté,Pas Adapte,Mathematics
2922,2017,Mathématiques,3,La Dérivation,6,Classe Cn par Morceaux,6,675,3,QCU,0.32,0.71,53.0,24,22,46,45,24,21,1.02,53.33,Facile,Moyen,-1,Plus Difficile,Pas Adapte,Mathematics
4046,2018,Mathématiques,3,La Dérivation,6,Classe Cn par Morceaux,6,675,3,QCU,0.26,0.51,64.0,26,14,40,39,26,13,1.03,66.67,Moyen,Moyen,0,Meme Difficulté,Adapte,Mathematics
5170,2019,Mathématiques,3,La Dérivation,6,Classe Cn par Morceaux,6,675,3,QCU,0.28,0.63,64.0,28,16,44,39,28,11,1.13,71.79,Moyen,Moyen,0,Meme Difficulté,Adapte,Mathematics
6294,2020,Mathématiques,3,La Dérivation,6,Classe Cn par Morceaux,6,675,3,QCU,0.39,0.67,64.0,28,15,43,35,28,7,1.23,80.0,Moyen,Moyen,0,Meme Difficulté,Adapte,Mathematics
675,2015,Mathématiques,3,La Dérivation,6,Classe Cn par Morceaux,6,676,4,QCU,0.3,0.64,53.0,28,24,52,30,28,2,1.73,93.33,Moyen,Moyen,0,Meme Difficulté,Pas Adapte,Mathematics
1799,2016,Mathématiques,3,La Dérivation,6,Classe Cn par Morceaux,6,676,4,QCU,0.33,0.73,41.0,23,32,55,26,23,3,2.12,88.46,Facile,Moyen,-1,Plus Difficile,Pas Adapte,Mathematics
2923,2017,Mathématiques,3,La Dérivation,6,Classe Cn par Morceaux,6,676,4,QCU,0.65,0.25,13.0,7,47,54,40,7,33,1.35,17.5,Facile,Difficile,-2,Beaucoup plus Difficile,Pas Adapte,Mathematics
4047,2018,Mathématiques,3,La Dérivation,6,Classe Cn par Morceaux,6,676,4,QCU,0.31,0.45,63.0,33,19,52,46,33,13,1.13,71.74,Difficile,Moyen,1,Plus Facile,Adapte,Mathematics
5171,2019,Mathématiques,3,La Dérivation,6,Classe Cn par Morceaux,6,676,4,QCU,0.22,0.7,63.0,30,17,47,40,30,10,1.18,75.0,Moyen,Moyen,0,Meme Difficulté,Adapte,Mathematics
6295,2020,Mathématiques,3,La Dérivation,6,Classe Cn par Morceaux,6,676,4,QCU,0.28,0.56,63.0,27,16,43,41,27,14,1.05,65.85,Moyen,Moyen,0,Meme Difficulté,Adapte,Mathematics
676,2015,Mathématiques,3,La Dérivation,6,Classe Cn par Morceaux,6,677,5,QCM,0.61,0.27,23.0,4,14,18,14,4,10,1.29,28.57,Facile,Difficile,-2,Beaucoup plus Difficile,Pas Adapte,Mathematics
1800,2016,Mathématiques,3,La Dérivation,6,Classe Cn par Morceaux,6,677,5,QCM,0.77,0.15,6.0,1,20,21,7,1,6,3.0,14.29,Difficile,Difficile,0,Meme Difficulté,Pas Adapte,Mathematics
2924,2017,Mathématiques,3,La Dérivation,6,Classe Cn par Morceaux,6,677,5,QO,0.84,0.06,16.0,4,19,23,22,4,18,1.05,18.18,Difficile,Difficile,0,Meme Difficulté,Pas Adapte,Mathematics
4048,2018,Mathématiques,3,La Dérivation,6,Classe Cn par Morceaux,6,677,5,QO,0.34,0.27,60.0,13,8,21,18,13,5,1.17,72.22,Difficile,Moyen,1,Plus Facile,Adapte,Mathematics
5172,2019,Mathématiques,3,La Dérivation,6,Classe Cn par Morceaux,6,677,5,QO,0.64,0.15,60.0,14,10,24,17,14,3,1.41,82.35,Moyen,Moyen,0,Meme Difficulté,Adapte,Mathematics
6296,2020,Mathématiques,3,La Dérivation,6,Classe Cn par Morceaux,6,677,5,QO,0.56,0.23,60.0,13,9,22,20,13,7,1.1,65.0,Moyen,Moyen,0,Meme Difficulté,Adapte,Mathematics
677,2015,Mathématiques,3,La Dérivation,6,Classe Cn par Morceaux,6,678,6,QCU,0.68,0.4,2.0,2,96,98,44,2,42,2.23,4.55,Moyen,Difficile,-1,Plus Difficile,Pas Adapte,Mathematics
1801,2016,Mathématiques,3,La Dérivation,6,Classe Cn par Morceaux,6,678,6,QCU,0.31,0.54,56.0,55,43,98,90,55,35,1.09,61.11,Moyen,Moyen,0,Meme Difficulté,Pas Adapte,Mathematics
2925,2017,Mathématiques,3,La Dérivation,6,Classe Cn par Morceaux,6,678,6,QCU,0.64,0.37,10.0,11,98,109,104,11,93,1.05,10.58,Facile,Difficile,-2,Beaucoup plus Difficile,Pas Adapte,Mathematics
4049,2018,Mathématiques,3,La Dérivation,6,Classe Cn par Morceaux,6,678,6,QCU,0.27,0.7,58.0,62,45,107,64,62,2,1.67,96.88,Moyen,Moyen,0,Meme Difficulté,Pas Adapte,Mathematics
5173,2019,Mathématiques,3,La Dérivation,6,Classe Cn par Morceaux,6,678,6,QCU,0.24,0.47,57.0,53,40,93,82,53,29,1.13,64.63,Moyen,Moyen,0,Meme Difficulté,Pas Adapte,Mathematics
6297,2020,Mathématiques,3,La Dérivation,6,Classe Cn par Morceaux,6,678,6,QCM,0.4,0.31,53.0,48,42,90,58,48,10,1.55,82.76,Difficile,Moyen,1,Plus Facile,Pas Adapte,Mathematics
678,2015,Mathématiques,3,La Dérivation,7,Fonctions Reciproques,11,679,1,QCU,0.31,0.43,43.0,11,14,25,17,11,6,1.47,64.71,Facile,Moyen,-1,Plus Difficile,Pas Adapte,Mathematics
1802,2016,Mathématiques,3,La Dérivation,7,Fonctions Reciproques,11,679,1,QROC,0.73,0.12,10.0,3,25,28,21,3,18,1.33,14.29,Facile,Difficile,-2,Beaucoup plus Difficile,Pas Adapte,Mathematics
2926,2017,Mathématiques,3,La Dérivation,7,Fonctions Reciproques,11,679,1,QROC,0.41,0.28,61.0,15,9,24,16,15,1,1.5,93.75,Facile,Moyen,-1,Plus Difficile,Adapte,Mathematics
4050,2018,Mathématiques,3,La Dérivation,7,Fonctions Reciproques,11,679,1,QROC,0.3,0.26,61.0,15,9,24,23,15,8,1.04,65.22,Moyen,Moyen,0,Meme Difficulté,Adapte,Mathematics
5174,2019,Mathématiques,3,La Dérivation,7,Fonctions Reciproques,11,679,1,QROC,0.32,0.29,61.0,15,9,24,21,15,6,1.14,71.43,Moyen,Moyen,0,Meme Difficulté,Adapte,Mathematics
6298,2020,Mathématiques,3,La Dérivation,7,Fonctions Reciproques,11,679,1,QO,0.6,0.15,61.0,15,10,25,24,15,9,1.04,62.5,Moyen,Moyen,0,Meme Difficulté,Adapte,Mathematics
679,2015,Mathématiques,3,La Dérivation,7,Fonctions Reciproques,11,680,2,QROC,0.54,0.36,58.0,55,39,94,59,55,4,1.59,93.22,Facile,Moyen,-1,Plus Difficile,Pas Adapte,Mathematics
1803,2016,Mathématiques,3,La Dérivation,7,Fonctions Reciproques,11,680,2,QO,0.71,0.3,56.0,57,45,102,79,57,22,1.29,72.15,Facile,Moyen,-1,Plus Difficile,Pas Adapte,Mathematics
2927,2017,Mathématiques,3,La Dérivation,7,Fonctions Reciproques,11,680,2,QO,0.88,0.02,31.0,33,72,105,87,33,54,1.21,37.93,Difficile,Difficile,0,Meme Difficulté,Pas Adapte,Mathematics
4051,2018,Mathématiques,3,La Dérivation,7,Fonctions Reciproques,11,680,2,QO,0.31,0.18,60.0,67,44,111,79,67,12,1.41,84.81,Moyen,Moyen,0,Meme Difficulté,Adapte,Mathematics
5175,2019,Mathématiques,3,La Dérivation,7,Fonctions Reciproques,11,680,2,QO,0.61,0.16,60.0,59,39,98,59,59,0,1.66,100.0,Moyen,Moyen,0,Meme Difficulté,Adapte,Mathematics
6299,2020,Mathématiques,3,La Dérivation,7,Fonctions Reciproques,11,680,2,QO,0.61,0.17,60.0,55,37,92,76,55,21,1.21,72.37,Moyen,Moyen,0,Meme Difficulté,Adapte,Mathematics
680,2015,Mathématiques,3,La Dérivation,7,Fonctions Reciproques,11,681,3,QCU,0.4,0.3,28.0,12,32,44,29,12,17,1.52,41.38,Difficile,Difficile,0,Meme Difficulté,Pas Adapte,Mathematics
1804,2016,Mathématiques,3,La Dérivation,7,Fonctions Reciproques,11,681,3,QCU,0.38,0.41,45.0,18,21,39,21,18,3,1.86,85.71,Moyen,Moyen,0,Meme Difficulté,Pas Adapte,Mathematics
2928,2017,Mathématiques,3,La Dérivation,7,Fonctions Reciproques,11,681,3,QCU,0.21,0.48,39.0,14,22,36,30,14,16,1.2,46.67,Facile,Moyen,-1,Plus Difficile,Pas Adapte,Mathematics
4052,2018,Mathématiques,3,La Dérivation,7,Fonctions Reciproques,11,681,3,QCU,0.31,0.6,38.0,12,19,31,15,12,3,2.07,80.0,Moyen,Moyen,0,Meme Difficulté,Pas Adapte,Mathematics
5176,2019,Mathématiques,3,La Dérivation,7,Fonctions Reciproques,11,681,3,QO,0.39,0.19,44.0,16,20,36,33,16,17,1.09,48.48,Moyen,Moyen,0,Meme Difficulté,Pas Adapte,Mathematics
6300,2020,Mathématiques,3,La Dérivation,7,Fonctions Reciproques,11,681,3,QO,0.86,0.12,15.0,6,34,40,36,6,30,1.11,16.67,Facile,Difficile,-2,Beaucoup plus Difficile,Pas Adapte,Mathematics
681,2015,Mathématiques,3,La Dérivation,7,Fonctions Reciproques,11,682,4,QCM,0.46,0.55,41.0,23,34,57,34,23,11,1.68,67.65,Facile,Moyen,-1,Plus Difficile,Pas Adapte,Mathematics
1805,2016,Mathématiques,3,La Dérivation,7,Fonctions Reciproques,11,682,4,QCM,0.26,0.55,58.0,32,23,55,52,32,20,1.06,61.54,Difficile,Moyen,1,Plus Facile,Pas Adapte,Mathematics
2929,2017,Mathématiques,3,La Dérivation,7,Fonctions Reciproques,11,682,4,QCM,0.66,0.16,4.0,2,59,61,57,2,55,1.07,3.51,Facile,Difficile,-2,Beaucoup plus Difficile,Pas Adapte,Mathematics
4053,2018,Mathématiques,3,La Dérivation,7,Fonctions Reciproques,11,682,4,QCM,0.7,0.17,15.0,8,47,55,49,8,41,1.12,16.33,Difficile,Difficile,0,Meme Difficulté,Pas Adapte,Mathematics
5177,2019,Mathématiques,3,La Dérivation,7,Fonctions Reciproques,11,682,4,QCU,0.52,0.25,16.0,8,43,51,22,8,14,2.32,36.36,Moyen,Difficile,-1,Plus Difficile,Pas Adapte,Mathematics
6301,2020,Mathématiques,3,La Dérivation,7,Fonctions Reciproques,11,682,4,QCU,0.29,0.74,51.0,28,27,55,36,28,8,1.53,77.78,Difficile,Moyen,1,Plus Facile,Pas Adapte,Mathematics
682,2015,Mathématiques,3,La Dérivation,7,Fonctions Reciproques,11,683,5,QCU,0.37,0.55,44.0,29,38,67,67,29,38,1.0,43.28,Moyen,Moyen,0,Meme Difficulté,Pas Adapte,Mathematics
1806,2016,Mathématiques,3,La Dérivation,7,Fonctions Reciproques,11,683,5,QCU,0.68,0.28,33.0,21,44,65,57,21,36,1.14,36.84,Difficile,Difficile,0,Meme Difficulté,Pas Adapte,Mathematics
2930,2017,Mathématiques,3,La Dérivation,7,Fonctions Reciproques,11,683,5,QCU,0.64,0.3,27.0,16,45,61,57,16,41,1.07,28.07,Facile,Difficile,-2,Beaucoup plus Difficile,Pas Adapte,Mathematics
4054,2018,Mathématiques,3,La Dérivation,7,Fonctions Reciproques,11,683,5,QROC,0.49,0.29,36.0,25,45,70,31,25,6,2.26,80.65,Moyen,Moyen,0,Meme Difficulté,Pas Adapte,Mathematics
5178,2019,Mathématiques,3,La Dérivation,7,Fonctions Reciproques,11,683,5,QROC,0.35,0.31,39.0,30,47,77,43,30,13,1.79,69.77,Difficile,Moyen,1,Plus Facile,Pas Adapte,Mathematics
6302,2020,Mathématiques,3,La Dérivation,7,Fonctions Reciproques,11,683,5,QROC,0.6,0.07,19.0,13,53,66,32,13,19,2.06,40.62,Difficile,Difficile,0,Meme Difficulté,Pas Adapte,Mathematics
683,2015,Mathématiques,3,La Dérivation,7,Fonctions Reciproques,11,684,6,QCU,0.71,0.27,28.0,15,38,53,47,15,32,1.13,31.91,Difficile,Difficile,0,Meme Difficulté,Pas Adapte,Mathematics
1807,2016,Mathématiques,3,La Dérivation,7,Fonctions Reciproques,11,684,6,QCU,0.22,0.55,62.0,33,20,53,49,33,16,1.08,67.35,Difficile,Moyen,1,Plus Facile,Adapte,Mathematics
2931,2017,Mathématiques,3,La Dérivation,7,Fonctions Reciproques,11,684,6,QCU,0.32,0.7,62.0,29,17,46,40,29,11,1.15,72.5,Moyen,Moyen,0,Meme Difficulté,Adapte,Mathematics
4055,2018,Mathématiques,3,La Dérivation,7,Fonctions Reciproques,11,684,6,QCU,0.25,0.61,62.0,26,16,42,37,26,11,1.14,70.27,Moyen,Moyen,0,Meme Difficulté,Adapte,Mathematics
5179,2019,Mathématiques,3,La Dérivation,7,Fonctions Reciproques,11,684,6,QCM,0.45,0.4,62.0,30,18,48,41,30,11,1.17,73.17,Moyen,Moyen,0,Meme Difficulté,Adapte,Mathematics
6303,2020,Mathématiques,3,La Dérivation,7,Fonctions Reciproques,11,684,6,QCU,0.34,0.62,62.0,27,16,43,27,27,0,1.59,100.0,Moyen,Moyen,0,Meme Difficulté,Adapte,Mathematics
684,2015,Mathématiques,3,La Dérivation,7,Fonctions Reciproques,11,685,7,QCM,0.59,0.21,25.0,22,65,87,57,22,35,1.53,38.6,Moyen,Difficile,-1,Plus Difficile,Pas Adapte,Mathematics
1808,2016,Mathématiques,3,La Dérivation,7,Fonctions Reciproques,11,685,7,QCM,0.46,0.38,57.0,57,43,100,93,57,36,1.08,61.29,Moyen,Moyen,0,Meme Difficulté,Pas Adapte,Mathematics
2932,2017,Mathématiques,3,La Dérivation,7,Fonctions Reciproques,11,685,7,QCM,0.35,0.54,55.0,56,46,102,81,56,25,1.26,69.14,Difficile,Moyen,1,Plus Facile,Pas Adapte,Mathematics
4056,2018,Mathématiques,3,La Dérivation,7,Fonctions Reciproques,11,685,7,QCM,0.5,0.63,61.0,58,37,95,93,58,35,1.02,62.37,Facile,Moyen,-1,Plus Difficile,Adapte,Mathematics
5180,2019,Mathématiques,3,La Dérivation,7,Fonctions Reciproques,11,685,7,QCU,0.39,0.54,61.0,49,32,81,55,49,6,1.47,89.09,Moyen,Moyen,0,Meme Difficulté,Adapte,Mathematics
6304,2020,Mathématiques,3,La Dérivation,7,Fonctions Reciproques,11,685,7,QCU,0.24,0.61,61.0,56,36,92,86,56,30,1.07,65.12,Moyen,Moyen,0,Meme Difficulté,Adapte,Mathematics
685,2015,Mathématiques,3,La Dérivation,7,Fonctions Reciproques,11,686,8,QCM,0.53,0.25,27.0,8,22,30,20,8,12,1.5,40.0,Moyen,Difficile,-1,Plus Difficile,Pas Adapte,Mathematics
1809,2016,Mathématiques,3,La Dérivation,7,Fonctions Reciproques,11,686,8,QCM,0.74,0.26,6.0,2,32,34,28,2,26,1.21,7.14,Difficile,Difficile,0,Meme Difficulté,Pas Adapte,Mathematics
2933,2017,Mathématiques,3,La Dérivation,7,Fonctions Reciproques,11,686,8,QCM,0.74,0.16,1.0,0,39,39,18,0,18,2.17,0.0,Facile,Difficile,-2,Beaucoup plus Difficile,Pas Adapte,Mathematics
4057,2018,Mathématiques,3,La Dérivation,7,Fonctions Reciproques,11,686,8,QCU,0.52,0.21,1.0,0,33,33,31,0,31,1.06,0.0,Facile,Difficile,-2,Beaucoup plus Difficile,Pas Adapte,Mathematics
5181,2019,Mathématiques,3,La Dérivation,7,Fonctions Reciproques,11,686,8,QCU,0.71,0.31,29.0,9,21,30,10,9,1,3.0,90.0,Difficile,Difficile,0,Meme Difficulté,Pas Adapte,Mathematics
6305,2020,Mathématiques,3,La Dérivation,7,Fonctions Reciproques,11,686,8,QCU,0.34,0.74,60.0,20,14,34,22,20,2,1.55,90.91,Difficile,Moyen,1,Plus Facile,Adapte,Mathematics
686,2015,Mathématiques,3,La Dérivation,7,Fonctions Reciproques,11,687,9,QCU,0.73,0.39,11.0,1,12,13,5,1,4,2.6,20.0,Difficile,Difficile,0,Meme Difficulté,Pas Adapte,Mathematics
1810,2016,Mathématiques,3,La Dérivation,7,Fonctions Reciproques,11,687,9,QCU,0.28,0.63,43.0,6,7,13,8,6,2,1.62,75.0,Difficile,Moyen,1,Plus Facile,Pas Adapte,Mathematics
2934,2017,Mathématiques,3,La Dérivation,7,Fonctions Reciproques,11,687,9,QCU,0.47,0.32,1.0,0,14,14,5,0,5,2.8,0.0,Moyen,Difficile,-1,Plus Difficile,Pas Adapte,Mathematics
4058,2018,Mathématiques,3,La Dérivation,7,Fonctions Reciproques,11,687,9,QCU,0.27,0.72,37.0,5,9,14,13,5,8,1.08,38.46,Facile,Moyen,-1,Plus Difficile,Pas Adapte,Mathematics
5182,2019,Mathématiques,3,La Dérivation,7,Fonctions Reciproques,11,687,9,QCU,0.4,0.55,55.0,9,7,16,13,9,4,1.23,69.23,Difficile,Moyen,1,Plus Facile,Pas Adapte,Mathematics
6306,2020,Mathématiques,3,La Dérivation,7,Fonctions Reciproques,11,687,9,QCU,0.65,0.37,11.0,2,13,15,13,2,11,1.15,15.38,Difficile,Difficile,0,Meme Difficulté,Pas Adapte,Mathematics
687,2015,Mathématiques,3,La Dérivation,7,Fonctions Reciproques,11,688,10,QROC,0.99,0.1,28.0,27,71,98,97,27,70,1.01,27.84,Difficile,Difficile,0,Meme Difficulté,Pas Adapte,Mathematics
1811,2016,Mathématiques,3,La Dérivation,7,Fonctions Reciproques,11,688,10,QROC,0.76,0.11,24.0,27,84,111,88,27,61,1.26,30.68,Facile,Difficile,-2,Beaucoup plus Difficile,Pas Adapte,Mathematics
2935,2017,Mathématiques,3,La Dérivation,7,Fonctions Reciproques,11,688,10,QROC,0.62,0.24,33.0,38,78,116,53,38,15,2.19,71.7,Moyen,Difficile,-1,Plus Difficile,Pas Adapte,Mathematics
4059,2018,Mathématiques,3,La Dérivation,7,Fonctions Reciproques,11,688,10,QROC,0.98,0.17,32.0,42,90,132,87,42,45,1.52,48.28,Difficile,Difficile,0,Meme Difficulté,Pas Adapte,Mathematics
5183,2019,Mathématiques,3,La Dérivation,7,Fonctions Reciproques,11,688,10,QROC,0.47,0.37,49.0,73,75,148,115,73,42,1.29,63.48,Facile,Moyen,-1,Plus Difficile,Pas Adapte,Mathematics
6307,2020,Mathématiques,3,La Dérivation,7,Fonctions Reciproques,11,688,10,QROC,0.73,0.19,3.0,4,123,127,80,4,76,1.59,5.0,Difficile,Difficile,0,Meme Difficulté,Pas Adapte,Mathematics
688,2015,Mathématiques,3,La Dérivation,7,Fonctions Reciproques,11,689,11,QCM,0.56,0.2,4.0,3,77,80,51,3,48,1.57,5.88,Moyen,Difficile,-1,Plus Difficile,Pas Adapte,Mathematics
1812,2016,Mathématiques,3,La Dérivation,7,Fonctions Reciproques,11,689,11,QCM,0.61,0.23,34.0,27,51,78,35,27,8,2.23,77.14,Difficile,Difficile,0,Meme Difficulté,Pas Adapte,Mathematics
2936,2017,Mathématiques,3,La Dérivation,7,Fonctions Reciproques,11,689,11,QCM,0.33,0.47,45.0,35,43,78,70,35,35,1.11,50.0,Facile,Moyen,-1,Plus Difficile,Pas Adapte,Mathematics
4060,2018,Mathématiques,3,La Dérivation,7,Fonctions Reciproques,11,689,11,QROC,0.52,0.35,44.0,29,38,67,39,29,10,1.72,74.36,Facile,Moyen,-1,Plus Difficile,Pas Adapte,Mathematics
5184,2019,Mathématiques,3,La Dérivation,7,Fonctions Reciproques,11,689,11,QROC,0.85,0.05,16.0,11,60,71,52,11,41,1.37,21.15,Difficile,Difficile,0,Meme Difficulté,Pas Adapte,Mathematics
6308,2020,Mathématiques,3,La Dérivation,7,Fonctions Reciproques,11,689,11,QROC,0.54,0.39,54.0,42,35,77,67,42,25,1.15,62.69,Facile,Moyen,-1,Plus Difficile,Pas Adapte,Mathematics
689,2015,Mathématiques,3,La Dérivation,8,Quelques Techniques de Calcul,12,690,1,QCU,0.7,0.33,29.0,5,11,16,9,5,4,1.78,55.56,Difficile,Difficile,0,Meme Difficulté,Pas Adapte,Mathematics
1813,2016,Mathématiques,3,La Dérivation,8,Quelques Techniques de Calcul,12,690,1,QCU,0.22,0.73,44.0,7,10,17,10,7,3,1.7,70.0,Facile,Moyen,-1,Plus Difficile,Pas Adapte,Mathematics
2937,2017,Mathématiques,3,La Dérivation,8,Quelques Techniques de Calcul,12,690,1,QCU,0.75,0.2,15.0,3,14,17,8,3,5,2.12,37.5,Moyen,Difficile,-1,Plus Difficile,Pas Adapte,Mathematics
4061,2018,Mathématiques,3,La Dérivation,8,Quelques Techniques de Calcul,12,690,1,QO,0.81,0.08,32.0,6,13,19,17,6,11,1.12,35.29,Moyen,Difficile,-1,Plus Difficile,Pas Adapte,Mathematics
5185,2019,Mathématiques,3,La Dérivation,8,Quelques Techniques de Calcul,12,690,1,QO,0.97,0.01,17.0,3,14,17,13,3,10,1.31,23.08,Difficile,Difficile,0,Meme Difficulté,Pas Adapte,Mathematics
6309,2020,Mathématiques,3,La Dérivation,8,Quelques Techniques de Calcul,12,690,1,QO,0.59,0.16,48.0,9,10,19,12,9,3,1.58,75.0,Difficile,Moyen,1,Plus Facile,Pas Adapte,Mathematics
690,2015,Mathématiques,3,La Dérivation,8,Quelques Techniques de Calcul,12,691,2,QROC,0.69,0.15,9.0,6,58,64,41,6,35,1.56,14.63,Facile,Difficile,-2,Beaucoup plus Difficile,Pas Adapte,Mathematics
1814,2016,Mathématiques,3,La Dérivation,8,Quelques Techniques de Calcul,12,691,2,QROC,0.73,0.02,14.0,8,51,59,42,8,34,1.4,19.05,Difficile,Difficile,0,Meme Difficulté,Pas Adapte,Mathematics
2938,2017,Mathématiques,3,La Dérivation,8,Quelques Techniques de Calcul,12,691,2,QROC,0.22,0.31,37.0,20,33,53,43,20,23,1.23,46.51,Facile,Moyen,-1,Plus Difficile,Pas Adapte,Mathematics
4062,2018,Mathématiques,3,La Dérivation,8,Quelques Techniques de Calcul,12,691,2,QROC,0.2,0.37,44.0,22,28,50,32,22,10,1.56,68.75,Facile,Moyen,-1,Plus Difficile,Pas Adapte,Mathematics
5186,2019,Mathématiques,3,La Dérivation,8,Quelques Techniques de Calcul,12,691,2,QROC,0.68,0.07,8.0,3,39,42,17,3,14,2.47,17.65,Facile,Difficile,-2,Beaucoup plus Difficile,Pas Adapte,Mathematics
6310,2020,Mathématiques,3,La Dérivation,8,Quelques Techniques de Calcul,12,691,2,QROC,0.76,0.06,30.0,13,30,43,29,13,16,1.48,44.83,Moyen,Difficile,-1,Plus Difficile,Pas Adapte,Mathematics
691,2015,Mathématiques,3,La Dérivation,8,Quelques Techniques de Calcul,12,692,3,QCU,0.31,0.51,37.0,10,18,28,25,10,15,1.12,40.0,Difficile,Moyen,1,Plus Facile,Pas Adapte,Mathematics
1815,2016,Mathématiques,3,La Dérivation,8,Quelques Techniques de Calcul,12,692,3,QCU,0.47,0.28,18.0,5,22,27,26,5,21,1.04,19.23,Facile,Difficile,-2,Beaucoup plus Difficile,Pas Adapte,Mathematics
2939,2017,Mathématiques,3,La Dérivation,8,Quelques Techniques de Calcul,12,692,3,QCU,0.64,0.29,34.0,9,18,27,16,9,7,1.69,56.25,Difficile,Difficile,0,Meme Difficulté,Pas Adapte,Mathematics
4063,2018,Mathématiques,3,La Dérivation,8,Quelques Techniques de Calcul,12,692,3,QCU,0.26,0.74,46.0,14,16,30,28,14,14,1.07,50.0,Difficile,Moyen,1,Plus Facile,Pas Adapte,Mathematics
5187,2019,Mathématiques,3,La Dérivation,8,Quelques Techniques de Calcul,12,692,3,QCU,0.23,0.47,57.0,19,14,33,28,19,9,1.18,67.86,Difficile,Moyen,1,Plus Facile,Pas Adapte,Mathematics
6311,2020,Mathématiques,3,La Dérivation,8,Quelques Techniques de Calcul,12,692,3,QCM,0.64,0.28,21.0,7,24,31,9,7,2,3.44,77.78,Difficile,Difficile,0,Meme Difficulté,Pas Adapte,Mathematics
692,2015,Mathématiques,3,La Dérivation,8,Quelques Techniques de Calcul,12,693,4,QCU,0.7,0.23,33.0,17,36,53,46,17,29,1.15,36.96,Difficile,Difficile,0,Meme Difficulté,Pas Adapte,Mathematics
1816,2016,Mathématiques,3,La Dérivation,8,Quelques Techniques de Calcul,12,693,4,QCU,0.72,0.23,21.0,11,40,51,28,11,17,1.82,39.29,Facile,Difficile,-2,Beaucoup plus Difficile,Pas Adapte,Mathematics
2940,2017,Mathématiques,3,La Dérivation,8,Quelques Techniques de Calcul,12,693,4,QCU,0.39,0.68,44.0,24,30,54,26,24,2,2.08,92.31,Moyen,Moyen,0,Meme Difficulté,Pas Adapte,Mathematics
4064,2018,Mathématiques,3,La Dérivation,8,Quelques Techniques de Calcul,12,693,4,QCU,0.27,0.58,54.0,26,23,49,26,26,0,1.88,100.0,Moyen,Moyen,0,Meme Difficulté,Pas Adapte,Mathematics
5188,2019,Mathématiques,3,La Dérivation,8,Quelques Techniques de Calcul,12,693,4,QCU,0.47,0.23,11.0,6,50,56,34,6,28,1.65,17.65,Difficile,Difficile,0,Meme Difficulté,Pas Adapte,Mathematics
6312,2020,Mathématiques,3,La Dérivation,8,Quelques Techniques de Calcul,12,693,4,QCU,0.23,0.58,41.0,20,30,50,41,20,21,1.22,48.78,Difficile,Moyen,1,Plus Facile,Pas Adapte,Mathematics
693,2015,Mathématiques,3,La Dérivation,8,Quelques Techniques de Calcul,12,694,5,QCU,0.28,0.49,50.0,36,35,71,65,36,29,1.09,55.38,Moyen,Moyen,0,Meme Difficulté,Pas Adapte,Mathematics
1817,2016,Mathématiques,3,La Dérivation,8,Quelques Techniques de Calcul,12,694,5,QCU,0.41,0.25,29.0,21,51,72,68,21,47,1.06,30.88,Facile,Difficile,-2,Beaucoup plus Difficile,Pas Adapte,Mathematics
2941,2017,Mathématiques,3,La Dérivation,8,Quelques Techniques de Calcul,12,694,5,QCU,0.25,0.63,48.0,34,37,71,58,34,24,1.22,58.62,Difficile,Moyen,1,Plus Facile,Pas Adapte,Mathematics
4065,2018,Mathématiques,3,La Dérivation,8,Quelques Techniques de Calcul,12,694,5,QCU,0.65,0.33,30.0,24,57,81,38,24,14,2.13,63.16,Facile,Difficile,-2,Beaucoup plus Difficile,Pas Adapte,Mathematics
5189,2019,Mathématiques,3,La Dérivation,8,Quelques Techniques de Calcul,12,694,5,QCU,0.71,0.22,6.0,4,70,74,58,4,54,1.28,6.9,Facile,Difficile,-2,Beaucoup plus Difficile,Pas Adapte,Mathematics
6313,2020,Mathématiques,3,La Dérivation,8,Quelques Techniques de Calcul,12,694,5,QCU,0.33,0.42,55.0,36,30,66,51,36,15,1.29,70.59,Facile,Moyen,-1,Plus Difficile,Pas Adapte,Mathematics
694,2015,Mathématiques,3,La Dérivation,8,Quelques Techniques de Calcul,12,695,6,QCU,0.68,0.27,14.0,3,19,22,12,3,9,1.83,25.0,Facile,Difficile,-2,Beaucoup plus Difficile,Pas Adapte,Mathematics
1818,2016,Mathématiques,3,La Dérivation,8,Quelques Techniques de Calcul,12,695,6,QCU,0.61,0.24,34.0,6,13,19,11,6,5,1.73,54.55,Facile,Difficile,-2,Beaucoup plus Difficile,Pas Adapte,Mathematics
2942,2017,Mathématiques,3,La Dérivation,8,Quelques Techniques de Calcul,12,695,6,QCU,0.51,0.36,27.0,6,15,21,17,6,11,1.24,35.29,Facile,Difficile,-2,Beaucoup plus Difficile,Pas Adapte,Mathematics
4066,2018,Mathématiques,3,La Dérivation,8,Quelques Techniques de Calcul,12,695,6,QCU,0.54,0.21,23.0,5,16,21,11,5,6,1.91,45.45,Difficile,Difficile,0,Meme Difficulté,Pas Adapte,Mathematics
5190,2019,Mathématiques,3,La Dérivation,8,Quelques Techniques de Calcul,12,695,6,QCM,0.35,0.3,61.0,13,9,22,17,13,4,1.29,76.47,Difficile,Moyen,1,Plus Facile,Adapte,Mathematics
6314,2020,Mathématiques,3,La Dérivation,8,Quelques Techniques de Calcul,12,695,6,QCM,0.41,0.51,61.0,15,9,24,17,15,2,1.41,88.24,Moyen,Moyen,0,Meme Difficulté,Adapte,Mathematics
695,2015,Mathématiques,3,La Dérivation,8,Quelques Techniques de Calcul,12,696,7,QCM,0.74,0.25,9.0,1,9,10,7,1,6,1.43,14.29,Moyen,Difficile,-1,Plus Difficile,Pas Adapte,Mathematics
1819,2016,Mathématiques,3,La Dérivation,8,Quelques Techniques de Calcul,12,696,7,QCM,0.4,0.37,53.0,6,5,11,9,6,3,1.22,66.67,Facile,Moyen,-1,Plus Difficile,Pas Adapte,Mathematics
2943,2017,Mathématiques,3,La Dérivation,8,Quelques Techniques de Calcul,12,696,7,QCM,0.33,0.58,48.0,5,6,11,8,5,3,1.38,62.5,Moyen,Moyen,0,Meme Difficulté,Pas Adapte,Mathematics
4067,2018,Mathématiques,3,La Dérivation,8,Quelques Techniques de Calcul,12,696,7,QCM,0.29,0.56,61.0,7,4,11,10,7,3,1.1,70.0,Difficile,Moyen,1,Plus Facile,Adapte,Mathematics
5191,2019,Mathématiques,3,La Dérivation,8,Quelques Techniques de Calcul,12,696,7,QCM,0.24,0.4,61.0,8,5,13,10,8,2,1.3,80.0,Moyen,Moyen,0,Meme Difficulté,Adapte,Mathematics
6315,2020,Mathématiques,3,La Dérivation,8,Quelques Techniques de Calcul,12,696,7,QCM,0.35,0.68,61.0,9,6,15,11,9,2,1.36,81.82,Moyen,Moyen,0,Meme Difficulté,Adapte,Mathematics
696,2015,Mathématiques,3,La Dérivation,8,Quelques Techniques de Calcul,12,697,8,QCU,0.35,0.59,38.0,12,20,32,32,12,20,1.0,37.5,Moyen,Moyen,0,Meme Difficulté,Pas Adapte,Mathematics
1820,2016,Mathématiques,3,La Dérivation,8,Quelques Techniques de Calcul,12,697,8,QCU,0.27,0.46,36.0,11,20,31,17,11,6,1.82,64.71,Difficile,Moyen,1,Plus Facile,Pas Adapte,Mathematics
2944,2017,Mathématiques,3,La Dérivation,8,Quelques Techniques de Calcul,12,697,8,QCU,0.33,0.71,45.0,13,16,29,22,13,9,1.32,59.09,Moyen,Moyen,0,Meme Difficulté,Pas Adapte,Mathematics
4068,2018,Mathématiques,3,La Dérivation,8,Quelques Techniques de Calcul,12,697,8,QCU,0.54,0.35,34.0,10,18,28,17,10,7,1.65,58.82,Moyen,Difficile,-1,Plus Difficile,Pas Adapte,Mathematics
5192,2019,Mathématiques,3,La Dérivation,8,Quelques Techniques de Calcul,12,697,8,QCU,0.34,0.63,40.0,12,19,31,17,12,5,1.82,70.59,Facile,Moyen,-1,Plus Difficile,Pas Adapte,Mathematics
6316,2020,Mathématiques,3,La Dérivation,8,Quelques Techniques de Calcul,12,697,8,QCU,0.23,0.69,61.0,22,14,36,32,22,10,1.12,68.75,Difficile,Moyen,1,Plus Facile,Adapte,Mathematics
697,2015,Mathématiques,3,La Dérivation,8,Quelques Techniques de Calcul,12,698,9,QROC,0.67,0.02,33.0,4,7,11,9,4,5,1.22,44.44,Facile,Difficile,-2,Beaucoup plus Difficile,Pas Adapte,Mathematics
1821,2016,Mathématiques,3,La Dérivation,8,Quelques Techniques de Calcul,12,698,9,QROC,0.44,0.33,62.0,6,3,9,7,6,1,1.29,85.71,Facile,Moyen,-1,Plus Difficile,Adapte,Mathematics
2945,2017,Mathématiques,3,La Dérivation,8,Quelques Techniques de Calcul,12,698,9,QO,0.46,0.21,62.0,6,3,9,8,6,2,1.12,75.0,Moyen,Moyen,0,Meme Difficulté,Adapte,Mathematics
4069,2018,Mathématiques,3,La Dérivation,8,Quelques Techniques de Calcul,12,698,9,QROC,0.32,0.35,62.0,6,4,10,7,6,1,1.43,85.71,Moyen,Moyen,0,Meme Difficulté,Adapte,Mathematics
5193,2019,Mathématiques,3,La Dérivation,8,Quelques Techniques de Calcul,12,698,9,QROC,0.36,0.34,62.0,5,3,8,6,5,1,1.33,83.33,Moyen,Moyen,0,Meme Difficulté,Adapte,Mathematics
6317,2020,Mathématiques,3,La Dérivation,8,Quelques Techniques de Calcul,12,698,9,QCM,0.28,0.43,62.0,5,3,8,5,5,0,1.6,100.0,Moyen,Moyen,0,Meme Difficulté,Adapte,Mathematics
698,2015,Mathématiques,3,La Dérivation,8,Quelques Techniques de Calcul,12,699,10,QCM,0.73,0.24,13.0,4,28,32,22,4,18,1.45,18.18,Difficile,Difficile,0,Meme Difficulté,Pas Adapte,Mathematics
1822,2016,Mathématiques,3,La Dérivation,8,Quelques Techniques de Calcul,12,699,10,QCM,0.51,0.26,28.0,10,27,37,13,10,3,2.85,76.92,Difficile,Difficile,0,Meme Difficulté,Pas Adapte,Mathematics
2946,2017,Mathématiques,3,La Dérivation,8,Quelques Techniques de Calcul,12,699,10,QCM,0.33,0.7,40.0,14,22,36,15,14,1,2.4,93.33,Difficile,Moyen,1,Plus Facile,Pas Adapte,Mathematics
4070,2018,Mathématiques,3,La Dérivation,8,Quelques Techniques de Calcul,12,699,10,QCM,0.23,0.53,40.0,15,22,37,28,15,13,1.32,53.57,Facile,Moyen,-1,Plus Difficile,Pas Adapte,Mathematics
5194,2019,Mathématiques,3,La Dérivation,8,Quelques Techniques de Calcul,12,699,10,QCM,0.67,0.27,14.0,6,35,41,38,6,32,1.08,15.79,Facile,Difficile,-2,Beaucoup plus Difficile,Pas Adapte,Mathematics
6318,2020,Mathématiques,3,La Dérivation,8,Quelques Techniques de Calcul,12,699,10,QCU,0.5,0.38,24.0,9,29,38,32,9,23,1.19,28.12,Difficile,Difficile,0,Meme Difficulté,Pas Adapte,Mathematics
699,2015,Mathématiques,3,La Dérivation,8,Quelques Techniques de Calcul,12,700,11,QCM,0.77,0.25,17.0,6,30,36,19,6,13,1.89,31.58,Facile,Difficile,-2,Beaucoup plus Difficile,Pas Adapte,Mathematics
1823,2016,Mathématiques,3,La Dérivation,8,Quelques Techniques de Calcul,12,700,11,QCM,0.44,0.46,61.0,21,14,35,33,21,12,1.06,63.64,Difficile,Moyen,1,Plus Facile,Adapte,Mathematics
2947,2017,Mathématiques,3,La Dérivation,8,Quelques Techniques de Calcul,12,700,11,QCU,0.39,0.42,61.0,21,13,34,33,21,12,1.03,63.64,Moyen,Moyen,0,Meme Difficulté,Adapte,Mathematics
4071,2018,Mathématiques,3,La Dérivation,8,Quelques Techniques de Calcul,12,700,11,QCU,0.4,0.52,61.0,21,14,35,21,21,0,1.67,100.0,Moyen,Moyen,0,Meme Difficulté,Adapte,Mathematics
5195,2019,Mathématiques,3,La Dérivation,8,Quelques Techniques de Calcul,12,700,11,QCU,0.35,0.42,61.0,20,13,33,31,20,11,1.06,64.52,Moyen,Moyen,0,Meme Difficulté,Adapte,Mathematics
6319,2020,Mathématiques,3,La Dérivation,8,Quelques Techniques de Calcul,12,700,11,QCU,0.34,0.61,61.0,18,12,30,28,18,10,1.07,64.29,Moyen,Moyen,0,Meme Difficulté,Adapte,Mathematics
700,2015,Mathématiques,3,La Dérivation,8,Quelques Techniques de Calcul,12,701,12,QCU,0.56,0.38,18.0,10,48,58,27,10,17,2.15,37.04,Difficile,Difficile,0,Meme Difficulté,Pas Adapte,Mathematics
1824,2016,Mathématiques,3,La Dérivation,8,Quelques Techniques de Calcul,12,701,12,QCU,0.28,0.74,64.0,35,19,54,39,35,4,1.38,89.74,Facile,Moyen,-1,Plus Difficile,Adapte,Mathematics
2948,2017,Mathématiques,3,La Dérivation,8,Quelques Techniques de Calcul,12,701,12,QCU,0.39,0.45,64.0,32,18,50,50,32,18,1.0,64.0,Moyen,Moyen,0,Meme Difficulté,Adapte,Mathematics
4072,2018,Mathématiques,3,La Dérivation,8,Quelques Techniques de Calcul,12,701,12,QCU,0.22,0.41,64.0,35,20,55,54,35,19,1.02,64.81,Moyen,Moyen,0,Meme Difficulté,Adapte,Mathematics
5196,2019,Mathématiques,3,La Dérivation,8,Quelques Techniques de Calcul,12,701,12,QCU,0.35,0.47,64.0,40,22,62,56,40,16,1.11,71.43,Moyen,Moyen,0,Meme Difficulté,Adapte,Mathematics
6320,2020,Mathématiques,3,La Dérivation,8,Quelques Techniques de Calcul,12,701,12,QCU,0.25,0.45,64.0,44,25,69,62,44,18,1.11,70.97,Moyen,Moyen,0,Meme Difficulté,Adapte,Mathematics
701,2015,Mathématiques,4,Les Séries Numériques,1,Espaces Prehilbertiens Reel ou Complexes,7,702,1,QCU,0.51,0.25,11.0,5,38,43,35,5,30,1.23,14.29,Moyen,Difficile,-1,Plus Difficile,Pas Adapte,Mathematics
1825,2016,Mathématiques,4,Les Séries Numériques,1,Espaces Prehilbertiens Reel ou Complexes,7,702,1,QCU,0.38,0.54,60.0,27,18,45,34,27,7,1.32,79.41,Difficile,Moyen,1,Plus Facile,Adapte,Mathematics
2949,2017,Mathématiques,4,Les Séries Numériques,1,Espaces Prehilbertiens Reel ou Complexes,7,702,1,QCU,0.29,0.64,60.0,23,16,39,27,23,4,1.44,85.19,Moyen,Moyen,0,Meme Difficulté,Adapte,Mathematics
4073,2018,Mathématiques,4,Les Séries Numériques,1,Espaces Prehilbertiens Reel ou Complexes,7,702,1,QCU,0.29,0.63,60.0,23,15,38,33,23,10,1.15,69.7,Moyen,Moyen,0,Meme Difficulté,Adapte,Mathematics
5197,2019,Mathématiques,4,Les Séries Numériques,1,Espaces Prehilbertiens Reel ou Complexes,7,702,1,QCU,0.26,0.56,60.0,25,16,41,35,25,10,1.17,71.43,Moyen,Moyen,0,Meme Difficulté,Adapte,Mathematics
6321,2020,Mathématiques,4,Les Séries Numériques,1,Espaces Prehilbertiens Reel ou Complexes,7,702,1,QCU,0.28,0.56,60.0,21,14,35,24,21,3,1.46,87.5,Moyen,Moyen,0,Meme Difficulté,Adapte,Mathematics
702,2015,Mathématiques,4,Les Séries Numériques,1,Espaces Prehilbertiens Reel ou Complexes,7,703,2,QCU,0.75,0.3,26.0,19,53,72,36,19,17,2.0,52.78,Difficile,Difficile,0,Meme Difficulté,Pas Adapte,Mathematics
1826,2016,Mathématiques,4,Les Séries Numériques,1,Espaces Prehilbertiens Reel ou Complexes,7,703,2,QCU,0.52,0.23,21.0,14,52,66,56,14,42,1.18,25.0,Difficile,Difficile,0,Meme Difficulté,Pas Adapte,Mathematics
2950,2017,Mathématiques,4,Les Séries Numériques,1,Espaces Prehilbertiens Reel ou Complexes,7,703,2,QCU,0.62,0.33,13.0,10,64,74,43,10,33,1.72,23.26,Facile,Difficile,-2,Beaucoup plus Difficile,Pas Adapte,Mathematics
4074,2018,Mathématiques,4,Les Séries Numériques,1,Espaces Prehilbertiens Reel ou Complexes,7,703,2,QCU,0.45,0.24,14.0,11,66,77,39,11,28,1.97,28.21,Difficile,Difficile,0,Meme Difficulté,Pas Adapte,Mathematics
5198,2019,Mathématiques,4,Les Séries Numériques,1,Espaces Prehilbertiens Reel ou Complexes,7,703,2,QCM,0.32,0.53,57.0,42,32,74,64,42,22,1.16,65.62,Difficile,Moyen,1,Plus Facile,Pas Adapte,Mathematics
6322,2020,Mathématiques,4,Les Séries Numériques,1,Espaces Prehilbertiens Reel ou Complexes,7,703,2,QCU,0.45,0.32,29.0,19,45,64,56,19,37,1.14,33.93,Difficile,Difficile,0,Meme Difficulté,Pas Adapte,Mathematics
703,2015,Mathématiques,4,Les Séries Numériques,1,Espaces Prehilbertiens Reel ou Complexes,7,704,3,QROC,0.88,0.18,32.0,23,50,73,41,23,18,1.78,56.1,Moyen,Difficile,-1,Plus Difficile,Pas Adapte,Mathematics
1827,2016,Mathématiques,4,Les Séries Numériques,1,Espaces Prehilbertiens Reel ou Complexes,7,704,3,QROC,0.34,0.39,38.0,32,52,84,67,32,35,1.25,47.76,Moyen,Moyen,0,Meme Difficulté,Pas Adapte,Mathematics
2951,2017,Mathématiques,4,Les Séries Numériques,1,Espaces Prehilbertiens Reel ou Complexes,7,704,3,QROC,0.93,0.16,17.0,16,81,97,62,16,46,1.56,25.81,Moyen,Difficile,-1,Plus Difficile,Pas Adapte,Mathematics
4075,2018,Mathématiques,4,Les Séries Numériques,1,Espaces Prehilbertiens Reel ou Complexes,7,704,3,QROC,0.61,0.21,22.0,22,80,102,53,22,31,1.92,41.51,Difficile,Difficile,0,Meme Difficulté,Pas Adapte,Mathematics
5199,2019,Mathématiques,4,Les Séries Numériques,1,Espaces Prehilbertiens Reel ou Complexes,7,704,3,QROC,0.97,0.11,0.0,0,92,92,66,0,66,1.39,0.0,Facile,Difficile,-2,Beaucoup plus Difficile,Pas Adapte,Mathematics
6323,2020,Mathématiques,4,Les Séries Numériques,1,Espaces Prehilbertiens Reel ou Complexes,7,704,3,QROC,0.96,0.2,19.0,17,72,89,67,17,50,1.33,25.37,Moyen,Difficile,-1,Plus Difficile,Pas Adapte,Mathematics
704,2015,Mathématiques,4,Les Séries Numériques,1,Espaces Prehilbertiens Reel ou Complexes,7,705,4,QROC,0.25,0.31,47.0,12,13,25,23,12,11,1.09,52.17,Facile,Moyen,-1,Plus Difficile,Pas Adapte,Mathematics
1828,2016,Mathématiques,4,Les Séries Numériques,1,Espaces Prehilbertiens Reel ou Complexes,7,705,4,QROC,0.71,0.07,32.0,9,20,29,18,9,9,1.61,50.0,Difficile,Difficile,0,Meme Difficulté,Pas Adapte,Mathematics
2952,2017,Mathématiques,4,Les Séries Numériques,1,Espaces Prehilbertiens Reel ou Complexes,7,705,4,QROC,0.46,0.28,54.0,16,14,30,20,16,4,1.5,80.0,Facile,Moyen,-1,Plus Difficile,Pas Adapte,Mathematics
4076,2018,Mathématiques,4,Les Séries Numériques,1,Espaces Prehilbertiens Reel ou Complexes,7,705,4,QROC,0.67,0.23,22.0,7,23,30,23,7,16,1.3,30.43,Facile,Difficile,-2,Beaucoup plus Difficile,Pas Adapte,Mathematics
5200,2019,Mathématiques,4,Les Séries Numériques,1,Espaces Prehilbertiens Reel ou Complexes,7,705,4,QROC,0.55,0.29,49.0,17,17,34,25,17,8,1.36,68.0,Moyen,Moyen,0,Meme Difficulté,Pas Adapte,Mathematics
6324,2020,Mathématiques,4,Les Séries Numériques,1,Espaces Prehilbertiens Reel ou Complexes,7,705,4,QROC,0.95,0.03,8.0,2,28,30,23,2,21,1.3,8.7,Moyen,Difficile,-1,Plus Difficile,Pas Adapte,Mathematics
705,2015,Mathématiques,4,Les Séries Numériques,1,Espaces Prehilbertiens Reel ou Complexes,7,706,5,QCU,0.74,0.24,35.0,8,14,22,21,8,13,1.05,38.1,Difficile,Difficile,0,Meme Difficulté,Pas Adapte,Mathematics
1829,2016,Mathématiques,4,Les Séries Numériques,1,Espaces Prehilbertiens Reel ou Complexes,7,706,5,QCU,0.49,0.37,35.0,9,16,25,16,9,7,1.56,56.25,Moyen,Difficile,-1,Plus Difficile,Pas Adapte,Mathematics
2953,2017,Mathématiques,4,Les Séries Numériques,1,Espaces Prehilbertiens Reel ou Complexes,7,706,5,QCU,0.37,0.59,41.0,10,14,24,14,10,4,1.71,71.43,Moyen,Moyen,0,Meme Difficulté,Pas Adapte,Mathematics
4077,2018,Mathématiques,4,Les Séries Numériques,1,Espaces Prehilbertiens Reel ou Complexes,7,706,5,QCU,0.73,0.36,10.0,2,21,23,22,2,20,1.05,9.09,Difficile,Difficile,0,Meme Difficulté,Pas Adapte,Mathematics
5201,2019,Mathématiques,4,Les Séries Numériques,1,Espaces Prehilbertiens Reel ou Complexes,7,706,5,QROC,0.67,0.24,21.0,5,21,26,18,5,13,1.44,27.78,Difficile,Difficile,0,Meme Difficulté,Pas Adapte,Mathematics
6325,2020,Mathématiques,4,Les Séries Numériques,1,Espaces Prehilbertiens Reel ou Complexes,7,706,5,QROC,0.52,0.31,62.0,19,11,30,30,19,11,1.0,63.33,Facile,Moyen,-1,Plus Difficile,Adapte,Mathematics
706,2015,Mathématiques,4,Les Séries Numériques,1,Espaces Prehilbertiens Reel ou Complexes,7,707,6,QCU,0.38,0.46,53.0,49,44,93,76,49,27,1.22,64.47,Difficile,Moyen,1,Plus Facile,Pas Adapte,Mathematics
1830,2016,Mathématiques,4,Les Séries Numériques,1,Espaces Prehilbertiens Reel ou Complexes,7,707,6,QCM,0.51,0.24,19.0,17,71,88,49,17,32,1.8,34.69,Facile,Difficile,-2,Beaucoup plus Difficile,Pas Adapte,Mathematics
2954,2017,Mathématiques,4,Les Séries Numériques,1,Espaces Prehilbertiens Reel ou Complexes,7,707,6,QCM,0.55,0.22,34.0,28,53,81,34,28,6,2.38,82.35,Difficile,Difficile,0,Meme Difficulté,Pas Adapte,Mathematics
4078,2018,Mathématiques,4,Les Séries Numériques,1,Espaces Prehilbertiens Reel ou Complexes,7,707,6,QCU,0.28,0.71,56.0,44,34,78,69,44,25,1.13,63.77,Difficile,Moyen,1,Plus Facile,Pas Adapte,Mathematics
5202,2019,Mathématiques,4,Les Séries Numériques,1,Espaces Prehilbertiens Reel ou Complexes,7,707,6,QCM,0.63,0.22,23.0,17,58,75,32,17,15,2.34,53.12,Difficile,Difficile,0,Meme Difficulté,Pas Adapte,Mathematics
6326,2020,Mathématiques,4,Les Séries Numériques,1,Espaces Prehilbertiens Reel ou Complexes,7,707,6,QCM,0.42,0.34,38.0,25,41,66,66,25,41,1.0,37.88,Facile,Moyen,-1,Plus Difficile,Pas Adapte,Mathematics
707,2015,Mathématiques,4,Les Séries Numériques,1,Espaces Prehilbertiens Reel ou Complexes,7,708,7,QCU,0.26,0.64,43.0,43,57,100,81,43,38,1.23,53.09,Difficile,Moyen,1,Plus Facile,Pas Adapte,Mathematics
1831,2016,Mathématiques,4,Les Séries Numériques,1,Espaces Prehilbertiens Reel ou Complexes,7,708,7,QO,0.97,0.13,10.0,11,97,108,85,11,74,1.27,12.94,Facile,Difficile,-2,Beaucoup plus Difficile,Pas Adapte,Mathematics
2955,2017,Mathématiques,4,Les Séries Numériques,1,Espaces Prehilbertiens Reel ou Complexes,7,708,7,QO,0.89,0.04,7.0,8,110,118,95,8,87,1.24,8.42,Facile,Difficile,-2,Beaucoup plus Difficile,Pas Adapte,Mathematics
4079,2018,Mathématiques,4,Les Séries Numériques,1,Espaces Prehilbertiens Reel ou Complexes,7,708,7,QO,0.45,0.16,45.0,52,64,116,68,52,16,1.71,76.47,Difficile,Moyen,1,Plus Facile,Pas Adapte,Mathematics
5203,2019,Mathématiques,4,Les Séries Numériques,1,Espaces Prehilbertiens Reel ou Complexes,7,708,7,QO,0.32,0.21,43.0,57,76,133,103,57,46,1.29,55.34,Moyen,Moyen,0,Meme Difficulté,Pas Adapte,Mathematics
6327,2020,Mathématiques,4,Les Séries Numériques,1,Espaces Prehilbertiens Reel ou Complexes,7,708,7,QO,0.3,0.18,52.0,64,59,123,116,64,52,1.06,55.17,Difficile,Moyen,1,Plus Facile,Pas Adapte,Mathematics
708,2015,Mathématiques,4,Les Séries Numériques,2,Espaces Euclidiens,2,709,1,QCU,0.52,0.23,27.0,23,64,87,77,23,54,1.13,29.87,Difficile,Difficile,0,Meme Difficulté,Pas Adapte,Mathematics
1832,2016,Mathématiques,4,Les Séries Numériques,2,Espaces Euclidiens,2,709,1,QCU,0.08,0.8,65.0,64,34,98,87,64,23,1.13,73.56,Difficile,Facile,2,Beaucoup plus Facile,Adapte,Mathematics
2956,2017,Mathématiques,4,Les Séries Numériques,2,Espaces Euclidiens,2,709,1,QCU,0.17,0.99,65.0,57,31,88,64,57,7,1.38,89.06,Facile,Facile,0,Meme Difficulté,Adapte,Mathematics
4080,2018,Mathématiques,4,Les Séries Numériques,2,Espaces Euclidiens,2,709,1,QCU,0.02,0.76,65.0,52,28,80,69,52,17,1.16,75.36,Facile,Facile,0,Meme Difficulté,Adapte,Mathematics
5204,2019,Mathématiques,4,Les Séries Numériques,2,Espaces Euclidiens,2,709,1,QCU,0.18,0.99,65.0,56,30,86,74,56,18,1.16,75.68,Facile,Facile,0,Meme Difficulté,Adapte,Mathematics
6328,2020,Mathématiques,4,Les Séries Numériques,2,Espaces Euclidiens,2,709,1,QCU,0.03,0.77,65.0,49,27,76,67,49,18,1.13,73.13,Facile,Facile,0,Meme Difficulté,Adapte,Mathematics
709,2015,Mathématiques,4,Les Séries Numériques,2,Espaces Euclidiens,2,710,2,QCU,0.5,0.22,18.0,13,59,72,50,13,37,1.44,26.0,Facile,Difficile,-2,Beaucoup plus Difficile,Pas Adapte,Mathematics
1833,2016,Mathématiques,4,Les Séries Numériques,2,Espaces Euclidiens,2,710,2,QCU,0.43,0.32,33.0,27,55,82,50,27,23,1.64,54.0,Moyen,Difficile,-1,Plus Difficile,Pas Adapte,Mathematics
2957,2017,Mathématiques,4,Les Séries Numériques,2,Espaces Euclidiens,2,710,2,QCU,0.58,0.25,11.0,8,64,72,44,8,36,1.64,18.18,Difficile,Difficile,0,Meme Difficulté,Pas Adapte,Mathematics
4081,2018,Mathématiques,4,Les Séries Numériques,2,Espaces Euclidiens,2,710,2,QCU,0.54,0.37,21.0,16,62,78,48,16,32,1.62,33.33,Facile,Difficile,-2,Beaucoup plus Difficile,Pas Adapte,Mathematics
5205,2019,Mathématiques,4,Les Séries Numériques,2,Espaces Euclidiens,2,710,2,QCU,0.35,0.49,43.0,32,43,75,45,32,13,1.67,71.11,Facile,Moyen,-1,Plus Difficile,Pas Adapte,Mathematics
6329,2020,Mathématiques,4,Les Séries Numériques,2,Espaces Euclidiens,2,710,2,QROC,0.24,0.33,36.0,30,54,84,72,30,42,1.17,41.67,Difficile,Moyen,1,Plus Facile,Pas Adapte,Mathematics
710,2015,Mathématiques,4,Les Séries Numériques,3,Rappels et Complements sur le Groupe Orthogonal d'un Espace Euclidien,8,711,1,QCU,0.58,0.25,29.0,6,15,21,16,6,10,1.31,37.5,Difficile,Difficile,0,Meme Difficulté,Pas Adapte,Mathematics
1834,2016,Mathématiques,4,Les Séries Numériques,3,Rappels et Complements sur le Groupe Orthogonal d'un Espace Euclidien,8,711,1,QCU,0.42,0.29,7.0,1,20,21,12,1,11,1.75,8.33,Facile,Difficile,-2,Beaucoup plus Difficile,Pas Adapte,Mathematics
2958,2017,Mathématiques,4,Les Séries Numériques,3,Rappels et Complements sur le Groupe Orthogonal d'un Espace Euclidien,8,711,1,QCU,0.68,0.33,3.0,1,19,20,13,1,12,1.54,7.69,Moyen,Difficile,-1,Plus Difficile,Pas Adapte,Mathematics
4082,2018,Mathématiques,4,Les Séries Numériques,3,Rappels et Complements sur le Groupe Orthogonal d'un Espace Euclidien,8,711,1,QCU,0.56,0.21,3.0,1,17,18,7,1,6,2.57,14.29,Moyen,Difficile,-1,Plus Difficile,Pas Adapte,Mathematics
5206,2019,Mathématiques,4,Les Séries Numériques,3,Rappels et Complements sur le Groupe Orthogonal d'un Espace Euclidien,8,711,1,QCU,0.29,0.46,62.0,11,7,18,16,11,5,1.12,68.75,Difficile,Moyen,1,Plus Facile,Adapte,Mathematics
6330,2020,Mathématiques,4,Les Séries Numériques,3,Rappels et Complements sur le Groupe Orthogonal d'un Espace Euclidien,8,711,1,QCU,0.38,0.71,62.0,11,7,18,15,11,4,1.2,73.33,Moyen,Moyen,0,Meme Difficulté,Adapte,Mathematics
711,2015,Mathématiques,4,Les Séries Numériques,3,Rappels et Complements sur le Groupe Orthogonal d'un Espace Euclidien,8,712,2,QCU,0.37,0.51,60.0,42,28,70,54,42,12,1.3,77.78,Facile,Moyen,-1,Plus Difficile,Adapte,Mathematics
1835,2016,Mathématiques,4,Les Séries Numériques,3,Rappels et Complements sur le Groupe Orthogonal d'un Espace Euclidien,8,712,2,QCU,0.23,0.72,60.0,41,28,69,68,41,27,1.01,60.29,Moyen,Moyen,0,Meme Difficulté,Adapte,Mathematics
2959,2017,Mathématiques,4,Les Séries Numériques,3,Rappels et Complements sur le Groupe Orthogonal d'un Espace Euclidien,8,712,2,QCU,0.27,0.42,60.0,40,27,67,51,40,11,1.31,78.43,Moyen,Moyen,0,Meme Difficulté,Adapte,Mathematics
4083,2018,Mathématiques,4,Les Séries Numériques,3,Rappels et Complements sur le Groupe Orthogonal d'un Espace Euclidien,8,712,2,QCU,0.38,0.59,60.0,37,24,61,59,37,22,1.03,62.71,Moyen,Moyen,0,Meme Difficulté,Adapte,Mathematics
5207,2019,Mathématiques,4,Les Séries Numériques,3,Rappels et Complements sur le Groupe Orthogonal d'un Espace Euclidien,8,712,2,QCU,0.29,0.68,60.0,40,26,66,44,40,4,1.5,90.91,Moyen,Moyen,0,Meme Difficulté,Adapte,Mathematics
6331,2020,Mathématiques,4,Les Séries Numériques,3,Rappels et Complements sur le Groupe Orthogonal d'un Espace Euclidien,8,712,2,QCU,0.33,0.63,60.0,45,30,75,56,45,11,1.34,80.36,Moyen,Moyen,0,Meme Difficulté,Adapte,Mathematics
712,2015,Mathématiques,4,Les Séries Numériques,3,Rappels et Complements sur le Groupe Orthogonal d'un Espace Euclidien,8,713,3,QCU,0.56,0.31,31.0,19,42,61,27,19,8,2.26,70.37,Facile,Difficile,-2,Beaucoup plus Difficile,Pas Adapte,Mathematics
1836,2016,Mathématiques,4,Les Séries Numériques,3,Rappels et Complements sur le Groupe Orthogonal d'un Espace Euclidien,8,713,3,QCU,0.58,0.23,22.0,15,55,70,42,15,27,1.67,35.71,Difficile,Difficile,0,Meme Difficulté,Pas Adapte,Mathematics
2960,2017,Mathématiques,4,Les Séries Numériques,3,Rappels et Complements sur le Groupe Orthogonal d'un Espace Euclidien,8,713,3,QCU,0.43,0.33,25.0,16,47,63,56,16,40,1.12,28.57,Facile,Difficile,-2,Beaucoup plus Difficile,Pas Adapte,Mathematics
4084,2018,Mathématiques,4,Les Séries Numériques,3,Rappels et Complements sur le Groupe Orthogonal d'un Espace Euclidien,8,713,3,QCM,0.38,0.31,45.0,28,34,62,51,28,23,1.22,54.9,Difficile,Moyen,1,Plus Facile,Pas Adapte,Mathematics
5208,2019,Mathématiques,4,Les Séries Numériques,3,Rappels et Complements sur le Groupe Orthogonal d'un Espace Euclidien,8,713,3,QCM,0.22,0.56,44.0,26,34,60,39,26,13,1.54,66.67,Moyen,Moyen,0,Meme Difficulté,Pas Adapte,Mathematics
6332,2020,Mathématiques,4,Les Séries Numériques,3,Rappels et Complements sur le Groupe Orthogonal d'un Espace Euclidien,8,713,3,QCM,0.69,0.29,14.0,8,50,58,36,8,28,1.61,22.22,Facile,Difficile,-2,Beaucoup plus Difficile,Pas Adapte,Mathematics
713,2015,Mathématiques,4,Les Séries Numériques,3,Rappels et Complements sur le Groupe Orthogonal d'un Espace Euclidien,8,714,4,QCU,0.43,0.22,18.0,13,58,71,26,13,13,2.73,50.0,Difficile,Difficile,0,Meme Difficulté,Pas Adapte,Mathematics
1837,2016,Mathématiques,4,Les Séries Numériques,3,Rappels et Complements sur le Groupe Orthogonal d'un Espace Euclidien,8,714,4,QCU,0.69,0.37,26.0,20,58,78,53,20,33,1.47,37.74,Facile,Difficile,-2,Beaucoup plus Difficile,Pas Adapte,Mathematics
2961,2017,Mathématiques,4,Les Séries Numériques,3,Rappels et Complements sur le Groupe Orthogonal d'un Espace Euclidien,8,714,4,QCU,0.37,0.54,56.0,48,37,85,80,48,32,1.06,60.0,Difficile,Moyen,1,Plus Facile,Pas Adapte,Mathematics
4085,2018,Mathématiques,4,Les Séries Numériques,3,Rappels et Complements sur le Groupe Orthogonal d'un Espace Euclidien,8,714,4,QCU,0.44,0.3,14.0,13,77,90,80,13,67,1.12,16.25,Moyen,Difficile,-1,Plus Difficile,Pas Adapte,Mathematics
5209,2019,Mathématiques,4,Les Séries Numériques,3,Rappels et Complements sur le Groupe Orthogonal d'un Espace Euclidien,8,714,4,QCU,0.32,0.61,46.0,45,53,98,64,45,19,1.53,70.31,Difficile,Moyen,1,Plus Facile,Pas Adapte,Mathematics
6333,2020,Mathématiques,4,Les Séries Numériques,3,Rappels et Complements sur le Groupe Orthogonal d'un Espace Euclidien,8,714,4,QCU,0.31,0.6,61.0,66,43,109,90,66,24,1.21,73.33,Facile,Moyen,-1,Plus Difficile,Adapte,Mathematics
714,2015,Mathématiques,4,Les Séries Numériques,3,Rappels et Complements sur le Groupe Orthogonal d'un Espace Euclidien,8,715,5,QCM,0.5,0.22,0.0,0,56,56,26,0,26,2.15,0.0,Facile,Difficile,-2,Beaucoup plus Difficile,Pas Adapte,Mathematics
1838,2016,Mathématiques,4,Les Séries Numériques,3,Rappels et Complements sur le Groupe Orthogonal d'un Espace Euclidien,8,715,5,QCM,0.55,0.2,28.0,18,45,63,57,18,39,1.11,31.58,Difficile,Difficile,0,Meme Difficulté,Pas Adapte,Mathematics
2962,2017,Mathématiques,4,Les Séries Numériques,3,Rappels et Complements sur le Groupe Orthogonal d'un Espace Euclidien,8,715,5,QCM,0.24,0.53,46.0,26,30,56,49,26,23,1.14,53.06,Facile,Moyen,-1,Plus Difficile,Pas Adapte,Mathematics
4086,2018,Mathématiques,4,Les Séries Numériques,3,Rappels et Complements sur le Groupe Orthogonal d'un Espace Euclidien,8,715,5,QCM,0.56,0.27,35.0,22,40,62,48,22,26,1.29,45.83,Facile,Difficile,-2,Beaucoup plus Difficile,Pas Adapte,Mathematics
5210,2019,Mathématiques,4,Les Séries Numériques,3,Rappels et Complements sur le Groupe Orthogonal d'un Espace Euclidien,8,715,5,QROC,0.58,0.3,42.0,27,38,65,64,27,37,1.02,42.19,Difficile,Moyen,1,Plus Facile,Pas Adapte,Mathematics
6334,2020,Mathématiques,4,Les Séries Numériques,3,Rappels et Complements sur le Groupe Orthogonal d'un Espace Euclidien,8,715,5,QROC,0.95,0.16,7.0,5,62,67,49,5,44,1.37,10.2,Facile,Difficile,-2,Beaucoup plus Difficile,Pas Adapte,Mathematics
715,2015,Mathématiques,4,Les Séries Numériques,3,Rappels et Complements sur le Groupe Orthogonal d'un Espace Euclidien,8,716,6,QCM,0.49,0.54,38.0,38,62,100,69,38,31,1.45,55.07,Facile,Moyen,-1,Plus Difficile,Pas Adapte,Mathematics
1839,2016,Mathématiques,4,Les Séries Numériques,3,Rappels et Complements sur le Groupe Orthogonal d'un Espace Euclidien,8,716,6,QCM,0.75,0.22,20.0,17,69,86,49,17,32,1.76,34.69,Moyen,Difficile,-1,Plus Difficile,Pas Adapte,Mathematics
2963,2017,Mathématiques,4,Les Séries Numériques,3,Rappels et Complements sur le Groupe Orthogonal d'un Espace Euclidien,8,716,6,QCM,0.76,0.29,17.0,15,73,88,84,15,69,1.05,17.86,Facile,Difficile,-2,Beaucoup plus Difficile,Pas Adapte,Mathematics
4087,2018,Mathématiques,4,Les Séries Numériques,3,Rappels et Complements sur le Groupe Orthogonal d'un Espace Euclidien,8,716,6,QCM,0.38,0.37,58.0,59,42,101,74,59,15,1.36,79.73,Moyen,Moyen,0,Meme Difficulté,Pas Adapte,Mathematics
5211,2019,Mathématiques,4,Les Séries Numériques,3,Rappels et Complements sur le Groupe Orthogonal d'un Espace Euclidien,8,716,6,QCM,0.75,0.21,0.0,0,105,105,85,0,85,1.24,0.0,Moyen,Difficile,-1,Plus Difficile,Pas Adapte,Mathematics
6335,2020,Mathématiques,4,Les Séries Numériques,3,Rappels et Complements sur le Groupe Orthogonal d'un Espace Euclidien,8,716,6,QCM,0.45,0.51,42.0,47,64,111,72,47,25,1.54,65.28,Difficile,Moyen,1,Plus Facile,Pas Adapte,Mathematics
716,2015,Mathématiques,4,Les Séries Numériques,3,Rappels et Complements sur le Groupe Orthogonal d'un Espace Euclidien,8,717,7,QCU,0.73,0.39,27.0,24,66,90,75,24,51,1.2,32.0,Facile,Difficile,-2,Beaucoup plus Difficile,Pas Adapte,Mathematics
1840,2016,Mathématiques,4,Les Séries Numériques,3,Rappels et Complements sur le Groupe Orthogonal d'un Espace Euclidien,8,717,7,QCU,0.48,0.29,7.0,7,96,103,58,7,51,1.78,12.07,Moyen,Difficile,-1,Plus Difficile,Pas Adapte,Mathematics
2964,2017,Mathématiques,4,Les Séries Numériques,3,Rappels et Complements sur le Groupe Orthogonal d'un Espace Euclidien,8,717,7,QCU,0.55,0.26,31.0,34,76,110,98,34,64,1.12,34.69,Difficile,Difficile,0,Meme Difficulté,Pas Adapte,Mathematics
4088,2018,Mathématiques,4,Les Séries Numériques,3,Rappels et Complements sur le Groupe Orthogonal d'un Espace Euclidien,8,717,7,QCM,0.36,0.4,63.0,76,45,121,93,76,17,1.3,81.72,Facile,Moyen,-1,Plus Difficile,Adapte,Mathematics
5212,2019,Mathématiques,4,Les Séries Numériques,3,Rappels et Complements sur le Groupe Orthogonal d'un Espace Euclidien,8,717,7,QCM,0.36,0.34,63.0,79,47,126,88,79,9,1.43,89.77,Moyen,Moyen,0,Meme Difficulté,Adapte,Mathematics
6336,2020,Mathématiques,4,Les Séries Numériques,3,Rappels et Complements sur le Groupe Orthogonal d'un Espace Euclidien,8,717,7,QCU,0.39,0.43,63.0,74,43,117,96,74,22,1.22,77.08,Moyen,Moyen,0,Meme Difficulté,Adapte,Mathematics
717,2015,Mathématiques,4,Les Séries Numériques,3,Rappels et Complements sur le Groupe Orthogonal d'un Espace Euclidien,8,718,8,QCU,0.56,0.35,30.0,23,53,76,26,23,3,2.92,88.46,Difficile,Difficile,0,Meme Difficulté,Pas Adapte,Mathematics
1841,2016,Mathématiques,4,Les Séries Numériques,3,Rappels et Complements sur le Groupe Orthogonal d'un Espace Euclidien,8,718,8,QCU,0.58,0.37,18.0,15,69,84,60,15,45,1.4,25.0,Moyen,Difficile,-1,Plus Difficile,Pas Adapte,Mathematics
2965,2017,Mathématiques,4,Les Séries Numériques,3,Rappels et Complements sur le Groupe Orthogonal d'un Espace Euclidien,8,718,8,QCU,0.38,0.59,57.0,44,33,77,61,44,17,1.26,72.13,Facile,Moyen,-1,Plus Difficile,Pas Adapte,Mathematics
4089,2018,Mathématiques,4,Les Séries Numériques,3,Rappels et Complements sur le Groupe Orthogonal d'un Espace Euclidien,8,718,8,QCU,0.72,0.21,2.0,2,87,89,74,2,72,1.2,2.7,Moyen,Difficile,-1,Plus Difficile,Pas Adapte,Mathematics
5213,2019,Mathématiques,4,Les Séries Numériques,3,Rappels et Complements sur le Groupe Orthogonal d'un Espace Euclidien,8,718,8,QCU,0.61,0.21,28.0,27,69,96,95,27,68,1.01,28.42,Moyen,Difficile,-1,Plus Difficile,Pas Adapte,Mathematics
6337,2020,Mathématiques,4,Les Séries Numériques,3,Rappels et Complements sur le Groupe Orthogonal d'un Espace Euclidien,8,718,8,QCU,0.73,0.4,31.0,34,75,109,97,34,63,1.12,35.05,Facile,Difficile,-2,Beaucoup plus Difficile,Pas Adapte,Mathematics
718,2015,Mathématiques,4,Les Séries Numériques,4,Complement sur les Endomorphismes Autoadjoints d'un Espace Euclidien et les Matrices Symetriques,3,719,1,QCM,0.26,0.41,57.0,46,35,81,62,46,16,1.31,74.19,Moyen,Moyen,0,Meme Difficulté,Pas Adapte,Mathematics
1842,2016,Mathématiques,4,Les Séries Numériques,4,Complement sur les Endomorphismes Autoadjoints d'un Espace Euclidien et les Matrices Symetriques,3,719,1,QCM,0.24,0.5,39.0,35,54,89,84,35,49,1.06,41.67,Facile,Moyen,-1,Plus Difficile,Pas Adapte,Mathematics
2966,2017,Mathématiques,4,Les Séries Numériques,4,Complement sur les Endomorphismes Autoadjoints d'un Espace Euclidien et les Matrices Symetriques,3,719,1,QCM,0.21,0.65,40.0,40,59,99,75,40,35,1.32,53.33,Facile,Moyen,-1,Plus Difficile,Pas Adapte,Mathematics
4090,2018,Mathématiques,4,Les Séries Numériques,4,Complement sur les Endomorphismes Autoadjoints d'un Espace Euclidien et les Matrices Symetriques,3,719,1,QCM,0.24,0.41,57.0,52,39,91,54,52,2,1.69,96.3,Facile,Moyen,-1,Plus Difficile,Pas Adapte,Mathematics
5214,2019,Mathématiques,4,Les Séries Numériques,4,Complement sur les Endomorphismes Autoadjoints d'un Espace Euclidien et les Matrices Symetriques,3,719,1,QCM,0.35,0.52,39.0,41,63,104,65,41,24,1.6,63.08,Facile,Moyen,-1,Plus Difficile,Pas Adapte,Mathematics
6338,2020,Mathématiques,4,Les Séries Numériques,4,Complement sur les Endomorphismes Autoadjoints d'un Espace Euclidien et les Matrices Symetriques,3,719,1,QCM,0.43,0.49,44.0,41,52,93,88,41,47,1.06,46.59,Moyen,Moyen,0,Meme Difficulté,Pas Adapte,Mathematics
719,2015,Mathématiques,4,Les Séries Numériques,4,Complement sur les Endomorphismes Autoadjoints d'un Espace Euclidien et les Matrices Symetriques,3,720,2,QCU,0.42,0.31,25.0,21,63,84,35,21,14,2.4,60.0,Facile,Difficile,-2,Beaucoup plus Difficile,Pas Adapte,Mathematics
1843,2016,Mathématiques,4,Les Séries Numériques,4,Complement sur les Endomorphismes Autoadjoints d'un Espace Euclidien et les Matrices Symetriques,3,720,2,QCU,0.58,0.35,3.0,2,71,73,30,2,28,2.43,6.67,Moyen,Difficile,-1,Plus Difficile,Pas Adapte,Mathematics
2967,2017,Mathématiques,4,Les Séries Numériques,4,Complement sur les Endomorphismes Autoadjoints d'un Espace Euclidien et les Matrices Symetriques,3,720,2,QCU,0.55,0.28,10.0,8,75,83,39,8,31,2.13,20.51,Facile,Difficile,-2,Beaucoup plus Difficile,Pas Adapte,Mathematics
4091,2018,Mathématiques,4,Les Séries Numériques,4,Complement sur les Endomorphismes Autoadjoints d'un Espace Euclidien et les Matrices Symetriques,3,720,2,QCU,0.26,0.46,54.0,45,38,83,52,45,7,1.6,86.54,Facile,Moyen,-1,Plus Difficile,Pas Adapte,Mathematics
5215,2019,Mathématiques,4,Les Séries Numériques,4,Complement sur les Endomorphismes Autoadjoints d'un Espace Euclidien et les Matrices Symetriques,3,720,2,QCU,0.61,0.27,7.0,5,72,77,54,5,49,1.43,9.26,Moyen,Difficile,-1,Plus Difficile,Pas Adapte,Mathematics
6339,2020,Mathématiques,4,Les Séries Numériques,4,Complement sur les Endomorphismes Autoadjoints d'un Espace Euclidien et les Matrices Symetriques,3,720,2,QCU,0.59,0.29,29.0,22,54,76,31,22,9,2.45,70.97,Difficile,Difficile,0,Meme Difficulté,Pas Adapte,Mathematics
720,2015,Mathématiques,4,Les Séries Numériques,4,Complement sur les Endomorphismes Autoadjoints d'un Espace Euclidien et les Matrices Symetriques,3,721,3,QCU,0.46,0.2,27.0,8,20,28,24,8,16,1.17,33.33,Facile,Difficile,-2,Beaucoup plus Difficile,Pas Adapte,Mathematics
1844,2016,Mathématiques,4,Les Séries Numériques,4,Complement sur les Endomorphismes Autoadjoints d'un Espace Euclidien et les Matrices Symetriques,3,721,3,QCU,0.51,0.24,19.0,6,23,29,21,6,15,1.38,28.57,Difficile,Difficile,0,Meme Difficulté,Pas Adapte,Mathematics
2968,2017,Mathématiques,4,Les Séries Numériques,4,Complement sur les Endomorphismes Autoadjoints d'un Espace Euclidien et les Matrices Symetriques,3,721,3,QCU,0.54,0.37,22.0,7,23,30,12,7,5,2.5,58.33,Moyen,Difficile,-1,Plus Difficile,Pas Adapte,Mathematics
4092,2018,Mathématiques,4,Les Séries Numériques,4,Complement sur les Endomorphismes Autoadjoints d'un Espace Euclidien et les Matrices Symetriques,3,721,3,QCU,0.4,0.63,40.0,13,19,32,26,13,13,1.23,50.0,Difficile,Moyen,1,Plus Facile,Pas Adapte,Mathematics
5216,2019,Mathématiques,4,Les Séries Numériques,4,Complement sur les Endomorphismes Autoadjoints d'un Espace Euclidien et les Matrices Symetriques,3,721,3,QROC,0.89,0.0,29.0,9,21,30,14,9,5,2.14,64.29,Facile,Difficile,-2,Beaucoup plus Difficile,Pas Adapte,Mathematics
6340,2020,Mathématiques,4,Les Séries Numériques,4,Complement sur les Endomorphismes Autoadjoints d'un Espace Euclidien et les Matrices Symetriques,3,721,3,QROC,0.65,0.05,0.0,0,29,29,18,0,18,1.61,0.0,Difficile,Difficile,0,Meme Difficulté,Pas Adapte,Mathematics
721,2015,Mathématiques,5,La Géométrie Analytique,1,Sur l'Utilisation de Maple,11,722,1,QROC,0.28,0.35,44.0,8,11,19,17,8,9,1.12,47.06,Moyen,Moyen,0,Meme Difficulté,Pas Adapte,Mathematics
1845,2016,Mathématiques,5,La Géométrie Analytique,1,Sur l'Utilisation de Maple,11,722,1,QROC,0.65,0.18,17.0,3,13,16,10,3,7,1.6,30.0,Moyen,Difficile,-1,Plus Difficile,Pas Adapte,Mathematics
2969,2017,Mathématiques,5,La Géométrie Analytique,1,Sur l'Utilisation de Maple,11,722,1,QROC,0.29,0.32,54.0,9,7,16,13,9,4,1.23,69.23,Difficile,Moyen,1,Plus Facile,Pas Adapte,Mathematics
4093,2018,Mathématiques,5,La Géométrie Analytique,1,Sur l'Utilisation de Maple,11,722,1,QCM,0.21,0.48,54.0,9,7,16,15,9,6,1.07,60.0,Difficile,Moyen,1,Plus Facile,Pas Adapte,Mathematics
5217,2019,Mathématiques,5,La Géométrie Analytique,1,Sur l'Utilisation de Maple,11,722,1,QCM,0.78,0.25,6.0,1,14,15,5,1,4,3.0,20.0,Moyen,Difficile,-1,Plus Difficile,Pas Adapte,Mathematics
6341,2020,Mathématiques,5,La Géométrie Analytique,1,Sur l'Utilisation de Maple,11,722,1,QCU,0.54,0.31,27.0,5,12,17,17,5,12,1.0,29.41,Difficile,Difficile,0,Meme Difficulté,Pas Adapte,Mathematics
722,2015,Mathématiques,5,La Géométrie Analytique,1,Sur l'Utilisation de Maple,11,723,2,QCM,0.6,0.27,22.0,13,46,59,51,13,38,1.16,25.49,Facile,Difficile,-2,Beaucoup plus Difficile,Pas Adapte,Mathematics
1846,2016,Mathématiques,5,La Géométrie Analytique,1,Sur l'Utilisation de Maple,11,723,2,QCM,0.75,0.27,34.0,21,40,61,55,21,34,1.11,38.18,Facile,Difficile,-2,Beaucoup plus Difficile,Pas Adapte,Mathematics
2970,2017,Mathématiques,5,La Géométrie Analytique,1,Sur l'Utilisation de Maple,11,723,2,QCM,0.72,0.2,11.0,8,61,69,23,8,15,3.0,34.78,Difficile,Difficile,0,Meme Difficulté,Pas Adapte,Mathematics
4094,2018,Mathématiques,5,La Géométrie Analytique,1,Sur l'Utilisation de Maple,11,723,2,QCM,0.55,0.19,32.0,23,49,72,51,23,28,1.41,45.1,Difficile,Difficile,0,Meme Difficulté,Pas Adapte,Mathematics
5218,2019,Mathématiques,5,La Géométrie Analytique,1,Sur l'Utilisation de Maple,11,723,2,QCM,0.62,0.3,31.0,23,50,73,61,23,38,1.2,37.7,Difficile,Difficile,0,Meme Difficulté,Pas Adapte,Mathematics
6342,2020,Mathématiques,5,La Géométrie Analytique,1,Sur l'Utilisation de Maple,11,723,2,QCM,0.42,0.48,45.0,29,36,65,47,29,18,1.38,61.7,Difficile,Moyen,1,Plus Facile,Pas Adapte,Mathematics
723,2015,Mathématiques,5,La Géométrie Analytique,1,Sur l'Utilisation de Maple,11,724,3,QCU,0.31,0.58,42.0,9,13,22,21,9,12,1.05,42.86,Facile,Moyen,-1,Plus Difficile,Pas Adapte,Mathematics
1847,2016,Mathématiques,5,La Géométrie Analytique,1,Sur l'Utilisation de Maple,11,724,3,QROC,0.74,0.06,14.0,3,20,23,12,3,9,1.92,25.0,Difficile,Difficile,0,Meme Difficulté,Pas Adapte,Mathematics
2971,2017,Mathématiques,5,La Géométrie Analytique,1,Sur l'Utilisation de Maple,11,724,3,QROC,0.45,0.38,57.0,13,10,23,15,13,2,1.53,86.67,Difficile,Moyen,1,Plus Facile,Pas Adapte,Mathematics
4095,2018,Mathématiques,5,La Géométrie Analytique,1,Sur l'Utilisation de Maple,11,724,3,QROC,0.45,0.37,63.0,13,7,20,15,13,2,1.33,86.67,Difficile,Moyen,1,Plus Facile,Adapte,Mathematics
5219,2019,Mathématiques,5,La Géométrie Analytique,1,Sur l'Utilisation de Maple,11,724,3,QCM,0.29,0.66,63.0,14,8,22,20,14,6,1.1,70.0,Moyen,Moyen,0,Meme Difficulté,Adapte,Mathematics
6343,2020,Mathématiques,5,La Géométrie Analytique,1,Sur l'Utilisation de Maple,11,724,3,QCM,0.2,0.48,63.0,13,8,21,16,13,3,1.31,81.25,Moyen,Moyen,0,Meme Difficulté,Adapte,Mathematics
724,2015,Mathématiques,5,La Géométrie Analytique,1,Sur l'Utilisation de Maple,11,725,4,QCU,0.21,0.45,54.0,44,37,81,81,44,37,1.0,54.32,Difficile,Moyen,1,Plus Facile,Pas Adapte,Mathematics
1848,2016,Mathématiques,5,La Géométrie Analytique,1,Sur l'Utilisation de Maple,11,725,4,QCU,0.54,0.25,2.0,2,77,79,56,2,54,1.41,3.57,Facile,Difficile,-2,Beaucoup plus Difficile,Pas Adapte,Mathematics
2972,2017,Mathématiques,5,La Géométrie Analytique,1,Sur l'Utilisation de Maple,11,725,4,QCU,0.55,0.28,30.0,24,56,80,73,24,49,1.1,32.88,Difficile,Difficile,0,Meme Difficulté,Pas Adapte,Mathematics
4096,2018,Mathématiques,5,La Géométrie Analytique,1,Sur l'Utilisation de Maple,11,725,4,QCU,0.68,0.2,23.0,16,54,70,33,16,17,2.12,48.48,Moyen,Difficile,-1,Plus Difficile,Pas Adapte,Mathematics
5220,2019,Mathématiques,5,La Géométrie Analytique,1,Sur l'Utilisation de Maple,11,725,4,QCU,0.35,0.61,48.0,36,40,76,66,36,30,1.15,54.55,Facile,Moyen,-1,Plus Difficile,Pas Adapte,Mathematics
6344,2020,Mathématiques,5,La Géométrie Analytique,1,Sur l'Utilisation de Maple,11,725,4,QCU,0.46,0.3,22.0,18,64,82,43,18,25,1.91,41.86,Facile,Difficile,-2,Beaucoup plus Difficile,Pas Adapte,Mathematics
725,2015,Mathématiques,5,La Géométrie Analytique,1,Sur l'Utilisation de Maple,11,726,5,QCU,0.49,0.39,2.0,1,46,47,21,1,20,2.24,4.76,Facile,Difficile,-2,Beaucoup plus Difficile,Pas Adapte,Mathematics
1849,2016,Mathématiques,5,La Géométrie Analytique,1,Sur l'Utilisation de Maple,11,726,5,QCU,0.38,0.5,36.0,15,26,41,37,15,22,1.11,40.54,Difficile,Moyen,1,Plus Facile,Pas Adapte,Mathematics
2973,2017,Mathématiques,5,La Géométrie Analytique,1,Sur l'Utilisation de Maple,11,726,5,QCU,0.56,0.26,22.0,8,27,35,14,8,6,2.5,57.14,Difficile,Difficile,0,Meme Difficulté,Pas Adapte,Mathematics
4097,2018,Mathématiques,5,La Géométrie Analytique,1,Sur l'Utilisation de Maple,11,726,5,QCU,0.38,0.65,64.0,22,12,34,27,22,5,1.26,81.48,Moyen,Moyen,0,Meme Difficulté,Adapte,Mathematics
5221,2019,Mathématiques,5,La Géométrie Analytique,1,Sur l'Utilisation de Maple,11,726,5,QCU,0.24,0.41,64.0,19,10,29,25,19,6,1.16,76.0,Moyen,Moyen,0,Meme Difficulté,Adapte,Mathematics
6345,2020,Mathématiques,5,La Géométrie Analytique,1,Sur l'Utilisation de Maple,11,726,5,QCU,0.36,0.64,64.0,17,9,26,19,17,2,1.37,89.47,Moyen,Moyen,0,Meme Difficulté,Adapte,Mathematics
726,2015,Mathématiques,5,La Géométrie Analytique,1,Sur l'Utilisation de Maple,11,727,6,QCM,0.53,0.19,17.0,2,8,10,7,2,5,1.43,28.57,Facile,Difficile,-2,Beaucoup plus Difficile,Pas Adapte,Mathematics
1850,2016,Mathématiques,5,La Géométrie Analytique,1,Sur l'Utilisation de Maple,11,727,6,QCM,0.6,0.21,5.0,0,9,9,3,0,3,3.0,0.0,Facile,Difficile,-2,Beaucoup plus Difficile,Pas Adapte,Mathematics
2974,2017,Mathématiques,5,La Géométrie Analytique,1,Sur l'Utilisation de Maple,11,727,6,QCM,0.47,0.31,41.0,4,6,10,6,4,2,1.67,66.67,Facile,Moyen,-1,Plus Difficile,Pas Adapte,Mathematics
4098,2018,Mathématiques,5,La Géométrie Analytique,1,Sur l'Utilisation de Maple,11,727,6,QCM,0.21,0.35,54.0,6,6,12,10,6,4,1.2,60.0,Difficile,Moyen,1,Plus Facile,Pas Adapte,Mathematics
5222,2019,Mathématiques,5,La Géométrie Analytique,1,Sur l'Utilisation de Maple,11,727,6,QCM,0.47,0.3,45.0,5,7,12,11,5,6,1.09,45.45,Moyen,Moyen,0,Meme Difficulté,Pas Adapte,Mathematics
6346,2020,Mathématiques,5,La Géométrie Analytique,1,Sur l'Utilisation de Maple,11,727,6,QCM,0.55,0.23,33.0,3,7,10,3,3,0,3.33,100.0,Facile,Difficile,-2,Beaucoup plus Difficile,Pas Adapte,Mathematics
727,2015,Mathématiques,5,La Géométrie Analytique,1,Sur l'Utilisation de Maple,11,728,7,QCM,0.4,0.51,50.0,20,21,41,36,20,16,1.14,55.56,Difficile,Moyen,1,Plus Facile,Pas Adapte,Mathematics
1851,2016,Mathématiques,5,La Géométrie Analytique,1,Sur l'Utilisation de Maple,11,728,7,QCM,0.55,0.18,19.0,9,38,47,36,9,27,1.31,25.0,Difficile,Difficile,0,Meme Difficulté,Pas Adapte,Mathematics
2975,2017,Mathématiques,5,La Géométrie Analytique,1,Sur l'Utilisation de Maple,11,728,7,QCM,0.35,0.39,49.0,26,28,54,37,26,11,1.46,70.27,Difficile,Moyen,1,Plus Facile,Pas Adapte,Mathematics
4099,2018,Mathématiques,5,La Géométrie Analytique,1,Sur l'Utilisation de Maple,11,728,7,QCM,0.55,0.28,25.0,12,37,49,25,12,13,1.96,48.0,Difficile,Difficile,0,Meme Difficulté,Pas Adapte,Mathematics
5223,2019,Mathématiques,5,La Géométrie Analytique,1,Sur l'Utilisation de Maple,11,728,7,QCM,0.38,0.58,61.0,33,21,54,48,33,15,1.12,68.75,Facile,Moyen,-1,Plus Difficile,Adapte,Mathematics
6347,2020,Mathématiques,5,La Géométrie Analytique,1,Sur l'Utilisation de Maple,11,728,7,QCU,0.36,0.54,61.0,36,23,59,52,36,16,1.13,69.23,Moyen,Moyen,0,Meme Difficulté,Adapte,Mathematics
728,2015,Mathématiques,5,La Géométrie Analytique,1,Sur l'Utilisation de Maple,11,729,8,QCU,0.54,0.22,21.0,14,54,68,62,14,48,1.1,22.58,Moyen,Difficile,-1,Plus Difficile,Pas Adapte,Mathematics
1852,2016,Mathématiques,5,La Géométrie Analytique,1,Sur l'Utilisation de Maple,11,729,8,QCU,0.24,0.67,63.0,37,21,58,53,37,16,1.09,69.81,Moyen,Moyen,0,Meme Difficulté,Adapte,Mathematics
2976,2017,Mathématiques,5,La Géométrie Analytique,1,Sur l'Utilisation de Maple,11,729,8,QCU,0.39,0.74,63.0,35,21,56,40,35,5,1.4,87.5,Moyen,Moyen,0,Meme Difficulté,Adapte,Mathematics
4100,2018,Mathématiques,5,La Géométrie Analytique,1,Sur l'Utilisation de Maple,11,729,8,QCU,0.34,0.63,63.0,38,22,60,53,38,15,1.13,71.7,Moyen,Moyen,0,Meme Difficulté,Adapte,Mathematics
5224,2019,Mathématiques,5,La Géométrie Analytique,1,Sur l'Utilisation de Maple,11,729,8,QROC,0.2,0.39,63.0,33,19,52,33,33,0,1.58,100.0,Moyen,Moyen,0,Meme Difficulté,Adapte,Mathematics
6348,2020,Mathématiques,5,La Géométrie Analytique,1,Sur l'Utilisation de Maple,11,729,8,QROC,0.33,0.25,63.0,32,18,50,45,32,13,1.11,71.11,Moyen,Moyen,0,Meme Difficulté,Adapte,Mathematics
729,2015,Mathématiques,5,La Géométrie Analytique,1,Sur l'Utilisation de Maple,11,730,9,QCU,0.27,0.56,60.0,19,12,31,20,19,1,1.55,95.0,Difficile,Moyen,1,Plus Facile,Adapte,Mathematics
1853,2016,Mathématiques,5,La Géométrie Analytique,1,Sur l'Utilisation de Maple,11,730,9,QCU,0.38,0.47,60.0,19,12,31,28,19,9,1.11,67.86,Moyen,Moyen,0,Meme Difficulté,Adapte,Mathematics
2977,2017,Mathématiques,5,La Géométrie Analytique,1,Sur l'Utilisation de Maple,11,730,9,QCU,0.25,0.55,60.0,19,13,32,30,19,11,1.07,63.33,Moyen,Moyen,0,Meme Difficulté,Adapte,Mathematics
4101,2018,Mathématiques,5,La Géométrie Analytique,1,Sur l'Utilisation de Maple,11,730,9,QROC,0.21,0.31,60.0,20,14,34,30,20,10,1.13,66.67,Moyen,Moyen,0,Meme Difficulté,Adapte,Mathematics
5225,2019,Mathématiques,5,La Géométrie Analytique,1,Sur l'Utilisation de Maple,11,730,9,QROC,0.48,0.28,60.0,17,12,29,24,17,7,1.21,70.83,Moyen,Moyen,0,Meme Difficulté,Adapte,Mathematics
6349,2020,Mathématiques,5,La Géométrie Analytique,1,Sur l'Utilisation de Maple,11,730,9,QO,0.62,0.19,60.0,16,11,27,27,16,11,1.0,59.26,Moyen,Moyen,0,Meme Difficulté,Adapte,Mathematics
730,2015,Mathématiques,5,La Géométrie Analytique,1,Sur l'Utilisation de Maple,11,731,10,QCU,0.6,0.39,10.0,1,5,6,5,1,4,1.2,20.0,Moyen,Difficile,-1,Plus Difficile,Pas Adapte,Mathematics
1854,2016,Mathématiques,5,La Géométrie Analytique,1,Sur l'Utilisation de Maple,11,731,10,QCU,0.7,0.26,27.0,2,5,7,5,2,3,1.4,40.0,Difficile,Difficile,0,Meme Difficulté,Pas Adapte,Mathematics
2978,2017,Mathématiques,5,La Géométrie Analytique,1,Sur l'Utilisation de Maple,11,731,10,QCU,0.0,0.75,65.0,5,2,7,6,5,1,1.17,83.33,Moyen,Facile,1,Plus Facile,Adapte,Mathematics
4102,2018,Mathématiques,5,La Géométrie Analytique,1,Sur l'Utilisation de Maple,11,731,10,QCU,0.12,0.76,65.0,4,2,6,6,4,2,1.0,66.67,Facile,Facile,0,Meme Difficulté,Adapte,Mathematics
5226,2019,Mathématiques,5,La Géométrie Analytique,1,Sur l'Utilisation de Maple,11,731,10,QCU,0.2,0.95,65.0,4,2,6,5,4,1,1.2,80.0,Facile,Facile,0,Meme Difficulté,Adapte,Mathematics
6350,2020,Mathématiques,5,La Géométrie Analytique,1,Sur l'Utilisation de Maple,11,731,10,QCU,0.18,0.88,65.0,4,2,6,5,4,1,1.2,80.0,Facile,Facile,0,Meme Difficulté,Adapte,Mathematics
731,2015,Mathématiques,5,La Géométrie Analytique,1,Sur l'Utilisation de Maple,11,732,11,QROC,0.28,0.29,40.0,33,50,83,71,33,38,1.17,46.48,Facile,Moyen,-1,Plus Difficile,Pas Adapte,Mathematics
1855,2016,Mathématiques,5,La Géométrie Analytique,1,Sur l'Utilisation de Maple,11,732,11,QROC,0.61,0.17,25.0,20,59,79,73,20,53,1.08,27.4,Moyen,Difficile,-1,Plus Difficile,Pas Adapte,Mathematics
2979,2017,Mathématiques,5,La Géométrie Analytique,1,Sur l'Utilisation de Maple,11,732,11,QO,0.92,0.08,14.0,11,70,81,55,11,44,1.47,20.0,Difficile,Difficile,0,Meme Difficulté,Pas Adapte,Mathematics
4103,2018,Mathématiques,5,La Géométrie Analytique,1,Sur l'Utilisation de Maple,11,732,11,QO,0.63,0.16,61.0,51,33,84,61,51,10,1.38,83.61,Moyen,Moyen,0,Meme Difficulté,Adapte,Mathematics
5227,2019,Mathématiques,5,La Géométrie Analytique,1,Sur l'Utilisation de Maple,11,732,11,QO,0.63,0.29,61.0,49,32,81,79,49,30,1.03,62.03,Moyen,Moyen,0,Meme Difficulté,Adapte,Mathematics
6351,2020,Mathématiques,5,La Géométrie Analytique,1,Sur l'Utilisation de Maple,11,732,11,QO,0.39,0.23,61.0,44,28,72,54,44,10,1.33,81.48,Moyen,Moyen,0,Meme Difficulté,Adapte,Mathematics
732,2015,Mathématiques,5,La Géométrie Analytique,2,Methodes Generales pour aborder un probleme de Geometrie Analytique,10,733,1,QCU,0.62,0.21,4.0,2,54,56,45,2,43,1.24,4.44,Moyen,Difficile,-1,Plus Difficile,Pas Adapte,Mathematics
1856,2016,Mathématiques,5,La Géométrie Analytique,2,Methodes Generales pour aborder un probleme de Geometrie Analytique,10,733,1,QCU,0.58,0.3,19.0,10,44,54,29,10,19,1.86,34.48,Moyen,Difficile,-1,Plus Difficile,Pas Adapte,Mathematics
2980,2017,Mathématiques,5,La Géométrie Analytique,2,Methodes Generales pour aborder un probleme de Geometrie Analytique,10,733,1,QCU,0.54,0.4,28.0,17,42,59,49,17,32,1.2,34.69,Difficile,Difficile,0,Meme Difficulté,Pas Adapte,Mathematics
4104,2018,Mathématiques,5,La Géométrie Analytique,2,Methodes Generales pour aborder un probleme de Geometrie Analytique,10,733,1,QCU,0.37,0.63,50.0,33,33,66,38,33,5,1.74,86.84,Facile,Moyen,-1,Plus Difficile,Pas Adapte,Mathematics
5228,2019,Mathématiques,5,La Géométrie Analytique,2,Methodes Generales pour aborder un probleme de Geometrie Analytique,10,733,1,QCU,0.46,0.35,29.0,18,44,62,34,18,16,1.82,52.94,Moyen,Difficile,-1,Plus Difficile,Pas Adapte,Mathematics
6352,2020,Mathématiques,5,La Géométrie Analytique,2,Methodes Generales pour aborder un probleme de Geometrie Analytique,10,733,1,QCM,0.66,0.21,30.0,18,43,61,25,18,7,2.44,72.0,Facile,Difficile,-2,Beaucoup plus Difficile,Pas Adapte,Mathematics
733,2015,Mathématiques,5,La Géométrie Analytique,2,Methodes Generales pour aborder un probleme de Geometrie Analytique,10,734,2,QCU,0.52,0.33,8.0,6,74,80,44,6,38,1.82,13.64,Difficile,Difficile,0,Meme Difficulté,Pas Adapte,Mathematics
1857,2016,Mathématiques,5,La Géométrie Analytique,2,Methodes Generales pour aborder un probleme de Geometrie Analytique,10,734,2,QCU,0.49,0.29,33.0,28,58,86,38,28,10,2.26,73.68,Difficile,Difficile,0,Meme Difficulté,Pas Adapte,Mathematics
2981,2017,Mathématiques,5,La Géométrie Analytique,2,Methodes Generales pour aborder un probleme de Geometrie Analytique,10,734,2,QCU,0.31,0.73,49.0,37,38,75,53,37,16,1.42,69.81,Moyen,Moyen,0,Meme Difficulté,Pas Adapte,Mathematics
4105,2018,Mathématiques,5,La Géométrie Analytique,2,Methodes Generales pour aborder un probleme de Geometrie Analytique,10,734,2,QCU,0.3,0.42,54.0,35,30,65,55,35,20,1.18,63.64,Facile,Moyen,-1,Plus Difficile,Pas Adapte,Mathematics
5229,2019,Mathématiques,5,La Géométrie Analytique,2,Methodes Generales pour aborder un probleme de Geometrie Analytique,10,734,2,QCM,0.69,0.25,15.0,8,48,56,53,8,45,1.06,15.09,Facile,Difficile,-2,Beaucoup plus Difficile,Pas Adapte,Mathematics
6353,2020,Mathématiques,5,La Géométrie Analytique,2,Methodes Generales pour aborder un probleme de Geometrie Analytique,10,734,2,QCM,0.59,0.16,11.0,6,46,52,38,6,32,1.37,15.79,Facile,Difficile,-2,Beaucoup plus Difficile,Pas Adapte,Mathematics
734,2015,Mathématiques,5,La Géométrie Analytique,2,Methodes Generales pour aborder un probleme de Geometrie Analytique,10,735,3,QCM,0.23,0.46,38.0,14,22,36,21,14,7,1.71,66.67,Facile,Moyen,-1,Plus Difficile,Pas Adapte,Mathematics
1858,2016,Mathématiques,5,La Géométrie Analytique,2,Methodes Generales pour aborder un probleme de Geometrie Analytique,10,735,3,QCM,0.49,0.66,52.0,17,16,33,26,17,9,1.27,65.38,Difficile,Moyen,1,Plus Facile,Pas Adapte,Mathematics
2982,2017,Mathématiques,5,La Géométrie Analytique,2,Methodes Generales pour aborder un probleme de Geometrie Analytique,10,735,3,QO,0.28,0.24,50.0,15,15,30,16,15,1,1.88,93.75,Facile,Moyen,-1,Plus Difficile,Pas Adapte,Mathematics
4106,2018,Mathématiques,5,La Géométrie Analytique,2,Methodes Generales pour aborder un probleme de Geometrie Analytique,10,735,3,QO,0.9,0.15,28.0,7,19,26,23,7,16,1.13,30.43,Facile,Difficile,-2,Beaucoup plus Difficile,Pas Adapte,Mathematics
5230,2019,Mathématiques,5,La Géométrie Analytique,2,Methodes Generales pour aborder un probleme de Geometrie Analytique,10,735,3,QCU,0.28,0.71,63.0,18,10,28,28,18,10,1.0,64.29,Facile,Moyen,-1,Plus Difficile,Adapte,Mathematics
6354,2020,Mathématiques,5,La Géométrie Analytique,2,Methodes Generales pour aborder un probleme de Geometrie Analytique,10,735,3,QCU,0.3,0.45,63.0,18,10,28,24,18,6,1.17,75.0,Moyen,Moyen,0,Meme Difficulté,Adapte,Mathematics
735,2015,Mathématiques,5,La Géométrie Analytique,2,Methodes Generales pour aborder un probleme de Geometrie Analytique,10,736,4,QCU,0.7,0.39,8.0,1,16,17,12,1,11,1.42,8.33,Difficile,Difficile,0,Meme Difficulté,Pas Adapte,Mathematics
1859,2016,Mathématiques,5,La Géométrie Analytique,2,Methodes Generales pour aborder un probleme de Geometrie Analytique,10,736,4,QCU,0.73,0.27,2.0,0,20,20,11,0,11,1.82,0.0,Facile,Difficile,-2,Beaucoup plus Difficile,Pas Adapte,Mathematics
2983,2017,Mathématiques,5,La Géométrie Analytique,2,Methodes Generales pour aborder un probleme de Geometrie Analytique,10,736,4,QCU,0.4,0.7,38.0,8,12,20,8,8,0,2.5,100.0,Facile,Moyen,-1,Plus Difficile,Pas Adapte,Mathematics
4107,2018,Mathématiques,5,La Géométrie Analytique,2,Methodes Generales pour aborder un probleme de Geometrie Analytique,10,736,4,QCU,0.27,0.52,55.0,11,9,20,15,11,4,1.33,73.33,Facile,Moyen,-1,Plus Difficile,Pas Adapte,Mathematics
5231,2019,Mathématiques,5,La Géométrie Analytique,2,Methodes Generales pour aborder un probleme de Geometrie Analytique,10,736,4,QCU,0.11,0.97,65.0,15,8,23,19,15,4,1.21,78.95,Moyen,Facile,1,Plus Facile,Adapte,Mathematics
6355,2020,Mathématiques,5,La Géométrie Analytique,2,Methodes Generales pour aborder un probleme de Geometrie Analytique,10,736,4,QCM,0.06,0.94,65.0,14,7,21,19,14,5,1.11,73.68,Facile,Facile,0,Meme Difficulté,Adapte,Mathematics
736,2015,Mathématiques,5,La Géométrie Analytique,2,Methodes Generales pour aborder un probleme de Geometrie Analytique,10,737,5,QCU,0.3,0.69,63.0,25,14,39,39,25,14,1.0,64.1,Moyen,Moyen,0,Meme Difficulté,Adapte,Mathematics
1860,2016,Mathématiques,5,La Géométrie Analytique,2,Methodes Generales pour aborder un probleme de Geometrie Analytique,10,737,5,QCM,0.28,0.33,63.0,22,13,35,30,22,8,1.17,73.33,Moyen,Moyen,0,Meme Difficulté,Adapte,Mathematics
2984,2017,Mathématiques,5,La Géométrie Analytique,2,Methodes Generales pour aborder un probleme de Geometrie Analytique,10,737,5,QCM,0.43,0.52,63.0,21,12,33,26,21,5,1.27,80.77,Moyen,Moyen,0,Meme Difficulté,Adapte,Mathematics
4108,2018,Mathématiques,5,La Géométrie Analytique,2,Methodes Generales pour aborder un probleme de Geometrie Analytique,10,737,5,QCM,0.36,0.65,63.0,24,14,38,31,24,7,1.23,77.42,Moyen,Moyen,0,Meme Difficulté,Adapte,Mathematics
5232,2019,Mathématiques,5,La Géométrie Analytique,2,Methodes Generales pour aborder un probleme de Geometrie Analytique,10,737,5,QCM,0.34,0.37,63.0,22,13,35,22,22,0,1.59,100.0,Moyen,Moyen,0,Meme Difficulté,Adapte,Mathematics
6356,2020,Mathématiques,5,La Géométrie Analytique,2,Methodes Generales pour aborder un probleme de Geometrie Analytique,10,737,5,QCM,0.3,0.56,63.0,22,13,35,27,22,5,1.3,81.48,Moyen,Moyen,0,Meme Difficulté,Adapte,Mathematics
737,2015,Mathématiques,5,La Géométrie Analytique,2,Methodes Generales pour aborder un probleme de Geometrie Analytique,10,738,6,QCM,0.41,0.48,43.0,11,15,26,22,11,11,1.18,50.0,Difficile,Moyen,1,Plus Facile,Pas Adapte,Mathematics
1861,2016,Mathématiques,5,La Géométrie Analytique,2,Methodes Generales pour aborder un probleme de Geometrie Analytique,10,738,6,QCM,0.74,0.16,19.0,5,20,25,24,5,19,1.04,20.83,Facile,Difficile,-2,Beaucoup plus Difficile,Pas Adapte,Mathematics
2985,2017,Mathématiques,5,La Géométrie Analytique,2,Methodes Generales pour aborder un probleme de Geometrie Analytique,10,738,6,QCM,0.36,0.55,38.0,11,17,28,18,11,7,1.56,61.11,Moyen,Moyen,0,Meme Difficulté,Pas Adapte,Mathematics
4109,2018,Mathématiques,5,La Géométrie Analytique,2,Methodes Generales pour aborder un probleme de Geometrie Analytique,10,738,6,QCU,0.66,0.39,4.0,1,30,31,11,1,10,2.82,9.09,Difficile,Difficile,0,Meme Difficulté,Pas Adapte,Mathematics
5233,2019,Mathématiques,5,La Géométrie Analytique,2,Methodes Generales pour aborder un probleme de Geometrie Analytique,10,738,6,QCU,0.2,0.42,54.0,17,14,31,30,17,13,1.03,56.67,Facile,Moyen,-1,Plus Difficile,Pas Adapte,Mathematics
6357,2020,Mathématiques,5,La Géométrie Analytique,2,Methodes Generales pour aborder un probleme de Geometrie Analytique,10,738,6,QCM,0.74,0.18,17.0,5,27,32,11,5,6,2.91,45.45,Moyen,Difficile,-1,Plus Difficile,Pas Adapte,Mathematics
738,2015,Mathématiques,5,La Géométrie Analytique,2,Methodes Generales pour aborder un probleme de Geometrie Analytique,10,739,7,QCM,0.62,0.16,10.0,1,7,8,4,1,3,2.0,25.0,Difficile,Difficile,0,Meme Difficulté,Pas Adapte,Mathematics
1862,2016,Mathématiques,5,La Géométrie Analytique,2,Methodes Generales pour aborder un probleme de Geometrie Analytique,10,739,7,QCM,0.79,0.16,24.0,2,5,7,4,2,2,1.75,50.0,Facile,Difficile,-2,Beaucoup plus Difficile,Pas Adapte,Mathematics
2986,2017,Mathématiques,5,La Géométrie Analytique,2,Methodes Generales pour aborder un probleme de Geometrie Analytique,10,739,7,QCU,0.27,0.65,64.0,5,3,8,7,5,2,1.14,71.43,Facile,Moyen,-1,Plus Difficile,Adapte,Mathematics
4110,2018,Mathématiques,5,La Géométrie Analytique,2,Methodes Generales pour aborder un probleme de Geometrie Analytique,10,739,7,QCU,0.38,0.47,64.0,4,3,7,6,4,2,1.17,66.67,Moyen,Moyen,0,Meme Difficulté,Adapte,Mathematics
5234,2019,Mathématiques,5,La Géométrie Analytique,2,Methodes Generales pour aborder un probleme de Geometrie Analytique,10,739,7,QCU,0.22,0.46,64.0,4,3,7,5,4,1,1.4,80.0,Moyen,Moyen,0,Meme Difficulté,Adapte,Mathematics
6358,2020,Mathématiques,5,La Géométrie Analytique,2,Methodes Generales pour aborder un probleme de Geometrie Analytique,10,739,7,QCU,0.39,0.41,64.0,5,3,8,7,5,2,1.14,71.43,Moyen,Moyen,0,Meme Difficulté,Adapte,Mathematics
739,2015,Mathématiques,5,La Géométrie Analytique,2,Methodes Generales pour aborder un probleme de Geometrie Analytique,10,740,8,QCU,0.47,0.24,11.0,10,81,91,80,10,70,1.14,12.5,Difficile,Difficile,0,Meme Difficulté,Pas Adapte,Mathematics
1863,2016,Mathématiques,5,La Géométrie Analytique,2,Methodes Generales pour aborder un probleme de Geometrie Analytique,10,740,8,QCU,0.5,0.22,4.0,4,90,94,71,4,67,1.32,5.63,Difficile,Difficile,0,Meme Difficulté,Pas Adapte,Mathematics
2987,2017,Mathématiques,5,La Géométrie Analytique,2,Methodes Generales pour aborder un probleme de Geometrie Analytique,10,740,8,QCU,0.39,0.52,41.0,43,61,104,76,43,33,1.37,56.58,Facile,Moyen,-1,Plus Difficile,Pas Adapte,Mathematics
4111,2018,Mathématiques,5,La Géométrie Analytique,2,Methodes Generales pour aborder un probleme de Geometrie Analytique,10,740,8,QCU,0.36,0.61,44.0,41,52,93,74,41,33,1.26,55.41,Facile,Moyen,-1,Plus Difficile,Pas Adapte,Mathematics
5235,2019,Mathématiques,5,La Géométrie Analytique,2,Methodes Generales pour aborder un probleme de Geometrie Analytique,10,740,8,QCU,0.4,0.47,63.0,58,34,92,88,58,30,1.05,65.91,Facile,Moyen,-1,Plus Difficile,Adapte,Mathematics
6359,2020,Mathématiques,5,La Géométrie Analytique,2,Methodes Generales pour aborder un probleme de Geometrie Analytique,10,740,8,QCM,0.31,0.66,63.0,58,34,92,70,58,12,1.31,82.86,Moyen,Moyen,0,Meme Difficulté,Adapte,Mathematics
740,2015,Mathématiques,5,La Géométrie Analytique,2,Methodes Generales pour aborder un probleme de Geometrie Analytique,10,741,9,QCU,0.23,0.64,39.0,26,40,66,61,26,35,1.08,42.62,Moyen,Moyen,0,Meme Difficulté,Pas Adapte,Mathematics
1864,2016,Mathématiques,5,La Géométrie Analytique,2,Methodes Generales pour aborder un probleme de Geometrie Analytique,10,741,9,QCU,0.46,0.25,3.0,2,63,65,23,2,21,2.83,8.7,Facile,Difficile,-2,Beaucoup plus Difficile,Pas Adapte,Mathematics
2988,2017,Mathématiques,5,La Géométrie Analytique,2,Methodes Generales pour aborder un probleme de Geometrie Analytique,10,741,9,QCU,0.28,0.44,51.0,29,27,56,40,29,11,1.4,72.5,Difficile,Moyen,1,Plus Facile,Pas Adapte,Mathematics
4112,2018,Mathématiques,5,La Géométrie Analytique,2,Methodes Generales pour aborder un probleme de Geometrie Analytique,10,741,9,QCU,0.35,0.45,63.0,39,23,62,40,39,1,1.55,97.5,Moyen,Moyen,0,Meme Difficulté,Adapte,Mathematics
5236,2019,Mathématiques,5,La Géométrie Analytique,2,Methodes Generales pour aborder un probleme de Geometrie Analytique,10,741,9,QCU,0.39,0.63,63.0,43,25,68,52,43,9,1.31,82.69,Moyen,Moyen,0,Meme Difficulté,Adapte,Mathematics
6360,2020,Mathématiques,5,La Géométrie Analytique,2,Methodes Generales pour aborder un probleme de Geometrie Analytique,10,741,9,QCU,0.38,0.41,63.0,46,27,73,47,46,1,1.55,97.87,Moyen,Moyen,0,Meme Difficulté,Adapte,Mathematics
741,2015,Mathématiques,5,La Géométrie Analytique,2,Methodes Generales pour aborder un probleme de Geometrie Analytique,10,742,10,QCU,0.22,0.53,38.0,4,7,11,7,4,3,1.57,57.14,Difficile,Moyen,1,Plus Facile,Pas Adapte,Mathematics
1865,2016,Mathématiques,5,La Géométrie Analytique,2,Methodes Generales pour aborder un probleme de Geometrie Analytique,10,742,10,QCU,0.72,0.3,18.0,2,9,11,6,2,4,1.83,33.33,Difficile,Difficile,0,Meme Difficulté,Pas Adapte,Mathematics
2989,2017,Mathématiques,5,La Géométrie Analytique,2,Methodes Generales pour aborder un probleme de Geometrie Analytique,10,742,10,QCU,0.42,0.31,2.0,0,13,13,9,0,9,1.44,0.0,Facile,Difficile,-2,Beaucoup plus Difficile,Pas Adapte,Mathematics
4113,2018,Mathématiques,5,La Géométrie Analytique,2,Methodes Generales pour aborder un probleme de Geometrie Analytique,10,742,10,QCU,0.3,0.57,54.0,7,6,13,10,7,3,1.3,70.0,Facile,Moyen,-1,Plus Difficile,Pas Adapte,Mathematics
5237,2019,Mathématiques,5,La Géométrie Analytique,2,Methodes Generales pour aborder un probleme de Geometrie Analytique,10,742,10,QCU,0.54,0.34,21.0,2,9,11,4,2,2,2.75,50.0,Facile,Difficile,-2,Beaucoup plus Difficile,Pas Adapte,Mathematics
6361,2020,Mathématiques,5,La Géométrie Analytique,2,Methodes Generales pour aborder un probleme de Geometrie Analytique,10,742,10,QCU,0.23,0.45,60.0,8,5,13,9,8,1,1.44,88.89,Difficile,Moyen,1,Plus Facile,Adapte,Mathematics
742,2015,Mathématiques,5,La Géométrie Analytique,3,Geometrie Plane,14,743,1,QO,0.63,0.16,64.0,31,18,49,37,31,6,1.32,83.78,Difficile,Moyen,1,Plus Facile,Adapte,Mathematics
1866,2016,Mathématiques,5,La Géométrie Analytique,3,Geometrie Plane,14,743,1,QO,0.24,0.17,64.0,32,18,50,41,32,9,1.22,78.05,Moyen,Moyen,0,Meme Difficulté,Adapte,Mathematics
2990,2017,Mathématiques,5,La Géométrie Analytique,3,Geometrie Plane,14,743,1,QO,0.29,0.19,64.0,30,17,47,43,30,13,1.09,69.77,Moyen,Moyen,0,Meme Difficulté,Adapte,Mathematics
4114,2018,Mathématiques,5,La Géométrie Analytique,3,Geometrie Plane,14,743,1,QCM,0.48,0.65,64.0,26,14,40,27,26,1,1.48,96.3,Moyen,Moyen,0,Meme Difficulté,Adapte,Mathematics
5238,2019,Mathématiques,5,La Géométrie Analytique,3,Geometrie Plane,14,743,1,QCM,0.38,0.62,64.0,22,13,35,25,22,3,1.4,88.0,Moyen,Moyen,0,Meme Difficulté,Adapte,Mathematics
6362,2020,Mathématiques,5,La Géométrie Analytique,3,Geometrie Plane,14,743,1,QCM,0.41,0.37,64.0,20,12,32,21,20,1,1.52,95.24,Moyen,Moyen,0,Meme Difficulté,Adapte,Mathematics
743,2015,Mathématiques,5,La Géométrie Analytique,3,Geometrie Plane,14,744,2,QCU,0.65,0.4,35.0,6,10,16,9,6,3,1.78,66.67,Difficile,Difficile,0,Meme Difficulté,Pas Adapte,Mathematics
1867,2016,Mathématiques,5,La Géométrie Analytique,3,Geometrie Plane,14,744,2,QCU,0.36,0.56,54.0,8,7,15,11,8,3,1.36,72.73,Difficile,Moyen,1,Plus Facile,Pas Adapte,Mathematics
2991,2017,Mathématiques,5,La Géométrie Analytique,3,Geometrie Plane,14,744,2,QCU,0.31,0.7,42.0,6,9,15,10,6,4,1.5,60.0,Moyen,Moyen,0,Meme Difficulté,Pas Adapte,Mathematics
4115,2018,Mathématiques,5,La Géométrie Analytique,3,Geometrie Plane,14,744,2,QCU,0.53,0.4,35.0,5,8,13,6,5,1,2.17,83.33,Facile,Difficile,-2,Beaucoup plus Difficile,Pas Adapte,Mathematics
5239,2019,Mathématiques,5,La Géométrie Analytique,3,Geometrie Plane,14,744,2,QCU,0.52,0.26,33.0,4,7,11,4,4,0,2.75,100.0,Moyen,Difficile,-1,Plus Difficile,Pas Adapte,Mathematics
6363,2020,Mathématiques,5,La Géométrie Analytique,3,Geometrie Plane,14,744,2,QCU,0.25,0.52,47.0,4,5,9,4,4,0,2.25,100.0,Facile,Moyen,-1,Plus Difficile,Pas Adapte,Mathematics
744,2015,Mathématiques,5,La Géométrie Analytique,3,Geometrie Plane,14,745,3,QCU,0.38,0.6,41.0,20,30,50,21,20,1,2.38,95.24,Difficile,Moyen,1,Plus Facile,Pas Adapte,Mathematics
1868,2016,Mathématiques,5,La Géométrie Analytique,3,Geometrie Plane,14,745,3,QCU,0.52,0.29,18.0,8,35,43,23,8,15,1.87,34.78,Difficile,Difficile,0,Meme Difficulté,Pas Adapte,Mathematics
2992,2017,Mathématiques,5,La Géométrie Analytique,3,Geometrie Plane,14,745,3,QCU,0.29,0.46,48.0,20,21,41,39,20,19,1.05,51.28,Moyen,Moyen,0,Meme Difficulté,Pas Adapte,Mathematics
4116,2018,Mathématiques,5,La Géométrie Analytique,3,Geometrie Plane,14,745,3,QCU,0.57,0.36,4.0,2,37,39,31,2,29,1.26,6.45,Difficile,Difficile,0,Meme Difficulté,Pas Adapte,Mathematics
5240,2019,Mathématiques,5,La Géométrie Analytique,3,Geometrie Plane,14,745,3,QCU,0.31,0.63,49.0,22,22,44,43,22,21,1.02,51.16,Facile,Moyen,-1,Plus Difficile,Pas Adapte,Mathematics
6364,2020,Mathématiques,5,La Géométrie Analytique,3,Geometrie Plane,14,745,3,QCU,0.46,0.2,19.0,8,36,44,35,8,27,1.26,22.86,Facile,Difficile,-2,Beaucoup plus Difficile,Pas Adapte,Mathematics
745,2015,Mathématiques,5,La Géométrie Analytique,3,Geometrie Plane,14,746,4,QO,0.81,0.04,29.0,15,37,52,33,15,18,1.58,45.45,Moyen,Difficile,-1,Plus Difficile,Pas Adapte,Mathematics
1869,2016,Mathématiques,5,La Géométrie Analytique,3,Geometrie Plane,14,746,4,QROC,0.59,0.27,49.0,25,27,52,32,25,7,1.62,78.12,Moyen,Moyen,0,Meme Difficulté,Pas Adapte,Mathematics
2993,2017,Mathématiques,5,La Géométrie Analytique,3,Geometrie Plane,14,746,4,QO,0.54,0.16,52.0,29,27,56,46,29,17,1.22,63.04,Moyen,Moyen,0,Meme Difficulté,Pas Adapte,Mathematics
4117,2018,Mathématiques,5,La Géométrie Analytique,3,Geometrie Plane,14,746,4,QO,0.51,0.24,56.0,33,26,59,54,33,21,1.09,61.11,Difficile,Moyen,1,Plus Facile,Pas Adapte,Mathematics
5241,2019,Mathématiques,5,La Géométrie Analytique,3,Geometrie Plane,14,746,4,QROC,0.78,0.13,18.0,10,45,55,45,10,35,1.22,22.22,Difficile,Difficile,0,Meme Difficulté,Pas Adapte,Mathematics
6365,2020,Mathématiques,5,La Géométrie Analytique,3,Geometrie Plane,14,746,4,QROC,0.9,0.04,9.0,4,44,48,32,4,28,1.5,12.5,Difficile,Difficile,0,Meme Difficulté,Pas Adapte,Mathematics
746,2015,Mathématiques,5,La Géométrie Analytique,3,Geometrie Plane,14,747,5,QCU,0.34,0.51,64.0,30,17,47,46,30,16,1.02,65.22,Moyen,Moyen,0,Meme Difficulté,Adapte,Mathematics
1870,2016,Mathématiques,5,La Géométrie Analytique,3,Geometrie Plane,14,747,5,QCU,0.34,0.55,64.0,33,19,52,40,33,7,1.3,82.5,Moyen,Moyen,0,Meme Difficulté,Adapte,Mathematics
2994,2017,Mathématiques,5,La Géométrie Analytique,3,Geometrie Plane,14,747,5,QCU,0.26,0.56,64.0,38,21,59,40,38,2,1.48,95.0,Moyen,Moyen,0,Meme Difficulté,Adapte,Mathematics
4118,2018,Mathématiques,5,La Géométrie Analytique,3,Geometrie Plane,14,747,5,QCU,0.25,0.48,64.0,36,20,56,41,36,5,1.37,87.8,Moyen,Moyen,0,Meme Difficulté,Adapte,Mathematics
5242,2019,Mathématiques,5,La Géométrie Analytique,3,Geometrie Plane,14,747,5,QCU,0.25,0.4,64.0,36,21,57,56,36,20,1.02,64.29,Moyen,Moyen,0,Meme Difficulté,Adapte,Mathematics
6366,2020,Mathématiques,5,La Géométrie Analytique,3,Geometrie Plane,14,747,5,QCU,0.24,0.65,64.0,38,21,59,42,38,4,1.4,90.48,Moyen,Moyen,0,Meme Difficulté,Adapte,Mathematics
747,2015,Mathématiques,5,La Géométrie Analytique,3,Geometrie Plane,14,748,6,QCU,0.28,0.57,63.0,30,17,47,39,30,9,1.21,76.92,Difficile,Moyen,1,Plus Facile,Adapte,Mathematics
1871,2016,Mathématiques,5,La Géométrie Analytique,3,Geometrie Plane,14,748,6,QCU,0.27,0.47,63.0,28,17,45,41,28,13,1.1,68.29,Moyen,Moyen,0,Meme Difficulté,Adapte,Mathematics
2995,2017,Mathématiques,5,La Géométrie Analytique,3,Geometrie Plane,14,748,6,QCU,0.21,0.68,63.0,28,16,44,44,28,16,1.0,63.64,Moyen,Moyen,0,Meme Difficulté,Adapte,Mathematics
4119,2018,Mathématiques,5,La Géométrie Analytique,3,Geometrie Plane,14,748,6,QCM,0.25,0.45,63.0,26,16,42,32,26,6,1.31,81.25,Moyen,Moyen,0,Meme Difficulté,Adapte,Mathematics
5243,2019,Mathématiques,5,La Géométrie Analytique,3,Geometrie Plane,14,748,6,QCM,0.39,0.57,63.0,26,16,42,32,26,6,1.31,81.25,Moyen,Moyen,0,Meme Difficulté,Adapte,Mathematics
6367,2020,Mathématiques,5,La Géométrie Analytique,3,Geometrie Plane,14,748,6,QCM,0.41,0.31,63.0,28,17,45,31,28,3,1.45,90.32,Moyen,Moyen,0,Meme Difficulté,Adapte,Mathematics
748,2015,Mathématiques,5,La Géométrie Analytique,3,Geometrie Plane,14,749,7,QCM,0.64,0.26,22.0,8,27,35,26,8,18,1.35,30.77,Facile,Difficile,-2,Beaucoup plus Difficile,Pas Adapte,Mathematics
1872,2016,Mathématiques,5,La Géométrie Analytique,3,Geometrie Plane,14,749,7,QCM,0.67,0.17,16.0,6,33,39,35,6,29,1.11,17.14,Difficile,Difficile,0,Meme Difficulté,Pas Adapte,Mathematics
2996,2017,Mathématiques,5,La Géométrie Analytique,3,Geometrie Plane,14,749,7,QCM,0.25,0.61,54.0,19,17,36,22,19,3,1.64,86.36,Facile,Moyen,-1,Plus Difficile,Pas Adapte,Mathematics
4120,2018,Mathématiques,5,La Géométrie Analytique,3,Geometrie Plane,14,749,7,QCM,0.6,0.18,2.0,1,31,32,23,1,22,1.39,4.35,Difficile,Difficile,0,Meme Difficulté,Pas Adapte,Mathematics
5244,2019,Mathématiques,5,La Géométrie Analytique,3,Geometrie Plane,14,749,7,QCM,0.36,0.33,56.0,17,13,30,26,17,9,1.15,65.38,Moyen,Moyen,0,Meme Difficulté,Pas Adapte,Mathematics
6368,2020,Mathématiques,5,La Géométrie Analytique,3,Geometrie Plane,14,749,7,QCM,0.25,0.47,48.0,16,17,33,21,16,5,1.57,76.19,Facile,Moyen,-1,Plus Difficile,Pas Adapte,Mathematics
749,2015,Mathématiques,5,La Géométrie Analytique,3,Geometrie Plane,14,750,8,QCU,0.3,0.45,53.0,28,24,52,50,28,22,1.04,56.0,Difficile,Moyen,1,Plus Facile,Pas Adapte,Mathematics
1873,2016,Mathématiques,5,La Géométrie Analytique,3,Geometrie Plane,14,750,8,QCU,0.25,0.59,50.0,29,29,58,34,29,5,1.71,85.29,Facile,Moyen,-1,Plus Difficile,Pas Adapte,Mathematics
2997,2017,Mathématiques,5,La Géométrie Analytique,3,Geometrie Plane,14,750,8,QCM,0.22,0.37,61.0,32,20,52,33,32,1,1.58,96.97,Moyen,Moyen,0,Meme Difficulté,Adapte,Mathematics
4121,2018,Mathématiques,5,La Géométrie Analytique,3,Geometrie Plane,14,750,8,QCM,0.48,0.35,61.0,36,23,59,48,36,12,1.23,75.0,Moyen,Moyen,0,Meme Difficulté,Adapte,Mathematics
5245,2019,Mathématiques,5,La Géométrie Analytique,3,Geometrie Plane,14,750,8,QCM,0.41,0.35,61.0,34,21,55,48,34,14,1.15,70.83,Moyen,Moyen,0,Meme Difficulté,Adapte,Mathematics
6369,2020,Mathématiques,5,La Géométrie Analytique,3,Geometrie Plane,14,750,8,QCM,0.24,0.47,61.0,35,23,58,47,35,12,1.23,74.47,Moyen,Moyen,0,Meme Difficulté,Adapte,Mathematics
750,2015,Mathématiques,5,La Géométrie Analytique,3,Geometrie Plane,14,751,9,QO,0.6,0.22,51.0,36,34,70,68,36,32,1.03,52.94,Moyen,Moyen,0,Meme Difficulté,Pas Adapte,Mathematics
1874,2016,Mathématiques,5,La Géométrie Analytique,3,Geometrie Plane,14,751,9,QO,0.93,0.03,14.0,9,53,62,43,9,34,1.44,20.93,Moyen,Difficile,-1,Plus Difficile,Pas Adapte,Mathematics
2998,2017,Mathématiques,5,La Géométrie Analytique,3,Geometrie Plane,14,751,9,QO,0.85,0.14,18.0,11,49,60,52,11,41,1.15,21.15,Facile,Difficile,-2,Beaucoup plus Difficile,Pas Adapte,Mathematics
4122,2018,Mathématiques,5,La Géométrie Analytique,3,Geometrie Plane,14,751,9,QO,0.63,0.19,52.0,32,30,62,55,32,23,1.13,58.18,Difficile,Moyen,1,Plus Facile,Pas Adapte,Mathematics
5246,2019,Mathématiques,5,La Géométrie Analytique,3,Geometrie Plane,14,751,9,QROC,0.43,0.26,54.0,30,25,55,51,30,21,1.08,58.82,Difficile,Moyen,1,Plus Facile,Pas Adapte,Mathematics
6370,2020,Mathématiques,5,La Géométrie Analytique,3,Geometrie Plane,14,751,9,QO,0.87,0.03,18.0,8,39,47,31,8,23,1.52,25.81,Facile,Difficile,-2,Beaucoup plus Difficile,Pas Adapte,Mathematics
751,2015,Mathématiques,5,La Géométrie Analytique,3,Geometrie Plane,14,752,10,QCM,0.3,0.32,38.0,12,19,31,25,12,13,1.24,48.0,Difficile,Moyen,1,Plus Facile,Pas Adapte,Mathematics
1875,2016,Mathématiques,5,La Géométrie Analytique,3,Geometrie Plane,14,752,10,QCM,0.45,0.34,51.0,17,16,33,32,17,15,1.03,53.12,Difficile,Moyen,1,Plus Facile,Pas Adapte,Mathematics
2999,2017,Mathématiques,5,La Géométrie Analytique,3,Geometrie Plane,14,752,10,QCM,0.73,0.17,8.0,3,34,37,18,3,15,2.06,16.67,Facile,Difficile,-2,Beaucoup plus Difficile,Pas Adapte,Mathematics
4123,2018,Mathématiques,5,La Géométrie Analytique,3,Geometrie Plane,14,752,10,QCM,0.58,0.22,16.0,7,34,41,13,7,6,3.15,53.85,Difficile,Difficile,0,Meme Difficulté,Pas Adapte,Mathematics
5247,2019,Mathématiques,5,La Géométrie Analytique,3,Geometrie Plane,14,752,10,QCM,0.42,0.65,56.0,24,19,43,41,24,17,1.05,58.54,Moyen,Moyen,0,Meme Difficulté,Pas Adapte,Mathematics
6371,2020,Mathématiques,5,La Géométrie Analytique,3,Geometrie Plane,14,752,10,QCM,0.76,0.19,32.0,14,30,44,34,14,20,1.29,41.18,Facile,Difficile,-2,Beaucoup plus Difficile,Pas Adapte,Mathematics
752,2015,Mathématiques,5,La Géométrie Analytique,3,Geometrie Plane,14,753,11,QCU,0.56,0.31,22.0,14,50,64,26,14,12,2.46,53.85,Facile,Difficile,-2,Beaucoup plus Difficile,Pas Adapte,Mathematics
1876,2016,Mathématiques,5,La Géométrie Analytique,3,Geometrie Plane,14,753,11,QCU,0.29,0.64,49.0,32,34,66,49,32,17,1.35,65.31,Moyen,Moyen,0,Meme Difficulté,Pas Adapte,Mathematics
3000,2017,Mathématiques,5,La Géométrie Analytique,3,Geometrie Plane,14,753,11,QCU,0.6,0.21,29.0,21,52,73,57,21,36,1.28,36.84,Difficile,Difficile,0,Meme Difficulté,Pas Adapte,Mathematics
4124,2018,Mathématiques,5,La Géométrie Analytique,3,Geometrie Plane,14,753,11,QCU,0.27,0.51,56.0,42,33,75,45,42,3,1.67,93.33,Difficile,Moyen,1,Plus Facile,Pas Adapte,Mathematics
5248,2019,Mathématiques,5,La Géométrie Analytique,3,Geometrie Plane,14,753,11,QCU,0.27,0.67,39.0,30,46,76,59,30,29,1.29,50.85,Facile,Moyen,-1,Plus Difficile,Pas Adapte,Mathematics
6372,2020,Mathématiques,5,La Géométrie Analytique,3,Geometrie Plane,14,753,11,QCU,0.62,0.31,22.0,15,53,68,46,15,31,1.48,32.61,Facile,Difficile,-2,Beaucoup plus Difficile,Pas Adapte,Mathematics
753,2015,Mathématiques,5,La Géométrie Analytique,3,Geometrie Plane,14,754,12,QCU,0.4,0.54,58.0,42,31,73,61,42,19,1.2,68.85,Difficile,Moyen,1,Plus Facile,Pas Adapte,Mathematics
1877,2016,Mathématiques,5,La Géométrie Analytique,3,Geometrie Plane,14,754,12,QCU,0.56,0.37,5.0,3,64,67,54,3,51,1.24,5.56,Facile,Difficile,-2,Beaucoup plus Difficile,Pas Adapte,Mathematics
3001,2017,Mathématiques,5,La Géométrie Analytique,3,Geometrie Plane,14,754,12,QCU,0.32,0.66,46.0,34,40,74,50,34,16,1.48,68.0,Facile,Moyen,-1,Plus Difficile,Pas Adapte,Mathematics
4125,2018,Mathématiques,5,La Géométrie Analytique,3,Geometrie Plane,14,754,12,QCU,0.54,0.33,2.0,2,73,75,37,2,35,2.03,5.41,Moyen,Difficile,-1,Plus Difficile,Pas Adapte,Mathematics
5249,2019,Mathématiques,5,La Géométrie Analytique,3,Geometrie Plane,14,754,12,QCU,0.55,0.35,13.0,10,65,75,46,10,36,1.63,21.74,Facile,Difficile,-2,Beaucoup plus Difficile,Pas Adapte,Mathematics
6373,2020,Mathématiques,5,La Géométrie Analytique,3,Geometrie Plane,14,754,12,QCU,0.27,0.6,44.0,35,44,79,55,35,20,1.44,63.64,Moyen,Moyen,0,Meme Difficulté,Pas Adapte,Mathematics
754,2015,Mathématiques,5,La Géométrie Analytique,3,Geometrie Plane,14,755,13,QCM,0.54,0.16,33.0,14,28,42,24,14,10,1.75,58.33,Difficile,Difficile,0,Meme Difficulté,Pas Adapte,Mathematics
1878,2016,Mathématiques,5,La Géométrie Analytique,3,Geometrie Plane,14,755,13,QCM,0.73,0.2,22.0,8,28,36,29,8,21,1.24,27.59,Difficile,Difficile,0,Meme Difficulté,Pas Adapte,Mathematics
3002,2017,Mathématiques,5,La Géométrie Analytique,3,Geometrie Plane,14,755,13,QCM,0.76,0.27,29.0,9,22,31,21,9,12,1.48,42.86,Difficile,Difficile,0,Meme Difficulté,Pas Adapte,Mathematics
4126,2018,Mathématiques,5,La Géométrie Analytique,3,Geometrie Plane,14,755,13,QCM,0.31,0.5,60.0,17,11,28,21,17,4,1.33,80.95,Moyen,Moyen,0,Meme Difficulté,Adapte,Mathematics
5250,2019,Mathématiques,5,La Géométrie Analytique,3,Geometrie Plane,14,755,13,QCU,0.29,0.73,60.0,17,12,29,26,17,9,1.12,65.38,Moyen,Moyen,0,Meme Difficulté,Adapte,Mathematics
6374,2020,Mathématiques,5,La Géométrie Analytique,3,Geometrie Plane,14,755,13,QCU,0.29,0.7,60.0,16,10,26,25,16,9,1.04,64.0,Moyen,Moyen,0,Meme Difficulté,Adapte,Mathematics
755,2015,Mathématiques,5,La Géométrie Analytique,3,Geometrie Plane,14,756,14,QCU,0.45,0.26,2.0,1,63,64,36,1,35,1.78,2.78,Difficile,Difficile,0,Meme Difficulté,Pas Adapte,Mathematics
1879,2016,Mathématiques,5,La Géométrie Analytique,3,Geometrie Plane,14,756,14,QCU,0.25,0.69,37.0,21,37,58,46,21,25,1.26,45.65,Difficile,Moyen,1,Plus Facile,Pas Adapte,Mathematics
3003,2017,Mathématiques,5,La Géométrie Analytique,3,Geometrie Plane,14,756,14,QCU,0.36,0.44,59.0,30,20,50,41,30,11,1.22,73.17,Difficile,Moyen,1,Plus Facile,Pas Adapte,Mathematics
4127,2018,Mathématiques,5,La Géométrie Analytique,3,Geometrie Plane,14,756,14,QCU,0.31,0.74,45.0,20,25,45,34,20,14,1.32,58.82,Facile,Moyen,-1,Plus Difficile,Pas Adapte,Mathematics
5251,2019,Mathématiques,5,La Géométrie Analytique,3,Geometrie Plane,14,756,14,QCU,0.66,0.25,26.0,13,37,50,17,13,4,2.94,76.47,Facile,Difficile,-2,Beaucoup plus Difficile,Pas Adapte,Mathematics
6375,2020,Mathématiques,5,La Géométrie Analytique,3,Geometrie Plane,14,756,14,QCU,0.33,0.62,50.0,26,25,51,38,26,12,1.34,68.42,Facile,Moyen,-1,Plus Difficile,Pas Adapte,Mathematics
756,2015,Philosophie,1,Introduction a la Philosophie,1,La Nature,6,757,1,QCM,0.6,0.25,22.27,4,13,17,7,4,3,2.43,57.14,Difficile,Difficile,0,Meme Difficulté,Pas Adapte,Philosophy
1880,2016,Philosophie,1,Introduction a la Philosophie,1,La Nature,6,757,1,QCM,0.29,0.34,63.17,9,6,15,9,9,0,1.67,100.0,Facile,Moyen,-1,Plus Difficile,Adapte,Philosophy
3004,2017,Philosophie,1,Introduction a la Philosophie,1,La Nature,6,757,1,QCM,0.47,0.54,63.17,11,6,17,16,11,5,1.06,68.75,Moyen,Moyen,0,Meme Difficulté,Adapte,Philosophy
4128,2018,Philosophie,1,Introduction a la Philosophie,1,La Nature,6,757,1,QCM,0.3,0.64,63.17,9,6,15,11,9,2,1.36,81.82,Moyen,Moyen,0,Meme Difficulté,Adapte,Philosophy
5252,2019,Philosophie,1,Introduction a la Philosophie,1,La Nature,6,757,1,QCM,0.37,0.67,63.17,9,6,15,15,9,6,1.0,60.0,Moyen,Moyen,0,Meme Difficulté,Adapte,Philosophy
6376,2020,Philosophie,1,Introduction a la Philosophie,1,La Nature,6,757,1,QCM,0.29,0.44,63.17,9,5,14,12,9,3,1.17,75.0,Moyen,Moyen,0,Meme Difficulté,Adapte,Philosophy
757,2015,Philosophie,1,Introduction a la Philosophie,1,La Nature,6,758,2,QCM,0.15,0.78,67.68,54,26,80,56,54,2,1.43,96.43,Difficile,Facile,2,Beaucoup plus Facile,Adapte,Philosophy
1881,2016,Philosophie,1,Introduction a la Philosophie,1,La Nature,6,758,2,QCM,0.09,0.81,67.68,46,22,68,59,46,13,1.15,77.97,Facile,Facile,0,Meme Difficulté,Adapte,Philosophy
3005,2017,Philosophie,1,Introduction a la Philosophie,1,La Nature,6,758,2,QCM,0.17,0.97,67.68,41,19,60,41,41,0,1.46,100.0,Facile,Facile,0,Meme Difficulté,Adapte,Philosophy
4129,2018,Philosophie,1,Introduction a la Philosophie,1,La Nature,6,758,2,QCM,0.07,0.84,67.68,40,19,59,56,40,16,1.05,71.43,Facile,Facile,0,Meme Difficulté,Adapte,Philosophy
5253,2019,Philosophie,1,Introduction a la Philosophie,1,La Nature,6,758,2,QCM,0.18,0.71,67.68,46,22,68,62,46,16,1.1,74.19,Facile,Facile,0,Meme Difficulté,Adapte,Philosophy
6377,2020,Philosophie,1,Introduction a la Philosophie,1,La Nature,6,758,2,QCM,0.05,0.73,67.68,52,25,77,61,52,9,1.26,85.25,Facile,Facile,0,Meme Difficulté,Adapte,Philosophy
758,2015,Philosophie,1,Introduction a la Philosophie,1,La Nature,6,759,3,QCU,0.1,0.99,69.47,34,15,49,36,34,2,1.36,94.44,Moyen,Facile,1,Plus Facile,Adapte,Philosophy
1882,2016,Philosophie,1,Introduction a la Philosophie,1,La Nature,6,759,3,QCU,0.13,0.83,69.47,36,16,52,42,36,6,1.24,85.71,Facile,Facile,0,Meme Difficulté,Adapte,Philosophy
3006,2017,Philosophie,1,Introduction a la Philosophie,1,La Nature,6,759,3,QCU,0.16,0.96,69.47,38,17,55,39,38,1,1.41,97.44,Facile,Facile,0,Meme Difficulté,Adapte,Philosophy
4130,2018,Philosophie,1,Introduction a la Philosophie,1,La Nature,6,759,3,QCU,0.1,0.84,69.47,33,15,48,36,33,3,1.33,91.67,Facile,Facile,0,Meme Difficulté,Adapte,Philosophy
5254,2019,Philosophie,1,Introduction a la Philosophie,1,La Nature,6,759,3,QCU,0.1,0.77,69.47,31,13,44,36,31,5,1.22,86.11,Facile,Facile,0,Meme Difficulté,Adapte,Philosophy
6378,2020,Philosophie,1,Introduction a la Philosophie,1,La Nature,6,759,3,QCU,0.04,0.91,69.47,28,13,41,40,28,12,1.02,70.0,Facile,Facile,0,Meme Difficulté,Adapte,Philosophy
759,2015,Philosophie,1,Introduction a la Philosophie,1,La Nature,6,760,4,QCM,0.51,0.26,13.86,13,84,97,69,13,56,1.41,18.84,Moyen,Difficile,-1,Plus Difficile,Pas Adapte,Philosophy
1883,2016,Philosophie,1,Introduction a la Philosophie,1,La Nature,6,760,4,QCM,0.4,0.51,41.55,38,54,92,92,38,54,1.0,41.3,Facile,Moyen,-1,Plus Difficile,Pas Adapte,Philosophy
3007,2017,Philosophie,1,Introduction a la Philosophie,1,La Nature,6,760,4,QCM,0.04,0.95,98.08,101,2,103,102,101,1,1.01,99.02,Difficile,Facile,2,Beaucoup plus Facile,Pas Adapte,Philosophy
4131,2018,Philosophie,1,Introduction a la Philosophie,1,La Nature,6,760,4,QCM,0.64,0.29,2.26,2,97,99,29,2,27,3.41,6.9,Difficile,Difficile,0,Meme Difficulté,Pas Adapte,Philosophy
5255,2019,Philosophie,1,Introduction a la Philosophie,1,La Nature,6,760,4,QCM,0.65,0.23,18.75,17,76,93,73,17,56,1.27,23.29,Moyen,Difficile,-1,Plus Difficile,Pas Adapte,Philosophy
6379,2020,Philosophie,1,Introduction a la Philosophie,1,La Nature,6,760,4,QCM,0.54,0.18,27.39,22,57,79,71,22,49,1.11,30.99,Difficile,Difficile,0,Meme Difficulté,Pas Adapte,Philosophy
760,2015,Philosophie,1,Introduction a la Philosophie,1,La Nature,6,761,5,QCM,0.54,0.27,13.5,1,6,7,4,1,3,1.75,25.0,Moyen,Difficile,-1,Plus Difficile,Pas Adapte,Philosophy
1884,2016,Philosophie,1,Introduction a la Philosophie,1,La Nature,6,761,5,QCM,0.52,0.28,24.82,2,6,8,8,2,6,1.0,25.0,Difficile,Difficile,0,Meme Difficulté,Pas Adapte,Philosophy
3008,2017,Philosophie,1,Introduction a la Philosophie,1,La Nature,6,761,5,QCM,0.4,0.44,55.6,4,4,8,5,4,1,1.6,80.0,Difficile,Moyen,1,Plus Facile,Pas Adapte,Philosophy
4132,2018,Philosophie,1,Introduction a la Philosophie,1,La Nature,6,761,5,QCM,0.65,0.22,7.79,1,7,8,2,1,1,4.0,50.0,Difficile,Difficile,0,Meme Difficulté,Pas Adapte,Philosophy
5256,2019,Philosophie,1,Introduction a la Philosophie,1,La Nature,6,761,5,QCM,0.18,0.88,77.18,7,2,9,8,7,1,1.12,87.5,Facile,Facile,0,Meme Difficulté,Pas Adapte,Philosophy
6380,2020,Philosophie,1,Introduction a la Philosophie,1,La Nature,6,761,5,QCU,0.19,0.86,80.93,8,2,10,8,8,0,1.25,100.0,Facile,Facile,0,Meme Difficulté,Pas Adapte,Philosophy
761,2015,Philosophie,1,Introduction a la Philosophie,1,La Nature,6,762,6,QROC,0.11,0.92,87.31,85,12,97,96,85,11,1.01,88.54,Facile,Facile,0,Meme Difficulté,Pas Adapte,Philosophy
1885,2016,Philosophie,1,Introduction a la Philosophie,1,La Nature,6,762,6,QROC,0.87,0.08,1.18,1,106,107,49,1,48,2.18,2.04,Moyen,Difficile,-1,Plus Difficile,Pas Adapte,Philosophy
3009,2017,Philosophie,1,Introduction a la Philosophie,1,La Nature,6,762,6,QROC,0.56,0.35,59.61,71,48,119,85,71,14,1.4,83.53,Facile,Moyen,-1,Plus Difficile,Pas Adapte,Philosophy
4133,2018,Philosophie,1,Introduction a la Philosophie,1,La Nature,6,762,6,QROC,0.08,0.85,69.01,83,37,120,85,83,2,1.41,97.65,Difficile,Facile,2,Beaucoup plus Facile,Adapte,Philosophy
5257,2019,Philosophie,1,Introduction a la Philosophie,1,La Nature,6,762,6,QROC,0.15,0.48,69.01,95,43,138,97,95,2,1.42,97.94,Facile,Facile,0,Meme Difficulté,Adapte,Philosophy
6381,2020,Philosophie,1,Introduction a la Philosophie,1,La Nature,6,762,6,QROC,0.15,0.53,69.01,101,45,146,138,101,37,1.06,73.19,Facile,Facile,0,Meme Difficulté,Adapte,Philosophy
762,2015,Philosophie,1,Introduction a la Philosophie,2,La Technique,9,763,1,QCM,0.06,0.98,90.82,19,2,21,20,19,1,1.05,95.0,Moyen,Facile,1,Plus Facile,Pas Adapte,Philosophy
1886,2016,Philosophie,1,Introduction a la Philosophie,2,La Technique,9,763,1,QCM,0.14,0.75,97.47,23,1,24,24,23,1,1.0,95.83,Difficile,Facile,2,Beaucoup plus Facile,Pas Adapte,Philosophy
3010,2017,Philosophie,1,Introduction a la Philosophie,2,La Technique,9,763,1,QCM,0.16,0.88,91.94,19,2,21,20,19,1,1.05,95.0,Facile,Facile,0,Meme Difficulté,Pas Adapte,Philosophy
4134,2018,Philosophie,1,Introduction a la Philosophie,2,La Technique,9,763,1,QCM,0.45,0.5,58.87,11,7,18,16,11,5,1.12,68.75,Difficile,Moyen,1,Plus Facile,Pas Adapte,Philosophy
5258,2019,Philosophie,1,Introduction a la Philosophie,2,La Technique,9,763,1,QCM,0.66,0.17,31.61,6,13,19,15,6,9,1.27,40.0,Moyen,Difficile,-1,Plus Difficile,Pas Adapte,Philosophy
6382,2020,Philosophie,1,Introduction a la Philosophie,2,La Technique,9,763,1,QCM,0.64,0.21,21.97,5,16,21,16,5,11,1.31,31.25,Moyen,Difficile,-1,Plus Difficile,Pas Adapte,Philosophy
763,2015,Philosophie,1,Introduction a la Philosophie,2,La Technique,9,764,2,QCU,0.3,0.49,45.97,31,36,67,56,31,25,1.2,55.36,Moyen,Moyen,0,Meme Difficulté,Pas Adapte,Philosophy
1887,2016,Philosophie,1,Introduction a la Philosophie,2,La Technique,9,764,2,QCU,0.68,0.24,26.06,16,44,60,54,16,38,1.11,29.63,Difficile,Difficile,0,Meme Difficulté,Pas Adapte,Philosophy
3011,2017,Philosophie,1,Introduction a la Philosophie,2,La Technique,9,764,2,QCM,0.04,0.89,67.51,35,17,52,38,35,3,1.37,92.11,Moyen,Facile,1,Plus Facile,Adapte,Philosophy
4135,2018,Philosophie,1,Introduction a la Philosophie,2,La Technique,9,764,2,QCM,0.0,0.85,67.51,32,15,47,35,32,3,1.34,91.43,Facile,Facile,0,Meme Difficulté,Adapte,Philosophy
5259,2019,Philosophie,1,Introduction a la Philosophie,2,La Technique,9,764,2,QCM,0.15,0.79,67.51,36,17,53,40,36,4,1.32,90.0,Facile,Facile,0,Meme Difficulté,Adapte,Philosophy
6383,2020,Philosophie,1,Introduction a la Philosophie,2,La Technique,9,764,2,QCM,0.02,0.72,67.51,32,15,47,34,32,2,1.38,94.12,Facile,Facile,0,Meme Difficulté,Adapte,Philosophy
764,2015,Philosophie,1,Introduction a la Philosophie,2,La Technique,9,765,3,QCM,0.57,0.17,19.13,8,36,44,19,8,11,2.32,42.11,Moyen,Difficile,-1,Plus Difficile,Pas Adapte,Philosophy
1888,2016,Philosophie,1,Introduction a la Philosophie,2,La Technique,9,765,3,QCM,0.41,0.47,42.75,21,27,48,48,21,27,1.0,43.75,Difficile,Moyen,1,Plus Facile,Pas Adapte,Philosophy
3012,2017,Philosophie,1,Introduction a la Philosophie,2,La Technique,9,765,3,QCM,0.17,0.72,72.04,36,14,50,41,36,5,1.22,87.8,Difficile,Facile,2,Beaucoup plus Facile,Adapte,Philosophy
4136,2018,Philosophie,1,Introduction a la Philosophie,2,La Technique,9,765,3,QCM,0.06,0.95,72.04,31,12,43,34,31,3,1.26,91.18,Facile,Facile,0,Meme Difficulté,Adapte,Philosophy
5260,2019,Philosophie,1,Introduction a la Philosophie,2,La Technique,9,765,3,QCM,0.07,0.85,72.04,32,12,44,40,32,8,1.1,80.0,Facile,Facile,0,Meme Difficulté,Adapte,Philosophy
6384,2020,Philosophie,1,Introduction a la Philosophie,2,La Technique,9,765,3,QCM,0.05,0.71,72.04,32,13,45,36,32,4,1.25,88.89,Facile,Facile,0,Meme Difficulté,Adapte,Philosophy
765,2015,Philosophie,1,Introduction a la Philosophie,2,La Technique,9,766,4,QCM,0.48,0.51,43.4,12,15,27,14,12,2,1.93,85.71,Difficile,Moyen,1,Plus Facile,Pas Adapte,Philosophy
1889,2016,Philosophie,1,Introduction a la Philosophie,2,La Technique,9,766,4,QO,0.81,0.14,12.93,4,27,31,22,4,18,1.41,18.18,Difficile,Difficile,0,Meme Difficulté,Pas Adapte,Philosophy
3013,2017,Philosophie,1,Introduction a la Philosophie,2,La Technique,9,766,4,QO,0.01,0.72,77.25,25,8,33,29,25,4,1.14,86.21,Moyen,Facile,1,Plus Facile,Pas Adapte,Philosophy
4137,2018,Philosophie,1,Introduction a la Philosophie,2,La Technique,9,766,4,QO,0.0,0.64,87.03,26,4,30,27,26,1,1.11,96.3,Difficile,Facile,2,Beaucoup plus Facile,Pas Adapte,Philosophy
5261,2019,Philosophie,1,Introduction a la Philosophie,2,La Technique,9,766,4,QROC,0.79,0.24,28.27,8,20,28,20,8,12,1.4,40.0,Moyen,Difficile,-1,Plus Difficile,Pas Adapte,Philosophy
6385,2020,Philosophie,1,Introduction a la Philosophie,2,La Technique,9,766,4,QROC,0.09,0.65,90.64,24,3,27,26,24,2,1.04,92.31,Moyen,Facile,1,Plus Facile,Pas Adapte,Philosophy
766,2015,Philosophie,1,Introduction a la Philosophie,2,La Technique,9,767,5,QCU,0.41,0.35,13.8,3,17,20,17,3,14,1.18,17.65,Facile,Difficile,-2,Beaucoup plus Difficile,Pas Adapte,Philosophy
1890,2016,Philosophie,1,Introduction a la Philosophie,2,La Technique,9,767,5,QCU,0.61,0.35,27.49,5,13,18,7,5,2,2.57,71.43,Difficile,Difficile,0,Meme Difficulté,Pas Adapte,Philosophy
3014,2017,Philosophie,1,Introduction a la Philosophie,2,La Technique,9,767,5,QCM,0.52,0.26,22.67,4,12,16,7,4,3,2.29,57.14,Difficile,Difficile,0,Meme Difficulté,Pas Adapte,Philosophy
4138,2018,Philosophie,1,Introduction a la Philosophie,2,La Technique,9,767,5,QCM,0.37,0.69,40.54,6,8,14,7,6,1,2.0,85.71,Moyen,Moyen,0,Meme Difficulté,Pas Adapte,Philosophy
5262,2019,Philosophie,1,Introduction a la Philosophie,2,La Technique,9,767,5,QCM,0.3,0.53,44.53,7,9,16,15,7,8,1.07,46.67,Facile,Moyen,-1,Plus Difficile,Pas Adapte,Philosophy
6386,2020,Philosophie,1,Introduction a la Philosophie,2,La Technique,9,767,5,QCM,0.73,0.24,31.26,5,12,17,12,5,7,1.42,41.67,Difficile,Difficile,0,Meme Difficulté,Pas Adapte,Philosophy
767,2015,Philosophie,1,Introduction a la Philosophie,2,La Technique,9,768,6,QROC,0.42,0.36,44.88,8,10,18,15,8,7,1.2,53.33,Difficile,Moyen,1,Plus Facile,Pas Adapte,Philosophy
1891,2016,Philosophie,1,Introduction a la Philosophie,2,La Technique,9,768,6,QROC,0.13,0.52,86.81,17,3,20,19,17,2,1.05,89.47,Facile,Facile,0,Meme Difficulté,Pas Adapte,Philosophy
3015,2017,Philosophie,1,Introduction a la Philosophie,2,La Technique,9,768,6,QROC,0.15,0.9,76.26,18,5,23,19,18,1,1.21,94.74,Moyen,Facile,1,Plus Facile,Pas Adapte,Philosophy
4139,2018,Philosophie,1,Introduction a la Philosophie,2,La Technique,9,768,6,QROC,0.07,0.67,66.48,15,7,22,18,15,3,1.22,83.33,Facile,Facile,0,Meme Difficulté,Adapte,Philosophy
5263,2019,Philosophie,1,Introduction a la Philosophie,2,La Technique,9,768,6,QROC,0.15,0.59,66.48,14,7,21,14,14,0,1.5,100.0,Facile,Facile,0,Meme Difficulté,Adapte,Philosophy
6387,2020,Philosophie,1,Introduction a la Philosophie,2,La Technique,9,768,6,QROC,0.14,0.95,66.48,13,7,20,19,13,6,1.05,68.42,Facile,Facile,0,Meme Difficulté,Adapte,Philosophy
768,2015,Philosophie,1,Introduction a la Philosophie,2,La Technique,9,769,7,QCM,0.17,0.71,78.2,41,11,52,45,41,4,1.16,91.11,Difficile,Facile,2,Beaucoup plus Facile,Pas Adapte,Philosophy
1892,2016,Philosophie,1,Introduction a la Philosophie,2,La Technique,9,769,7,QCM,0.7,0.24,4.71,3,52,55,20,3,17,2.75,15.0,Facile,Difficile,-2,Beaucoup plus Difficile,Pas Adapte,Philosophy
3016,2017,Philosophie,1,Introduction a la Philosophie,2,La Technique,9,769,7,QCM,0.1,0.74,68.14,41,19,60,49,41,8,1.22,83.67,Difficile,Facile,2,Beaucoup plus Facile,Adapte,Philosophy
4140,2018,Philosophie,1,Introduction a la Philosophie,2,La Technique,9,769,7,QROC,0.06,0.74,68.14,35,17,52,51,35,16,1.02,68.63,Facile,Facile,0,Meme Difficulté,Adapte,Philosophy
5264,2019,Philosophie,1,Introduction a la Philosophie,2,La Technique,9,769,7,QROC,0.01,0.49,68.14,33,16,49,44,33,11,1.11,75.0,Facile,Facile,0,Meme Difficulté,Adapte,Philosophy
6388,2020,Philosophie,1,Introduction a la Philosophie,2,La Technique,9,769,7,QROC,0.16,0.55,68.14,33,16,49,47,33,14,1.04,70.21,Facile,Facile,0,Meme Difficulté,Adapte,Philosophy
769,2015,Philosophie,1,Introduction a la Philosophie,2,La Technique,9,770,8,QCU,0.59,0.37,7.61,7,80,87,32,7,25,2.72,21.88,Difficile,Difficile,0,Meme Difficulté,Pas Adapte,Philosophy
1893,2016,Philosophie,1,Introduction a la Philosophie,2,La Technique,9,770,8,QCU,0.03,0.99,86.33,73,11,84,78,73,5,1.08,93.59,Difficile,Facile,2,Beaucoup plus Facile,Pas Adapte,Philosophy
3017,2017,Philosophie,1,Introduction a la Philosophie,2,La Technique,9,770,8,QCU,0.07,0.81,94.51,84,5,89,88,84,4,1.01,95.45,Difficile,Facile,2,Beaucoup plus Facile,Pas Adapte,Philosophy
4141,2018,Philosophie,1,Introduction a la Philosophie,2,La Technique,9,770,8,QCU,0.23,0.43,61.52,49,30,79,65,49,16,1.22,75.38,Facile,Moyen,-1,Plus Difficile,Adapte,Philosophy
5265,2019,Philosophie,1,Introduction a la Philosophie,2,La Technique,9,770,8,QCU,0.35,0.53,61.52,55,35,90,76,55,21,1.18,72.37,Moyen,Moyen,0,Meme Difficulté,Adapte,Philosophy
6389,2020,Philosophie,1,Introduction a la Philosophie,2,La Technique,9,770,8,QCU,0.34,0.56,61.52,60,37,97,88,60,28,1.1,68.18,Moyen,Moyen,0,Meme Difficulté,Adapte,Philosophy
770,2015,Philosophie,1,Introduction a la Philosophie,2,La Technique,9,771,9,QCU,0.28,0.75,63.07,44,25,69,63,44,19,1.1,69.84,Facile,Moyen,-1,Plus Difficile,Adapte,Philosophy
1894,2016,Philosophie,1,Introduction a la Philosophie,2,La Technique,9,771,9,QO,0.4,0.21,63.07,44,26,70,55,44,11,1.27,80.0,Moyen,Moyen,0,Meme Difficulté,Adapte,Philosophy
3018,2017,Philosophie,1,Introduction a la Philosophie,2,La Technique,9,771,9,QO,0.73,0.29,63.07,47,27,74,50,47,3,1.48,94.0,Moyen,Moyen,0,Meme Difficulté,Adapte,Philosophy
4142,2018,Philosophie,1,Introduction a la Philosophie,2,La Technique,9,771,9,QO,0.56,0.16,63.07,47,28,75,59,47,12,1.27,79.66,Moyen,Moyen,0,Meme Difficulté,Adapte,Philosophy
5266,2019,Philosophie,1,Introduction a la Philosophie,2,La Technique,9,771,9,QO,0.73,0.26,63.07,50,30,80,60,50,10,1.33,83.33,Moyen,Moyen,0,Meme Difficulté,Adapte,Philosophy
6390,2020,Philosophie,1,Introduction a la Philosophie,2,La Technique,9,771,9,QO,0.53,0.2,63.07,54,31,85,79,54,25,1.08,68.35,Moyen,Moyen,0,Meme Difficulté,Adapte,Philosophy
771,2015,Philosophie,1,Introduction a la Philosophie,3,L'Oeuvre d'Art,14,772,1,QCM,0.58,0.26,31.04,29,65,94,81,29,52,1.16,35.8,Moyen,Difficile,-1,Plus Difficile,Pas Adapte,Philosophy
1895,2016,Philosophie,1,Introduction a la Philosophie,3,L'Oeuvre d'Art,14,772,1,QCM,0.75,0.23,33.31,33,67,100,40,33,7,2.5,82.5,Moyen,Difficile,-1,Plus Difficile,Pas Adapte,Philosophy
3019,2017,Philosophie,1,Introduction a la Philosophie,3,L'Oeuvre d'Art,14,772,1,QCM,0.65,0.18,1.71,2,111,113,48,2,46,2.35,4.17,Moyen,Difficile,-1,Plus Difficile,Pas Adapte,Philosophy
4143,2018,Philosophie,1,Introduction a la Philosophie,3,L'Oeuvre d'Art,14,772,1,QCM,0.25,0.31,39.86,49,73,122,51,49,2,2.39,96.08,Facile,Moyen,-1,Plus Difficile,Pas Adapte,Philosophy
5267,2019,Philosophie,1,Introduction a la Philosophie,3,L'Oeuvre d'Art,14,772,1,QCM,0.22,0.39,48.22,62,67,129,102,62,40,1.26,60.78,Moyen,Moyen,0,Meme Difficulté,Pas Adapte,Philosophy
6391,2020,Philosophie,1,Introduction a la Philosophie,3,L'Oeuvre d'Art,14,772,1,QCM,0.56,0.26,11.02,12,98,110,79,12,67,1.39,15.19,Moyen,Difficile,-1,Plus Difficile,Pas Adapte,Philosophy
772,2015,Philosophie,1,Introduction a la Philosophie,3,L'Oeuvre d'Art,14,773,2,QCM,0.63,0.24,3.51,2,50,52,14,2,12,3.71,14.29,Moyen,Difficile,-1,Plus Difficile,Pas Adapte,Philosophy
1896,2016,Philosophie,1,Introduction a la Philosophie,3,L'Oeuvre d'Art,14,773,2,QCM,0.63,0.29,22.77,10,35,45,32,10,22,1.41,31.25,Moyen,Difficile,-1,Plus Difficile,Pas Adapte,Philosophy
3020,2017,Philosophie,1,Introduction a la Philosophie,3,L'Oeuvre d'Art,14,773,2,QCU,0.61,0.37,19.96,10,39,49,22,10,12,2.23,45.45,Facile,Difficile,-2,Beaucoup plus Difficile,Pas Adapte,Philosophy
4144,2018,Philosophie,1,Introduction a la Philosophie,3,L'Oeuvre d'Art,14,773,2,QCU,0.46,0.34,32.74,17,35,52,47,17,30,1.11,36.17,Difficile,Difficile,0,Meme Difficulté,Pas Adapte,Philosophy
5268,2019,Philosophie,1,Introduction a la Philosophie,3,L'Oeuvre d'Art,14,773,2,QCU,0.51,0.3,6.88,3,46,49,48,3,45,1.02,6.25,Difficile,Difficile,0,Meme Difficulté,Pas Adapte,Philosophy
6392,2020,Philosophie,1,Introduction a la Philosophie,3,L'Oeuvre d'Art,14,773,2,QCM,0.15,0.93,66.22,33,17,50,34,33,1,1.47,97.06,Difficile,Facile,2,Beaucoup plus Facile,Adapte,Philosophy
773,2015,Philosophie,1,Introduction a la Philosophie,3,L'Oeuvre d'Art,14,774,3,QCU,0.64,0.32,6.55,1,21,22,11,1,10,2.0,9.09,Moyen,Difficile,-1,Plus Difficile,Pas Adapte,Philosophy
1897,2016,Philosophie,1,Introduction a la Philosophie,3,L'Oeuvre d'Art,14,774,3,QCU,0.44,0.29,3.79,1,20,21,20,1,19,1.05,5.0,Moyen,Difficile,-1,Plus Difficile,Pas Adapte,Philosophy
3021,2017,Philosophie,1,Introduction a la Philosophie,3,L'Oeuvre d'Art,14,774,3,QCU,0.06,0.83,99.32,21,0,21,21,21,0,1.0,100.0,Facile,Facile,0,Meme Difficulté,Pas Adapte,Philosophy
4145,2018,Philosophie,1,Introduction a la Philosophie,3,L'Oeuvre d'Art,14,774,3,QCU,0.32,0.64,42.17,9,13,22,17,9,8,1.29,52.94,Facile,Moyen,-1,Plus Difficile,Pas Adapte,Philosophy
5269,2019,Philosophie,1,Introduction a la Philosophie,3,L'Oeuvre d'Art,14,774,3,QCU,0.25,0.41,49.88,12,13,25,12,12,0,2.08,100.0,Difficile,Moyen,1,Plus Facile,Pas Adapte,Philosophy
6393,2020,Philosophie,1,Introduction a la Philosophie,3,L'Oeuvre d'Art,14,774,3,QCU,0.5,0.33,14.11,3,20,23,19,3,16,1.21,15.79,Moyen,Difficile,-1,Plus Difficile,Pas Adapte,Philosophy
774,2015,Philosophie,1,Introduction a la Philosophie,3,L'Oeuvre d'Art,14,775,4,QCU,0.58,0.3,24.0,17,52,69,26,17,9,2.65,65.38,Difficile,Difficile,0,Meme Difficulté,Pas Adapte,Philosophy
1898,2016,Philosophie,1,Introduction a la Philosophie,3,L'Oeuvre d'Art,14,775,4,QCM,0.08,0.89,66.73,44,22,66,45,44,1,1.47,97.78,Moyen,Facile,1,Plus Facile,Adapte,Philosophy
3022,2017,Philosophie,1,Introduction a la Philosophie,3,L'Oeuvre d'Art,14,775,4,QCM,0.2,0.71,66.73,42,21,63,48,42,6,1.31,87.5,Facile,Facile,0,Meme Difficulté,Adapte,Philosophy
4146,2018,Philosophie,1,Introduction a la Philosophie,3,L'Oeuvre d'Art,14,775,4,QCM,0.01,0.93,66.73,43,22,65,55,43,12,1.18,78.18,Facile,Facile,0,Meme Difficulté,Adapte,Philosophy
5270,2019,Philosophie,1,Introduction a la Philosophie,3,L'Oeuvre d'Art,14,775,4,QCM,0.15,0.92,66.73,39,19,58,53,39,14,1.09,73.58,Facile,Facile,0,Meme Difficulté,Adapte,Philosophy
6394,2020,Philosophie,1,Introduction a la Philosophie,3,L'Oeuvre d'Art,14,775,4,QCM,0.07,0.79,66.73,33,16,49,36,33,3,1.36,91.67,Facile,Facile,0,Meme Difficulté,Adapte,Philosophy
775,2015,Philosophie,1,Introduction a la Philosophie,3,L'Oeuvre d'Art,14,776,5,QO,0.68,0.29,49.13,22,23,45,42,22,20,1.07,52.38,Difficile,Moyen,1,Plus Facile,Pas Adapte,Philosophy
1899,2016,Philosophie,1,Introduction a la Philosophie,3,L'Oeuvre d'Art,14,776,5,QO,0.27,0.2,35.95,15,26,41,27,15,12,1.52,55.56,Difficile,Moyen,1,Plus Facile,Pas Adapte,Philosophy
3023,2017,Philosophie,1,Introduction a la Philosophie,3,L'Oeuvre d'Art,14,776,5,QO,0.55,0.19,41.94,17,24,41,24,17,7,1.71,70.83,Facile,Moyen,-1,Plus Difficile,Pas Adapte,Philosophy
4147,2018,Philosophie,1,Introduction a la Philosophie,3,L'Oeuvre d'Art,14,776,5,QO,0.8,0.12,16.74,7,34,41,29,7,22,1.41,24.14,Facile,Difficile,-2,Beaucoup plus Difficile,Pas Adapte,Philosophy
5271,2019,Philosophie,1,Introduction a la Philosophie,3,L'Oeuvre d'Art,14,776,5,QO,0.25,0.24,35.64,15,28,43,39,15,24,1.1,38.46,Moyen,Moyen,0,Meme Difficulté,Pas Adapte,Philosophy
6395,2020,Philosophie,1,Introduction a la Philosophie,3,L'Oeuvre d'Art,14,776,5,QROC,0.58,0.29,37.86,14,23,37,24,14,10,1.54,58.33,Moyen,Moyen,0,Meme Difficulté,Pas Adapte,Philosophy
776,2015,Philosophie,1,Introduction a la Philosophie,3,L'Oeuvre d'Art,14,777,6,QCU,0.0,0.88,79.76,73,19,92,74,73,1,1.24,98.65,Moyen,Facile,1,Plus Facile,Pas Adapte,Philosophy
1900,2016,Philosophie,1,Introduction a la Philosophie,3,L'Oeuvre d'Art,14,777,6,QCU,0.73,0.32,29.26,29,70,99,71,29,42,1.39,40.85,Difficile,Difficile,0,Meme Difficulté,Pas Adapte,Philosophy
3024,2017,Philosophie,1,Introduction a la Philosophie,3,L'Oeuvre d'Art,14,777,6,QCU,0.72,0.27,18.89,20,84,104,87,20,67,1.2,22.99,Facile,Difficile,-2,Beaucoup plus Difficile,Pas Adapte,Philosophy
4148,2018,Philosophie,1,Introduction a la Philosophie,3,L'Oeuvre d'Art,14,777,6,QCU,0.24,0.63,64.46,72,40,112,85,72,13,1.32,84.71,Moyen,Moyen,0,Meme Difficulté,Adapte,Philosophy
5272,2019,Philosophie,1,Introduction a la Philosophie,3,L'Oeuvre d'Art,14,777,6,QCU,0.38,0.66,64.46,68,37,105,80,68,12,1.31,85.0,Moyen,Moyen,0,Meme Difficulté,Adapte,Philosophy
6396,2020,Philosophie,1,Introduction a la Philosophie,3,L'Oeuvre d'Art,14,777,6,QCU,0.29,0.47,64.46,64,35,99,97,64,33,1.02,65.98,Moyen,Moyen,0,Meme Difficulté,Adapte,Philosophy
777,2015,Philosophie,1,Introduction a la Philosophie,3,L'Oeuvre d'Art,14,778,7,QCU,0.63,0.39,5.46,3,44,47,31,3,28,1.52,9.68,Difficile,Difficile,0,Meme Difficulté,Pas Adapte,Philosophy
1901,2016,Philosophie,1,Introduction a la Philosophie,3,L'Oeuvre d'Art,14,778,7,QCU,0.46,0.25,9.1,4,40,44,16,4,12,2.75,25.0,Moyen,Difficile,-1,Plus Difficile,Pas Adapte,Philosophy
3025,2017,Philosophie,1,Introduction a la Philosophie,3,L'Oeuvre d'Art,14,778,7,QCU,0.0,0.81,65.03,28,15,43,31,28,3,1.39,90.32,Facile,Facile,0,Meme Difficulté,Adapte,Philosophy
4149,2018,Philosophie,1,Introduction a la Philosophie,3,L'Oeuvre d'Art,14,778,7,QCU,0.02,0.84,65.03,28,15,43,39,28,11,1.1,71.79,Facile,Facile,0,Meme Difficulté,Adapte,Philosophy
5273,2019,Philosophie,1,Introduction a la Philosophie,3,L'Oeuvre d'Art,14,778,7,QCU,0.08,0.96,65.03,29,16,45,42,29,13,1.07,69.05,Facile,Facile,0,Meme Difficulté,Adapte,Philosophy
6397,2020,Philosophie,1,Introduction a la Philosophie,3,L'Oeuvre d'Art,14,778,7,QCU,0.08,0.92,65.03,31,17,48,46,31,15,1.04,67.39,Facile,Facile,0,Meme Difficulté,Adapte,Philosophy
778,2015,Philosophie,1,Introduction a la Philosophie,3,L'Oeuvre d'Art,14,779,8,QCU,0.37,0.74,44.7,6,7,13,11,6,5,1.18,54.55,Facile,Moyen,-1,Plus Difficile,Pas Adapte,Philosophy
1902,2016,Philosophie,1,Introduction a la Philosophie,3,L'Oeuvre d'Art,14,779,8,QCU,0.44,0.21,25.77,3,9,12,8,3,5,1.5,37.5,Facile,Difficile,-2,Beaucoup plus Difficile,Pas Adapte,Philosophy
3026,2017,Philosophie,1,Introduction a la Philosophie,3,L'Oeuvre d'Art,14,779,8,QCU,0.6,0.31,15.55,2,10,12,5,2,3,2.4,40.0,Difficile,Difficile,0,Meme Difficulté,Pas Adapte,Philosophy
4150,2018,Philosophie,1,Introduction a la Philosophie,3,L'Oeuvre d'Art,14,779,8,QCU,0.75,0.32,13.05,2,11,13,12,2,10,1.08,16.67,Difficile,Difficile,0,Meme Difficulté,Pas Adapte,Philosophy
5274,2019,Philosophie,1,Introduction a la Philosophie,3,L'Oeuvre d'Art,14,779,8,QCU,0.65,0.33,14.89,2,12,14,5,2,3,2.8,40.0,Facile,Difficile,-2,Beaucoup plus Difficile,Pas Adapte,Philosophy
6398,2020,Philosophie,1,Introduction a la Philosophie,3,L'Oeuvre d'Art,14,779,8,QCU,0.16,0.91,94.79,11,1,12,12,11,1,1.0,91.67,Facile,Facile,0,Meme Difficulté,Pas Adapte,Philosophy
779,2015,Philosophie,1,Introduction a la Philosophie,3,L'Oeuvre d'Art,14,780,9,QROC,0.5,0.29,35.71,10,18,28,14,10,4,2.0,71.43,Moyen,Moyen,0,Meme Difficulté,Pas Adapte,Philosophy
1903,2016,Philosophie,1,Introduction a la Philosophie,3,L'Oeuvre d'Art,14,780,9,QROC,0.72,0.03,28.38,7,17,24,23,7,16,1.04,30.43,Difficile,Difficile,0,Meme Difficulté,Pas Adapte,Philosophy
3027,2017,Philosophie,1,Introduction a la Philosophie,3,L'Oeuvre d'Art,14,780,9,QROC,0.08,0.93,88.42,19,2,21,20,19,1,1.05,95.0,Facile,Facile,0,Meme Difficulté,Pas Adapte,Philosophy
4151,2018,Philosophie,1,Introduction a la Philosophie,3,L'Oeuvre d'Art,14,780,9,QROC,0.61,0.16,5.84,1,19,20,13,1,12,1.54,7.69,Facile,Difficile,-2,Beaucoup plus Difficile,Pas Adapte,Philosophy
5275,2019,Philosophie,1,Introduction a la Philosophie,3,L'Oeuvre d'Art,14,780,9,QROC,0.63,0.24,30.09,7,16,23,13,7,6,1.77,53.85,Facile,Difficile,-2,Beaucoup plus Difficile,Pas Adapte,Philosophy
6399,2020,Philosophie,1,Introduction a la Philosophie,3,L'Oeuvre d'Art,14,780,9,QROC,0.26,0.39,35.84,7,13,20,9,7,2,2.22,77.78,Facile,Moyen,-1,Plus Difficile,Pas Adapte,Philosophy
780,2015,Philosophie,1,Introduction a la Philosophie,3,L'Oeuvre d'Art,14,781,10,QCM,0.11,0.79,81.97,70,15,85,84,70,14,1.01,83.33,Moyen,Facile,1,Plus Facile,Pas Adapte,Philosophy
1904,2016,Philosophie,1,Introduction a la Philosophie,3,L'Oeuvre d'Art,14,781,10,QCM,0.37,0.54,48.21,45,49,94,75,45,30,1.25,60.0,Moyen,Moyen,0,Meme Difficulté,Pas Adapte,Philosophy
3028,2017,Philosophie,1,Introduction a la Philosophie,3,L'Oeuvre d'Art,14,781,10,QCM,0.44,0.33,57.99,59,43,102,69,59,10,1.48,85.51,Moyen,Moyen,0,Meme Difficulté,Pas Adapte,Philosophy
4152,2018,Philosophie,1,Introduction a la Philosophie,3,L'Oeuvre d'Art,14,781,10,QCM,0.56,0.16,7.13,6,85,91,78,6,72,1.17,7.69,Facile,Difficile,-2,Beaucoup plus Difficile,Pas Adapte,Philosophy
5276,2019,Philosophie,1,Introduction a la Philosophie,3,L'Oeuvre d'Art,14,781,10,QCM,0.68,0.18,23.39,23,77,100,81,23,58,1.23,28.4,Facile,Difficile,-2,Beaucoup plus Difficile,Pas Adapte,Philosophy
6400,2020,Philosophie,1,Introduction a la Philosophie,3,L'Oeuvre d'Art,14,781,10,QCM,0.57,0.27,20.95,19,74,93,79,19,60,1.18,24.05,Difficile,Difficile,0,Meme Difficulté,Pas Adapte,Philosophy
781,2015,Philosophie,1,Introduction a la Philosophie,3,L'Oeuvre d'Art,14,782,11,QO,0.9,0.1,18.48,10,45,55,37,10,27,1.49,27.03,Difficile,Difficile,0,Meme Difficulté,Pas Adapte,Philosophy
1905,2016,Philosophie,1,Introduction a la Philosophie,3,L'Oeuvre d'Art,14,782,11,QO,0.97,0.12,11.32,6,46,52,50,6,44,1.04,12.0,Difficile,Difficile,0,Meme Difficulté,Pas Adapte,Philosophy
3029,2017,Philosophie,1,Introduction a la Philosophie,3,L'Oeuvre d'Art,14,782,11,QCM,0.19,0.82,65.76,36,18,54,48,36,12,1.12,75.0,Facile,Facile,0,Meme Difficulté,Adapte,Philosophy
4153,2018,Philosophie,1,Introduction a la Philosophie,3,L'Oeuvre d'Art,14,782,11,QCU,0.1,0.79,65.76,34,18,52,41,34,7,1.27,82.93,Facile,Facile,0,Meme Difficulté,Adapte,Philosophy
5277,2019,Philosophie,1,Introduction a la Philosophie,3,L'Oeuvre d'Art,14,782,11,QCU,0.0,0.96,65.76,29,15,44,43,29,14,1.02,67.44,Facile,Facile,0,Meme Difficulté,Adapte,Philosophy
6401,2020,Philosophie,1,Introduction a la Philosophie,3,L'Oeuvre d'Art,14,782,11,QCU,0.08,0.85,65.76,26,13,39,34,26,8,1.15,76.47,Facile,Facile,0,Meme Difficulté,Adapte,Philosophy
782,2015,Philosophie,1,Introduction a la Philosophie,3,L'Oeuvre d'Art,14,783,12,QCU,0.32,0.69,49.38,6,6,12,7,6,1,1.71,85.71,Moyen,Moyen,0,Meme Difficulté,Pas Adapte,Philosophy
1906,2016,Philosophie,1,Introduction a la Philosophie,3,L'Oeuvre d'Art,14,783,12,QCU,0.14,0.86,75.61,8,3,11,9,8,1,1.22,88.89,Moyen,Facile,1,Plus Facile,Pas Adapte,Philosophy
3030,2017,Philosophie,1,Introduction a la Philosophie,3,L'Oeuvre d'Art,14,783,12,QCU,0.49,0.21,33.56,3,6,9,7,3,4,1.29,42.86,Facile,Difficile,-2,Beaucoup plus Difficile,Pas Adapte,Philosophy
4154,2018,Philosophie,1,Introduction a la Philosophie,3,L'Oeuvre d'Art,14,783,12,QROC,0.65,0.09,3.69,0,9,9,4,0,4,2.25,0.0,Moyen,Difficile,-1,Plus Difficile,Pas Adapte,Philosophy
5278,2019,Philosophie,1,Introduction a la Philosophie,3,L'Oeuvre d'Art,14,783,12,QROC,0.86,0.06,13.95,1,9,10,8,1,7,1.25,12.5,Facile,Difficile,-2,Beaucoup plus Difficile,Pas Adapte,Philosophy
6402,2020,Philosophie,1,Introduction a la Philosophie,3,L'Oeuvre d'Art,14,783,12,QROC,0.68,0.1,34.53,3,5,8,7,3,4,1.14,42.86,Difficile,Difficile,0,Meme Difficulté,Pas Adapte,Philosophy
783,2015,Philosophie,1,Introduction a la Philosophie,3,L'Oeuvre d'Art,14,784,13,QROC,0.43,0.34,59.99,55,37,92,65,55,10,1.42,84.62,Moyen,Moyen,0,Meme Difficulté,Pas Adapte,Philosophy
1907,2016,Philosophie,1,Introduction a la Philosophie,3,L'Oeuvre d'Art,14,784,13,QROC,0.85,0.04,10.67,10,88,98,49,10,39,2.0,20.41,Moyen,Difficile,-1,Plus Difficile,Pas Adapte,Philosophy
3031,2017,Philosophie,1,Introduction a la Philosophie,3,L'Oeuvre d'Art,14,784,13,QROC,0.13,0.95,91.87,103,9,112,110,103,7,1.02,93.64,Moyen,Facile,1,Plus Facile,Pas Adapte,Philosophy
4155,2018,Philosophie,1,Introduction a la Philosophie,3,L'Oeuvre d'Art,14,784,13,QROC,0.08,0.84,76.21,75,24,99,94,75,19,1.05,79.79,Facile,Facile,0,Meme Difficulté,Pas Adapte,Philosophy
5279,2019,Philosophie,1,Introduction a la Philosophie,3,L'Oeuvre d'Art,14,784,13,QROC,0.56,0.33,49.22,50,52,102,74,50,24,1.38,67.57,Moyen,Moyen,0,Meme Difficulté,Pas Adapte,Philosophy
6403,2020,Philosophie,1,Introduction a la Philosophie,3,L'Oeuvre d'Art,14,784,13,QO,0.02,0.97,99.45,87,0,87,87,87,0,1.0,100.0,Difficile,Facile,2,Beaucoup plus Facile,Pas Adapte,Philosophy
784,2015,Philosophie,1,Introduction a la Philosophie,3,L'Oeuvre d'Art,14,785,14,QCU,0.6,0.33,6.07,0,8,8,4,0,4,2.0,0.0,Facile,Difficile,-2,Beaucoup plus Difficile,Pas Adapte,Philosophy
1908,2016,Philosophie,1,Introduction a la Philosophie,3,L'Oeuvre d'Art,14,785,14,QCM,0.14,0.73,98.48,9,0,9,9,9,0,1.0,100.0,Difficile,Facile,2,Beaucoup plus Facile,Pas Adapte,Philosophy
3032,2017,Philosophie,1,Introduction a la Philosophie,3,L'Oeuvre d'Art,14,785,14,QCM,0.54,0.3,15.49,1,7,8,7,1,6,1.14,14.29,Difficile,Difficile,0,Meme Difficulté,Pas Adapte,Philosophy
4156,2018,Philosophie,1,Introduction a la Philosophie,3,L'Oeuvre d'Art,14,785,14,QCM,0.15,0.75,68.17,5,3,8,6,5,1,1.33,83.33,Moyen,Facile,1,Plus Facile,Adapte,Philosophy
5280,2019,Philosophie,1,Introduction a la Philosophie,3,L'Oeuvre d'Art,14,785,14,QCM,0.1,0.78,68.17,5,3,8,5,5,0,1.6,100.0,Facile,Facile,0,Meme Difficulté,Adapte,Philosophy
6404,2020,Philosophie,1,Introduction a la Philosophie,3,L'Oeuvre d'Art,14,785,14,QCM,0.13,0.85,68.17,5,3,8,6,5,1,1.33,83.33,Facile,Facile,0,Meme Difficulté,Adapte,Philosophy
785,2015,Philosophie,1,Introduction a la Philosophie,4,L'Histoire,6,786,1,QCU,0.59,0.36,4.91,4,68,72,38,4,34,1.89,10.53,Moyen,Difficile,-1,Plus Difficile,Pas Adapte,Philosophy
1909,2016,Philosophie,1,Introduction a la Philosophie,4,L'Histoire,6,786,1,QCU,0.11,0.92,80.42,61,15,76,62,61,1,1.23,98.39,Difficile,Facile,2,Beaucoup plus Facile,Pas Adapte,Philosophy
3033,2017,Philosophie,1,Introduction a la Philosophie,4,L'Histoire,6,786,1,QCU,0.01,0.86,99.89,66,0,66,66,66,0,1.0,100.0,Difficile,Facile,2,Beaucoup plus Facile,Pas Adapte,Philosophy
4157,2018,Philosophie,1,Introduction a la Philosophie,4,L'Histoire,6,786,1,QCM,0.45,0.45,56.4,38,30,68,48,38,10,1.42,79.17,Moyen,Moyen,0,Meme Difficulté,Pas Adapte,Philosophy
5281,2019,Philosophie,1,Introduction a la Philosophie,4,L'Histoire,6,786,1,QCM,0.71,0.28,31.48,20,42,62,25,20,5,2.48,80.0,Difficile,Difficile,0,Meme Difficulté,Pas Adapte,Philosophy
6405,2020,Philosophie,1,Introduction a la Philosophie,4,L'Histoire,6,786,1,QCM,0.04,0.76,65.58,43,23,66,60,43,17,1.1,71.67,Moyen,Facile,1,Plus Facile,Adapte,Philosophy
786,2015,Philosophie,1,Introduction a la Philosophie,4,L'Histoire,6,787,2,QCU,0.57,0.26,16.55,9,43,52,45,9,36,1.16,20.0,Difficile,Difficile,0,Meme Difficulté,Pas Adapte,Philosophy
1910,2016,Philosophie,1,Introduction a la Philosophie,4,L'Histoire,6,787,2,QCU,0.05,0.91,98.3,47,1,48,47,47,0,1.02,100.0,Moyen,Facile,1,Plus Facile,Pas Adapte,Philosophy
3034,2017,Philosophie,1,Introduction a la Philosophie,4,L'Histoire,6,787,2,QCU,0.1,0.84,79.89,34,9,43,37,34,3,1.16,91.89,Facile,Facile,0,Meme Difficulté,Pas Adapte,Philosophy
4158,2018,Philosophie,1,Introduction a la Philosophie,4,L'Histoire,6,787,2,QCU,0.47,0.22,0.6,0,47,47,24,0,24,1.96,0.0,Moyen,Difficile,-1,Plus Difficile,Pas Adapte,Philosophy
5282,2019,Philosophie,1,Introduction a la Philosophie,4,L'Histoire,6,787,2,QCU,0.18,0.91,86.49,44,7,51,45,44,1,1.13,97.78,Facile,Facile,0,Meme Difficulté,Pas Adapte,Philosophy
6406,2020,Philosophie,1,Introduction a la Philosophie,4,L'Histoire,6,787,2,QCU,0.27,0.54,38.66,19,29,48,46,19,27,1.04,41.3,Facile,Moyen,-1,Plus Difficile,Pas Adapte,Philosophy
787,2015,Philosophie,1,Introduction a la Philosophie,4,L'Histoire,6,788,3,QCM,0.3,0.49,54.46,39,32,71,43,39,4,1.65,90.7,Moyen,Moyen,0,Meme Difficulté,Pas Adapte,Philosophy
1911,2016,Philosophie,1,Introduction a la Philosophie,4,L'Histoire,6,788,3,QCM,0.07,0.89,67.73,53,25,78,74,53,21,1.05,71.62,Moyen,Facile,1,Plus Facile,Adapte,Philosophy
3035,2017,Philosophie,1,Introduction a la Philosophie,4,L'Histoire,6,788,3,QCM,0.15,0.89,67.73,48,23,71,51,48,3,1.39,94.12,Facile,Facile,0,Meme Difficulté,Adapte,Philosophy
4159,2018,Philosophie,1,Introduction a la Philosophie,4,L'Histoire,6,788,3,QCM,0.2,0.7,67.73,43,20,63,45,43,2,1.4,95.56,Facile,Facile,0,Meme Difficulté,Adapte,Philosophy
5283,2019,Philosophie,1,Introduction a la Philosophie,4,L'Histoire,6,788,3,QCM,0.01,0.77,67.73,39,19,58,43,39,4,1.35,90.7,Facile,Facile,0,Meme Difficulté,Adapte,Philosophy
6407,2020,Philosophie,1,Introduction a la Philosophie,4,L'Histoire,6,788,3,QCM,0.08,0.86,67.73,44,21,65,49,44,5,1.33,89.8,Facile,Facile,0,Meme Difficulté,Adapte,Philosophy
788,2015,Philosophie,1,Introduction a la Philosophie,4,L'Histoire,6,789,4,QCU,0.22,0.55,63.62,51,29,80,59,51,8,1.36,86.44,Facile,Moyen,-1,Plus Difficile,Adapte,Philosophy
1912,2016,Philosophie,1,Introduction a la Philosophie,4,L'Histoire,6,789,4,QCU,0.4,0.72,63.62,45,26,71,59,45,14,1.2,76.27,Moyen,Moyen,0,Meme Difficulté,Adapte,Philosophy
3036,2017,Philosophie,1,Introduction a la Philosophie,4,L'Histoire,6,789,4,QCU,0.38,0.67,63.62,46,26,72,64,46,18,1.12,71.88,Moyen,Moyen,0,Meme Difficulté,Adapte,Philosophy
4160,2018,Philosophie,1,Introduction a la Philosophie,4,L'Histoire,6,789,4,QCM,0.2,0.6,63.62,48,27,75,61,48,13,1.23,78.69,Moyen,Moyen,0,Meme Difficulté,Adapte,Philosophy
5284,2019,Philosophie,1,Introduction a la Philosophie,4,L'Histoire,6,789,4,QCM,0.48,0.56,63.62,46,26,72,59,46,13,1.22,77.97,Moyen,Moyen,0,Meme Difficulté,Adapte,Philosophy
6408,2020,Philosophie,1,Introduction a la Philosophie,4,L'Histoire,6,789,4,QCU,0.38,0.63,63.62,41,23,64,56,41,15,1.14,73.21,Moyen,Moyen,0,Meme Difficulté,Adapte,Philosophy
789,2015,Philosophie,1,Introduction a la Philosophie,4,L'Histoire,6,790,5,QCM,0.27,0.53,64.24,57,31,88,74,57,17,1.19,77.03,Facile,Moyen,-1,Plus Difficile,Adapte,Philosophy
1913,2016,Philosophie,1,Introduction a la Philosophie,4,L'Histoire,6,790,5,QCM,0.46,0.45,64.24,54,30,84,65,54,11,1.29,83.08,Moyen,Moyen,0,Meme Difficulté,Adapte,Philosophy
3037,2017,Philosophie,1,Introduction a la Philosophie,4,L'Histoire,6,790,5,QROC,0.26,0.37,64.24,60,33,93,79,60,19,1.18,75.95,Moyen,Moyen,0,Meme Difficulté,Adapte,Philosophy
4161,2018,Philosophie,1,Introduction a la Philosophie,4,L'Histoire,6,790,5,QROC,0.21,0.32,64.24,55,30,85,71,55,16,1.2,77.46,Moyen,Moyen,0,Meme Difficulté,Adapte,Philosophy
5285,2019,Philosophie,1,Introduction a la Philosophie,4,L'Histoire,6,790,5,QROC,0.28,0.35,64.24,52,29,81,52,52,0,1.56,100.0,Moyen,Moyen,0,Meme Difficulté,Adapte,Philosophy
6409,2020,Philosophie,1,Introduction a la Philosophie,4,L'Histoire,6,790,5,QROC,0.36,0.35,64.24,59,33,92,64,59,5,1.44,92.19,Moyen,Moyen,0,Meme Difficulté,Adapte,Philosophy
790,2015,Philosophie,1,Introduction a la Philosophie,4,L'Histoire,6,791,6,QCM,0.25,0.44,53.72,15,13,28,25,15,10,1.12,60.0,Facile,Moyen,-1,Plus Difficile,Pas Adapte,Philosophy
1914,2016,Philosophie,1,Introduction a la Philosophie,4,L'Histoire,6,791,6,QCM,0.44,0.41,61.59,15,10,25,15,15,0,1.67,100.0,Moyen,Moyen,0,Meme Difficulté,Adapte,Philosophy
3038,2017,Philosophie,1,Introduction a la Philosophie,4,L'Histoire,6,791,6,QCU,0.32,0.6,61.59,15,9,24,22,15,7,1.09,68.18,Moyen,Moyen,0,Meme Difficulté,Adapte,Philosophy
4162,2018,Philosophie,1,Introduction a la Philosophie,4,L'Histoire,6,791,6,QCU,0.32,0.62,61.59,13,8,21,16,13,3,1.31,81.25,Moyen,Moyen,0,Meme Difficulté,Adapte,Philosophy
5286,2019,Philosophie,1,Introduction a la Philosophie,4,L'Histoire,6,791,6,QCU,0.38,0.6,61.59,15,9,24,15,15,0,1.6,100.0,Moyen,Moyen,0,Meme Difficulté,Adapte,Philosophy
6410,2020,Philosophie,1,Introduction a la Philosophie,4,L'Histoire,6,791,6,QCU,0.39,0.71,61.59,17,10,27,18,17,1,1.5,94.44,Moyen,Moyen,0,Meme Difficulté,Adapte,Philosophy
791,2015,Philosophie,1,Introduction a la Philosophie,5,Le Droit,9,792,1,QCU,0.57,0.24,15.21,9,50,59,23,9,14,2.57,39.13,Moyen,Difficile,-1,Plus Difficile,Pas Adapte,Philosophy
1915,2016,Philosophie,1,Introduction a la Philosophie,5,Le Droit,9,792,1,QCU,0.27,0.47,61.96,35,22,57,48,35,13,1.19,72.92,Facile,Moyen,-1,Plus Difficile,Adapte,Philosophy
3039,2017,Philosophie,1,Introduction a la Philosophie,5,Le Droit,9,792,1,QCU,0.38,0.63,61.96,30,18,48,45,30,15,1.07,66.67,Moyen,Moyen,0,Meme Difficulté,Adapte,Philosophy
4163,2018,Philosophie,1,Introduction a la Philosophie,5,Le Droit,9,792,1,QCU,0.21,0.64,61.96,30,18,48,44,30,14,1.09,68.18,Moyen,Moyen,0,Meme Difficulté,Adapte,Philosophy
5287,2019,Philosophie,1,Introduction a la Philosophie,5,Le Droit,9,792,1,QCU,0.39,0.65,61.96,27,16,43,33,27,6,1.3,81.82,Moyen,Moyen,0,Meme Difficulté,Adapte,Philosophy
6411,2020,Philosophie,1,Introduction a la Philosophie,5,Le Droit,9,792,1,QCU,0.35,0.72,61.96,25,16,41,37,25,12,1.11,67.57,Moyen,Moyen,0,Meme Difficulté,Adapte,Philosophy
792,2015,Philosophie,1,Introduction a la Philosophie,5,Le Droit,9,793,2,QCU,0.56,0.35,24.11,9,27,36,27,9,18,1.33,33.33,Facile,Difficile,-2,Beaucoup plus Difficile,Pas Adapte,Philosophy
1916,2016,Philosophie,1,Introduction a la Philosophie,5,Le Droit,9,793,2,QCU,0.65,0.37,1.02,0,37,37,36,0,36,1.03,0.0,Difficile,Difficile,0,Meme Difficulté,Pas Adapte,Philosophy
3040,2017,Philosophie,1,Introduction a la Philosophie,5,Le Droit,9,793,2,QCM,0.2,0.58,43.32,14,19,33,22,14,8,1.5,63.64,Moyen,Moyen,0,Meme Difficulté,Pas Adapte,Philosophy
4164,2018,Philosophie,1,Introduction a la Philosophie,5,Le Droit,9,793,2,QCM,0.41,0.37,56.54,20,15,35,22,20,2,1.59,90.91,Moyen,Moyen,0,Meme Difficulté,Pas Adapte,Philosophy
5288,2019,Philosophie,1,Introduction a la Philosophie,5,Le Droit,9,793,2,QCU,0.3,0.7,54.0,16,14,30,21,16,5,1.43,76.19,Difficile,Moyen,1,Plus Facile,Pas Adapte,Philosophy
6412,2020,Philosophie,1,Introduction a la Philosophie,5,Le Droit,9,793,2,QCU,0.27,0.65,37.63,10,16,26,18,10,8,1.44,55.56,Facile,Moyen,-1,Plus Difficile,Pas Adapte,Philosophy
793,2015,Philosophie,1,Introduction a la Philosophie,5,Le Droit,9,794,3,QCU,0.67,0.23,26.5,17,48,65,51,17,34,1.27,33.33,Difficile,Difficile,0,Meme Difficulté,Pas Adapte,Philosophy
1917,2016,Philosophie,1,Introduction a la Philosophie,5,Le Droit,9,794,3,QCU,0.4,0.43,51.24,29,28,57,51,29,22,1.12,56.86,Facile,Moyen,-1,Plus Difficile,Pas Adapte,Philosophy
3041,2017,Philosophie,1,Introduction a la Philosophie,5,Le Droit,9,794,3,QCU,0.17,0.95,98.0,65,1,66,65,65,0,1.02,100.0,Difficile,Facile,2,Beaucoup plus Facile,Pas Adapte,Philosophy
4165,2018,Philosophie,1,Introduction a la Philosophie,5,Le Droit,9,794,3,QCU,0.28,0.46,47.62,32,35,67,50,32,18,1.34,64.0,Moyen,Moyen,0,Meme Difficulté,Pas Adapte,Philosophy
5289,2019,Philosophie,1,Introduction a la Philosophie,5,Le Droit,9,794,3,QCM,0.16,0.97,82.54,52,11,63,55,52,3,1.15,94.55,Facile,Facile,0,Meme Difficulté,Pas Adapte,Philosophy
6413,2020,Philosophie,1,Introduction a la Philosophie,5,Le Droit,9,794,3,QCM,0.42,0.48,36.15,22,40,62,23,22,1,2.7,95.65,Moyen,Moyen,0,Meme Difficulté,Pas Adapte,Philosophy
794,2015,Philosophie,1,Introduction a la Philosophie,5,Le Droit,9,795,4,QCU,0.22,0.74,49.39,33,33,66,55,33,22,1.2,60.0,Difficile,Moyen,1,Plus Facile,Pas Adapte,Philosophy
1918,2016,Philosophie,1,Introduction a la Philosophie,5,Le Droit,9,795,4,QCU,0.47,0.33,26.85,17,47,64,63,17,46,1.02,26.98,Difficile,Difficile,0,Meme Difficulté,Pas Adapte,Philosophy
3042,2017,Philosophie,1,Introduction a la Philosophie,5,Le Droit,9,795,4,QCU,0.21,0.72,39.55,25,38,63,46,25,21,1.37,54.35,Difficile,Moyen,1,Plus Facile,Pas Adapte,Philosophy
4166,2018,Philosophie,1,Introduction a la Philosophie,5,Le Droit,9,795,4,QCU,0.21,0.52,54.6,35,29,64,37,35,2,1.73,94.59,Difficile,Moyen,1,Plus Facile,Pas Adapte,Philosophy
5290,2019,Philosophie,1,Introduction a la Philosophie,5,Le Droit,9,795,4,QCU,0.22,0.61,50.33,33,33,66,42,33,9,1.57,78.57,Facile,Moyen,-1,Plus Difficile,Pas Adapte,Philosophy
6414,2020,Philosophie,1,Introduction a la Philosophie,5,Le Droit,9,795,4,QCU,0.12,0.79,78.82,44,12,56,45,44,1,1.24,97.78,Difficile,Facile,2,Beaucoup plus Facile,Pas Adapte,Philosophy
795,2015,Philosophie,1,Introduction a la Philosophie,5,Le Droit,9,796,5,QO,0.24,0.17,63.3,11,7,18,15,11,4,1.2,73.33,Difficile,Moyen,1,Plus Facile,Adapte,Philosophy
1919,2016,Philosophie,1,Introduction a la Philosophie,5,Le Droit,9,796,5,QO,0.42,0.21,63.3,13,8,21,19,13,6,1.11,68.42,Moyen,Moyen,0,Meme Difficulté,Adapte,Philosophy
3043,2017,Philosophie,1,Introduction a la Philosophie,5,Le Droit,9,796,5,QO,0.44,0.3,63.3,15,9,24,19,15,4,1.26,78.95,Moyen,Moyen,0,Meme Difficulté,Adapte,Philosophy
4167,2018,Philosophie,1,Introduction a la Philosophie,5,Le Droit,9,796,5,QROC,0.54,0.36,63.3,13,8,21,15,13,2,1.4,86.67,Moyen,Moyen,0,Meme Difficulté,Adapte,Philosophy
5291,2019,Philosophie,1,Introduction a la Philosophie,5,Le Droit,9,796,5,QROC,0.25,0.26,63.3,15,8,23,23,15,8,1.0,65.22,Moyen,Moyen,0,Meme Difficulté,Adapte,Philosophy
6415,2020,Philosophie,1,Introduction a la Philosophie,5,Le Droit,9,796,5,QROC,0.35,0.28,63.3,16,9,25,23,16,7,1.09,69.57,Moyen,Moyen,0,Meme Difficulté,Adapte,Philosophy
796,2015,Philosophie,1,Introduction a la Philosophie,5,Le Droit,9,797,6,QCU,0.45,0.29,22.49,12,41,53,49,12,37,1.08,24.49,Moyen,Difficile,-1,Plus Difficile,Pas Adapte,Philosophy
1920,2016,Philosophie,1,Introduction a la Philosophie,5,Le Droit,9,797,6,QCU,0.1,0.84,80.22,47,12,59,55,47,8,1.07,85.45,Difficile,Facile,2,Beaucoup plus Facile,Pas Adapte,Philosophy
3044,2017,Philosophie,1,Introduction a la Philosophie,5,Le Droit,9,797,6,QCU,0.14,0.86,85.36,47,8,55,51,47,4,1.08,92.16,Moyen,Facile,1,Plus Facile,Pas Adapte,Philosophy
4168,2018,Philosophie,1,Introduction a la Philosophie,5,Le Droit,9,797,6,QCU,0.61,0.26,24.04,13,40,53,23,13,10,2.3,56.52,Difficile,Difficile,0,Meme Difficulté,Pas Adapte,Philosophy
5292,2019,Philosophie,1,Introduction a la Philosophie,5,Le Droit,9,797,6,QCU,0.3,0.42,58.43,34,24,58,53,34,19,1.09,64.15,Difficile,Moyen,1,Plus Facile,Pas Adapte,Philosophy
6416,2020,Philosophie,1,Introduction a la Philosophie,5,Le Droit,9,797,6,QCU,0.37,0.52,54.74,32,26,58,40,32,8,1.45,80.0,Difficile,Moyen,1,Plus Facile,Pas Adapte,Philosophy
797,2015,Philosophie,1,Introduction a la Philosophie,5,Le Droit,9,798,7,QCM,0.36,0.47,51.28,21,19,40,29,21,8,1.38,72.41,Moyen,Moyen,0,Meme Difficulté,Pas Adapte,Philosophy
1921,2016,Philosophie,1,Introduction a la Philosophie,5,Le Droit,9,798,7,QCM,0.11,0.7,84.04,34,7,41,38,34,4,1.08,89.47,Facile,Facile,0,Meme Difficulté,Pas Adapte,Philosophy
3045,2017,Philosophie,1,Introduction a la Philosophie,5,Le Droit,9,798,7,QCM,0.07,0.73,82.39,30,6,36,36,30,6,1.0,83.33,Moyen,Facile,1,Plus Facile,Pas Adapte,Philosophy
4169,2018,Philosophie,1,Introduction a la Philosophie,5,Le Droit,9,798,7,QCM,0.01,0.79,85.28,28,5,33,30,28,2,1.1,93.33,Moyen,Facile,1,Plus Facile,Pas Adapte,Philosophy
5293,2019,Philosophie,1,Introduction a la Philosophie,5,Le Droit,9,798,7,QCM,0.71,0.24,20.78,6,24,30,30,6,24,1.0,20.0,Difficile,Difficile,0,Meme Difficulté,Pas Adapte,Philosophy
6417,2020,Philosophie,1,Introduction a la Philosophie,5,Le Droit,9,798,7,QCM,0.76,0.2,13.29,4,26,30,17,4,13,1.76,23.53,Moyen,Difficile,-1,Plus Difficile,Pas Adapte,Philosophy
798,2015,Philosophie,1,Introduction a la Philosophie,5,Le Droit,9,799,8,QCU,0.44,0.32,28.02,25,64,89,68,25,43,1.31,36.76,Moyen,Difficile,-1,Plus Difficile,Pas Adapte,Philosophy
1922,2016,Philosophie,1,Introduction a la Philosophie,5,Le Droit,9,799,8,QCU,0.39,0.46,46.52,44,50,94,76,44,32,1.24,57.89,Difficile,Moyen,1,Plus Facile,Pas Adapte,Philosophy
3046,2017,Philosophie,1,Introduction a la Philosophie,5,Le Droit,9,799,8,QCM,0.52,0.17,16.99,15,74,89,49,15,34,1.82,30.61,Difficile,Difficile,0,Meme Difficulté,Pas Adapte,Philosophy
4170,2018,Philosophie,1,Introduction a la Philosophie,5,Le Droit,9,799,8,QCM,0.29,0.6,60.43,48,32,80,64,48,16,1.25,75.0,Facile,Moyen,-1,Plus Difficile,Adapte,Philosophy
5294,2019,Philosophie,1,Introduction a la Philosophie,5,Le Droit,9,799,8,QCU,0.35,0.54,60.43,50,33,83,57,50,7,1.46,87.72,Moyen,Moyen,0,Meme Difficulté,Adapte,Philosophy
6418,2020,Philosophie,1,Introduction a la Philosophie,5,Le Droit,9,799,8,QCU,0.23,0.54,60.43,46,30,76,71,46,25,1.07,64.79,Moyen,Moyen,0,Meme Difficulté,Adapte,Philosophy
799,2015,Philosophie,1,Introduction a la Philosophie,5,Le Droit,9,800,9,QCM,0.08,0.95,78.79,72,19,91,85,72,13,1.07,84.71,Facile,Facile,0,Meme Difficulté,Pas Adapte,Philosophy
1923,2016,Philosophie,1,Introduction a la Philosophie,5,Le Droit,9,800,9,QCM,0.31,0.35,49.24,51,52,103,60,51,9,1.72,85.0,Facile,Moyen,-1,Plus Difficile,Pas Adapte,Philosophy
3047,2017,Philosophie,1,Introduction a la Philosophie,5,Le Droit,9,800,9,QCM,0.25,0.46,43.02,49,65,114,105,49,56,1.09,46.67,Difficile,Moyen,1,Plus Facile,Pas Adapte,Philosophy
4171,2018,Philosophie,1,Introduction a la Philosophie,5,Le Droit,9,800,9,QCM,0.17,0.95,66.66,87,44,131,105,87,18,1.25,82.86,Difficile,Facile,2,Beaucoup plus Facile,Adapte,Philosophy
5295,2019,Philosophie,1,Introduction a la Philosophie,5,Le Droit,9,800,9,QCM,0.05,1.0,66.66,90,45,135,117,90,27,1.15,76.92,Facile,Facile,0,Meme Difficulté,Adapte,Philosophy
6419,2020,Philosophie,1,Introduction a la Philosophie,5,Le Droit,9,800,9,QCM,0.1,0.79,66.66,85,42,127,88,85,3,1.44,96.59,Facile,Facile,0,Meme Difficulté,Adapte,Philosophy
800,2015,Philosophie,1,Introduction a la Philosophie,6,La Raison,7,801,1,QO,0.49,0.19,52.51,13,11,24,22,13,9,1.09,59.09,Moyen,Moyen,0,Meme Difficulté,Pas Adapte,Philosophy
1924,2016,Philosophie,1,Introduction a la Philosophie,6,La Raison,7,801,1,QO,0.96,0.06,5.8,1,19,20,15,1,14,1.33,6.67,Difficile,Difficile,0,Meme Difficulté,Pas Adapte,Philosophy
3048,2017,Philosophie,1,Introduction a la Philosophie,6,La Raison,7,801,1,QO,0.02,0.89,97.89,20,0,20,20,20,0,1.0,100.0,Moyen,Facile,1,Plus Facile,Pas Adapte,Philosophy
4172,2018,Philosophie,1,Introduction a la Philosophie,6,La Raison,7,801,1,QO,0.1,0.66,93.81,17,1,18,17,17,0,1.06,100.0,Facile,Facile,0,Meme Difficulté,Pas Adapte,Philosophy
5296,2019,Philosophie,1,Introduction a la Philosophie,6,La Raison,7,801,1,QO,0.04,0.54,79.07,13,3,16,16,13,3,1.0,81.25,Moyen,Facile,1,Plus Facile,Pas Adapte,Philosophy
6420,2020,Philosophie,1,Introduction a la Philosophie,6,La Raison,7,801,1,QO,0.62,0.22,42.1,7,10,17,10,7,3,1.7,70.0,Moyen,Moyen,0,Meme Difficulté,Pas Adapte,Philosophy
801,2015,Philosophie,1,Introduction a la Philosophie,6,La Raison,7,802,2,QCM,0.09,0.85,86.91,11,2,13,12,11,1,1.08,91.67,Difficile,Facile,2,Beaucoup plus Facile,Pas Adapte,Philosophy
1925,2016,Philosophie,1,Introduction a la Philosophie,6,La Raison,7,802,2,QCM,0.78,0.27,11.68,2,11,13,7,2,5,1.86,28.57,Moyen,Difficile,-1,Plus Difficile,Pas Adapte,Philosophy
3049,2017,Philosophie,1,Introduction a la Philosophie,6,La Raison,7,802,2,QCM,0.29,0.51,48.17,7,7,14,13,7,6,1.08,53.85,Facile,Moyen,-1,Plus Difficile,Pas Adapte,Philosophy
4173,2018,Philosophie,1,Introduction a la Philosophie,6,La Raison,7,802,2,QCM,0.78,0.28,31.45,4,9,13,10,4,6,1.3,40.0,Facile,Difficile,-2,Beaucoup plus Difficile,Pas Adapte,Philosophy
5297,2019,Philosophie,1,Introduction a la Philosophie,6,La Raison,7,802,2,QCM,0.79,0.27,22.16,2,9,11,11,2,9,1.0,18.18,Moyen,Difficile,-1,Plus Difficile,Pas Adapte,Philosophy
6421,2020,Philosophie,1,Introduction a la Philosophie,6,La Raison,7,802,2,QCU,0.3,0.48,56.99,7,6,13,8,7,1,1.62,87.5,Moyen,Moyen,0,Meme Difficulté,Pas Adapte,Philosophy
802,2015,Philosophie,1,Introduction a la Philosophie,6,La Raison,7,803,3,QCU,0.11,0.8,79.22,16,4,20,20,16,4,1.0,80.0,Difficile,Facile,2,Beaucoup plus Facile,Pas Adapte,Philosophy
1926,2016,Philosophie,1,Introduction a la Philosophie,6,La Raison,7,803,3,QCU,0.08,0.89,80.89,15,4,19,19,15,4,1.0,78.95,Moyen,Facile,1,Plus Facile,Pas Adapte,Philosophy
3050,2017,Philosophie,1,Introduction a la Philosophie,6,La Raison,7,803,3,QCU,0.7,0.36,2.49,1,20,21,8,1,7,2.62,12.5,Moyen,Difficile,-1,Plus Difficile,Pas Adapte,Philosophy
4174,2018,Philosophie,1,Introduction a la Philosophie,6,La Raison,7,803,3,QCU,0.37,0.64,38.23,9,14,23,10,9,1,2.3,90.0,Moyen,Moyen,0,Meme Difficulté,Pas Adapte,Philosophy
5298,2019,Philosophie,1,Introduction a la Philosophie,6,La Raison,7,803,3,QCU,0.3,0.75,45.0,10,12,22,17,10,7,1.29,58.82,Difficile,Moyen,1,Plus Facile,Pas Adapte,Philosophy
6422,2020,Philosophie,1,Introduction a la Philosophie,6,La Raison,7,803,3,QCM,0.3,0.32,46.51,12,13,25,16,12,4,1.56,75.0,Difficile,Moyen,1,Plus Facile,Pas Adapte,Philosophy
803,2015,Philosophie,1,Introduction a la Philosophie,6,La Raison,7,804,4,QCM,0.27,0.52,41.58,37,51,88,83,37,46,1.06,44.58,Difficile,Moyen,1,Plus Facile,Pas Adapte,Philosophy
1927,2016,Philosophie,1,Introduction a la Philosophie,6,La Raison,7,804,4,QCM,0.57,0.29,29.83,24,56,80,54,24,30,1.48,44.44,Difficile,Difficile,0,Meme Difficulté,Pas Adapte,Philosophy
3051,2017,Philosophie,1,Introduction a la Philosophie,6,La Raison,7,804,4,QCM,0.39,0.4,60.72,46,29,75,47,46,1,1.6,97.87,Moyen,Moyen,0,Meme Difficulté,Adapte,Philosophy
4175,2018,Philosophie,1,Introduction a la Philosophie,6,La Raison,7,804,4,QO,0.32,0.25,60.72,42,27,69,69,42,27,1.0,60.87,Moyen,Moyen,0,Meme Difficulté,Adapte,Philosophy
5299,2019,Philosophie,1,Introduction a la Philosophie,6,La Raison,7,804,4,QO,0.37,0.16,60.72,43,27,70,53,43,10,1.32,81.13,Moyen,Moyen,0,Meme Difficulté,Adapte,Philosophy
6423,2020,Philosophie,1,Introduction a la Philosophie,6,La Raison,7,804,4,QO,0.51,0.29,60.72,41,27,68,42,41,1,1.62,97.62,Moyen,Moyen,0,Meme Difficulté,Adapte,Philosophy
804,2015,Philosophie,1,Introduction a la Philosophie,6,La Raison,7,805,5,QCU,0.08,0.85,93.81,87,6,93,87,87,0,1.07,100.0,Difficile,Facile,2,Beaucoup plus Facile,Pas Adapte,Philosophy
1928,2016,Philosophie,1,Introduction a la Philosophie,6,La Raison,7,805,5,QCU,0.72,0.28,14.5,15,90,105,62,15,47,1.69,24.19,Facile,Difficile,-2,Beaucoup plus Difficile,Pas Adapte,Philosophy
3052,2017,Philosophie,1,Introduction a la Philosophie,6,La Raison,7,805,5,QCU,0.67,0.39,32.67,38,78,116,50,38,12,2.32,76.0,Difficile,Difficile,0,Meme Difficulté,Pas Adapte,Philosophy
4176,2018,Philosophie,1,Introduction a la Philosophie,6,La Raison,7,805,5,QCM,0.51,0.21,10.87,11,88,99,76,11,65,1.3,14.47,Moyen,Difficile,-1,Plus Difficile,Pas Adapte,Philosophy
5300,2019,Philosophie,1,Introduction a la Philosophie,6,La Raison,7,805,5,QCM,0.74,0.16,9.03,10,98,108,42,10,32,2.57,23.81,Facile,Difficile,-2,Beaucoup plus Difficile,Pas Adapte,Philosophy
6424,2020,Philosophie,1,Introduction a la Philosophie,6,La Raison,7,805,5,QCM,0.15,0.77,73.73,82,29,111,95,82,13,1.17,86.32,Facile,Facile,0,Meme Difficulté,Adapte,Philosophy
805,2015,Philosophie,1,Introduction a la Philosophie,6,La Raison,7,806,6,QCU,0.14,0.89,76.16,52,16,68,65,52,13,1.05,80.0,Moyen,Facile,1,Plus Facile,Pas Adapte,Philosophy
1929,2016,Philosophie,1,Introduction a la Philosophie,6,La Raison,7,806,6,QCU,0.34,0.68,44.57,32,39,71,51,32,19,1.39,62.75,Difficile,Moyen,1,Plus Facile,Pas Adapte,Philosophy
3053,2017,Philosophie,1,Introduction a la Philosophie,6,La Raison,7,806,6,QCU,0.03,0.88,94.32,58,3,61,60,58,2,1.02,96.67,Moyen,Facile,1,Plus Facile,Pas Adapte,Philosophy
4177,2018,Philosophie,1,Introduction a la Philosophie,6,La Raison,7,806,6,QCU,0.23,0.52,56.69,36,27,63,45,36,9,1.4,80.0,Difficile,Moyen,1,Plus Facile,Pas Adapte,Philosophy
5301,2019,Philosophie,1,Introduction a la Philosophie,6,La Raison,7,806,6,QCM,0.61,0.19,31.81,18,38,56,43,18,25,1.3,41.86,Facile,Difficile,-2,Beaucoup plus Difficile,Pas Adapte,Philosophy
6425,2020,Philosophie,1,Introduction a la Philosophie,6,La Raison,7,806,6,QCM,0.59,0.25,28.02,16,40,56,22,16,6,2.55,72.73,Facile,Difficile,-2,Beaucoup plus Difficile,Pas Adapte,Philosophy
806,2015,Philosophie,1,Introduction a la Philosophie,6,La Raison,7,807,7,QCM,0.75,0.28,19.75,9,37,46,39,9,30,1.18,23.08,Moyen,Difficile,-1,Plus Difficile,Pas Adapte,Philosophy
1930,2016,Philosophie,1,Introduction a la Philosophie,6,La Raison,7,807,7,QCM,0.79,0.2,9.52,4,42,46,26,4,22,1.77,15.38,Moyen,Difficile,-1,Plus Difficile,Pas Adapte,Philosophy
3054,2017,Philosophie,1,Introduction a la Philosophie,6,La Raison,7,807,7,QCU,0.13,0.79,85.75,41,7,48,47,41,6,1.02,87.23,Facile,Facile,0,Meme Difficulté,Pas Adapte,Philosophy
4178,2018,Philosophie,1,Introduction a la Philosophie,6,La Raison,7,807,7,QCU,0.17,0.79,72.97,31,11,42,40,31,9,1.05,77.5,Facile,Facile,0,Meme Difficulté,Adapte,Philosophy
5302,2019,Philosophie,1,Introduction a la Philosophie,6,La Raison,7,807,7,QCU,0.11,0.98,72.97,28,11,39,29,28,1,1.34,96.55,Facile,Facile,0,Meme Difficulté,Adapte,Philosophy
6426,2020,Philosophie,1,Introduction a la Philosophie,6,La Raison,7,807,7,QCU,0.15,0.77,72.97,26,10,36,28,26,2,1.29,92.86,Facile,Facile,0,Meme Difficulté,Adapte,Philosophy
807,2015,Philosophie,1,Introduction a la Philosophie,7,La Verite,7,808,1,QCU,0.3,0.45,63.64,60,34,94,62,60,2,1.52,96.77,Facile,Moyen,-1,Plus Difficile,Adapte,Philosophy
1931,2016,Philosophie,1,Introduction a la Philosophie,7,La Verite,7,808,1,QCU,0.31,0.47,63.64,60,34,94,61,60,1,1.54,98.36,Moyen,Moyen,0,Meme Difficulté,Adapte,Philosophy
3055,2017,Philosophie,1,Introduction a la Philosophie,7,La Verite,7,808,1,QCU,0.27,0.74,63.64,62,36,98,98,62,36,1.0,63.27,Moyen,Moyen,0,Meme Difficulté,Adapte,Philosophy
4179,2018,Philosophie,1,Introduction a la Philosophie,7,La Verite,7,808,1,QCU,0.25,0.7,63.64,57,32,89,65,57,8,1.37,87.69,Moyen,Moyen,0,Meme Difficulté,Adapte,Philosophy
5303,2019,Philosophie,1,Introduction a la Philosophie,7,La Verite,7,808,1,QCM,0.22,0.6,63.64,50,29,79,77,50,27,1.03,64.94,Moyen,Moyen,0,Meme Difficulté,Adapte,Philosophy
6427,2020,Philosophie,1,Introduction a la Philosophie,7,La Verite,7,808,1,QCM,0.48,0.64,63.64,51,29,80,60,51,9,1.33,85.0,Moyen,Moyen,0,Meme Difficulté,Adapte,Philosophy
808,2015,Philosophie,1,Introduction a la Philosophie,7,La Verite,7,809,2,QCM,0.62,0.29,21.09,18,66,84,28,18,10,3.0,64.29,Difficile,Difficile,0,Meme Difficulté,Pas Adapte,Philosophy
1932,2016,Philosophie,1,Introduction a la Philosophie,7,La Verite,7,809,2,QCM,0.42,0.37,44.09,40,51,91,70,40,30,1.3,57.14,Facile,Moyen,-1,Plus Difficile,Pas Adapte,Philosophy
3056,2017,Philosophie,1,Introduction a la Philosophie,7,La Verite,7,809,2,QCM,0.61,0.17,23.85,24,78,102,27,24,3,3.78,88.89,Facile,Difficile,-2,Beaucoup plus Difficile,Pas Adapte,Philosophy
4180,2018,Philosophie,1,Introduction a la Philosophie,7,La Verite,7,809,2,QCM,0.04,0.75,88.58,89,12,101,97,89,8,1.04,91.75,Moyen,Facile,1,Plus Facile,Pas Adapte,Philosophy
5304,2019,Philosophie,1,Introduction a la Philosophie,7,La Verite,7,809,2,QCM,0.1,0.71,66.11,72,37,109,102,72,30,1.07,70.59,Facile,Facile,0,Meme Difficulté,Adapte,Philosophy
6428,2020,Philosophie,1,Introduction a la Philosophie,7,La Verite,7,809,2,QCM,0.03,0.78,66.11,82,42,124,115,82,33,1.08,71.3,Facile,Facile,0,Meme Difficulté,Adapte,Philosophy
809,2015,Philosophie,1,Introduction a la Philosophie,7,La Verite,7,810,3,QCU,0.43,0.3,19.96,11,43,54,25,11,14,2.16,44.0,Moyen,Difficile,-1,Plus Difficile,Pas Adapte,Philosophy
1933,2016,Philosophie,1,Introduction a la Philosophie,7,La Verite,7,810,3,QCU,0.47,0.23,24.09,14,46,60,44,14,30,1.36,31.82,Difficile,Difficile,0,Meme Difficulté,Pas Adapte,Philosophy
3057,2017,Philosophie,1,Introduction a la Philosophie,7,La Verite,7,810,3,QCU,0.72,0.38,1.33,1,67,68,66,1,65,1.03,1.52,Facile,Difficile,-2,Beaucoup plus Difficile,Pas Adapte,Philosophy
4181,2018,Philosophie,1,Introduction a la Philosophie,7,La Verite,7,810,3,QROC,0.91,0.18,18.38,13,58,71,56,13,43,1.27,23.21,Moyen,Difficile,-1,Plus Difficile,Pas Adapte,Philosophy
5305,2019,Philosophie,1,Introduction a la Philosophie,7,La Verite,7,810,3,QROC,0.28,0.28,50.72,40,38,78,46,40,6,1.7,86.96,Moyen,Moyen,0,Meme Difficulté,Pas Adapte,Philosophy
6429,2020,Philosophie,1,Introduction a la Philosophie,7,La Verite,7,810,3,QCM,0.3,0.64,63.67,43,24,67,53,43,10,1.26,81.13,Facile,Moyen,-1,Plus Difficile,Adapte,Philosophy
810,2015,Philosophie,1,Introduction a la Philosophie,7,La Verite,7,811,4,QROC,0.97,0.15,20.26,17,69,86,72,17,55,1.19,23.61,Facile,Difficile,-2,Beaucoup plus Difficile,Pas Adapte,Philosophy
1934,2016,Philosophie,1,Introduction a la Philosophie,7,La Verite,7,811,4,QROC,0.04,0.85,89.78,66,7,73,73,66,7,1.0,90.41,Difficile,Facile,2,Beaucoup plus Facile,Pas Adapte,Philosophy
3058,2017,Philosophie,1,Introduction a la Philosophie,7,La Verite,7,811,4,QROC,0.4,0.31,43.45,36,47,83,67,36,31,1.24,53.73,Difficile,Moyen,1,Plus Facile,Pas Adapte,Philosophy
4182,2018,Philosophie,1,Introduction a la Philosophie,7,La Verite,7,811,4,QROC,0.08,0.5,91.27,68,6,74,71,68,3,1.04,95.77,Facile,Facile,0,Meme Difficulté,Pas Adapte,Philosophy
5306,2019,Philosophie,1,Introduction a la Philosophie,7,La Verite,7,811,4,QROC,0.8,0.02,22.58,15,51,66,49,15,34,1.35,30.61,Facile,Difficile,-2,Beaucoup plus Difficile,Pas Adapte,Philosophy
6430,2020,Philosophie,1,Introduction a la Philosophie,7,La Verite,7,811,4,QROC,0.66,0.09,7.9,5,61,66,41,5,36,1.61,12.2,Moyen,Difficile,-1,Plus Difficile,Pas Adapte,Philosophy
811,2015,Philosophie,1,Introduction a la Philosophie,7,La Verite,7,812,5,QCM,0.33,0.68,37.7,18,29,47,37,18,19,1.27,48.65,Moyen,Moyen,0,Meme Difficulté,Pas Adapte,Philosophy
1935,2016,Philosophie,1,Introduction a la Philosophie,7,La Verite,7,812,5,QCM,0.65,0.29,30.82,14,32,46,24,14,10,1.92,58.33,Facile,Difficile,-2,Beaucoup plus Difficile,Pas Adapte,Philosophy
3059,2017,Philosophie,1,Introduction a la Philosophie,7,La Verite,7,812,5,QCM,0.72,0.23,12.2,6,47,53,19,6,13,2.79,31.58,Facile,Difficile,-2,Beaucoup plus Difficile,Pas Adapte,Philosophy
4183,2018,Philosophie,1,Introduction a la Philosophie,7,La Verite,7,812,5,QCM,0.15,0.71,96.56,49,2,51,50,49,1,1.02,98.0,Difficile,Facile,2,Beaucoup plus Facile,Pas Adapte,Philosophy
5307,2019,Philosophie,1,Introduction a la Philosophie,7,La Verite,7,812,5,QCM,0.33,0.37,42.75,21,28,49,49,21,28,1.0,42.86,Moyen,Moyen,0,Meme Difficulté,Pas Adapte,Philosophy
6431,2020,Philosophie,1,Introduction a la Philosophie,7,La Verite,7,812,5,QCU,0.34,0.48,47.96,21,22,43,22,21,1,1.95,95.45,Moyen,Moyen,0,Meme Difficulté,Pas Adapte,Philosophy
812,2015,Philosophie,1,Introduction a la Philosophie,7,La Verite,7,813,6,QO,0.78,0.0,28.56,6,16,22,14,6,8,1.57,42.86,Moyen,Difficile,-1,Plus Difficile,Pas Adapte,Philosophy
1936,2016,Philosophie,1,Introduction a la Philosophie,7,La Verite,7,813,6,QO,0.26,0.23,37.19,8,13,21,19,8,11,1.11,42.11,Difficile,Moyen,1,Plus Facile,Pas Adapte,Philosophy
3060,2017,Philosophie,1,Introduction a la Philosophie,7,La Verite,7,813,6,QO,0.21,0.18,41.63,8,12,20,14,8,6,1.43,57.14,Difficile,Moyen,1,Plus Facile,Pas Adapte,Philosophy
4184,2018,Philosophie,1,Introduction a la Philosophie,7,La Verite,7,813,6,QO,0.9,0.12,0.99,0,17,17,13,0,13,1.31,0.0,Facile,Difficile,-2,Beaucoup plus Difficile,Pas Adapte,Philosophy
5308,2019,Philosophie,1,Introduction a la Philosophie,7,La Verite,7,813,6,QO,0.94,0.01,12.74,3,17,20,18,3,15,1.11,16.67,Difficile,Difficile,0,Meme Difficulté,Pas Adapte,Philosophy
6432,2020,Philosophie,1,Introduction a la Philosophie,7,La Verite,7,813,6,QO,0.79,0.08,31.0,7,16,23,23,7,16,1.0,30.43,Difficile,Difficile,0,Meme Difficulté,Pas Adapte,Philosophy
813,2015,Philosophie,1,Introduction a la Philosophie,7,La Verite,7,814,7,QCU,0.2,0.82,98.37,95,2,97,95,95,0,1.02,100.0,Facile,Facile,0,Meme Difficulté,Pas Adapte,Philosophy
1937,2016,Philosophie,1,Introduction a la Philosophie,7,La Verite,7,814,7,QCU,0.37,0.55,43.51,49,63,112,103,49,54,1.09,47.57,Facile,Moyen,-1,Plus Difficile,Pas Adapte,Philosophy
3061,2017,Philosophie,1,Introduction a la Philosophie,7,La Verite,7,814,7,QCU,0.54,0.27,29.64,33,79,112,53,33,20,2.11,62.26,Difficile,Difficile,0,Meme Difficulté,Pas Adapte,Philosophy
4185,2018,Philosophie,1,Introduction a la Philosophie,7,La Verite,7,814,7,QCU,0.1,1.0,83.32,101,20,121,118,101,17,1.03,85.59,Difficile,Facile,2,Beaucoup plus Facile,Pas Adapte,Philosophy
5309,2019,Philosophie,1,Introduction a la Philosophie,7,La Verite,7,814,7,QCU,0.02,0.76,77.68,88,25,113,90,88,2,1.26,97.78,Facile,Facile,0,Meme Difficulté,Pas Adapte,Philosophy
6433,2020,Philosophie,1,Introduction a la Philosophie,7,La Verite,7,814,7,QCU,0.03,0.99,87.87,94,13,107,94,94,0,1.14,100.0,Moyen,Facile,1,Plus Facile,Pas Adapte,Philosophy
814,2015,Philosophie,1,Introduction a la Philosophie,8,La Conscience,11,815,1,QCM,0.76,0.25,26.3,7,20,27,14,7,7,1.93,50.0,Facile,Difficile,-2,Beaucoup plus Difficile,Pas Adapte,Philosophy
1938,2016,Philosophie,1,Introduction a la Philosophie,8,La Conscience,11,815,1,QCU,0.7,0.25,33.29,9,17,26,15,9,6,1.73,60.0,Facile,Difficile,-2,Beaucoup plus Difficile,Pas Adapte,Philosophy
3062,2017,Philosophie,1,Introduction a la Philosophie,8,La Conscience,11,815,1,QCU,0.57,0.29,6.54,1,21,22,21,1,20,1.05,4.76,Facile,Difficile,-2,Beaucoup plus Difficile,Pas Adapte,Philosophy
4186,2018,Philosophie,1,Introduction a la Philosophie,8,La Conscience,11,815,1,QCU,0.12,0.93,95.54,20,1,21,21,20,1,1.0,95.24,Difficile,Facile,2,Beaucoup plus Facile,Pas Adapte,Philosophy
5310,2019,Philosophie,1,Introduction a la Philosophie,8,La Conscience,11,815,1,QCM,0.61,0.23,11.01,2,16,18,7,2,5,2.57,28.57,Difficile,Difficile,0,Meme Difficulté,Pas Adapte,Philosophy
6434,2020,Philosophie,1,Introduction a la Philosophie,8,La Conscience,11,815,1,QCM,0.01,0.71,96.91,18,1,19,18,18,0,1.06,100.0,Moyen,Facile,1,Plus Facile,Pas Adapte,Philosophy
815,2015,Philosophie,1,Introduction a la Philosophie,8,La Conscience,11,816,2,QCU,0.58,0.27,4.63,2,38,40,37,2,35,1.08,5.41,Facile,Difficile,-2,Beaucoup plus Difficile,Pas Adapte,Philosophy
1939,2016,Philosophie,1,Introduction a la Philosophie,8,La Conscience,11,816,2,QCU,0.14,0.88,67.41,28,13,41,36,28,8,1.14,77.78,Moyen,Facile,1,Plus Facile,Adapte,Philosophy
3063,2017,Philosophie,1,Introduction a la Philosophie,8,La Conscience,11,816,2,QCM,0.19,0.71,67.41,28,13,41,36,28,8,1.14,77.78,Facile,Facile,0,Meme Difficulté,Adapte,Philosophy
4187,2018,Philosophie,1,Introduction a la Philosophie,8,La Conscience,11,816,2,QCM,0.09,0.74,67.41,30,14,44,32,30,2,1.38,93.75,Facile,Facile,0,Meme Difficulté,Adapte,Philosophy
5311,2019,Philosophie,1,Introduction a la Philosophie,8,La Conscience,11,816,2,QCM,0.16,0.77,67.41,28,14,42,31,28,3,1.35,90.32,Facile,Facile,0,Meme Difficulté,Adapte,Philosophy
6435,2020,Philosophie,1,Introduction a la Philosophie,8,La Conscience,11,816,2,QROC,0.03,0.65,67.41,32,16,48,47,32,15,1.02,68.09,Facile,Facile,0,Meme Difficulté,Adapte,Philosophy
816,2015,Philosophie,1,Introduction a la Philosophie,8,La Conscience,11,817,3,QCU,0.36,0.44,38.77,16,25,41,22,16,6,1.86,72.73,Difficile,Moyen,1,Plus Facile,Pas Adapte,Philosophy
1940,2016,Philosophie,1,Introduction a la Philosophie,8,La Conscience,11,817,3,QCU,0.08,0.85,93.01,44,3,47,47,44,3,1.0,93.62,Facile,Facile,0,Meme Difficulté,Pas Adapte,Philosophy
3064,2017,Philosophie,1,Introduction a la Philosophie,8,La Conscience,11,817,3,QCU,0.54,0.32,21.5,10,36,46,36,10,26,1.28,27.78,Facile,Difficile,-2,Beaucoup plus Difficile,Pas Adapte,Philosophy
4188,2018,Philosophie,1,Introduction a la Philosophie,8,La Conscience,11,817,3,QCU,0.03,0.86,74.85,34,12,46,37,34,3,1.24,91.89,Difficile,Facile,2,Beaucoup plus Facile,Adapte,Philosophy
5312,2019,Philosophie,1,Introduction a la Philosophie,8,La Conscience,11,817,3,QCU,0.18,0.94,74.85,32,11,43,33,32,1,1.3,96.97,Facile,Facile,0,Meme Difficulté,Adapte,Philosophy
6436,2020,Philosophie,1,Introduction a la Philosophie,8,La Conscience,11,817,3,QCU,0.09,0.95,74.85,28,9,37,29,28,1,1.28,96.55,Facile,Facile,0,Meme Difficulté,Adapte,Philosophy
817,2015,Philosophie,1,Introduction a la Philosophie,8,La Conscience,11,818,4,QCM,0.46,0.36,47.36,14,16,30,17,14,3,1.76,82.35,Difficile,Moyen,1,Plus Facile,Pas Adapte,Philosophy
1941,2016,Philosophie,1,Introduction a la Philosophie,8,La Conscience,11,818,4,QCM,0.13,0.95,82.04,23,5,28,25,23,2,1.12,92.0,Facile,Facile,0,Meme Difficulté,Pas Adapte,Philosophy
3065,2017,Philosophie,1,Introduction a la Philosophie,8,La Conscience,11,818,4,QCM,0.31,0.69,63.53,17,10,27,26,17,9,1.04,65.38,Difficile,Moyen,1,Plus Facile,Adapte,Philosophy
4189,2018,Philosophie,1,Introduction a la Philosophie,8,La Conscience,11,818,4,QCM,0.39,0.48,63.53,15,9,24,16,15,1,1.5,93.75,Moyen,Moyen,0,Meme Difficulté,Adapte,Philosophy
5313,2019,Philosophie,1,Introduction a la Philosophie,8,La Conscience,11,818,4,QCM,0.4,0.59,63.53,18,10,28,21,18,3,1.33,85.71,Moyen,Moyen,0,Meme Difficulté,Adapte,Philosophy
6437,2020,Philosophie,1,Introduction a la Philosophie,8,La Conscience,11,818,4,QCM,0.3,0.36,63.53,18,10,28,26,18,8,1.08,69.23,Moyen,Moyen,0,Meme Difficulté,Adapte,Philosophy
818,2015,Philosophie,1,Introduction a la Philosophie,8,La Conscience,11,819,5,QCU,0.5,0.32,5.89,6,88,94,52,6,46,1.81,11.54,Difficile,Difficile,0,Meme Difficulté,Pas Adapte,Philosophy
1942,2016,Philosophie,1,Introduction a la Philosophie,8,La Conscience,11,819,5,QCM,0.03,0.84,76.62,70,21,91,76,70,6,1.2,92.11,Moyen,Facile,1,Plus Facile,Pas Adapte,Philosophy
3066,2017,Philosophie,1,Introduction a la Philosophie,8,La Conscience,11,819,5,QCM,0.18,0.91,74.04,59,21,80,73,59,14,1.1,80.82,Moyen,Facile,1,Plus Facile,Adapte,Philosophy
4190,2018,Philosophie,1,Introduction a la Philosophie,8,La Conscience,11,819,5,QROC,0.06,0.78,74.04,59,21,80,71,59,12,1.13,83.1,Facile,Facile,0,Meme Difficulté,Adapte,Philosophy
5314,2019,Philosophie,1,Introduction a la Philosophie,8,La Conscience,11,819,5,QROC,0.17,0.98,74.04,66,23,89,68,66,2,1.31,97.06,Facile,Facile,0,Meme Difficulté,Adapte,Philosophy
6438,2020,Philosophie,1,Introduction a la Philosophie,8,La Conscience,11,819,5,QROC,0.15,0.66,74.04,65,23,88,82,65,17,1.07,79.27,Facile,Facile,0,Meme Difficulté,Adapte,Philosophy
819,2015,Philosophie,1,Introduction a la Philosophie,8,La Conscience,11,820,6,QCU,0.38,0.54,36.93,33,57,90,36,33,3,2.5,91.67,Facile,Moyen,-1,Plus Difficile,Pas Adapte,Philosophy
1943,2016,Philosophie,1,Introduction a la Philosophie,8,La Conscience,11,820,6,QCM,0.03,0.79,75.77,64,21,85,66,64,2,1.29,96.97,Facile,Facile,0,Meme Difficulté,Pas Adapte,Philosophy
3067,2017,Philosophie,1,Introduction a la Philosophie,8,La Conscience,11,820,6,QCM,0.07,0.93,66.56,61,31,92,68,61,7,1.35,89.71,Facile,Facile,0,Meme Difficulté,Adapte,Philosophy
4191,2018,Philosophie,1,Introduction a la Philosophie,8,La Conscience,11,820,6,QCM,0.08,0.92,66.56,69,35,104,103,69,34,1.01,66.99,Facile,Facile,0,Meme Difficulté,Adapte,Philosophy
5315,2019,Philosophie,1,Introduction a la Philosophie,8,La Conscience,11,820,6,QCM,0.01,0.75,66.56,76,38,114,103,76,27,1.11,73.79,Facile,Facile,0,Meme Difficulté,Adapte,Philosophy
6439,2020,Philosophie,1,Introduction a la Philosophie,8,La Conscience,11,820,6,QCM,0.06,0.92,66.56,81,40,121,89,81,8,1.36,91.01,Facile,Facile,0,Meme Difficulté,Adapte,Philosophy
820,2015,Philosophie,1,Introduction a la Philosophie,8,La Conscience,11,821,7,QCU,0.37,0.73,57.23,10,7,17,16,10,6,1.06,62.5,Moyen,Moyen,0,Meme Difficulté,Pas Adapte,Philosophy
1944,2016,Philosophie,1,Introduction a la Philosophie,8,La Conscience,11,821,7,QCU,0.04,0.93,90.02,13,1,14,14,13,1,1.0,92.86,Moyen,Facile,1,Plus Facile,Pas Adapte,Philosophy
3068,2017,Philosophie,1,Introduction a la Philosophie,8,La Conscience,11,821,7,QCU,0.7,0.28,16.7,2,10,12,5,2,3,2.4,40.0,Difficile,Difficile,0,Meme Difficulté,Pas Adapte,Philosophy
4192,2018,Philosophie,1,Introduction a la Philosophie,8,La Conscience,11,821,7,QCU,0.24,0.72,58.09,6,4,10,8,6,2,1.25,75.0,Facile,Moyen,-1,Plus Difficile,Pas Adapte,Philosophy
5316,2019,Philosophie,1,Introduction a la Philosophie,8,La Conscience,11,821,7,QCU,0.35,0.57,49.6,4,5,9,6,4,2,1.5,66.67,Difficile,Moyen,1,Plus Facile,Pas Adapte,Philosophy
6440,2020,Philosophie,1,Introduction a la Philosophie,8,La Conscience,11,821,7,QCU,0.65,0.2,5.91,1,9,10,6,1,5,1.67,16.67,Moyen,Difficile,-1,Plus Difficile,Pas Adapte,Philosophy
821,2015,Philosophie,1,Introduction a la Philosophie,8,La Conscience,11,822,8,QCU,0.08,0.95,96.23,12,0,12,12,12,0,1.0,100.0,Moyen,Facile,1,Plus Facile,Pas Adapte,Philosophy
1945,2016,Philosophie,1,Introduction a la Philosophie,8,La Conscience,11,822,8,QCU,0.01,0.79,98.49,12,0,12,12,12,0,1.0,100.0,Moyen,Facile,1,Plus Facile,Pas Adapte,Philosophy
3069,2017,Philosophie,1,Introduction a la Philosophie,8,La Conscience,11,822,8,QCU,0.72,0.37,13.27,1,9,10,4,1,3,2.5,25.0,Difficile,Difficile,0,Meme Difficulté,Pas Adapte,Philosophy
4193,2018,Philosophie,1,Introduction a la Philosophie,8,La Conscience,11,822,8,QCU,0.6,0.22,25.85,2,7,9,8,2,6,1.12,25.0,Difficile,Difficile,0,Meme Difficulté,Pas Adapte,Philosophy
5317,2019,Philosophie,1,Introduction a la Philosophie,8,La Conscience,11,822,8,QCU,0.07,0.92,80.19,6,2,8,7,6,1,1.14,85.71,Difficile,Facile,2,Beaucoup plus Facile,Pas Adapte,Philosophy
6441,2020,Philosophie,1,Introduction a la Philosophie,8,La Conscience,11,822,8,QCU,0.26,0.66,52.1,4,4,8,7,4,3,1.14,57.14,Facile,Moyen,-1,Plus Difficile,Pas Adapte,Philosophy
822,2015,Philosophie,1,Introduction a la Philosophie,8,La Conscience,11,823,9,QCM,0.1,0.83,80.62,46,11,57,48,46,2,1.19,95.83,Difficile,Facile,2,Beaucoup plus Facile,Pas Adapte,Philosophy
1946,2016,Philosophie,1,Introduction a la Philosophie,8,La Conscience,11,823,9,QCM,0.37,0.34,51.65,31,29,60,46,31,15,1.3,67.39,Facile,Moyen,-1,Plus Difficile,Pas Adapte,Philosophy
3070,2017,Philosophie,1,Introduction a la Philosophie,8,La Conscience,11,823,9,QCM,0.37,0.35,57.83,40,29,69,66,40,26,1.05,60.61,Facile,Moyen,-1,Plus Difficile,Pas Adapte,Philosophy
4194,2018,Philosophie,1,Introduction a la Philosophie,8,La Conscience,11,823,9,QCM,0.64,0.18,13.48,11,68,79,68,11,57,1.16,16.18,Facile,Difficile,-2,Beaucoup plus Difficile,Pas Adapte,Philosophy
5318,2019,Philosophie,1,Introduction a la Philosophie,8,La Conscience,11,823,9,QO,0.59,0.17,42.08,29,41,70,35,29,6,2.0,82.86,Difficile,Moyen,1,Plus Facile,Pas Adapte,Philosophy
6442,2020,Philosophie,1,Introduction a la Philosophie,8,La Conscience,11,823,9,QO,0.04,0.67,99.27,72,1,73,72,72,0,1.01,100.0,Difficile,Facile,2,Beaucoup plus Facile,Pas Adapte,Philosophy
823,2015,Philosophie,1,Introduction a la Philosophie,8,La Conscience,11,824,10,QROC,0.24,0.27,58.87,21,15,36,35,21,14,1.03,60.0,Facile,Moyen,-1,Plus Difficile,Pas Adapte,Philosophy
1947,2016,Philosophie,1,Introduction a la Philosophie,8,La Conscience,11,824,10,QROC,0.89,0.09,18.28,6,28,34,23,6,17,1.48,26.09,Moyen,Difficile,-1,Plus Difficile,Pas Adapte,Philosophy
3071,2017,Philosophie,1,Introduction a la Philosophie,8,La Conscience,11,824,10,QROC,0.2,0.27,44.18,16,21,37,32,16,16,1.16,50.0,Facile,Moyen,-1,Plus Difficile,Pas Adapte,Philosophy
4195,2018,Philosophie,1,Introduction a la Philosophie,8,La Conscience,11,824,10,QROC,0.12,0.92,66.08,24,12,36,36,24,12,1.0,66.67,Moyen,Facile,1,Plus Facile,Adapte,Philosophy
5319,2019,Philosophie,1,Introduction a la Philosophie,8,La Conscience,11,824,10,QROC,0.12,0.45,66.08,21,11,32,24,21,3,1.33,87.5,Facile,Facile,0,Meme Difficulté,Adapte,Philosophy
6443,2020,Philosophie,1,Introduction a la Philosophie,8,La Conscience,11,824,10,QROC,0.15,0.41,66.08,24,13,37,34,24,10,1.09,70.59,Facile,Facile,0,Meme Difficulté,Adapte,Philosophy
824,2015,Philosophie,1,Introduction a la Philosophie,8,La Conscience,11,825,11,QROC,0.79,0.05,2.3,1,63,64,61,1,60,1.05,1.64,Facile,Difficile,-2,Beaucoup plus Difficile,Pas Adapte,Philosophy
1948,2016,Philosophie,1,Introduction a la Philosophie,8,La Conscience,11,825,11,QROC,0.94,0.18,26.31,15,43,58,41,15,26,1.41,36.59,Moyen,Difficile,-1,Plus Difficile,Pas Adapte,Philosophy
3072,2017,Philosophie,1,Introduction a la Philosophie,8,La Conscience,11,825,11,QROC,0.76,0.24,7.98,4,45,49,28,4,24,1.75,14.29,Moyen,Difficile,-1,Plus Difficile,Pas Adapte,Philosophy
4196,2018,Philosophie,1,Introduction a la Philosophie,8,La Conscience,11,825,11,QROC,0.87,0.25,14.39,8,47,55,29,8,21,1.9,27.59,Difficile,Difficile,0,Meme Difficulté,Pas Adapte,Philosophy
5320,2019,Philosophie,1,Introduction a la Philosophie,8,La Conscience,11,825,11,QROC,0.99,0.23,29.72,15,34,49,39,15,24,1.26,38.46,Moyen,Difficile,-1,Plus Difficile,Pas Adapte,Philosophy
6444,2020,Philosophie,1,Introduction a la Philosophie,8,La Conscience,11,825,11,QROC,0.19,0.97,67.99,37,18,55,38,37,1,1.45,97.37,Facile,Facile,0,Meme Difficulté,Adapte,Philosophy
825,2015,Philosophie,1,Introduction a la Philosophie,9,La Liberte,5,826,1,QCU,0.08,0.84,94.2,24,1,25,24,24,0,1.04,100.0,Facile,Facile,0,Meme Difficulté,Pas Adapte,Philosophy
1949,2016,Philosophie,1,Introduction a la Philosophie,9,La Liberte,5,826,1,QCU,0.12,0.88,71.27,20,8,28,27,20,7,1.04,74.07,Facile,Facile,0,Meme Difficulté,Adapte,Philosophy
3073,2017,Philosophie,1,Introduction a la Philosophie,9,La Liberte,5,826,1,QCU,0.13,0.96,71.27,21,8,29,23,21,2,1.26,91.3,Facile,Facile,0,Meme Difficulté,Adapte,Philosophy
4197,2018,Philosophie,1,Introduction a la Philosophie,9,La Liberte,5,826,1,QCU,0.16,0.95,71.27,24,9,33,30,24,6,1.1,80.0,Facile,Facile,0,Meme Difficulté,Adapte,Philosophy
5321,2019,Philosophie,1,Introduction a la Philosophie,9,La Liberte,5,826,1,QCU,0.18,0.9,71.27,20,8,28,23,20,3,1.22,86.96,Facile,Facile,0,Meme Difficulté,Adapte,Philosophy
6445,2020,Philosophie,1,Introduction a la Philosophie,9,La Liberte,5,826,1,QCU,0.02,0.8,71.27,23,9,32,27,23,4,1.19,85.19,Facile,Facile,0,Meme Difficulté,Adapte,Philosophy
826,2015,Philosophie,1,Introduction a la Philosophie,9,La Liberte,5,827,2,QCU,0.18,0.96,65.46,16,9,25,22,16,6,1.14,72.73,Moyen,Facile,1,Plus Facile,Adapte,Philosophy
1950,2016,Philosophie,1,Introduction a la Philosophie,9,La Liberte,5,827,2,QCU,0.0,0.81,65.46,14,7,21,18,14,4,1.17,77.78,Facile,Facile,0,Meme Difficulté,Adapte,Philosophy
3074,2017,Philosophie,1,Introduction a la Philosophie,9,La Liberte,5,827,2,QCU,0.04,0.99,65.46,14,8,22,17,14,3,1.29,82.35,Facile,Facile,0,Meme Difficulté,Adapte,Philosophy
4198,2018,Philosophie,1,Introduction a la Philosophie,9,La Liberte,5,827,2,QCU,0.02,0.78,65.46,16,9,25,19,16,3,1.32,84.21,Facile,Facile,0,Meme Difficulté,Adapte,Philosophy
5322,2019,Philosophie,1,Introduction a la Philosophie,9,La Liberte,5,827,2,QCU,0.17,0.78,65.46,18,9,27,23,18,5,1.17,78.26,Facile,Facile,0,Meme Difficulté,Adapte,Philosophy
6446,2020,Philosophie,1,Introduction a la Philosophie,9,La Liberte,5,827,2,QCU,0.12,0.88,65.46,15,8,23,18,15,3,1.28,83.33,Facile,Facile,0,Meme Difficulté,Adapte,Philosophy
827,2015,Philosophie,1,Introduction a la Philosophie,9,La Liberte,5,828,3,QROC,0.87,0.19,16.36,2,12,14,6,2,4,2.33,33.33,Facile,Difficile,-2,Beaucoup plus Difficile,Pas Adapte,Philosophy
1951,2016,Philosophie,1,Introduction a la Philosophie,9,La Liberte,5,828,3,QCM,0.17,0.95,74.91,10,4,14,14,10,4,1.0,71.43,Moyen,Facile,1,Plus Facile,Adapte,Philosophy
3075,2017,Philosophie,1,Introduction a la Philosophie,9,La Liberte,5,828,3,QCU,0.06,0.88,74.91,11,4,15,13,11,2,1.15,84.62,Facile,Facile,0,Meme Difficulté,Adapte,Philosophy
4199,2018,Philosophie,1,Introduction a la Philosophie,9,La Liberte,5,828,3,QCU,0.2,0.89,74.91,11,4,15,14,11,3,1.07,78.57,Facile,Facile,0,Meme Difficulté,Adapte,Philosophy
5323,2019,Philosophie,1,Introduction a la Philosophie,9,La Liberte,5,828,3,QCU,0.19,0.94,74.91,11,4,15,13,11,2,1.15,84.62,Facile,Facile,0,Meme Difficulté,Adapte,Philosophy
6447,2020,Philosophie,1,Introduction a la Philosophie,9,La Liberte,5,828,3,QCU,0.17,0.84,74.91,10,3,13,12,10,2,1.08,83.33,Facile,Facile,0,Meme Difficulté,Adapte,Philosophy
828,2015,Philosophie,1,Introduction a la Philosophie,9,La Liberte,5,829,4,QCM,0.06,0.75,87.25,62,9,71,67,62,5,1.06,92.54,Moyen,Facile,1,Plus Facile,Pas Adapte,Philosophy
1952,2016,Philosophie,1,Introduction a la Philosophie,9,La Liberte,5,829,4,QCM,0.15,0.75,79.15,48,13,61,49,48,1,1.24,97.96,Difficile,Facile,2,Beaucoup plus Facile,Pas Adapte,Philosophy
3076,2017,Philosophie,1,Introduction a la Philosophie,9,La Liberte,5,829,4,QCM,0.7,0.26,21.62,11,41,52,36,11,25,1.44,30.56,Difficile,Difficile,0,Meme Difficulté,Pas Adapte,Philosophy
4200,2018,Philosophie,1,Introduction a la Philosophie,9,La Liberte,5,829,4,QCM,0.23,0.43,48.23,27,30,57,46,27,19,1.24,58.7,Facile,Moyen,-1,Plus Difficile,Pas Adapte,Philosophy
5324,2019,Philosophie,1,Introduction a la Philosophie,9,La Liberte,5,829,4,QCM,0.12,0.84,89.0,59,7,66,59,59,0,1.12,100.0,Difficile,Facile,2,Beaucoup plus Facile,Pas Adapte,Philosophy
6448,2020,Philosophie,1,Introduction a la Philosophie,9,La Liberte,5,829,4,QCM,0.02,0.82,75.48,54,17,71,55,54,1,1.29,98.18,Facile,Facile,0,Meme Difficulté,Pas Adapte,Philosophy
829,2015,Philosophie,1,Introduction a la Philosophie,9,La Liberte,5,830,5,QCU,0.2,0.95,93.25,82,6,88,85,82,3,1.04,96.47,Facile,Facile,0,Meme Difficulté,Pas Adapte,Philosophy
1953,2016,Philosophie,1,Introduction a la Philosophie,9,La Liberte,5,830,5,QCU,0.39,0.73,43.64,37,47,84,49,37,12,1.71,75.51,Moyen,Moyen,0,Meme Difficulté,Pas Adapte,Philosophy
3077,2017,Philosophie,1,Introduction a la Philosophie,9,La Liberte,5,830,5,QCU,0.0,0.8,69.69,59,25,84,74,59,15,1.14,79.73,Difficile,Facile,2,Beaucoup plus Facile,Adapte,Philosophy
4201,2018,Philosophie,1,Introduction a la Philosophie,9,La Liberte,5,830,5,QCU,0.1,0.94,69.69,68,29,97,86,68,18,1.13,79.07,Facile,Facile,0,Meme Difficulté,Adapte,Philosophy
5325,2019,Philosophie,1,Introduction a la Philosophie,9,La Liberte,5,830,5,QCU,0.15,0.85,69.69,77,33,110,108,77,31,1.02,71.3,Facile,Facile,0,Meme Difficulté,Adapte,Philosophy
6449,2020,Philosophie,1,Introduction a la Philosophie,9,La Liberte,5,830,5,QCU,0.07,0.92,69.69,87,38,125,109,87,22,1.15,79.82,Facile,Facile,0,Meme Difficulté,Adapte,Philosophy
830,2015,Philosophie,2,La Notion de Logique,1,Les Lois Logiques,1,831,1,QCU,0.16,0.93,99.5,31,0,31,31,31,0,1.0,100.0,Facile,Facile,0,Meme Difficulté,Pas Adapte,Philosophy
1954,2016,Philosophie,2,La Notion de Logique,1,Les Lois Logiques,1,831,1,QCU,0.45,0.34,9.65,3,29,32,30,3,27,1.07,10.0,Moyen,Difficile,-1,Plus Difficile,Pas Adapte,Philosophy
3078,2017,Philosophie,2,La Notion de Logique,1,Les Lois Logiques,1,831,1,QCU,0.35,0.5,43.19,14,18,32,16,14,2,2.0,87.5,Moyen,Moyen,0,Meme Difficulté,Pas Adapte,Philosophy
4202,2018,Philosophie,2,La Notion de Logique,1,Les Lois Logiques,1,831,1,QCU,0.15,0.75,68.11,19,9,28,26,19,7,1.08,73.08,Difficile,Facile,2,Beaucoup plus Facile,Adapte,Philosophy
5326,2019,Philosophie,2,La Notion de Logique,1,Les Lois Logiques,1,831,1,QCU,0.16,0.85,68.11,21,10,31,25,21,4,1.24,84.0,Facile,Facile,0,Meme Difficulté,Adapte,Philosophy
6450,2020,Philosophie,2,La Notion de Logique,1,Les Lois Logiques,1,831,1,QCU,0.13,0.82,68.11,22,11,33,26,22,4,1.27,84.62,Facile,Facile,0,Meme Difficulté,Adapte,Philosophy
831,2015,Philosophie,2,La Notion de Logique,2,Les Raisonnements Valides,7,832,1,QCM,0.68,0.19,7.6,2,18,20,19,2,17,1.05,10.53,Difficile,Difficile,0,Meme Difficulté,Pas Adapte,Philosophy
1955,2016,Philosophie,2,La Notion de Logique,2,Les Raisonnements Valides,7,832,1,QCU,0.7,0.38,15.89,3,16,19,13,3,10,1.46,23.08,Facile,Difficile,-2,Beaucoup plus Difficile,Pas Adapte,Philosophy
3079,2017,Philosophie,2,La Notion de Logique,2,Les Raisonnements Valides,7,832,1,QCU,0.1,0.97,86.46,14,2,16,16,14,2,1.0,87.5,Facile,Facile,0,Meme Difficulté,Pas Adapte,Philosophy
4203,2018,Philosophie,2,La Notion de Logique,2,Les Raisonnements Valides,7,832,1,QCU,0.64,0.25,19.87,3,11,14,6,3,3,2.33,50.0,Difficile,Difficile,0,Meme Difficulté,Pas Adapte,Philosophy
5327,2019,Philosophie,2,La Notion de Logique,2,Les Raisonnements Valides,7,832,1,QCU,0.24,0.45,49.59,8,8,16,10,8,2,1.6,80.0,Facile,Moyen,-1,Plus Difficile,Pas Adapte,Philosophy
6451,2020,Philosophie,2,La Notion de Logique,2,Les Raisonnements Valides,7,832,1,QCU,0.03,0.77,80.47,12,3,15,13,12,1,1.15,92.31,Difficile,Facile,2,Beaucoup plus Facile,Pas Adapte,Philosophy
832,2015,Philosophie,2,La Notion de Logique,2,Les Raisonnements Valides,7,833,2,QROC,0.16,0.59,87.78,56,8,64,60,56,4,1.07,93.33,Difficile,Facile,2,Beaucoup plus Facile,Pas Adapte,Philosophy
1956,2016,Philosophie,2,La Notion de Logique,2,Les Raisonnements Valides,7,833,2,QROC,0.9,0.13,32.0,20,41,61,49,20,29,1.24,40.82,Moyen,Difficile,-1,Plus Difficile,Pas Adapte,Philosophy
3080,2017,Philosophie,2,La Notion de Logique,2,Les Raisonnements Valides,7,833,2,QO,0.08,0.55,91.03,57,6,63,62,57,5,1.02,91.94,Moyen,Facile,1,Plus Facile,Pas Adapte,Philosophy
4204,2018,Philosophie,2,La Notion de Logique,2,Les Raisonnements Valides,7,833,2,QCU,0.15,0.88,91.27,62,6,68,65,62,3,1.05,95.38,Moyen,Facile,1,Plus Facile,Pas Adapte,Philosophy
5328,2019,Philosophie,2,La Notion de Logique,2,Les Raisonnements Valides,7,833,2,QCU,0.22,0.51,57.84,40,29,69,45,40,5,1.53,88.89,Facile,Moyen,-1,Plus Difficile,Pas Adapte,Philosophy
6452,2020,Philosophie,2,La Notion de Logique,2,Les Raisonnements Valides,7,833,2,QCU,0.35,0.51,51.57,32,30,62,50,32,18,1.24,64.0,Facile,Moyen,-1,Plus Difficile,Pas Adapte,Philosophy
833,2015,Philosophie,2,La Notion de Logique,2,Les Raisonnements Valides,7,834,3,QCU,0.22,0.74,43.92,6,8,14,9,6,3,1.56,66.67,Moyen,Moyen,0,Meme Difficulté,Pas Adapte,Philosophy
1957,2016,Philosophie,2,La Notion de Logique,2,Les Raisonnements Valides,7,834,3,QCU,0.43,0.36,13.5,2,10,12,9,2,7,1.33,22.22,Facile,Difficile,-2,Beaucoup plus Difficile,Pas Adapte,Philosophy
3081,2017,Philosophie,2,La Notion de Logique,2,Les Raisonnements Valides,7,834,3,QCM,0.19,0.87,83.78,9,2,11,11,9,2,1.0,81.82,Difficile,Facile,2,Beaucoup plus Facile,Pas Adapte,Philosophy
4205,2018,Philosophie,2,La Notion de Logique,2,Les Raisonnements Valides,7,834,3,QCM,0.65,0.3,28.45,3,6,9,5,3,2,1.8,60.0,Moyen,Difficile,-1,Plus Difficile,Pas Adapte,Philosophy
5329,2019,Philosophie,2,La Notion de Logique,2,Les Raisonnements Valides,7,834,3,QCM,0.55,0.22,9.78,1,9,10,7,1,6,1.43,14.29,Difficile,Difficile,0,Meme Difficulté,Pas Adapte,Philosophy
6453,2020,Philosophie,2,La Notion de Logique,2,Les Raisonnements Valides,7,834,3,QCM,0.1,0.82,68.21,8,4,12,10,8,2,1.2,80.0,Facile,Facile,0,Meme Difficulté,Adapte,Philosophy
834,2015,Philosophie,2,La Notion de Logique,2,Les Raisonnements Valides,7,835,4,QROC,0.04,0.62,68.23,18,8,26,23,18,5,1.13,78.26,Facile,Facile,0,Meme Difficulté,Adapte,Philosophy
1958,2016,Philosophie,2,La Notion de Logique,2,Les Raisonnements Valides,7,835,4,QROC,0.11,0.91,68.23,16,8,24,20,16,4,1.2,80.0,Facile,Facile,0,Meme Difficulté,Adapte,Philosophy
3082,2017,Philosophie,2,La Notion de Logique,2,Les Raisonnements Valides,7,835,4,QROC,0.03,0.86,68.23,18,8,26,23,18,5,1.13,78.26,Facile,Facile,0,Meme Difficulté,Adapte,Philosophy
4206,2018,Philosophie,2,La Notion de Logique,2,Les Raisonnements Valides,7,835,4,QROC,0.14,0.93,68.23,18,9,27,21,18,3,1.29,85.71,Facile,Facile,0,Meme Difficulté,Adapte,Philosophy
5330,2019,Philosophie,2,La Notion de Logique,2,Les Raisonnements Valides,7,835,4,QROC,0.02,0.89,68.23,19,9,28,24,19,5,1.17,79.17,Facile,Facile,0,Meme Difficulté,Adapte,Philosophy
6454,2020,Philosophie,2,La Notion de Logique,2,Les Raisonnements Valides,7,835,4,QROC,0.11,0.87,68.23,16,8,24,16,16,0,1.5,100.0,Facile,Facile,0,Meme Difficulté,Adapte,Philosophy
835,2015,Philosophie,2,La Notion de Logique,2,Les Raisonnements Valides,7,836,5,QCU,0.74,0.2,20.58,7,29,36,18,7,11,2.0,38.89,Facile,Difficile,-2,Beaucoup plus Difficile,Pas Adapte,Philosophy
1959,2016,Philosophie,2,La Notion de Logique,2,Les Raisonnements Valides,7,836,5,QCU,0.58,0.39,6.07,2,38,40,22,2,20,1.82,9.09,Moyen,Difficile,-1,Plus Difficile,Pas Adapte,Philosophy
3083,2017,Philosophie,2,La Notion de Logique,2,Les Raisonnements Valides,7,836,5,QO,0.16,0.88,87.7,31,4,35,32,31,1,1.09,96.88,Facile,Facile,0,Meme Difficulté,Pas Adapte,Philosophy
4207,2018,Philosophie,2,La Notion de Logique,2,Les Raisonnements Valides,7,836,5,QO,0.56,0.19,46.3,15,18,33,23,15,8,1.43,65.22,Difficile,Moyen,1,Plus Facile,Pas Adapte,Philosophy
5331,2019,Philosophie,2,La Notion de Logique,2,Les Raisonnements Valides,7,836,5,QO,0.12,0.58,69.25,19,9,28,25,19,6,1.12,76.0,Facile,Facile,0,Meme Difficulté,Adapte,Philosophy
6455,2020,Philosophie,2,La Notion de Logique,2,Les Raisonnements Valides,7,836,5,QO,0.09,0.6,69.25,17,8,25,25,17,8,1.0,68.0,Facile,Facile,0,Meme Difficulté,Adapte,Philosophy
836,2015,Philosophie,2,La Notion de Logique,2,Les Raisonnements Valides,7,837,6,QCM,0.74,0.16,2.36,1,54,55,28,1,27,1.96,3.57,Difficile,Difficile,0,Meme Difficulté,Pas Adapte,Philosophy
1960,2016,Philosophie,2,La Notion de Logique,2,Les Raisonnements Valides,7,837,6,QCM,0.01,0.89,65.66,32,16,48,44,32,12,1.09,72.73,Facile,Facile,0,Meme Difficulté,Adapte,Philosophy
3084,2017,Philosophie,2,La Notion de Logique,2,Les Raisonnements Valides,7,837,6,QCM,0.01,0.83,65.66,35,18,53,45,35,10,1.18,77.78,Facile,Facile,0,Meme Difficulté,Adapte,Philosophy
4208,2018,Philosophie,2,La Notion de Logique,2,Les Raisonnements Valides,7,837,6,QCM,0.02,0.99,65.66,34,18,52,41,34,7,1.27,82.93,Facile,Facile,0,Meme Difficulté,Adapte,Philosophy
5332,2019,Philosophie,2,La Notion de Logique,2,Les Raisonnements Valides,7,837,6,QO,0.08,0.75,65.66,36,19,55,48,36,12,1.15,75.0,Facile,Facile,0,Meme Difficulté,Adapte,Philosophy
6456,2020,Philosophie,2,La Notion de Logique,2,Les Raisonnements Valides,7,837,6,QCM,0.08,0.84,65.66,33,17,50,47,33,14,1.06,70.21,Facile,Facile,0,Meme Difficulté,Adapte,Philosophy
837,2015,Philosophie,2,La Notion de Logique,2,Les Raisonnements Valides,7,838,7,QCU,0.74,0.28,13.58,4,25,29,22,4,18,1.32,18.18,Difficile,Difficile,0,Meme Difficulté,Pas Adapte,Philosophy
1961,2016,Philosophie,2,La Notion de Logique,2,Les Raisonnements Valides,7,838,7,QCU,0.11,0.91,85.89,23,4,27,25,23,2,1.08,92.0,Difficile,Facile,2,Beaucoup plus Facile,Pas Adapte,Philosophy
3085,2017,Philosophie,2,La Notion de Logique,2,Les Raisonnements Valides,7,838,7,QCU,0.29,0.49,43.1,13,17,30,18,13,5,1.67,72.22,Difficile,Moyen,1,Plus Facile,Pas Adapte,Philosophy
4209,2018,Philosophie,2,La Notion de Logique,2,Les Raisonnements Valides,7,838,7,QCU,0.0,0.99,87.94,27,4,31,29,27,2,1.07,93.1,Facile,Facile,0,Meme Difficulté,Pas Adapte,Philosophy
5333,2019,Philosophie,2,La Notion de Logique,2,Les Raisonnements Valides,7,838,7,QCU,0.16,0.96,72.07,24,9,33,30,24,6,1.1,80.0,Difficile,Facile,2,Beaucoup plus Facile,Adapte,Philosophy
6457,2020,Philosophie,2,La Notion de Logique,2,Les Raisonnements Valides,7,838,7,QCU,0.02,0.86,72.07,27,10,37,27,27,0,1.37,100.0,Facile,Facile,0,Meme Difficulté,Adapte,Philosophy
838,2015,Philosophie,2,La Notion de Logique,3,Les Paradoxes,12,839,1,QCM,0.17,0.88,69.42,30,13,43,35,30,5,1.23,85.71,Moyen,Facile,1,Plus Facile,Adapte,Philosophy
1962,2016,Philosophie,2,La Notion de Logique,3,Les Paradoxes,12,839,1,QCM,0.13,0.99,69.42,30,13,43,31,30,1,1.39,96.77,Facile,Facile,0,Meme Difficulté,Adapte,Philosophy
3086,2017,Philosophie,2,La Notion de Logique,3,Les Paradoxes,12,839,1,QCM,0.18,0.83,69.42,33,14,47,33,33,0,1.42,100.0,Facile,Facile,0,Meme Difficulté,Adapte,Philosophy
4210,2018,Philosophie,2,La Notion de Logique,3,Les Paradoxes,12,839,1,QCM,0.08,0.71,69.42,36,16,52,41,36,5,1.27,87.8,Facile,Facile,0,Meme Difficulté,Adapte,Philosophy
5334,2019,Philosophie,2,La Notion de Logique,3,Les Paradoxes,12,839,1,QCU,0.19,0.84,69.42,35,16,51,44,35,9,1.16,79.55,Facile,Facile,0,Meme Difficulté,Adapte,Philosophy
6458,2020,Philosophie,2,La Notion de Logique,3,Les Paradoxes,12,839,1,QROC,0.09,0.88,69.42,31,13,44,34,31,3,1.29,91.18,Facile,Facile,0,Meme Difficulté,Adapte,Philosophy
839,2015,Philosophie,2,La Notion de Logique,3,Les Paradoxes,12,840,2,QCM,0.31,0.5,58.01,24,18,42,39,24,15,1.08,61.54,Difficile,Moyen,1,Plus Facile,Pas Adapte,Philosophy
1963,2016,Philosophie,2,La Notion de Logique,3,Les Paradoxes,12,840,2,QCM,0.66,0.27,7.45,3,33,36,20,3,17,1.8,15.0,Difficile,Difficile,0,Meme Difficulté,Pas Adapte,Philosophy
3087,2017,Philosophie,2,La Notion de Logique,3,Les Paradoxes,12,840,2,QCM,0.66,0.23,16.04,6,34,40,37,6,31,1.08,16.22,Facile,Difficile,-2,Beaucoup plus Difficile,Pas Adapte,Philosophy
4211,2018,Philosophie,2,La Notion de Logique,3,Les Paradoxes,12,840,2,QCM,0.4,0.43,55.77,23,18,41,23,23,0,1.78,100.0,Difficile,Moyen,1,Plus Facile,Pas Adapte,Philosophy
5335,2019,Philosophie,2,La Notion de Logique,3,Les Paradoxes,12,840,2,QCU,0.54,0.35,3.93,2,44,46,30,2,28,1.53,6.67,Moyen,Difficile,-1,Plus Difficile,Pas Adapte,Philosophy
6459,2020,Philosophie,2,La Notion de Logique,3,Les Paradoxes,12,840,2,QROC,0.84,0.13,19.39,9,39,48,29,9,20,1.66,31.03,Moyen,Difficile,-1,Plus Difficile,Pas Adapte,Philosophy
840,2015,Philosophie,2,La Notion de Logique,3,Les Paradoxes,12,841,3,QCM,0.26,0.47,48.8,41,42,83,45,41,4,1.84,91.11,Moyen,Moyen,0,Meme Difficulté,Pas Adapte,Philosophy
1964,2016,Philosophie,2,La Notion de Logique,3,Les Paradoxes,12,841,3,QCM,0.38,0.43,58.07,46,33,79,69,46,23,1.14,66.67,Facile,Moyen,-1,Plus Difficile,Pas Adapte,Philosophy
3088,2017,Philosophie,2,La Notion de Logique,3,Les Paradoxes,12,841,3,QCM,0.03,0.82,74.23,65,23,88,83,65,18,1.06,78.31,Difficile,Facile,2,Beaucoup plus Facile,Adapte,Philosophy
4212,2018,Philosophie,2,La Notion de Logique,3,Les Paradoxes,12,841,3,QCM,0.18,0.91,74.23,66,23,89,76,66,10,1.17,86.84,Facile,Facile,0,Meme Difficulté,Adapte,Philosophy
5336,2019,Philosophie,2,La Notion de Logique,3,Les Paradoxes,12,841,3,QCM,0.08,0.95,74.23,59,20,79,73,59,14,1.08,80.82,Facile,Facile,0,Meme Difficulté,Adapte,Philosophy
6460,2020,Philosophie,2,La Notion de Logique,3,Les Paradoxes,12,841,3,QCM,0.17,0.85,74.23,67,23,90,89,67,22,1.01,75.28,Facile,Facile,0,Meme Difficulté,Adapte,Philosophy
841,2015,Philosophie,2,La Notion de Logique,3,Les Paradoxes,12,842,4,QO,0.32,0.2,37.1,4,6,10,7,4,3,1.43,57.14,Difficile,Moyen,1,Plus Facile,Pas Adapte,Philosophy
1965,2016,Philosophie,2,La Notion de Logique,3,Les Paradoxes,12,842,4,QO,0.35,0.29,51.83,6,6,12,8,6,2,1.5,75.0,Moyen,Moyen,0,Meme Difficulté,Pas Adapte,Philosophy
3089,2017,Philosophie,2,La Notion de Logique,3,Les Paradoxes,12,842,4,QO,0.79,0.1,23.41,2,8,10,9,2,7,1.11,22.22,Difficile,Difficile,0,Meme Difficulté,Pas Adapte,Philosophy
4213,2018,Philosophie,2,La Notion de Logique,3,Les Paradoxes,12,842,4,QCM,0.48,0.37,59.79,7,4,11,11,7,4,1.0,63.64,Difficile,Moyen,1,Plus Facile,Pas Adapte,Philosophy
5337,2019,Philosophie,2,La Notion de Logique,3,Les Paradoxes,12,842,4,QCM,0.72,0.26,3.16,0,10,10,4,0,4,2.5,0.0,Facile,Difficile,-2,Beaucoup plus Difficile,Pas Adapte,Philosophy
6461,2020,Philosophie,2,La Notion de Logique,3,Les Paradoxes,12,842,4,QO,0.2,0.68,65.59,7,3,10,10,7,3,1.0,70.0,Moyen,Facile,1,Plus Facile,Adapte,Philosophy
842,2015,Philosophie,2,La Notion de Logique,3,Les Paradoxes,12,843,5,QCM,0.23,0.38,64.78,31,17,48,47,31,16,1.02,65.96,Facile,Moyen,-1,Plus Difficile,Adapte,Philosophy
1966,2016,Philosophie,2,La Notion de Logique,3,Les Paradoxes,12,843,5,QCM,0.44,0.31,64.78,29,15,44,43,29,14,1.02,67.44,Moyen,Moyen,0,Meme Difficulté,Adapte,Philosophy
3090,2017,Philosophie,2,La Notion de Logique,3,Les Paradoxes,12,843,5,QCM,0.42,0.47,64.78,33,18,51,43,33,10,1.19,76.74,Moyen,Moyen,0,Meme Difficulté,Adapte,Philosophy
4214,2018,Philosophie,2,La Notion de Logique,3,Les Paradoxes,12,843,5,QCU,0.39,0.58,64.78,34,18,52,39,34,5,1.33,87.18,Moyen,Moyen,0,Meme Difficulté,Adapte,Philosophy
5338,2019,Philosophie,2,La Notion de Logique,3,Les Paradoxes,12,843,5,QCU,0.32,0.62,64.78,32,18,50,33,32,1,1.52,96.97,Moyen,Moyen,0,Meme Difficulté,Adapte,Philosophy
6462,2020,Philosophie,2,La Notion de Logique,3,Les Paradoxes,12,843,5,QCU,0.34,0.4,64.78,35,19,54,40,35,5,1.35,87.5,Moyen,Moyen,0,Meme Difficulté,Adapte,Philosophy
843,2015,Philosophie,2,La Notion de Logique,3,Les Paradoxes,12,844,6,QCM,0.13,0.92,69.25,48,22,70,50,48,2,1.4,96.0,Moyen,Facile,1,Plus Facile,Adapte,Philosophy
1967,2016,Philosophie,2,La Notion de Logique,3,Les Paradoxes,12,844,6,QCM,0.04,0.78,69.25,54,24,78,60,54,6,1.3,90.0,Facile,Facile,0,Meme Difficulté,Adapte,Philosophy
3091,2017,Philosophie,2,La Notion de Logique,3,Les Paradoxes,12,844,6,QCM,0.19,0.96,69.25,46,21,67,62,46,16,1.08,74.19,Facile,Facile,0,Meme Difficulté,Adapte,Philosophy
4215,2018,Philosophie,2,La Notion de Logique,3,Les Paradoxes,12,844,6,QCM,0.18,0.79,69.25,48,21,69,55,48,7,1.25,87.27,Facile,Facile,0,Meme Difficulté,Adapte,Philosophy
5339,2019,Philosophie,2,La Notion de Logique,3,Les Paradoxes,12,844,6,QCM,0.11,0.94,69.25,46,20,66,50,46,4,1.32,92.0,Facile,Facile,0,Meme Difficulté,Adapte,Philosophy
6463,2020,Philosophie,2,La Notion de Logique,3,Les Paradoxes,12,844,6,QCM,0.09,0.89,69.25,48,21,69,59,48,11,1.17,81.36,Facile,Facile,0,Meme Difficulté,Adapte,Philosophy
844,2015,Philosophie,2,La Notion de Logique,3,Les Paradoxes,12,845,7,QROC,0.07,0.42,78.88,41,11,52,46,41,5,1.13,89.13,Difficile,Facile,2,Beaucoup plus Facile,Pas Adapte,Philosophy
1968,2016,Philosophie,2,La Notion de Logique,3,Les Paradoxes,12,845,7,QROC,0.45,0.34,39.53,23,36,59,48,23,25,1.23,47.92,Facile,Moyen,-1,Plus Difficile,Pas Adapte,Philosophy
3092,2017,Philosophie,2,La Notion de Logique,3,Les Paradoxes,12,845,7,QROC,0.28,0.29,48.86,26,28,54,40,26,14,1.35,65.0,Moyen,Moyen,0,Meme Difficulté,Pas Adapte,Philosophy
4216,2018,Philosophie,2,La Notion de Logique,3,Les Paradoxes,12,845,7,QCM,0.15,0.88,67.32,39,19,58,41,39,2,1.41,95.12,Facile,Facile,0,Meme Difficulté,Adapte,Philosophy
5340,2019,Philosophie,2,La Notion de Logique,3,Les Paradoxes,12,845,7,QCM,0.06,0.76,67.32,41,20,61,48,41,7,1.27,85.42,Facile,Facile,0,Meme Difficulté,Adapte,Philosophy
6464,2020,Philosophie,2,La Notion de Logique,3,Les Paradoxes,12,845,7,QCM,0.12,0.8,67.32,44,21,65,55,44,11,1.18,80.0,Facile,Facile,0,Meme Difficulté,Adapte,Philosophy
845,2015,Philosophie,2,La Notion de Logique,3,Les Paradoxes,12,846,8,QROC,0.08,0.47,73.01,19,7,26,22,19,3,1.18,86.36,Difficile,Facile,2,Beaucoup plus Facile,Adapte,Philosophy
1969,2016,Philosophie,2,La Notion de Logique,3,Les Paradoxes,12,846,8,QROC,0.04,0.88,73.01,20,7,27,25,20,5,1.08,80.0,Facile,Facile,0,Meme Difficulté,Adapte,Philosophy
3093,2017,Philosophie,2,La Notion de Logique,3,Les Paradoxes,12,846,8,QROC,0.08,0.68,73.01,18,7,25,22,18,4,1.14,81.82,Facile,Facile,0,Meme Difficulté,Adapte,Philosophy
4217,2018,Philosophie,2,La Notion de Logique,3,Les Paradoxes,12,846,8,QROC,0.14,0.84,73.01,21,8,29,21,21,0,1.38,100.0,Facile,Facile,0,Meme Difficulté,Adapte,Philosophy
5341,2019,Philosophie,2,La Notion de Logique,3,Les Paradoxes,12,846,8,QROC,0.06,0.95,73.01,23,9,32,31,23,8,1.03,74.19,Facile,Facile,0,Meme Difficulté,Adapte,Philosophy
6465,2020,Philosophie,2,La Notion de Logique,3,Les Paradoxes,12,846,8,QCM,0.16,0.97,73.01,20,7,27,21,20,1,1.29,95.24,Facile,Facile,0,Meme Difficulté,Adapte,Philosophy
846,2015,Philosophie,2,La Notion de Logique,3,Les Paradoxes,12,847,9,QCM,0.75,0.19,26.71,15,41,56,35,15,20,1.6,42.86,Facile,Difficile,-2,Beaucoup plus Difficile,Pas Adapte,Philosophy
1970,2016,Philosophie,2,La Notion de Logique,3,Les Paradoxes,12,847,9,QCM,0.71,0.15,6.95,4,56,60,18,4,14,3.33,22.22,Difficile,Difficile,0,Meme Difficulté,Pas Adapte,Philosophy
3094,2017,Philosophie,2,La Notion de Logique,3,Les Paradoxes,12,847,9,QCU,0.38,0.72,61.46,37,24,61,39,37,2,1.56,94.87,Difficile,Moyen,1,Plus Facile,Adapte,Philosophy
4218,2018,Philosophie,2,La Notion de Logique,3,Les Paradoxes,12,847,9,QCU,0.21,0.52,61.46,39,25,64,49,39,10,1.31,79.59,Moyen,Moyen,0,Meme Difficulté,Adapte,Philosophy
5342,2019,Philosophie,2,La Notion de Logique,3,Les Paradoxes,12,847,9,QO,0.41,0.19,61.46,41,25,66,64,41,23,1.03,64.06,Moyen,Moyen,0,Meme Difficulté,Adapte,Philosophy
6466,2020,Philosophie,2,La Notion de Logique,3,Les Paradoxes,12,847,9,QO,0.63,0.29,61.46,34,22,56,39,34,5,1.44,87.18,Moyen,Moyen,0,Meme Difficulté,Adapte,Philosophy
847,2015,Philosophie,2,La Notion de Logique,3,Les Paradoxes,12,848,10,QCM,0.43,0.34,49.67,29,30,59,58,29,29,1.02,50.0,Moyen,Moyen,0,Meme Difficulté,Pas Adapte,Philosophy
1971,2016,Philosophie,2,La Notion de Logique,3,Les Paradoxes,12,848,10,QCM,0.53,0.28,13.4,8,51,59,37,8,29,1.59,21.62,Facile,Difficile,-2,Beaucoup plus Difficile,Pas Adapte,Philosophy
3095,2017,Philosophie,2,La Notion de Logique,3,Les Paradoxes,12,848,10,QCM,0.12,0.86,81.46,50,11,61,52,50,2,1.17,96.15,Facile,Facile,0,Meme Difficulté,Pas Adapte,Philosophy
4219,2018,Philosophie,2,La Notion de Logique,3,Les Paradoxes,12,848,10,QCM,0.17,0.89,87.82,54,7,61,59,54,5,1.03,91.53,Difficile,Facile,2,Beaucoup plus Facile,Pas Adapte,Philosophy
5343,2019,Philosophie,2,La Notion de Logique,3,Les Paradoxes,12,848,10,QCM,0.31,0.61,45.72,27,32,59,28,27,1,2.11,96.43,Facile,Moyen,-1,Plus Difficile,Pas Adapte,Philosophy
6467,2020,Philosophie,2,La Notion de Logique,3,Les Paradoxes,12,848,10,QCM,0.2,0.72,98.02,63,1,64,63,63,0,1.02,100.0,Moyen,Facile,1,Plus Facile,Pas Adapte,Philosophy
848,2015,Philosophie,2,La Notion de Logique,3,Les Paradoxes,12,849,11,QCU,0.7,0.3,9.18,3,31,34,33,3,30,1.03,9.09,Difficile,Difficile,0,Meme Difficulté,Pas Adapte,Philosophy
1972,2016,Philosophie,2,La Notion de Logique,3,Les Paradoxes,12,849,11,QCU,0.21,0.62,58.1,19,13,32,22,19,3,1.45,86.36,Difficile,Moyen,1,Plus Facile,Pas Adapte,Philosophy
3096,2017,Philosophie,2,La Notion de Logique,3,Les Paradoxes,12,849,11,QCU,0.58,0.38,7.63,3,33,36,29,3,26,1.24,10.34,Facile,Difficile,-2,Beaucoup plus Difficile,Pas Adapte,Philosophy
4220,2018,Philosophie,2,La Notion de Logique,3,Les Paradoxes,12,849,11,QCU,0.12,0.81,93.73,31,2,33,32,31,1,1.03,96.88,Facile,Facile,0,Meme Difficulté,Pas Adapte,Philosophy
5344,2019,Philosophie,2,La Notion de Logique,3,Les Paradoxes,12,849,11,QCU,0.22,0.54,57.67,18,14,32,27,18,9,1.19,66.67,Facile,Moyen,-1,Plus Difficile,Pas Adapte,Philosophy
6468,2020,Philosophie,2,La Notion de Logique,3,Les Paradoxes,12,849,11,QCM,0.12,0.86,95.92,27,1,28,27,27,0,1.04,100.0,Facile,Facile,0,Meme Difficulté,Pas Adapte,Philosophy
849,2015,Philosophie,2,La Notion de Logique,3,Les Paradoxes,12,850,12,QCU,0.22,0.66,51.57,10,10,20,13,10,3,1.54,76.92,Difficile,Moyen,1,Plus Facile,Pas Adapte,Philosophy
1973,2016,Philosophie,2,La Notion de Logique,3,Les Paradoxes,12,850,12,QCU,0.73,0.39,7.25,1,16,17,15,1,14,1.13,6.67,Difficile,Difficile,0,Meme Difficulté,Pas Adapte,Philosophy
3097,2017,Philosophie,2,La Notion de Logique,3,Les Paradoxes,12,850,12,QCU,0.08,0.77,98.23,18,0,18,18,18,0,1.0,100.0,Difficile,Facile,2,Beaucoup plus Facile,Pas Adapte,Philosophy
4221,2018,Philosophie,2,La Notion de Logique,3,Les Paradoxes,12,850,12,QCU,0.54,0.31,19.78,3,13,16,13,3,10,1.23,23.08,Moyen,Difficile,-1,Plus Difficile,Pas Adapte,Philosophy
5345,2019,Philosophie,2,La Notion de Logique,3,Les Paradoxes,12,850,12,QCU,0.16,0.83,85.48,15,2,17,15,15,0,1.13,100.0,Difficile,Facile,2,Beaucoup plus Facile,Pas Adapte,Philosophy
6469,2020,Philosophie,2,La Notion de Logique,3,Les Paradoxes,12,850,12,QCU,0.65,0.3,12.8,2,15,17,16,2,14,1.06,12.5,Facile,Difficile,-2,Beaucoup plus Difficile,Pas Adapte,Philosophy
850,2015,Philosophie,2,La Notion de Logique,4,La Notion du Modele,13,851,1,QCU,0.48,0.28,11.02,2,19,21,11,2,9,1.91,18.18,Moyen,Difficile,-1,Plus Difficile,Pas Adapte,Philosophy
1974,2016,Philosophie,2,La Notion de Logique,4,La Notion du Modele,13,851,1,QROC,0.34,0.38,43.45,8,11,19,16,8,8,1.19,50.0,Difficile,Moyen,1,Plus Facile,Pas Adapte,Philosophy
3098,2017,Philosophie,2,La Notion de Logique,4,La Notion du Modele,13,851,1,QROC,0.79,0.1,9.25,2,17,19,10,2,8,1.9,20.0,Facile,Difficile,-2,Beaucoup plus Difficile,Pas Adapte,Philosophy
4222,2018,Philosophie,2,La Notion de Logique,4,La Notion du Modele,13,851,1,QROC,0.19,0.4,96.47,18,1,19,18,18,0,1.06,100.0,Difficile,Facile,2,Beaucoup plus Facile,Pas Adapte,Philosophy
5346,2019,Philosophie,2,La Notion de Logique,4,La Notion du Modele,13,851,1,QROC,0.57,0.26,45.47,9,11,20,11,9,2,1.82,81.82,Difficile,Moyen,1,Plus Facile,Pas Adapte,Philosophy
6470,2020,Philosophie,2,La Notion de Logique,4,La Notion du Modele,13,851,1,QROC,0.77,0.25,1.96,0,17,17,12,0,12,1.42,0.0,Facile,Difficile,-2,Beaucoup plus Difficile,Pas Adapte,Philosophy
851,2015,Philosophie,2,La Notion de Logique,4,La Notion du Modele,13,852,2,QCU,0.19,0.81,70.82,67,28,95,79,67,12,1.2,84.81,Facile,Facile,0,Meme Difficulté,Adapte,Philosophy
1975,2016,Philosophie,2,La Notion de Logique,4,La Notion du Modele,13,852,2,QCU,0.18,0.75,70.82,62,26,88,75,62,13,1.17,82.67,Facile,Facile,0,Meme Difficulté,Adapte,Philosophy
3099,2017,Philosophie,2,La Notion de Logique,4,La Notion du Modele,13,852,2,QCU,0.19,0.77,70.82,53,22,75,57,53,4,1.32,92.98,Facile,Facile,0,Meme Difficulté,Adapte,Philosophy
4223,2018,Philosophie,2,La Notion de Logique,4,La Notion du Modele,13,852,2,QCU,0.08,0.91,70.82,55,22,77,71,55,16,1.08,77.46,Facile,Facile,0,Meme Difficulté,Adapte,Philosophy
5347,2019,Philosophie,2,La Notion de Logique,4,La Notion du Modele,13,852,2,QCU,0.12,0.79,70.82,53,22,75,55,53,2,1.36,96.36,Facile,Facile,0,Meme Difficulté,Adapte,Philosophy
6471,2020,Philosophie,2,La Notion de Logique,4,La Notion du Modele,13,852,2,QCU,0.1,0.88,70.82,47,20,67,47,47,0,1.43,100.0,Facile,Facile,0,Meme Difficulté,Adapte,Philosophy
852,2015,Philosophie,2,La Notion de Logique,4,La Notion du Modele,13,853,3,QO,0.02,0.92,71.2,11,5,16,12,11,1,1.33,91.67,Moyen,Facile,1,Plus Facile,Adapte,Philosophy
1976,2016,Philosophie,2,La Notion de Logique,4,La Notion du Modele,13,853,3,QO,0.12,0.92,71.2,10,4,14,11,10,1,1.27,90.91,Facile,Facile,0,Meme Difficulté,Adapte,Philosophy
3100,2017,Philosophie,2,La Notion de Logique,4,La Notion du Modele,13,853,3,QO,0.17,0.48,71.2,10,4,14,10,10,0,1.4,100.0,Facile,Facile,0,Meme Difficulté,Adapte,Philosophy
4224,2018,Philosophie,2,La Notion de Logique,4,La Notion du Modele,13,853,3,QO,0.02,0.66,71.2,11,4,15,11,11,0,1.36,100.0,Facile,Facile,0,Meme Difficulté,Adapte,Philosophy
5348,2019,Philosophie,2,La Notion de Logique,4,La Notion du Modele,13,853,3,QO,0.06,0.39,71.2,12,5,17,17,12,5,1.0,70.59,Facile,Facile,0,Meme Difficulté,Adapte,Philosophy
6472,2020,Philosophie,2,La Notion de Logique,4,La Notion du Modele,13,853,3,QO,0.17,0.55,71.2,14,6,20,18,14,4,1.11,77.78,Facile,Facile,0,Meme Difficulté,Adapte,Philosophy
853,2015,Philosophie,2,La Notion de Logique,4,La Notion du Modele,13,854,4,QCU,0.36,0.64,40.75,20,30,50,39,20,19,1.28,51.28,Difficile,Moyen,1,Plus Facile,Pas Adapte,Philosophy
1977,2016,Philosophie,2,La Notion de Logique,4,La Notion du Modele,13,854,4,QCU,0.37,0.74,50.96,22,21,43,34,22,12,1.26,64.71,Facile,Moyen,-1,Plus Difficile,Pas Adapte,Philosophy
3101,2017,Philosophie,2,La Notion de Logique,4,La Notion du Modele,13,854,4,QCU,0.02,0.94,99.12,40,0,40,40,40,0,1.0,100.0,Difficile,Facile,2,Beaucoup plus Facile,Pas Adapte,Philosophy
4225,2018,Philosophie,2,La Notion de Logique,4,La Notion du Modele,13,854,4,QCU,0.07,0.99,74.23,27,9,36,34,27,7,1.06,79.41,Difficile,Facile,2,Beaucoup plus Facile,Adapte,Philosophy
5349,2019,Philosophie,2,La Notion de Logique,4,La Notion du Modele,13,854,4,QCU,0.04,0.94,74.23,30,11,41,37,30,7,1.11,81.08,Facile,Facile,0,Meme Difficulté,Adapte,Philosophy
6473,2020,Philosophie,2,La Notion de Logique,4,La Notion du Modele,13,854,4,QCU,0.02,0.91,74.23,33,11,44,44,33,11,1.0,75.0,Facile,Facile,0,Meme Difficulté,Adapte,Philosophy
854,2015,Philosophie,2,La Notion de Logique,4,La Notion du Modele,13,855,5,QCU,0.25,0.57,44.2,26,33,59,29,26,3,2.03,89.66,Facile,Moyen,-1,Plus Difficile,Pas Adapte,Philosophy
1978,2016,Philosophie,2,La Notion de Logique,4,La Notion du Modele,13,855,5,QCU,0.65,0.23,11.38,6,50,56,27,6,21,2.07,22.22,Facile,Difficile,-2,Beaucoup plus Difficile,Pas Adapte,Philosophy
3102,2017,Philosophie,2,La Notion de Logique,4,La Notion du Modele,13,855,5,QCU,0.13,0.82,82.47,50,11,61,56,50,6,1.09,89.29,Difficile,Facile,2,Beaucoup plus Facile,Pas Adapte,Philosophy
4226,2018,Philosophie,2,La Notion de Logique,4,La Notion du Modele,13,855,5,QCU,0.65,0.38,15.75,10,51,61,36,10,26,1.69,27.78,Moyen,Difficile,-1,Plus Difficile,Pas Adapte,Philosophy
5350,2019,Philosophie,2,La Notion de Logique,4,La Notion du Modele,13,855,5,QCU,0.0,0.96,97.05,51,2,53,52,51,1,1.02,98.08,Facile,Facile,0,Meme Difficulté,Pas Adapte,Philosophy
6474,2020,Philosophie,2,La Notion de Logique,4,La Notion du Modele,13,855,5,QCU,0.04,0.97,86.33,40,6,46,46,40,6,1.0,86.96,Moyen,Facile,1,Plus Facile,Pas Adapte,Philosophy
855,2015,Philosophie,2,La Notion de Logique,4,La Notion du Modele,13,856,6,QCM,0.14,0.96,77.1,65,19,84,68,65,3,1.24,95.59,Moyen,Facile,1,Plus Facile,Pas Adapte,Philosophy
1979,2016,Philosophie,2,La Notion de Logique,4,La Notion du Modele,13,856,6,QCM,0.36,0.61,43.8,33,42,75,62,33,29,1.21,53.23,Moyen,Moyen,0,Meme Difficulté,Pas Adapte,Philosophy
3103,2017,Philosophie,2,La Notion de Logique,4,La Notion du Modele,13,856,6,QCM,0.35,0.41,36.95,25,44,69,28,25,3,2.46,89.29,Facile,Moyen,-1,Plus Difficile,Pas Adapte,Philosophy
4227,2018,Philosophie,2,La Notion de Logique,4,La Notion du Modele,13,856,6,QCM,0.0,0.95,86.31,66,10,76,66,66,0,1.15,100.0,Facile,Facile,0,Meme Difficulté,Pas Adapte,Philosophy
5351,2019,Philosophie,2,La Notion de Logique,4,La Notion du Modele,13,856,6,QCM,0.13,0.79,76.57,60,19,79,77,60,17,1.03,77.92,Moyen,Facile,1,Plus Facile,Pas Adapte,Philosophy
6475,2020,Philosophie,2,La Notion de Logique,4,La Notion du Modele,13,856,6,QCM,0.44,0.63,64.39,45,25,70,66,45,21,1.06,68.18,Difficile,Moyen,1,Plus Facile,Adapte,Philosophy
856,2015,Philosophie,2,La Notion de Logique,4,La Notion du Modele,13,857,7,QCM,0.68,0.19,18.76,9,41,50,26,9,17,1.92,34.62,Difficile,Difficile,0,Meme Difficulté,Pas Adapte,Philosophy
1980,2016,Philosophie,2,La Notion de Logique,4,La Notion du Modele,13,857,7,QCM,0.09,1.0,75.36,41,13,54,53,41,12,1.02,77.36,Moyen,Facile,1,Plus Facile,Pas Adapte,Philosophy
3104,2017,Philosophie,2,La Notion de Logique,4,La Notion du Modele,13,857,7,QCM,0.1,0.93,77.06,40,12,52,49,40,9,1.06,81.63,Facile,Facile,0,Meme Difficulté,Pas Adapte,Philosophy
4228,2018,Philosophie,2,La Notion de Logique,4,La Notion du Modele,13,857,7,QCM,0.05,0.82,77.27,39,11,50,50,39,11,1.0,78.0,Facile,Facile,0,Meme Difficulté,Pas Adapte,Philosophy
5352,2019,Philosophie,2,La Notion de Logique,4,La Notion du Modele,13,857,7,QCM,0.6,0.19,22.69,11,38,49,17,11,6,2.88,64.71,Difficile,Difficile,0,Meme Difficulté,Pas Adapte,Philosophy
6476,2020,Philosophie,2,La Notion de Logique,4,La Notion du Modele,13,857,7,QCM,0.09,0.91,99.05,51,0,51,51,51,0,1.0,100.0,Moyen,Facile,1,Plus Facile,Pas Adapte,Philosophy
857,2015,Philosophie,2,La Notion de Logique,4,La Notion du Modele,13,858,8,QCU,0.06,0.87,76.9,18,6,24,20,18,2,1.2,90.0,Difficile,Facile,2,Beaucoup plus Facile,Pas Adapte,Philosophy
1981,2016,Philosophie,2,La Notion de Logique,4,La Notion du Modele,13,858,8,QCU,0.27,0.43,54.4,11,9,20,19,11,8,1.05,57.89,Moyen,Moyen,0,Meme Difficulté,Pas Adapte,Philosophy
3105,2017,Philosophie,2,La Notion de Logique,4,La Notion du Modele,13,858,8,QCU,0.36,0.7,60.76,12,8,20,19,12,7,1.05,63.16,Moyen,Moyen,0,Meme Difficulté,Adapte,Philosophy
4229,2018,Philosophie,2,La Notion de Logique,4,La Notion du Modele,13,858,8,QCU,0.36,0.67,60.76,12,8,20,16,12,4,1.25,75.0,Moyen,Moyen,0,Meme Difficulté,Adapte,Philosophy
5353,2019,Philosophie,2,La Notion de Logique,4,La Notion du Modele,13,858,8,QCU,0.36,0.57,60.76,10,7,17,14,10,4,1.21,71.43,Moyen,Moyen,0,Meme Difficulté,Adapte,Philosophy
6477,2020,Philosophie,2,La Notion de Logique,4,La Notion du Modele,13,858,8,QCU,0.38,0.49,60.76,10,7,17,16,10,6,1.06,62.5,Moyen,Moyen,0,Meme Difficulté,Adapte,Philosophy
858,2015,Philosophie,2,La Notion de Logique,4,La Notion du Modele,13,859,9,QCU,0.24,0.54,57.68,21,16,37,27,21,6,1.37,77.78,Facile,Moyen,-1,Plus Difficile,Pas Adapte,Philosophy
1982,2016,Philosophie,2,La Notion de Logique,4,La Notion du Modele,13,859,9,QCU,0.54,0.4,13.23,4,27,31,26,4,22,1.19,15.38,Difficile,Difficile,0,Meme Difficulté,Pas Adapte,Philosophy
3106,2017,Philosophie,2,La Notion de Logique,4,La Notion du Modele,13,859,9,QCU,0.13,0.94,79.65,22,5,27,23,22,1,1.17,95.65,Moyen,Facile,1,Plus Facile,Pas Adapte,Philosophy
4230,2018,Philosophie,2,La Notion de Logique,4,La Notion du Modele,13,859,9,QCU,0.11,0.85,97.72,24,1,25,25,24,1,1.0,96.0,Facile,Facile,0,Meme Difficulté,Pas Adapte,Philosophy
5354,2019,Philosophie,2,La Notion de Logique,4,La Notion du Modele,13,859,9,QCU,0.18,0.87,95.28,27,1,28,27,27,0,1.04,100.0,Difficile,Facile,2,Beaucoup plus Facile,Pas Adapte,Philosophy
6478,2020,Philosophie,2,La Notion de Logique,4,La Notion du Modele,13,859,9,QCU,0.12,0.76,74.47,19,7,26,23,19,4,1.13,82.61,Facile,Facile,0,Meme Difficulté,Adapte,Philosophy
859,2015,Philosophie,2,La Notion de Logique,4,La Notion du Modele,13,860,10,QCM,0.14,0.97,74.17,8,3,11,10,8,2,1.1,80.0,Difficile,Facile,2,Beaucoup plus Facile,Adapte,Philosophy
1983,2016,Philosophie,2,La Notion de Logique,4,La Notion du Modele,13,860,10,QO,0.01,1.0,74.17,8,3,11,10,8,2,1.1,80.0,Facile,Facile,0,Meme Difficulté,Adapte,Philosophy
3107,2017,Philosophie,2,La Notion de Logique,4,La Notion du Modele,13,860,10,QO,0.17,0.92,74.17,10,3,13,13,10,3,1.0,76.92,Facile,Facile,0,Meme Difficulté,Adapte,Philosophy
4231,2018,Philosophie,2,La Notion de Logique,4,La Notion du Modele,13,860,10,QO,0.1,0.36,74.17,10,4,14,10,10,0,1.4,100.0,Facile,Facile,0,Meme Difficulté,Adapte,Philosophy
5355,2019,Philosophie,2,La Notion de Logique,4,La Notion du Modele,13,860,10,QO,0.08,0.88,74.17,11,4,15,12,11,1,1.25,91.67,Facile,Facile,0,Meme Difficulté,Adapte,Philosophy
6479,2020,Philosophie,2,La Notion de Logique,4,La Notion du Modele,13,860,10,QO,0.16,0.51,74.17,11,4,15,13,11,2,1.15,84.62,Facile,Facile,0,Meme Difficulté,Adapte,Philosophy
860,2015,Philosophie,2,La Notion de Logique,4,La Notion du Modele,13,861,11,QCM,0.76,0.28,12.06,2,11,13,12,2,10,1.08,16.67,Moyen,Difficile,-1,Plus Difficile,Pas Adapte,Philosophy
1984,2016,Philosophie,2,La Notion de Logique,4,La Notion du Modele,13,861,11,QCM,0.76,0.16,24.01,3,8,11,8,3,5,1.38,37.5,Moyen,Difficile,-1,Plus Difficile,Pas Adapte,Philosophy
3108,2017,Philosophie,2,La Notion de Logique,4,La Notion du Modele,13,861,11,QROC,0.39,0.26,49.58,6,6,12,7,6,1,1.71,85.71,Moyen,Moyen,0,Meme Difficulté,Pas Adapte,Philosophy
4232,2018,Philosophie,2,La Notion de Logique,4,La Notion du Modele,13,861,11,QROC,0.99,0.02,0.51,0,10,10,6,0,6,1.67,0.0,Difficile,Difficile,0,Meme Difficulté,Pas Adapte,Philosophy
5356,2019,Philosophie,2,La Notion de Logique,4,La Notion du Modele,13,861,11,QROC,0.04,0.96,96.78,11,0,11,11,11,0,1.0,100.0,Moyen,Facile,1,Plus Facile,Pas Adapte,Philosophy
6480,2020,Philosophie,2,La Notion de Logique,4,La Notion du Modele,13,861,11,QROC,0.7,0.21,11.01,1,11,12,8,1,7,1.5,12.5,Difficile,Difficile,0,Meme Difficulté,Pas Adapte,Philosophy
861,2015,Philosophie,2,La Notion de Logique,4,La Notion du Modele,13,862,12,QCM,0.18,0.91,86.08,36,6,42,40,36,4,1.05,90.0,Difficile,Facile,2,Beaucoup plus Facile,Pas Adapte,Philosophy
1985,2016,Philosophie,2,La Notion de Logique,4,La Notion du Modele,13,862,12,QCM,0.24,0.62,42.89,15,21,36,28,15,13,1.29,53.57,Moyen,Moyen,0,Meme Difficulté,Pas Adapte,Philosophy
3109,2017,Philosophie,2,La Notion de Logique,4,La Notion du Modele,13,862,12,QCM,0.13,0.99,67.79,28,13,41,36,28,8,1.14,77.78,Difficile,Facile,2,Beaucoup plus Facile,Adapte,Philosophy
4233,2018,Philosophie,2,La Notion de Logique,4,La Notion du Modele,13,862,12,QCM,0.12,0.75,67.79,29,14,43,41,29,12,1.05,70.73,Facile,Facile,0,Meme Difficulté,Adapte,Philosophy
5357,2019,Philosophie,2,La Notion de Logique,4,La Notion du Modele,13,862,12,QCM,0.08,0.91,67.79,33,16,49,38,33,5,1.29,86.84,Facile,Facile,0,Meme Difficulté,Adapte,Philosophy
6481,2020,Philosophie,2,La Notion de Logique,4,La Notion du Modele,13,862,12,QCM,0.09,0.94,67.79,35,16,51,45,35,10,1.13,77.78,Facile,Facile,0,Meme Difficulté,Adapte,Philosophy
862,2015,Philosophie,2,La Notion de Logique,4,La Notion du Modele,13,863,13,QCM,0.04,0.96,69.51,65,29,94,86,65,21,1.09,75.58,Difficile,Facile,2,Beaucoup plus Facile,Adapte,Philosophy
1986,2016,Philosophie,2,La Notion de Logique,4,La Notion du Modele,13,863,13,QCM,0.08,0.81,69.51,59,26,85,71,59,12,1.2,83.1,Facile,Facile,0,Meme Difficulté,Adapte,Philosophy
3110,2017,Philosophie,2,La Notion de Logique,4,La Notion du Modele,13,863,13,QCM,0.06,0.81,69.51,56,25,81,73,56,17,1.11,76.71,Facile,Facile,0,Meme Difficulté,Adapte,Philosophy
4234,2018,Philosophie,2,La Notion de Logique,4,La Notion du Modele,13,863,13,QCM,0.0,0.89,69.51,54,24,78,66,54,12,1.18,81.82,Facile,Facile,0,Meme Difficulté,Adapte,Philosophy
5358,2019,Philosophie,2,La Notion de Logique,4,La Notion du Modele,13,863,13,QCM,0.02,0.83,69.51,56,24,80,66,56,10,1.21,84.85,Facile,Facile,0,Meme Difficulté,Adapte,Philosophy
6482,2020,Philosophie,2,La Notion de Logique,4,La Notion du Modele,13,863,13,QCM,0.19,0.97,69.51,49,21,70,58,49,9,1.21,84.48,Facile,Facile,0,Meme Difficulté,Adapte,Philosophy
863,2015,Philosophie,2,La Notion de Logique,5,Le Calcul des Sequents,9,864,1,QCM,0.17,0.84,75.44,43,14,57,49,43,6,1.16,87.76,Facile,Facile,0,Meme Difficulté,Pas Adapte,Philosophy
1987,2016,Philosophie,2,La Notion de Logique,5,Le Calcul des Sequents,9,864,1,QCM,0.63,0.25,11.29,7,59,66,17,7,10,3.88,41.18,Difficile,Difficile,0,Meme Difficulté,Pas Adapte,Philosophy
3111,2017,Philosophie,2,La Notion de Logique,5,Le Calcul des Sequents,9,864,1,QCM,0.2,0.45,64.01,39,22,61,46,39,7,1.33,84.78,Moyen,Moyen,0,Meme Difficulté,Adapte,Philosophy
4235,2018,Philosophie,2,La Notion de Logique,5,Le Calcul des Sequents,9,864,1,QCM,0.37,0.47,64.01,38,21,59,46,38,8,1.28,82.61,Moyen,Moyen,0,Meme Difficulté,Adapte,Philosophy
5359,2019,Philosophie,2,La Notion de Logique,5,Le Calcul des Sequents,9,864,1,QCM,0.26,0.3,64.01,44,24,68,66,44,22,1.03,66.67,Moyen,Moyen,0,Meme Difficulté,Adapte,Philosophy
6483,2020,Philosophie,2,La Notion de Logique,5,Le Calcul des Sequents,9,864,1,QCM,0.32,0.49,64.01,40,23,63,55,40,15,1.15,72.73,Moyen,Moyen,0,Meme Difficulté,Adapte,Philosophy
864,2015,Philosophie,2,La Notion de Logique,5,Le Calcul des Sequents,9,865,2,QCU,0.06,0.95,69.4,65,29,94,75,65,10,1.25,86.67,Facile,Facile,0,Meme Difficulté,Adapte,Philosophy
1988,2016,Philosophie,2,La Notion de Logique,5,Le Calcul des Sequents,9,865,2,QROC,0.07,0.58,69.4,70,31,101,76,70,6,1.33,92.11,Facile,Facile,0,Meme Difficulté,Adapte,Philosophy
3112,2017,Philosophie,2,La Notion de Logique,5,Le Calcul des Sequents,9,865,2,QROC,0.13,0.74,69.4,60,26,86,83,60,23,1.04,72.29,Facile,Facile,0,Meme Difficulté,Adapte,Philosophy
4236,2018,Philosophie,2,La Notion de Logique,5,Le Calcul des Sequents,9,865,2,QROC,0.16,0.78,69.4,54,24,78,77,54,23,1.01,70.13,Facile,Facile,0,Meme Difficulté,Adapte,Philosophy
5360,2019,Philosophie,2,La Notion de Logique,5,Le Calcul des Sequents,9,865,2,QROC,0.06,0.98,69.4,51,23,74,70,51,19,1.06,72.86,Facile,Facile,0,Meme Difficulté,Adapte,Philosophy
6484,2020,Philosophie,2,La Notion de Logique,5,Le Calcul des Sequents,9,865,2,QCM,0.11,0.79,69.4,47,21,68,48,47,1,1.42,97.92,Facile,Facile,0,Meme Difficulté,Adapte,Philosophy
865,2015,Philosophie,2,La Notion de Logique,5,Le Calcul des Sequents,9,866,3,QCU,0.35,0.58,39.07,25,39,64,33,25,8,1.94,75.76,Moyen,Moyen,0,Meme Difficulté,Pas Adapte,Philosophy
1989,2016,Philosophie,2,La Notion de Logique,5,Le Calcul des Sequents,9,866,3,QROC,0.64,0.15,20.61,15,57,72,45,15,30,1.6,33.33,Facile,Difficile,-2,Beaucoup plus Difficile,Pas Adapte,Philosophy
3113,2017,Philosophie,2,La Notion de Logique,5,Le Calcul des Sequents,9,866,3,QO,0.78,0.1,33.1,23,45,68,56,23,33,1.21,41.07,Facile,Difficile,-2,Beaucoup plus Difficile,Pas Adapte,Philosophy
4237,2018,Philosophie,2,La Notion de Logique,5,Le Calcul des Sequents,9,866,3,QO,0.01,0.74,73.58,43,16,59,53,43,10,1.11,81.13,Difficile,Facile,2,Beaucoup plus Facile,Adapte,Philosophy
5361,2019,Philosophie,2,La Notion de Logique,5,Le Calcul des Sequents,9,866,3,QO,0.04,0.59,73.58,45,16,61,58,45,13,1.05,77.59,Facile,Facile,0,Meme Difficulté,Adapte,Philosophy
6485,2020,Philosophie,2,La Notion de Logique,5,Le Calcul des Sequents,9,866,3,QO,0.05,0.34,73.58,46,17,63,50,46,4,1.26,92.0,Facile,Facile,0,Meme Difficulté,Adapte,Philosophy
866,2015,Philosophie,2,La Notion de Logique,5,Le Calcul des Sequents,9,867,4,QCM,0.45,0.52,55.36,6,4,10,6,6,0,1.67,100.0,Moyen,Moyen,0,Meme Difficulté,Pas Adapte,Philosophy
1990,2016,Philosophie,2,La Notion de Logique,5,Le Calcul des Sequents,9,867,4,QCM,0.4,0.56,60.14,5,4,9,7,5,2,1.29,71.43,Facile,Moyen,-1,Plus Difficile,Adapte,Philosophy
3114,2017,Philosophie,2,La Notion de Logique,5,Le Calcul des Sequents,9,867,4,QCM,0.36,0.35,60.14,6,4,10,6,6,0,1.67,100.0,Moyen,Moyen,0,Meme Difficulté,Adapte,Philosophy
4238,2018,Philosophie,2,La Notion de Logique,5,Le Calcul des Sequents,9,867,4,QCM,0.29,0.44,60.14,5,4,9,7,5,2,1.29,71.43,Moyen,Moyen,0,Meme Difficulté,Adapte,Philosophy
5362,2019,Philosophie,2,La Notion de Logique,5,Le Calcul des Sequents,9,867,4,QCM,0.49,0.53,60.14,5,4,9,8,5,3,1.12,62.5,Moyen,Moyen,0,Meme Difficulté,Adapte,Philosophy
6486,2020,Philosophie,2,La Notion de Logique,5,Le Calcul des Sequents,9,867,4,QCM,0.41,0.33,60.14,5,3,8,6,5,1,1.33,83.33,Moyen,Moyen,0,Meme Difficulté,Adapte,Philosophy
867,2015,Philosophie,2,La Notion de Logique,5,Le Calcul des Sequents,9,868,5,QCM,0.65,0.3,2.45,0,10,10,4,0,4,2.5,0.0,Difficile,Difficile,0,Meme Difficulté,Pas Adapte,Philosophy
1991,2016,Philosophie,2,La Notion de Logique,5,Le Calcul des Sequents,9,868,5,QCM,0.18,0.73,93.17,11,1,12,12,11,1,1.0,91.67,Difficile,Facile,2,Beaucoup plus Facile,Pas Adapte,Philosophy
3115,2017,Philosophie,2,La Notion de Logique,5,Le Calcul des Sequents,9,868,5,QCM,0.25,0.4,37.05,4,8,12,6,4,2,2.0,66.67,Difficile,Moyen,1,Plus Facile,Pas Adapte,Philosophy
4239,2018,Philosophie,2,La Notion de Logique,5,Le Calcul des Sequents,9,868,5,QCM,0.37,0.57,41.76,6,8,14,7,6,1,2.0,85.71,Facile,Moyen,-1,Plus Difficile,Pas Adapte,Philosophy
5363,2019,Philosophie,2,La Notion de Logique,5,Le Calcul des Sequents,9,868,5,QCU,0.08,0.89,87.03,12,2,14,13,12,1,1.08,92.31,Difficile,Facile,2,Beaucoup plus Facile,Pas Adapte,Philosophy
6487,2020,Philosophie,2,La Notion de Logique,5,Le Calcul des Sequents,9,868,5,QROC,0.02,0.51,89.44,11,1,12,11,11,0,1.09,100.0,Moyen,Facile,1,Plus Facile,Pas Adapte,Philosophy
868,2015,Philosophie,2,La Notion de Logique,5,Le Calcul des Sequents,9,869,6,QROC,0.19,0.41,80.47,50,12,62,50,50,0,1.24,100.0,Difficile,Facile,2,Beaucoup plus Facile,Pas Adapte,Philosophy
1992,2016,Philosophie,2,La Notion de Logique,5,Le Calcul des Sequents,9,869,6,QROC,0.08,0.67,89.01,56,7,63,57,56,1,1.11,98.25,Moyen,Facile,1,Plus Facile,Pas Adapte,Philosophy
3116,2017,Philosophie,2,La Notion de Logique,5,Le Calcul des Sequents,9,869,6,QROC,0.82,0.18,16.04,9,48,57,35,9,26,1.63,25.71,Moyen,Difficile,-1,Plus Difficile,Pas Adapte,Philosophy
4240,2018,Philosophie,2,La Notion de Logique,5,Le Calcul des Sequents,9,869,6,QROC,0.7,0.06,13.12,8,52,60,38,8,30,1.58,21.05,Moyen,Difficile,-1,Plus Difficile,Pas Adapte,Philosophy
5364,2019,Philosophie,2,La Notion de Logique,5,Le Calcul des Sequents,9,869,6,QROC,0.94,0.19,11.26,6,46,52,35,6,29,1.49,17.14,Moyen,Difficile,-1,Plus Difficile,Pas Adapte,Philosophy
6488,2020,Philosophie,2,La Notion de Logique,5,Le Calcul des Sequents,9,869,6,QROC,0.88,0.07,27.16,13,36,49,41,13,28,1.2,31.71,Difficile,Difficile,0,Meme Difficulté,Pas Adapte,Philosophy
869,2015,Philosophie,2,La Notion de Logique,5,Le Calcul des Sequents,9,870,7,QCM,0.19,0.87,91.92,27,2,29,29,27,2,1.0,93.1,Difficile,Facile,2,Beaucoup plus Facile,Pas Adapte,Philosophy
1993,2016,Philosophie,2,La Notion de Logique,5,Le Calcul des Sequents,9,870,7,QROC,0.48,0.36,48.11,13,14,27,20,13,7,1.35,65.0,Difficile,Moyen,1,Plus Facile,Pas Adapte,Philosophy
3117,2017,Philosophie,2,La Notion de Logique,5,Le Calcul des Sequents,9,870,7,QROC,0.17,0.96,87.82,22,3,25,24,22,2,1.04,91.67,Difficile,Facile,2,Beaucoup plus Facile,Pas Adapte,Philosophy
4241,2018,Philosophie,2,La Notion de Logique,5,Le Calcul des Sequents,9,870,7,QROC,0.19,0.61,66.32,14,7,21,20,14,6,1.05,70.0,Facile,Facile,0,Meme Difficulté,Adapte,Philosophy
5365,2019,Philosophie,2,La Notion de Logique,5,Le Calcul des Sequents,9,870,7,QROC,0.04,0.8,66.32,12,6,18,13,12,1,1.38,92.31,Facile,Facile,0,Meme Difficulté,Adapte,Philosophy
6489,2020,Philosophie,2,La Notion de Logique,5,Le Calcul des Sequents,9,870,7,QROC,0.04,0.48,66.32,10,5,15,13,10,3,1.15,76.92,Facile,Facile,0,Meme Difficulté,Adapte,Philosophy
870,2015,Philosophie,2,La Notion de Logique,5,Le Calcul des Sequents,9,871,8,QCU,0.39,0.55,63.21,54,31,85,60,54,6,1.42,90.0,Moyen,Moyen,0,Meme Difficulté,Adapte,Philosophy
1994,2016,Philosophie,2,La Notion de Logique,5,Le Calcul des Sequents,9,871,8,QCU,0.37,0.52,63.21,46,27,73,60,46,14,1.22,76.67,Moyen,Moyen,0,Meme Difficulté,Adapte,Philosophy
3118,2017,Philosophie,2,La Notion de Logique,5,Le Calcul des Sequents,9,871,8,QCM,0.5,0.53,63.21,49,28,77,58,49,9,1.33,84.48,Moyen,Moyen,0,Meme Difficulté,Adapte,Philosophy
4242,2018,Philosophie,2,La Notion de Logique,5,Le Calcul des Sequents,9,871,8,QCM,0.42,0.48,63.21,50,29,79,54,50,4,1.46,92.59,Moyen,Moyen,0,Meme Difficulté,Adapte,Philosophy
5366,2019,Philosophie,2,La Notion de Logique,5,Le Calcul des Sequents,9,871,8,QCM,0.3,0.5,63.21,48,28,76,75,48,27,1.01,64.0,Moyen,Moyen,0,Meme Difficulté,Adapte,Philosophy
6490,2020,Philosophie,2,La Notion de Logique,5,Le Calcul des Sequents,9,871,8,QCM,0.41,0.59,63.21,41,24,65,51,41,10,1.27,80.39,Moyen,Moyen,0,Meme Difficulté,Adapte,Philosophy
871,2015,Philosophie,2,La Notion de Logique,5,Le Calcul des Sequents,9,872,9,QCM,0.12,0.77,66.02,63,32,95,71,63,8,1.34,88.73,Difficile,Facile,2,Beaucoup plus Facile,Adapte,Philosophy
1995,2016,Philosophie,2,La Notion de Logique,5,Le Calcul des Sequents,9,872,9,QCM,0.02,0.76,66.02,66,34,100,79,66,13,1.27,83.54,Facile,Facile,0,Meme Difficulté,Adapte,Philosophy
3119,2017,Philosophie,2,La Notion de Logique,5,Le Calcul des Sequents,9,872,9,QCM,0.02,0.88,66.02,60,31,91,67,60,7,1.36,89.55,Facile,Facile,0,Meme Difficulté,Adapte,Philosophy
4243,2018,Philosophie,2,La Notion de Logique,5,Le Calcul des Sequents,9,872,9,QCM,0.12,0.71,66.02,69,35,104,98,69,29,1.06,70.41,Facile,Facile,0,Meme Difficulté,Adapte,Philosophy
5367,2019,Philosophie,2,La Notion de Logique,5,Le Calcul des Sequents,9,872,9,QCM,0.19,0.88,66.02,71,36,107,78,71,7,1.37,91.03,Facile,Facile,0,Meme Difficulté,Adapte,Philosophy
6491,2020,Philosophie,2,La Notion de Logique,5,Le Calcul des Sequents,9,872,9,QCM,0.02,0.86,66.02,75,38,113,90,75,15,1.26,83.33,Facile,Facile,0,Meme Difficulté,Adapte,Philosophy
872,2015,Philosophie,2,La Notion de Logique,6,Le Theoreme de Completude,5,873,1,QCM,0.15,0.82,88.89,83,10,93,84,83,1,1.11,98.81,Moyen,Facile,1,Plus Facile,Pas Adapte,Philosophy
1996,2016,Philosophie,2,La Notion de Logique,6,Le Theoreme de Completude,5,873,1,QCM,0.69,0.23,21.74,20,74,94,83,20,63,1.13,24.1,Moyen,Difficile,-1,Plus Difficile,Pas Adapte,Philosophy
3120,2017,Philosophie,2,La Notion de Logique,6,Le Theoreme de Completude,5,873,1,QCM,0.77,0.18,4.62,5,93,98,37,5,32,2.65,13.51,Difficile,Difficile,0,Meme Difficulté,Pas Adapte,Philosophy
4244,2018,Philosophie,2,La Notion de Logique,6,Le Theoreme de Completude,5,873,1,QCM,0.0,0.94,84.6,82,15,97,86,82,4,1.13,95.35,Facile,Facile,0,Meme Difficulté,Pas Adapte,Philosophy
5368,2019,Philosophie,2,La Notion de Logique,6,Le Theoreme de Completude,5,873,1,QCM,0.18,0.77,86.69,74,11,85,80,74,6,1.06,92.5,Moyen,Facile,1,Plus Facile,Pas Adapte,Philosophy
6492,2020,Philosophie,2,La Notion de Logique,6,Le Theoreme de Completude,5,873,1,QCM,0.08,0.77,68.44,62,29,91,67,62,5,1.36,92.54,Facile,Facile,0,Meme Difficulté,Adapte,Philosophy
873,2015,Philosophie,2,La Notion de Logique,6,Le Theoreme de Completude,5,874,2,QCU,0.38,0.58,42.89,36,47,83,57,36,21,1.46,63.16,Moyen,Moyen,0,Meme Difficulté,Pas Adapte,Philosophy
1997,2016,Philosophie,2,La Notion de Logique,6,Le Theoreme de Completude,5,874,2,QCU,0.18,0.81,70.51,56,24,80,74,56,18,1.08,75.68,Difficile,Facile,2,Beaucoup plus Facile,Adapte,Philosophy
3121,2017,Philosophie,2,La Notion de Logique,6,Le Theoreme de Completude,5,874,2,QO,0.16,0.58,70.51,52,22,74,63,52,11,1.17,82.54,Facile,Facile,0,Meme Difficulté,Adapte,Philosophy
4245,2018,Philosophie,2,La Notion de Logique,6,Le Theoreme de Completude,5,874,2,QO,0.01,0.84,70.51,44,19,63,51,44,7,1.24,86.27,Facile,Facile,0,Meme Difficulté,Adapte,Philosophy
5369,2019,Philosophie,2,La Notion de Logique,6,Le Theoreme de Completude,5,874,2,QO,0.19,0.66,70.51,39,16,55,44,39,5,1.25,88.64,Facile,Facile,0,Meme Difficulté,Adapte,Philosophy
6493,2020,Philosophie,2,La Notion de Logique,6,Le Theoreme de Completude,5,874,2,QO,0.03,0.94,70.51,39,17,56,53,39,14,1.06,73.58,Facile,Facile,0,Meme Difficulté,Adapte,Philosophy
874,2015,Philosophie,2,La Notion de Logique,6,Le Theoreme de Completude,5,875,3,QROC,0.8,0.04,21.65,21,78,99,80,21,59,1.24,26.25,Facile,Difficile,-2,Beaucoup plus Difficile,Pas Adapte,Philosophy
1998,2016,Philosophie,2,La Notion de Logique,6,Le Theoreme de Completude,5,875,3,QROC,0.72,0.03,22.32,22,77,99,81,22,59,1.22,27.16,Moyen,Difficile,-1,Plus Difficile,Pas Adapte,Philosophy
3122,2017,Philosophie,2,La Notion de Logique,6,Le Theoreme de Completude,5,875,3,QCM,0.68,0.18,20.07,18,71,89,40,18,22,2.23,45.0,Moyen,Difficile,-1,Plus Difficile,Pas Adapte,Philosophy
4246,2018,Philosophie,2,La Notion de Logique,6,Le Theoreme de Completude,5,875,3,QCM,0.37,0.39,51.47,50,48,98,71,50,21,1.38,70.42,Difficile,Moyen,1,Plus Facile,Pas Adapte,Philosophy
5370,2019,Philosophie,2,La Notion de Logique,6,Le Theoreme de Completude,5,875,3,QCM,0.32,0.55,54.06,56,48,104,99,56,43,1.05,56.57,Facile,Moyen,-1,Plus Difficile,Pas Adapte,Philosophy
6494,2020,Philosophie,2,La Notion de Logique,6,Le Theoreme de Completude,5,875,3,QCM,0.39,0.66,44.53,47,58,105,52,47,5,2.02,90.38,Moyen,Moyen,0,Meme Difficulté,Pas Adapte,Philosophy
875,2015,Philosophie,2,La Notion de Logique,6,Le Theoreme de Completude,5,876,4,QCM,0.5,0.5,43.55,17,23,40,29,17,12,1.38,58.62,Moyen,Moyen,0,Meme Difficulté,Pas Adapte,Philosophy
1999,2016,Philosophie,2,La Notion de Logique,6,Le Theoreme de Completude,5,876,4,QCM,0.73,0.17,24.71,11,35,46,22,11,11,2.09,50.0,Moyen,Difficile,-1,Plus Difficile,Pas Adapte,Philosophy
3123,2017,Philosophie,2,La Notion de Logique,6,Le Theoreme de Completude,5,876,4,QCU,0.1,0.94,79.05,40,10,50,49,40,9,1.02,81.63,Difficile,Facile,2,Beaucoup plus Facile,Pas Adapte,Philosophy
4247,2018,Philosophie,2,La Notion de Logique,6,Le Theoreme de Completude,5,876,4,QCM,0.48,0.48,42.02,21,29,50,25,21,4,2.0,84.0,Difficile,Moyen,1,Plus Facile,Pas Adapte,Philosophy
5371,2019,Philosophie,2,La Notion de Logique,6,Le Theoreme de Completude,5,876,4,QCM,0.24,0.51,38.92,22,34,56,44,22,22,1.27,50.0,Difficile,Moyen,1,Plus Facile,Pas Adapte,Philosophy
6495,2020,Philosophie,2,La Notion de Logique,6,Le Theoreme de Completude,5,876,4,QCM,0.39,0.6,45.17,29,35,64,50,29,21,1.28,58.0,Difficile,Moyen,1,Plus Facile,Pas Adapte,Philosophy
876,2015,Philosophie,2,La Notion de Logique,6,Le Theoreme de Completude,5,877,5,QROC,0.03,0.43,91.41,69,6,75,70,69,1,1.07,98.57,Facile,Facile,0,Meme Difficulté,Pas Adapte,Philosophy
2000,2016,Philosophie,2,La Notion de Logique,6,Le Theoreme de Completude,5,877,5,QROC,0.6,0.23,17.33,14,69,83,56,14,42,1.48,25.0,Moyen,Difficile,-1,Plus Difficile,Pas Adapte,Philosophy
3124,2017,Philosophie,2,La Notion de Logique,6,Le Theoreme de Completude,5,877,5,QROC,0.05,0.59,82.87,66,14,80,70,66,4,1.14,94.29,Facile,Facile,0,Meme Difficulté,Pas Adapte,Philosophy
4248,2018,Philosophie,2,La Notion de Logique,6,Le Theoreme de Completude,5,877,5,QROC,0.43,0.38,36.31,28,48,76,37,28,9,2.05,75.68,Difficile,Moyen,1,Plus Facile,Pas Adapte,Philosophy
5372,2019,Philosophie,2,La Notion de Logique,6,Le Theoreme de Completude,5,877,5,QROC,0.56,0.3,59.92,50,33,83,56,50,6,1.48,89.29,Moyen,Moyen,0,Meme Difficulté,Pas Adapte,Philosophy
6496,2020,Philosophie,2,La Notion de Logique,6,Le Theoreme de Completude,5,877,5,QO,0.91,0.11,33.47,25,50,75,66,25,41,1.14,37.88,Moyen,Difficile,-1,Plus Difficile,Pas Adapte,Philosophy
877,2015,Philosophie,3,La Notion d'Ethique,1,La Recherche d'Ethique,8,878,1,QO,0.77,0.09,8.37,5,55,60,44,5,39,1.36,11.36,Facile,Difficile,-2,Beaucoup plus Difficile,Pas Adapte,Philosophy
2001,2016,Philosophie,3,La Notion d'Ethique,1,La Recherche d'Ethique,8,878,1,QCM,0.57,0.23,17.34,11,51,62,48,11,37,1.29,22.92,Difficile,Difficile,0,Meme Difficulté,Pas Adapte,Philosophy
3125,2017,Philosophie,3,La Notion d'Ethique,1,La Recherche d'Ethique,8,878,1,QCU,0.52,0.25,14.53,10,57,67,43,10,33,1.56,23.26,Moyen,Difficile,-1,Plus Difficile,Pas Adapte,Philosophy
4249,2018,Philosophie,3,La Notion d'Ethique,1,La Recherche d'Ethique,8,878,1,QCU,0.02,0.92,81.22,57,13,70,59,57,2,1.19,96.61,Facile,Facile,0,Meme Difficulté,Pas Adapte,Philosophy
5373,2019,Philosophie,3,La Notion d'Ethique,1,La Recherche d'Ethique,8,878,1,QCU,0.71,0.31,28.53,21,53,74,70,21,49,1.06,30.0,Facile,Difficile,-2,Beaucoup plus Difficile,Pas Adapte,Philosophy
6497,2020,Philosophie,3,La Notion d'Ethique,1,La Recherche d'Ethique,8,878,1,QCM,0.37,0.54,63.37,49,28,77,75,49,26,1.03,65.33,Facile,Moyen,-1,Plus Difficile,Adapte,Philosophy
878,2015,Philosophie,3,La Notion d'Ethique,1,La Recherche d'Ethique,8,879,2,QCU,0.16,0.91,77.14,59,17,76,70,59,11,1.09,84.29,Facile,Facile,0,Meme Difficulté,Pas Adapte,Philosophy
2002,2016,Philosophie,3,La Notion d'Ethique,1,La Recherche d'Ethique,8,879,2,QCU,0.17,0.96,90.59,67,7,74,70,67,3,1.06,95.71,Facile,Facile,0,Meme Difficulté,Pas Adapte,Philosophy
3126,2017,Philosophie,3,La Notion d'Ethique,1,La Recherche d'Ethique,8,879,2,QCM,0.4,0.45,42.27,35,48,83,59,35,24,1.41,59.32,Difficile,Moyen,1,Plus Facile,Pas Adapte,Philosophy
4250,2018,Philosophie,3,La Notion d'Ethique,1,La Recherche d'Ethique,8,879,2,QCM,0.73,0.24,22.4,19,68,87,76,19,57,1.14,25.0,Moyen,Difficile,-1,Plus Difficile,Pas Adapte,Philosophy
5374,2019,Philosophie,3,La Notion d'Ethique,1,La Recherche d'Ethique,8,879,2,QCU,0.31,0.46,41.37,36,50,86,68,36,32,1.26,52.94,Difficile,Moyen,1,Plus Facile,Pas Adapte,Philosophy
6498,2020,Philosophie,3,La Notion d'Ethique,1,La Recherche d'Ethique,8,879,2,QCM,0.15,1.0,76.38,60,18,78,65,60,5,1.2,92.31,Difficile,Facile,2,Beaucoup plus Facile,Pas Adapte,Philosophy
879,2015,Philosophie,3,La Notion d'Ethique,1,La Recherche d'Ethique,8,880,3,QCM,0.04,0.81,75.92,43,13,56,53,43,10,1.06,81.13,Facile,Facile,0,Meme Difficulté,Pas Adapte,Philosophy
2003,2016,Philosophie,3,La Notion d'Ethique,1,La Recherche d'Ethique,8,880,3,QCM,0.45,0.6,58.0,37,26,63,40,37,3,1.57,92.5,Moyen,Moyen,0,Meme Difficulté,Pas Adapte,Philosophy
3127,2017,Philosophie,3,La Notion d'Ethique,1,La Recherche d'Ethique,8,880,3,QCM,0.51,0.2,6.11,4,67,71,69,4,65,1.03,5.8,Facile,Difficile,-2,Beaucoup plus Difficile,Pas Adapte,Philosophy
4251,2018,Philosophie,3,La Notion d'Ethique,1,La Recherche d'Ethique,8,880,3,QCM,0.78,0.21,30.37,20,47,67,42,20,22,1.6,47.62,Moyen,Difficile,-1,Plus Difficile,Pas Adapte,Philosophy
5375,2019,Philosophie,3,La Notion d'Ethique,1,La Recherche d'Ethique,8,880,3,QROC,0.23,0.35,54.6,36,30,66,64,36,28,1.03,56.25,Moyen,Moyen,0,Meme Difficulté,Pas Adapte,Philosophy
6499,2020,Philosophie,3,La Notion d'Ethique,1,La Recherche d'Ethique,8,880,3,QROC,0.87,0.0,3.73,3,69,72,46,3,43,1.57,6.52,Moyen,Difficile,-1,Plus Difficile,Pas Adapte,Philosophy
880,2015,Philosophie,3,La Notion d'Ethique,1,La Recherche d'Ethique,8,881,4,QCM,0.68,0.18,15.02,9,51,60,47,9,38,1.28,19.15,Moyen,Difficile,-1,Plus Difficile,Pas Adapte,Philosophy
2004,2016,Philosophie,3,La Notion d'Ethique,1,La Recherche d'Ethique,8,881,4,QCM,0.19,0.99,83.27,50,10,60,53,50,3,1.13,94.34,Moyen,Facile,1,Plus Facile,Pas Adapte,Philosophy
3128,2017,Philosophie,3,La Notion d'Ethique,1,La Recherche d'Ethique,8,881,4,QCM,0.02,0.77,74.85,49,16,65,56,49,7,1.16,87.5,Moyen,Facile,1,Plus Facile,Adapte,Philosophy
4252,2018,Philosophie,3,La Notion d'Ethique,1,La Recherche d'Ethique,8,881,4,QO,0.19,0.63,74.85,54,18,72,54,54,0,1.33,100.0,Facile,Facile,0,Meme Difficulté,Adapte,Philosophy
5376,2019,Philosophie,3,La Notion d'Ethique,1,La Recherche d'Ethique,8,881,4,QO,0.13,0.35,74.85,54,18,72,61,54,7,1.18,88.52,Facile,Facile,0,Meme Difficulté,Adapte,Philosophy
6500,2020,Philosophie,3,La Notion d'Ethique,1,La Recherche d'Ethique,8,881,4,QO,0.02,0.98,74.85,58,20,78,74,58,16,1.05,78.38,Facile,Facile,0,Meme Difficulté,Adapte,Philosophy
881,2015,Philosophie,3,La Notion d'Ethique,1,La Recherche d'Ethique,8,882,5,QCM,0.38,0.46,44.45,10,13,23,16,10,6,1.44,62.5,Moyen,Moyen,0,Meme Difficulté,Pas Adapte,Philosophy
2005,2016,Philosophie,3,La Notion d'Ethique,1,La Recherche d'Ethique,8,882,5,QCM,0.59,0.3,17.24,4,20,24,8,4,4,3.0,50.0,Moyen,Difficile,-1,Plus Difficile,Pas Adapte,Philosophy
3129,2017,Philosophie,3,La Notion d'Ethique,1,La Recherche d'Ethique,8,882,5,QCM,0.09,0.71,66.45,15,8,23,18,15,3,1.28,83.33,Moyen,Facile,1,Plus Facile,Adapte,Philosophy
4253,2018,Philosophie,3,La Notion d'Ethique,1,La Recherche d'Ethique,8,882,5,QCM,0.13,0.77,66.45,17,9,26,21,17,4,1.24,80.95,Facile,Facile,0,Meme Difficulté,Adapte,Philosophy
5377,2019,Philosophie,3,La Notion d'Ethique,1,La Recherche d'Ethique,8,882,5,QCM,0.02,0.7,66.45,20,10,30,21,20,1,1.43,95.24,Facile,Facile,0,Meme Difficulté,Adapte,Philosophy
6501,2020,Philosophie,3,La Notion d'Ethique,1,La Recherche d'Ethique,8,882,5,QCM,0.0,0.89,66.45,19,9,28,28,19,9,1.0,67.86,Facile,Facile,0,Meme Difficulté,Adapte,Philosophy
882,2015,Philosophie,3,La Notion d'Ethique,1,La Recherche d'Ethique,8,883,6,QCM,0.57,0.26,9.5,5,46,51,30,5,25,1.7,16.67,Moyen,Difficile,-1,Plus Difficile,Pas Adapte,Philosophy
2006,2016,Philosophie,3,La Notion d'Ethique,1,La Recherche d'Ethique,8,883,6,QCM,0.46,0.35,38.74,17,27,44,19,17,2,2.32,89.47,Moyen,Moyen,0,Meme Difficulté,Pas Adapte,Philosophy
3130,2017,Philosophie,3,La Notion d'Ethique,1,La Recherche d'Ethique,8,883,6,QCM,0.13,0.84,99.72,42,0,42,42,42,0,1.0,100.0,Moyen,Facile,1,Plus Facile,Pas Adapte,Philosophy
4254,2018,Philosophie,3,La Notion d'Ethique,1,La Recherche d'Ethique,8,883,6,QCM,0.59,0.26,12.83,5,34,39,26,5,21,1.5,19.23,Difficile,Difficile,0,Meme Difficulté,Pas Adapte,Philosophy
5378,2019,Philosophie,3,La Notion d'Ethique,1,La Recherche d'Ethique,8,883,6,QCM,0.42,0.62,54.07,21,17,38,32,21,11,1.19,65.62,Moyen,Moyen,0,Meme Difficulté,Pas Adapte,Philosophy
6502,2020,Philosophie,3,La Notion d'Ethique,1,La Recherche d'Ethique,8,883,6,QCM,0.71,0.25,25.03,10,28,38,36,10,26,1.06,27.78,Moyen,Difficile,-1,Plus Difficile,Pas Adapte,Philosophy
883,2015,Philosophie,3,La Notion d'Ethique,1,La Recherche d'Ethique,8,884,7,QCU,0.45,0.27,25.51,20,60,80,64,20,44,1.25,31.25,Difficile,Difficile,0,Meme Difficulté,Pas Adapte,Philosophy
2007,2016,Philosophie,3,La Notion d'Ethique,1,La Recherche d'Ethique,8,884,7,QCU,0.14,0.8,72.99,67,25,92,67,67,0,1.37,100.0,Moyen,Facile,1,Plus Facile,Adapte,Philosophy
3131,2017,Philosophie,3,La Notion d'Ethique,1,La Recherche d'Ethique,8,884,7,QCU,0.07,0.87,72.99,63,23,86,81,63,18,1.06,77.78,Facile,Facile,0,Meme Difficulté,Adapte,Philosophy
4255,2018,Philosophie,3,La Notion d'Ethique,1,La Recherche d'Ethique,8,884,7,QCU,0.16,0.99,72.99,66,25,91,81,66,15,1.12,81.48,Facile,Facile,0,Meme Difficulté,Adapte,Philosophy
5379,2019,Philosophie,3,La Notion d'Ethique,1,La Recherche d'Ethique,8,884,7,QCU,0.07,0.98,72.99,58,21,79,63,58,5,1.25,92.06,Facile,Facile,0,Meme Difficulté,Adapte,Philosophy
6503,2020,Philosophie,3,La Notion d'Ethique,1,La Recherche d'Ethique,8,884,7,QCU,0.13,0.88,72.99,57,21,78,64,57,7,1.22,89.06,Facile,Facile,0,Meme Difficulté,Adapte,Philosophy
884,2015,Philosophie,3,La Notion d'Ethique,1,La Recherche d'Ethique,8,885,8,QCU,0.31,0.65,47.01,11,12,23,17,11,6,1.35,64.71,Moyen,Moyen,0,Meme Difficulté,Pas Adapte,Philosophy
2008,2016,Philosophie,3,La Notion d'Ethique,1,La Recherche d'Ethique,8,885,8,QCU,0.26,0.66,48.7,13,13,26,14,13,1,1.86,92.86,Facile,Moyen,-1,Plus Difficile,Pas Adapte,Philosophy
3132,2017,Philosophie,3,La Notion d'Ethique,1,La Recherche d'Ethique,8,885,8,QCU,0.15,0.87,73.51,18,7,25,24,18,6,1.04,75.0,Facile,Facile,0,Meme Difficulté,Adapte,Philosophy
4256,2018,Philosophie,3,La Notion d'Ethique,1,La Recherche d'Ethique,8,885,8,QCU,0.12,0.9,73.51,15,6,21,19,15,4,1.11,78.95,Facile,Facile,0,Meme Difficulté,Adapte,Philosophy
5380,2019,Philosophie,3,La Notion d'Ethique,1,La Recherche d'Ethique,8,885,8,QCM,0.13,0.71,73.51,16,6,22,18,16,2,1.22,88.89,Facile,Facile,0,Meme Difficulté,Adapte,Philosophy
6504,2020,Philosophie,3,La Notion d'Ethique,1,La Recherche d'Ethique,8,885,8,QCM,0.16,0.93,73.51,16,6,22,20,16,4,1.1,80.0,Facile,Facile,0,Meme Difficulté,Adapte,Philosophy
885,2015,Philosophie,3,La Notion d'Ethique,2,Libre Arbitre et Determinisme,9,886,1,QCM,0.01,0.72,83.46,5,1,6,6,5,1,1.0,83.33,Difficile,Facile,2,Beaucoup plus Facile,Pas Adapte,Philosophy
2009,2016,Philosophie,3,La Notion d'Ethique,2,Libre Arbitre et Determinisme,9,886,1,QCM,0.48,0.64,50.01,3,2,5,3,3,0,1.67,100.0,Facile,Moyen,-1,Plus Difficile,Pas Adapte,Philosophy
3133,2017,Philosophie,3,La Notion d'Ethique,2,Libre Arbitre et Determinisme,9,886,1,QCM,0.04,0.77,78.09,5,1,6,5,5,0,1.2,100.0,Facile,Facile,0,Meme Difficulté,Pas Adapte,Philosophy
4257,2018,Philosophie,3,La Notion d'Ethique,2,Libre Arbitre et Determinisme,9,886,1,QCM,0.08,0.9,94.28,5,0,5,5,5,0,1.0,100.0,Moyen,Facile,1,Plus Facile,Pas Adapte,Philosophy
5381,2019,Philosophie,3,La Notion d'Ethique,2,Libre Arbitre et Determinisme,9,886,1,QCM,0.48,0.7,46.27,2,2,4,2,2,0,2.0,100.0,Moyen,Moyen,0,Meme Difficulté,Pas Adapte,Philosophy
6505,2020,Philosophie,3,La Notion d'Ethique,2,Libre Arbitre et Determinisme,9,886,1,QCM,0.77,0.22,34.9,2,3,5,4,2,2,1.25,50.0,Moyen,Difficile,-1,Plus Difficile,Pas Adapte,Philosophy
886,2015,Philosophie,3,La Notion d'Ethique,2,Libre Arbitre et Determinisme,9,887,2,QCU,0.22,0.5,47.82,12,13,25,16,12,4,1.56,75.0,Difficile,Moyen,1,Plus Facile,Pas Adapte,Philosophy
2010,2016,Philosophie,3,La Notion d'Ethique,2,Libre Arbitre et Determinisme,9,887,2,QROC,0.12,0.82,78.62,20,6,26,24,20,4,1.08,83.33,Difficile,Facile,2,Beaucoup plus Facile,Pas Adapte,Philosophy
3134,2017,Philosophie,3,La Notion d'Ethique,2,Libre Arbitre et Determinisme,9,887,2,QROC,0.18,0.75,85.49,20,3,23,20,20,0,1.15,100.0,Moyen,Facile,1,Plus Facile,Pas Adapte,Philosophy
4258,2018,Philosophie,3,La Notion d'Ethique,2,Libre Arbitre et Determinisme,9,887,2,QROC,0.57,0.4,44.3,11,14,25,14,11,3,1.79,78.57,Facile,Moyen,-1,Plus Difficile,Pas Adapte,Philosophy
5382,2019,Philosophie,3,La Notion d'Ethique,2,Libre Arbitre et Determinisme,9,887,2,QROC,0.68,0.07,12.26,3,19,22,15,3,12,1.47,20.0,Difficile,Difficile,0,Meme Difficulté,Pas Adapte,Philosophy
6506,2020,Philosophie,3,La Notion d'Ethique,2,Libre Arbitre et Determinisme,9,887,2,QROC,0.25,0.32,47.96,11,11,22,18,11,7,1.22,61.11,Difficile,Moyen,1,Plus Facile,Pas Adapte,Philosophy
887,2015,Philosophie,3,La Notion d'Ethique,2,Libre Arbitre et Determinisme,9,888,3,QO,0.6,0.28,55.34,4,4,8,8,4,4,1.0,50.0,Moyen,Moyen,0,Meme Difficulté,Pas Adapte,Philosophy
2011,2016,Philosophie,3,La Notion d'Ethique,2,Libre Arbitre et Determinisme,9,888,3,QO,0.48,0.3,42.58,3,4,7,6,3,3,1.17,50.0,Facile,Moyen,-1,Plus Difficile,Pas Adapte,Philosophy
3135,2017,Philosophie,3,La Notion d'Ethique,2,Libre Arbitre et Determinisme,9,888,3,QO,0.79,0.03,31.31,3,5,8,4,3,1,2.0,75.0,Difficile,Difficile,0,Meme Difficulté,Pas Adapte,Philosophy
4259,2018,Philosophie,3,La Notion d'Ethique,2,Libre Arbitre et Determinisme,9,888,3,QO,0.63,0.29,64.11,6,3,9,8,6,2,1.12,75.0,Difficile,Moyen,1,Plus Facile,Adapte,Philosophy
5383,2019,Philosophie,3,La Notion d'Ethique,2,Libre Arbitre et Determinisme,9,888,3,QO,0.41,0.24,64.11,6,4,10,10,6,4,1.0,60.0,Moyen,Moyen,0,Meme Difficulté,Adapte,Philosophy
6507,2020,Philosophie,3,La Notion d'Ethique,2,Libre Arbitre et Determinisme,9,888,3,QO,0.73,0.21,64.11,6,3,9,8,6,2,1.12,75.0,Moyen,Moyen,0,Meme Difficulté,Adapte,Philosophy
888,2015,Philosophie,3,La Notion d'Ethique,2,Libre Arbitre et Determinisme,9,889,4,QCM,0.34,0.51,48.89,17,18,35,20,17,3,1.75,85.0,Difficile,Moyen,1,Plus Facile,Pas Adapte,Philosophy
2012,2016,Philosophie,3,La Notion d'Ethique,2,Libre Arbitre et Determinisme,9,889,4,QCM,0.13,0.98,72.44,27,10,37,29,27,2,1.28,93.1,Difficile,Facile,2,Beaucoup plus Facile,Adapte,Philosophy
3136,2017,Philosophie,3,La Notion d'Ethique,2,Libre Arbitre et Determinisme,9,889,4,QCM,0.08,0.77,72.44,23,9,32,32,23,9,1.0,71.88,Facile,Facile,0,Meme Difficulté,Adapte,Philosophy
4260,2018,Philosophie,3,La Notion d'Ethique,2,Libre Arbitre et Determinisme,9,889,4,QCU,0.0,0.85,72.44,22,9,31,24,22,2,1.29,91.67,Facile,Facile,0,Meme Difficulté,Adapte,Philosophy
5384,2019,Philosophie,3,La Notion d'Ethique,2,Libre Arbitre et Determinisme,9,889,4,QCU,0.15,0.78,72.44,20,7,27,22,20,2,1.23,90.91,Facile,Facile,0,Meme Difficulté,Adapte,Philosophy
6508,2020,Philosophie,3,La Notion d'Ethique,2,Libre Arbitre et Determinisme,9,889,4,QCU,0.02,0.76,72.44,17,6,23,21,17,4,1.1,80.95,Facile,Facile,0,Meme Difficulté,Adapte,Philosophy
889,2015,Philosophie,3,La Notion d'Ethique,2,Libre Arbitre et Determinisme,9,890,5,QCM,0.73,0.27,8.09,1,7,8,7,1,6,1.14,14.29,Moyen,Difficile,-1,Plus Difficile,Pas Adapte,Philosophy
2013,2016,Philosophie,3,La Notion d'Ethique,2,Libre Arbitre et Determinisme,9,890,5,QCM,0.65,0.19,10.12,1,7,8,5,1,4,1.6,20.0,Facile,Difficile,-2,Beaucoup plus Difficile,Pas Adapte,Philosophy
3137,2017,Philosophie,3,La Notion d'Ethique,2,Libre Arbitre et Determinisme,9,890,5,QCM,0.55,0.21,17.54,1,7,8,7,1,6,1.14,14.29,Difficile,Difficile,0,Meme Difficulté,Pas Adapte,Philosophy
4261,2018,Philosophie,3,La Notion d'Ethique,2,Libre Arbitre et Determinisme,9,890,5,QCM,0.01,0.79,81.3,7,1,8,8,7,1,1.0,87.5,Facile,Facile,0,Meme Difficulté,Pas Adapte,Philosophy
5385,2019,Philosophie,3,La Notion d'Ethique,2,Libre Arbitre et Determinisme,9,890,5,QCM,0.05,0.95,87.51,7,1,8,8,7,1,1.0,87.5,Facile,Facile,0,Meme Difficulté,Pas Adapte,Philosophy
6509,2020,Philosophie,3,La Notion d'Ethique,2,Libre Arbitre et Determinisme,9,890,5,QCM,0.69,0.18,18.91,2,6,8,6,2,4,1.33,33.33,Difficile,Difficile,0,Meme Difficulté,Pas Adapte,Philosophy
890,2015,Philosophie,3,La Notion d'Ethique,2,Libre Arbitre et Determinisme,9,891,6,QCU,0.54,0.24,28.63,3,6,9,6,3,3,1.5,50.0,Facile,Difficile,-2,Beaucoup plus Difficile,Pas Adapte,Philosophy
2014,2016,Philosophie,3,La Notion d'Ethique,2,Libre Arbitre et Determinisme,9,891,6,QCU,0.05,0.97,89.54,8,1,9,9,8,1,1.0,88.89,Moyen,Facile,1,Plus Facile,Pas Adapte,Philosophy
3138,2017,Philosophie,3,La Notion d'Ethique,2,Libre Arbitre et Determinisme,9,891,6,QCU,0.22,0.51,64.12,6,3,9,7,6,1,1.29,85.71,Difficile,Moyen,1,Plus Facile,Adapte,Philosophy
4262,2018,Philosophie,3,La Notion d'Ethique,2,Libre Arbitre et Determinisme,9,891,6,QCU,0.37,0.59,64.12,6,4,10,9,6,3,1.11,66.67,Moyen,Moyen,0,Meme Difficulté,Adapte,Philosophy
5386,2019,Philosophie,3,La Notion d'Ethique,2,Libre Arbitre et Determinisme,9,891,6,QCU,0.28,0.48,64.12,5,3,8,6,5,1,1.33,83.33,Moyen,Moyen,0,Meme Difficulté,Adapte,Philosophy
6510,2020,Philosophie,3,La Notion d'Ethique,2,Libre Arbitre et Determinisme,9,891,6,QCU,0.24,0.48,64.12,6,3,9,9,6,3,1.0,66.67,Moyen,Moyen,0,Meme Difficulté,Adapte,Philosophy
891,2015,Philosophie,3,La Notion d'Ethique,2,Libre Arbitre et Determinisme,9,892,7,QCM,0.53,0.29,9.02,3,28,31,30,3,27,1.03,10.0,Moyen,Difficile,-1,Plus Difficile,Pas Adapte,Philosophy
2015,2016,Philosophie,3,La Notion d'Ethique,2,Libre Arbitre et Determinisme,9,892,7,QCM,0.11,0.8,89.93,26,3,29,27,26,1,1.07,96.3,Difficile,Facile,2,Beaucoup plus Facile,Pas Adapte,Philosophy
3139,2017,Philosophie,3,La Notion d'Ethique,2,Libre Arbitre et Determinisme,9,892,7,QCM,0.12,0.95,85.47,27,5,32,29,27,2,1.1,93.1,Difficile,Facile,2,Beaucoup plus Facile,Pas Adapte,Philosophy
4263,2018,Philosophie,3,La Notion d'Ethique,2,Libre Arbitre et Determinisme,9,892,7,QCM,0.61,0.17,3.56,1,35,36,12,1,11,3.0,8.33,Difficile,Difficile,0,Meme Difficulté,Pas Adapte,Philosophy
5387,2019,Philosophie,3,La Notion d'Ethique,2,Libre Arbitre et Determinisme,9,892,7,QCM,0.27,0.66,47.33,19,21,40,27,19,8,1.48,70.37,Difficile,Moyen,1,Plus Facile,Pas Adapte,Philosophy
6511,2020,Philosophie,3,La Notion d'Ethique,2,Libre Arbitre et Determinisme,9,892,7,QCM,0.35,0.61,51.41,21,20,41,28,21,7,1.46,75.0,Facile,Moyen,-1,Plus Difficile,Pas Adapte,Philosophy
892,2015,Philosophie,3,La Notion d'Ethique,2,Libre Arbitre et Determinisme,9,893,8,QCU,0.3,0.57,44.03,11,14,25,22,11,11,1.14,50.0,Moyen,Moyen,0,Meme Difficulté,Pas Adapte,Philosophy
2016,2016,Philosophie,3,La Notion d'Ethique,2,Libre Arbitre et Determinisme,9,893,8,QCU,0.14,0.78,89.0,19,2,21,20,19,1,1.05,95.0,Difficile,Facile,2,Beaucoup plus Facile,Pas Adapte,Philosophy
3140,2017,Philosophie,3,La Notion d'Ethique,2,Libre Arbitre et Determinisme,9,893,8,QCU,0.52,0.39,14.93,3,16,19,7,3,4,2.71,42.86,Facile,Difficile,-2,Beaucoup plus Difficile,Pas Adapte,Philosophy
4264,2018,Philosophie,3,La Notion d'Ethique,2,Libre Arbitre et Determinisme,9,893,8,QCU,0.12,0.92,85.26,14,3,17,16,14,2,1.06,87.5,Difficile,Facile,2,Beaucoup plus Facile,Pas Adapte,Philosophy
5388,2019,Philosophie,3,La Notion d'Ethique,2,Libre Arbitre et Determinisme,9,893,8,QCU,0.3,0.6,50.07,10,10,20,12,10,2,1.67,83.33,Moyen,Moyen,0,Meme Difficulté,Pas Adapte,Philosophy
6512,2020,Philosophie,3,La Notion d'Ethique,2,Libre Arbitre et Determinisme,9,893,8,QCU,0.02,0.87,96.21,19,1,20,19,19,0,1.05,100.0,Difficile,Facile,2,Beaucoup plus Facile,Pas Adapte,Philosophy
893,2015,Philosophie,3,La Notion d'Ethique,2,Libre Arbitre et Determinisme,9,894,9,QCU,0.22,0.62,51.1,32,30,62,49,32,17,1.27,65.31,Difficile,Moyen,1,Plus Facile,Pas Adapte,Philosophy
2017,2016,Philosophie,3,La Notion d'Ethique,2,Libre Arbitre et Determinisme,9,894,9,QCM,0.08,0.87,82.44,46,10,56,51,46,5,1.1,90.2,Facile,Facile,0,Meme Difficulté,Pas Adapte,Philosophy
3141,2017,Philosophie,3,La Notion d'Ethique,2,Libre Arbitre et Determinisme,9,894,9,QCM,0.31,0.31,41.55,22,32,54,33,22,11,1.64,66.67,Difficile,Moyen,1,Plus Facile,Pas Adapte,Philosophy
4265,2018,Philosophie,3,La Notion d'Ethique,2,Libre Arbitre et Determinisme,9,894,9,QCM,0.28,0.45,41.75,24,33,57,30,24,6,1.9,80.0,Facile,Moyen,-1,Plus Difficile,Pas Adapte,Philosophy
5389,2019,Philosophie,3,La Notion d'Ethique,2,Libre Arbitre et Determinisme,9,894,9,QCM,0.06,0.7,94.27,50,3,53,52,50,2,1.02,96.15,Facile,Facile,0,Meme Difficulté,Pas Adapte,Philosophy
6513,2020,Philosophie,3,La Notion d'Ethique,2,Libre Arbitre et Determinisme,9,894,9,QCU,0.04,0.88,95.92,46,2,48,47,46,1,1.02,97.87,Facile,Facile,0,Meme Difficulté,Pas Adapte,Philosophy
894,2015,Philosophie,3,La Notion d'Ethique,3,Ethique du Devoir et Ethique Religieuse,5,895,1,QROC,0.18,0.58,71.78,31,12,43,42,31,11,1.02,73.81,Facile,Facile,0,Meme Difficulté,Adapte,Philosophy
2018,2016,Philosophie,3,La Notion d'Ethique,3,Ethique du Devoir et Ethique Religieuse,5,895,1,QROC,0.06,0.67,71.78,34,13,47,45,34,11,1.04,75.56,Facile,Facile,0,Meme Difficulté,Adapte,Philosophy
3142,2017,Philosophie,3,La Notion d'Ethique,3,Ethique du Devoir et Ethique Religieuse,5,895,1,QROC,0.11,0.76,71.78,32,12,44,43,32,11,1.02,74.42,Facile,Facile,0,Meme Difficulté,Adapte,Philosophy
4266,2018,Philosophie,3,La Notion d'Ethique,3,Ethique du Devoir et Ethique Religieuse,5,895,1,QROC,0.17,0.42,71.78,29,12,41,35,29,6,1.17,82.86,Facile,Facile,0,Meme Difficulté,Adapte,Philosophy
5390,2019,Philosophie,3,La Notion d'Ethique,3,Ethique du Devoir et Ethique Religieuse,5,895,1,QROC,0.07,0.55,71.78,28,11,39,37,28,9,1.05,75.68,Facile,Facile,0,Meme Difficulté,Adapte,Philosophy
6514,2020,Philosophie,3,La Notion d'Ethique,3,Ethique du Devoir et Ethique Religieuse,5,895,1,QO,0.13,0.97,71.78,27,11,38,38,27,11,1.0,71.05,Facile,Facile,0,Meme Difficulté,Adapte,Philosophy
895,2015,Philosophie,3,La Notion d'Ethique,3,Ethique du Devoir et Ethique Religieuse,5,896,2,QCU,0.21,0.53,46.67,42,48,90,85,42,43,1.06,49.41,Moyen,Moyen,0,Meme Difficulté,Pas Adapte,Philosophy
2019,2016,Philosophie,3,La Notion d'Ethique,3,Ethique du Devoir et Ethique Religieuse,5,896,2,QCU,0.2,0.98,70.86,69,28,97,84,69,15,1.15,82.14,Facile,Facile,0,Meme Difficulté,Adapte,Philosophy
3143,2017,Philosophie,3,La Notion d'Ethique,3,Ethique du Devoir et Ethique Religieuse,5,896,2,QCU,0.18,0.88,70.86,75,31,106,96,75,21,1.1,78.12,Facile,Facile,0,Meme Difficulté,Adapte,Philosophy
4267,2018,Philosophie,3,La Notion d'Ethique,3,Ethique du Devoir et Ethique Religieuse,5,896,2,QCU,0.01,0.89,70.86,86,36,122,100,86,14,1.22,86.0,Facile,Facile,0,Meme Difficulté,Adapte,Philosophy
5391,2019,Philosophie,3,La Notion d'Ethique,3,Ethique du Devoir et Ethique Religieuse,5,896,2,QCU,0.17,0.97,70.86,84,34,118,108,84,24,1.09,77.78,Facile,Facile,0,Meme Difficulté,Adapte,Philosophy
6515,2020,Philosophie,3,La Notion d'Ethique,3,Ethique du Devoir et Ethique Religieuse,5,896,2,QCM,0.14,0.91,70.86,77,31,108,82,77,5,1.32,93.9,Facile,Facile,0,Meme Difficulté,Adapte,Philosophy
896,2015,Philosophie,3,La Notion d'Ethique,3,Ethique du Devoir et Ethique Religieuse,5,897,3,QO,0.44,0.19,48.92,40,41,81,75,40,35,1.08,53.33,Facile,Moyen,-1,Plus Difficile,Pas Adapte,Philosophy
2020,2016,Philosophie,3,La Notion d'Ethique,3,Ethique du Devoir et Ethique Religieuse,5,897,3,QCM,0.66,0.28,24.37,19,57,76,68,19,49,1.12,27.94,Facile,Difficile,-2,Beaucoup plus Difficile,Pas Adapte,Philosophy
3144,2017,Philosophie,3,La Notion d'Ethique,3,Ethique du Devoir et Ethique Religieuse,5,897,3,QCM,0.59,0.2,22.7,16,55,71,56,16,40,1.27,28.57,Moyen,Difficile,-1,Plus Difficile,Pas Adapte,Philosophy
4268,2018,Philosophie,3,La Notion d'Ethique,3,Ethique du Devoir et Ethique Religieuse,5,897,3,QCM,0.12,0.99,94.11,72,4,76,73,72,1,1.04,98.63,Facile,Facile,0,Meme Difficulté,Pas Adapte,Philosophy
5392,2019,Philosophie,3,La Notion d'Ethique,3,Ethique du Devoir et Ethique Religieuse,5,897,3,QCU,0.13,0.81,68.65,52,24,76,52,52,0,1.46,100.0,Difficile,Facile,2,Beaucoup plus Facile,Adapte,Philosophy
6516,2020,Philosophie,3,La Notion d'Ethique,3,Ethique du Devoir et Ethique Religieuse,5,897,3,QCU,0.08,0.9,68.65,46,21,67,62,46,16,1.08,74.19,Facile,Facile,0,Meme Difficulté,Adapte,Philosophy
897,2015,Philosophie,3,La Notion d'Ethique,3,Ethique du Devoir et Ethique Religieuse,5,898,4,QCU,0.64,0.21,34.69,6,10,16,14,6,8,1.14,42.86,Facile,Difficile,-2,Beaucoup plus Difficile,Pas Adapte,Philosophy
2021,2016,Philosophie,3,La Notion d'Ethique,3,Ethique du Devoir et Ethique Religieuse,5,898,4,QCU,0.06,0.76,98.02,18,0,18,18,18,0,1.0,100.0,Facile,Facile,0,Meme Difficulté,Pas Adapte,Philosophy
3145,2017,Philosophie,3,La Notion d'Ethique,3,Ethique du Devoir et Ethique Religieuse,5,898,4,QCU,0.53,0.38,9.98,2,18,20,7,2,5,2.86,28.57,Facile,Difficile,-2,Beaucoup plus Difficile,Pas Adapte,Philosophy
4269,2018,Philosophie,3,La Notion d'Ethique,3,Ethique du Devoir et Ethique Religieuse,5,898,4,QCU,0.36,0.68,38.92,7,12,19,13,7,6,1.46,53.85,Facile,Moyen,-1,Plus Difficile,Pas Adapte,Philosophy
5393,2019,Philosophie,3,La Notion d'Ethique,3,Ethique du Devoir et Ethique Religieuse,5,898,4,QCM,0.26,0.62,45.77,10,11,21,13,10,3,1.62,76.92,Facile,Moyen,-1,Plus Difficile,Pas Adapte,Philosophy
6517,2020,Philosophie,3,La Notion d'Ethique,3,Ethique du Devoir et Ethique Religieuse,5,898,4,QCM,0.79,0.2,18.86,3,15,18,10,3,7,1.8,30.0,Moyen,Difficile,-1,Plus Difficile,Pas Adapte,Philosophy
898,2015,Philosophie,3,La Notion d'Ethique,3,Ethique du Devoir et Ethique Religieuse,5,899,5,QO,0.98,0.06,0.75,1,76,77,74,1,73,1.04,1.35,Moyen,Difficile,-1,Plus Difficile,Pas Adapte,Philosophy
2022,2016,Philosophie,3,La Notion d'Ethique,3,Ethique du Devoir et Ethique Religieuse,5,899,5,QO,0.94,0.12,32.19,26,55,81,75,26,49,1.08,34.67,Facile,Difficile,-2,Beaucoup plus Difficile,Pas Adapte,Philosophy
3146,2017,Philosophie,3,La Notion d'Ethique,3,Ethique du Devoir et Ethique Religieuse,5,899,5,QO,0.05,0.35,78.24,66,18,84,77,66,11,1.09,85.71,Difficile,Facile,2,Beaucoup plus Facile,Pas Adapte,Philosophy
4270,2018,Philosophie,3,La Notion d'Ethique,3,Ethique du Devoir et Ethique Religieuse,5,899,5,QO,0.77,0.04,19.74,16,65,81,44,16,28,1.84,36.36,Moyen,Difficile,-1,Plus Difficile,Pas Adapte,Philosophy
5394,2019,Philosophie,3,La Notion d'Ethique,3,Ethique du Devoir et Ethique Religieuse,5,899,5,QO,0.02,0.47,97.82,87,2,89,87,87,0,1.02,100.0,Moyen,Facile,1,Plus Facile,Pas Adapte,Philosophy
6518,2020,Philosophie,3,La Notion d'Ethique,3,Ethique du Devoir et Ethique Religieuse,5,899,5,QO,0.49,0.24,60.47,48,32,80,75,48,27,1.07,64.0,Difficile,Moyen,1,Plus Facile,Adapte,Philosophy
899,2015,Philosophie,4,La Culture,1,Sentiments Croyance et Cultes Religieux,6,900,1,QCU,0.39,0.57,37.13,30,51,81,34,30,4,2.38,88.24,Facile,Moyen,-1,Plus Difficile,Pas Adapte,Philosophy
2023,2016,Philosophie,4,La Culture,1,Sentiments Croyance et Cultes Religieux,6,900,1,QCU,0.1,0.8,77.6,68,20,88,76,68,8,1.16,89.47,Facile,Facile,0,Meme Difficulté,Pas Adapte,Philosophy
3147,2017,Philosophie,4,La Culture,1,Sentiments Croyance et Cultes Religieux,6,900,1,QCU,0.38,0.46,53.2,48,43,91,73,48,25,1.25,65.75,Moyen,Moyen,0,Meme Difficulté,Pas Adapte,Philosophy
4271,2018,Philosophie,4,La Culture,1,Sentiments Croyance et Cultes Religieux,6,900,1,QCU,0.08,0.86,70.76,60,25,85,73,60,13,1.16,82.19,Difficile,Facile,2,Beaucoup plus Facile,Adapte,Philosophy
5395,2019,Philosophie,4,La Culture,1,Sentiments Croyance et Cultes Religieux,6,900,1,QCU,0.03,1.0,70.76,60,25,85,63,60,3,1.35,95.24,Facile,Facile,0,Meme Difficulté,Adapte,Philosophy
6519,2020,Philosophie,4,La Culture,1,Sentiments Croyance et Cultes Religieux,6,900,1,QCU,0.09,0.93,70.76,64,26,90,74,64,10,1.22,86.49,Facile,Facile,0,Meme Difficulté,Adapte,Philosophy
900,2015,Philosophie,4,La Culture,1,Sentiments Croyance et Cultes Religieux,6,901,2,QCU,0.44,0.22,31.08,24,54,78,39,24,15,2.0,61.54,Difficile,Difficile,0,Meme Difficulté,Pas Adapte,Philosophy
2024,2016,Philosophie,4,La Culture,1,Sentiments Croyance et Cultes Religieux,6,901,2,QCU,0.01,0.91,97.81,79,2,81,80,79,1,1.01,98.75,Difficile,Facile,2,Beaucoup plus Facile,Pas Adapte,Philosophy
3148,2017,Philosophie,4,La Culture,1,Sentiments Croyance et Cultes Religieux,6,901,2,QCU,0.39,0.61,63.64,54,31,85,77,54,23,1.1,70.13,Facile,Moyen,-1,Plus Difficile,Adapte,Philosophy
4272,2018,Philosophie,4,La Culture,1,Sentiments Croyance et Cultes Religieux,6,901,2,QCU,0.23,0.58,63.64,52,29,81,64,52,12,1.27,81.25,Moyen,Moyen,0,Meme Difficulté,Adapte,Philosophy
5396,2019,Philosophie,4,La Culture,1,Sentiments Croyance et Cultes Religieux,6,901,2,QCM,0.47,0.33,63.64,59,33,92,76,59,17,1.21,77.63,Moyen,Moyen,0,Meme Difficulté,Adapte,Philosophy
6520,2020,Philosophie,4,La Culture,1,Sentiments Croyance et Cultes Religieux,6,901,2,QCM,0.33,0.46,63.64,56,32,88,66,56,10,1.33,84.85,Moyen,Moyen,0,Meme Difficulté,Adapte,Philosophy
901,2015,Philosophie,4,La Culture,1,Sentiments Croyance et Cultes Religieux,6,902,3,QCU,0.04,0.79,96.4,12,0,12,12,12,0,1.0,100.0,Difficile,Facile,2,Beaucoup plus Facile,Pas Adapte,Philosophy
2025,2016,Philosophie,4,La Culture,1,Sentiments Croyance et Cultes Religieux,6,902,3,QCU,0.24,0.48,55.79,6,4,10,9,6,3,1.11,66.67,Moyen,Moyen,0,Meme Difficulté,Pas Adapte,Philosophy
3149,2017,Philosophie,4,La Culture,1,Sentiments Croyance et Cultes Religieux,6,902,3,QCU,0.45,0.23,28.56,3,8,11,8,3,5,1.38,37.5,Facile,Difficile,-2,Beaucoup plus Difficile,Pas Adapte,Philosophy
4273,2018,Philosophie,4,La Culture,1,Sentiments Croyance et Cultes Religieux,6,902,3,QCU,0.06,0.86,71.83,9,4,13,11,9,2,1.18,81.82,Moyen,Facile,1,Plus Facile,Adapte,Philosophy
5397,2019,Philosophie,4,La Culture,1,Sentiments Croyance et Cultes Religieux,6,902,3,QCU,0.16,0.77,71.83,9,4,13,11,9,2,1.18,81.82,Facile,Facile,0,Meme Difficulté,Adapte,Philosophy
6521,2020,Philosophie,4,La Culture,1,Sentiments Croyance et Cultes Religieux,6,902,3,QCU,0.13,0.87,71.83,9,3,12,11,9,2,1.09,81.82,Facile,Facile,0,Meme Difficulté,Adapte,Philosophy
902,2015,Philosophie,4,La Culture,1,Sentiments Croyance et Cultes Religieux,6,903,4,QROC,0.76,0.25,11.55,10,78,88,76,10,66,1.16,13.16,Difficile,Difficile,0,Meme Difficulté,Pas Adapte,Philosophy
2026,2016,Philosophie,4,La Culture,1,Sentiments Croyance et Cultes Religieux,6,903,4,QROC,0.92,0.22,24.44,21,65,86,66,21,45,1.3,31.82,Difficile,Difficile,0,Meme Difficulté,Pas Adapte,Philosophy
3150,2017,Philosophie,4,La Culture,1,Sentiments Croyance et Cultes Religieux,6,903,4,QCM,0.44,0.42,64.77,58,32,90,65,58,7,1.38,89.23,Difficile,Moyen,1,Plus Facile,Adapte,Philosophy
4274,2018,Philosophie,4,La Culture,1,Sentiments Croyance et Cultes Religieux,6,903,4,QCM,0.42,0.51,64.77,57,31,88,86,57,29,1.02,66.28,Moyen,Moyen,0,Meme Difficulté,Adapte,Philosophy
5398,2019,Philosophie,4,La Culture,1,Sentiments Croyance et Cultes Religieux,6,903,4,QCM,0.27,0.32,64.77,49,27,76,52,49,3,1.46,94.23,Moyen,Moyen,0,Meme Difficulté,Adapte,Philosophy
6522,2020,Philosophie,4,La Culture,1,Sentiments Croyance et Cultes Religieux,6,903,4,QCU,0.2,0.57,64.77,54,29,83,66,54,12,1.26,81.82,Moyen,Moyen,0,Meme Difficulté,Adapte,Philosophy
903,2015,Philosophie,4,La Culture,1,Sentiments Croyance et Cultes Religieux,6,904,5,QO,0.09,0.44,70.38,56,23,79,73,56,17,1.08,76.71,Moyen,Facile,1,Plus Facile,Adapte,Philosophy
2027,2016,Philosophie,4,La Culture,1,Sentiments Croyance et Cultes Religieux,6,904,5,QO,0.17,0.93,70.38,49,21,70,49,49,0,1.43,100.0,Facile,Facile,0,Meme Difficulté,Adapte,Philosophy
3151,2017,Philosophie,4,La Culture,1,Sentiments Croyance et Cultes Religieux,6,904,5,QO,0.08,0.38,70.38,56,23,79,63,56,7,1.25,88.89,Facile,Facile,0,Meme Difficulté,Adapte,Philosophy
4275,2018,Philosophie,4,La Culture,1,Sentiments Croyance et Cultes Religieux,6,904,5,QO,0.09,0.92,70.38,61,26,87,65,61,4,1.34,93.85,Facile,Facile,0,Meme Difficulté,Adapte,Philosophy
5399,2019,Philosophie,4,La Culture,1,Sentiments Croyance et Cultes Religieux,6,904,5,QO,0.04,0.55,70.38,70,29,99,77,70,7,1.29,90.91,Facile,Facile,0,Meme Difficulté,Adapte,Philosophy
6523,2020,Philosophie,4,La Culture,1,Sentiments Croyance et Cultes Religieux,6,904,5,QROC,0.16,0.4,70.38,63,26,89,75,63,12,1.19,84.0,Facile,Facile,0,Meme Difficulté,Adapte,Philosophy
904,2015,Philosophie,4,La Culture,1,Sentiments Croyance et Cultes Religieux,6,905,6,QCM,0.46,0.39,44.34,39,50,89,46,39,7,1.93,84.78,Facile,Moyen,-1,Plus Difficile,Pas Adapte,Philosophy
2028,2016,Philosophie,4,La Culture,1,Sentiments Croyance et Cultes Religieux,6,905,6,QCM,0.18,0.79,98.64,84,1,85,85,84,1,1.0,98.82,Difficile,Facile,2,Beaucoup plus Facile,Pas Adapte,Philosophy
3152,2017,Philosophie,4,La Culture,1,Sentiments Croyance et Cultes Religieux,6,905,6,QCM,0.16,0.85,96.57,70,2,72,71,70,1,1.01,98.59,Difficile,Facile,2,Beaucoup plus Facile,Pas Adapte,Philosophy
4276,2018,Philosophie,4,La Culture,1,Sentiments Croyance et Cultes Religieux,6,905,6,QCU,0.13,0.91,87.46,53,8,61,58,53,5,1.05,91.38,Difficile,Facile,2,Beaucoup plus Facile,Pas Adapte,Philosophy
5400,2019,Philosophie,4,La Culture,1,Sentiments Croyance et Cultes Religieux,6,905,6,QCU,0.15,0.9,87.91,55,7,62,61,55,6,1.02,90.16,Difficile,Facile,2,Beaucoup plus Facile,Pas Adapte,Philosophy
6524,2020,Philosophie,4,La Culture,1,Sentiments Croyance et Cultes Religieux,6,905,6,QCM,0.56,0.2,19.13,12,50,62,44,12,32,1.41,27.27,Facile,Difficile,-2,Beaucoup plus Difficile,Pas Adapte,Philosophy
905,2015,Philosophie,4,La Culture,2,Croyances Religieuses et Verite,9,906,1,QCM,0.24,0.54,35.78,19,34,53,25,19,6,2.12,76.0,Facile,Moyen,-1,Plus Difficile,Pas Adapte,Philosophy
2029,2016,Philosophie,4,La Culture,2,Croyances Religieuses et Verite,9,906,1,QCM,0.17,0.77,97.17,45,1,46,46,45,1,1.0,97.83,Facile,Facile,0,Meme Difficulté,Pas Adapte,Philosophy
3153,2017,Philosophie,4,La Culture,2,Croyances Religieuses et Verite,9,906,1,QROC,0.8,0.01,9.97,5,47,52,34,5,29,1.53,14.71,Difficile,Difficile,0,Meme Difficulté,Pas Adapte,Philosophy
4277,2018,Philosophie,4,La Culture,2,Croyances Religieuses et Verite,9,906,1,QROC,0.08,0.76,78.06,36,10,46,40,36,4,1.15,90.0,Moyen,Facile,1,Plus Facile,Pas Adapte,Philosophy
5401,2019,Philosophie,4,La Culture,2,Croyances Religieuses et Verite,9,906,1,QROC,0.19,0.89,97.84,43,1,44,44,43,1,1.0,97.73,Facile,Facile,0,Meme Difficulté,Pas Adapte,Philosophy
6525,2020,Philosophie,4,La Culture,2,Croyances Religieuses et Verite,9,906,1,QROC,0.94,0.09,1.38,1,42,43,39,1,38,1.1,2.56,Moyen,Difficile,-1,Plus Difficile,Pas Adapte,Philosophy
906,2015,Philosophie,4,La Culture,2,Croyances Religieuses et Verite,9,907,2,QCM,0.4,0.69,39.02,9,13,22,21,9,12,1.05,42.86,Moyen,Moyen,0,Meme Difficulté,Pas Adapte,Philosophy
2030,2016,Philosophie,4,La Culture,2,Croyances Religieuses et Verite,9,907,2,QCM,0.79,0.19,21.3,4,15,19,13,4,9,1.46,30.77,Facile,Difficile,-2,Beaucoup plus Difficile,Pas Adapte,Philosophy
3154,2017,Philosophie,4,La Culture,2,Croyances Religieuses et Verite,9,907,2,QCM,0.17,0.77,67.65,14,6,20,16,14,2,1.25,87.5,Difficile,Facile,2,Beaucoup plus Facile,Adapte,Philosophy
4278,2018,Philosophie,4,La Culture,2,Croyances Religieuses et Verite,9,907,2,QO,0.17,0.98,67.65,16,7,23,18,16,2,1.28,88.89,Facile,Facile,0,Meme Difficulté,Adapte,Philosophy
5402,2019,Philosophie,4,La Culture,2,Croyances Religieuses et Verite,9,907,2,QO,0.16,0.47,67.65,17,8,25,23,17,6,1.09,73.91,Facile,Facile,0,Meme Difficulté,Adapte,Philosophy
6526,2020,Philosophie,4,La Culture,2,Croyances Religieuses et Verite,9,907,2,QO,0.13,0.53,67.65,16,7,23,18,16,2,1.28,88.89,Facile,Facile,0,Meme Difficulté,Adapte,Philosophy
907,2015,Philosophie,4,La Culture,2,Croyances Religieuses et Verite,9,908,3,QCU,0.64,0.32,20.69,9,35,44,33,9,24,1.33,27.27,Moyen,Difficile,-1,Plus Difficile,Pas Adapte,Philosophy
2031,2016,Philosophie,4,La Culture,2,Croyances Religieuses et Verite,9,908,3,QCU,0.12,0.76,76.5,33,10,43,43,33,10,1.0,76.74,Difficile,Facile,2,Beaucoup plus Facile,Pas Adapte,Philosophy
3155,2017,Philosophie,4,La Culture,2,Croyances Religieuses et Verite,9,908,3,QCM,0.04,0.72,75.77,35,11,46,45,35,10,1.02,77.78,Difficile,Facile,2,Beaucoup plus Facile,Pas Adapte,Philosophy
4279,2018,Philosophie,4,La Culture,2,Croyances Religieuses et Verite,9,908,3,QCM,0.73,0.2,31.62,17,36,53,29,17,12,1.83,58.62,Facile,Difficile,-2,Beaucoup plus Difficile,Pas Adapte,Philosophy
5403,2019,Philosophie,4,La Culture,2,Croyances Religieuses et Verite,9,908,3,QCM,0.34,0.31,53.86,27,23,50,31,27,4,1.61,87.1,Facile,Moyen,-1,Plus Difficile,Pas Adapte,Philosophy
6527,2020,Philosophie,4,La Culture,2,Croyances Religieuses et Verite,9,908,3,QCM,0.09,0.8,91.69,41,4,45,41,41,0,1.1,100.0,Difficile,Facile,2,Beaucoup plus Facile,Pas Adapte,Philosophy
908,2015,Philosophie,4,La Culture,2,Croyances Religieuses et Verite,9,909,4,QCM,0.25,0.53,49.19,7,8,15,10,7,3,1.5,70.0,Facile,Moyen,-1,Plus Difficile,Pas Adapte,Philosophy
2032,2016,Philosophie,4,La Culture,2,Croyances Religieuses et Verite,9,909,4,QCU,0.68,0.39,19.56,3,10,13,8,3,5,1.62,37.5,Moyen,Difficile,-1,Plus Difficile,Pas Adapte,Philosophy
3156,2017,Philosophie,4,La Culture,2,Croyances Religieuses et Verite,9,909,4,QCU,0.2,0.66,50.59,7,7,14,10,7,3,1.4,70.0,Moyen,Moyen,0,Meme Difficulté,Pas Adapte,Philosophy
4280,2018,Philosophie,4,La Culture,2,Croyances Religieuses et Verite,9,909,4,QCU,0.73,0.3,1.1,0,14,14,13,0,13,1.08,0.0,Facile,Difficile,-2,Beaucoup plus Difficile,Pas Adapte,Philosophy
5404,2019,Philosophie,4,La Culture,2,Croyances Religieuses et Verite,9,909,4,QROC,0.06,0.8,73.83,11,4,15,12,11,1,1.25,91.67,Facile,Facile,0,Meme Difficulté,Adapte,Philosophy
6528,2020,Philosophie,4,La Culture,2,Croyances Religieuses et Verite,9,909,4,QROC,0.19,0.53,73.83,10,3,13,13,10,3,1.0,76.92,Facile,Facile,0,Meme Difficulté,Adapte,Philosophy
909,2015,Philosophie,4,La Culture,2,Croyances Religieuses et Verite,9,910,5,QCM,0.01,0.86,96.2,57,2,59,57,57,0,1.04,100.0,Difficile,Facile,2,Beaucoup plus Facile,Pas Adapte,Philosophy
2033,2016,Philosophie,4,La Culture,2,Croyances Religieuses et Verite,9,910,5,QCM,0.2,0.89,71.31,41,16,57,42,41,1,1.36,97.62,Difficile,Facile,2,Beaucoup plus Facile,Adapte,Philosophy
3157,2017,Philosophie,4,La Culture,2,Croyances Religieuses et Verite,9,910,5,QCM,0.04,0.97,71.31,41,17,58,43,41,2,1.35,95.35,Facile,Facile,0,Meme Difficulté,Adapte,Philosophy
4281,2018,Philosophie,4,La Culture,2,Croyances Religieuses et Verite,9,910,5,QCU,0.01,0.78,71.31,38,15,53,44,38,6,1.2,86.36,Facile,Facile,0,Meme Difficulté,Adapte,Philosophy
5405,2019,Philosophie,4,La Culture,2,Croyances Religieuses et Verite,9,910,5,QCU,0.08,0.87,71.31,39,16,55,55,39,16,1.0,70.91,Facile,Facile,0,Meme Difficulté,Adapte,Philosophy
6529,2020,Philosophie,4,La Culture,2,Croyances Religieuses et Verite,9,910,5,QCU,0.18,0.86,71.31,43,17,60,53,43,10,1.13,81.13,Facile,Facile,0,Meme Difficulté,Adapte,Philosophy
910,2015,Philosophie,4,La Culture,2,Croyances Religieuses et Verite,9,911,6,QCM,0.09,0.86,70.37,23,10,33,31,23,8,1.06,74.19,Moyen,Facile,1,Plus Facile,Adapte,Philosophy
2034,2016,Philosophie,4,La Culture,2,Croyances Religieuses et Verite,9,911,6,QCM,0.16,0.77,70.37,23,9,32,29,23,6,1.1,79.31,Facile,Facile,0,Meme Difficulté,Adapte,Philosophy
3158,2017,Philosophie,4,La Culture,2,Croyances Religieuses et Verite,9,911,6,QCM,0.0,0.92,70.37,23,10,33,25,23,2,1.32,92.0,Facile,Facile,0,Meme Difficulté,Adapte,Philosophy
4282,2018,Philosophie,4,La Culture,2,Croyances Religieuses et Verite,9,911,6,QCM,0.02,0.91,70.37,25,11,36,30,25,5,1.2,83.33,Facile,Facile,0,Meme Difficulté,Adapte,Philosophy
5406,2019,Philosophie,4,La Culture,2,Croyances Religieuses et Verite,9,911,6,QCM,0.13,0.99,70.37,27,12,39,30,27,3,1.3,90.0,Facile,Facile,0,Meme Difficulté,Adapte,Philosophy
6530,2020,Philosophie,4,La Culture,2,Croyances Religieuses et Verite,9,911,6,QCM,0.02,0.77,70.37,24,10,34,25,24,1,1.36,96.0,Facile,Facile,0,Meme Difficulté,Adapte,Philosophy
911,2015,Philosophie,4,La Culture,2,Croyances Religieuses et Verite,9,912,7,QROC,0.01,0.77,70.03,57,25,82,79,57,22,1.04,72.15,Difficile,Facile,2,Beaucoup plus Facile,Adapte,Philosophy
2035,2016,Philosophie,4,La Culture,2,Croyances Religieuses et Verite,9,912,7,QO,0.05,0.4,70.03,50,21,71,56,50,6,1.27,89.29,Facile,Facile,0,Meme Difficulté,Adapte,Philosophy
3159,2017,Philosophie,4,La Culture,2,Croyances Religieuses et Verite,9,912,7,QO,0.19,0.77,70.03,43,18,61,56,43,13,1.09,76.79,Facile,Facile,0,Meme Difficulté,Adapte,Philosophy
4283,2018,Philosophie,4,La Culture,2,Croyances Religieuses et Verite,9,912,7,QO,0.05,0.85,70.03,43,18,61,52,43,9,1.17,82.69,Facile,Facile,0,Meme Difficulté,Adapte,Philosophy
5407,2019,Philosophie,4,La Culture,2,Croyances Religieuses et Verite,9,912,7,QO,0.18,0.49,70.03,48,21,69,60,48,12,1.15,80.0,Facile,Facile,0,Meme Difficulté,Adapte,Philosophy
6531,2020,Philosophie,4,La Culture,2,Croyances Religieuses et Verite,9,912,7,QO,0.14,0.3,70.03,49,21,70,70,49,21,1.0,70.0,Facile,Facile,0,Meme Difficulté,Adapte,Philosophy
912,2015,Philosophie,4,La Culture,2,Croyances Religieuses et Verite,9,913,8,QCM,0.39,0.65,51.62,3,3,6,3,3,0,2.0,100.0,Difficile,Moyen,1,Plus Facile,Pas Adapte,Philosophy
2036,2016,Philosophie,4,La Culture,2,Croyances Religieuses et Verite,9,913,8,QCM,0.25,0.59,53.79,4,3,7,5,4,1,1.4,80.0,Difficile,Moyen,1,Plus Facile,Pas Adapte,Philosophy
3160,2017,Philosophie,4,La Culture,2,Croyances Religieuses et Verite,9,913,8,QCM,0.02,0.71,97.77,6,0,6,6,6,0,1.0,100.0,Facile,Facile,0,Meme Difficulté,Pas Adapte,Philosophy
4284,2018,Philosophie,4,La Culture,2,Croyances Religieuses et Verite,9,913,8,QCM,0.11,0.8,70.07,4,1,5,5,4,1,1.0,80.0,Difficile,Facile,2,Beaucoup plus Facile,Adapte,Philosophy
5408,2019,Philosophie,4,La Culture,2,Croyances Religieuses et Verite,9,913,8,QCM,0.09,0.89,70.07,4,1,5,4,4,0,1.25,100.0,Facile,Facile,0,Meme Difficulté,Adapte,Philosophy
6532,2020,Philosophie,4,La Culture,2,Croyances Religieuses et Verite,9,913,8,QCM,0.16,0.77,70.07,4,2,6,5,4,1,1.2,80.0,Facile,Facile,0,Meme Difficulté,Adapte,Philosophy
913,2015,Philosophie,4,La Culture,2,Croyances Religieuses et Verite,9,914,9,QCU,0.11,0.76,85.63,74,13,87,82,74,8,1.06,90.24,Facile,Facile,0,Meme Difficulté,Pas Adapte,Philosophy
2037,2016,Philosophie,4,La Culture,2,Croyances Religieuses et Verite,9,914,9,QCU,0.4,0.22,23.95,23,71,94,81,23,58,1.16,28.4,Difficile,Difficile,0,Meme Difficulté,Pas Adapte,Philosophy
3161,2017,Philosophie,4,La Culture,2,Croyances Religieuses et Verite,9,914,9,QCU,0.54,0.33,31.67,31,67,98,55,31,24,1.78,56.36,Moyen,Difficile,-1,Plus Difficile,Pas Adapte,Philosophy
4285,2018,Philosophie,4,La Culture,2,Croyances Religieuses et Verite,9,914,9,QCU,0.26,0.49,43.4,48,62,110,90,48,42,1.22,53.33,Facile,Moyen,-1,Plus Difficile,Pas Adapte,Philosophy
5409,2019,Philosophie,4,La Culture,2,Croyances Religieuses et Verite,9,914,9,QCU,0.7,0.32,22.24,25,89,114,92,25,67,1.24,27.17,Difficile,Difficile,0,Meme Difficulté,Pas Adapte,Philosophy
6533,2020,Philosophie,4,La Culture,2,Croyances Religieuses et Verite,9,914,9,QCU,0.34,0.41,57.24,68,51,119,68,68,0,1.75,100.0,Moyen,Moyen,0,Meme Difficulté,Pas Adapte,Philosophy
914,2015,Philosophie,4,La Culture,3,Religion et Morale,14,915,1,QO,0.13,0.82,97.21,46,1,47,47,46,1,1.0,97.87,Facile,Facile,0,Meme Difficulté,Pas Adapte,Philosophy
2038,2016,Philosophie,4,La Culture,3,Religion et Morale,14,915,1,QO,0.07,0.83,91.7,48,4,52,50,48,2,1.04,96.0,Difficile,Facile,2,Beaucoup plus Facile,Pas Adapte,Philosophy
3162,2017,Philosophie,4,La Culture,3,Religion et Morale,14,915,1,QO,0.07,0.91,76.54,46,14,60,57,46,11,1.05,80.7,Moyen,Facile,1,Plus Facile,Pas Adapte,Philosophy
4286,2018,Philosophie,4,La Culture,3,Religion et Morale,14,915,1,QROC,0.8,0.14,3.54,2,53,55,30,2,28,1.83,6.67,Facile,Difficile,-2,Beaucoup plus Difficile,Pas Adapte,Philosophy
5410,2019,Philosophie,4,La Culture,3,Religion et Morale,14,915,1,QROC,0.11,0.45,80.22,45,11,56,46,45,1,1.22,97.83,Difficile,Facile,2,Beaucoup plus Facile,Pas Adapte,Philosophy
6534,2020,Philosophie,4,La Culture,3,Religion et Morale,14,915,1,QROC,0.45,0.39,59.26,32,22,54,37,32,5,1.46,86.49,Facile,Moyen,-1,Plus Difficile,Pas Adapte,Philosophy
915,2015,Philosophie,4,La Culture,3,Religion et Morale,14,916,2,QROC,0.37,0.32,38.46,29,47,76,64,29,35,1.19,45.31,Difficile,Moyen,1,Plus Facile,Pas Adapte,Philosophy
2039,2016,Philosophie,4,La Culture,3,Religion et Morale,14,916,2,QROC,0.86,0.21,0.67,0,67,67,28,0,28,2.39,0.0,Difficile,Difficile,0,Meme Difficulté,Pas Adapte,Philosophy
3163,2017,Philosophie,4,La Culture,3,Religion et Morale,14,916,2,QO,0.79,0.02,2.26,1,64,65,63,1,62,1.03,1.59,Moyen,Difficile,-1,Plus Difficile,Pas Adapte,Philosophy
4287,2018,Philosophie,4,La Culture,3,Religion et Morale,14,916,2,QROC,0.46,0.28,43.91,28,36,64,61,28,33,1.05,45.9,Moyen,Moyen,0,Meme Difficulté,Pas Adapte,Philosophy
5411,2019,Philosophie,4,La Culture,3,Religion et Morale,14,916,2,QROC,0.86,0.16,27.62,18,47,65,53,18,35,1.23,33.96,Facile,Difficile,-2,Beaucoup plus Difficile,Pas Adapte,Philosophy
6535,2020,Philosophie,4,La Culture,3,Religion et Morale,14,916,2,QROC,0.58,0.37,63.47,37,22,59,47,37,10,1.26,78.72,Facile,Moyen,-1,Plus Difficile,Adapte,Philosophy
916,2015,Philosophie,4,La Culture,3,Religion et Morale,14,917,3,QO,0.93,0.02,10.74,1,8,9,7,1,6,1.29,14.29,Difficile,Difficile,0,Meme Difficulté,Pas Adapte,Philosophy
2040,2016,Philosophie,4,La Culture,3,Religion et Morale,14,917,3,QO,0.66,0.15,61.24,6,4,10,6,6,0,1.67,100.0,Facile,Moyen,-1,Plus Difficile,Adapte,Philosophy
3164,2017,Philosophie,4,La Culture,3,Religion et Morale,14,917,3,QO,0.4,0.2,61.24,6,4,10,8,6,2,1.25,75.0,Moyen,Moyen,0,Meme Difficulté,Adapte,Philosophy
4288,2018,Philosophie,4,La Culture,3,Religion et Morale,14,917,3,QROC,0.21,0.3,61.24,7,4,11,10,7,3,1.1,70.0,Moyen,Moyen,0,Meme Difficulté,Adapte,Philosophy
5412,2019,Philosophie,4,La Culture,3,Religion et Morale,14,917,3,QROC,0.54,0.39,61.24,6,4,10,10,6,4,1.0,60.0,Moyen,Moyen,0,Meme Difficulté,Adapte,Philosophy
6536,2020,Philosophie,4,La Culture,3,Religion et Morale,14,917,3,QO,0.33,0.15,61.24,5,3,8,6,5,1,1.33,83.33,Moyen,Moyen,0,Meme Difficulté,Adapte,Philosophy
917,2015,Philosophie,4,La Culture,3,Religion et Morale,14,918,4,QCU,0.63,0.29,20.22,18,69,87,67,18,49,1.3,26.87,Facile,Difficile,-2,Beaucoup plus Difficile,Pas Adapte,Philosophy
2041,2016,Philosophie,4,La Culture,3,Religion et Morale,14,918,4,QCU,0.45,0.35,18.02,16,75,91,33,16,17,2.76,48.48,Difficile,Difficile,0,Meme Difficulté,Pas Adapte,Philosophy
3165,2017,Philosophie,4,La Culture,3,Religion et Morale,14,918,4,QCU,0.52,0.36,1.76,1,81,82,38,1,37,2.16,2.63,Facile,Difficile,-2,Beaucoup plus Difficile,Pas Adapte,Philosophy
4289,2018,Philosophie,4,La Culture,3,Religion et Morale,14,918,4,QCU,0.71,0.39,25.39,23,67,90,33,23,10,2.73,69.7,Facile,Difficile,-2,Beaucoup plus Difficile,Pas Adapte,Philosophy
5413,2019,Philosophie,4,La Culture,3,Religion et Morale,14,918,4,QCU,0.4,0.25,34.25,32,62,94,85,32,53,1.11,37.65,Facile,Difficile,-2,Beaucoup plus Difficile,Pas Adapte,Philosophy
6537,2020,Philosophie,4,La Culture,3,Religion et Morale,14,918,4,QCU,0.12,0.89,69.44,60,27,87,82,60,22,1.06,73.17,Difficile,Facile,2,Beaucoup plus Facile,Adapte,Philosophy
918,2015,Philosophie,4,La Culture,3,Religion et Morale,14,919,5,QROC,0.68,0.05,14.72,3,16,19,18,3,15,1.06,16.67,Difficile,Difficile,0,Meme Difficulté,Pas Adapte,Philosophy
2042,2016,Philosophie,4,La Culture,3,Religion et Morale,14,919,5,QO,0.62,0.17,59.32,10,7,17,14,10,4,1.21,71.43,Facile,Moyen,-1,Plus Difficile,Pas Adapte,Philosophy
3166,2017,Philosophie,4,La Culture,3,Religion et Morale,14,919,5,QO,0.98,0.15,33.35,6,13,19,18,6,12,1.06,33.33,Facile,Difficile,-2,Beaucoup plus Difficile,Pas Adapte,Philosophy
4290,2018,Philosophie,4,La Culture,3,Religion et Morale,14,919,5,QROC,0.18,0.41,96.36,15,1,16,15,15,0,1.07,100.0,Difficile,Facile,2,Beaucoup plus Facile,Pas Adapte,Philosophy
5414,2019,Philosophie,4,La Culture,3,Religion et Morale,14,919,5,QROC,0.16,0.6,92.19,15,1,16,15,15,0,1.07,100.0,Facile,Facile,0,Meme Difficulté,Pas Adapte,Philosophy
6538,2020,Philosophie,4,La Culture,3,Religion et Morale,14,919,5,QROC,0.46,0.38,54.52,8,7,15,12,8,4,1.25,66.67,Facile,Moyen,-1,Plus Difficile,Pas Adapte,Philosophy
919,2015,Philosophie,4,La Culture,3,Religion et Morale,14,920,6,QCM,0.02,0.71,96.92,63,2,65,64,63,1,1.02,98.44,Difficile,Facile,2,Beaucoup plus Facile,Pas Adapte,Philosophy
2043,2016,Philosophie,4,La Culture,3,Religion et Morale,14,920,6,QCM,0.08,0.74,73.7,46,17,63,51,46,5,1.24,90.2,Moyen,Facile,1,Plus Facile,Adapte,Philosophy
3167,2017,Philosophie,4,La Culture,3,Religion et Morale,14,920,6,QCM,0.04,1.0,73.7,41,14,55,43,41,2,1.28,95.35,Facile,Facile,0,Meme Difficulté,Adapte,Philosophy
4291,2018,Philosophie,4,La Culture,3,Religion et Morale,14,920,6,QCU,0.08,0.92,73.7,35,13,48,45,35,10,1.07,77.78,Facile,Facile,0,Meme Difficulté,Adapte,Philosophy
5415,2019,Philosophie,4,La Culture,3,Religion et Morale,14,920,6,QCU,0.17,0.91,73.7,39,14,53,44,39,5,1.2,88.64,Facile,Facile,0,Meme Difficulté,Adapte,Philosophy
6539,2020,Philosophie,4,La Culture,3,Religion et Morale,14,920,6,QCU,0.09,0.88,73.7,41,14,55,41,41,0,1.34,100.0,Facile,Facile,0,Meme Difficulté,Adapte,Philosophy
920,2015,Philosophie,4,La Culture,3,Religion et Morale,14,921,7,QCM,0.23,0.6,46.18,15,17,32,17,15,2,1.88,88.24,Moyen,Moyen,0,Meme Difficulté,Pas Adapte,Philosophy
2044,2016,Philosophie,4,La Culture,3,Religion et Morale,14,921,7,QCM,0.07,0.76,78.53,29,8,37,32,29,3,1.16,90.62,Moyen,Facile,1,Plus Facile,Pas Adapte,Philosophy
3168,2017,Philosophie,4,La Culture,3,Religion et Morale,14,921,7,QCM,0.05,0.9,84.89,29,5,34,32,29,3,1.06,90.62,Facile,Facile,0,Meme Difficulté,Pas Adapte,Philosophy
4292,2018,Philosophie,4,La Culture,3,Religion et Morale,14,921,7,QCM,0.03,0.8,94.47,37,2,39,37,37,0,1.05,100.0,Difficile,Facile,2,Beaucoup plus Facile,Pas Adapte,Philosophy
5416,2019,Philosophie,4,La Culture,3,Religion et Morale,14,921,7,QCU,0.25,0.62,54.23,20,17,37,24,20,4,1.54,83.33,Moyen,Moyen,0,Meme Difficulté,Pas Adapte,Philosophy
6540,2020,Philosophie,4,La Culture,3,Religion et Morale,14,921,7,QCU,0.12,0.91,85.29,32,5,37,37,32,5,1.0,86.49,Moyen,Facile,1,Plus Facile,Pas Adapte,Philosophy
921,2015,Philosophie,4,La Culture,3,Religion et Morale,14,922,8,QCU,0.19,0.87,86.23,53,8,61,56,53,3,1.09,94.64,Moyen,Facile,1,Plus Facile,Pas Adapte,Philosophy
2045,2016,Philosophie,4,La Culture,3,Religion et Morale,14,922,8,QCU,0.59,0.22,34.6,19,35,54,46,19,27,1.17,41.3,Difficile,Difficile,0,Meme Difficulté,Pas Adapte,Philosophy
3169,2017,Philosophie,4,La Culture,3,Religion et Morale,14,922,8,QCU,0.09,0.93,65.56,35,19,54,50,35,15,1.08,70.0,Difficile,Facile,2,Beaucoup plus Facile,Adapte,Philosophy
4293,2018,Philosophie,4,La Culture,3,Religion et Morale,14,922,8,QCU,0.07,0.89,65.56,38,20,58,39,38,1,1.49,97.44,Facile,Facile,0,Meme Difficulté,Adapte,Philosophy
5417,2019,Philosophie,4,La Culture,3,Religion et Morale,14,922,8,QCU,0.06,0.83,65.56,38,20,58,56,38,18,1.04,67.86,Facile,Facile,0,Meme Difficulté,Adapte,Philosophy
6541,2020,Philosophie,4,La Culture,3,Religion et Morale,14,922,8,QCU,0.12,0.97,65.56,33,17,50,48,33,15,1.04,68.75,Facile,Facile,0,Meme Difficulté,Adapte,Philosophy
922,2015,Philosophie,4,La Culture,3,Religion et Morale,14,923,9,QCM,0.67,0.16,9.77,6,56,62,37,6,31,1.68,16.22,Difficile,Difficile,0,Meme Difficulté,Pas Adapte,Philosophy
2046,2016,Philosophie,4,La Culture,3,Religion et Morale,14,923,9,QCM,0.13,0.88,73.57,46,17,63,50,46,4,1.26,92.0,Facile,Facile,0,Meme Difficulté,Adapte,Philosophy
3170,2017,Philosophie,4,La Culture,3,Religion et Morale,14,923,9,QCU,0.17,0.88,73.57,48,17,65,50,48,2,1.3,96.0,Facile,Facile,0,Meme Difficulté,Adapte,Philosophy
4294,2018,Philosophie,4,La Culture,3,Religion et Morale,14,923,9,QCU,0.11,0.91,73.57,52,18,70,63,52,11,1.11,82.54,Facile,Facile,0,Meme Difficulté,Adapte,Philosophy
5418,2019,Philosophie,4,La Culture,3,Religion et Morale,14,923,9,QROC,0.14,0.76,73.57,58,21,79,75,58,17,1.05,77.33,Facile,Facile,0,Meme Difficulté,Adapte,Philosophy
6542,2020,Philosophie,4,La Culture,3,Religion et Morale,14,923,9,QROC,0.11,0.66,73.57,65,23,88,86,65,21,1.02,75.58,Facile,Facile,0,Meme Difficulté,Adapte,Philosophy
923,2015,Philosophie,4,La Culture,3,Religion et Morale,14,924,10,QROC,0.92,0.03,15.6,14,77,91,64,14,50,1.42,21.88,Moyen,Difficile,-1,Plus Difficile,Pas Adapte,Philosophy
2047,2016,Philosophie,4,La Culture,3,Religion et Morale,14,924,10,QROC,0.06,0.61,77.02,69,21,90,86,69,17,1.05,80.23,Facile,Facile,0,Meme Difficulté,Pas Adapte,Philosophy
3171,2017,Philosophie,4,La Culture,3,Religion et Morale,14,924,10,QROC,0.74,0.22,1.33,1,76,77,63,1,62,1.22,1.59,Facile,Difficile,-2,Beaucoup plus Difficile,Pas Adapte,Philosophy
4295,2018,Philosophie,4,La Culture,3,Religion et Morale,14,924,10,QROC,0.16,0.44,95.07,67,3,70,67,67,0,1.04,100.0,Facile,Facile,0,Meme Difficulté,Pas Adapte,Philosophy
5419,2019,Philosophie,4,La Culture,3,Religion et Morale,14,924,10,QROC,0.15,0.82,80.57,59,14,73,72,59,13,1.01,81.94,Moyen,Facile,1,Plus Facile,Pas Adapte,Philosophy
6543,2020,Philosophie,4,La Culture,3,Religion et Morale,14,924,10,QROC,0.44,0.34,64.51,52,28,80,64,52,12,1.25,81.25,Moyen,Moyen,0,Meme Difficulté,Adapte,Philosophy
924,2015,Philosophie,4,La Culture,3,Religion et Morale,14,925,11,QCM,0.19,0.87,76.38,46,14,60,46,46,0,1.3,100.0,Facile,Facile,0,Meme Difficulté,Pas Adapte,Philosophy
2048,2016,Philosophie,4,La Culture,3,Religion et Morale,14,925,11,QCU,0.71,0.39,28.12,17,43,60,48,17,31,1.25,35.42,Moyen,Difficile,-1,Plus Difficile,Pas Adapte,Philosophy
3172,2017,Philosophie,4,La Culture,3,Religion et Morale,14,925,11,QCU,0.07,0.87,95.08,57,3,60,59,57,2,1.02,96.61,Difficile,Facile,2,Beaucoup plus Facile,Pas Adapte,Philosophy
4296,2018,Philosophie,4,La Culture,3,Religion et Morale,14,925,11,QROC,0.06,0.64,70.8,49,20,69,55,49,6,1.25,89.09,Facile,Facile,0,Meme Difficulté,Adapte,Philosophy
5420,2019,Philosophie,4,La Culture,3,Religion et Morale,14,925,11,QCM,0.03,0.92,70.8,43,18,61,48,43,5,1.27,89.58,Facile,Facile,0,Meme Difficulté,Adapte,Philosophy
6544,2020,Philosophie,4,La Culture,3,Religion et Morale,14,925,11,QCM,0.09,0.94,70.8,40,17,57,49,40,9,1.16,81.63,Facile,Facile,0,Meme Difficulté,Adapte,Philosophy
925,2015,Philosophie,4,La Culture,3,Religion et Morale,14,926,12,QCU,0.22,0.5,63.87,15,9,24,17,15,2,1.41,88.24,Difficile,Moyen,1,Plus Facile,Adapte,Philosophy
2049,2016,Philosophie,4,La Culture,3,Religion et Morale,14,926,12,QCU,0.35,0.66,63.87,15,9,24,18,15,3,1.33,83.33,Moyen,Moyen,0,Meme Difficulté,Adapte,Philosophy
3173,2017,Philosophie,4,La Culture,3,Religion et Morale,14,926,12,QCU,0.39,0.58,63.87,15,8,23,16,15,1,1.44,93.75,Moyen,Moyen,0,Meme Difficulté,Adapte,Philosophy
4297,2018,Philosophie,4,La Culture,3,Religion et Morale,14,926,12,QCU,0.33,0.65,63.87,13,8,21,18,13,5,1.17,72.22,Moyen,Moyen,0,Meme Difficulté,Adapte,Philosophy
5421,2019,Philosophie,4,La Culture,3,Religion et Morale,14,926,12,QO,0.64,0.23,63.87,15,8,23,18,15,3,1.28,83.33,Moyen,Moyen,0,Meme Difficulté,Adapte,Philosophy
6545,2020,Philosophie,4,La Culture,3,Religion et Morale,14,926,12,QO,0.75,0.19,63.87,14,8,22,21,14,7,1.05,66.67,Moyen,Moyen,0,Meme Difficulté,Adapte,Philosophy
926,2015,Philosophie,4,La Culture,3,Religion et Morale,14,927,13,QCM,0.25,0.63,64.49,64,35,99,88,64,24,1.12,72.73,Moyen,Moyen,0,Meme Difficulté,Adapte,Philosophy
2050,2016,Philosophie,4,La Culture,3,Religion et Morale,14,927,13,QCM,0.46,0.32,64.49,71,39,110,88,71,17,1.25,80.68,Moyen,Moyen,0,Meme Difficulté,Adapte,Philosophy
3174,2017,Philosophie,4,La Culture,3,Religion et Morale,14,927,13,QCM,0.43,0.37,64.49,73,40,113,93,73,20,1.22,78.49,Moyen,Moyen,0,Meme Difficulté,Adapte,Philosophy
4298,2018,Philosophie,4,La Culture,3,Religion et Morale,14,927,13,QCM,0.24,0.41,64.49,76,42,118,91,76,15,1.3,83.52,Moyen,Moyen,0,Meme Difficulté,Adapte,Philosophy
5422,2019,Philosophie,4,La Culture,3,Religion et Morale,14,927,13,QCM,0.21,0.55,64.49,77,43,120,82,77,5,1.46,93.9,Moyen,Moyen,0,Meme Difficulté,Adapte,Philosophy
6546,2020,Philosophie,4,La Culture,3,Religion et Morale,14,927,13,QROC,0.22,0.33,64.49,78,43,121,87,78,9,1.39,89.66,Moyen,Moyen,0,Meme Difficulté,Adapte,Philosophy
927,2015,Philosophie,4,La Culture,3,Religion et Morale,14,928,14,QCM,0.11,0.76,95.03,36,2,38,37,36,1,1.03,97.3,Difficile,Facile,2,Beaucoup plus Facile,Pas Adapte,Philosophy
2051,2016,Philosophie,4,La Culture,3,Religion et Morale,14,928,14,QCU,0.29,0.75,55.11,21,18,39,30,21,9,1.3,70.0,Facile,Moyen,-1,Plus Difficile,Pas Adapte,Philosophy
3175,2017,Philosophie,4,La Culture,3,Religion et Morale,14,928,14,QCU,0.37,0.47,36.55,13,23,36,21,13,8,1.71,61.9,Difficile,Moyen,1,Plus Facile,Pas Adapte,Philosophy
4299,2018,Philosophie,4,La Culture,3,Religion et Morale,14,928,14,QCU,0.02,0.98,96.88,30,1,31,31,30,1,1.0,96.77,Difficile,Facile,2,Beaucoup plus Facile,Pas Adapte,Philosophy
5423,2019,Philosophie,4,La Culture,3,Religion et Morale,14,928,14,QCM,0.04,0.71,85.83,24,4,28,25,24,1,1.12,96.0,Difficile,Facile,2,Beaucoup plus Facile,Pas Adapte,Philosophy
6547,2020,Philosophie,4,La Culture,3,Religion et Morale,14,928,14,QCM,0.79,0.27,10.72,3,26,29,18,3,15,1.61,16.67,Moyen,Difficile,-1,Plus Difficile,Pas Adapte,Philosophy
928,2015,Sociologie,1,Les Differentes Approches de l'Economie,1,Comment l'Activite et la Science Economiques se detachent-elles de la Morale et de la Politique?,13,929,1,QROC,0.02,0.93,70.74,19,8,27,26,19,7,1.04,73.08,Moyen,Facile,1,Plus Facile,Adapte,Sociology
2052,2016,Sociologie,1,Les Differentes Approches de l'Economie,1,Comment l'Activite et la Science Economiques se detachent-elles de la Morale et de la Politique?,13,929,1,QROC,0.12,0.83,70.74,21,9,30,30,21,9,1.0,70.0,Facile,Facile,0,Meme Difficulté,Adapte,Sociology
3176,2017,Sociologie,1,Les Differentes Approches de l'Economie,1,Comment l'Activite et la Science Economiques se detachent-elles de la Morale et de la Politique?,13,929,1,QROC,0.16,0.71,70.74,21,8,29,27,21,6,1.07,77.78,Facile,Facile,0,Meme Difficulté,Adapte,Sociology
4300,2018,Sociologie,1,Les Differentes Approches de l'Economie,1,Comment l'Activite et la Science Economiques se detachent-elles de la Morale et de la Politique?,13,929,1,QROC,0.18,0.69,70.74,19,8,27,26,19,7,1.04,73.08,Facile,Facile,0,Meme Difficulté,Adapte,Sociology
5424,2019,Sociologie,1,Les Differentes Approches de l'Economie,1,Comment l'Activite et la Science Economiques se detachent-elles de la Morale et de la Politique?,13,929,1,QROC,0.09,0.51,70.74,20,8,28,28,20,8,1.0,71.43,Facile,Facile,0,Meme Difficulté,Adapte,Sociology
6548,2020,Sociologie,1,Les Differentes Approches de l'Economie,1,Comment l'Activite et la Science Economiques se detachent-elles de la Morale et de la Politique?,13,929,1,QROC,0.12,0.74,70.74,21,8,29,22,21,1,1.32,95.45,Facile,Facile,0,Meme Difficulté,Adapte,Sociology
929,2015,Sociologie,1,Les Differentes Approches de l'Economie,1,Comment l'Activite et la Science Economiques se detachent-elles de la Morale et de la Politique?,13,930,2,QROC,0.49,0.36,42.96,39,52,91,44,39,5,2.07,88.64,Difficile,Moyen,1,Plus Facile,Pas Adapte,Sociology
2053,2016,Sociologie,1,Les Differentes Approches de l'Economie,1,Comment l'Activite et la Science Economiques se detachent-elles de la Morale et de la Politique?,13,930,2,QROC,0.06,0.66,94.26,95,6,101,97,95,2,1.04,97.94,Difficile,Facile,2,Beaucoup plus Facile,Pas Adapte,Sociology
3177,2017,Sociologie,1,Les Differentes Approches de l'Economie,1,Comment l'Activite et la Science Economiques se detachent-elles de la Morale et de la Politique?,13,930,2,QROC,0.62,0.09,4.31,4,89,93,66,4,62,1.41,6.06,Moyen,Difficile,-1,Plus Difficile,Pas Adapte,Sociology
4301,2018,Sociologie,1,Les Differentes Approches de l'Economie,1,Comment l'Activite et la Science Economiques se detachent-elles de la Morale et de la Politique?,13,930,2,QROC,0.52,0.3,52.89,45,41,86,62,45,17,1.39,72.58,Facile,Moyen,-1,Plus Difficile,Pas Adapte,Sociology
5425,2019,Sociologie,1,Les Differentes Approches de l'Economie,1,Comment l'Activite et la Science Economiques se detachent-elles de la Morale et de la Politique?,13,930,2,QROC,0.14,0.83,67.1,53,26,79,59,53,6,1.34,89.83,Difficile,Facile,2,Beaucoup plus Facile,Adapte,Sociology
6549,2020,Sociologie,1,Les Differentes Approches de l'Economie,1,Comment l'Activite et la Science Economiques se detachent-elles de la Morale et de la Politique?,13,930,2,QO,0.04,0.32,67.1,47,23,70,49,47,2,1.43,95.92,Facile,Facile,0,Meme Difficulté,Adapte,Sociology
930,2015,Sociologie,1,Les Differentes Approches de l'Economie,1,Comment l'Activite et la Science Economiques se detachent-elles de la Morale et de la Politique?,13,931,3,QROC,0.73,0.01,11.11,4,34,38,35,4,31,1.09,11.43,Difficile,Difficile,0,Meme Difficulté,Pas Adapte,Sociology
2054,2016,Sociologie,1,Les Differentes Approches de l'Economie,1,Comment l'Activite et la Science Economiques se detachent-elles de la Morale et de la Politique?,13,931,3,QROC,0.61,0.01,25.81,9,25,34,20,9,11,1.7,45.0,Facile,Difficile,-2,Beaucoup plus Difficile,Pas Adapte,Sociology
3178,2017,Sociologie,1,Les Differentes Approches de l'Economie,1,Comment l'Activite et la Science Economiques se detachent-elles de la Morale et de la Politique?,13,931,3,QROC,0.35,0.27,49.13,17,17,34,25,17,8,1.36,68.0,Facile,Moyen,-1,Plus Difficile,Pas Adapte,Sociology
4302,2018,Sociologie,1,Les Differentes Approches de l'Economie,1,Comment l'Activite et la Science Economiques se detachent-elles de la Morale et de la Politique?,13,931,3,QROC,0.09,0.79,96.37,38,1,39,38,38,0,1.03,100.0,Moyen,Facile,1,Plus Facile,Pas Adapte,Sociology
5426,2019,Sociologie,1,Les Differentes Approches de l'Economie,1,Comment l'Activite et la Science Economiques se detachent-elles de la Morale et de la Politique?,13,931,3,QROC,0.17,0.51,74.15,33,11,44,36,33,3,1.22,91.67,Facile,Facile,0,Meme Difficulté,Adapte,Sociology
6550,2020,Sociologie,1,Les Differentes Approches de l'Economie,1,Comment l'Activite et la Science Economiques se detachent-elles de la Morale et de la Politique?,13,931,3,QROC,0.05,0.43,74.15,37,13,50,44,37,7,1.14,84.09,Facile,Facile,0,Meme Difficulté,Adapte,Sociology
931,2015,Sociologie,1,Les Differentes Approches de l'Economie,1,Comment l'Activite et la Science Economiques se detachent-elles de la Morale et de la Politique?,13,932,4,QCM,0.06,0.79,88.81,60,7,67,66,60,6,1.02,90.91,Difficile,Facile,2,Beaucoup plus Facile,Pas Adapte,Sociology
2055,2016,Sociologie,1,Les Differentes Approches de l'Economie,1,Comment l'Activite et la Science Economiques se detachent-elles de la Morale et de la Politique?,13,932,4,QCM,0.6,0.24,12.51,8,58,66,60,8,52,1.1,13.33,Difficile,Difficile,0,Meme Difficulté,Pas Adapte,Sociology
3179,2017,Sociologie,1,Les Differentes Approches de l'Economie,1,Comment l'Activite et la Science Economiques se detachent-elles de la Morale et de la Politique?,13,932,4,QCM,0.5,0.23,11.51,7,52,59,27,7,20,2.19,25.93,Moyen,Difficile,-1,Plus Difficile,Pas Adapte,Sociology
4303,2018,Sociologie,1,Les Differentes Approches de l'Economie,1,Comment l'Activite et la Science Economiques se detachent-elles de la Morale et de la Politique?,13,932,4,QCM,0.13,0.87,77.02,39,11,50,44,39,5,1.14,88.64,Difficile,Facile,2,Beaucoup plus Facile,Pas Adapte,Sociology
5427,2019,Sociologie,1,Les Differentes Approches de l'Economie,1,Comment l'Activite et la Science Economiques se detachent-elles de la Morale et de la Politique?,13,932,4,QCM,0.36,0.57,58.63,28,19,47,44,28,16,1.07,63.64,Moyen,Moyen,0,Meme Difficulté,Pas Adapte,Sociology
6551,2020,Sociologie,1,Les Differentes Approches de l'Economie,1,Comment l'Activite et la Science Economiques se detachent-elles de la Morale et de la Politique?,13,932,4,QROC,0.04,0.82,78.71,35,9,44,37,35,2,1.19,94.59,Difficile,Facile,2,Beaucoup plus Facile,Pas Adapte,Sociology
932,2015,Sociologie,1,Les Differentes Approches de l'Economie,1,Comment l'Activite et la Science Economiques se detachent-elles de la Morale et de la Politique?,13,933,5,QCM,0.15,0.94,89.26,79,9,88,85,79,6,1.04,92.94,Moyen,Facile,1,Plus Facile,Pas Adapte,Sociology
2056,2016,Sociologie,1,Les Differentes Approches de l'Economie,1,Comment l'Activite et la Science Economiques se detachent-elles de la Morale et de la Politique?,13,933,5,QCM,0.46,0.69,64.25,59,33,92,90,59,31,1.02,65.56,Difficile,Moyen,1,Plus Facile,Adapte,Sociology
3180,2017,Sociologie,1,Les Differentes Approches de l'Economie,1,Comment l'Activite et la Science Economiques se detachent-elles de la Morale et de la Politique?,13,933,5,QCM,0.45,0.53,64.25,64,35,99,85,64,21,1.16,75.29,Moyen,Moyen,0,Meme Difficulté,Adapte,Sociology
4304,2018,Sociologie,1,Les Differentes Approches de l'Economie,1,Comment l'Activite et la Science Economiques se detachent-elles de la Morale et de la Politique?,13,933,5,QCM,0.29,0.69,64.25,73,40,113,73,73,0,1.55,100.0,Moyen,Moyen,0,Meme Difficulté,Adapte,Sociology
5428,2019,Sociologie,1,Les Differentes Approches de l'Economie,1,Comment l'Activite et la Science Economiques se detachent-elles de la Morale et de la Politique?,13,933,5,QCM,0.46,0.52,64.25,66,36,102,94,66,28,1.09,70.21,Moyen,Moyen,0,Meme Difficulté,Adapte,Sociology
6552,2020,Sociologie,1,Les Differentes Approches de l'Economie,1,Comment l'Activite et la Science Economiques se detachent-elles de la Morale et de la Politique?,13,933,5,QCM,0.39,0.4,64.25,56,31,87,76,56,20,1.14,73.68,Moyen,Moyen,0,Meme Difficulté,Adapte,Sociology
933,2015,Sociologie,1,Les Differentes Approches de l'Economie,1,Comment l'Activite et la Science Economiques se detachent-elles de la Morale et de la Politique?,13,934,6,QROC,0.2,0.25,58.26,51,36,87,61,51,10,1.43,83.61,Moyen,Moyen,0,Meme Difficulté,Pas Adapte,Sociology
2057,2016,Sociologie,1,Les Differentes Approches de l'Economie,1,Comment l'Activite et la Science Economiques se detachent-elles de la Morale et de la Politique?,13,934,6,QROC,0.05,0.5,77.43,66,19,85,77,66,11,1.1,85.71,Facile,Facile,0,Meme Difficulté,Pas Adapte,Sociology
3181,2017,Sociologie,1,Les Differentes Approches de l'Economie,1,Comment l'Activite et la Science Economiques se detachent-elles de la Morale et de la Politique?,13,934,6,QROC,0.51,0.31,35.29,28,51,79,60,28,32,1.32,46.67,Difficile,Moyen,1,Plus Facile,Pas Adapte,Sociology
4305,2018,Sociologie,1,Les Differentes Approches de l'Economie,1,Comment l'Activite et la Science Economiques se detachent-elles de la Morale et de la Politique?,13,934,6,QROC,0.0,0.67,74.78,61,20,81,75,61,14,1.08,81.33,Moyen,Facile,1,Plus Facile,Adapte,Sociology
5429,2019,Sociologie,1,Les Differentes Approches de l'Economie,1,Comment l'Activite et la Science Economiques se detachent-elles de la Morale et de la Politique?,13,934,6,QROC,0.16,0.85,74.78,56,19,75,57,56,1,1.32,98.25,Facile,Facile,0,Meme Difficulté,Adapte,Sociology
6553,2020,Sociologie,1,Les Differentes Approches de l'Economie,1,Comment l'Activite et la Science Economiques se detachent-elles de la Morale et de la Politique?,13,934,6,QROC,0.14,0.45,74.78,63,21,84,73,63,10,1.15,86.3,Facile,Facile,0,Meme Difficulté,Adapte,Sociology
934,2015,Sociologie,1,Les Differentes Approches de l'Economie,1,Comment l'Activite et la Science Economiques se detachent-elles de la Morale et de la Politique?,13,935,7,QCU,0.31,0.64,52.45,16,14,30,18,16,2,1.67,88.89,Difficile,Moyen,1,Plus Facile,Pas Adapte,Sociology
2058,2016,Sociologie,1,Les Differentes Approches de l'Economie,1,Comment l'Activite et la Science Economiques se detachent-elles de la Morale et de la Politique?,13,935,7,QCU,0.04,0.78,88.83,28,4,32,29,28,1,1.1,96.55,Moyen,Facile,1,Plus Facile,Pas Adapte,Sociology
3182,2017,Sociologie,1,Les Differentes Approches de l'Economie,1,Comment l'Activite et la Science Economiques se detachent-elles de la Morale et de la Politique?,13,935,7,QCU,0.64,0.27,15.46,6,31,37,35,6,29,1.06,17.14,Difficile,Difficile,0,Meme Difficulté,Pas Adapte,Sociology
4306,2018,Sociologie,1,Les Differentes Approches de l'Economie,1,Comment l'Activite et la Science Economiques se detachent-elles de la Morale et de la Politique?,13,935,7,QCU,0.6,0.23,30.76,10,23,33,17,10,7,1.94,58.82,Facile,Difficile,-2,Beaucoup plus Difficile,Pas Adapte,Sociology
5430,2019,Sociologie,1,Les Differentes Approches de l'Economie,1,Comment l'Activite et la Science Economiques se detachent-elles de la Morale et de la Politique?,13,935,7,QCU,0.07,0.86,83.75,28,5,33,30,28,2,1.1,93.33,Facile,Facile,0,Meme Difficulté,Pas Adapte,Sociology
6554,2020,Sociologie,1,Les Differentes Approches de l'Economie,1,Comment l'Activite et la Science Economiques se detachent-elles de la Morale et de la Politique?,13,935,7,QCU,0.4,0.38,8.87,3,32,35,21,3,18,1.67,14.29,Moyen,Difficile,-1,Plus Difficile,Pas Adapte,Sociology
935,2015,Sociologie,1,Les Differentes Approches de l'Economie,1,Comment l'Activite et la Science Economiques se detachent-elles de la Morale et de la Politique?,13,936,8,QO,0.54,0.24,56.98,56,43,99,99,56,43,1.0,56.57,Difficile,Moyen,1,Plus Facile,Pas Adapte,Sociology
2059,2016,Sociologie,1,Les Differentes Approches de l'Economie,1,Comment l'Activite et la Science Economiques se detachent-elles de la Morale et de la Politique?,13,936,8,QO,0.85,0.03,25.49,24,72,96,83,24,59,1.16,28.92,Facile,Difficile,-2,Beaucoup plus Difficile,Pas Adapte,Sociology
3183,2017,Sociologie,1,Les Differentes Approches de l'Economie,1,Comment l'Activite et la Science Economiques se detachent-elles de la Morale et de la Politique?,13,936,8,QO,0.18,0.59,83.77,80,16,96,92,80,12,1.04,86.96,Facile,Facile,0,Meme Difficulté,Pas Adapte,Sociology
4307,2018,Sociologie,1,Les Differentes Approches de l'Economie,1,Comment l'Activite et la Science Economiques se detachent-elles de la Morale et de la Politique?,13,936,8,QO,0.83,0.13,0.72,1,107,108,68,1,67,1.59,1.47,Facile,Difficile,-2,Beaucoup plus Difficile,Pas Adapte,Sociology
5431,2019,Sociologie,1,Les Differentes Approches de l'Economie,1,Comment l'Activite et la Science Economiques se detachent-elles de la Morale et de la Politique?,13,936,8,QO,0.29,0.19,53.75,56,48,104,85,56,29,1.22,65.88,Difficile,Moyen,1,Plus Facile,Pas Adapte,Sociology
6555,2020,Sociologie,1,Les Differentes Approches de l'Economie,1,Comment l'Activite et la Science Economiques se detachent-elles de la Morale et de la Politique?,13,936,8,QO,0.51,0.29,37.75,41,67,108,62,41,21,1.74,66.13,Facile,Moyen,-1,Plus Difficile,Pas Adapte,Sociology
936,2015,Sociologie,1,Les Differentes Approches de l'Economie,1,Comment l'Activite et la Science Economiques se detachent-elles de la Morale et de la Politique?,13,937,9,QCM,0.61,0.18,16.37,15,77,92,79,15,64,1.16,18.99,Facile,Difficile,-2,Beaucoup plus Difficile,Pas Adapte,Sociology
2060,2016,Sociologie,1,Les Differentes Approches de l'Economie,1,Comment l'Activite et la Science Economiques se detachent-elles de la Morale et de la Politique?,13,937,9,QCM,0.09,0.82,82.88,81,17,98,97,81,16,1.01,83.51,Moyen,Facile,1,Plus Facile,Pas Adapte,Sociology
3184,2017,Sociologie,1,Les Differentes Approches de l'Economie,1,Comment l'Activite et la Science Economiques se detachent-elles de la Morale et de la Politique?,13,937,9,QCM,0.02,0.92,85.16,87,15,102,97,87,10,1.05,89.69,Facile,Facile,0,Meme Difficulté,Pas Adapte,Sociology
4308,2018,Sociologie,1,Les Differentes Approches de l'Economie,1,Comment l'Activite et la Science Economiques se detachent-elles de la Morale et de la Politique?,13,937,9,QCM,0.74,0.3,2.01,2,95,97,39,2,37,2.49,5.13,Facile,Difficile,-2,Beaucoup plus Difficile,Pas Adapte,Sociology
5432,2019,Sociologie,1,Les Differentes Approches de l'Economie,1,Comment l'Activite et la Science Economiques se detachent-elles de la Morale et de la Politique?,13,937,9,QCM,0.38,0.55,57.01,48,37,85,49,48,1,1.73,97.96,Facile,Moyen,-1,Plus Difficile,Pas Adapte,Sociology
6556,2020,Sociologie,1,Les Differentes Approches de l'Economie,1,Comment l'Activite et la Science Economiques se detachent-elles de la Morale et de la Politique?,13,937,9,QCM,0.69,0.16,32.29,28,58,86,36,28,8,2.39,77.78,Difficile,Difficile,0,Meme Difficulté,Pas Adapte,Sociology
937,2015,Sociologie,1,Les Differentes Approches de l'Economie,1,Comment l'Activite et la Science Economiques se detachent-elles de la Morale et de la Politique?,13,938,10,QCU,0.5,0.26,21.22,6,24,30,16,6,10,1.88,37.5,Difficile,Difficile,0,Meme Difficulté,Pas Adapte,Sociology
2061,2016,Sociologie,1,Les Differentes Approches de l'Economie,1,Comment l'Activite et la Science Economiques se detachent-elles de la Morale et de la Politique?,13,938,10,QCM,0.23,0.31,39.57,11,18,29,27,11,16,1.07,40.74,Moyen,Moyen,0,Meme Difficulté,Pas Adapte,Sociology
3185,2017,Sociologie,1,Les Differentes Approches de l'Economie,1,Comment l'Activite et la Science Economiques se detachent-elles de la Morale et de la Politique?,13,938,10,QCM,0.69,0.2,27.37,7,20,27,27,7,20,1.0,25.93,Facile,Difficile,-2,Beaucoup plus Difficile,Pas Adapte,Sociology
4309,2018,Sociologie,1,Les Differentes Approches de l'Economie,1,Comment l'Activite et la Science Economiques se detachent-elles de la Morale et de la Politique?,13,938,10,QCM,0.03,0.83,72.87,20,8,28,21,20,1,1.33,95.24,Facile,Facile,0,Meme Difficulté,Adapte,Sociology
5433,2019,Sociologie,1,Les Differentes Approches de l'Economie,1,Comment l'Activite et la Science Economiques se detachent-elles de la Morale et de la Politique?,13,938,10,QCU,0.13,0.9,72.87,21,8,29,26,21,5,1.12,80.77,Facile,Facile,0,Meme Difficulté,Adapte,Sociology
6557,2020,Sociologie,1,Les Differentes Approches de l'Economie,1,Comment l'Activite et la Science Economiques se detachent-elles de la Morale et de la Politique?,13,938,10,QCU,0.07,0.85,72.87,20,8,28,27,20,7,1.04,74.07,Facile,Facile,0,Meme Difficulté,Adapte,Sociology
938,2015,Sociologie,1,Les Differentes Approches de l'Economie,1,Comment l'Activite et la Science Economiques se detachent-elles de la Morale et de la Politique?,13,939,11,QCM,0.15,0.98,81.87,79,17,96,81,79,2,1.19,97.53,Moyen,Facile,1,Plus Facile,Pas Adapte,Sociology
2062,2016,Sociologie,1,Les Differentes Approches de l'Economie,1,Comment l'Activite et la Science Economiques se detachent-elles de la Morale et de la Politique?,13,939,11,QCM,0.62,0.25,34.35,32,61,93,35,32,3,2.66,91.43,Moyen,Difficile,-1,Plus Difficile,Pas Adapte,Sociology
3186,2017,Sociologie,1,Les Differentes Approches de l'Economie,1,Comment l'Activite et la Science Economiques se detachent-elles de la Morale et de la Politique?,13,939,11,QCM,0.24,0.53,53.84,45,39,84,55,45,10,1.53,81.82,Difficile,Moyen,1,Plus Facile,Pas Adapte,Sociology
4310,2018,Sociologie,1,Les Differentes Approches de l'Economie,1,Comment l'Activite et la Science Economiques se detachent-elles de la Morale et de la Politique?,13,939,11,QCM,0.67,0.15,8.57,8,81,89,61,8,53,1.46,13.11,Difficile,Difficile,0,Meme Difficulté,Pas Adapte,Sociology
5434,2019,Sociologie,1,Les Differentes Approches de l'Economie,1,Comment l'Activite et la Science Economiques se detachent-elles de la Morale et de la Politique?,13,939,11,QCM,0.03,0.99,93.82,80,5,85,80,80,0,1.06,100.0,Moyen,Facile,1,Plus Facile,Pas Adapte,Sociology
6558,2020,Sociologie,1,Les Differentes Approches de l'Economie,1,Comment l'Activite et la Science Economiques se detachent-elles de la Morale et de la Politique?,13,939,11,QCM,0.74,0.2,21.74,18,66,84,45,18,27,1.87,40.0,Facile,Difficile,-2,Beaucoup plus Difficile,Pas Adapte,Sociology
939,2015,Sociologie,1,Les Differentes Approches de l'Economie,1,Comment l'Activite et la Science Economiques se detachent-elles de la Morale et de la Politique?,13,940,12,QCM,0.1,0.8,87.5,61,9,70,68,61,7,1.03,89.71,Difficile,Facile,2,Beaucoup plus Facile,Pas Adapte,Sociology
2063,2016,Sociologie,1,Les Differentes Approches de l'Economie,1,Comment l'Activite et la Science Economiques se detachent-elles de la Morale et de la Politique?,13,940,12,QCM,0.62,0.19,11.63,9,70,79,73,9,64,1.08,12.33,Difficile,Difficile,0,Meme Difficulté,Pas Adapte,Sociology
3187,2017,Sociologie,1,Les Differentes Approches de l'Economie,1,Comment l'Activite et la Science Economiques se detachent-elles de la Morale et de la Politique?,13,940,12,QCM,0.08,0.8,88.24,75,10,85,78,75,3,1.09,96.15,Difficile,Facile,2,Beaucoup plus Facile,Pas Adapte,Sociology
4311,2018,Sociologie,1,Les Differentes Approches de l'Economie,1,Comment l'Activite et la Science Economiques se detachent-elles de la Morale et de la Politique?,13,940,12,QCM,0.11,0.93,74.71,69,24,93,75,69,6,1.24,92.0,Difficile,Facile,2,Beaucoup plus Facile,Adapte,Sociology
5435,2019,Sociologie,1,Les Differentes Approches de l'Economie,1,Comment l'Activite et la Science Economiques se detachent-elles de la Morale et de la Politique?,13,940,12,QCM,0.19,0.98,74.71,78,27,105,79,78,1,1.33,98.73,Facile,Facile,0,Meme Difficulté,Adapte,Sociology
6559,2020,Sociologie,1,Les Differentes Approches de l'Economie,1,Comment l'Activite et la Science Economiques se detachent-elles de la Morale et de la Politique?,13,940,12,QCM,0.19,0.92,74.71,66,23,89,69,66,3,1.29,95.65,Facile,Facile,0,Meme Difficulté,Adapte,Sociology
940,2015,Sociologie,1,Les Differentes Approches de l'Economie,1,Comment l'Activite et la Science Economiques se detachent-elles de la Morale et de la Politique?,13,941,13,QCM,0.65,0.23,31.03,6,14,20,13,6,7,1.54,46.15,Facile,Difficile,-2,Beaucoup plus Difficile,Pas Adapte,Sociology
2064,2016,Sociologie,1,Les Differentes Approches de l'Economie,1,Comment l'Activite et la Science Economiques se detachent-elles de la Morale et de la Politique?,13,941,13,QCM,0.22,0.49,48.85,9,10,19,15,9,6,1.27,60.0,Moyen,Moyen,0,Meme Difficulté,Pas Adapte,Sociology
3188,2017,Sociologie,1,Les Differentes Approches de l'Economie,1,Comment l'Activite et la Science Economiques se detachent-elles de la Morale et de la Politique?,13,941,13,QROC,0.78,0.11,4.96,1,16,17,13,1,12,1.31,7.69,Moyen,Difficile,-1,Plus Difficile,Pas Adapte,Sociology
4312,2018,Sociologie,1,Les Differentes Approches de l'Economie,1,Comment l'Activite et la Science Economiques se detachent-elles de la Morale et de la Politique?,13,941,13,QO,0.76,0.06,30.69,6,14,20,13,6,7,1.54,46.15,Difficile,Difficile,0,Meme Difficulté,Pas Adapte,Sociology
5436,2019,Sociologie,1,Les Differentes Approches de l'Economie,1,Comment l'Activite et la Science Economiques se detachent-elles de la Morale et de la Politique?,13,941,13,QO,0.4,0.2,61.85,12,8,20,13,12,1,1.54,92.31,Difficile,Moyen,1,Plus Facile,Adapte,Sociology
6560,2020,Sociologie,1,Les Differentes Approches de l'Economie,1,Comment l'Activite et la Science Economiques se detachent-elles de la Morale et de la Politique?,13,941,13,QO,0.6,0.21,61.85,11,6,17,15,11,4,1.13,73.33,Moyen,Moyen,0,Meme Difficulté,Adapte,Sociology
941,2015,Sociologie,1,Les Differentes Approches de l'Economie,2,Les Auteurs Classiques,7,942,1,QROC,0.48,0.38,61.06,31,20,51,48,31,17,1.06,64.58,Moyen,Moyen,0,Meme Difficulté,Adapte,Sociology
2065,2016,Sociologie,1,Les Differentes Approches de l'Economie,2,Les Auteurs Classiques,7,942,1,QROC,0.46,0.33,61.06,30,19,49,33,30,3,1.48,90.91,Moyen,Moyen,0,Meme Difficulté,Adapte,Sociology
3189,2017,Sociologie,1,Les Differentes Approches de l'Economie,2,Les Auteurs Classiques,7,942,1,QROC,0.34,0.28,61.06,27,18,45,36,27,9,1.25,75.0,Moyen,Moyen,0,Meme Difficulté,Adapte,Sociology
4313,2018,Sociologie,1,Les Differentes Approches de l'Economie,2,Les Auteurs Classiques,7,942,1,QROC,0.26,0.28,61.06,27,17,44,42,27,15,1.05,64.29,Moyen,Moyen,0,Meme Difficulté,Adapte,Sociology
5437,2019,Sociologie,1,Les Differentes Approches de l'Economie,2,Les Auteurs Classiques,7,942,1,QROC,0.49,0.31,61.06,25,16,41,38,25,13,1.08,65.79,Moyen,Moyen,0,Meme Difficulté,Adapte,Sociology
6561,2020,Sociologie,1,Les Differentes Approches de l'Economie,2,Les Auteurs Classiques,7,942,1,QROC,0.3,0.26,61.06,26,17,43,27,26,1,1.59,96.3,Moyen,Moyen,0,Meme Difficulté,Adapte,Sociology
942,2015,Sociologie,1,Les Differentes Approches de l'Economie,2,Les Auteurs Classiques,7,943,2,QCU,0.13,0.81,65.2,33,18,51,41,33,8,1.24,80.49,Difficile,Facile,2,Beaucoup plus Facile,Adapte,Sociology
2066,2016,Sociologie,1,Les Differentes Approches de l'Economie,2,Les Auteurs Classiques,7,943,2,QCU,0.16,0.95,65.2,33,18,51,45,33,12,1.13,73.33,Facile,Facile,0,Meme Difficulté,Adapte,Sociology
3190,2017,Sociologie,1,Les Differentes Approches de l'Economie,2,Les Auteurs Classiques,7,943,2,QCU,0.17,0.9,65.2,33,18,51,38,33,5,1.34,86.84,Facile,Facile,0,Meme Difficulté,Adapte,Sociology
4314,2018,Sociologie,1,Les Differentes Approches de l'Economie,2,Les Auteurs Classiques,7,943,2,QCU,0.18,0.87,65.2,32,17,49,33,32,1,1.48,96.97,Facile,Facile,0,Meme Difficulté,Adapte,Sociology
5438,2019,Sociologie,1,Les Differentes Approches de l'Economie,2,Les Auteurs Classiques,7,943,2,QCU,0.19,0.82,65.2,34,18,52,42,34,8,1.24,80.95,Facile,Facile,0,Meme Difficulté,Adapte,Sociology
6562,2020,Sociologie,1,Les Differentes Approches de l'Economie,2,Les Auteurs Classiques,7,943,2,QCU,0.12,0.77,65.2,34,18,52,49,34,15,1.06,69.39,Facile,Facile,0,Meme Difficulté,Adapte,Sociology
943,2015,Sociologie,1,Les Differentes Approches de l'Economie,2,Les Auteurs Classiques,7,944,3,QCU,0.14,0.79,80.0,58,14,72,62,58,4,1.16,93.55,Moyen,Facile,1,Plus Facile,Pas Adapte,Sociology
2067,2016,Sociologie,1,Les Differentes Approches de l'Economie,2,Les Auteurs Classiques,7,944,3,QCU,0.21,0.41,35.7,23,41,64,38,23,15,1.68,60.53,Difficile,Moyen,1,Plus Facile,Pas Adapte,Sociology
3191,2017,Sociologie,1,Les Differentes Approches de l'Economie,2,Les Auteurs Classiques,7,944,3,QCU,0.32,0.48,50.28,32,31,63,47,32,15,1.34,68.09,Facile,Moyen,-1,Plus Difficile,Pas Adapte,Sociology
4315,2018,Sociologie,1,Les Differentes Approches de l'Economie,2,Les Auteurs Classiques,7,944,3,QROC,0.63,0.12,27.74,20,52,72,50,20,30,1.44,40.0,Difficile,Difficile,0,Meme Difficulté,Pas Adapte,Sociology
5439,2019,Sociologie,1,Les Differentes Approches de l'Economie,2,Les Auteurs Classiques,7,944,3,QROC,0.69,0.14,28.02,22,57,79,54,22,32,1.46,40.74,Difficile,Difficile,0,Meme Difficulté,Pas Adapte,Sociology
6563,2020,Sociologie,1,Les Differentes Approches de l'Economie,2,Les Auteurs Classiques,7,944,3,QROC,0.1,0.64,84.65,66,12,78,76,66,10,1.03,86.84,Facile,Facile,0,Meme Difficulté,Pas Adapte,Sociology
944,2015,Sociologie,1,Les Differentes Approches de l'Economie,2,Les Auteurs Classiques,7,945,4,QCU,0.66,0.21,13.26,1,4,5,3,1,2,1.67,33.33,Moyen,Difficile,-1,Plus Difficile,Pas Adapte,Sociology
2068,2016,Sociologie,1,Les Differentes Approches de l'Economie,2,Les Auteurs Classiques,7,945,4,QCU,0.4,0.27,19.33,1,5,6,5,1,4,1.2,20.0,Difficile,Difficile,0,Meme Difficulté,Pas Adapte,Sociology
3192,2017,Sociologie,1,Les Differentes Approches de l'Economie,2,Les Auteurs Classiques,7,945,4,QCU,0.32,0.62,55.35,3,3,6,3,3,0,2.0,100.0,Moyen,Moyen,0,Meme Difficulté,Pas Adapte,Sociology
4316,2018,Sociologie,1,Les Differentes Approches de l'Economie,2,Les Auteurs Classiques,7,945,4,QROC,0.65,0.03,27.61,2,5,7,3,2,1,2.33,66.67,Difficile,Difficile,0,Meme Difficulté,Pas Adapte,Sociology
5440,2019,Sociologie,1,Les Differentes Approches de l'Economie,2,Les Auteurs Classiques,7,945,4,QROC,0.26,0.39,36.68,3,5,8,6,3,3,1.33,50.0,Difficile,Moyen,1,Plus Facile,Pas Adapte,Sociology
6564,2020,Sociologie,1,Les Differentes Approches de l'Economie,2,Les Auteurs Classiques,7,945,4,QROC,0.35,0.29,57.63,5,4,9,9,5,4,1.0,55.56,Facile,Moyen,-1,Plus Difficile,Pas Adapte,Sociology
945,2015,Sociologie,1,Les Differentes Approches de l'Economie,2,Les Auteurs Classiques,7,946,5,QCU,0.29,0.57,58.47,46,33,79,50,46,4,1.58,92.0,Difficile,Moyen,1,Plus Facile,Pas Adapte,Sociology
2069,2016,Sociologie,1,Les Differentes Approches de l'Economie,2,Les Auteurs Classiques,7,946,5,QCU,0.6,0.38,5.65,5,79,84,40,5,35,2.1,12.5,Moyen,Difficile,-1,Plus Difficile,Pas Adapte,Sociology
3193,2017,Sociologie,1,Les Differentes Approches de l'Economie,2,Les Auteurs Classiques,7,946,5,QCU,0.11,0.9,99.35,88,1,89,89,88,1,1.0,98.88,Moyen,Facile,1,Plus Facile,Pas Adapte,Sociology
4317,2018,Sociologie,1,Les Differentes Approches de l'Economie,2,Les Auteurs Classiques,7,946,5,QCU,0.32,0.74,59.6,54,36,90,57,54,3,1.58,94.74,Moyen,Moyen,0,Meme Difficulté,Pas Adapte,Sociology
5441,2019,Sociologie,1,Les Differentes Approches de l'Economie,2,Les Auteurs Classiques,7,946,5,QCU,0.07,0.81,91.45,86,8,94,88,86,2,1.07,97.73,Facile,Facile,0,Meme Difficulté,Pas Adapte,Sociology
6565,2020,Sociologie,1,Les Differentes Approches de l'Economie,2,Les Auteurs Classiques,7,946,5,QCU,0.52,0.29,5.68,6,102,108,66,6,60,1.64,9.09,Difficile,Difficile,0,Meme Difficulté,Pas Adapte,Sociology
946,2015,Sociologie,1,Les Differentes Approches de l'Economie,2,Les Auteurs Classiques,7,947,6,QCU,0.27,0.68,43.94,6,7,13,7,6,1,1.86,85.71,Difficile,Moyen,1,Plus Facile,Pas Adapte,Sociology
2070,2016,Sociologie,1,Les Differentes Approches de l'Economie,2,Les Auteurs Classiques,7,947,6,QCU,0.19,0.78,98.92,12,0,12,12,12,0,1.0,100.0,Difficile,Facile,2,Beaucoup plus Facile,Pas Adapte,Sociology
3194,2017,Sociologie,1,Les Differentes Approches de l'Economie,2,Les Auteurs Classiques,7,947,6,QCU,0.36,0.52,45.34,5,7,12,6,5,1,2.0,83.33,Difficile,Moyen,1,Plus Facile,Pas Adapte,Sociology
4318,2018,Sociologie,1,Les Differentes Approches de l'Economie,2,Les Auteurs Classiques,7,947,6,QCU,0.28,0.47,51.69,6,6,12,7,6,1,1.71,85.71,Moyen,Moyen,0,Meme Difficulté,Pas Adapte,Sociology
5442,2019,Sociologie,1,Les Differentes Approches de l'Economie,2,Les Auteurs Classiques,7,947,6,QCU,0.25,0.66,38.56,5,9,14,6,5,1,2.33,83.33,Difficile,Moyen,1,Plus Facile,Pas Adapte,Sociology
6566,2020,Sociologie,1,Les Differentes Approches de l'Economie,2,Les Auteurs Classiques,7,947,6,QCU,0.46,0.38,22.69,3,9,12,10,3,7,1.2,30.0,Difficile,Difficile,0,Meme Difficulté,Pas Adapte,Sociology
947,2015,Sociologie,1,Les Differentes Approches de l'Economie,2,Les Auteurs Classiques,7,948,7,QCM,0.13,0.98,93.05,89,7,96,96,89,7,1.0,92.71,Difficile,Facile,2,Beaucoup plus Facile,Pas Adapte,Sociology
2071,2016,Sociologie,1,Les Differentes Approches de l'Economie,2,Les Auteurs Classiques,7,948,7,QCM,0.39,0.61,43.73,43,56,99,54,43,11,1.83,79.63,Moyen,Moyen,0,Meme Difficulté,Pas Adapte,Sociology
3195,2017,Sociologie,1,Les Differentes Approches de l'Economie,2,Les Auteurs Classiques,7,948,7,QCM,0.07,0.96,92.85,82,6,88,87,82,5,1.01,94.25,Moyen,Facile,1,Plus Facile,Pas Adapte,Sociology
4319,2018,Sociologie,1,Les Differentes Approches de l'Economie,2,Les Auteurs Classiques,7,948,7,QCM,0.08,0.97,70.84,63,26,89,81,63,18,1.1,77.78,Difficile,Facile,2,Beaucoup plus Facile,Adapte,Sociology
5443,2019,Sociologie,1,Les Differentes Approches de l'Economie,2,Les Auteurs Classiques,7,948,7,QCM,0.18,0.83,70.84,57,23,80,69,57,12,1.16,82.61,Facile,Facile,0,Meme Difficulté,Adapte,Sociology
6567,2020,Sociologie,1,Les Differentes Approches de l'Economie,2,Les Auteurs Classiques,7,948,7,QCM,0.05,0.96,70.84,65,27,92,72,65,7,1.28,90.28,Facile,Facile,0,Meme Difficulté,Adapte,Sociology
948,2015,Sociologie,1,Les Differentes Approches de l'Economie,3,Les Auteurs Neoclassiques,10,949,1,QCU,0.2,0.77,82.12,70,15,85,72,70,2,1.18,97.22,Facile,Facile,0,Meme Difficulté,Pas Adapte,Sociology
2072,2016,Sociologie,1,Les Differentes Approches de l'Economie,3,Les Auteurs Neoclassiques,10,949,1,QCU,0.56,0.23,1.34,1,76,77,49,1,48,1.57,2.04,Facile,Difficile,-2,Beaucoup plus Difficile,Pas Adapte,Sociology
3196,2017,Sociologie,1,Les Differentes Approches de l'Economie,3,Les Auteurs Neoclassiques,10,949,1,QCU,0.7,0.23,30.07,23,54,77,52,23,29,1.48,44.23,Difficile,Difficile,0,Meme Difficulté,Pas Adapte,Sociology
4320,2018,Sociologie,1,Les Differentes Approches de l'Economie,3,Les Auteurs Neoclassiques,10,949,1,QCM,0.03,0.96,81.16,71,17,88,77,71,6,1.14,92.21,Difficile,Facile,2,Beaucoup plus Facile,Pas Adapte,Sociology
5444,2019,Sociologie,1,Les Differentes Approches de l'Economie,3,Les Auteurs Neoclassiques,10,949,1,QCU,0.14,0.98,79.36,62,16,78,76,62,14,1.03,81.58,Facile,Facile,0,Meme Difficulté,Pas Adapte,Sociology
6568,2020,Sociologie,1,Les Differentes Approches de l'Economie,3,Les Auteurs Neoclassiques,10,949,1,QCU,0.31,0.7,55.1,47,38,85,63,47,16,1.35,74.6,Difficile,Moyen,1,Plus Facile,Pas Adapte,Sociology
949,2015,Sociologie,1,Les Differentes Approches de l'Economie,3,Les Auteurs Neoclassiques,10,950,2,QCM,0.12,0.73,94.63,95,5,100,96,95,1,1.04,98.96,Facile,Facile,0,Meme Difficulté,Pas Adapte,Sociology
2073,2016,Sociologie,1,Les Differentes Approches de l'Economie,3,Les Auteurs Neoclassiques,10,950,2,QCM,0.27,0.62,42.12,48,66,114,109,48,61,1.05,44.04,Difficile,Moyen,1,Plus Facile,Pas Adapte,Sociology
3197,2017,Sociologie,1,Les Differentes Approches de l'Economie,3,Les Auteurs Neoclassiques,10,950,2,QCM,0.52,0.29,12.0,13,98,111,101,13,88,1.1,12.87,Moyen,Difficile,-1,Plus Difficile,Pas Adapte,Sociology
4321,2018,Sociologie,1,Les Differentes Approches de l'Economie,3,Les Auteurs Neoclassiques,10,950,2,QO,0.94,0.09,8.12,8,91,99,69,8,61,1.43,11.59,Difficile,Difficile,0,Meme Difficulté,Pas Adapte,Sociology
5445,2019,Sociologie,1,Les Differentes Approches de l'Economie,3,Les Auteurs Neoclassiques,10,950,2,QO,0.94,0.1,16.41,14,73,87,62,14,48,1.4,22.58,Facile,Difficile,-2,Beaucoup plus Difficile,Pas Adapte,Sociology
6569,2020,Sociologie,1,Les Differentes Approches de l'Economie,3,Les Auteurs Neoclassiques,10,950,2,QO,0.14,0.38,79.36,74,19,93,86,74,12,1.08,86.05,Facile,Facile,0,Meme Difficulté,Pas Adapte,Sociology
950,2015,Sociologie,1,Les Differentes Approches de l'Economie,3,Les Auteurs Neoclassiques,10,951,3,QCM,0.34,0.5,35.11,33,60,93,50,33,17,1.86,66.0,Moyen,Moyen,0,Meme Difficulté,Pas Adapte,Sociology
2074,2016,Sociologie,1,Les Differentes Approches de l'Economie,3,Les Auteurs Neoclassiques,10,951,3,QCM,0.37,0.62,57.99,52,38,90,70,52,18,1.29,74.29,Difficile,Moyen,1,Plus Facile,Pas Adapte,Sociology
3198,2017,Sociologie,1,Les Differentes Approches de l'Economie,3,Les Auteurs Neoclassiques,10,951,3,QCM,0.43,0.42,64.68,61,33,94,92,61,31,1.02,66.3,Facile,Moyen,-1,Plus Difficile,Adapte,Sociology
4322,2018,Sociologie,1,Les Differentes Approches de l'Economie,3,Les Auteurs Neoclassiques,10,951,3,QCM,0.32,0.42,64.68,67,37,104,90,67,23,1.16,74.44,Moyen,Moyen,0,Meme Difficulté,Adapte,Sociology
5446,2019,Sociologie,1,Les Differentes Approches de l'Economie,3,Les Auteurs Neoclassiques,10,951,3,QCM,0.45,0.43,64.68,67,36,103,80,67,13,1.29,83.75,Moyen,Moyen,0,Meme Difficulté,Adapte,Sociology
6570,2020,Sociologie,1,Les Differentes Approches de l'Economie,3,Les Auteurs Neoclassiques,10,951,3,QCM,0.47,0.48,64.68,74,41,115,100,74,26,1.15,74.0,Moyen,Moyen,0,Meme Difficulté,Adapte,Sociology
951,2015,Sociologie,1,Les Differentes Approches de l'Economie,3,Les Auteurs Neoclassiques,10,952,4,QCM,0.19,0.84,81.54,6,1,7,6,6,0,1.17,100.0,Facile,Facile,0,Meme Difficulté,Pas Adapte,Sociology
2075,2016,Sociologie,1,Les Differentes Approches de l'Economie,3,Les Auteurs Neoclassiques,10,952,4,QCM,0.24,0.45,50.18,3,3,6,4,3,1,1.5,75.0,Difficile,Moyen,1,Plus Facile,Pas Adapte,Sociology
3199,2017,Sociologie,1,Les Differentes Approches de l'Economie,3,Les Auteurs Neoclassiques,10,952,4,QCM,0.75,0.19,19.0,1,6,7,4,1,3,1.75,25.0,Facile,Difficile,-2,Beaucoup plus Difficile,Pas Adapte,Sociology
4323,2018,Sociologie,1,Les Differentes Approches de l'Economie,3,Les Auteurs Neoclassiques,10,952,4,QCM,0.01,0.72,79.85,5,1,6,6,5,1,1.0,83.33,Facile,Facile,0,Meme Difficulté,Pas Adapte,Sociology
5447,2019,Sociologie,1,Les Differentes Approches de l'Economie,3,Les Auteurs Neoclassiques,10,952,4,QCM,0.62,0.18,6.25,0,5,5,3,0,3,1.67,0.0,Moyen,Difficile,-1,Plus Difficile,Pas Adapte,Sociology
6571,2020,Sociologie,1,Les Differentes Approches de l'Economie,3,Les Auteurs Neoclassiques,10,952,4,QCU,0.3,0.72,59.72,2,2,4,4,2,2,1.0,50.0,Difficile,Moyen,1,Plus Facile,Pas Adapte,Sociology
952,2015,Sociologie,1,Les Differentes Approches de l'Economie,3,Les Auteurs Neoclassiques,10,953,5,QCM,0.31,0.58,64.54,10,6,16,15,10,5,1.07,66.67,Difficile,Moyen,1,Plus Facile,Adapte,Sociology
2076,2016,Sociologie,1,Les Differentes Approches de l'Economie,3,Les Auteurs Neoclassiques,10,953,5,QCM,0.45,0.51,64.54,9,5,14,13,9,4,1.08,69.23,Moyen,Moyen,0,Meme Difficulté,Adapte,Sociology
3200,2017,Sociologie,1,Les Differentes Approches de l'Economie,3,Les Auteurs Neoclassiques,10,953,5,QCU,0.33,0.66,64.54,8,5,13,11,8,3,1.18,72.73,Moyen,Moyen,0,Meme Difficulté,Adapte,Sociology
4324,2018,Sociologie,1,Les Differentes Approches de l'Economie,3,Les Auteurs Neoclassiques,10,953,5,QCU,0.36,0.7,64.54,10,5,15,12,10,2,1.25,83.33,Moyen,Moyen,0,Meme Difficulté,Adapte,Sociology
5448,2019,Sociologie,1,Les Differentes Approches de l'Economie,3,Les Auteurs Neoclassiques,10,953,5,QCU,0.35,0.69,64.54,10,6,16,11,10,1,1.45,90.91,Moyen,Moyen,0,Meme Difficulté,Adapte,Sociology
6572,2020,Sociologie,1,Les Differentes Approches de l'Economie,3,Les Auteurs Neoclassiques,10,953,5,QCM,0.34,0.7,64.54,10,6,16,11,10,1,1.45,90.91,Moyen,Moyen,0,Meme Difficulté,Adapte,Sociology
953,2015,Sociologie,1,Les Differentes Approches de l'Economie,3,Les Auteurs Neoclassiques,10,954,6,QCM,0.64,0.23,17.15,4,18,22,8,4,4,2.75,50.0,Moyen,Difficile,-1,Plus Difficile,Pas Adapte,Sociology
2077,2016,Sociologie,1,Les Differentes Approches de l'Economie,3,Les Auteurs Neoclassiques,10,954,6,QCU,0.31,0.54,40.26,10,15,25,16,10,6,1.56,62.5,Difficile,Moyen,1,Plus Facile,Pas Adapte,Sociology
3201,2017,Sociologie,1,Les Differentes Approches de l'Economie,3,Les Auteurs Neoclassiques,10,954,6,QCU,0.44,0.38,14.82,4,23,27,23,4,19,1.17,17.39,Facile,Difficile,-2,Beaucoup plus Difficile,Pas Adapte,Sociology
4325,2018,Sociologie,1,Les Differentes Approches de l'Economie,3,Les Auteurs Neoclassiques,10,954,6,QCU,0.13,0.91,99.34,24,0,24,24,24,0,1.0,100.0,Facile,Facile,0,Meme Difficulté,Pas Adapte,Sociology
5449,2019,Sociologie,1,Les Differentes Approches de l'Economie,3,Les Auteurs Neoclassiques,10,954,6,QCU,0.25,0.55,45.34,13,15,28,22,13,9,1.27,59.09,Difficile,Moyen,1,Plus Facile,Pas Adapte,Sociology
6573,2020,Sociologie,1,Les Differentes Approches de l'Economie,3,Les Auteurs Neoclassiques,10,954,6,QCU,0.72,0.24,32.54,10,22,32,30,10,20,1.07,33.33,Moyen,Difficile,-1,Plus Difficile,Pas Adapte,Sociology
954,2015,Sociologie,1,Les Differentes Approches de l'Economie,3,Les Auteurs Neoclassiques,10,955,7,QROC,0.27,0.37,54.3,26,21,47,41,26,15,1.15,63.41,Difficile,Moyen,1,Plus Facile,Pas Adapte,Sociology
2078,2016,Sociologie,1,Les Differentes Approches de l'Economie,3,Les Auteurs Neoclassiques,10,955,7,QROC,0.03,0.63,77.64,39,11,50,42,39,3,1.19,92.86,Facile,Facile,0,Meme Difficulté,Pas Adapte,Sociology
3202,2017,Sociologie,1,Les Differentes Approches de l'Economie,3,Les Auteurs Neoclassiques,10,955,7,QROC,0.04,0.46,98.72,49,1,50,49,49,0,1.02,100.0,Facile,Facile,0,Meme Difficulté,Pas Adapte,Sociology
4326,2018,Sociologie,1,Les Differentes Approches de l'Economie,3,Les Auteurs Neoclassiques,10,955,7,QROC,0.28,0.33,44.12,23,30,53,45,23,22,1.18,51.11,Moyen,Moyen,0,Meme Difficulté,Pas Adapte,Sociology
5450,2019,Sociologie,1,Les Differentes Approches de l'Economie,3,Les Auteurs Neoclassiques,10,955,7,QROC,0.33,0.27,58.13,28,20,48,40,28,12,1.2,70.0,Facile,Moyen,-1,Plus Difficile,Pas Adapte,Sociology
6574,2020,Sociologie,1,Les Differentes Approches de l'Economie,3,Les Auteurs Neoclassiques,10,955,7,QROC,0.79,0.12,20.83,10,40,50,37,10,27,1.35,27.03,Difficile,Difficile,0,Meme Difficulté,Pas Adapte,Sociology
955,2015,Sociologie,1,Les Differentes Approches de l'Economie,3,Les Auteurs Neoclassiques,10,956,8,QCU,0.68,0.32,11.17,11,87,98,94,11,83,1.04,11.7,Facile,Difficile,-2,Beaucoup plus Difficile,Pas Adapte,Sociology
2079,2016,Sociologie,1,Les Differentes Approches de l'Economie,3,Les Auteurs Neoclassiques,10,956,8,QCU,0.27,0.7,64.09,69,39,108,70,69,1,1.54,98.57,Facile,Moyen,-1,Plus Difficile,Adapte,Sociology
3203,2017,Sociologie,1,Les Differentes Approches de l'Economie,3,Les Auteurs Neoclassiques,10,956,8,QCU,0.24,0.67,64.09,70,39,109,101,70,31,1.08,69.31,Moyen,Moyen,0,Meme Difficulté,Adapte,Sociology
4327,2018,Sociologie,1,Les Differentes Approches de l'Economie,3,Les Auteurs Neoclassiques,10,956,8,QCU,0.3,0.73,64.09,60,34,94,92,60,32,1.02,65.22,Moyen,Moyen,0,Meme Difficulté,Adapte,Sociology
5451,2019,Sociologie,1,Les Differentes Approches de l'Economie,3,Les Auteurs Neoclassiques,10,956,8,QROC,0.54,0.38,64.09,56,31,87,75,56,19,1.16,74.67,Moyen,Moyen,0,Meme Difficulté,Adapte,Sociology
6575,2020,Sociologie,1,Les Differentes Approches de l'Economie,3,Les Auteurs Neoclassiques,10,956,8,QROC,0.31,0.37,64.09,56,31,87,73,56,17,1.19,76.71,Moyen,Moyen,0,Meme Difficulté,Adapte,Sociology
956,2015,Sociologie,1,Les Differentes Approches de l'Economie,3,Les Auteurs Neoclassiques,10,957,9,QCU,0.33,0.61,35.22,15,28,43,34,15,19,1.26,44.12,Moyen,Moyen,0,Meme Difficulté,Pas Adapte,Sociology
2080,2016,Sociologie,1,Les Differentes Approches de l'Economie,3,Les Auteurs Neoclassiques,10,957,9,QCU,0.21,0.58,38.97,19,29,48,31,19,12,1.55,61.29,Moyen,Moyen,0,Meme Difficulté,Pas Adapte,Sociology
3204,2017,Sociologie,1,Les Differentes Approches de l'Economie,3,Les Auteurs Neoclassiques,10,957,9,QCU,0.0,0.81,68.26,29,14,43,29,29,0,1.48,100.0,Moyen,Facile,1,Plus Facile,Adapte,Sociology
4328,2018,Sociologie,1,Les Differentes Approches de l'Economie,3,Les Auteurs Neoclassiques,10,957,9,QCU,0.03,0.75,68.26,29,14,43,32,29,3,1.34,90.62,Facile,Facile,0,Meme Difficulté,Adapte,Sociology
5452,2019,Sociologie,1,Les Differentes Approches de l'Economie,3,Les Auteurs Neoclassiques,10,957,9,QCU,0.09,1.0,68.26,29,13,42,30,29,1,1.4,96.67,Facile,Facile,0,Meme Difficulté,Adapte,Sociology
6576,2020,Sociologie,1,Les Differentes Approches de l'Economie,3,Les Auteurs Neoclassiques,10,957,9,QCU,0.19,0.82,68.26,27,13,40,29,27,2,1.38,93.1,Facile,Facile,0,Meme Difficulté,Adapte,Sociology
957,2015,Sociologie,1,Les Differentes Approches de l'Economie,3,Les Auteurs Neoclassiques,10,958,10,QCU,0.7,0.3,16.81,2,7,9,5,2,3,1.8,40.0,Moyen,Difficile,-1,Plus Difficile,Pas Adapte,Sociology
2081,2016,Sociologie,1,Les Differentes Approches de l'Economie,3,Les Auteurs Neoclassiques,10,958,10,QCU,0.36,0.66,56.62,5,3,8,7,5,2,1.14,71.43,Facile,Moyen,-1,Plus Difficile,Pas Adapte,Sociology
3205,2017,Sociologie,1,Les Differentes Approches de l'Economie,3,Les Auteurs Neoclassiques,10,958,10,QCU,0.15,0.84,76.78,6,2,8,6,6,0,1.33,100.0,Moyen,Facile,1,Plus Facile,Pas Adapte,Sociology
4329,2018,Sociologie,1,Les Differentes Approches de l'Economie,3,Les Auteurs Neoclassiques,10,958,10,QCU,0.18,0.97,81.86,6,1,7,6,6,0,1.17,100.0,Facile,Facile,0,Meme Difficulté,Pas Adapte,Sociology
5453,2019,Sociologie,1,Les Differentes Approches de l'Economie,3,Les Auteurs Neoclassiques,10,958,10,QCU,0.11,0.96,69.99,6,2,8,8,6,2,1.0,75.0,Moyen,Facile,1,Plus Facile,Adapte,Sociology
6577,2020,Sociologie,1,Les Differentes Approches de l'Economie,3,Les Auteurs Neoclassiques,10,958,10,QCM,0.1,0.94,69.99,5,2,7,6,5,1,1.17,83.33,Facile,Facile,0,Meme Difficulté,Adapte,Sociology
958,2015,Sociologie,1,Les Differentes Approches de l'Economie,4,L'Analyse Marxiste,9,959,1,QCU,0.04,0.93,77.33,7,2,9,8,7,1,1.12,87.5,Moyen,Facile,1,Plus Facile,Pas Adapte,Sociology
2082,2016,Sociologie,1,Les Differentes Approches de l'Economie,4,L'Analyse Marxiste,9,959,1,QCU,0.12,0.76,81.04,6,2,8,7,6,1,1.14,85.71,Difficile,Facile,2,Beaucoup plus Facile,Pas Adapte,Sociology
3206,2017,Sociologie,1,Les Differentes Approches de l'Economie,4,L'Analyse Marxiste,9,959,1,QCM,0.3,0.54,61.13,5,3,8,7,5,2,1.14,71.43,Moyen,Moyen,0,Meme Difficulté,Adapte,Sociology
4330,2018,Sociologie,1,Les Differentes Approches de l'Economie,4,L'Analyse Marxiste,9,959,1,QCM,0.44,0.5,61.13,5,3,8,8,5,3,1.0,62.5,Moyen,Moyen,0,Meme Difficulté,Adapte,Sociology
5454,2019,Sociologie,1,Les Differentes Approches de l'Economie,4,L'Analyse Marxiste,9,959,1,QCM,0.26,0.32,61.13,6,3,9,9,6,3,1.0,66.67,Moyen,Moyen,0,Meme Difficulté,Adapte,Sociology
6578,2020,Sociologie,1,Les Differentes Approches de l'Economie,4,L'Analyse Marxiste,9,959,1,QCM,0.44,0.33,61.13,5,3,8,7,5,2,1.14,71.43,Moyen,Moyen,0,Meme Difficulté,Adapte,Sociology
959,2015,Sociologie,1,Les Differentes Approches de l'Economie,4,L'Analyse Marxiste,9,960,2,QCU,0.31,0.5,46.01,46,53,99,93,46,47,1.06,49.46,Moyen,Moyen,0,Meme Difficulté,Pas Adapte,Sociology
2083,2016,Sociologie,1,Les Differentes Approches de l'Economie,4,L'Analyse Marxiste,9,960,2,QCU,0.03,0.75,81.14,72,17,89,87,72,15,1.02,82.76,Difficile,Facile,2,Beaucoup plus Facile,Pas Adapte,Sociology
3207,2017,Sociologie,1,Les Differentes Approches de l'Economie,4,L'Analyse Marxiste,9,960,2,QO,0.5,0.23,63.09,49,28,77,70,49,21,1.1,70.0,Moyen,Moyen,0,Meme Difficulté,Adapte,Sociology
4331,2018,Sociologie,1,Les Differentes Approches de l'Economie,4,L'Analyse Marxiste,9,960,2,QO,0.54,0.24,63.09,45,27,72,54,45,9,1.33,83.33,Moyen,Moyen,0,Meme Difficulté,Adapte,Sociology
5455,2019,Sociologie,1,Les Differentes Approches de l'Economie,4,L'Analyse Marxiste,9,960,2,QO,0.73,0.28,63.09,49,29,78,73,49,24,1.07,67.12,Moyen,Moyen,0,Meme Difficulté,Adapte,Sociology
6579,2020,Sociologie,1,Les Differentes Approches de l'Economie,4,L'Analyse Marxiste,9,960,2,QO,0.48,0.23,63.09,50,30,80,73,50,23,1.1,68.49,Moyen,Moyen,0,Meme Difficulté,Adapte,Sociology
960,2015,Sociologie,1,Les Differentes Approches de l'Economie,4,L'Analyse Marxiste,9,961,3,QCU,0.29,0.69,51.7,31,28,59,38,31,7,1.55,81.58,Moyen,Moyen,0,Meme Difficulté,Pas Adapte,Sociology
2084,2016,Sociologie,1,Les Differentes Approches de l'Economie,4,L'Analyse Marxiste,9,961,3,QCU,0.37,0.66,48.86,26,28,54,32,26,6,1.69,81.25,Difficile,Moyen,1,Plus Facile,Pas Adapte,Sociology
3208,2017,Sociologie,1,Les Differentes Approches de l'Economie,4,L'Analyse Marxiste,9,961,3,QCU,0.32,0.63,51.86,28,26,54,36,28,8,1.5,77.78,Difficile,Moyen,1,Plus Facile,Pas Adapte,Sociology
4332,2018,Sociologie,1,Les Differentes Approches de l'Economie,4,L'Analyse Marxiste,9,961,3,QCU,0.31,0.43,44.49,21,27,48,28,21,7,1.71,75.0,Difficile,Moyen,1,Plus Facile,Pas Adapte,Sociology
5456,2019,Sociologie,1,Les Differentes Approches de l'Economie,4,L'Analyse Marxiste,9,961,3,QCU,0.01,0.86,77.71,37,11,48,40,37,3,1.2,92.5,Difficile,Facile,2,Beaucoup plus Facile,Pas Adapte,Sociology
6580,2020,Sociologie,1,Les Differentes Approches de l'Economie,4,L'Analyse Marxiste,9,961,3,QCU,0.2,0.86,91.8,48,4,52,51,48,3,1.02,94.12,Facile,Facile,0,Meme Difficulté,Pas Adapte,Sociology
961,2015,Sociologie,1,Les Differentes Approches de l'Economie,4,L'Analyse Marxiste,9,962,4,QCU,0.22,0.53,40.6,18,26,44,43,18,25,1.02,41.86,Difficile,Moyen,1,Plus Facile,Pas Adapte,Sociology
2085,2016,Sociologie,1,Les Differentes Approches de l'Economie,4,L'Analyse Marxiste,9,962,4,QCM,0.72,0.16,2.43,1,45,46,14,1,13,3.29,7.14,Facile,Difficile,-2,Beaucoup plus Difficile,Pas Adapte,Sociology
3209,2017,Sociologie,1,Les Differentes Approches de l'Economie,4,L'Analyse Marxiste,9,962,4,QROC,0.48,0.28,58.42,29,20,49,47,29,18,1.04,61.7,Moyen,Moyen,0,Meme Difficulté,Pas Adapte,Sociology
4333,2018,Sociologie,1,Les Differentes Approches de l'Economie,4,L'Analyse Marxiste,9,962,4,QROC,0.11,0.79,90.35,49,5,54,49,49,0,1.1,100.0,Facile,Facile,0,Meme Difficulté,Pas Adapte,Sociology
5457,2019,Sociologie,1,Les Differentes Approches de l'Economie,4,L'Analyse Marxiste,9,962,4,QROC,0.8,0.07,31.94,18,37,55,33,18,15,1.67,54.55,Facile,Difficile,-2,Beaucoup plus Difficile,Pas Adapte,Sociology
6581,2020,Sociologie,1,Les Differentes Approches de l'Economie,4,L'Analyse Marxiste,9,962,4,QO,0.13,0.56,96.39,45,2,47,47,45,2,1.0,95.74,Difficile,Facile,2,Beaucoup plus Facile,Pas Adapte,Sociology
962,2015,Sociologie,1,Les Differentes Approches de l'Economie,4,L'Analyse Marxiste,9,963,5,QCM,0.5,0.63,45.84,25,30,55,47,25,22,1.17,53.19,Moyen,Moyen,0,Meme Difficulté,Pas Adapte,Sociology
2086,2016,Sociologie,1,Les Differentes Approches de l'Economie,4,L'Analyse Marxiste,9,963,5,QCM,0.32,0.41,43.88,21,26,47,23,21,2,2.04,91.3,Moyen,Moyen,0,Meme Difficulté,Pas Adapte,Sociology
3210,2017,Sociologie,1,Les Differentes Approches de l'Economie,4,L'Analyse Marxiste,9,963,5,QCM,0.53,0.29,1.92,1,47,48,21,1,20,2.29,4.76,Moyen,Difficile,-1,Plus Difficile,Pas Adapte,Sociology
4334,2018,Sociologie,1,Les Differentes Approches de l'Economie,4,L'Analyse Marxiste,9,963,5,QCM,0.74,0.17,23.01,10,34,44,36,10,26,1.22,27.78,Moyen,Difficile,-1,Plus Difficile,Pas Adapte,Sociology
5458,2019,Sociologie,1,Les Differentes Approches de l'Economie,4,L'Analyse Marxiste,9,963,5,QCM,0.36,0.61,52.75,21,19,40,33,21,12,1.21,63.64,Facile,Moyen,-1,Plus Difficile,Pas Adapte,Sociology
6582,2020,Sociologie,1,Les Differentes Approches de l'Economie,4,L'Analyse Marxiste,9,963,5,QROC,0.81,0.03,9.59,3,32,35,33,3,30,1.06,9.09,Difficile,Difficile,0,Meme Difficulté,Pas Adapte,Sociology
963,2015,Sociologie,1,Les Differentes Approches de l'Economie,4,L'Analyse Marxiste,9,964,6,QCM,0.53,0.3,19.04,4,17,21,9,4,5,2.33,44.44,Facile,Difficile,-2,Beaucoup plus Difficile,Pas Adapte,Sociology
2087,2016,Sociologie,1,Les Differentes Approches de l'Economie,4,L'Analyse Marxiste,9,964,6,QCM,0.34,0.38,43.67,8,10,18,17,8,9,1.06,47.06,Moyen,Moyen,0,Meme Difficulté,Pas Adapte,Sociology
3211,2017,Sociologie,1,Les Differentes Approches de l'Economie,4,L'Analyse Marxiste,9,964,6,QCM,0.72,0.18,9.08,2,18,20,16,2,14,1.25,12.5,Moyen,Difficile,-1,Plus Difficile,Pas Adapte,Sociology
4335,2018,Sociologie,1,Les Differentes Approches de l'Economie,4,L'Analyse Marxiste,9,964,6,QCM,0.51,0.3,30.56,7,15,22,15,7,8,1.47,46.67,Difficile,Difficile,0,Meme Difficulté,Pas Adapte,Sociology
5459,2019,Sociologie,1,Les Differentes Approches de l'Economie,4,L'Analyse Marxiste,9,964,6,QCU,0.23,0.41,41.24,8,12,20,15,8,7,1.33,53.33,Facile,Moyen,-1,Plus Difficile,Pas Adapte,Sociology
6583,2020,Sociologie,1,Les Differentes Approches de l'Economie,4,L'Analyse Marxiste,9,964,6,QCU,0.54,0.33,19.76,4,16,20,9,4,5,2.22,44.44,Facile,Difficile,-2,Beaucoup plus Difficile,Pas Adapte,Sociology
964,2015,Sociologie,1,Les Differentes Approches de l'Economie,4,L'Analyse Marxiste,9,965,7,QCU,0.09,0.78,99.47,98,1,99,99,98,1,1.0,98.99,Moyen,Facile,1,Plus Facile,Pas Adapte,Sociology
2088,2016,Sociologie,1,Les Differentes Approches de l'Economie,4,L'Analyse Marxiste,9,965,7,QCU,0.29,0.47,53.84,52,45,97,88,52,36,1.1,59.09,Difficile,Moyen,1,Plus Facile,Pas Adapte,Sociology
3212,2017,Sociologie,1,Les Differentes Approches de l'Economie,4,L'Analyse Marxiste,9,965,7,QCU,0.01,0.85,73.39,62,23,85,79,62,17,1.08,78.48,Difficile,Facile,2,Beaucoup plus Facile,Adapte,Sociology
4336,2018,Sociologie,1,Les Differentes Approches de l'Economie,4,L'Analyse Marxiste,9,965,7,QCU,0.13,0.89,73.39,68,24,92,88,68,20,1.05,77.27,Facile,Facile,0,Meme Difficulté,Adapte,Sociology
5460,2019,Sociologie,1,Les Differentes Approches de l'Economie,4,L'Analyse Marxiste,9,965,7,QCU,0.14,0.95,73.39,67,24,91,84,67,17,1.08,79.76,Facile,Facile,0,Meme Difficulté,Adapte,Sociology
6584,2020,Sociologie,1,Les Differentes Approches de l'Economie,4,L'Analyse Marxiste,9,965,7,QCU,0.19,0.94,73.39,68,25,93,74,68,6,1.26,91.89,Facile,Facile,0,Meme Difficulté,Adapte,Sociology
965,2015,Sociologie,1,Les Differentes Approches de l'Economie,4,L'Analyse Marxiste,9,966,8,QROC,0.42,0.29,57.76,39,28,67,62,39,23,1.08,62.9,Moyen,Moyen,0,Meme Difficulté,Pas Adapte,Sociology
2089,2016,Sociologie,1,Les Differentes Approches de l'Economie,4,L'Analyse Marxiste,9,966,8,QROC,0.08,0.89,89.85,62,7,69,64,62,2,1.08,96.88,Moyen,Facile,1,Plus Facile,Pas Adapte,Sociology
3213,2017,Sociologie,1,Les Differentes Approches de l'Economie,4,L'Analyse Marxiste,9,966,8,QROC,0.15,0.44,93.27,58,4,62,58,58,0,1.07,100.0,Difficile,Facile,2,Beaucoup plus Facile,Pas Adapte,Sociology
4337,2018,Sociologie,1,Les Differentes Approches de l'Economie,4,L'Analyse Marxiste,9,966,8,QROC,0.23,0.37,62.86,36,22,58,51,36,15,1.14,70.59,Moyen,Moyen,0,Meme Difficulté,Adapte,Sociology
5461,2019,Sociologie,1,Les Differentes Approches de l'Economie,4,L'Analyse Marxiste,9,966,8,QO,0.59,0.28,62.86,42,25,67,60,42,18,1.12,70.0,Moyen,Moyen,0,Meme Difficulté,Adapte,Sociology
6585,2020,Sociologie,1,Les Differentes Approches de l'Economie,4,L'Analyse Marxiste,9,966,8,QO,0.35,0.23,62.86,36,22,58,55,36,19,1.05,65.45,Moyen,Moyen,0,Meme Difficulté,Adapte,Sociology
966,2015,Sociologie,1,Les Differentes Approches de l'Economie,4,L'Analyse Marxiste,9,967,9,QCM,0.1,0.94,92.45,84,7,91,84,84,0,1.08,100.0,Facile,Facile,0,Meme Difficulté,Pas Adapte,Sociology
2090,2016,Sociologie,1,Les Differentes Approches de l'Economie,4,L'Analyse Marxiste,9,967,9,QO,1.0,0.13,3.28,3,101,104,53,3,50,1.96,5.66,Moyen,Difficile,-1,Plus Difficile,Pas Adapte,Sociology
3214,2017,Sociologie,1,Les Differentes Approches de l'Economie,4,L'Analyse Marxiste,9,967,9,QO,0.98,0.05,14.23,14,83,97,61,14,47,1.59,22.95,Facile,Difficile,-2,Beaucoup plus Difficile,Pas Adapte,Sociology
4338,2018,Sociologie,1,Les Differentes Approches de l'Economie,4,L'Analyse Marxiste,9,967,9,QO,0.25,0.16,57.37,53,40,93,65,53,12,1.43,81.54,Facile,Moyen,-1,Plus Difficile,Pas Adapte,Sociology
5462,2019,Sociologie,1,Les Differentes Approches de l'Economie,4,L'Analyse Marxiste,9,967,9,QO,0.91,0.03,10.13,10,86,96,77,10,67,1.25,12.99,Difficile,Difficile,0,Meme Difficulté,Pas Adapte,Sociology
6586,2020,Sociologie,1,Les Differentes Approches de l'Economie,4,L'Analyse Marxiste,9,967,9,QO,0.13,0.54,94.24,104,6,110,110,104,6,1.0,94.55,Facile,Facile,0,Meme Difficulté,Pas Adapte,Sociology
967,2015,Sociologie,1,Les Differentes Approches de l'Economie,5,La Pensee Economique de Keynes,5,968,1,QCU,0.66,0.33,18.66,13,54,67,52,13,39,1.29,25.0,Moyen,Difficile,-1,Plus Difficile,Pas Adapte,Sociology
2091,2016,Sociologie,1,Les Differentes Approches de l'Economie,5,La Pensee Economique de Keynes,5,968,1,QCU,0.46,0.32,30.19,20,47,67,26,20,6,2.58,76.92,Difficile,Difficile,0,Meme Difficulté,Pas Adapte,Sociology
3215,2017,Sociologie,1,Les Differentes Approches de l'Economie,5,La Pensee Economique de Keynes,5,968,1,QCU,0.65,0.3,18.63,13,59,72,38,13,25,1.89,34.21,Moyen,Difficile,-1,Plus Difficile,Pas Adapte,Sociology
4339,2018,Sociologie,1,Les Differentes Approches de l'Economie,5,La Pensee Economique de Keynes,5,968,1,QCU,0.4,0.24,34.51,25,48,73,67,25,42,1.09,37.31,Moyen,Difficile,-1,Plus Difficile,Pas Adapte,Sociology
5463,2019,Sociologie,1,Les Differentes Approches de l'Economie,5,La Pensee Economique de Keynes,5,968,1,QCU,0.12,0.85,66.25,48,25,73,56,48,8,1.3,85.71,Facile,Facile,0,Meme Difficulté,Adapte,Sociology
6587,2020,Sociologie,1,Les Differentes Approches de l'Economie,5,La Pensee Economique de Keynes,5,968,1,QCU,0.1,0.88,66.25,47,24,71,53,47,6,1.34,88.68,Facile,Facile,0,Meme Difficulté,Adapte,Sociology
968,2015,Sociologie,1,Les Differentes Approches de l'Economie,5,La Pensee Economique de Keynes,5,969,2,QROC,0.81,0.21,18.15,4,20,24,15,4,11,1.6,26.67,Difficile,Difficile,0,Meme Difficulté,Pas Adapte,Sociology
2092,2016,Sociologie,1,Les Differentes Approches de l'Economie,5,La Pensee Economique de Keynes,5,969,2,QROC,0.54,0.26,39.89,10,15,25,16,10,6,1.56,62.5,Moyen,Moyen,0,Meme Difficulté,Pas Adapte,Sociology
3216,2017,Sociologie,1,Les Differentes Approches de l'Economie,5,La Pensee Economique de Keynes,5,969,2,QROC,0.13,0.45,92.43,20,2,22,20,20,0,1.1,100.0,Facile,Facile,0,Meme Difficulté,Pas Adapte,Sociology
4340,2018,Sociologie,1,Les Differentes Approches de l'Economie,5,La Pensee Economique de Keynes,5,969,2,QROC,0.77,0.15,4.56,1,20,21,12,1,11,1.75,8.33,Facile,Difficile,-2,Beaucoup plus Difficile,Pas Adapte,Sociology
5464,2019,Sociologie,1,Les Differentes Approches de l'Economie,5,La Pensee Economique de Keynes,5,969,2,QROC,0.42,0.28,55.9,12,9,21,12,12,0,1.75,100.0,Difficile,Moyen,1,Plus Facile,Pas Adapte,Sociology
6588,2020,Sociologie,1,Les Differentes Approches de l'Economie,5,La Pensee Economique de Keynes,5,969,2,QO,0.2,0.79,84.16,20,4,24,22,20,2,1.09,90.91,Difficile,Facile,2,Beaucoup plus Facile,Pas Adapte,Sociology
969,2015,Sociologie,1,Les Differentes Approches de l'Economie,5,La Pensee Economique de Keynes,5,970,3,QCU,0.34,0.43,63.09,31,18,49,39,31,8,1.26,79.49,Moyen,Moyen,0,Meme Difficulté,Adapte,Sociology
2093,2016,Sociologie,1,Les Differentes Approches de l'Economie,5,La Pensee Economique de Keynes,5,970,3,QCU,0.23,0.45,63.09,28,17,45,38,28,10,1.18,73.68,Moyen,Moyen,0,Meme Difficulté,Adapte,Sociology
3217,2017,Sociologie,1,Les Differentes Approches de l'Economie,5,La Pensee Economique de Keynes,5,970,3,QCU,0.32,0.58,63.09,25,15,40,33,25,8,1.21,75.76,Moyen,Moyen,0,Meme Difficulté,Adapte,Sociology
4341,2018,Sociologie,1,Les Differentes Approches de l'Economie,5,La Pensee Economique de Keynes,5,970,3,QCU,0.24,0.64,63.09,26,16,42,40,26,14,1.05,65.0,Moyen,Moyen,0,Meme Difficulté,Adapte,Sociology
5465,2019,Sociologie,1,Les Differentes Approches de l'Economie,5,La Pensee Economique de Keynes,5,970,3,QCU,0.39,0.74,63.09,25,15,40,39,25,14,1.03,64.1,Moyen,Moyen,0,Meme Difficulté,Adapte,Sociology
6589,2020,Sociologie,1,Les Differentes Approches de l'Economie,5,La Pensee Economique de Keynes,5,970,3,QCU,0.31,0.6,63.09,26,16,42,37,26,11,1.14,70.27,Moyen,Moyen,0,Meme Difficulté,Adapte,Sociology
970,2015,Sociologie,1,Les Differentes Approches de l'Economie,5,La Pensee Economique de Keynes,5,971,4,QCU,0.02,0.94,92.82,15,1,16,16,15,1,1.0,93.75,Difficile,Facile,2,Beaucoup plus Facile,Pas Adapte,Sociology
2094,2016,Sociologie,1,Les Differentes Approches de l'Economie,5,La Pensee Economique de Keynes,5,971,4,QCU,0.05,0.81,87.95,13,2,15,14,13,1,1.07,92.86,Facile,Facile,0,Meme Difficulté,Pas Adapte,Sociology
3218,2017,Sociologie,1,Les Differentes Approches de l'Economie,5,La Pensee Economique de Keynes,5,971,4,QCU,0.51,0.21,2.56,0,14,14,11,0,11,1.27,0.0,Difficile,Difficile,0,Meme Difficulté,Pas Adapte,Sociology
4342,2018,Sociologie,1,Les Differentes Approches de l'Economie,5,La Pensee Economique de Keynes,5,971,4,QCM,0.67,0.26,33.88,5,11,16,14,5,9,1.14,35.71,Difficile,Difficile,0,Meme Difficulté,Pas Adapte,Sociology
5466,2019,Sociologie,1,Les Differentes Approches de l'Economie,5,La Pensee Economique de Keynes,5,971,4,QCM,0.73,0.26,0.64,0,14,14,13,0,13,1.08,0.0,Moyen,Difficile,-1,Plus Difficile,Pas Adapte,Sociology
6590,2020,Sociologie,1,Les Differentes Approches de l'Economie,5,La Pensee Economique de Keynes,5,971,4,QCM,0.17,0.71,80.78,11,3,14,12,11,1,1.17,91.67,Facile,Facile,0,Meme Difficulté,Pas Adapte,Sociology
971,2015,Sociologie,1,Les Differentes Approches de l'Economie,5,La Pensee Economique de Keynes,5,972,5,QCM,0.65,0.17,14.47,12,72,84,34,12,22,2.47,35.29,Facile,Difficile,-2,Beaucoup plus Difficile,Pas Adapte,Sociology
2095,2016,Sociologie,1,Les Differentes Approches de l'Economie,5,La Pensee Economique de Keynes,5,972,5,QCM,0.17,0.89,93.86,76,5,81,80,76,4,1.01,95.0,Facile,Facile,0,Meme Difficulté,Pas Adapte,Sociology
3219,2017,Sociologie,1,Les Differentes Approches de l'Economie,5,La Pensee Economique de Keynes,5,972,5,QCM,0.57,0.28,11.32,10,80,90,72,10,62,1.25,13.89,Facile,Difficile,-2,Beaucoup plus Difficile,Pas Adapte,Sociology
4343,2018,Sociologie,1,Les Differentes Approches de l'Economie,5,La Pensee Economique de Keynes,5,972,5,QCM,0.49,0.65,55.72,44,35,79,75,44,31,1.05,58.67,Moyen,Moyen,0,Meme Difficulté,Pas Adapte,Sociology
5467,2019,Sociologie,1,Les Differentes Approches de l'Economie,5,La Pensee Economique de Keynes,5,972,5,QCM,0.1,0.73,93.97,83,5,88,85,83,2,1.04,97.65,Facile,Facile,0,Meme Difficulté,Pas Adapte,Sociology
6591,2020,Sociologie,1,Les Differentes Approches de l'Economie,5,La Pensee Economique de Keynes,5,972,5,QROC,0.09,0.8,85.86,76,13,89,77,76,1,1.16,98.7,Difficile,Facile,2,Beaucoup plus Facile,Pas Adapte,Sociology
972,2015,Sociologie,1,Les Differentes Approches de l'Economie,6,Les Insuffisances d'une Pensee purement Economique,13,973,1,QCM,0.63,0.15,20.68,17,67,84,29,17,12,2.9,58.62,Facile,Difficile,-2,Beaucoup plus Difficile,Pas Adapte,Sociology
2096,2016,Sociologie,1,Les Differentes Approches de l'Economie,6,Les Insuffisances d'une Pensee purement Economique,13,973,1,QCM,0.48,0.58,48.47,43,45,88,81,43,38,1.09,53.09,Facile,Moyen,-1,Plus Difficile,Pas Adapte,Sociology
3220,2017,Sociologie,1,Les Differentes Approches de l'Economie,6,Les Insuffisances d'une Pensee purement Economique,13,973,1,QCM,0.68,0.29,28.48,28,69,97,48,28,20,2.02,58.33,Facile,Difficile,-2,Beaucoup plus Difficile,Pas Adapte,Sociology
4344,2018,Sociologie,1,Les Differentes Approches de l'Economie,6,Les Insuffisances d'une Pensee purement Economique,13,973,1,QCM,0.21,0.39,50.25,55,54,109,91,55,36,1.2,60.44,Moyen,Moyen,0,Meme Difficulté,Pas Adapte,Sociology
5468,2019,Sociologie,1,Les Differentes Approches de l'Economie,6,Les Insuffisances d'une Pensee purement Economique,13,973,1,QCM,0.47,0.68,50.75,47,46,93,70,47,23,1.33,67.14,Moyen,Moyen,0,Meme Difficulté,Pas Adapte,Sociology
6592,2020,Sociologie,1,Les Differentes Approches de l'Economie,6,Les Insuffisances d'une Pensee purement Economique,13,973,1,QCM,0.58,0.18,9.98,10,94,104,27,10,17,3.85,37.04,Moyen,Difficile,-1,Plus Difficile,Pas Adapte,Sociology
973,2015,Sociologie,1,Les Differentes Approches de l'Economie,6,Les Insuffisances d'une Pensee purement Economique,13,974,2,QCU,0.32,0.41,46.43,41,47,88,78,41,37,1.13,52.56,Difficile,Moyen,1,Plus Facile,Pas Adapte,Sociology
2097,2016,Sociologie,1,Les Differentes Approches de l'Economie,6,Les Insuffisances d'une Pensee purement Economique,13,974,2,QCU,0.28,0.61,38.41,29,47,76,76,29,47,1.0,38.16,Difficile,Moyen,1,Plus Facile,Pas Adapte,Sociology
3221,2017,Sociologie,1,Les Differentes Approches de l'Economie,6,Les Insuffisances d'une Pensee purement Economique,13,974,2,QCU,0.73,0.23,3.89,3,81,84,61,3,58,1.38,4.92,Facile,Difficile,-2,Beaucoup plus Difficile,Pas Adapte,Sociology
4345,2018,Sociologie,1,Les Differentes Approches de l'Economie,6,Les Insuffisances d'une Pensee purement Economique,13,974,2,QCU,0.3,0.57,47.52,36,39,75,54,36,18,1.39,66.67,Moyen,Moyen,0,Meme Difficulté,Pas Adapte,Sociology
5469,2019,Sociologie,1,Les Differentes Approches de l'Economie,6,Les Insuffisances d'une Pensee purement Economique,13,974,2,QCU,0.48,0.31,2.06,2,74,76,72,2,70,1.06,2.78,Facile,Difficile,-2,Beaucoup plus Difficile,Pas Adapte,Sociology
6593,2020,Sociologie,1,Les Differentes Approches de l'Economie,6,Les Insuffisances d'une Pensee purement Economique,13,974,2,QCU,0.1,0.75,84.16,72,13,85,81,72,9,1.05,88.89,Difficile,Facile,2,Beaucoup plus Facile,Pas Adapte,Sociology
974,2015,Sociologie,1,Les Differentes Approches de l'Economie,6,Les Insuffisances d'une Pensee purement Economique,13,975,3,QCU,0.59,0.34,15.47,6,34,40,25,6,19,1.6,24.0,Facile,Difficile,-2,Beaucoup plus Difficile,Pas Adapte,Sociology
2098,2016,Sociologie,1,Les Differentes Approches de l'Economie,6,Les Insuffisances d'une Pensee purement Economique,13,975,3,QCU,0.46,0.2,28.91,13,33,46,46,13,33,1.0,28.26,Difficile,Difficile,0,Meme Difficulté,Pas Adapte,Sociology
3222,2017,Sociologie,1,Les Differentes Approches de l'Economie,6,Les Insuffisances d'une Pensee purement Economique,13,975,3,QCU,0.16,0.76,78.16,36,10,46,39,36,3,1.18,92.31,Facile,Facile,0,Meme Difficulté,Pas Adapte,Sociology
4346,2018,Sociologie,1,Les Differentes Approches de l'Economie,6,Les Insuffisances d'une Pensee purement Economique,13,975,3,QCU,0.34,0.74,45.93,19,22,41,37,19,18,1.11,51.35,Moyen,Moyen,0,Meme Difficulté,Pas Adapte,Sociology
5470,2019,Sociologie,1,Les Differentes Approches de l'Economie,6,Les Insuffisances d'une Pensee purement Economique,13,975,3,QCU,0.68,0.31,18.78,7,30,37,26,7,19,1.42,26.92,Difficile,Difficile,0,Meme Difficulté,Pas Adapte,Sociology
6594,2020,Sociologie,1,Les Differentes Approches de l'Economie,6,Les Insuffisances d'une Pensee purement Economique,13,975,3,QCU,0.42,0.29,33.41,13,25,38,15,13,2,2.53,86.67,Difficile,Difficile,0,Meme Difficulté,Pas Adapte,Sociology
975,2015,Sociologie,1,Les Differentes Approches de l'Economie,6,Les Insuffisances d'une Pensee purement Economique,13,976,4,QROC,0.95,0.06,26.31,24,68,92,80,24,56,1.15,30.0,Moyen,Difficile,-1,Plus Difficile,Pas Adapte,Sociology
2099,2016,Sociologie,1,Les Differentes Approches de l'Economie,6,Les Insuffisances d'une Pensee purement Economique,13,976,4,QROC,0.17,0.8,83.33,72,14,86,85,72,13,1.01,84.71,Facile,Facile,0,Meme Difficulté,Pas Adapte,Sociology
3223,2017,Sociologie,1,Les Differentes Approches de l'Economie,6,Les Insuffisances d'une Pensee purement Economique,13,976,4,QROC,0.97,0.07,21.51,17,62,79,66,17,49,1.2,25.76,Moyen,Difficile,-1,Plus Difficile,Pas Adapte,Sociology
4347,2018,Sociologie,1,Les Differentes Approches de l'Economie,6,Les Insuffisances d'une Pensee purement Economique,13,976,4,QROC,0.2,0.27,54.61,43,35,78,57,43,14,1.37,75.44,Facile,Moyen,-1,Plus Difficile,Pas Adapte,Sociology
5471,2019,Sociologie,1,Les Differentes Approches de l'Economie,6,Les Insuffisances d'une Pensee purement Economique,13,976,4,QROC,0.76,0.03,33.54,26,53,79,72,26,46,1.1,36.11,Difficile,Difficile,0,Meme Difficulté,Pas Adapte,Sociology
6595,2020,Sociologie,1,Les Differentes Approches de l'Economie,6,Les Insuffisances d'une Pensee purement Economique,13,976,4,QROC,0.29,0.34,42.53,36,48,84,53,36,17,1.58,67.92,Moyen,Moyen,0,Meme Difficulté,Pas Adapte,Sociology
976,2015,Sociologie,1,Les Differentes Approches de l'Economie,6,Les Insuffisances d'une Pensee purement Economique,13,977,5,QCU,0.29,0.4,40.88,26,37,63,39,26,13,1.62,66.67,Difficile,Moyen,1,Plus Facile,Pas Adapte,Sociology
2100,2016,Sociologie,1,Les Differentes Approches de l'Economie,6,Les Insuffisances d'une Pensee purement Economique,13,977,5,QCU,0.74,0.23,20.46,15,56,71,45,15,30,1.58,33.33,Difficile,Difficile,0,Meme Difficulté,Pas Adapte,Sociology
3224,2017,Sociologie,1,Les Differentes Approches de l'Economie,6,Les Insuffisances d'une Pensee purement Economique,13,977,5,QCU,0.47,0.23,23.27,17,57,74,68,17,51,1.09,25.0,Moyen,Difficile,-1,Plus Difficile,Pas Adapte,Sociology
4348,2018,Sociologie,1,Les Differentes Approches de l'Economie,6,Les Insuffisances d'une Pensee purement Economique,13,977,5,QCU,0.51,0.21,8.04,6,69,75,67,6,61,1.12,8.96,Difficile,Difficile,0,Meme Difficulté,Pas Adapte,Sociology
5472,2019,Sociologie,1,Les Differentes Approches de l'Economie,6,Les Insuffisances d'une Pensee purement Economique,13,977,5,QCU,0.28,0.51,49.84,40,40,80,47,40,7,1.7,85.11,Facile,Moyen,-1,Plus Difficile,Pas Adapte,Sociology
6596,2020,Sociologie,1,Les Differentes Approches de l'Economie,6,Les Insuffisances d'une Pensee purement Economique,13,977,5,QCU,0.06,0.92,82.03,64,14,78,78,64,14,1.0,82.05,Difficile,Facile,2,Beaucoup plus Facile,Pas Adapte,Sociology
977,2015,Sociologie,1,Les Differentes Approches de l'Economie,6,Les Insuffisances d'une Pensee purement Economique,13,978,6,QROC,0.66,0.05,4.36,3,76,79,63,3,60,1.25,4.76,Difficile,Difficile,0,Meme Difficulté,Pas Adapte,Sociology
2101,2016,Sociologie,1,Les Differentes Approches de l'Economie,6,Les Insuffisances d'une Pensee purement Economique,13,978,6,QROC,0.35,0.27,44.73,30,37,67,35,30,5,1.91,85.71,Difficile,Moyen,1,Plus Facile,Pas Adapte,Sociology
3225,2017,Sociologie,1,Les Differentes Approches de l'Economie,6,Les Insuffisances d'une Pensee purement Economique,13,978,6,QROC,0.41,0.39,60.9,38,24,62,52,38,14,1.19,73.08,Moyen,Moyen,0,Meme Difficulté,Adapte,Sociology
4349,2018,Sociologie,1,Les Differentes Approches de l'Economie,6,Les Insuffisances d'une Pensee purement Economique,13,978,6,QROC,0.2,0.39,60.9,41,26,67,51,41,10,1.31,80.39,Moyen,Moyen,0,Meme Difficulté,Adapte,Sociology
5473,2019,Sociologie,1,Les Differentes Approches de l'Economie,6,Les Insuffisances d'une Pensee purement Economique,13,978,6,QO,0.48,0.22,60.9,35,22,57,47,35,12,1.21,74.47,Moyen,Moyen,0,Meme Difficulté,Adapte,Sociology
6597,2020,Sociologie,1,Les Differentes Approches de l'Economie,6,Les Insuffisances d'une Pensee purement Economique,13,978,6,QO,0.63,0.28,60.9,30,19,49,46,30,16,1.07,65.22,Moyen,Moyen,0,Meme Difficulté,Adapte,Sociology
978,2015,Sociologie,1,Les Differentes Approches de l'Economie,6,Les Insuffisances d'une Pensee purement Economique,13,979,7,QCM,0.36,0.4,40.12,8,11,19,17,8,9,1.12,47.06,Facile,Moyen,-1,Plus Difficile,Pas Adapte,Sociology
2102,2016,Sociologie,1,Les Differentes Approches de l'Economie,6,Les Insuffisances d'une Pensee purement Economique,13,979,7,QCM,0.37,0.45,36.35,6,10,16,10,6,4,1.6,60.0,Moyen,Moyen,0,Meme Difficulté,Pas Adapte,Sociology
3226,2017,Sociologie,1,Les Differentes Approches de l'Economie,6,Les Insuffisances d'une Pensee purement Economique,13,979,7,QCM,0.4,0.64,46.02,6,8,14,11,6,5,1.27,54.55,Facile,Moyen,-1,Plus Difficile,Pas Adapte,Sociology
4350,2018,Sociologie,1,Les Differentes Approches de l'Economie,6,Les Insuffisances d'une Pensee purement Economique,13,979,7,QCM,0.65,0.24,29.35,5,11,16,7,5,2,2.29,71.43,Facile,Difficile,-2,Beaucoup plus Difficile,Pas Adapte,Sociology
5474,2019,Sociologie,1,Les Differentes Approches de l'Economie,6,Les Insuffisances d'une Pensee purement Economique,13,979,7,QCM,0.64,0.24,10.7,2,14,16,15,2,13,1.07,13.33,Moyen,Difficile,-1,Plus Difficile,Pas Adapte,Sociology
6598,2020,Sociologie,1,Les Differentes Approches de l'Economie,6,Les Insuffisances d'une Pensee purement Economique,13,979,7,QROC,0.07,0.97,88.17,15,2,17,15,15,0,1.13,100.0,Facile,Facile,0,Meme Difficulté,Pas Adapte,Sociology
979,2015,Sociologie,1,Les Differentes Approches de l'Economie,6,Les Insuffisances d'une Pensee purement Economique,13,980,8,QCU,0.48,0.29,3.36,1,35,36,34,1,33,1.06,2.94,Moyen,Difficile,-1,Plus Difficile,Pas Adapte,Sociology
2103,2016,Sociologie,1,Les Differentes Approches de l'Economie,6,Les Insuffisances d'une Pensee purement Economique,13,980,8,QCU,0.53,0.22,15.59,6,30,36,34,6,28,1.06,17.65,Moyen,Difficile,-1,Plus Difficile,Pas Adapte,Sociology
3227,2017,Sociologie,1,Les Differentes Approches de l'Economie,6,Les Insuffisances d'une Pensee purement Economique,13,980,8,QCU,0.31,0.53,58.5,19,13,32,22,19,3,1.45,86.36,Facile,Moyen,-1,Plus Difficile,Pas Adapte,Sociology
4351,2018,Sociologie,1,Les Differentes Approches de l'Economie,6,Les Insuffisances d'une Pensee purement Economique,13,980,8,QCU,0.58,0.26,2.2,1,31,32,28,1,27,1.14,3.57,Moyen,Difficile,-1,Plus Difficile,Pas Adapte,Sociology
5475,2019,Sociologie,1,Les Differentes Approches de l'Economie,6,Les Insuffisances d'une Pensee purement Economique,13,980,8,QCU,0.23,0.71,44.02,16,20,36,23,16,7,1.57,69.57,Facile,Moyen,-1,Plus Difficile,Pas Adapte,Sociology
6599,2020,Sociologie,1,Les Differentes Approches de l'Economie,6,Les Insuffisances d'une Pensee purement Economique,13,980,8,QCU,0.47,0.39,0.73,0,34,34,14,0,14,2.43,0.0,Facile,Difficile,-2,Beaucoup plus Difficile,Pas Adapte,Sociology
980,2015,Sociologie,1,Les Differentes Approches de l'Economie,6,Les Insuffisances d'une Pensee purement Economique,13,981,9,QCM,0.54,0.3,16.85,2,11,13,10,2,8,1.3,20.0,Moyen,Difficile,-1,Plus Difficile,Pas Adapte,Sociology
2104,2016,Sociologie,1,Les Differentes Approches de l'Economie,6,Les Insuffisances d'une Pensee purement Economique,13,981,9,QCM,0.42,0.56,56.36,6,5,11,7,6,1,1.57,85.71,Difficile,Moyen,1,Plus Facile,Pas Adapte,Sociology
3228,2017,Sociologie,1,Les Differentes Approches de l'Economie,6,Les Insuffisances d'une Pensee purement Economique,13,981,9,QCM,0.2,0.46,54.98,7,6,13,8,7,1,1.62,87.5,Moyen,Moyen,0,Meme Difficulté,Pas Adapte,Sociology
4352,2018,Sociologie,1,Les Differentes Approches de l'Economie,6,Les Insuffisances d'une Pensee purement Economique,13,981,9,QCM,0.26,0.48,64.79,8,5,13,12,8,4,1.08,66.67,Difficile,Moyen,1,Plus Facile,Adapte,Sociology
5476,2019,Sociologie,1,Les Differentes Approches de l'Economie,6,Les Insuffisances d'une Pensee purement Economique,13,981,9,QCM,0.38,0.31,64.79,8,5,13,11,8,3,1.18,72.73,Moyen,Moyen,0,Meme Difficulté,Adapte,Sociology
6600,2020,Sociologie,1,Les Differentes Approches de l'Economie,6,Les Insuffisances d'une Pensee purement Economique,13,981,9,QCM,0.44,0.67,64.79,8,5,13,12,8,4,1.08,66.67,Moyen,Moyen,0,Meme Difficulté,Adapte,Sociology
981,2015,Sociologie,1,Les Differentes Approches de l'Economie,6,Les Insuffisances d'une Pensee purement Economique,13,982,10,QCU,0.5,0.33,32.1,19,39,58,26,19,7,2.23,73.08,Facile,Difficile,-2,Beaucoup plus Difficile,Pas Adapte,Sociology
2105,2016,Sociologie,1,Les Differentes Approches de l'Economie,6,Les Insuffisances d'une Pensee purement Economique,13,982,10,QCM,0.38,0.32,62.61,39,24,63,48,39,9,1.31,81.25,Moyen,Moyen,0,Meme Difficulté,Adapte,Sociology
3229,2017,Sociologie,1,Les Differentes Approches de l'Economie,6,Les Insuffisances d'une Pensee purement Economique,13,982,10,QCM,0.5,0.63,62.61,38,22,60,40,38,2,1.5,95.0,Moyen,Moyen,0,Meme Difficulté,Adapte,Sociology
4353,2018,Sociologie,1,Les Differentes Approches de l'Economie,6,Les Insuffisances d'une Pensee purement Economique,13,982,10,QCM,0.46,0.5,62.61,38,22,60,45,38,7,1.33,84.44,Moyen,Moyen,0,Meme Difficulté,Adapte,Sociology
5477,2019,Sociologie,1,Les Differentes Approches de l'Economie,6,Les Insuffisances d'une Pensee purement Economique,13,982,10,QCM,0.29,0.54,62.61,34,21,55,53,34,19,1.04,64.15,Moyen,Moyen,0,Meme Difficulté,Adapte,Sociology
6601,2020,Sociologie,1,Les Differentes Approches de l'Economie,6,Les Insuffisances d'une Pensee purement Economique,13,982,10,QCM,0.44,0.38,62.61,38,22,60,41,38,3,1.46,92.68,Moyen,Moyen,0,Meme Difficulté,Adapte,Sociology
982,2015,Sociologie,1,Les Differentes Approches de l'Economie,6,Les Insuffisances d'une Pensee purement Economique,13,983,11,QROC,0.31,0.36,44.8,31,39,70,52,31,21,1.35,59.62,Facile,Moyen,-1,Plus Difficile,Pas Adapte,Sociology
2106,2016,Sociologie,1,Les Differentes Approches de l'Economie,6,Les Insuffisances d'une Pensee purement Economique,13,983,11,QROC,0.04,0.69,92.63,68,5,73,70,68,2,1.04,97.14,Difficile,Facile,2,Beaucoup plus Facile,Pas Adapte,Sociology
3230,2017,Sociologie,1,Les Differentes Approches de l'Economie,6,Les Insuffisances d'une Pensee purement Economique,13,983,11,QROC,0.44,0.29,51.58,36,34,70,55,36,19,1.27,65.45,Facile,Moyen,-1,Plus Difficile,Pas Adapte,Sociology
4354,2018,Sociologie,1,Les Differentes Approches de l'Economie,6,Les Insuffisances d'une Pensee purement Economique,13,983,11,QROC,0.15,0.95,84.77,65,12,77,72,65,7,1.07,90.28,Facile,Facile,0,Meme Difficulté,Pas Adapte,Sociology
5478,2019,Sociologie,1,Les Differentes Approches de l'Economie,6,Les Insuffisances d'une Pensee purement Economique,13,983,11,QROC,0.0,0.7,82.1,64,14,78,76,64,12,1.03,84.21,Facile,Facile,0,Meme Difficulté,Pas Adapte,Sociology
6602,2020,Sociologie,1,Les Differentes Approches de l'Economie,6,Les Insuffisances d'une Pensee purement Economique,13,983,11,QROC,0.57,0.37,44.8,40,50,90,47,40,7,1.91,85.11,Difficile,Moyen,1,Plus Facile,Pas Adapte,Sociology
983,2015,Sociologie,1,Les Differentes Approches de l'Economie,6,Les Insuffisances d'une Pensee purement Economique,13,984,12,QCU,0.35,0.71,42.77,9,11,20,17,9,8,1.18,52.94,Moyen,Moyen,0,Meme Difficulté,Pas Adapte,Sociology
2107,2016,Sociologie,1,Les Differentes Approches de l'Economie,6,Les Insuffisances d'une Pensee purement Economique,13,984,12,QCU,0.16,0.97,65.77,12,7,19,17,12,5,1.12,70.59,Difficile,Facile,2,Beaucoup plus Facile,Adapte,Sociology
3231,2017,Sociologie,1,Les Differentes Approches de l'Economie,6,Les Insuffisances d'une Pensee purement Economique,13,984,12,QCM,0.05,0.82,65.77,12,6,18,15,12,3,1.2,80.0,Facile,Facile,0,Meme Difficulté,Adapte,Sociology
4355,2018,Sociologie,1,Les Differentes Approches de l'Economie,6,Les Insuffisances d'une Pensee purement Economique,13,984,12,QCM,0.11,1.0,65.77,11,5,16,16,11,5,1.0,68.75,Facile,Facile,0,Meme Difficulté,Adapte,Sociology
5479,2019,Sociologie,1,Les Differentes Approches de l'Economie,6,Les Insuffisances d'une Pensee purement Economique,13,984,12,QCM,0.09,0.73,65.77,12,6,18,14,12,2,1.29,85.71,Facile,Facile,0,Meme Difficulté,Adapte,Sociology
6603,2020,Sociologie,1,Les Differentes Approches de l'Economie,6,Les Insuffisances d'une Pensee purement Economique,13,984,12,QROC,0.03,0.66,65.77,11,5,16,15,11,4,1.07,73.33,Facile,Facile,0,Meme Difficulté,Adapte,Sociology
984,2015,Sociologie,1,Les Differentes Approches de l'Economie,6,Les Insuffisances d'une Pensee purement Economique,13,985,13,QCU,0.08,0.88,96.0,10,0,10,10,10,0,1.0,100.0,Difficile,Facile,2,Beaucoup plus Facile,Pas Adapte,Sociology
2108,2016,Sociologie,1,Les Differentes Approches de l'Economie,6,Les Insuffisances d'une Pensee purement Economique,13,985,13,QCU,0.6,0.26,8.06,1,7,8,6,1,5,1.33,16.67,Difficile,Difficile,0,Meme Difficulté,Pas Adapte,Sociology
3232,2017,Sociologie,1,Les Differentes Approches de l'Economie,6,Les Insuffisances d'une Pensee purement Economique,13,985,13,QCU,0.19,0.86,99.35,7,0,7,7,7,0,1.0,100.0,Moyen,Facile,1,Plus Facile,Pas Adapte,Sociology
4356,2018,Sociologie,1,Les Differentes Approches de l'Economie,6,Les Insuffisances d'une Pensee purement Economique,13,985,13,QCU,0.52,0.27,33.25,2,5,7,4,2,2,1.75,50.0,Moyen,Difficile,-1,Plus Difficile,Pas Adapte,Sociology
5480,2019,Sociologie,1,Les Differentes Approches de l'Economie,6,Les Insuffisances d'une Pensee purement Economique,13,985,13,QCU,0.31,0.4,37.98,2,4,6,6,2,4,1.0,33.33,Moyen,Moyen,0,Meme Difficulté,Pas Adapte,Sociology
6604,2020,Sociologie,1,Les Differentes Approches de l'Economie,6,Les Insuffisances d'une Pensee purement Economique,13,985,13,QCU,0.16,0.87,70.02,4,1,5,5,4,1,1.0,80.0,Difficile,Facile,2,Beaucoup plus Facile,Adapte,Sociology
985,2015,Sociologie,2,Histoire de la Pensee Economique,1,Introduction,4,986,1,QCU,0.23,0.65,37.51,14,22,36,20,14,6,1.8,70.0,Facile,Moyen,-1,Plus Difficile,Pas Adapte,Sociology
2109,2016,Sociologie,2,Histoire de la Pensee Economique,1,Introduction,4,986,1,QCU,0.57,0.21,26.29,11,30,41,20,11,9,2.05,55.0,Difficile,Difficile,0,Meme Difficulté,Pas Adapte,Sociology
3233,2017,Sociologie,2,Histoire de la Pensee Economique,1,Introduction,4,986,1,QCU,0.18,0.86,84.61,31,6,37,32,31,1,1.16,96.88,Facile,Facile,0,Meme Difficulté,Pas Adapte,Sociology
4357,2018,Sociologie,2,Histoire de la Pensee Economique,1,Introduction,4,986,1,QCU,0.42,0.26,27.67,9,25,34,13,9,4,2.62,69.23,Facile,Difficile,-2,Beaucoup plus Difficile,Pas Adapte,Sociology
5481,2019,Sociologie,2,Histoire de la Pensee Economique,1,Introduction,4,986,1,QCM,0.12,0.75,79.07,28,8,36,32,28,4,1.12,87.5,Moyen,Facile,1,Plus Facile,Pas Adapte,Sociology
6605,2020,Sociologie,2,Histoire de la Pensee Economique,1,Introduction,4,986,1,QCM,0.14,0.87,79.68,25,6,31,31,25,6,1.0,80.65,Moyen,Facile,1,Plus Facile,Pas Adapte,Sociology
986,2015,Sociologie,2,Histoire de la Pensee Economique,1,Introduction,4,987,2,QCM,0.06,0.99,84.84,76,14,90,90,76,14,1.0,84.44,Facile,Facile,0,Meme Difficulté,Pas Adapte,Sociology
2110,2016,Sociologie,2,Histoire de la Pensee Economique,1,Introduction,4,987,2,QCM,0.73,0.2,27.81,27,70,97,28,27,1,3.46,96.43,Moyen,Difficile,-1,Plus Difficile,Pas Adapte,Sociology
3234,2017,Sociologie,2,Histoire de la Pensee Economique,1,Introduction,4,987,2,QCM,0.03,0.88,70.91,68,28,96,90,68,22,1.07,75.56,Moyen,Facile,1,Plus Facile,Adapte,Sociology
4358,2018,Sociologie,2,Histoire de la Pensee Economique,1,Introduction,4,987,2,QCM,0.11,0.8,70.91,71,29,100,94,71,23,1.06,75.53,Facile,Facile,0,Meme Difficulté,Adapte,Sociology
5482,2019,Sociologie,2,Histoire de la Pensee Economique,1,Introduction,4,987,2,QCM,0.13,0.86,70.91,69,28,97,84,69,15,1.15,82.14,Facile,Facile,0,Meme Difficulté,Adapte,Sociology
6606,2020,Sociologie,2,Histoire de la Pensee Economique,1,Introduction,4,987,2,QCM,0.11,0.93,70.91,58,24,82,76,58,18,1.08,76.32,Facile,Facile,0,Meme Difficulté,Adapte,Sociology
987,2015,Sociologie,2,Histoire de la Pensee Economique,1,Introduction,4,988,3,QCM,0.68,0.29,15.98,2,12,14,11,2,9,1.27,18.18,Facile,Difficile,-2,Beaucoup plus Difficile,Pas Adapte,Sociology
2111,2016,Sociologie,2,Histoire de la Pensee Economique,1,Introduction,4,988,3,QCM,0.52,0.26,1.72,0,16,16,6,0,6,2.67,0.0,Facile,Difficile,-2,Beaucoup plus Difficile,Pas Adapte,Sociology
3235,2017,Sociologie,2,Histoire de la Pensee Economique,1,Introduction,4,988,3,QCM,0.3,0.67,51.58,7,7,14,14,7,7,1.0,50.0,Facile,Moyen,-1,Plus Difficile,Pas Adapte,Sociology
4359,2018,Sociologie,2,Histoire de la Pensee Economique,1,Introduction,4,988,3,QCM,0.71,0.26,7.88,1,12,13,5,1,4,2.6,20.0,Difficile,Difficile,0,Meme Difficulté,Pas Adapte,Sociology
5483,2019,Sociologie,2,Histoire de la Pensee Economique,1,Introduction,4,988,3,QCM,0.48,0.61,50.5,7,6,13,8,7,1,1.62,87.5,Difficile,Moyen,1,Plus Facile,Pas Adapte,Sociology
6607,2020,Sociologie,2,Histoire de la Pensee Economique,1,Introduction,4,988,3,QCM,0.43,0.41,52.16,7,7,14,11,7,4,1.27,63.64,Facile,Moyen,-1,Plus Difficile,Pas Adapte,Sociology
988,2015,Sociologie,2,Histoire de la Pensee Economique,1,Introduction,4,989,4,QCM,0.03,0.72,98.54,97,1,98,98,97,1,1.0,98.98,Difficile,Facile,2,Beaucoup plus Facile,Pas Adapte,Sociology
2112,2016,Sociologie,2,Histoire de la Pensee Economique,1,Introduction,4,989,4,QCM,0.63,0.24,1.57,1,87,88,87,1,86,1.01,1.15,Moyen,Difficile,-1,Plus Difficile,Pas Adapte,Sociology
3236,2017,Sociologie,2,Histoire de la Pensee Economique,1,Introduction,4,989,4,QCU,0.08,0.86,69.09,58,26,84,71,58,13,1.18,81.69,Difficile,Facile,2,Beaucoup plus Facile,Adapte,Sociology
4360,2018,Sociologie,2,Histoire de la Pensee Economique,1,Introduction,4,989,4,QCM,0.06,0.88,69.09,64,28,92,68,64,4,1.35,94.12,Facile,Facile,0,Meme Difficulté,Adapte,Sociology
5484,2019,Sociologie,2,Histoire de la Pensee Economique,1,Introduction,4,989,4,QCM,0.14,0.87,69.09,73,32,105,94,73,21,1.12,77.66,Facile,Facile,0,Meme Difficulté,Adapte,Sociology
6608,2020,Sociologie,2,Histoire de la Pensee Economique,1,Introduction,4,989,4,QCM,0.15,0.9,69.09,77,35,112,83,77,6,1.35,92.77,Facile,Facile,0,Meme Difficulté,Adapte,Sociology
989,2015,Sociologie,2,Histoire de la Pensee Economique,2,La Formation de la Pensee Economique jusqu'a Adam Smith,10,990,1,QCU,0.57,0.29,7.84,8,90,98,81,8,73,1.21,9.88,Facile,Difficile,-2,Beaucoup plus Difficile,Pas Adapte,Sociology
2113,2016,Sociologie,2,Histoire de la Pensee Economique,2,La Formation de la Pensee Economique jusqu'a Adam Smith,10,990,1,QCU,0.56,0.3,8.39,9,93,102,38,9,29,2.68,23.68,Difficile,Difficile,0,Meme Difficulté,Pas Adapte,Sociology
3237,2017,Sociologie,2,Histoire de la Pensee Economique,2,La Formation de la Pensee Economique jusqu'a Adam Smith,10,990,1,QCU,0.2,0.75,88.06,89,12,101,96,89,7,1.05,92.71,Moyen,Facile,1,Plus Facile,Pas Adapte,Sociology
4361,2018,Sociologie,2,Histoire de la Pensee Economique,2,La Formation de la Pensee Economique jusqu'a Adam Smith,10,990,1,QCU,0.49,0.2,20.49,20,79,99,49,20,29,2.02,40.82,Moyen,Difficile,-1,Plus Difficile,Pas Adapte,Sociology
5485,2019,Sociologie,2,Histoire de la Pensee Economique,2,La Formation de la Pensee Economique jusqu'a Adam Smith,10,990,1,QCU,0.06,0.95,69.62,61,26,87,64,61,3,1.36,95.31,Moyen,Facile,1,Plus Facile,Adapte,Sociology
6609,2020,Sociologie,2,Histoire de la Pensee Economique,2,La Formation de la Pensee Economique jusqu'a Adam Smith,10,990,1,QCU,0.04,0.82,69.62,54,24,78,75,54,21,1.04,72.0,Facile,Facile,0,Meme Difficulté,Adapte,Sociology
990,2015,Sociologie,2,Histoire de la Pensee Economique,2,La Formation de la Pensee Economique jusqu'a Adam Smith,10,991,2,QROC,0.58,0.32,60.08,25,16,41,41,25,16,1.0,60.98,Facile,Moyen,-1,Plus Difficile,Adapte,Sociology
2114,2016,Sociologie,2,Histoire de la Pensee Economique,2,La Formation de la Pensee Economique jusqu'a Adam Smith,10,991,2,QROC,0.23,0.33,60.08,22,14,36,34,22,12,1.06,64.71,Moyen,Moyen,0,Meme Difficulté,Adapte,Sociology
3238,2017,Sociologie,2,Histoire de la Pensee Economique,2,La Formation de la Pensee Economique jusqu'a Adam Smith,10,991,2,QROC,0.32,0.39,60.08,24,16,40,30,24,6,1.33,80.0,Moyen,Moyen,0,Meme Difficulté,Adapte,Sociology
4362,2018,Sociologie,2,Histoire de la Pensee Economique,2,La Formation de la Pensee Economique jusqu'a Adam Smith,10,991,2,QROC,0.36,0.37,60.08,24,16,40,36,24,12,1.11,66.67,Moyen,Moyen,0,Meme Difficulté,Adapte,Sociology
5486,2019,Sociologie,2,Histoire de la Pensee Economique,2,La Formation de la Pensee Economique jusqu'a Adam Smith,10,991,2,QROC,0.33,0.34,60.08,22,14,36,25,22,3,1.44,88.0,Moyen,Moyen,0,Meme Difficulté,Adapte,Sociology
6610,2020,Sociologie,2,Histoire de la Pensee Economique,2,La Formation de la Pensee Economique jusqu'a Adam Smith,10,991,2,QROC,0.51,0.25,60.08,22,14,36,28,22,6,1.29,78.57,Moyen,Moyen,0,Meme Difficulté,Adapte,Sociology
991,2015,Sociologie,2,Histoire de la Pensee Economique,2,La Formation de la Pensee Economique jusqu'a Adam Smith,10,992,3,QROC,0.09,0.52,81.58,56,13,69,62,56,6,1.11,90.32,Moyen,Facile,1,Plus Facile,Pas Adapte,Sociology
2115,2016,Sociologie,2,Histoire de la Pensee Economique,2,La Formation de la Pensee Economique jusqu'a Adam Smith,10,992,3,QROC,0.68,0.22,4.9,3,65,68,51,3,48,1.33,5.88,Difficile,Difficile,0,Meme Difficulté,Pas Adapte,Sociology
3239,2017,Sociologie,2,Histoire de la Pensee Economique,2,La Formation de la Pensee Economique jusqu'a Adam Smith,10,992,3,QROC,0.94,0.02,28.36,17,43,60,52,17,35,1.15,32.69,Difficile,Difficile,0,Meme Difficulté,Pas Adapte,Sociology
4363,2018,Sociologie,2,Histoire de la Pensee Economique,2,La Formation de la Pensee Economique jusqu'a Adam Smith,10,992,3,QO,0.08,0.53,79.6,49,12,61,60,49,11,1.02,81.67,Difficile,Facile,2,Beaucoup plus Facile,Pas Adapte,Sociology
5487,2019,Sociologie,2,Histoire de la Pensee Economique,2,La Formation de la Pensee Economique jusqu'a Adam Smith,10,992,3,QO,0.16,0.61,77.44,46,14,60,58,46,12,1.03,79.31,Difficile,Facile,2,Beaucoup plus Facile,Pas Adapte,Sociology
6611,2020,Sociologie,2,Histoire de la Pensee Economique,2,La Formation de la Pensee Economique jusqu'a Adam Smith,10,992,3,QO,0.1,0.99,85.47,49,8,57,53,49,4,1.08,92.45,Moyen,Facile,1,Plus Facile,Pas Adapte,Sociology
992,2015,Sociologie,2,Histoire de la Pensee Economique,2,La Formation de la Pensee Economique jusqu'a Adam Smith,10,993,4,QCU,0.02,0.75,67.34,58,28,86,66,58,8,1.3,87.88,Moyen,Facile,1,Plus Facile,Adapte,Sociology
2116,2016,Sociologie,2,Histoire de la Pensee Economique,2,La Formation de la Pensee Economique jusqu'a Adam Smith,10,993,4,QCM,0.1,0.86,67.34,61,30,91,63,61,2,1.44,96.83,Facile,Facile,0,Meme Difficulté,Adapte,Sociology
3240,2017,Sociologie,2,Histoire de la Pensee Economique,2,La Formation de la Pensee Economique jusqu'a Adam Smith,10,993,4,QCM,0.11,0.71,67.34,69,34,103,91,69,22,1.13,75.82,Facile,Facile,0,Meme Difficulté,Adapte,Sociology
4364,2018,Sociologie,2,Histoire de la Pensee Economique,2,La Formation de la Pensee Economique jusqu'a Adam Smith,10,993,4,QCM,0.11,0.83,67.34,72,35,107,74,72,2,1.45,97.3,Facile,Facile,0,Meme Difficulté,Adapte,Sociology
5488,2019,Sociologie,2,Histoire de la Pensee Economique,2,La Formation de la Pensee Economique jusqu'a Adam Smith,10,993,4,QCU,0.19,0.99,67.34,67,32,99,73,67,6,1.36,91.78,Facile,Facile,0,Meme Difficulté,Adapte,Sociology
6612,2020,Sociologie,2,Histoire de la Pensee Economique,2,La Formation de la Pensee Economique jusqu'a Adam Smith,10,993,4,QCU,0.0,0.78,67.34,63,31,94,90,63,27,1.04,70.0,Facile,Facile,0,Meme Difficulté,Adapte,Sociology
993,2015,Sociologie,2,Histoire de la Pensee Economique,2,La Formation de la Pensee Economique jusqu'a Adam Smith,10,994,5,QCU,0.42,0.27,28.64,2,6,8,7,2,5,1.14,28.57,Difficile,Difficile,0,Meme Difficulté,Pas Adapte,Sociology
2117,2016,Sociologie,2,Histoire de la Pensee Economique,2,La Formation de la Pensee Economique jusqu'a Adam Smith,10,994,5,QCU,0.15,0.88,85.33,8,1,9,8,8,0,1.12,100.0,Moyen,Facile,1,Plus Facile,Pas Adapte,Sociology
3241,2017,Sociologie,2,Histoire de la Pensee Economique,2,La Formation de la Pensee Economique jusqu'a Adam Smith,10,994,5,QCU,0.31,0.71,47.78,4,4,8,6,4,2,1.33,66.67,Moyen,Moyen,0,Meme Difficulté,Pas Adapte,Sociology
4365,2018,Sociologie,2,Histoire de la Pensee Economique,2,La Formation de la Pensee Economique jusqu'a Adam Smith,10,994,5,QCU,0.12,0.95,95.82,8,0,8,8,8,0,1.0,100.0,Difficile,Facile,2,Beaucoup plus Facile,Pas Adapte,Sociology
5489,2019,Sociologie,2,Histoire de la Pensee Economique,2,La Formation de la Pensee Economique jusqu'a Adam Smith,10,994,5,QCM,0.3,0.68,45.59,3,4,7,5,3,2,1.4,60.0,Difficile,Moyen,1,Plus Facile,Pas Adapte,Sociology
6613,2020,Sociologie,2,Histoire de la Pensee Economique,2,La Formation de la Pensee Economique jusqu'a Adam Smith,10,994,5,QCM,0.79,0.24,8.81,1,5,6,5,1,4,1.2,20.0,Facile,Difficile,-2,Beaucoup plus Difficile,Pas Adapte,Sociology
994,2015,Sociologie,2,Histoire de la Pensee Economique,2,La Formation de la Pensee Economique jusqu'a Adam Smith,10,995,6,QCU,0.38,0.51,35.2,9,17,26,21,9,12,1.24,42.86,Facile,Moyen,-1,Plus Difficile,Pas Adapte,Sociology
2118,2016,Sociologie,2,Histoire de la Pensee Economique,2,La Formation de la Pensee Economique jusqu'a Adam Smith,10,995,6,QCU,0.04,0.91,72.96,17,6,23,18,17,1,1.28,94.44,Moyen,Facile,1,Plus Facile,Adapte,Sociology
3242,2017,Sociologie,2,Histoire de la Pensee Economique,2,La Formation de la Pensee Economique jusqu'a Adam Smith,10,995,6,QCU,0.09,0.76,72.96,15,5,20,19,15,4,1.05,78.95,Facile,Facile,0,Meme Difficulté,Adapte,Sociology
4366,2018,Sociologie,2,Histoire de la Pensee Economique,2,La Formation de la Pensee Economique jusqu'a Adam Smith,10,995,6,QCU,0.04,0.85,72.96,14,5,19,18,14,4,1.06,77.78,Facile,Facile,0,Meme Difficulté,Adapte,Sociology
5490,2019,Sociologie,2,Histoire de la Pensee Economique,2,La Formation de la Pensee Economique jusqu'a Adam Smith,10,995,6,QCU,0.07,0.96,72.96,15,6,21,19,15,4,1.11,78.95,Facile,Facile,0,Meme Difficulté,Adapte,Sociology
6614,2020,Sociologie,2,Histoire de la Pensee Economique,2,La Formation de la Pensee Economique jusqu'a Adam Smith,10,995,6,QCU,0.09,0.95,72.96,15,5,20,20,15,5,1.0,75.0,Facile,Facile,0,Meme Difficulté,Adapte,Sociology
995,2015,Sociologie,2,Histoire de la Pensee Economique,2,La Formation de la Pensee Economique jusqu'a Adam Smith,10,996,7,QO,0.19,0.82,69.95,38,17,55,52,38,14,1.06,73.08,Difficile,Facile,2,Beaucoup plus Facile,Adapte,Sociology
2119,2016,Sociologie,2,Histoire de la Pensee Economique,2,La Formation de la Pensee Economique jusqu'a Adam Smith,10,996,7,QO,0.03,0.92,69.95,36,15,51,48,36,12,1.06,75.0,Facile,Facile,0,Meme Difficulté,Adapte,Sociology
3243,2017,Sociologie,2,Histoire de la Pensee Economique,2,La Formation de la Pensee Economique jusqu'a Adam Smith,10,996,7,QO,0.1,0.64,69.95,36,16,52,45,36,9,1.16,80.0,Facile,Facile,0,Meme Difficulté,Adapte,Sociology
4367,2018,Sociologie,2,Histoire de la Pensee Economique,2,La Formation de la Pensee Economique jusqu'a Adam Smith,10,996,7,QO,0.15,0.73,69.95,34,14,48,45,34,11,1.07,75.56,Facile,Facile,0,Meme Difficulté,Adapte,Sociology
5491,2019,Sociologie,2,Histoire de la Pensee Economique,2,La Formation de la Pensee Economique jusqu'a Adam Smith,10,996,7,QO,0.04,0.9,69.95,31,14,45,37,31,6,1.22,83.78,Facile,Facile,0,Meme Difficulté,Adapte,Sociology
6615,2020,Sociologie,2,Histoire de la Pensee Economique,2,La Formation de la Pensee Economique jusqu'a Adam Smith,10,996,7,QO,0.1,0.56,69.95,28,12,40,29,28,1,1.38,96.55,Facile,Facile,0,Meme Difficulté,Adapte,Sociology
996,2015,Sociologie,2,Histoire de la Pensee Economique,2,La Formation de la Pensee Economique jusqu'a Adam Smith,10,997,8,QCU,0.18,0.94,94.49,85,5,90,89,85,4,1.01,95.51,Moyen,Facile,1,Plus Facile,Pas Adapte,Sociology
2120,2016,Sociologie,2,Histoire de la Pensee Economique,2,La Formation de la Pensee Economique jusqu'a Adam Smith,10,997,8,QCU,0.06,0.91,81.9,67,15,82,80,67,13,1.02,83.75,Facile,Facile,0,Meme Difficulté,Pas Adapte,Sociology
3244,2017,Sociologie,2,Histoire de la Pensee Economique,2,La Formation de la Pensee Economique jusqu'a Adam Smith,10,997,8,QCU,0.08,0.82,69.29,60,27,87,83,60,23,1.05,72.29,Moyen,Facile,1,Plus Facile,Adapte,Sociology
4368,2018,Sociologie,2,Histoire de la Pensee Economique,2,La Formation de la Pensee Economique jusqu'a Adam Smith,10,997,8,QCU,0.0,0.76,69.29,56,25,81,60,56,4,1.35,93.33,Facile,Facile,0,Meme Difficulté,Adapte,Sociology
5492,2019,Sociologie,2,Histoire de la Pensee Economique,2,La Formation de la Pensee Economique jusqu'a Adam Smith,10,997,8,QCU,0.2,0.98,69.29,63,28,91,90,63,27,1.01,70.0,Facile,Facile,0,Meme Difficulté,Adapte,Sociology
6616,2020,Sociologie,2,Histoire de la Pensee Economique,2,La Formation de la Pensee Economique jusqu'a Adam Smith,10,997,8,QCU,0.16,0.82,69.29,66,29,95,95,66,29,1.0,69.47,Facile,Facile,0,Meme Difficulté,Adapte,Sociology
997,2015,Sociologie,2,Histoire de la Pensee Economique,2,La Formation de la Pensee Economique jusqu'a Adam Smith,10,998,9,QCU,0.41,0.35,1.79,0,22,22,10,0,10,2.2,0.0,Facile,Difficile,-2,Beaucoup plus Difficile,Pas Adapte,Sociology
2121,2016,Sociologie,2,Histoire de la Pensee Economique,2,La Formation de la Pensee Economique jusqu'a Adam Smith,10,998,9,QCU,0.22,0.73,56.9,13,10,23,16,13,3,1.44,81.25,Facile,Moyen,-1,Plus Difficile,Pas Adapte,Sociology
3245,2017,Sociologie,2,Histoire de la Pensee Economique,2,La Formation de la Pensee Economique jusqu'a Adam Smith,10,998,9,QCU,0.59,0.36,31.84,7,14,21,14,7,7,1.5,50.0,Difficile,Difficile,0,Meme Difficulté,Pas Adapte,Sociology
4369,2018,Sociologie,2,Histoire de la Pensee Economique,2,La Formation de la Pensee Economique jusqu'a Adam Smith,10,998,9,QCU,0.33,0.74,59.59,14,9,23,20,14,6,1.15,70.0,Facile,Moyen,-1,Plus Difficile,Pas Adapte,Sociology
5493,2019,Sociologie,2,Histoire de la Pensee Economique,2,La Formation de la Pensee Economique jusqu'a Adam Smith,10,998,9,QCU,0.15,0.87,82.35,21,4,25,24,21,3,1.04,87.5,Moyen,Facile,1,Plus Facile,Pas Adapte,Sociology
6617,2020,Sociologie,2,Histoire de la Pensee Economique,2,La Formation de la Pensee Economique jusqu'a Adam Smith,10,998,9,QCU,0.46,0.21,1.89,0,23,23,9,0,9,2.56,0.0,Moyen,Difficile,-1,Plus Difficile,Pas Adapte,Sociology
998,2015,Sociologie,2,Histoire de la Pensee Economique,2,La Formation de la Pensee Economique jusqu'a Adam Smith,10,999,10,QCU,0.66,0.26,0.02,0,60,60,35,0,35,1.71,0.0,Facile,Difficile,-2,Beaucoup plus Difficile,Pas Adapte,Sociology
2122,2016,Sociologie,2,Histoire de la Pensee Economique,2,La Formation de la Pensee Economique jusqu'a Adam Smith,10,999,10,QCU,0.74,0.33,22.68,15,51,66,44,15,29,1.5,34.09,Facile,Difficile,-2,Beaucoup plus Difficile,Pas Adapte,Sociology
3246,2017,Sociologie,2,Histoire de la Pensee Economique,2,La Formation de la Pensee Economique jusqu'a Adam Smith,10,999,10,QCU,0.23,0.69,46.99,30,33,63,53,30,23,1.19,56.6,Difficile,Moyen,1,Plus Facile,Pas Adapte,Sociology
4370,2018,Sociologie,2,Histoire de la Pensee Economique,2,La Formation de la Pensee Economique jusqu'a Adam Smith,10,999,10,QROC,0.14,0.56,71.64,42,17,59,57,42,15,1.04,73.68,Difficile,Facile,2,Beaucoup plus Facile,Adapte,Sociology
5494,2019,Sociologie,2,Histoire de la Pensee Economique,2,La Formation de la Pensee Economique jusqu'a Adam Smith,10,999,10,QROC,0.01,0.68,71.64,48,19,67,62,48,14,1.08,77.42,Facile,Facile,0,Meme Difficulté,Adapte,Sociology
6618,2020,Sociologie,2,Histoire de la Pensee Economique,2,La Formation de la Pensee Economique jusqu'a Adam Smith,10,999,10,QROC,0.17,0.87,71.64,53,21,74,65,53,12,1.14,81.54,Facile,Facile,0,Meme Difficulté,Adapte,Sociology
999,2015,Sociologie,2,Histoire de la Pensee Economique,3,La Conception Liberale de l'Economie,10,1000,1,QROC,0.73,0.17,18.89,11,49,60,46,11,35,1.3,23.91,Moyen,Difficile,-1,Plus Difficile,Pas Adapte,Sociology
2123,2016,Sociologie,2,Histoire de la Pensee Economique,3,La Conception Liberale de l'Economie,10,1000,1,QROC,0.0,0.41,72.83,47,18,65,59,47,12,1.1,79.66,Facile,Facile,0,Meme Difficulté,Adapte,Sociology
3247,2017,Sociologie,2,Histoire de la Pensee Economique,3,La Conception Liberale de l'Economie,10,1000,1,QROC,0.1,0.43,72.83,47,17,64,55,47,8,1.16,85.45,Facile,Facile,0,Meme Difficulté,Adapte,Sociology
4371,2018,Sociologie,2,Histoire de la Pensee Economique,3,La Conception Liberale de l'Economie,10,1000,1,QCM,0.14,0.71,72.83,53,20,73,56,53,3,1.3,94.64,Facile,Facile,0,Meme Difficulté,Adapte,Sociology
5495,2019,Sociologie,2,Histoire de la Pensee Economique,3,La Conception Liberale de l'Economie,10,1000,1,QCM,0.16,0.99,72.83,55,20,75,58,55,3,1.29,94.83,Facile,Facile,0,Meme Difficulté,Adapte,Sociology
6619,2020,Sociologie,2,Histoire de la Pensee Economique,3,La Conception Liberale de l'Economie,10,1000,1,QCM,0.0,0.81,72.83,55,20,75,61,55,6,1.23,90.16,Facile,Facile,0,Meme Difficulté,Adapte,Sociology
1000,2015,Sociologie,2,Histoire de la Pensee Economique,3,La Conception Liberale de l'Economie,10,1001,2,QCM,0.35,0.44,64.46,33,18,51,36,33,3,1.42,91.67,Difficile,Moyen,1,Plus Facile,Adapte,Sociology
2124,2016,Sociologie,2,Histoire de la Pensee Economique,3,La Conception Liberale de l'Economie,10,1001,2,QCM,0.3,0.54,64.46,38,21,59,51,38,13,1.16,74.51,Moyen,Moyen,0,Meme Difficulté,Adapte,Sociology
3248,2017,Sociologie,2,Histoire de la Pensee Economique,3,La Conception Liberale de l'Economie,10,1001,2,QCU,0.25,0.61,64.46,39,21,60,56,39,17,1.07,69.64,Moyen,Moyen,0,Meme Difficulté,Adapte,Sociology
4372,2018,Sociologie,2,Histoire de la Pensee Economique,3,La Conception Liberale de l'Economie,10,1001,2,QCU,0.32,0.55,64.46,34,19,53,44,34,10,1.2,77.27,Moyen,Moyen,0,Meme Difficulté,Adapte,Sociology
5496,2019,Sociologie,2,Histoire de la Pensee Economique,3,La Conception Liberale de l'Economie,10,1001,2,QO,0.35,0.26,64.46,39,21,60,55,39,16,1.09,70.91,Moyen,Moyen,0,Meme Difficulté,Adapte,Sociology
6620,2020,Sociologie,2,Histoire de la Pensee Economique,3,La Conception Liberale de l'Economie,10,1001,2,QO,0.29,0.16,64.46,33,18,51,47,33,14,1.09,70.21,Moyen,Moyen,0,Meme Difficulté,Adapte,Sociology
1001,2015,Sociologie,2,Histoire de la Pensee Economique,3,La Conception Liberale de l'Economie,10,1002,3,QROC,0.23,0.25,59.54,13,8,21,14,13,1,1.5,92.86,Facile,Moyen,-1,Plus Difficile,Pas Adapte,Sociology
2125,2016,Sociologie,2,Histoire de la Pensee Economique,3,La Conception Liberale de l'Economie,10,1002,3,QROC,0.73,0.12,0.75,0,20,20,16,0,16,1.25,0.0,Difficile,Difficile,0,Meme Difficulté,Pas Adapte,Sociology
3249,2017,Sociologie,2,Histoire de la Pensee Economique,3,La Conception Liberale de l'Economie,10,1002,3,QROC,0.13,0.99,73.37,15,5,20,16,15,1,1.25,93.75,Facile,Facile,0,Meme Difficulté,Adapte,Sociology
4373,2018,Sociologie,2,Histoire de la Pensee Economique,3,La Conception Liberale de l'Economie,10,1002,3,QROC,0.17,0.46,73.37,15,5,20,20,15,5,1.0,75.0,Facile,Facile,0,Meme Difficulté,Adapte,Sociology
5497,2019,Sociologie,2,Histoire de la Pensee Economique,3,La Conception Liberale de l'Economie,10,1002,3,QROC,0.05,0.93,73.37,13,5,18,15,13,2,1.2,86.67,Facile,Facile,0,Meme Difficulté,Adapte,Sociology
6621,2020,Sociologie,2,Histoire de la Pensee Economique,3,La Conception Liberale de l'Economie,10,1002,3,QROC,0.12,0.99,73.37,15,6,21,16,15,1,1.31,93.75,Facile,Facile,0,Meme Difficulté,Adapte,Sociology
1002,2015,Sociologie,2,Histoire de la Pensee Economique,3,La Conception Liberale de l'Economie,10,1003,4,QCM,0.17,0.88,95.3,70,3,73,71,70,1,1.03,98.59,Moyen,Facile,1,Plus Facile,Pas Adapte,Sociology
2126,2016,Sociologie,2,Histoire de la Pensee Economique,3,La Conception Liberale de l'Economie,10,1003,4,QCM,0.24,0.57,54.68,38,31,69,68,38,30,1.01,55.88,Facile,Moyen,-1,Plus Difficile,Pas Adapte,Sociology
3250,2017,Sociologie,2,Histoire de la Pensee Economique,3,La Conception Liberale de l'Economie,10,1003,4,QCM,0.04,0.71,76.59,55,17,72,65,55,10,1.11,84.62,Moyen,Facile,1,Plus Facile,Pas Adapte,Sociology
4374,2018,Sociologie,2,Histoire de la Pensee Economique,3,La Conception Liberale de l'Economie,10,1003,4,QCM,0.17,0.8,86.13,55,9,64,56,55,1,1.14,98.21,Difficile,Facile,2,Beaucoup plus Facile,Pas Adapte,Sociology
5498,2019,Sociologie,2,Histoire de la Pensee Economique,3,La Conception Liberale de l'Economie,10,1003,4,QCM,0.43,0.42,61.74,42,26,68,61,42,19,1.11,68.85,Difficile,Moyen,1,Plus Facile,Adapte,Sociology
6622,2020,Sociologie,2,Histoire de la Pensee Economique,3,La Conception Liberale de l'Economie,10,1003,4,QCM,0.25,0.57,61.74,38,23,61,59,38,21,1.03,64.41,Moyen,Moyen,0,Meme Difficulté,Adapte,Sociology
1003,2015,Sociologie,2,Histoire de la Pensee Economique,3,La Conception Liberale de l'Economie,10,1004,5,QROC,0.86,0.21,30.04,8,18,26,19,8,11,1.37,42.11,Moyen,Difficile,-1,Plus Difficile,Pas Adapte,Sociology
2127,2016,Sociologie,2,Histoire de la Pensee Economique,3,La Conception Liberale de l'Economie,10,1004,5,QROC,0.61,0.21,28.83,8,21,29,29,8,21,1.0,27.59,Difficile,Difficile,0,Meme Difficulté,Pas Adapte,Sociology
3251,2017,Sociologie,2,Histoire de la Pensee Economique,3,La Conception Liberale de l'Economie,10,1004,5,QCM,0.75,0.15,30.47,9,21,30,23,9,14,1.3,39.13,Facile,Difficile,-2,Beaucoup plus Difficile,Pas Adapte,Sociology
4375,2018,Sociologie,2,Histoire de la Pensee Economique,3,La Conception Liberale de l'Economie,10,1004,5,QCM,0.06,0.73,96.83,25,1,26,26,25,1,1.0,96.15,Difficile,Facile,2,Beaucoup plus Facile,Pas Adapte,Sociology
5499,2019,Sociologie,2,Histoire de la Pensee Economique,3,La Conception Liberale de l'Economie,10,1004,5,QCU,0.67,0.33,0.02,0,24,24,9,0,9,2.67,0.0,Facile,Difficile,-2,Beaucoup plus Difficile,Pas Adapte,Sociology
6623,2020,Sociologie,2,Histoire de la Pensee Economique,3,La Conception Liberale de l'Economie,10,1004,5,QCU,0.56,0.24,31.14,8,18,26,14,8,6,1.86,57.14,Moyen,Difficile,-1,Plus Difficile,Pas Adapte,Sociology
1004,2015,Sociologie,2,Histoire de la Pensee Economique,3,La Conception Liberale de l'Economie,10,1005,6,QCM,0.49,0.4,53.15,37,33,70,69,37,32,1.01,53.62,Facile,Moyen,-1,Plus Difficile,Pas Adapte,Sociology
2128,2016,Sociologie,2,Histoire de la Pensee Economique,3,La Conception Liberale de l'Economie,10,1005,6,QCM,0.52,0.26,30.76,22,49,71,42,22,20,1.69,52.38,Moyen,Difficile,-1,Plus Difficile,Pas Adapte,Sociology
3252,2017,Sociologie,2,Histoire de la Pensee Economique,3,La Conception Liberale de l'Economie,10,1005,6,QCM,0.26,0.55,58.47,40,29,69,48,40,8,1.44,83.33,Difficile,Moyen,1,Plus Facile,Pas Adapte,Sociology
4376,2018,Sociologie,2,Histoire de la Pensee Economique,3,La Conception Liberale de l'Economie,10,1005,6,QCM,0.05,0.79,78.41,50,14,64,62,50,12,1.03,80.65,Facile,Facile,0,Meme Difficulté,Pas Adapte,Sociology
5500,2019,Sociologie,2,Histoire de la Pensee Economique,3,La Conception Liberale de l'Economie,10,1005,6,QCU,0.12,0.94,92.8,69,5,74,72,69,3,1.03,95.83,Facile,Facile,0,Meme Difficulté,Pas Adapte,Sociology
6624,2020,Sociologie,2,Histoire de la Pensee Economique,3,La Conception Liberale de l'Economie,10,1005,6,QCU,0.3,0.74,55.79,46,36,82,50,46,4,1.64,92.0,Difficile,Moyen,1,Plus Facile,Pas Adapte,Sociology
1005,2015,Sociologie,2,Histoire de la Pensee Economique,3,La Conception Liberale de l'Economie,10,1006,7,QROC,0.17,0.71,86.91,43,6,49,48,43,5,1.02,89.58,Facile,Facile,0,Meme Difficulté,Pas Adapte,Sociology
2129,2016,Sociologie,2,Histoire de la Pensee Economique,3,La Conception Liberale de l'Economie,10,1006,7,QROC,0.56,0.31,36.6,17,30,47,31,17,14,1.52,54.84,Difficile,Moyen,1,Plus Facile,Pas Adapte,Sociology
3253,2017,Sociologie,2,Histoire de la Pensee Economique,3,La Conception Liberale de l'Economie,10,1006,7,QROC,0.82,0.23,15.78,8,41,49,21,8,13,2.33,38.1,Moyen,Difficile,-1,Plus Difficile,Pas Adapte,Sociology
4377,2018,Sociologie,2,Histoire de la Pensee Economique,3,La Conception Liberale de l'Economie,10,1006,7,QROC,0.64,0.15,15.0,7,38,45,19,7,12,2.37,36.84,Difficile,Difficile,0,Meme Difficulté,Pas Adapte,Sociology
5501,2019,Sociologie,2,Histoire de la Pensee Economique,3,La Conception Liberale de l'Economie,10,1006,7,QROC,0.66,0.22,11.27,6,46,52,28,6,22,1.86,21.43,Facile,Difficile,-2,Beaucoup plus Difficile,Pas Adapte,Sociology
6625,2020,Sociologie,2,Histoire de la Pensee Economique,3,La Conception Liberale de l'Economie,10,1006,7,QROC,0.38,0.31,44.01,26,33,59,56,26,30,1.05,46.43,Moyen,Moyen,0,Meme Difficulté,Pas Adapte,Sociology
1006,2015,Sociologie,2,Histoire de la Pensee Economique,3,La Conception Liberale de l'Economie,10,1007,8,QCU,0.54,0.28,16.65,15,73,88,75,15,60,1.17,20.0,Moyen,Difficile,-1,Plus Difficile,Pas Adapte,Sociology
2130,2016,Sociologie,2,Histoire de la Pensee Economique,3,La Conception Liberale de l'Economie,10,1007,8,QCU,0.62,0.39,23.99,22,68,90,77,22,55,1.17,28.57,Difficile,Difficile,0,Meme Difficulté,Pas Adapte,Sociology
3254,2017,Sociologie,2,Histoire de la Pensee Economique,3,La Conception Liberale de l'Economie,10,1007,8,QCU,0.23,0.67,43.19,35,47,82,46,35,11,1.78,76.09,Facile,Moyen,-1,Plus Difficile,Pas Adapte,Sociology
4378,2018,Sociologie,2,Histoire de la Pensee Economique,3,La Conception Liberale de l'Economie,10,1007,8,QCU,0.58,0.3,0.05,0,93,93,88,0,88,1.06,0.0,Difficile,Difficile,0,Meme Difficulté,Pas Adapte,Sociology
5502,2019,Sociologie,2,Histoire de la Pensee Economique,3,La Conception Liberale de l'Economie,10,1007,8,QROC,0.05,0.79,89.74,92,10,102,102,92,10,1.0,90.2,Moyen,Facile,1,Plus Facile,Pas Adapte,Sociology
6626,2020,Sociologie,2,Histoire de la Pensee Economique,3,La Conception Liberale de l'Economie,10,1007,8,QROC,0.12,0.53,76.33,73,22,95,93,73,20,1.02,78.49,Moyen,Facile,1,Plus Facile,Pas Adapte,Sociology
1007,2015,Sociologie,2,Histoire de la Pensee Economique,3,La Conception Liberale de l'Economie,10,1008,9,QCM,0.18,0.76,80.11,50,12,62,61,50,11,1.02,81.97,Facile,Facile,0,Meme Difficulté,Pas Adapte,Sociology
2131,2016,Sociologie,2,Histoire de la Pensee Economique,3,La Conception Liberale de l'Economie,10,1008,9,QCM,0.3,0.36,47.5,26,28,54,43,26,17,1.26,60.47,Facile,Moyen,-1,Plus Difficile,Pas Adapte,Sociology
3255,2017,Sociologie,2,Histoire de la Pensee Economique,3,La Conception Liberale de l'Economie,10,1008,9,QCM,0.3,0.52,64.36,37,21,58,53,37,16,1.09,69.81,Moyen,Moyen,0,Meme Difficulté,Adapte,Sociology
4379,2018,Sociologie,2,Histoire de la Pensee Economique,3,La Conception Liberale de l'Economie,10,1008,9,QCM,0.22,0.4,64.36,43,24,67,48,43,5,1.4,89.58,Moyen,Moyen,0,Meme Difficulté,Adapte,Sociology
5503,2019,Sociologie,2,Histoire de la Pensee Economique,3,La Conception Liberale de l'Economie,10,1008,9,QCM,0.23,0.52,64.36,41,22,63,51,41,10,1.24,80.39,Moyen,Moyen,0,Meme Difficulté,Adapte,Sociology
6627,2020,Sociologie,2,Histoire de la Pensee Economique,3,La Conception Liberale de l'Economie,10,1008,9,QCM,0.41,0.43,64.36,43,24,67,61,43,18,1.1,70.49,Moyen,Moyen,0,Meme Difficulté,Adapte,Sociology
1008,2015,Sociologie,2,Histoire de la Pensee Economique,3,La Conception Liberale de l'Economie,10,1009,10,QCU,0.02,0.83,65.86,28,14,42,38,28,10,1.11,73.68,Moyen,Facile,1,Plus Facile,Adapte,Sociology
2132,2016,Sociologie,2,Histoire de la Pensee Economique,3,La Conception Liberale de l'Economie,10,1009,10,QCU,0.02,0.96,65.86,30,16,46,43,30,13,1.07,69.77,Facile,Facile,0,Meme Difficulté,Adapte,Sociology
3256,2017,Sociologie,2,Histoire de la Pensee Economique,3,La Conception Liberale de l'Economie,10,1009,10,QCU,0.17,0.98,65.86,26,13,39,38,26,12,1.03,68.42,Facile,Facile,0,Meme Difficulté,Adapte,Sociology
4380,2018,Sociologie,2,Histoire de la Pensee Economique,3,La Conception Liberale de l'Economie,10,1009,10,QCU,0.19,0.83,65.86,28,14,42,30,28,2,1.4,93.33,Facile,Facile,0,Meme Difficulté,Adapte,Sociology
5504,2019,Sociologie,2,Histoire de la Pensee Economique,3,La Conception Liberale de l'Economie,10,1009,10,QCU,0.2,0.91,65.86,30,15,45,41,30,11,1.1,73.17,Facile,Facile,0,Meme Difficulté,Adapte,Sociology
6628,2020,Sociologie,2,Histoire de la Pensee Economique,3,La Conception Liberale de l'Economie,10,1009,10,QCU,0.03,0.92,65.86,31,16,47,42,31,11,1.12,73.81,Facile,Facile,0,Meme Difficulté,Adapte,Sociology
1009,2015,Sociologie,2,Histoire de la Pensee Economique,4,L'Analyse Marxiste,10,1010,1,QCU,0.15,1.0,72.33,8,3,11,9,8,1,1.22,88.89,Facile,Facile,0,Meme Difficulté,Adapte,Sociology
2133,2016,Sociologie,2,Histoire de la Pensee Economique,4,L'Analyse Marxiste,10,1010,1,QCM,0.04,0.8,72.33,7,3,10,9,7,2,1.11,77.78,Facile,Facile,0,Meme Difficulté,Adapte,Sociology
3257,2017,Sociologie,2,Histoire de la Pensee Economique,4,L'Analyse Marxiste,10,1010,1,QCM,0.19,0.86,72.33,9,3,12,12,9,3,1.0,75.0,Facile,Facile,0,Meme Difficulté,Adapte,Sociology
4381,2018,Sociologie,2,Histoire de la Pensee Economique,4,L'Analyse Marxiste,10,1010,1,QCM,0.12,0.86,72.33,7,3,10,9,7,2,1.11,77.78,Facile,Facile,0,Meme Difficulté,Adapte,Sociology
5505,2019,Sociologie,2,Histoire de la Pensee Economique,4,L'Analyse Marxiste,10,1010,1,QCM,0.1,0.95,72.33,7,2,9,9,7,2,1.0,77.78,Facile,Facile,0,Meme Difficulté,Adapte,Sociology
6629,2020,Sociologie,2,Histoire de la Pensee Economique,4,L'Analyse Marxiste,10,1010,1,QCM,0.12,0.87,72.33,7,3,10,8,7,1,1.25,87.5,Facile,Facile,0,Meme Difficulté,Adapte,Sociology
1010,2015,Sociologie,2,Histoire de la Pensee Economique,4,L'Analyse Marxiste,10,1011,2,QCU,0.1,0.79,83.94,83,16,99,86,83,3,1.15,96.51,Difficile,Facile,2,Beaucoup plus Facile,Pas Adapte,Sociology
2134,2016,Sociologie,2,Histoire de la Pensee Economique,4,L'Analyse Marxiste,10,1011,2,QCU,0.35,0.54,52.67,53,48,101,92,53,39,1.1,57.61,Moyen,Moyen,0,Meme Difficulté,Pas Adapte,Sociology
3258,2017,Sociologie,2,Histoire de la Pensee Economique,4,L'Analyse Marxiste,10,1011,2,QCU,0.37,0.7,40.54,39,57,96,59,39,20,1.63,66.1,Facile,Moyen,-1,Plus Difficile,Pas Adapte,Sociology
4382,2018,Sociologie,2,Histoire de la Pensee Economique,4,L'Analyse Marxiste,10,1011,2,QCM,0.7,0.29,24.1,25,77,102,39,25,14,2.62,64.1,Facile,Difficile,-2,Beaucoup plus Difficile,Pas Adapte,Sociology
5506,2019,Sociologie,2,Histoire de la Pensee Economique,4,L'Analyse Marxiste,10,1011,2,QCU,0.22,0.7,40.99,41,60,101,55,41,14,1.84,74.55,Moyen,Moyen,0,Meme Difficulté,Pas Adapte,Sociology
6630,2020,Sociologie,2,Histoire de la Pensee Economique,4,L'Analyse Marxiste,10,1011,2,QCU,0.65,0.38,4.7,5,104,109,60,5,55,1.82,8.33,Facile,Difficile,-2,Beaucoup plus Difficile,Pas Adapte,Sociology
1011,2015,Sociologie,2,Histoire de la Pensee Economique,4,L'Analyse Marxiste,10,1012,3,QCM,0.24,0.46,42.58,26,35,61,46,26,20,1.33,56.52,Difficile,Moyen,1,Plus Facile,Pas Adapte,Sociology
2135,2016,Sociologie,2,Histoire de la Pensee Economique,4,L'Analyse Marxiste,10,1012,3,QCM,0.05,0.84,75.97,53,17,70,59,53,6,1.19,89.83,Difficile,Facile,2,Beaucoup plus Facile,Pas Adapte,Sociology
3259,2017,Sociologie,2,Histoire de la Pensee Economique,4,L'Analyse Marxiste,10,1012,3,QCM,0.21,0.7,42.99,30,40,70,68,30,38,1.03,44.12,Difficile,Moyen,1,Plus Facile,Pas Adapte,Sociology
4383,2018,Sociologie,2,Histoire de la Pensee Economique,4,L'Analyse Marxiste,10,1012,3,QCM,0.34,0.47,60.23,37,25,62,56,37,19,1.11,66.07,Facile,Moyen,-1,Plus Difficile,Adapte,Sociology
5507,2019,Sociologie,2,Histoire de la Pensee Economique,4,L'Analyse Marxiste,10,1012,3,QROC,0.51,0.3,60.23,34,22,56,43,34,9,1.3,79.07,Moyen,Moyen,0,Meme Difficulté,Adapte,Sociology
6631,2020,Sociologie,2,Histoire de la Pensee Economique,4,L'Analyse Marxiste,10,1012,3,QROC,0.25,0.28,60.23,31,20,51,45,31,14,1.13,68.89,Moyen,Moyen,0,Meme Difficulté,Adapte,Sociology
1012,2015,Sociologie,2,Histoire de la Pensee Economique,4,L'Analyse Marxiste,10,1013,4,QCU,0.53,0.39,23.36,21,69,90,65,21,44,1.38,32.31,Difficile,Difficile,0,Meme Difficulté,Pas Adapte,Sociology
2136,2016,Sociologie,2,Histoire de la Pensee Economique,4,L'Analyse Marxiste,10,1013,4,QCU,0.56,0.24,22.45,22,78,100,35,22,13,2.86,62.86,Difficile,Difficile,0,Meme Difficulté,Pas Adapte,Sociology
3260,2017,Sociologie,2,Histoire de la Pensee Economique,4,L'Analyse Marxiste,10,1013,4,QROC,0.17,0.49,69.66,70,31,101,78,70,8,1.29,89.74,Facile,Facile,0,Meme Difficulté,Adapte,Sociology
4384,2018,Sociologie,2,Histoire de la Pensee Economique,4,L'Analyse Marxiste,10,1013,4,QO,0.09,0.91,69.66,69,30,99,79,69,10,1.25,87.34,Facile,Facile,0,Meme Difficulté,Adapte,Sociology
5508,2019,Sociologie,2,Histoire de la Pensee Economique,4,L'Analyse Marxiste,10,1013,4,QO,0.06,0.59,69.66,75,32,107,76,75,1,1.41,98.68,Facile,Facile,0,Meme Difficulté,Adapte,Sociology
6632,2020,Sociologie,2,Histoire de la Pensee Economique,4,L'Analyse Marxiste,10,1013,4,QO,0.17,0.63,69.66,75,32,107,84,75,9,1.27,89.29,Facile,Facile,0,Meme Difficulté,Adapte,Sociology
1013,2015,Sociologie,2,Histoire de la Pensee Economique,4,L'Analyse Marxiste,10,1014,5,QCM,0.71,0.19,4.66,5,93,98,54,5,49,1.81,9.26,Facile,Difficile,-2,Beaucoup plus Difficile,Pas Adapte,Sociology
2137,2016,Sociologie,2,Histoire de la Pensee Economique,4,L'Analyse Marxiste,10,1014,5,QCM,0.78,0.17,1.49,1,96,97,69,1,68,1.41,1.45,Difficile,Difficile,0,Meme Difficulté,Pas Adapte,Sociology
3261,2017,Sociologie,2,Histoire de la Pensee Economique,4,L'Analyse Marxiste,10,1014,5,QCM,0.18,0.94,88.57,98,13,111,107,98,9,1.04,91.59,Moyen,Facile,1,Plus Facile,Pas Adapte,Sociology
4385,2018,Sociologie,2,Histoire de la Pensee Economique,4,L'Analyse Marxiste,10,1014,5,QCM,0.46,0.62,51.49,62,59,121,64,62,2,1.89,96.88,Difficile,Moyen,1,Plus Facile,Pas Adapte,Sociology
5509,2019,Sociologie,2,Histoire de la Pensee Economique,4,L'Analyse Marxiste,10,1014,5,QCM,0.05,0.9,67.23,79,38,117,100,79,21,1.17,79.0,Moyen,Facile,1,Plus Facile,Adapte,Sociology
6633,2020,Sociologie,2,Histoire de la Pensee Economique,4,L'Analyse Marxiste,10,1014,5,QO,0.09,0.68,67.23,81,39,120,88,81,7,1.36,92.05,Facile,Facile,0,Meme Difficulté,Adapte,Sociology
1014,2015,Sociologie,2,Histoire de la Pensee Economique,4,L'Analyse Marxiste,10,1015,6,QCM,0.07,1.0,76.91,44,13,57,54,44,10,1.06,81.48,Moyen,Facile,1,Plus Facile,Pas Adapte,Sociology
2138,2016,Sociologie,2,Histoire de la Pensee Economique,4,L'Analyse Marxiste,10,1015,6,QCM,0.31,0.35,43.32,21,28,49,29,21,8,1.69,72.41,Facile,Moyen,-1,Plus Difficile,Pas Adapte,Sociology
3262,2017,Sociologie,2,Histoire de la Pensee Economique,4,L'Analyse Marxiste,10,1015,6,QCM,0.61,0.2,8.26,4,46,50,41,4,37,1.22,9.76,Moyen,Difficile,-1,Plus Difficile,Pas Adapte,Sociology
4386,2018,Sociologie,2,Histoire de la Pensee Economique,4,L'Analyse Marxiste,10,1015,6,QROC,0.89,0.13,13.35,6,42,48,35,6,29,1.37,17.14,Moyen,Difficile,-1,Plus Difficile,Pas Adapte,Sociology
5510,2019,Sociologie,2,Histoire de la Pensee Economique,4,L'Analyse Marxiste,10,1015,6,QROC,0.52,0.36,43.37,20,25,45,39,20,19,1.15,51.28,Moyen,Moyen,0,Meme Difficulté,Pas Adapte,Sociology
6634,2020,Sociologie,2,Histoire de la Pensee Economique,4,L'Analyse Marxiste,10,1015,6,QO,0.05,0.51,88.0,33,5,38,34,33,1,1.12,97.06,Difficile,Facile,2,Beaucoup plus Facile,Pas Adapte,Sociology
1015,2015,Sociologie,2,Histoire de la Pensee Economique,4,L'Analyse Marxiste,10,1016,7,QCU,0.11,0.92,83.13,51,10,61,58,51,7,1.05,87.93,Moyen,Facile,1,Plus Facile,Pas Adapte,Sociology
2139,2016,Sociologie,2,Histoire de la Pensee Economique,4,L'Analyse Marxiste,10,1016,7,QCU,0.06,0.97,79.31,45,12,57,46,45,1,1.24,97.83,Moyen,Facile,1,Plus Facile,Pas Adapte,Sociology
3263,2017,Sociologie,2,Histoire de la Pensee Economique,4,L'Analyse Marxiste,10,1016,7,QCU,0.1,0.78,73.81,48,17,65,56,48,8,1.16,85.71,Difficile,Facile,2,Beaucoup plus Facile,Adapte,Sociology
4387,2018,Sociologie,2,Histoire de la Pensee Economique,4,L'Analyse Marxiste,10,1016,7,QCM,0.16,0.91,73.81,44,15,59,49,44,5,1.2,89.8,Facile,Facile,0,Meme Difficulté,Adapte,Sociology
5511,2019,Sociologie,2,Histoire de la Pensee Economique,4,L'Analyse Marxiste,10,1016,7,QCM,0.01,0.84,73.81,41,15,56,51,41,10,1.1,80.39,Facile,Facile,0,Meme Difficulté,Adapte,Sociology
6635,2020,Sociologie,2,Histoire de la Pensee Economique,4,L'Analyse Marxiste,10,1016,7,QCM,0.17,0.85,73.81,45,16,61,59,45,14,1.03,76.27,Facile,Facile,0,Meme Difficulté,Adapte,Sociology
1016,2015,Sociologie,2,Histoire de la Pensee Economique,4,L'Analyse Marxiste,10,1017,8,QCM,0.22,0.64,61.64,33,21,54,50,33,17,1.08,66.0,Moyen,Moyen,0,Meme Difficulté,Adapte,Sociology
2140,2016,Sociologie,2,Histoire de la Pensee Economique,4,L'Analyse Marxiste,10,1017,8,QCU,0.32,0.68,61.64,28,18,46,41,28,13,1.12,68.29,Moyen,Moyen,0,Meme Difficulté,Adapte,Sociology
3264,2017,Sociologie,2,Histoire de la Pensee Economique,4,L'Analyse Marxiste,10,1017,8,QCU,0.32,0.41,61.64,25,15,40,33,25,8,1.21,75.76,Moyen,Moyen,0,Meme Difficulté,Adapte,Sociology
4388,2018,Sociologie,2,Histoire de la Pensee Economique,4,L'Analyse Marxiste,10,1017,8,QCU,0.4,0.45,61.64,26,16,42,29,26,3,1.45,89.66,Moyen,Moyen,0,Meme Difficulté,Adapte,Sociology
5512,2019,Sociologie,2,Histoire de la Pensee Economique,4,L'Analyse Marxiste,10,1017,8,QROC,0.29,0.27,61.64,28,17,45,32,28,4,1.41,87.5,Moyen,Moyen,0,Meme Difficulté,Adapte,Sociology
6636,2020,Sociologie,2,Histoire de la Pensee Economique,4,L'Analyse Marxiste,10,1017,8,QROC,0.58,0.34,61.64,23,15,38,27,23,4,1.41,85.19,Moyen,Moyen,0,Meme Difficulté,Adapte,Sociology
1017,2015,Sociologie,2,Histoire de la Pensee Economique,4,L'Analyse Marxiste,10,1018,9,QCU,0.6,0.27,20.5,12,45,57,50,12,38,1.14,24.0,Facile,Difficile,-2,Beaucoup plus Difficile,Pas Adapte,Sociology
2141,2016,Sociologie,2,Histoire de la Pensee Economique,4,L'Analyse Marxiste,10,1018,9,QCU,0.13,1.0,80.62,46,11,57,46,46,0,1.24,100.0,Difficile,Facile,2,Beaucoup plus Facile,Pas Adapte,Sociology
3265,2017,Sociologie,2,Histoire de la Pensee Economique,4,L'Analyse Marxiste,10,1018,9,QCU,0.0,0.81,94.91,61,3,64,62,61,1,1.03,98.39,Facile,Facile,0,Meme Difficulté,Pas Adapte,Sociology
4389,2018,Sociologie,2,Histoire de la Pensee Economique,4,L'Analyse Marxiste,10,1018,9,QCU,0.61,0.2,1.07,1,67,68,66,1,65,1.03,1.52,Facile,Difficile,-2,Beaucoup plus Difficile,Pas Adapte,Sociology
5513,2019,Sociologie,2,Histoire de la Pensee Economique,4,L'Analyse Marxiste,10,1018,9,QCU,0.23,0.41,61.64,36,23,59,41,36,5,1.44,87.8,Difficile,Moyen,1,Plus Facile,Adapte,Sociology
6637,2020,Sociologie,2,Histoire de la Pensee Economique,4,L'Analyse Marxiste,10,1018,9,QCU,0.29,0.69,61.64,33,21,54,34,33,1,1.59,97.06,Moyen,Moyen,0,Meme Difficulté,Adapte,Sociology
1018,2015,Sociologie,2,Histoire de la Pensee Economique,4,L'Analyse Marxiste,10,1019,10,QROC,0.02,0.49,84.82,75,13,88,79,75,4,1.11,94.94,Moyen,Facile,1,Plus Facile,Pas Adapte,Sociology
2142,2016,Sociologie,2,Histoire de la Pensee Economique,4,L'Analyse Marxiste,10,1019,10,QROC,0.06,0.72,85.1,66,11,77,68,66,2,1.13,97.06,Moyen,Facile,1,Plus Facile,Pas Adapte,Sociology
3266,2017,Sociologie,2,Histoire de la Pensee Economique,4,L'Analyse Marxiste,10,1019,10,QROC,0.08,0.58,92.78,79,6,85,82,79,3,1.04,96.34,Moyen,Facile,1,Plus Facile,Pas Adapte,Sociology
4390,2018,Sociologie,2,Histoire de la Pensee Economique,4,L'Analyse Marxiste,10,1019,10,QROC,0.55,0.27,58.45,51,37,88,64,51,13,1.38,79.69,Moyen,Moyen,0,Meme Difficulté,Pas Adapte,Sociology
5514,2019,Sociologie,2,Histoire de la Pensee Economique,4,L'Analyse Marxiste,10,1019,10,QROC,0.19,0.52,66.81,57,28,85,66,57,9,1.29,86.36,Difficile,Facile,2,Beaucoup plus Facile,Adapte,Sociology
6638,2020,Sociologie,2,Histoire de la Pensee Economique,4,L'Analyse Marxiste,10,1019,10,QROC,0.13,0.7,66.81,61,30,91,73,61,12,1.25,83.56,Facile,Facile,0,Meme Difficulté,Adapte,Sociology
1019,2015,Sociologie,2,Histoire de la Pensee Economique,5,La Revolution Keynesienne,7,1020,1,QROC,0.13,0.91,76.59,51,15,66,65,51,14,1.02,78.46,Facile,Facile,0,Meme Difficulté,Pas Adapte,Sociology
2143,2016,Sociologie,2,Histoire de la Pensee Economique,5,La Revolution Keynesienne,7,1020,1,QO,0.79,0.01,9.05,5,52,57,53,5,48,1.08,9.43,Facile,Difficile,-2,Beaucoup plus Difficile,Pas Adapte,Sociology
3267,2017,Sociologie,2,Histoire de la Pensee Economique,5,La Revolution Keynesienne,7,1020,1,QO,0.75,0.05,21.58,11,40,51,41,11,30,1.24,26.83,Facile,Difficile,-2,Beaucoup plus Difficile,Pas Adapte,Sociology
4391,2018,Sociologie,2,Histoire de la Pensee Economique,5,La Revolution Keynesienne,7,1020,1,QCM,0.34,0.34,60.29,33,22,55,50,33,17,1.1,66.0,Facile,Moyen,-1,Plus Difficile,Adapte,Sociology
5515,2019,Sociologie,2,Histoire de la Pensee Economique,5,La Revolution Keynesienne,7,1020,1,QCU,0.24,0.41,60.29,31,21,52,41,31,10,1.27,75.61,Moyen,Moyen,0,Meme Difficulté,Adapte,Sociology
6639,2020,Sociologie,2,Histoire de la Pensee Economique,5,La Revolution Keynesienne,7,1020,1,QCU,0.21,0.63,60.29,34,23,57,35,34,1,1.63,97.14,Moyen,Moyen,0,Meme Difficulté,Adapte,Sociology
1020,2015,Sociologie,2,Histoire de la Pensee Economique,5,La Revolution Keynesienne,7,1021,2,QCM,0.1,0.99,87.9,40,5,45,40,40,0,1.12,100.0,Difficile,Facile,2,Beaucoup plus Facile,Pas Adapte,Sociology
2144,2016,Sociologie,2,Histoire de la Pensee Economique,5,La Revolution Keynesienne,7,1021,2,QCM,0.28,0.48,49.5,25,26,51,48,25,23,1.06,52.08,Facile,Moyen,-1,Plus Difficile,Pas Adapte,Sociology
3268,2017,Sociologie,2,Histoire de la Pensee Economique,5,La Revolution Keynesienne,7,1021,2,QCM,0.44,0.34,49.36,29,30,59,45,29,16,1.31,64.44,Facile,Moyen,-1,Plus Difficile,Pas Adapte,Sociology
4392,2018,Sociologie,2,Histoire de la Pensee Economique,5,La Revolution Keynesienne,7,1021,2,QCM,0.7,0.24,0.03,0,65,65,59,0,59,1.1,0.0,Facile,Difficile,-2,Beaucoup plus Difficile,Pas Adapte,Sociology
5516,2019,Sociologie,2,Histoire de la Pensee Economique,5,La Revolution Keynesienne,7,1021,2,QCM,0.02,0.73,67.51,38,19,57,53,38,15,1.08,71.7,Difficile,Facile,2,Beaucoup plus Facile,Adapte,Sociology
6640,2020,Sociologie,2,Histoire de la Pensee Economique,5,La Revolution Keynesienne,7,1021,2,QCM,0.12,0.86,67.51,43,20,63,56,43,13,1.12,76.79,Facile,Facile,0,Meme Difficulté,Adapte,Sociology
1021,2015,Sociologie,2,Histoire de la Pensee Economique,5,La Revolution Keynesienne,7,1022,3,QCU,0.36,0.71,64.21,51,29,80,60,51,9,1.33,85.0,Difficile,Moyen,1,Plus Facile,Adapte,Sociology
2145,2016,Sociologie,2,Histoire de la Pensee Economique,5,La Revolution Keynesienne,7,1022,3,QCU,0.3,0.64,64.21,45,25,70,66,45,21,1.06,68.18,Moyen,Moyen,0,Meme Difficulté,Adapte,Sociology
3269,2017,Sociologie,2,Histoire de la Pensee Economique,5,La Revolution Keynesienne,7,1022,3,QCU,0.26,0.53,64.21,39,22,61,42,39,3,1.45,92.86,Moyen,Moyen,0,Meme Difficulté,Adapte,Sociology
4393,2018,Sociologie,2,Histoire de la Pensee Economique,5,La Revolution Keynesienne,7,1022,3,QCM,0.22,0.36,64.21,37,20,57,55,37,18,1.04,67.27,Moyen,Moyen,0,Meme Difficulté,Adapte,Sociology
5517,2019,Sociologie,2,Histoire de la Pensee Economique,5,La Revolution Keynesienne,7,1022,3,QCM,0.36,0.47,64.21,35,19,54,40,35,5,1.35,87.5,Moyen,Moyen,0,Meme Difficulté,Adapte,Sociology
6641,2020,Sociologie,2,Histoire de la Pensee Economique,5,La Revolution Keynesienne,7,1022,3,QCM,0.3,0.36,64.21,36,20,56,45,36,9,1.24,80.0,Moyen,Moyen,0,Meme Difficulté,Adapte,Sociology
1022,2015,Sociologie,2,Histoire de la Pensee Economique,5,La Revolution Keynesienne,7,1023,4,QCM,0.21,0.55,53.12,25,22,47,27,25,2,1.74,92.59,Difficile,Moyen,1,Plus Facile,Pas Adapte,Sociology
2146,2016,Sociologie,2,Histoire de la Pensee Economique,5,La Revolution Keynesienne,7,1023,4,QCM,0.17,0.99,72.57,38,15,53,50,38,12,1.06,76.0,Facile,Facile,0,Meme Difficulté,Adapte,Sociology
3270,2017,Sociologie,2,Histoire de la Pensee Economique,5,La Revolution Keynesienne,7,1023,4,QCM,0.12,0.77,72.57,42,16,58,43,42,1,1.35,97.67,Facile,Facile,0,Meme Difficulté,Adapte,Sociology
4394,2018,Sociologie,2,Histoire de la Pensee Economique,5,La Revolution Keynesienne,7,1023,4,QCM,0.09,0.71,72.57,38,14,52,52,38,14,1.0,73.08,Facile,Facile,0,Meme Difficulté,Adapte,Sociology
5518,2019,Sociologie,2,Histoire de la Pensee Economique,5,La Revolution Keynesienne,7,1023,4,QCM,0.12,0.92,72.57,42,16,58,52,42,10,1.12,80.77,Facile,Facile,0,Meme Difficulté,Adapte,Sociology
6642,2020,Sociologie,2,Histoire de la Pensee Economique,5,La Revolution Keynesienne,7,1023,4,QCU,0.07,0.84,72.57,46,17,63,58,46,12,1.09,79.31,Facile,Facile,0,Meme Difficulté,Adapte,Sociology
1023,2015,Sociologie,2,Histoire de la Pensee Economique,5,La Revolution Keynesienne,7,1024,5,QROC,0.93,0.19,22.81,12,40,52,31,12,19,1.68,38.71,Difficile,Difficile,0,Meme Difficulté,Pas Adapte,Sociology
2147,2016,Sociologie,2,Histoire de la Pensee Economique,5,La Revolution Keynesienne,7,1024,5,QROC,0.63,0.18,20.21,12,45,57,33,12,21,1.73,36.36,Moyen,Difficile,-1,Plus Difficile,Pas Adapte,Sociology
3271,2017,Sociologie,2,Histoire de la Pensee Economique,5,La Revolution Keynesienne,7,1024,5,QROC,0.98,0.14,33.8,20,39,59,47,20,27,1.26,42.55,Moyen,Difficile,-1,Plus Difficile,Pas Adapte,Sociology
4395,2018,Sociologie,2,Histoire de la Pensee Economique,5,La Revolution Keynesienne,7,1024,5,QROC,0.36,0.27,63.29,34,19,53,44,34,10,1.2,77.27,Difficile,Moyen,1,Plus Facile,Adapte,Sociology
5519,2019,Sociologie,2,Histoire de la Pensee Economique,5,La Revolution Keynesienne,7,1024,5,QROC,0.56,0.33,63.29,30,18,48,46,30,16,1.04,65.22,Moyen,Moyen,0,Meme Difficulté,Adapte,Sociology
6643,2020,Sociologie,2,Histoire de la Pensee Economique,5,La Revolution Keynesienne,7,1024,5,QROC,0.51,0.36,63.29,30,17,47,31,30,1,1.52,96.77,Moyen,Moyen,0,Meme Difficulté,Adapte,Sociology
1024,2015,Sociologie,2,Histoire de la Pensee Economique,5,La Revolution Keynesienne,7,1025,6,QCM,0.09,0.76,91.54,72,7,79,73,72,1,1.08,98.63,Facile,Facile,0,Meme Difficulté,Pas Adapte,Sociology
2148,2016,Sociologie,2,Histoire de la Pensee Economique,5,La Revolution Keynesienne,7,1025,6,QCM,0.67,0.23,18.15,14,63,77,34,14,20,2.26,41.18,Difficile,Difficile,0,Meme Difficulté,Pas Adapte,Sociology
3272,2017,Sociologie,2,Histoire de la Pensee Economique,5,La Revolution Keynesienne,7,1025,6,QROC,0.7,0.19,5.98,5,82,87,35,5,30,2.49,14.29,Facile,Difficile,-2,Beaucoup plus Difficile,Pas Adapte,Sociology
4396,2018,Sociologie,2,Histoire de la Pensee Economique,5,La Revolution Keynesienne,7,1025,6,QROC,0.07,0.42,99.41,97,1,98,97,97,0,1.01,100.0,Moyen,Facile,1,Plus Facile,Pas Adapte,Sociology
5520,2019,Sociologie,2,Histoire de la Pensee Economique,5,La Revolution Keynesienne,7,1025,6,QCU,0.27,0.44,58.27,57,41,98,77,57,20,1.27,74.03,Facile,Moyen,-1,Plus Difficile,Pas Adapte,Sociology
6644,2020,Sociologie,2,Histoire de la Pensee Economique,5,La Revolution Keynesienne,7,1025,6,QCU,0.66,0.25,17.64,17,82,99,52,17,35,1.9,32.69,Facile,Difficile,-2,Beaucoup plus Difficile,Pas Adapte,Sociology
1025,2015,Sociologie,2,Histoire de la Pensee Economique,5,La Revolution Keynesienne,7,1026,7,QCM,0.13,0.77,93.98,53,3,56,56,53,3,1.0,94.64,Difficile,Facile,2,Beaucoup plus Facile,Pas Adapte,Sociology
2149,2016,Sociologie,2,Histoire de la Pensee Economique,5,La Revolution Keynesienne,7,1026,7,QCM,0.01,0.72,95.89,57,2,59,57,57,0,1.04,100.0,Difficile,Facile,2,Beaucoup plus Facile,Pas Adapte,Sociology
3273,2017,Sociologie,2,Histoire de la Pensee Economique,5,La Revolution Keynesienne,7,1026,7,QCU,0.37,0.44,37.31,24,39,63,32,24,8,1.97,75.0,Moyen,Moyen,0,Meme Difficulté,Pas Adapte,Sociology
4397,2018,Sociologie,2,Histoire de la Pensee Economique,5,La Revolution Keynesienne,7,1026,7,QCU,0.44,0.38,33.01,18,37,55,39,18,21,1.41,46.15,Moyen,Difficile,-1,Plus Difficile,Pas Adapte,Sociology
5521,2019,Sociologie,2,Histoire de la Pensee Economique,5,La Revolution Keynesienne,7,1026,7,QCU,0.08,0.87,93.06,55,4,59,59,55,4,1.0,93.22,Moyen,Facile,1,Plus Facile,Pas Adapte,Sociology
6645,2020,Sociologie,2,Histoire de la Pensee Economique,5,La Revolution Keynesienne,7,1026,7,QCM,0.19,0.91,95.03,55,3,58,57,55,2,1.02,96.49,Moyen,Facile,1,Plus Facile,Pas Adapte,Sociology
1026,2015,Sociologie,3,"Travail, Emploi, Chomage",1,Caracteristiques de l'Emploi et du Chomage,9,1027,1,QROC,0.34,0.28,40.67,31,46,77,47,31,16,1.64,65.96,Moyen,Moyen,0,Meme Difficulté,Pas Adapte,Sociology
2150,2016,Sociologie,3,"Travail, Emploi, Chomage",1,Caracteristiques de l'Emploi et du Chomage,9,1027,1,QROC,0.28,0.26,53.02,34,31,65,39,34,5,1.67,87.18,Moyen,Moyen,0,Meme Difficulté,Pas Adapte,Sociology
3274,2017,Sociologie,3,"Travail, Emploi, Chomage",1,Caracteristiques de l'Emploi et du Chomage,9,1027,1,QROC,0.53,0.31,52.28,37,34,71,71,37,34,1.0,52.11,Difficile,Moyen,1,Plus Facile,Pas Adapte,Sociology
4398,2018,Sociologie,3,"Travail, Emploi, Chomage",1,Caracteristiques de l'Emploi et du Chomage,9,1027,1,QROC,0.08,0.75,85.42,53,9,62,56,53,3,1.11,94.64,Facile,Facile,0,Meme Difficulté,Pas Adapte,Sociology
5522,2019,Sociologie,3,"Travail, Emploi, Chomage",1,Caracteristiques de l'Emploi et du Chomage,9,1027,1,QROC,0.67,0.06,6.6,4,56,60,50,4,46,1.2,8.0,Difficile,Difficile,0,Meme Difficulté,Pas Adapte,Sociology
6646,2020,Sociologie,3,"Travail, Emploi, Chomage",1,Caracteristiques de l'Emploi et du Chomage,9,1027,1,QO,0.91,0.0,16.66,8,43,51,51,8,43,1.0,15.69,Moyen,Difficile,-1,Plus Difficile,Pas Adapte,Sociology
1027,2015,Sociologie,3,"Travail, Emploi, Chomage",1,Caracteristiques de l'Emploi et du Chomage,9,1028,2,QCM,0.0,0.75,90.48,29,3,32,30,29,1,1.07,96.67,Difficile,Facile,2,Beaucoup plus Facile,Pas Adapte,Sociology
2151,2016,Sociologie,3,"Travail, Emploi, Chomage",1,Caracteristiques de l'Emploi et du Chomage,9,1028,2,QCM,0.03,0.9,80.01,22,5,27,22,22,0,1.23,100.0,Moyen,Facile,1,Plus Facile,Pas Adapte,Sociology
3275,2017,Sociologie,3,"Travail, Emploi, Chomage",1,Caracteristiques de l'Emploi et du Chomage,9,1028,2,QCM,0.68,0.21,32.47,8,16,24,10,8,2,2.4,80.0,Facile,Difficile,-2,Beaucoup plus Difficile,Pas Adapte,Sociology
4399,2018,Sociologie,3,"Travail, Emploi, Chomage",1,Caracteristiques de l'Emploi et du Chomage,9,1028,2,QCM,0.04,0.9,93.13,21,2,23,21,21,0,1.1,100.0,Facile,Facile,0,Meme Difficulté,Pas Adapte,Sociology
5523,2019,Sociologie,3,"Travail, Emploi, Chomage",1,Caracteristiques de l'Emploi et du Chomage,9,1028,2,QCM,0.53,0.15,15.32,3,18,21,7,3,4,3.0,42.86,Moyen,Difficile,-1,Plus Difficile,Pas Adapte,Sociology
6647,2020,Sociologie,3,"Travail, Emploi, Chomage",1,Caracteristiques de l'Emploi et du Chomage,9,1028,2,QCM,0.0,0.98,87.63,20,3,23,21,20,1,1.1,95.24,Difficile,Facile,2,Beaucoup plus Facile,Pas Adapte,Sociology
1028,2015,Sociologie,3,"Travail, Emploi, Chomage",1,Caracteristiques de l'Emploi et du Chomage,9,1029,3,QCU,0.59,0.25,25.66,22,63,85,67,22,45,1.27,32.84,Difficile,Difficile,0,Meme Difficulté,Pas Adapte,Sociology
2152,2016,Sociologie,3,"Travail, Emploi, Chomage",1,Caracteristiques de l'Emploi et du Chomage,9,1029,3,QCU,0.74,0.28,5.12,4,81,85,70,4,66,1.21,5.71,Facile,Difficile,-2,Beaucoup plus Difficile,Pas Adapte,Sociology
3276,2017,Sociologie,3,"Travail, Emploi, Chomage",1,Caracteristiques de l'Emploi et du Chomage,9,1029,3,QCM,0.56,0.18,11.6,10,73,83,56,10,46,1.48,17.86,Difficile,Difficile,0,Meme Difficulté,Pas Adapte,Sociology
4400,2018,Sociologie,3,"Travail, Emploi, Chomage",1,Caracteristiques de l'Emploi et du Chomage,9,1029,3,QCM,0.39,0.5,52.77,42,37,79,52,42,10,1.52,80.77,Moyen,Moyen,0,Meme Difficulté,Pas Adapte,Sociology
5524,2019,Sociologie,3,"Travail, Emploi, Chomage",1,Caracteristiques de l'Emploi et du Chomage,9,1029,3,QCU,0.6,0.37,9.07,7,71,78,38,7,31,2.05,18.42,Facile,Difficile,-2,Beaucoup plus Difficile,Pas Adapte,Sociology
6648,2020,Sociologie,3,"Travail, Emploi, Chomage",1,Caracteristiques de l'Emploi et du Chomage,9,1029,3,QCU,0.07,0.86,65.11,46,25,71,67,46,21,1.06,68.66,Difficile,Facile,2,Beaucoup plus Facile,Adapte,Sociology
1029,2015,Sociologie,3,"Travail, Emploi, Chomage",1,Caracteristiques de l'Emploi et du Chomage,9,1030,4,QCM,0.61,0.27,20.12,11,46,57,56,11,45,1.02,19.64,Difficile,Difficile,0,Meme Difficulté,Pas Adapte,Sociology
2153,2016,Sociologie,3,"Travail, Emploi, Chomage",1,Caracteristiques de l'Emploi et du Chomage,9,1030,4,QCM,0.53,0.29,2.77,2,54,56,31,2,29,1.81,6.45,Facile,Difficile,-2,Beaucoup plus Difficile,Pas Adapte,Sociology
3277,2017,Sociologie,3,"Travail, Emploi, Chomage",1,Caracteristiques de l'Emploi et du Chomage,9,1030,4,QCU,0.04,0.79,71.92,44,17,61,45,44,1,1.36,97.78,Moyen,Facile,1,Plus Facile,Adapte,Sociology
4401,2018,Sociologie,3,"Travail, Emploi, Chomage",1,Caracteristiques de l'Emploi et du Chomage,9,1030,4,QCU,0.04,0.97,71.92,37,15,52,42,37,5,1.24,88.1,Facile,Facile,0,Meme Difficulté,Adapte,Sociology
5525,2019,Sociologie,3,"Travail, Emploi, Chomage",1,Caracteristiques de l'Emploi et du Chomage,9,1030,4,QCU,0.12,0.9,71.92,37,14,51,44,37,7,1.16,84.09,Facile,Facile,0,Meme Difficulté,Adapte,Sociology
6649,2020,Sociologie,3,"Travail, Emploi, Chomage",1,Caracteristiques de l'Emploi et du Chomage,9,1030,4,QCU,0.03,0.85,71.92,36,14,50,39,36,3,1.28,92.31,Facile,Facile,0,Meme Difficulté,Adapte,Sociology
1030,2015,Sociologie,3,"Travail, Emploi, Chomage",1,Caracteristiques de l'Emploi et du Chomage,9,1031,5,QCM,0.61,0.3,18.5,7,33,40,12,7,5,3.33,58.33,Moyen,Difficile,-1,Plus Difficile,Pas Adapte,Sociology
2154,2016,Sociologie,3,"Travail, Emploi, Chomage",1,Caracteristiques de l'Emploi et du Chomage,9,1031,5,QCM,0.25,0.55,36.33,12,22,34,24,12,12,1.42,50.0,Facile,Moyen,-1,Plus Difficile,Pas Adapte,Sociology
3278,2017,Sociologie,3,"Travail, Emploi, Chomage",1,Caracteristiques de l'Emploi et du Chomage,9,1031,5,QCM,0.47,0.35,39.5,15,24,39,29,15,14,1.34,51.72,Facile,Moyen,-1,Plus Difficile,Pas Adapte,Sociology
4402,2018,Sociologie,3,"Travail, Emploi, Chomage",1,Caracteristiques de l'Emploi et du Chomage,9,1031,5,QCM,0.78,0.3,17.26,8,36,44,40,8,32,1.1,20.0,Moyen,Difficile,-1,Plus Difficile,Pas Adapte,Sociology
5526,2019,Sociologie,3,"Travail, Emploi, Chomage",1,Caracteristiques de l'Emploi et du Chomage,9,1031,5,QROC,0.2,0.7,77.48,39,11,50,41,39,2,1.22,95.12,Facile,Facile,0,Meme Difficulté,Pas Adapte,Sociology
6650,2020,Sociologie,3,"Travail, Emploi, Chomage",1,Caracteristiques de l'Emploi et du Chomage,9,1031,5,QROC,0.31,0.38,50.27,25,24,49,27,25,2,1.81,92.59,Facile,Moyen,-1,Plus Difficile,Pas Adapte,Sociology
1031,2015,Sociologie,3,"Travail, Emploi, Chomage",1,Caracteristiques de l'Emploi et du Chomage,9,1032,6,QCM,0.11,0.94,83.5,5,1,6,5,5,0,1.2,100.0,Difficile,Facile,2,Beaucoup plus Facile,Pas Adapte,Sociology
2155,2016,Sociologie,3,"Travail, Emploi, Chomage",1,Caracteristiques de l'Emploi et du Chomage,9,1032,6,QCM,0.75,0.18,31.78,2,5,7,3,2,1,2.33,66.67,Moyen,Difficile,-1,Plus Difficile,Pas Adapte,Sociology
3279,2017,Sociologie,3,"Travail, Emploi, Chomage",1,Caracteristiques de l'Emploi et du Chomage,9,1032,6,QCM,0.63,0.26,7.31,1,6,7,2,1,1,3.5,50.0,Moyen,Difficile,-1,Plus Difficile,Pas Adapte,Sociology
4403,2018,Sociologie,3,"Travail, Emploi, Chomage",1,Caracteristiques de l'Emploi et du Chomage,9,1032,6,QCM,0.08,0.9,97.82,6,0,6,6,6,0,1.0,100.0,Difficile,Facile,2,Beaucoup plus Facile,Pas Adapte,Sociology
5527,2019,Sociologie,3,"Travail, Emploi, Chomage",1,Caracteristiques de l'Emploi et du Chomage,9,1032,6,QCU,0.31,0.56,55.57,4,3,7,7,4,3,1.0,57.14,Difficile,Moyen,1,Plus Facile,Pas Adapte,Sociology
6651,2020,Sociologie,3,"Travail, Emploi, Chomage",1,Caracteristiques de l'Emploi et du Chomage,9,1032,6,QCU,0.02,0.78,94.78,6,0,6,6,6,0,1.0,100.0,Moyen,Facile,1,Plus Facile,Pas Adapte,Sociology
1032,2015,Sociologie,3,"Travail, Emploi, Chomage",1,Caracteristiques de l'Emploi et du Chomage,9,1033,7,QCM,0.67,0.22,22.73,8,26,34,27,8,19,1.26,29.63,Difficile,Difficile,0,Meme Difficulté,Pas Adapte,Sociology
2156,2016,Sociologie,3,"Travail, Emploi, Chomage",1,Caracteristiques de l'Emploi et du Chomage,9,1033,7,QCM,0.09,0.84,96.14,31,1,32,32,31,1,1.0,96.88,Facile,Facile,0,Meme Difficulté,Pas Adapte,Sociology
3280,2017,Sociologie,3,"Travail, Emploi, Chomage",1,Caracteristiques de l'Emploi et du Chomage,9,1033,7,QCM,0.2,0.41,60.21,16,11,27,18,16,2,1.5,88.89,Moyen,Moyen,0,Meme Difficulté,Adapte,Sociology
4404,2018,Sociologie,3,"Travail, Emploi, Chomage",1,Caracteristiques de l'Emploi et du Chomage,9,1033,7,QCM,0.24,0.61,60.21,15,10,25,23,15,8,1.09,65.22,Moyen,Moyen,0,Meme Difficulté,Adapte,Sociology
5528,2019,Sociologie,3,"Travail, Emploi, Chomage",1,Caracteristiques de l'Emploi et du Chomage,9,1033,7,QCU,0.39,0.73,60.21,16,10,26,23,16,7,1.13,69.57,Moyen,Moyen,0,Meme Difficulté,Adapte,Sociology
6652,2020,Sociologie,3,"Travail, Emploi, Chomage",1,Caracteristiques de l'Emploi et du Chomage,9,1033,7,QCU,0.23,0.45,60.21,13,9,22,13,13,0,1.69,100.0,Moyen,Moyen,0,Meme Difficulté,Adapte,Sociology
1033,2015,Sociologie,3,"Travail, Emploi, Chomage",1,Caracteristiques de l'Emploi et du Chomage,9,1034,8,QCU,0.68,0.23,32.86,21,42,63,28,21,7,2.25,75.0,Moyen,Difficile,-1,Plus Difficile,Pas Adapte,Sociology
2157,2016,Sociologie,3,"Travail, Emploi, Chomage",1,Caracteristiques de l'Emploi et du Chomage,9,1034,8,QCU,0.34,0.53,59.85,37,24,61,45,37,8,1.36,82.22,Difficile,Moyen,1,Plus Facile,Pas Adapte,Sociology
3281,2017,Sociologie,3,"Travail, Emploi, Chomage",1,Caracteristiques de l'Emploi et du Chomage,9,1034,8,QCU,0.66,0.27,4.58,3,60,63,49,3,46,1.29,6.12,Difficile,Difficile,0,Meme Difficulté,Pas Adapte,Sociology
4405,2018,Sociologie,3,"Travail, Emploi, Chomage",1,Caracteristiques de l'Emploi et du Chomage,9,1034,8,QCU,0.07,0.94,91.27,50,5,55,55,50,5,1.0,90.91,Difficile,Facile,2,Beaucoup plus Facile,Pas Adapte,Sociology
5529,2019,Sociologie,3,"Travail, Emploi, Chomage",1,Caracteristiques de l'Emploi et du Chomage,9,1034,8,QCU,0.47,0.33,9.74,6,56,62,49,6,43,1.27,12.24,Moyen,Difficile,-1,Plus Difficile,Pas Adapte,Sociology
6653,2020,Sociologie,3,"Travail, Emploi, Chomage",1,Caracteristiques de l'Emploi et du Chomage,9,1034,8,QCU,0.05,0.81,74.22,52,18,70,64,52,12,1.09,81.25,Difficile,Facile,2,Beaucoup plus Facile,Adapte,Sociology
1034,2015,Sociologie,3,"Travail, Emploi, Chomage",1,Caracteristiques de l'Emploi et du Chomage,9,1035,9,QCM,0.07,0.98,88.23,49,7,56,52,49,3,1.08,94.23,Difficile,Facile,2,Beaucoup plus Facile,Pas Adapte,Sociology
2158,2016,Sociologie,3,"Travail, Emploi, Chomage",1,Caracteristiques de l'Emploi et du Chomage,9,1035,9,QCM,0.79,0.25,15.64,10,52,62,45,10,35,1.38,22.22,Facile,Difficile,-2,Beaucoup plus Difficile,Pas Adapte,Sociology
3282,2017,Sociologie,3,"Travail, Emploi, Chomage",1,Caracteristiques de l'Emploi et du Chomage,9,1035,9,QCU,0.36,0.45,41.37,24,33,57,50,24,26,1.14,48.0,Moyen,Moyen,0,Meme Difficulté,Pas Adapte,Sociology
4406,2018,Sociologie,3,"Travail, Emploi, Chomage",1,Caracteristiques de l'Emploi et du Chomage,9,1035,9,QCU,0.31,0.65,55.25,30,25,55,35,30,5,1.57,85.71,Difficile,Moyen,1,Plus Facile,Pas Adapte,Sociology
5530,2019,Sociologie,3,"Travail, Emploi, Chomage",1,Caracteristiques de l'Emploi et du Chomage,9,1035,9,QCU,0.55,0.29,12.16,7,50,57,52,7,45,1.1,13.46,Difficile,Difficile,0,Meme Difficulté,Pas Adapte,Sociology
6654,2020,Sociologie,3,"Travail, Emploi, Chomage",1,Caracteristiques de l'Emploi et du Chomage,9,1035,9,QCU,0.53,0.23,20.49,13,50,63,54,13,41,1.17,24.07,Moyen,Difficile,-1,Plus Difficile,Pas Adapte,Sociology
1035,2015,Sociologie,3,"Travail, Emploi, Chomage",2,Fonctionnement du Marche du Chomage dans les Theories Economiques,7,1036,1,QCU,0.17,0.85,87.98,76,10,86,85,76,9,1.01,89.41,Difficile,Facile,2,Beaucoup plus Facile,Pas Adapte,Sociology
2159,2016,Sociologie,3,"Travail, Emploi, Chomage",2,Fonctionnement du Marche du Chomage dans les Theories Economiques,7,1036,1,QCU,0.24,0.45,38.26,34,54,88,88,34,54,1.0,38.64,Moyen,Moyen,0,Meme Difficulté,Pas Adapte,Sociology
3283,2017,Sociologie,3,"Travail, Emploi, Chomage",2,Fonctionnement du Marche du Chomage dans les Theories Economiques,7,1036,1,QCU,0.25,0.44,46.06,44,52,96,86,44,42,1.12,51.16,Facile,Moyen,-1,Plus Difficile,Pas Adapte,Sociology
4407,2018,Sociologie,3,"Travail, Emploi, Chomage",2,Fonctionnement du Marche du Chomage dans les Theories Economiques,7,1036,1,QCU,0.42,0.34,27.86,23,60,83,39,23,16,2.13,58.97,Facile,Difficile,-2,Beaucoup plus Difficile,Pas Adapte,Sociology
5531,2019,Sociologie,3,"Travail, Emploi, Chomage",2,Fonctionnement du Marche du Chomage dans les Theories Economiques,7,1036,1,QCU,0.07,0.87,67.89,57,27,84,78,57,21,1.08,73.08,Facile,Facile,0,Meme Difficulté,Adapte,Sociology
6655,2020,Sociologie,3,"Travail, Emploi, Chomage",2,Fonctionnement du Marche du Chomage dans les Theories Economiques,7,1036,1,QCM,0.18,0.8,67.89,59,28,87,85,59,26,1.02,69.41,Facile,Facile,0,Meme Difficulté,Adapte,Sociology
1036,2015,Sociologie,3,"Travail, Emploi, Chomage",2,Fonctionnement du Marche du Chomage dans les Theories Economiques,7,1037,2,QCM,0.06,0.73,85.56,80,13,93,82,80,2,1.13,97.56,Moyen,Facile,1,Plus Facile,Pas Adapte,Sociology
2160,2016,Sociologie,3,"Travail, Emploi, Chomage",2,Fonctionnement du Marche du Chomage dans les Theories Economiques,7,1037,2,QCM,0.45,0.64,56.1,47,36,83,58,47,11,1.43,81.03,Moyen,Moyen,0,Meme Difficulté,Pas Adapte,Sociology
3284,2017,Sociologie,3,"Travail, Emploi, Chomage",2,Fonctionnement du Marche du Chomage dans les Theories Economiques,7,1037,2,QCM,0.4,0.34,39.84,37,57,94,66,37,29,1.42,56.06,Facile,Moyen,-1,Plus Difficile,Pas Adapte,Sociology
4408,2018,Sociologie,3,"Travail, Emploi, Chomage",2,Fonctionnement du Marche du Chomage dans les Theories Economiques,7,1037,2,QCM,0.67,0.19,1.47,1,97,98,31,1,30,3.16,3.23,Moyen,Difficile,-1,Plus Difficile,Pas Adapte,Sociology
5532,2019,Sociologie,3,"Travail, Emploi, Chomage",2,Fonctionnement du Marche du Chomage dans les Theories Economiques,7,1037,2,QCM,0.5,0.32,44.51,37,47,84,52,37,15,1.62,71.15,Facile,Moyen,-1,Plus Difficile,Pas Adapte,Sociology
6656,2020,Sociologie,3,"Travail, Emploi, Chomage",2,Fonctionnement du Marche du Chomage dans les Theories Economiques,7,1037,2,QCM,0.71,0.27,27.38,20,52,72,61,20,41,1.18,32.79,Difficile,Difficile,0,Meme Difficulté,Pas Adapte,Sociology
1037,2015,Sociologie,3,"Travail, Emploi, Chomage",2,Fonctionnement du Marche du Chomage dans les Theories Economiques,7,1038,3,QCM,0.0,0.82,98.76,59,1,60,59,59,0,1.02,100.0,Facile,Facile,0,Meme Difficulté,Pas Adapte,Sociology
2161,2016,Sociologie,3,"Travail, Emploi, Chomage",2,Fonctionnement du Marche du Chomage dans les Theories Economiques,7,1038,3,QCM,0.49,0.31,42.29,22,31,53,42,22,20,1.26,52.38,Difficile,Moyen,1,Plus Facile,Pas Adapte,Sociology
3285,2017,Sociologie,3,"Travail, Emploi, Chomage",2,Fonctionnement du Marche du Chomage dans les Theories Economiques,7,1038,3,QCM,0.16,0.9,83.85,44,9,53,52,44,8,1.02,84.62,Difficile,Facile,2,Beaucoup plus Facile,Pas Adapte,Sociology
4409,2018,Sociologie,3,"Travail, Emploi, Chomage",2,Fonctionnement du Marche du Chomage dans les Theories Economiques,7,1038,3,QCM,0.09,0.95,86.01,40,6,46,40,40,0,1.15,100.0,Moyen,Facile,1,Plus Facile,Pas Adapte,Sociology
5533,2019,Sociologie,3,"Travail, Emploi, Chomage",2,Fonctionnement du Marche du Chomage dans les Theories Economiques,7,1038,3,QROC,0.03,0.71,80.17,35,9,44,35,35,0,1.26,100.0,Facile,Facile,0,Meme Difficulté,Pas Adapte,Sociology
6657,2020,Sociologie,3,"Travail, Emploi, Chomage",2,Fonctionnement du Marche du Chomage dans les Theories Economiques,7,1038,3,QROC,0.28,0.31,64.75,28,15,43,28,28,0,1.54,100.0,Difficile,Moyen,1,Plus Facile,Adapte,Sociology
1038,2015,Sociologie,3,"Travail, Emploi, Chomage",2,Fonctionnement du Marche du Chomage dans les Theories Economiques,7,1039,4,QCU,0.23,0.42,37.45,34,57,91,51,34,17,1.78,66.67,Moyen,Moyen,0,Meme Difficulté,Pas Adapte,Sociology
2162,2016,Sociologie,3,"Travail, Emploi, Chomage",2,Fonctionnement du Marche du Chomage dans les Theories Economiques,7,1039,4,QCU,0.6,0.25,23.52,22,73,95,40,22,18,2.38,55.0,Moyen,Difficile,-1,Plus Difficile,Pas Adapte,Sociology
3286,2017,Sociologie,3,"Travail, Emploi, Chomage",2,Fonctionnement du Marche du Chomage dans les Theories Economiques,7,1039,4,QROC,0.58,0.3,43.05,46,62,108,76,46,30,1.42,60.53,Facile,Moyen,-1,Plus Difficile,Pas Adapte,Sociology
4410,2018,Sociologie,3,"Travail, Emploi, Chomage",2,Fonctionnement du Marche du Chomage dans les Theories Economiques,7,1039,4,QROC,1.0,0.12,6.96,9,114,123,55,9,46,2.24,16.36,Difficile,Difficile,0,Meme Difficulté,Pas Adapte,Sociology
5534,2019,Sociologie,3,"Travail, Emploi, Chomage",2,Fonctionnement du Marche du Chomage dans les Theories Economiques,7,1039,4,QROC,0.29,0.31,38.88,51,81,132,121,51,70,1.09,42.15,Facile,Moyen,-1,Plus Difficile,Pas Adapte,Sociology
6658,2020,Sociologie,3,"Travail, Emploi, Chomage",2,Fonctionnement du Marche du Chomage dans les Theories Economiques,7,1039,4,QROC,0.65,0.23,6.51,8,111,119,106,8,98,1.12,7.55,Moyen,Difficile,-1,Plus Difficile,Pas Adapte,Sociology
1039,2015,Sociologie,3,"Travail, Emploi, Chomage",2,Fonctionnement du Marche du Chomage dans les Theories Economiques,7,1040,5,QCM,0.13,0.74,95.39,12,1,13,13,12,1,1.0,92.31,Moyen,Facile,1,Plus Facile,Pas Adapte,Sociology
2163,2016,Sociologie,3,"Travail, Emploi, Chomage",2,Fonctionnement du Marche du Chomage dans les Theories Economiques,7,1040,5,QCM,0.51,0.29,1.01,0,15,15,8,0,8,1.88,0.0,Facile,Difficile,-2,Beaucoup plus Difficile,Pas Adapte,Sociology
3287,2017,Sociologie,3,"Travail, Emploi, Chomage",2,Fonctionnement du Marche du Chomage dans les Theories Economiques,7,1040,5,QCU,0.75,0.23,4.36,1,15,16,13,1,12,1.23,7.69,Difficile,Difficile,0,Meme Difficulté,Pas Adapte,Sociology
4411,2018,Sociologie,3,"Travail, Emploi, Chomage",2,Fonctionnement du Marche du Chomage dans les Theories Economiques,7,1040,5,QCU,0.25,0.62,52.97,9,8,17,12,9,3,1.42,75.0,Moyen,Moyen,0,Meme Difficulté,Pas Adapte,Sociology
5535,2019,Sociologie,3,"Travail, Emploi, Chomage",2,Fonctionnement du Marche du Chomage dans les Theories Economiques,7,1040,5,QCU,0.1,0.9,72.52,13,5,18,14,13,1,1.29,92.86,Facile,Facile,0,Meme Difficulté,Adapte,Sociology
6659,2020,Sociologie,3,"Travail, Emploi, Chomage",2,Fonctionnement du Marche du Chomage dans les Theories Economiques,7,1040,5,QCU,0.19,0.75,72.52,13,5,18,18,13,5,1.0,72.22,Facile,Facile,0,Meme Difficulté,Adapte,Sociology
1040,2015,Sociologie,3,"Travail, Emploi, Chomage",2,Fonctionnement du Marche du Chomage dans les Theories Economiques,7,1041,6,QCU,0.16,0.77,67.94,58,27,85,84,58,26,1.01,69.05,Facile,Facile,0,Meme Difficulté,Adapte,Sociology
2164,2016,Sociologie,3,"Travail, Emploi, Chomage",2,Fonctionnement du Marche du Chomage dans les Theories Economiques,7,1041,6,QCU,0.17,0.99,67.94,54,25,79,77,54,23,1.03,70.13,Facile,Facile,0,Meme Difficulté,Adapte,Sociology
3288,2017,Sociologie,3,"Travail, Emploi, Chomage",2,Fonctionnement du Marche du Chomage dans les Theories Economiques,7,1041,6,QCU,0.17,0.96,67.94,49,23,72,55,49,6,1.31,89.09,Facile,Facile,0,Meme Difficulté,Adapte,Sociology
4412,2018,Sociologie,3,"Travail, Emploi, Chomage",2,Fonctionnement du Marche du Chomage dans les Theories Economiques,7,1041,6,QCU,0.15,0.85,67.94,46,22,68,67,46,21,1.01,68.66,Facile,Facile,0,Meme Difficulté,Adapte,Sociology
5536,2019,Sociologie,3,"Travail, Emploi, Chomage",2,Fonctionnement du Marche du Chomage dans les Theories Economiques,7,1041,6,QCU,0.04,0.92,67.94,40,19,59,53,40,13,1.11,75.47,Facile,Facile,0,Meme Difficulté,Adapte,Sociology
6660,2020,Sociologie,3,"Travail, Emploi, Chomage",2,Fonctionnement du Marche du Chomage dans les Theories Economiques,7,1041,6,QCU,0.03,0.87,67.94,40,19,59,53,40,13,1.11,75.47,Facile,Facile,0,Meme Difficulté,Adapte,Sociology
1041,2015,Sociologie,3,"Travail, Emploi, Chomage",2,Fonctionnement du Marche du Chomage dans les Theories Economiques,7,1042,7,QCM,0.17,0.89,91.97,14,1,15,14,14,0,1.07,100.0,Facile,Facile,0,Meme Difficulté,Pas Adapte,Sociology
2165,2016,Sociologie,3,"Travail, Emploi, Chomage",2,Fonctionnement du Marche du Chomage dans les Theories Economiques,7,1042,7,QCM,0.67,0.19,32.77,4,9,13,7,4,3,1.86,57.14,Facile,Difficile,-2,Beaucoup plus Difficile,Pas Adapte,Sociology
3289,2017,Sociologie,3,"Travail, Emploi, Chomage",2,Fonctionnement du Marche du Chomage dans les Theories Economiques,7,1042,7,QCM,0.66,0.16,24.14,3,9,12,8,3,5,1.5,37.5,Difficile,Difficile,0,Meme Difficulté,Pas Adapte,Sociology
4413,2018,Sociologie,3,"Travail, Emploi, Chomage",2,Fonctionnement du Marche du Chomage dans les Theories Economiques,7,1042,7,QCM,0.63,0.15,33.14,3,7,10,9,3,6,1.11,33.33,Difficile,Difficile,0,Meme Difficulté,Pas Adapte,Sociology
5537,2019,Sociologie,3,"Travail, Emploi, Chomage",2,Fonctionnement du Marche du Chomage dans les Theories Economiques,7,1042,7,QCU,0.05,0.84,67.45,5,3,8,5,5,0,1.6,100.0,Facile,Facile,0,Meme Difficulté,Adapte,Sociology
6661,2020,Sociologie,3,"Travail, Emploi, Chomage",2,Fonctionnement du Marche du Chomage dans les Theories Economiques,7,1042,7,QCU,0.1,0.95,67.45,5,3,8,7,5,2,1.14,71.43,Facile,Facile,0,Meme Difficulté,Adapte,Sociology
1042,2015,Sociologie,3,"Travail, Emploi, Chomage",3,Les Actions pour l'Emploi,14,1043,1,QCU,0.11,0.87,95.65,48,2,50,48,48,0,1.04,100.0,Facile,Facile,0,Meme Difficulté,Pas Adapte,Sociology
2166,2016,Sociologie,3,"Travail, Emploi, Chomage",3,Les Actions pour l'Emploi,14,1043,1,QCU,0.1,0.95,86.55,41,6,47,46,41,5,1.02,89.13,Facile,Facile,0,Meme Difficulté,Pas Adapte,Sociology
3290,2017,Sociologie,3,"Travail, Emploi, Chomage",3,Les Actions pour l'Emploi,14,1043,1,QCU,0.44,0.32,4.42,2,45,47,46,2,44,1.02,4.35,Difficile,Difficile,0,Meme Difficulté,Pas Adapte,Sociology
4414,2018,Sociologie,3,"Travail, Emploi, Chomage",3,Les Actions pour l'Emploi,14,1043,1,QCU,0.06,0.84,95.79,43,2,45,44,43,1,1.02,97.73,Facile,Facile,0,Meme Difficulté,Pas Adapte,Sociology
5538,2019,Sociologie,3,"Travail, Emploi, Chomage",3,Les Actions pour l'Emploi,14,1043,1,QROC,0.2,0.6,81.74,32,7,39,36,32,4,1.08,88.89,Moyen,Facile,1,Plus Facile,Pas Adapte,Sociology
6662,2020,Sociologie,3,"Travail, Emploi, Chomage",3,Les Actions pour l'Emploi,14,1043,1,QROC,0.06,0.62,78.81,33,9,42,35,33,2,1.2,94.29,Difficile,Facile,2,Beaucoup plus Facile,Pas Adapte,Sociology
1043,2015,Sociologie,3,"Travail, Emploi, Chomage",3,Les Actions pour l'Emploi,14,1044,2,QCM,0.58,0.29,4.3,3,56,59,17,3,14,3.47,17.65,Facile,Difficile,-2,Beaucoup plus Difficile,Pas Adapte,Sociology
2167,2016,Sociologie,3,"Travail, Emploi, Chomage",3,Les Actions pour l'Emploi,14,1044,2,QCM,0.74,0.19,10.43,5,45,50,49,5,44,1.02,10.2,Facile,Difficile,-2,Beaucoup plus Difficile,Pas Adapte,Sociology
3291,2017,Sociologie,3,"Travail, Emploi, Chomage",3,Les Actions pour l'Emploi,14,1044,2,QCM,0.1,0.79,82.59,37,8,45,41,37,4,1.1,90.24,Facile,Facile,0,Meme Difficulté,Pas Adapte,Sociology
4415,2018,Sociologie,3,"Travail, Emploi, Chomage",3,Les Actions pour l'Emploi,14,1044,2,QCU,0.56,0.36,0.72,0,45,45,26,0,26,1.73,0.0,Facile,Difficile,-2,Beaucoup plus Difficile,Pas Adapte,Sociology
5539,2019,Sociologie,3,"Travail, Emploi, Chomage",3,Les Actions pour l'Emploi,14,1044,2,QCU,0.39,0.62,46.74,22,25,47,22,22,0,2.14,100.0,Moyen,Moyen,0,Meme Difficulté,Pas Adapte,Sociology
6663,2020,Sociologie,3,"Travail, Emploi, Chomage",3,Les Actions pour l'Emploi,14,1044,2,QCM,0.42,0.5,60.5,32,21,53,51,32,19,1.04,62.75,Moyen,Moyen,0,Meme Difficulté,Adapte,Sociology
1044,2015,Sociologie,3,"Travail, Emploi, Chomage",3,Les Actions pour l'Emploi,14,1045,3,QCU,0.01,0.85,98.66,20,0,20,20,20,0,1.0,100.0,Facile,Facile,0,Meme Difficulté,Pas Adapte,Sociology
2168,2016,Sociologie,3,"Travail, Emploi, Chomage",3,Les Actions pour l'Emploi,14,1045,3,QCU,0.31,0.75,56.41,10,7,17,13,10,3,1.31,76.92,Moyen,Moyen,0,Meme Difficulté,Pas Adapte,Sociology
3292,2017,Sociologie,3,"Travail, Emploi, Chomage",3,Les Actions pour l'Emploi,14,1045,3,QCU,0.06,0.76,73.59,13,5,18,16,13,3,1.12,81.25,Difficile,Facile,2,Beaucoup plus Facile,Adapte,Sociology
4416,2018,Sociologie,3,"Travail, Emploi, Chomage",3,Les Actions pour l'Emploi,14,1045,3,QCU,0.03,0.78,73.59,15,5,20,16,15,1,1.25,93.75,Facile,Facile,0,Meme Difficulté,Adapte,Sociology
5540,2019,Sociologie,3,"Travail, Emploi, Chomage",3,Les Actions pour l'Emploi,14,1045,3,QCM,0.09,0.76,73.59,14,5,19,16,14,2,1.19,87.5,Facile,Facile,0,Meme Difficulté,Adapte,Sociology
6664,2020,Sociologie,3,"Travail, Emploi, Chomage",3,Les Actions pour l'Emploi,14,1045,3,QCM,0.1,0.74,73.59,13,4,17,16,13,3,1.06,81.25,Facile,Facile,0,Meme Difficulté,Adapte,Sociology
1045,2015,Sociologie,3,"Travail, Emploi, Chomage",3,Les Actions pour l'Emploi,14,1046,4,QCM,0.77,0.26,0.6,1,92,93,69,1,68,1.35,1.45,Facile,Difficile,-2,Beaucoup plus Difficile,Pas Adapte,Sociology
2169,2016,Sociologie,3,"Travail, Emploi, Chomage",3,Les Actions pour l'Emploi,14,1046,4,QCM,0.5,0.39,49.59,50,51,101,57,50,7,1.77,87.72,Moyen,Moyen,0,Meme Difficulté,Pas Adapte,Sociology
3293,2017,Sociologie,3,"Travail, Emploi, Chomage",3,Les Actions pour l'Emploi,14,1046,4,QCM,0.54,0.27,24.31,26,83,109,65,26,39,1.68,40.0,Facile,Difficile,-2,Beaucoup plus Difficile,Pas Adapte,Sociology
4417,2018,Sociologie,3,"Travail, Emploi, Chomage",3,Les Actions pour l'Emploi,14,1046,4,QCU,0.74,0.21,28.34,27,69,96,89,27,62,1.08,30.34,Moyen,Difficile,-1,Plus Difficile,Pas Adapte,Sociology
5541,2019,Sociologie,3,"Travail, Emploi, Chomage",3,Les Actions pour l'Emploi,14,1046,4,QCU,0.63,0.33,11.79,10,75,85,49,10,39,1.73,20.41,Facile,Difficile,-2,Beaucoup plus Difficile,Pas Adapte,Sociology
6665,2020,Sociologie,3,"Travail, Emploi, Chomage",3,Les Actions pour l'Emploi,14,1046,4,QCU,0.24,0.46,51.25,43,41,84,47,43,4,1.79,91.49,Moyen,Moyen,0,Meme Difficulté,Pas Adapte,Sociology
1046,2015,Sociologie,3,"Travail, Emploi, Chomage",3,Les Actions pour l'Emploi,14,1047,5,QO,0.21,0.23,55.41,32,26,58,38,32,6,1.53,84.21,Difficile,Moyen,1,Plus Facile,Pas Adapte,Sociology
2170,2016,Sociologie,3,"Travail, Emploi, Chomage",3,Les Actions pour l'Emploi,14,1047,5,QO,0.03,0.38,71.13,38,15,53,47,38,9,1.13,80.85,Facile,Facile,0,Meme Difficulté,Adapte,Sociology
3294,2017,Sociologie,3,"Travail, Emploi, Chomage",3,Les Actions pour l'Emploi,14,1047,5,QROC,0.18,0.91,71.13,33,14,47,44,33,11,1.07,75.0,Facile,Facile,0,Meme Difficulté,Adapte,Sociology
4418,2018,Sociologie,3,"Travail, Emploi, Chomage",3,Les Actions pour l'Emploi,14,1047,5,QROC,0.05,1.0,71.13,36,15,51,40,36,4,1.27,90.0,Facile,Facile,0,Meme Difficulté,Adapte,Sociology
5542,2019,Sociologie,3,"Travail, Emploi, Chomage",3,Les Actions pour l'Emploi,14,1047,5,QROC,0.2,0.49,71.13,31,13,44,31,31,0,1.42,100.0,Facile,Facile,0,Meme Difficulté,Adapte,Sociology
6666,2020,Sociologie,3,"Travail, Emploi, Chomage",3,Les Actions pour l'Emploi,14,1047,5,QROC,0.15,0.93,71.13,30,12,42,37,30,7,1.14,81.08,Facile,Facile,0,Meme Difficulté,Adapte,Sociology
1047,2015,Sociologie,3,"Travail, Emploi, Chomage",3,Les Actions pour l'Emploi,14,1048,6,QROC,0.35,0.31,64.8,58,31,89,85,58,27,1.05,68.24,Difficile,Moyen,1,Plus Facile,Adapte,Sociology
2171,2016,Sociologie,3,"Travail, Emploi, Chomage",3,Les Actions pour l'Emploi,14,1048,6,QO,0.52,0.28,64.8,63,34,97,95,63,32,1.02,66.32,Moyen,Moyen,0,Meme Difficulté,Adapte,Sociology
3295,2017,Sociologie,3,"Travail, Emploi, Chomage",3,Les Actions pour l'Emploi,14,1048,6,QROC,0.29,0.32,64.8,63,34,97,87,63,24,1.11,72.41,Moyen,Moyen,0,Meme Difficulté,Adapte,Sociology
4419,2018,Sociologie,3,"Travail, Emploi, Chomage",3,Les Actions pour l'Emploi,14,1048,6,QO,0.28,0.28,64.8,54,29,83,71,54,17,1.17,76.06,Moyen,Moyen,0,Meme Difficulté,Adapte,Sociology
5543,2019,Sociologie,3,"Travail, Emploi, Chomage",3,Les Actions pour l'Emploi,14,1048,6,QCU,0.25,0.43,64.8,56,30,86,70,56,14,1.23,80.0,Moyen,Moyen,0,Meme Difficulté,Adapte,Sociology
6667,2020,Sociologie,3,"Travail, Emploi, Chomage",3,Les Actions pour l'Emploi,14,1048,6,QCU,0.25,0.73,64.8,48,26,74,71,48,23,1.04,67.61,Moyen,Moyen,0,Meme Difficulté,Adapte,Sociology
1048,2015,Sociologie,3,"Travail, Emploi, Chomage",3,Les Actions pour l'Emploi,14,1049,7,QCM,0.57,0.29,4.67,1,19,20,15,1,14,1.33,6.67,Facile,Difficile,-2,Beaucoup plus Difficile,Pas Adapte,Sociology
2172,2016,Sociologie,3,"Travail, Emploi, Chomage",3,Les Actions pour l'Emploi,14,1049,7,QCM,0.46,0.63,64.85,14,8,22,22,14,8,1.0,63.64,Moyen,Moyen,0,Meme Difficulté,Adapte,Sociology
3296,2017,Sociologie,3,"Travail, Emploi, Chomage",3,Les Actions pour l'Emploi,14,1049,7,QCM,0.33,0.48,64.85,15,8,23,23,15,8,1.0,65.22,Moyen,Moyen,0,Meme Difficulté,Adapte,Sociology
4420,2018,Sociologie,3,"Travail, Emploi, Chomage",3,Les Actions pour l'Emploi,14,1049,7,QCM,0.44,0.34,64.85,17,9,26,25,17,8,1.04,68.0,Moyen,Moyen,0,Meme Difficulté,Adapte,Sociology
5544,2019,Sociologie,3,"Travail, Emploi, Chomage",3,Les Actions pour l'Emploi,14,1049,7,QCM,0.24,0.43,64.85,18,10,28,22,18,4,1.27,81.82,Moyen,Moyen,0,Meme Difficulté,Adapte,Sociology
6668,2020,Sociologie,3,"Travail, Emploi, Chomage",3,Les Actions pour l'Emploi,14,1049,7,QCM,0.47,0.66,64.85,19,10,29,26,19,7,1.12,73.08,Moyen,Moyen,0,Meme Difficulté,Adapte,Sociology
1049,2015,Sociologie,3,"Travail, Emploi, Chomage",3,Les Actions pour l'Emploi,14,1050,8,QROC,0.59,0.32,58.81,14,10,24,16,14,2,1.5,87.5,Moyen,Moyen,0,Meme Difficulté,Pas Adapte,Sociology
2173,2016,Sociologie,3,"Travail, Emploi, Chomage",3,Les Actions pour l'Emploi,14,1050,8,QROC,0.19,0.68,69.68,18,8,26,21,18,3,1.24,85.71,Facile,Facile,0,Meme Difficulté,Adapte,Sociology
3297,2017,Sociologie,3,"Travail, Emploi, Chomage",3,Les Actions pour l'Emploi,14,1050,8,QROC,0.03,0.47,69.68,17,8,25,23,17,6,1.09,73.91,Facile,Facile,0,Meme Difficulté,Adapte,Sociology
4421,2018,Sociologie,3,"Travail, Emploi, Chomage",3,Les Actions pour l'Emploi,14,1050,8,QCM,0.12,0.74,69.68,16,7,23,22,16,6,1.05,72.73,Facile,Facile,0,Meme Difficulté,Adapte,Sociology
5545,2019,Sociologie,3,"Travail, Emploi, Chomage",3,Les Actions pour l'Emploi,14,1050,8,QCM,0.04,0.77,69.68,16,7,23,17,16,1,1.35,94.12,Facile,Facile,0,Meme Difficulté,Adapte,Sociology
6669,2020,Sociologie,3,"Travail, Emploi, Chomage",3,Les Actions pour l'Emploi,14,1050,8,QCM,0.17,0.91,69.68,15,7,22,19,15,4,1.16,78.95,Facile,Facile,0,Meme Difficulté,Adapte,Sociology
1050,2015,Sociologie,3,"Travail, Emploi, Chomage",3,Les Actions pour l'Emploi,14,1051,9,QCM,0.61,0.28,23.98,22,68,90,33,22,11,2.73,66.67,Moyen,Difficile,-1,Plus Difficile,Pas Adapte,Sociology
2174,2016,Sociologie,3,"Travail, Emploi, Chomage",3,Les Actions pour l'Emploi,14,1051,9,QCM,0.77,0.21,0.86,1,79,80,69,1,68,1.16,1.45,Facile,Difficile,-2,Beaucoup plus Difficile,Pas Adapte,Sociology
3298,2017,Sociologie,3,"Travail, Emploi, Chomage",3,Les Actions pour l'Emploi,14,1051,9,QROC,0.09,0.49,94.78,70,4,74,73,70,3,1.01,95.89,Difficile,Facile,2,Beaucoup plus Facile,Pas Adapte,Sociology
4422,2018,Sociologie,3,"Travail, Emploi, Chomage",3,Les Actions pour l'Emploi,14,1051,9,QO,0.26,0.16,49.69,36,36,72,62,36,26,1.16,58.06,Moyen,Moyen,0,Meme Difficulté,Pas Adapte,Sociology
5546,2019,Sociologie,3,"Travail, Emploi, Chomage",3,Les Actions pour l'Emploi,14,1051,9,QO,0.95,0.08,21.47,15,57,72,65,15,50,1.11,23.08,Difficile,Difficile,0,Meme Difficulté,Pas Adapte,Sociology
6670,2020,Sociologie,3,"Travail, Emploi, Chomage",3,Les Actions pour l'Emploi,14,1051,9,QO,0.91,0.05,22.36,14,49,63,59,14,45,1.07,23.73,Moyen,Difficile,-1,Plus Difficile,Pas Adapte,Sociology
1051,2015,Sociologie,3,"Travail, Emploi, Chomage",3,Les Actions pour l'Emploi,14,1052,10,QCU,0.08,0.92,96.02,55,2,57,56,55,1,1.02,98.21,Difficile,Facile,2,Beaucoup plus Facile,Pas Adapte,Sociology
2175,2016,Sociologie,3,"Travail, Emploi, Chomage",3,Les Actions pour l'Emploi,14,1052,10,QCU,0.18,0.91,91.39,44,4,48,47,44,3,1.02,93.62,Facile,Facile,0,Meme Difficulté,Pas Adapte,Sociology
3299,2017,Sociologie,3,"Travail, Emploi, Chomage",3,Les Actions pour l'Emploi,14,1052,10,QCU,0.01,0.81,68.07,29,14,43,31,29,2,1.39,93.55,Facile,Facile,0,Meme Difficulté,Adapte,Sociology
4423,2018,Sociologie,3,"Travail, Emploi, Chomage",3,Les Actions pour l'Emploi,14,1052,10,QCU,0.19,0.89,68.07,26,12,38,30,26,4,1.27,86.67,Facile,Facile,0,Meme Difficulté,Adapte,Sociology
5547,2019,Sociologie,3,"Travail, Emploi, Chomage",3,Les Actions pour l'Emploi,14,1052,10,QCU,0.06,0.85,68.07,29,14,43,38,29,9,1.13,76.32,Facile,Facile,0,Meme Difficulté,Adapte,Sociology
6671,2020,Sociologie,3,"Travail, Emploi, Chomage",3,Les Actions pour l'Emploi,14,1052,10,QCU,0.08,0.96,68.07,29,14,43,40,29,11,1.07,72.5,Facile,Facile,0,Meme Difficulté,Adapte,Sociology
1052,2015,Sociologie,3,"Travail, Emploi, Chomage",3,Les Actions pour l'Emploi,14,1053,11,QCU,0.4,0.3,32.12,19,41,60,51,19,32,1.18,37.25,Moyen,Difficile,-1,Plus Difficile,Pas Adapte,Sociology
2176,2016,Sociologie,3,"Travail, Emploi, Chomage",3,Les Actions pour l'Emploi,14,1053,11,QCU,0.53,0.35,12.83,7,46,53,18,7,11,2.94,38.89,Difficile,Difficile,0,Meme Difficulté,Pas Adapte,Sociology
3300,2017,Sociologie,3,"Travail, Emploi, Chomage",3,Les Actions pour l'Emploi,14,1053,11,QCU,0.66,0.36,15.05,8,46,54,31,8,23,1.74,25.81,Difficile,Difficile,0,Meme Difficulté,Pas Adapte,Sociology
4424,2018,Sociologie,3,"Travail, Emploi, Chomage",3,Les Actions pour l'Emploi,14,1053,11,QCU,0.31,0.46,54.91,29,24,53,40,29,11,1.32,72.5,Moyen,Moyen,0,Meme Difficulté,Pas Adapte,Sociology
5548,2019,Sociologie,3,"Travail, Emploi, Chomage",3,Les Actions pour l'Emploi,14,1053,11,QCU,0.75,0.23,7.72,4,47,51,31,4,27,1.65,12.9,Moyen,Difficile,-1,Plus Difficile,Pas Adapte,Sociology
6672,2020,Sociologie,3,"Travail, Emploi, Chomage",3,Les Actions pour l'Emploi,14,1053,11,QCU,0.16,0.78,77.21,36,11,47,41,36,5,1.15,87.8,Moyen,Facile,1,Plus Facile,Pas Adapte,Sociology
1053,2015,Sociologie,3,"Travail, Emploi, Chomage",3,Les Actions pour l'Emploi,14,1054,12,QCU,0.21,0.54,46.76,9,10,19,12,9,3,1.58,75.0,Moyen,Moyen,0,Meme Difficulté,Pas Adapte,Sociology
2177,2016,Sociologie,3,"Travail, Emploi, Chomage",3,Les Actions pour l'Emploi,14,1054,12,QCU,0.0,0.88,85.18,14,2,16,16,14,2,1.0,87.5,Difficile,Facile,2,Beaucoup plus Facile,Pas Adapte,Sociology
3301,2017,Sociologie,3,"Travail, Emploi, Chomage",3,Les Actions pour l'Emploi,14,1054,12,QCU,0.06,0.76,72.6,12,5,17,14,12,2,1.21,85.71,Moyen,Facile,1,Plus Facile,Adapte,Sociology
4425,2018,Sociologie,3,"Travail, Emploi, Chomage",3,Les Actions pour l'Emploi,14,1054,12,QCM,0.04,0.81,72.6,13,5,18,17,13,4,1.06,76.47,Facile,Facile,0,Meme Difficulté,Adapte,Sociology
5549,2019,Sociologie,3,"Travail, Emploi, Chomage",3,Les Actions pour l'Emploi,14,1054,12,QCM,0.01,0.72,72.6,15,5,20,17,15,2,1.18,88.24,Facile,Facile,0,Meme Difficulté,Adapte,Sociology
6673,2020,Sociologie,3,"Travail, Emploi, Chomage",3,Les Actions pour l'Emploi,14,1054,12,QROC,0.08,0.72,72.6,14,5,19,18,14,4,1.06,77.78,Facile,Facile,0,Meme Difficulté,Adapte,Sociology
1054,2015,Sociologie,3,"Travail, Emploi, Chomage",3,Les Actions pour l'Emploi,14,1055,13,QCM,0.5,0.22,26.36,4,11,15,7,4,3,2.14,57.14,Moyen,Difficile,-1,Plus Difficile,Pas Adapte,Sociology
2178,2016,Sociologie,3,"Travail, Emploi, Chomage",3,Les Actions pour l'Emploi,14,1055,13,QCM,0.2,0.97,92.26,12,1,13,13,12,1,1.0,92.31,Moyen,Facile,1,Plus Facile,Pas Adapte,Sociology
3302,2017,Sociologie,3,"Travail, Emploi, Chomage",3,Les Actions pour l'Emploi,14,1055,13,QCM,0.59,0.24,31.75,5,10,15,6,5,1,2.5,83.33,Facile,Difficile,-2,Beaucoup plus Difficile,Pas Adapte,Sociology
4426,2018,Sociologie,3,"Travail, Emploi, Chomage",3,Les Actions pour l'Emploi,14,1055,13,QCM,0.09,0.77,95.33,16,1,17,16,16,0,1.06,100.0,Facile,Facile,0,Meme Difficulté,Pas Adapte,Sociology
5550,2019,Sociologie,3,"Travail, Emploi, Chomage",3,Les Actions pour l'Emploi,14,1055,13,QCM,0.67,0.25,4.23,1,18,19,15,1,14,1.27,6.67,Moyen,Difficile,-1,Plus Difficile,Pas Adapte,Sociology
6674,2020,Sociologie,3,"Travail, Emploi, Chomage",3,Les Actions pour l'Emploi,14,1055,13,QCM,0.19,0.9,73.11,13,5,18,17,13,4,1.06,76.47,Moyen,Facile,1,Plus Facile,Adapte,Sociology
1055,2015,Sociologie,3,"Travail, Emploi, Chomage",3,Les Actions pour l'Emploi,14,1056,14,QCM,0.11,0.87,95.57,32,2,34,33,32,1,1.03,96.97,Moyen,Facile,1,Plus Facile,Pas Adapte,Sociology
2179,2016,Sociologie,3,"Travail, Emploi, Chomage",3,Les Actions pour l'Emploi,14,1056,14,QCM,0.78,0.17,24.23,8,25,33,24,8,16,1.38,33.33,Facile,Difficile,-2,Beaucoup plus Difficile,Pas Adapte,Sociology
3303,2017,Sociologie,3,"Travail, Emploi, Chomage",3,Les Actions pour l'Emploi,14,1056,14,QCM,0.11,0.75,81.84,24,5,29,27,24,3,1.07,88.89,Facile,Facile,0,Meme Difficulté,Pas Adapte,Sociology
4427,2018,Sociologie,3,"Travail, Emploi, Chomage",3,Les Actions pour l'Emploi,14,1056,14,QCM,0.07,0.89,91.73,26,2,28,28,26,2,1.0,92.86,Facile,Facile,0,Meme Difficulté,Pas Adapte,Sociology
5551,2019,Sociologie,3,"Travail, Emploi, Chomage",3,Les Actions pour l'Emploi,14,1056,14,QCM,0.65,0.27,8.6,2,24,26,22,2,20,1.18,9.09,Difficile,Difficile,0,Meme Difficulté,Pas Adapte,Sociology
6675,2020,Sociologie,3,"Travail, Emploi, Chomage",3,Les Actions pour l'Emploi,14,1056,14,QROC,0.05,0.87,70.06,16,7,23,16,16,0,1.44,100.0,Moyen,Facile,1,Plus Facile,Adapte,Sociology
1056,2015,Sociologie,3,"Travail, Emploi, Chomage",4,La Question du Travail,5,1057,1,QCU,0.45,0.24,11.59,10,80,90,74,10,64,1.22,13.51,Difficile,Difficile,0,Meme Difficulté,Pas Adapte,Sociology
2180,2016,Sociologie,3,"Travail, Emploi, Chomage",4,La Question du Travail,5,1057,1,QCU,0.01,0.78,88.19,85,11,96,90,85,5,1.07,94.44,Difficile,Facile,2,Beaucoup plus Facile,Pas Adapte,Sociology
3304,2017,Sociologie,3,"Travail, Emploi, Chomage",4,La Question du Travail,5,1057,1,QCU,0.49,0.31,0.87,1,83,84,77,1,76,1.09,1.3,Moyen,Difficile,-1,Plus Difficile,Pas Adapte,Sociology
4428,2018,Sociologie,3,"Travail, Emploi, Chomage",4,La Question du Travail,5,1057,1,QCU,0.08,0.99,72.32,59,22,81,75,59,16,1.08,78.67,Difficile,Facile,2,Beaucoup plus Facile,Adapte,Sociology
5552,2019,Sociologie,3,"Travail, Emploi, Chomage",4,La Question du Travail,5,1057,1,QROC,0.19,0.53,72.32,51,19,70,65,51,14,1.08,78.46,Facile,Facile,0,Meme Difficulté,Adapte,Sociology
6676,2020,Sociologie,3,"Travail, Emploi, Chomage",4,La Question du Travail,5,1057,1,QROC,0.15,0.97,72.32,46,18,64,58,46,12,1.1,79.31,Facile,Facile,0,Meme Difficulté,Adapte,Sociology
1057,2015,Sociologie,3,"Travail, Emploi, Chomage",4,La Question du Travail,5,1058,2,QCM,0.62,0.18,34.16,20,39,59,39,20,19,1.51,51.28,Moyen,Difficile,-1,Plus Difficile,Pas Adapte,Sociology
2181,2016,Sociologie,3,"Travail, Emploi, Chomage",4,La Question du Travail,5,1058,2,QCM,0.74,0.23,26.94,15,39,54,26,15,11,2.08,57.69,Facile,Difficile,-2,Beaucoup plus Difficile,Pas Adapte,Sociology
3305,2017,Sociologie,3,"Travail, Emploi, Chomage",4,La Question du Travail,5,1058,2,QCM,0.56,0.24,8.42,4,49,53,33,4,29,1.61,12.12,Difficile,Difficile,0,Meme Difficulté,Pas Adapte,Sociology
4429,2018,Sociologie,3,"Travail, Emploi, Chomage",4,La Question du Travail,5,1058,2,QCM,0.53,0.28,18.29,11,49,60,45,11,34,1.33,24.44,Moyen,Difficile,-1,Plus Difficile,Pas Adapte,Sociology
5553,2019,Sociologie,3,"Travail, Emploi, Chomage",4,La Question du Travail,5,1058,2,QCM,0.47,0.54,41.22,23,34,57,25,23,2,2.28,92.0,Moyen,Moyen,0,Meme Difficulté,Pas Adapte,Sociology
6677,2020,Sociologie,3,"Travail, Emploi, Chomage",4,La Question du Travail,5,1058,2,QCM,0.35,0.38,59.76,35,24,59,40,35,5,1.48,87.5,Facile,Moyen,-1,Plus Difficile,Pas Adapte,Sociology
1058,2015,Sociologie,3,"Travail, Emploi, Chomage",4,La Question du Travail,5,1059,3,QCM,0.0,0.79,83.3,19,4,23,23,19,4,1.0,82.61,Facile,Facile,0,Meme Difficulté,Pas Adapte,Sociology
2182,2016,Sociologie,3,"Travail, Emploi, Chomage",4,La Question du Travail,5,1059,3,QCM,0.15,0.84,66.45,14,7,21,18,14,4,1.17,77.78,Moyen,Facile,1,Plus Facile,Adapte,Sociology
3306,2017,Sociologie,3,"Travail, Emploi, Chomage",4,La Question du Travail,5,1059,3,QCM,0.11,0.72,66.45,12,6,18,14,12,2,1.29,85.71,Facile,Facile,0,Meme Difficulté,Adapte,Sociology
4430,2018,Sociologie,3,"Travail, Emploi, Chomage",4,La Question du Travail,5,1059,3,QCM,0.09,0.95,66.45,13,7,20,16,13,3,1.25,81.25,Facile,Facile,0,Meme Difficulté,Adapte,Sociology
5554,2019,Sociologie,3,"Travail, Emploi, Chomage",4,La Question du Travail,5,1059,3,QCM,0.2,0.91,66.45,11,6,17,13,11,2,1.31,84.62,Facile,Facile,0,Meme Difficulté,Adapte,Sociology
6678,2020,Sociologie,3,"Travail, Emploi, Chomage",4,La Question du Travail,5,1059,3,QCM,0.03,0.78,66.45,13,7,20,14,13,1,1.43,92.86,Facile,Facile,0,Meme Difficulté,Adapte,Sociology
1059,2015,Sociologie,3,"Travail, Emploi, Chomage",4,La Question du Travail,5,1060,4,QCU,0.07,0.81,69.77,33,15,48,43,33,10,1.12,76.74,Facile,Facile,0,Meme Difficulté,Adapte,Sociology
2183,2016,Sociologie,3,"Travail, Emploi, Chomage",4,La Question du Travail,5,1060,4,QCU,0.19,0.82,69.77,29,13,42,41,29,12,1.02,70.73,Facile,Facile,0,Meme Difficulté,Adapte,Sociology
3307,2017,Sociologie,3,"Travail, Emploi, Chomage",4,La Question du Travail,5,1060,4,QCU,0.03,0.9,69.77,26,11,37,26,26,0,1.42,100.0,Facile,Facile,0,Meme Difficulté,Adapte,Sociology
4431,2018,Sociologie,3,"Travail, Emploi, Chomage",4,La Question du Travail,5,1060,4,QCU,0.01,0.75,69.77,22,9,31,22,22,0,1.41,100.0,Facile,Facile,0,Meme Difficulté,Adapte,Sociology
5555,2019,Sociologie,3,"Travail, Emploi, Chomage",4,La Question du Travail,5,1060,4,QCM,0.16,0.98,69.77,24,10,34,28,24,4,1.21,85.71,Facile,Facile,0,Meme Difficulté,Adapte,Sociology
6679,2020,Sociologie,3,"Travail, Emploi, Chomage",4,La Question du Travail,5,1060,4,QCM,0.01,0.81,69.77,25,11,36,28,25,3,1.29,89.29,Facile,Facile,0,Meme Difficulté,Adapte,Sociology
1060,2015,Sociologie,3,"Travail, Emploi, Chomage",4,La Question du Travail,5,1061,5,QROC,0.08,0.63,85.57,61,10,71,69,61,8,1.03,88.41,Moyen,Facile,1,Plus Facile,Pas Adapte,Sociology
2184,2016,Sociologie,3,"Travail, Emploi, Chomage",4,La Question du Travail,5,1061,5,QROC,0.09,0.46,95.82,58,3,61,60,58,2,1.02,96.67,Moyen,Facile,1,Plus Facile,Pas Adapte,Sociology
3308,2017,Sociologie,3,"Travail, Emploi, Chomage",4,La Question du Travail,5,1061,5,QROC,0.55,0.37,44.2,24,31,55,40,24,16,1.38,60.0,Difficile,Moyen,1,Plus Facile,Pas Adapte,Sociology
4432,2018,Sociologie,3,"Travail, Emploi, Chomage",4,La Question du Travail,5,1061,5,QROC,0.33,0.33,48.33,27,28,55,31,27,4,1.77,87.1,Facile,Moyen,-1,Plus Difficile,Pas Adapte,Sociology
5556,2019,Sociologie,3,"Travail, Emploi, Chomage",4,La Question du Travail,5,1061,5,QO,0.93,0.09,22.72,12,42,54,40,12,28,1.35,30.0,Moyen,Difficile,-1,Plus Difficile,Pas Adapte,Sociology
6680,2020,Sociologie,3,"Travail, Emploi, Chomage",4,La Question du Travail,5,1061,5,QROC,0.46,0.37,43.58,20,26,46,43,20,23,1.07,46.51,Difficile,Moyen,1,Plus Facile,Pas Adapte,Sociology
1061,2015,Sociologie,4,Notions de Sociologie,1,Les Modernites,6,1062,1,QROC,0.4,0.28,51.86,11,11,22,16,11,5,1.38,68.75,Facile,Moyen,-1,Plus Difficile,Pas Adapte,Sociology
2185,2016,Sociologie,4,Notions de Sociologie,1,Les Modernites,6,1062,1,QROC,0.62,0.03,20.29,4,16,20,8,4,4,2.5,50.0,Difficile,Difficile,0,Meme Difficulté,Pas Adapte,Sociology
3309,2017,Sociologie,4,Notions de Sociologie,1,Les Modernites,6,1062,1,QCM,0.02,0.8,69.67,14,6,20,17,14,3,1.18,82.35,Moyen,Facile,1,Plus Facile,Adapte,Sociology
4433,2018,Sociologie,4,Notions de Sociologie,1,Les Modernites,6,1062,1,QCM,0.13,0.72,69.67,16,7,23,21,16,5,1.1,76.19,Facile,Facile,0,Meme Difficulté,Adapte,Sociology
5557,2019,Sociologie,4,Notions de Sociologie,1,Les Modernites,6,1062,1,QCM,0.07,0.88,69.67,16,7,23,16,16,0,1.44,100.0,Facile,Facile,0,Meme Difficulté,Adapte,Sociology
6681,2020,Sociologie,4,Notions de Sociologie,1,Les Modernites,6,1062,1,QROC,0.02,0.65,69.67,17,8,25,18,17,1,1.39,94.44,Facile,Facile,0,Meme Difficulté,Adapte,Sociology
1062,2015,Sociologie,4,Notions de Sociologie,1,Les Modernites,6,1063,2,QCU,0.58,0.4,31.64,23,51,74,57,23,34,1.3,40.35,Difficile,Difficile,0,Meme Difficulté,Pas Adapte,Sociology
2186,2016,Sociologie,4,Notions de Sociologie,1,Les Modernites,6,1063,2,QCU,0.52,0.38,4.4,4,78,82,35,4,31,2.34,11.43,Moyen,Difficile,-1,Plus Difficile,Pas Adapte,Sociology
3310,2017,Sociologie,4,Notions de Sociologie,1,Les Modernites,6,1063,2,QCU,0.29,0.69,37.81,34,55,89,61,34,27,1.46,55.74,Moyen,Moyen,0,Meme Difficulté,Pas Adapte,Sociology
4434,2018,Sociologie,4,Notions de Sociologie,1,Les Modernites,6,1063,2,QCM,0.36,0.44,48.01,44,47,91,84,44,40,1.08,52.38,Facile,Moyen,-1,Plus Difficile,Pas Adapte,Sociology
5558,2019,Sociologie,4,Notions de Sociologie,1,Les Modernites,6,1063,2,QCM,0.06,0.71,99.1,89,1,90,90,89,1,1.0,98.89,Difficile,Facile,2,Beaucoup plus Facile,Pas Adapte,Sociology
6682,2020,Sociologie,4,Notions de Sociologie,1,Les Modernites,6,1063,2,QCM,0.14,0.79,79.27,68,18,86,83,68,15,1.04,81.93,Difficile,Facile,2,Beaucoup plus Facile,Pas Adapte,Sociology
1063,2015,Sociologie,4,Notions de Sociologie,1,Les Modernites,6,1064,3,QCU,0.6,0.25,21.81,10,36,46,31,10,21,1.48,32.26,Difficile,Difficile,0,Meme Difficulté,Pas Adapte,Sociology
2187,2016,Sociologie,4,Notions de Sociologie,1,Les Modernites,6,1064,3,QCU,0.27,0.53,36.78,15,27,42,32,15,17,1.31,46.88,Facile,Moyen,-1,Plus Difficile,Pas Adapte,Sociology
3311,2017,Sociologie,4,Notions de Sociologie,1,Les Modernites,6,1064,3,QROC,0.25,0.38,53.85,23,20,43,30,23,7,1.43,76.67,Moyen,Moyen,0,Meme Difficulté,Pas Adapte,Sociology
4435,2018,Sociologie,4,Notions de Sociologie,1,Les Modernites,6,1064,3,QCM,0.47,0.46,54.57,22,18,40,27,22,5,1.48,81.48,Facile,Moyen,-1,Plus Difficile,Pas Adapte,Sociology
5559,2019,Sociologie,4,Notions de Sociologie,1,Les Modernites,6,1064,3,QCM,0.18,0.97,71.71,32,12,44,33,32,1,1.33,96.97,Moyen,Facile,1,Plus Facile,Adapte,Sociology
6683,2020,Sociologie,4,Notions de Sociologie,1,Les Modernites,6,1064,3,QCU,0.04,0.85,71.71,34,14,48,45,34,11,1.07,75.56,Facile,Facile,0,Meme Difficulté,Adapte,Sociology
1064,2015,Sociologie,4,Notions de Sociologie,1,Les Modernites,6,1065,4,QROC,0.01,0.81,98.62,12,0,12,12,12,0,1.0,100.0,Difficile,Facile,2,Beaucoup plus Facile,Pas Adapte,Sociology
2188,2016,Sociologie,4,Notions de Sociologie,1,Les Modernites,6,1065,4,QROC,0.12,0.82,82.84,9,2,11,11,9,2,1.0,81.82,Moyen,Facile,1,Plus Facile,Pas Adapte,Sociology
3312,2017,Sociologie,4,Notions de Sociologie,1,Les Modernites,6,1065,4,QROC,0.54,0.27,56.8,6,5,11,8,6,2,1.38,75.0,Difficile,Moyen,1,Plus Facile,Pas Adapte,Sociology
4436,2018,Sociologie,4,Notions de Sociologie,1,Les Modernites,6,1065,4,QROC,0.78,0.09,28.66,3,7,10,7,3,4,1.43,42.86,Moyen,Difficile,-1,Plus Difficile,Pas Adapte,Sociology
5560,2019,Sociologie,4,Notions de Sociologie,1,Les Modernites,6,1065,4,QO,0.74,0.19,36.63,4,8,12,10,4,6,1.2,40.0,Difficile,Moyen,1,Plus Facile,Pas Adapte,Sociology
6684,2020,Sociologie,4,Notions de Sociologie,1,Les Modernites,6,1065,4,QO,0.04,0.51,83.9,12,2,14,13,12,1,1.08,92.31,Moyen,Facile,1,Plus Facile,Pas Adapte,Sociology
1065,2015,Sociologie,4,Notions de Sociologie,1,Les Modernites,6,1066,5,QCU,0.03,0.87,90.29,39,4,43,40,39,1,1.07,97.5,Moyen,Facile,1,Plus Facile,Pas Adapte,Sociology
2189,2016,Sociologie,4,Notions de Sociologie,1,Les Modernites,6,1066,5,QCU,0.22,0.41,48.84,20,20,40,33,20,13,1.21,60.61,Moyen,Moyen,0,Meme Difficulté,Pas Adapte,Sociology
3313,2017,Sociologie,4,Notions de Sociologie,1,Les Modernites,6,1066,5,QCU,0.24,0.42,42.2,15,21,36,20,15,5,1.8,75.0,Facile,Moyen,-1,Plus Difficile,Pas Adapte,Sociology
4437,2018,Sociologie,4,Notions de Sociologie,1,Les Modernites,6,1066,5,QCU,0.61,0.25,26.99,11,28,39,13,11,2,3.0,84.62,Moyen,Difficile,-1,Plus Difficile,Pas Adapte,Sociology
5561,2019,Sociologie,4,Notions de Sociologie,1,Les Modernites,6,1066,5,QCU,0.65,0.38,12.19,4,29,33,21,4,17,1.57,19.05,Facile,Difficile,-2,Beaucoup plus Difficile,Pas Adapte,Sociology
6685,2020,Sociologie,4,Notions de Sociologie,1,Les Modernites,6,1066,5,QCU,0.39,0.51,43.35,14,19,33,25,14,11,1.32,56.0,Moyen,Moyen,0,Meme Difficulté,Pas Adapte,Sociology
1066,2015,Sociologie,4,Notions de Sociologie,1,Les Modernites,6,1067,6,QCM,0.02,0.86,95.68,7,0,7,7,7,0,1.0,100.0,Difficile,Facile,2,Beaucoup plus Facile,Pas Adapte,Sociology
2190,2016,Sociologie,4,Notions de Sociologie,1,Les Modernites,6,1067,6,QCM,0.61,0.28,24.63,2,5,7,5,2,3,1.4,40.0,Facile,Difficile,-2,Beaucoup plus Difficile,Pas Adapte,Sociology
3314,2017,Sociologie,4,Notions de Sociologie,1,Les Modernites,6,1067,6,QCM,0.34,0.37,63.51,4,3,7,5,4,1,1.4,80.0,Facile,Moyen,-1,Plus Difficile,Adapte,Sociology
4438,2018,Sociologie,4,Notions de Sociologie,1,Les Modernites,6,1067,6,QCU,0.29,0.4,63.51,4,2,6,5,4,1,1.2,80.0,Moyen,Moyen,0,Meme Difficulté,Adapte,Sociology
5562,2019,Sociologie,4,Notions de Sociologie,1,Les Modernites,6,1067,6,QCU,0.26,0.51,63.51,4,2,6,6,4,2,1.0,66.67,Moyen,Moyen,0,Meme Difficulté,Adapte,Sociology
6686,2020,Sociologie,4,Notions de Sociologie,1,Les Modernites,6,1067,6,QCM,0.31,0.66,63.51,3,2,5,4,3,1,1.25,75.0,Moyen,Moyen,0,Meme Difficulté,Adapte,Sociology
1067,2015,Sociologie,4,Notions de Sociologie,2,Structure et Classes Sociales,6,1068,1,QCU,0.14,0.91,71.08,49,20,69,60,49,11,1.15,81.67,Facile,Facile,0,Meme Difficulté,Adapte,Sociology
2191,2016,Sociologie,4,Notions de Sociologie,2,Structure et Classes Sociales,6,1068,1,QCU,0.01,0.96,71.08,42,17,59,47,42,5,1.26,89.36,Facile,Facile,0,Meme Difficulté,Adapte,Sociology
3315,2017,Sociologie,4,Notions de Sociologie,2,Structure et Classes Sociales,6,1068,1,QCU,0.05,0.85,71.08,41,16,57,48,41,7,1.19,85.42,Facile,Facile,0,Meme Difficulté,Adapte,Sociology
4439,2018,Sociologie,4,Notions de Sociologie,2,Structure et Classes Sociales,6,1068,1,QCU,0.17,1.0,71.08,46,19,65,61,46,15,1.07,75.41,Facile,Facile,0,Meme Difficulté,Adapte,Sociology
5563,2019,Sociologie,4,Notions de Sociologie,2,Structure et Classes Sociales,6,1068,1,QCU,0.12,0.88,71.08,42,17,59,46,42,4,1.28,91.3,Facile,Facile,0,Meme Difficulté,Adapte,Sociology
6687,2020,Sociologie,4,Notions de Sociologie,2,Structure et Classes Sociales,6,1068,1,QCU,0.02,0.75,71.08,46,19,65,55,46,9,1.18,83.64,Facile,Facile,0,Meme Difficulté,Adapte,Sociology
1068,2015,Sociologie,4,Notions de Sociologie,2,Structure et Classes Sociales,6,1069,2,QCM,0.29,0.37,44.84,24,30,54,48,24,24,1.12,50.0,Difficile,Moyen,1,Plus Facile,Pas Adapte,Sociology
2192,2016,Sociologie,4,Notions de Sociologie,2,Structure et Classes Sociales,6,1069,2,QCM,0.6,0.22,3.69,2,48,50,38,2,36,1.32,5.26,Moyen,Difficile,-1,Plus Difficile,Pas Adapte,Sociology
3316,2017,Sociologie,4,Notions de Sociologie,2,Structure et Classes Sociales,6,1069,2,QCM,0.28,0.52,59.46,26,18,44,34,26,8,1.29,76.47,Moyen,Moyen,0,Meme Difficulté,Pas Adapte,Sociology
4440,2018,Sociologie,4,Notions de Sociologie,2,Structure et Classes Sociales,6,1069,2,QCM,0.02,0.89,81.43,41,9,50,45,41,4,1.11,91.11,Moyen,Facile,1,Plus Facile,Pas Adapte,Sociology
5564,2019,Sociologie,4,Notions de Sociologie,2,Structure et Classes Sociales,6,1069,2,QCM,0.1,0.85,87.65,41,6,47,43,41,2,1.09,95.35,Facile,Facile,0,Meme Difficulté,Pas Adapte,Sociology
6688,2020,Sociologie,4,Notions de Sociologie,2,Structure et Classes Sociales,6,1069,2,QCM,0.08,0.91,99.17,52,0,52,52,52,0,1.0,100.0,Difficile,Facile,2,Beaucoup plus Facile,Pas Adapte,Sociology
1069,2015,Sociologie,4,Notions de Sociologie,2,Structure et Classes Sociales,6,1070,3,QCU,0.54,0.22,32.06,31,67,98,43,31,12,2.28,72.09,Moyen,Difficile,-1,Plus Difficile,Pas Adapte,Sociology
2193,2016,Sociologie,4,Notions de Sociologie,2,Structure et Classes Sociales,6,1070,3,QCU,0.03,0.82,77.68,72,21,93,72,72,0,1.29,100.0,Moyen,Facile,1,Plus Facile,Pas Adapte,Sociology
3317,2017,Sociologie,4,Notions de Sociologie,2,Structure et Classes Sociales,6,1070,3,QCU,0.51,0.35,28.22,22,57,79,69,22,47,1.14,31.88,Facile,Difficile,-2,Beaucoup plus Difficile,Pas Adapte,Sociology
4441,2018,Sociologie,4,Notions de Sociologie,2,Structure et Classes Sociales,6,1070,3,QCU,0.37,0.5,55.75,37,30,67,47,37,10,1.43,78.72,Moyen,Moyen,0,Meme Difficulté,Pas Adapte,Sociology
5565,2019,Sociologie,4,Notions de Sociologie,2,Structure et Classes Sociales,6,1070,3,QCU,0.25,0.71,52.94,34,30,64,36,34,2,1.78,94.44,Moyen,Moyen,0,Meme Difficulté,Pas Adapte,Sociology
6689,2020,Sociologie,4,Notions de Sociologie,2,Structure et Classes Sociales,6,1070,3,QCU,0.05,0.82,78.2,45,12,57,51,45,6,1.12,88.24,Difficile,Facile,2,Beaucoup plus Facile,Pas Adapte,Sociology
1070,2015,Sociologie,4,Notions de Sociologie,2,Structure et Classes Sociales,6,1071,4,QCM,0.51,0.19,27.9,14,37,51,48,14,34,1.06,29.17,Difficile,Difficile,0,Meme Difficulté,Pas Adapte,Sociology
2194,2016,Sociologie,4,Notions de Sociologie,2,Structure et Classes Sociales,6,1071,4,QCM,0.49,0.64,43.32,19,25,44,23,19,4,1.91,82.61,Moyen,Moyen,0,Meme Difficulté,Pas Adapte,Sociology
3318,2017,Sociologie,4,Notions de Sociologie,2,Structure et Classes Sociales,6,1071,4,QCU,0.18,0.94,89.23,42,5,47,43,42,1,1.09,97.67,Difficile,Facile,2,Beaucoup plus Facile,Pas Adapte,Sociology
4442,2018,Sociologie,4,Notions de Sociologie,2,Structure et Classes Sociales,6,1071,4,QCU,0.25,0.65,50.22,26,26,52,40,26,14,1.3,65.0,Facile,Moyen,-1,Plus Difficile,Pas Adapte,Sociology
5566,2019,Sociologie,4,Notions de Sociologie,2,Structure et Classes Sociales,6,1071,4,QCU,0.22,0.51,38.95,18,29,47,22,18,4,2.14,81.82,Facile,Moyen,-1,Plus Difficile,Pas Adapte,Sociology
6690,2020,Sociologie,4,Notions de Sociologie,2,Structure et Classes Sociales,6,1071,4,QCU,0.27,0.48,43.05,23,31,54,52,23,29,1.04,44.23,Facile,Moyen,-1,Plus Difficile,Pas Adapte,Sociology
1071,2015,Sociologie,4,Notions de Sociologie,2,Structure et Classes Sociales,6,1072,5,QCM,0.47,0.31,57.15,50,37,87,53,50,3,1.64,94.34,Moyen,Moyen,0,Meme Difficulté,Pas Adapte,Sociology
2195,2016,Sociologie,4,Notions de Sociologie,2,Structure et Classes Sociales,6,1072,5,QCM,0.66,0.23,16.48,16,82,98,85,16,69,1.15,18.82,Moyen,Difficile,-1,Plus Difficile,Pas Adapte,Sociology
3319,2017,Sociologie,4,Notions de Sociologie,2,Structure et Classes Sociales,6,1072,5,QCM,0.21,0.53,62.69,57,34,91,72,57,15,1.26,79.17,Difficile,Moyen,1,Plus Facile,Adapte,Sociology
4443,2018,Sociologie,4,Notions de Sociologie,2,Structure et Classes Sociales,6,1072,5,QCM,0.38,0.69,62.69,61,36,97,78,61,17,1.24,78.21,Moyen,Moyen,0,Meme Difficulté,Adapte,Sociology
5567,2019,Sociologie,4,Notions de Sociologie,2,Structure et Classes Sociales,6,1072,5,QCM,0.39,0.69,62.69,58,34,92,89,58,31,1.03,65.17,Moyen,Moyen,0,Meme Difficulté,Adapte,Sociology
6691,2020,Sociologie,4,Notions de Sociologie,2,Structure et Classes Sociales,6,1072,5,QCM,0.36,0.63,62.69,50,29,79,61,50,11,1.3,81.97,Moyen,Moyen,0,Meme Difficulté,Adapte,Sociology
1072,2015,Sociologie,4,Notions de Sociologie,2,Structure et Classes Sociales,6,1073,6,QCM,0.13,0.96,89.22,21,3,24,22,21,1,1.09,95.45,Moyen,Facile,1,Plus Facile,Pas Adapte,Sociology
2196,2016,Sociologie,4,Notions de Sociologie,2,Structure et Classes Sociales,6,1073,6,QCM,0.27,0.36,48.09,11,11,22,22,11,11,1.0,50.0,Moyen,Moyen,0,Meme Difficulté,Pas Adapte,Sociology
3320,2017,Sociologie,4,Notions de Sociologie,2,Structure et Classes Sociales,6,1073,6,QCM,0.01,0.9,87.8,21,3,24,23,21,2,1.04,91.3,Facile,Facile,0,Meme Difficulté,Pas Adapte,Sociology
4444,2018,Sociologie,4,Notions de Sociologie,2,Structure et Classes Sociales,6,1073,6,QCM,0.64,0.23,34.85,8,16,24,23,8,15,1.04,34.78,Moyen,Difficile,-1,Plus Difficile,Pas Adapte,Sociology
5568,2019,Sociologie,4,Notions de Sociologie,2,Structure et Classes Sociales,6,1073,6,QCM,0.61,0.22,4.45,1,20,21,12,1,11,1.75,8.33,Moyen,Difficile,-1,Plus Difficile,Pas Adapte,Sociology
6692,2020,Sociologie,4,Notions de Sociologie,2,Structure et Classes Sociales,6,1073,6,QCM,0.04,0.73,75.68,17,5,22,18,17,1,1.22,94.44,Difficile,Facile,2,Beaucoup plus Facile,Pas Adapte,Sociology
1073,2015,Sociologie,4,Notions de Sociologie,3,Organisation et Institution,11,1074,1,QCU,0.03,0.95,80.29,66,16,82,69,66,3,1.19,95.65,Moyen,Facile,1,Plus Facile,Pas Adapte,Sociology
2197,2016,Sociologie,4,Notions de Sociologie,3,Organisation et Institution,11,1074,1,QCU,0.57,0.23,8.72,7,70,77,42,7,35,1.83,16.67,Facile,Difficile,-2,Beaucoup plus Difficile,Pas Adapte,Sociology
3321,2017,Sociologie,4,Notions de Sociologie,3,Organisation et Institution,11,1074,1,QCM,0.17,0.81,66.97,50,24,74,66,50,16,1.12,75.76,Difficile,Facile,2,Beaucoup plus Facile,Adapte,Sociology
4445,2018,Sociologie,4,Notions de Sociologie,3,Organisation et Institution,11,1074,1,QCM,0.05,0.77,66.97,51,25,76,53,51,2,1.43,96.23,Facile,Facile,0,Meme Difficulté,Adapte,Sociology
5569,2019,Sociologie,4,Notions de Sociologie,3,Organisation et Institution,11,1074,1,QCM,0.01,0.74,66.97,50,24,74,64,50,14,1.16,78.12,Facile,Facile,0,Meme Difficulté,Adapte,Sociology
6693,2020,Sociologie,4,Notions de Sociologie,3,Organisation et Institution,11,1074,1,QCM,0.13,0.71,66.97,52,26,78,70,52,18,1.11,74.29,Facile,Facile,0,Meme Difficulté,Adapte,Sociology
1074,2015,Sociologie,4,Notions de Sociologie,3,Organisation et Institution,11,1075,2,QROC,0.78,0.18,7.46,5,57,62,57,5,52,1.09,8.77,Difficile,Difficile,0,Meme Difficulté,Pas Adapte,Sociology
2198,2016,Sociologie,4,Notions de Sociologie,3,Organisation et Institution,11,1075,2,QROC,0.19,0.94,75.27,44,15,59,58,44,14,1.02,75.86,Difficile,Facile,2,Beaucoup plus Facile,Pas Adapte,Sociology
3322,2017,Sociologie,4,Notions de Sociologie,3,Organisation et Institution,11,1075,2,QCM,0.54,0.3,24.39,14,45,59,57,14,43,1.04,24.56,Facile,Difficile,-2,Beaucoup plus Difficile,Pas Adapte,Sociology
4446,2018,Sociologie,4,Notions de Sociologie,3,Organisation et Institution,11,1075,2,QCM,0.04,0.71,84.62,48,9,57,51,48,3,1.12,94.12,Moyen,Facile,1,Plus Facile,Pas Adapte,Sociology
5570,2019,Sociologie,4,Notions de Sociologie,3,Organisation et Institution,11,1075,2,QCM,0.13,0.82,72.44,42,16,58,49,42,7,1.18,85.71,Moyen,Facile,1,Plus Facile,Adapte,Sociology
6694,2020,Sociologie,4,Notions de Sociologie,3,Organisation et Institution,11,1075,2,QCM,0.12,0.94,72.44,40,15,55,47,40,7,1.17,85.11,Facile,Facile,0,Meme Difficulté,Adapte,Sociology
1075,2015,Sociologie,4,Notions de Sociologie,3,Organisation et Institution,11,1076,3,QCM,0.31,0.32,61.55,52,33,85,72,52,20,1.18,72.22,Moyen,Moyen,0,Meme Difficulté,Adapte,Sociology
2199,2016,Sociologie,4,Notions de Sociologie,3,Organisation et Institution,11,1076,3,QCM,0.26,0.69,61.55,56,35,91,74,56,18,1.23,75.68,Moyen,Moyen,0,Meme Difficulté,Adapte,Sociology
3323,2017,Sociologie,4,Notions de Sociologie,3,Organisation et Institution,11,1076,3,QCM,0.37,0.42,61.55,55,35,90,81,55,26,1.11,67.9,Moyen,Moyen,0,Meme Difficulté,Adapte,Sociology
4447,2018,Sociologie,4,Notions de Sociologie,3,Organisation et Institution,11,1076,3,QCU,0.23,0.67,61.55,49,30,79,76,49,27,1.04,64.47,Moyen,Moyen,0,Meme Difficulté,Adapte,Sociology
5571,2019,Sociologie,4,Notions de Sociologie,3,Organisation et Institution,11,1076,3,QCU,0.26,0.54,61.55,50,31,81,58,50,8,1.4,86.21,Moyen,Moyen,0,Meme Difficulté,Adapte,Sociology
6695,2020,Sociologie,4,Notions de Sociologie,3,Organisation et Institution,11,1076,3,QCU,0.35,0.7,61.55,46,28,74,73,46,27,1.01,63.01,Moyen,Moyen,0,Meme Difficulté,Adapte,Sociology
1076,2015,Sociologie,4,Notions de Sociologie,3,Organisation et Institution,11,1077,4,QROC,0.36,0.38,35.37,8,15,23,16,8,8,1.44,50.0,Facile,Moyen,-1,Plus Difficile,Pas Adapte,Sociology
2200,2016,Sociologie,4,Notions de Sociologie,3,Organisation et Institution,11,1077,4,QROC,0.07,0.45,77.28,19,6,25,24,19,5,1.04,79.17,Difficile,Facile,2,Beaucoup plus Facile,Pas Adapte,Sociology
3324,2017,Sociologie,4,Notions de Sociologie,3,Organisation et Institution,11,1077,4,QROC,0.0,0.64,84.68,23,4,27,26,23,3,1.04,88.46,Moyen,Facile,1,Plus Facile,Pas Adapte,Sociology
4448,2018,Sociologie,4,Notions de Sociologie,3,Organisation et Institution,11,1077,4,QROC,0.03,0.82,76.29,18,5,23,19,18,1,1.21,94.74,Facile,Facile,0,Meme Difficulté,Pas Adapte,Sociology
5572,2019,Sociologie,4,Notions de Sociologie,3,Organisation et Institution,11,1077,4,QROC,0.98,0.25,31.39,7,14,21,17,7,10,1.24,41.18,Facile,Difficile,-2,Beaucoup plus Difficile,Pas Adapte,Sociology
6696,2020,Sociologie,4,Notions de Sociologie,3,Organisation et Institution,11,1077,4,QCM,0.64,0.23,4.4,1,22,23,10,1,9,2.3,10.0,Difficile,Difficile,0,Meme Difficulté,Pas Adapte,Sociology
1077,2015,Sociologie,4,Notions de Sociologie,3,Organisation et Institution,11,1078,5,QCU,0.05,0.89,87.25,42,6,48,44,42,2,1.09,95.45,Moyen,Facile,1,Plus Facile,Pas Adapte,Sociology
2201,2016,Sociologie,4,Notions de Sociologie,3,Organisation et Institution,11,1078,5,QCU,0.3,0.67,41.29,17,24,41,35,17,18,1.17,48.57,Difficile,Moyen,1,Plus Facile,Pas Adapte,Sociology
3325,2017,Sociologie,4,Notions de Sociologie,3,Organisation et Institution,11,1078,5,QCM,0.67,0.27,1.66,1,37,38,15,1,14,2.53,6.67,Difficile,Difficile,0,Meme Difficulté,Pas Adapte,Sociology
4449,2018,Sociologie,4,Notions de Sociologie,3,Organisation et Institution,11,1078,5,QCM,0.74,0.15,7.96,3,36,39,17,3,14,2.29,17.65,Moyen,Difficile,-1,Plus Difficile,Pas Adapte,Sociology
5573,2019,Sociologie,4,Notions de Sociologie,3,Organisation et Institution,11,1078,5,QCU,0.48,0.26,24.46,9,26,35,34,9,25,1.03,26.47,Facile,Difficile,-2,Beaucoup plus Difficile,Pas Adapte,Sociology
6697,2020,Sociologie,4,Notions de Sociologie,3,Organisation et Institution,11,1078,5,QCU,0.07,0.76,78.81,31,8,39,33,31,2,1.18,93.94,Facile,Facile,0,Meme Difficulté,Pas Adapte,Sociology
1078,2015,Sociologie,4,Notions de Sociologie,3,Organisation et Institution,11,1079,6,QCU,0.38,0.41,60.87,60,39,99,87,60,27,1.14,68.97,Difficile,Moyen,1,Plus Facile,Adapte,Sociology
2202,2016,Sociologie,4,Notions de Sociologie,3,Organisation et Institution,11,1079,6,QCU,0.21,0.53,60.87,52,33,85,59,52,7,1.44,88.14,Moyen,Moyen,0,Meme Difficulté,Adapte,Sociology
3326,2017,Sociologie,4,Notions de Sociologie,3,Organisation et Institution,11,1079,6,QCU,0.34,0.5,60.87,51,32,83,52,51,1,1.6,98.08,Moyen,Moyen,0,Meme Difficulté,Adapte,Sociology
4450,2018,Sociologie,4,Notions de Sociologie,3,Organisation et Institution,11,1079,6,QCM,0.27,0.57,60.87,54,34,88,55,54,1,1.6,98.18,Moyen,Moyen,0,Meme Difficulté,Adapte,Sociology
5574,2019,Sociologie,4,Notions de Sociologie,3,Organisation et Institution,11,1079,6,QCM,0.45,0.61,60.87,57,36,93,90,57,33,1.03,63.33,Moyen,Moyen,0,Meme Difficulté,Adapte,Sociology
6698,2020,Sociologie,4,Notions de Sociologie,3,Organisation et Institution,11,1079,6,QCM,0.34,0.48,60.87,48,31,79,73,48,25,1.08,65.75,Moyen,Moyen,0,Meme Difficulté,Adapte,Sociology
1079,2015,Sociologie,4,Notions de Sociologie,3,Organisation et Institution,11,1080,7,QROC,0.86,0.07,2.15,1,62,63,36,1,35,1.75,2.78,Moyen,Difficile,-1,Plus Difficile,Pas Adapte,Sociology
2203,2016,Sociologie,4,Notions de Sociologie,3,Organisation et Institution,11,1080,7,QROC,0.38,0.3,51.16,31,30,61,36,31,5,1.69,86.11,Difficile,Moyen,1,Plus Facile,Pas Adapte,Sociology
3327,2017,Sociologie,4,Notions de Sociologie,3,Organisation et Institution,11,1080,7,QROC,0.99,0.02,23.9,14,46,60,56,14,42,1.07,25.0,Moyen,Difficile,-1,Plus Difficile,Pas Adapte,Sociology
4451,2018,Sociologie,4,Notions de Sociologie,3,Organisation et Institution,11,1080,7,QROC,0.97,0.21,27.88,16,43,59,46,16,30,1.28,34.78,Facile,Difficile,-2,Beaucoup plus Difficile,Pas Adapte,Sociology
5575,2019,Sociologie,4,Notions de Sociologie,3,Organisation et Institution,11,1080,7,QROC,0.04,0.65,98.06,61,1,62,62,61,1,1.0,98.39,Facile,Facile,0,Meme Difficulté,Pas Adapte,Sociology
6699,2020,Sociologie,4,Notions de Sociologie,3,Organisation et Institution,11,1080,7,QCM,0.09,0.92,93.08,51,4,55,54,51,3,1.02,94.44,Moyen,Facile,1,Plus Facile,Pas Adapte,Sociology
1080,2015,Sociologie,4,Notions de Sociologie,3,Organisation et Institution,11,1081,8,QCM,0.6,0.3,7.61,2,18,20,8,2,6,2.5,25.0,Facile,Difficile,-2,Beaucoup plus Difficile,Pas Adapte,Sociology
2204,2016,Sociologie,4,Notions de Sociologie,3,Organisation et Institution,11,1081,8,QCM,0.04,0.83,96.96,18,1,19,19,18,1,1.0,94.74,Facile,Facile,0,Meme Difficulté,Pas Adapte,Sociology
3328,2017,Sociologie,4,Notions de Sociologie,3,Organisation et Institution,11,1081,8,QCM,0.04,0.79,79.69,16,4,20,17,16,1,1.18,94.12,Facile,Facile,0,Meme Difficulté,Pas Adapte,Sociology
4452,2018,Sociologie,4,Notions de Sociologie,3,Organisation et Institution,11,1081,8,QROC,0.37,0.32,36.13,8,14,22,20,8,12,1.1,40.0,Difficile,Moyen,1,Plus Facile,Pas Adapte,Sociology
5576,2019,Sociologie,4,Notions de Sociologie,3,Organisation et Institution,11,1081,8,QROC,0.4,0.26,39.91,9,13,22,20,9,11,1.1,45.0,Facile,Moyen,-1,Plus Difficile,Pas Adapte,Sociology
6700,2020,Sociologie,4,Notions de Sociologie,3,Organisation et Institution,11,1081,8,QCM,0.04,0.86,93.94,19,1,20,20,19,1,1.0,95.0,Moyen,Facile,1,Plus Facile,Pas Adapte,Sociology
1081,2015,Sociologie,4,Notions de Sociologie,3,Organisation et Institution,11,1082,9,QCU,0.49,0.35,16.61,15,74,89,75,15,60,1.19,20.0,Facile,Difficile,-2,Beaucoup plus Difficile,Pas Adapte,Sociology
2205,2016,Sociologie,4,Notions de Sociologie,3,Organisation et Institution,11,1082,9,QCU,0.05,1.0,87.12,83,12,95,83,83,0,1.14,100.0,Moyen,Facile,1,Plus Facile,Pas Adapte,Sociology
3329,2017,Sociologie,4,Notions de Sociologie,3,Organisation et Institution,11,1082,9,QCU,0.36,0.53,35.38,36,67,103,51,36,15,2.02,70.59,Difficile,Moyen,1,Plus Facile,Pas Adapte,Sociology
4453,2018,Sociologie,4,Notions de Sociologie,3,Organisation et Institution,11,1082,9,QCU,0.52,0.26,18.32,17,77,94,72,17,55,1.31,23.61,Facile,Difficile,-2,Beaucoup plus Difficile,Pas Adapte,Sociology
5577,2019,Sociologie,4,Notions de Sociologie,3,Organisation et Institution,11,1082,9,QCU,0.07,0.93,88.95,80,10,90,84,80,4,1.07,95.24,Difficile,Facile,2,Beaucoup plus Facile,Pas Adapte,Sociology
6701,2020,Sociologie,4,Notions de Sociologie,3,Organisation et Institution,11,1082,9,QCU,0.55,0.21,17.95,15,71,86,41,15,26,2.1,36.59,Facile,Difficile,-2,Beaucoup plus Difficile,Pas Adapte,Sociology
1082,2015,Sociologie,4,Notions de Sociologie,3,Organisation et Institution,11,1083,10,QCU,0.02,0.76,94.8,48,3,51,48,48,0,1.06,100.0,Difficile,Facile,2,Beaucoup plus Facile,Pas Adapte,Sociology
2206,2016,Sociologie,4,Notions de Sociologie,3,Organisation et Institution,11,1083,10,QCU,0.38,0.62,53.8,32,27,59,54,32,22,1.09,59.26,Difficile,Moyen,1,Plus Facile,Pas Adapte,Sociology
3330,2017,Sociologie,4,Notions de Sociologie,3,Organisation et Institution,11,1083,10,QCU,0.05,0.83,73.34,37,14,51,37,37,0,1.38,100.0,Moyen,Facile,1,Plus Facile,Adapte,Sociology
4454,2018,Sociologie,4,Notions de Sociologie,3,Organisation et Institution,11,1083,10,QROC,0.16,0.98,73.34,40,14,54,41,40,1,1.32,97.56,Facile,Facile,0,Meme Difficulté,Adapte,Sociology
5578,2019,Sociologie,4,Notions de Sociologie,3,Organisation et Institution,11,1083,10,QROC,0.04,0.8,73.34,43,16,59,50,43,7,1.18,86.0,Facile,Facile,0,Meme Difficulté,Adapte,Sociology
6702,2020,Sociologie,4,Notions de Sociologie,3,Organisation et Institution,11,1083,10,QROC,0.15,0.91,73.34,39,14,53,50,39,11,1.06,78.0,Facile,Facile,0,Meme Difficulté,Adapte,Sociology
1083,2015,Sociologie,4,Notions de Sociologie,3,Organisation et Institution,11,1084,11,QCM,0.37,0.35,50.67,41,39,80,58,41,17,1.38,70.69,Difficile,Moyen,1,Plus Facile,Pas Adapte,Sociology
2207,2016,Sociologie,4,Notions de Sociologie,3,Organisation et Institution,11,1084,11,QCM,0.23,0.38,41.6,38,53,91,53,38,15,1.72,71.7,Moyen,Moyen,0,Meme Difficulté,Pas Adapte,Sociology
3331,2017,Sociologie,4,Notions de Sociologie,3,Organisation et Institution,11,1084,11,QCU,0.05,0.92,92.58,88,7,95,91,88,3,1.04,96.7,Facile,Facile,0,Meme Difficulté,Pas Adapte,Sociology
4455,2018,Sociologie,4,Notions de Sociologie,3,Organisation et Institution,11,1084,11,QCU,0.7,0.22,12.43,13,95,108,53,13,40,2.04,24.53,Facile,Difficile,-2,Beaucoup plus Difficile,Pas Adapte,Sociology
5579,2019,Sociologie,4,Notions de Sociologie,3,Organisation et Institution,11,1084,11,QCU,0.52,0.26,31.17,31,67,98,96,31,65,1.02,32.29,Facile,Difficile,-2,Beaucoup plus Difficile,Pas Adapte,Sociology
6703,2020,Sociologie,4,Notions de Sociologie,3,Organisation et Institution,11,1084,11,QCU,0.06,0.77,88.9,88,11,99,97,88,9,1.02,90.72,Difficile,Facile,2,Beaucoup plus Facile,Pas Adapte,Sociology
1084,2015,Sociologie,4,Notions de Sociologie,4,La Socialisation,4,1085,1,QCU,0.17,0.76,90.53,5,1,6,6,5,1,1.0,83.33,Moyen,Facile,1,Plus Facile,Pas Adapte,Sociology
2208,2016,Sociologie,4,Notions de Sociologie,4,La Socialisation,4,1085,1,QO,0.11,0.5,80.28,4,1,5,5,4,1,1.0,80.0,Difficile,Facile,2,Beaucoup plus Facile,Pas Adapte,Sociology
3332,2017,Sociologie,4,Notions de Sociologie,4,La Socialisation,4,1085,1,QO,0.11,0.98,94.62,4,0,4,4,4,0,1.0,100.0,Facile,Facile,0,Meme Difficulté,Pas Adapte,Sociology
4456,2018,Sociologie,4,Notions de Sociologie,4,La Socialisation,4,1085,1,QO,0.19,0.75,72.59,2,1,3,2,2,0,1.5,100.0,Difficile,Facile,2,Beaucoup plus Facile,Adapte,Sociology
5580,2019,Sociologie,4,Notions de Sociologie,4,La Socialisation,4,1085,1,QO,0.05,0.3,72.59,2,1,3,3,2,1,1.0,66.67,Facile,Facile,0,Meme Difficulté,Adapte,Sociology
6704,2020,Sociologie,4,Notions de Sociologie,4,La Socialisation,4,1085,1,QO,0.03,0.87,72.59,2,1,3,2,2,0,1.5,100.0,Facile,Facile,0,Meme Difficulté,Adapte,Sociology
1085,2015,Sociologie,4,Notions de Sociologie,4,La Socialisation,4,1086,2,QCM,0.05,0.73,86.34,21,3,24,22,21,1,1.09,95.45,Moyen,Facile,1,Plus Facile,Pas Adapte,Sociology
2209,2016,Sociologie,4,Notions de Sociologie,4,La Socialisation,4,1086,2,QCU,0.38,0.45,58.34,16,12,28,26,16,10,1.08,61.54,Difficile,Moyen,1,Plus Facile,Pas Adapte,Sociology
3333,2017,Sociologie,4,Notions de Sociologie,4,La Socialisation,4,1086,2,QCU,0.61,0.37,1.1,0,32,32,19,0,19,1.68,0.0,Difficile,Difficile,0,Meme Difficulté,Pas Adapte,Sociology
4457,2018,Sociologie,4,Notions de Sociologie,4,La Socialisation,4,1086,2,QCU,0.26,0.55,57.16,20,15,35,29,20,9,1.21,68.97,Difficile,Moyen,1,Plus Facile,Pas Adapte,Sociology
5581,2019,Sociologie,4,Notions de Sociologie,4,La Socialisation,4,1086,2,QCU,0.18,0.86,91.57,37,3,40,38,37,1,1.05,97.37,Difficile,Facile,2,Beaucoup plus Facile,Pas Adapte,Sociology
6705,2020,Sociologie,4,Notions de Sociologie,4,La Socialisation,4,1086,2,QCU,0.46,0.29,17.68,7,33,40,17,7,10,2.35,41.18,Moyen,Difficile,-1,Plus Difficile,Pas Adapte,Sociology
1086,2015,Sociologie,4,Notions de Sociologie,4,La Socialisation,4,1087,3,QROC,0.43,0.28,49.21,23,23,46,24,23,1,1.92,95.83,Facile,Moyen,-1,Plus Difficile,Pas Adapte,Sociology
2210,2016,Sociologie,4,Notions de Sociologie,4,La Socialisation,4,1087,3,QCM,0.1,0.7,87.07,34,5,39,36,34,2,1.08,94.44,Difficile,Facile,2,Beaucoup plus Facile,Pas Adapte,Sociology
3334,2017,Sociologie,4,Notions de Sociologie,4,La Socialisation,4,1087,3,QCU,0.38,0.51,58.79,21,15,36,25,21,4,1.44,84.0,Difficile,Moyen,1,Plus Facile,Pas Adapte,Sociology
4458,2018,Sociologie,4,Notions de Sociologie,4,La Socialisation,4,1087,3,QCU,0.2,0.7,64.51,23,13,36,26,23,3,1.38,88.46,Difficile,Moyen,1,Plus Facile,Adapte,Sociology
5582,2019,Sociologie,4,Notions de Sociologie,4,La Socialisation,4,1087,3,QCU,0.33,0.41,64.51,25,13,38,30,25,5,1.27,83.33,Moyen,Moyen,0,Meme Difficulté,Adapte,Sociology
6706,2020,Sociologie,4,Notions de Sociologie,4,La Socialisation,4,1087,3,QCU,0.24,0.43,64.51,26,14,40,36,26,10,1.11,72.22,Moyen,Moyen,0,Meme Difficulté,Adapte,Sociology
1087,2015,Sociologie,4,Notions de Sociologie,4,La Socialisation,4,1088,4,QCM,0.53,0.19,10.66,7,63,70,31,7,24,2.26,22.58,Difficile,Difficile,0,Meme Difficulté,Pas Adapte,Sociology
2211,2016,Sociologie,4,Notions de Sociologie,4,La Socialisation,4,1088,4,QCU,0.01,0.99,99.71,60,0,60,60,60,0,1.0,100.0,Difficile,Facile,2,Beaucoup plus Facile,Pas Adapte,Sociology
3335,2017,Sociologie,4,Notions de Sociologie,4,La Socialisation,4,1088,4,QCU,0.02,0.93,99.99,58,0,58,58,58,0,1.0,100.0,Moyen,Facile,1,Plus Facile,Pas Adapte,Sociology
4459,2018,Sociologie,4,Notions de Sociologie,4,La Socialisation,4,1088,4,QCU,0.36,0.74,61.62,36,23,59,36,36,0,1.64,100.0,Difficile,Moyen,1,Plus Facile,Adapte,Sociology
5583,2019,Sociologie,4,Notions de Sociologie,4,La Socialisation,4,1088,4,QCU,0.23,0.54,61.62,38,24,62,44,38,6,1.41,86.36,Moyen,Moyen,0,Meme Difficulté,Adapte,Sociology
6707,2020,Sociologie,4,Notions de Sociologie,4,La Socialisation,4,1088,4,QCU,0.21,0.66,61.62,39,24,63,44,39,5,1.43,88.64,Moyen,Moyen,0,Meme Difficulté,Adapte,Sociology
1088,2015,Sociologie,4,Notions de Sociologie,5,Au-dela de l'Idee de Societe,10,1089,1,QCM,0.18,0.78,88.8,79,10,89,88,79,9,1.01,89.77,Facile,Facile,0,Meme Difficulté,Pas Adapte,Sociology
2212,2016,Sociologie,4,Notions de Sociologie,5,Au-dela de l'Idee de Societe,10,1089,1,QCM,0.79,0.19,2.94,2,81,83,60,2,58,1.38,3.33,Difficile,Difficile,0,Meme Difficulté,Pas Adapte,Sociology
3336,2017,Sociologie,4,Notions de Sociologie,5,Au-dela de l'Idee de Societe,10,1089,1,QCM,0.76,0.21,12.36,10,67,77,40,10,30,1.93,25.0,Moyen,Difficile,-1,Plus Difficile,Pas Adapte,Sociology
4460,2018,Sociologie,4,Notions de Sociologie,5,Au-dela de l'Idee de Societe,10,1089,1,QCU,0.04,0.93,70.44,60,25,85,62,60,2,1.37,96.77,Facile,Facile,0,Meme Difficulté,Adapte,Sociology
5584,2019,Sociologie,4,Notions de Sociologie,5,Au-dela de l'Idee de Societe,10,1089,1,QCU,0.07,0.98,70.44,54,22,76,56,54,2,1.36,96.43,Facile,Facile,0,Meme Difficulté,Adapte,Sociology
6708,2020,Sociologie,4,Notions de Sociologie,5,Au-dela de l'Idee de Societe,10,1089,1,QCU,0.08,0.97,70.44,56,23,79,66,56,10,1.2,84.85,Facile,Facile,0,Meme Difficulté,Adapte,Sociology
1089,2015,Sociologie,4,Notions de Sociologie,5,Au-dela de l'Idee de Societe,10,1090,2,QCU,0.25,0.75,50.34,35,35,70,43,35,8,1.63,81.4,Difficile,Moyen,1,Plus Facile,Pas Adapte,Sociology
2213,2016,Sociologie,4,Notions de Sociologie,5,Au-dela de l'Idee de Societe,10,1090,2,QCU,0.46,0.21,4.91,3,67,70,41,3,38,1.71,7.32,Difficile,Difficile,0,Meme Difficulté,Pas Adapte,Sociology
3337,2017,Sociologie,4,Notions de Sociologie,5,Au-dela de l'Idee de Societe,10,1090,2,QCU,0.13,0.91,70.89,57,23,80,76,57,19,1.05,75.0,Difficile,Facile,2,Beaucoup plus Facile,Adapte,Sociology
4461,2018,Sociologie,4,Notions de Sociologie,5,Au-dela de l'Idee de Societe,10,1090,2,QCM,0.04,0.78,70.89,57,23,80,69,57,12,1.16,82.61,Facile,Facile,0,Meme Difficulté,Adapte,Sociology
5585,2019,Sociologie,4,Notions de Sociologie,5,Au-dela de l'Idee de Societe,10,1090,2,QCM,0.13,0.98,70.89,50,21,71,56,50,6,1.27,89.29,Facile,Facile,0,Meme Difficulté,Adapte,Sociology
6709,2020,Sociologie,4,Notions de Sociologie,5,Au-dela de l'Idee de Societe,10,1090,2,QCM,0.2,0.8,70.89,57,23,80,67,57,10,1.19,85.07,Facile,Facile,0,Meme Difficulté,Adapte,Sociology
1090,2015,Sociologie,4,Notions de Sociologie,5,Au-dela de l'Idee de Societe,10,1091,3,QCU,0.13,0.92,77.69,33,10,43,41,33,8,1.05,80.49,Facile,Facile,0,Meme Difficulté,Pas Adapte,Sociology
2214,2016,Sociologie,4,Notions de Sociologie,5,Au-dela de l'Idee de Societe,10,1091,3,QCU,0.34,0.72,49.66,21,21,42,22,21,1,1.91,95.45,Difficile,Moyen,1,Plus Facile,Pas Adapte,Sociology
3338,2017,Sociologie,4,Notions de Sociologie,5,Au-dela de l'Idee de Societe,10,1091,3,QCU,0.66,0.25,31.26,12,27,39,36,12,24,1.08,33.33,Facile,Difficile,-2,Beaucoup plus Difficile,Pas Adapte,Sociology
4462,2018,Sociologie,4,Notions de Sociologie,5,Au-dela de l'Idee de Societe,10,1091,3,QCU,0.66,0.29,4.54,1,32,33,32,1,31,1.03,3.12,Difficile,Difficile,0,Meme Difficulté,Pas Adapte,Sociology
5586,2019,Sociologie,4,Notions de Sociologie,5,Au-dela de l'Idee de Societe,10,1091,3,QCM,0.79,0.22,7.72,2,29,31,15,2,13,2.07,13.33,Moyen,Difficile,-1,Plus Difficile,Pas Adapte,Sociology
6710,2020,Sociologie,4,Notions de Sociologie,5,Au-dela de l'Idee de Societe,10,1091,3,QCM,0.1,0.7,85.68,27,4,31,28,27,1,1.11,96.43,Facile,Facile,0,Meme Difficulté,Pas Adapte,Sociology
1091,2015,Sociologie,4,Notions de Sociologie,5,Au-dela de l'Idee de Societe,10,1092,4,QROC,0.61,0.19,15.17,4,23,27,27,4,23,1.0,14.81,Facile,Difficile,-2,Beaucoup plus Difficile,Pas Adapte,Sociology
2215,2016,Sociologie,4,Notions de Sociologie,5,Au-dela de l'Idee de Societe,10,1092,4,QROC,0.16,0.4,88.52,27,3,30,30,27,3,1.0,90.0,Facile,Facile,0,Meme Difficulté,Pas Adapte,Sociology
3339,2017,Sociologie,4,Notions de Sociologie,5,Au-dela de l'Idee de Societe,10,1092,4,QROC,0.53,0.29,57.01,19,14,33,21,19,2,1.57,90.48,Moyen,Moyen,0,Meme Difficulté,Pas Adapte,Sociology
4463,2018,Sociologie,4,Notions de Sociologie,5,Au-dela de l'Idee de Societe,10,1092,4,QROC,0.57,0.25,46.83,18,20,38,20,18,2,1.9,90.0,Difficile,Moyen,1,Plus Facile,Pas Adapte,Sociology
5587,2019,Sociologie,4,Notions de Sociologie,5,Au-dela de l'Idee de Societe,10,1092,4,QROC,0.49,0.26,48.01,19,21,40,33,19,14,1.21,57.58,Moyen,Moyen,0,Meme Difficulté,Pas Adapte,Sociology
6711,2020,Sociologie,4,Notions de Sociologie,5,Au-dela de l'Idee de Societe,10,1092,4,QROC,0.65,0.18,17.32,6,31,37,20,6,14,1.85,30.0,Difficile,Difficile,0,Meme Difficulté,Pas Adapte,Sociology
1092,2015,Sociologie,4,Notions de Sociologie,5,Au-dela de l'Idee de Societe,10,1093,5,QCM,0.06,0.92,97.75,87,2,89,89,87,2,1.0,97.75,Facile,Facile,0,Meme Difficulté,Pas Adapte,Sociology
2216,2016,Sociologie,4,Notions de Sociologie,5,Au-dela de l'Idee de Societe,10,1093,5,QCM,0.05,0.99,79.21,60,16,76,67,60,7,1.13,89.55,Difficile,Facile,2,Beaucoup plus Facile,Pas Adapte,Sociology
3340,2017,Sociologie,4,Notions de Sociologie,5,Au-dela de l'Idee de Societe,10,1093,5,QCU,0.08,0.86,97.97,72,1,73,72,72,0,1.01,100.0,Facile,Facile,0,Meme Difficulté,Pas Adapte,Sociology
4464,2018,Sociologie,4,Notions de Sociologie,5,Au-dela de l'Idee de Societe,10,1093,5,QCU,0.67,0.32,14.23,9,57,66,54,9,45,1.22,16.67,Moyen,Difficile,-1,Plus Difficile,Pas Adapte,Sociology
5588,2019,Sociologie,4,Notions de Sociologie,5,Au-dela de l'Idee de Societe,10,1093,5,QCU,0.08,0.98,86.75,57,9,66,64,57,7,1.03,89.06,Facile,Facile,0,Meme Difficulté,Pas Adapte,Sociology
6712,2020,Sociologie,4,Notions de Sociologie,5,Au-dela de l'Idee de Societe,10,1093,5,QCU,0.46,0.27,25.97,15,42,57,31,15,16,1.84,48.39,Facile,Difficile,-2,Beaucoup plus Difficile,Pas Adapte,Sociology
1093,2015,Sociologie,4,Notions de Sociologie,5,Au-dela de l'Idee de Societe,10,1094,6,QROC,0.34,0.35,53.2,30,26,56,42,30,12,1.33,71.43,Difficile,Moyen,1,Plus Facile,Pas Adapte,Sociology
2217,2016,Sociologie,4,Notions de Sociologie,5,Au-dela de l'Idee de Societe,10,1094,6,QROC,0.99,0.06,17.81,9,43,52,41,9,32,1.27,21.95,Facile,Difficile,-2,Beaucoup plus Difficile,Pas Adapte,Sociology
3341,2017,Sociologie,4,Notions de Sociologie,5,Au-dela de l'Idee de Societe,10,1094,6,QROC,0.19,0.51,99.27,45,0,45,45,45,0,1.0,100.0,Moyen,Facile,1,Plus Facile,Pas Adapte,Sociology
4465,2018,Sociologie,4,Notions de Sociologie,5,Au-dela de l'Idee de Societe,10,1094,6,QO,0.79,0.05,5.41,2,39,41,21,2,19,1.95,9.52,Facile,Difficile,-2,Beaucoup plus Difficile,Pas Adapte,Sociology
5589,2019,Sociologie,4,Notions de Sociologie,5,Au-dela de l'Idee de Societe,10,1094,6,QO,0.15,0.91,96.65,43,1,44,43,43,0,1.02,100.0,Difficile,Facile,2,Beaucoup plus Facile,Pas Adapte,Sociology
6713,2020,Sociologie,4,Notions de Sociologie,5,Au-dela de l'Idee de Societe,10,1094,6,QO,0.66,0.19,38.33,20,31,51,33,20,13,1.55,60.61,Difficile,Moyen,1,Plus Facile,Pas Adapte,Sociology
1094,2015,Sociologie,4,Notions de Sociologie,5,Au-dela de l'Idee de Societe,10,1095,7,QO,0.64,0.16,52.39,19,17,36,24,19,5,1.5,79.17,Facile,Moyen,-1,Plus Difficile,Pas Adapte,Sociology
2218,2016,Sociologie,4,Notions de Sociologie,5,Au-dela de l'Idee de Societe,10,1095,7,QO,0.1,0.63,77.81,25,7,32,25,25,0,1.28,100.0,Difficile,Facile,2,Beaucoup plus Facile,Pas Adapte,Sociology
3342,2017,Sociologie,4,Notions de Sociologie,5,Au-dela de l'Idee de Societe,10,1095,7,QO,0.42,0.23,38.47,10,17,27,19,10,9,1.42,52.63,Difficile,Moyen,1,Plus Facile,Pas Adapte,Sociology
4466,2018,Sociologie,4,Notions de Sociologie,5,Au-dela de l'Idee de Societe,10,1095,7,QO,0.17,0.57,74.77,19,6,25,25,19,6,1.0,76.0,Facile,Facile,0,Meme Difficulté,Adapte,Sociology
5590,2019,Sociologie,4,Notions de Sociologie,5,Au-dela de l'Idee de Societe,10,1095,7,QCM,0.06,0.96,74.77,20,7,27,23,20,3,1.17,86.96,Facile,Facile,0,Meme Difficulté,Adapte,Sociology
6714,2020,Sociologie,4,Notions de Sociologie,5,Au-dela de l'Idee de Societe,10,1095,7,QCM,0.04,0.9,74.77,18,6,24,19,18,1,1.26,94.74,Facile,Facile,0,Meme Difficulté,Adapte,Sociology
1095,2015,Sociologie,4,Notions de Sociologie,5,Au-dela de l'Idee de Societe,10,1096,8,QCU,0.36,0.42,57.87,22,16,38,34,22,12,1.12,64.71,Moyen,Moyen,0,Meme Difficulté,Pas Adapte,Sociology
2219,2016,Sociologie,4,Notions de Sociologie,5,Au-dela de l'Idee de Societe,10,1096,8,QCU,0.43,0.24,33.23,12,24,36,20,12,8,1.8,60.0,Difficile,Difficile,0,Meme Difficulté,Pas Adapte,Sociology
3343,2017,Sociologie,4,Notions de Sociologie,5,Au-dela de l'Idee de Societe,10,1096,8,QCU,0.62,0.39,21.86,8,28,36,16,8,8,2.25,50.0,Facile,Difficile,-2,Beaucoup plus Difficile,Pas Adapte,Sociology
4467,2018,Sociologie,4,Notions de Sociologie,5,Au-dela de l'Idee de Societe,10,1096,8,QCU,0.54,0.38,30.28,10,23,33,25,10,15,1.32,40.0,Difficile,Difficile,0,Meme Difficulté,Pas Adapte,Sociology
5591,2019,Sociologie,4,Notions de Sociologie,5,Au-dela de l'Idee de Societe,10,1096,8,QCU,0.11,0.84,76.87,25,8,33,33,25,8,1.0,75.76,Moyen,Facile,1,Plus Facile,Pas Adapte,Sociology
6715,2020,Sociologie,4,Notions de Sociologie,5,Au-dela de l'Idee de Societe,10,1096,8,QO,0.88,0.07,14.5,5,32,37,37,5,32,1.0,13.51,Moyen,Difficile,-1,Plus Difficile,Pas Adapte,Sociology
1096,2015,Sociologie,4,Notions de Sociologie,5,Au-dela de l'Idee de Societe,10,1097,9,QCM,0.01,1.0,66.49,10,5,15,12,10,2,1.25,83.33,Difficile,Facile,2,Beaucoup plus Facile,Adapte,Sociology
2220,2016,Sociologie,4,Notions de Sociologie,5,Au-dela de l'Idee de Societe,10,1097,9,QCM,0.01,0.74,66.49,9,5,14,13,9,4,1.08,69.23,Facile,Facile,0,Meme Difficulté,Adapte,Sociology
3344,2017,Sociologie,4,Notions de Sociologie,5,Au-dela de l'Idee de Societe,10,1097,9,QROC,0.03,0.61,66.49,10,5,15,14,10,4,1.07,71.43,Facile,Facile,0,Meme Difficulté,Adapte,Sociology
4468,2018,Sociologie,4,Notions de Sociologie,5,Au-dela de l'Idee de Societe,10,1097,9,QROC,0.14,0.99,66.49,9,5,14,9,9,0,1.56,100.0,Facile,Facile,0,Meme Difficulté,Adapte,Sociology
5592,2019,Sociologie,4,Notions de Sociologie,5,Au-dela de l'Idee de Societe,10,1097,9,QROC,0.08,0.58,66.49,9,4,13,12,9,3,1.08,75.0,Facile,Facile,0,Meme Difficulté,Adapte,Sociology
6716,2020,Sociologie,4,Notions de Sociologie,5,Au-dela de l'Idee de Societe,10,1097,9,QROC,0.11,0.6,66.49,10,5,15,10,10,0,1.5,100.0,Facile,Facile,0,Meme Difficulté,Adapte,Sociology
1097,2015,Sociologie,4,Notions de Sociologie,5,Au-dela de l'Idee de Societe,10,1098,10,QCU,0.28,0.59,42.01,29,40,69,44,29,15,1.57,65.91,Moyen,Moyen,0,Meme Difficulté,Pas Adapte,Sociology
2221,2016,Sociologie,4,Notions de Sociologie,5,Au-dela de l'Idee de Societe,10,1098,10,QCU,0.02,0.77,96.57,62,2,64,62,62,0,1.03,100.0,Facile,Facile,0,Meme Difficulté,Pas Adapte,Sociology
3345,2017,Sociologie,4,Notions de Sociologie,5,Au-dela de l'Idee de Societe,10,1098,10,QCU,0.06,0.99,92.89,59,4,63,61,59,2,1.03,96.72,Difficile,Facile,2,Beaucoup plus Facile,Pas Adapte,Sociology
4469,2018,Sociologie,4,Notions de Sociologie,5,Au-dela de l'Idee de Societe,10,1098,10,QCU,0.45,0.24,22.89,16,52,68,56,16,40,1.21,28.57,Moyen,Difficile,-1,Plus Difficile,Pas Adapte,Sociology
5593,2019,Sociologie,4,Notions de Sociologie,5,Au-dela de l'Idee de Societe,10,1098,10,QCU,0.42,0.21,20.21,12,49,61,32,12,20,1.91,37.5,Facile,Difficile,-2,Beaucoup plus Difficile,Pas Adapte,Sociology
6717,2020,Sociologie,4,Notions de Sociologie,5,Au-dela de l'Idee de Societe,10,1098,10,QCU,0.68,0.22,14.82,8,46,54,36,8,28,1.5,22.22,Difficile,Difficile,0,Meme Difficulté,Pas Adapte,Sociology
1098,2015,Sociologie,5,Sociologie Generale,1,"Le Sociologue, la Sociologie et la Vie Sociale",6,1099,1,QCM,0.02,0.78,87.74,18,2,20,18,18,0,1.11,100.0,Difficile,Facile,2,Beaucoup plus Facile,Pas Adapte,Sociology
2222,2016,Sociologie,5,Sociologie Generale,1,"Le Sociologue, la Sociologie et la Vie Sociale",6,1099,1,QCM,0.06,0.89,88.01,18,3,21,21,18,3,1.0,85.71,Difficile,Facile,2,Beaucoup plus Facile,Pas Adapte,Sociology
3346,2017,Sociologie,5,Sociologie Generale,1,"Le Sociologue, la Sociologie et la Vie Sociale",6,1099,1,QCM,0.28,0.68,38.18,8,12,20,16,8,8,1.25,50.0,Moyen,Moyen,0,Meme Difficulté,Pas Adapte,Sociology
4470,2018,Sociologie,5,Sociologie Generale,1,"Le Sociologue, la Sociologie et la Vie Sociale",6,1099,1,QCM,0.13,0.8,96.33,16,1,17,17,16,1,1.0,94.12,Moyen,Facile,1,Plus Facile,Pas Adapte,Sociology
5594,2019,Sociologie,5,Sociologie Generale,1,"Le Sociologue, la Sociologie et la Vie Sociale",6,1099,1,QCM,0.09,0.79,95.39,13,1,14,14,13,1,1.0,92.86,Difficile,Facile,2,Beaucoup plus Facile,Pas Adapte,Sociology
6718,2020,Sociologie,5,Sociologie Generale,1,"Le Sociologue, la Sociologie et la Vie Sociale",6,1099,1,QCU,0.04,0.99,75.05,12,4,16,15,12,3,1.07,80.0,Difficile,Facile,2,Beaucoup plus Facile,Pas Adapte,Sociology
1099,2015,Sociologie,5,Sociologie Generale,1,"Le Sociologue, la Sociologie et la Vie Sociale",6,1100,2,QCU,0.14,0.8,72.16,69,27,96,74,69,5,1.3,93.24,Difficile,Facile,2,Beaucoup plus Facile,Adapte,Sociology
2223,2016,Sociologie,5,Sociologie Generale,1,"Le Sociologue, la Sociologie et la Vie Sociale",6,1100,2,QCM,0.11,0.75,72.16,63,24,87,76,63,13,1.14,82.89,Facile,Facile,0,Meme Difficulté,Adapte,Sociology
3347,2017,Sociologie,5,Sociologie Generale,1,"Le Sociologue, la Sociologie et la Vie Sociale",6,1100,2,QCM,0.18,0.88,72.16,66,25,91,73,66,7,1.25,90.41,Facile,Facile,0,Meme Difficulté,Adapte,Sociology
4471,2018,Sociologie,5,Sociologie Generale,1,"Le Sociologue, la Sociologie et la Vie Sociale",6,1100,2,QCM,0.03,0.99,72.16,63,25,88,85,63,22,1.04,74.12,Facile,Facile,0,Meme Difficulté,Adapte,Sociology
5595,2019,Sociologie,5,Sociologie Generale,1,"Le Sociologue, la Sociologie et la Vie Sociale",6,1100,2,QCM,0.17,0.81,72.16,55,21,76,66,55,11,1.15,83.33,Facile,Facile,0,Meme Difficulté,Adapte,Sociology
6719,2020,Sociologie,5,Sociologie Generale,1,"Le Sociologue, la Sociologie et la Vie Sociale",6,1100,2,QCM,0.11,0.82,72.16,51,19,70,57,51,6,1.23,89.47,Facile,Facile,0,Meme Difficulté,Adapte,Sociology
1100,2015,Sociologie,5,Sociologie Generale,1,"Le Sociologue, la Sociologie et la Vie Sociale",6,1101,3,QCU,0.2,0.52,48.96,33,34,67,54,33,21,1.24,61.11,Difficile,Moyen,1,Plus Facile,Pas Adapte,Sociology
2224,2016,Sociologie,5,Sociologie Generale,1,"Le Sociologue, la Sociologie et la Vie Sociale",6,1101,3,QCU,0.59,0.34,28.06,19,49,68,32,19,13,2.12,59.38,Facile,Difficile,-2,Beaucoup plus Difficile,Pas Adapte,Sociology
3348,2017,Sociologie,5,Sociologie Generale,1,"Le Sociologue, la Sociologie et la Vie Sociale",6,1101,3,QCU,0.63,0.21,28.97,18,45,63,40,18,22,1.57,45.0,Moyen,Difficile,-1,Plus Difficile,Pas Adapte,Sociology
4472,2018,Sociologie,5,Sociologie Generale,1,"Le Sociologue, la Sociologie et la Vie Sociale",6,1101,3,QCU,0.69,0.23,32.46,21,43,64,46,21,25,1.39,45.65,Difficile,Difficile,0,Meme Difficulté,Pas Adapte,Sociology
5596,2019,Sociologie,5,Sociologie Generale,1,"Le Sociologue, la Sociologie et la Vie Sociale",6,1101,3,QCU,0.67,0.34,12.55,9,61,70,24,9,15,2.92,37.5,Moyen,Difficile,-1,Plus Difficile,Pas Adapte,Sociology
6720,2020,Sociologie,5,Sociologie Generale,1,"Le Sociologue, la Sociologie et la Vie Sociale",6,1101,3,QCU,0.12,0.91,91.61,62,6,68,67,62,5,1.01,92.54,Facile,Facile,0,Meme Difficulté,Pas Adapte,Sociology
1101,2015,Sociologie,5,Sociologie Generale,1,"Le Sociologue, la Sociologie et la Vie Sociale",6,1102,4,QROC,0.46,0.3,59.06,57,39,96,88,57,31,1.09,64.77,Facile,Moyen,-1,Plus Difficile,Pas Adapte,Sociology
2225,2016,Sociologie,5,Sociologie Generale,1,"Le Sociologue, la Sociologie et la Vie Sociale",6,1102,4,QROC,0.85,0.21,8.81,8,84,92,64,8,56,1.44,12.5,Moyen,Difficile,-1,Plus Difficile,Pas Adapte,Sociology
3349,2017,Sociologie,5,Sociologie Generale,1,"Le Sociologue, la Sociologie et la Vie Sociale",6,1102,4,QROC,0.38,0.4,46.99,50,56,106,58,50,8,1.83,86.21,Difficile,Moyen,1,Plus Facile,Pas Adapte,Sociology
4473,2018,Sociologie,5,Sociologie Generale,1,"Le Sociologue, la Sociologie et la Vie Sociale",6,1102,4,QROC,0.23,0.34,44.03,48,61,109,54,48,6,2.02,88.89,Facile,Moyen,-1,Plus Difficile,Pas Adapte,Sociology
5597,2019,Sociologie,5,Sociologie Generale,1,"Le Sociologue, la Sociologie et la Vie Sociale",6,1102,4,QROC,0.22,0.33,57.87,64,47,111,70,64,6,1.59,91.43,Difficile,Moyen,1,Plus Facile,Pas Adapte,Sociology
6721,2020,Sociologie,5,Sociologie Generale,1,"Le Sociologue, la Sociologie et la Vie Sociale",6,1102,4,QO,0.5,0.25,48.19,49,52,101,77,49,28,1.31,63.64,Moyen,Moyen,0,Meme Difficulté,Pas Adapte,Sociology
1102,2015,Sociologie,5,Sociologie Generale,1,"Le Sociologue, la Sociologie et la Vie Sociale",6,1103,5,QCU,0.31,0.62,45.92,18,21,39,23,18,5,1.7,78.26,Facile,Moyen,-1,Plus Difficile,Pas Adapte,Sociology
2226,2016,Sociologie,5,Sociologie Generale,1,"Le Sociologue, la Sociologie et la Vie Sociale",6,1103,5,QCU,0.61,0.24,8.65,4,38,42,35,4,31,1.2,11.43,Difficile,Difficile,0,Meme Difficulté,Pas Adapte,Sociology
3350,2017,Sociologie,5,Sociologie Generale,1,"Le Sociologue, la Sociologie et la Vie Sociale",6,1103,5,QROC,0.93,0.19,8.11,4,41,45,31,4,27,1.45,12.9,Moyen,Difficile,-1,Plus Difficile,Pas Adapte,Sociology
4474,2018,Sociologie,5,Sociologie Generale,1,"Le Sociologue, la Sociologie et la Vie Sociale",6,1103,5,QROC,0.11,0.53,68.58,29,14,43,33,29,4,1.3,87.88,Facile,Facile,0,Meme Difficulté,Adapte,Sociology
5598,2019,Sociologie,5,Sociologie Generale,1,"Le Sociologue, la Sociologie et la Vie Sociale",6,1103,5,QROC,0.09,0.58,68.58,29,13,42,41,29,12,1.02,70.73,Facile,Facile,0,Meme Difficulté,Adapte,Sociology
6722,2020,Sociologie,5,Sociologie Generale,1,"Le Sociologue, la Sociologie et la Vie Sociale",6,1103,5,QROC,0.1,0.64,68.58,29,13,42,31,29,2,1.35,93.55,Facile,Facile,0,Meme Difficulté,Adapte,Sociology
1103,2015,Sociologie,5,Sociologie Generale,1,"Le Sociologue, la Sociologie et la Vie Sociale",6,1104,6,QCU,0.64,0.28,18.83,8,37,45,20,8,12,2.25,40.0,Facile,Difficile,-2,Beaucoup plus Difficile,Pas Adapte,Sociology
2227,2016,Sociologie,5,Sociologie Generale,1,"Le Sociologue, la Sociologie et la Vie Sociale",6,1104,6,QCM,0.38,0.58,57.22,22,17,39,23,22,1,1.7,95.65,Facile,Moyen,-1,Plus Difficile,Pas Adapte,Sociology
3351,2017,Sociologie,5,Sociologie Generale,1,"Le Sociologue, la Sociologie et la Vie Sociale",6,1104,6,QCM,0.65,0.23,29.45,11,27,38,23,11,12,1.65,47.83,Facile,Difficile,-2,Beaucoup plus Difficile,Pas Adapte,Sociology
4475,2018,Sociologie,5,Sociologie Generale,1,"Le Sociologue, la Sociologie et la Vie Sociale",6,1104,6,QCM,0.38,0.5,64.39,24,14,38,37,24,13,1.03,64.86,Moyen,Moyen,0,Meme Difficulté,Adapte,Sociology
5599,2019,Sociologie,5,Sociologie Generale,1,"Le Sociologue, la Sociologie et la Vie Sociale",6,1104,6,QCM,0.24,0.52,64.39,26,15,41,31,26,5,1.32,83.87,Moyen,Moyen,0,Meme Difficulté,Adapte,Sociology
6723,2020,Sociologie,5,Sociologie Generale,1,"Le Sociologue, la Sociologie et la Vie Sociale",6,1104,6,QCM,0.21,0.38,64.39,26,15,41,31,26,5,1.32,83.87,Moyen,Moyen,0,Meme Difficulté,Adapte,Sociology
1104,2015,Sociologie,5,Sociologie Generale,2,La Theorie Sociologique,10,1105,1,QCU,0.19,0.9,84.09,62,12,74,66,62,4,1.12,93.94,Facile,Facile,0,Meme Difficulté,Pas Adapte,Sociology
2228,2016,Sociologie,5,Sociologie Generale,2,La Theorie Sociologique,10,1105,1,QCU,0.48,0.32,22.1,18,63,81,49,18,31,1.65,36.73,Moyen,Difficile,-1,Plus Difficile,Pas Adapte,Sociology
3352,2017,Sociologie,5,Sociologie Generale,2,La Theorie Sociologique,10,1105,1,QCU,0.07,0.99,94.61,78,4,82,79,78,1,1.04,98.73,Moyen,Facile,1,Plus Facile,Pas Adapte,Sociology
4476,2018,Sociologie,5,Sociologie Generale,2,La Theorie Sociologique,10,1105,1,QCU,0.06,0.76,90.23,72,8,80,78,72,6,1.03,92.31,Difficile,Facile,2,Beaucoup plus Facile,Pas Adapte,Sociology
5600,2019,Sociologie,5,Sociologie Generale,2,La Theorie Sociologique,10,1105,1,QCU,0.5,0.25,20.13,14,55,69,41,14,27,1.68,34.15,Facile,Difficile,-2,Beaucoup plus Difficile,Pas Adapte,Sociology
6724,2020,Sociologie,5,Sociologie Generale,2,La Theorie Sociologique,10,1105,1,QCU,0.42,0.34,10.08,6,53,59,28,6,22,2.11,21.43,Difficile,Difficile,0,Meme Difficulté,Pas Adapte,Sociology
1105,2015,Sociologie,5,Sociologie Generale,2,La Theorie Sociologique,10,1106,2,QROC,0.16,0.69,95.34,71,3,74,71,71,0,1.04,100.0,Facile,Facile,0,Meme Difficulté,Pas Adapte,Sociology
2229,2016,Sociologie,5,Sociologie Generale,2,La Theorie Sociologique,10,1106,2,QROC,0.69,0.06,12.55,10,67,77,62,10,52,1.24,16.13,Difficile,Difficile,0,Meme Difficulté,Pas Adapte,Sociology
3353,2017,Sociologie,5,Sociologie Generale,2,La Theorie Sociologique,10,1106,2,QROC,0.95,0.01,31.59,21,47,68,66,21,45,1.03,31.82,Facile,Difficile,-2,Beaucoup plus Difficile,Pas Adapte,Sociology
4477,2018,Sociologie,5,Sociologie Generale,2,La Theorie Sociologique,10,1106,2,QROC,0.92,0.08,20.36,12,49,61,29,12,17,2.1,41.38,Facile,Difficile,-2,Beaucoup plus Difficile,Pas Adapte,Sociology
5601,2019,Sociologie,5,Sociologie Generale,2,La Theorie Sociologique,10,1106,2,QROC,0.24,0.35,57.55,40,30,70,51,40,11,1.37,78.43,Facile,Moyen,-1,Plus Difficile,Pas Adapte,Sociology
6725,2020,Sociologie,5,Sociologie Generale,2,La Theorie Sociologique,10,1106,2,QROC,0.83,0.01,7.3,4,56,60,34,4,30,1.76,11.76,Facile,Difficile,-2,Beaucoup plus Difficile,Pas Adapte,Sociology
1106,2015,Sociologie,5,Sociologie Generale,2,La Theorie Sociologique,10,1107,3,QCU,0.16,0.87,87.97,31,4,35,33,31,2,1.06,93.94,Facile,Facile,0,Meme Difficulté,Pas Adapte,Sociology
2230,2016,Sociologie,5,Sociologie Generale,2,La Theorie Sociologique,10,1107,3,QO,0.89,0.15,17.71,7,31,38,26,7,19,1.46,26.92,Facile,Difficile,-2,Beaucoup plus Difficile,Pas Adapte,Sociology
3354,2017,Sociologie,5,Sociologie Generale,2,La Theorie Sociologique,10,1107,3,QROC,0.26,0.36,58.47,22,16,38,38,22,16,1.0,57.89,Moyen,Moyen,0,Meme Difficulté,Pas Adapte,Sociology
4478,2018,Sociologie,5,Sociologie Generale,2,La Theorie Sociologique,10,1107,3,QROC,0.37,0.37,47.34,18,19,37,26,18,8,1.42,69.23,Moyen,Moyen,0,Meme Difficulté,Pas Adapte,Sociology
5602,2019,Sociologie,5,Sociologie Generale,2,La Theorie Sociologique,10,1107,3,QO,0.03,0.42,78.73,24,7,31,24,24,0,1.29,100.0,Difficile,Facile,2,Beaucoup plus Facile,Pas Adapte,Sociology
6726,2020,Sociologie,5,Sociologie Generale,2,La Theorie Sociologique,10,1107,3,QO,0.77,0.03,24.68,8,24,32,17,8,9,1.88,47.06,Facile,Difficile,-2,Beaucoup plus Difficile,Pas Adapte,Sociology
1107,2015,Sociologie,5,Sociologie Generale,2,La Theorie Sociologique,10,1108,4,QCM,0.5,0.17,25.99,13,36,49,15,13,2,3.27,86.67,Moyen,Difficile,-1,Plus Difficile,Pas Adapte,Sociology
2231,2016,Sociologie,5,Sociologie Generale,2,La Theorie Sociologique,10,1108,4,QCU,0.26,0.55,53.3,27,23,50,46,27,19,1.09,58.7,Difficile,Moyen,1,Plus Facile,Pas Adapte,Sociology
3355,2017,Sociologie,5,Sociologie Generale,2,La Theorie Sociologique,10,1108,4,QCU,0.17,0.96,77.28,43,13,56,45,43,2,1.24,95.56,Difficile,Facile,2,Beaucoup plus Facile,Pas Adapte,Sociology
4479,2018,Sociologie,5,Sociologie Generale,2,La Theorie Sociologique,10,1108,4,QCU,0.04,0.88,87.58,56,8,64,57,56,1,1.12,98.25,Facile,Facile,0,Meme Difficulté,Pas Adapte,Sociology
5603,2019,Sociologie,5,Sociologie Generale,2,La Theorie Sociologique,10,1108,4,QCU,0.54,0.38,19.04,10,44,54,24,10,14,2.25,41.67,Moyen,Difficile,-1,Plus Difficile,Pas Adapte,Sociology
6727,2020,Sociologie,5,Sociologie Generale,2,La Theorie Sociologique,10,1108,4,QCU,0.19,0.97,80.51,39,10,49,44,39,5,1.11,88.64,Difficile,Facile,2,Beaucoup plus Facile,Pas Adapte,Sociology
1108,2015,Sociologie,5,Sociologie Generale,2,La Theorie Sociologique,10,1109,5,QCU,0.1,0.98,90.46,27,3,30,29,27,2,1.03,93.1,Facile,Facile,0,Meme Difficulté,Pas Adapte,Sociology
2232,2016,Sociologie,5,Sociologie Generale,2,La Theorie Sociologique,10,1109,5,QCU,0.11,0.96,71.88,24,9,33,29,24,5,1.14,82.76,Moyen,Facile,1,Plus Facile,Adapte,Sociology
3356,2017,Sociologie,5,Sociologie Generale,2,La Theorie Sociologique,10,1109,5,QCM,0.18,0.72,71.88,23,9,32,29,23,6,1.1,79.31,Facile,Facile,0,Meme Difficulté,Adapte,Sociology
4480,2018,Sociologie,5,Sociologie Generale,2,La Theorie Sociologique,10,1109,5,QCM,0.01,0.74,71.88,24,10,34,33,24,9,1.03,72.73,Facile,Facile,0,Meme Difficulté,Adapte,Sociology
5604,2019,Sociologie,5,Sociologie Generale,2,La Theorie Sociologique,10,1109,5,QCM,0.17,0.77,71.88,23,9,32,28,23,5,1.14,82.14,Facile,Facile,0,Meme Difficulté,Adapte,Sociology
6728,2020,Sociologie,5,Sociologie Generale,2,La Theorie Sociologique,10,1109,5,QCM,0.02,0.74,71.88,24,9,33,25,24,1,1.32,96.0,Facile,Facile,0,Meme Difficulté,Adapte,Sociology
1109,2015,Sociologie,5,Sociologie Generale,2,La Theorie Sociologique,10,1110,6,QROC,0.08,0.42,90.67,72,7,79,77,72,5,1.03,93.51,Moyen,Facile,1,Plus Facile,Pas Adapte,Sociology
2233,2016,Sociologie,5,Sociologie Generale,2,La Theorie Sociologique,10,1110,6,QROC,0.16,0.49,97.11,81,2,83,82,81,1,1.01,98.78,Difficile,Facile,2,Beaucoup plus Facile,Pas Adapte,Sociology
3357,2017,Sociologie,5,Sociologie Generale,2,La Theorie Sociologique,10,1110,6,QROC,0.84,0.13,24.97,19,59,78,34,19,15,2.29,55.88,Facile,Difficile,-2,Beaucoup plus Difficile,Pas Adapte,Sociology
4481,2018,Sociologie,5,Sociologie Generale,2,La Theorie Sociologique,10,1110,6,QROC,0.05,0.62,86.62,72,11,83,79,72,7,1.05,91.14,Facile,Facile,0,Meme Difficulté,Pas Adapte,Sociology
5605,2019,Sociologie,5,Sociologie Generale,2,La Theorie Sociologique,10,1110,6,QROC,0.16,0.52,65.27,58,31,89,71,58,13,1.25,81.69,Moyen,Facile,1,Plus Facile,Adapte,Sociology
6729,2020,Sociologie,5,Sociologie Generale,2,La Theorie Sociologique,10,1110,6,QO,0.0,0.96,65.27,50,27,77,64,50,14,1.2,78.12,Facile,Facile,0,Meme Difficulté,Adapte,Sociology
1110,2015,Sociologie,5,Sociologie Generale,2,La Theorie Sociologique,10,1111,7,QCU,0.21,0.56,53.13,39,34,73,63,39,24,1.16,61.9,Facile,Moyen,-1,Plus Difficile,Pas Adapte,Sociology
2234,2016,Sociologie,5,Sociologie Generale,2,La Theorie Sociologique,10,1111,7,QCU,0.22,0.62,45.64,31,37,68,66,31,35,1.03,46.97,Moyen,Moyen,0,Meme Difficulté,Pas Adapte,Sociology
3358,2017,Sociologie,5,Sociologie Generale,2,La Theorie Sociologique,10,1111,7,QCU,0.64,0.3,2.91,2,65,67,48,2,46,1.4,4.17,Facile,Difficile,-2,Beaucoup plus Difficile,Pas Adapte,Sociology
4482,2018,Sociologie,5,Sociologie Generale,2,La Theorie Sociologique,10,1111,7,QCU,0.26,0.54,36.38,21,37,58,52,21,31,1.12,40.38,Moyen,Moyen,0,Meme Difficulté,Pas Adapte,Sociology
5606,2019,Sociologie,5,Sociologie Generale,2,La Theorie Sociologique,10,1111,7,QCU,0.12,0.87,76.34,50,16,66,64,50,14,1.03,78.12,Moyen,Facile,1,Plus Facile,Pas Adapte,Sociology
6730,2020,Sociologie,5,Sociologie Generale,2,La Theorie Sociologique,10,1111,7,QCU,0.09,0.91,79.44,51,13,64,59,51,8,1.08,86.44,Moyen,Facile,1,Plus Facile,Pas Adapte,Sociology
1111,2015,Sociologie,5,Sociologie Generale,2,La Theorie Sociologique,10,1112,8,QCU,0.23,0.72,64.63,11,6,17,15,11,4,1.13,73.33,Facile,Moyen,-1,Plus Difficile,Adapte,Sociology
2235,2016,Sociologie,5,Sociologie Generale,2,La Theorie Sociologique,10,1112,8,QCU,0.29,0.41,64.63,12,7,19,17,12,5,1.12,70.59,Moyen,Moyen,0,Meme Difficulté,Adapte,Sociology
3359,2017,Sociologie,5,Sociologie Generale,2,La Theorie Sociologique,10,1112,8,QCU,0.21,0.58,64.63,14,8,22,19,14,5,1.16,73.68,Moyen,Moyen,0,Meme Difficulté,Adapte,Sociology
4483,2018,Sociologie,5,Sociologie Generale,2,La Theorie Sociologique,10,1112,8,QCU,0.2,0.47,64.63,13,7,20,15,13,2,1.33,86.67,Moyen,Moyen,0,Meme Difficulté,Adapte,Sociology
5607,2019,Sociologie,5,Sociologie Generale,2,La Theorie Sociologique,10,1112,8,QCU,0.31,0.56,64.63,12,6,18,15,12,3,1.2,80.0,Moyen,Moyen,0,Meme Difficulté,Adapte,Sociology
6731,2020,Sociologie,5,Sociologie Generale,2,La Theorie Sociologique,10,1112,8,QCU,0.2,0.54,64.63,10,5,15,13,10,3,1.15,76.92,Moyen,Moyen,0,Meme Difficulté,Adapte,Sociology
1112,2015,Sociologie,5,Sociologie Generale,2,La Theorie Sociologique,10,1113,9,QCM,0.63,0.26,8.72,5,51,56,34,5,29,1.65,14.71,Facile,Difficile,-2,Beaucoup plus Difficile,Pas Adapte,Sociology
2236,2016,Sociologie,5,Sociologie Generale,2,La Theorie Sociologique,10,1113,9,QCM,0.65,0.21,1.41,1,62,63,56,1,55,1.12,1.79,Difficile,Difficile,0,Meme Difficulté,Pas Adapte,Sociology
3360,2017,Sociologie,5,Sociologie Generale,2,La Theorie Sociologique,10,1113,9,QCM,0.52,0.21,30.31,20,47,67,48,20,28,1.4,41.67,Facile,Difficile,-2,Beaucoup plus Difficile,Pas Adapte,Sociology
4484,2018,Sociologie,5,Sociologie Generale,2,La Theorie Sociologique,10,1113,9,QCM,0.39,0.5,35.27,27,49,76,49,27,22,1.55,55.1,Facile,Moyen,-1,Plus Difficile,Pas Adapte,Sociology
5608,2019,Sociologie,5,Sociologie Generale,2,La Theorie Sociologique,10,1113,9,QO,0.78,0.01,6.13,5,76,81,42,5,37,1.93,11.9,Moyen,Difficile,-1,Plus Difficile,Pas Adapte,Sociology
6732,2020,Sociologie,5,Sociologie Generale,2,La Theorie Sociologique,10,1113,9,QO,0.38,0.17,51.83,48,44,92,62,48,14,1.48,77.42,Facile,Moyen,-1,Plus Difficile,Pas Adapte,Sociology
1113,2015,Sociologie,5,Sociologie Generale,2,La Theorie Sociologique,10,1114,10,QCU,0.34,0.74,62.87,22,13,35,27,22,5,1.3,81.48,Moyen,Moyen,0,Meme Difficulté,Adapte,Sociology
2237,2016,Sociologie,5,Sociologie Generale,2,La Theorie Sociologique,10,1114,10,QCU,0.2,0.56,62.87,25,14,39,29,25,4,1.34,86.21,Moyen,Moyen,0,Meme Difficulté,Adapte,Sociology
3361,2017,Sociologie,5,Sociologie Generale,2,La Theorie Sociologique,10,1114,10,QO,0.74,0.18,62.87,22,13,35,29,22,7,1.21,75.86,Moyen,Moyen,0,Meme Difficulté,Adapte,Sociology
4485,2018,Sociologie,5,Sociologie Generale,2,La Theorie Sociologique,10,1114,10,QROC,0.58,0.26,62.87,20,12,32,21,20,1,1.52,95.24,Moyen,Moyen,0,Meme Difficulté,Adapte,Sociology
5609,2019,Sociologie,5,Sociologie Generale,2,La Theorie Sociologique,10,1114,10,QROC,0.43,0.37,62.87,21,12,33,25,21,4,1.32,84.0,Moyen,Moyen,0,Meme Difficulté,Adapte,Sociology
6733,2020,Sociologie,5,Sociologie Generale,2,La Theorie Sociologique,10,1114,10,QROC,0.47,0.38,62.87,21,13,34,23,21,2,1.48,91.3,Moyen,Moyen,0,Meme Difficulté,Adapte,Sociology
1114,2015,Sociologie,5,Sociologie Generale,3,La Condition Moderne,8,1115,1,QCM,0.1,0.88,84.15,64,12,76,70,64,6,1.09,91.43,Facile,Facile,0,Meme Difficulté,Pas Adapte,Sociology
2238,2016,Sociologie,5,Sociologie Generale,3,La Condition Moderne,8,1115,1,QCM,0.23,0.64,63.2,54,31,85,60,54,6,1.42,90.0,Facile,Moyen,-1,Plus Difficile,Adapte,Sociology
3362,2017,Sociologie,5,Sociologie Generale,3,La Condition Moderne,8,1115,1,QCM,0.21,0.49,63.2,52,30,82,76,52,24,1.08,68.42,Moyen,Moyen,0,Meme Difficulté,Adapte,Sociology
4486,2018,Sociologie,5,Sociologie Generale,3,La Condition Moderne,8,1115,1,QCU,0.33,0.57,63.2,57,33,90,64,57,7,1.41,89.06,Moyen,Moyen,0,Meme Difficulté,Adapte,Sociology
5610,2019,Sociologie,5,Sociologie Generale,3,La Condition Moderne,8,1115,1,QCM,0.49,0.57,63.2,64,37,101,73,64,9,1.38,87.67,Moyen,Moyen,0,Meme Difficulté,Adapte,Sociology
6734,2020,Sociologie,5,Sociologie Generale,3,La Condition Moderne,8,1115,1,QCM,0.5,0.49,63.2,69,40,109,84,69,15,1.3,82.14,Moyen,Moyen,0,Meme Difficulté,Adapte,Sociology
1115,2015,Sociologie,5,Sociologie Generale,3,La Condition Moderne,8,1116,2,QCU,0.54,0.26,12.56,10,68,78,58,10,48,1.34,17.24,Difficile,Difficile,0,Meme Difficulté,Pas Adapte,Sociology
2239,2016,Sociologie,5,Sociologie Generale,3,La Condition Moderne,8,1116,2,QCU,0.24,0.62,55.2,38,30,68,46,38,8,1.48,82.61,Difficile,Moyen,1,Plus Facile,Pas Adapte,Sociology
3363,2017,Sociologie,5,Sociologie Generale,3,La Condition Moderne,8,1116,2,QCU,0.01,0.91,65.95,38,20,58,42,38,4,1.38,90.48,Difficile,Facile,2,Beaucoup plus Facile,Adapte,Sociology
4487,2018,Sociologie,5,Sociologie Generale,3,La Condition Moderne,8,1116,2,QCU,0.18,0.95,65.95,44,23,67,45,44,1,1.49,97.78,Facile,Facile,0,Meme Difficulté,Adapte,Sociology
5611,2019,Sociologie,5,Sociologie Generale,3,La Condition Moderne,8,1116,2,QCU,0.01,0.82,65.95,43,22,65,53,43,10,1.23,81.13,Facile,Facile,0,Meme Difficulté,Adapte,Sociology
6735,2020,Sociologie,5,Sociologie Generale,3,La Condition Moderne,8,1116,2,QCU,0.07,0.88,65.95,44,23,67,52,44,8,1.29,84.62,Facile,Facile,0,Meme Difficulté,Adapte,Sociology
1116,2015,Sociologie,5,Sociologie Generale,3,La Condition Moderne,8,1117,3,QCU,0.21,0.51,35.95,12,20,32,29,12,17,1.1,41.38,Difficile,Moyen,1,Plus Facile,Pas Adapte,Sociology
2240,2016,Sociologie,5,Sociologie Generale,3,La Condition Moderne,8,1117,3,QCU,0.19,0.93,95.98,30,1,31,30,30,0,1.03,100.0,Moyen,Facile,1,Plus Facile,Pas Adapte,Sociology
3364,2017,Sociologie,5,Sociologie Generale,3,La Condition Moderne,8,1117,3,QCU,0.29,0.59,49.63,13,14,27,24,13,11,1.12,54.17,Moyen,Moyen,0,Meme Difficulté,Pas Adapte,Sociology
4488,2018,Sociologie,5,Sociologie Generale,3,La Condition Moderne,8,1117,3,QCU,0.14,0.94,84.91,21,4,25,24,21,3,1.04,87.5,Facile,Facile,0,Meme Difficulté,Pas Adapte,Sociology
5612,2019,Sociologie,5,Sociologie Generale,3,La Condition Moderne,8,1117,3,QCU,0.16,0.78,72.47,21,8,29,27,21,6,1.07,77.78,Facile,Facile,0,Meme Difficulté,Adapte,Sociology
6736,2020,Sociologie,5,Sociologie Generale,3,La Condition Moderne,8,1117,3,QCU,0.13,0.95,72.47,20,7,27,25,20,5,1.08,80.0,Facile,Facile,0,Meme Difficulté,Adapte,Sociology
1117,2015,Sociologie,5,Sociologie Generale,3,La Condition Moderne,8,1118,4,QCM,0.07,0.98,99.41,36,0,36,36,36,0,1.0,100.0,Facile,Facile,0,Meme Difficulté,Pas Adapte,Sociology
2241,2016,Sociologie,5,Sociologie Generale,3,La Condition Moderne,8,1118,4,QCM,0.11,0.94,71.37,26,10,36,31,26,5,1.16,83.87,Moyen,Facile,1,Plus Facile,Adapte,Sociology
3365,2017,Sociologie,5,Sociologie Generale,3,La Condition Moderne,8,1118,4,QCM,0.16,0.94,71.37,25,10,35,27,25,2,1.3,92.59,Facile,Facile,0,Meme Difficulté,Adapte,Sociology
4489,2018,Sociologie,5,Sociologie Generale,3,La Condition Moderne,8,1118,4,QCU,0.02,0.85,71.37,21,9,30,30,21,9,1.0,70.0,Facile,Facile,0,Meme Difficulté,Adapte,Sociology
5613,2019,Sociologie,5,Sociologie Generale,3,La Condition Moderne,8,1118,4,QROC,0.08,0.55,71.37,20,8,28,21,20,1,1.33,95.24,Facile,Facile,0,Meme Difficulté,Adapte,Sociology
6737,2020,Sociologie,5,Sociologie Generale,3,La Condition Moderne,8,1118,4,QROC,0.16,0.63,71.37,19,8,27,22,19,3,1.23,86.36,Facile,Facile,0,Meme Difficulté,Adapte,Sociology
1118,2015,Sociologie,5,Sociologie Generale,3,La Condition Moderne,8,1119,5,QCU,0.43,0.32,1.37,1,91,92,83,1,82,1.11,1.2,Difficile,Difficile,0,Meme Difficulté,Pas Adapte,Sociology
2242,2016,Sociologie,5,Sociologie Generale,3,La Condition Moderne,8,1119,5,QCU,0.19,0.89,99.21,105,1,106,106,105,1,1.0,99.06,Moyen,Facile,1,Plus Facile,Pas Adapte,Sociology
3366,2017,Sociologie,5,Sociologie Generale,3,La Condition Moderne,8,1119,5,QCU,0.72,0.23,5.75,6,91,97,42,6,36,2.31,14.29,Facile,Difficile,-2,Beaucoup plus Difficile,Pas Adapte,Sociology
4490,2018,Sociologie,5,Sociologie Generale,3,La Condition Moderne,8,1119,5,QCU,0.5,0.34,29.64,25,58,83,67,25,42,1.24,37.31,Difficile,Difficile,0,Meme Difficulté,Pas Adapte,Sociology
5614,2019,Sociologie,5,Sociologie Generale,3,La Condition Moderne,8,1119,5,QCU,0.23,0.43,49.99,38,39,77,51,38,13,1.51,74.51,Difficile,Moyen,1,Plus Facile,Pas Adapte,Sociology
6738,2020,Sociologie,5,Sociologie Generale,3,La Condition Moderne,8,1119,5,QCU,0.58,0.23,12.48,11,77,88,86,11,75,1.02,12.79,Difficile,Difficile,0,Meme Difficulté,Pas Adapte,Sociology
1119,2015,Sociologie,5,Sociologie Generale,3,La Condition Moderne,8,1120,6,QCU,0.26,0.54,62.68,27,16,43,42,27,15,1.02,64.29,Difficile,Moyen,1,Plus Facile,Adapte,Sociology
2243,2016,Sociologie,5,Sociologie Generale,3,La Condition Moderne,8,1120,6,QCU,0.21,0.41,62.68,28,17,45,30,28,2,1.5,93.33,Moyen,Moyen,0,Meme Difficulté,Adapte,Sociology
3367,2017,Sociologie,5,Sociologie Generale,3,La Condition Moderne,8,1120,6,QCU,0.33,0.48,62.68,29,17,46,36,29,7,1.28,80.56,Moyen,Moyen,0,Meme Difficulté,Adapte,Sociology
4491,2018,Sociologie,5,Sociologie Generale,3,La Condition Moderne,8,1120,6,QCU,0.39,0.64,62.68,28,17,45,29,28,1,1.55,96.55,Moyen,Moyen,0,Meme Difficulté,Adapte,Sociology
5615,2019,Sociologie,5,Sociologie Generale,3,La Condition Moderne,8,1120,6,QCU,0.23,0.71,62.68,26,16,42,41,26,15,1.02,63.41,Moyen,Moyen,0,Meme Difficulté,Adapte,Sociology
6739,2020,Sociologie,5,Sociologie Generale,3,La Condition Moderne,8,1120,6,QCU,0.33,0.7,62.68,24,15,39,26,24,2,1.5,92.31,Moyen,Moyen,0,Meme Difficulté,Adapte,Sociology
1120,2015,Sociologie,5,Sociologie Generale,3,La Condition Moderne,8,1121,7,QCM,0.54,0.28,15.78,4,19,23,20,4,16,1.15,20.0,Moyen,Difficile,-1,Plus Difficile,Pas Adapte,Sociology
2244,2016,Sociologie,5,Sociologie Generale,3,La Condition Moderne,8,1121,7,QCM,0.29,0.45,56.94,12,9,21,21,12,9,1.0,57.14,Moyen,Moyen,0,Meme Difficulté,Pas Adapte,Sociology
3368,2017,Sociologie,5,Sociologie Generale,3,La Condition Moderne,8,1121,7,QCM,0.22,0.32,53.16,13,11,24,14,13,1,1.71,92.86,Moyen,Moyen,0,Meme Difficulté,Pas Adapte,Sociology
4492,2018,Sociologie,5,Sociologie Generale,3,La Condition Moderne,8,1121,7,QCM,0.21,0.55,40.34,10,15,25,13,10,3,1.92,76.92,Difficile,Moyen,1,Plus Facile,Pas Adapte,Sociology
5616,2019,Sociologie,5,Sociologie Generale,3,La Condition Moderne,8,1121,7,QCM,0.09,0.92,97.26,21,1,22,21,21,0,1.05,100.0,Difficile,Facile,2,Beaucoup plus Facile,Pas Adapte,Sociology
6740,2020,Sociologie,5,Sociologie Generale,3,La Condition Moderne,8,1121,7,QCM,0.35,0.57,48.45,10,10,20,15,10,5,1.33,66.67,Difficile,Moyen,1,Plus Facile,Pas Adapte,Sociology
1121,2015,Sociologie,5,Sociologie Generale,3,La Condition Moderne,8,1122,8,QCM,0.74,0.28,0.78,1,72,73,19,1,18,3.84,5.26,Facile,Difficile,-2,Beaucoup plus Difficile,Pas Adapte,Sociology
2245,2016,Sociologie,5,Sociologie Generale,3,La Condition Moderne,8,1122,8,QCU,0.54,0.27,30.54,23,51,74,33,23,10,2.24,69.7,Moyen,Difficile,-1,Plus Difficile,Pas Adapte,Sociology
3369,2017,Sociologie,5,Sociologie Generale,3,La Condition Moderne,8,1122,8,QCU,0.69,0.35,13.62,9,56,65,41,9,32,1.59,21.95,Facile,Difficile,-2,Beaucoup plus Difficile,Pas Adapte,Sociology
4493,2018,Sociologie,5,Sociologie Generale,3,La Condition Moderne,8,1122,8,QCU,0.33,0.62,47.05,30,33,63,40,30,10,1.57,75.0,Moyen,Moyen,0,Meme Difficulté,Pas Adapte,Sociology
5617,2019,Sociologie,5,Sociologie Generale,3,La Condition Moderne,8,1122,8,QCU,0.3,0.71,50.62,35,34,69,48,35,13,1.44,72.92,Moyen,Moyen,0,Meme Difficulté,Pas Adapte,Sociology
6741,2020,Sociologie,5,Sociologie Generale,3,La Condition Moderne,8,1122,8,QCU,0.15,0.98,67.68,44,21,65,46,44,2,1.41,95.65,Difficile,Facile,2,Beaucoup plus Facile,Adapte,Sociology
1122,2015,Sociologie,5,Sociologie Generale,4,Les Debats Sociologiques Contemporains,2,1123,1,QCM,0.63,0.23,14.21,10,59,69,58,10,48,1.19,17.24,Difficile,Difficile,0,Meme Difficulté,Pas Adapte,Sociology
2246,2016,Sociologie,5,Sociologie Generale,4,Les Debats Sociologiques Contemporains,2,1123,1,QCM,0.05,0.71,85.12,67,12,79,74,67,7,1.07,90.54,Difficile,Facile,2,Beaucoup plus Facile,Pas Adapte,Sociology
3370,2017,Sociologie,5,Sociologie Generale,4,Les Debats Sociologiques Contemporains,2,1123,1,QCM,0.36,0.46,56.31,44,35,79,68,44,24,1.16,64.71,Moyen,Moyen,0,Meme Difficulté,Pas Adapte,Sociology
4494,2018,Sociologie,5,Sociologie Generale,4,Les Debats Sociologiques Contemporains,2,1123,1,QCM,0.09,0.75,68.89,51,23,74,58,51,7,1.28,87.93,Moyen,Facile,1,Plus Facile,Adapte,Sociology
5618,2019,Sociologie,5,Sociologie Generale,4,Les Debats Sociologiques Contemporains,2,1123,1,QCM,0.12,0.94,68.89,50,23,73,70,50,20,1.04,71.43,Facile,Facile,0,Meme Difficulté,Adapte,Sociology
6742,2020,Sociologie,5,Sociologie Generale,4,Les Debats Sociologiques Contemporains,2,1123,1,QCM,0.13,0.83,68.89,46,21,67,62,46,16,1.08,74.19,Facile,Facile,0,Meme Difficulté,Adapte,Sociology
1123,2015,Sociologie,5,Sociologie Generale,4,Les Debats Sociologiques Contemporains,2,1124,2,QROC,0.6,0.28,48.95,31,32,63,54,31,23,1.17,57.41,Difficile,Moyen,1,Plus Facile,Pas Adapte,Sociology
2247,2016,Sociologie,5,Sociologie Generale,4,Les Debats Sociologiques Contemporains,2,1124,2,QROC,0.12,0.82,86.94,50,8,58,56,50,6,1.04,89.29,Facile,Facile,0,Meme Difficulté,Pas Adapte,Sociology
3371,2017,Sociologie,5,Sociologie Generale,4,Les Debats Sociologiques Contemporains,2,1124,2,QROC,0.9,0.14,13.62,9,56,65,39,9,30,1.67,23.08,Moyen,Difficile,-1,Plus Difficile,Pas Adapte,Sociology
4495,2018,Sociologie,5,Sociologie Generale,4,Les Debats Sociologiques Contemporains,2,1124,2,QROC,0.83,0.04,3.32,2,54,56,53,2,51,1.06,3.77,Difficile,Difficile,0,Meme Difficulté,Pas Adapte,Sociology
5619,2019,Sociologie,5,Sociologie Generale,4,Les Debats Sociologiques Contemporains,2,1124,2,QROC,0.65,0.05,13.48,8,55,63,29,8,21,2.17,27.59,Moyen,Difficile,-1,Plus Difficile,Pas Adapte,Sociology
6743,2020,Sociologie,5,Sociologie Generale,4,Les Debats Sociologiques Contemporains,2,1124,2,QROC,0.66,0.02,14.58,8,47,55,27,8,19,2.04,29.63,Moyen,Difficile,-1,Plus Difficile,Pas Adapte,Sociology
