,Quizz_ID,Year,Departement,Chapter_ID,Rank_onChapter,Quizz_Type,B,Slip,Guess,Number_Attempts,UniQ_Learner,Sucessful_Learners,Unsucessful_Learners,Avg_Attempts,Percent_Learners_Success,Success_Attempts,Failure_Attempts,TruePrct_Succes,Predict_Difficulty,Correct_Difficulty,Prediction/Correct Difficulty
0,1,2015,Ingenieurie,1,1,QCU,0.7459,0.11,0.67,61,56,45,11,1.09,80.36,45,16,74.59,Trop Difficile,Adapte,Trop Difficile / Adapte
830,1,2016,Ingenieurie,1,1,QCU,0.7377,0.21,0.62,72,69,53,16,1.04,76.81,53,19,73.77,Adapte,Adapte,Adapte / Adapte
1660,1,2017,Ingenieurie,1,1,QCU,0.6404,0.01,0.42,83,56,53,3,1.48,94.64,53,30,64.04,Adapte,Adapte,Adapte / Adapte
2490,1,2018,Ingenieurie,1,1,QCU,0.6202,0.03,0.49,66,60,41,19,1.1,68.33,41,25,62.02,Adapte,Adapte,Adapte / Adapte
3320,1,2019,Ingenieurie,1,1,QCU,0.6134,0.2,0.46,78,63,48,15,1.24,76.19,48,30,61.34,Adapte,Adapte,Adapte / Adapte
4150,1,2020,Ingenieurie,1,1,QCU,0.6526,0.29,0.42,73,66,48,18,1.11,72.73,48,25,65.26,Adapte,Adapte,Adapte / Adapte
1,2,2015,Ingenieurie,1,2,QCU,0.705,0.28,0.56,62,50,44,6,1.24,88.0,44,18,70.5,Adapte,Adapte,Adapte / Adapte
831,2,2016,Ingenieurie,1,2,QCU,0.7029,0.2,0.52,64,58,45,13,1.1,77.59,45,19,70.29,Adapte,Adapte,Adapte / Adapte
1661,2,2017,Ingenieurie,1,2,QCU,0.6176,0.12,0.49,68,60,42,18,1.13,70.0,42,26,61.76,Adapte,Adapte,Adapte / Adapte
2491,2,2018,Ingenieurie,1,2,QCU,0.6733,0.05,0.45,62,61,42,19,1.02,68.85,42,20,67.33,Adapte,Adapte,Adapte / Adapte
3321,2,2019,Ingenieurie,1,2,QCU,0.7456,0.17,0.67,70,53,52,1,1.32,98.11,52,18,74.56,Adapte,Adapte,Adapte / Adapte
4151,2,2020,Ingenieurie,1,2,QCU,0.6393,0.05,0.61,80,74,51,23,1.08,68.92,51,29,63.93,Adapte,Adapte,Adapte / Adapte
2,3,2015,Ingenieurie,1,3,QCU,0.4043,0.26,0.39,9,6,4,2,1.5,66.67,4,5,40.43,Difficile,Difficile,Difficile / Difficile
832,3,2016,Ingenieurie,1,3,QCU,0.942,0.06,1.0,10,10,9,1,1.0,90.0,9,1,94.2,Trop Facile,Trop Facile,Trop Facile / Trop Facile
1662,3,2017,Ingenieurie,1,3,QCU,0.9419,0.07,0.94,9,9,8,1,1.0,88.89,8,1,94.19,Trop Facile,Trop Facile,Trop Facile / Trop Facile
2492,3,2018,Ingenieurie,1,3,QCU,0.869,0.06,0.98,7,6,6,0,1.17,100.0,6,1,86.9,Trop Facile,Trop Facile,Trop Facile / Trop Facile
3322,3,2019,Ingenieurie,1,3,QCU,0.9076,0.01,0.94,7,6,6,0,1.17,100.0,6,1,90.76,Trop Facile,Trop Facile,Trop Facile / Trop Facile
4152,3,2020,Ingenieurie,1,3,QCU,0.6334,0.05,0.7,6,5,4,1,1.2,80.0,4,2,63.34,Trop Facile,Adapte,Trop Facile / Adapte
3,4,2015,Ingenieurie,1,4,QCU,0.7942,0.15,0.85,7,7,6,1,1.0,85.71,6,1,79.42,Facile,Facile,Facile / Facile
833,4,2016,Ingenieurie,1,4,QCU,0.1077,0.3,0.27,7,4,1,3,1.75,25.0,1,6,10.77,Trop Facile,Trop Difficile,Trop Facile / Trop Difficile
1663,4,2017,Ingenieurie,1,4,QCU,0.9718,0.03,0.99,6,6,6,0,1.0,100.0,6,0,97.18,Trop Facile,Trop Facile,Trop Facile / Trop Facile
2493,4,2018,Ingenieurie,1,4,QCU,0.2583,0.09,0.32,5,5,1,4,1.0,20.0,1,4,25.83,Trop Facile,Difficile,Trop Facile / Difficile
3323,4,2019,Ingenieurie,1,4,QCU,0.9691,0.02,0.97,5,5,5,0,1.0,100.0,5,0,96.91,Trop Facile,Trop Facile,Trop Facile / Trop Facile
4153,4,2020,Ingenieurie,1,4,QCU,0.3146,0.19,0.35,5,5,2,3,1.0,40.0,2,3,31.46,Trop Facile,Difficile,Trop Facile / Difficile
4,5,2015,Ingenieurie,1,5,QCM,0.1858,0.34,0.21,46,14,9,5,3.29,64.29,9,37,18.58,Trop Difficile,Trop Difficile,Trop Difficile / Trop Difficile
834,5,2016,Ingenieurie,1,5,QCM,0.1997,0.05,0.3,44,26,9,17,1.69,34.62,9,35,19.97,Facile,Trop Difficile,Facile / Trop Difficile
1664,5,2017,Ingenieurie,1,5,QCM,0.8446,0.04,0.74,37,36,31,5,1.03,86.11,31,6,84.46,Facile,Facile,Facile / Facile
2494,5,2018,Ingenieurie,1,5,QCM,0.078,0.71,0.25,30,23,2,21,1.3,8.7,2,28,7.8,Facile,Trop Difficile,Facile / Trop Difficile
3324,5,2019,Ingenieurie,1,5,QCM,0.789,0.16,0.71,34,33,27,6,1.03,81.82,27,7,78.9,Facile,Facile,Facile / Facile
4154,5,2020,Ingenieurie,1,5,QCM,0.839,0.08,0.76,36,31,30,1,1.16,96.77,30,6,83.9,Facile,Facile,Facile / Facile
5,6,2015,Ingenieurie,1,6,QCU,0.747,0.07,0.56,93,85,69,16,1.09,81.18,69,24,74.7,Facile,Adapte,Facile / Adapte
835,6,2016,Ingenieurie,1,6,QCU,0.6606,0.01,0.55,103,76,68,8,1.36,89.47,68,35,66.06,Adapte,Adapte,Adapte / Adapte
1665,6,2017,Ingenieurie,1,6,QCU,0.6891,0.19,0.54,121,119,83,36,1.02,69.75,83,38,68.91,Adapte,Adapte,Adapte / Adapte
2495,6,2018,Ingenieurie,1,6,QCU,0.6121,0.28,0.63,125,103,77,26,1.21,74.76,77,48,61.21,Adapte,Adapte,Adapte / Adapte
3325,6,2019,Ingenieurie,1,6,QCU,0.686,0.09,0.62,135,115,93,22,1.17,80.87,93,42,68.6,Adapte,Adapte,Adapte / Adapte
4155,6,2020,Ingenieurie,1,6,QCU,0.628,0.15,0.46,158,144,99,45,1.1,68.75,99,59,62.8,Adapte,Adapte,Adapte / Adapte
6,7,2015,Ingenieurie,1,7,QROC,0.4077,0.74,0.16,63,38,26,12,1.66,68.42,26,37,40.77,Difficile,Difficile,Difficile / Difficile
836,7,2016,Ingenieurie,1,7,QROC,0.8498,0.08,0.63,55,48,47,1,1.15,97.92,47,8,84.98,Facile,Facile,Facile / Facile
1666,7,2017,Ingenieurie,1,7,QROC,0.8345,0.13,0.7,59,58,49,9,1.02,84.48,49,10,83.45,Facile,Facile,Facile / Facile
2496,7,2018,Ingenieurie,1,7,QROC,0.7763,0.19,0.61,70,55,54,1,1.27,98.18,54,16,77.63,Facile,Facile,Facile / Facile
3326,7,2019,Ingenieurie,1,7,QROC,0.7741,0.06,0.55,66,56,51,5,1.18,91.07,51,15,77.41,Facile,Facile,Facile / Facile
4156,7,2020,Ingenieurie,1,7,QROC,0.798,0.05,0.66,57,46,45,1,1.24,97.83,45,12,79.8,Facile,Facile,Facile / Facile
7,8,2015,Ingenieurie,1,8,QCU,0.0861,0.59,0.27,47,18,4,14,2.61,22.22,4,43,8.61,Trop Difficile,Trop Difficile,Trop Difficile / Trop Difficile
837,8,2016,Ingenieurie,1,8,QCU,0.969,0.05,0.9,50,49,48,1,1.02,97.96,48,2,96.9,Trop Facile,Trop Facile,Trop Facile / Trop Facile
1667,8,2017,Ingenieurie,1,8,QCU,0.3634,0.32,0.35,49,39,18,21,1.26,46.15,18,31,36.34,Trop Facile,Difficile,Trop Facile / Difficile
2497,8,2018,Ingenieurie,1,8,QCU,0.9624,0.09,0.91,53,53,51,2,1.0,96.23,51,2,96.24,Trop Facile,Trop Facile,Trop Facile / Trop Facile
3327,8,2019,Ingenieurie,1,8,QCU,0.9719,0.09,0.96,54,52,52,0,1.04,100.0,52,2,97.19,Trop Facile,Trop Facile,Trop Facile / Trop Facile
4157,8,2020,Ingenieurie,1,8,QCU,0.8185,0.11,0.76,57,48,47,1,1.19,97.92,47,10,81.85,Trop Facile,Facile,Trop Facile / Facile
8,9,2015,Ingenieurie,1,9,QCU,0.6104,0.16,0.45,78,48,48,0,1.62,100.0,48,30,61.04,Trop Facile,Adapte,Trop Facile / Adapte
838,9,2016,Ingenieurie,1,9,QCU,0.727,0.17,0.47,62,48,45,3,1.29,93.75,45,17,72.7,Adapte,Adapte,Adapte / Adapte
1668,9,2017,Ingenieurie,1,9,QCU,0.704,0.06,0.56,57,52,40,12,1.1,76.92,40,17,70.4,Adapte,Adapte,Adapte / Adapte
2498,9,2018,Ingenieurie,1,9,QCU,0.6641,0.04,0.7,47,34,31,3,1.38,91.18,31,16,66.41,Adapte,Adapte,Adapte / Adapte
3328,9,2019,Ingenieurie,1,9,QCU,0.6071,0.06,0.5,56,51,34,17,1.1,66.67,34,22,60.71,Adapte,Adapte,Adapte / Adapte
4158,9,2020,Ingenieurie,1,9,QCU,0.6243,0.27,0.56,50,46,31,15,1.09,67.39,31,19,62.43,Adapte,Adapte,Adapte / Adapte
9,10,2015,Ingenieurie,2,1,QCU,0.6747,0.02,0.54,7,7,5,2,1.0,71.43,5,2,67.47,Trop Facile,Adapte,Trop Facile / Adapte
839,10,2016,Ingenieurie,2,1,QCU,0.6448,0.19,0.69,8,7,5,2,1.14,71.43,5,3,64.48,Adapte,Adapte,Adapte / Adapte
1669,10,2017,Ingenieurie,2,1,QCU,0.6615,0.23,0.63,9,6,6,0,1.5,100.0,6,3,66.15,Adapte,Adapte,Adapte / Adapte
2499,10,2018,Ingenieurie,2,1,QCU,0.6617,0.13,0.67,7,5,5,0,1.4,100.0,5,2,66.17,Adapte,Adapte,Adapte / Adapte
3329,10,2019,Ingenieurie,2,1,QCU,0.6107,0.27,0.42,7,5,4,1,1.4,80.0,4,3,61.07,Adapte,Adapte,Adapte / Adapte
4159,10,2020,Ingenieurie,2,1,QCU,0.677,0.05,0.55,7,6,5,1,1.17,83.33,5,2,67.7,Adapte,Adapte,Adapte / Adapte
10,11,2015,Ingenieurie,2,2,QO,0.4741,0.9,0.03,71,53,34,19,1.34,64.15,34,37,47.41,Difficile,Difficile,Difficile / Difficile
840,11,2016,Ingenieurie,2,2,QO,0.6512,0.64,0.16,77,60,50,10,1.28,83.33,50,27,65.12,Adapte,Adapte,Adapte / Adapte
1670,11,2017,Ingenieurie,2,2,QO,0.6907,0.66,0.22,75,64,52,12,1.17,81.25,52,23,69.07,Adapte,Adapte,Adapte / Adapte
2500,11,2018,Ingenieurie,2,2,QO,0.6406,0.28,0.21,71,64,45,19,1.11,70.31,45,26,64.06,Adapte,Adapte,Adapte / Adapte
3330,11,2019,Ingenieurie,2,2,QO,0.6579,0.27,0.2,67,53,44,9,1.26,83.02,44,23,65.79,Adapte,Adapte,Adapte / Adapte
4160,11,2020,Ingenieurie,2,2,QO,0.6675,0.29,0.22,62,61,41,20,1.02,67.21,41,21,66.75,Adapte,Adapte,Adapte / Adapte
11,12,2015,Ingenieurie,2,3,QCM,0.9733,0.05,0.99,22,22,21,1,1.0,95.45,21,1,97.33,Difficile,Trop Facile,Difficile / Trop Facile
841,12,2016,Ingenieurie,2,3,QCM,0.7655,0.04,0.75,26,24,20,4,1.08,83.33,20,6,76.55,Facile,Facile,Facile / Facile
1671,12,2017,Ingenieurie,2,3,QCM,0.8357,0.08,0.78,27,24,23,1,1.12,95.83,23,4,83.57,Facile,Facile,Facile / Facile
2501,12,2018,Ingenieurie,2,3,QCM,0.9612,0.0,0.96,23,23,22,1,1.0,95.65,22,1,96.12,Facile,Trop Facile,Facile / Trop Facile
3331,12,2019,Ingenieurie,2,3,QCM,0.8365,0.16,0.77,23,22,19,3,1.05,86.36,19,4,83.65,Facile,Facile,Facile / Facile
4161,12,2020,Ingenieurie,2,3,QCM,0.8295,0.09,0.75,25,25,21,4,1.0,84.0,21,4,82.95,Facile,Facile,Facile / Facile
12,13,2015,Ingenieurie,2,4,QCU,0.9586,0.07,0.98,58,58,56,2,1.0,96.55,56,2,95.86,Trop Facile,Trop Facile,Trop Facile / Trop Facile
842,13,2016,Ingenieurie,2,4,QCU,0.9559,0.08,0.93,55,54,53,1,1.02,98.15,53,2,95.59,Trop Facile,Trop Facile,Trop Facile / Trop Facile
1672,13,2017,Ingenieurie,2,4,QCU,0.9194,0.04,0.94,48,47,44,3,1.02,93.62,44,4,91.94,Trop Facile,Trop Facile,Trop Facile / Trop Facile
2502,13,2018,Ingenieurie,2,4,QCU,0.9576,0.01,0.91,44,44,42,2,1.0,95.45,42,2,95.76,Trop Facile,Trop Facile,Trop Facile / Trop Facile
3332,13,2019,Ingenieurie,2,4,QCU,0.9969,0.05,0.97,42,42,42,0,1.0,100.0,42,0,99.69,Trop Facile,Trop Facile,Trop Facile / Trop Facile
4162,13,2020,Ingenieurie,2,4,QCU,0.9708,0.03,0.98,49,48,48,0,1.02,100.0,48,1,97.08,Trop Facile,Trop Facile,Trop Facile / Trop Facile
13,14,2015,Ingenieurie,2,5,QCU,0.9038,0.05,0.99,39,37,35,2,1.05,94.59,35,4,90.38,Trop Difficile,Trop Facile,Trop Difficile / Trop Facile
843,14,2016,Ingenieurie,2,5,QCU,0.8941,0.07,0.97,47,43,42,1,1.09,97.67,42,5,89.41,Trop Facile,Trop Facile,Trop Facile / Trop Facile
1673,14,2017,Ingenieurie,2,5,QCU,0.8981,0.09,0.96,41,39,37,2,1.05,94.87,37,4,89.81,Trop Facile,Trop Facile,Trop Facile / Trop Facile
2503,14,2018,Ingenieurie,2,5,QCU,0.6128,0.19,0.55,45,45,28,17,1.0,62.22,28,17,61.28,Trop Facile,Adapte,Trop Facile / Adapte
3333,14,2019,Ingenieurie,2,5,QCU,0.6621,0.2,0.48,45,36,30,6,1.25,83.33,30,15,66.21,Adapte,Adapte,Adapte / Adapte
4163,14,2020,Ingenieurie,2,5,QCU,0.6239,0.13,0.46,37,33,23,10,1.12,69.7,23,14,62.39,Adapte,Adapte,Adapte / Adapte
14,15,2015,Ingenieurie,2,6,QCU,0.7184,0.16,0.56,76,68,55,13,1.12,80.88,55,21,71.84,Adapte,Adapte,Adapte / Adapte
844,15,2016,Ingenieurie,2,6,QCU,0.6408,0.14,0.49,82,69,53,16,1.19,76.81,53,29,64.08,Adapte,Adapte,Adapte / Adapte
1674,15,2017,Ingenieurie,2,6,QCU,0.6181,0.23,0.57,68,54,42,12,1.26,77.78,42,26,61.81,Adapte,Adapte,Adapte / Adapte
2504,15,2018,Ingenieurie,2,6,QCU,0.6433,0.12,0.45,69,65,44,21,1.06,67.69,44,25,64.33,Adapte,Adapte,Adapte / Adapte
3334,15,2019,Ingenieurie,2,6,QCU,0.6338,0.2,0.52,58,52,37,15,1.12,71.15,37,21,63.38,Adapte,Adapte,Adapte / Adapte
4164,15,2020,Ingenieurie,2,6,QCU,0.6535,0.28,0.69,68,50,44,6,1.36,88.0,44,24,65.35,Adapte,Adapte,Adapte / Adapte
15,16,2015,Ingenieurie,2,7,QCM,0.0878,0.52,0.29,60,22,5,17,2.73,22.73,5,55,8.78,Trop Difficile,Trop Difficile,Trop Difficile / Trop Difficile
845,16,2016,Ingenieurie,2,7,QCM,0.7754,0.02,0.75,64,52,50,2,1.23,96.15,50,14,77.54,Facile,Facile,Facile / Facile
1675,16,2017,Ingenieurie,2,7,QCM,0.0338,0.53,0.25,76,26,3,23,2.92,11.54,3,73,3.38,Facile,Trop Difficile,Facile / Trop Difficile
2505,16,2018,Ingenieurie,2,7,QCM,0.7617,0.02,0.78,91,79,69,10,1.15,87.34,69,22,76.17,Facile,Facile,Facile / Facile
3335,16,2019,Ingenieurie,2,7,QCM,0.7803,0.08,0.76,80,76,62,14,1.05,81.58,62,18,78.03,Facile,Facile,Facile / Facile
4165,16,2020,Ingenieurie,2,7,QCM,0.654,0.13,0.47,91,71,60,11,1.28,84.51,60,31,65.4,Facile,Adapte,Facile / Adapte
16,17,2015,Ingenieurie,2,8,QCU,0.8296,0.05,0.84,81,80,67,13,1.01,83.75,67,14,82.96,Facile,Facile,Facile / Facile
846,17,2016,Ingenieurie,2,8,QCU,0.8742,0.0,0.92,96,94,84,10,1.02,89.36,84,12,87.42,Trop Facile,Trop Facile,Trop Facile / Trop Facile
1676,17,2017,Ingenieurie,2,8,QCU,0.9335,0.01,0.9,80,80,75,5,1.0,93.75,75,5,93.35,Trop Facile,Trop Facile,Trop Facile / Trop Facile
2506,17,2018,Ingenieurie,2,8,QCU,0.8791,0.01,0.98,86,85,76,9,1.01,89.41,76,10,87.91,Trop Facile,Trop Facile,Trop Facile / Trop Facile
3336,17,2019,Ingenieurie,2,8,QCU,0.1578,0.2,0.27,86,42,14,28,2.05,33.33,14,72,15.78,Trop Facile,Trop Difficile,Trop Facile / Trop Difficile
4166,17,2020,Ingenieurie,2,8,QCU,0.2552,0.1,0.36,90,70,23,47,1.29,32.86,23,67,25.52,Trop Facile,Difficile,Trop Facile / Difficile
17,18,2015,Ingenieurie,2,9,QCU,0.2053,0.41,0.27,63,22,13,9,2.86,59.09,13,50,20.53,Trop Difficile,Trop Difficile,Trop Difficile / Trop Difficile
847,18,2016,Ingenieurie,2,9,QCU,0.4906,0.32,0.32,76,62,37,25,1.23,59.68,37,39,49.06,Trop Facile,Difficile,Trop Facile / Difficile
1677,18,2017,Ingenieurie,2,9,QCU,0.8953,0.03,0.92,86,84,77,7,1.02,91.67,77,9,89.53,Trop Facile,Trop Facile,Trop Facile / Trop Facile
2507,18,2018,Ingenieurie,2,9,QCU,0.9751,0.04,0.97,70,69,68,1,1.01,98.55,68,2,97.51,Trop Facile,Trop Facile,Trop Facile / Trop Facile
3337,18,2019,Ingenieurie,2,9,QCU,0.8101,0.06,0.87,62,59,50,9,1.05,84.75,50,12,81.01,Trop Facile,Facile,Trop Facile / Facile
4167,18,2020,Ingenieurie,2,9,QCU,0.9117,0.08,0.9,62,60,57,3,1.03,95.0,57,5,91.17,Trop Facile,Trop Facile,Trop Facile / Trop Facile
18,19,2015,Ingenieurie,2,10,QCM,0.0427,0.72,0.28,85,69,4,65,1.23,5.8,4,81,4.27,Trop Difficile,Trop Difficile,Trop Difficile / Trop Difficile
848,19,2016,Ingenieurie,2,10,QCM,0.8426,0.01,0.71,78,75,66,9,1.04,88.0,66,12,84.26,Facile,Facile,Facile / Facile
1678,19,2017,Ingenieurie,2,10,QCM,0.7995,0.09,0.71,78,77,62,15,1.01,80.52,62,16,79.95,Facile,Facile,Facile / Facile
2508,19,2018,Ingenieurie,2,10,QCM,0.771,0.06,0.8,85,70,66,4,1.21,94.29,66,19,77.1,Facile,Facile,Facile / Facile
3338,19,2019,Ingenieurie,2,10,QCM,0.8385,0.12,0.8,69,61,58,3,1.13,95.08,58,11,83.85,Facile,Facile,Facile / Facile
4168,19,2020,Ingenieurie,2,10,QCM,0.6915,0.24,0.49,63,61,44,17,1.03,72.13,44,19,69.15,Facile,Adapte,Facile / Adapte
19,20,2015,Ingenieurie,3,1,QROC,0.0317,0.81,0.05,24,13,1,12,1.85,7.69,1,23,3.17,Facile,Trop Difficile,Facile / Trop Difficile
849,20,2016,Ingenieurie,3,1,QROC,0.1501,0.89,0.05,24,23,4,19,1.04,17.39,4,20,15.01,Facile,Trop Difficile,Facile / Trop Difficile
1679,20,2017,Ingenieurie,3,1,QROC,0.7767,0.18,0.54,21,18,16,2,1.17,88.89,16,5,77.67,Facile,Facile,Facile / Facile
2509,20,2018,Ingenieurie,3,1,QROC,0.7765,0.18,0.42,20,16,16,0,1.25,100.0,16,4,77.65,Facile,Facile,Facile / Facile
3339,20,2019,Ingenieurie,3,1,QROC,0.8189,0.19,0.61,21,20,17,3,1.05,85.0,17,4,81.89,Facile,Facile,Facile / Facile
4169,20,2020,Ingenieurie,3,1,QROC,0.8277,0.07,0.74,18,17,15,2,1.06,88.24,15,3,82.77,Facile,Facile,Facile / Facile
20,21,2015,Ingenieurie,3,2,QCU,0.0857,0.36,0.23,41,33,4,29,1.24,12.12,4,37,8.57,Trop Difficile,Trop Difficile,Trop Difficile / Trop Difficile
850,21,2016,Ingenieurie,3,2,QCU,0.9926,0.04,0.94,44,44,44,0,1.0,100.0,44,0,99.26,Trop Facile,Trop Facile,Trop Facile / Trop Facile
1680,21,2017,Ingenieurie,3,2,QCU,0.3688,0.16,0.37,40,16,15,1,2.5,93.75,15,25,36.88,Trop Facile,Difficile,Trop Facile / Difficile
2510,21,2018,Ingenieurie,3,2,QCU,0.9228,0.09,0.93,48,45,44,1,1.07,97.78,44,4,92.28,Trop Facile,Trop Facile,Trop Facile / Trop Facile
3340,21,2019,Ingenieurie,3,2,QCU,0.9021,0.05,0.94,42,38,38,0,1.11,100.0,38,4,90.21,Trop Facile,Trop Facile,Trop Facile / Trop Facile
4170,21,2020,Ingenieurie,3,2,QCU,0.7834,0.05,0.76,39,34,31,3,1.15,91.18,31,8,78.34,Trop Facile,Facile,Trop Facile / Facile
21,22,2015,Ingenieurie,3,3,QCM,0.4761,0.25,0.33,46,42,22,20,1.1,52.38,22,24,47.61,Difficile,Difficile,Difficile / Difficile
851,22,2016,Ingenieurie,3,3,QCM,0.765,0.2,0.75,43,37,33,4,1.16,89.19,33,10,76.5,Facile,Facile,Facile / Facile
1681,22,2017,Ingenieurie,3,3,QCM,0.6447,0.03,0.55,49,41,32,9,1.2,78.05,32,17,64.47,Facile,Adapte,Facile / Adapte
2511,22,2018,Ingenieurie,3,3,QCM,0.6945,0.15,0.48,55,46,38,8,1.2,82.61,38,17,69.45,Adapte,Adapte,Adapte / Adapte
3341,22,2019,Ingenieurie,3,3,QCM,0.6461,0.29,0.55,66,54,43,11,1.22,79.63,43,23,64.61,Adapte,Adapte,Adapte / Adapte
4171,22,2020,Ingenieurie,3,3,QCM,0.7348,0.02,0.59,72,64,53,11,1.12,82.81,53,19,73.48,Adapte,Adapte,Adapte / Adapte
22,23,2015,Ingenieurie,3,4,QCU,0.2074,0.62,0.29,18,6,4,2,3.0,66.67,4,14,20.74,Difficile,Trop Difficile,Difficile / Trop Difficile
852,23,2016,Ingenieurie,3,4,QCU,0.9449,0.09,0.97,22,22,21,1,1.0,95.45,21,1,94.49,Trop Facile,Trop Facile,Trop Facile / Trop Facile
1682,23,2017,Ingenieurie,3,4,QCU,0.1795,0.66,0.25,21,15,4,11,1.4,26.67,4,17,17.95,Trop Facile,Trop Difficile,Trop Facile / Trop Difficile
2512,23,2018,Ingenieurie,3,4,QCU,0.9965,0.0,0.98,18,18,18,0,1.0,100.0,18,0,99.65,Trop Facile,Trop Facile,Trop Facile / Trop Facile
3342,23,2019,Ingenieurie,3,4,QCU,0.655,0.12,0.62,21,17,14,3,1.24,82.35,14,7,65.5,Trop Facile,Adapte,Trop Facile / Adapte
4172,23,2020,Ingenieurie,3,4,QCU,0.7482,0.03,0.61,20,17,15,2,1.18,88.24,15,5,74.82,Adapte,Adapte,Adapte / Adapte
23,24,2015,Ingenieurie,3,5,QCM,0.6998,0.03,0.67,92,91,64,27,1.01,70.33,64,28,69.98,Adapte,Adapte,Adapte / Adapte
853,24,2016,Ingenieurie,3,5,QCM,0.6241,0.02,0.46,105,68,66,2,1.54,97.06,66,39,62.41,Adapte,Adapte,Adapte / Adapte
1683,24,2017,Ingenieurie,3,5,QCM,0.6218,0.3,0.58,101,72,63,9,1.4,87.5,63,38,62.18,Adapte,Adapte,Adapte / Adapte
2513,24,2018,Ingenieurie,3,5,QCM,0.746,0.04,0.55,102,77,76,1,1.32,98.7,76,26,74.6,Adapte,Adapte,Adapte / Adapte
3343,24,2019,Ingenieurie,3,5,QCM,0.6787,0.0,0.65,104,86,71,15,1.21,82.56,71,33,67.87,Adapte,Adapte,Adapte / Adapte
4173,24,2020,Ingenieurie,3,5,QCM,0.6409,0.08,0.45,95,79,61,18,1.2,77.22,61,34,64.09,Adapte,Adapte,Adapte / Adapte
24,25,2015,Ingenieurie,3,6,QCU,0.0499,0.54,0.21,56,38,3,35,1.47,7.89,3,53,4.99,Difficile,Trop Difficile,Difficile / Trop Difficile
854,25,2016,Ingenieurie,3,6,QCU,0.8611,0.04,0.96,62,59,53,6,1.05,89.83,53,9,86.11,Trop Facile,Trop Facile,Trop Facile / Trop Facile
1684,25,2017,Ingenieurie,3,6,QCU,0.8619,0.06,0.91,54,47,47,0,1.15,100.0,47,7,86.19,Trop Facile,Trop Facile,Trop Facile / Trop Facile
2514,25,2018,Ingenieurie,3,6,QCU,0.8794,0.06,0.99,46,44,40,4,1.05,90.91,40,6,87.94,Trop Facile,Trop Facile,Trop Facile / Trop Facile
3344,25,2019,Ingenieurie,3,6,QCU,0.9909,0.03,0.98,44,44,44,0,1.0,100.0,44,0,99.09,Trop Facile,Trop Facile,Trop Facile / Trop Facile
4174,25,2020,Ingenieurie,3,6,QCU,0.8758,0.06,0.94,49,46,43,3,1.07,93.48,43,6,87.58,Trop Facile,Trop Facile,Trop Facile / Trop Facile
25,26,2015,Ingenieurie,3,7,QROC,0.9722,0.07,0.85,35,34,34,0,1.03,100.0,34,1,97.22,Trop Facile,Trop Facile,Trop Facile / Trop Facile
855,26,2016,Ingenieurie,3,7,QROC,0.0159,0.8,0.04,42,28,1,27,1.5,3.57,1,41,1.59,Facile,Trop Difficile,Facile / Trop Difficile
1685,26,2017,Ingenieurie,3,7,QROC,0.8307,0.01,0.71,42,41,35,6,1.02,85.37,35,7,83.07,Facile,Facile,Facile / Facile
2515,26,2018,Ingenieurie,3,7,QROC,0.7883,0.1,0.64,44,35,35,0,1.26,100.0,35,9,78.83,Facile,Facile,Facile / Facile
3345,26,2019,Ingenieurie,3,7,QROC,0.8461,0.11,0.7,52,49,44,5,1.06,89.8,44,8,84.61,Facile,Facile,Facile / Facile
4175,26,2020,Ingenieurie,3,7,QROC,0.8478,0.09,0.73,53,46,45,1,1.15,97.83,45,8,84.78,Facile,Facile,Facile / Facile
26,27,2015,Ingenieurie,3,8,QO,0.3198,0.76,0.15,35,18,11,7,1.94,61.11,11,24,31.98,Trop Difficile,Difficile,Trop Difficile / Difficile
856,27,2016,Ingenieurie,3,8,QO,0.6027,0.6,0.23,36,25,22,3,1.44,88.0,22,14,60.27,Adapte,Adapte,Adapte / Adapte
1686,27,2017,Ingenieurie,3,8,QO,0.7163,0.47,0.18,35,29,25,4,1.21,86.21,25,10,71.63,Adapte,Adapte,Adapte / Adapte
2516,27,2018,Ingenieurie,3,8,QO,0.6011,0.63,0.2,36,28,22,6,1.29,78.57,22,14,60.11,Adapte,Adapte,Adapte / Adapte
3346,27,2019,Ingenieurie,3,8,QO,0.6061,0.24,0.18,31,26,19,7,1.19,73.08,19,12,60.61,Adapte,Adapte,Adapte / Adapte
4176,27,2020,Ingenieurie,3,8,QO,0.7232,0.49,0.23,34,32,25,7,1.06,78.12,25,9,72.32,Adapte,Adapte,Adapte / Adapte
27,28,2015,Ingenieurie,3,9,QCU,0.8893,0.03,0.93,16,15,14,1,1.07,93.33,14,2,88.93,Trop Facile,Trop Facile,Trop Facile / Trop Facile
857,28,2016,Ingenieurie,3,9,QCU,0.9231,0.07,0.91,15,14,14,0,1.07,100.0,14,1,92.31,Trop Facile,Trop Facile,Trop Facile / Trop Facile
1687,28,2017,Ingenieurie,3,9,QCU,0.88,0.01,0.97,13,11,11,0,1.18,100.0,11,2,88.0,Trop Facile,Trop Facile,Trop Facile / Trop Facile
2517,28,2018,Ingenieurie,3,9,QCU,0.9416,0.06,0.91,16,15,15,0,1.07,100.0,15,1,94.16,Trop Facile,Trop Facile,Trop Facile / Trop Facile
3347,28,2019,Ingenieurie,3,9,QCU,0.8185,0.09,0.8,16,16,13,3,1.0,81.25,13,3,81.85,Trop Facile,Facile,Trop Facile / Facile
4177,28,2020,Ingenieurie,3,9,QCU,0.8932,0.09,0.95,15,13,13,0,1.15,100.0,13,2,89.32,Trop Facile,Trop Facile,Trop Facile / Trop Facile
28,29,2015,Ingenieurie,3,10,QCM,0.6667,0.28,0.5,8,6,5,1,1.33,83.33,5,3,66.67,Trop Facile,Adapte,Trop Facile / Adapte
858,29,2016,Ingenieurie,3,10,QCM,0.702,0.2,0.67,8,8,6,2,1.0,75.0,6,2,70.2,Adapte,Adapte,Adapte / Adapte
1688,29,2017,Ingenieurie,3,10,QCM,0.6862,0.21,0.51,6,5,4,1,1.2,80.0,4,2,68.62,Adapte,Adapte,Adapte / Adapte
2518,29,2018,Ingenieurie,3,10,QCM,0.7175,0.1,0.53,6,5,4,1,1.2,80.0,4,2,71.75,Adapte,Adapte,Adapte / Adapte
3348,29,2019,Ingenieurie,3,10,QCM,0.7303,0.19,0.63,7,6,5,1,1.17,83.33,5,2,73.03,Adapte,Adapte,Adapte / Adapte
4178,29,2020,Ingenieurie,3,10,QCM,0.6348,0.16,0.69,7,4,4,0,1.75,100.0,4,3,63.48,Adapte,Adapte,Adapte / Adapte
29,30,2015,Ingenieurie,3,11,QCU,0.1261,0.33,0.21,62,22,8,14,2.82,36.36,8,54,12.61,Trop Difficile,Trop Difficile,Trop Difficile / Trop Difficile
859,30,2016,Ingenieurie,3,11,QCU,0.9229,0.08,0.93,62,59,57,2,1.05,96.61,57,5,92.29,Trop Facile,Trop Facile,Trop Facile / Trop Facile
1689,30,2017,Ingenieurie,3,11,QCU,0.7765,0.11,0.88,67,64,52,12,1.05,81.25,52,15,77.65,Trop Facile,Facile,Trop Facile / Facile
2519,30,2018,Ingenieurie,3,11,QCU,0.9975,0.03,0.97,69,69,69,0,1.0,100.0,69,0,99.75,Trop Facile,Trop Facile,Trop Facile / Trop Facile
3349,30,2019,Ingenieurie,3,11,QCU,0.8646,0.06,0.9,77,69,67,2,1.12,97.1,67,10,86.46,Trop Facile,Trop Facile,Trop Facile / Trop Facile
4179,30,2020,Ingenieurie,3,11,QCU,0.6529,0.07,0.49,83,57,54,3,1.46,94.74,54,29,65.29,Trop Facile,Adapte,Trop Facile / Adapte
30,31,2015,Ingenieurie,3,12,QCU,0.8084,0.1,0.88,58,56,47,9,1.04,83.93,47,11,80.84,Facile,Facile,Facile / Facile
860,31,2016,Ingenieurie,3,12,QCU,0.9181,0.03,1.0,55,53,50,3,1.04,94.34,50,5,91.81,Trop Facile,Trop Facile,Trop Facile / Trop Facile
1690,31,2017,Ingenieurie,3,12,QCU,0.9461,0.08,0.95,58,57,55,2,1.02,96.49,55,3,94.61,Trop Facile,Trop Facile,Trop Facile / Trop Facile
2520,31,2018,Ingenieurie,3,12,QCU,0.262,0.15,0.39,66,40,17,23,1.65,42.5,17,49,26.2,Trop Facile,Difficile,Trop Facile / Difficile
3350,31,2019,Ingenieurie,3,12,QCU,0.9105,0.02,0.93,61,61,56,5,1.0,91.8,56,5,91.05,Trop Facile,Trop Facile,Trop Facile / Trop Facile
4180,31,2020,Ingenieurie,3,12,QCU,0.8668,0.04,0.91,52,47,45,2,1.11,95.74,45,7,86.68,Trop Facile,Trop Facile,Trop Facile / Trop Facile
31,32,2015,Ingenieurie,3,13,QCM,0.052,0.38,0.22,35,21,2,19,1.67,9.52,2,33,5.2,Trop Difficile,Trop Difficile,Trop Difficile / Trop Difficile
861,32,2016,Ingenieurie,3,13,QCM,0.7747,0.1,0.79,28,28,22,6,1.0,78.57,22,6,77.47,Facile,Facile,Facile / Facile
1691,32,2017,Ingenieurie,3,13,QCM,0.7799,0.17,0.78,28,23,22,1,1.22,95.65,22,6,77.99,Facile,Facile,Facile / Facile
2521,32,2018,Ingenieurie,3,13,QCM,0.838,0.06,0.74,34,30,28,2,1.13,93.33,28,6,83.8,Facile,Facile,Facile / Facile
3351,32,2019,Ingenieurie,3,13,QCM,0.6892,0.24,0.63,27,23,19,4,1.17,82.61,19,8,68.92,Facile,Adapte,Facile / Adapte
4181,32,2020,Ingenieurie,3,13,QCM,0.6307,0.08,0.49,25,22,16,6,1.14,72.73,16,9,63.07,Adapte,Adapte,Adapte / Adapte
32,33,2015,Ingenieurie,3,14,QCU,0.0993,0.23,0.29,86,55,9,46,1.56,16.36,9,77,9.93,Difficile,Trop Difficile,Difficile / Trop Difficile
862,33,2016,Ingenieurie,3,14,QCU,0.9062,0.01,0.99,94,86,85,1,1.09,98.84,85,9,90.62,Trop Facile,Trop Facile,Trop Facile / Trop Facile
1692,33,2017,Ingenieurie,3,14,QCU,0.8961,0.07,0.95,87,84,78,6,1.04,92.86,78,9,89.61,Trop Facile,Trop Facile,Trop Facile / Trop Facile
2522,33,2018,Ingenieurie,3,14,QCU,0.9663,0.06,0.96,84,83,81,2,1.01,97.59,81,3,96.63,Trop Facile,Trop Facile,Trop Facile / Trop Facile
3352,33,2019,Ingenieurie,3,14,QCU,0.7905,0.16,0.81,70,55,55,0,1.27,100.0,55,15,79.05,Trop Facile,Facile,Trop Facile / Facile
4182,33,2020,Ingenieurie,3,14,QCU,0.9205,0.09,0.96,83,76,76,0,1.09,100.0,76,7,92.05,Trop Facile,Trop Facile,Trop Facile / Trop Facile
33,34,2015,Ingenieurie,4,1,QCU,0.3684,0.33,0.39,90,43,33,10,2.09,76.74,33,57,36.84,Difficile,Difficile,Difficile / Difficile
863,34,2016,Ingenieurie,4,1,QCU,0.816,0.14,0.82,91,77,74,3,1.18,96.1,74,17,81.6,Trop Facile,Facile,Trop Facile / Facile
1693,34,2017,Ingenieurie,4,1,QCU,0.6789,0.12,0.49,97,91,66,25,1.07,72.53,66,31,67.89,Trop Facile,Adapte,Trop Facile / Adapte
2523,34,2018,Ingenieurie,4,1,QCU,0.6132,0.1,0.59,103,77,63,14,1.34,81.82,63,40,61.32,Adapte,Adapte,Adapte / Adapte
3353,34,2019,Ingenieurie,4,1,QCU,0.6832,0.27,0.48,121,90,83,7,1.34,92.22,83,38,68.32,Adapte,Adapte,Adapte / Adapte
4183,34,2020,Ingenieurie,4,1,QCU,0.6875,0.21,0.54,111,92,76,16,1.21,82.61,76,35,68.75,Adapte,Adapte,Adapte / Adapte
34,35,2015,Ingenieurie,4,2,QCU,0.4415,0.23,0.4,6,4,3,1,1.5,75.0,3,3,44.15,Difficile,Difficile,Difficile / Difficile
864,35,2016,Ingenieurie,4,2,QCU,0.8631,0.03,0.92,6,6,5,1,1.0,83.33,5,1,86.31,Trop Facile,Trop Facile,Trop Facile / Trop Facile
1694,35,2017,Ingenieurie,4,2,QCU,0.7946,0.11,0.87,7,6,6,0,1.17,100.0,6,1,79.46,Trop Facile,Facile,Trop Facile / Facile
2524,35,2018,Ingenieurie,4,2,QCU,0.8829,0.05,0.98,8,7,7,0,1.14,100.0,7,1,88.29,Trop Facile,Trop Facile,Trop Facile / Trop Facile
3354,35,2019,Ingenieurie,4,2,QCU,0.9497,0.07,0.95,10,9,9,0,1.11,100.0,9,1,94.97,Trop Facile,Trop Facile,Trop Facile / Trop Facile
4184,35,2020,Ingenieurie,4,2,QCU,0.9921,0.02,0.98,9,9,9,0,1.0,100.0,9,0,99.21,Trop Facile,Trop Facile,Trop Facile / Trop Facile
35,36,2015,Ingenieurie,4,3,QCU,0.0736,0.2,0.21,84,62,6,56,1.35,9.68,6,78,7.36,Facile,Trop Difficile,Facile / Trop Difficile
865,36,2016,Ingenieurie,4,3,QCU,0.2371,0.09,0.23,93,44,22,22,2.11,50.0,22,71,23.71,Trop Facile,Trop Difficile,Trop Facile / Trop Difficile
1695,36,2017,Ingenieurie,4,3,QCU,0.2298,0.36,0.26,109,107,25,82,1.02,23.36,25,84,22.98,Trop Facile,Trop Difficile,Trop Facile / Trop Difficile
2525,36,2018,Ingenieurie,4,3,QCU,0.8215,0.06,0.79,128,127,105,22,1.01,82.68,105,23,82.15,Trop Facile,Facile,Trop Facile / Facile
3355,36,2019,Ingenieurie,4,3,QCU,0.8653,0.04,0.94,124,114,107,7,1.09,93.86,107,17,86.53,Trop Facile,Trop Facile,Trop Facile / Trop Facile
4185,36,2020,Ingenieurie,4,3,QCU,0.9151,0.09,0.98,148,142,135,7,1.04,95.07,135,13,91.51,Trop Facile,Trop Facile,Trop Facile / Trop Facile
36,37,2015,Ingenieurie,4,4,QCU,0.8016,0.19,0.84,27,24,22,2,1.12,91.67,22,5,80.16,Facile,Facile,Facile / Facile
866,37,2016,Ingenieurie,4,4,QCU,0.9243,0.01,0.91,28,26,26,0,1.08,100.0,26,2,92.43,Trop Facile,Trop Facile,Trop Facile / Trop Facile
1696,37,2017,Ingenieurie,4,4,QCU,0.8761,0.05,0.91,31,28,27,1,1.11,96.43,27,4,87.61,Trop Facile,Trop Facile,Trop Facile / Trop Facile
2526,37,2018,Ingenieurie,4,4,QCU,0.2589,0.14,0.31,37,15,10,5,2.47,66.67,10,27,25.89,Trop Facile,Difficile,Trop Facile / Difficile
3356,37,2019,Ingenieurie,4,4,QCU,0.9067,0.0,0.92,37,35,34,1,1.06,97.14,34,3,90.67,Trop Facile,Trop Facile,Trop Facile / Trop Facile
4186,37,2020,Ingenieurie,4,4,QCU,0.2082,0.18,0.26,36,18,7,11,2.0,38.89,7,29,20.82,Trop Facile,Trop Difficile,Trop Facile / Trop Difficile
37,38,2015,Ingenieurie,4,5,QCM,0.673,0.01,0.6,37,26,25,1,1.42,96.15,25,12,67.3,Difficile,Adapte,Difficile / Adapte
867,38,2016,Ingenieurie,4,5,QCM,0.6566,0.29,0.41,37,33,24,9,1.12,72.73,24,13,65.66,Adapte,Adapte,Adapte / Adapte
1697,38,2017,Ingenieurie,4,5,QCM,0.6164,0.02,0.53,38,28,23,5,1.36,82.14,23,15,61.64,Adapte,Adapte,Adapte / Adapte
2527,38,2018,Ingenieurie,4,5,QCM,0.6948,0.15,0.56,37,31,26,5,1.19,83.87,26,11,69.48,Adapte,Adapte,Adapte / Adapte
3357,38,2019,Ingenieurie,4,5,QCM,0.6034,0.05,0.63,32,23,19,4,1.39,82.61,19,13,60.34,Adapte,Adapte,Adapte / Adapte
4187,38,2020,Ingenieurie,4,5,QCM,0.668,0.16,0.46,37,33,25,8,1.12,75.76,25,12,66.8,Adapte,Adapte,Adapte / Adapte
38,39,2015,Ingenieurie,4,6,QROC,0.6944,0.45,0.36,13,10,9,1,1.3,90.0,9,4,69.44,Difficile,Adapte,Difficile / Adapte
868,39,2016,Ingenieurie,4,6,QROC,0.6732,0.22,0.39,15,13,10,3,1.15,76.92,10,5,67.32,Adapte,Adapte,Adapte / Adapte
1698,39,2017,Ingenieurie,4,6,QROC,0.7323,0.25,0.32,17,16,12,4,1.06,75.0,12,5,73.23,Adapte,Adapte,Adapte / Adapte
2528,39,2018,Ingenieurie,4,6,QROC,0.7294,0.48,0.3,17,15,12,3,1.13,80.0,12,5,72.94,Adapte,Adapte,Adapte / Adapte
3358,39,2019,Ingenieurie,4,6,QROC,0.6937,0.35,0.33,16,12,11,1,1.33,91.67,11,5,69.37,Adapte,Adapte,Adapte / Adapte
4188,39,2020,Ingenieurie,4,6,QROC,0.6969,0.26,0.31,14,13,10,3,1.08,76.92,10,4,69.69,Adapte,Adapte,Adapte / Adapte
39,40,2015,Ingenieurie,4,7,QCM,0.6519,0.13,0.46,17,16,11,5,1.06,68.75,11,6,65.19,Trop Difficile,Adapte,Trop Difficile / Adapte
869,40,2016,Ingenieurie,4,7,QCM,0.649,0.11,0.65,17,12,11,1,1.42,91.67,11,6,64.9,Adapte,Adapte,Adapte / Adapte
1699,40,2017,Ingenieurie,4,7,QCM,0.6776,0.1,0.51,18,13,12,1,1.38,92.31,12,6,67.76,Adapte,Adapte,Adapte / Adapte
2529,40,2018,Ingenieurie,4,7,QCM,0.6382,0.19,0.54,17,15,11,4,1.13,73.33,11,6,63.82,Adapte,Adapte,Adapte / Adapte
3359,40,2019,Ingenieurie,4,7,QCM,0.6638,0.2,0.63,17,17,11,6,1.0,64.71,11,6,66.38,Adapte,Adapte,Adapte / Adapte
4189,40,2020,Ingenieurie,4,7,QCM,0.6666,0.06,0.69,14,9,9,0,1.56,100.0,9,5,66.66,Adapte,Adapte,Adapte / Adapte
40,41,2015,Ingenieurie,5,1,QCM,0.4776,0.44,0.31,10,8,5,3,1.25,62.5,5,5,47.76,Difficile,Difficile,Difficile / Difficile
870,41,2016,Ingenieurie,5,1,QCM,0.7792,0.02,0.78,11,11,9,2,1.0,81.82,9,2,77.92,Facile,Facile,Facile / Facile
1700,41,2017,Ingenieurie,5,1,QCM,0.8225,0.01,0.79,9,7,7,0,1.29,100.0,7,2,82.25,Facile,Facile,Facile / Facile
2530,41,2018,Ingenieurie,5,1,QCM,0.8164,0.19,0.76,8,7,7,0,1.14,100.0,7,1,81.64,Facile,Facile,Facile / Facile
3360,41,2019,Ingenieurie,5,1,QCM,0.5426,0.33,0.31,6,6,3,3,1.0,50.0,3,3,54.26,Facile,Difficile,Facile / Difficile
4190,41,2020,Ingenieurie,5,1,QCM,0.8218,0.16,0.78,7,6,6,0,1.17,100.0,6,1,82.18,Facile,Facile,Facile / Facile
41,42,2015,Ingenieurie,5,2,QCU,0.8201,0.1,0.86,22,21,18,3,1.05,85.71,18,4,82.01,Facile,Facile,Facile / Facile
871,42,2016,Ingenieurie,5,2,QCU,0.9619,0.01,0.98,21,20,20,0,1.05,100.0,20,1,96.19,Trop Facile,Trop Facile,Trop Facile / Trop Facile
1701,42,2017,Ingenieurie,5,2,QCU,0.8942,0.07,0.99,24,22,21,1,1.09,95.45,21,3,89.42,Trop Facile,Trop Facile,Trop Facile / Trop Facile
2531,42,2018,Ingenieurie,5,2,QCU,0.9119,0.01,0.99,24,24,22,2,1.0,91.67,22,2,91.19,Trop Facile,Trop Facile,Trop Facile / Trop Facile
3361,42,2019,Ingenieurie,5,2,QCU,0.988,0.06,0.94,20,20,20,0,1.0,100.0,20,0,98.8,Trop Facile,Trop Facile,Trop Facile / Trop Facile
4191,42,2020,Ingenieurie,5,2,QCU,0.6821,0.16,0.44,19,15,13,2,1.27,86.67,13,6,68.21,Trop Facile,Adapte,Trop Facile / Adapte
42,43,2015,Ingenieurie,5,3,QCU,0.8376,0.11,0.81,35,34,29,5,1.03,85.29,29,6,83.76,Facile,Facile,Facile / Facile
872,43,2016,Ingenieurie,5,3,QCU,0.0518,0.62,0.24,42,20,2,18,2.1,10.0,2,40,5.18,Trop Facile,Trop Difficile,Trop Facile / Trop Difficile
1702,43,2017,Ingenieurie,5,3,QCU,0.6384,0.0,0.44,47,42,30,12,1.12,71.43,30,17,63.84,Trop Facile,Adapte,Trop Facile / Adapte
2532,43,2018,Ingenieurie,5,3,QCU,0.6654,0.25,0.51,53,37,35,2,1.43,94.59,35,18,66.54,Adapte,Adapte,Adapte / Adapte
3362,43,2019,Ingenieurie,5,3,QCU,0.6248,0.06,0.56,47,45,29,16,1.04,64.44,29,18,62.48,Adapte,Adapte,Adapte / Adapte
4192,43,2020,Ingenieurie,5,3,QCU,0.7079,0.07,0.54,41,32,29,3,1.28,90.62,29,12,70.79,Adapte,Adapte,Adapte / Adapte
43,44,2015,Ingenieurie,5,4,QROC,0.2234,0.94,0.03,70,68,16,52,1.03,23.53,16,54,22.34,Difficile,Trop Difficile,Difficile / Trop Difficile
873,44,2016,Ingenieurie,5,4,QROC,0.0383,0.81,0.15,70,68,3,65,1.03,4.41,3,67,3.83,Facile,Trop Difficile,Facile / Trop Difficile
1703,44,2017,Ingenieurie,5,4,QROC,0.4343,0.68,0.18,65,38,28,10,1.71,73.68,28,37,43.43,Facile,Difficile,Facile / Difficile
2533,44,2018,Ingenieurie,5,4,QROC,0.8142,0.02,0.6,61,59,50,9,1.03,84.75,50,11,81.42,Facile,Facile,Facile / Facile
3363,44,2019,Ingenieurie,5,4,QROC,0.8077,0.17,0.72,64,57,52,5,1.12,91.23,52,12,80.77,Facile,Facile,Facile / Facile
4193,44,2020,Ingenieurie,5,4,QROC,0.7775,0.05,0.56,77,70,60,10,1.1,85.71,60,17,77.75,Facile,Facile,Facile / Facile
44,45,2015,Ingenieurie,5,5,QROC,0.3224,0.69,0.24,57,56,18,38,1.02,32.14,18,39,32.24,Facile,Difficile,Facile / Difficile
874,45,2016,Ingenieurie,5,5,QROC,0.6279,0.44,0.39,54,42,34,8,1.29,80.95,34,20,62.79,Facile,Adapte,Facile / Adapte
1704,45,2017,Ingenieurie,5,5,QROC,0.6976,0.45,0.39,65,58,45,13,1.12,77.59,45,20,69.76,Adapte,Adapte,Adapte / Adapte
2534,45,2018,Ingenieurie,5,5,QROC,0.7208,0.22,0.37,74,61,53,8,1.21,86.89,53,21,72.08,Adapte,Adapte,Adapte / Adapte
3364,45,2019,Ingenieurie,5,5,QROC,0.6901,0.29,0.38,67,62,46,16,1.08,74.19,46,21,69.01,Adapte,Adapte,Adapte / Adapte
4194,45,2020,Ingenieurie,5,5,QROC,0.6067,0.41,0.38,66,65,40,25,1.02,61.54,40,26,60.67,Adapte,Adapte,Adapte / Adapte
45,46,2015,Ingenieurie,5,6,QCM,0.8419,0.05,0.75,66,56,56,0,1.18,100.0,56,10,84.19,Facile,Facile,Facile / Facile
875,46,2016,Ingenieurie,5,6,QCM,0.9859,0.03,0.85,77,76,76,0,1.01,100.0,76,1,98.59,Facile,Trop Facile,Facile / Trop Facile
1705,46,2017,Ingenieurie,5,6,QCM,0.7831,0.03,0.77,89,86,70,16,1.03,81.4,70,19,78.31,Facile,Facile,Facile / Facile
2535,46,2018,Ingenieurie,5,6,QCM,0.768,0.13,0.71,107,86,82,4,1.24,95.35,82,25,76.8,Facile,Facile,Facile / Facile
3365,46,2019,Ingenieurie,5,6,QCM,0.8049,0.02,0.74,108,99,87,12,1.09,87.88,87,21,80.49,Facile,Facile,Facile / Facile
4195,46,2020,Ingenieurie,5,6,QCM,0.8072,0.02,0.72,126,102,102,0,1.24,100.0,102,24,80.72,Facile,Facile,Facile / Facile
46,47,2015,Ingenieurie,5,7,QCM,0.6252,0.05,0.53,27,23,17,6,1.17,73.91,17,10,62.52,Difficile,Adapte,Difficile / Adapte
876,47,2016,Ingenieurie,5,7,QCM,0.6648,0.05,0.66,22,16,15,1,1.38,93.75,15,7,66.48,Adapte,Adapte,Adapte / Adapte
1706,47,2017,Ingenieurie,5,7,QCM,0.6023,0.06,0.57,20,16,12,4,1.25,75.0,12,8,60.23,Adapte,Adapte,Adapte / Adapte
2536,47,2018,Ingenieurie,5,7,QCM,0.6607,0.23,0.53,21,20,14,6,1.05,70.0,14,7,66.07,Adapte,Adapte,Adapte / Adapte
3366,47,2019,Ingenieurie,5,7,QCM,0.6129,0.16,0.63,20,13,12,1,1.54,92.31,12,8,61.29,Adapte,Adapte,Adapte / Adapte
4196,47,2020,Ingenieurie,5,7,QCM,0.7054,0.08,0.47,16,12,11,1,1.33,91.67,11,5,70.54,Adapte,Adapte,Adapte / Adapte
47,48,2015,Ingenieurie,5,8,QO,0.1051,0.97,0.04,19,12,2,10,1.58,16.67,2,17,10.51,Difficile,Trop Difficile,Difficile / Trop Difficile
877,48,2016,Ingenieurie,5,8,QO,0.67,0.42,0.28,18,16,12,4,1.12,75.0,12,6,67.0,Adapte,Adapte,Adapte / Adapte
1707,48,2017,Ingenieurie,5,8,QO,0.6378,0.42,0.26,17,14,11,3,1.21,78.57,11,6,63.78,Adapte,Adapte,Adapte / Adapte
2537,48,2018,Ingenieurie,5,8,QO,0.6727,0.22,0.28,19,17,13,4,1.12,76.47,13,6,67.27,Adapte,Adapte,Adapte / Adapte
3367,48,2019,Ingenieurie,5,8,QO,0.6133,0.44,0.19,21,17,13,4,1.24,76.47,13,8,61.33,Adapte,Adapte,Adapte / Adapte
4197,48,2020,Ingenieurie,5,8,QO,0.6136,0.43,0.17,22,22,13,9,1.0,59.09,13,9,61.36,Adapte,Adapte,Adapte / Adapte
48,49,2015,Ingenieurie,5,9,QCU,0.0656,0.47,0.2,57,55,4,51,1.04,7.27,4,53,6.56,Adapte,Trop Difficile,Adapte / Trop Difficile
878,49,2016,Ingenieurie,5,9,QCU,0.0064,0.28,0.22,64,37,0,37,1.73,0.0,0,64,0.64,Trop Facile,Trop Difficile,Trop Facile / Trop Difficile
1708,49,2017,Ingenieurie,5,9,QCU,0.8967,0.07,0.91,70,64,63,1,1.09,98.44,63,7,89.67,Trop Facile,Trop Facile,Trop Facile / Trop Facile
2538,49,2018,Ingenieurie,5,9,QCU,0.9665,0.04,0.91,80,78,77,1,1.03,98.72,77,3,96.65,Trop Facile,Trop Facile,Trop Facile / Trop Facile
3368,49,2019,Ingenieurie,5,9,QCU,0.9736,0.08,0.96,94,94,92,2,1.0,97.87,92,2,97.36,Trop Facile,Trop Facile,Trop Facile / Trop Facile
4198,49,2020,Ingenieurie,5,9,QCU,0.9732,0.08,0.97,92,90,90,0,1.02,100.0,90,2,97.32,Trop Facile,Trop Facile,Trop Facile / Trop Facile
49,50,2015,Ingenieurie,5,10,QCM,0.8063,0.02,0.74,49,45,40,5,1.09,88.89,40,9,80.63,Facile,Facile,Facile / Facile
879,50,2016,Ingenieurie,5,10,QCM,0.8307,0.19,0.78,48,45,40,5,1.07,88.89,40,8,83.07,Facile,Facile,Facile / Facile
1709,50,2017,Ingenieurie,5,10,QCM,0.7768,0.15,0.76,55,50,43,7,1.1,86.0,43,12,77.68,Facile,Facile,Facile / Facile
2539,50,2018,Ingenieurie,5,10,QCM,0.8349,0.04,0.78,59,53,49,4,1.11,92.45,49,10,83.49,Facile,Facile,Facile / Facile
3369,50,2019,Ingenieurie,5,10,QCM,0.1274,0.2,0.23,59,59,8,51,1.0,13.56,8,51,12.74,Facile,Trop Difficile,Facile / Trop Difficile
4199,50,2020,Ingenieurie,5,10,QCM,0.806,0.03,0.73,52,44,42,2,1.18,95.45,42,10,80.6,Facile,Facile,Facile / Facile
50,51,2015,Ingenieurie,6,1,QCU,0.7259,0.23,0.52,32,30,23,7,1.07,76.67,23,9,72.59,Facile,Adapte,Facile / Adapte
880,51,2016,Ingenieurie,6,1,QCU,0.6822,0.02,0.44,32,27,22,5,1.19,81.48,22,10,68.22,Adapte,Adapte,Adapte / Adapte
1710,51,2017,Ingenieurie,6,1,QCU,0.6447,0.24,0.64,31,27,20,7,1.15,74.07,20,11,64.47,Adapte,Adapte,Adapte / Adapte
2540,51,2018,Ingenieurie,6,1,QCU,0.7049,0.15,0.55,34,28,24,4,1.21,85.71,24,10,70.49,Adapte,Adapte,Adapte / Adapte
3370,51,2019,Ingenieurie,6,1,QCU,0.607,0.02,0.49,27,25,16,9,1.08,64.0,16,11,60.7,Adapte,Adapte,Adapte / Adapte
4200,51,2020,Ingenieurie,6,1,QCU,0.6446,0.13,0.64,32,30,21,9,1.07,70.0,21,11,64.46,Adapte,Adapte,Adapte / Adapte
51,52,2015,Ingenieurie,6,2,QCM,0.4557,0.21,0.33,56,54,26,28,1.04,48.15,26,30,45.57,Difficile,Difficile,Difficile / Difficile
881,52,2016,Ingenieurie,6,2,QCM,0.3612,0.17,0.34,50,40,18,22,1.25,45.0,18,32,36.12,Facile,Difficile,Facile / Difficile
1711,52,2017,Ingenieurie,6,2,QCM,0.4743,0.32,0.39,48,26,23,3,1.85,88.46,23,25,47.43,Facile,Difficile,Facile / Difficile
2541,52,2018,Ingenieurie,6,2,QCM,0.7776,0.14,0.72,48,46,37,9,1.04,80.43,37,11,77.76,Facile,Facile,Facile / Facile
3371,52,2019,Ingenieurie,6,2,QCM,0.8382,0.02,0.77,49,43,41,2,1.14,95.35,41,8,83.82,Facile,Facile,Facile / Facile
4201,52,2020,Ingenieurie,6,2,QCM,0.8374,0.12,0.7,45,43,38,5,1.05,88.37,38,7,83.74,Facile,Facile,Facile / Facile
52,53,2015,Ingenieurie,6,3,QROC,0.773,0.18,0.66,39,34,30,4,1.15,88.24,30,9,77.3,Facile,Facile,Facile / Facile
882,53,2016,Ingenieurie,6,3,QROC,0.7603,0.19,0.67,37,35,28,7,1.06,80.0,28,9,76.03,Facile,Facile,Facile / Facile
1712,53,2017,Ingenieurie,6,3,QROC,0.8347,0.2,0.44,32,28,27,1,1.14,96.43,27,5,83.47,Facile,Facile,Facile / Facile
2542,53,2018,Ingenieurie,6,3,QROC,0.8197,0.11,0.67,34,32,28,4,1.06,87.5,28,6,81.97,Facile,Facile,Facile / Facile
3372,53,2019,Ingenieurie,6,3,QROC,0.7734,0.06,0.7,37,32,29,3,1.16,90.62,29,8,77.34,Facile,Facile,Facile / Facile
4202,53,2020,Ingenieurie,6,3,QROC,0.827,0.03,0.66,39,34,32,2,1.15,94.12,32,7,82.7,Facile,Facile,Facile / Facile
53,54,2015,Ingenieurie,6,4,QCU,0.977,0.0,0.91,84,84,82,2,1.0,97.62,82,2,97.7,Trop Facile,Trop Facile,Trop Facile / Trop Facile
883,54,2016,Ingenieurie,6,4,QCU,0.7902,0.14,0.85,75,70,59,11,1.07,84.29,59,16,79.02,Trop Facile,Facile,Trop Facile / Facile
1713,54,2017,Ingenieurie,6,4,QCU,0.9744,0.04,0.92,67,66,65,1,1.02,98.48,65,2,97.44,Trop Facile,Trop Facile,Trop Facile / Trop Facile
2543,54,2018,Ingenieurie,6,4,QCU,0.9655,0.06,0.91,54,52,52,0,1.04,100.0,52,2,96.55,Trop Facile,Trop Facile,Trop Facile / Trop Facile
3373,54,2019,Ingenieurie,6,4,QCU,0.1379,0.44,0.21,61,21,8,13,2.9,38.1,8,53,13.79,Trop Facile,Trop Difficile,Trop Facile / Trop Difficile
4203,54,2020,Ingenieurie,6,4,QCU,0.7611,0.07,0.82,69,67,53,14,1.03,79.1,53,16,76.11,Trop Facile,Facile,Trop Facile / Facile
54,55,2015,Ingenieurie,6,5,QCU,0.8823,0.02,0.95,58,56,51,5,1.04,91.07,51,7,88.23,Trop Facile,Trop Facile,Trop Facile / Trop Facile
884,55,2016,Ingenieurie,6,5,QCU,0.2909,0.03,0.35,54,49,16,33,1.1,32.65,16,38,29.09,Trop Facile,Difficile,Trop Facile / Difficile
1714,55,2017,Ingenieurie,6,5,QCU,0.0872,0.25,0.3,56,35,5,30,1.6,14.29,5,51,8.72,Trop Facile,Trop Difficile,Trop Facile / Trop Difficile
2544,55,2018,Ingenieurie,6,5,QCU,0.9696,0.06,0.95,57,55,55,0,1.04,100.0,55,2,96.96,Trop Facile,Trop Facile,Trop Facile / Trop Facile
3374,55,2019,Ingenieurie,6,5,QCU,0.9898,0.07,0.9,66,66,65,1,1.0,98.48,65,1,98.98,Trop Facile,Trop Facile,Trop Facile / Trop Facile
4204,55,2020,Ingenieurie,6,5,QCU,0.8773,0.08,0.97,54,49,47,2,1.1,95.92,47,7,87.73,Trop Facile,Trop Facile,Trop Facile / Trop Facile
55,56,2015,Ingenieurie,6,6,QCM,0.2659,0.1,0.39,82,45,22,23,1.82,48.89,22,60,26.59,Difficile,Difficile,Difficile / Difficile
885,56,2016,Ingenieurie,6,6,QCM,0.6833,0.03,0.52,91,69,62,7,1.32,89.86,62,29,68.33,Facile,Adapte,Facile / Adapte
1715,56,2017,Ingenieurie,6,6,QCM,0.7066,0.17,0.62,89,75,63,12,1.19,84.0,63,26,70.66,Adapte,Adapte,Adapte / Adapte
2545,56,2018,Ingenieurie,6,6,QCM,0.6911,0.19,0.61,77,57,53,4,1.35,92.98,53,24,69.11,Adapte,Adapte,Adapte / Adapte
3375,56,2019,Ingenieurie,6,6,QCM,0.6643,0.16,0.68,63,47,42,5,1.34,89.36,42,21,66.43,Adapte,Adapte,Adapte / Adapte
4205,56,2020,Ingenieurie,6,6,QCM,0.6802,0.08,0.5,66,64,45,19,1.03,70.31,45,21,68.02,Adapte,Adapte,Adapte / Adapte
56,57,2015,Ingenieurie,7,1,QCU,0.5144,0.11,0.33,32,30,16,14,1.07,53.33,16,16,51.44,Difficile,Difficile,Difficile / Difficile
886,57,2016,Ingenieurie,7,1,QCU,0.8989,0.06,0.95,30,30,27,3,1.0,90.0,27,3,89.89,Trop Facile,Trop Facile,Trop Facile / Trop Facile
1716,57,2017,Ingenieurie,7,1,QCU,0.7645,0.14,0.89,27,25,21,4,1.08,84.0,21,6,76.45,Trop Facile,Facile,Trop Facile / Facile
2546,57,2018,Ingenieurie,7,1,QCU,0.895,0.04,0.98,25,23,22,1,1.09,95.65,22,3,89.5,Trop Facile,Trop Facile,Trop Facile / Trop Facile
3376,57,2019,Ingenieurie,7,1,QCU,0.9501,0.08,0.93,20,20,19,1,1.0,95.0,19,1,95.01,Trop Facile,Trop Facile,Trop Facile / Trop Facile
4206,57,2020,Ingenieurie,7,1,QCU,0.9324,0.0,0.95,20,20,19,1,1.0,95.0,19,1,93.24,Trop Facile,Trop Facile,Trop Facile / Trop Facile
57,58,2015,Ingenieurie,7,2,QROC,0.7184,0.24,0.36,58,52,42,10,1.12,80.77,42,16,71.84,Adapte,Adapte,Adapte / Adapte
887,58,2016,Ingenieurie,7,2,QROC,0.684,0.23,0.29,64,47,44,3,1.36,93.62,44,20,68.4,Adapte,Adapte,Adapte / Adapte
1717,58,2017,Ingenieurie,7,2,QROC,0.6709,0.21,0.29,74,67,50,17,1.1,74.63,50,24,67.09,Adapte,Adapte,Adapte / Adapte
2547,58,2018,Ingenieurie,7,2,QROC,0.7094,0.26,0.35,67,64,48,16,1.05,75.0,48,19,70.94,Adapte,Adapte,Adapte / Adapte
3377,58,2019,Ingenieurie,7,2,QROC,0.6973,0.37,0.38,76,73,53,20,1.04,72.6,53,23,69.73,Adapte,Adapte,Adapte / Adapte
4207,58,2020,Ingenieurie,7,2,QROC,0.6191,0.3,0.37,89,56,55,1,1.59,98.21,55,34,61.91,Adapte,Adapte,Adapte / Adapte
58,59,2015,Ingenieurie,8,1,QCU,0.611,0.17,0.47,18,13,11,2,1.38,84.62,11,7,61.1,Adapte,Adapte,Adapte / Adapte
888,59,2016,Ingenieurie,8,1,QCU,0.6415,0.15,0.44,14,10,9,1,1.4,90.0,9,5,64.15,Adapte,Adapte,Adapte / Adapte
1718,59,2017,Ingenieurie,8,1,QCU,0.7239,0.22,0.64,11,8,8,0,1.38,100.0,8,3,72.39,Adapte,Adapte,Adapte / Adapte
2548,59,2018,Ingenieurie,8,1,QCU,0.7285,0.11,0.65,10,10,7,3,1.0,70.0,7,3,72.85,Adapte,Adapte,Adapte / Adapte
3378,59,2019,Ingenieurie,8,1,QCU,0.6895,0.14,0.61,8,7,6,1,1.14,85.71,6,2,68.95,Adapte,Adapte,Adapte / Adapte
4208,59,2020,Ingenieurie,8,1,QCU,0.7116,0.11,0.5,9,8,6,2,1.12,75.0,6,3,71.16,Adapte,Adapte,Adapte / Adapte
59,60,2015,Ingenieurie,8,2,QROC,0.9639,0.05,0.83,90,89,87,2,1.01,97.75,87,3,96.39,Difficile,Trop Facile,Difficile / Trop Facile
889,60,2016,Ingenieurie,8,2,QROC,0.8026,0.04,0.64,72,70,58,12,1.03,82.86,58,14,80.26,Facile,Facile,Facile / Facile
1719,60,2017,Ingenieurie,8,2,QROC,0.8443,0.13,0.73,59,51,50,1,1.16,98.04,50,9,84.43,Facile,Facile,Facile / Facile
2549,60,2018,Ingenieurie,8,2,QROC,0.8,0.16,0.46,61,60,49,11,1.02,81.67,49,12,80.0,Facile,Facile,Facile / Facile
3379,60,2019,Ingenieurie,8,2,QROC,0.7806,0.04,0.41,58,54,45,9,1.07,83.33,45,13,78.06,Facile,Facile,Facile / Facile
4209,60,2020,Ingenieurie,8,2,QROC,0.8026,0.11,0.51,63,56,51,5,1.12,91.07,51,12,80.26,Facile,Facile,Facile / Facile
60,61,2015,Ingenieurie,9,1,QCU,0.7376,0.2,0.61,17,14,13,1,1.21,92.86,13,4,73.76,Facile,Adapte,Facile / Adapte
890,61,2016,Ingenieurie,9,1,QCU,0.6152,0.27,0.48,17,11,10,1,1.55,90.91,10,7,61.52,Adapte,Adapte,Adapte / Adapte
1720,61,2017,Ingenieurie,9,1,QCU,0.6314,0.12,0.56,18,15,11,4,1.2,73.33,11,7,63.14,Adapte,Adapte,Adapte / Adapte
2550,61,2018,Ingenieurie,9,1,QCU,0.6019,0.03,0.6,21,17,13,4,1.24,76.47,13,8,60.19,Adapte,Adapte,Adapte / Adapte
3380,61,2019,Ingenieurie,9,1,QCU,0.6428,0.13,0.43,22,17,14,3,1.29,82.35,14,8,64.28,Adapte,Adapte,Adapte / Adapte
4210,61,2020,Ingenieurie,9,1,QCU,0.6555,0.05,0.48,24,22,16,6,1.09,72.73,16,8,65.55,Adapte,Adapte,Adapte / Adapte
61,62,2015,Ingenieurie,9,2,QCM,0.9008,0.01,0.81,75,70,68,2,1.07,97.14,68,7,90.08,Trop Facile,Trop Facile,Trop Facile / Trop Facile
891,62,2016,Ingenieurie,9,2,QCM,0.7307,0.16,0.65,87,81,64,17,1.07,79.01,64,23,73.07,Facile,Adapte,Facile / Adapte
1721,62,2017,Ingenieurie,9,2,QCM,0.6689,0.07,0.52,71,59,47,12,1.2,79.66,47,24,66.89,Adapte,Adapte,Adapte / Adapte
2551,62,2018,Ingenieurie,9,2,QCM,0.6927,0.22,0.42,83,77,57,20,1.08,74.03,57,26,69.27,Adapte,Adapte,Adapte / Adapte
3381,62,2019,Ingenieurie,9,2,QCM,0.6858,0.27,0.51,68,57,47,10,1.19,82.46,47,21,68.58,Adapte,Adapte,Adapte / Adapte
4211,62,2020,Ingenieurie,9,2,QCM,0.7134,0.16,0.47,69,55,49,6,1.25,89.09,49,20,71.34,Adapte,Adapte,Adapte / Adapte
62,63,2015,Ingenieurie,9,3,QCU,0.6675,0.04,0.55,46,32,31,1,1.44,96.88,31,15,66.75,Trop Difficile,Adapte,Trop Difficile / Adapte
892,63,2016,Ingenieurie,9,3,QCU,0.6233,0.16,0.54,54,45,34,11,1.2,75.56,34,20,62.33,Adapte,Adapte,Adapte / Adapte
1722,63,2017,Ingenieurie,9,3,QCU,0.6994,0.06,0.69,45,41,31,10,1.1,75.61,31,14,69.94,Adapte,Adapte,Adapte / Adapte
2552,63,2018,Ingenieurie,9,3,QCU,0.6923,0.23,0.56,44,37,30,7,1.19,81.08,30,14,69.23,Adapte,Adapte,Adapte / Adapte
3382,63,2019,Ingenieurie,9,3,QCU,0.7306,0.15,0.44,38,37,28,9,1.03,75.68,28,10,73.06,Adapte,Adapte,Adapte / Adapte
4212,63,2020,Ingenieurie,9,3,QCU,0.7252,0.26,0.65,36,35,26,9,1.03,74.29,26,10,72.52,Adapte,Adapte,Adapte / Adapte
63,64,2015,Ingenieurie,9,4,QCU,0.7615,0.04,0.81,97,75,74,1,1.29,98.67,74,23,76.15,Facile,Facile,Facile / Facile
893,64,2016,Ingenieurie,9,4,QCU,0.8642,0.08,1.0,91,79,79,0,1.15,100.0,79,12,86.42,Trop Facile,Trop Facile,Trop Facile / Trop Facile
1723,64,2017,Ingenieurie,9,4,QCU,0.928,0.01,0.92,101,95,94,1,1.06,98.95,94,7,92.8,Trop Facile,Trop Facile,Trop Facile / Trop Facile
2553,64,2018,Ingenieurie,9,4,QCU,0.7861,0.15,0.88,119,102,94,8,1.17,92.16,94,25,78.61,Trop Facile,Facile,Trop Facile / Facile
3383,64,2019,Ingenieurie,9,4,QCU,0.6707,0.28,0.56,114,97,76,21,1.18,78.35,76,38,67.07,Trop Facile,Adapte,Trop Facile / Adapte
4213,64,2020,Ingenieurie,9,4,QCU,0.6384,0.18,0.51,103,96,66,30,1.07,68.75,66,37,63.84,Adapte,Adapte,Adapte / Adapte
64,65,2015,Ingenieurie,9,5,QCU,0.0461,0.12,0.24,29,15,1,14,1.93,6.67,1,28,4.61,Trop Difficile,Trop Difficile,Trop Difficile / Trop Difficile
894,65,2016,Ingenieurie,9,5,QCU,0.9926,0.03,0.94,29,29,29,0,1.0,100.0,29,0,99.26,Trop Facile,Trop Facile,Trop Facile / Trop Facile
1724,65,2017,Ingenieurie,9,5,QCU,0.9333,0.1,0.97,32,32,30,2,1.0,93.75,30,2,93.33,Trop Facile,Trop Facile,Trop Facile / Trop Facile
2554,65,2018,Ingenieurie,9,5,QCU,0.9031,0.04,0.98,30,29,27,2,1.03,93.1,27,3,90.31,Trop Facile,Trop Facile,Trop Facile / Trop Facile
3384,65,2019,Ingenieurie,9,5,QCU,0.4243,0.29,0.37,28,15,12,3,1.87,80.0,12,16,42.43,Trop Facile,Difficile,Trop Facile / Difficile
4214,65,2020,Ingenieurie,9,5,QCU,0.9413,0.0,0.95,26,25,24,1,1.04,96.0,24,2,94.13,Trop Facile,Trop Facile,Trop Facile / Trop Facile
65,66,2015,Ingenieurie,9,6,QCU,0.8184,0.05,0.77,89,85,73,12,1.05,85.88,73,16,81.84,Facile,Facile,Facile / Facile
895,66,2016,Ingenieurie,9,6,QCU,0.7127,0.02,0.7,76,57,54,3,1.33,94.74,54,22,71.27,Trop Facile,Adapte,Trop Facile / Adapte
1725,66,2017,Ingenieurie,9,6,QCU,0.7498,0.12,0.62,83,67,62,5,1.24,92.54,62,21,74.98,Adapte,Adapte,Adapte / Adapte
2555,66,2018,Ingenieurie,9,6,QCU,0.7208,0.11,0.59,66,55,48,7,1.2,87.27,48,18,72.08,Adapte,Adapte,Adapte / Adapte
3385,66,2019,Ingenieurie,9,6,QCU,0.6308,0.16,0.47,79,56,50,6,1.41,89.29,50,29,63.08,Adapte,Adapte,Adapte / Adapte
4215,66,2020,Ingenieurie,9,6,QCU,0.7352,0.05,0.61,78,75,57,18,1.04,76.0,57,21,73.52,Adapte,Adapte,Adapte / Adapte
66,67,2015,Ingenieurie,9,7,QCU,0.046,0.34,0.21,32,17,1,16,1.88,5.88,1,31,4.6,Trop Difficile,Trop Difficile,Trop Difficile / Trop Difficile
896,67,2016,Ingenieurie,9,7,QCU,0.9425,0.05,0.92,26,26,25,1,1.0,96.15,25,1,94.25,Trop Facile,Trop Facile,Trop Facile / Trop Facile
1726,67,2017,Ingenieurie,9,7,QCU,0.9912,0.09,0.9,27,27,27,0,1.0,100.0,27,0,99.12,Trop Facile,Trop Facile,Trop Facile / Trop Facile
2556,67,2018,Ingenieurie,9,7,QCU,0.9214,0.09,0.95,28,26,26,0,1.08,100.0,26,2,92.14,Trop Facile,Trop Facile,Trop Facile / Trop Facile
3386,67,2019,Ingenieurie,9,7,QCU,0.6148,0.21,0.42,23,15,14,1,1.53,93.33,14,9,61.48,Trop Facile,Adapte,Trop Facile / Adapte
4216,67,2020,Ingenieurie,9,7,QCU,0.6857,0.18,0.6,19,13,13,0,1.46,100.0,13,6,68.57,Adapte,Adapte,Adapte / Adapte
67,68,2015,Ingenieurie,9,8,QCU,0.9714,0.06,0.95,18,18,17,1,1.0,94.44,17,1,97.14,Trop Facile,Trop Facile,Trop Facile / Trop Facile
897,68,2016,Ingenieurie,9,8,QCU,0.0543,0.06,0.24,19,11,1,10,1.73,9.09,1,18,5.43,Trop Facile,Trop Difficile,Trop Facile / Trop Difficile
1727,68,2017,Ingenieurie,9,8,QCU,0.9674,0.03,0.97,20,19,19,0,1.05,100.0,19,1,96.74,Trop Facile,Trop Facile,Trop Facile / Trop Facile
2557,68,2018,Ingenieurie,9,8,QCU,0.9565,0.04,0.96,24,23,23,0,1.04,100.0,23,1,95.65,Trop Facile,Trop Facile,Trop Facile / Trop Facile
3387,68,2019,Ingenieurie,9,8,QCU,0.5667,0.18,0.31,28,18,16,2,1.56,88.89,16,12,56.67,Trop Facile,Difficile,Trop Facile / Difficile
4217,68,2020,Ingenieurie,9,8,QCU,0.0438,0.35,0.3,26,21,1,20,1.24,4.76,1,25,4.38,Trop Facile,Trop Difficile,Trop Facile / Trop Difficile
68,69,2015,Ingenieurie,9,9,QCM,0.0955,0.18,0.23,24,8,2,6,3.0,25.0,2,22,9.55,Trop Difficile,Trop Difficile,Trop Difficile / Trop Difficile
898,69,2016,Ingenieurie,9,9,QCM,0.8061,0.06,0.78,24,22,19,3,1.09,86.36,19,5,80.61,Facile,Facile,Facile / Facile
1728,69,2017,Ingenieurie,9,9,QCM,0.724,0.15,0.4,21,15,15,0,1.4,100.0,15,6,72.4,Facile,Adapte,Facile / Adapte
2558,69,2018,Ingenieurie,9,9,QCM,0.7097,0.2,0.62,20,20,14,6,1.0,70.0,14,6,70.97,Adapte,Adapte,Adapte / Adapte
3388,69,2019,Ingenieurie,9,9,QCM,0.6782,0.16,0.52,23,22,16,6,1.05,72.73,16,7,67.82,Adapte,Adapte,Adapte / Adapte
4218,69,2020,Ingenieurie,9,9,QCM,0.6455,0.16,0.56,22,19,14,5,1.16,73.68,14,8,64.55,Adapte,Adapte,Adapte / Adapte
69,70,2015,Ingenieurie,9,10,QROC,0.9322,0.02,0.91,51,48,48,0,1.06,100.0,48,3,93.22,Trop Facile,Trop Facile,Trop Facile / Trop Facile
899,70,2016,Ingenieurie,9,10,QROC,0.839,0.2,0.47,54,52,45,7,1.04,86.54,45,9,83.9,Facile,Facile,Facile / Facile
1729,70,2017,Ingenieurie,9,10,QROC,0.8202,0.05,0.63,56,55,46,9,1.02,83.64,46,10,82.02,Facile,Facile,Facile / Facile
2559,70,2018,Ingenieurie,9,10,QROC,0.9316,0.02,0.5,54,53,50,3,1.02,94.34,50,4,93.16,Facile,Trop Facile,Facile / Trop Facile
3389,70,2019,Ingenieurie,9,10,QROC,0.7935,0.09,0.65,63,51,50,1,1.24,98.04,50,13,79.35,Facile,Facile,Facile / Facile
4219,70,2020,Ingenieurie,9,10,QROC,0.8049,0.06,0.71,55,52,44,8,1.06,84.62,44,11,80.49,Facile,Facile,Facile / Facile
70,71,2015,Ingenieurie,10,1,QROC,0.5236,0.59,0.21,63,57,33,24,1.11,57.89,33,30,52.36,Difficile,Difficile,Difficile / Difficile
900,71,2016,Ingenieurie,10,1,QROC,0.9022,0.03,0.66,62,57,56,1,1.09,98.25,56,6,90.22,Facile,Trop Facile,Facile / Trop Facile
1730,71,2017,Ingenieurie,10,1,QROC,0.7446,0.41,0.27,56,47,42,5,1.19,89.36,42,14,74.46,Facile,Adapte,Facile / Adapte
2560,71,2018,Ingenieurie,10,1,QROC,0.7298,0.46,0.28,48,45,35,10,1.07,77.78,35,13,72.98,Adapte,Adapte,Adapte / Adapte
3390,71,2019,Ingenieurie,10,1,QROC,0.6759,0.48,0.34,53,36,36,0,1.47,100.0,36,17,67.59,Adapte,Adapte,Adapte / Adapte
4220,71,2020,Ingenieurie,10,1,QROC,0.7071,0.43,0.32,61,55,43,12,1.11,78.18,43,18,70.71,Adapte,Adapte,Adapte / Adapte
71,72,2015,Ingenieurie,10,2,QCU,0.1336,0.03,0.26,34,15,5,10,2.27,33.33,5,29,13.36,Trop Difficile,Trop Difficile,Trop Difficile / Trop Difficile
901,72,2016,Ingenieurie,10,2,QCU,0.9696,0.09,0.91,38,37,37,0,1.03,100.0,37,1,96.96,Trop Facile,Trop Facile,Trop Facile / Trop Facile
1731,72,2017,Ingenieurie,10,2,QCU,0.6331,0.1,0.52,34,27,22,5,1.26,81.48,22,12,63.31,Trop Facile,Adapte,Trop Facile / Adapte
2561,72,2018,Ingenieurie,10,2,QCU,0.6048,0.26,0.49,32,20,19,1,1.6,95.0,19,13,60.48,Adapte,Adapte,Adapte / Adapte
3391,72,2019,Ingenieurie,10,2,QCU,0.6043,0.1,0.4,32,30,19,11,1.07,63.33,19,13,60.43,Adapte,Adapte,Adapte / Adapte
4221,72,2020,Ingenieurie,10,2,QCU,0.7357,0.19,0.51,37,35,27,8,1.06,77.14,27,10,73.57,Adapte,Adapte,Adapte / Adapte
72,73,2015,Ingenieurie,11,1,QCM,0.8045,0.12,0.74,82,73,66,7,1.12,90.41,66,16,80.45,Trop Facile,Facile,Trop Facile / Facile
902,73,2016,Ingenieurie,11,1,QCM,0.9555,0.06,0.97,91,91,87,4,1.0,95.6,87,4,95.55,Facile,Trop Facile,Facile / Trop Facile
1732,73,2017,Ingenieurie,11,1,QCM,0.8454,0.07,0.77,105,93,89,4,1.13,95.7,89,16,84.54,Facile,Facile,Facile / Facile
2562,73,2018,Ingenieurie,11,1,QCM,0.8264,0.02,0.79,108,95,89,6,1.14,93.68,89,19,82.64,Facile,Facile,Facile / Facile
3392,73,2019,Ingenieurie,11,1,QCM,0.8789,0.05,0.88,102,92,90,2,1.11,97.83,90,12,87.89,Facile,Trop Facile,Facile / Trop Facile
4222,73,2020,Ingenieurie,11,1,QCM,0.3568,0.44,0.33,110,89,39,50,1.24,43.82,39,71,35.68,Facile,Difficile,Facile / Difficile
73,74,2015,Ingenieurie,11,2,QCM,0.9752,0.06,0.9,48,48,47,1,1.0,97.92,47,1,97.52,Trop Facile,Trop Facile,Trop Facile / Trop Facile
903,74,2016,Ingenieurie,11,2,QCM,0.7601,0.08,0.71,51,49,39,10,1.04,79.59,39,12,76.01,Facile,Facile,Facile / Facile
1733,74,2017,Ingenieurie,11,2,QCM,0.9788,0.03,0.98,61,60,60,0,1.02,100.0,60,1,97.88,Facile,Trop Facile,Facile / Trop Facile
2563,74,2018,Ingenieurie,11,2,QCM,0.7724,0.2,0.75,68,57,53,4,1.19,92.98,53,15,77.24,Facile,Facile,Facile / Facile
3393,74,2019,Ingenieurie,11,2,QCM,0.7802,0.1,0.77,63,58,49,9,1.09,84.48,49,14,78.02,Facile,Facile,Facile / Facile
4223,74,2020,Ingenieurie,11,2,QCM,0.9016,0.04,0.93,62,60,56,4,1.03,93.33,56,6,90.16,Facile,Trop Facile,Facile / Trop Facile
74,75,2015,Ingenieurie,11,3,QROC,0.2027,0.85,0.06,78,34,16,18,2.29,47.06,16,62,20.27,Trop Difficile,Trop Difficile,Trop Difficile / Trop Difficile
904,75,2016,Ingenieurie,11,3,QROC,0.6436,0.22,0.33,84,71,54,17,1.18,76.06,54,30,64.36,Facile,Adapte,Facile / Adapte
1734,75,2017,Ingenieurie,11,3,QROC,0.7111,0.34,0.26,97,80,69,11,1.21,86.25,69,28,71.11,Adapte,Adapte,Adapte / Adapte
2564,75,2018,Ingenieurie,11,3,QROC,0.6918,0.25,0.35,90,88,62,26,1.02,70.45,62,28,69.18,Adapte,Adapte,Adapte / Adapte
3394,75,2019,Ingenieurie,11,3,QROC,0.6374,0.49,0.37,73,70,47,23,1.04,67.14,47,26,63.74,Adapte,Adapte,Adapte / Adapte
4224,75,2020,Ingenieurie,11,3,QROC,0.6623,0.48,0.28,88,84,58,26,1.05,69.05,58,30,66.23,Adapte,Adapte,Adapte / Adapte
75,76,2015,Ingenieurie,11,4,QCM,0.6044,0.25,0.62,13,11,8,3,1.18,72.73,8,5,60.44,Adapte,Adapte,Adapte / Adapte
905,76,2016,Ingenieurie,11,4,QCM,0.6494,0.13,0.59,12,8,8,0,1.5,100.0,8,4,64.94,Adapte,Adapte,Adapte / Adapte
1735,76,2017,Ingenieurie,11,4,QCM,0.6075,0.19,0.42,10,10,6,4,1.0,60.0,6,4,60.75,Adapte,Adapte,Adapte / Adapte
2565,76,2018,Ingenieurie,11,4,QCM,0.7374,0.1,0.46,10,8,7,1,1.25,87.5,7,3,73.74,Adapte,Adapte,Adapte / Adapte
3395,76,2019,Ingenieurie,11,4,QCM,0.6682,0.04,0.58,12,8,8,0,1.5,100.0,8,4,66.82,Adapte,Adapte,Adapte / Adapte
4225,76,2020,Ingenieurie,11,4,QCM,0.6437,0.01,0.57,13,9,8,1,1.44,88.89,8,5,64.37,Adapte,Adapte,Adapte / Adapte
76,77,2015,Ingenieurie,11,5,QCM,0.7668,0.07,0.7,38,37,29,8,1.03,78.38,29,9,76.68,Difficile,Facile,Difficile / Facile
906,77,2016,Ingenieurie,11,5,QCM,0.9228,0.07,0.96,36,33,33,0,1.09,100.0,33,3,92.28,Facile,Trop Facile,Facile / Trop Facile
1736,77,2017,Ingenieurie,11,5,QCM,0.6119,0.19,0.69,41,34,25,9,1.21,73.53,25,16,61.19,Facile,Adapte,Facile / Adapte
2566,77,2018,Ingenieurie,11,5,QCM,0.6157,0.12,0.52,37,27,23,4,1.37,85.19,23,14,61.57,Adapte,Adapte,Adapte / Adapte
3396,77,2019,Ingenieurie,11,5,QCM,0.6372,0.28,0.66,35,28,22,6,1.25,78.57,22,13,63.72,Adapte,Adapte,Adapte / Adapte
4226,77,2020,Ingenieurie,11,5,QCM,0.7485,0.16,0.66,32,24,24,0,1.33,100.0,24,8,74.85,Adapte,Adapte,Adapte / Adapte
77,78,2015,Ingenieurie,11,6,QROC,0.1686,0.79,0.0,77,33,13,20,2.33,39.39,13,64,16.86,Trop Difficile,Trop Difficile,Trop Difficile / Trop Difficile
907,78,2016,Ingenieurie,11,6,QROC,0.8112,0.16,0.47,92,76,75,1,1.21,98.68,75,17,81.12,Facile,Facile,Facile / Facile
1737,78,2017,Ingenieurie,11,6,QROC,0.7648,0.04,0.71,76,68,58,10,1.12,85.29,58,18,76.48,Facile,Facile,Facile / Facile
2567,78,2018,Ingenieurie,11,6,QROC,0.8211,0.1,0.67,88,81,72,9,1.09,88.89,72,16,82.11,Facile,Facile,Facile / Facile
3397,78,2019,Ingenieurie,11,6,QROC,0.8433,0.15,0.53,81,79,68,11,1.03,86.08,68,13,84.33,Facile,Facile,Facile / Facile
4227,78,2020,Ingenieurie,11,6,QROC,0.7757,0.12,0.68,92,80,71,9,1.15,88.75,71,21,77.57,Facile,Facile,Facile / Facile
78,79,2015,Ingenieurie,11,7,QCU,0.7809,0.1,0.77,27,26,21,5,1.04,80.77,21,6,78.09,Facile,Facile,Facile / Facile
908,79,2016,Ingenieurie,11,7,QCU,0.9229,0.04,0.95,26,26,24,2,1.0,92.31,24,2,92.29,Trop Facile,Trop Facile,Trop Facile / Trop Facile
1738,79,2017,Ingenieurie,11,7,QCU,0.9912,0.03,0.97,28,28,28,0,1.0,100.0,28,0,99.12,Trop Facile,Trop Facile,Trop Facile / Trop Facile
2568,79,2018,Ingenieurie,11,7,QCU,0.9913,0.03,0.92,22,22,22,0,1.0,100.0,22,0,99.13,Trop Facile,Trop Facile,Trop Facile / Trop Facile
3398,79,2019,Ingenieurie,11,7,QCU,0.9703,0.03,0.91,26,25,25,0,1.04,100.0,25,1,97.03,Trop Facile,Trop Facile,Trop Facile / Trop Facile
4228,79,2020,Ingenieurie,11,7,QCU,0.3009,0.32,0.4,29,15,9,6,1.93,60.0,9,20,30.09,Trop Facile,Difficile,Trop Facile / Difficile
79,80,2015,Ingenieurie,12,1,QCU,0.1373,0.74,0.21,57,19,8,11,3.0,42.11,8,49,13.73,Trop Difficile,Trop Difficile,Trop Difficile / Trop Difficile
909,80,2016,Ingenieurie,12,1,QCU,0.7423,0.11,0.58,60,59,45,14,1.02,76.27,45,15,74.23,Trop Facile,Adapte,Trop Facile / Adapte
1739,80,2017,Ingenieurie,12,1,QCU,0.6093,0.28,0.43,69,48,42,6,1.44,87.5,42,27,60.93,Adapte,Adapte,Adapte / Adapte
2569,80,2018,Ingenieurie,12,1,QCU,0.7093,0.24,0.67,72,66,51,15,1.09,77.27,51,21,70.93,Adapte,Adapte,Adapte / Adapte
3399,80,2019,Ingenieurie,12,1,QCU,0.6835,0.19,0.51,59,58,40,18,1.02,68.97,40,19,68.35,Adapte,Adapte,Adapte / Adapte
4229,80,2020,Ingenieurie,12,1,QCU,0.7026,0.05,0.4,57,45,40,5,1.27,88.89,40,17,70.26,Adapte,Adapte,Adapte / Adapte
80,81,2015,Ingenieurie,12,2,QCM,0.6608,0.26,0.63,77,66,51,15,1.17,77.27,51,26,66.08,Adapte,Adapte,Adapte / Adapte
910,81,2016,Ingenieurie,12,2,QCM,0.6634,0.0,0.58,92,78,61,17,1.18,78.21,61,31,66.34,Adapte,Adapte,Adapte / Adapte
1740,81,2017,Ingenieurie,12,2,QCM,0.6388,0.18,0.44,104,68,66,2,1.53,97.06,66,38,63.88,Adapte,Adapte,Adapte / Adapte
2570,81,2018,Ingenieurie,12,2,QCM,0.7317,0.03,0.4,87,83,64,19,1.05,77.11,64,23,73.17,Adapte,Adapte,Adapte / Adapte
3400,81,2019,Ingenieurie,12,2,QCM,0.6242,0.09,0.54,93,89,58,31,1.04,65.17,58,35,62.42,Adapte,Adapte,Adapte / Adapte
4230,81,2020,Ingenieurie,12,2,QCM,0.6587,0.13,0.48,74,74,49,25,1.0,66.22,49,25,65.87,Adapte,Adapte,Adapte / Adapte
81,82,2015,Ingenieurie,12,3,QCM,0.6922,0.17,0.51,65,62,45,17,1.05,72.58,45,20,69.22,Difficile,Adapte,Difficile / Adapte
911,82,2016,Ingenieurie,12,3,QCM,0.7338,0.11,0.59,69,64,51,13,1.08,79.69,51,18,73.38,Adapte,Adapte,Adapte / Adapte
1741,82,2017,Ingenieurie,12,3,QCM,0.7476,0.09,0.6,68,63,51,12,1.08,80.95,51,17,74.76,Adapte,Adapte,Adapte / Adapte
2571,82,2018,Ingenieurie,12,3,QCM,0.6633,0.22,0.5,74,68,49,19,1.09,72.06,49,25,66.33,Adapte,Adapte,Adapte / Adapte
3401,82,2019,Ingenieurie,12,3,QCM,0.6242,0.06,0.5,88,79,55,24,1.11,69.62,55,33,62.42,Adapte,Adapte,Adapte / Adapte
4231,82,2020,Ingenieurie,12,3,QCM,0.6263,0.2,0.45,81,61,51,10,1.33,83.61,51,30,62.63,Adapte,Adapte,Adapte / Adapte
82,83,2015,Ingenieurie,12,4,QROC,0.8175,0.17,0.72,77,77,63,14,1.0,81.82,63,14,81.75,Adapte,Facile,Adapte / Facile
912,83,2016,Ingenieurie,12,4,QROC,0.9928,0.01,0.9,62,62,62,0,1.0,100.0,62,0,99.28,Facile,Trop Facile,Facile / Trop Facile
1742,83,2017,Ingenieurie,12,4,QROC,0.8284,0.03,0.56,64,64,53,11,1.0,82.81,53,11,82.84,Facile,Facile,Facile / Facile
2572,83,2018,Ingenieurie,12,4,QROC,0.8929,0.08,0.62,74,67,66,1,1.1,98.51,66,8,89.29,Facile,Trop Facile,Facile / Trop Facile
3402,83,2019,Ingenieurie,12,4,QROC,0.3134,0.62,0.2,87,39,27,12,2.23,69.23,27,60,31.34,Facile,Difficile,Facile / Difficile
4232,83,2020,Ingenieurie,12,4,QROC,0.8282,0.12,0.51,86,84,71,13,1.02,84.52,71,15,82.82,Facile,Facile,Facile / Facile
83,84,2015,Ingenieurie,12,5,QO,0.9902,0.04,0.9,83,82,82,0,1.01,100.0,82,1,99.02,Trop Difficile,Trop Facile,Trop Difficile / Trop Facile
913,84,2016,Ingenieurie,12,5,QO,0.0731,0.98,0.05,89,55,7,48,1.62,12.73,7,82,7.31,Adapte,Trop Difficile,Adapte / Trop Difficile
1743,84,2017,Ingenieurie,12,5,QO,0.7335,0.67,0.29,76,59,56,3,1.29,94.92,56,20,73.35,Adapte,Adapte,Adapte / Adapte
2573,84,2018,Ingenieurie,12,5,QO,0.6476,0.68,0.26,78,70,51,19,1.11,72.86,51,27,64.76,Adapte,Adapte,Adapte / Adapte
3403,84,2019,Ingenieurie,12,5,QO,0.726,0.43,0.25,80,64,58,6,1.25,90.62,58,22,72.6,Adapte,Adapte,Adapte / Adapte
4233,84,2020,Ingenieurie,12,5,QO,0.68,0.73,0.24,68,59,46,13,1.15,77.97,46,22,68.0,Adapte,Adapte,Adapte / Adapte
84,85,2015,Ingenieurie,12,6,QCM,0.9046,0.02,1.0,76,74,69,5,1.03,93.24,69,7,90.46,Trop Facile,Trop Facile,Trop Facile / Trop Facile
914,85,2016,Ingenieurie,12,6,QCM,0.1541,0.33,0.25,75,56,12,44,1.34,21.43,12,63,15.41,Facile,Trop Difficile,Facile / Trop Difficile
1744,85,2017,Ingenieurie,12,6,QCM,0.7753,0.03,0.71,77,69,60,9,1.12,86.96,60,17,77.53,Facile,Facile,Facile / Facile
2574,85,2018,Ingenieurie,12,6,QCM,0.8195,0.15,0.77,91,91,75,16,1.0,82.42,75,16,81.95,Facile,Facile,Facile / Facile
3404,85,2019,Ingenieurie,12,6,QCM,0.7944,0.11,0.76,80,72,64,8,1.11,88.89,64,16,79.44,Facile,Facile,Facile / Facile
4234,85,2020,Ingenieurie,12,6,QCM,0.8225,0.04,0.74,95,90,78,12,1.06,86.67,78,17,82.25,Facile,Facile,Facile / Facile
85,86,2015,Ingenieurie,12,7,QCM,0.1487,0.15,0.3,59,26,9,17,2.27,34.62,9,50,14.87,Trop Difficile,Trop Difficile,Trop Difficile / Trop Difficile
915,86,2016,Ingenieurie,12,7,QCM,0.6362,0.03,0.43,71,62,45,17,1.15,72.58,45,26,63.62,Facile,Adapte,Facile / Adapte
1745,86,2017,Ingenieurie,12,7,QCM,0.6504,0.06,0.5,60,51,39,12,1.18,76.47,39,21,65.04,Adapte,Adapte,Adapte / Adapte
2575,86,2018,Ingenieurie,12,7,QCM,0.6058,0.06,0.66,62,54,38,16,1.15,70.37,38,24,60.58,Adapte,Adapte,Adapte / Adapte
3405,86,2019,Ingenieurie,12,7,QCM,0.7151,0.17,0.48,50,46,36,10,1.09,78.26,36,14,71.51,Adapte,Adapte,Adapte / Adapte
4235,86,2020,Ingenieurie,12,7,QCM,0.7421,0.03,0.43,45,40,33,7,1.12,82.5,33,12,74.21,Adapte,Adapte,Adapte / Adapte
86,87,2015,Ingenieurie,12,8,QCM,0.4237,0.08,0.33,41,24,17,7,1.71,70.83,17,24,42.37,Trop Difficile,Difficile,Trop Difficile / Difficile
916,87,2016,Ingenieurie,12,8,QCM,0.7608,0.13,0.77,43,35,33,2,1.23,94.29,33,10,76.08,Facile,Facile,Facile / Facile
1746,87,2017,Ingenieurie,12,8,QCM,0.8082,0.15,0.73,47,45,38,7,1.04,84.44,38,9,80.82,Facile,Facile,Facile / Facile
2576,87,2018,Ingenieurie,12,8,QCM,0.8332,0.06,0.72,46,42,38,4,1.1,90.48,38,8,83.32,Facile,Facile,Facile / Facile
3406,87,2019,Ingenieurie,12,8,QCM,0.0476,0.67,0.2,37,21,2,19,1.76,9.52,2,35,4.76,Facile,Trop Difficile,Facile / Trop Difficile
4236,87,2020,Ingenieurie,12,8,QCM,0.9337,0.04,0.9,32,30,30,0,1.07,100.0,30,2,93.37,Facile,Trop Facile,Facile / Trop Facile
87,88,2015,Ingenieurie,12,9,QCM,0.6356,0.2,0.57,98,95,62,33,1.03,65.26,62,36,63.56,Trop Difficile,Adapte,Trop Difficile / Adapte
917,88,2016,Ingenieurie,12,9,QCM,0.6816,0.02,0.47,82,63,56,7,1.3,88.89,56,26,68.16,Adapte,Adapte,Adapte / Adapte
1747,88,2017,Ingenieurie,12,9,QCM,0.7263,0.0,0.42,83,73,60,13,1.14,82.19,60,23,72.63,Adapte,Adapte,Adapte / Adapte
2577,88,2018,Ingenieurie,12,9,QCM,0.6899,0.05,0.58,89,72,61,11,1.24,84.72,61,28,68.99,Adapte,Adapte,Adapte / Adapte
3407,88,2019,Ingenieurie,12,9,QCM,0.6445,0.16,0.45,71,61,46,15,1.16,75.41,46,25,64.45,Adapte,Adapte,Adapte / Adapte
4237,88,2020,Ingenieurie,12,9,QCM,0.6283,0.27,0.53,83,82,52,30,1.01,63.41,52,31,62.83,Adapte,Adapte,Adapte / Adapte
88,89,2015,Ingenieurie,13,1,QROC,0.216,0.83,0.06,28,22,6,16,1.27,27.27,6,22,21.6,Trop Difficile,Trop Difficile,Trop Difficile / Trop Difficile
918,89,2016,Ingenieurie,13,1,QROC,0.797,0.12,0.54,23,19,18,1,1.21,94.74,18,5,79.7,Facile,Facile,Facile / Facile
1748,89,2017,Ingenieurie,13,1,QROC,0.683,0.31,0.31,27,22,18,4,1.23,81.82,18,9,68.3,Facile,Adapte,Facile / Adapte
2578,89,2018,Ingenieurie,13,1,QROC,0.7274,0.27,0.39,25,23,18,5,1.09,78.26,18,7,72.74,Adapte,Adapte,Adapte / Adapte
3408,89,2019,Ingenieurie,13,1,QROC,0.6267,0.3,0.35,29,28,18,10,1.04,64.29,18,11,62.67,Adapte,Adapte,Adapte / Adapte
4238,89,2020,Ingenieurie,13,1,QROC,0.6724,0.37,0.29,30,29,20,9,1.03,68.97,20,10,67.24,Adapte,Adapte,Adapte / Adapte
89,90,2015,Ingenieurie,13,2,QROC,0.6684,0.45,0.31,97,80,65,15,1.21,81.25,65,32,66.84,Adapte,Adapte,Adapte / Adapte
919,90,2016,Ingenieurie,13,2,QROC,0.6689,0.39,0.39,98,93,66,27,1.05,70.97,66,32,66.89,Adapte,Adapte,Adapte / Adapte
1749,90,2017,Ingenieurie,13,2,QROC,0.7435,0.41,0.35,81,68,60,8,1.19,88.24,60,21,74.35,Adapte,Adapte,Adapte / Adapte
2579,90,2018,Ingenieurie,13,2,QROC,0.6842,0.36,0.27,86,66,59,7,1.3,89.39,59,27,68.42,Adapte,Adapte,Adapte / Adapte
3409,90,2019,Ingenieurie,13,2,QROC,0.6439,0.25,0.36,85,62,55,7,1.37,88.71,55,30,64.39,Adapte,Adapte,Adapte / Adapte
4239,90,2020,Ingenieurie,13,2,QROC,0.741,0.47,0.28,79,75,59,16,1.05,78.67,59,20,74.1,Adapte,Adapte,Adapte / Adapte
90,91,2015,Ingenieurie,13,3,QCM,0.288,0.46,0.33,8,2,2,0,4.0,100.0,2,6,28.8,Difficile,Difficile,Difficile / Difficile
920,91,2016,Ingenieurie,13,3,QCM,0.8131,0.13,0.72,8,8,7,1,1.0,87.5,7,1,81.31,Facile,Facile,Facile / Facile
1750,91,2017,Ingenieurie,13,3,QCM,0.5588,0.42,0.37,6,3,3,0,2.0,100.0,3,3,55.88,Facile,Difficile,Facile / Difficile
2580,91,2018,Ingenieurie,13,3,QCM,0.802,0.08,0.76,5,4,4,0,1.25,100.0,4,1,80.2,Facile,Facile,Facile / Facile
3410,91,2019,Ingenieurie,13,3,QCM,0.8305,0.05,0.71,6,5,5,0,1.2,100.0,5,1,83.05,Facile,Facile,Facile / Facile
4240,91,2020,Ingenieurie,13,3,QCM,0.8412,0.19,0.72,7,6,6,0,1.17,100.0,6,1,84.12,Facile,Facile,Facile / Facile
91,92,2015,Ingenieurie,13,4,QCU,0.2398,0.26,0.2,6,5,1,4,1.2,20.0,1,5,23.98,Facile,Trop Difficile,Facile / Trop Difficile
921,92,2016,Ingenieurie,13,4,QCU,0.8909,0.06,0.97,5,4,4,0,1.25,100.0,4,1,89.09,Trop Facile,Trop Facile,Trop Facile / Trop Facile
1751,92,2017,Ingenieurie,13,4,QCU,0.6905,0.17,0.47,5,4,3,1,1.25,75.0,3,2,69.05,Trop Facile,Adapte,Trop Facile / Adapte
2581,92,2018,Ingenieurie,13,4,QCU,0.6657,0.22,0.55,5,4,3,1,1.25,75.0,3,2,66.57,Adapte,Adapte,Adapte / Adapte
3411,92,2019,Ingenieurie,13,4,QCU,0.7341,0.01,0.7,6,4,4,0,1.5,100.0,4,2,73.41,Adapte,Adapte,Adapte / Adapte
4241,92,2020,Ingenieurie,13,4,QCU,0.7474,0.01,0.68,6,5,4,1,1.2,80.0,4,2,74.74,Adapte,Adapte,Adapte / Adapte
92,93,2015,Ingenieurie,13,5,QCM,0.151,0.43,0.22,34,20,5,15,1.7,25.0,5,29,15.1,Trop Facile,Trop Difficile,Trop Facile / Trop Difficile
922,93,2016,Ingenieurie,13,5,QCM,0.8105,0.07,0.72,28,26,23,3,1.08,88.46,23,5,81.05,Facile,Facile,Facile / Facile
1752,93,2017,Ingenieurie,13,5,QCM,0.7625,0.17,0.8,33,26,25,1,1.27,96.15,25,8,76.25,Facile,Facile,Facile / Facile
2582,93,2018,Ingenieurie,13,5,QCM,0.9086,0.0,0.98,26,24,24,0,1.08,100.0,24,2,90.86,Facile,Trop Facile,Facile / Trop Facile
3412,93,2019,Ingenieurie,13,5,QCM,0.7819,0.11,0.73,22,21,17,4,1.05,80.95,17,5,78.19,Facile,Facile,Facile / Facile
4242,93,2020,Ingenieurie,13,5,QCM,0.8498,0.12,0.75,19,18,16,2,1.06,88.89,16,3,84.98,Facile,Facile,Facile / Facile
93,94,2015,Ingenieurie,13,6,QCU,0.8379,0.05,0.86,35,32,29,3,1.09,90.62,29,6,83.79,Facile,Facile,Facile / Facile
923,94,2016,Ingenieurie,13,6,QCU,0.8806,0.08,0.9,38,34,33,1,1.12,97.06,33,5,88.06,Trop Facile,Trop Facile,Trop Facile / Trop Facile
1753,94,2017,Ingenieurie,13,6,QCU,0.9839,0.1,1.0,34,34,33,1,1.0,97.06,33,1,98.39,Trop Facile,Trop Facile,Trop Facile / Trop Facile
2583,94,2018,Ingenieurie,13,6,QCU,0.9357,0.09,0.99,32,31,30,1,1.03,96.77,30,2,93.57,Trop Facile,Trop Facile,Trop Facile / Trop Facile
3413,94,2019,Ingenieurie,13,6,QCU,0.1244,0.14,0.2,34,13,4,9,2.62,30.77,4,30,12.44,Trop Facile,Trop Difficile,Trop Facile / Trop Difficile
4243,94,2020,Ingenieurie,13,6,QCU,0.9239,0.08,0.99,38,35,35,0,1.09,100.0,35,3,92.39,Trop Facile,Trop Facile,Trop Facile / Trop Facile
94,95,2015,Ingenieurie,13,7,QCM,0.3202,0.37,0.39,34,12,11,1,2.83,91.67,11,23,32.02,Difficile,Difficile,Difficile / Difficile
924,95,2016,Ingenieurie,13,7,QCM,0.8098,0.07,0.79,31,29,25,4,1.07,86.21,25,6,80.98,Facile,Facile,Facile / Facile
1754,95,2017,Ingenieurie,13,7,QCM,0.8451,0.02,0.75,26,23,22,1,1.13,95.65,22,4,84.51,Facile,Facile,Facile / Facile
2584,95,2018,Ingenieurie,13,7,QCM,0.7882,0.12,0.78,30,26,24,2,1.15,92.31,24,6,78.82,Facile,Facile,Facile / Facile
3414,95,2019,Ingenieurie,13,7,QCM,0.8455,0.06,0.71,27,26,23,3,1.04,88.46,23,4,84.55,Facile,Facile,Facile / Facile
4244,95,2020,Ingenieurie,13,7,QCM,0.0462,0.31,0.3,30,24,1,23,1.25,4.17,1,29,4.62,Facile,Trop Difficile,Facile / Trop Difficile
95,96,2015,Ingenieurie,13,8,QCU,0.4811,0.03,0.36,19,15,9,6,1.27,60.0,9,10,48.11,Difficile,Difficile,Difficile / Difficile
925,96,2016,Ingenieurie,13,8,QCU,0.8274,0.04,0.88,19,16,16,0,1.19,100.0,16,3,82.74,Trop Facile,Facile,Trop Facile / Facile
1755,96,2017,Ingenieurie,13,8,QCU,0.8031,0.03,0.76,21,20,17,3,1.05,85.0,17,4,80.31,Trop Facile,Facile,Trop Facile / Facile
2585,96,2018,Ingenieurie,13,8,QCU,0.8915,0.01,0.93,19,18,17,1,1.06,94.44,17,2,89.15,Trop Facile,Trop Facile,Trop Facile / Trop Facile
3415,96,2019,Ingenieurie,13,8,QCU,0.9197,0.05,0.98,16,16,15,1,1.0,93.75,15,1,91.97,Trop Facile,Trop Facile,Trop Facile / Trop Facile
4245,96,2020,Ingenieurie,13,8,QCU,0.9027,0.05,1.0,17,15,15,0,1.13,100.0,15,2,90.27,Trop Facile,Trop Facile,Trop Facile / Trop Facile
96,97,2015,Ingenieurie,13,9,QCU,0.2969,0.19,0.35,39,25,12,13,1.56,48.0,12,27,29.69,Difficile,Difficile,Difficile / Difficile
926,97,2016,Ingenieurie,13,9,QCU,0.1389,0.44,0.26,42,41,6,35,1.02,14.63,6,36,13.89,Trop Facile,Trop Difficile,Trop Facile / Trop Difficile
1756,97,2017,Ingenieurie,13,9,QCU,0.6345,0.16,0.46,35,22,22,0,1.59,100.0,22,13,63.45,Trop Facile,Adapte,Trop Facile / Adapte
2586,97,2018,Ingenieurie,13,9,QCU,0.6603,0.05,0.63,32,22,21,1,1.45,95.45,21,11,66.03,Adapte,Adapte,Adapte / Adapte
3416,97,2019,Ingenieurie,13,9,QCU,0.6275,0.29,0.42,29,28,18,10,1.04,64.29,18,11,62.75,Adapte,Adapte,Adapte / Adapte
4246,97,2020,Ingenieurie,13,9,QCU,0.6971,0.11,0.48,32,25,22,3,1.28,88.0,22,10,69.71,Adapte,Adapte,Adapte / Adapte
97,98,2015,Ingenieurie,14,1,QCU,0.3537,0.14,0.39,26,24,9,15,1.08,37.5,9,17,35.37,Difficile,Difficile,Difficile / Difficile
927,98,2016,Ingenieurie,14,1,QCU,0.7111,0.08,0.58,22,21,16,5,1.05,76.19,16,6,71.11,Trop Facile,Adapte,Trop Facile / Adapte
1757,98,2017,Ingenieurie,14,1,QCU,0.7078,0.26,0.54,20,16,14,2,1.25,87.5,14,6,70.78,Adapte,Adapte,Adapte / Adapte
2587,98,2018,Ingenieurie,14,1,QCU,0.6826,0.02,0.65,18,15,12,3,1.2,80.0,12,6,68.26,Adapte,Adapte,Adapte / Adapte
3417,98,2019,Ingenieurie,14,1,QCU,0.7013,0.09,0.63,20,17,14,3,1.18,82.35,14,6,70.13,Adapte,Adapte,Adapte / Adapte
4247,98,2020,Ingenieurie,14,1,QCU,0.7358,0.08,0.49,24,21,18,3,1.14,85.71,18,6,73.58,Adapte,Adapte,Adapte / Adapte
98,99,2015,Ingenieurie,14,2,QCU,0.782,0.2,0.77,38,32,30,2,1.19,93.75,30,8,78.2,Facile,Facile,Facile / Facile
928,99,2016,Ingenieurie,14,2,QCU,0.9149,0.09,0.93,44,41,40,1,1.07,97.56,40,4,91.49,Trop Facile,Trop Facile,Trop Facile / Trop Facile
1758,99,2017,Ingenieurie,14,2,QCU,0.8977,0.0,0.98,42,42,38,4,1.0,90.48,38,4,89.77,Trop Facile,Trop Facile,Trop Facile / Trop Facile
2588,99,2018,Ingenieurie,14,2,QCU,0.9228,0.08,0.99,43,42,40,2,1.02,95.24,40,3,92.28,Trop Facile,Trop Facile,Trop Facile / Trop Facile
3418,99,2019,Ingenieurie,14,2,QCU,0.9195,0.09,0.93,45,42,41,1,1.07,97.62,41,4,91.95,Trop Facile,Trop Facile,Trop Facile / Trop Facile
4248,99,2020,Ingenieurie,14,2,QCU,0.9259,0.1,0.99,42,41,39,2,1.02,95.12,39,3,92.59,Trop Facile,Trop Facile,Trop Facile / Trop Facile
99,100,2015,Ingenieurie,14,3,QCU,0.9919,0.0,0.93,64,63,63,0,1.02,100.0,63,1,99.19,Trop Facile,Trop Facile,Trop Facile / Trop Facile
929,100,2016,Ingenieurie,14,3,QCU,0.0637,0.63,0.21,61,32,4,28,1.91,12.5,4,57,6.37,Trop Facile,Trop Difficile,Trop Facile / Trop Difficile
1759,100,2017,Ingenieurie,14,3,QCU,0.0386,0.66,0.27,64,37,2,35,1.73,5.41,2,62,3.86,Trop Facile,Trop Difficile,Trop Facile / Trop Difficile
2589,100,2018,Ingenieurie,14,3,QCU,0.3203,0.08,0.36,77,60,25,35,1.28,41.67,25,52,32.03,Trop Facile,Difficile,Trop Facile / Difficile
3419,100,2019,Ingenieurie,14,3,QCU,0.9627,0.03,0.96,70,69,67,2,1.01,97.1,67,3,96.27,Trop Facile,Trop Facile,Trop Facile / Trop Facile
4249,100,2020,Ingenieurie,14,3,QCU,0.8877,0.03,0.93,71,67,63,4,1.06,94.03,63,8,88.77,Trop Facile,Trop Facile,Trop Facile / Trop Facile
100,101,2015,Ingenieurie,14,4,QROC,0.8314,0.09,0.71,100,87,83,4,1.15,95.4,83,17,83.14,Trop Difficile,Facile,Trop Difficile / Facile
930,101,2016,Ingenieurie,14,4,QROC,0.0807,0.84,0.04,91,51,7,44,1.78,13.73,7,84,8.07,Facile,Trop Difficile,Facile / Trop Difficile
1760,101,2017,Ingenieurie,14,4,QROC,0.1551,0.78,0.05,77,51,12,39,1.51,23.53,12,65,15.51,Facile,Trop Difficile,Facile / Trop Difficile
2590,101,2018,Ingenieurie,14,4,QROC,0.8465,0.19,0.5,71,71,60,11,1.0,84.51,60,11,84.65,Facile,Facile,Facile / Facile
3420,101,2019,Ingenieurie,14,4,QROC,0.8363,0.2,0.73,77,74,64,10,1.04,86.49,64,13,83.63,Facile,Facile,Facile / Facile
4250,101,2020,Ingenieurie,14,4,QROC,0.4466,0.6,0.21,72,54,32,22,1.33,59.26,32,40,44.66,Facile,Difficile,Facile / Difficile
101,102,2015,Ingenieurie,14,5,QCU,0.6879,0.06,0.58,97,87,67,20,1.11,77.01,67,30,68.79,Difficile,Adapte,Difficile / Adapte
931,102,2016,Ingenieurie,14,5,QCU,0.6536,0.27,0.65,82,77,54,23,1.06,70.13,54,28,65.36,Adapte,Adapte,Adapte / Adapte
1761,102,2017,Ingenieurie,14,5,QCU,0.7156,0.12,0.62,94,68,67,1,1.38,98.53,67,27,71.56,Adapte,Adapte,Adapte / Adapte
2591,102,2018,Ingenieurie,14,5,QCU,0.6982,0.18,0.45,82,62,57,5,1.32,91.94,57,25,69.82,Adapte,Adapte,Adapte / Adapte
3421,102,2019,Ingenieurie,14,5,QCU,0.6852,0.12,0.5,84,60,58,2,1.4,96.67,58,26,68.52,Adapte,Adapte,Adapte / Adapte
4251,102,2020,Ingenieurie,14,5,QCU,0.6246,0.29,0.54,93,73,58,15,1.27,79.45,58,35,62.46,Adapte,Adapte,Adapte / Adapte
102,103,2015,Ingenieurie,14,6,QO,0.4129,0.88,0.0,88,63,36,27,1.4,57.14,36,52,41.29,Difficile,Difficile,Difficile / Difficile
932,103,2016,Ingenieurie,14,6,QO,0.6648,0.51,0.17,78,75,52,23,1.04,69.33,52,26,66.48,Adapte,Adapte,Adapte / Adapte
1762,103,2017,Ingenieurie,14,6,QO,0.6847,0.26,0.24,80,73,55,18,1.1,75.34,55,25,68.47,Adapte,Adapte,Adapte / Adapte
2592,103,2018,Ingenieurie,14,6,QO,0.7085,0.55,0.16,78,75,55,20,1.04,73.33,55,23,70.85,Adapte,Adapte,Adapte / Adapte
3422,103,2019,Ingenieurie,14,6,QO,0.6054,0.32,0.26,84,65,51,14,1.29,78.46,51,33,60.54,Adapte,Adapte,Adapte / Adapte
4252,103,2020,Ingenieurie,14,6,QO,0.6003,0.39,0.23,79,69,47,22,1.14,68.12,47,32,60.03,Adapte,Adapte,Adapte / Adapte
103,104,2015,Ingenieurie,15,1,QCU,0.5723,0.28,0.37,32,23,18,5,1.39,78.26,18,14,57.23,Facile,Difficile,Facile / Difficile
933,104,2016,Ingenieurie,15,1,QCU,0.9149,0.0,0.96,36,34,33,1,1.06,97.06,33,3,91.49,Trop Facile,Trop Facile,Trop Facile / Trop Facile
1763,104,2017,Ingenieurie,15,1,QCU,0.9086,0.06,0.99,29,27,26,1,1.07,96.3,26,3,90.86,Trop Facile,Trop Facile,Trop Facile / Trop Facile
2593,104,2018,Ingenieurie,15,1,QCU,0.449,0.24,0.39,34,19,15,4,1.79,78.95,15,19,44.9,Trop Facile,Difficile,Trop Facile / Difficile
3423,104,2019,Ingenieurie,15,1,QCU,0.7647,0.16,0.79,30,25,23,2,1.2,92.0,23,7,76.47,Trop Facile,Facile,Trop Facile / Facile
4253,104,2020,Ingenieurie,15,1,QCU,0.9911,0.04,0.93,26,26,26,0,1.0,100.0,26,0,99.11,Trop Facile,Trop Facile,Trop Facile / Trop Facile
104,105,2015,Ingenieurie,15,2,QCM,0.9368,0.04,0.88,57,55,53,2,1.04,96.36,53,4,93.68,Facile,Trop Facile,Facile / Trop Facile
934,105,2016,Ingenieurie,15,2,QCM,0.4324,0.48,0.38,59,27,26,1,2.19,96.3,26,33,43.24,Facile,Difficile,Facile / Difficile
1764,105,2017,Ingenieurie,15,2,QCM,0.7721,0.1,0.78,62,48,48,0,1.29,100.0,48,14,77.21,Facile,Facile,Facile / Facile
2594,105,2018,Ingenieurie,15,2,QCM,0.8051,0.16,0.74,50,48,40,8,1.04,83.33,40,10,80.51,Facile,Facile,Facile / Facile
3424,105,2019,Ingenieurie,15,2,QCM,0.7931,0.17,0.72,48,40,38,2,1.2,95.0,38,10,79.31,Facile,Facile,Facile / Facile
4254,105,2020,Ingenieurie,15,2,QCM,0.7292,0.14,0.42,55,43,40,3,1.28,93.02,40,15,72.92,Facile,Adapte,Facile / Adapte
105,106,2015,Ingenieurie,15,3,QCU,0.9466,0.01,0.99,59,56,56,0,1.05,100.0,56,3,94.66,Trop Facile,Trop Facile,Trop Facile / Trop Facile
935,106,2016,Ingenieurie,15,3,QCU,0.5166,0.17,0.37,59,49,30,19,1.2,61.22,30,29,51.66,Trop Facile,Difficile,Trop Facile / Difficile
1765,106,2017,Ingenieurie,15,3,QCU,0.9952,0.05,0.97,47,47,47,0,1.0,100.0,47,0,99.52,Trop Facile,Trop Facile,Trop Facile / Trop Facile
2595,106,2018,Ingenieurie,15,3,QCU,0.9554,0.05,0.91,55,55,53,2,1.0,96.36,53,2,95.54,Trop Facile,Trop Facile,Trop Facile / Trop Facile
3425,106,2019,Ingenieurie,15,3,QCU,0.8213,0.18,0.79,50,46,41,5,1.09,89.13,41,9,82.13,Trop Facile,Facile,Trop Facile / Facile
4255,106,2020,Ingenieurie,15,3,QCU,0.7867,0.04,0.78,41,38,32,6,1.08,84.21,32,9,78.67,Trop Facile,Facile,Trop Facile / Facile
106,107,2015,Ingenieurie,15,4,QCM,0.411,0.32,0.37,30,20,12,8,1.5,60.0,12,18,41.1,Difficile,Difficile,Difficile / Difficile
936,107,2016,Ingenieurie,15,4,QCM,0.8157,0.09,0.73,28,28,23,5,1.0,82.14,23,5,81.57,Facile,Facile,Facile / Facile
1766,107,2017,Ingenieurie,15,4,QCM,0.8262,0.14,0.72,28,27,23,4,1.04,85.19,23,5,82.62,Facile,Facile,Facile / Facile
2596,107,2018,Ingenieurie,15,4,QCM,0.7727,0.08,0.77,30,26,23,3,1.15,88.46,23,7,77.27,Facile,Facile,Facile / Facile
3426,107,2019,Ingenieurie,15,4,QCM,0.8353,0.1,0.74,33,31,28,3,1.06,90.32,28,5,83.53,Facile,Facile,Facile / Facile
4256,107,2020,Ingenieurie,15,4,QCM,0.8314,0.13,0.7,37,37,31,6,1.0,83.78,31,6,83.14,Facile,Facile,Facile / Facile
107,108,2015,Ingenieurie,15,5,QROC,0.7741,0.12,0.5,29,24,22,2,1.21,91.67,22,7,77.41,Facile,Facile,Facile / Facile
937,108,2016,Ingenieurie,15,5,QROC,0.8184,0.07,0.55,27,27,22,5,1.0,81.48,22,5,81.84,Facile,Facile,Facile / Facile
1767,108,2017,Ingenieurie,15,5,QROC,0.9302,0.1,0.75,22,21,20,1,1.05,95.24,20,2,93.02,Facile,Trop Facile,Facile / Trop Facile
2597,108,2018,Ingenieurie,15,5,QROC,0.7693,0.05,0.58,20,18,15,3,1.11,83.33,15,5,76.93,Facile,Facile,Facile / Facile
3427,108,2019,Ingenieurie,15,5,QROC,0.8434,0.01,0.67,21,20,18,2,1.05,90.0,18,3,84.34,Facile,Facile,Facile / Facile
4257,108,2020,Ingenieurie,15,5,QROC,0.8083,0.19,0.48,19,18,15,3,1.06,83.33,15,4,80.83,Facile,Facile,Facile / Facile
108,109,2015,Ingenieurie,15,6,QCU,0.2905,0.3,0.33,61,57,18,39,1.07,31.58,18,43,29.05,Difficile,Difficile,Difficile / Difficile
938,109,2016,Ingenieurie,15,6,QCU,0.871,0.08,0.9,60,53,52,1,1.13,98.11,52,8,87.1,Trop Facile,Trop Facile,Trop Facile / Trop Facile
1768,109,2017,Ingenieurie,15,6,QCU,0.0263,0.05,0.24,59,39,2,37,1.51,5.13,2,57,2.63,Trop Facile,Trop Difficile,Trop Facile / Trop Difficile
2598,109,2018,Ingenieurie,15,6,QCU,0.2277,0.57,0.2,68,61,15,46,1.11,24.59,15,53,22.77,Trop Facile,Trop Difficile,Trop Facile / Trop Difficile
3428,109,2019,Ingenieurie,15,6,QCU,0.9784,0.05,0.9,56,56,55,1,1.0,98.21,55,1,97.84,Trop Facile,Trop Facile,Trop Facile / Trop Facile
4258,109,2020,Ingenieurie,15,6,QCU,0.141,0.04,0.3,61,26,9,17,2.35,34.62,9,52,14.1,Trop Facile,Trop Difficile,Trop Facile / Trop Difficile
109,110,2015,Ingenieurie,16,1,QROC,0.073,0.86,0.05,33,19,2,17,1.74,10.53,2,31,7.3,Difficile,Trop Difficile,Difficile / Trop Difficile
939,110,2016,Ingenieurie,16,1,QROC,0.8472,0.09,0.71,35,32,30,2,1.09,93.75,30,5,84.72,Facile,Facile,Facile / Facile
1769,110,2017,Ingenieurie,16,1,QROC,0.9219,0.0,0.77,36,36,33,3,1.0,91.67,33,3,92.19,Facile,Trop Facile,Facile / Trop Facile
2599,110,2018,Ingenieurie,16,1,QROC,0.4303,0.62,0.16,39,31,17,14,1.26,54.84,17,22,43.03,Facile,Difficile,Facile / Difficile
3429,110,2019,Ingenieurie,16,1,QROC,0.6237,0.25,0.32,31,24,19,5,1.29,79.17,19,12,62.37,Facile,Adapte,Facile / Adapte
4259,110,2020,Ingenieurie,16,1,QROC,0.6133,0.37,0.27,30,29,18,11,1.03,62.07,18,12,61.33,Adapte,Adapte,Adapte / Adapte
110,111,2015,Ingenieurie,17,1,QCU,0.8188,0.05,0.8,97,91,79,12,1.07,86.81,79,18,81.88,Facile,Facile,Facile / Facile
940,111,2016,Ingenieurie,17,1,QCU,0.9275,0.03,0.93,81,80,75,5,1.01,93.75,75,6,92.75,Trop Facile,Trop Facile,Trop Facile / Trop Facile
1770,111,2017,Ingenieurie,17,1,QCU,0.9914,0.05,0.96,94,94,93,1,1.0,98.94,93,1,99.14,Trop Facile,Trop Facile,Trop Facile / Trop Facile
2600,111,2018,Ingenieurie,17,1,QCU,0.6811,0.08,0.46,112,109,76,33,1.03,69.72,76,36,68.11,Trop Facile,Adapte,Trop Facile / Adapte
3430,111,2019,Ingenieurie,17,1,QCU,0.6289,0.02,0.68,134,106,84,22,1.26,79.25,84,50,62.89,Adapte,Adapte,Adapte / Adapte
4260,111,2020,Ingenieurie,17,1,QCU,0.6654,0.05,0.4,109,93,73,20,1.17,78.49,73,36,66.54,Adapte,Adapte,Adapte / Adapte
111,112,2015,Management,1,1,QO,0.5571,0.78,0.13,80,61,45,16,1.31,73.77,45,35,55.71,Difficile,Difficile,Difficile / Difficile
941,112,2016,Management,1,1,QO,0.7138,0.4,0.25,66,52,47,5,1.27,90.38,47,19,71.38,Adapte,Adapte,Adapte / Adapte
1771,112,2017,Management,1,1,QO,0.6146,0.63,0.3,75,67,46,21,1.12,68.66,46,29,61.46,Adapte,Adapte,Adapte / Adapte
2601,112,2018,Management,1,1,QO,0.6276,0.49,0.3,71,52,45,7,1.37,86.54,45,26,62.76,Adapte,Adapte,Adapte / Adapte
3431,112,2019,Management,1,1,QO,0.6544,0.64,0.3,84,77,55,22,1.09,71.43,55,29,65.44,Adapte,Adapte,Adapte / Adapte
4261,112,2020,Management,1,1,QO,0.7137,0.32,0.23,69,63,49,14,1.1,77.78,49,20,71.37,Adapte,Adapte,Adapte / Adapte
112,113,2015,Management,1,2,QCU,0.9358,0.02,0.95,96,92,90,2,1.04,97.83,90,6,93.58,Trop Difficile,Trop Facile,Trop Difficile / Trop Facile
942,113,2016,Management,1,2,QCU,0.4498,0.01,0.39,93,52,42,10,1.79,80.77,42,51,44.98,Trop Facile,Difficile,Trop Facile / Difficile
1772,113,2017,Management,1,2,QCU,0.95,0.04,0.99,81,80,77,3,1.01,96.25,77,4,95.0,Trop Facile,Trop Facile,Trop Facile / Trop Facile
2602,113,2018,Management,1,2,QCU,0.9935,0.07,0.92,65,65,65,0,1.0,100.0,65,0,99.35,Trop Facile,Trop Facile,Trop Facile / Trop Facile
3432,113,2019,Management,1,2,QCU,0.4666,0.27,0.32,73,70,34,36,1.04,48.57,34,39,46.66,Trop Facile,Difficile,Trop Facile / Difficile
4262,113,2020,Management,1,2,QCU,0.881,0.01,0.97,86,77,76,1,1.12,98.7,76,10,88.1,Trop Facile,Trop Facile,Trop Facile / Trop Facile
113,114,2015,Management,1,3,QCM,0.5626,0.2,0.35,9,6,5,1,1.5,83.33,5,4,56.26,Facile,Difficile,Facile / Difficile
943,114,2016,Management,1,3,QCM,0.841,0.12,0.75,8,7,7,0,1.14,100.0,7,1,84.1,Facile,Facile,Facile / Facile
1773,114,2017,Management,1,3,QCM,0.3535,0.39,0.37,7,5,2,3,1.4,40.0,2,5,35.35,Facile,Difficile,Facile / Difficile
2603,114,2018,Management,1,3,QCM,0.7914,0.08,0.72,6,5,5,0,1.2,100.0,5,1,79.14,Facile,Facile,Facile / Facile
3433,114,2019,Management,1,3,QCM,0.8494,0.17,0.72,5,4,4,0,1.25,100.0,4,1,84.94,Facile,Facile,Facile / Facile
4263,114,2020,Management,1,3,QCM,0.7734,0.07,0.74,5,4,4,0,1.25,100.0,4,1,77.34,Facile,Facile,Facile / Facile
114,115,2015,Management,1,4,QROC,0.6111,0.25,0.34,70,57,43,14,1.23,75.44,43,27,61.11,Trop Difficile,Adapte,Trop Difficile / Adapte
944,115,2016,Management,1,4,QROC,0.6263,0.45,0.25,65,53,41,12,1.23,77.36,41,24,62.63,Adapte,Adapte,Adapte / Adapte
1774,115,2017,Management,1,4,QROC,0.7209,0.26,0.31,75,54,54,0,1.39,100.0,54,21,72.09,Adapte,Adapte,Adapte / Adapte
2604,115,2018,Management,1,4,QROC,0.6132,0.49,0.29,64,48,39,9,1.33,81.25,39,25,61.32,Adapte,Adapte,Adapte / Adapte
3434,115,2019,Management,1,4,QROC,0.6737,0.24,0.28,66,45,44,1,1.47,97.78,44,22,67.37,Adapte,Adapte,Adapte / Adapte
4264,115,2020,Management,1,4,QROC,0.6731,0.3,0.35,75,55,50,5,1.36,90.91,50,25,67.31,Adapte,Adapte,Adapte / Adapte
115,116,2015,Management,1,5,QCM,0.6464,0.18,0.57,45,33,29,4,1.36,87.88,29,16,64.64,Trop Difficile,Adapte,Trop Difficile / Adapte
945,116,2016,Management,1,5,QCM,0.6864,0.02,0.47,44,44,30,14,1.0,68.18,30,14,68.64,Adapte,Adapte,Adapte / Adapte
1775,116,2017,Management,1,5,QCM,0.6077,0.12,0.63,49,44,30,14,1.11,68.18,30,19,60.77,Adapte,Adapte,Adapte / Adapte
2605,116,2018,Management,1,5,QCM,0.7157,0.02,0.44,58,43,42,1,1.35,97.67,42,16,71.57,Adapte,Adapte,Adapte / Adapte
3435,116,2019,Management,1,5,QCM,0.6973,0.0,0.59,50,39,35,4,1.28,89.74,35,15,69.73,Adapte,Adapte,Adapte / Adapte
4265,116,2020,Management,1,5,QCM,0.7159,0.05,0.48,41,39,29,10,1.05,74.36,29,12,71.59,Adapte,Adapte,Adapte / Adapte
116,117,2015,Management,1,6,QROC,0.1266,1.0,0.03,41,17,5,12,2.41,29.41,5,36,12.66,Difficile,Trop Difficile,Difficile / Trop Difficile
946,117,2016,Management,1,6,QROC,0.8386,0.05,0.67,33,28,28,0,1.18,100.0,28,5,83.86,Facile,Facile,Facile / Facile
1776,117,2017,Management,1,6,QROC,0.9264,0.02,0.92,37,36,34,2,1.03,94.44,34,3,92.64,Facile,Trop Facile,Facile / Trop Facile
2606,117,2018,Management,1,6,QROC,0.8846,0.04,0.72,43,43,38,5,1.0,88.37,38,5,88.46,Facile,Trop Facile,Facile / Trop Facile
3436,117,2019,Management,1,6,QROC,0.6226,0.44,0.4,48,32,30,2,1.5,93.75,30,18,62.26,Facile,Adapte,Facile / Adapte
4266,117,2020,Management,1,6,QROC,0.6589,0.45,0.38,55,44,36,8,1.25,81.82,36,19,65.89,Adapte,Adapte,Adapte / Adapte
117,118,2015,Management,1,7,QCM,0.9269,0.06,0.9,75,72,70,2,1.04,97.22,70,5,92.69,Trop Facile,Trop Facile,Trop Facile / Trop Facile
947,118,2016,Management,1,7,QCM,0.816,0.03,0.78,72,70,59,11,1.03,84.29,59,13,81.6,Facile,Facile,Facile / Facile
1777,118,2017,Management,1,7,QCM,0.8019,0.05,0.73,64,59,51,8,1.08,86.44,51,13,80.19,Facile,Facile,Facile / Facile
2607,118,2018,Management,1,7,QCM,0.7809,0.18,0.71,61,56,48,8,1.09,85.71,48,13,78.09,Facile,Facile,Facile / Facile
3437,118,2019,Management,1,7,QCM,0.8086,0.04,0.72,66,56,53,3,1.18,94.64,53,13,80.86,Facile,Facile,Facile / Facile
4267,118,2020,Management,1,7,QCM,0.828,0.12,0.77,79,78,65,13,1.01,83.33,65,14,82.8,Facile,Facile,Facile / Facile
118,119,2015,Management,1,8,QCM,0.6413,0.27,0.67,7,7,4,3,1.0,57.14,4,3,64.13,Adapte,Adapte,Adapte / Adapte
948,119,2016,Management,1,8,QCM,0.6486,0.26,0.47,8,6,5,1,1.33,83.33,5,3,64.86,Adapte,Adapte,Adapte / Adapte
1778,119,2017,Management,1,8,QCM,0.6225,0.13,0.59,10,7,6,1,1.43,85.71,6,4,62.25,Adapte,Adapte,Adapte / Adapte
2608,119,2018,Management,1,8,QCM,0.7169,0.01,0.45,8,7,6,1,1.14,85.71,6,2,71.69,Adapte,Adapte,Adapte / Adapte
3438,119,2019,Management,1,8,QCM,0.7432,0.13,0.4,10,8,7,1,1.25,87.5,7,3,74.32,Adapte,Adapte,Adapte / Adapte
4268,119,2020,Management,1,8,QCM,0.6829,0.3,0.57,8,7,5,2,1.14,71.43,5,3,68.29,Adapte,Adapte,Adapte / Adapte
119,120,2015,Management,1,9,QCM,0.3099,0.32,0.32,37,24,11,13,1.54,45.83,11,26,30.99,Difficile,Difficile,Difficile / Difficile
949,120,2016,Management,1,9,QCM,0.8197,0.09,0.77,42,35,34,1,1.2,97.14,34,8,81.97,Facile,Facile,Facile / Facile
1779,120,2017,Management,1,9,QCM,0.7784,0.14,0.77,47,38,37,1,1.24,97.37,37,10,77.84,Facile,Facile,Facile / Facile
2609,120,2018,Management,1,9,QCM,0.1418,0.31,0.25,40,11,6,5,3.64,54.55,6,34,14.18,Facile,Trop Difficile,Facile / Trop Difficile
3439,120,2019,Management,1,9,QCM,0.7662,0.08,0.72,44,34,34,0,1.29,100.0,34,10,76.62,Facile,Facile,Facile / Facile
4269,120,2020,Management,1,9,QCM,0.83,0.17,0.77,40,38,33,5,1.05,86.84,33,7,83.0,Facile,Facile,Facile / Facile
120,121,2015,Management,1,10,QCU,0.0102,0.57,0.28,52,30,1,29,1.73,3.33,1,51,1.02,Difficile,Trop Difficile,Difficile / Trop Difficile
950,121,2016,Management,1,10,QCU,0.8828,0.08,0.95,45,41,40,1,1.1,97.56,40,5,88.28,Trop Facile,Trop Facile,Trop Facile / Trop Facile
1780,121,2017,Management,1,10,QCU,0.9175,0.03,0.98,42,41,39,2,1.02,95.12,39,3,91.75,Trop Facile,Trop Facile,Trop Facile / Trop Facile
2610,121,2018,Management,1,10,QCU,0.9824,0.03,0.94,47,47,46,1,1.0,97.87,46,1,98.24,Trop Facile,Trop Facile,Trop Facile / Trop Facile
3440,121,2019,Management,1,10,QCU,0.9097,0.05,1.0,49,48,45,3,1.02,93.75,45,4,90.97,Trop Facile,Trop Facile,Trop Facile / Trop Facile
4270,121,2020,Management,1,10,QCU,0.9465,0.05,0.93,59,58,56,2,1.02,96.55,56,3,94.65,Trop Facile,Trop Facile,Trop Facile / Trop Facile
121,122,2015,Management,1,11,QO,0.7285,0.48,0.29,12,10,9,1,1.2,90.0,9,3,72.85,Adapte,Adapte,Adapte / Adapte
951,122,2016,Management,1,11,QO,0.6993,0.3,0.19,10,7,7,0,1.43,100.0,7,3,69.93,Adapte,Adapte,Adapte / Adapte
1781,122,2017,Management,1,11,QO,0.6354,0.61,0.2,10,7,6,1,1.43,85.71,6,4,63.54,Adapte,Adapte,Adapte / Adapte
2611,122,2018,Management,1,11,QO,0.6914,0.25,0.24,11,10,8,2,1.1,80.0,8,3,69.14,Adapte,Adapte,Adapte / Adapte
3441,122,2019,Management,1,11,QO,0.6209,0.26,0.29,10,8,6,2,1.25,75.0,6,4,62.09,Adapte,Adapte,Adapte / Adapte
4271,122,2020,Management,1,11,QO,0.6464,0.5,0.23,9,8,6,2,1.12,75.0,6,3,64.64,Adapte,Adapte,Adapte / Adapte
122,123,2015,Management,1,12,QCM,0.1325,0.31,0.29,41,28,5,23,1.46,17.86,5,36,13.25,Trop Difficile,Trop Difficile,Trop Difficile / Trop Difficile
952,123,2016,Management,1,12,QCM,0.9324,0.05,0.96,35,34,33,1,1.03,97.06,33,2,93.24,Facile,Trop Facile,Facile / Trop Facile
1782,123,2017,Management,1,12,QCM,0.8453,0.14,0.74,33,31,28,3,1.06,90.32,28,5,84.53,Facile,Facile,Facile / Facile
2612,123,2018,Management,1,12,QCM,0.8479,0.02,0.72,28,26,24,2,1.08,92.31,24,4,84.79,Facile,Facile,Facile / Facile
3442,123,2019,Management,1,12,QCM,0.6748,0.29,0.62,22,15,15,0,1.47,100.0,15,7,67.48,Facile,Adapte,Facile / Adapte
4272,123,2020,Management,1,12,QCM,0.6742,0.2,0.46,22,17,15,2,1.29,88.24,15,7,67.42,Adapte,Adapte,Adapte / Adapte
123,124,2015,Management,1,13,QCM,0.2795,0.31,0.34,88,76,25,51,1.16,32.89,25,63,27.95,Difficile,Difficile,Difficile / Difficile
953,124,2016,Management,1,13,QCM,0.7946,0.19,0.73,75,73,60,13,1.03,82.19,60,15,79.46,Facile,Facile,Facile / Facile
1783,124,2017,Management,1,13,QCM,0.7674,0.13,0.76,63,50,48,2,1.26,96.0,48,15,76.74,Facile,Facile,Facile / Facile
2613,124,2018,Management,1,13,QCM,0.3504,0.34,0.4,57,57,20,37,1.0,35.09,20,37,35.04,Facile,Difficile,Facile / Difficile
3443,124,2019,Management,1,13,QCM,0.5232,0.09,0.36,57,32,30,2,1.78,93.75,30,27,52.32,Facile,Difficile,Facile / Difficile
4273,124,2020,Management,1,13,QCM,0.9156,0.01,0.88,67,65,61,4,1.03,93.85,61,6,91.56,Facile,Trop Facile,Facile / Trop Facile
124,125,2015,Management,2,1,QCM,0.6044,0.26,0.66,68,55,41,14,1.24,74.55,41,27,60.44,Adapte,Adapte,Adapte / Adapte
954,125,2016,Management,2,1,QCM,0.7451,0.14,0.52,72,68,54,14,1.06,79.41,54,18,74.51,Adapte,Adapte,Adapte / Adapte
1784,125,2017,Management,2,1,QCM,0.6945,0.17,0.51,61,52,42,10,1.17,80.77,42,19,69.45,Adapte,Adapte,Adapte / Adapte
2614,125,2018,Management,2,1,QCM,0.6529,0.06,0.49,52,38,34,4,1.37,89.47,34,18,65.29,Adapte,Adapte,Adapte / Adapte
3444,125,2019,Management,2,1,QCM,0.6924,0.08,0.43,60,43,42,1,1.4,97.67,42,18,69.24,Adapte,Adapte,Adapte / Adapte
4274,125,2020,Management,2,1,QCM,0.6143,0.07,0.56,63,41,39,2,1.54,95.12,39,24,61.43,Adapte,Adapte,Adapte / Adapte
125,126,2015,Management,2,2,QCU,0.8096,0.07,0.86,72,64,58,6,1.12,90.62,58,14,80.96,Difficile,Facile,Difficile / Facile
955,126,2016,Management,2,2,QCU,0.898,0.02,0.92,69,65,62,3,1.06,95.38,62,7,89.8,Trop Facile,Trop Facile,Trop Facile / Trop Facile
1785,126,2017,Management,2,2,QCU,0.8333,0.19,0.79,80,78,67,11,1.03,85.9,67,13,83.33,Trop Facile,Facile,Trop Facile / Facile
2615,126,2018,Management,2,2,QCU,0.7865,0.05,0.87,83,67,65,2,1.24,97.01,65,18,78.65,Trop Facile,Facile,Trop Facile / Facile
3445,126,2019,Management,2,2,QCU,0.8951,0.08,0.93,71,64,64,0,1.11,100.0,64,7,89.51,Trop Facile,Trop Facile,Trop Facile / Trop Facile
4275,126,2020,Management,2,2,QCU,0.9213,0.04,1.0,77,75,71,4,1.03,94.67,71,6,92.13,Trop Facile,Trop Facile,Trop Facile / Trop Facile
126,127,2015,Management,2,3,QROC,0.0355,0.93,0.1,29,24,1,23,1.21,4.17,1,28,3.55,Trop Difficile,Trop Difficile,Trop Difficile / Trop Difficile
956,127,2016,Management,2,3,QROC,0.8154,0.1,0.52,33,32,27,5,1.03,84.38,27,6,81.54,Facile,Facile,Facile / Facile
1786,127,2017,Management,2,3,QROC,0.8351,0.14,0.64,32,29,27,2,1.1,93.1,27,5,83.51,Facile,Facile,Facile / Facile
2616,127,2018,Management,2,3,QROC,0.8308,0.03,0.66,27,24,22,2,1.12,91.67,22,5,83.08,Facile,Facile,Facile / Facile
3446,127,2019,Management,2,3,QROC,0.8422,0.07,0.63,22,21,19,2,1.05,90.48,19,3,84.22,Facile,Facile,Facile / Facile
4276,127,2020,Management,2,3,QROC,0.7884,0.19,0.56,20,17,16,1,1.18,94.12,16,4,78.84,Facile,Facile,Facile / Facile
127,128,2015,Management,2,4,QCU,0.9876,0.02,0.9,6,6,6,0,1.0,100.0,6,0,98.76,Trop Facile,Trop Facile,Trop Facile / Trop Facile
957,128,2016,Management,2,4,QCU,0.9295,0.06,0.93,6,6,6,0,1.0,100.0,6,0,92.95,Trop Facile,Trop Facile,Trop Facile / Trop Facile
1787,128,2017,Management,2,4,QCU,0.8962,0.01,0.98,7,6,6,0,1.17,100.0,6,1,89.62,Trop Facile,Trop Facile,Trop Facile / Trop Facile
2617,128,2018,Management,2,4,QCU,0.9489,0.03,0.97,6,6,6,0,1.0,100.0,6,0,94.89,Trop Facile,Trop Facile,Trop Facile / Trop Facile
3447,128,2019,Management,2,4,QCU,0.4014,0.19,0.3,7,6,3,3,1.17,50.0,3,4,40.14,Trop Facile,Difficile,Trop Facile / Difficile
4277,128,2020,Management,2,4,QCU,0.9635,0.0,0.96,8,8,8,0,1.0,100.0,8,0,96.35,Trop Facile,Trop Facile,Trop Facile / Trop Facile
128,129,2015,Management,2,5,QCU,0.469,0.2,0.32,88,43,41,2,2.05,95.35,41,47,46.9,Difficile,Difficile,Difficile / Difficile
958,129,2016,Management,2,5,QCU,0.7962,0.06,0.86,72,64,57,7,1.12,89.06,57,15,79.62,Trop Facile,Facile,Trop Facile / Facile
1788,129,2017,Management,2,5,QCU,0.9314,0.04,0.92,74,72,69,3,1.03,95.83,69,5,93.14,Trop Facile,Trop Facile,Trop Facile / Trop Facile
2618,129,2018,Management,2,5,QCU,0.3378,0.24,0.39,89,49,30,19,1.82,61.22,30,59,33.78,Trop Facile,Difficile,Trop Facile / Difficile
3448,129,2019,Management,2,5,QCU,0.9412,0.06,0.94,77,75,72,3,1.03,96.0,72,5,94.12,Trop Facile,Trop Facile,Trop Facile / Trop Facile
4278,129,2020,Management,2,5,QCU,0.9741,0.02,0.96,81,81,79,2,1.0,97.53,79,2,97.41,Trop Facile,Trop Facile,Trop Facile / Trop Facile
129,130,2015,Management,2,6,QCM,0.5111,0.36,0.32,46,37,24,13,1.24,64.86,24,22,51.11,Difficile,Difficile,Difficile / Difficile
959,130,2016,Management,2,6,QCM,0.7856,0.16,0.76,55,46,43,3,1.2,93.48,43,12,78.56,Facile,Facile,Facile / Facile
1789,130,2017,Management,2,6,QCM,0.8491,0.07,0.78,50,45,42,3,1.11,93.33,42,8,84.91,Facile,Facile,Facile / Facile
2619,130,2018,Management,2,6,QCM,0.8237,0.12,0.75,42,41,35,6,1.02,85.37,35,7,82.37,Facile,Facile,Facile / Facile
3449,130,2019,Management,2,6,QCM,0.7809,0.19,0.75,43,41,34,7,1.05,82.93,34,9,78.09,Facile,Facile,Facile / Facile
4279,130,2020,Management,2,6,QCM,0.8407,0.06,0.8,45,38,38,0,1.18,100.0,38,7,84.07,Facile,Facile,Facile / Facile
130,131,2015,Management,2,7,QCM,0.6982,0.09,0.62,58,52,40,12,1.12,76.92,40,18,69.82,Facile,Adapte,Facile / Adapte
960,131,2016,Management,2,7,QCM,0.6693,0.29,0.41,59,45,39,6,1.31,86.67,39,20,66.93,Adapte,Adapte,Adapte / Adapte
1790,131,2017,Management,2,7,QCM,0.7244,0.0,0.55,65,57,47,10,1.14,82.46,47,18,72.44,Adapte,Adapte,Adapte / Adapte
2620,131,2018,Management,2,7,QCM,0.6419,0.23,0.42,75,59,48,11,1.27,81.36,48,27,64.19,Adapte,Adapte,Adapte / Adapte
3450,131,2019,Management,2,7,QCM,0.649,0.11,0.6,76,69,49,20,1.1,71.01,49,27,64.9,Adapte,Adapte,Adapte / Adapte
4280,131,2020,Management,2,7,QCM,0.6142,0.13,0.56,77,49,47,2,1.57,95.92,47,30,61.42,Adapte,Adapte,Adapte / Adapte
131,132,2015,Management,2,8,QCU,0.0555,0.46,0.25,69,44,4,40,1.57,9.09,4,65,5.55,Trop Difficile,Trop Difficile,Trop Difficile / Trop Difficile
961,132,2016,Management,2,8,QCU,0.8844,0.05,0.94,64,62,57,5,1.03,91.94,57,7,88.44,Trop Facile,Trop Facile,Trop Facile / Trop Facile
1791,132,2017,Management,2,8,QCU,0.8966,0.01,0.96,66,62,59,3,1.06,95.16,59,7,89.66,Trop Facile,Trop Facile,Trop Facile / Trop Facile
2621,132,2018,Management,2,8,QCU,0.5351,0.26,0.39,70,42,37,5,1.67,88.1,37,33,53.51,Trop Facile,Difficile,Trop Facile / Difficile
3451,132,2019,Management,2,8,QCU,0.8415,0.01,0.86,57,50,48,2,1.14,96.0,48,9,84.15,Trop Facile,Facile,Trop Facile / Facile
4281,132,2020,Management,2,8,QCU,0.6357,0.2,0.6,54,47,34,13,1.15,72.34,34,20,63.57,Trop Facile,Adapte,Trop Facile / Adapte
132,133,2015,Management,2,9,QCM,0.8255,0.02,0.73,37,31,31,0,1.19,100.0,31,6,82.55,Difficile,Facile,Difficile / Facile
962,133,2016,Management,2,9,QCM,0.8058,0.16,0.73,43,42,35,7,1.02,83.33,35,8,80.58,Facile,Facile,Facile / Facile
1792,133,2017,Management,2,9,QCM,0.8478,0.1,0.72,38,38,32,6,1.0,84.21,32,6,84.78,Facile,Facile,Facile / Facile
2622,133,2018,Management,2,9,QCM,0.7926,0.04,0.7,33,30,26,4,1.1,86.67,26,7,79.26,Facile,Facile,Facile / Facile
3452,133,2019,Management,2,9,QCM,0.6303,0.11,0.63,28,23,18,5,1.22,78.26,18,10,63.03,Facile,Adapte,Facile / Adapte
4282,133,2020,Management,2,9,QCM,0.704,0.11,0.42,26,26,18,8,1.0,69.23,18,8,70.4,Adapte,Adapte,Adapte / Adapte
133,134,2015,Management,2,10,QCU,0.8828,0.03,0.99,42,40,37,3,1.05,92.5,37,5,88.28,Facile,Trop Facile,Facile / Trop Facile
963,134,2016,Management,2,10,QCU,0.8852,0.06,0.99,37,34,33,1,1.09,97.06,33,4,88.52,Trop Facile,Trop Facile,Trop Facile / Trop Facile
1793,134,2017,Management,2,10,QCU,0.0519,0.08,0.27,38,28,2,26,1.36,7.14,2,36,5.19,Trop Facile,Trop Difficile,Trop Facile / Trop Difficile
2623,134,2018,Management,2,10,QCU,0.9352,0.02,0.99,40,39,37,2,1.03,94.87,37,3,93.52,Trop Facile,Trop Facile,Trop Facile / Trop Facile
3453,134,2019,Management,2,10,QCU,0.5391,0.29,0.32,45,27,24,3,1.67,88.89,24,21,53.91,Trop Facile,Difficile,Trop Facile / Difficile
4283,134,2020,Management,2,10,QCU,0.8794,0.01,0.97,51,45,45,0,1.13,100.0,45,6,87.94,Trop Facile,Trop Facile,Trop Facile / Trop Facile
134,135,2015,Management,2,11,QROC,0.8105,0.13,0.64,39,35,32,3,1.11,91.43,32,7,81.05,Trop Facile,Facile,Trop Facile / Facile
964,135,2016,Management,2,11,QROC,0.8201,0.09,0.69,31,26,25,1,1.19,96.15,25,6,82.01,Facile,Facile,Facile / Facile
1794,135,2017,Management,2,11,QROC,0.7992,0.02,0.55,37,33,30,3,1.12,90.91,30,7,79.92,Facile,Facile,Facile / Facile
2624,135,2018,Management,2,11,QROC,0.8121,0.16,0.5,36,34,29,5,1.06,85.29,29,7,81.21,Facile,Facile,Facile / Facile
3454,135,2019,Management,2,11,QROC,0.2195,0.78,0.05,42,36,9,27,1.17,25.0,9,33,21.95,Facile,Trop Difficile,Facile / Trop Difficile
4284,135,2020,Management,2,11,QROC,0.7447,0.32,0.33,37,31,28,3,1.19,90.32,28,9,74.47,Facile,Adapte,Facile / Adapte
135,136,2015,Management,2,12,QCM,0.5665,0.25,0.34,34,28,19,9,1.21,67.86,19,15,56.65,Difficile,Difficile,Difficile / Difficile
965,136,2016,Management,2,12,QCM,0.8072,0.15,0.74,38,37,31,6,1.03,83.78,31,7,80.72,Facile,Facile,Facile / Facile
1795,136,2017,Management,2,12,QCM,0.7854,0.1,0.71,30,28,24,4,1.07,85.71,24,6,78.54,Facile,Facile,Facile / Facile
2625,136,2018,Management,2,12,QCM,0.8246,0.08,0.79,31,30,26,4,1.03,86.67,26,5,82.46,Facile,Facile,Facile / Facile
3455,136,2019,Management,2,12,QCM,0.839,0.07,0.77,25,24,21,3,1.04,87.5,21,4,83.9,Facile,Facile,Facile / Facile
4285,136,2020,Management,2,12,QCM,0.8336,0.1,0.74,24,22,20,2,1.09,90.91,20,4,83.36,Facile,Facile,Facile / Facile
136,137,2015,Management,2,13,QCU,0.2121,0.63,0.23,30,25,6,19,1.2,24.0,6,24,21.21,Adapte,Trop Difficile,Adapte / Trop Difficile
966,137,2016,Management,2,13,QCU,0.8835,0.0,0.99,29,28,26,2,1.04,92.86,26,3,88.35,Trop Facile,Trop Facile,Trop Facile / Trop Facile
1796,137,2017,Management,2,13,QCU,0.9186,0.02,0.94,30,28,28,0,1.07,100.0,28,2,91.86,Trop Facile,Trop Facile,Trop Facile / Trop Facile
2626,137,2018,Management,2,13,QCU,0.9489,0.04,0.95,36,34,34,0,1.06,100.0,34,2,94.89,Trop Facile,Trop Facile,Trop Facile / Trop Facile
3456,137,2019,Management,2,13,QCU,0.8819,0.03,0.91,34,34,30,4,1.0,88.24,30,4,88.19,Trop Facile,Trop Facile,Trop Facile / Trop Facile
4286,137,2020,Management,2,13,QCU,0.81,0.1,0.82,34,32,28,4,1.06,87.5,28,6,81.0,Trop Facile,Facile,Trop Facile / Facile
137,138,2015,Management,3,1,QCM,0.0818,0.64,0.24,16,4,1,3,4.0,25.0,1,15,8.18,Trop Difficile,Trop Difficile,Trop Difficile / Trop Difficile
967,138,2016,Management,3,1,QCM,0.8464,0.17,0.75,18,15,15,0,1.2,100.0,15,3,84.64,Facile,Facile,Facile / Facile
1797,138,2017,Management,3,1,QCM,0.8261,0.17,0.75,21,19,17,2,1.11,89.47,17,4,82.61,Facile,Facile,Facile / Facile
2627,138,2018,Management,3,1,QCM,0.8233,0.0,0.74,19,18,16,2,1.06,88.89,16,3,82.33,Facile,Facile,Facile / Facile
3457,138,2019,Management,3,1,QCM,0.8871,0.05,0.81,16,15,14,1,1.07,93.33,14,2,88.71,Facile,Trop Facile,Facile / Trop Facile
4287,138,2020,Management,3,1,QCM,0.974,0.05,0.84,16,16,16,0,1.0,100.0,16,0,97.4,Facile,Trop Facile,Facile / Trop Facile
138,139,2015,Management,3,2,QCU,0.9545,0.07,0.93,85,83,81,2,1.02,97.59,81,4,95.45,Trop Facile,Trop Facile,Trop Facile / Trop Facile
968,139,2016,Management,3,2,QCU,0.8825,0.03,0.93,95,95,84,11,1.0,88.42,84,11,88.25,Trop Facile,Trop Facile,Trop Facile / Trop Facile
1798,139,2017,Management,3,2,QCU,0.4546,0.15,0.35,88,68,40,28,1.29,58.82,40,48,45.46,Trop Facile,Difficile,Trop Facile / Difficile
2628,139,2018,Management,3,2,QCU,0.9079,0.03,0.9,103,95,94,1,1.08,98.95,94,9,90.79,Trop Facile,Trop Facile,Trop Facile / Trop Facile
3458,139,2019,Management,3,2,QCU,0.9685,0.06,0.95,120,119,116,3,1.01,97.48,116,4,96.85,Trop Facile,Trop Facile,Trop Facile / Trop Facile
4288,139,2020,Management,3,2,QCU,0.6715,0.25,0.68,118,108,79,29,1.09,73.15,79,39,67.15,Trop Facile,Adapte,Trop Facile / Adapte
139,140,2015,Management,3,3,QCM,0.6809,0.18,0.67,55,54,37,17,1.02,68.52,37,18,68.09,Adapte,Adapte,Adapte / Adapte
969,140,2016,Management,3,3,QCM,0.6878,0.15,0.68,47,44,32,12,1.07,72.73,32,15,68.78,Adapte,Adapte,Adapte / Adapte
1799,140,2017,Management,3,3,QCM,0.6978,0.2,0.57,51,37,36,1,1.38,97.3,36,15,69.78,Adapte,Adapte,Adapte / Adapte
2629,140,2018,Management,3,3,QCM,0.6924,0.12,0.65,55,50,38,12,1.1,76.0,38,17,69.24,Adapte,Adapte,Adapte / Adapte
3459,140,2019,Management,3,3,QCM,0.7392,0.14,0.45,63,54,47,7,1.17,87.04,47,16,73.92,Adapte,Adapte,Adapte / Adapte
4289,140,2020,Management,3,3,QCM,0.6558,0.06,0.51,64,45,42,3,1.42,93.33,42,22,65.58,Adapte,Adapte,Adapte / Adapte
140,141,2015,Management,3,4,QCM,0.8205,0.02,0.74,26,25,21,4,1.04,84.0,21,5,82.05,Facile,Facile,Facile / Facile
970,141,2016,Management,3,4,QCM,0.1853,0.09,0.25,26,8,5,3,3.25,62.5,5,21,18.53,Facile,Trop Difficile,Facile / Trop Difficile
1800,141,2017,Management,3,4,QCM,0.9356,0.02,0.81,27,27,25,2,1.0,92.59,25,2,93.56,Facile,Trop Facile,Facile / Trop Facile
2630,141,2018,Management,3,4,QCM,0.5558,0.25,0.3,24,14,13,1,1.71,92.86,13,11,55.58,Facile,Difficile,Facile / Difficile
3460,141,2019,Management,3,4,QCM,0.1361,0.59,0.3,21,11,3,8,1.91,27.27,3,18,13.61,Facile,Trop Difficile,Facile / Trop Difficile
4290,141,2020,Management,3,4,QCM,0.7825,0.1,0.76,17,16,13,3,1.06,81.25,13,4,78.25,Facile,Facile,Facile / Facile
141,142,2015,Management,3,5,QCU,0.7917,0.01,0.81,81,77,64,13,1.05,83.12,64,17,79.17,Facile,Facile,Facile / Facile
971,142,2016,Management,3,5,QCU,0.9144,0.07,0.99,87,85,80,5,1.02,94.12,80,7,91.44,Trop Facile,Trop Facile,Trop Facile / Trop Facile
1801,142,2017,Management,3,5,QCU,0.8917,0.04,0.99,84,81,75,6,1.04,92.59,75,9,89.17,Trop Facile,Trop Facile,Trop Facile / Trop Facile
2631,142,2018,Management,3,5,QCU,0.9285,0.01,0.96,89,85,83,2,1.05,97.65,83,6,92.85,Trop Facile,Trop Facile,Trop Facile / Trop Facile
3461,142,2019,Management,3,5,QCU,0.8759,0.09,1.0,82,74,72,2,1.11,97.3,72,10,87.59,Trop Facile,Trop Facile,Trop Facile / Trop Facile
4291,142,2020,Management,3,5,QCU,0.9597,0.08,0.92,94,92,90,2,1.02,97.83,90,4,95.97,Trop Facile,Trop Facile,Trop Facile / Trop Facile
142,143,2015,Management,3,6,QCU,0.1435,0.18,0.23,46,40,7,33,1.15,17.5,7,39,14.35,Trop Facile,Trop Difficile,Trop Facile / Trop Difficile
972,143,2016,Management,3,6,QCU,1.0,0.07,0.94,41,41,41,0,1.0,100.0,41,0,100.0,Trop Facile,Trop Facile,Trop Facile / Trop Facile
1802,143,2017,Management,3,6,QCU,0.8747,0.09,1.0,36,32,31,1,1.12,96.88,31,5,87.47,Trop Facile,Trop Facile,Trop Facile / Trop Facile
2632,143,2018,Management,3,6,QCU,0.154,0.75,0.25,29,26,4,22,1.12,15.38,4,25,15.4,Trop Facile,Trop Difficile,Trop Facile / Trop Difficile
3462,143,2019,Management,3,6,QCU,0.9472,0.09,0.93,26,26,25,1,1.0,96.15,25,1,94.72,Trop Facile,Trop Facile,Trop Facile / Trop Facile
4292,143,2020,Management,3,6,QCU,0.9889,0.09,1.0,23,23,23,0,1.0,100.0,23,0,98.89,Trop Facile,Trop Facile,Trop Facile / Trop Facile
143,144,2015,Management,4,1,QO,0.9131,0.04,0.75,70,69,64,5,1.01,92.75,64,6,91.31,Trop Difficile,Trop Facile,Trop Difficile / Trop Facile
973,144,2016,Management,4,1,QO,0.659,0.47,0.15,61,56,40,16,1.09,71.43,40,21,65.9,Adapte,Adapte,Adapte / Adapte
1803,144,2017,Management,4,1,QO,0.7386,0.53,0.16,52,44,38,6,1.18,86.36,38,14,73.86,Adapte,Adapte,Adapte / Adapte
2633,144,2018,Management,4,1,QO,0.6131,0.49,0.23,45,40,28,12,1.12,70.0,28,17,61.31,Adapte,Adapte,Adapte / Adapte
3463,144,2019,Management,4,1,QO,0.6628,0.4,0.28,44,44,29,15,1.0,65.91,29,15,66.28,Adapte,Adapte,Adapte / Adapte
4293,144,2020,Management,4,1,QO,0.6756,0.4,0.28,36,36,24,12,1.0,66.67,24,12,67.56,Adapte,Adapte,Adapte / Adapte
144,145,2015,Management,4,2,QCU,0.7731,0.08,0.81,98,90,76,14,1.09,84.44,76,22,77.31,Facile,Facile,Facile / Facile
974,145,2016,Management,4,2,QCU,0.6402,0.08,0.41,90,69,58,11,1.3,84.06,58,32,64.02,Trop Facile,Adapte,Trop Facile / Adapte
1804,145,2017,Management,4,2,QCU,0.6246,0.08,0.43,95,71,59,12,1.34,83.1,59,36,62.46,Adapte,Adapte,Adapte / Adapte
2634,145,2018,Management,4,2,QCU,0.7388,0.3,0.58,101,87,75,12,1.16,86.21,75,26,73.88,Adapte,Adapte,Adapte / Adapte
3464,145,2019,Management,4,2,QCU,0.6869,0.01,0.5,87,65,60,5,1.34,92.31,60,27,68.69,Adapte,Adapte,Adapte / Adapte
4294,145,2020,Management,4,2,QCU,0.6342,0.1,0.57,94,80,60,20,1.18,75.0,60,34,63.42,Adapte,Adapte,Adapte / Adapte
145,146,2015,Management,5,1,QCU,0.932,0.01,0.99,25,23,23,0,1.09,100.0,23,2,93.2,Trop Facile,Trop Facile,Trop Facile / Trop Facile
975,146,2016,Management,5,1,QCU,0.9439,0.06,0.97,22,21,21,0,1.05,100.0,21,1,94.39,Trop Facile,Trop Facile,Trop Facile / Trop Facile
1805,146,2017,Management,5,1,QCU,0.9787,0.03,0.95,19,19,19,0,1.0,100.0,19,0,97.87,Trop Facile,Trop Facile,Trop Facile / Trop Facile
2635,146,2018,Management,5,1,QCU,0.9399,0.07,0.91,19,19,18,1,1.0,94.74,18,1,93.99,Trop Facile,Trop Facile,Trop Facile / Trop Facile
3465,146,2019,Management,5,1,QCU,0.9381,0.04,0.99,16,16,15,1,1.0,93.75,15,1,93.81,Trop Facile,Trop Facile,Trop Facile / Trop Facile
4295,146,2020,Management,5,1,QCU,0.9598,0.06,0.95,18,17,17,0,1.06,100.0,17,1,95.98,Trop Facile,Trop Facile,Trop Facile / Trop Facile
146,147,2015,Management,5,2,QCU,0.3753,0.37,0.31,63,51,24,27,1.24,47.06,24,39,37.53,Difficile,Difficile,Difficile / Difficile
976,147,2016,Management,5,2,QCU,0.9968,0.09,0.95,55,55,55,0,1.0,100.0,55,0,99.68,Trop Facile,Trop Facile,Trop Facile / Trop Facile
1806,147,2017,Management,5,2,QCU,0.9519,0.01,0.98,53,52,50,2,1.02,96.15,50,3,95.19,Trop Facile,Trop Facile,Trop Facile / Trop Facile
2636,147,2018,Management,5,2,QCU,0.8266,0.04,0.9,47,40,39,1,1.18,97.5,39,8,82.66,Trop Facile,Facile,Trop Facile / Facile
3466,147,2019,Management,5,2,QCU,0.0692,0.42,0.23,53,21,4,17,2.52,19.05,4,49,6.92,Trop Facile,Trop Difficile,Trop Facile / Trop Difficile
4296,147,2020,Management,5,2,QCU,0.8617,0.03,0.93,59,51,51,0,1.16,100.0,51,8,86.17,Trop Facile,Trop Facile,Trop Facile / Trop Facile
147,148,2015,Management,5,3,QCM,0.7888,0.06,0.78,5,5,4,1,1.0,80.0,4,1,78.88,Facile,Facile,Facile / Facile
977,148,2016,Management,5,3,QCM,0.7605,0.08,0.78,6,5,5,0,1.2,100.0,5,1,76.05,Facile,Facile,Facile / Facile
1807,148,2017,Management,5,3,QCM,0.6609,0.18,0.45,6,5,4,1,1.2,80.0,4,2,66.09,Facile,Adapte,Facile / Adapte
2637,148,2018,Management,5,3,QCM,0.6299,0.25,0.57,5,4,3,1,1.25,75.0,3,2,62.99,Adapte,Adapte,Adapte / Adapte
3467,148,2019,Management,5,3,QCM,0.6807,0.21,0.68,4,3,3,0,1.33,100.0,3,1,68.07,Adapte,Adapte,Adapte / Adapte
4297,148,2020,Management,5,3,QCM,0.7281,0.04,0.51,3,2,2,0,1.5,100.0,2,1,72.81,Adapte,Adapte,Adapte / Adapte
148,149,2015,Management,5,4,QCU,0.1182,0.32,0.21,60,25,7,18,2.4,28.0,7,53,11.82,Trop Difficile,Trop Difficile,Trop Difficile / Trop Difficile
978,149,2016,Management,5,4,QCU,0.8774,0.05,0.97,67,64,59,5,1.05,92.19,59,8,87.74,Trop Facile,Trop Facile,Trop Facile / Trop Facile
1808,149,2017,Management,5,4,QCU,0.7021,0.16,0.44,72,62,51,11,1.16,82.26,51,21,70.21,Trop Facile,Adapte,Trop Facile / Adapte
2638,149,2018,Management,5,4,QCU,0.7365,0.04,0.46,69,56,51,5,1.23,91.07,51,18,73.65,Adapte,Adapte,Adapte / Adapte
3468,149,2019,Management,5,4,QCU,0.7386,0.23,0.57,71,55,52,3,1.29,94.55,52,19,73.86,Adapte,Adapte,Adapte / Adapte
4298,149,2020,Management,5,4,QCU,0.6488,0.29,0.59,68,60,44,16,1.13,73.33,44,24,64.88,Adapte,Adapte,Adapte / Adapte
149,150,2015,Management,5,5,QCM,0.5326,0.09,0.32,82,57,44,13,1.44,77.19,44,38,53.26,Facile,Difficile,Facile / Difficile
979,150,2016,Management,5,5,QCM,0.8315,0.03,0.75,94,91,78,13,1.03,85.71,78,16,83.15,Facile,Facile,Facile / Facile
1809,150,2017,Management,5,5,QCM,0.4771,0.36,0.39,106,59,51,8,1.8,86.44,51,55,47.71,Facile,Difficile,Facile / Difficile
2639,150,2018,Management,5,5,QCM,0.021,0.15,0.27,116,100,2,98,1.16,2.0,2,114,2.1,Facile,Trop Difficile,Facile / Trop Difficile
3469,150,2019,Management,5,5,QCM,0.8462,0.0,0.73,135,126,114,12,1.07,90.48,114,21,84.62,Facile,Facile,Facile / Facile
4299,150,2020,Management,5,5,QCM,0.8491,0.08,0.76,134,130,114,16,1.03,87.69,114,20,84.91,Facile,Facile,Facile / Facile
150,151,2015,Management,5,6,QCU,0.0422,0.16,0.25,30,12,1,11,2.5,8.33,1,29,4.22,Trop Difficile,Trop Difficile,Trop Difficile / Trop Difficile
980,151,2016,Management,5,6,QCU,0.9797,0.01,0.95,30,29,29,0,1.03,100.0,29,1,97.97,Trop Facile,Trop Facile,Trop Facile / Trop Facile
1810,151,2017,Management,5,6,QCU,0.9352,0.01,0.96,29,28,27,1,1.04,96.43,27,2,93.52,Trop Facile,Trop Facile,Trop Facile / Trop Facile
2640,151,2018,Management,5,6,QCU,0.9401,0.01,0.99,31,31,29,2,1.0,93.55,29,2,94.01,Trop Facile,Trop Facile,Trop Facile / Trop Facile
3470,151,2019,Management,5,6,QCU,0.9007,0.05,0.99,28,27,25,2,1.04,92.59,25,3,90.07,Trop Facile,Trop Facile,Trop Facile / Trop Facile
4300,151,2020,Management,5,6,QCU,0.9651,0.07,0.91,33,32,32,0,1.03,100.0,32,1,96.51,Trop Facile,Trop Facile,Trop Facile / Trop Facile
151,152,2015,Management,5,7,QCM,0.7944,0.18,0.79,44,43,35,8,1.02,81.4,35,9,79.44,Trop Difficile,Facile,Trop Difficile / Facile
981,152,2016,Management,5,7,QCM,0.7742,0.05,0.79,44,42,34,8,1.05,80.95,34,10,77.42,Facile,Facile,Facile / Facile
1811,152,2017,Management,5,7,QCM,0.3113,0.35,0.31,37,22,12,10,1.68,54.55,12,25,31.13,Facile,Difficile,Facile / Difficile
2641,152,2018,Management,5,7,QCM,0.8436,0.04,0.77,32,29,27,2,1.1,93.1,27,5,84.36,Facile,Facile,Facile / Facile
3471,152,2019,Management,5,7,QCM,0.7618,0.11,0.79,33,30,25,5,1.1,83.33,25,8,76.18,Facile,Facile,Facile / Facile
4301,152,2020,Management,5,7,QCM,0.8106,0.15,0.73,26,24,21,3,1.08,87.5,21,5,81.06,Facile,Facile,Facile / Facile
152,153,2015,Management,6,1,QCM,0.8275,0.05,0.74,59,54,49,5,1.09,90.74,49,10,82.75,Facile,Facile,Facile / Facile
982,153,2016,Management,6,1,QCM,0.8072,0.03,0.74,62,55,50,5,1.13,90.91,50,12,80.72,Facile,Facile,Facile / Facile
1812,153,2017,Management,6,1,QCM,0.7732,0.12,0.72,52,45,40,5,1.16,88.89,40,12,77.32,Facile,Facile,Facile / Facile
2642,153,2018,Management,6,1,QCM,0.8417,0.19,0.75,53,53,45,8,1.0,84.91,45,8,84.17,Facile,Facile,Facile / Facile
3472,153,2019,Management,6,1,QCM,0.8123,0.09,0.73,43,39,35,4,1.1,89.74,35,8,81.23,Facile,Facile,Facile / Facile
4302,153,2020,Management,6,1,QCM,0.8459,0.05,0.71,35,33,30,3,1.06,90.91,30,5,84.59,Facile,Facile,Facile / Facile
153,154,2015,Management,6,2,QCM,0.6795,0.01,0.57,85,69,58,11,1.23,84.06,58,27,67.95,Trop Facile,Adapte,Trop Facile / Adapte
983,154,2016,Management,6,2,QCM,0.6574,0.04,0.64,73,69,48,21,1.06,69.57,48,25,65.74,Adapte,Adapte,Adapte / Adapte
1813,154,2017,Management,6,2,QCM,0.6875,0.11,0.41,63,50,43,7,1.26,86.0,43,20,68.75,Adapte,Adapte,Adapte / Adapte
2643,154,2018,Management,6,2,QCM,0.668,0.24,0.47,64,53,43,10,1.21,81.13,43,21,66.8,Adapte,Adapte,Adapte / Adapte
3473,154,2019,Management,6,2,QCM,0.658,0.28,0.65,74,69,49,20,1.07,71.01,49,25,65.8,Adapte,Adapte,Adapte / Adapte
4303,154,2020,Management,6,2,QCM,0.7102,0.04,0.5,59,52,42,10,1.13,80.77,42,17,71.02,Adapte,Adapte,Adapte / Adapte
154,155,2015,Management,7,1,QCU,0.0466,0.46,0.26,56,46,3,43,1.22,6.52,3,53,4.66,Trop Difficile,Trop Difficile,Trop Difficile / Trop Difficile
984,155,2016,Management,7,1,QCU,0.7622,0.04,0.77,53,51,40,11,1.04,78.43,40,13,76.22,Trop Facile,Facile,Trop Facile / Facile
1814,155,2017,Management,7,1,QCU,0.8669,0.07,1.0,48,47,42,5,1.02,89.36,42,6,86.69,Trop Facile,Trop Facile,Trop Facile / Trop Facile
2644,155,2018,Management,7,1,QCU,0.887,0.06,0.92,51,47,45,2,1.09,95.74,45,6,88.7,Trop Facile,Trop Facile,Trop Facile / Trop Facile
3474,155,2019,Management,7,1,QCU,0.9038,0.08,0.97,46,44,42,2,1.05,95.45,42,4,90.38,Trop Facile,Trop Facile,Trop Facile / Trop Facile
4304,155,2020,Management,7,1,QCU,0.9401,0.01,0.92,38,37,36,1,1.03,97.3,36,2,94.01,Trop Facile,Trop Facile,Trop Facile / Trop Facile
155,156,2015,Management,7,2,QCM,0.4947,0.45,0.38,14,11,7,4,1.27,63.64,7,7,49.47,Adapte,Difficile,Adapte / Difficile
985,156,2016,Management,7,2,QCM,0.8472,0.05,0.72,13,12,11,1,1.08,91.67,11,2,84.72,Facile,Facile,Facile / Facile
1815,156,2017,Management,7,2,QCM,0.0758,0.55,0.28,11,5,1,4,2.2,20.0,1,10,7.58,Facile,Trop Difficile,Facile / Trop Difficile
2645,156,2018,Management,7,2,QCM,0.8295,0.17,0.74,13,13,11,2,1.0,84.62,11,2,82.95,Facile,Facile,Facile / Facile
3475,156,2019,Management,7,2,QCM,0.7656,0.12,0.77,15,15,11,4,1.0,73.33,11,4,76.56,Facile,Facile,Facile / Facile
4305,156,2020,Management,7,2,QCM,0.8359,0.03,0.7,12,11,10,1,1.09,90.91,10,2,83.59,Facile,Facile,Facile / Facile
156,157,2015,Management,7,3,QCU,0.7954,0.09,0.84,94,93,75,18,1.01,80.65,75,19,79.54,Facile,Facile,Facile / Facile
986,157,2016,Management,7,3,QCU,0.6507,0.27,0.48,82,60,53,7,1.37,88.33,53,29,65.07,Trop Facile,Adapte,Trop Facile / Adapte
1816,157,2017,Management,7,3,QCU,0.7084,0.25,0.62,87,80,62,18,1.09,77.5,62,25,70.84,Adapte,Adapte,Adapte / Adapte
2646,157,2018,Management,7,3,QCU,0.6866,0.05,0.47,99,69,68,1,1.43,98.55,68,31,68.66,Adapte,Adapte,Adapte / Adapte
3476,157,2019,Management,7,3,QCU,0.6775,0.06,0.49,102,90,69,21,1.13,76.67,69,33,67.75,Adapte,Adapte,Adapte / Adapte
4306,157,2020,Management,7,3,QCU,0.7248,0.06,0.5,102,80,74,6,1.27,92.5,74,28,72.48,Adapte,Adapte,Adapte / Adapte
157,158,2015,Management,7,4,QCM,0.5745,0.03,0.39,14,10,8,2,1.4,80.0,8,6,57.45,Difficile,Difficile,Difficile / Difficile
987,158,2016,Management,7,4,QCM,0.3265,0.1,0.36,17,11,6,5,1.55,54.55,6,11,32.65,Facile,Difficile,Facile / Difficile
1817,158,2017,Management,7,4,QCM,0.7661,0.08,0.78,17,16,13,3,1.06,81.25,13,4,76.61,Facile,Facile,Facile / Facile
2647,158,2018,Management,7,4,QCM,0.9179,0.05,0.87,18,17,17,0,1.06,100.0,17,1,91.79,Facile,Trop Facile,Facile / Trop Facile
3477,158,2019,Management,7,4,QCM,0.7014,0.03,0.51,21,21,15,6,1.0,71.43,15,6,70.14,Facile,Adapte,Facile / Adapte
4307,158,2020,Management,7,4,QCM,0.6024,0.13,0.44,17,14,10,4,1.21,71.43,10,7,60.24,Adapte,Adapte,Adapte / Adapte
158,159,2015,Management,7,5,QCU,0.7439,0.23,0.57,30,25,22,3,1.2,88.0,22,8,74.39,Trop Facile,Adapte,Trop Facile / Adapte
988,159,2016,Management,7,5,QCU,0.7144,0.11,0.64,29,26,21,5,1.12,80.77,21,8,71.44,Adapte,Adapte,Adapte / Adapte
1818,159,2017,Management,7,5,QCU,0.7018,0.13,0.67,33,25,23,2,1.32,92.0,23,10,70.18,Adapte,Adapte,Adapte / Adapte
2648,159,2018,Management,7,5,QCU,0.6075,0.15,0.69,37,34,22,12,1.09,64.71,22,15,60.75,Adapte,Adapte,Adapte / Adapte
3478,159,2019,Management,7,5,QCU,0.6653,0.24,0.58,36,27,24,3,1.33,88.89,24,12,66.53,Adapte,Adapte,Adapte / Adapte
4308,159,2020,Management,7,5,QCU,0.6793,0.08,0.44,31,29,21,8,1.07,72.41,21,10,67.93,Adapte,Adapte,Adapte / Adapte
159,160,2015,Management,7,6,QCM,0.3241,0.23,0.37,78,56,25,31,1.39,44.64,25,53,32.41,Difficile,Difficile,Difficile / Difficile
989,160,2016,Management,7,6,QCM,0.0307,0.25,0.3,85,64,3,61,1.33,4.69,3,82,3.07,Facile,Trop Difficile,Facile / Trop Difficile
1819,160,2017,Management,7,6,QCM,0.4578,0.37,0.4,94,73,43,30,1.29,58.9,43,51,45.78,Facile,Difficile,Facile / Difficile
2649,160,2018,Management,7,6,QCM,0.7919,0.04,0.79,104,88,82,6,1.18,93.18,82,22,79.19,Facile,Facile,Facile / Facile
3479,160,2019,Management,7,6,QCM,0.8698,0.06,0.99,120,107,104,3,1.12,97.2,104,16,86.98,Facile,Trop Facile,Facile / Trop Facile
4309,160,2020,Management,7,6,QCM,0.8321,0.18,0.79,126,112,105,7,1.12,93.75,105,21,83.21,Facile,Facile,Facile / Facile
160,161,2015,Management,7,7,QCU,0.43,0.08,0.34,58,28,25,3,2.07,89.29,25,33,43.0,Trop Facile,Difficile,Trop Facile / Difficile
990,161,2016,Management,7,7,QCU,0.9194,0.06,0.92,52,49,48,1,1.06,97.96,48,4,91.94,Trop Facile,Trop Facile,Trop Facile / Trop Facile
1820,161,2017,Management,7,7,QCU,0.9701,0.03,0.91,50,50,49,1,1.0,98.0,49,1,97.01,Trop Facile,Trop Facile,Trop Facile / Trop Facile
2650,161,2018,Management,7,7,QCU,0.9596,0.06,0.91,45,43,43,0,1.05,100.0,43,2,95.96,Trop Facile,Trop Facile,Trop Facile / Trop Facile
3480,161,2019,Management,7,7,QCU,0.4541,0.25,0.34,49,37,22,15,1.32,59.46,22,27,45.41,Trop Facile,Difficile,Trop Facile / Difficile
4310,161,2020,Management,7,7,QCU,0.9135,0.08,0.95,52,49,48,1,1.06,97.96,48,4,91.35,Trop Facile,Trop Facile,Trop Facile / Trop Facile
161,162,2015,Management,7,8,QCM,0.6237,0.05,0.58,7,6,4,2,1.17,66.67,4,3,62.37,Difficile,Adapte,Difficile / Adapte
991,162,2016,Management,7,8,QCM,0.6259,0.01,0.46,7,6,4,2,1.17,66.67,4,3,62.59,Adapte,Adapte,Adapte / Adapte
1821,162,2017,Management,7,8,QCM,0.6494,0.2,0.69,7,5,5,0,1.4,100.0,5,2,64.94,Adapte,Adapte,Adapte / Adapte
2651,162,2018,Management,7,8,QCM,0.6007,0.06,0.58,7,6,4,2,1.17,66.67,4,3,60.07,Adapte,Adapte,Adapte / Adapte
3481,162,2019,Management,7,8,QCM,0.6897,0.26,0.44,7,7,5,2,1.0,71.43,5,2,68.97,Adapte,Adapte,Adapte / Adapte
4311,162,2020,Management,7,8,QCM,0.663,0.23,0.63,8,6,5,1,1.33,83.33,5,3,66.3,Adapte,Adapte,Adapte / Adapte
162,163,2015,Management,7,9,QCU,0.9197,0.08,0.94,40,38,37,1,1.05,97.37,37,3,91.97,Difficile,Trop Facile,Difficile / Trop Facile
992,163,2016,Management,7,9,QCU,0.9093,0.05,0.91,48,46,44,2,1.04,95.65,44,4,90.93,Trop Facile,Trop Facile,Trop Facile / Trop Facile
1822,163,2017,Management,7,9,QCU,0.7795,0.04,0.87,53,46,41,5,1.15,89.13,41,12,77.95,Trop Facile,Facile,Trop Facile / Facile
2652,163,2018,Management,7,9,QCU,0.9991,0.1,1.0,50,50,50,0,1.0,100.0,50,0,99.91,Trop Facile,Trop Facile,Trop Facile / Trop Facile
3482,163,2019,Management,7,9,QCU,0.9133,0.06,0.96,46,45,42,3,1.02,93.33,42,4,91.33,Trop Facile,Trop Facile,Trop Facile / Trop Facile
4312,163,2020,Management,7,9,QCU,0.8078,0.12,0.82,39,33,32,1,1.18,96.97,32,7,80.78,Trop Facile,Facile,Trop Facile / Facile
163,164,2015,Management,7,10,QCU,0.2298,0.01,0.26,20,12,5,7,1.67,41.67,5,15,22.98,Trop Difficile,Trop Difficile,Trop Difficile / Trop Difficile
993,164,2016,Management,7,10,QCU,0.9334,0.01,0.98,20,20,19,1,1.0,95.0,19,1,93.34,Trop Facile,Trop Facile,Trop Facile / Trop Facile
1823,164,2017,Management,7,10,QCU,0.9773,0.01,0.99,23,22,22,0,1.05,100.0,22,1,97.73,Trop Facile,Trop Facile,Trop Facile / Trop Facile
2653,164,2018,Management,7,10,QCU,0.007,0.34,0.27,21,11,0,11,1.91,0.0,0,21,0.7,Trop Facile,Trop Difficile,Trop Facile / Trop Difficile
3483,164,2019,Management,7,10,QCU,0.9739,0.04,0.99,21,20,20,0,1.05,100.0,20,1,97.39,Trop Facile,Trop Facile,Trop Facile / Trop Facile
4313,164,2020,Management,7,10,QCU,0.6793,0.12,0.65,22,22,15,7,1.0,68.18,15,7,67.93,Trop Facile,Adapte,Trop Facile / Adapte
164,165,2015,Management,7,11,QCM,0.1477,0.37,0.3,44,21,6,15,2.1,28.57,6,38,14.77,Trop Facile,Trop Difficile,Trop Facile / Trop Difficile
994,165,2016,Management,7,11,QCM,0.638,0.2,0.51,42,34,27,7,1.24,79.41,27,15,63.8,Facile,Adapte,Facile / Adapte
1824,165,2017,Management,7,11,QCM,0.6233,0.17,0.44,38,36,24,12,1.06,66.67,24,14,62.33,Adapte,Adapte,Adapte / Adapte
2654,165,2018,Management,7,11,QCM,0.6813,0.29,0.44,45,35,31,4,1.29,88.57,31,14,68.13,Adapte,Adapte,Adapte / Adapte
3484,165,2019,Management,7,11,QCM,0.6504,0.02,0.48,50,33,33,0,1.52,100.0,33,17,65.04,Adapte,Adapte,Adapte / Adapte
4314,165,2020,Management,7,11,QCM,0.6016,0.1,0.6,44,30,26,4,1.47,86.67,26,18,60.16,Adapte,Adapte,Adapte / Adapte
165,166,2015,Management,8,1,QCM,0.6915,0.17,0.6,95,80,66,14,1.19,82.5,66,29,69.15,Adapte,Adapte,Adapte / Adapte
995,166,2016,Management,8,1,QCM,0.7061,0.06,0.64,104,74,73,1,1.41,98.65,73,31,70.61,Adapte,Adapte,Adapte / Adapte
1825,166,2017,Management,8,1,QCM,0.7376,0.04,0.41,115,90,85,5,1.28,94.44,85,30,73.76,Adapte,Adapte,Adapte / Adapte
2655,166,2018,Management,8,1,QCM,0.7448,0.3,0.63,100,80,74,6,1.25,92.5,74,26,74.48,Adapte,Adapte,Adapte / Adapte
3485,166,2019,Management,8,1,QCM,0.6422,0.14,0.68,105,70,67,3,1.5,95.71,67,38,64.22,Adapte,Adapte,Adapte / Adapte
4315,166,2020,Management,8,1,QCM,0.6691,0.13,0.64,102,79,68,11,1.29,86.08,68,34,66.91,Adapte,Adapte,Adapte / Adapte
166,167,2015,Management,8,2,QCM,0.7482,0.16,0.54,44,35,33,2,1.26,94.29,33,11,74.82,Trop Facile,Adapte,Trop Facile / Adapte
996,167,2016,Management,8,2,QCM,0.6403,0.01,0.61,37,31,24,7,1.19,77.42,24,13,64.03,Adapte,Adapte,Adapte / Adapte
1826,167,2017,Management,8,2,QCM,0.7161,0.06,0.44,35,34,25,9,1.03,73.53,25,10,71.61,Adapte,Adapte,Adapte / Adapte
2656,167,2018,Management,8,2,QCM,0.7412,0.23,0.55,28,22,21,1,1.27,95.45,21,7,74.12,Adapte,Adapte,Adapte / Adapte
3486,167,2019,Management,8,2,QCM,0.6618,0.03,0.56,24,17,16,1,1.41,94.12,16,8,66.18,Adapte,Adapte,Adapte / Adapte
4316,167,2020,Management,8,2,QCM,0.6431,0.29,0.41,24,16,15,1,1.5,93.75,15,9,64.31,Adapte,Adapte,Adapte / Adapte
167,168,2015,Management,8,3,QROC,0.0112,0.82,0.03,12,5,0,5,2.4,0.0,0,12,1.12,Trop Difficile,Trop Difficile,Trop Difficile / Trop Difficile
997,168,2016,Management,8,3,QROC,0.4566,0.6,0.25,11,10,5,5,1.1,50.0,5,6,45.66,Facile,Difficile,Facile / Difficile
1827,168,2017,Management,8,3,QROC,0.78,0.14,0.62,12,10,9,1,1.2,90.0,9,3,78.0,Facile,Facile,Facile / Facile
2657,168,2018,Management,8,3,QROC,0.8146,0.09,0.71,12,11,10,1,1.09,90.91,10,2,81.46,Facile,Facile,Facile / Facile
3487,168,2019,Management,8,3,QROC,0.8307,0.12,0.49,14,13,12,1,1.08,92.31,12,2,83.07,Facile,Facile,Facile / Facile
4317,168,2020,Management,8,3,QROC,0.7695,0.16,0.49,16,14,12,2,1.14,85.71,12,4,76.95,Facile,Facile,Facile / Facile
168,169,2015,Management,8,4,QROC,0.8792,0.09,0.8,48,43,42,1,1.12,97.67,42,6,87.92,Trop Facile,Trop Facile,Trop Facile / Trop Facile
998,169,2016,Management,8,4,QROC,0.4535,0.69,0.23,42,21,19,2,2.0,90.48,19,23,45.35,Facile,Difficile,Facile / Difficile
1828,169,2017,Management,8,4,QROC,0.7958,0.12,0.66,36,34,29,5,1.06,85.29,29,7,79.58,Facile,Facile,Facile / Facile
2658,169,2018,Management,8,4,QROC,0.7831,0.19,0.49,36,34,28,6,1.06,82.35,28,8,78.31,Facile,Facile,Facile / Facile
3488,169,2019,Management,8,4,QROC,0.8481,0.2,0.71,33,30,28,2,1.1,93.33,28,5,84.81,Facile,Facile,Facile / Facile
4318,169,2020,Management,8,4,QROC,0.7855,0.05,0.64,31,27,24,3,1.15,88.89,24,7,78.55,Facile,Facile,Facile / Facile
169,170,2015,Management,8,5,QCM,0.4866,0.26,0.37,68,37,33,4,1.84,89.19,33,35,48.66,Facile,Difficile,Facile / Difficile
999,170,2016,Management,8,5,QCM,0.8176,0.14,0.75,65,57,53,4,1.14,92.98,53,12,81.76,Facile,Facile,Facile / Facile
1829,170,2017,Management,8,5,QCM,0.8279,0.08,0.73,62,61,51,10,1.02,83.61,51,11,82.79,Facile,Facile,Facile / Facile
2659,170,2018,Management,8,5,QCM,0.835,0.15,0.76,69,66,58,8,1.05,87.88,58,11,83.5,Facile,Facile,Facile / Facile
3489,170,2019,Management,8,5,QCM,0.4713,0.06,0.34,71,57,33,24,1.25,57.89,33,38,47.13,Facile,Difficile,Facile / Difficile
4319,170,2020,Management,8,5,QCM,0.8404,0.04,0.78,83,80,70,10,1.04,87.5,70,13,84.04,Facile,Facile,Facile / Facile
170,171,2015,Management,8,6,QCM,0.7789,0.13,0.73,17,16,13,3,1.06,81.25,13,4,77.89,Trop Facile,Facile,Trop Facile / Facile
1000,171,2016,Management,8,6,QCM,0.0846,0.19,0.26,17,7,1,6,2.43,14.29,1,16,8.46,Facile,Trop Difficile,Facile / Trop Difficile
1830,171,2017,Management,8,6,QCM,0.7619,0.09,0.75,20,19,15,4,1.05,78.95,15,5,76.19,Facile,Facile,Facile / Facile
2660,171,2018,Management,8,6,QCM,0.7768,0.11,0.74,22,21,17,4,1.05,80.95,17,5,77.68,Facile,Facile,Facile / Facile
3490,171,2019,Management,8,6,QCM,0.905,0.02,0.94,24,24,22,2,1.0,91.67,22,2,90.5,Facile,Trop Facile,Facile / Trop Facile
4320,171,2020,Management,8,6,QCM,0.7604,0.13,0.73,22,21,17,4,1.05,80.95,17,5,76.04,Facile,Facile,Facile / Facile
171,172,2015,Management,9,1,QCM,0.8374,0.12,0.76,67,63,56,7,1.06,88.89,56,11,83.74,Difficile,Facile,Difficile / Facile
1001,172,2016,Management,9,1,QCM,0.8207,0.16,0.79,68,57,56,1,1.19,98.25,56,12,82.07,Facile,Facile,Facile / Facile
1831,172,2017,Management,9,1,QCM,0.8278,0.14,0.77,81,69,67,2,1.17,97.1,67,14,82.78,Facile,Facile,Facile / Facile
2661,172,2018,Management,9,1,QCM,0.8977,0.07,0.88,71,67,64,3,1.06,95.52,64,7,89.77,Facile,Trop Facile,Facile / Trop Facile
3491,172,2019,Management,9,1,QCM,0.4945,0.33,0.33,66,56,33,23,1.18,58.93,33,33,49.45,Facile,Difficile,Facile / Difficile
4321,172,2020,Management,9,1,QCM,0.7656,0.17,0.72,65,54,50,4,1.2,92.59,50,15,76.56,Facile,Facile,Facile / Facile
172,173,2015,Management,9,2,QCU,0.3526,0.27,0.3,49,23,17,6,2.13,73.91,17,32,35.26,Facile,Difficile,Facile / Difficile
1002,173,2016,Management,9,2,QCU,0.9078,0.08,0.92,54,49,49,0,1.1,100.0,49,5,90.78,Trop Facile,Trop Facile,Trop Facile / Trop Facile
1832,173,2017,Management,9,2,QCU,0.8857,0.1,0.95,63,60,56,4,1.05,93.33,56,7,88.57,Trop Facile,Trop Facile,Trop Facile / Trop Facile
2662,173,2018,Management,9,2,QCU,0.3919,0.12,0.3,68,28,27,1,2.43,96.43,27,41,39.19,Trop Facile,Difficile,Trop Facile / Difficile
3492,173,2019,Management,9,2,QCU,0.9207,0.04,0.98,66,63,61,2,1.05,96.83,61,5,92.07,Trop Facile,Trop Facile,Trop Facile / Trop Facile
4322,173,2020,Management,9,2,QCU,0.9881,0.03,0.92,62,62,61,1,1.0,98.39,61,1,98.81,Trop Facile,Trop Facile,Trop Facile / Trop Facile
173,174,2015,Management,9,3,QO,0.7806,0.15,0.33,100,90,78,12,1.11,86.67,78,22,78.06,Trop Difficile,Facile,Trop Difficile / Facile
1003,174,2016,Management,9,3,QO,0.3894,0.78,0.07,94,83,37,46,1.13,44.58,37,57,38.94,Adapte,Difficile,Adapte / Difficile
1833,174,2017,Management,9,3,QO,0.678,0.72,0.24,110,85,75,10,1.29,88.24,75,35,67.8,Adapte,Adapte,Adapte / Adapte
2663,174,2018,Management,9,3,QO,0.7366,0.26,0.26,122,93,90,3,1.31,96.77,90,32,73.66,Adapte,Adapte,Adapte / Adapte
3493,174,2019,Management,9,3,QO,0.7448,0.75,0.28,141,138,105,33,1.02,76.09,105,36,74.48,Adapte,Adapte,Adapte / Adapte
4323,174,2020,Management,9,3,QO,0.6348,0.49,0.18,137,111,87,24,1.23,78.38,87,50,63.48,Adapte,Adapte,Adapte / Adapte
174,175,2015,Management,9,4,QCU,0.7812,0.14,0.79,41,34,32,2,1.21,94.12,32,9,78.12,Difficile,Facile,Difficile / Facile
1004,175,2016,Management,9,4,QCU,0.9768,0.07,0.95,46,45,45,0,1.02,100.0,45,1,97.68,Trop Facile,Trop Facile,Trop Facile / Trop Facile
1834,175,2017,Management,9,4,QCU,0.9527,0.08,0.91,40,39,38,1,1.03,97.44,38,2,95.27,Trop Facile,Trop Facile,Trop Facile / Trop Facile
2664,175,2018,Management,9,4,QCU,0.9594,0.09,0.93,40,38,38,0,1.05,100.0,38,2,95.94,Trop Facile,Trop Facile,Trop Facile / Trop Facile
3494,175,2019,Management,9,4,QCU,0.944,0.03,0.98,46,46,43,3,1.0,93.48,43,3,94.4,Trop Facile,Trop Facile,Trop Facile / Trop Facile
4324,175,2020,Management,9,4,QCU,0.9142,0.05,0.96,51,50,47,3,1.02,94.0,47,4,91.42,Trop Facile,Trop Facile,Trop Facile / Trop Facile
175,176,2015,Management,9,5,QROC,0.4033,0.68,0.25,75,32,30,2,2.34,93.75,30,45,40.33,Difficile,Difficile,Difficile / Difficile
1005,176,2016,Management,9,5,QROC,0.8369,0.09,0.59,80,71,67,4,1.13,94.37,67,13,83.69,Facile,Facile,Facile / Facile
1835,176,2017,Management,9,5,QROC,0.797,0.04,0.64,67,67,53,14,1.0,79.1,53,14,79.7,Facile,Facile,Facile / Facile
2665,176,2018,Management,9,5,QROC,0.8326,0.09,0.5,56,51,47,4,1.1,92.16,47,9,83.26,Facile,Facile,Facile / Facile
3495,176,2019,Management,9,5,QROC,0.7122,0.25,0.3,62,57,44,13,1.09,77.19,44,18,71.22,Facile,Adapte,Facile / Adapte
4325,176,2020,Management,9,5,QROC,0.7252,0.33,0.36,63,47,46,1,1.34,97.87,46,17,72.52,Adapte,Adapte,Adapte / Adapte
176,177,2015,Management,9,6,QCU,0.2338,0.43,0.21,95,92,22,70,1.03,23.91,22,73,23.38,Trop Facile,Trop Difficile,Trop Facile / Trop Difficile
1006,177,2016,Management,9,6,QCU,0.9503,0.0,0.91,91,86,86,0,1.06,100.0,86,5,95.03,Trop Facile,Trop Facile,Trop Facile / Trop Facile
1836,177,2017,Management,9,6,QCU,0.9908,0.04,0.94,102,102,101,1,1.0,99.02,101,1,99.08,Trop Facile,Trop Facile,Trop Facile / Trop Facile
2666,177,2018,Management,9,6,QCU,0.6557,0.03,0.66,109,79,71,8,1.38,89.87,71,38,65.57,Trop Facile,Adapte,Trop Facile / Adapte
3496,177,2019,Management,9,6,QCU,0.7441,0.29,0.42,91,82,68,14,1.11,82.93,68,23,74.41,Adapte,Adapte,Adapte / Adapte
4326,177,2020,Management,9,6,QCU,0.6101,0.11,0.62,105,94,64,30,1.12,68.09,64,41,61.01,Adapte,Adapte,Adapte / Adapte
177,178,2015,Management,9,7,QCU,0.8671,0.03,0.94,11,10,10,0,1.1,100.0,10,1,86.71,Trop Facile,Trop Facile,Trop Facile / Trop Facile
1007,178,2016,Management,9,7,QCU,0.6379,0.01,0.57,10,7,6,1,1.43,85.71,6,4,63.79,Trop Facile,Adapte,Trop Facile / Adapte
1837,178,2017,Management,9,7,QCU,0.6118,0.19,0.45,8,6,5,1,1.33,83.33,5,3,61.18,Adapte,Adapte,Adapte / Adapte
2667,178,2018,Management,9,7,QCU,0.6702,0.06,0.68,10,8,7,1,1.25,87.5,7,3,67.02,Adapte,Adapte,Adapte / Adapte
3497,178,2019,Management,9,7,QCU,0.7253,0.3,0.67,11,9,8,1,1.22,88.89,8,3,72.53,Adapte,Adapte,Adapte / Adapte
4327,178,2020,Management,9,7,QCU,0.6629,0.09,0.62,11,9,7,2,1.22,77.78,7,4,66.29,Adapte,Adapte,Adapte / Adapte
178,179,2015,Management,9,8,QCM,0.5018,0.39,0.37,58,29,29,0,2.0,100.0,29,29,50.18,Adapte,Difficile,Adapte / Difficile
1008,179,2016,Management,9,8,QCM,0.8049,0.02,0.79,59,51,47,4,1.16,92.16,47,12,80.49,Facile,Facile,Facile / Facile
1838,179,2017,Management,9,8,QCM,0.7719,0.16,0.72,61,55,47,8,1.11,85.45,47,14,77.19,Facile,Facile,Facile / Facile
2668,179,2018,Management,9,8,QCM,0.8027,0.2,0.74,50,47,40,7,1.06,85.11,40,10,80.27,Facile,Facile,Facile / Facile
3498,179,2019,Management,9,8,QCM,0.2882,0.16,0.32,54,47,16,31,1.15,34.04,16,38,28.82,Facile,Difficile,Facile / Difficile
4328,179,2020,Management,9,8,QCM,0.1097,0.61,0.23,54,20,6,14,2.7,30.0,6,48,10.97,Facile,Trop Difficile,Facile / Trop Difficile
179,180,2015,Management,9,9,QCM,0.9352,0.06,0.96,91,87,85,2,1.05,97.7,85,6,93.52,Trop Facile,Trop Facile,Trop Facile / Trop Facile
1009,180,2016,Management,9,9,QCM,0.774,0.01,0.76,105,82,81,1,1.28,98.78,81,24,77.4,Facile,Facile,Facile / Facile
1839,180,2017,Management,9,9,QCM,0.4713,0.48,0.32,106,94,50,44,1.13,53.19,50,56,47.13,Facile,Difficile,Facile / Difficile
2669,180,2018,Management,9,9,QCM,0.7845,0.11,0.79,90,80,71,9,1.12,88.75,71,19,78.45,Facile,Facile,Facile / Facile
3499,180,2019,Management,9,9,QCM,0.7822,0.1,0.75,92,89,72,17,1.03,80.9,72,20,78.22,Facile,Facile,Facile / Facile
4329,180,2020,Management,9,9,QCM,0.6349,0.06,0.49,109,107,69,38,1.02,64.49,69,40,63.49,Facile,Adapte,Facile / Adapte
180,181,2015,Management,10,1,QCM,0.6598,0.15,0.53,100,75,66,9,1.33,88.0,66,34,65.98,Adapte,Adapte,Adapte / Adapte
1010,181,2016,Management,10,1,QCM,0.6433,0.17,0.49,92,82,59,23,1.12,71.95,59,33,64.33,Adapte,Adapte,Adapte / Adapte
1840,181,2017,Management,10,1,QCM,0.6522,0.29,0.59,90,77,59,18,1.17,76.62,59,31,65.22,Adapte,Adapte,Adapte / Adapte
2670,181,2018,Management,10,1,QCM,0.6919,0.1,0.56,107,89,74,15,1.2,83.15,74,33,69.19,Adapte,Adapte,Adapte / Adapte
3500,181,2019,Management,10,1,QCM,0.7323,0.18,0.52,121,97,89,8,1.25,91.75,89,32,73.23,Adapte,Adapte,Adapte / Adapte
4330,181,2020,Management,10,1,QCM,0.6002,0.15,0.56,145,92,87,5,1.58,94.57,87,58,60.02,Adapte,Adapte,Adapte / Adapte
181,182,2015,Management,10,2,QCM,0.8896,0.04,0.9,30,27,27,0,1.11,100.0,27,3,88.96,Trop Difficile,Trop Facile,Trop Difficile / Trop Facile
1011,182,2016,Management,10,2,QCM,0.8149,0.1,0.8,24,23,20,3,1.04,86.96,20,4,81.49,Facile,Facile,Facile / Facile
1841,182,2017,Management,10,2,QCM,0.7223,0.01,0.6,23,19,17,2,1.21,89.47,17,6,72.23,Facile,Adapte,Facile / Adapte
2671,182,2018,Management,10,2,QCM,0.7434,0.05,0.68,21,20,16,4,1.05,80.0,16,5,74.34,Adapte,Adapte,Adapte / Adapte
3501,182,2019,Management,10,2,QCM,0.6803,0.1,0.51,21,15,14,1,1.4,93.33,14,7,68.03,Adapte,Adapte,Adapte / Adapte
4331,182,2020,Management,10,2,QCM,0.7066,0.1,0.64,18,16,13,3,1.12,81.25,13,5,70.66,Adapte,Adapte,Adapte / Adapte
182,183,2015,Management,10,3,QCM,0.1351,0.7,0.22,8,6,1,5,1.33,16.67,1,7,13.51,Trop Difficile,Trop Difficile,Trop Difficile / Trop Difficile
1012,183,2016,Management,10,3,QCM,0.7656,0.13,0.78,9,8,7,1,1.12,87.5,7,2,76.56,Facile,Facile,Facile / Facile
1842,183,2017,Management,10,3,QCM,0.7723,0.18,0.74,11,10,8,2,1.1,80.0,8,3,77.23,Facile,Facile,Facile / Facile
2672,183,2018,Management,10,3,QCM,0.8262,0.1,0.72,9,9,7,2,1.0,77.78,7,2,82.62,Facile,Facile,Facile / Facile
3502,183,2019,Management,10,3,QCM,0.7847,0.19,0.75,7,6,5,1,1.17,83.33,5,2,78.47,Facile,Facile,Facile / Facile
4332,183,2020,Management,10,3,QCM,0.8404,0.04,0.75,7,6,6,0,1.17,100.0,6,1,84.04,Facile,Facile,Facile / Facile
183,184,2015,Management,10,4,QCU,0.7765,0.09,0.88,12,10,9,1,1.2,90.0,9,3,77.65,Facile,Facile,Facile / Facile
1013,184,2016,Management,10,4,QCU,0.8752,0.01,0.92,11,11,10,1,1.0,90.91,10,1,87.52,Trop Facile,Trop Facile,Trop Facile / Trop Facile
1843,184,2017,Management,10,4,QCU,0.9184,0.06,0.99,11,10,10,0,1.1,100.0,10,1,91.84,Trop Facile,Trop Facile,Trop Facile / Trop Facile
2673,184,2018,Management,10,4,QCU,0.9382,0.02,0.93,10,9,9,0,1.11,100.0,9,1,93.82,Trop Facile,Trop Facile,Trop Facile / Trop Facile
3503,184,2019,Management,10,4,QCU,0.8761,0.09,0.99,10,9,9,0,1.11,100.0,9,1,87.61,Trop Facile,Trop Facile,Trop Facile / Trop Facile
4333,184,2020,Management,10,4,QCU,0.1398,0.44,0.25,12,9,2,7,1.33,22.22,2,10,13.98,Trop Facile,Trop Difficile,Trop Facile / Trop Difficile
184,185,2015,Management,10,5,QROC,0.0903,0.93,0.14,6,5,1,4,1.2,20.0,1,5,9.03,Trop Difficile,Trop Difficile,Trop Difficile / Trop Difficile
1014,185,2016,Management,10,5,QROC,0.8378,0.16,0.53,7,6,6,0,1.17,100.0,6,1,83.78,Facile,Facile,Facile / Facile
1844,185,2017,Management,10,5,QROC,0.8384,0.11,0.72,7,6,6,0,1.17,100.0,6,1,83.84,Facile,Facile,Facile / Facile
2674,185,2018,Management,10,5,QROC,0.7711,0.05,0.54,8,7,6,1,1.14,85.71,6,2,77.11,Facile,Facile,Facile / Facile
3504,185,2019,Management,10,5,QROC,0.8188,0.06,0.44,10,8,8,0,1.25,100.0,8,2,81.88,Facile,Facile,Facile / Facile
4334,185,2020,Management,10,5,QROC,0.7655,0.18,0.57,11,10,8,2,1.1,80.0,8,3,76.55,Facile,Facile,Facile / Facile
185,186,2015,Management,10,6,QCM,0.8165,0.1,0.77,81,80,66,14,1.01,82.5,66,15,81.65,Trop Facile,Facile,Trop Facile / Facile
1015,186,2016,Management,10,6,QCM,0.8398,0.03,0.74,69,67,58,9,1.03,86.57,58,11,83.98,Facile,Facile,Facile / Facile
1845,186,2017,Management,10,6,QCM,0.808,0.2,0.78,56,54,45,9,1.04,83.33,45,11,80.8,Facile,Facile,Facile / Facile
2675,186,2018,Management,10,6,QCM,0.2242,0.51,0.29,67,42,15,27,1.6,35.71,15,52,22.42,Facile,Trop Difficile,Facile / Trop Difficile
3505,186,2019,Management,10,6,QCM,0.828,0.1,0.72,73,65,60,5,1.12,92.31,60,13,82.8,Facile,Facile,Facile / Facile
4335,186,2020,Management,10,6,QCM,0.7065,0.27,0.41,65,61,46,15,1.07,75.41,46,19,70.65,Facile,Adapte,Facile / Adapte
186,187,2015,Management,10,7,QCM,0.7083,0.09,0.44,30,25,21,4,1.2,84.0,21,9,70.83,Facile,Adapte,Facile / Adapte
1016,187,2016,Management,10,7,QCM,0.6453,0.13,0.57,27,18,17,1,1.5,94.44,17,10,64.53,Adapte,Adapte,Adapte / Adapte
1846,187,2017,Management,10,7,QCM,0.7341,0.16,0.52,22,20,16,4,1.1,80.0,16,6,73.41,Adapte,Adapte,Adapte / Adapte
2676,187,2018,Management,10,7,QCM,0.7078,0.25,0.7,18,17,13,4,1.06,76.47,13,5,70.78,Adapte,Adapte,Adapte / Adapte
3506,187,2019,Management,10,7,QCM,0.7245,0.12,0.63,19,15,14,1,1.27,93.33,14,5,72.45,Adapte,Adapte,Adapte / Adapte
4336,187,2020,Management,10,7,QCM,0.656,0.25,0.46,19,17,12,5,1.12,70.59,12,7,65.6,Adapte,Adapte,Adapte / Adapte
187,188,2015,Management,10,8,QCM,0.7652,0.11,0.75,70,62,54,8,1.13,87.1,54,16,76.52,Facile,Facile,Facile / Facile
1017,188,2016,Management,10,8,QCM,0.8358,0.11,0.73,57,49,48,1,1.16,97.96,48,9,83.58,Facile,Facile,Facile / Facile
1847,188,2017,Management,10,8,QCM,0.4985,0.36,0.4,64,34,32,2,1.88,94.12,32,32,49.85,Facile,Difficile,Facile / Difficile
2677,188,2018,Management,10,8,QCM,0.8133,0.03,0.73,70,58,57,1,1.21,98.28,57,13,81.33,Facile,Facile,Facile / Facile
3507,188,2019,Management,10,8,QCM,0.883,0.08,0.91,75,67,66,1,1.12,98.51,66,9,88.3,Facile,Trop Facile,Facile / Trop Facile
4337,188,2020,Management,10,8,QCM,0.7611,0.1,0.79,82,71,62,9,1.15,87.32,62,20,76.11,Facile,Facile,Facile / Facile
188,189,2015,Management,10,9,QROC,0.1355,0.85,0.01,92,51,12,39,1.8,23.53,12,80,13.55,Trop Difficile,Trop Difficile,Trop Difficile / Trop Difficile
1018,189,2016,Management,10,9,QROC,0.8377,0.11,0.6,82,77,69,8,1.06,89.61,69,13,83.77,Facile,Facile,Facile / Facile
1848,189,2017,Management,10,9,QROC,0.1559,0.85,0.11,79,49,12,37,1.61,24.49,12,67,15.59,Facile,Trop Difficile,Facile / Trop Difficile
2678,189,2018,Management,10,9,QROC,0.7755,0.0,0.46,67,58,52,6,1.16,89.66,52,15,77.55,Facile,Facile,Facile / Facile
3508,189,2019,Management,10,9,QROC,0.2004,0.91,0.09,70,64,14,50,1.09,21.88,14,56,20.04,Facile,Trop Difficile,Facile / Trop Difficile
4338,189,2020,Management,10,9,QROC,0.7724,0.12,0.54,67,55,52,3,1.22,94.55,52,15,77.24,Facile,Facile,Facile / Facile
189,190,2015,Management,10,10,QCU,0.9868,0.07,0.92,14,14,14,0,1.0,100.0,14,0,98.68,Trop Facile,Trop Facile,Trop Facile / Trop Facile
1019,190,2016,Management,10,10,QCU,0.9995,0.05,0.91,11,11,11,0,1.0,100.0,11,0,99.95,Trop Facile,Trop Facile,Trop Facile / Trop Facile
1849,190,2017,Management,10,10,QCU,0.8906,0.1,0.94,13,13,12,1,1.0,92.31,12,1,89.06,Trop Facile,Trop Facile,Trop Facile / Trop Facile
2679,190,2018,Management,10,10,QCU,0.9265,0.03,0.99,14,13,13,0,1.08,100.0,13,1,92.65,Trop Facile,Trop Facile,Trop Facile / Trop Facile
3509,190,2019,Management,10,10,QCU,0.9192,0.01,0.99,14,14,13,1,1.0,92.86,13,1,91.92,Trop Facile,Trop Facile,Trop Facile / Trop Facile
4339,190,2020,Management,10,10,QCU,0.0766,0.14,0.21,15,6,1,5,2.5,16.67,1,14,7.66,Trop Facile,Trop Difficile,Trop Facile / Trop Difficile
190,191,2015,Management,10,11,QCM,0.7442,0.16,0.68,52,41,39,2,1.27,95.12,39,13,74.42,Difficile,Adapte,Difficile / Adapte
1020,191,2016,Management,10,11,QCM,0.7159,0.22,0.69,60,58,43,15,1.03,74.14,43,17,71.59,Adapte,Adapte,Adapte / Adapte
1850,191,2017,Management,10,11,QCM,0.6111,0.11,0.65,66,63,40,23,1.05,63.49,40,26,61.11,Adapte,Adapte,Adapte / Adapte
2680,191,2018,Management,10,11,QCM,0.7053,0.05,0.57,58,45,41,4,1.29,91.11,41,17,70.53,Adapte,Adapte,Adapte / Adapte
3510,191,2019,Management,10,11,QCM,0.6282,0.15,0.67,66,43,41,2,1.53,95.35,41,25,62.82,Adapte,Adapte,Adapte / Adapte
4340,191,2020,Management,10,11,QCM,0.6509,0.28,0.7,64,49,42,7,1.31,85.71,42,22,65.09,Adapte,Adapte,Adapte / Adapte
191,192,2015,Management,10,12,QCM,0.8376,0.01,0.76,29,25,24,1,1.16,96.0,24,5,83.76,Facile,Facile,Facile / Facile
1021,192,2016,Management,10,12,QCM,0.7267,0.12,0.48,31,24,23,1,1.29,95.83,23,8,72.67,Facile,Adapte,Facile / Adapte
1851,192,2017,Management,10,12,QCM,0.6896,0.16,0.68,35,28,24,4,1.25,85.71,24,11,68.96,Adapte,Adapte,Adapte / Adapte
2681,192,2018,Management,10,12,QCM,0.6382,0.22,0.49,28,23,18,5,1.22,78.26,18,10,63.82,Adapte,Adapte,Adapte / Adapte
3511,192,2019,Management,10,12,QCM,0.7439,0.12,0.41,24,21,18,3,1.14,85.71,18,6,74.39,Adapte,Adapte,Adapte / Adapte
4341,192,2020,Management,10,12,QCM,0.6014,0.28,0.58,28,27,17,10,1.04,62.96,17,11,60.14,Adapte,Adapte,Adapte / Adapte
192,193,2015,Management,10,13,QCM,0.9984,0.06,0.91,67,67,67,0,1.0,100.0,67,0,99.84,Difficile,Trop Facile,Difficile / Trop Facile
1022,193,2016,Management,10,13,QCM,0.6816,0.11,0.67,69,67,47,20,1.03,70.15,47,22,68.16,Facile,Adapte,Facile / Adapte
1852,193,2017,Management,10,13,QCM,0.7117,0.27,0.5,75,69,53,16,1.09,76.81,53,22,71.17,Adapte,Adapte,Adapte / Adapte
2682,193,2018,Management,10,13,QCM,0.6563,0.21,0.62,65,51,43,8,1.27,84.31,43,22,65.63,Adapte,Adapte,Adapte / Adapte
3512,193,2019,Management,10,13,QCM,0.6099,0.19,0.55,61,48,37,11,1.27,77.08,37,24,60.99,Adapte,Adapte,Adapte / Adapte
4342,193,2020,Management,10,13,QCM,0.6606,0.23,0.62,49,37,32,5,1.32,86.49,32,17,66.06,Adapte,Adapte,Adapte / Adapte
193,194,2015,Management,11,1,QCU,0.2831,0.39,0.39,69,68,20,48,1.01,29.41,20,49,28.31,Facile,Difficile,Facile / Difficile
1023,194,2016,Management,11,1,QCU,0.5456,0.29,0.35,76,74,41,33,1.03,55.41,41,35,54.56,Trop Facile,Difficile,Trop Facile / Difficile
1853,194,2017,Management,11,1,QCU,0.9958,0.08,0.94,82,82,82,0,1.0,100.0,82,0,99.58,Trop Facile,Trop Facile,Trop Facile / Trop Facile
2683,194,2018,Management,11,1,QCU,0.7944,0.03,0.89,94,88,75,13,1.07,85.23,75,19,79.44,Trop Facile,Facile,Trop Facile / Facile
3513,194,2019,Management,11,1,QCU,0.9073,0.08,0.92,97,95,88,7,1.02,92.63,88,9,90.73,Trop Facile,Trop Facile,Trop Facile / Trop Facile
4343,194,2020,Management,11,1,QCU,0.8676,0.09,0.95,108,103,94,9,1.05,91.26,94,14,86.76,Trop Facile,Trop Facile,Trop Facile / Trop Facile
194,195,2015,Management,11,2,QO,0.0755,0.97,0.03,83,70,6,64,1.19,8.57,6,77,7.55,Trop Difficile,Trop Difficile,Trop Difficile / Trop Difficile
1024,195,2016,Management,11,2,QO,0.663,0.38,0.29,68,61,45,16,1.11,73.77,45,23,66.3,Adapte,Adapte,Adapte / Adapte
1854,195,2017,Management,11,2,QO,0.6182,0.32,0.3,61,60,38,22,1.02,63.33,38,23,61.82,Adapte,Adapte,Adapte / Adapte
2684,195,2018,Management,11,2,QO,0.6438,0.23,0.27,52,36,33,3,1.44,91.67,33,19,64.38,Adapte,Adapte,Adapte / Adapte
3514,195,2019,Management,11,2,QO,0.7356,0.6,0.18,44,35,32,3,1.26,91.43,32,12,73.56,Adapte,Adapte,Adapte / Adapte
4344,195,2020,Management,11,2,QO,0.6354,0.44,0.28,43,31,27,4,1.39,87.1,27,16,63.54,Adapte,Adapte,Adapte / Adapte
195,196,2015,Management,11,3,QCU,0.6344,0.07,0.42,9,8,6,2,1.12,75.0,6,3,63.44,Difficile,Adapte,Difficile / Adapte
1025,196,2016,Management,11,3,QCU,0.6215,0.02,0.56,10,8,6,2,1.25,75.0,6,4,62.15,Adapte,Adapte,Adapte / Adapte
1855,196,2017,Management,11,3,QCU,0.6275,0.04,0.67,8,6,5,1,1.33,83.33,5,3,62.75,Adapte,Adapte,Adapte / Adapte
2685,196,2018,Management,11,3,QCU,0.7026,0.04,0.66,6,6,4,2,1.0,66.67,4,2,70.26,Adapte,Adapte,Adapte / Adapte
3515,196,2019,Management,11,3,QCU,0.6109,0.09,0.69,7,6,4,2,1.17,66.67,4,3,61.09,Adapte,Adapte,Adapte / Adapte
4345,196,2020,Management,11,3,QCU,0.6967,0.13,0.66,7,6,5,1,1.17,83.33,5,2,69.67,Adapte,Adapte,Adapte / Adapte
196,197,2015,Management,11,4,QROC,0.1221,0.82,0.1,58,42,7,35,1.38,16.67,7,51,12.21,Trop Difficile,Trop Difficile,Trop Difficile / Trop Difficile
1026,197,2016,Management,11,4,QROC,0.8134,0.04,0.62,70,64,57,7,1.09,89.06,57,13,81.34,Facile,Facile,Facile / Facile
1856,197,2017,Management,11,4,QROC,0.7649,0.08,0.61,65,59,50,9,1.1,84.75,50,15,76.49,Facile,Facile,Facile / Facile
2686,197,2018,Management,11,4,QROC,0.8365,0.17,0.48,56,51,47,4,1.1,92.16,47,9,83.65,Facile,Facile,Facile / Facile
3516,197,2019,Management,11,4,QROC,0.7235,0.33,0.35,52,47,38,9,1.11,80.85,38,14,72.35,Facile,Adapte,Facile / Adapte
4346,197,2020,Management,11,4,QROC,0.6148,0.28,0.38,49,37,30,7,1.32,81.08,30,19,61.48,Adapte,Adapte,Adapte / Adapte
197,198,2015,Management,11,5,QCU,0.6187,0.05,0.68,42,39,26,13,1.08,66.67,26,16,61.87,Adapte,Adapte,Adapte / Adapte
1027,198,2016,Management,11,5,QCU,0.7001,0.15,0.42,44,38,31,7,1.16,81.58,31,13,70.01,Adapte,Adapte,Adapte / Adapte
1857,198,2017,Management,11,5,QCU,0.6283,0.05,0.55,53,51,33,18,1.04,64.71,33,20,62.83,Adapte,Adapte,Adapte / Adapte
2687,198,2018,Management,11,5,QCU,0.6926,0.28,0.65,46,39,32,7,1.18,82.05,32,14,69.26,Adapte,Adapte,Adapte / Adapte
3517,198,2019,Management,11,5,QCU,0.6089,0.15,0.55,50,32,30,2,1.56,93.75,30,20,60.89,Adapte,Adapte,Adapte / Adapte
4347,198,2020,Management,11,5,QCU,0.6609,0.25,0.47,43,34,28,6,1.26,82.35,28,15,66.09,Adapte,Adapte,Adapte / Adapte
198,199,2015,Management,11,6,QROC,0.9559,0.07,0.89,58,55,55,0,1.05,100.0,55,3,95.59,Trop Facile,Trop Facile,Trop Facile / Trop Facile
1028,199,2016,Management,11,6,QROC,0.7872,0.0,0.55,55,45,43,2,1.22,95.56,43,12,78.72,Facile,Facile,Facile / Facile
1858,199,2017,Management,11,6,QROC,0.1227,0.98,0.04,53,35,7,28,1.51,20.0,7,46,12.27,Facile,Trop Difficile,Facile / Trop Difficile
2688,199,2018,Management,11,6,QROC,0.8233,0.07,0.65,62,56,51,5,1.11,91.07,51,11,82.33,Facile,Facile,Facile / Facile
3518,199,2019,Management,11,6,QROC,0.8277,0.18,0.61,59,58,49,9,1.02,84.48,49,10,82.77,Facile,Facile,Facile / Facile
4348,199,2020,Management,11,6,QROC,0.9872,0.07,0.79,58,57,57,0,1.02,100.0,57,1,98.72,Facile,Trop Facile,Facile / Trop Facile
199,200,2015,Management,11,7,QCM,0.6007,0.22,0.49,21,16,13,3,1.31,81.25,13,8,60.07,Adapte,Adapte,Adapte / Adapte
1029,200,2016,Management,11,7,QCM,0.6017,0.09,0.55,17,11,10,1,1.55,90.91,10,7,60.17,Adapte,Adapte,Adapte / Adapte
1859,200,2017,Management,11,7,QCM,0.6302,0.27,0.63,15,12,9,3,1.25,75.0,9,6,63.02,Adapte,Adapte,Adapte / Adapte
2689,200,2018,Management,11,7,QCM,0.6798,0.2,0.43,18,15,12,3,1.2,80.0,12,6,67.98,Adapte,Adapte,Adapte / Adapte
3519,200,2019,Management,11,7,QCM,0.6392,0.21,0.55,20,16,13,3,1.25,81.25,13,7,63.92,Adapte,Adapte,Adapte / Adapte
4349,200,2020,Management,11,7,QCM,0.7495,0.04,0.67,24,19,18,1,1.26,94.74,18,6,74.95,Adapte,Adapte,Adapte / Adapte
200,201,2015,Management,11,8,QCU,0.1797,0.2,0.24,99,75,18,57,1.32,24.0,18,81,17.97,Difficile,Trop Difficile,Difficile / Trop Difficile
1030,201,2016,Management,11,8,QCU,0.9481,0.09,0.96,87,86,82,4,1.01,95.35,82,5,94.81,Trop Facile,Trop Facile,Trop Facile / Trop Facile
1860,201,2017,Management,11,8,QCU,0.8676,0.03,0.95,72,71,62,9,1.01,87.32,62,10,86.76,Trop Facile,Trop Facile,Trop Facile / Trop Facile
2690,201,2018,Management,11,8,QCU,0.6749,0.26,0.53,65,56,44,12,1.16,78.57,44,21,67.49,Trop Facile,Adapte,Trop Facile / Adapte
3520,201,2019,Management,11,8,QCU,0.6707,0.18,0.66,69,60,46,14,1.15,76.67,46,23,67.07,Adapte,Adapte,Adapte / Adapte
4350,201,2020,Management,11,8,QCU,0.7063,0.3,0.47,65,48,46,2,1.35,95.83,46,19,70.63,Adapte,Adapte,Adapte / Adapte
201,202,2015,Management,11,9,QROC,0.8447,0.1,0.61,6,5,5,0,1.2,100.0,5,1,84.47,Facile,Facile,Facile / Facile
1031,202,2016,Management,11,9,QROC,0.8427,0.15,0.48,5,5,4,1,1.0,80.0,4,1,84.27,Facile,Facile,Facile / Facile
1861,202,2017,Management,11,9,QROC,0.807,0.12,0.5,5,4,4,0,1.25,100.0,4,1,80.7,Facile,Facile,Facile / Facile
2691,202,2018,Management,11,9,QROC,0.1727,0.91,0.13,4,4,1,3,1.0,25.0,1,3,17.27,Facile,Trop Difficile,Facile / Trop Difficile
3521,202,2019,Management,11,9,QROC,0.7855,0.09,0.45,4,3,3,0,1.33,100.0,3,1,78.55,Facile,Facile,Facile / Facile
4351,202,2020,Management,11,9,QROC,0.6201,0.24,0.35,4,3,2,1,1.33,66.67,2,2,62.01,Facile,Adapte,Facile / Adapte
202,203,2015,Management,11,10,QCM,0.7883,0.18,0.75,28,27,22,5,1.04,81.48,22,6,78.83,Facile,Facile,Facile / Facile
1032,203,2016,Management,11,10,QCM,0.8301,0.04,0.71,33,32,27,5,1.03,84.38,27,6,83.01,Facile,Facile,Facile / Facile
1862,203,2017,Management,11,10,QCM,0.1683,0.6,0.23,27,24,5,19,1.12,20.83,5,22,16.83,Facile,Trop Difficile,Facile / Trop Difficile
2692,203,2018,Management,11,10,QCM,0.8027,0.11,0.77,28,26,22,4,1.08,84.62,22,6,80.27,Facile,Facile,Facile / Facile
3522,203,2019,Management,11,10,QCM,0.8251,0.07,0.72,33,28,27,1,1.18,96.43,27,6,82.51,Facile,Facile,Facile / Facile
4352,203,2020,Management,11,10,QCM,0.7721,0.07,0.77,35,31,27,4,1.13,87.1,27,8,77.21,Facile,Facile,Facile / Facile
203,204,2015,Management,11,11,QCM,0.5824,0.46,0.37,63,57,37,20,1.11,64.91,37,26,58.24,Trop Difficile,Difficile,Trop Difficile / Difficile
1033,204,2016,Management,11,11,QCM,0.2606,0.12,0.34,60,59,16,43,1.02,27.12,16,44,26.06,Facile,Difficile,Facile / Difficile
1863,204,2017,Management,11,11,QCM,0.8097,0.13,0.77,68,65,55,10,1.05,84.62,55,13,80.97,Facile,Facile,Facile / Facile
2693,204,2018,Management,11,11,QCM,0.8078,0.13,0.75,73,65,59,6,1.12,90.77,59,14,80.78,Facile,Facile,Facile / Facile
3523,204,2019,Management,11,11,QCM,0.9529,0.0,0.85,80,79,76,3,1.01,96.2,76,4,95.29,Facile,Trop Facile,Facile / Trop Facile
4353,204,2020,Management,11,11,QCM,0.5263,0.05,0.36,95,73,50,23,1.3,68.49,50,45,52.63,Facile,Difficile,Facile / Difficile
204,205,2015,Management,11,12,QCU,0.1193,0.14,0.3,94,82,11,71,1.15,13.41,11,83,11.93,Trop Difficile,Trop Difficile,Trop Difficile / Trop Difficile
1034,205,2016,Management,11,12,QCU,0.8856,0.0,0.95,95,93,84,9,1.02,90.32,84,11,88.56,Trop Facile,Trop Facile,Trop Facile / Trop Facile
1864,205,2017,Management,11,12,QCU,0.8938,0.07,0.96,87,79,78,1,1.1,98.73,78,9,89.38,Trop Facile,Trop Facile,Trop Facile / Trop Facile
2694,205,2018,Management,11,12,QCU,0.9632,0.04,0.91,81,80,78,2,1.01,97.5,78,3,96.32,Trop Facile,Trop Facile,Trop Facile / Trop Facile
3524,205,2019,Management,11,12,QCU,0.9051,0.02,0.95,74,69,67,2,1.07,97.1,67,7,90.51,Trop Facile,Trop Facile,Trop Facile / Trop Facile
4354,205,2020,Management,11,12,QCU,0.9957,0.08,0.97,77,77,77,0,1.0,100.0,77,0,99.57,Trop Facile,Trop Facile,Trop Facile / Trop Facile
205,206,2015,Management,11,13,QROC,0.1699,0.78,0.12,64,48,11,37,1.33,22.92,11,53,16.99,Trop Difficile,Trop Difficile,Trop Difficile / Trop Difficile
1035,206,2016,Management,11,13,QROC,0.7972,0.03,0.61,61,60,49,11,1.02,81.67,49,12,79.72,Facile,Facile,Facile / Facile
1865,206,2017,Management,11,13,QROC,0.8094,0.1,0.74,65,60,53,7,1.08,88.33,53,12,80.94,Facile,Facile,Facile / Facile
2695,206,2018,Management,11,13,QROC,0.8433,0.14,0.66,62,61,52,9,1.02,85.25,52,10,84.33,Facile,Facile,Facile / Facile
3525,206,2019,Management,11,13,QROC,0.7821,0.08,0.54,56,52,44,8,1.08,84.62,44,12,78.21,Facile,Facile,Facile / Facile
4355,206,2020,Management,11,13,QROC,0.8245,0.17,0.51,52,50,43,7,1.04,86.0,43,9,82.45,Facile,Facile,Facile / Facile
206,207,2015,Management,11,14,QCU,0.3285,0.2,0.31,13,10,4,6,1.3,40.0,4,9,32.85,Difficile,Difficile,Difficile / Difficile
1036,207,2016,Management,11,14,QCU,0.4476,0.05,0.31,15,9,7,2,1.67,77.78,7,8,44.76,Trop Facile,Difficile,Trop Facile / Difficile
1866,207,2017,Management,11,14,QCU,0.888,0.05,0.93,14,13,12,1,1.08,92.31,12,2,88.8,Trop Facile,Trop Facile,Trop Facile / Trop Facile
2696,207,2018,Management,11,14,QCU,0.6986,0.13,0.53,16,16,11,5,1.0,68.75,11,5,69.86,Trop Facile,Adapte,Trop Facile / Adapte
3526,207,2019,Management,11,14,QCU,0.6411,0.17,0.56,13,11,8,3,1.18,72.73,8,5,64.11,Adapte,Adapte,Adapte / Adapte
4356,207,2020,Management,11,14,QCU,0.6609,0.06,0.42,12,12,8,4,1.0,66.67,8,4,66.09,Adapte,Adapte,Adapte / Adapte
207,208,2015,Management,12,1,QCU,0.6897,0.12,0.69,79,75,54,21,1.05,72.0,54,25,68.97,Facile,Adapte,Facile / Adapte
1037,208,2016,Management,12,1,QCU,0.7103,0.08,0.43,71,67,50,17,1.06,74.63,50,21,71.03,Adapte,Adapte,Adapte / Adapte
1867,208,2017,Management,12,1,QCU,0.6159,0.25,0.65,81,75,50,25,1.08,66.67,50,31,61.59,Adapte,Adapte,Adapte / Adapte
2697,208,2018,Management,12,1,QCU,0.7014,0.22,0.52,72,68,51,17,1.06,75.0,51,21,70.14,Adapte,Adapte,Adapte / Adapte
3527,208,2019,Management,12,1,QCU,0.6452,0.27,0.47,68,62,44,18,1.1,70.97,44,24,64.52,Adapte,Adapte,Adapte / Adapte
4357,208,2020,Management,12,1,QCU,0.6981,0.21,0.65,78,58,54,4,1.34,93.1,54,24,69.81,Adapte,Adapte,Adapte / Adapte
208,209,2015,Management,12,2,QCM,0.2958,0.05,0.32,28,13,8,5,2.15,61.54,8,20,29.58,Difficile,Difficile,Difficile / Difficile
1038,209,2016,Management,12,2,QCM,0.9219,0.09,0.85,24,23,22,1,1.04,95.65,22,2,92.19,Facile,Trop Facile,Facile / Trop Facile
1868,209,2017,Management,12,2,QCM,0.3702,0.34,0.31,25,24,9,15,1.04,37.5,9,16,37.02,Facile,Difficile,Facile / Difficile
2698,209,2018,Management,12,2,QCM,0.2025,0.7,0.21,25,14,5,9,1.79,35.71,5,20,20.25,Facile,Trop Difficile,Facile / Trop Difficile
3528,209,2019,Management,12,2,QCM,0.1838,0.5,0.23,28,9,5,4,3.11,55.56,5,23,18.38,Facile,Trop Difficile,Facile / Trop Difficile
4358,209,2020,Management,12,2,QCM,0.7963,0.11,0.76,28,25,22,3,1.12,88.0,22,6,79.63,Facile,Facile,Facile / Facile
209,210,2015,Management,12,3,QCU,0.8827,0.07,0.99,62,58,55,3,1.07,94.83,55,7,88.27,Trop Facile,Trop Facile,Trop Facile / Trop Facile
1039,210,2016,Management,12,3,QCU,0.9335,0.04,0.93,59,56,55,1,1.05,98.21,55,4,93.35,Trop Facile,Trop Facile,Trop Facile / Trop Facile
1869,210,2017,Management,12,3,QCU,0.8893,0.03,0.95,61,57,54,3,1.07,94.74,54,7,88.93,Trop Facile,Trop Facile,Trop Facile / Trop Facile
2699,210,2018,Management,12,3,QCU,0.8915,0.03,0.92,61,61,54,7,1.0,88.52,54,7,89.15,Trop Facile,Trop Facile,Trop Facile / Trop Facile
3529,210,2019,Management,12,3,QCU,0.8804,0.05,0.92,50,50,44,6,1.0,88.0,44,6,88.04,Trop Facile,Trop Facile,Trop Facile / Trop Facile
4359,210,2020,Management,12,3,QCU,0.377,0.39,0.4,52,36,20,16,1.44,55.56,20,32,37.7,Trop Facile,Difficile,Trop Facile / Difficile
210,211,2015,Management,12,4,QCU,0.5668,0.13,0.35,50,32,28,4,1.56,87.5,28,22,56.68,Difficile,Difficile,Difficile / Difficile
1040,211,2016,Management,12,4,QCU,0.8821,0.09,0.98,43,40,38,2,1.07,95.0,38,5,88.21,Trop Facile,Trop Facile,Trop Facile / Trop Facile
1870,211,2017,Management,12,4,QCU,0.2872,0.31,0.37,36,35,10,25,1.03,28.57,10,26,28.72,Trop Facile,Difficile,Trop Facile / Difficile
2700,211,2018,Management,12,4,QCU,0.9573,0.03,0.93,30,30,29,1,1.0,96.67,29,1,95.73,Trop Facile,Trop Facile,Trop Facile / Trop Facile
3530,211,2019,Management,12,4,QCU,0.9141,0.04,0.98,26,25,24,1,1.04,96.0,24,2,91.41,Trop Facile,Trop Facile,Trop Facile / Trop Facile
4360,211,2020,Management,12,4,QCU,0.0957,0.65,0.29,29,15,3,12,1.93,20.0,3,26,9.57,Trop Facile,Trop Difficile,Trop Facile / Trop Difficile
211,212,2015,Management,12,5,QROC,0.148,0.87,0.06,54,51,8,43,1.06,15.69,8,46,14.8,Trop Difficile,Trop Difficile,Trop Difficile / Trop Difficile
1041,212,2016,Management,12,5,QROC,0.8304,0.05,0.52,54,50,45,5,1.08,90.0,45,9,83.04,Facile,Facile,Facile / Facile
1871,212,2017,Management,12,5,QROC,0.8418,0.14,0.67,53,50,45,5,1.06,90.0,45,8,84.18,Facile,Facile,Facile / Facile
2701,212,2018,Management,12,5,QROC,0.8188,0.14,0.71,55,51,45,6,1.08,88.24,45,10,81.88,Facile,Facile,Facile / Facile
3531,212,2019,Management,12,5,QROC,0.7655,0.15,0.59,54,43,41,2,1.26,95.35,41,13,76.55,Facile,Facile,Facile / Facile
4361,212,2020,Management,12,5,QROC,0.6966,0.45,0.31,43,40,30,10,1.07,75.0,30,13,69.66,Facile,Adapte,Facile / Adapte
212,213,2015,Management,12,6,QCM,0.7998,0.09,0.71,87,83,70,13,1.05,84.34,70,17,79.98,Facile,Facile,Facile / Facile
1042,213,2016,Management,12,6,QCM,0.7969,0.05,0.77,85,72,68,4,1.18,94.44,68,17,79.69,Facile,Facile,Facile / Facile
1872,213,2017,Management,12,6,QCM,0.8138,0.2,0.79,95,82,77,5,1.16,93.9,77,18,81.38,Facile,Facile,Facile / Facile
2702,213,2018,Management,12,6,QCM,0.8679,0.01,0.84,102,101,89,12,1.01,88.12,89,13,86.79,Facile,Trop Facile,Facile / Trop Facile
3532,213,2019,Management,12,6,QCM,0.8387,0.1,0.71,116,99,97,2,1.17,97.98,97,19,83.87,Facile,Facile,Facile / Facile
4362,213,2020,Management,12,6,QCM,0.8395,0.13,0.76,115,100,97,3,1.15,97.0,97,18,83.95,Facile,Facile,Facile / Facile
213,214,2015,Management,12,7,QCU,0.9153,0.01,0.99,19,18,17,1,1.06,94.44,17,2,91.53,Trop Facile,Trop Facile,Trop Facile / Trop Facile
1043,214,2016,Management,12,7,QCU,0.9958,0.05,0.96,15,15,15,0,1.0,100.0,15,0,99.58,Trop Facile,Trop Facile,Trop Facile / Trop Facile
1873,214,2017,Management,12,7,QCU,0.9664,0.09,0.94,17,16,16,0,1.06,100.0,16,1,96.64,Trop Facile,Trop Facile,Trop Facile / Trop Facile
2703,214,2018,Management,12,7,QCU,0.0105,0.03,0.28,15,13,0,13,1.15,0.0,0,15,1.05,Trop Facile,Trop Difficile,Trop Facile / Trop Difficile
3533,214,2019,Management,12,7,QCU,0.786,0.13,0.78,12,9,9,0,1.33,100.0,9,3,78.6,Trop Facile,Facile,Trop Facile / Facile
4363,214,2020,Management,12,7,QCU,0.8913,0.04,0.99,12,11,11,0,1.09,100.0,11,1,89.13,Trop Facile,Trop Facile,Trop Facile / Trop Facile
214,215,2015,Management,12,8,QROC,0.6352,0.2,0.4,37,30,24,6,1.23,80.0,24,13,63.52,Adapte,Adapte,Adapte / Adapte
1044,215,2016,Management,12,8,QROC,0.6915,0.36,0.28,39,37,27,10,1.05,72.97,27,12,69.15,Adapte,Adapte,Adapte / Adapte
1874,215,2017,Management,12,8,QROC,0.6231,0.38,0.25,32,25,20,5,1.28,80.0,20,12,62.31,Adapte,Adapte,Adapte / Adapte
2704,215,2018,Management,12,8,QROC,0.6929,0.25,0.4,35,30,24,6,1.17,80.0,24,11,69.29,Adapte,Adapte,Adapte / Adapte
3534,215,2019,Management,12,8,QROC,0.6781,0.25,0.29,37,28,25,3,1.32,89.29,25,12,67.81,Adapte,Adapte,Adapte / Adapte
4364,215,2020,Management,12,8,QROC,0.7307,0.43,0.38,41,38,30,8,1.08,78.95,30,11,73.07,Adapte,Adapte,Adapte / Adapte
215,216,2015,Management,12,9,QROC,0.367,0.64,0.2,38,19,14,5,2.0,73.68,14,24,36.7,Trop Facile,Difficile,Trop Facile / Difficile
1045,216,2016,Management,12,9,QROC,0.8472,0.1,0.65,46,42,39,3,1.1,92.86,39,7,84.72,Facile,Facile,Facile / Facile
1875,216,2017,Management,12,9,QROC,0.8334,0.05,0.73,45,42,38,4,1.07,90.48,38,7,83.34,Facile,Facile,Facile / Facile
2705,216,2018,Management,12,9,QROC,0.8097,0.08,0.63,39,38,32,6,1.03,84.21,32,7,80.97,Facile,Facile,Facile / Facile
3535,216,2019,Management,12,9,QROC,0.5065,0.73,0.19,47,32,24,8,1.47,75.0,24,23,50.65,Facile,Difficile,Facile / Difficile
4365,216,2020,Management,12,9,QROC,0.7928,0.01,0.72,48,45,38,7,1.07,84.44,38,10,79.28,Facile,Facile,Facile / Facile
216,217,2015,Management,12,10,QCU,0.7601,0.08,0.77,8,6,6,0,1.33,100.0,6,2,76.01,Facile,Facile,Facile / Facile
1046,217,2016,Management,12,10,QCU,0.9233,0.02,0.98,10,10,9,1,1.0,90.0,9,1,92.33,Trop Facile,Trop Facile,Trop Facile / Trop Facile
1876,217,2017,Management,12,10,QCU,0.9298,0.09,0.98,11,11,10,1,1.0,90.91,10,1,92.98,Trop Facile,Trop Facile,Trop Facile / Trop Facile
2706,217,2018,Management,12,10,QCU,0.9921,0.04,0.9,13,13,13,0,1.0,100.0,13,0,99.21,Trop Facile,Trop Facile,Trop Facile / Trop Facile
3536,217,2019,Management,12,10,QCU,0.8093,0.19,0.84,12,11,10,1,1.09,90.91,10,2,80.93,Trop Facile,Facile,Trop Facile / Facile
4366,217,2020,Management,12,10,QCU,0.9493,0.08,0.94,12,12,11,1,1.0,91.67,11,1,94.93,Trop Facile,Trop Facile,Trop Facile / Trop Facile
217,218,2015,Management,12,11,QCU,0.7609,0.09,0.88,72,70,55,15,1.03,78.57,55,17,76.09,Trop Facile,Facile,Trop Facile / Facile
1047,218,2016,Management,12,11,QCU,0.22,0.05,0.25,63,34,14,20,1.85,41.18,14,49,22.0,Trop Facile,Trop Difficile,Trop Facile / Trop Difficile
1877,218,2017,Management,12,11,QCU,0.9386,0.05,0.96,53,51,50,1,1.04,98.04,50,3,93.86,Trop Facile,Trop Facile,Trop Facile / Trop Facile
2707,218,2018,Management,12,11,QCU,0.9773,0.07,0.99,50,50,49,1,1.0,98.0,49,1,97.73,Trop Facile,Trop Facile,Trop Facile / Trop Facile
3537,218,2019,Management,12,11,QCU,0.987,0.04,0.99,54,54,53,1,1.0,98.15,53,1,98.7,Trop Facile,Trop Facile,Trop Facile / Trop Facile
4367,218,2020,Management,12,11,QCU,0.939,0.02,0.98,45,44,42,2,1.02,95.45,42,3,93.9,Trop Facile,Trop Facile,Trop Facile / Trop Facile
218,219,2015,Management,13,1,QCU,0.5875,0.11,0.32,92,84,54,30,1.1,64.29,54,38,58.75,Trop Difficile,Difficile,Trop Difficile / Difficile
1048,219,2016,Management,13,1,QCU,0.9181,0.05,0.93,84,80,77,3,1.05,96.25,77,7,91.81,Trop Facile,Trop Facile,Trop Facile / Trop Facile
1878,219,2017,Management,13,1,QCU,0.7835,0.2,0.87,90,86,71,15,1.05,82.56,71,19,78.35,Trop Facile,Facile,Trop Facile / Facile
2708,219,2018,Management,13,1,QCU,0.8955,0.09,0.93,93,85,83,2,1.09,97.65,83,10,89.55,Trop Facile,Trop Facile,Trop Facile / Trop Facile
3538,219,2019,Management,13,1,QCU,0.8422,0.12,0.89,107,101,90,11,1.06,89.11,90,17,84.22,Trop Facile,Facile,Trop Facile / Facile
4368,219,2020,Management,13,1,QCU,0.6528,0.26,0.55,92,80,60,20,1.15,75.0,60,32,65.28,Trop Facile,Adapte,Trop Facile / Adapte
219,220,2015,Management,13,2,QCM,0.8394,0.05,0.77,47,40,39,1,1.18,97.5,39,8,83.94,Facile,Facile,Facile / Facile
1049,220,2016,Management,13,2,QCM,0.7828,0.05,0.73,49,42,38,4,1.17,90.48,38,11,78.28,Facile,Facile,Facile / Facile
1879,220,2017,Management,13,2,QCM,0.8223,0.06,0.71,56,51,46,5,1.1,90.2,46,10,82.23,Facile,Facile,Facile / Facile
2709,220,2018,Management,13,2,QCM,0.0801,0.67,0.21,65,57,5,52,1.14,8.77,5,60,8.01,Facile,Trop Difficile,Facile / Trop Difficile
3539,220,2019,Management,13,2,QCM,0.7616,0.09,0.78,71,58,54,4,1.22,93.1,54,17,76.16,Facile,Facile,Facile / Facile
4369,220,2020,Management,13,2,QCM,0.8317,0.14,0.78,70,63,58,5,1.11,92.06,58,12,83.17,Facile,Facile,Facile / Facile
220,221,2015,Management,13,3,QCM,0.8378,0.19,0.71,100,92,84,8,1.09,91.3,84,16,83.78,Trop Facile,Facile,Trop Facile / Facile
1050,221,2016,Management,13,3,QCM,0.7635,0.1,0.73,82,80,63,17,1.02,78.75,63,19,76.35,Facile,Facile,Facile / Facile
1880,221,2017,Management,13,3,QCM,0.0518,0.26,0.23,76,29,4,25,2.62,13.79,4,72,5.18,Facile,Trop Difficile,Facile / Trop Difficile
2710,221,2018,Management,13,3,QCM,0.7707,0.06,0.71,65,56,50,6,1.16,89.29,50,15,77.07,Facile,Facile,Facile / Facile
3540,221,2019,Management,13,3,QCM,0.7709,0.0,0.79,53,43,41,2,1.23,95.35,41,12,77.09,Facile,Facile,Facile / Facile
4370,221,2020,Management,13,3,QCM,0.1033,0.52,0.24,43,43,4,39,1.0,9.3,4,39,10.33,Facile,Trop Difficile,Facile / Trop Difficile
221,222,2015,Management,13,4,QCM,0.9604,0.1,0.84,62,61,60,1,1.02,98.36,60,2,96.04,Trop Facile,Trop Facile,Trop Facile / Trop Facile
1051,222,2016,Management,13,4,QCM,0.796,0.04,0.7,55,48,44,4,1.15,91.67,44,11,79.6,Facile,Facile,Facile / Facile
1881,222,2017,Management,13,4,QCM,0.7908,0.08,0.73,60,52,47,5,1.15,90.38,47,13,79.08,Facile,Facile,Facile / Facile
2711,222,2018,Management,13,4,QCM,0.0084,0.06,0.25,65,18,1,17,3.61,5.56,1,64,0.84,Facile,Trop Difficile,Facile / Trop Difficile
3541,222,2019,Management,13,4,QCM,0.7787,0.06,0.75,75,62,58,4,1.21,93.55,58,17,77.87,Facile,Facile,Facile / Facile
4371,222,2020,Management,13,4,QCM,0.8166,0.05,0.78,89,83,73,10,1.07,87.95,73,16,81.66,Facile,Facile,Facile / Facile
222,223,2015,Management,13,5,QCU,0.0241,0.1,0.21,66,41,2,39,1.61,4.88,2,64,2.41,Facile,Trop Difficile,Facile / Trop Difficile
1052,223,2016,Management,13,5,QCU,0.9583,0.01,0.97,69,68,66,2,1.01,97.06,66,3,95.83,Trop Facile,Trop Facile,Trop Facile / Trop Facile
1882,223,2017,Management,13,5,QCU,0.9162,0.06,0.97,72,67,66,1,1.07,98.51,66,6,91.62,Trop Facile,Trop Facile,Trop Facile / Trop Facile
2712,223,2018,Management,13,5,QCU,0.8784,0.0,0.97,73,70,64,6,1.04,91.43,64,9,87.84,Trop Facile,Trop Facile,Trop Facile / Trop Facile
3542,223,2019,Management,13,5,QCU,0.8729,0.01,1.0,58,52,51,1,1.12,98.08,51,7,87.29,Trop Facile,Trop Facile,Trop Facile / Trop Facile
4372,223,2020,Management,13,5,QCU,0.9463,0.05,0.97,53,51,50,1,1.04,98.04,50,3,94.63,Trop Facile,Trop Facile,Trop Facile / Trop Facile
223,224,2015,Management,13,6,QCU,0.9823,0.04,0.96,47,47,46,1,1.0,97.87,46,1,98.23,Trop Facile,Trop Facile,Trop Facile / Trop Facile
1053,224,2016,Management,13,6,QCU,0.7153,0.22,0.67,45,41,32,9,1.1,78.05,32,13,71.53,Trop Facile,Adapte,Trop Facile / Adapte
1883,224,2017,Management,13,6,QCU,0.6168,0.27,0.5,52,50,32,18,1.04,64.0,32,20,61.68,Adapte,Adapte,Adapte / Adapte
2713,224,2018,Management,13,6,QCU,0.6435,0.2,0.55,54,41,35,6,1.32,85.37,35,19,64.35,Adapte,Adapte,Adapte / Adapte
3543,224,2019,Management,13,6,QCU,0.6018,0.21,0.42,61,60,37,23,1.02,61.67,37,24,60.18,Adapte,Adapte,Adapte / Adapte
4373,224,2020,Management,13,6,QCU,0.6361,0.21,0.69,54,50,34,16,1.08,68.0,34,20,63.61,Adapte,Adapte,Adapte / Adapte
224,225,2015,Management,13,7,QCU,0.8837,0.09,0.92,38,35,34,1,1.09,97.14,34,4,88.37,Trop Facile,Trop Facile,Trop Facile / Trop Facile
1054,225,2016,Management,13,7,QCU,0.8755,0.04,0.91,42,37,37,0,1.14,100.0,37,5,87.55,Trop Facile,Trop Facile,Trop Facile / Trop Facile
1884,225,2017,Management,13,7,QCU,0.8434,0.14,0.79,41,40,35,5,1.02,87.5,35,6,84.34,Trop Facile,Facile,Trop Facile / Facile
2714,225,2018,Management,13,7,QCU,0.991,0.06,0.98,38,38,38,0,1.0,100.0,38,0,99.1,Trop Facile,Trop Facile,Trop Facile / Trop Facile
3544,225,2019,Management,13,7,QCU,0.9209,0.03,0.97,41,39,38,1,1.05,97.44,38,3,92.09,Trop Facile,Trop Facile,Trop Facile / Trop Facile
4374,225,2020,Management,13,7,QCU,0.3059,0.27,0.35,44,15,13,2,2.93,86.67,13,31,30.59,Trop Facile,Difficile,Trop Facile / Difficile
225,226,2015,Management,14,1,QROC,0.8786,0.02,0.97,65,60,57,3,1.08,95.0,57,8,87.86,Trop Facile,Trop Facile,Trop Facile / Trop Facile
1055,226,2016,Management,14,1,QROC,0.8262,0.14,0.51,57,55,47,8,1.04,85.45,47,10,82.62,Facile,Facile,Facile / Facile
1885,226,2017,Management,14,1,QROC,0.8495,0.1,0.67,50,48,42,6,1.04,87.5,42,8,84.95,Facile,Facile,Facile / Facile
2715,226,2018,Management,14,1,QROC,0.8437,0.13,0.54,53,48,45,3,1.1,93.75,45,8,84.37,Facile,Facile,Facile / Facile
3545,226,2019,Management,14,1,QROC,0.7996,0.02,0.46,56,49,45,4,1.14,91.84,45,11,79.96,Facile,Facile,Facile / Facile
4375,226,2020,Management,14,1,QROC,0.8182,0.19,0.41,45,39,37,2,1.15,94.87,37,8,81.82,Facile,Facile,Facile / Facile
226,227,2015,Management,14,2,QCU,0.8394,0.09,0.76,22,22,18,4,1.0,81.82,18,4,83.94,Trop Difficile,Facile,Trop Difficile / Facile
1056,227,2016,Management,14,2,QCU,0.899,0.01,0.91,18,18,16,2,1.0,88.89,16,2,89.9,Trop Facile,Trop Facile,Trop Facile / Trop Facile
1886,227,2017,Management,14,2,QCU,0.9373,0.05,0.9,20,19,19,0,1.05,100.0,19,1,93.73,Trop Facile,Trop Facile,Trop Facile / Trop Facile
2716,227,2018,Management,14,2,QCU,0.3469,0.05,0.34,21,11,7,4,1.91,63.64,7,14,34.69,Trop Facile,Difficile,Trop Facile / Difficile
3546,227,2019,Management,14,2,QCU,0.4699,0.3,0.38,24,24,11,13,1.0,45.83,11,13,46.99,Trop Facile,Difficile,Trop Facile / Difficile
4376,227,2020,Management,14,2,QCU,0.9687,0.09,0.93,27,26,26,0,1.04,100.0,26,1,96.87,Trop Facile,Trop Facile,Trop Facile / Trop Facile
227,228,2015,Management,14,3,QCU,0.0424,0.1,0.3,31,31,1,30,1.0,3.23,1,30,4.24,Trop Difficile,Trop Difficile,Trop Difficile / Trop Difficile
1057,228,2016,Management,14,3,QCU,0.8808,0.01,0.93,30,28,26,2,1.07,92.86,26,4,88.08,Trop Facile,Trop Facile,Trop Facile / Trop Facile
1887,228,2017,Management,14,3,QCU,0.9859,0.08,0.93,28,28,28,0,1.0,100.0,28,0,98.59,Trop Facile,Trop Facile,Trop Facile / Trop Facile
2717,228,2018,Management,14,3,QCU,0.8759,0.09,0.97,23,20,20,0,1.15,100.0,20,3,87.59,Trop Facile,Trop Facile,Trop Facile / Trop Facile
3547,228,2019,Management,14,3,QCU,0.8785,0.03,0.91,18,17,16,1,1.06,94.12,16,2,87.85,Trop Facile,Trop Facile,Trop Facile / Trop Facile
4377,228,2020,Management,14,3,QCU,0.5208,0.34,0.3,19,15,10,5,1.27,66.67,10,9,52.08,Trop Facile,Difficile,Trop Facile / Difficile
228,229,2015,Management,15,1,QCM,0.6975,0.23,0.68,24,19,17,2,1.26,89.47,17,7,69.75,Adapte,Adapte,Adapte / Adapte
1058,229,2016,Management,15,1,QCM,0.6456,0.21,0.54,22,16,14,2,1.38,87.5,14,8,64.56,Adapte,Adapte,Adapte / Adapte
1888,229,2017,Management,15,1,QCM,0.6908,0.1,0.62,19,19,13,6,1.0,68.42,13,6,69.08,Adapte,Adapte,Adapte / Adapte
2718,229,2018,Management,15,1,QCM,0.7089,0.24,0.44,22,17,16,1,1.29,94.12,16,6,70.89,Adapte,Adapte,Adapte / Adapte
3548,229,2019,Management,15,1,QCM,0.6139,0.17,0.58,23,19,14,5,1.21,73.68,14,9,61.39,Adapte,Adapte,Adapte / Adapte
4378,229,2020,Management,15,1,QCM,0.7422,0.12,0.62,25,21,19,2,1.19,90.48,19,6,74.22,Adapte,Adapte,Adapte / Adapte
229,230,2015,Management,15,2,QCU,0.3176,0.23,0.4,38,33,12,21,1.15,36.36,12,26,31.76,Difficile,Difficile,Difficile / Difficile
1059,230,2016,Management,15,2,QCU,0.9909,0.09,1.0,38,38,38,0,1.0,100.0,38,0,99.09,Trop Facile,Trop Facile,Trop Facile / Trop Facile
1889,230,2017,Management,15,2,QCU,0.8972,0.04,0.95,34,31,31,0,1.1,100.0,31,3,89.72,Trop Facile,Trop Facile,Trop Facile / Trop Facile
2719,230,2018,Management,15,2,QCU,0.9549,0.01,0.98,40,39,38,1,1.03,97.44,38,2,95.49,Trop Facile,Trop Facile,Trop Facile / Trop Facile
3549,230,2019,Management,15,2,QCU,0.8697,0.0,0.91,43,37,37,0,1.16,100.0,37,6,86.97,Trop Facile,Trop Facile,Trop Facile / Trop Facile
4379,230,2020,Management,15,2,QCU,0.8692,0.1,0.98,45,44,39,5,1.02,88.64,39,6,86.92,Trop Facile,Trop Facile,Trop Facile / Trop Facile
230,231,2015,Informatique,1,1,QCM,0.1201,0.53,0.27,45,13,5,8,3.46,38.46,5,40,12.01,Facile,Trop Difficile,Facile / Trop Difficile
1060,231,2016,Informatique,1,1,QCM,0.6522,0.3,0.53,46,38,30,8,1.21,78.95,30,16,65.22,Facile,Adapte,Facile / Adapte
1890,231,2017,Informatique,1,1,QCM,0.7321,0.13,0.42,38,30,28,2,1.27,93.33,28,10,73.21,Adapte,Adapte,Adapte / Adapte
2720,231,2018,Informatique,1,1,QCM,0.6759,0.05,0.6,33,31,22,9,1.06,70.97,22,11,67.59,Adapte,Adapte,Adapte / Adapte
3550,231,2019,Informatique,1,1,QCM,0.6842,0.2,0.54,37,29,25,4,1.28,86.21,25,12,68.42,Adapte,Adapte,Adapte / Adapte
4380,231,2020,Informatique,1,1,QCM,0.604,0.11,0.51,40,36,24,12,1.11,66.67,24,16,60.4,Adapte,Adapte,Adapte / Adapte
231,232,2015,Informatique,1,2,QCM,0.9752,0.08,0.96,43,42,42,0,1.02,100.0,42,1,97.52,Trop Facile,Trop Facile,Trop Facile / Trop Facile
1061,232,2016,Informatique,1,2,QCM,0.7914,0.1,0.8,39,32,31,1,1.22,96.88,31,8,79.14,Facile,Facile,Facile / Facile
1891,232,2017,Informatique,1,2,QCM,0.9455,0.05,0.84,44,42,42,0,1.05,100.0,42,2,94.55,Facile,Trop Facile,Facile / Trop Facile
2721,232,2018,Informatique,1,2,QCM,0.8139,0.15,0.71,37,31,30,1,1.19,96.77,30,7,81.39,Facile,Facile,Facile / Facile
3551,232,2019,Informatique,1,2,QCM,0.7792,0.12,0.74,34,30,26,4,1.13,86.67,26,8,77.92,Facile,Facile,Facile / Facile
4381,232,2020,Informatique,1,2,QCM,0.6942,0.06,0.67,38,35,26,9,1.09,74.29,26,12,69.42,Facile,Adapte,Facile / Adapte
232,233,2015,Informatique,1,3,QCU,0.9096,0.05,0.98,95,89,86,3,1.07,96.63,86,9,90.96,Facile,Trop Facile,Facile / Trop Facile
1062,233,2016,Informatique,1,3,QCU,0.8644,0.07,0.92,107,94,92,2,1.14,97.87,92,15,86.44,Trop Facile,Trop Facile,Trop Facile / Trop Facile
1892,233,2017,Informatique,1,3,QCU,0.8997,0.04,0.97,92,85,83,2,1.08,97.65,83,9,89.97,Trop Facile,Trop Facile,Trop Facile / Trop Facile
2722,233,2018,Informatique,1,3,QCU,0.3171,0.03,0.36,74,49,23,26,1.51,46.94,23,51,31.71,Trop Facile,Difficile,Trop Facile / Difficile
3552,233,2019,Informatique,1,3,QCU,0.1901,0.22,0.27,74,66,14,52,1.12,21.21,14,60,19.01,Trop Facile,Trop Difficile,Trop Facile / Trop Difficile
4382,233,2020,Informatique,1,3,QCU,0.9927,0.0,1.0,71,70,70,0,1.01,100.0,70,1,99.27,Trop Facile,Trop Facile,Trop Facile / Trop Facile
233,234,2015,Informatique,1,4,QCM,0.9944,0.01,0.94,36,36,36,0,1.0,100.0,36,0,99.44,Trop Facile,Trop Facile,Trop Facile / Trop Facile
1063,234,2016,Informatique,1,4,QCM,0.7627,0.06,0.75,34,34,26,8,1.0,76.47,26,8,76.27,Facile,Facile,Facile / Facile
1893,234,2017,Informatique,1,4,QCM,0.8012,0.03,0.78,35,28,28,0,1.25,100.0,28,7,80.12,Facile,Facile,Facile / Facile
2723,234,2018,Informatique,1,4,QCM,0.8149,0.18,0.78,35,34,29,5,1.03,85.29,29,6,81.49,Facile,Facile,Facile / Facile
3553,234,2019,Informatique,1,4,QCM,0.7211,0.04,0.42,38,37,27,10,1.03,72.97,27,11,72.11,Facile,Adapte,Facile / Adapte
4383,234,2020,Informatique,1,4,QCM,0.6489,0.29,0.49,42,40,27,13,1.05,67.5,27,15,64.89,Adapte,Adapte,Adapte / Adapte
234,235,2015,Informatique,1,5,QCM,0.9384,0.01,0.91,77,73,72,1,1.05,98.63,72,5,93.84,Trop Difficile,Trop Facile,Trop Difficile / Trop Facile
1064,235,2016,Informatique,1,5,QCM,0.5442,0.39,0.31,81,63,44,19,1.29,69.84,44,37,54.42,Facile,Difficile,Facile / Difficile
1894,235,2017,Informatique,1,5,QCM,0.7623,0.09,0.7,83,67,63,4,1.24,94.03,63,20,76.23,Facile,Facile,Facile / Facile
2724,235,2018,Informatique,1,5,QCM,0.9288,0.09,0.97,73,70,68,2,1.04,97.14,68,5,92.88,Facile,Trop Facile,Facile / Trop Facile
3554,235,2019,Informatique,1,5,QCM,0.8722,0.05,0.87,61,54,53,1,1.13,98.15,53,8,87.22,Facile,Trop Facile,Facile / Trop Facile
4384,235,2020,Informatique,1,5,QCM,0.7612,0.1,0.71,67,62,51,11,1.08,82.26,51,16,76.12,Facile,Facile,Facile / Facile
235,236,2015,Informatique,1,6,QCU,0.5041,0.09,0.31,21,21,11,10,1.0,52.38,11,10,50.41,Adapte,Difficile,Adapte / Difficile
1065,236,2016,Informatique,1,6,QCU,0.8666,0.05,0.98,25,23,22,1,1.09,95.65,22,3,86.66,Trop Facile,Trop Facile,Trop Facile / Trop Facile
1895,236,2017,Informatique,1,6,QCU,0.9525,0.04,0.91,21,21,20,1,1.0,95.24,20,1,95.25,Trop Facile,Trop Facile,Trop Facile / Trop Facile
2725,236,2018,Informatique,1,6,QCU,0.6857,0.25,0.56,21,15,14,1,1.4,93.33,14,7,68.57,Trop Facile,Adapte,Trop Facile / Adapte
3555,236,2019,Informatique,1,6,QCU,0.6325,0.26,0.62,22,16,14,2,1.38,87.5,14,8,63.25,Adapte,Adapte,Adapte / Adapte
4385,236,2020,Informatique,1,6,QCU,0.6842,0.3,0.58,21,19,14,5,1.11,73.68,14,7,68.42,Adapte,Adapte,Adapte / Adapte
236,237,2015,Informatique,1,7,QCM,0.2862,0.18,0.39,8,7,2,5,1.14,28.57,2,6,28.62,Difficile,Difficile,Difficile / Difficile
1066,237,2016,Informatique,1,7,QCM,0.3256,0.35,0.34,9,8,3,5,1.12,37.5,3,6,32.56,Facile,Difficile,Facile / Difficile
1896,237,2017,Informatique,1,7,QCM,0.7723,0.0,0.79,8,8,6,2,1.0,75.0,6,2,77.23,Facile,Facile,Facile / Facile
2726,237,2018,Informatique,1,7,QCM,0.9361,0.01,0.89,6,6,6,0,1.0,100.0,6,0,93.61,Facile,Trop Facile,Facile / Trop Facile
3556,237,2019,Informatique,1,7,QCM,0.8489,0.08,0.74,6,5,5,0,1.2,100.0,5,1,84.89,Facile,Facile,Facile / Facile
4386,237,2020,Informatique,1,7,QCM,0.1377,0.68,0.27,5,2,1,1,2.5,50.0,1,4,13.77,Facile,Trop Difficile,Facile / Trop Difficile
237,238,2015,Informatique,1,8,QCU,0.0743,0.3,0.25,68,38,5,33,1.79,13.16,5,63,7.43,Facile,Trop Difficile,Facile / Trop Difficile
1067,238,2016,Informatique,1,8,QCU,0.8705,0.07,0.91,73,71,64,7,1.03,90.14,64,9,87.05,Trop Facile,Trop Facile,Trop Facile / Trop Facile
1897,238,2017,Informatique,1,8,QCU,0.9643,0.06,0.93,58,57,56,1,1.02,98.25,56,2,96.43,Trop Facile,Trop Facile,Trop Facile / Trop Facile
2727,238,2018,Informatique,1,8,QCU,0.9634,0.03,0.96,66,66,64,2,1.0,96.97,64,2,96.34,Trop Facile,Trop Facile,Trop Facile / Trop Facile
3557,238,2019,Informatique,1,8,QCU,0.7936,0.03,0.8,66,56,52,4,1.18,92.86,52,14,79.36,Trop Facile,Facile,Trop Facile / Facile
4387,238,2020,Informatique,1,8,QCU,0.3611,0.14,0.32,72,47,26,21,1.53,55.32,26,46,36.11,Trop Facile,Difficile,Trop Facile / Difficile
238,239,2015,Informatique,1,9,QROC,0.6082,0.34,0.28,16,13,10,3,1.23,76.92,10,6,60.82,Adapte,Adapte,Adapte / Adapte
1068,239,2016,Informatique,1,9,QROC,0.6259,0.33,0.39,15,10,9,1,1.5,90.0,9,6,62.59,Adapte,Adapte,Adapte / Adapte
1898,239,2017,Informatique,1,9,QROC,0.6343,0.4,0.29,17,17,11,6,1.0,64.71,11,6,63.43,Adapte,Adapte,Adapte / Adapte
2728,239,2018,Informatique,1,9,QROC,0.623,0.43,0.26,14,14,9,5,1.0,64.29,9,5,62.3,Adapte,Adapte,Adapte / Adapte
3558,239,2019,Informatique,1,9,QROC,0.6533,0.36,0.3,17,14,11,3,1.21,78.57,11,6,65.33,Adapte,Adapte,Adapte / Adapte
4388,239,2020,Informatique,1,9,QROC,0.6217,0.38,0.37,18,11,11,0,1.64,100.0,11,7,62.17,Adapte,Adapte,Adapte / Adapte
239,240,2015,Informatique,1,10,QCM,0.8294,0.2,0.72,87,72,72,0,1.21,100.0,72,15,82.94,Trop Difficile,Facile,Trop Difficile / Facile
1069,240,2016,Informatique,1,10,QCM,0.7661,0.05,0.71,77,59,59,0,1.31,100.0,59,18,76.61,Facile,Facile,Facile / Facile
1899,240,2017,Informatique,1,10,QCM,0.7849,0.06,0.74,83,80,65,15,1.04,81.25,65,18,78.49,Facile,Facile,Facile / Facile
2729,240,2018,Informatique,1,10,QCM,0.8079,0.05,0.7,74,74,60,14,1.0,81.08,60,14,80.79,Facile,Facile,Facile / Facile
3559,240,2019,Informatique,1,10,QCM,0.3252,0.06,0.36,82,61,27,34,1.34,44.26,27,55,32.52,Facile,Difficile,Facile / Difficile
4389,240,2020,Informatique,1,10,QCM,0.8124,0.02,0.73,90,75,73,2,1.2,97.33,73,17,81.24,Facile,Facile,Facile / Facile
240,241,2015,Informatique,1,11,QROC,0.5098,0.64,0.18,88,64,45,19,1.38,70.31,45,43,50.98,Difficile,Difficile,Difficile / Difficile
1070,241,2016,Informatique,1,11,QROC,0.666,0.3,0.35,95,68,63,5,1.4,92.65,63,32,66.6,Facile,Adapte,Facile / Adapte
1900,241,2017,Informatique,1,11,QROC,0.6446,0.37,0.31,92,78,59,19,1.18,75.64,59,33,64.46,Adapte,Adapte,Adapte / Adapte
2730,241,2018,Informatique,1,11,QROC,0.6236,0.21,0.35,76,75,47,28,1.01,62.67,47,29,62.36,Adapte,Adapte,Adapte / Adapte
3560,241,2019,Informatique,1,11,QROC,0.6053,0.35,0.36,66,46,40,6,1.43,86.96,40,26,60.53,Adapte,Adapte,Adapte / Adapte
4390,241,2020,Informatique,1,11,QROC,0.7418,0.38,0.29,57,51,42,9,1.12,82.35,42,15,74.18,Adapte,Adapte,Adapte / Adapte
241,242,2015,Informatique,1,12,QCU,0.2249,0.07,0.21,48,38,11,27,1.26,28.95,11,37,22.49,Trop Difficile,Trop Difficile,Trop Difficile / Trop Difficile
1071,242,2016,Informatique,1,12,QCU,0.9113,0.05,0.96,44,43,40,3,1.02,93.02,40,4,91.13,Trop Facile,Trop Facile,Trop Facile / Trop Facile
1901,242,2017,Informatique,1,12,QCU,0.1136,0.21,0.29,45,25,5,20,1.8,20.0,5,40,11.36,Trop Facile,Trop Difficile,Trop Facile / Trop Difficile
2731,242,2018,Informatique,1,12,QCU,0.8837,0.02,0.93,36,36,32,4,1.0,88.89,32,4,88.37,Trop Facile,Trop Facile,Trop Facile / Trop Facile
3561,242,2019,Informatique,1,12,QCU,0.8687,0.06,0.9,29,26,25,1,1.12,96.15,25,4,86.87,Trop Facile,Trop Facile,Trop Facile / Trop Facile
4391,242,2020,Informatique,1,12,QCU,0.9301,0.06,0.96,34,33,32,1,1.03,96.97,32,2,93.01,Trop Facile,Trop Facile,Trop Facile / Trop Facile
242,243,2015,Informatique,2,1,QCU,0.8476,0.05,0.85,13,13,11,2,1.0,84.62,11,2,84.76,Facile,Facile,Facile / Facile
1072,243,2016,Informatique,2,1,QCU,0.8898,0.09,0.93,12,11,11,0,1.09,100.0,11,1,88.98,Trop Facile,Trop Facile,Trop Facile / Trop Facile
1902,243,2017,Informatique,2,1,QCU,0.9771,0.03,1.0,13,13,13,0,1.0,100.0,13,0,97.71,Trop Facile,Trop Facile,Trop Facile / Trop Facile
2732,243,2018,Informatique,2,1,QCU,0.194,0.27,0.25,16,8,3,5,2.0,37.5,3,13,19.4,Trop Facile,Trop Difficile,Trop Facile / Trop Difficile
3562,243,2019,Informatique,2,1,QCU,0.6012,0.05,0.68,14,12,8,4,1.17,66.67,8,6,60.12,Trop Facile,Adapte,Trop Facile / Adapte
4392,243,2020,Informatique,2,1,QCU,0.6533,0.19,0.62,12,11,8,3,1.09,72.73,8,4,65.33,Adapte,Adapte,Adapte / Adapte
243,244,2015,Informatique,2,2,QCU,0.8333,0.07,0.87,73,68,61,7,1.07,89.71,61,12,83.33,Adapte,Facile,Adapte / Facile
1073,244,2016,Informatique,2,2,QCU,0.8684,0.03,0.96,71,66,62,4,1.08,93.94,62,9,86.84,Trop Facile,Trop Facile,Trop Facile / Trop Facile
1903,244,2017,Informatique,2,2,QCU,0.2135,0.71,0.25,61,44,13,31,1.39,29.55,13,48,21.35,Trop Facile,Trop Difficile,Trop Facile / Trop Difficile
2733,244,2018,Informatique,2,2,QCU,0.9733,0.09,0.97,71,70,69,1,1.01,98.57,69,2,97.33,Trop Facile,Trop Facile,Trop Facile / Trop Facile
3563,244,2019,Informatique,2,2,QCU,0.2654,0.28,0.36,59,34,16,18,1.74,47.06,16,43,26.54,Trop Facile,Difficile,Trop Facile / Difficile
4393,244,2020,Informatique,2,2,QCU,0.8805,0.03,0.97,61,54,54,0,1.13,100.0,54,7,88.05,Trop Facile,Trop Facile,Trop Facile / Trop Facile
244,245,2015,Informatique,2,3,QCU,0.5504,0.04,0.33,6,4,3,1,1.5,75.0,3,3,55.04,Difficile,Difficile,Difficile / Difficile
1074,245,2016,Informatique,2,3,QCU,0.6404,0.12,0.57,5,4,3,1,1.25,75.0,3,2,64.04,Trop Facile,Adapte,Trop Facile / Adapte
1904,245,2017,Informatique,2,3,QCU,0.634,0.11,0.5,6,4,4,0,1.5,100.0,4,2,63.4,Adapte,Adapte,Adapte / Adapte
2734,245,2018,Informatique,2,3,QCU,0.7121,0.01,0.51,7,5,5,0,1.4,100.0,5,2,71.21,Adapte,Adapte,Adapte / Adapte
3564,245,2019,Informatique,2,3,QCU,0.6859,0.25,0.46,6,5,4,1,1.2,80.0,4,2,68.59,Adapte,Adapte,Adapte / Adapte
4394,245,2020,Informatique,2,3,QCU,0.7134,0.3,0.44,6,4,4,0,1.5,100.0,4,2,71.34,Adapte,Adapte,Adapte / Adapte
245,246,2015,Informatique,2,4,QCM,0.85,0.16,0.79,12,10,10,0,1.2,100.0,10,2,85.0,Adapte,Facile,Adapte / Facile
1075,246,2016,Informatique,2,4,QCM,0.7921,0.18,0.74,13,11,10,1,1.18,90.91,10,3,79.21,Facile,Facile,Facile / Facile
1905,246,2017,Informatique,2,4,QCM,0.8394,0.13,0.73,10,9,8,1,1.11,88.89,8,2,83.94,Facile,Facile,Facile / Facile
2735,246,2018,Informatique,2,4,QCM,0.8395,0.14,0.73,9,9,8,1,1.0,88.89,8,1,83.95,Facile,Facile,Facile / Facile
3565,246,2019,Informatique,2,4,QCM,0.8049,0.05,0.72,7,7,6,1,1.0,85.71,6,1,80.49,Facile,Facile,Facile / Facile
4395,246,2020,Informatique,2,4,QCM,0.7759,0.13,0.74,8,6,6,0,1.33,100.0,6,2,77.59,Facile,Facile,Facile / Facile
246,247,2015,Informatique,2,5,QROC,0.3675,0.73,0.22,96,73,35,38,1.32,47.95,35,61,36.75,Adapte,Difficile,Adapte / Difficile
1076,247,2016,Informatique,2,5,QROC,0.8645,0.09,0.76,81,74,70,4,1.09,94.59,70,11,86.45,Facile,Trop Facile,Facile / Trop Facile
1906,247,2017,Informatique,2,5,QROC,0.6035,0.3,0.33,73,55,44,11,1.33,80.0,44,29,60.35,Facile,Adapte,Facile / Adapte
2736,247,2018,Informatique,2,5,QROC,0.6099,0.42,0.29,78,57,48,9,1.37,84.21,48,30,60.99,Adapte,Adapte,Adapte / Adapte
3566,247,2019,Informatique,2,5,QROC,0.608,0.26,0.35,75,75,46,29,1.0,61.33,46,29,60.8,Adapte,Adapte,Adapte / Adapte
4396,247,2020,Informatique,2,5,QROC,0.6457,0.46,0.27,66,58,43,15,1.14,74.14,43,23,64.57,Adapte,Adapte,Adapte / Adapte
247,248,2015,Informatique,2,6,QO,0.1267,0.96,0.03,31,27,4,23,1.15,14.81,4,27,12.67,Trop Difficile,Trop Difficile,Trop Difficile / Trop Difficile
1077,248,2016,Informatique,2,6,QO,0.6749,0.22,0.3,27,25,18,7,1.08,72.0,18,9,67.49,Adapte,Adapte,Adapte / Adapte
1907,248,2017,Informatique,2,6,QO,0.689,0.65,0.27,28,27,19,8,1.04,70.37,19,9,68.9,Adapte,Adapte,Adapte / Adapte
2737,248,2018,Informatique,2,6,QO,0.681,0.5,0.27,22,16,15,1,1.38,93.75,15,7,68.1,Adapte,Adapte,Adapte / Adapte
3567,248,2019,Informatique,2,6,QO,0.7099,0.6,0.21,20,15,14,1,1.33,93.33,14,6,70.99,Adapte,Adapte,Adapte / Adapte
4397,248,2020,Informatique,2,6,QO,0.733,0.54,0.26,24,21,18,3,1.14,85.71,18,6,73.3,Adapte,Adapte,Adapte / Adapte
248,249,2015,Informatique,3,1,QCU,0.9383,0.03,0.95,100,96,94,2,1.04,97.92,94,6,93.83,Adapte,Trop Facile,Adapte / Trop Facile
1078,249,2016,Informatique,3,1,QCU,0.963,0.07,0.99,99,99,95,4,1.0,95.96,95,4,96.3,Trop Facile,Trop Facile,Trop Facile / Trop Facile
1908,249,2017,Informatique,3,1,QCU,0.0664,0.36,0.27,95,61,6,55,1.56,9.84,6,89,6.64,Trop Facile,Trop Difficile,Trop Facile / Trop Difficile
2738,249,2018,Informatique,3,1,QCU,0.9354,0.03,0.9,76,73,71,2,1.04,97.26,71,5,93.54,Trop Facile,Trop Facile,Trop Facile / Trop Facile
3568,249,2019,Informatique,3,1,QCU,0.8643,0.03,0.93,83,75,72,3,1.11,96.0,72,11,86.43,Trop Facile,Trop Facile,Trop Facile / Trop Facile
4398,249,2020,Informatique,3,1,QCU,0.881,0.1,0.94,87,77,77,0,1.13,100.0,77,10,88.1,Trop Facile,Trop Facile,Trop Facile / Trop Facile
249,250,2015,Informatique,3,2,QCM,0.9991,0.1,0.93,61,61,61,0,1.0,100.0,61,0,99.91,Trop Difficile,Trop Facile,Trop Difficile / Trop Facile
1079,250,2016,Informatique,3,2,QCM,0.9649,0.08,0.91,68,68,66,2,1.0,97.06,66,2,96.49,Facile,Trop Facile,Facile / Trop Facile
1909,250,2017,Informatique,3,2,QCM,0.8435,0.1,0.72,82,70,69,1,1.17,98.57,69,13,84.35,Facile,Facile,Facile / Facile
2739,250,2018,Informatique,3,2,QCM,0.8393,0.01,0.71,91,82,76,6,1.11,92.68,76,15,83.93,Facile,Facile,Facile / Facile
3569,250,2019,Informatique,3,2,QCM,0.848,0.07,0.73,105,91,89,2,1.15,97.8,89,16,84.8,Facile,Facile,Facile / Facile
4399,250,2020,Informatique,3,2,QCM,0.7725,0.06,0.73,110,100,85,15,1.1,85.0,85,25,77.25,Facile,Facile,Facile / Facile
250,251,2015,Informatique,3,3,QCM,0.1711,0.59,0.27,56,21,10,11,2.67,47.62,10,46,17.11,Difficile,Trop Difficile,Difficile / Trop Difficile
1080,251,2016,Informatique,3,3,QCM,0.8086,0.07,0.78,50,49,40,9,1.02,81.63,40,10,80.86,Facile,Facile,Facile / Facile
1910,251,2017,Informatique,3,3,QCM,0.8316,0.03,0.78,50,46,42,4,1.09,91.3,42,8,83.16,Facile,Facile,Facile / Facile
2740,251,2018,Informatique,3,3,QCM,0.7972,0.18,0.72,59,58,47,11,1.02,81.03,47,12,79.72,Facile,Facile,Facile / Facile
3570,251,2019,Informatique,3,3,QCM,0.161,0.7,0.22,55,44,9,35,1.25,20.45,9,46,16.1,Facile,Trop Difficile,Facile / Trop Difficile
4400,251,2020,Informatique,3,3,QCM,0.794,0.12,0.78,56,54,44,10,1.04,81.48,44,12,79.4,Facile,Facile,Facile / Facile
251,252,2015,Informatique,3,4,QCU,0.5802,0.35,0.31,46,30,27,3,1.53,90.0,27,19,58.02,Trop Facile,Difficile,Trop Facile / Difficile
1081,252,2016,Informatique,3,4,QCU,0.798,0.18,0.79,46,42,37,5,1.1,88.1,37,9,79.8,Trop Facile,Facile,Trop Facile / Facile
1911,252,2017,Informatique,3,4,QCU,0.8755,0.08,0.91,43,39,38,1,1.1,97.44,38,5,87.55,Trop Facile,Trop Facile,Trop Facile / Trop Facile
2741,252,2018,Informatique,3,4,QCU,0.9783,0.08,0.97,50,50,49,1,1.0,98.0,49,1,97.83,Trop Facile,Trop Facile,Trop Facile / Trop Facile
3571,252,2019,Informatique,3,4,QCU,0.8672,0.01,1.0,46,41,40,1,1.12,97.56,40,6,86.72,Trop Facile,Trop Facile,Trop Facile / Trop Facile
4401,252,2020,Informatique,3,4,QCU,0.9863,0.09,0.99,51,51,50,1,1.0,98.04,50,1,98.63,Trop Facile,Trop Facile,Trop Facile / Trop Facile
252,253,2015,Informatique,3,5,QO,0.993,0.07,0.76,16,16,16,0,1.0,100.0,16,0,99.3,Trop Difficile,Trop Facile,Trop Difficile / Trop Facile
1082,253,2016,Informatique,3,5,QO,0.6205,0.44,0.26,16,15,10,5,1.07,66.67,10,6,62.05,Adapte,Adapte,Adapte / Adapte
1912,253,2017,Informatique,3,5,QO,0.7489,0.22,0.26,16,16,12,4,1.0,75.0,12,4,74.89,Adapte,Adapte,Adapte / Adapte
2742,253,2018,Informatique,3,5,QO,0.6037,0.26,0.22,16,15,10,5,1.07,66.67,10,6,60.37,Adapte,Adapte,Adapte / Adapte
3572,253,2019,Informatique,3,5,QO,0.7374,0.61,0.24,13,12,10,2,1.08,83.33,10,3,73.74,Adapte,Adapte,Adapte / Adapte
4402,253,2020,Informatique,3,5,QO,0.6841,0.64,0.15,14,11,10,1,1.27,90.91,10,4,68.41,Adapte,Adapte,Adapte / Adapte
253,254,2015,Informatique,3,6,QCM,0.3543,0.48,0.37,65,61,23,38,1.07,37.7,23,42,35.43,Difficile,Difficile,Difficile / Difficile
1083,254,2016,Informatique,3,6,QCM,0.6393,0.27,0.41,55,48,35,13,1.15,72.92,35,20,63.93,Facile,Adapte,Facile / Adapte
1913,254,2017,Informatique,3,6,QCM,0.6092,0.23,0.43,52,50,32,18,1.04,64.0,32,20,60.92,Adapte,Adapte,Adapte / Adapte
2743,254,2018,Informatique,3,6,QCM,0.6116,0.17,0.63,59,57,36,21,1.04,63.16,36,23,61.16,Adapte,Adapte,Adapte / Adapte
3573,254,2019,Informatique,3,6,QCM,0.6875,0.03,0.41,69,52,47,5,1.33,90.38,47,22,68.75,Adapte,Adapte,Adapte / Adapte
4403,254,2020,Informatique,3,6,QCM,0.7224,0.21,0.42,72,56,52,4,1.29,92.86,52,20,72.24,Adapte,Adapte,Adapte / Adapte
254,255,2015,Informatique,3,7,QCM,0.8136,0.16,0.7,22,19,18,1,1.16,94.74,18,4,81.36,Facile,Facile,Facile / Facile
1084,255,2016,Informatique,3,7,QCM,0.8031,0.12,0.76,20,17,16,1,1.18,94.12,16,4,80.31,Facile,Facile,Facile / Facile
1914,255,2017,Informatique,3,7,QCM,0.6326,0.16,0.52,16,16,10,6,1.0,62.5,10,6,63.26,Facile,Adapte,Facile / Adapte
2744,255,2018,Informatique,3,7,QCM,0.6645,0.01,0.45,17,13,11,2,1.31,84.62,11,6,66.45,Adapte,Adapte,Adapte / Adapte
3574,255,2019,Informatique,3,7,QCM,0.6128,0.05,0.51,14,11,9,2,1.27,81.82,9,5,61.28,Adapte,Adapte,Adapte / Adapte
4404,255,2020,Informatique,3,7,QCM,0.644,0.15,0.62,11,10,7,3,1.1,70.0,7,4,64.4,Adapte,Adapte,Adapte / Adapte
255,256,2015,Informatique,3,8,QCM,0.0136,0.59,0.27,13,11,0,11,1.18,0.0,0,13,1.36,Trop Difficile,Trop Difficile,Trop Difficile / Trop Difficile
1085,256,2016,Informatique,3,8,QCM,0.731,0.22,0.55,15,13,11,2,1.15,84.62,11,4,73.1,Facile,Adapte,Facile / Adapte
1915,256,2017,Informatique,3,8,QCM,0.6984,0.09,0.41,16,15,11,4,1.07,73.33,11,5,69.84,Adapte,Adapte,Adapte / Adapte
2745,256,2018,Informatique,3,8,QCM,0.6049,0.19,0.42,18,13,11,2,1.38,84.62,11,7,60.49,Adapte,Adapte,Adapte / Adapte
3575,256,2019,Informatique,3,8,QCM,0.732,0.09,0.56,17,16,12,4,1.06,75.0,12,5,73.2,Adapte,Adapte,Adapte / Adapte
4405,256,2020,Informatique,3,8,QCM,0.6006,0.04,0.69,15,12,9,3,1.25,75.0,9,6,60.06,Adapte,Adapte,Adapte / Adapte
256,257,2015,Informatique,3,9,QCU,0.7741,0.01,0.83,6,6,5,1,1.0,83.33,5,1,77.41,Facile,Facile,Facile / Facile
1086,257,2016,Informatique,3,9,QCU,0.9839,0.05,0.94,6,6,6,0,1.0,100.0,6,0,98.39,Trop Facile,Trop Facile,Trop Facile / Trop Facile
1916,257,2017,Informatique,3,9,QCU,0.9184,0.04,0.96,7,7,6,1,1.0,85.71,6,1,91.84,Trop Facile,Trop Facile,Trop Facile / Trop Facile
2746,257,2018,Informatique,3,9,QCU,0.944,0.06,0.96,6,6,6,0,1.0,100.0,6,0,94.4,Trop Facile,Trop Facile,Trop Facile / Trop Facile
3576,257,2019,Informatique,3,9,QCU,0.9872,0.06,0.94,5,5,5,0,1.0,100.0,5,0,98.72,Trop Facile,Trop Facile,Trop Facile / Trop Facile
4406,257,2020,Informatique,3,9,QCU,0.6538,0.22,0.42,4,4,3,1,1.0,75.0,3,1,65.38,Trop Facile,Adapte,Trop Facile / Adapte
257,258,2015,Informatique,4,1,QCM,0.8327,0.18,0.77,17,15,14,1,1.13,93.33,14,3,83.27,Facile,Facile,Facile / Facile
1087,258,2016,Informatique,4,1,QCM,0.7725,0.11,0.79,14,12,11,1,1.17,91.67,11,3,77.25,Facile,Facile,Facile / Facile
1917,258,2017,Informatique,4,1,QCM,0.7767,0.07,0.78,16,13,12,1,1.23,92.31,12,4,77.67,Facile,Facile,Facile / Facile
2747,258,2018,Informatique,4,1,QCM,0.6318,0.17,0.47,18,17,11,6,1.06,64.71,11,7,63.18,Facile,Adapte,Facile / Adapte
3577,258,2019,Informatique,4,1,QCM,0.6817,0.0,0.58,15,11,10,1,1.36,90.91,10,5,68.17,Adapte,Adapte,Adapte / Adapte
4407,258,2020,Informatique,4,1,QCM,0.6271,0.14,0.52,14,13,9,4,1.08,69.23,9,5,62.71,Adapte,Adapte,Adapte / Adapte
258,259,2015,Informatique,4,2,QROC,0.4608,0.61,0.23,53,24,24,0,2.21,100.0,24,29,46.08,Difficile,Difficile,Difficile / Difficile
1088,259,2016,Informatique,4,2,QROC,0.8357,0.2,0.59,59,57,49,8,1.04,85.96,49,10,83.57,Facile,Facile,Facile / Facile
1918,259,2017,Informatique,4,2,QROC,0.8362,0.03,0.54,62,58,52,6,1.07,89.66,52,10,83.62,Facile,Facile,Facile / Facile
2748,259,2018,Informatique,4,2,QROC,0.8452,0.15,0.58,73,67,62,5,1.09,92.54,62,11,84.52,Facile,Facile,Facile / Facile
3578,259,2019,Informatique,4,2,QROC,0.8445,0.15,0.58,76,68,64,4,1.12,94.12,64,12,84.45,Facile,Facile,Facile / Facile
4408,259,2020,Informatique,4,2,QROC,0.8104,0.11,0.61,85,70,69,1,1.21,98.57,69,16,81.04,Facile,Facile,Facile / Facile
259,260,2015,Informatique,4,3,QROC,0.3377,0.74,0.2,35,15,12,3,2.33,80.0,12,23,33.77,Difficile,Difficile,Difficile / Difficile
1089,260,2016,Informatique,4,3,QROC,0.7873,0.15,0.69,38,31,30,1,1.23,96.77,30,8,78.73,Facile,Facile,Facile / Facile
1919,260,2017,Informatique,4,3,QROC,0.7676,0.04,0.56,43,38,33,5,1.13,86.84,33,10,76.76,Facile,Facile,Facile / Facile
2749,260,2018,Informatique,4,3,QROC,0.1217,0.99,0.07,40,16,5,11,2.5,31.25,5,35,12.17,Facile,Trop Difficile,Facile / Trop Difficile
3579,260,2019,Informatique,4,3,QROC,0.0027,0.78,0.05,34,19,0,19,1.79,0.0,0,34,0.27,Facile,Trop Difficile,Facile / Trop Difficile
4409,260,2020,Informatique,4,3,QROC,0.8325,0.16,0.49,32,28,27,1,1.14,96.43,27,5,83.25,Facile,Facile,Facile / Facile
260,261,2015,Informatique,4,4,QCU,0.8709,0.02,0.93,91,83,79,4,1.1,95.18,79,12,87.09,Trop Difficile,Trop Facile,Trop Difficile / Trop Facile
1090,261,2016,Informatique,4,4,QCU,0.9553,0.03,0.93,102,99,97,2,1.03,97.98,97,5,95.53,Trop Facile,Trop Facile,Trop Facile / Trop Facile
1920,261,2017,Informatique,4,4,QCU,0.2743,0.35,0.39,93,44,26,18,2.11,59.09,26,67,27.43,Trop Facile,Difficile,Trop Facile / Difficile
2750,261,2018,Informatique,4,4,QCU,0.8891,0.06,0.95,94,92,84,8,1.02,91.3,84,10,88.91,Trop Facile,Trop Facile,Trop Facile / Trop Facile
3580,261,2019,Informatique,4,4,QCU,0.8979,0.07,0.97,79,76,71,5,1.04,93.42,71,8,89.79,Trop Facile,Trop Facile,Trop Facile / Trop Facile
4410,261,2020,Informatique,4,4,QCU,0.6963,0.26,0.55,76,73,53,20,1.04,72.6,53,23,69.63,Trop Facile,Adapte,Trop Facile / Adapte
261,262,2015,Informatique,4,5,QCU,0.3779,0.32,0.32,73,35,28,7,2.09,80.0,28,45,37.79,Adapte,Difficile,Adapte / Difficile
1091,262,2016,Informatique,4,5,QCU,0.9364,0.03,0.98,66,65,62,3,1.02,95.38,62,4,93.64,Trop Facile,Trop Facile,Trop Facile / Trop Facile
1921,262,2017,Informatique,4,5,QCU,0.9102,0.02,0.9,70,64,64,0,1.09,100.0,64,6,91.02,Trop Facile,Trop Facile,Trop Facile / Trop Facile
2751,262,2018,Informatique,4,5,QCU,0.912,0.09,1.0,84,79,77,2,1.06,97.47,77,7,91.2,Trop Facile,Trop Facile,Trop Facile / Trop Facile
3581,262,2019,Informatique,4,5,QCU,0.8821,0.04,0.92,87,79,77,2,1.1,97.47,77,10,88.21,Trop Facile,Trop Facile,Trop Facile / Trop Facile
4411,262,2020,Informatique,4,5,QCU,0.8842,0.1,0.99,80,76,71,5,1.05,93.42,71,9,88.42,Trop Facile,Trop Facile,Trop Facile / Trop Facile
262,263,2015,Informatique,5,1,QCM,0.8047,0.09,0.77,68,58,55,3,1.17,94.83,55,13,80.47,Facile,Facile,Facile / Facile
1092,263,2016,Informatique,5,1,QCM,0.376,0.08,0.35,67,33,25,8,2.03,75.76,25,42,37.6,Facile,Difficile,Facile / Difficile
1922,263,2017,Informatique,5,1,QCM,0.7811,0.05,0.78,58,45,45,0,1.29,100.0,45,13,78.11,Facile,Facile,Facile / Facile
2752,263,2018,Informatique,5,1,QCM,0.7851,0.08,0.71,48,42,38,4,1.14,90.48,38,10,78.51,Facile,Facile,Facile / Facile
3582,263,2019,Informatique,5,1,QCM,0.7694,0.12,0.78,42,34,32,2,1.24,94.12,32,10,76.94,Facile,Facile,Facile / Facile
4412,263,2020,Informatique,5,1,QCM,0.9272,0.02,0.99,46,45,43,2,1.02,95.56,43,3,92.72,Facile,Trop Facile,Facile / Trop Facile
263,264,2015,Informatique,5,2,QCU,0.1107,0.64,0.25,70,57,8,49,1.23,14.04,8,62,11.07,Trop Difficile,Trop Difficile,Trop Difficile / Trop Difficile
1093,264,2016,Informatique,5,2,QCU,0.9298,0.0,0.97,61,60,57,3,1.02,95.0,57,4,92.98,Trop Facile,Trop Facile,Trop Facile / Trop Facile
1923,264,2017,Informatique,5,2,QCU,0.8985,0.03,0.99,70,67,63,4,1.04,94.03,63,7,89.85,Trop Facile,Trop Facile,Trop Facile / Trop Facile
2753,264,2018,Informatique,5,2,QCU,0.9853,0.05,1.0,82,81,81,0,1.01,100.0,81,1,98.53,Trop Facile,Trop Facile,Trop Facile / Trop Facile
3583,264,2019,Informatique,5,2,QCU,0.9576,0.0,0.99,93,92,89,3,1.01,96.74,89,4,95.76,Trop Facile,Trop Facile,Trop Facile / Trop Facile
4413,264,2020,Informatique,5,2,QCU,0.8897,0.07,0.95,94,88,84,4,1.07,95.45,84,10,88.97,Trop Facile,Trop Facile,Trop Facile / Trop Facile
264,265,2015,Informatique,5,3,QCM,0.7136,0.03,0.42,46,41,33,8,1.12,80.49,33,13,71.36,Adapte,Adapte,Adapte / Adapte
1094,265,2016,Informatique,5,3,QCM,0.6831,0.29,0.68,40,35,27,8,1.14,77.14,27,13,68.31,Adapte,Adapte,Adapte / Adapte
1924,265,2017,Informatique,5,3,QCM,0.7293,0.03,0.41,46,38,34,4,1.21,89.47,34,12,72.93,Adapte,Adapte,Adapte / Adapte
2754,265,2018,Informatique,5,3,QCM,0.7251,0.08,0.54,43,31,31,0,1.39,100.0,31,12,72.51,Adapte,Adapte,Adapte / Adapte
3584,265,2019,Informatique,5,3,QCM,0.6042,0.0,0.61,42,31,25,6,1.35,80.65,25,17,60.42,Adapte,Adapte,Adapte / Adapte
4414,265,2020,Informatique,5,3,QCM,0.699,0.27,0.45,36,27,25,2,1.33,92.59,25,11,69.9,Adapte,Adapte,Adapte / Adapte
265,266,2015,Informatique,5,4,QO,0.81,0.14,0.54,33,28,27,1,1.18,96.43,27,6,81.0,Difficile,Facile,Difficile / Facile
1095,266,2016,Informatique,5,4,QO,0.7374,0.43,0.22,27,26,20,6,1.04,76.92,20,7,73.74,Adapte,Adapte,Adapte / Adapte
1925,266,2017,Informatique,5,4,QO,0.7233,0.28,0.27,31,27,22,5,1.15,81.48,22,9,72.33,Adapte,Adapte,Adapte / Adapte
2755,266,2018,Informatique,5,4,QO,0.7077,0.44,0.16,26,25,18,7,1.04,72.0,18,8,70.77,Adapte,Adapte,Adapte / Adapte
3585,266,2019,Informatique,5,4,QO,0.6808,0.35,0.29,28,20,19,1,1.4,95.0,19,9,68.08,Adapte,Adapte,Adapte / Adapte
4415,266,2020,Informatique,5,4,QO,0.6398,0.63,0.26,34,30,22,8,1.13,73.33,22,12,63.98,Adapte,Adapte,Adapte / Adapte
266,267,2015,Informatique,5,5,QCU,0.2564,0.39,0.32,80,35,21,14,2.29,60.0,21,59,25.64,Adapte,Difficile,Adapte / Difficile
1096,267,2016,Informatique,5,5,QCU,0.8902,0.06,0.98,92,83,82,1,1.11,98.8,82,10,89.02,Trop Facile,Trop Facile,Trop Facile / Trop Facile
1926,267,2017,Informatique,5,5,QCU,0.6631,0.03,0.59,86,73,57,16,1.18,78.08,57,29,66.31,Trop Facile,Adapte,Trop Facile / Adapte
2756,267,2018,Informatique,5,5,QCU,0.6086,0.11,0.6,103,101,63,38,1.02,62.38,63,40,60.86,Adapte,Adapte,Adapte / Adapte
3586,267,2019,Informatique,5,5,QCU,0.6344,0.04,0.49,96,90,61,29,1.07,67.78,61,35,63.44,Adapte,Adapte,Adapte / Adapte
4416,267,2020,Informatique,5,5,QCU,0.7285,0.27,0.59,88,69,64,5,1.28,92.75,64,24,72.85,Adapte,Adapte,Adapte / Adapte
267,268,2015,Informatique,5,6,QROC,0.9658,0.06,0.77,60,59,58,1,1.02,98.31,58,2,96.58,Facile,Trop Facile,Facile / Trop Facile
1097,268,2016,Informatique,5,6,QROC,0.8858,0.09,0.55,48,44,43,1,1.09,97.73,43,5,88.58,Facile,Trop Facile,Facile / Trop Facile
1927,268,2017,Informatique,5,6,QROC,0.7828,0.11,0.6,52,44,41,3,1.18,93.18,41,11,78.28,Facile,Facile,Facile / Facile
2757,268,2018,Informatique,5,6,QROC,0.7887,0.05,0.55,50,47,39,8,1.06,82.98,39,11,78.87,Facile,Facile,Facile / Facile
3587,268,2019,Informatique,5,6,QROC,0.7678,0.19,0.54,47,43,36,7,1.09,83.72,36,11,76.78,Facile,Facile,Facile / Facile
4417,268,2020,Informatique,5,6,QROC,0.8194,0.14,0.63,43,36,35,1,1.19,97.22,35,8,81.94,Facile,Facile,Facile / Facile
268,269,2015,Informatique,5,7,QROC,0.8434,0.01,0.52,53,50,45,5,1.06,90.0,45,8,84.34,Facile,Facile,Facile / Facile
1098,269,2016,Informatique,5,7,QROC,0.9417,0.09,0.57,56,53,53,0,1.06,100.0,53,3,94.17,Facile,Trop Facile,Facile / Trop Facile
1928,269,2017,Informatique,5,7,QROC,0.089,0.91,0.04,65,34,6,28,1.91,17.65,6,59,8.9,Facile,Trop Difficile,Facile / Trop Difficile
2758,269,2018,Informatique,5,7,QROC,0.392,0.75,0.24,64,30,25,5,2.13,83.33,25,39,39.2,Facile,Difficile,Facile / Difficile
3588,269,2019,Informatique,5,7,QROC,0.8264,0.17,0.58,66,63,55,8,1.05,87.3,55,11,82.64,Facile,Facile,Facile / Facile
4418,269,2020,Informatique,5,7,QROC,0.3747,0.74,0.16,65,30,24,6,2.17,80.0,24,41,37.47,Facile,Difficile,Facile / Difficile
269,270,2015,Informatique,5,8,QCU,0.3851,0.1,0.32,87,43,34,9,2.02,79.07,34,53,38.51,Difficile,Difficile,Difficile / Difficile
1099,270,2016,Informatique,5,8,QCU,0.9062,0.07,0.93,103,96,93,3,1.07,96.88,93,10,90.62,Trop Facile,Trop Facile,Trop Facile / Trop Facile
1929,270,2017,Informatique,5,8,QCU,0.8812,0.08,0.95,116,104,102,2,1.12,98.08,102,14,88.12,Trop Facile,Trop Facile,Trop Facile / Trop Facile
2759,270,2018,Informatique,5,8,QCU,0.9971,0.07,0.91,102,102,102,0,1.0,100.0,102,0,99.71,Trop Facile,Trop Facile,Trop Facile / Trop Facile
3589,270,2019,Informatique,5,8,QCU,0.902,0.0,0.96,93,89,84,5,1.04,94.38,84,9,90.2,Trop Facile,Trop Facile,Trop Facile / Trop Facile
4419,270,2020,Informatique,5,8,QCU,0.8859,0.03,0.98,87,80,77,3,1.09,96.25,77,10,88.59,Trop Facile,Trop Facile,Trop Facile / Trop Facile
270,271,2015,Informatique,6,1,QCM,0.7428,0.26,0.64,75,59,56,3,1.27,94.92,56,19,74.28,Facile,Adapte,Facile / Adapte
1100,271,2016,Informatique,6,1,QCM,0.7139,0.26,0.6,60,51,43,8,1.18,84.31,43,17,71.39,Adapte,Adapte,Adapte / Adapte
1930,271,2017,Informatique,6,1,QCM,0.7406,0.14,0.46,67,63,50,13,1.06,79.37,50,17,74.06,Adapte,Adapte,Adapte / Adapte
2760,271,2018,Informatique,6,1,QCM,0.6231,0.14,0.66,79,63,49,14,1.25,77.78,49,30,62.31,Adapte,Adapte,Adapte / Adapte
3590,271,2019,Informatique,6,1,QCM,0.6541,0.1,0.66,77,64,50,14,1.2,78.12,50,27,65.41,Adapte,Adapte,Adapte / Adapte
4420,271,2020,Informatique,6,1,QCM,0.7446,0.05,0.51,79,69,59,10,1.14,85.51,59,20,74.46,Adapte,Adapte,Adapte / Adapte
271,272,2015,Informatique,7,1,QCU,0.0873,0.08,0.26,9,7,1,6,1.29,14.29,1,8,8.73,Trop Difficile,Trop Difficile,Trop Difficile / Trop Difficile
1101,272,2016,Informatique,7,1,QCU,0.9044,0.06,0.94,8,7,7,0,1.14,100.0,7,1,90.44,Trop Facile,Trop Facile,Trop Facile / Trop Facile
1931,272,2017,Informatique,7,1,QCU,0.4619,0.39,0.38,10,7,5,2,1.43,71.43,5,5,46.19,Trop Facile,Difficile,Trop Facile / Difficile
2761,272,2018,Informatique,7,1,QCU,0.9995,0.06,0.96,9,9,9,0,1.0,100.0,9,0,99.95,Trop Facile,Trop Facile,Trop Facile / Trop Facile
3591,272,2019,Informatique,7,1,QCU,0.7486,0.24,0.7,7,6,5,1,1.17,83.33,5,2,74.86,Trop Facile,Adapte,Trop Facile / Adapte
4421,272,2020,Informatique,7,1,QCU,0.6284,0.08,0.63,7,6,4,2,1.17,66.67,4,3,62.84,Adapte,Adapte,Adapte / Adapte
272,273,2015,Informatique,7,2,QCM,0.2059,0.67,0.28,17,8,4,4,2.12,50.0,4,13,20.59,Trop Difficile,Trop Difficile,Trop Difficile / Trop Difficile
1102,273,2016,Informatique,7,2,QCM,0.1697,0.65,0.28,17,8,3,5,2.12,37.5,3,14,16.97,Facile,Trop Difficile,Facile / Trop Difficile
1932,273,2017,Informatique,7,2,QCM,0.8153,0.13,0.79,16,14,13,1,1.14,92.86,13,3,81.53,Facile,Facile,Facile / Facile
2762,273,2018,Informatique,7,2,QCM,0.7852,0.07,0.72,19,19,15,4,1.0,78.95,15,4,78.52,Facile,Facile,Facile / Facile
3592,273,2019,Informatique,7,2,QCM,0.8156,0.1,0.71,21,20,17,3,1.05,85.0,17,4,81.56,Facile,Facile,Facile / Facile
4422,273,2020,Informatique,7,2,QCM,0.8448,0.06,0.76,19,17,16,1,1.12,94.12,16,3,84.48,Facile,Facile,Facile / Facile
273,274,2015,Informatique,7,3,QCU,0.7678,0.17,0.76,85,70,65,5,1.21,92.86,65,20,76.78,Facile,Facile,Facile / Facile
1103,274,2016,Informatique,7,3,QCU,0.8643,0.05,0.97,68,60,59,1,1.13,98.33,59,9,86.43,Trop Facile,Trop Facile,Trop Facile / Trop Facile
1933,274,2017,Informatique,7,3,QCU,0.9499,0.03,0.92,61,58,58,0,1.05,100.0,58,3,94.99,Trop Facile,Trop Facile,Trop Facile / Trop Facile
2763,274,2018,Informatique,7,3,QCU,0.8799,0.03,0.94,67,63,59,4,1.06,93.65,59,8,87.99,Trop Facile,Trop Facile,Trop Facile / Trop Facile
3593,274,2019,Informatique,7,3,QCU,0.1984,0.66,0.26,76,64,15,49,1.19,23.44,15,61,19.84,Trop Facile,Trop Difficile,Trop Facile / Trop Difficile
4423,274,2020,Informatique,7,3,QCU,0.1778,0.68,0.22,91,37,16,21,2.46,43.24,16,75,17.78,Trop Facile,Trop Difficile,Trop Facile / Trop Difficile
274,275,2015,Informatique,7,4,QCM,0.9681,0.02,0.86,98,96,95,1,1.02,98.96,95,3,96.81,Trop Facile,Trop Facile,Trop Facile / Trop Facile
1104,275,2016,Informatique,7,4,QCM,0.8462,0.16,0.72,117,101,99,2,1.16,98.02,99,18,84.62,Facile,Facile,Facile / Facile
1934,275,2017,Informatique,7,4,QCM,0.7684,0.08,0.7,109,98,84,14,1.11,85.71,84,25,76.84,Facile,Facile,Facile / Facile
2764,275,2018,Informatique,7,4,QCM,0.8421,0.17,0.77,92,91,77,14,1.01,84.62,77,15,84.21,Facile,Facile,Facile / Facile
3594,275,2019,Informatique,7,4,QCM,0.8425,0.08,0.78,105,95,88,7,1.11,92.63,88,17,84.25,Facile,Facile,Facile / Facile
4424,275,2020,Informatique,7,4,QCM,0.7965,0.15,0.74,107,107,85,22,1.0,79.44,85,22,79.65,Facile,Facile,Facile / Facile
275,276,2015,Informatique,7,5,QCM,0.5799,0.11,0.36,79,52,46,6,1.52,88.46,46,33,57.99,Difficile,Difficile,Difficile / Difficile
1105,276,2016,Informatique,7,5,QCM,0.8478,0.04,0.77,66,61,56,5,1.08,91.8,56,10,84.78,Facile,Facile,Facile / Facile
1935,276,2017,Informatique,7,5,QCM,0.6781,0.21,0.66,64,60,43,17,1.07,71.67,43,21,67.81,Facile,Adapte,Facile / Adapte
2765,276,2018,Informatique,7,5,QCM,0.6354,0.22,0.68,66,60,42,18,1.1,70.0,42,24,63.54,Adapte,Adapte,Adapte / Adapte
3595,276,2019,Informatique,7,5,QCM,0.7423,0.17,0.45,64,60,48,12,1.07,80.0,48,16,74.23,Adapte,Adapte,Adapte / Adapte
4425,276,2020,Informatique,7,5,QCM,0.7134,0.18,0.48,76,75,54,21,1.01,72.0,54,22,71.34,Adapte,Adapte,Adapte / Adapte
276,277,2015,Informatique,7,6,QCM,0.726,0.28,0.43,45,38,33,5,1.18,86.84,33,12,72.6,Trop Difficile,Adapte,Trop Difficile / Adapte
1106,277,2016,Informatique,7,6,QCM,0.6755,0.07,0.57,48,47,32,15,1.02,68.09,32,16,67.55,Adapte,Adapte,Adapte / Adapte
1936,277,2017,Informatique,7,6,QCM,0.6348,0.01,0.67,45,42,29,13,1.07,69.05,29,16,63.48,Adapte,Adapte,Adapte / Adapte
2766,277,2018,Informatique,7,6,QCM,0.6522,0.3,0.48,54,52,35,17,1.04,67.31,35,19,65.22,Adapte,Adapte,Adapte / Adapte
3596,277,2019,Informatique,7,6,QCM,0.7499,0.04,0.52,49,41,37,4,1.2,90.24,37,12,74.99,Adapte,Adapte,Adapte / Adapte
4426,277,2020,Informatique,7,6,QCM,0.6213,0.09,0.55,49,45,30,15,1.09,66.67,30,19,62.13,Adapte,Adapte,Adapte / Adapte
277,278,2015,Informatique,8,1,QCU,0.3482,0.2,0.38,80,46,28,18,1.74,60.87,28,52,34.82,Difficile,Difficile,Difficile / Difficile
1107,278,2016,Informatique,8,1,QCU,0.5386,0.27,0.36,65,38,35,3,1.71,92.11,35,30,53.86,Trop Facile,Difficile,Trop Facile / Difficile
1937,278,2017,Informatique,8,1,QCU,0.8778,0.01,0.97,61,58,54,4,1.05,93.1,54,7,87.78,Trop Facile,Trop Facile,Trop Facile / Trop Facile
2767,278,2018,Informatique,8,1,QCU,0.9348,0.09,0.93,58,58,54,4,1.0,93.1,54,4,93.48,Trop Facile,Trop Facile,Trop Facile / Trop Facile
3597,278,2019,Informatique,8,1,QCU,0.9325,0.01,0.96,47,46,44,2,1.02,95.65,44,3,93.25,Trop Facile,Trop Facile,Trop Facile / Trop Facile
4427,278,2020,Informatique,8,1,QCU,0.6132,0.13,0.58,55,47,34,13,1.17,72.34,34,21,61.32,Trop Facile,Adapte,Trop Facile / Adapte
278,279,2015,Informatique,8,2,QCU,0.2193,0.04,0.22,50,40,11,29,1.25,27.5,11,39,21.93,Trop Difficile,Trop Difficile,Trop Difficile / Trop Difficile
1108,279,2016,Informatique,8,2,QCU,0.8687,0.06,0.92,45,45,39,6,1.0,86.67,39,6,86.87,Trop Facile,Trop Facile,Trop Facile / Trop Facile
1938,279,2017,Informatique,8,2,QCU,0.6582,0.17,0.6,37,28,24,4,1.32,85.71,24,13,65.82,Trop Facile,Adapte,Trop Facile / Adapte
2768,279,2018,Informatique,8,2,QCU,0.6886,0.07,0.59,44,36,30,6,1.22,83.33,30,14,68.86,Adapte,Adapte,Adapte / Adapte
3598,279,2019,Informatique,8,2,QCU,0.6523,0.19,0.47,48,34,31,3,1.41,91.18,31,17,65.23,Adapte,Adapte,Adapte / Adapte
4428,279,2020,Informatique,8,2,QCU,0.6713,0.29,0.55,57,53,38,15,1.08,71.7,38,19,67.13,Adapte,Adapte,Adapte / Adapte
279,280,2015,Informatique,8,3,QCM,0.688,0.02,0.5,39,38,27,11,1.03,71.05,27,12,68.8,Adapte,Adapte,Adapte / Adapte
1109,280,2016,Informatique,8,3,QCM,0.6948,0.16,0.53,38,30,26,4,1.27,86.67,26,12,69.48,Adapte,Adapte,Adapte / Adapte
1939,280,2017,Informatique,8,3,QCM,0.6023,0.05,0.49,33,20,20,0,1.65,100.0,20,13,60.23,Adapte,Adapte,Adapte / Adapte
2769,280,2018,Informatique,8,3,QCM,0.7229,0.1,0.65,30,24,22,2,1.25,91.67,22,8,72.29,Adapte,Adapte,Adapte / Adapte
3599,280,2019,Informatique,8,3,QCM,0.7147,0.02,0.47,34,32,24,8,1.06,75.0,24,10,71.47,Adapte,Adapte,Adapte / Adapte
4429,280,2020,Informatique,8,3,QCM,0.6705,0.22,0.49,36,28,24,4,1.29,85.71,24,12,67.05,Adapte,Adapte,Adapte / Adapte
280,281,2015,Informatique,8,4,QCM,0.9473,0.08,0.96,49,48,46,2,1.02,95.83,46,3,94.73,Difficile,Trop Facile,Difficile / Trop Facile
1110,281,2016,Informatique,8,4,QCM,0.7776,0.06,0.75,51,49,40,9,1.04,81.63,40,11,77.76,Facile,Facile,Facile / Facile
1940,281,2017,Informatique,8,4,QCM,0.9789,0.04,0.94,59,59,58,1,1.0,98.31,58,1,97.89,Facile,Trop Facile,Facile / Trop Facile
2770,281,2018,Informatique,8,4,QCM,0.901,0.09,0.84,61,58,55,3,1.05,94.83,55,6,90.1,Facile,Trop Facile,Facile / Trop Facile
3600,281,2019,Informatique,8,4,QCM,0.9979,0.03,0.86,69,69,69,0,1.0,100.0,69,0,99.79,Facile,Trop Facile,Facile / Trop Facile
4430,281,2020,Informatique,8,4,QCM,0.7645,0.0,0.75,61,59,47,12,1.03,79.66,47,14,76.45,Facile,Facile,Facile / Facile
281,282,2015,Informatique,8,5,QCM,0.7772,0.05,0.77,57,52,44,8,1.1,84.62,44,13,77.72,Facile,Facile,Facile / Facile
1111,282,2016,Informatique,8,5,QCM,0.763,0.01,0.79,50,45,38,7,1.11,84.44,38,12,76.3,Facile,Facile,Facile / Facile
1941,282,2017,Informatique,8,5,QCM,0.814,0.13,0.78,55,47,45,2,1.17,95.74,45,10,81.4,Facile,Facile,Facile / Facile
2771,282,2018,Informatique,8,5,QCM,0.7998,0.06,0.73,54,50,43,7,1.08,86.0,43,11,79.98,Facile,Facile,Facile / Facile
3601,282,2019,Informatique,8,5,QCM,0.8117,0.12,0.76,62,60,50,10,1.03,83.33,50,12,81.17,Facile,Facile,Facile / Facile
4431,282,2020,Informatique,8,5,QCM,0.8314,0.06,0.71,68,61,57,4,1.11,93.44,57,11,83.14,Facile,Facile,Facile / Facile
282,283,2015,Informatique,8,6,QCU,0.6124,0.04,0.44,47,40,29,11,1.18,72.5,29,18,61.24,Adapte,Adapte,Adapte / Adapte
1112,283,2016,Informatique,8,6,QCU,0.6771,0.23,0.49,46,41,31,10,1.12,75.61,31,15,67.71,Adapte,Adapte,Adapte / Adapte
1942,283,2017,Informatique,8,6,QCU,0.7116,0.15,0.51,47,46,33,13,1.02,71.74,33,14,71.16,Adapte,Adapte,Adapte / Adapte
2772,283,2018,Informatique,8,6,QCU,0.6874,0.02,0.48,49,48,34,14,1.02,70.83,34,15,68.74,Adapte,Adapte,Adapte / Adapte
3602,283,2019,Informatique,8,6,QCU,0.6361,0.06,0.55,50,34,32,2,1.47,94.12,32,18,63.61,Adapte,Adapte,Adapte / Adapte
4432,283,2020,Informatique,8,6,QCU,0.6737,0.04,0.61,49,43,33,10,1.14,76.74,33,16,67.37,Adapte,Adapte,Adapte / Adapte
283,284,2015,Informatique,8,7,QCU,0.0399,0.27,0.25,24,14,1,13,1.71,7.14,1,23,3.99,Trop Difficile,Trop Difficile,Trop Difficile / Trop Difficile
1113,284,2016,Informatique,8,7,QCU,0.9197,0.04,0.97,22,21,20,1,1.05,95.24,20,2,91.97,Trop Facile,Trop Facile,Trop Facile / Trop Facile
1943,284,2017,Informatique,8,7,QCU,0.6867,0.01,0.56,21,16,14,2,1.31,87.5,14,7,68.67,Trop Facile,Adapte,Trop Facile / Adapte
2773,284,2018,Informatique,8,7,QCU,0.7239,0.06,0.69,21,21,15,6,1.0,71.43,15,6,72.39,Adapte,Adapte,Adapte / Adapte
3603,284,2019,Informatique,8,7,QCU,0.6891,0.1,0.42,19,17,13,4,1.12,76.47,13,6,68.91,Adapte,Adapte,Adapte / Adapte
4433,284,2020,Informatique,8,7,QCU,0.6858,0.16,0.55,20,15,14,1,1.33,93.33,14,6,68.58,Adapte,Adapte,Adapte / Adapte
284,285,2015,Informatique,8,8,QCU,0.8387,0.11,0.87,65,58,55,3,1.12,94.83,55,10,83.87,Facile,Facile,Facile / Facile
1114,285,2016,Informatique,8,8,QCU,0.7007,0.12,0.51,71,69,50,19,1.03,72.46,50,21,70.07,Trop Facile,Adapte,Trop Facile / Adapte
1944,285,2017,Informatique,8,8,QCU,0.6315,0.26,0.53,57,44,36,8,1.3,81.82,36,21,63.15,Adapte,Adapte,Adapte / Adapte
2774,285,2018,Informatique,8,8,QCU,0.6388,0.17,0.64,66,52,42,10,1.27,80.77,42,24,63.88,Adapte,Adapte,Adapte / Adapte
3604,285,2019,Informatique,8,8,QCU,0.6216,0.24,0.53,77,74,48,26,1.04,64.86,48,29,62.16,Adapte,Adapte,Adapte / Adapte
4434,285,2020,Informatique,8,8,QCU,0.6751,0.21,0.58,80,64,54,10,1.25,84.38,54,26,67.51,Adapte,Adapte,Adapte / Adapte
285,286,2015,Informatique,8,9,QCU,0.0752,0.29,0.25,100,39,8,31,2.56,20.51,8,92,7.52,Trop Difficile,Trop Difficile,Trop Difficile / Trop Difficile
1115,286,2016,Informatique,8,9,QCU,0.6139,0.22,0.51,96,93,59,34,1.03,63.44,59,37,61.39,Trop Facile,Adapte,Trop Facile / Adapte
1945,286,2017,Informatique,8,9,QCU,0.6136,0.12,0.42,92,64,56,8,1.44,87.5,56,36,61.36,Adapte,Adapte,Adapte / Adapte
2775,286,2018,Informatique,8,9,QCU,0.6302,0.25,0.56,97,87,61,26,1.11,70.11,61,36,63.02,Adapte,Adapte,Adapte / Adapte
3605,286,2019,Informatique,8,9,QCU,0.6074,0.21,0.59,97,67,59,8,1.45,88.06,59,38,60.74,Adapte,Adapte,Adapte / Adapte
4435,286,2020,Informatique,8,9,QCU,0.607,0.21,0.43,89,79,54,25,1.13,68.35,54,35,60.7,Adapte,Adapte,Adapte / Adapte
286,287,2015,Informatique,8,10,QCU,0.4734,0.35,0.31,5,2,2,0,2.5,100.0,2,3,47.34,Difficile,Difficile,Difficile / Difficile
1116,287,2016,Informatique,8,10,QCU,0.8125,0.1,0.88,6,6,5,1,1.0,83.33,5,1,81.25,Trop Facile,Facile,Trop Facile / Facile
1946,287,2017,Informatique,8,10,QCU,0.8989,0.01,0.91,7,6,6,0,1.17,100.0,6,1,89.89,Trop Facile,Trop Facile,Trop Facile / Trop Facile
2776,287,2018,Informatique,8,10,QCU,0.9284,0.05,0.95,6,6,6,0,1.0,100.0,6,0,92.84,Trop Facile,Trop Facile,Trop Facile / Trop Facile
3606,287,2019,Informatique,8,10,QCU,0.67,0.08,0.54,7,6,5,1,1.17,83.33,5,2,67.0,Trop Facile,Adapte,Trop Facile / Adapte
4436,287,2020,Informatique,8,10,QCU,0.621,0.02,0.58,7,6,4,2,1.17,66.67,4,3,62.1,Adapte,Adapte,Adapte / Adapte
287,288,2015,Informatique,8,11,QCU,0.0626,0.39,0.26,63,26,4,22,2.42,15.38,4,59,6.26,Trop Difficile,Trop Difficile,Trop Difficile / Trop Difficile
1117,288,2016,Informatique,8,11,QCU,0.9388,0.06,0.98,58,56,54,2,1.04,96.43,54,4,93.88,Trop Facile,Trop Facile,Trop Facile / Trop Facile
1947,288,2017,Informatique,8,11,QCU,0.8738,0.04,0.98,47,46,41,5,1.02,89.13,41,6,87.38,Trop Facile,Trop Facile,Trop Facile / Trop Facile
2777,288,2018,Informatique,8,11,QCU,0.9722,0.0,0.92,43,42,42,0,1.02,100.0,42,1,97.22,Trop Facile,Trop Facile,Trop Facile / Trop Facile
3607,288,2019,Informatique,8,11,QCU,0.8832,0.02,0.91,38,37,34,3,1.03,91.89,34,4,88.32,Trop Facile,Trop Facile,Trop Facile / Trop Facile
4437,288,2020,Informatique,8,11,QCU,0.9361,0.06,0.93,37,36,35,1,1.03,97.22,35,2,93.61,Trop Facile,Trop Facile,Trop Facile / Trop Facile
288,289,2015,Informatique,8,12,QCM,0.4523,0.3,0.32,99,90,45,45,1.1,50.0,45,54,45.23,Difficile,Difficile,Difficile / Difficile
1118,289,2016,Informatique,8,12,QCM,0.5388,0.31,0.32,98,62,53,9,1.58,85.48,53,45,53.88,Facile,Difficile,Facile / Difficile
1948,289,2017,Informatique,8,12,QCM,0.681,0.09,0.56,103,77,70,7,1.34,90.91,70,33,68.1,Facile,Adapte,Facile / Adapte
2778,289,2018,Informatique,8,12,QCM,0.6579,0.28,0.69,112,104,74,30,1.08,71.15,74,38,65.79,Adapte,Adapte,Adapte / Adapte
3608,289,2019,Informatique,8,12,QCM,0.7297,0.26,0.49,111,81,81,0,1.37,100.0,81,30,72.97,Adapte,Adapte,Adapte / Adapte
4438,289,2020,Informatique,8,12,QCM,0.705,0.27,0.57,94,66,66,0,1.42,100.0,66,28,70.5,Adapte,Adapte,Adapte / Adapte
289,290,2015,Informatique,8,13,QCU,0.7906,0.04,0.88,42,33,33,0,1.27,100.0,33,9,79.06,Facile,Facile,Facile / Facile
1119,290,2016,Informatique,8,13,QCU,0.8722,0.08,0.99,40,39,35,4,1.03,89.74,35,5,87.22,Trop Facile,Trop Facile,Trop Facile / Trop Facile
1949,290,2017,Informatique,8,13,QCU,0.2397,0.14,0.25,32,20,8,12,1.6,40.0,8,24,23.97,Trop Facile,Trop Difficile,Trop Facile / Trop Difficile
2779,290,2018,Informatique,8,13,QCU,0.4053,0.05,0.36,36,15,15,0,2.4,100.0,15,21,40.53,Trop Facile,Difficile,Trop Facile / Difficile
3609,290,2019,Informatique,8,13,QCU,0.8867,0.04,0.98,32,30,28,2,1.07,93.33,28,4,88.67,Trop Facile,Trop Facile,Trop Facile / Trop Facile
4439,290,2020,Informatique,8,13,QCU,0.8841,0.07,0.91,34,32,30,2,1.06,93.75,30,4,88.41,Trop Facile,Trop Facile,Trop Facile / Trop Facile
290,291,2015,Informatique,9,1,QROC,0.1097,0.93,0.03,62,47,7,40,1.32,14.89,7,55,10.97,Facile,Trop Difficile,Facile / Trop Difficile
1120,291,2016,Informatique,9,1,QROC,0.7788,0.12,0.72,66,51,51,0,1.29,100.0,51,15,77.88,Facile,Facile,Facile / Facile
1950,291,2017,Informatique,9,1,QROC,0.7746,0.06,0.73,77,70,60,10,1.1,85.71,60,17,77.46,Facile,Facile,Facile / Facile
2780,291,2018,Informatique,9,1,QROC,0.8337,0.04,0.71,62,57,52,5,1.09,91.23,52,10,83.37,Facile,Facile,Facile / Facile
3610,291,2019,Informatique,9,1,QROC,0.7649,0.01,0.6,58,51,44,7,1.14,86.27,44,14,76.49,Facile,Facile,Facile / Facile
4440,291,2020,Informatique,9,1,QROC,0.6791,0.21,0.34,48,35,33,2,1.37,94.29,33,15,67.91,Facile,Adapte,Facile / Adapte
291,292,2015,Informatique,9,2,QCM,0.9604,0.07,0.9,88,87,85,2,1.01,97.7,85,3,96.04,Trop Facile,Trop Facile,Trop Facile / Trop Facile
1121,292,2016,Informatique,9,2,QCM,0.8391,0.09,0.79,105,94,88,6,1.12,93.62,88,17,83.91,Facile,Facile,Facile / Facile
1951,292,2017,Informatique,9,2,QCM,0.8047,0.11,0.71,111,98,89,9,1.13,90.82,89,22,80.47,Facile,Facile,Facile / Facile
2781,292,2018,Informatique,9,2,QCM,0.8413,0.04,0.72,117,104,98,6,1.12,94.23,98,19,84.13,Facile,Facile,Facile / Facile
3611,292,2019,Informatique,9,2,QCM,0.8207,0.07,0.77,97,80,80,0,1.21,100.0,80,17,82.07,Facile,Facile,Facile / Facile
4441,292,2020,Informatique,9,2,QCM,0.7631,0.02,0.73,113,110,86,24,1.03,78.18,86,27,76.31,Facile,Facile,Facile / Facile
292,293,2015,Informatique,9,3,QCU,0.8343,0.02,0.84,91,84,76,8,1.08,90.48,76,15,83.43,Facile,Facile,Facile / Facile
1122,293,2016,Informatique,9,3,QCU,0.9545,0.04,0.91,105,103,100,3,1.02,97.09,100,5,95.45,Trop Facile,Trop Facile,Trop Facile / Trop Facile
1952,293,2017,Informatique,9,3,QCU,0.8799,0.06,1.0,101,99,89,10,1.02,89.9,89,12,87.99,Trop Facile,Trop Facile,Trop Facile / Trop Facile
2782,293,2018,Informatique,9,3,QCU,0.761,0.04,0.88,97,90,74,16,1.08,82.22,74,23,76.1,Trop Facile,Facile,Trop Facile / Facile
3612,293,2019,Informatique,9,3,QCU,0.2262,0.43,0.26,94,87,21,66,1.08,24.14,21,73,22.62,Trop Facile,Trop Difficile,Trop Facile / Trop Difficile
4442,293,2020,Informatique,9,3,QCU,0.0906,0.22,0.21,77,57,7,50,1.35,12.28,7,70,9.06,Trop Facile,Trop Difficile,Trop Facile / Trop Difficile
293,294,2015,Informatique,9,4,QCM,0.4183,0.39,0.36,67,29,28,1,2.31,96.55,28,39,41.83,Difficile,Difficile,Difficile / Difficile
1123,294,2016,Informatique,9,4,QCM,0.7748,0.0,0.73,78,76,60,16,1.03,78.95,60,18,77.48,Facile,Facile,Facile / Facile
1953,294,2017,Informatique,9,4,QCM,0.9919,0.09,0.9,76,75,75,0,1.01,100.0,75,1,99.19,Facile,Trop Facile,Facile / Trop Facile
2783,294,2018,Informatique,9,4,QCM,0.2221,0.69,0.24,82,44,18,26,1.86,40.91,18,64,22.21,Facile,Trop Difficile,Facile / Trop Difficile
3613,294,2019,Informatique,9,4,QCM,0.4202,0.24,0.4,72,38,30,8,1.89,78.95,30,42,42.02,Facile,Difficile,Facile / Difficile
4443,294,2020,Informatique,9,4,QCM,0.8034,0.06,0.73,76,64,61,3,1.19,95.31,61,15,80.34,Facile,Facile,Facile / Facile
294,295,2015,Informatique,9,5,QCM,0.8194,0.03,0.77,35,32,29,3,1.09,90.62,29,6,81.94,Adapte,Facile,Adapte / Facile
1124,295,2016,Informatique,9,5,QCM,0.9173,0.09,0.82,30,28,28,0,1.07,100.0,28,2,91.73,Facile,Trop Facile,Facile / Trop Facile
1954,295,2017,Informatique,9,5,QCM,0.7868,0.01,0.79,28,27,22,5,1.04,81.48,22,6,78.68,Facile,Facile,Facile / Facile
2784,295,2018,Informatique,9,5,QCM,0.8183,0.15,0.79,30,29,25,4,1.03,86.21,25,5,81.83,Facile,Facile,Facile / Facile
3614,295,2019,Informatique,9,5,QCM,0.8132,0.0,0.78,34,34,28,6,1.0,82.35,28,6,81.32,Facile,Facile,Facile / Facile
4444,295,2020,Informatique,9,5,QCM,0.7756,0.05,0.71,31,26,24,2,1.19,92.31,24,7,77.56,Facile,Facile,Facile / Facile
295,296,2015,Informatique,9,6,QCU,0.0484,0.23,0.29,14,6,1,5,2.33,16.67,1,13,4.84,Trop Difficile,Trop Difficile,Trop Difficile / Trop Difficile
1125,296,2016,Informatique,9,6,QCU,0.9286,0.1,0.97,17,16,16,0,1.06,100.0,16,1,92.86,Trop Facile,Trop Facile,Trop Facile / Trop Facile
1955,296,2017,Informatique,9,6,QCU,0.8788,0.01,0.93,16,15,14,1,1.07,93.33,14,2,87.88,Trop Facile,Trop Facile,Trop Facile / Trop Facile
2785,296,2018,Informatique,9,6,QCU,0.9674,0.03,0.98,18,18,17,1,1.0,94.44,17,1,96.74,Trop Facile,Trop Facile,Trop Facile / Trop Facile
3615,296,2019,Informatique,9,6,QCU,0.8968,0.1,0.97,22,21,20,1,1.05,95.24,20,2,89.68,Trop Facile,Trop Facile,Trop Facile / Trop Facile
4445,296,2020,Informatique,9,6,QCU,0.9019,0.06,0.95,19,17,17,0,1.12,100.0,17,2,90.19,Trop Facile,Trop Facile,Trop Facile / Trop Facile
296,297,2015,Informatique,9,7,QCM,0.3084,0.2,0.36,35,16,11,5,2.19,68.75,11,24,30.84,Difficile,Difficile,Difficile / Difficile
1126,297,2016,Informatique,9,7,QCM,0.7746,0.06,0.78,33,33,26,7,1.0,78.79,26,7,77.46,Facile,Facile,Facile / Facile
1956,297,2017,Informatique,9,7,QCM,0.7615,0.18,0.75,39,31,30,1,1.26,96.77,30,9,76.15,Facile,Facile,Facile / Facile
2786,297,2018,Informatique,9,7,QCM,0.7923,0.11,0.78,42,41,33,8,1.02,80.49,33,9,79.23,Facile,Facile,Facile / Facile
3616,297,2019,Informatique,9,7,QCM,0.7979,0.01,0.79,37,31,30,1,1.19,96.77,30,7,79.79,Facile,Facile,Facile / Facile
4446,297,2020,Informatique,9,7,QCM,0.9649,0.04,0.99,35,34,34,0,1.03,100.0,34,1,96.49,Facile,Trop Facile,Facile / Trop Facile
297,298,2015,Informatique,9,8,QCU,0.9914,0.02,0.92,40,40,40,0,1.0,100.0,40,0,99.14,Trop Facile,Trop Facile,Trop Facile / Trop Facile
1127,298,2016,Informatique,9,8,QCU,0.7251,0.09,0.63,37,29,27,2,1.28,93.1,27,10,72.51,Trop Facile,Adapte,Trop Facile / Adapte
1957,298,2017,Informatique,9,8,QCU,0.638,0.01,0.48,37,28,24,4,1.32,85.71,24,13,63.8,Adapte,Adapte,Adapte / Adapte
2787,298,2018,Informatique,9,8,QCU,0.615,0.18,0.61,33,25,20,5,1.32,80.0,20,13,61.5,Adapte,Adapte,Adapte / Adapte
3617,298,2019,Informatique,9,8,QCU,0.64,0.05,0.5,40,34,26,8,1.18,76.47,26,14,64.0,Adapte,Adapte,Adapte / Adapte
4447,298,2020,Informatique,9,8,QCU,0.7026,0.2,0.41,41,38,29,9,1.08,76.32,29,12,70.26,Adapte,Adapte,Adapte / Adapte
298,299,2015,Informatique,9,9,QCM,0.6427,0.09,0.6,54,43,35,8,1.26,81.4,35,19,64.27,Adapte,Adapte,Adapte / Adapte
1128,299,2016,Informatique,9,9,QCM,0.6686,0.26,0.58,56,52,37,15,1.08,71.15,37,19,66.86,Adapte,Adapte,Adapte / Adapte
1958,299,2017,Informatique,9,9,QCM,0.7034,0.01,0.46,51,42,36,6,1.21,85.71,36,15,70.34,Adapte,Adapte,Adapte / Adapte
2788,299,2018,Informatique,9,9,QCM,0.7174,0.15,0.42,56,45,40,5,1.24,88.89,40,16,71.74,Adapte,Adapte,Adapte / Adapte
3618,299,2019,Informatique,9,9,QCM,0.6182,0.14,0.44,57,43,35,8,1.33,81.4,35,22,61.82,Adapte,Adapte,Adapte / Adapte
4448,299,2020,Informatique,9,9,QCM,0.7385,0.14,0.5,62,62,46,16,1.0,74.19,46,16,73.85,Adapte,Adapte,Adapte / Adapte
299,300,2015,Informatique,9,10,QCU,0.1755,0.29,0.25,10,9,2,7,1.11,22.22,2,8,17.55,Difficile,Trop Difficile,Difficile / Trop Difficile
1129,300,2016,Informatique,9,10,QCU,0.7368,0.18,0.66,9,7,7,0,1.29,100.0,7,2,73.68,Trop Facile,Adapte,Trop Facile / Adapte
1959,300,2017,Informatique,9,10,QCU,0.6141,0.25,0.68,11,9,7,2,1.22,77.78,7,4,61.41,Adapte,Adapte,Adapte / Adapte
2789,300,2018,Informatique,9,10,QCU,0.7439,0.15,0.54,12,11,9,2,1.09,81.82,9,3,74.39,Adapte,Adapte,Adapte / Adapte
3619,300,2019,Informatique,9,10,QCU,0.6868,0.02,0.49,12,10,8,2,1.2,80.0,8,4,68.68,Adapte,Adapte,Adapte / Adapte
4449,300,2020,Informatique,9,10,QCU,0.6954,0.23,0.53,13,13,9,4,1.0,69.23,9,4,69.54,Adapte,Adapte,Adapte / Adapte
300,301,2015,Informatique,9,11,QCM,0.4405,0.44,0.35,96,77,42,35,1.25,54.55,42,54,44.05,Difficile,Difficile,Difficile / Difficile
1130,301,2016,Informatique,9,11,QCM,0.6669,0.3,0.58,89,69,59,10,1.29,85.51,59,30,66.69,Facile,Adapte,Facile / Adapte
1960,301,2017,Informatique,9,11,QCM,0.7267,0.01,0.7,79,73,57,16,1.08,78.08,57,22,72.67,Adapte,Adapte,Adapte / Adapte
2790,301,2018,Informatique,9,11,QCM,0.7183,0.11,0.69,92,73,66,7,1.26,90.41,66,26,71.83,Adapte,Adapte,Adapte / Adapte
3620,301,2019,Informatique,9,11,QCM,0.6586,0.11,0.53,76,66,50,16,1.15,75.76,50,26,65.86,Adapte,Adapte,Adapte / Adapte
4450,301,2020,Informatique,9,11,QCM,0.6436,0.2,0.56,75,50,48,2,1.5,96.0,48,27,64.36,Adapte,Adapte,Adapte / Adapte
301,302,2015,Informatique,9,12,QO,0.0421,0.94,0.1,42,32,2,30,1.31,6.25,2,40,4.21,Trop Difficile,Trop Difficile,Trop Difficile / Trop Difficile
1131,302,2016,Informatique,9,12,QO,0.6392,0.63,0.21,49,45,31,14,1.09,68.89,31,18,63.92,Adapte,Adapte,Adapte / Adapte
1961,302,2017,Informatique,9,12,QO,0.7491,0.38,0.24,39,30,29,1,1.3,96.67,29,10,74.91,Adapte,Adapte,Adapte / Adapte
2791,302,2018,Informatique,9,12,QO,0.6509,0.22,0.21,40,27,26,1,1.48,96.3,26,14,65.09,Adapte,Adapte,Adapte / Adapte
3621,302,2019,Informatique,9,12,QO,0.6612,0.68,0.17,42,41,28,13,1.02,68.29,28,14,66.12,Adapte,Adapte,Adapte / Adapte
4451,302,2020,Informatique,9,12,QO,0.6614,0.33,0.21,48,40,32,8,1.2,80.0,32,16,66.14,Adapte,Adapte,Adapte / Adapte
302,303,2015,Informatique,10,1,QCU,0.9497,0.1,0.91,37,36,35,1,1.03,97.22,35,2,94.97,Trop Facile,Trop Facile,Trop Facile / Trop Facile
1132,303,2016,Informatique,10,1,QCU,0.8904,0.09,0.92,41,38,37,1,1.08,97.37,37,4,89.04,Trop Facile,Trop Facile,Trop Facile / Trop Facile
1962,303,2017,Informatique,10,1,QCU,0.5724,0.22,0.32,35,20,20,0,1.75,100.0,20,15,57.24,Trop Facile,Difficile,Trop Facile / Difficile
2792,303,2018,Informatique,10,1,QCU,0.9933,0.1,0.95,31,31,31,0,1.0,100.0,31,0,99.33,Trop Facile,Trop Facile,Trop Facile / Trop Facile
3622,303,2019,Informatique,10,1,QCU,0.8025,0.13,0.86,35,30,28,2,1.17,93.33,28,7,80.25,Trop Facile,Facile,Trop Facile / Facile
4452,303,2020,Informatique,10,1,QCU,0.6146,0.06,0.64,36,35,22,13,1.03,62.86,22,14,61.46,Trop Facile,Adapte,Trop Facile / Adapte
303,304,2015,Informatique,10,2,QCU,0.5218,0.29,0.31,85,81,44,37,1.05,54.32,44,41,52.18,Difficile,Difficile,Difficile / Difficile
1133,304,2016,Informatique,10,2,QCU,0.8675,0.03,0.97,90,89,78,11,1.01,87.64,78,12,86.75,Trop Facile,Trop Facile,Trop Facile / Trop Facile
1963,304,2017,Informatique,10,2,QCU,0.8455,0.12,0.84,96,86,81,5,1.12,94.19,81,15,84.55,Trop Facile,Facile,Trop Facile / Facile
2793,304,2018,Informatique,10,2,QCU,0.8669,0.07,0.92,82,80,71,9,1.02,88.75,71,11,86.69,Trop Facile,Trop Facile,Trop Facile / Trop Facile
3623,304,2019,Informatique,10,2,QCU,0.8656,0.06,0.91,72,70,62,8,1.03,88.57,62,10,86.56,Trop Facile,Trop Facile,Trop Facile / Trop Facile
4453,304,2020,Informatique,10,2,QCU,0.9386,0.07,0.96,63,62,59,3,1.02,95.16,59,4,93.86,Trop Facile,Trop Facile,Trop Facile / Trop Facile
304,305,2015,Informatique,10,3,QCU,0.0149,0.25,0.28,91,34,1,33,2.68,2.94,1,90,1.49,Trop Difficile,Trop Difficile,Trop Difficile / Trop Difficile
1134,305,2016,Informatique,10,3,QCU,0.9926,0.06,0.94,101,101,100,1,1.0,99.01,100,1,99.26,Trop Facile,Trop Facile,Trop Facile / Trop Facile
1964,305,2017,Informatique,10,3,QCU,0.8769,0.07,0.92,118,114,103,11,1.04,90.35,103,15,87.69,Trop Facile,Trop Facile,Trop Facile / Trop Facile
2794,305,2018,Informatique,10,3,QCU,0.9604,0.05,0.98,113,109,109,0,1.04,100.0,109,4,96.04,Trop Facile,Trop Facile,Trop Facile / Trop Facile
3624,305,2019,Informatique,10,3,QCU,0.9383,0.09,0.96,123,118,115,3,1.04,97.46,115,8,93.83,Trop Facile,Trop Facile,Trop Facile / Trop Facile
4454,305,2020,Informatique,10,3,QCU,0.7683,0.08,0.81,143,135,110,25,1.06,81.48,110,33,76.83,Trop Facile,Facile,Trop Facile / Facile
305,306,2015,Informatique,10,4,QROC,0.8492,0.18,0.48,32,29,27,2,1.1,93.1,27,5,84.92,Facile,Facile,Facile / Facile
1135,306,2016,Informatique,10,4,QROC,0.8069,0.15,0.55,34,32,27,5,1.06,84.38,27,7,80.69,Facile,Facile,Facile / Facile
1965,306,2017,Informatique,10,4,QROC,0.0199,0.77,0.13,39,31,1,30,1.26,3.23,1,38,1.99,Facile,Trop Difficile,Facile / Trop Difficile
2795,306,2018,Informatique,10,4,QROC,0.7686,0.06,0.41,46,40,35,5,1.15,87.5,35,11,76.86,Facile,Facile,Facile / Facile
3625,306,2019,Informatique,10,4,QROC,0.819,0.19,0.41,45,41,37,4,1.1,90.24,37,8,81.9,Facile,Facile,Facile / Facile
4455,306,2020,Informatique,10,4,QROC,0.9134,0.04,0.72,39,37,36,1,1.05,97.3,36,3,91.34,Facile,Trop Facile,Facile / Trop Facile
306,307,2015,Informatique,10,5,QCM,0.6003,0.07,0.68,100,96,60,36,1.04,62.5,60,40,60.03,Adapte,Adapte,Adapte / Adapte
1136,307,2016,Informatique,10,5,QCM,0.7187,0.17,0.47,98,70,70,0,1.4,100.0,70,28,71.87,Adapte,Adapte,Adapte / Adapte
1966,307,2017,Informatique,10,5,QCM,0.6454,0.2,0.44,97,67,63,4,1.45,94.03,63,34,64.54,Adapte,Adapte,Adapte / Adapte
2796,307,2018,Informatique,10,5,QCM,0.6126,0.07,0.51,109,105,67,38,1.04,63.81,67,42,61.26,Adapte,Adapte,Adapte / Adapte
3626,307,2019,Informatique,10,5,QCM,0.6928,0.18,0.49,120,105,83,22,1.14,79.05,83,37,69.28,Adapte,Adapte,Adapte / Adapte
4456,307,2020,Informatique,10,5,QCM,0.7122,0.27,0.57,113,108,80,28,1.05,74.07,80,33,71.22,Adapte,Adapte,Adapte / Adapte
307,308,2015,Informatique,10,6,QCM,0.7965,0.04,0.7,55,47,44,3,1.17,93.62,44,11,79.65,Facile,Facile,Facile / Facile
1137,308,2016,Informatique,10,6,QCM,0.7804,0.04,0.76,58,54,45,9,1.07,83.33,45,13,78.04,Facile,Facile,Facile / Facile
1967,308,2017,Informatique,10,6,QCM,0.4206,0.04,0.32,56,50,24,26,1.12,48.0,24,32,42.06,Facile,Difficile,Facile / Difficile
2797,308,2018,Informatique,10,6,QCM,0.0949,0.42,0.24,50,45,5,40,1.11,11.11,5,45,9.49,Facile,Trop Difficile,Facile / Trop Difficile
3627,308,2019,Informatique,10,6,QCM,0.8172,0.06,0.75,45,44,37,7,1.02,84.09,37,8,81.72,Facile,Facile,Facile / Facile
4457,308,2020,Informatique,10,6,QCM,0.8118,0.02,0.7,39,34,32,2,1.15,94.12,32,7,81.18,Facile,Facile,Facile / Facile
308,309,2015,Informatique,10,7,QROC,0.1467,0.9,0.11,85,34,12,22,2.5,35.29,12,73,14.67,Adapte,Trop Difficile,Adapte / Trop Difficile
1138,309,2016,Informatique,10,7,QROC,0.9604,0.1,0.7,73,71,70,1,1.03,98.59,70,3,96.04,Facile,Trop Facile,Facile / Trop Facile
1968,309,2017,Informatique,10,7,QROC,0.7716,0.0,0.72,58,46,45,1,1.26,97.83,45,13,77.16,Facile,Facile,Facile / Facile
2798,309,2018,Informatique,10,7,QROC,0.7804,0.02,0.59,53,48,41,7,1.1,85.42,41,12,78.04,Facile,Facile,Facile / Facile
3628,309,2019,Informatique,10,7,QROC,0.7919,0.17,0.67,59,53,47,6,1.11,88.68,47,12,79.19,Facile,Facile,Facile / Facile
4458,309,2020,Informatique,10,7,QROC,0.8272,0.15,0.53,63,55,52,3,1.15,94.55,52,11,82.72,Facile,Facile,Facile / Facile
309,310,2015,Informatique,10,8,QCM,0.8059,0.15,0.7,11,10,9,1,1.1,90.0,9,2,80.59,Adapte,Facile,Adapte / Facile
1139,310,2016,Informatique,10,8,QCM,0.763,0.2,0.7,10,10,8,2,1.0,80.0,8,2,76.3,Facile,Facile,Facile / Facile
1969,310,2017,Informatique,10,8,QCM,0.8333,0.14,0.72,11,11,9,2,1.0,81.82,9,2,83.33,Facile,Facile,Facile / Facile
2799,310,2018,Informatique,10,8,QCM,0.823,0.01,0.74,13,11,11,0,1.18,100.0,11,2,82.3,Facile,Facile,Facile / Facile
3629,310,2019,Informatique,10,8,QCM,0.1085,0.67,0.24,12,5,1,4,2.4,20.0,1,11,10.85,Facile,Trop Difficile,Facile / Trop Difficile
4459,310,2020,Informatique,10,8,QCM,0.8308,0.09,0.76,13,11,11,0,1.18,100.0,11,2,83.08,Facile,Facile,Facile / Facile
310,311,2015,Informatique,10,9,QROC,0.9392,0.07,0.76,49,48,46,2,1.02,95.83,46,3,93.92,Trop Facile,Trop Facile,Trop Facile / Trop Facile
1140,311,2016,Informatique,10,9,QROC,0.7876,0.16,0.63,40,34,32,2,1.18,94.12,32,8,78.76,Facile,Facile,Facile / Facile
1970,311,2017,Informatique,10,9,QROC,0.7977,0.1,0.63,42,36,34,2,1.17,94.44,34,8,79.77,Facile,Facile,Facile / Facile
2800,311,2018,Informatique,10,9,QROC,0.7763,0.17,0.44,36,29,28,1,1.24,96.55,28,8,77.63,Facile,Facile,Facile / Facile
3630,311,2019,Informatique,10,9,QROC,0.7876,0.1,0.58,37,33,29,4,1.12,87.88,29,8,78.76,Facile,Facile,Facile / Facile
4460,311,2020,Informatique,10,9,QROC,0.6896,0.41,0.36,36,28,25,3,1.29,89.29,25,11,68.96,Facile,Adapte,Facile / Adapte
311,312,2015,Informatique,11,1,QO,0.8437,0.05,0.46,64,64,54,10,1.0,84.38,54,10,84.37,Trop Difficile,Facile,Trop Difficile / Facile
1141,312,2016,Informatique,11,1,QO,0.7104,0.72,0.17,58,55,41,14,1.05,74.55,41,17,71.04,Adapte,Adapte,Adapte / Adapte
1971,312,2017,Informatique,11,1,QO,0.6868,0.74,0.15,67,54,46,8,1.24,85.19,46,21,68.68,Adapte,Adapte,Adapte / Adapte
2801,312,2018,Informatique,11,1,QO,0.718,0.74,0.3,73,64,52,12,1.14,81.25,52,21,71.8,Adapte,Adapte,Adapte / Adapte
3631,312,2019,Informatique,11,1,QO,0.7189,0.72,0.25,77,62,55,7,1.24,88.71,55,22,71.89,Adapte,Adapte,Adapte / Adapte
4461,312,2020,Informatique,11,1,QO,0.7389,0.31,0.24,65,64,48,16,1.02,75.0,48,17,73.89,Adapte,Adapte,Adapte / Adapte
312,313,2015,Informatique,12,1,QCM,0.9225,0.06,0.93,64,64,59,5,1.0,92.19,59,5,92.25,Trop Facile,Trop Facile,Trop Facile / Trop Facile
1142,313,2016,Informatique,12,1,QCM,0.7944,0.19,0.74,56,53,44,9,1.06,83.02,44,12,79.44,Facile,Facile,Facile / Facile
1972,313,2017,Informatique,12,1,QCM,0.7844,0.04,0.78,58,46,45,1,1.26,97.83,45,13,78.44,Facile,Facile,Facile / Facile
2802,313,2018,Informatique,12,1,QCM,0.8344,0.01,0.79,68,57,57,0,1.19,100.0,57,11,83.44,Facile,Facile,Facile / Facile
3632,313,2019,Informatique,12,1,QCM,0.4027,0.31,0.37,79,49,32,17,1.61,65.31,32,47,40.27,Facile,Difficile,Facile / Difficile
4462,313,2020,Informatique,12,1,QCM,0.8945,0.06,0.85,89,84,80,4,1.06,95.24,80,9,89.45,Facile,Trop Facile,Facile / Trop Facile
313,314,2015,Informatique,12,2,QCM,0.0329,0.71,0.29,64,17,2,15,3.76,11.76,2,62,3.29,Trop Facile,Trop Difficile,Trop Facile / Trop Difficile
1143,314,2016,Informatique,12,2,QCM,0.7962,0.01,0.78,51,46,41,5,1.11,89.13,41,10,79.62,Facile,Facile,Facile / Facile
1973,314,2017,Informatique,12,2,QCM,0.1988,0.22,0.21,44,33,9,24,1.33,27.27,9,35,19.88,Facile,Trop Difficile,Facile / Trop Difficile
2803,314,2018,Informatique,12,2,QCM,0.9255,0.02,0.85,37,35,34,1,1.06,97.14,34,3,92.55,Facile,Trop Facile,Facile / Trop Facile
3633,314,2019,Informatique,12,2,QCM,0.2533,0.02,0.34,35,10,9,1,3.5,90.0,9,26,25.33,Facile,Difficile,Facile / Difficile
4463,314,2020,Informatique,12,2,QCM,0.8371,0.16,0.8,33,31,28,3,1.06,90.32,28,5,83.71,Facile,Facile,Facile / Facile
314,315,2015,Informatique,12,3,QCM,0.3479,0.34,0.36,32,17,11,6,1.88,64.71,11,21,34.79,Facile,Difficile,Facile / Difficile
1144,315,2016,Informatique,12,3,QCM,0.162,0.35,0.21,38,32,6,26,1.19,18.75,6,32,16.2,Facile,Trop Difficile,Facile / Trop Difficile
1974,315,2017,Informatique,12,3,QCM,0.7769,0.13,0.71,43,38,33,5,1.13,86.84,33,10,77.69,Facile,Facile,Facile / Facile
2804,315,2018,Informatique,12,3,QCM,0.0208,0.45,0.29,52,14,1,13,3.71,7.14,1,51,2.08,Facile,Trop Difficile,Facile / Trop Difficile
3634,315,2019,Informatique,12,3,QCM,0.8101,0.18,0.76,49,45,40,5,1.09,88.89,40,9,81.01,Facile,Facile,Facile / Facile
4464,315,2020,Informatique,12,3,QCM,0.805,0.02,0.8,59,59,47,12,1.0,79.66,47,12,80.5,Facile,Facile,Facile / Facile
315,316,2015,Informatique,12,4,QCM,0.0508,0.58,0.21,60,59,3,56,1.02,5.08,3,57,5.08,Trop Difficile,Trop Difficile,Trop Difficile / Trop Difficile
1145,316,2016,Informatique,12,4,QCM,0.9989,0.08,0.93,56,56,56,0,1.0,100.0,56,0,99.89,Facile,Trop Facile,Facile / Trop Facile
1975,316,2017,Informatique,12,4,QCM,0.7091,0.27,0.6,55,40,39,1,1.38,97.5,39,16,70.91,Facile,Adapte,Facile / Adapte
2805,316,2018,Informatique,12,4,QCM,0.6595,0.03,0.62,48,40,32,8,1.2,80.0,32,16,65.95,Adapte,Adapte,Adapte / Adapte
3635,316,2019,Informatique,12,4,QCM,0.74,0.13,0.43,54,51,40,11,1.06,78.43,40,14,74.0,Adapte,Adapte,Adapte / Adapte
4465,316,2020,Informatique,12,4,QCM,0.6591,0.25,0.65,48,33,32,1,1.45,96.97,32,16,65.91,Adapte,Adapte,Adapte / Adapte
316,317,2015,Informatique,12,5,QCM,0.7941,0.16,0.74,11,11,9,2,1.0,81.82,9,2,79.41,Facile,Facile,Facile / Facile
1146,317,2016,Informatique,12,5,QCM,0.7875,0.17,0.76,9,8,7,1,1.12,87.5,7,2,78.75,Facile,Facile,Facile / Facile
1976,317,2017,Informatique,12,5,QCM,0.516,0.06,0.31,8,8,4,4,1.0,50.0,4,4,51.6,Facile,Difficile,Facile / Difficile
2806,317,2018,Informatique,12,5,QCM,0.78,0.13,0.79,8,7,6,1,1.14,85.71,6,2,78.0,Facile,Facile,Facile / Facile
3636,317,2019,Informatique,12,5,QCM,0.9098,0.03,0.82,7,7,6,1,1.0,85.71,6,1,90.98,Facile,Trop Facile,Facile / Trop Facile
4466,317,2020,Informatique,12,5,QCM,0.8042,0.14,0.75,8,6,6,0,1.33,100.0,6,2,80.42,Facile,Facile,Facile / Facile
317,318,2015,Informatique,12,6,QCM,0.8927,0.02,0.81,27,26,24,2,1.04,92.31,24,3,89.27,Trop Difficile,Trop Facile,Trop Difficile / Trop Facile
1147,318,2016,Informatique,12,6,QCM,0.7729,0.05,0.79,29,24,22,2,1.21,91.67,22,7,77.29,Facile,Facile,Facile / Facile
1977,318,2017,Informatique,12,6,QCM,0.7915,0.09,0.71,24,19,19,0,1.26,100.0,19,5,79.15,Facile,Facile,Facile / Facile
2807,318,2018,Informatique,12,6,QCM,0.79,0.15,0.74,24,21,19,2,1.14,90.48,19,5,79.0,Facile,Facile,Facile / Facile
3637,318,2019,Informatique,12,6,QCM,0.8498,0.07,0.75,19,17,16,1,1.12,94.12,16,3,84.98,Facile,Facile,Facile / Facile
4467,318,2020,Informatique,12,6,QCM,0.4064,0.3,0.34,23,20,9,11,1.15,45.0,9,14,40.64,Facile,Difficile,Facile / Difficile
318,319,2015,Informatique,12,7,QCM,0.7063,0.19,0.53,29,25,20,5,1.16,80.0,20,9,70.63,Adapte,Adapte,Adapte / Adapte
1148,319,2016,Informatique,12,7,QCM,0.6472,0.16,0.69,28,25,18,7,1.12,72.0,18,10,64.72,Adapte,Adapte,Adapte / Adapte
1978,319,2017,Informatique,12,7,QCM,0.7141,0.0,0.63,26,24,19,5,1.08,79.17,19,7,71.41,Adapte,Adapte,Adapte / Adapte
2808,319,2018,Informatique,12,7,QCM,0.7379,0.29,0.69,26,19,19,0,1.37,100.0,19,7,73.79,Adapte,Adapte,Adapte / Adapte
3638,319,2019,Informatique,12,7,QCM,0.7126,0.05,0.45,23,22,16,6,1.05,72.73,16,7,71.26,Adapte,Adapte,Adapte / Adapte
4468,319,2020,Informatique,12,7,QCM,0.6139,0.13,0.49,21,19,13,6,1.11,68.42,13,8,61.39,Adapte,Adapte,Adapte / Adapte
319,320,2015,Informatique,12,8,QROC,0.2075,0.84,0.06,97,74,20,54,1.31,27.03,20,77,20.75,Trop Difficile,Trop Difficile,Trop Difficile / Trop Difficile
1149,320,2016,Informatique,12,8,QROC,0.6602,0.49,0.29,100,69,66,3,1.45,95.65,66,34,66.02,Facile,Adapte,Facile / Adapte
1979,320,2017,Informatique,12,8,QROC,0.7484,0.36,0.26,93,90,70,20,1.03,77.78,70,23,74.84,Adapte,Adapte,Adapte / Adapte
2809,320,2018,Informatique,12,8,QROC,0.6521,0.44,0.39,80,65,52,13,1.23,80.0,52,28,65.21,Adapte,Adapte,Adapte / Adapte
3639,320,2019,Informatique,12,8,QROC,0.6057,0.4,0.25,68,54,41,13,1.26,75.93,41,27,60.57,Adapte,Adapte,Adapte / Adapte
4469,320,2020,Informatique,12,8,QROC,0.6282,0.32,0.35,70,61,44,17,1.15,72.13,44,26,62.82,Adapte,Adapte,Adapte / Adapte
320,321,2015,Informatique,12,9,QCU,0.1538,0.1,0.21,39,36,6,30,1.08,16.67,6,33,15.38,Facile,Trop Difficile,Facile / Trop Difficile
1150,321,2016,Informatique,12,9,QCU,0.9824,0.1,0.94,46,45,45,0,1.02,100.0,45,1,98.24,Trop Facile,Trop Facile,Trop Facile / Trop Facile
1980,321,2017,Informatique,12,9,QCU,0.9755,0.07,0.98,51,50,50,0,1.02,100.0,50,1,97.55,Trop Facile,Trop Facile,Trop Facile / Trop Facile
2810,321,2018,Informatique,12,9,QCU,0.8094,0.13,0.85,56,55,45,10,1.02,81.82,45,11,80.94,Trop Facile,Facile,Trop Facile / Facile
3640,321,2019,Informatique,12,9,QCU,0.9543,0.04,0.92,49,47,47,0,1.04,100.0,47,2,95.43,Trop Facile,Trop Facile,Trop Facile / Trop Facile
4470,321,2020,Informatique,12,9,QCU,0.873,0.01,0.92,48,45,42,3,1.07,93.33,42,6,87.3,Trop Facile,Trop Facile,Trop Facile / Trop Facile
321,322,2015,Informatique,12,10,QCU,0.6145,0.1,0.57,31,19,19,0,1.63,100.0,19,12,61.45,Adapte,Adapte,Adapte / Adapte
1151,322,2016,Informatique,12,10,QCU,0.6862,0.04,0.5,36,25,25,0,1.44,100.0,25,11,68.62,Adapte,Adapte,Adapte / Adapte
1981,322,2017,Informatique,12,10,QCU,0.6604,0.27,0.44,33,26,22,4,1.27,84.62,22,11,66.04,Adapte,Adapte,Adapte / Adapte
2811,322,2018,Informatique,12,10,QCU,0.7014,0.1,0.49,38,35,27,8,1.09,77.14,27,11,70.14,Adapte,Adapte,Adapte / Adapte
3641,322,2019,Informatique,12,10,QCU,0.6623,0.09,0.58,30,29,20,9,1.03,68.97,20,10,66.23,Adapte,Adapte,Adapte / Adapte
4471,322,2020,Informatique,12,10,QCU,0.665,0.18,0.47,29,23,19,4,1.26,82.61,19,10,66.5,Adapte,Adapte,Adapte / Adapte
322,323,2015,Informatique,12,11,QCU,0.4432,0.01,0.36,8,6,4,2,1.33,66.67,4,4,44.32,Difficile,Difficile,Difficile / Difficile
1152,323,2016,Informatique,12,11,QCU,0.8962,0.06,0.99,9,9,8,1,1.0,88.89,8,1,89.62,Trop Facile,Trop Facile,Trop Facile / Trop Facile
1982,323,2017,Informatique,12,11,QCU,0.5662,0.35,0.38,7,7,4,3,1.0,57.14,4,3,56.62,Trop Facile,Difficile,Trop Facile / Difficile
2812,323,2018,Informatique,12,11,QCU,0.8726,0.07,0.99,7,6,6,0,1.17,100.0,6,1,87.26,Trop Facile,Trop Facile,Trop Facile / Trop Facile
3642,323,2019,Informatique,12,11,QCU,0.9053,0.09,0.97,6,5,5,0,1.2,100.0,5,1,90.53,Trop Facile,Trop Facile,Trop Facile / Trop Facile
4472,323,2020,Informatique,12,11,QCU,0.8985,0.1,1.0,5,4,4,0,1.25,100.0,4,1,89.85,Trop Facile,Trop Facile,Trop Facile / Trop Facile
323,324,2015,Informatique,12,12,QCM,0.8628,0.01,0.94,87,85,75,10,1.02,88.24,75,12,86.28,Trop Facile,Trop Facile,Trop Facile / Trop Facile
1153,324,2016,Informatique,12,12,QCM,0.8066,0.15,0.77,73,71,59,12,1.03,83.1,59,14,80.66,Facile,Facile,Facile / Facile
1983,324,2017,Informatique,12,12,QCM,0.7947,0.13,0.76,60,53,48,5,1.13,90.57,48,12,79.47,Facile,Facile,Facile / Facile
2813,324,2018,Informatique,12,12,QCM,0.8033,0.02,0.74,57,53,46,7,1.08,86.79,46,11,80.33,Facile,Facile,Facile / Facile
3643,324,2019,Informatique,12,12,QCM,0.3397,0.21,0.35,61,28,21,7,2.18,75.0,21,40,33.97,Facile,Difficile,Facile / Difficile
4473,324,2020,Informatique,12,12,QCM,0.8431,0.19,0.73,57,51,48,3,1.12,94.12,48,9,84.31,Facile,Facile,Facile / Facile
324,325,2015,Informatique,12,13,QROC,0.8432,0.15,0.59,9,8,8,0,1.12,100.0,8,1,84.32,Facile,Facile,Facile / Facile
1154,325,2016,Informatique,12,13,QROC,0.8305,0.12,0.58,10,8,8,0,1.25,100.0,8,2,83.05,Facile,Facile,Facile / Facile
1984,325,2017,Informatique,12,13,QROC,0.7745,0.04,0.43,10,9,8,1,1.11,88.89,8,2,77.45,Facile,Facile,Facile / Facile
2814,325,2018,Informatique,12,13,QROC,0.8258,0.05,0.42,8,7,7,0,1.14,100.0,7,1,82.58,Facile,Facile,Facile / Facile
3644,325,2019,Informatique,12,13,QROC,0.8193,0.12,0.72,9,8,7,1,1.12,87.5,7,2,81.93,Facile,Facile,Facile / Facile
4474,325,2020,Informatique,12,13,QROC,0.8426,0.13,0.56,8,7,7,0,1.14,100.0,7,1,84.26,Facile,Facile,Facile / Facile
325,326,2015,Informatique,12,14,QCU,0.7891,0.16,0.75,98,94,77,17,1.04,81.91,77,21,78.91,Facile,Facile,Facile / Facile
1155,326,2016,Informatique,12,14,QCU,0.9494,0.02,0.92,116,111,110,1,1.05,99.1,110,6,94.94,Trop Facile,Trop Facile,Trop Facile / Trop Facile
1985,326,2017,Informatique,12,14,QCU,0.9007,0.02,1.0,111,104,100,4,1.07,96.15,100,11,90.07,Trop Facile,Trop Facile,Trop Facile / Trop Facile
2815,326,2018,Informatique,12,14,QCU,0.8808,0.01,0.97,133,131,117,14,1.02,89.31,117,16,88.08,Trop Facile,Trop Facile,Trop Facile / Trop Facile
3645,326,2019,Informatique,12,14,QCU,0.7908,0.18,0.77,141,127,112,15,1.11,88.19,112,29,79.08,Trop Facile,Facile,Trop Facile / Facile
4475,326,2020,Informatique,12,14,QCU,0.8359,0.07,0.85,150,128,125,3,1.17,97.66,125,25,83.59,Trop Facile,Facile,Trop Facile / Facile
326,327,2015,Informatique,13,1,QCU,0.6883,0.12,0.51,39,32,27,5,1.22,84.38,27,12,68.83,Adapte,Adapte,Adapte / Adapte
1156,327,2016,Informatique,13,1,QCU,0.7086,0.09,0.64,41,34,29,5,1.21,85.29,29,12,70.86,Adapte,Adapte,Adapte / Adapte
1986,327,2017,Informatique,13,1,QCU,0.7297,0.02,0.65,40,35,29,6,1.14,82.86,29,11,72.97,Adapte,Adapte,Adapte / Adapte
2816,327,2018,Informatique,13,1,QCU,0.6093,0.28,0.49,40,31,24,7,1.29,77.42,24,16,60.93,Adapte,Adapte,Adapte / Adapte
3646,327,2019,Informatique,13,1,QCU,0.6116,0.05,0.55,37,24,23,1,1.54,95.83,23,14,61.16,Adapte,Adapte,Adapte / Adapte
4476,327,2020,Informatique,13,1,QCU,0.7279,0.22,0.45,33,25,24,1,1.32,96.0,24,9,72.79,Adapte,Adapte,Adapte / Adapte
327,328,2015,Informatique,13,2,QROC,0.2805,0.67,0.2,44,34,12,22,1.29,35.29,12,32,28.05,Adapte,Difficile,Adapte / Difficile
1157,328,2016,Informatique,13,2,QROC,0.7831,0.11,0.58,52,44,41,3,1.18,93.18,41,11,78.31,Facile,Facile,Facile / Facile
1987,328,2017,Informatique,13,2,QROC,0.9539,0.09,0.6,61,61,58,3,1.0,95.08,58,3,95.39,Facile,Trop Facile,Facile / Trop Facile
2817,328,2018,Informatique,13,2,QROC,0.7792,0.15,0.65,58,49,45,4,1.18,91.84,45,13,77.92,Facile,Facile,Facile / Facile
3647,328,2019,Informatique,13,2,QROC,0.764,0.04,0.47,61,57,47,10,1.07,82.46,47,14,76.4,Facile,Facile,Facile / Facile
4477,328,2020,Informatique,13,2,QROC,0.7021,0.42,0.32,70,57,49,8,1.23,85.96,49,21,70.21,Facile,Adapte,Facile / Adapte
328,329,2015,Informatique,14,1,QROC,0.2019,0.88,0.12,74,40,15,25,1.85,37.5,15,59,20.19,Trop Difficile,Trop Difficile,Trop Difficile / Trop Difficile
1158,329,2016,Informatique,14,1,QROC,0.8315,0.19,0.68,78,78,65,13,1.0,83.33,65,13,83.15,Facile,Facile,Facile / Facile
1988,329,2017,Informatique,14,1,QROC,0.776,0.04,0.49,82,75,64,11,1.09,85.33,64,18,77.6,Facile,Facile,Facile / Facile
2818,329,2018,Informatique,14,1,QROC,0.7801,0.11,0.48,84,78,66,12,1.08,84.62,66,18,78.01,Facile,Facile,Facile / Facile
3648,329,2019,Informatique,14,1,QROC,0.7891,0.09,0.49,69,56,54,2,1.23,96.43,54,15,78.91,Facile,Facile,Facile / Facile
4478,329,2020,Informatique,14,1,QROC,0.7674,0.04,0.52,71,67,54,13,1.06,80.6,54,17,76.74,Facile,Facile,Facile / Facile
329,330,2015,Informatique,14,2,QCM,0.819,0.05,0.72,64,64,52,12,1.0,81.25,52,12,81.9,Facile,Facile,Facile / Facile
1159,330,2016,Informatique,14,2,QCM,0.0769,0.09,0.25,67,60,5,55,1.12,8.33,5,62,7.69,Facile,Trop Difficile,Facile / Trop Difficile
1989,330,2017,Informatique,14,2,QCM,0.812,0.09,0.73,57,49,46,3,1.16,93.88,46,11,81.2,Facile,Facile,Facile / Facile
2819,330,2018,Informatique,14,2,QCM,0.1572,0.62,0.2,55,30,9,21,1.83,30.0,9,46,15.72,Facile,Trop Difficile,Facile / Trop Difficile
3649,330,2019,Informatique,14,2,QCM,0.788,0.09,0.75,59,48,46,2,1.23,95.83,46,13,78.8,Facile,Facile,Facile / Facile
4479,330,2020,Informatique,14,2,QCM,0.832,0.11,0.75,47,41,39,2,1.15,95.12,39,8,83.2,Facile,Facile,Facile / Facile
330,331,2015,Informatique,14,3,QROC,0.7164,0.37,0.31,43,33,31,2,1.3,93.94,31,12,71.64,Adapte,Adapte,Adapte / Adapte
1160,331,2016,Informatique,14,3,QROC,0.6349,0.22,0.35,49,41,31,10,1.2,75.61,31,18,63.49,Adapte,Adapte,Adapte / Adapte
1990,331,2017,Informatique,14,3,QROC,0.7373,0.31,0.36,42,34,31,3,1.24,91.18,31,11,73.73,Adapte,Adapte,Adapte / Adapte
2820,331,2018,Informatique,14,3,QROC,0.7288,0.25,0.25,48,46,35,11,1.04,76.09,35,13,72.88,Adapte,Adapte,Adapte / Adapte
3650,331,2019,Informatique,14,3,QROC,0.6605,0.4,0.3,39,38,26,12,1.03,68.42,26,13,66.05,Adapte,Adapte,Adapte / Adapte
4480,331,2020,Informatique,14,3,QROC,0.719,0.46,0.35,45,43,32,11,1.05,74.42,32,13,71.9,Adapte,Adapte,Adapte / Adapte
331,332,2015,Informatique,14,4,QCU,0.4393,0.38,0.35,34,20,15,5,1.7,75.0,15,19,43.93,Difficile,Difficile,Difficile / Difficile
1161,332,2016,Informatique,14,4,QCU,0.0988,0.35,0.24,33,20,3,17,1.65,15.0,3,30,9.88,Trop Facile,Trop Difficile,Trop Facile / Trop Difficile
1991,332,2017,Informatique,14,4,QCU,0.6746,0.06,0.62,40,38,27,11,1.05,71.05,27,13,67.46,Trop Facile,Adapte,Trop Facile / Adapte
2821,332,2018,Informatique,14,4,QCU,0.6299,0.15,0.62,47,44,30,14,1.07,68.18,30,17,62.99,Adapte,Adapte,Adapte / Adapte
3651,332,2019,Informatique,14,4,QCU,0.6319,0.21,0.57,46,29,29,0,1.59,100.0,29,17,63.19,Adapte,Adapte,Adapte / Adapte
4481,332,2020,Informatique,14,4,QCU,0.6767,0.12,0.68,44,30,30,0,1.47,100.0,30,14,67.67,Adapte,Adapte,Adapte / Adapte
332,333,2015,Informatique,14,5,QROC,0.523,0.71,0.23,77,61,40,21,1.26,65.57,40,37,52.3,Trop Facile,Difficile,Trop Facile / Difficile
1162,333,2016,Informatique,14,5,QROC,0.8664,0.09,0.7,76,73,66,7,1.04,90.41,66,10,86.64,Facile,Trop Facile,Facile / Trop Facile
1992,333,2017,Informatique,14,5,QROC,0.8011,0.13,0.72,88,71,70,1,1.24,98.59,70,18,80.11,Facile,Facile,Facile / Facile
2822,333,2018,Informatique,14,5,QROC,0.9468,0.05,0.95,72,69,68,1,1.04,98.55,68,4,94.68,Facile,Trop Facile,Facile / Trop Facile
3652,333,2019,Informatique,14,5,QROC,0.8224,0.07,0.43,79,68,65,3,1.16,95.59,65,14,82.24,Facile,Facile,Facile / Facile
4482,333,2020,Informatique,14,5,QROC,0.9348,0.03,0.97,72,71,67,4,1.01,94.37,67,5,93.48,Facile,Trop Facile,Facile / Trop Facile
333,334,2015,Informatique,14,6,QCU,0.5061,0.14,0.33,15,13,8,5,1.15,61.54,8,7,50.61,Difficile,Difficile,Difficile / Difficile
1163,334,2016,Informatique,14,6,QCU,0.8948,0.03,1.0,15,14,13,1,1.07,92.86,13,2,89.48,Trop Facile,Trop Facile,Trop Facile / Trop Facile
1993,334,2017,Informatique,14,6,QCU,0.4512,0.34,0.33,12,9,5,4,1.33,55.56,5,7,45.12,Trop Facile,Difficile,Trop Facile / Difficile
2823,334,2018,Informatique,14,6,QCU,0.9079,0.03,0.96,10,10,9,1,1.0,90.0,9,1,90.79,Trop Facile,Trop Facile,Trop Facile / Trop Facile
3653,334,2019,Informatique,14,6,QCU,0.8975,0.01,0.95,11,10,10,0,1.1,100.0,10,1,89.75,Trop Facile,Trop Facile,Trop Facile / Trop Facile
4483,334,2020,Informatique,14,6,QCU,0.2155,0.56,0.23,13,9,3,6,1.44,33.33,3,10,21.55,Trop Facile,Trop Difficile,Trop Facile / Trop Difficile
334,335,2015,Informatique,14,7,QCU,0.4975,0.06,0.34,13,7,6,1,1.86,85.71,6,7,49.75,Trop Difficile,Difficile,Trop Difficile / Difficile
1164,335,2016,Informatique,14,7,QCU,0.9516,0.08,0.92,10,10,10,0,1.0,100.0,10,0,95.16,Trop Facile,Trop Facile,Trop Facile / Trop Facile
1994,335,2017,Informatique,14,7,QCU,0.8655,0.05,1.0,9,8,8,0,1.12,100.0,8,1,86.55,Trop Facile,Trop Facile,Trop Facile / Trop Facile
2824,335,2018,Informatique,14,7,QCU,0.9448,0.01,0.91,8,8,8,0,1.0,100.0,8,0,94.48,Trop Facile,Trop Facile,Trop Facile / Trop Facile
3654,335,2019,Informatique,14,7,QCU,0.9814,0.04,1.0,7,7,7,0,1.0,100.0,7,0,98.14,Trop Facile,Trop Facile,Trop Facile / Trop Facile
4484,335,2020,Informatique,14,7,QCU,0.098,0.31,0.23,8,3,1,2,2.67,33.33,1,7,9.8,Trop Facile,Trop Difficile,Trop Facile / Trop Difficile
335,336,2015,Informatique,14,8,QROC,0.7811,0.03,0.48,84,67,66,1,1.25,98.51,66,18,78.11,Facile,Facile,Facile / Facile
1165,336,2016,Informatique,14,8,QROC,0.7737,0.05,0.51,100,90,77,13,1.11,85.56,77,23,77.37,Facile,Facile,Facile / Facile
1995,336,2017,Informatique,14,8,QROC,0.8343,0.11,0.45,98,88,82,6,1.11,93.18,82,16,83.43,Facile,Facile,Facile / Facile
2825,336,2018,Informatique,14,8,QROC,0.7785,0.14,0.47,85,85,66,19,1.0,77.65,66,19,77.85,Facile,Facile,Facile / Facile
3655,336,2019,Informatique,14,8,QROC,0.8213,0.18,0.63,89,74,73,1,1.2,98.65,73,16,82.13,Facile,Facile,Facile / Facile
4485,336,2020,Informatique,14,8,QROC,0.7894,0.2,0.54,80,71,63,8,1.13,88.73,63,17,78.94,Facile,Facile,Facile / Facile
336,337,2015,Informatique,14,9,QCM,0.9376,0.02,0.86,44,43,41,2,1.02,95.35,41,3,93.76,Trop Facile,Trop Facile,Trop Facile / Trop Facile
1166,337,2016,Informatique,14,9,QCM,0.3667,0.48,0.3,40,26,15,11,1.54,57.69,15,25,36.67,Facile,Difficile,Facile / Difficile
1996,337,2017,Informatique,14,9,QCM,0.8205,0.13,0.8,36,33,30,3,1.09,90.91,30,6,82.05,Facile,Facile,Facile / Facile
2826,337,2018,Informatique,14,9,QCM,0.7881,0.09,0.78,39,39,31,8,1.0,79.49,31,8,78.81,Facile,Facile,Facile / Facile
3656,337,2019,Informatique,14,9,QCM,0.7712,0.12,0.74,39,30,30,0,1.3,100.0,30,9,77.12,Facile,Facile,Facile / Facile
4486,337,2020,Informatique,14,9,QCM,0.7615,0.16,0.75,38,38,29,9,1.0,76.32,29,9,76.15,Facile,Facile,Facile / Facile
337,338,2015,Informatique,14,10,QCM,0.3043,0.05,0.35,7,3,2,1,2.33,66.67,2,5,30.43,Facile,Difficile,Facile / Difficile
1167,338,2016,Informatique,14,10,QCM,0.8166,0.11,0.72,7,6,6,0,1.17,100.0,6,1,81.66,Facile,Facile,Facile / Facile
1997,338,2017,Informatique,14,10,QCM,0.6285,0.27,0.65,7,7,4,3,1.0,57.14,4,3,62.85,Facile,Adapte,Facile / Adapte
2827,338,2018,Informatique,14,10,QCM,0.6958,0.04,0.57,7,7,5,2,1.0,71.43,5,2,69.58,Adapte,Adapte,Adapte / Adapte
3657,338,2019,Informatique,14,10,QCM,0.6595,0.15,0.68,7,6,5,1,1.17,83.33,5,2,65.95,Adapte,Adapte,Adapte / Adapte
4487,338,2020,Informatique,14,10,QCM,0.6326,0.09,0.57,8,5,5,0,1.6,100.0,5,3,63.26,Adapte,Adapte,Adapte / Adapte
338,339,2015,Informatique,14,11,QROC,0.9793,0.08,0.82,32,31,31,0,1.03,100.0,31,1,97.93,Trop Difficile,Trop Facile,Trop Difficile / Trop Facile
1168,339,2016,Informatique,14,11,QROC,0.2703,0.74,0.23,37,33,10,23,1.12,30.3,10,27,27.03,Facile,Difficile,Facile / Difficile
1998,339,2017,Informatique,14,11,QROC,0.4778,0.51,0.16,32,17,15,2,1.88,88.24,15,17,47.78,Facile,Difficile,Facile / Difficile
2828,339,2018,Informatique,14,11,QROC,0.8394,0.2,0.62,36,31,30,1,1.16,96.77,30,6,83.94,Facile,Facile,Facile / Facile
3658,339,2019,Informatique,14,11,QROC,0.7921,0.02,0.44,41,36,32,4,1.14,88.89,32,9,79.21,Facile,Facile,Facile / Facile
4488,339,2020,Informatique,14,11,QROC,0.801,0.09,0.48,42,40,34,6,1.05,85.0,34,8,80.1,Facile,Facile,Facile / Facile
339,340,2015,Informatique,15,1,QCM,0.2623,0.28,0.34,87,68,23,45,1.28,33.82,23,64,26.23,Difficile,Difficile,Difficile / Difficile
1169,340,2016,Informatique,15,1,QCM,0.8481,0.06,0.77,82,70,70,0,1.17,100.0,70,12,84.81,Facile,Facile,Facile / Facile
1999,340,2017,Informatique,15,1,QCM,0.7884,0.15,0.7,83,69,65,4,1.2,94.2,65,18,78.84,Facile,Facile,Facile / Facile
2829,340,2018,Informatique,15,1,QCM,0.8253,0.01,0.72,94,81,78,3,1.16,96.3,78,16,82.53,Facile,Facile,Facile / Facile
3659,340,2019,Informatique,15,1,QCM,0.8129,0.0,0.73,79,74,64,10,1.07,86.49,64,15,81.29,Facile,Facile,Facile / Facile
4489,340,2020,Informatique,15,1,QCM,0.8336,0.09,0.75,78,69,65,4,1.13,94.2,65,13,83.36,Facile,Facile,Facile / Facile
340,341,2015,Art,1,1,QCM,0.0242,0.06,0.25,72,35,2,33,2.06,5.71,2,70,2.42,Difficile,Trop Difficile,Difficile / Trop Difficile
1170,341,2016,Art,1,1,QCM,0.7733,0.06,0.73,86,69,67,2,1.25,97.1,67,19,77.33,Facile,Facile,Facile / Facile
2000,341,2017,Art,1,1,QCM,0.7891,0.04,0.71,82,81,65,16,1.01,80.25,65,17,78.91,Facile,Facile,Facile / Facile
2830,341,2018,Art,1,1,QCM,0.8194,0.02,0.71,83,75,68,7,1.11,90.67,68,15,81.94,Facile,Facile,Facile / Facile
3660,341,2019,Art,1,1,QCM,0.8408,0.04,0.73,77,75,65,10,1.03,86.67,65,12,84.08,Facile,Facile,Facile / Facile
4490,341,2020,Art,1,1,QCM,0.7908,0.13,0.8,86,82,68,14,1.05,82.93,68,18,79.08,Facile,Facile,Facile / Facile
341,342,2015,Art,1,2,QROC,0.8301,0.18,0.54,56,48,46,2,1.17,95.83,46,10,83.01,Trop Difficile,Facile,Trop Difficile / Facile
1171,342,2016,Art,1,2,QROC,0.6261,0.23,0.26,53,34,33,1,1.56,97.06,33,20,62.61,Facile,Adapte,Facile / Adapte
2001,342,2017,Art,1,2,QROC,0.6198,0.34,0.39,64,58,40,18,1.1,68.97,40,24,61.98,Adapte,Adapte,Adapte / Adapte
2831,342,2018,Art,1,2,QROC,0.7488,0.39,0.29,54,49,40,9,1.1,81.63,40,14,74.88,Adapte,Adapte,Adapte / Adapte
3661,342,2019,Art,1,2,QROC,0.7034,0.28,0.26,64,63,45,18,1.02,71.43,45,19,70.34,Adapte,Adapte,Adapte / Adapte
4491,342,2020,Art,1,2,QROC,0.6407,0.29,0.35,63,41,40,1,1.54,97.56,40,23,64.07,Adapte,Adapte,Adapte / Adapte
342,343,2015,Art,1,3,QCM,0.0862,0.18,0.2,45,39,4,35,1.15,10.26,4,41,8.62,Trop Difficile,Trop Difficile,Trop Difficile / Trop Difficile
1172,343,2016,Art,1,3,QCM,0.8737,0.05,0.96,54,54,47,7,1.0,87.04,47,7,87.37,Facile,Trop Facile,Facile / Trop Facile
2002,343,2017,Art,1,3,QCM,0.8769,0.09,0.88,46,42,40,2,1.1,95.24,40,6,87.69,Facile,Trop Facile,Facile / Trop Facile
2832,343,2018,Art,1,3,QCM,0.5202,0.07,0.35,45,24,23,1,1.88,95.83,23,22,52.02,Facile,Difficile,Facile / Difficile
3662,343,2019,Art,1,3,QCM,0.8245,0.19,0.76,49,46,40,6,1.07,86.96,40,9,82.45,Facile,Facile,Facile / Facile
4492,343,2020,Art,1,3,QCM,0.7392,0.07,0.6,47,46,35,11,1.02,76.09,35,12,73.92,Facile,Adapte,Facile / Adapte
343,344,2015,Art,1,4,QROC,0.3649,0.71,0.21,73,67,27,40,1.09,40.3,27,46,36.49,Adapte,Difficile,Adapte / Difficile
1173,344,2016,Art,1,4,QROC,0.7642,0.01,0.41,76,64,58,6,1.19,90.62,58,18,76.42,Facile,Facile,Facile / Facile
2003,344,2017,Art,1,4,QROC,0.9116,0.05,0.55,88,82,80,2,1.07,97.56,80,8,91.16,Facile,Trop Facile,Facile / Trop Facile
2833,344,2018,Art,1,4,QROC,0.1453,0.82,0.06,81,55,12,43,1.47,21.82,12,69,14.53,Facile,Trop Difficile,Facile / Trop Difficile
3663,344,2019,Art,1,4,QROC,0.7723,0.0,0.56,65,63,50,13,1.03,79.37,50,15,77.23,Facile,Facile,Facile / Facile
4493,344,2020,Art,1,4,QROC,0.3144,0.56,0.24,52,27,16,11,1.93,59.26,16,36,31.44,Facile,Difficile,Facile / Difficile
344,345,2015,Art,1,5,QCU,0.1705,0.13,0.23,79,48,13,35,1.65,27.08,13,66,17.05,Trop Difficile,Trop Difficile,Trop Difficile / Trop Difficile
1174,345,2016,Art,1,5,QCU,0.874,0.01,0.93,67,66,59,7,1.02,89.39,59,8,87.4,Trop Facile,Trop Facile,Trop Facile / Trop Facile
2004,345,2017,Art,1,5,QCU,0.8999,0.02,0.93,54,50,49,1,1.08,98.0,49,5,89.99,Trop Facile,Trop Facile,Trop Facile / Trop Facile
2834,345,2018,Art,1,5,QCU,0.3209,0.21,0.34,46,23,15,8,2.0,65.22,15,31,32.09,Trop Facile,Difficile,Trop Facile / Difficile
3664,345,2019,Art,1,5,QCU,0.9991,0.05,0.97,49,49,49,0,1.0,100.0,49,0,99.91,Trop Facile,Trop Facile,Trop Facile / Trop Facile
4494,345,2020,Art,1,5,QCU,0.8622,0.08,0.91,54,47,47,0,1.15,100.0,47,7,86.22,Trop Facile,Trop Facile,Trop Facile / Trop Facile
345,346,2015,Art,1,6,QCM,0.8393,0.04,0.79,43,38,36,2,1.13,94.74,36,7,83.93,Facile,Facile,Facile / Facile
1175,346,2016,Art,1,6,QCM,0.5623,0.31,0.35,41,27,23,4,1.52,85.19,23,18,56.23,Facile,Difficile,Facile / Difficile
2005,346,2017,Art,1,6,QCM,0.8236,0.1,0.74,44,38,36,2,1.16,94.74,36,8,82.36,Facile,Facile,Facile / Facile
2835,346,2018,Art,1,6,QCM,0.7717,0.02,0.78,50,44,39,5,1.14,88.64,39,11,77.17,Facile,Facile,Facile / Facile
3665,346,2019,Art,1,6,QCM,0.9253,0.0,0.9,57,53,53,0,1.08,100.0,53,4,92.53,Facile,Trop Facile,Facile / Trop Facile
4495,346,2020,Art,1,6,QCM,0.8025,0.15,0.77,68,57,55,2,1.19,96.49,55,13,80.25,Facile,Facile,Facile / Facile
346,347,2015,Art,1,7,QCU,0.9265,0.06,0.95,95,88,88,0,1.08,100.0,88,7,92.65,Trop Facile,Trop Facile,Trop Facile / Trop Facile
1176,347,2016,Art,1,7,QCU,0.9781,0.03,0.99,91,89,89,0,1.02,100.0,89,2,97.81,Trop Facile,Trop Facile,Trop Facile / Trop Facile
2006,347,2017,Art,1,7,QCU,0.8791,0.06,0.91,83,79,73,6,1.05,92.41,73,10,87.91,Trop Facile,Trop Facile,Trop Facile / Trop Facile
2836,347,2018,Art,1,7,QCU,0.8836,0.04,0.98,81,80,72,8,1.01,90.0,72,9,88.36,Trop Facile,Trop Facile,Trop Facile / Trop Facile
3666,347,2019,Art,1,7,QCU,0.792,0.11,0.81,77,68,61,7,1.13,89.71,61,16,79.2,Trop Facile,Facile,Trop Facile / Facile
4496,347,2020,Art,1,7,QCU,0.9467,0.09,0.93,75,74,71,3,1.01,95.95,71,4,94.67,Trop Facile,Trop Facile,Trop Facile / Trop Facile
347,348,2015,Art,1,8,QCU,0.1584,0.52,0.22,80,66,13,53,1.21,19.7,13,67,15.84,Trop Difficile,Trop Difficile,Trop Difficile / Trop Difficile
1177,348,2016,Art,1,8,QCU,0.8993,0.08,0.93,82,79,74,5,1.04,93.67,74,8,89.93,Trop Facile,Trop Facile,Trop Facile / Trop Facile
2007,348,2017,Art,1,8,QCU,0.9851,0.07,0.91,69,69,68,1,1.0,98.55,68,1,98.51,Trop Facile,Trop Facile,Trop Facile / Trop Facile
2837,348,2018,Art,1,8,QCU,0.5638,0.36,0.37,57,46,32,14,1.24,69.57,32,25,56.38,Trop Facile,Difficile,Trop Facile / Difficile
3667,348,2019,Art,1,8,QCU,0.915,0.0,0.95,55,53,50,3,1.04,94.34,50,5,91.5,Trop Facile,Trop Facile,Trop Facile / Trop Facile
4497,348,2020,Art,1,8,QCU,0.6884,0.25,0.45,51,50,35,15,1.02,70.0,35,16,68.84,Trop Facile,Adapte,Trop Facile / Adapte
348,349,2015,Art,2,1,QO,0.3345,0.86,0.06,6,5,2,3,1.2,40.0,2,4,33.45,Difficile,Difficile,Difficile / Difficile
1178,349,2016,Art,2,1,QO,0.6507,0.53,0.25,7,6,5,1,1.17,83.33,5,2,65.07,Adapte,Adapte,Adapte / Adapte
2008,349,2017,Art,2,1,QO,0.7484,0.73,0.17,8,6,6,0,1.33,100.0,6,2,74.84,Adapte,Adapte,Adapte / Adapte
2838,349,2018,Art,2,1,QO,0.7466,0.46,0.21,9,8,7,1,1.12,87.5,7,2,74.66,Adapte,Adapte,Adapte / Adapte
3668,349,2019,Art,2,1,QO,0.6453,0.4,0.27,9,7,6,1,1.29,85.71,6,3,64.53,Adapte,Adapte,Adapte / Adapte
4498,349,2020,Art,2,1,QO,0.7353,0.68,0.22,7,6,5,1,1.17,83.33,5,2,73.53,Adapte,Adapte,Adapte / Adapte
349,350,2015,Art,2,2,QCU,0.1006,0.18,0.28,76,49,8,41,1.55,16.33,8,68,10.06,Trop Difficile,Trop Difficile,Trop Difficile / Trop Difficile
1179,350,2016,Art,2,2,QCU,0.3735,0.22,0.32,83,66,31,35,1.26,46.97,31,52,37.35,Trop Facile,Difficile,Trop Facile / Difficile
2009,350,2017,Art,2,2,QCU,0.972,0.01,0.91,78,78,76,2,1.0,97.44,76,2,97.2,Trop Facile,Trop Facile,Trop Facile / Trop Facile
2839,350,2018,Art,2,2,QCU,0.8884,0.02,0.97,76,70,68,2,1.09,97.14,68,8,88.84,Trop Facile,Trop Facile,Trop Facile / Trop Facile
3669,350,2019,Art,2,2,QCU,0.5334,0.01,0.38,77,59,41,18,1.31,69.49,41,36,53.34,Trop Facile,Difficile,Trop Facile / Difficile
4499,350,2020,Art,2,2,QCU,0.9505,0.08,0.94,73,71,69,2,1.03,97.18,69,4,95.05,Trop Facile,Trop Facile,Trop Facile / Trop Facile
350,351,2015,Art,2,3,QCM,0.8303,0.2,0.76,36,30,30,0,1.2,100.0,30,6,83.03,Facile,Facile,Facile / Facile
1180,351,2016,Art,2,3,QCM,0.7904,0.06,0.8,29,23,23,0,1.26,100.0,23,6,79.04,Facile,Facile,Facile / Facile
2010,351,2017,Art,2,3,QCM,0.8322,0.02,0.75,27,23,22,1,1.17,95.65,22,5,83.22,Facile,Facile,Facile / Facile
2840,351,2018,Art,2,3,QCM,0.8487,0.17,0.8,23,21,20,1,1.1,95.24,20,3,84.87,Facile,Facile,Facile / Facile
3670,351,2019,Art,2,3,QCM,0.7941,0.16,0.74,24,21,19,2,1.14,90.48,19,5,79.41,Facile,Facile,Facile / Facile
4500,351,2020,Art,2,3,QCM,0.6998,0.14,0.6,28,23,20,3,1.22,86.96,20,8,69.98,Facile,Adapte,Facile / Adapte
351,352,2015,Art,2,4,QCU,0.7963,0.07,0.84,25,22,20,2,1.14,90.91,20,5,79.63,Facile,Facile,Facile / Facile
1181,352,2016,Art,2,4,QCU,0.8682,0.03,0.99,23,22,20,2,1.05,90.91,20,3,86.82,Trop Facile,Trop Facile,Trop Facile / Trop Facile
2011,352,2017,Art,2,4,QCU,0.8795,0.04,0.93,19,19,17,2,1.0,89.47,17,2,87.95,Trop Facile,Trop Facile,Trop Facile / Trop Facile
2841,352,2018,Art,2,4,QCU,0.891,0.01,0.91,18,17,16,1,1.06,94.12,16,2,89.1,Trop Facile,Trop Facile,Trop Facile / Trop Facile
3671,352,2019,Art,2,4,QCU,0.8908,0.06,0.91,19,18,17,1,1.06,94.44,17,2,89.08,Trop Facile,Trop Facile,Trop Facile / Trop Facile
4501,352,2020,Art,2,4,QCU,0.8916,0.08,0.91,23,23,21,2,1.0,91.3,21,2,89.16,Trop Facile,Trop Facile,Trop Facile / Trop Facile
352,353,2015,Art,2,5,QCM,0.8383,0.05,0.73,95,90,80,10,1.06,88.89,80,15,83.83,Trop Facile,Facile,Trop Facile / Facile
1182,353,2016,Art,2,5,QCM,0.1953,0.34,0.21,111,105,22,83,1.06,20.95,22,89,19.53,Facile,Trop Difficile,Facile / Trop Difficile
2012,353,2017,Art,2,5,QCM,0.8492,0.2,0.74,131,118,111,7,1.11,94.07,111,20,84.92,Facile,Facile,Facile / Facile
2842,353,2018,Art,2,5,QCM,0.6803,0.0,0.52,117,90,80,10,1.3,88.89,80,37,68.03,Facile,Adapte,Facile / Adapte
3672,353,2019,Art,2,5,QCM,0.6269,0.04,0.44,121,120,76,44,1.01,63.33,76,45,62.69,Adapte,Adapte,Adapte / Adapte
4502,353,2020,Art,2,5,QCM,0.7498,0.13,0.49,112,100,84,16,1.12,84.0,84,28,74.98,Adapte,Adapte,Adapte / Adapte
353,354,2015,Art,2,6,QCU,0.7817,0.14,0.9,68,55,53,2,1.24,96.36,53,15,78.17,Adapte,Facile,Adapte / Facile
1183,354,2016,Art,2,6,QCU,0.8993,0.03,0.92,82,75,74,1,1.09,98.67,74,8,89.93,Trop Facile,Trop Facile,Trop Facile / Trop Facile
2013,354,2017,Art,2,6,QCU,0.9894,0.09,0.92,90,89,89,0,1.01,100.0,89,1,98.94,Trop Facile,Trop Facile,Trop Facile / Trop Facile
2843,354,2018,Art,2,6,QCU,0.5204,0.08,0.38,105,77,55,22,1.36,71.43,55,50,52.04,Trop Facile,Difficile,Trop Facile / Difficile
3673,354,2019,Art,2,6,QCU,0.8803,0.03,0.92,91,87,80,7,1.05,91.95,80,11,88.03,Trop Facile,Trop Facile,Trop Facile / Trop Facile
4503,354,2020,Art,2,6,QCU,0.8735,0.03,0.92,101,99,88,11,1.02,88.89,88,13,87.35,Trop Facile,Trop Facile,Trop Facile / Trop Facile
354,355,2015,Art,2,7,QCU,0.8389,0.05,0.77,94,87,79,8,1.08,90.8,79,15,83.89,Facile,Facile,Facile / Facile
1184,355,2016,Art,2,7,QCU,0.9457,0.07,0.99,113,108,107,1,1.05,99.07,107,6,94.57,Trop Facile,Trop Facile,Trop Facile / Trop Facile
2014,355,2017,Art,2,7,QCU,0.9933,0.02,0.99,105,104,104,0,1.01,100.0,104,1,99.33,Trop Facile,Trop Facile,Trop Facile / Trop Facile
2844,355,2018,Art,2,7,QCU,0.9476,0.09,0.95,113,112,107,5,1.01,95.54,107,6,94.76,Trop Facile,Trop Facile,Trop Facile / Trop Facile
3674,355,2019,Art,2,7,QCU,0.9537,0.02,0.97,115,114,110,4,1.01,96.49,110,5,95.37,Trop Facile,Trop Facile,Trop Facile / Trop Facile
4504,355,2020,Art,2,7,QCU,0.9386,0.08,0.93,132,130,124,6,1.02,95.38,124,8,93.86,Trop Facile,Trop Facile,Trop Facile / Trop Facile
355,356,2015,Art,2,8,QCM,0.8242,0.14,0.73,97,88,80,8,1.1,90.91,80,17,82.42,Facile,Facile,Facile / Facile
1185,356,2016,Art,2,8,QCM,0.8378,0.12,0.77,112,95,94,1,1.18,98.95,94,18,83.78,Facile,Facile,Facile / Facile
2015,356,2017,Art,2,8,QCM,0.7747,0.12,0.76,97,78,75,3,1.24,96.15,75,22,77.47,Facile,Facile,Facile / Facile
2845,356,2018,Art,2,8,QCM,0.7719,0.19,0.74,113,106,87,19,1.07,82.08,87,26,77.19,Facile,Facile,Facile / Facile
3675,356,2019,Art,2,8,QCM,0.836,0.08,0.72,129,113,108,5,1.14,95.58,108,21,83.6,Facile,Facile,Facile / Facile
4505,356,2020,Art,2,8,QCM,0.7711,0.06,0.72,139,136,107,29,1.02,78.68,107,32,77.11,Facile,Facile,Facile / Facile
356,357,2015,Art,3,1,QROC,0.8153,0.12,0.74,57,48,46,2,1.19,95.83,46,11,81.53,Adapte,Facile,Adapte / Facile
1186,357,2016,Art,3,1,QROC,0.8142,0.06,0.64,47,38,38,0,1.24,100.0,38,9,81.42,Facile,Facile,Facile / Facile
2016,357,2017,Art,3,1,QROC,0.8277,0.1,0.6,53,50,44,6,1.06,88.0,44,9,82.77,Facile,Facile,Facile / Facile
2846,357,2018,Art,3,1,QROC,0.8498,0.13,0.44,57,54,48,6,1.06,88.89,48,9,84.98,Facile,Facile,Facile / Facile
3676,357,2019,Art,3,1,QROC,0.3982,0.59,0.16,63,46,25,21,1.37,54.35,25,38,39.82,Facile,Difficile,Facile / Difficile
4506,357,2020,Art,3,1,QROC,0.7886,0.2,0.41,76,67,60,7,1.13,89.55,60,16,78.86,Facile,Facile,Facile / Facile
357,358,2015,Art,3,2,QCU,0.8338,0.04,0.79,68,58,57,1,1.17,98.28,57,11,83.38,Facile,Facile,Facile / Facile
1187,358,2016,Art,3,2,QCU,0.9398,0.09,0.93,76,72,71,1,1.06,98.61,71,5,93.98,Trop Facile,Trop Facile,Trop Facile / Trop Facile
2017,358,2017,Art,3,2,QCU,0.6273,0.13,0.47,82,60,51,9,1.37,85.0,51,31,62.73,Trop Facile,Adapte,Trop Facile / Adapte
2847,358,2018,Art,3,2,QCU,0.6382,0.26,0.67,86,63,55,8,1.37,87.3,55,31,63.82,Adapte,Adapte,Adapte / Adapte
3677,358,2019,Art,3,2,QCU,0.6421,0.28,0.53,90,78,58,20,1.15,74.36,58,32,64.21,Adapte,Adapte,Adapte / Adapte
4507,358,2020,Art,3,2,QCU,0.7317,0.22,0.44,99,91,72,19,1.09,79.12,72,27,73.17,Adapte,Adapte,Adapte / Adapte
358,359,2015,Art,4,1,QCM,0.9701,0.04,0.85,89,88,86,2,1.01,97.73,86,3,97.01,Facile,Trop Facile,Facile / Trop Facile
1188,359,2016,Art,4,1,QCM,0.2591,0.23,0.36,76,25,20,5,3.04,80.0,20,56,25.91,Facile,Difficile,Facile / Difficile
2018,359,2017,Art,4,1,QCM,0.1941,0.49,0.21,70,45,14,31,1.56,31.11,14,56,19.41,Facile,Trop Difficile,Facile / Trop Difficile
2848,359,2018,Art,4,1,QCM,0.8057,0.03,0.71,67,63,54,9,1.06,85.71,54,13,80.57,Facile,Facile,Facile / Facile
3678,359,2019,Art,4,1,QCM,0.7656,0.08,0.76,63,57,48,9,1.11,84.21,48,15,76.56,Facile,Facile,Facile / Facile
4508,359,2020,Art,4,1,QCM,0.8304,0.04,0.75,65,63,54,9,1.03,85.71,54,11,83.04,Facile,Facile,Facile / Facile
359,360,2015,Art,4,2,QCU,0.3623,0.11,0.35,94,62,34,28,1.52,54.84,34,60,36.23,Difficile,Difficile,Difficile / Difficile
1189,360,2016,Art,4,2,QCU,0.9145,0.02,0.94,104,99,95,4,1.05,95.96,95,9,91.45,Trop Facile,Trop Facile,Trop Facile / Trop Facile
2019,360,2017,Art,4,2,QCU,0.5636,0.28,0.33,114,98,64,34,1.16,65.31,64,50,56.36,Trop Facile,Difficile,Trop Facile / Difficile
2849,360,2018,Art,4,2,QCU,0.907,0.03,0.99,136,133,123,10,1.02,92.48,123,13,90.7,Trop Facile,Trop Facile,Trop Facile / Trop Facile
3679,360,2019,Art,4,2,QCU,0.9882,0.09,0.95,134,132,132,0,1.02,100.0,132,2,98.82,Trop Facile,Trop Facile,Trop Facile / Trop Facile
4509,360,2020,Art,4,2,QCU,0.044,0.73,0.26,110,74,5,69,1.49,6.76,5,105,4.4,Trop Facile,Trop Difficile,Trop Facile / Trop Difficile
360,361,2015,Art,4,3,QCM,0.7442,0.16,0.43,27,21,20,1,1.29,95.24,20,7,74.42,Adapte,Adapte,Adapte / Adapte
1190,361,2016,Art,4,3,QCM,0.7266,0.12,0.52,22,18,16,2,1.22,88.89,16,6,72.66,Adapte,Adapte,Adapte / Adapte
2020,361,2017,Art,4,3,QCM,0.6744,0.18,0.66,20,15,13,2,1.33,86.67,13,7,67.44,Adapte,Adapte,Adapte / Adapte
2850,361,2018,Art,4,3,QCM,0.723,0.03,0.47,19,17,14,3,1.12,82.35,14,5,72.3,Adapte,Adapte,Adapte / Adapte
3680,361,2019,Art,4,3,QCM,0.7242,0.23,0.63,15,13,11,2,1.15,84.62,11,4,72.42,Adapte,Adapte,Adapte / Adapte
4510,361,2020,Art,4,3,QCM,0.7427,0.08,0.59,12,10,9,1,1.2,90.0,9,3,74.27,Adapte,Adapte,Adapte / Adapte
361,362,2015,Art,4,4,QCU,0.1099,0.06,0.28,28,19,3,16,1.47,15.79,3,25,10.99,Trop Difficile,Trop Difficile,Trop Difficile / Trop Difficile
1191,362,2016,Art,4,4,QCU,0.9996,0.06,0.91,31,31,31,0,1.0,100.0,31,0,99.96,Trop Facile,Trop Facile,Trop Facile / Trop Facile
2021,362,2017,Art,4,4,QCU,0.9708,0.02,0.95,27,27,26,1,1.0,96.3,26,1,97.08,Trop Facile,Trop Facile,Trop Facile / Trop Facile
2851,362,2018,Art,4,4,QCU,0.9205,0.05,0.94,22,21,20,1,1.05,95.24,20,2,92.05,Trop Facile,Trop Facile,Trop Facile / Trop Facile
3681,362,2019,Art,4,4,QCU,0.9232,0.04,0.91,21,19,19,0,1.11,100.0,19,2,92.32,Trop Facile,Trop Facile,Trop Facile / Trop Facile
4511,362,2020,Art,4,4,QCU,0.8733,0.04,0.91,18,17,16,1,1.06,94.12,16,2,87.33,Trop Facile,Trop Facile,Trop Facile / Trop Facile
362,363,2015,Art,4,5,QCM,0.0998,0.17,0.22,79,30,8,22,2.63,26.67,8,71,9.98,Difficile,Trop Difficile,Difficile / Trop Difficile
1192,363,2016,Art,4,5,QCM,0.8037,0.0,0.72,89,75,72,3,1.19,96.0,72,17,80.37,Facile,Facile,Facile / Facile
2022,363,2017,Art,4,5,QCM,0.0275,0.28,0.24,72,52,2,50,1.38,3.85,2,70,2.75,Facile,Trop Difficile,Facile / Trop Difficile
2852,363,2018,Art,4,5,QCM,0.7722,0.05,0.72,72,59,56,3,1.22,94.92,56,16,77.22,Facile,Facile,Facile / Facile
3682,363,2019,Art,4,5,QCM,0.846,0.11,0.71,71,63,60,3,1.13,95.24,60,11,84.6,Facile,Facile,Facile / Facile
4512,363,2020,Art,4,5,QCM,0.8231,0.11,0.72,64,55,53,2,1.16,96.36,53,11,82.31,Facile,Facile,Facile / Facile
363,364,2015,Art,4,6,QCM,0.8822,0.06,0.81,77,69,68,1,1.12,98.55,68,9,88.22,Trop Facile,Trop Facile,Trop Facile / Trop Facile
1193,364,2016,Art,4,6,QCM,0.6004,0.04,0.49,85,66,51,15,1.29,77.27,51,34,60.04,Facile,Adapte,Facile / Adapte
2023,364,2017,Art,4,6,QCM,0.7257,0.11,0.66,96,95,70,25,1.01,73.68,70,26,72.57,Adapte,Adapte,Adapte / Adapte
2853,364,2018,Art,4,6,QCM,0.69,0.22,0.61,103,78,71,7,1.32,91.03,71,32,69.0,Adapte,Adapte,Adapte / Adapte
3683,364,2019,Art,4,6,QCM,0.6573,0.14,0.66,122,98,80,18,1.24,81.63,80,42,65.73,Adapte,Adapte,Adapte / Adapte
4513,364,2020,Art,4,6,QCM,0.7411,0.08,0.48,114,104,84,20,1.1,80.77,84,30,74.11,Adapte,Adapte,Adapte / Adapte
364,365,2015,Art,4,7,QCM,0.7733,0.08,0.79,83,68,64,4,1.22,94.12,64,19,77.33,Adapte,Facile,Adapte / Facile
1194,365,2016,Art,4,7,QCM,0.8129,0.13,0.74,92,80,75,5,1.15,93.75,75,17,81.29,Facile,Facile,Facile / Facile
2024,365,2017,Art,4,7,QCM,0.8294,0.1,0.73,84,72,70,2,1.17,97.22,70,14,82.94,Facile,Facile,Facile / Facile
2854,365,2018,Art,4,7,QCM,0.9096,0.08,0.86,81,80,74,6,1.01,92.5,74,7,90.96,Facile,Trop Facile,Facile / Trop Facile
3684,365,2019,Art,4,7,QCM,0.1094,0.54,0.28,70,61,8,53,1.15,13.11,8,62,10.94,Facile,Trop Difficile,Facile / Trop Difficile
4514,365,2020,Art,4,7,QCM,0.8251,0.02,0.76,66,55,54,1,1.2,98.18,54,12,82.51,Facile,Facile,Facile / Facile
365,366,2015,Art,4,8,QCM,0.824,0.0,0.75,16,13,13,0,1.23,100.0,13,3,82.4,Facile,Facile,Facile / Facile
1195,366,2016,Art,4,8,QCM,0.8446,0.18,0.78,13,13,11,2,1.0,84.62,11,2,84.46,Facile,Facile,Facile / Facile
2025,366,2017,Art,4,8,QCM,0.7793,0.08,0.79,14,13,11,2,1.08,84.62,11,3,77.93,Facile,Facile,Facile / Facile
2855,366,2018,Art,4,8,QCM,0.814,0.18,0.75,13,12,11,1,1.08,91.67,11,2,81.4,Facile,Facile,Facile / Facile
3685,366,2019,Art,4,8,QCM,0.7984,0.05,0.78,14,11,11,0,1.27,100.0,11,3,79.84,Facile,Facile,Facile / Facile
4515,366,2020,Art,4,8,QCM,0.788,0.12,0.7,12,12,9,3,1.0,75.0,9,3,78.8,Facile,Facile,Facile / Facile
366,367,2015,Art,4,9,QROC,0.9442,0.07,0.74,45,43,42,1,1.05,97.67,42,3,94.42,Trop Difficile,Trop Facile,Trop Difficile / Trop Facile
1196,367,2016,Art,4,9,QROC,0.8715,0.08,0.6,43,43,37,6,1.0,86.05,37,6,87.15,Facile,Trop Facile,Facile / Trop Facile
2026,367,2017,Art,4,9,QROC,0.9217,0.01,0.87,44,42,41,1,1.05,97.62,41,3,92.17,Facile,Trop Facile,Facile / Trop Facile
2856,367,2018,Art,4,9,QROC,0.8017,0.1,0.57,35,34,28,6,1.03,82.35,28,7,80.17,Facile,Facile,Facile / Facile
3686,367,2019,Art,4,9,QROC,0.9781,0.0,0.69,35,35,34,1,1.0,97.14,34,1,97.81,Facile,Trop Facile,Facile / Trop Facile
4516,367,2020,Art,4,9,QROC,0.7764,0.19,0.53,41,39,32,7,1.05,82.05,32,9,77.64,Facile,Facile,Facile / Facile
367,368,2015,Art,4,10,QROC,0.789,0.01,0.48,31,28,24,4,1.11,85.71,24,7,78.9,Difficile,Facile,Difficile / Facile
1197,368,2016,Art,4,10,QROC,0.8023,0.01,0.59,35,29,28,1,1.21,96.55,28,7,80.23,Facile,Facile,Facile / Facile
2027,368,2017,Art,4,10,QROC,0.837,0.18,0.52,34,29,28,1,1.17,96.55,28,6,83.7,Facile,Facile,Facile / Facile
2857,368,2018,Art,4,10,QROC,0.771,0.05,0.4,32,29,25,4,1.1,86.21,25,7,77.1,Facile,Facile,Facile / Facile
3687,368,2019,Art,4,10,QROC,0.7653,0.18,0.69,32,31,24,7,1.03,77.42,24,8,76.53,Facile,Facile,Facile / Facile
4517,368,2020,Art,4,10,QROC,0.9097,0.0,0.85,34,33,31,2,1.03,93.94,31,3,90.97,Facile,Trop Facile,Facile / Trop Facile
368,369,2015,Art,5,1,QO,0.9766,0.05,0.92,20,20,20,0,1.0,100.0,20,0,97.66,Adapte,Trop Facile,Adapte / Trop Facile
1198,369,2016,Art,5,1,QO,0.6807,0.27,0.16,22,16,15,1,1.38,93.75,15,7,68.07,Adapte,Adapte,Adapte / Adapte
2028,369,2017,Art,5,1,QO,0.6807,0.42,0.24,24,21,16,5,1.14,76.19,16,8,68.07,Adapte,Adapte,Adapte / Adapte
2858,369,2018,Art,5,1,QO,0.7389,0.61,0.19,22,17,16,1,1.29,94.12,16,6,73.89,Adapte,Adapte,Adapte / Adapte
3688,369,2019,Art,5,1,QO,0.7283,0.36,0.17,23,19,17,2,1.21,89.47,17,6,72.83,Adapte,Adapte,Adapte / Adapte
4518,369,2020,Art,5,1,QO,0.6795,0.29,0.17,23,17,16,1,1.35,94.12,16,7,67.95,Adapte,Adapte,Adapte / Adapte
369,370,2015,Art,5,2,QO,0.3159,0.88,0.03,43,42,14,28,1.02,33.33,14,29,31.59,Trop Difficile,Difficile,Trop Difficile / Difficile
1199,370,2016,Art,5,2,QO,0.636,0.3,0.25,42,35,27,8,1.2,77.14,27,15,63.6,Adapte,Adapte,Adapte / Adapte
2029,370,2017,Art,5,2,QO,0.7302,0.6,0.27,47,38,34,4,1.24,89.47,34,13,73.02,Adapte,Adapte,Adapte / Adapte
2859,370,2018,Art,5,2,QO,0.7176,0.28,0.27,55,45,39,6,1.22,86.67,39,16,71.76,Adapte,Adapte,Adapte / Adapte
3689,370,2019,Art,5,2,QO,0.6082,0.71,0.26,58,37,35,2,1.57,94.59,35,23,60.82,Adapte,Adapte,Adapte / Adapte
4519,370,2020,Art,5,2,QO,0.7056,0.47,0.25,66,66,47,19,1.0,71.21,47,19,70.56,Adapte,Adapte,Adapte / Adapte
370,371,2015,Art,5,3,QCU,0.426,0.15,0.33,85,47,36,11,1.81,76.6,36,49,42.6,Difficile,Difficile,Difficile / Difficile
1200,371,2016,Art,5,3,QCU,0.8926,0.07,0.94,85,77,76,1,1.1,98.7,76,9,89.26,Trop Facile,Trop Facile,Trop Facile / Trop Facile
2030,371,2017,Art,5,3,QCU,0.3065,0.37,0.32,92,88,28,60,1.05,31.82,28,64,30.65,Trop Facile,Difficile,Trop Facile / Difficile
2860,371,2018,Art,5,3,QCU,0.9758,0.09,0.96,107,107,104,3,1.0,97.2,104,3,97.58,Trop Facile,Trop Facile,Trop Facile / Trop Facile
3690,371,2019,Art,5,3,QCU,0.8886,0.03,0.98,104,103,92,11,1.01,89.32,92,12,88.86,Trop Facile,Trop Facile,Trop Facile / Trop Facile
4520,371,2020,Art,5,3,QCU,0.9953,0.01,0.93,106,106,106,0,1.0,100.0,106,0,99.53,Trop Facile,Trop Facile,Trop Facile / Trop Facile
371,372,2015,Art,6,1,QROC,0.7354,0.39,0.33,83,77,61,16,1.08,79.22,61,22,73.54,Adapte,Adapte,Adapte / Adapte
1201,372,2016,Art,6,1,QROC,0.6569,0.24,0.3,87,68,57,11,1.28,83.82,57,30,65.69,Adapte,Adapte,Adapte / Adapte
2031,372,2017,Art,6,1,QROC,0.6116,0.27,0.35,98,75,60,15,1.31,80.0,60,38,61.16,Adapte,Adapte,Adapte / Adapte
2861,372,2018,Art,6,1,QROC,0.6857,0.38,0.37,106,74,73,1,1.43,98.65,73,33,68.57,Adapte,Adapte,Adapte / Adapte
3691,372,2019,Art,6,1,QROC,0.6573,0.37,0.32,109,76,72,4,1.43,94.74,72,37,65.73,Adapte,Adapte,Adapte / Adapte
4521,372,2020,Art,6,1,QROC,0.7476,0.34,0.27,107,85,80,5,1.26,94.12,80,27,74.76,Adapte,Adapte,Adapte / Adapte
372,373,2015,Art,6,2,QCU,0.7957,0.1,0.8,65,52,52,0,1.25,100.0,52,13,79.57,Facile,Facile,Facile / Facile
1202,373,2016,Art,6,2,QCU,0.9453,0.1,0.91,69,65,65,0,1.06,100.0,65,4,94.53,Trop Facile,Trop Facile,Trop Facile / Trop Facile
2032,373,2017,Art,6,2,QCU,0.8953,0.01,0.97,67,66,60,6,1.02,90.91,60,7,89.53,Trop Facile,Trop Facile,Trop Facile / Trop Facile
2862,373,2018,Art,6,2,QCU,0.95,0.03,1.0,62,59,59,0,1.05,100.0,59,3,95.0,Trop Facile,Trop Facile,Trop Facile / Trop Facile
3692,373,2019,Art,6,2,QCU,0.9216,0.1,0.93,56,54,52,2,1.04,96.3,52,4,92.16,Trop Facile,Trop Facile,Trop Facile / Trop Facile
4522,373,2020,Art,6,2,QCU,0.97,0.0,0.93,56,55,54,1,1.02,98.18,54,2,97.0,Trop Facile,Trop Facile,Trop Facile / Trop Facile
373,374,2015,Art,6,3,QCU,0.7236,0.08,0.56,56,54,41,13,1.04,75.93,41,15,72.36,Adapte,Adapte,Adapte / Adapte
1203,374,2016,Art,6,3,QCU,0.6838,0.23,0.42,58,46,40,6,1.26,86.96,40,18,68.38,Adapte,Adapte,Adapte / Adapte
2033,374,2017,Art,6,3,QCU,0.6109,0.25,0.67,68,67,42,25,1.01,62.69,42,26,61.09,Adapte,Adapte,Adapte / Adapte
2863,374,2018,Art,6,3,QCU,0.697,0.16,0.44,58,56,40,16,1.04,71.43,40,18,69.7,Adapte,Adapte,Adapte / Adapte
3693,374,2019,Art,6,3,QCU,0.6621,0.16,0.66,68,65,45,20,1.05,69.23,45,23,66.21,Adapte,Adapte,Adapte / Adapte
4523,374,2020,Art,6,3,QCU,0.6095,0.17,0.5,65,50,40,10,1.3,80.0,40,25,60.95,Adapte,Adapte,Adapte / Adapte
374,375,2015,Art,6,4,QCU,0.4877,0.36,0.39,56,32,27,5,1.75,84.38,27,29,48.77,Difficile,Difficile,Difficile / Difficile
1204,375,2016,Art,6,4,QCU,0.9526,0.02,0.9,63,63,60,3,1.0,95.24,60,3,95.26,Trop Facile,Trop Facile,Trop Facile / Trop Facile
2034,375,2017,Art,6,4,QCU,0.8673,0.09,0.94,63,59,55,4,1.07,93.22,55,8,86.73,Trop Facile,Trop Facile,Trop Facile / Trop Facile
2864,375,2018,Art,6,4,QCU,0.9534,0.02,0.91,63,61,60,1,1.03,98.36,60,3,95.34,Trop Facile,Trop Facile,Trop Facile / Trop Facile
3694,375,2019,Art,6,4,QCU,0.8838,0.03,0.94,72,66,64,2,1.09,96.97,64,8,88.38,Trop Facile,Trop Facile,Trop Facile / Trop Facile
4524,375,2020,Art,6,4,QCU,0.9802,0.07,0.98,80,79,78,1,1.01,98.73,78,2,98.02,Trop Facile,Trop Facile,Trop Facile / Trop Facile
375,376,2015,Art,6,5,QCU,0.9831,0.01,0.97,32,32,31,1,1.0,96.88,31,1,98.31,Trop Facile,Trop Facile,Trop Facile / Trop Facile
1205,376,2016,Art,6,5,QCU,0.9672,0.01,0.93,34,33,33,0,1.03,100.0,33,1,96.72,Trop Facile,Trop Facile,Trop Facile / Trop Facile
2035,376,2017,Art,6,5,QCU,0.9062,0.08,0.97,36,34,33,1,1.06,97.06,33,3,90.62,Trop Facile,Trop Facile,Trop Facile / Trop Facile
2865,376,2018,Art,6,5,QCU,0.905,0.01,1.0,37,37,33,4,1.0,89.19,33,4,90.5,Trop Facile,Trop Facile,Trop Facile / Trop Facile
3695,376,2019,Art,6,5,QCU,0.273,0.03,0.32,40,19,11,8,2.11,57.89,11,29,27.3,Trop Facile,Difficile,Trop Facile / Difficile
4525,376,2020,Art,6,5,QCU,0.8017,0.14,0.9,40,35,32,3,1.14,91.43,32,8,80.17,Trop Facile,Facile,Trop Facile / Facile
376,377,2015,Art,6,6,QCM,0.4772,0.21,0.39,72,38,34,4,1.89,89.47,34,38,47.72,Difficile,Difficile,Difficile / Difficile
1206,377,2016,Art,6,6,QCM,0.8124,0.1,0.77,74,64,60,4,1.16,93.75,60,14,81.24,Facile,Facile,Facile / Facile
2036,377,2017,Art,6,6,QCM,0.8235,0.2,0.71,82,75,68,7,1.09,90.67,68,14,82.35,Facile,Facile,Facile / Facile
2866,377,2018,Art,6,6,QCM,0.7988,0.15,0.71,97,87,77,10,1.11,88.51,77,20,79.88,Facile,Facile,Facile / Facile
3696,377,2019,Art,6,6,QCM,0.7694,0.05,0.79,113,98,87,11,1.15,88.78,87,26,76.94,Facile,Facile,Facile / Facile
4526,377,2020,Art,6,6,QCM,0.1128,0.42,0.2,131,85,15,70,1.54,17.65,15,116,11.28,Facile,Trop Difficile,Facile / Trop Difficile
377,378,2015,Art,6,7,QCU,0.9615,0.01,0.98,43,43,41,2,1.0,95.35,41,2,96.15,Adapte,Trop Facile,Adapte / Trop Facile
1207,378,2016,Art,6,7,QCU,0.3588,0.04,0.34,38,23,14,9,1.65,60.87,14,24,35.88,Trop Facile,Difficile,Trop Facile / Difficile
2037,378,2017,Art,6,7,QCU,0.0545,0.02,0.25,30,10,2,8,3.0,20.0,2,28,5.45,Trop Facile,Trop Difficile,Trop Facile / Trop Difficile
2867,378,2018,Art,6,7,QCU,0.3951,0.05,0.4,26,24,10,14,1.08,41.67,10,16,39.51,Trop Facile,Difficile,Trop Facile / Difficile
3697,378,2019,Art,6,7,QCU,0.7038,0.2,0.59,24,22,17,5,1.09,77.27,17,7,70.38,Trop Facile,Adapte,Trop Facile / Adapte
4527,378,2020,Art,6,7,QCU,0.6163,0.05,0.65,26,23,16,7,1.13,69.57,16,10,61.63,Adapte,Adapte,Adapte / Adapte
378,379,2015,Art,6,8,QCU,0.0028,0.39,0.25,14,12,0,12,1.17,0.0,0,14,0.28,Trop Difficile,Trop Difficile,Trop Difficile / Trop Difficile
1208,379,2016,Art,6,8,QCU,0.9696,0.08,0.9,15,15,15,0,1.0,100.0,15,0,96.96,Trop Facile,Trop Facile,Trop Facile / Trop Facile
2038,379,2017,Art,6,8,QCU,0.9103,0.08,0.97,14,13,13,0,1.08,100.0,13,1,91.03,Trop Facile,Trop Facile,Trop Facile / Trop Facile
2868,379,2018,Art,6,8,QCU,0.9556,0.03,0.97,15,14,14,0,1.07,100.0,14,1,95.56,Trop Facile,Trop Facile,Trop Facile / Trop Facile
3698,379,2019,Art,6,8,QCU,0.9173,0.09,0.98,16,15,15,0,1.07,100.0,15,1,91.73,Trop Facile,Trop Facile,Trop Facile / Trop Facile
4528,379,2020,Art,6,8,QCU,0.8226,0.08,0.78,18,16,15,1,1.12,93.75,15,3,82.26,Trop Facile,Facile,Trop Facile / Facile
379,380,2015,Art,6,9,QROC,0.4495,0.56,0.25,64,63,29,34,1.02,46.03,29,35,44.95,Difficile,Difficile,Difficile / Difficile
1209,380,2016,Art,6,9,QROC,0.7945,0.18,0.55,66,52,52,0,1.27,100.0,52,14,79.45,Facile,Facile,Facile / Facile
2039,380,2017,Art,6,9,QROC,0.6424,0.32,0.39,63,61,40,21,1.03,65.57,40,23,64.24,Facile,Adapte,Facile / Adapte
2869,380,2018,Art,6,9,QROC,0.6761,0.5,0.26,58,40,39,1,1.45,97.5,39,19,67.61,Adapte,Adapte,Adapte / Adapte
3699,380,2019,Art,6,9,QROC,0.7115,0.33,0.29,55,41,39,2,1.34,95.12,39,16,71.15,Adapte,Adapte,Adapte / Adapte
4529,380,2020,Art,6,9,QROC,0.7006,0.37,0.25,60,48,42,6,1.25,87.5,42,18,70.06,Adapte,Adapte,Adapte / Adapte
380,381,2015,Art,6,10,QCM,0.683,0.14,0.63,62,47,42,5,1.32,89.36,42,20,68.3,Trop Facile,Adapte,Trop Facile / Adapte
1210,381,2016,Art,6,10,QCM,0.6938,0.02,0.69,55,52,38,14,1.06,73.08,38,17,69.38,Adapte,Adapte,Adapte / Adapte
2040,381,2017,Art,6,10,QCM,0.6281,0.04,0.63,53,37,33,4,1.43,89.19,33,20,62.81,Adapte,Adapte,Adapte / Adapte
2870,381,2018,Art,6,10,QCM,0.6475,0.21,0.47,64,51,41,10,1.25,80.39,41,23,64.75,Adapte,Adapte,Adapte / Adapte
3700,381,2019,Art,6,10,QCM,0.6579,0.22,0.51,74,53,49,4,1.4,92.45,49,25,65.79,Adapte,Adapte,Adapte / Adapte
4530,381,2020,Art,6,10,QCM,0.6625,0.02,0.54,65,63,43,20,1.03,68.25,43,22,66.25,Adapte,Adapte,Adapte / Adapte
381,382,2015,Art,6,11,QCM,0.9159,0.05,0.95,8,8,7,1,1.0,87.5,7,1,91.59,Trop Facile,Trop Facile,Trop Facile / Trop Facile
1211,382,2016,Art,6,11,QCM,0.8067,0.08,0.75,10,8,8,0,1.25,100.0,8,2,80.67,Facile,Facile,Facile / Facile
2041,382,2017,Art,6,11,QCM,0.8246,0.1,0.8,12,10,10,0,1.2,100.0,10,2,82.46,Facile,Facile,Facile / Facile
2871,382,2018,Art,6,11,QCM,0.8374,0.01,0.78,12,11,10,1,1.09,90.91,10,2,83.74,Facile,Facile,Facile / Facile
3701,382,2019,Art,6,11,QCM,0.8321,0.12,0.73,10,10,8,2,1.0,80.0,8,2,83.21,Facile,Facile,Facile / Facile
4531,382,2020,Art,6,11,QCM,0.6148,0.28,0.59,11,11,7,4,1.0,63.64,7,4,61.48,Facile,Adapte,Facile / Adapte
382,383,2015,Art,6,12,QCM,0.8294,0.04,0.73,21,17,17,0,1.24,100.0,17,4,82.94,Difficile,Facile,Difficile / Facile
1212,383,2016,Art,6,12,QCM,0.7924,0.04,0.78,25,21,20,1,1.19,95.24,20,5,79.24,Facile,Facile,Facile / Facile
2042,383,2017,Art,6,12,QCM,0.9747,0.09,0.91,29,28,28,0,1.04,100.0,28,1,97.47,Facile,Trop Facile,Facile / Trop Facile
2872,383,2018,Art,6,12,QCM,0.8249,0.1,0.78,27,24,22,2,1.12,91.67,22,5,82.49,Facile,Facile,Facile / Facile
3702,383,2019,Art,6,12,QCM,0.8332,0.06,0.7,29,25,24,1,1.16,96.0,24,5,83.32,Facile,Facile,Facile / Facile
4532,383,2020,Art,6,12,QCM,0.8011,0.11,0.71,30,25,24,1,1.2,96.0,24,6,80.11,Facile,Facile,Facile / Facile
383,384,2015,Art,6,13,QCM,0.3669,0.48,0.35,84,71,31,40,1.18,43.66,31,53,36.69,Difficile,Difficile,Difficile / Difficile
1213,384,2016,Art,6,13,QCM,0.338,0.42,0.36,78,68,26,42,1.15,38.24,26,52,33.8,Facile,Difficile,Facile / Difficile
2043,384,2017,Art,6,13,QCM,0.8481,0.03,0.76,94,84,80,4,1.12,95.24,80,14,84.81,Facile,Facile,Facile / Facile
2873,384,2018,Art,6,13,QCM,0.574,0.46,0.33,80,47,46,1,1.7,97.87,46,34,57.4,Facile,Difficile,Facile / Difficile
3703,384,2019,Art,6,13,QCM,0.7817,0.02,0.79,73,69,57,12,1.06,82.61,57,16,78.17,Facile,Facile,Facile / Facile
4533,384,2020,Art,6,13,QCM,0.9812,0.03,0.93,61,61,60,1,1.0,98.36,60,1,98.12,Facile,Trop Facile,Facile / Trop Facile
384,385,2015,Art,6,14,QCU,0.5632,0.37,0.39,39,33,22,11,1.18,66.67,22,17,56.32,Difficile,Difficile,Difficile / Difficile
1214,385,2016,Art,6,14,QCU,0.9057,0.08,0.93,47,45,43,2,1.04,95.56,43,4,90.57,Trop Facile,Trop Facile,Trop Facile / Trop Facile
2044,385,2017,Art,6,14,QCU,0.9731,0.01,0.93,44,44,43,1,1.0,97.73,43,1,97.31,Trop Facile,Trop Facile,Trop Facile / Trop Facile
2874,385,2018,Art,6,14,QCU,0.8935,0.07,0.98,46,44,41,3,1.05,93.18,41,5,89.35,Trop Facile,Trop Facile,Trop Facile / Trop Facile
3704,385,2019,Art,6,14,QCU,0.8195,0.0,0.81,54,53,44,9,1.02,83.02,44,10,81.95,Trop Facile,Facile,Trop Facile / Facile
4534,385,2020,Art,6,14,QCU,0.9933,0.05,0.91,61,61,61,0,1.0,100.0,61,0,99.33,Trop Facile,Trop Facile,Trop Facile / Trop Facile
385,386,2015,Art,7,1,QCU,0.8763,0.04,0.91,32,30,28,2,1.07,93.33,28,4,87.63,Trop Facile,Trop Facile,Trop Facile / Trop Facile
1215,386,2016,Art,7,1,QCU,0.9519,0.1,0.93,32,32,30,2,1.0,93.75,30,2,95.19,Trop Facile,Trop Facile,Trop Facile / Trop Facile
2045,386,2017,Art,7,1,QCU,0.9329,0.08,0.94,37,37,35,2,1.0,94.59,35,2,93.29,Trop Facile,Trop Facile,Trop Facile / Trop Facile
2875,386,2018,Art,7,1,QCU,0.9297,0.01,0.96,31,29,29,0,1.07,100.0,29,2,92.97,Trop Facile,Trop Facile,Trop Facile / Trop Facile
3705,386,2019,Art,7,1,QCU,0.8127,0.17,0.89,33,32,27,5,1.03,84.38,27,6,81.27,Trop Facile,Facile,Trop Facile / Facile
4535,386,2020,Art,7,1,QCU,0.9238,0.08,0.92,29,28,27,1,1.04,96.43,27,2,92.38,Trop Facile,Trop Facile,Trop Facile / Trop Facile
386,387,2015,Art,7,2,QCM,0.0174,0.2,0.22,36,12,1,11,3.0,8.33,1,35,1.74,Trop Difficile,Trop Difficile,Trop Difficile / Trop Difficile
1216,387,2016,Art,7,2,QCM,0.9052,0.06,0.92,37,36,33,3,1.03,91.67,33,4,90.52,Facile,Trop Facile,Facile / Trop Facile
2046,387,2017,Art,7,2,QCM,0.8024,0.02,0.72,40,36,32,4,1.11,88.89,32,8,80.24,Facile,Facile,Facile / Facile
2876,387,2018,Art,7,2,QCM,0.7669,0.11,0.8,39,31,30,1,1.26,96.77,30,9,76.69,Facile,Facile,Facile / Facile
3706,387,2019,Art,7,2,QCM,0.8477,0.05,0.72,34,29,29,0,1.17,100.0,29,5,84.77,Facile,Facile,Facile / Facile
4536,387,2020,Art,7,2,QCM,0.956,0.0,0.95,41,40,39,1,1.02,97.5,39,2,95.6,Facile,Trop Facile,Facile / Trop Facile
387,388,2015,Art,7,3,QCU,0.0951,0.3,0.2,69,46,7,39,1.5,15.22,7,62,9.51,Facile,Trop Difficile,Facile / Trop Difficile
1217,388,2016,Art,7,3,QCU,0.9755,0.1,0.95,74,73,72,1,1.01,98.63,72,2,97.55,Trop Facile,Trop Facile,Trop Facile / Trop Facile
2047,388,2017,Art,7,3,QCU,0.9849,0.09,0.96,62,62,61,1,1.0,98.39,61,1,98.49,Trop Facile,Trop Facile,Trop Facile / Trop Facile
2877,388,2018,Art,7,3,QCU,0.8783,0.08,0.97,55,52,48,4,1.06,92.31,48,7,87.83,Trop Facile,Trop Facile,Trop Facile / Trop Facile
3707,388,2019,Art,7,3,QCU,0.9963,0.01,0.97,53,53,53,0,1.0,100.0,53,0,99.63,Trop Facile,Trop Facile,Trop Facile / Trop Facile
4537,388,2020,Art,7,3,QCU,0.6061,0.15,0.52,64,39,39,0,1.64,100.0,39,25,60.61,Trop Facile,Adapte,Trop Facile / Adapte
388,389,2015,Art,8,1,QROC,0.2149,0.93,0.09,23,22,5,17,1.05,22.73,5,18,21.49,Adapte,Trop Difficile,Adapte / Trop Difficile
1218,389,2016,Art,8,1,QROC,0.7199,0.35,0.3,26,20,19,1,1.3,95.0,19,7,71.99,Facile,Adapte,Facile / Adapte
2048,389,2017,Art,8,1,QROC,0.6921,0.33,0.36,22,21,15,6,1.05,71.43,15,7,69.21,Adapte,Adapte,Adapte / Adapte
2878,389,2018,Art,8,1,QROC,0.6852,0.39,0.38,23,23,16,7,1.0,69.57,16,7,68.52,Adapte,Adapte,Adapte / Adapte
3708,389,2019,Art,8,1,QROC,0.6371,0.41,0.32,18,15,11,4,1.2,73.33,11,7,63.71,Adapte,Adapte,Adapte / Adapte
4538,389,2020,Art,8,1,QROC,0.7345,0.37,0.34,18,16,13,3,1.12,81.25,13,5,73.45,Adapte,Adapte,Adapte / Adapte
389,390,2015,Art,8,2,QCU,0.1909,0.55,0.2,57,28,11,17,2.04,39.29,11,46,19.09,Trop Facile,Trop Difficile,Trop Facile / Trop Difficile
1219,390,2016,Art,8,2,QCU,0.6807,0.02,0.54,59,55,40,15,1.07,72.73,40,19,68.07,Trop Facile,Adapte,Trop Facile / Adapte
2049,390,2017,Art,8,2,QCU,0.6069,0.29,0.64,68,63,41,22,1.08,65.08,41,27,60.69,Adapte,Adapte,Adapte / Adapte
2879,390,2018,Art,8,2,QCU,0.6718,0.1,0.69,63,48,42,6,1.31,87.5,42,21,67.18,Adapte,Adapte,Adapte / Adapte
3709,390,2019,Art,8,2,QCU,0.6348,0.08,0.47,53,52,34,18,1.02,65.38,34,19,63.48,Adapte,Adapte,Adapte / Adapte
4539,390,2020,Art,8,2,QCU,0.601,0.15,0.56,54,38,32,6,1.42,84.21,32,22,60.1,Adapte,Adapte,Adapte / Adapte
390,391,2015,Art,8,3,QCM,0.5194,0.13,0.3,6,4,3,1,1.5,75.0,3,3,51.94,Difficile,Difficile,Difficile / Difficile
1220,391,2016,Art,8,3,QCM,0.9395,0.04,0.84,7,7,7,0,1.0,100.0,7,0,93.95,Facile,Trop Facile,Facile / Trop Facile
2050,391,2017,Art,8,3,QCM,0.7675,0.16,0.73,6,5,5,0,1.2,100.0,5,1,76.75,Facile,Facile,Facile / Facile
2880,391,2018,Art,8,3,QCM,0.4588,0.33,0.35,7,7,3,4,1.0,42.86,3,4,45.88,Facile,Difficile,Facile / Difficile
3710,391,2019,Art,8,3,QCM,0.8479,0.04,0.79,6,5,5,0,1.2,100.0,5,1,84.79,Facile,Facile,Facile / Facile
4540,391,2020,Art,8,3,QCM,0.7931,0.13,0.73,6,6,5,1,1.0,83.33,5,1,79.31,Facile,Facile,Facile / Facile
391,392,2015,Art,8,4,QCM,0.75,0.08,0.58,97,81,73,8,1.2,90.12,73,24,75.0,Adapte,Adapte,Adapte / Adapte
1221,392,2016,Art,8,4,QCM,0.6971,0.24,0.53,94,91,66,25,1.03,72.53,66,28,69.71,Adapte,Adapte,Adapte / Adapte
2051,392,2017,Art,8,4,QCM,0.6327,0.05,0.56,79,54,50,4,1.46,92.59,50,29,63.27,Adapte,Adapte,Adapte / Adapte
2881,392,2018,Art,8,4,QCM,0.726,0.05,0.55,76,66,55,11,1.15,83.33,55,21,72.6,Adapte,Adapte,Adapte / Adapte
3711,392,2019,Art,8,4,QCM,0.7397,0.01,0.59,84,83,62,21,1.01,74.7,62,22,73.97,Adapte,Adapte,Adapte / Adapte
4541,392,2020,Art,8,4,QCM,0.6651,0.08,0.44,75,74,50,24,1.01,67.57,50,25,66.51,Adapte,Adapte,Adapte / Adapte
392,393,2015,Art,8,5,QCU,0.3579,0.07,0.38,37,28,13,15,1.32,46.43,13,24,35.79,Difficile,Difficile,Difficile / Difficile
1222,393,2016,Art,8,5,QCU,0.1016,0.7,0.3,38,16,4,12,2.38,25.0,4,34,10.16,Trop Facile,Trop Difficile,Trop Facile / Trop Difficile
2052,393,2017,Art,8,5,QCU,0.9068,0.04,0.97,40,38,36,2,1.05,94.74,36,4,90.68,Trop Facile,Trop Facile,Trop Facile / Trop Facile
2882,393,2018,Art,8,5,QCU,0.5018,0.2,0.36,35,29,18,11,1.21,62.07,18,17,50.18,Trop Facile,Difficile,Trop Facile / Difficile
3712,393,2019,Art,8,5,QCU,0.8947,0.05,0.99,34,34,30,4,1.0,88.24,30,4,89.47,Trop Facile,Trop Facile,Trop Facile / Trop Facile
4542,393,2020,Art,8,5,QCU,0.5672,0.22,0.34,34,26,19,7,1.31,73.08,19,15,56.72,Trop Facile,Difficile,Trop Facile / Difficile
393,394,2015,Art,9,1,QO,0.0979,0.99,0.04,87,78,9,69,1.12,11.54,9,78,9.79,Trop Difficile,Trop Difficile,Trop Difficile / Trop Difficile
1223,394,2016,Art,9,1,QO,0.6963,0.75,0.27,86,74,60,14,1.16,81.08,60,26,69.63,Adapte,Adapte,Adapte / Adapte
2053,394,2017,Art,9,1,QO,0.7056,0.59,0.25,89,73,63,10,1.22,86.3,63,26,70.56,Adapte,Adapte,Adapte / Adapte
2883,394,2018,Art,9,1,QO,0.654,0.38,0.17,79,66,52,14,1.2,78.79,52,27,65.4,Adapte,Adapte,Adapte / Adapte
3713,394,2019,Art,9,1,QO,0.6601,0.26,0.2,83,68,55,13,1.22,80.88,55,28,66.01,Adapte,Adapte,Adapte / Adapte
4543,394,2020,Art,9,1,QO,0.6107,0.34,0.28,83,64,51,13,1.3,79.69,51,32,61.07,Adapte,Adapte,Adapte / Adapte
394,395,2015,Art,9,2,QROC,0.3341,0.56,0.24,65,36,22,14,1.81,61.11,22,43,33.41,Difficile,Difficile,Difficile / Difficile
1224,395,2016,Art,9,2,QROC,0.9214,0.01,0.73,67,63,62,1,1.06,98.41,62,5,92.14,Facile,Trop Facile,Facile / Trop Facile
2054,395,2017,Art,9,2,QROC,0.834,0.17,0.55,70,63,58,5,1.11,92.06,58,12,83.4,Facile,Facile,Facile / Facile
2884,395,2018,Art,9,2,QROC,0.7889,0.01,0.53,64,60,50,10,1.07,83.33,50,14,78.89,Facile,Facile,Facile / Facile
3714,395,2019,Art,9,2,QROC,0.2923,0.73,0.17,66,29,19,10,2.28,65.52,19,47,29.23,Facile,Difficile,Facile / Difficile
4544,395,2020,Art,9,2,QROC,0.764,0.1,0.54,54,42,41,1,1.29,97.62,41,13,76.4,Facile,Facile,Facile / Facile
395,396,2015,Art,9,3,QCM,0.9057,0.09,0.88,43,41,39,2,1.05,95.12,39,4,90.57,Trop Difficile,Trop Facile,Trop Difficile / Trop Facile
1225,396,2016,Art,9,3,QCM,0.7714,0.02,0.79,51,45,39,6,1.13,86.67,39,12,77.14,Facile,Facile,Facile / Facile
2055,396,2017,Art,9,3,QCM,0.7956,0.04,0.72,61,54,49,5,1.13,90.74,49,12,79.56,Facile,Facile,Facile / Facile
2885,396,2018,Art,9,3,QCM,0.8381,0.17,0.76,49,48,41,7,1.02,85.42,41,8,83.81,Facile,Facile,Facile / Facile
3715,396,2019,Art,9,3,QCM,0.807,0.13,0.74,39,38,31,7,1.03,81.58,31,8,80.7,Facile,Facile,Facile / Facile
4545,396,2020,Art,9,3,QCM,0.7997,0.06,0.76,41,38,33,5,1.08,86.84,33,8,79.97,Facile,Facile,Facile / Facile
396,397,2015,Art,9,4,QCM,0.8364,0.03,0.79,96,93,80,13,1.03,86.02,80,16,83.64,Difficile,Facile,Difficile / Facile
1226,397,2016,Art,9,4,QCM,0.7961,0.13,0.74,91,80,72,8,1.14,90.0,72,19,79.61,Facile,Facile,Facile / Facile
2056,397,2017,Art,9,4,QCM,0.8098,0.01,0.75,92,88,75,13,1.05,85.23,75,17,80.98,Facile,Facile,Facile / Facile
2886,397,2018,Art,9,4,QCM,0.8021,0.05,0.78,87,87,70,17,1.0,80.46,70,17,80.21,Facile,Facile,Facile / Facile
3716,397,2019,Art,9,4,QCM,0.9523,0.09,0.96,99,96,94,2,1.03,97.92,94,5,95.23,Facile,Trop Facile,Facile / Trop Facile
4546,397,2020,Art,9,4,QCM,0.5895,0.18,0.35,109,104,64,40,1.05,61.54,64,45,58.95,Facile,Difficile,Facile / Difficile
397,398,2015,Art,9,5,QCM,0.7405,0.0,0.66,22,21,16,5,1.05,76.19,16,6,74.05,Facile,Adapte,Facile / Adapte
1227,398,2016,Art,9,5,QCM,0.7081,0.08,0.62,24,24,17,7,1.0,70.83,17,7,70.81,Adapte,Adapte,Adapte / Adapte
2057,398,2017,Art,9,5,QCM,0.7439,0.03,0.67,21,19,16,3,1.11,84.21,16,5,74.39,Adapte,Adapte,Adapte / Adapte
2887,398,2018,Art,9,5,QCM,0.6976,0.2,0.45,21,19,15,4,1.11,78.95,15,6,69.76,Adapte,Adapte,Adapte / Adapte
3717,398,2019,Art,9,5,QCM,0.6708,0.06,0.47,19,18,13,5,1.06,72.22,13,6,67.08,Adapte,Adapte,Adapte / Adapte
4547,398,2020,Art,9,5,QCM,0.6034,0.22,0.44,19,15,11,4,1.27,73.33,11,8,60.34,Adapte,Adapte,Adapte / Adapte
398,399,2015,Art,9,6,QCM,0.0543,0.39,0.21,20,19,1,18,1.05,5.26,1,19,5.43,Trop Difficile,Trop Difficile,Trop Difficile / Trop Difficile
1228,399,2016,Art,9,6,QCM,0.7721,0.01,0.77,24,21,19,2,1.14,90.48,19,5,77.21,Facile,Facile,Facile / Facile
2058,399,2017,Art,9,6,QCM,0.7889,0.11,0.79,22,19,17,2,1.16,89.47,17,5,78.89,Facile,Facile,Facile / Facile
2888,399,2018,Art,9,6,QCM,0.8084,0.19,0.79,22,21,18,3,1.05,85.71,18,4,80.84,Facile,Facile,Facile / Facile
3718,399,2019,Art,9,6,QCM,0.773,0.05,0.78,19,19,15,4,1.0,78.95,15,4,77.3,Facile,Facile,Facile / Facile
4548,399,2020,Art,9,6,QCM,0.5425,0.16,0.31,16,12,9,3,1.33,75.0,9,7,54.25,Facile,Difficile,Facile / Difficile
399,400,2015,Art,9,7,QCU,0.0688,0.21,0.25,96,32,7,25,3.0,21.88,7,89,6.88,Trop Facile,Trop Difficile,Trop Facile / Trop Difficile
1229,400,2016,Art,9,7,QCU,0.8766,0.01,0.91,105,93,92,1,1.13,98.92,92,13,87.66,Trop Facile,Trop Facile,Trop Facile / Trop Facile
2059,400,2017,Art,9,7,QCU,0.9741,0.06,0.96,115,112,112,0,1.03,100.0,112,3,97.41,Trop Facile,Trop Facile,Trop Facile / Trop Facile
2889,400,2018,Art,9,7,QCU,0.9121,0.09,0.97,129,127,118,9,1.02,92.91,118,11,91.21,Trop Facile,Trop Facile,Trop Facile / Trop Facile
3719,400,2019,Art,9,7,QCU,0.8882,0.08,0.93,155,146,138,8,1.06,94.52,138,17,88.82,Trop Facile,Trop Facile,Trop Facile / Trop Facile
4549,400,2020,Art,9,7,QCU,0.9013,0.08,0.98,134,127,121,6,1.06,95.28,121,13,90.13,Trop Facile,Trop Facile,Trop Facile / Trop Facile
400,401,2015,Art,9,8,QCM,0.8224,0.2,0.76,48,46,39,7,1.04,84.78,39,9,82.24,Trop Facile,Facile,Trop Facile / Facile
1230,401,2016,Art,9,8,QCM,0.7124,0.15,0.57,46,35,33,2,1.31,94.29,33,13,71.24,Facile,Adapte,Facile / Adapte
2060,401,2017,Art,9,8,QCM,0.6761,0.3,0.52,55,41,37,4,1.34,90.24,37,18,67.61,Adapte,Adapte,Adapte / Adapte
2890,401,2018,Art,9,8,QCM,0.6797,0.04,0.63,52,36,35,1,1.44,97.22,35,17,67.97,Adapte,Adapte,Adapte / Adapte
3720,401,2019,Art,9,8,QCM,0.6262,0.26,0.67,61,48,38,10,1.27,79.17,38,23,62.62,Adapte,Adapte,Adapte / Adapte
4550,401,2020,Art,9,8,QCM,0.7072,0.09,0.54,60,54,42,12,1.11,77.78,42,18,70.72,Adapte,Adapte,Adapte / Adapte
401,402,2015,Art,9,9,QCU,0.0655,0.33,0.22,47,31,3,28,1.52,9.68,3,44,6.55,Trop Difficile,Trop Difficile,Trop Difficile / Trop Difficile
1231,402,2016,Art,9,9,QCU,0.6525,0.16,0.51,54,38,35,3,1.42,92.11,35,19,65.25,Trop Facile,Adapte,Trop Facile / Adapte
2061,402,2017,Art,9,9,QCU,0.6626,0.24,0.67,50,44,33,11,1.14,75.0,33,17,66.26,Adapte,Adapte,Adapte / Adapte
2891,402,2018,Art,9,9,QCU,0.6666,0.12,0.67,52,41,35,6,1.27,85.37,35,17,66.66,Adapte,Adapte,Adapte / Adapte
3721,402,2019,Art,9,9,QCU,0.6392,0.18,0.47,60,51,38,13,1.18,74.51,38,22,63.92,Adapte,Adapte,Adapte / Adapte
4551,402,2020,Art,9,9,QCU,0.7351,0.02,0.54,58,56,43,13,1.04,76.79,43,15,73.51,Adapte,Adapte,Adapte / Adapte
402,403,2015,Art,9,10,QCM,0.9751,0.0,0.81,83,82,81,1,1.01,98.78,81,2,97.51,Adapte,Trop Facile,Adapte / Trop Facile
1232,403,2016,Art,9,10,QCM,0.8153,0.02,0.8,81,69,66,3,1.17,95.65,66,15,81.53,Facile,Facile,Facile / Facile
2062,403,2017,Art,9,10,QCM,0.6858,0.23,0.5,75,54,51,3,1.39,94.44,51,24,68.58,Facile,Adapte,Facile / Adapte
2892,403,2018,Art,9,10,QCM,0.6426,0.14,0.6,73,73,47,26,1.0,64.38,47,26,64.26,Adapte,Adapte,Adapte / Adapte
3722,403,2019,Art,9,10,QCM,0.7413,0.23,0.68,84,82,62,20,1.02,75.61,62,22,74.13,Adapte,Adapte,Adapte / Adapte
4552,403,2020,Art,9,10,QCM,0.6636,0.28,0.46,83,77,55,22,1.08,71.43,55,28,66.36,Adapte,Adapte,Adapte / Adapte
403,404,2015,Art,9,11,QO,0.3676,0.82,0.1,41,40,15,25,1.02,37.5,15,26,36.76,Difficile,Difficile,Difficile / Difficile
1233,404,2016,Art,9,11,QO,0.6451,0.64,0.18,44,36,28,8,1.22,77.78,28,16,64.51,Adapte,Adapte,Adapte / Adapte
2063,404,2017,Art,9,11,QO,0.7063,0.42,0.26,44,31,31,0,1.42,100.0,31,13,70.63,Adapte,Adapte,Adapte / Adapte
2893,404,2018,Art,9,11,QO,0.7376,0.68,0.18,37,33,27,6,1.12,81.82,27,10,73.76,Adapte,Adapte,Adapte / Adapte
3723,404,2019,Art,9,11,QO,0.6216,0.57,0.21,31,30,19,11,1.03,63.33,19,12,62.16,Adapte,Adapte,Adapte / Adapte
4553,404,2020,Art,9,11,QO,0.7287,0.29,0.23,26,23,19,4,1.13,82.61,19,7,72.87,Adapte,Adapte,Adapte / Adapte
404,405,2015,Art,10,1,QCM,0.3329,0.33,0.36,52,29,17,12,1.79,58.62,17,35,33.29,Adapte,Difficile,Adapte / Difficile
1234,405,2016,Art,10,1,QCM,0.3756,0.21,0.36,53,36,20,16,1.47,55.56,20,33,37.56,Facile,Difficile,Facile / Difficile
2064,405,2017,Art,10,1,QCM,0.827,0.15,0.7,62,56,51,5,1.11,91.07,51,11,82.7,Facile,Facile,Facile / Facile
2894,405,2018,Art,10,1,QCM,0.8425,0.1,0.76,64,58,54,4,1.1,93.1,54,10,84.25,Facile,Facile,Facile / Facile
3724,405,2019,Art,10,1,QCM,0.6264,0.19,0.68,54,38,34,4,1.42,89.47,34,20,62.64,Facile,Adapte,Facile / Adapte
4554,405,2020,Art,10,1,QCM,0.6809,0.1,0.53,44,40,30,10,1.1,75.0,30,14,68.09,Adapte,Adapte,Adapte / Adapte
405,406,2015,Art,10,2,QCU,0.5899,0.22,0.4,98,84,58,26,1.17,69.05,58,40,58.99,Adapte,Difficile,Adapte / Difficile
1235,406,2016,Art,10,2,QCU,0.8985,0.07,0.95,96,88,86,2,1.09,97.73,86,10,89.85,Trop Facile,Trop Facile,Trop Facile / Trop Facile
2065,406,2017,Art,10,2,QCU,0.9433,0.08,0.97,95,95,90,5,1.0,94.74,90,5,94.33,Trop Facile,Trop Facile,Trop Facile / Trop Facile
2895,406,2018,Art,10,2,QCU,0.9622,0.01,0.9,96,94,92,2,1.02,97.87,92,4,96.22,Trop Facile,Trop Facile,Trop Facile / Trop Facile
3725,406,2019,Art,10,2,QCU,0.0731,0.39,0.21,91,74,7,67,1.23,9.46,7,84,7.31,Trop Facile,Trop Difficile,Trop Facile / Trop Difficile
4555,406,2020,Art,10,2,QCU,0.9152,0.06,0.93,97,93,89,4,1.04,95.7,89,8,91.52,Trop Facile,Trop Facile,Trop Facile / Trop Facile
406,407,2015,Art,10,3,QCM,0.8435,0.05,0.79,54,51,46,5,1.06,90.2,46,8,84.35,Facile,Facile,Facile / Facile
1236,407,2016,Art,10,3,QCM,0.7895,0.05,0.77,62,55,49,6,1.13,89.09,49,13,78.95,Facile,Facile,Facile / Facile
2066,407,2017,Art,10,3,QCM,0.9145,0.01,0.84,71,70,65,5,1.01,92.86,65,6,91.45,Facile,Trop Facile,Facile / Trop Facile
2896,407,2018,Art,10,3,QCM,0.8978,0.04,0.82,62,57,56,1,1.09,98.25,56,6,89.78,Facile,Trop Facile,Facile / Trop Facile
3726,407,2019,Art,10,3,QCM,0.9211,0.03,0.85,55,51,51,0,1.08,100.0,51,4,92.11,Facile,Trop Facile,Facile / Trop Facile
4556,407,2020,Art,10,3,QCM,0.8303,0.12,0.71,49,42,41,1,1.17,97.62,41,8,83.03,Facile,Facile,Facile / Facile
407,408,2015,Art,10,4,QCM,0.812,0.13,0.8,47,40,38,2,1.18,95.0,38,9,81.2,Facile,Facile,Facile / Facile
1237,408,2016,Art,10,4,QCM,0.8063,0.09,0.8,54,52,44,8,1.04,84.62,44,10,80.63,Facile,Facile,Facile / Facile
2067,408,2017,Art,10,4,QCM,0.8233,0.02,0.74,44,43,36,7,1.02,83.72,36,8,82.33,Facile,Facile,Facile / Facile
2897,408,2018,Art,10,4,QCM,0.7475,0.08,0.69,50,40,37,3,1.25,92.5,37,13,74.75,Facile,Adapte,Facile / Adapte
3727,408,2019,Art,10,4,QCM,0.6455,0.05,0.53,44,36,28,8,1.22,77.78,28,16,64.55,Adapte,Adapte,Adapte / Adapte
4557,408,2020,Art,10,4,QCM,0.6404,0.04,0.51,36,25,23,2,1.44,92.0,23,13,64.04,Adapte,Adapte,Adapte / Adapte
408,409,2015,Art,10,5,QCM,0.1861,0.11,0.21,6,2,1,1,3.0,50.0,1,5,18.61,Trop Difficile,Trop Difficile,Trop Difficile / Trop Difficile
1238,409,2016,Art,10,5,QCM,0.9298,0.08,0.97,6,6,6,0,1.0,100.0,6,0,92.98,Facile,Trop Facile,Facile / Trop Facile
2068,409,2017,Art,10,5,QCM,0.4616,0.23,0.35,6,4,3,1,1.5,75.0,3,3,46.16,Facile,Difficile,Facile / Difficile
2898,409,2018,Art,10,5,QCM,0.8373,0.12,0.73,5,4,4,0,1.25,100.0,4,1,83.73,Facile,Facile,Facile / Facile
3728,409,2019,Art,10,5,QCM,0.65,0.3,0.54,4,4,3,1,1.0,75.0,3,1,65.0,Facile,Adapte,Facile / Adapte
4558,409,2020,Art,10,5,QCM,0.67,0.0,0.67,3,3,2,1,1.0,66.67,2,1,67.0,Adapte,Adapte,Adapte / Adapte
409,410,2015,Art,10,6,QCU,0.0456,0.2,0.22,94,35,4,31,2.69,11.43,4,90,4.56,Adapte,Trop Difficile,Adapte / Trop Difficile
1239,410,2016,Art,10,6,QCU,0.5882,0.22,0.35,93,56,55,1,1.66,98.21,55,38,58.82,Trop Facile,Difficile,Trop Facile / Difficile
2069,410,2017,Art,10,6,QCU,0.9528,0.05,0.94,111,109,106,3,1.02,97.25,106,5,95.28,Trop Facile,Trop Facile,Trop Facile / Trop Facile
2899,410,2018,Art,10,6,QCU,0.9913,0.1,0.97,100,100,99,1,1.0,99.0,99,1,99.13,Trop Facile,Trop Facile,Trop Facile / Trop Facile
3729,410,2019,Art,10,6,QCU,0.8075,0.08,0.79,114,95,92,3,1.2,96.84,92,22,80.75,Trop Facile,Facile,Trop Facile / Facile
4559,410,2020,Art,10,6,QCU,0.6032,0.12,0.7,114,110,69,41,1.04,62.73,69,45,60.32,Trop Facile,Adapte,Trop Facile / Adapte
410,411,2015,Art,10,7,QO,0.0696,0.98,0.03,18,15,1,14,1.2,6.67,1,17,6.96,Trop Difficile,Trop Difficile,Trop Difficile / Trop Difficile
1240,411,2016,Art,10,7,QO,0.6904,0.69,0.18,22,21,15,6,1.05,71.43,15,7,69.04,Adapte,Adapte,Adapte / Adapte
2070,411,2017,Art,10,7,QO,0.7303,0.2,0.19,20,15,15,0,1.33,100.0,15,5,73.03,Adapte,Adapte,Adapte / Adapte
2900,411,2018,Art,10,7,QO,0.7323,0.7,0.17,24,22,18,4,1.09,81.82,18,6,73.23,Adapte,Adapte,Adapte / Adapte
3730,411,2019,Art,10,7,QO,0.6876,0.55,0.16,29,20,20,0,1.45,100.0,20,9,68.76,Adapte,Adapte,Adapte / Adapte
4560,411,2020,Art,10,7,QO,0.7221,0.71,0.29,23,23,17,6,1.0,73.91,17,6,72.21,Adapte,Adapte,Adapte / Adapte
411,412,2015,Art,11,1,QCM,0.2789,0.13,0.34,13,6,4,2,2.17,66.67,4,9,27.89,Difficile,Difficile,Difficile / Difficile
1241,412,2016,Art,11,1,QCM,0.911,0.06,0.94,16,15,15,0,1.07,100.0,15,1,91.1,Facile,Trop Facile,Facile / Trop Facile
2071,412,2017,Art,11,1,QCM,0.029,0.45,0.22,18,14,1,13,1.29,7.14,1,17,2.9,Facile,Trop Difficile,Facile / Trop Difficile
2901,412,2018,Art,11,1,QCM,0.3669,0.2,0.34,16,9,6,3,1.78,66.67,6,10,36.69,Facile,Difficile,Facile / Difficile
3731,412,2019,Art,11,1,QCM,0.7769,0.16,0.71,19,16,15,1,1.19,93.75,15,4,77.69,Facile,Facile,Facile / Facile
4561,412,2020,Art,11,1,QCM,0.8473,0.02,0.72,23,21,19,2,1.1,90.48,19,4,84.73,Facile,Facile,Facile / Facile
412,413,2015,Art,11,2,QCU,0.4915,0.28,0.32,99,76,49,27,1.3,64.47,49,50,49.15,Difficile,Difficile,Difficile / Difficile
1242,413,2016,Art,11,2,QCU,0.8834,0.03,0.99,99,97,87,10,1.02,89.69,87,12,88.34,Trop Facile,Trop Facile,Trop Facile / Trop Facile
2072,413,2017,Art,11,2,QCU,0.7774,0.07,0.76,102,92,79,13,1.11,85.87,79,23,77.74,Trop Facile,Facile,Trop Facile / Facile
2902,413,2018,Art,11,2,QCU,0.9726,0.08,0.96,107,105,104,1,1.02,99.05,104,3,97.26,Trop Facile,Trop Facile,Trop Facile / Trop Facile
3732,413,2019,Art,11,2,QCU,0.956,0.0,0.92,108,105,103,2,1.03,98.1,103,5,95.6,Trop Facile,Trop Facile,Trop Facile / Trop Facile
4562,413,2020,Art,11,2,QCU,0.8744,0.0,0.99,107,97,94,3,1.1,96.91,94,13,87.44,Trop Facile,Trop Facile,Trop Facile / Trop Facile
413,414,2015,Art,11,3,QCM,0.6545,0.27,0.48,48,43,31,12,1.12,72.09,31,17,65.45,Trop Difficile,Adapte,Trop Difficile / Adapte
1243,414,2016,Art,11,3,QCM,0.6225,0.0,0.58,44,43,27,16,1.02,62.79,27,17,62.25,Adapte,Adapte,Adapte / Adapte
2073,414,2017,Art,11,3,QCM,0.7351,0.07,0.53,40,35,29,6,1.14,82.86,29,11,73.51,Adapte,Adapte,Adapte / Adapte
2903,414,2018,Art,11,3,QCM,0.6938,0.13,0.43,48,40,33,7,1.2,82.5,33,15,69.38,Adapte,Adapte,Adapte / Adapte
3733,414,2019,Art,11,3,QCM,0.6156,0.08,0.55,49,36,30,6,1.36,83.33,30,19,61.56,Adapte,Adapte,Adapte / Adapte
4563,414,2020,Art,11,3,QCM,0.7182,0.06,0.68,39,37,28,9,1.05,75.68,28,11,71.82,Adapte,Adapte,Adapte / Adapte
414,415,2015,Art,11,4,QCM,0.7314,0.06,0.45,51,51,37,14,1.0,72.55,37,14,73.14,Trop Difficile,Adapte,Trop Difficile / Adapte
1244,415,2016,Art,11,4,QCM,0.6089,0.17,0.53,50,46,30,16,1.09,65.22,30,20,60.89,Adapte,Adapte,Adapte / Adapte
2074,415,2017,Art,11,4,QCM,0.6733,0.28,0.45,55,42,37,5,1.31,88.1,37,18,67.33,Adapte,Adapte,Adapte / Adapte
2904,415,2018,Art,11,4,QCM,0.7351,0.01,0.54,48,47,35,12,1.02,74.47,35,13,73.51,Adapte,Adapte,Adapte / Adapte
3734,415,2019,Art,11,4,QCM,0.6284,0.17,0.59,41,29,26,3,1.41,89.66,26,15,62.84,Adapte,Adapte,Adapte / Adapte
4564,415,2020,Art,11,4,QCM,0.647,0.09,0.7,39,39,25,14,1.0,64.1,25,14,64.7,Adapte,Adapte,Adapte / Adapte
415,416,2015,Art,11,5,QCU,0.5818,0.29,0.36,100,68,58,10,1.47,85.29,58,42,58.18,Difficile,Difficile,Difficile / Difficile
1245,416,2016,Art,11,5,QCU,0.9132,0.09,0.92,106,98,97,1,1.08,98.98,97,9,91.32,Trop Facile,Trop Facile,Trop Facile / Trop Facile
2075,416,2017,Art,11,5,QCU,0.9798,0.0,0.97,98,97,96,1,1.01,98.97,96,2,97.98,Trop Facile,Trop Facile,Trop Facile / Trop Facile
2905,416,2018,Art,11,5,QCU,0.8726,0.02,1.0,101,97,88,9,1.04,90.72,88,13,87.26,Trop Facile,Trop Facile,Trop Facile / Trop Facile
3735,416,2019,Art,11,5,QCU,0.9904,0.02,0.96,103,103,102,1,1.0,99.03,102,1,99.04,Trop Facile,Trop Facile,Trop Facile / Trop Facile
4565,416,2020,Art,11,5,QCU,0.9764,0.02,0.95,88,87,86,1,1.01,98.85,86,2,97.64,Trop Facile,Trop Facile,Trop Facile / Trop Facile
416,417,2015,Art,11,6,QROC,0.7987,0.11,0.6,100,96,80,16,1.04,83.33,80,20,79.87,Adapte,Facile,Adapte / Facile
1246,417,2016,Art,11,6,QROC,0.7734,0.06,0.67,87,86,67,19,1.01,77.91,67,20,77.34,Facile,Facile,Facile / Facile
2076,417,2017,Art,11,6,QROC,0.1385,0.91,0.1,83,36,11,25,2.31,30.56,11,72,13.85,Facile,Trop Difficile,Facile / Trop Difficile
2906,417,2018,Art,11,6,QROC,0.8347,0.09,0.57,71,59,59,0,1.2,100.0,59,12,83.47,Facile,Facile,Facile / Facile
3736,417,2019,Art,11,6,QROC,0.6561,0.5,0.39,82,66,54,12,1.24,81.82,54,28,65.61,Facile,Adapte,Facile / Adapte
4566,417,2020,Art,11,6,QROC,0.6337,0.25,0.35,75,63,48,15,1.19,76.19,48,27,63.37,Adapte,Adapte,Adapte / Adapte
417,418,2015,Art,11,7,QCU,0.345,0.12,0.4,8,7,3,4,1.14,42.86,3,5,34.5,Trop Difficile,Difficile,Trop Difficile / Difficile
1247,418,2016,Art,11,7,QCU,0.8762,0.02,0.92,8,7,7,0,1.14,100.0,7,1,87.62,Trop Facile,Trop Facile,Trop Facile / Trop Facile
2077,418,2017,Art,11,7,QCU,0.8934,0.06,0.98,6,5,5,0,1.2,100.0,5,1,89.34,Trop Facile,Trop Facile,Trop Facile / Trop Facile
2907,418,2018,Art,11,7,QCU,0.8818,0.04,0.99,6,6,5,1,1.0,83.33,5,1,88.18,Trop Facile,Trop Facile,Trop Facile / Trop Facile
3737,418,2019,Art,11,7,QCU,0.8798,0.07,0.94,5,5,4,1,1.0,80.0,4,1,87.98,Trop Facile,Trop Facile,Trop Facile / Trop Facile
4567,418,2020,Art,11,7,QCU,0.0483,0.29,0.29,6,4,0,4,1.5,0.0,0,6,4.83,Trop Facile,Trop Difficile,Trop Facile / Trop Difficile
418,419,2015,Art,11,8,QROC,0.0577,0.86,0.07,47,21,3,18,2.24,14.29,3,44,5.77,Difficile,Trop Difficile,Difficile / Trop Difficile
1248,419,2016,Art,11,8,QROC,0.7941,0.05,0.65,39,31,31,0,1.26,100.0,31,8,79.41,Facile,Facile,Facile / Facile
2078,419,2017,Art,11,8,QROC,0.772,0.01,0.45,45,44,35,9,1.02,79.55,35,10,77.2,Facile,Facile,Facile / Facile
2908,419,2018,Art,11,8,QROC,0.7774,0.11,0.54,46,41,36,5,1.12,87.8,36,10,77.74,Facile,Facile,Facile / Facile
3738,419,2019,Art,11,8,QROC,0.7817,0.05,0.48,45,44,35,9,1.02,79.55,35,10,78.17,Facile,Facile,Facile / Facile
4568,419,2020,Art,11,8,QROC,0.6973,0.44,0.33,49,40,34,6,1.23,85.0,34,15,69.73,Facile,Adapte,Facile / Adapte
419,420,2015,Art,11,9,QCU,0.9964,0.07,0.99,43,43,43,0,1.0,100.0,43,0,99.64,Trop Facile,Trop Facile,Trop Facile / Trop Facile
1249,420,2016,Art,11,9,QCU,0.9048,0.01,0.95,44,41,40,1,1.07,97.56,40,4,90.48,Trop Facile,Trop Facile,Trop Facile / Trop Facile
2079,420,2017,Art,11,9,QCU,0.7135,0.22,0.67,44,31,31,0,1.42,100.0,31,13,71.35,Trop Facile,Adapte,Trop Facile / Adapte
2909,420,2018,Art,11,9,QCU,0.6077,0.15,0.59,53,37,32,5,1.43,86.49,32,21,60.77,Adapte,Adapte,Adapte / Adapte
3739,420,2019,Art,11,9,QCU,0.728,0.05,0.57,42,33,31,2,1.27,93.94,31,11,72.8,Adapte,Adapte,Adapte / Adapte
4569,420,2020,Art,11,9,QCU,0.6034,0.06,0.59,42,25,25,0,1.68,100.0,25,17,60.34,Adapte,Adapte,Adapte / Adapte
420,421,2015,Art,11,10,QROC,0.465,0.68,0.21,44,32,20,12,1.38,62.5,20,24,46.5,Difficile,Difficile,Difficile / Difficile
1250,421,2016,Art,11,10,QROC,0.8053,0.18,0.69,39,38,31,7,1.03,81.58,31,8,80.53,Facile,Facile,Facile / Facile
2080,421,2017,Art,11,10,QROC,0.7804,0.14,0.53,32,32,25,7,1.0,78.12,25,7,78.04,Facile,Facile,Facile / Facile
2910,421,2018,Art,11,10,QROC,0.0359,0.87,0.06,37,33,1,32,1.12,3.03,1,36,3.59,Facile,Trop Difficile,Facile / Trop Difficile
3740,421,2019,Art,11,10,QROC,0.8885,0.05,0.53,31,29,28,1,1.07,96.55,28,3,88.85,Facile,Trop Facile,Facile / Trop Facile
4570,421,2020,Art,11,10,QROC,0.7999,0.03,0.44,32,27,26,1,1.19,96.3,26,6,79.99,Facile,Facile,Facile / Facile
421,422,2015,Art,12,1,QCU,0.537,0.36,0.36,27,25,14,11,1.08,56.0,14,13,53.7,Difficile,Difficile,Difficile / Difficile
1251,422,2016,Art,12,1,QCU,0.9811,0.0,0.95,26,26,26,0,1.0,100.0,26,0,98.11,Trop Facile,Trop Facile,Trop Facile / Trop Facile
2081,422,2017,Art,12,1,QCU,0.1096,0.43,0.27,25,24,3,21,1.04,12.5,3,22,10.96,Trop Facile,Trop Difficile,Trop Facile / Trop Difficile
2911,422,2018,Art,12,1,QCU,0.8814,0.06,0.95,25,23,22,1,1.09,95.65,22,3,88.14,Trop Facile,Trop Facile,Trop Facile / Trop Facile
3741,422,2019,Art,12,1,QCU,0.9425,0.07,0.94,22,21,21,0,1.05,100.0,21,1,94.25,Trop Facile,Trop Facile,Trop Facile / Trop Facile
4571,422,2020,Art,12,1,QCU,0.5512,0.24,0.35,23,22,13,9,1.05,59.09,13,10,55.12,Trop Facile,Difficile,Trop Facile / Difficile
422,423,2015,Art,12,2,QCM,0.0207,0.0,0.24,64,33,1,32,1.94,3.03,1,63,2.07,Trop Difficile,Trop Difficile,Trop Difficile / Trop Difficile
1252,423,2016,Art,12,2,QCM,0.8197,0.13,0.74,60,50,49,1,1.2,98.0,49,11,81.97,Facile,Facile,Facile / Facile
2082,423,2017,Art,12,2,QCM,0.7619,0.09,0.76,71,62,54,8,1.15,87.1,54,17,76.19,Facile,Facile,Facile / Facile
2912,423,2018,Art,12,2,QCM,0.8013,0.11,0.76,71,64,57,7,1.11,89.06,57,14,80.13,Facile,Facile,Facile / Facile
3742,423,2019,Art,12,2,QCM,0.8401,0.12,0.77,77,75,65,10,1.03,86.67,65,12,84.01,Facile,Facile,Facile / Facile
4572,423,2020,Art,12,2,QCM,0.9174,0.03,0.83,75,74,69,5,1.01,93.24,69,6,91.74,Facile,Trop Facile,Facile / Trop Facile
423,424,2015,Art,12,3,QCM,0.1717,0.41,0.24,98,71,17,54,1.38,23.94,17,81,17.17,Trop Difficile,Trop Difficile,Trop Difficile / Trop Difficile
1253,424,2016,Art,12,3,QCM,0.8401,0.19,0.74,117,99,98,1,1.18,98.99,98,19,84.01,Facile,Facile,Facile / Facile
2083,424,2017,Art,12,3,QCM,0.7965,0.03,0.74,132,129,105,24,1.02,81.4,105,27,79.65,Facile,Facile,Facile / Facile
2913,424,2018,Art,12,3,QCM,0.7838,0.15,0.77,109,93,85,8,1.17,91.4,85,24,78.38,Facile,Facile,Facile / Facile
3743,424,2019,Art,12,3,QCM,0.7737,0.15,0.75,103,95,80,15,1.08,84.21,80,23,77.37,Facile,Facile,Facile / Facile
4573,424,2020,Art,12,3,QCM,0.8117,0.17,0.73,82,70,67,3,1.17,95.71,67,15,81.17,Facile,Facile,Facile / Facile
424,425,2015,Art,12,4,QCM,0.4439,0.39,0.3,75,51,33,18,1.47,64.71,33,42,44.39,Difficile,Difficile,Difficile / Difficile
1254,425,2016,Art,12,4,QCM,0.8194,0.07,0.79,79,66,65,1,1.2,98.48,65,14,81.94,Facile,Facile,Facile / Facile
2084,425,2017,Art,12,4,QCM,0.8115,0.02,0.77,88,80,71,9,1.1,88.75,71,17,81.15,Facile,Facile,Facile / Facile
2914,425,2018,Art,12,4,QCM,0.7631,0.11,0.74,95,82,72,10,1.16,87.8,72,23,76.31,Facile,Facile,Facile / Facile
3744,425,2019,Art,12,4,QCM,0.8348,0.09,0.78,86,78,72,6,1.1,92.31,72,14,83.48,Facile,Facile,Facile / Facile
4574,425,2020,Art,12,4,QCM,0.7813,0.14,0.7,88,87,69,18,1.01,79.31,69,19,78.13,Facile,Facile,Facile / Facile
425,426,2015,Art,12,5,QCU,0.6979,0.19,0.68,91,80,64,16,1.14,80.0,64,27,69.79,Adapte,Adapte,Adapte / Adapte
1255,426,2016,Art,12,5,QCU,0.7369,0.17,0.67,78,76,57,19,1.03,75.0,57,21,73.69,Adapte,Adapte,Adapte / Adapte
2085,426,2017,Art,12,5,QCU,0.6152,0.01,0.69,86,80,53,27,1.07,66.25,53,33,61.52,Adapte,Adapte,Adapte / Adapte
2915,426,2018,Art,12,5,QCU,0.6703,0.07,0.64,75,73,50,23,1.03,68.49,50,25,67.03,Adapte,Adapte,Adapte / Adapte
3745,426,2019,Art,12,5,QCU,0.6127,0.16,0.64,88,70,54,16,1.26,77.14,54,34,61.27,Adapte,Adapte,Adapte / Adapte
4575,426,2020,Art,12,5,QCU,0.6928,0.15,0.54,72,61,50,11,1.18,81.97,50,22,69.28,Adapte,Adapte,Adapte / Adapte
426,427,2015,Art,12,6,QCU,0.8145,0.19,0.83,7,6,6,0,1.17,100.0,6,1,81.45,Facile,Facile,Facile / Facile
1256,427,2016,Art,12,6,QCU,0.3795,0.26,0.35,7,4,3,1,1.75,75.0,3,4,37.95,Trop Facile,Difficile,Trop Facile / Difficile
2086,427,2017,Art,12,6,QCU,0.9464,0.08,0.95,8,8,8,0,1.0,100.0,8,0,94.64,Trop Facile,Trop Facile,Trop Facile / Trop Facile
2916,427,2018,Art,12,6,QCU,0.9001,0.01,1.0,8,8,7,1,1.0,87.5,7,1,90.01,Trop Facile,Trop Facile,Trop Facile / Trop Facile
3746,427,2019,Art,12,6,QCU,0.9477,0.0,0.92,8,8,8,0,1.0,100.0,8,0,94.77,Trop Facile,Trop Facile,Trop Facile / Trop Facile
4576,427,2020,Art,12,6,QCU,0.9334,0.06,0.95,7,7,7,0,1.0,100.0,7,0,93.34,Trop Facile,Trop Facile,Trop Facile / Trop Facile
427,428,2015,Art,13,1,QROC,0.8888,0.1,0.91,67,63,60,3,1.06,95.24,60,7,88.88,Trop Difficile,Trop Facile,Trop Difficile / Trop Facile
1257,428,2016,Art,13,1,QROC,0.6717,0.43,0.26,71,58,48,10,1.22,82.76,48,23,67.17,Facile,Adapte,Facile / Adapte
2087,428,2017,Art,13,1,QROC,0.6471,0.45,0.32,85,73,55,18,1.16,75.34,55,30,64.71,Adapte,Adapte,Adapte / Adapte
2917,428,2018,Art,13,1,QROC,0.7118,0.44,0.32,83,59,59,0,1.41,100.0,59,24,71.18,Adapte,Adapte,Adapte / Adapte
3747,428,2019,Art,13,1,QROC,0.6813,0.29,0.26,84,65,57,8,1.29,87.69,57,27,68.13,Adapte,Adapte,Adapte / Adapte
4577,428,2020,Art,13,1,QROC,0.6605,0.39,0.25,81,66,54,12,1.23,81.82,54,27,66.05,Adapte,Adapte,Adapte / Adapte
428,429,2015,Art,14,1,QCU,0.86,0.0,0.94,15,14,13,1,1.07,92.86,13,2,86.0,Trop Facile,Trop Facile,Trop Facile / Trop Facile
1258,429,2016,Art,14,1,QCU,0.0105,0.36,0.29,17,9,0,9,1.89,0.0,0,17,1.05,Trop Facile,Trop Difficile,Trop Facile / Trop Difficile
2088,429,2017,Art,14,1,QCU,0.8304,0.05,0.87,18,16,15,1,1.12,93.75,15,3,83.04,Trop Facile,Facile,Trop Facile / Facile
2918,429,2018,Art,14,1,QCU,0.9503,0.07,1.0,20,19,19,0,1.05,100.0,19,1,95.03,Trop Facile,Trop Facile,Trop Facile / Trop Facile
3748,429,2019,Art,14,1,QCU,0.9536,0.07,0.99,24,24,23,1,1.0,95.83,23,1,95.36,Trop Facile,Trop Facile,Trop Facile / Trop Facile
4578,429,2020,Art,14,1,QCU,0.8699,0.02,0.94,29,28,25,3,1.04,89.29,25,4,86.99,Trop Facile,Trop Facile,Trop Facile / Trop Facile
429,430,2015,Art,14,2,QCU,0.9255,0.03,0.92,58,57,54,3,1.02,94.74,54,4,92.55,Trop Facile,Trop Facile,Trop Facile / Trop Facile
1259,430,2016,Art,14,2,QCU,0.9362,0.02,0.97,58,58,54,4,1.0,93.1,54,4,93.62,Trop Facile,Trop Facile,Trop Facile / Trop Facile
2089,430,2017,Art,14,2,QCU,0.976,0.03,0.99,59,59,58,1,1.0,98.31,58,1,97.6,Trop Facile,Trop Facile,Trop Facile / Trop Facile
2919,430,2018,Art,14,2,QCU,0.9143,0.02,0.93,48,46,44,2,1.04,95.65,44,4,91.43,Trop Facile,Trop Facile,Trop Facile / Trop Facile
3749,430,2019,Art,14,2,QCU,0.874,0.09,0.94,55,52,48,4,1.06,92.31,48,7,87.4,Trop Facile,Trop Facile,Trop Facile / Trop Facile
4579,430,2020,Art,14,2,QCU,0.8676,0.1,0.98,49,48,43,5,1.02,89.58,43,6,86.76,Trop Facile,Trop Facile,Trop Facile / Trop Facile
430,431,2015,Art,14,3,QCM,0.2565,0.23,0.39,44,22,11,11,2.0,50.0,11,33,25.65,Difficile,Difficile,Difficile / Difficile
1260,431,2016,Art,14,3,QCM,0.9793,0.0,0.95,50,50,49,1,1.0,98.0,49,1,97.93,Facile,Trop Facile,Facile / Trop Facile
2090,431,2017,Art,14,3,QCM,0.8459,0.03,0.76,59,57,50,7,1.04,87.72,50,9,84.59,Facile,Facile,Facile / Facile
2920,431,2018,Art,14,3,QCM,0.8001,0.07,0.72,71,68,57,11,1.04,83.82,57,14,80.01,Facile,Facile,Facile / Facile
3750,431,2019,Art,14,3,QCM,0.3493,0.22,0.32,78,28,27,1,2.79,96.43,27,51,34.93,Facile,Difficile,Facile / Difficile
4580,431,2020,Art,14,3,QCM,0.7635,0.06,0.7,94,79,72,7,1.19,91.14,72,22,76.35,Facile,Facile,Facile / Facile
431,432,2015,Art,14,4,QCM,0.0537,0.18,0.28,19,16,1,15,1.19,6.25,1,18,5.37,Trop Difficile,Trop Difficile,Trop Difficile / Trop Difficile
1261,432,2016,Art,14,4,QCM,0.3917,0.31,0.3,23,14,9,5,1.64,64.29,9,14,39.17,Facile,Difficile,Facile / Difficile
2091,432,2017,Art,14,4,QCM,0.2808,0.19,0.33,27,27,8,19,1.0,29.63,8,19,28.08,Facile,Difficile,Facile / Difficile
2921,432,2018,Art,14,4,QCM,0.9294,0.06,0.83,29,28,27,1,1.04,96.43,27,2,92.94,Facile,Trop Facile,Facile / Trop Facile
3751,432,2019,Art,14,4,QCM,0.7944,0.05,0.76,25,20,20,0,1.25,100.0,20,5,79.44,Facile,Facile,Facile / Facile
4581,432,2020,Art,14,4,QCM,0.8433,0.1,0.74,26,24,22,2,1.08,91.67,22,4,84.33,Facile,Facile,Facile / Facile
432,433,2015,Art,14,5,QCU,0.4145,0.34,0.38,65,38,27,11,1.71,71.05,27,38,41.45,Difficile,Difficile,Difficile / Difficile
1262,433,2016,Art,14,5,QCU,0.9352,0.01,0.92,57,56,53,3,1.02,94.64,53,4,93.52,Trop Facile,Trop Facile,Trop Facile / Trop Facile
2092,433,2017,Art,14,5,QCU,0.8937,0.03,0.94,68,61,61,0,1.11,100.0,61,7,89.37,Trop Facile,Trop Facile,Trop Facile / Trop Facile
2922,433,2018,Art,14,5,QCU,0.879,0.05,0.96,54,50,47,3,1.08,94.0,47,7,87.9,Trop Facile,Trop Facile,Trop Facile / Trop Facile
3752,433,2019,Art,14,5,QCU,0.8605,0.08,0.99,49,46,42,4,1.07,91.3,42,7,86.05,Trop Facile,Trop Facile,Trop Facile / Trop Facile
4582,433,2020,Art,14,5,QCU,0.6913,0.25,0.44,42,39,29,10,1.08,74.36,29,13,69.13,Trop Facile,Adapte,Trop Facile / Adapte
433,434,2015,Art,14,6,QCU,0.4199,0.19,0.32,94,63,39,24,1.49,61.9,39,55,41.99,Difficile,Difficile,Difficile / Difficile
1263,434,2016,Art,14,6,QCU,0.5423,0.14,0.32,79,74,43,31,1.07,58.11,43,36,54.23,Trop Facile,Difficile,Trop Facile / Difficile
2093,434,2017,Art,14,6,QCU,0.6191,0.03,0.57,85,56,53,3,1.52,94.64,53,32,61.91,Trop Facile,Adapte,Trop Facile / Adapte
2923,434,2018,Art,14,6,QCU,0.7308,0.09,0.64,89,83,65,18,1.07,78.31,65,24,73.08,Adapte,Adapte,Adapte / Adapte
3753,434,2019,Art,14,6,QCU,0.734,0.26,0.48,77,66,57,9,1.17,86.36,57,20,73.4,Adapte,Adapte,Adapte / Adapte
4583,434,2020,Art,14,6,QCU,0.6471,0.24,0.61,83,72,54,18,1.15,75.0,54,29,64.71,Adapte,Adapte,Adapte / Adapte
434,435,2015,Art,14,7,QCM,0.9496,0.01,0.98,64,63,61,2,1.02,96.83,61,3,94.96,Adapte,Trop Facile,Adapte / Trop Facile
1264,435,2016,Art,14,7,QCM,0.8424,0.16,0.75,51,45,43,2,1.13,95.56,43,8,84.24,Facile,Facile,Facile / Facile
2094,435,2017,Art,14,7,QCM,0.3616,0.43,0.34,50,21,18,3,2.38,85.71,18,32,36.16,Facile,Difficile,Facile / Difficile
2924,435,2018,Art,14,7,QCM,0.8488,0.19,0.79,57,52,48,4,1.1,92.31,48,9,84.88,Facile,Facile,Facile / Facile
3754,435,2019,Art,14,7,QCM,0.7839,0.15,0.7,52,44,41,3,1.18,93.18,41,11,78.39,Facile,Facile,Facile / Facile
4584,435,2020,Art,14,7,QCM,0.0137,0.52,0.26,54,31,1,30,1.74,3.23,1,53,1.37,Facile,Trop Difficile,Facile / Trop Difficile
435,436,2015,Art,14,8,QROC,0.8146,0.12,0.55,48,43,39,4,1.12,90.7,39,9,81.46,Facile,Facile,Facile / Facile
1265,436,2016,Art,14,8,QROC,0.8014,0.13,0.65,46,44,37,7,1.05,84.09,37,9,80.14,Facile,Facile,Facile / Facile
2095,436,2017,Art,14,8,QROC,0.8192,0.09,0.57,46,39,38,1,1.18,97.44,38,8,81.92,Facile,Facile,Facile / Facile
2925,436,2018,Art,14,8,QROC,0.7776,0.06,0.62,42,41,33,8,1.02,80.49,33,9,77.76,Facile,Facile,Facile / Facile
3755,436,2019,Art,14,8,QROC,0.0446,0.81,0.06,41,17,2,15,2.41,11.76,2,39,4.46,Facile,Trop Difficile,Facile / Trop Difficile
4585,436,2020,Art,14,8,QROC,0.9064,0.08,0.77,46,42,42,0,1.1,100.0,42,4,90.64,Facile,Trop Facile,Facile / Trop Facile
436,437,2015,Art,14,9,QROC,0.3165,0.6,0.2,17,16,5,11,1.06,31.25,5,12,31.65,Trop Difficile,Difficile,Trop Difficile / Difficile
1266,437,2016,Art,14,9,QROC,0.6623,0.2,0.39,20,17,13,4,1.18,76.47,13,7,66.23,Facile,Adapte,Facile / Adapte
2096,437,2017,Art,14,9,QROC,0.6798,0.35,0.31,24,19,16,3,1.26,84.21,16,8,67.98,Adapte,Adapte,Adapte / Adapte
2926,437,2018,Art,14,9,QROC,0.686,0.37,0.3,24,24,16,8,1.0,66.67,16,8,68.6,Adapte,Adapte,Adapte / Adapte
3756,437,2019,Art,14,9,QROC,0.6311,0.43,0.31,29,26,18,8,1.12,69.23,18,11,63.11,Adapte,Adapte,Adapte / Adapte
4586,437,2020,Art,14,9,QROC,0.6278,0.34,0.38,34,32,21,11,1.06,65.62,21,13,62.78,Adapte,Adapte,Adapte / Adapte
437,438,2015,Art,14,10,QCU,0.8923,0.1,0.92,52,47,46,1,1.11,97.87,46,6,89.23,Trop Facile,Trop Facile,Trop Facile / Trop Facile
1267,438,2016,Art,14,10,QCU,0.9356,0.0,0.99,53,51,50,1,1.04,98.04,50,3,93.56,Trop Facile,Trop Facile,Trop Facile / Trop Facile
2097,438,2017,Art,14,10,QCU,0.7783,0.08,0.83,50,48,39,9,1.04,81.25,39,11,77.83,Trop Facile,Facile,Trop Facile / Facile
2927,438,2018,Art,14,10,QCU,0.9409,0.05,0.96,56,54,53,1,1.04,98.15,53,3,94.09,Trop Facile,Trop Facile,Trop Facile / Trop Facile
3757,438,2019,Art,14,10,QCU,0.8616,0.06,0.97,63,55,54,1,1.15,98.18,54,9,86.16,Trop Facile,Trop Facile,Trop Facile / Trop Facile
4587,438,2020,Art,14,10,QCU,0.9868,0.1,0.95,73,72,72,0,1.01,100.0,72,1,98.68,Trop Facile,Trop Facile,Trop Facile / Trop Facile
438,439,2015,Art,15,1,QROC,0.7781,0.19,0.41,59,51,46,5,1.16,90.2,46,13,77.81,Trop Difficile,Facile,Trop Difficile / Facile
1268,439,2016,Art,15,1,QROC,0.8339,0.02,0.74,63,63,53,10,1.0,84.13,53,10,83.39,Facile,Facile,Facile / Facile
2098,439,2017,Art,15,1,QROC,0.763,0.06,0.68,75,66,57,9,1.14,86.36,57,18,76.3,Facile,Facile,Facile / Facile
2928,439,2018,Art,15,1,QROC,0.9606,0.02,0.88,77,75,74,1,1.03,98.67,74,3,96.06,Facile,Trop Facile,Facile / Trop Facile
3758,439,2019,Art,15,1,QROC,0.7864,0.18,0.49,82,69,64,5,1.19,92.75,64,18,78.64,Facile,Facile,Facile / Facile
4588,439,2020,Art,15,1,QROC,0.5614,0.65,0.23,93,64,52,12,1.45,81.25,52,41,56.14,Facile,Difficile,Facile / Difficile
439,440,2015,Art,15,2,QCU,0.6869,0.09,0.6,73,58,50,8,1.26,86.21,50,23,68.69,Adapte,Adapte,Adapte / Adapte
1269,440,2016,Art,15,2,QCU,0.6078,0.08,0.68,66,56,40,16,1.18,71.43,40,26,60.78,Adapte,Adapte,Adapte / Adapte
2099,440,2017,Art,15,2,QCU,0.6705,0.04,0.66,70,59,47,12,1.19,79.66,47,23,67.05,Adapte,Adapte,Adapte / Adapte
2929,440,2018,Art,15,2,QCU,0.6015,0.18,0.63,78,48,47,1,1.62,97.92,47,31,60.15,Adapte,Adapte,Adapte / Adapte
3759,440,2019,Art,15,2,QCU,0.6001,0.29,0.52,89,87,53,34,1.02,60.92,53,36,60.01,Adapte,Adapte,Adapte / Adapte
4589,440,2020,Art,15,2,QCU,0.7183,0.08,0.69,91,81,65,16,1.12,80.25,65,26,71.83,Adapte,Adapte,Adapte / Adapte
440,441,2015,Art,15,3,QCM,0.367,0.12,0.36,76,72,28,44,1.06,38.89,28,48,36.7,Difficile,Difficile,Difficile / Difficile
1270,441,2016,Art,15,3,QCM,0.7768,0.03,0.73,62,52,48,4,1.19,92.31,48,14,77.68,Facile,Facile,Facile / Facile
2100,441,2017,Art,15,3,QCM,0.8232,0.13,0.71,59,50,49,1,1.18,98.0,49,10,82.32,Facile,Facile,Facile / Facile
2930,441,2018,Art,15,3,QCM,0.7677,0.03,0.78,51,41,39,2,1.24,95.12,39,12,76.77,Facile,Facile,Facile / Facile
3760,441,2019,Art,15,3,QCM,0.8491,0.1,0.74,50,43,42,1,1.16,97.67,42,8,84.91,Facile,Facile,Facile / Facile
4590,441,2020,Art,15,3,QCM,0.8309,0.03,0.78,59,50,49,1,1.18,98.0,49,10,83.09,Facile,Facile,Facile / Facile
441,442,2015,Art,15,4,QCU,0.3546,0.03,0.37,17,11,6,5,1.55,54.55,6,11,35.46,Difficile,Difficile,Difficile / Difficile
1271,442,2016,Art,15,4,QCU,0.8675,0.0,0.98,15,15,13,2,1.0,86.67,13,2,86.75,Trop Facile,Trop Facile,Trop Facile / Trop Facile
2101,442,2017,Art,15,4,QCU,0.897,0.1,0.91,17,16,15,1,1.06,93.75,15,2,89.7,Trop Facile,Trop Facile,Trop Facile / Trop Facile
2931,442,2018,Art,15,4,QCU,0.9743,0.03,0.91,18,18,18,0,1.0,100.0,18,0,97.43,Trop Facile,Trop Facile,Trop Facile / Trop Facile
3761,442,2019,Art,15,4,QCU,0.2289,0.68,0.3,15,13,3,10,1.15,23.08,3,12,22.89,Trop Facile,Trop Difficile,Trop Facile / Trop Difficile
4591,442,2020,Art,15,4,QCU,0.3227,0.3,0.39,18,15,6,9,1.2,40.0,6,12,32.27,Trop Facile,Difficile,Trop Facile / Difficile
442,443,2015,Art,15,5,QCU,0.7497,0.25,0.41,77,65,58,7,1.18,89.23,58,19,74.97,Adapte,Adapte,Adapte / Adapte
1272,443,2016,Art,15,5,QCU,0.6756,0.27,0.62,77,67,52,15,1.15,77.61,52,25,67.56,Adapte,Adapte,Adapte / Adapte
2102,443,2017,Art,15,5,QCU,0.7042,0.08,0.5,82,65,58,7,1.26,89.23,58,24,70.42,Adapte,Adapte,Adapte / Adapte
2932,443,2018,Art,15,5,QCU,0.681,0.16,0.45,74,59,50,9,1.25,84.75,50,24,68.1,Adapte,Adapte,Adapte / Adapte
3762,443,2019,Art,15,5,QCU,0.7252,0.01,0.52,87,79,63,16,1.1,79.75,63,24,72.52,Adapte,Adapte,Adapte / Adapte
4592,443,2020,Art,15,5,QCU,0.6352,0.05,0.61,91,65,58,7,1.4,89.23,58,33,63.52,Adapte,Adapte,Adapte / Adapte
443,444,2015,Art,15,6,QROC,0.9367,0.05,0.95,64,61,60,1,1.05,98.36,60,4,93.67,Trop Difficile,Trop Facile,Trop Difficile / Trop Facile
1273,444,2016,Art,15,6,QROC,0.8391,0.02,0.56,64,62,54,8,1.03,87.1,54,10,83.91,Facile,Facile,Facile / Facile
2103,444,2017,Art,15,6,QROC,0.6859,0.4,0.27,76,54,52,2,1.41,96.3,52,24,68.59,Facile,Adapte,Facile / Adapte
2933,444,2018,Art,15,6,QROC,0.6574,0.5,0.3,89,79,59,20,1.13,74.68,59,30,65.74,Adapte,Adapte,Adapte / Adapte
3763,444,2019,Art,15,6,QROC,0.7448,0.31,0.39,72,71,54,17,1.01,76.06,54,18,74.48,Adapte,Adapte,Adapte / Adapte
4593,444,2020,Art,15,6,QROC,0.7226,0.41,0.38,72,63,52,11,1.14,82.54,52,20,72.26,Adapte,Adapte,Adapte / Adapte
444,445,2015,Art,15,7,QROC,0.3635,0.69,0.21,81,59,29,30,1.37,49.15,29,52,36.35,Difficile,Difficile,Difficile / Difficile
1274,445,2016,Art,15,7,QROC,0.8899,0.04,0.98,78,76,69,7,1.03,90.79,69,9,88.99,Facile,Trop Facile,Facile / Trop Facile
2104,445,2017,Art,15,7,QROC,0.7619,0.08,0.65,81,70,62,8,1.16,88.57,62,19,76.19,Facile,Facile,Facile / Facile
2934,445,2018,Art,15,7,QROC,0.8186,0.14,0.67,92,83,75,8,1.11,90.36,75,17,81.86,Facile,Facile,Facile / Facile
3764,445,2019,Art,15,7,QROC,0.764,0.17,0.71,103,102,79,23,1.01,77.45,79,24,76.4,Facile,Facile,Facile / Facile
4594,445,2020,Art,15,7,QROC,0.6127,0.28,0.3,113,103,69,34,1.1,66.99,69,44,61.27,Facile,Adapte,Facile / Adapte
445,446,2015,Art,15,8,QCU,0.226,0.27,0.23,17,15,4,11,1.13,26.67,4,13,22.6,Trop Difficile,Trop Difficile,Trop Difficile / Trop Difficile
1275,446,2016,Art,15,8,QCU,0.9783,0.03,0.91,20,20,20,0,1.0,100.0,20,0,97.83,Trop Facile,Trop Facile,Trop Facile / Trop Facile
2105,446,2017,Art,15,8,QCU,0.9879,0.05,0.92,18,18,18,0,1.0,100.0,18,0,98.79,Trop Facile,Trop Facile,Trop Facile / Trop Facile
2935,446,2018,Art,15,8,QCU,0.8979,0.08,0.91,19,17,17,0,1.12,100.0,17,2,89.79,Trop Facile,Trop Facile,Trop Facile / Trop Facile
3765,446,2019,Art,15,8,QCU,0.9738,0.02,0.94,21,20,20,0,1.05,100.0,20,1,97.38,Trop Facile,Trop Facile,Trop Facile / Trop Facile
4595,446,2020,Art,15,8,QCU,0.915,0.08,0.9,20,19,18,1,1.05,94.74,18,2,91.5,Trop Facile,Trop Facile,Trop Facile / Trop Facile
446,447,2015,Art,15,9,QCU,0.0222,0.71,0.2,44,40,1,39,1.1,2.5,1,43,2.22,Trop Difficile,Trop Difficile,Trop Difficile / Trop Difficile
1276,447,2016,Art,15,9,QCU,0.7019,0.2,0.69,51,44,36,8,1.16,81.82,36,15,70.19,Trop Facile,Adapte,Trop Facile / Adapte
2106,447,2017,Art,15,9,QCU,0.7242,0.21,0.58,41,31,30,1,1.32,96.77,30,11,72.42,Adapte,Adapte,Adapte / Adapte
2936,447,2018,Art,15,9,QCU,0.6486,0.29,0.49,44,32,29,3,1.38,90.62,29,15,64.86,Adapte,Adapte,Adapte / Adapte
3766,447,2019,Art,15,9,QCU,0.6537,0.12,0.45,36,25,24,1,1.44,96.0,24,12,65.37,Adapte,Adapte,Adapte / Adapte
4596,447,2020,Art,15,9,QCU,0.6651,0.26,0.58,35,31,23,8,1.13,74.19,23,12,66.51,Adapte,Adapte,Adapte / Adapte
447,448,2015,Art,15,10,QROC,0.1026,0.81,0.06,64,62,7,55,1.03,11.29,7,57,10.26,Trop Difficile,Trop Difficile,Trop Difficile / Trop Difficile
1277,448,2016,Art,15,10,QROC,0.7868,0.11,0.66,75,75,59,16,1.0,78.67,59,16,78.68,Facile,Facile,Facile / Facile
2107,448,2017,Art,15,10,QROC,0.7848,0.18,0.43,79,66,62,4,1.2,93.94,62,17,78.48,Facile,Facile,Facile / Facile
2937,448,2018,Art,15,10,QROC,0.4645,0.5,0.15,92,60,43,17,1.53,71.67,43,49,46.45,Facile,Difficile,Facile / Difficile
3767,448,2019,Art,15,10,QROC,0.8147,0.14,0.67,92,87,75,12,1.06,86.21,75,17,81.47,Facile,Facile,Facile / Facile
4597,448,2020,Art,15,10,QROC,0.0492,0.98,0.07,86,68,4,64,1.26,5.88,4,82,4.92,Facile,Trop Difficile,Facile / Trop Difficile
448,449,2015,Art,15,11,QROC,0.5339,0.51,0.17,8,7,4,3,1.14,57.14,4,4,53.39,Trop Facile,Difficile,Trop Facile / Difficile
1278,449,2016,Art,15,11,QROC,0.8817,0.07,0.95,8,7,7,0,1.14,100.0,7,1,88.17,Facile,Trop Facile,Facile / Trop Facile
2108,449,2017,Art,15,11,QROC,0.821,0.16,0.55,10,10,8,2,1.0,80.0,8,2,82.1,Facile,Facile,Facile / Facile
2938,449,2018,Art,15,11,QROC,0.7997,0.08,0.41,12,11,10,1,1.09,90.91,10,2,79.97,Facile,Facile,Facile / Facile
3768,449,2019,Art,15,11,QROC,0.7983,0.05,0.43,10,10,8,2,1.0,80.0,8,2,79.83,Facile,Facile,Facile / Facile
4598,449,2020,Art,15,11,QROC,0.9146,0.01,0.58,11,10,10,0,1.1,100.0,10,1,91.46,Facile,Trop Facile,Facile / Trop Facile
449,450,2015,Art,16,1,QCM,0.9938,0.03,0.8,68,68,68,0,1.0,100.0,68,0,99.38,Trop Difficile,Trop Facile,Trop Difficile / Trop Facile
1279,450,2016,Art,16,1,QCM,0.7696,0.02,0.78,72,71,55,16,1.01,77.46,55,17,76.96,Facile,Facile,Facile / Facile
2109,450,2017,Art,16,1,QCM,0.2297,0.05,0.26,58,34,13,21,1.71,38.24,13,45,22.97,Facile,Trop Difficile,Facile / Trop Difficile
2939,450,2018,Art,16,1,QCM,0.8157,0.18,0.79,56,47,46,1,1.19,97.87,46,10,81.57,Facile,Facile,Facile / Facile
3769,450,2019,Art,16,1,QCM,0.8497,0.12,0.79,53,45,45,0,1.18,100.0,45,8,84.97,Facile,Facile,Facile / Facile
4599,450,2020,Art,16,1,QCM,0.7883,0.17,0.78,61,54,48,6,1.13,88.89,48,13,78.83,Facile,Facile,Facile / Facile
450,451,2015,Art,16,2,QCM,0.8799,0.02,0.94,29,27,26,1,1.07,96.3,26,3,87.99,Trop Facile,Trop Facile,Trop Facile / Trop Facile
1280,451,2016,Art,16,2,QCM,0.824,0.02,0.73,32,28,26,2,1.14,92.86,26,6,82.4,Facile,Facile,Facile / Facile
2110,451,2017,Art,16,2,QCM,0.7932,0.16,0.79,26,24,21,3,1.08,87.5,21,5,79.32,Facile,Facile,Facile / Facile
2940,451,2018,Art,16,2,QCM,0.6983,0.24,0.55,21,20,15,5,1.05,75.0,15,6,69.83,Facile,Adapte,Facile / Adapte
3770,451,2019,Art,16,2,QCM,0.6102,0.01,0.63,23,17,14,3,1.35,82.35,14,9,61.02,Adapte,Adapte,Adapte / Adapte
4600,451,2020,Art,16,2,QCM,0.6005,0.17,0.52,20,17,12,5,1.18,70.59,12,8,60.05,Adapte,Adapte,Adapte / Adapte
451,452,2015,Art,16,3,QCM,0.4786,0.13,0.32,25,18,12,6,1.39,66.67,12,13,47.86,Difficile,Difficile,Difficile / Difficile
1281,452,2016,Art,16,3,QCM,0.0662,0.21,0.22,29,17,2,15,1.71,11.76,2,27,6.62,Facile,Trop Difficile,Facile / Trop Difficile
2111,452,2017,Art,16,3,QCM,0.9508,0.06,0.87,29,29,28,1,1.0,96.55,28,1,95.08,Facile,Trop Facile,Facile / Trop Facile
2941,452,2018,Art,16,3,QCM,0.7684,0.18,0.73,32,31,25,6,1.03,80.65,25,7,76.84,Facile,Facile,Facile / Facile
3771,452,2019,Art,16,3,QCM,0.8307,0.03,0.73,34,31,28,3,1.1,90.32,28,6,83.07,Facile,Facile,Facile / Facile
4601,452,2020,Art,16,3,QCM,0.7795,0.11,0.78,30,28,23,5,1.07,82.14,23,7,77.95,Facile,Facile,Facile / Facile
452,453,2015,Art,16,4,QCU,0.844,0.11,0.76,84,83,71,12,1.01,85.54,71,13,84.4,Facile,Facile,Facile / Facile
1282,453,2016,Art,16,4,QCU,0.9067,0.0,0.96,82,81,74,7,1.01,91.36,74,8,90.67,Trop Facile,Trop Facile,Trop Facile / Trop Facile
2112,453,2017,Art,16,4,QCU,0.8083,0.01,0.83,98,84,79,5,1.17,94.05,79,19,80.83,Trop Facile,Facile,Trop Facile / Facile
2942,453,2018,Art,16,4,QCU,0.0144,0.32,0.23,115,51,2,49,2.25,3.92,2,113,1.44,Trop Facile,Trop Difficile,Trop Facile / Trop Difficile
3772,453,2019,Art,16,4,QCU,0.8683,0.03,0.98,133,116,115,1,1.15,99.14,115,18,86.83,Trop Facile,Trop Facile,Trop Facile / Trop Facile
4602,453,2020,Art,16,4,QCU,0.9558,0.0,0.91,110,105,105,0,1.05,100.0,105,5,95.58,Trop Facile,Trop Facile,Trop Facile / Trop Facile
453,454,2015,Art,16,5,QCU,0.666,0.17,0.5,64,55,43,12,1.16,78.18,43,21,66.6,Trop Difficile,Adapte,Trop Difficile / Adapte
1283,454,2016,Art,16,5,QCU,0.7438,0.16,0.5,69,62,51,11,1.11,82.26,51,18,74.38,Adapte,Adapte,Adapte / Adapte
2113,454,2017,Art,16,5,QCU,0.728,0.07,0.41,60,59,44,15,1.02,74.58,44,16,72.8,Adapte,Adapte,Adapte / Adapte
2943,454,2018,Art,16,5,QCU,0.7327,0.24,0.48,55,43,40,3,1.28,93.02,40,15,73.27,Adapte,Adapte,Adapte / Adapte
3773,454,2019,Art,16,5,QCU,0.6064,0.26,0.65,66,58,40,18,1.14,68.97,40,26,60.64,Adapte,Adapte,Adapte / Adapte
4603,454,2020,Art,16,5,QCU,0.6486,0.27,0.56,61,46,40,6,1.33,86.96,40,21,64.86,Adapte,Adapte,Adapte / Adapte
454,455,2015,Art,16,6,QCU,0.8284,0.15,0.83,54,46,45,1,1.17,97.83,45,9,82.84,Facile,Facile,Facile / Facile
1284,455,2016,Art,16,6,QCU,0.869,0.0,0.97,43,43,37,6,1.0,86.05,37,6,86.9,Trop Facile,Trop Facile,Trop Facile / Trop Facile
2114,455,2017,Art,16,6,QCU,0.9518,0.0,0.97,39,38,37,1,1.03,97.37,37,2,95.18,Trop Facile,Trop Facile,Trop Facile / Trop Facile
2944,455,2018,Art,16,6,QCU,0.8968,0.02,0.92,32,31,29,2,1.03,93.55,29,3,89.68,Trop Facile,Trop Facile,Trop Facile / Trop Facile
3774,455,2019,Art,16,6,QCU,0.989,0.04,0.91,30,30,30,0,1.0,100.0,30,0,98.9,Trop Facile,Trop Facile,Trop Facile / Trop Facile
4604,455,2020,Art,16,6,QCU,0.911,0.05,0.91,31,29,28,1,1.07,96.55,28,3,91.1,Trop Facile,Trop Facile,Trop Facile / Trop Facile
455,456,2015,Art,16,7,QCM,0.697,0.04,0.59,34,33,24,9,1.03,72.73,24,10,69.7,Facile,Adapte,Facile / Adapte
1285,456,2016,Art,16,7,QCM,0.6058,0.03,0.6,31,21,19,2,1.48,90.48,19,12,60.58,Adapte,Adapte,Adapte / Adapte
2115,456,2017,Art,16,7,QCM,0.7182,0.14,0.55,35,32,25,7,1.09,78.12,25,10,71.82,Adapte,Adapte,Adapte / Adapte
2945,456,2018,Art,16,7,QCM,0.6048,0.22,0.63,42,30,25,5,1.4,83.33,25,17,60.48,Adapte,Adapte,Adapte / Adapte
3775,456,2019,Art,16,7,QCM,0.6383,0.3,0.42,34,23,22,1,1.48,95.65,22,12,63.83,Adapte,Adapte,Adapte / Adapte
4605,456,2020,Art,16,7,QCM,0.6845,0.19,0.63,30,22,21,1,1.36,95.45,21,9,68.45,Adapte,Adapte,Adapte / Adapte
456,457,2015,Art,16,8,QCU,0.8385,0.0,0.84,26,23,22,1,1.13,95.65,22,4,83.85,Facile,Facile,Facile / Facile
1286,457,2016,Art,16,8,QCU,0.8186,0.14,0.81,27,27,22,5,1.0,81.48,22,5,81.86,Trop Facile,Facile,Trop Facile / Facile
2116,457,2017,Art,16,8,QCU,0.3275,0.01,0.38,23,10,8,2,2.3,80.0,8,15,32.75,Trop Facile,Difficile,Trop Facile / Difficile
2946,457,2018,Art,16,8,QCU,0.9541,0.09,0.94,26,26,25,1,1.0,96.15,25,1,95.41,Trop Facile,Trop Facile,Trop Facile / Trop Facile
3776,457,2019,Art,16,8,QCU,0.0801,0.61,0.23,30,14,2,12,2.14,14.29,2,28,8.01,Trop Facile,Trop Difficile,Trop Facile / Trop Difficile
4606,457,2020,Art,16,8,QCU,0.9548,0.08,0.95,24,24,23,1,1.0,95.83,23,1,95.48,Trop Facile,Trop Facile,Trop Facile / Trop Facile
457,458,2015,Art,16,9,QCM,0.0213,0.65,0.22,77,22,2,20,3.5,9.09,2,75,2.13,Facile,Trop Difficile,Facile / Trop Difficile
1287,458,2016,Art,16,9,QCM,0.7637,0.07,0.78,79,68,60,8,1.16,88.24,60,19,76.37,Facile,Facile,Facile / Facile
2117,458,2017,Art,16,9,QCM,0.5359,0.12,0.36,78,69,42,27,1.13,60.87,42,36,53.59,Facile,Difficile,Facile / Difficile
2947,458,2018,Art,16,9,QCM,0.2251,0.21,0.25,88,72,20,52,1.22,27.78,20,68,22.51,Facile,Trop Difficile,Facile / Trop Difficile
3777,458,2019,Art,16,9,QCM,0.763,0.13,0.74,79,70,60,10,1.13,85.71,60,19,76.3,Facile,Facile,Facile / Facile
4607,458,2020,Art,16,9,QCM,0.8437,0.03,0.7,75,65,63,2,1.15,96.92,63,12,84.37,Facile,Facile,Facile / Facile
458,459,2015,Art,17,1,QCM,0.9903,0.1,0.91,27,27,27,0,1.0,100.0,27,0,99.03,Adapte,Trop Facile,Adapte / Trop Facile
1288,459,2016,Art,17,1,QCM,0.8303,0.11,0.79,23,19,19,0,1.21,100.0,19,4,83.03,Facile,Facile,Facile / Facile
2118,459,2017,Art,17,1,QCM,0.8064,0.07,0.74,21,17,17,0,1.24,100.0,17,4,80.64,Facile,Facile,Facile / Facile
2948,459,2018,Art,17,1,QCM,0.8134,0.16,0.79,17,15,14,1,1.13,93.33,14,3,81.34,Facile,Facile,Facile / Facile
3778,459,2019,Art,17,1,QCM,0.801,0.19,0.72,19,16,15,1,1.19,93.75,15,4,80.1,Facile,Facile,Facile / Facile
4608,459,2020,Art,17,1,QCM,0.7908,0.09,0.75,23,20,18,2,1.15,90.0,18,5,79.08,Facile,Facile,Facile / Facile
459,460,2015,Art,17,2,QROC,0.8206,0.18,0.63,36,35,30,5,1.03,85.71,30,6,82.06,Trop Difficile,Facile,Trop Difficile / Facile
1289,460,2016,Art,17,2,QROC,0.5255,0.62,0.16,40,36,21,15,1.11,58.33,21,19,52.55,Facile,Difficile,Facile / Difficile
2119,460,2017,Art,17,2,QROC,0.7657,0.19,0.42,48,41,37,4,1.17,90.24,37,11,76.57,Facile,Facile,Facile / Facile
2949,460,2018,Art,17,2,QROC,0.8268,0.04,0.59,49,48,41,7,1.02,85.42,41,8,82.68,Facile,Facile,Facile / Facile
3779,460,2019,Art,17,2,QROC,0.9666,0.04,0.84,39,39,38,1,1.0,97.44,38,1,96.66,Facile,Trop Facile,Facile / Trop Facile
4609,460,2020,Art,17,2,QROC,0.1568,0.84,0.07,41,29,6,23,1.41,20.69,6,35,15.68,Facile,Trop Difficile,Facile / Trop Difficile
460,461,2015,Art,17,3,QCM,0.4553,0.02,0.32,41,23,19,4,1.78,82.61,19,22,45.53,Difficile,Difficile,Difficile / Difficile
1290,461,2016,Art,17,3,QCM,0.4809,0.26,0.31,47,30,23,7,1.57,76.67,23,24,48.09,Facile,Difficile,Facile / Difficile
2120,461,2017,Art,17,3,QCM,0.7603,0.19,0.72,49,42,37,5,1.17,88.1,37,12,76.03,Facile,Facile,Facile / Facile
2950,461,2018,Art,17,3,QCM,0.896,0.03,0.82,52,49,47,2,1.06,95.92,47,5,89.6,Facile,Trop Facile,Facile / Trop Facile
3780,461,2019,Art,17,3,QCM,0.1833,0.39,0.2,57,39,10,29,1.46,25.64,10,47,18.33,Facile,Trop Difficile,Facile / Trop Difficile
4610,461,2020,Art,17,3,QCM,0.3165,0.35,0.38,46,27,15,12,1.7,55.56,15,31,31.65,Facile,Difficile,Facile / Difficile
461,462,2015,Art,17,4,QCU,0.862,0.03,0.97,11,10,9,1,1.1,90.0,9,2,86.2,Trop Facile,Trop Facile,Trop Facile / Trop Facile
1291,462,2016,Art,17,4,QCU,0.9742,0.03,0.96,12,12,12,0,1.0,100.0,12,0,97.42,Trop Facile,Trop Facile,Trop Facile / Trop Facile
2121,462,2017,Art,17,4,QCU,0.9276,0.03,0.93,13,12,12,0,1.08,100.0,12,1,92.76,Trop Facile,Trop Facile,Trop Facile / Trop Facile
2951,462,2018,Art,17,4,QCU,0.7997,0.02,0.89,12,11,10,1,1.09,90.91,10,2,79.97,Trop Facile,Facile,Trop Facile / Facile
3781,462,2019,Art,17,4,QCU,0.6756,0.17,0.4,10,10,7,3,1.0,70.0,7,3,67.56,Trop Facile,Adapte,Trop Facile / Adapte
4611,462,2020,Art,17,4,QCU,0.6185,0.27,0.42,8,6,5,1,1.33,83.33,5,3,61.85,Adapte,Adapte,Adapte / Adapte
462,463,2015,Art,17,5,QCM,0.7946,0.04,0.72,99,85,79,6,1.16,92.94,79,20,79.46,Facile,Facile,Facile / Facile
1292,463,2016,Art,17,5,QCM,0.7384,0.03,0.5,84,65,62,3,1.29,95.38,62,22,73.84,Facile,Adapte,Facile / Adapte
2122,463,2017,Art,17,5,QCM,0.6633,0.17,0.44,77,54,51,3,1.43,94.44,51,26,66.33,Adapte,Adapte,Adapte / Adapte
2952,463,2018,Art,17,5,QCM,0.7482,0.23,0.62,64,55,48,7,1.16,87.27,48,16,74.82,Adapte,Adapte,Adapte / Adapte
3782,463,2019,Art,17,5,QCM,0.6147,0.27,0.49,62,46,38,8,1.35,82.61,38,24,61.47,Adapte,Adapte,Adapte / Adapte
4612,463,2020,Art,17,5,QCM,0.7477,0.06,0.68,69,68,52,16,1.01,76.47,52,17,74.77,Adapte,Adapte,Adapte / Adapte
463,464,2015,Art,17,6,QCU,0.5887,0.25,0.38,57,45,34,11,1.27,75.56,34,23,58.87,Difficile,Difficile,Difficile / Difficile
1293,464,2016,Art,17,6,QCU,0.4417,0.37,0.3,66,31,29,2,2.13,93.55,29,37,44.17,Trop Facile,Difficile,Trop Facile / Difficile
2123,464,2017,Art,17,6,QCU,0.8065,0.07,0.77,75,63,60,3,1.19,95.24,60,15,80.65,Trop Facile,Facile,Trop Facile / Facile
2953,464,2018,Art,17,6,QCU,0.9911,0.05,0.91,74,74,73,1,1.0,98.65,73,1,99.11,Trop Facile,Trop Facile,Trop Facile / Trop Facile
3783,464,2019,Art,17,6,QCU,0.9523,0.02,0.93,68,67,65,2,1.01,97.01,65,3,95.23,Trop Facile,Trop Facile,Trop Facile / Trop Facile
4613,464,2020,Art,17,6,QCU,0.8787,0.03,0.98,70,67,62,5,1.04,92.54,62,8,87.87,Trop Facile,Trop Facile,Trop Facile / Trop Facile
464,465,2015,Art,17,7,QCM,0.8011,0.09,0.73,50,45,40,5,1.11,88.89,40,10,80.11,Facile,Facile,Facile / Facile
1294,465,2016,Art,17,7,QCM,0.9582,0.02,0.98,58,56,56,0,1.04,100.0,56,2,95.82,Facile,Trop Facile,Facile / Trop Facile
2124,465,2017,Art,17,7,QCM,0.4333,0.35,0.38,51,35,22,13,1.46,62.86,22,29,43.33,Facile,Difficile,Facile / Difficile
2954,465,2018,Art,17,7,QCM,0.7883,0.03,0.71,61,58,48,10,1.05,82.76,48,13,78.83,Facile,Facile,Facile / Facile
3784,465,2019,Art,17,7,QCM,0.0621,0.44,0.21,67,21,4,17,3.19,19.05,4,63,6.21,Facile,Trop Difficile,Facile / Trop Difficile
4614,465,2020,Art,17,7,QCM,0.1854,0.22,0.3,69,68,13,55,1.01,19.12,13,56,18.54,Facile,Trop Difficile,Facile / Trop Difficile
465,466,2015,Droit,1,1,QCU,0.8094,0.05,0.89,11,10,9,1,1.1,90.0,9,2,80.94,Facile,Facile,Facile / Facile
1295,466,2016,Droit,1,1,QCU,0.74,0.2,0.52,12,10,9,1,1.2,90.0,9,3,74.0,Trop Facile,Adapte,Trop Facile / Adapte
2125,466,2017,Droit,1,1,QCU,0.6209,0.23,0.51,11,10,7,3,1.1,70.0,7,4,62.09,Adapte,Adapte,Adapte / Adapte
2955,466,2018,Droit,1,1,QCU,0.7402,0.28,0.68,13,12,10,2,1.08,83.33,10,3,74.02,Adapte,Adapte,Adapte / Adapte
3785,466,2019,Droit,1,1,QCU,0.693,0.21,0.68,11,10,8,2,1.1,80.0,8,3,69.3,Adapte,Adapte,Adapte / Adapte
4615,466,2020,Droit,1,1,QCU,0.602,0.24,0.6,11,9,7,2,1.22,77.78,7,4,60.2,Adapte,Adapte,Adapte / Adapte
466,467,2015,Droit,1,2,QCM,0.1857,0.22,0.24,22,10,4,6,2.2,40.0,4,18,18.57,Trop Difficile,Trop Difficile,Trop Difficile / Trop Difficile
1296,467,2016,Droit,1,2,QCM,0.7886,0.19,0.77,19,19,15,4,1.0,78.95,15,4,78.86,Facile,Facile,Facile / Facile
2126,467,2017,Droit,1,2,QCM,0.7654,0.07,0.77,15,11,11,0,1.36,100.0,11,4,76.54,Facile,Facile,Facile / Facile
2956,467,2018,Droit,1,2,QCM,0.8242,0.06,0.75,12,11,10,1,1.09,90.91,10,2,82.42,Facile,Facile,Facile / Facile
3786,467,2019,Droit,1,2,QCM,0.7809,0.18,0.74,10,9,8,1,1.11,88.89,8,2,78.09,Facile,Facile,Facile / Facile
4616,467,2020,Droit,1,2,QCM,0.7446,0.09,0.6,9,8,7,1,1.12,87.5,7,2,74.46,Facile,Adapte,Facile / Adapte
467,468,2015,Droit,1,3,QCM,0.6483,0.08,0.51,94,78,61,17,1.21,78.21,61,33,64.83,Adapte,Adapte,Adapte / Adapte
1297,468,2016,Droit,1,3,QCM,0.7016,0.18,0.53,81,78,57,21,1.04,73.08,57,24,70.16,Adapte,Adapte,Adapte / Adapte
2127,468,2017,Droit,1,3,QCM,0.6756,0.09,0.54,81,67,55,12,1.21,82.09,55,26,67.56,Adapte,Adapte,Adapte / Adapte
2957,468,2018,Droit,1,3,QCM,0.6714,0.17,0.42,96,81,64,17,1.19,79.01,64,32,67.14,Adapte,Adapte,Adapte / Adapte
3787,468,2019,Droit,1,3,QCM,0.7184,0.3,0.53,100,94,72,22,1.06,76.6,72,28,71.84,Adapte,Adapte,Adapte / Adapte
4617,468,2020,Droit,1,3,QCM,0.6784,0.04,0.62,104,98,71,27,1.06,72.45,71,33,67.84,Adapte,Adapte,Adapte / Adapte
468,469,2015,Droit,1,4,QCM,0.1841,0.1,0.26,94,61,17,44,1.54,27.87,17,77,18.41,Trop Difficile,Trop Difficile,Trop Difficile / Trop Difficile
1298,469,2016,Droit,1,4,QCM,0.7786,0.2,0.74,89,88,69,19,1.01,78.41,69,20,77.86,Facile,Facile,Facile / Facile
2128,469,2017,Droit,1,4,QCM,0.8018,0.16,0.72,107,96,86,10,1.11,89.58,86,21,80.18,Facile,Facile,Facile / Facile
2958,469,2018,Droit,1,4,QCM,0.7889,0.1,0.7,125,124,99,25,1.01,79.84,99,26,78.89,Facile,Facile,Facile / Facile
3788,469,2019,Droit,1,4,QCM,0.8249,0.08,0.77,117,98,97,1,1.19,98.98,97,20,82.49,Facile,Facile,Facile / Facile
4618,469,2020,Droit,1,4,QCM,0.8434,0.08,0.76,97,91,82,9,1.07,90.11,82,15,84.34,Facile,Facile,Facile / Facile
469,470,2015,Droit,1,5,QO,0.7691,0.06,0.71,10,9,8,1,1.11,88.89,8,2,76.91,Difficile,Facile,Difficile / Facile
1299,470,2016,Droit,1,5,QO,0.7312,0.27,0.17,11,10,8,2,1.1,80.0,8,3,73.12,Adapte,Adapte,Adapte / Adapte
2129,470,2017,Droit,1,5,QO,0.6246,0.68,0.28,13,9,8,1,1.44,88.89,8,5,62.46,Adapte,Adapte,Adapte / Adapte
2959,470,2018,Droit,1,5,QO,0.638,0.74,0.22,10,6,6,0,1.67,100.0,6,4,63.8,Adapte,Adapte,Adapte / Adapte
3789,470,2019,Droit,1,5,QO,0.6313,0.22,0.22,11,10,7,3,1.1,70.0,7,4,63.13,Adapte,Adapte,Adapte / Adapte
4619,470,2020,Droit,1,5,QO,0.7414,0.5,0.21,11,8,8,0,1.38,100.0,8,3,74.14,Adapte,Adapte,Adapte / Adapte
470,471,2015,Droit,1,6,QCM,0.7761,0.05,0.78,80,71,62,9,1.13,87.32,62,18,77.61,Facile,Facile,Facile / Facile
1300,471,2016,Droit,1,6,QCM,0.2151,0.62,0.23,68,64,15,49,1.06,23.44,15,53,21.51,Facile,Trop Difficile,Facile / Trop Difficile
2130,471,2017,Droit,1,6,QCM,0.8839,0.02,0.93,78,71,69,2,1.1,97.18,69,9,88.39,Facile,Trop Facile,Facile / Trop Facile
2960,471,2018,Droit,1,6,QCM,0.8453,0.2,0.76,67,67,57,10,1.0,85.07,57,10,84.53,Facile,Facile,Facile / Facile
3790,471,2019,Droit,1,6,QCM,0.7968,0.02,0.77,61,58,49,9,1.05,84.48,49,12,79.68,Facile,Facile,Facile / Facile
4620,471,2020,Droit,1,6,QCM,0.3202,0.43,0.3,73,39,23,16,1.87,58.97,23,50,32.02,Facile,Difficile,Facile / Difficile
471,472,2015,Droit,1,7,QCM,0.2335,0.11,0.22,31,23,7,16,1.35,30.43,7,24,23.35,Facile,Trop Difficile,Facile / Trop Difficile
1301,472,2016,Droit,1,7,QCM,0.8,0.17,0.74,36,32,29,3,1.12,90.62,29,7,80.0,Facile,Facile,Facile / Facile
2131,472,2017,Droit,1,7,QCM,0.8453,0.19,0.71,34,32,29,3,1.06,90.62,29,5,84.53,Facile,Facile,Facile / Facile
2961,472,2018,Droit,1,7,QCM,0.1655,0.15,0.24,36,19,6,13,1.89,31.58,6,30,16.55,Facile,Trop Difficile,Facile / Trop Difficile
3791,472,2019,Droit,1,7,QCM,0.7749,0.16,0.77,29,25,22,3,1.16,88.0,22,7,77.49,Facile,Facile,Facile / Facile
4621,472,2020,Droit,1,7,QCM,0.7416,0.07,0.63,27,24,20,4,1.12,83.33,20,7,74.16,Facile,Adapte,Facile / Adapte
472,473,2015,Droit,1,8,QCU,0.8708,0.0,0.96,75,73,65,8,1.03,89.04,65,10,87.08,Trop Difficile,Trop Facile,Trop Difficile / Trop Facile
1302,473,2016,Droit,1,8,QCU,0.9931,0.01,0.95,89,89,88,1,1.0,98.88,88,1,99.31,Trop Facile,Trop Facile,Trop Facile / Trop Facile
2132,473,2017,Droit,1,8,QCU,0.962,0.08,0.92,99,95,95,0,1.04,100.0,95,4,96.2,Trop Facile,Trop Facile,Trop Facile / Trop Facile
2962,473,2018,Droit,1,8,QCU,0.4703,0.36,0.34,103,54,48,6,1.91,88.89,48,55,47.03,Trop Facile,Difficile,Trop Facile / Difficile
3792,473,2019,Droit,1,8,QCU,0.8477,0.06,0.8,124,109,105,4,1.14,96.33,105,19,84.77,Trop Facile,Facile,Trop Facile / Facile
4622,473,2020,Droit,1,8,QCU,0.8365,0.03,0.84,130,125,109,16,1.04,87.2,109,21,83.65,Trop Facile,Facile,Trop Facile / Facile
473,474,2015,Droit,1,9,QCM,0.3532,0.35,0.34,55,28,19,9,1.96,67.86,19,36,35.32,Facile,Difficile,Facile / Difficile
1303,474,2016,Droit,1,9,QCM,0.8268,0.12,0.77,48,47,40,7,1.02,85.11,40,8,82.68,Facile,Facile,Facile / Facile
2133,474,2017,Droit,1,9,QCM,0.9398,0.02,0.82,47,45,44,1,1.04,97.78,44,3,93.98,Facile,Trop Facile,Facile / Trop Facile
2963,474,2018,Droit,1,9,QCM,0.8004,0.12,0.78,45,42,36,6,1.07,85.71,36,9,80.04,Facile,Facile,Facile / Facile
3793,474,2019,Droit,1,9,QCM,0.8436,0.13,0.77,39,37,33,4,1.05,89.19,33,6,84.36,Facile,Facile,Facile / Facile
4623,474,2020,Droit,1,9,QCM,0.811,0.19,0.71,43,41,35,6,1.05,85.37,35,8,81.1,Facile,Facile,Facile / Facile
474,475,2015,Droit,1,10,QO,0.9013,0.05,0.89,31,28,28,0,1.11,100.0,28,3,90.13,Trop Facile,Trop Facile,Trop Facile / Trop Facile
1304,475,2016,Droit,1,10,QO,0.6199,0.23,0.25,33,21,20,1,1.57,95.24,20,13,61.99,Adapte,Adapte,Adapte / Adapte
2134,475,2017,Droit,1,10,QO,0.6766,0.22,0.24,35,27,24,3,1.3,88.89,24,11,67.66,Adapte,Adapte,Adapte / Adapte
2964,475,2018,Droit,1,10,QO,0.7208,0.51,0.28,40,33,29,4,1.21,87.88,29,11,72.08,Adapte,Adapte,Adapte / Adapte
3794,475,2019,Droit,1,10,QO,0.6631,0.52,0.21,48,35,32,3,1.37,91.43,32,16,66.31,Adapte,Adapte,Adapte / Adapte
4624,475,2020,Droit,1,10,QO,0.6079,0.55,0.22,49,40,30,10,1.23,75.0,30,19,60.79,Adapte,Adapte,Adapte / Adapte
475,476,2015,Droit,1,11,QCM,0.515,0.39,0.37,65,48,33,15,1.35,68.75,33,32,51.5,Difficile,Difficile,Difficile / Difficile
1305,476,2016,Droit,1,11,QCM,0.8163,0.13,0.73,61,51,50,1,1.2,98.04,50,11,81.63,Facile,Facile,Facile / Facile
2135,476,2017,Droit,1,11,QCM,0.8035,0.14,0.75,52,45,42,3,1.16,93.33,42,10,80.35,Facile,Facile,Facile / Facile
2965,476,2018,Droit,1,11,QCM,0.8485,0.16,0.73,42,40,36,4,1.05,90.0,36,6,84.85,Facile,Facile,Facile / Facile
3795,476,2019,Droit,1,11,QCM,0.2658,0.31,0.33,38,34,10,24,1.12,29.41,10,28,26.58,Facile,Difficile,Facile / Difficile
4625,476,2020,Droit,1,11,QCM,0.6441,0.02,0.57,37,34,24,10,1.09,70.59,24,13,64.41,Facile,Adapte,Facile / Adapte
476,477,2015,Droit,2,1,QCU,0.6427,0.15,0.65,44,41,28,13,1.07,68.29,28,16,64.27,Adapte,Adapte,Adapte / Adapte
1306,477,2016,Droit,2,1,QCU,0.671,0.18,0.7,53,42,36,6,1.26,85.71,36,17,67.1,Adapte,Adapte,Adapte / Adapte
2136,477,2017,Droit,2,1,QCU,0.6568,0.24,0.61,59,44,39,5,1.34,88.64,39,20,65.68,Adapte,Adapte,Adapte / Adapte
2966,477,2018,Droit,2,1,QCU,0.6252,0.05,0.69,55,45,34,11,1.22,75.56,34,21,62.52,Adapte,Adapte,Adapte / Adapte
3796,477,2019,Droit,2,1,QCU,0.6904,0.27,0.45,52,42,36,6,1.24,85.71,36,16,69.04,Adapte,Adapte,Adapte / Adapte
4626,477,2020,Droit,2,1,QCU,0.734,0.29,0.67,46,38,34,4,1.21,89.47,34,12,73.4,Adapte,Adapte,Adapte / Adapte
477,478,2015,Droit,2,2,QCM,0.3785,0.23,0.39,51,32,19,13,1.59,59.38,19,32,37.85,Difficile,Difficile,Difficile / Difficile
1307,478,2016,Droit,2,2,QCM,0.8466,0.12,0.78,46,41,39,2,1.12,95.12,39,7,84.66,Facile,Facile,Facile / Facile
2137,478,2017,Droit,2,2,QCM,0.6093,0.15,0.54,46,33,28,5,1.39,84.85,28,18,60.93,Facile,Adapte,Facile / Adapte
2967,478,2018,Droit,2,2,QCM,0.6904,0.08,0.59,50,39,35,4,1.28,89.74,35,15,69.04,Adapte,Adapte,Adapte / Adapte
3797,478,2019,Droit,2,2,QCM,0.6376,0.0,0.48,60,60,38,22,1.0,63.33,38,22,63.76,Adapte,Adapte,Adapte / Adapte
4627,478,2020,Droit,2,2,QCM,0.7299,0.28,0.6,56,46,41,5,1.22,89.13,41,15,72.99,Adapte,Adapte,Adapte / Adapte
478,479,2015,Droit,2,3,QCM,0.0676,0.07,0.28,97,71,7,64,1.37,9.86,7,90,6.76,Trop Difficile,Trop Difficile,Trop Difficile / Trop Difficile
1308,479,2016,Droit,2,3,QCM,0.8138,0.01,0.77,92,81,75,6,1.14,92.59,75,17,81.38,Facile,Facile,Facile / Facile
2138,479,2017,Droit,2,3,QCM,0.9336,0.01,0.8,89,86,83,3,1.03,96.51,83,6,93.36,Facile,Trop Facile,Facile / Trop Facile
2968,479,2018,Droit,2,3,QCM,0.8055,0.17,0.74,107,101,86,15,1.06,85.15,86,21,80.55,Facile,Facile,Facile / Facile
3798,479,2019,Droit,2,3,QCM,0.8207,0.13,0.72,126,124,103,21,1.02,83.06,103,23,82.07,Facile,Facile,Facile / Facile
4628,479,2020,Droit,2,3,QCM,0.8171,0.1,0.72,104,95,85,10,1.09,89.47,85,19,81.71,Facile,Facile,Facile / Facile
479,480,2015,Droit,2,4,QCU,0.4578,0.3,0.33,66,65,30,35,1.02,46.15,30,36,45.78,Difficile,Difficile,Difficile / Difficile
1309,480,2016,Droit,2,4,QCU,0.9829,0.07,0.95,69,68,68,0,1.01,100.0,68,1,98.29,Trop Facile,Trop Facile,Trop Facile / Trop Facile
2139,480,2017,Droit,2,4,QCU,0.8722,0.09,0.93,56,51,49,2,1.1,96.08,49,7,87.22,Trop Facile,Trop Facile,Trop Facile / Trop Facile
2969,480,2018,Droit,2,4,QCU,0.9812,0.06,0.91,49,48,48,0,1.02,100.0,48,1,98.12,Trop Facile,Trop Facile,Trop Facile / Trop Facile
3799,480,2019,Droit,2,4,QCU,0.9837,0.09,1.0,40,40,39,1,1.0,97.5,39,1,98.37,Trop Facile,Trop Facile,Trop Facile / Trop Facile
4629,480,2020,Droit,2,4,QCU,0.9937,0.09,0.96,36,36,36,0,1.0,100.0,36,0,99.37,Trop Facile,Trop Facile,Trop Facile / Trop Facile
480,481,2015,Droit,2,5,QCM,0.9939,0.08,0.89,64,64,64,0,1.0,100.0,64,0,99.39,Trop Facile,Trop Facile,Trop Facile / Trop Facile
1310,481,2016,Droit,2,5,QCM,0.8427,0.03,0.76,72,72,61,11,1.0,84.72,61,11,84.27,Facile,Facile,Facile / Facile
2140,481,2017,Droit,2,5,QCM,0.026,0.63,0.25,61,26,2,24,2.35,7.69,2,59,2.6,Facile,Trop Difficile,Facile / Trop Difficile
2970,481,2018,Droit,2,5,QCM,0.8485,0.09,0.71,50,43,42,1,1.16,97.67,42,8,84.85,Facile,Facile,Facile / Facile
3800,481,2019,Droit,2,5,QCM,0.7666,0.1,0.75,40,38,31,7,1.05,81.58,31,9,76.66,Facile,Facile,Facile / Facile
4630,481,2020,Droit,2,5,QCM,0.9363,0.06,0.99,32,31,30,1,1.03,96.77,30,2,93.63,Facile,Trop Facile,Facile / Trop Facile
481,482,2015,Droit,2,6,QCU,0.8775,0.06,0.94,39,38,34,4,1.03,89.47,34,5,87.75,Trop Facile,Trop Facile,Trop Facile / Trop Facile
1311,482,2016,Droit,2,6,QCU,0.9548,0.04,1.0,43,43,41,2,1.0,95.35,41,2,95.48,Trop Facile,Trop Facile,Trop Facile / Trop Facile
2141,482,2017,Droit,2,6,QCU,0.9948,0.09,0.91,49,49,49,0,1.0,100.0,49,0,99.48,Trop Facile,Trop Facile,Trop Facile / Trop Facile
2971,482,2018,Droit,2,6,QCU,0.9355,0.04,0.97,46,46,43,3,1.0,93.48,43,3,93.55,Trop Facile,Trop Facile,Trop Facile / Trop Facile
3801,482,2019,Droit,2,6,QCU,0.8743,0.06,0.98,38,35,33,2,1.09,94.29,33,5,87.43,Trop Facile,Trop Facile,Trop Facile / Trop Facile
4631,482,2020,Droit,2,6,QCU,0.9648,0.02,0.93,42,42,41,1,1.0,97.62,41,1,96.48,Trop Facile,Trop Facile,Trop Facile / Trop Facile
482,483,2015,Droit,3,1,QCM,0.9612,0.08,0.88,97,96,93,3,1.01,96.88,93,4,96.12,Trop Facile,Trop Facile,Trop Facile / Trop Facile
1312,483,2016,Droit,3,1,QCM,0.8389,0.02,0.76,114,102,96,6,1.12,94.12,96,18,83.89,Facile,Facile,Facile / Facile
2142,483,2017,Droit,3,1,QCM,0.7686,0.1,0.74,120,111,92,19,1.08,82.88,92,28,76.86,Facile,Facile,Facile / Facile
2972,483,2018,Droit,3,1,QCM,0.7157,0.02,0.63,105,91,75,16,1.15,82.42,75,30,71.57,Facile,Adapte,Facile / Adapte
3802,483,2019,Droit,3,1,QCM,0.63,0.11,0.65,92,86,58,28,1.07,67.44,58,34,63.0,Adapte,Adapte,Adapte / Adapte
4632,483,2020,Droit,3,1,QCM,0.6427,0.11,0.55,100,85,64,21,1.18,75.29,64,36,64.27,Adapte,Adapte,Adapte / Adapte
483,484,2015,Droit,3,2,QCM,0.8244,0.04,0.77,98,96,81,15,1.02,84.38,81,17,82.44,Difficile,Facile,Difficile / Facile
1313,484,2016,Droit,3,2,QCM,0.0868,0.38,0.25,116,83,10,73,1.4,12.05,10,106,8.68,Facile,Trop Difficile,Facile / Trop Difficile
2143,484,2017,Droit,3,2,QCM,0.8324,0.17,0.73,95,80,79,1,1.19,98.75,79,16,83.24,Facile,Facile,Facile / Facile
2973,484,2018,Droit,3,2,QCM,0.773,0.05,0.77,108,106,83,23,1.02,78.3,83,25,77.3,Facile,Facile,Facile / Facile
3803,484,2019,Droit,3,2,QCM,0.7863,0.13,0.77,110,92,86,6,1.2,93.48,86,24,78.63,Facile,Facile,Facile / Facile
4633,484,2020,Droit,3,2,QCM,0.173,0.19,0.23,124,124,21,103,1.0,16.94,21,103,17.3,Facile,Trop Difficile,Facile / Trop Difficile
484,485,2015,Droit,3,3,QCU,0.7924,0.1,0.88,5,4,4,0,1.25,100.0,4,1,79.24,Facile,Facile,Facile / Facile
1314,485,2016,Droit,3,3,QCU,0.1876,0.51,0.3,6,5,1,4,1.2,20.0,1,5,18.76,Trop Facile,Trop Difficile,Trop Facile / Trop Difficile
2144,485,2017,Droit,3,3,QCU,0.2856,0.3,0.38,7,3,2,1,2.33,66.67,2,5,28.56,Trop Facile,Difficile,Trop Facile / Difficile
2974,485,2018,Droit,3,3,QCU,0.9147,0.06,0.92,7,6,6,0,1.17,100.0,6,1,91.47,Trop Facile,Trop Facile,Trop Facile / Trop Facile
3804,485,2019,Droit,3,3,QCU,0.9137,0.04,1.0,7,6,6,0,1.17,100.0,6,1,91.37,Trop Facile,Trop Facile,Trop Facile / Trop Facile
4634,485,2020,Droit,3,3,QCU,0.9303,0.09,0.99,6,6,6,0,1.0,100.0,6,0,93.03,Trop Facile,Trop Facile,Trop Facile / Trop Facile
485,486,2015,Droit,3,4,QCM,0.5305,0.29,0.33,25,18,13,5,1.39,72.22,13,12,53.05,Adapte,Difficile,Adapte / Difficile
1315,486,2016,Droit,3,4,QCM,0.7814,0.03,0.71,27,25,21,4,1.08,84.0,21,6,78.14,Facile,Facile,Facile / Facile
2145,486,2017,Droit,3,4,QCM,0.813,0.1,0.79,28,23,23,0,1.22,100.0,23,5,81.3,Facile,Facile,Facile / Facile
2975,486,2018,Droit,3,4,QCM,0.0557,0.73,0.26,26,12,1,11,2.17,8.33,1,25,5.57,Facile,Trop Difficile,Facile / Trop Difficile
3805,486,2019,Droit,3,4,QCM,0.7889,0.17,0.73,31,25,24,1,1.24,96.0,24,7,78.89,Facile,Facile,Facile / Facile
4635,486,2020,Droit,3,4,QCM,0.7697,0.14,0.74,29,23,22,1,1.26,95.65,22,7,76.97,Facile,Facile,Facile / Facile
486,487,2015,Droit,3,5,QCM,0.9839,0.08,0.81,87,86,86,0,1.01,100.0,86,1,98.39,Trop Facile,Trop Facile,Trop Facile / Trop Facile
1316,487,2016,Droit,3,5,QCM,0.5329,0.12,0.35,98,56,52,4,1.75,92.86,52,46,53.29,Facile,Difficile,Facile / Difficile
2146,487,2017,Droit,3,5,QCM,0.7893,0.18,0.77,101,83,80,3,1.22,96.39,80,21,78.93,Facile,Facile,Facile / Facile
2976,487,2018,Droit,3,5,QCM,0.9764,0.03,0.9,106,104,103,1,1.02,99.04,103,3,97.64,Facile,Trop Facile,Facile / Trop Facile
3806,487,2019,Droit,3,5,QCM,0.6619,0.01,0.57,121,103,80,23,1.17,77.67,80,41,66.19,Facile,Adapte,Facile / Adapte
4636,487,2020,Droit,3,5,QCM,0.7389,0.22,0.48,124,95,92,3,1.31,96.84,92,32,73.89,Adapte,Adapte,Adapte / Adapte
487,488,2015,Droit,3,6,QCU,0.0818,0.05,0.29,44,32,4,28,1.38,12.5,4,40,8.18,Trop Difficile,Trop Difficile,Trop Difficile / Trop Difficile
1317,488,2016,Droit,3,6,QCU,0.6068,0.23,0.47,38,27,23,4,1.41,85.19,23,15,60.68,Trop Facile,Adapte,Trop Facile / Adapte
2147,488,2017,Droit,3,6,QCU,0.6783,0.27,0.62,34,33,23,10,1.03,69.7,23,11,67.83,Adapte,Adapte,Adapte / Adapte
2977,488,2018,Droit,3,6,QCU,0.6614,0.15,0.54,35,30,23,7,1.17,76.67,23,12,66.14,Adapte,Adapte,Adapte / Adapte
3807,488,2019,Droit,3,6,QCU,0.7345,0.08,0.54,32,25,24,1,1.28,96.0,24,8,73.45,Adapte,Adapte,Adapte / Adapte
4637,488,2020,Droit,3,6,QCU,0.6927,0.01,0.64,36,32,25,7,1.12,78.12,25,11,69.27,Adapte,Adapte,Adapte / Adapte
488,489,2015,Droit,3,7,QCU,0.7609,0.17,0.79,53,44,40,4,1.2,90.91,40,13,76.09,Facile,Facile,Facile / Facile
1318,489,2016,Droit,3,7,QCU,0.8784,0.08,0.92,55,53,48,5,1.04,90.57,48,7,87.84,Trop Facile,Trop Facile,Trop Facile / Trop Facile
2148,489,2017,Droit,3,7,QCU,0.9516,0.06,0.98,62,60,59,1,1.03,98.33,59,3,95.16,Trop Facile,Trop Facile,Trop Facile / Trop Facile
2978,489,2018,Droit,3,7,QCU,0.905,0.06,0.9,68,64,62,2,1.06,96.88,62,6,90.5,Trop Facile,Trop Facile,Trop Facile / Trop Facile
3808,489,2019,Droit,3,7,QCU,0.8603,0.05,0.93,74,65,64,1,1.14,98.46,64,10,86.03,Trop Facile,Trop Facile,Trop Facile / Trop Facile
4638,489,2020,Droit,3,7,QCU,0.8869,0.08,0.91,59,56,52,4,1.05,92.86,52,7,88.69,Trop Facile,Trop Facile,Trop Facile / Trop Facile
489,490,2015,Droit,3,8,QCM,0.2558,0.14,0.31,84,40,21,19,2.1,52.5,21,63,25.58,Adapte,Difficile,Adapte / Difficile
1319,490,2016,Droit,3,8,QCM,0.8358,0.05,0.72,99,86,83,3,1.15,96.51,83,16,83.58,Facile,Facile,Facile / Facile
2149,490,2017,Droit,3,8,QCM,0.8806,0.08,0.91,93,85,82,3,1.09,96.47,82,11,88.06,Facile,Trop Facile,Facile / Trop Facile
2979,490,2018,Droit,3,8,QCM,0.5403,0.16,0.35,85,85,46,39,1.0,54.12,46,39,54.03,Facile,Difficile,Facile / Difficile
3809,490,2019,Droit,3,8,QCM,0.8177,0.04,0.75,100,93,82,11,1.08,88.17,82,18,81.77,Facile,Facile,Facile / Facile
4639,490,2020,Droit,3,8,QCM,0.8882,0.06,0.95,85,77,75,2,1.1,97.4,75,10,88.82,Facile,Trop Facile,Facile / Trop Facile
490,491,2015,Droit,3,9,QCU,0.1327,0.57,0.21,8,7,1,6,1.14,14.29,1,7,13.27,Trop Difficile,Trop Difficile,Trop Difficile / Trop Difficile
1320,491,2016,Droit,3,9,QCU,0.5658,0.35,0.38,9,9,5,4,1.0,55.56,5,4,56.58,Trop Facile,Difficile,Trop Facile / Difficile
2150,491,2017,Droit,3,9,QCU,0.9375,0.08,0.98,11,11,10,1,1.0,90.91,10,1,93.75,Trop Facile,Trop Facile,Trop Facile / Trop Facile
2980,491,2018,Droit,3,9,QCU,0.8122,0.0,0.84,11,10,9,1,1.1,90.0,9,2,81.22,Trop Facile,Facile,Trop Facile / Facile
3810,491,2019,Droit,3,9,QCU,0.1615,0.39,0.22,12,4,2,2,3.0,50.0,2,10,16.15,Trop Facile,Trop Difficile,Trop Facile / Trop Difficile
4640,491,2020,Droit,3,9,QCU,0.9221,0.07,0.91,10,9,9,0,1.11,100.0,9,1,92.21,Trop Facile,Trop Facile,Trop Facile / Trop Facile
491,492,2015,Droit,3,10,QCM,0.1887,0.64,0.27,20,7,4,3,2.86,57.14,4,16,18.87,Difficile,Trop Difficile,Difficile / Trop Difficile
1321,492,2016,Droit,3,10,QCM,0.0098,0.06,0.28,21,14,0,14,1.5,0.0,0,21,0.98,Facile,Trop Difficile,Facile / Trop Difficile
2151,492,2017,Droit,3,10,QCM,0.8324,0.19,0.74,19,16,16,0,1.19,100.0,16,3,83.24,Facile,Facile,Facile / Facile
2981,492,2018,Droit,3,10,QCM,0.766,0.14,0.72,17,16,13,3,1.06,81.25,13,4,76.6,Facile,Facile,Facile / Facile
3811,492,2019,Droit,3,10,QCM,0.8197,0.15,0.79,19,16,16,0,1.19,100.0,16,3,81.97,Facile,Facile,Facile / Facile
4641,492,2020,Droit,3,10,QCM,0.8363,0.12,0.7,17,15,14,1,1.13,93.33,14,3,83.63,Facile,Facile,Facile / Facile
492,493,2015,Droit,4,1,QO,0.1387,0.92,0.03,79,58,11,47,1.36,18.97,11,68,13.87,Facile,Trop Difficile,Facile / Trop Difficile
1322,493,2016,Droit,4,1,QO,0.6533,0.35,0.25,77,56,50,6,1.38,89.29,50,27,65.33,Adapte,Adapte,Adapte / Adapte
2152,493,2017,Droit,4,1,QO,0.7002,0.64,0.24,80,61,56,5,1.31,91.8,56,24,70.02,Adapte,Adapte,Adapte / Adapte
2982,493,2018,Droit,4,1,QO,0.6448,0.39,0.27,87,67,56,11,1.3,83.58,56,31,64.48,Adapte,Adapte,Adapte / Adapte
3812,493,2019,Droit,4,1,QO,0.6471,0.37,0.29,91,68,59,9,1.34,86.76,59,32,64.71,Adapte,Adapte,Adapte / Adapte
4642,493,2020,Droit,4,1,QO,0.6862,0.64,0.21,104,82,71,11,1.27,86.59,71,33,68.62,Adapte,Adapte,Adapte / Adapte
493,494,2015,Droit,4,2,QCU,0.9729,0.09,0.98,92,90,90,0,1.02,100.0,90,2,97.29,Trop Facile,Trop Facile,Trop Facile / Trop Facile
1323,494,2016,Droit,4,2,QCU,0.9133,0.0,0.98,90,85,82,3,1.06,96.47,82,8,91.33,Trop Facile,Trop Facile,Trop Facile / Trop Facile
2153,494,2017,Droit,4,2,QCU,0.7858,0.03,0.8,107,102,84,18,1.05,82.35,84,23,78.58,Trop Facile,Facile,Trop Facile / Facile
2983,494,2018,Droit,4,2,QCU,0.8695,0.05,1.0,120,119,104,15,1.01,87.39,104,16,86.95,Trop Facile,Trop Facile,Trop Facile / Trop Facile
3813,494,2019,Droit,4,2,QCU,0.9986,0.06,0.91,140,140,140,0,1.0,100.0,140,0,99.86,Trop Facile,Trop Facile,Trop Facile / Trop Facile
4643,494,2020,Droit,4,2,QCU,0.9503,0.07,0.98,161,158,153,5,1.02,96.84,153,8,95.03,Trop Facile,Trop Facile,Trop Facile / Trop Facile
494,495,2015,Droit,4,3,QCM,0.9158,0.01,0.86,40,40,37,3,1.0,92.5,37,3,91.58,Adapte,Trop Facile,Adapte / Trop Facile
1324,495,2016,Droit,4,3,QCM,0.7999,0.01,0.78,40,34,32,2,1.18,94.12,32,8,79.99,Facile,Facile,Facile / Facile
2154,495,2017,Droit,4,3,QCM,0.812,0.05,0.76,35,30,28,2,1.17,93.33,28,7,81.2,Facile,Facile,Facile / Facile
2984,495,2018,Droit,4,3,QCM,0.8172,0.13,0.73,28,25,23,2,1.12,92.0,23,5,81.72,Facile,Facile,Facile / Facile
3814,495,2019,Droit,4,3,QCM,0.7782,0.06,0.79,29,23,23,0,1.26,100.0,23,6,77.82,Facile,Facile,Facile / Facile
4644,495,2020,Droit,4,3,QCM,0.8254,0.06,0.75,31,30,26,4,1.03,86.67,26,5,82.54,Facile,Facile,Facile / Facile
495,496,2015,Droit,4,4,QCU,0.8389,0.08,0.75,39,33,33,0,1.18,100.0,33,6,83.89,Facile,Facile,Facile / Facile
1325,496,2016,Droit,4,4,QCU,0.6364,0.2,0.54,39,37,25,12,1.05,67.57,25,14,63.64,Trop Facile,Adapte,Trop Facile / Adapte
2155,496,2017,Droit,4,4,QCU,0.6164,0.08,0.49,36,30,22,8,1.2,73.33,22,14,61.64,Adapte,Adapte,Adapte / Adapte
2985,496,2018,Droit,4,4,QCU,0.6227,0.04,0.64,31,22,19,3,1.41,86.36,19,12,62.27,Adapte,Adapte,Adapte / Adapte
3815,496,2019,Droit,4,4,QCU,0.6875,0.06,0.43,32,32,22,10,1.0,68.75,22,10,68.75,Adapte,Adapte,Adapte / Adapte
4645,496,2020,Droit,4,4,QCU,0.7174,0.17,0.64,37,34,27,7,1.09,79.41,27,10,71.74,Adapte,Adapte,Adapte / Adapte
496,497,2015,Droit,4,5,QCU,0.1377,0.06,0.23,18,13,2,11,1.38,15.38,2,16,13.77,Trop Difficile,Trop Difficile,Trop Difficile / Trop Difficile
1326,497,2016,Droit,4,5,QCU,0.9455,0.02,0.91,16,16,15,1,1.0,93.75,15,1,94.55,Trop Facile,Trop Facile,Trop Facile / Trop Facile
2156,497,2017,Droit,4,5,QCU,0.8675,0.02,0.94,15,15,13,2,1.0,86.67,13,2,86.75,Trop Facile,Trop Facile,Trop Facile / Trop Facile
2986,497,2018,Droit,4,5,QCU,0.9553,0.09,0.96,15,15,14,1,1.0,93.33,14,1,95.53,Trop Facile,Trop Facile,Trop Facile / Trop Facile
3816,497,2019,Droit,4,5,QCU,0.8906,0.09,0.96,17,17,15,2,1.0,88.24,15,2,89.06,Trop Facile,Trop Facile,Trop Facile / Trop Facile
4646,497,2020,Droit,4,5,QCU,0.9387,0.0,0.9,16,16,15,1,1.0,93.75,15,1,93.87,Trop Facile,Trop Facile,Trop Facile / Trop Facile
497,498,2015,Droit,4,6,QCU,0.8073,0.07,0.8,57,51,46,5,1.12,90.2,46,11,80.73,Facile,Facile,Facile / Facile
1327,498,2016,Droit,4,6,QCU,0.9633,0.09,0.97,48,47,46,1,1.02,97.87,46,2,96.33,Trop Facile,Trop Facile,Trop Facile / Trop Facile
2157,498,2017,Droit,4,6,QCU,0.9748,0.04,0.91,38,38,37,1,1.0,97.37,37,1,97.48,Trop Facile,Trop Facile,Trop Facile / Trop Facile
2987,498,2018,Droit,4,6,QCU,0.9869,0.05,0.95,46,45,45,0,1.02,100.0,45,1,98.69,Trop Facile,Trop Facile,Trop Facile / Trop Facile
3817,498,2019,Droit,4,6,QCU,0.9177,0.08,0.92,51,48,47,1,1.06,97.92,47,4,91.77,Trop Facile,Trop Facile,Trop Facile / Trop Facile
4647,498,2020,Droit,4,6,QCU,0.8645,0.08,0.95,41,40,35,5,1.02,87.5,35,6,86.45,Trop Facile,Trop Facile,Trop Facile / Trop Facile
498,499,2015,Droit,4,7,QCU,0.8827,0.08,0.93,47,45,41,4,1.04,91.11,41,6,88.27,Trop Facile,Trop Facile,Trop Facile / Trop Facile
1328,499,2016,Droit,4,7,QCU,0.8407,0.05,0.85,40,34,34,0,1.18,100.0,34,6,84.07,Trop Facile,Facile,Trop Facile / Facile
2158,499,2017,Droit,4,7,QCU,0.922,0.07,0.95,35,35,32,3,1.0,91.43,32,3,92.2,Trop Facile,Trop Facile,Trop Facile / Trop Facile
2988,499,2018,Droit,4,7,QCU,0.9151,0.07,0.95,37,36,34,2,1.03,94.44,34,3,91.51,Trop Facile,Trop Facile,Trop Facile / Trop Facile
3818,499,2019,Droit,4,7,QCU,0.9007,0.05,0.95,44,43,40,3,1.02,93.02,40,4,90.07,Trop Facile,Trop Facile,Trop Facile / Trop Facile
4648,499,2020,Droit,4,7,QCU,0.8853,0.02,0.94,35,31,31,0,1.13,100.0,31,4,88.53,Trop Facile,Trop Facile,Trop Facile / Trop Facile
499,500,2015,Droit,4,8,QCM,0.1523,0.51,0.23,41,25,6,19,1.64,24.0,6,35,15.23,Facile,Trop Difficile,Facile / Trop Difficile
1329,500,2016,Droit,4,8,QCM,0.9807,0.08,0.9,33,32,32,0,1.03,100.0,32,1,98.07,Facile,Trop Facile,Facile / Trop Facile
2159,500,2017,Droit,4,8,QCM,0.6925,0.15,0.55,26,18,18,0,1.44,100.0,18,8,69.25,Facile,Adapte,Facile / Adapte
2989,500,2018,Droit,4,8,QCM,0.6064,0.14,0.4,29,24,18,6,1.21,75.0,18,11,60.64,Adapte,Adapte,Adapte / Adapte
3819,500,2019,Droit,4,8,QCM,0.7487,0.06,0.42,24,20,18,2,1.2,90.0,18,6,74.87,Adapte,Adapte,Adapte / Adapte
4649,500,2020,Droit,4,8,QCM,0.6634,0.19,0.66,24,18,16,2,1.33,88.89,16,8,66.34,Adapte,Adapte,Adapte / Adapte
500,501,2015,Droit,4,9,QO,0.4806,0.81,0.04,52,50,25,25,1.04,50.0,25,27,48.06,Trop Difficile,Difficile,Trop Difficile / Difficile
1330,501,2016,Droit,4,9,QO,0.7144,0.49,0.24,46,38,33,5,1.21,86.84,33,13,71.44,Adapte,Adapte,Adapte / Adapte
2160,501,2017,Droit,4,9,QO,0.6876,0.35,0.21,45,45,31,14,1.0,68.89,31,14,68.76,Adapte,Adapte,Adapte / Adapte
2990,501,2018,Droit,4,9,QO,0.6986,0.58,0.19,47,46,33,13,1.02,71.74,33,14,69.86,Adapte,Adapte,Adapte / Adapte
3820,501,2019,Droit,4,9,QO,0.7377,0.7,0.27,40,40,30,10,1.0,75.0,30,10,73.77,Adapte,Adapte,Adapte / Adapte
4650,501,2020,Droit,4,9,QO,0.6834,0.23,0.3,37,26,25,1,1.42,96.15,25,12,68.34,Adapte,Adapte,Adapte / Adapte
501,502,2015,Droit,5,1,QROC,0.0892,0.88,0.06,44,26,4,22,1.69,15.38,4,40,8.92,Trop Difficile,Trop Difficile,Trop Difficile / Trop Difficile
1331,502,2016,Droit,5,1,QROC,0.8967,0.06,0.7,48,46,43,3,1.04,93.48,43,5,89.67,Facile,Trop Facile,Facile / Trop Facile
2161,502,2017,Droit,5,1,QROC,0.8127,0.19,0.67,45,45,37,8,1.0,82.22,37,8,81.27,Facile,Facile,Facile / Facile
2991,502,2018,Droit,5,1,QROC,0.8494,0.06,0.72,48,47,41,6,1.02,87.23,41,7,84.94,Facile,Facile,Facile / Facile
3821,502,2019,Droit,5,1,QROC,0.8024,0.03,0.58,40,39,32,7,1.03,82.05,32,8,80.24,Facile,Facile,Facile / Facile
4651,502,2020,Droit,5,1,QROC,0.8223,0.16,0.61,34,29,28,1,1.17,96.55,28,6,82.23,Facile,Facile,Facile / Facile
502,503,2015,Droit,5,2,QCU,0.2301,0.47,0.29,52,18,12,6,2.89,66.67,12,40,23.01,Trop Difficile,Trop Difficile,Trop Difficile / Trop Difficile
1332,503,2016,Droit,5,2,QCU,0.2655,0.17,0.32,49,21,13,8,2.33,61.9,13,36,26.55,Trop Facile,Difficile,Trop Facile / Difficile
2162,503,2017,Droit,5,2,QCU,0.9145,0.05,0.97,49,48,45,3,1.02,93.75,45,4,91.45,Trop Facile,Trop Facile,Trop Facile / Trop Facile
2992,503,2018,Droit,5,2,QCU,0.9941,0.02,0.98,57,57,57,0,1.0,100.0,57,0,99.41,Trop Facile,Trop Facile,Trop Facile / Trop Facile
3822,503,2019,Droit,5,2,QCU,0.7258,0.03,0.52,46,34,33,1,1.35,97.06,33,13,72.58,Trop Facile,Adapte,Trop Facile / Adapte
4652,503,2020,Droit,5,2,QCU,0.6721,0.14,0.65,40,32,27,5,1.25,84.38,27,13,67.21,Adapte,Adapte,Adapte / Adapte
503,504,2015,Droit,5,3,QCU,0.849,0.05,0.75,59,55,50,5,1.07,90.91,50,9,84.9,Facile,Facile,Facile / Facile
1333,504,2016,Droit,5,3,QCU,0.9088,0.02,0.96,69,65,63,2,1.06,96.92,63,6,90.88,Trop Facile,Trop Facile,Trop Facile / Trop Facile
2163,504,2017,Droit,5,3,QCU,0.0073,0.02,0.25,55,30,0,30,1.83,0.0,0,55,0.73,Trop Facile,Trop Difficile,Trop Facile / Trop Difficile
2993,504,2018,Droit,5,3,QCU,0.8743,0.06,0.95,64,62,56,6,1.03,90.32,56,8,87.43,Trop Facile,Trop Facile,Trop Facile / Trop Facile
3823,504,2019,Droit,5,3,QCU,0.8304,0.14,0.83,71,61,59,2,1.16,96.72,59,12,83.04,Trop Facile,Facile,Trop Facile / Facile
4653,504,2020,Droit,5,3,QCU,0.9089,0.05,0.99,76,72,69,3,1.06,95.83,69,7,90.89,Trop Facile,Trop Facile,Trop Facile / Trop Facile
504,505,2015,Droit,5,4,QCM,0.9261,0.0,0.87,81,79,75,4,1.03,94.94,75,6,92.61,Difficile,Trop Facile,Difficile / Trop Facile
1334,505,2016,Droit,5,4,QCM,0.8135,0.18,0.78,81,76,66,10,1.07,86.84,66,15,81.35,Facile,Facile,Facile / Facile
2164,505,2017,Droit,5,4,QCM,0.0947,0.34,0.29,87,47,8,39,1.85,17.02,8,79,9.47,Facile,Trop Difficile,Facile / Trop Difficile
2994,505,2018,Droit,5,4,QCM,0.777,0.01,0.71,90,83,70,13,1.08,84.34,70,20,77.7,Facile,Facile,Facile / Facile
3824,505,2019,Droit,5,4,QCM,0.8326,0.06,0.75,73,64,61,3,1.14,95.31,61,12,83.26,Facile,Facile,Facile / Facile
4654,505,2020,Droit,5,4,QCM,0.8826,0.09,0.89,77,72,68,4,1.07,94.44,68,9,88.26,Facile,Trop Facile,Facile / Trop Facile
505,506,2015,Droit,5,5,QROC,0.3559,0.74,0.18,13,13,5,8,1.0,38.46,5,8,35.59,Difficile,Difficile,Difficile / Difficile
1335,506,2016,Droit,5,5,QROC,0.8034,0.13,0.7,10,9,8,1,1.11,88.89,8,2,80.34,Facile,Facile,Facile / Facile
2165,506,2017,Droit,5,5,QROC,0.812,0.13,0.66,12,11,10,1,1.09,90.91,10,2,81.2,Facile,Facile,Facile / Facile
2995,506,2018,Droit,5,5,QROC,0.7819,0.02,0.51,10,9,8,1,1.11,88.89,8,2,78.19,Facile,Facile,Facile / Facile
3825,506,2019,Droit,5,5,QROC,0.7775,0.17,0.69,12,10,9,1,1.2,90.0,9,3,77.75,Facile,Facile,Facile / Facile
4655,506,2020,Droit,5,5,QROC,0.8408,0.18,0.41,13,11,11,0,1.18,100.0,11,2,84.08,Facile,Facile,Facile / Facile
506,507,2015,Droit,5,6,QCU,0.0487,0.08,0.22,94,74,5,69,1.27,6.76,5,89,4.87,Trop Difficile,Trop Difficile,Trop Difficile / Trop Difficile
1336,507,2016,Droit,5,6,QCU,0.9842,0.03,0.92,80,80,79,1,1.0,98.75,79,1,98.42,Trop Facile,Trop Facile,Trop Facile / Trop Facile
2166,507,2017,Droit,5,6,QCU,0.9483,0.05,0.93,89,86,84,2,1.03,97.67,84,5,94.83,Trop Facile,Trop Facile,Trop Facile / Trop Facile
2996,507,2018,Droit,5,6,QCU,0.9134,0.03,0.92,92,90,84,6,1.02,93.33,84,8,91.34,Trop Facile,Trop Facile,Trop Facile / Trop Facile
3826,507,2019,Droit,5,6,QCU,0.9759,0.06,0.9,96,96,94,2,1.0,97.92,94,2,97.59,Trop Facile,Trop Facile,Trop Facile / Trop Facile
4656,507,2020,Droit,5,6,QCU,0.5097,0.4,0.31,83,59,42,17,1.41,71.19,42,41,50.97,Trop Facile,Difficile,Trop Facile / Difficile
507,508,2015,Droit,5,7,QCU,0.6939,0.19,0.41,53,47,37,10,1.13,78.72,37,16,69.39,Adapte,Adapte,Adapte / Adapte
1337,508,2016,Droit,5,7,QCU,0.6274,0.03,0.69,49,33,31,2,1.48,93.94,31,18,62.74,Adapte,Adapte,Adapte / Adapte
2167,508,2017,Droit,5,7,QCU,0.6683,0.24,0.66,45,33,30,3,1.36,90.91,30,15,66.83,Adapte,Adapte,Adapte / Adapte
2997,508,2018,Droit,5,7,QCU,0.6072,0.18,0.59,44,35,27,8,1.26,77.14,27,17,60.72,Adapte,Adapte,Adapte / Adapte
3827,508,2019,Droit,5,7,QCU,0.6918,0.23,0.59,42,31,29,2,1.35,93.55,29,13,69.18,Adapte,Adapte,Adapte / Adapte
4657,508,2020,Droit,5,7,QCU,0.6058,0.23,0.6,34,21,21,0,1.62,100.0,21,13,60.58,Adapte,Adapte,Adapte / Adapte
508,509,2015,Droit,5,8,QROC,0.8698,0.1,0.87,80,70,70,0,1.14,100.0,70,10,86.98,Trop Facile,Trop Facile,Trop Facile / Trop Facile
1338,509,2016,Droit,5,8,QROC,0.8342,0.0,0.48,65,64,54,10,1.02,84.38,54,11,83.42,Facile,Facile,Facile / Facile
2168,509,2017,Droit,5,8,QROC,0.7399,0.5,0.32,57,48,42,6,1.19,87.5,42,15,73.99,Facile,Adapte,Facile / Adapte
2998,509,2018,Droit,5,8,QROC,0.6276,0.37,0.32,67,62,42,20,1.08,67.74,42,25,62.76,Adapte,Adapte,Adapte / Adapte
3828,509,2019,Droit,5,8,QROC,0.7451,0.37,0.29,63,50,47,3,1.26,94.0,47,16,74.51,Adapte,Adapte,Adapte / Adapte
4658,509,2020,Droit,5,8,QROC,0.7379,0.4,0.34,58,47,43,4,1.23,91.49,43,15,73.79,Adapte,Adapte,Adapte / Adapte
509,510,2015,Droit,6,1,QCU,0.9727,0.1,0.98,18,18,18,0,1.0,100.0,18,0,97.27,Facile,Trop Facile,Facile / Trop Facile
1339,510,2016,Droit,6,1,QCU,0.9517,0.07,0.96,15,15,14,1,1.0,93.33,14,1,95.17,Trop Facile,Trop Facile,Trop Facile / Trop Facile
2169,510,2017,Droit,6,1,QCU,0.9459,0.03,0.96,17,17,16,1,1.0,94.12,16,1,94.59,Trop Facile,Trop Facile,Trop Facile / Trop Facile
2999,510,2018,Droit,6,1,QCU,0.9368,0.07,0.91,15,14,14,0,1.07,100.0,14,1,93.68,Trop Facile,Trop Facile,Trop Facile / Trop Facile
3829,510,2019,Droit,6,1,QCU,0.8607,0.04,0.94,18,16,15,1,1.12,93.75,15,3,86.07,Trop Facile,Trop Facile,Trop Facile / Trop Facile
4659,510,2020,Droit,6,1,QCU,0.9256,0.04,0.98,20,20,19,1,1.0,95.0,19,1,92.56,Trop Facile,Trop Facile,Trop Facile / Trop Facile
510,511,2015,Droit,6,2,QCU,0.8899,0.04,0.94,46,41,41,0,1.12,100.0,41,5,88.99,Trop Facile,Trop Facile,Trop Facile / Trop Facile
1340,511,2016,Droit,6,2,QCU,0.8703,0.01,0.99,55,53,48,5,1.04,90.57,48,7,87.03,Trop Facile,Trop Facile,Trop Facile / Trop Facile
2170,511,2017,Droit,6,2,QCU,0.8798,0.04,0.9,55,51,48,3,1.08,94.12,48,7,87.98,Trop Facile,Trop Facile,Trop Facile / Trop Facile
3000,511,2018,Droit,6,2,QCU,0.9802,0.02,0.91,44,44,43,1,1.0,97.73,43,1,98.02,Trop Facile,Trop Facile,Trop Facile / Trop Facile
3830,511,2019,Droit,6,2,QCU,0.9069,0.09,0.99,43,40,39,1,1.07,97.5,39,4,90.69,Trop Facile,Trop Facile,Trop Facile / Trop Facile
4660,511,2020,Droit,6,2,QCU,0.5247,0.21,0.38,47,43,25,18,1.09,58.14,25,22,52.47,Trop Facile,Difficile,Trop Facile / Difficile
511,512,2015,Droit,6,3,QCM,0.6352,0.22,0.44,30,28,19,9,1.07,67.86,19,11,63.52,Trop Difficile,Adapte,Trop Difficile / Adapte
1341,512,2016,Droit,6,3,QCM,0.7071,0.18,0.5,35,30,25,5,1.17,83.33,25,10,70.71,Adapte,Adapte,Adapte / Adapte
2171,512,2017,Droit,6,3,QCM,0.7274,0.16,0.47,33,30,24,6,1.1,80.0,24,9,72.74,Adapte,Adapte,Adapte / Adapte
3001,512,2018,Droit,6,3,QCM,0.6055,0.03,0.43,29,20,18,2,1.45,90.0,18,11,60.55,Adapte,Adapte,Adapte / Adapte
3831,512,2019,Droit,6,3,QCM,0.6174,0.22,0.61,33,22,20,2,1.5,90.91,20,13,61.74,Adapte,Adapte,Adapte / Adapte
4661,512,2020,Droit,6,3,QCM,0.7161,0.07,0.58,39,35,28,7,1.11,80.0,28,11,71.61,Adapte,Adapte,Adapte / Adapte
512,513,2015,Droit,6,4,QCM,0.7442,0.23,0.51,7,6,5,1,1.17,83.33,5,2,74.42,Trop Facile,Adapte,Trop Facile / Adapte
1342,513,2016,Droit,6,4,QCM,0.6304,0.13,0.48,8,8,5,3,1.0,62.5,5,3,63.04,Adapte,Adapte,Adapte / Adapte
2172,513,2017,Droit,6,4,QCM,0.7395,0.28,0.43,9,9,7,2,1.0,77.78,7,2,73.95,Adapte,Adapte,Adapte / Adapte
3002,513,2018,Droit,6,4,QCM,0.6129,0.26,0.41,7,4,4,0,1.75,100.0,4,3,61.29,Adapte,Adapte,Adapte / Adapte
3832,513,2019,Droit,6,4,QCM,0.6306,0.27,0.63,8,5,5,0,1.6,100.0,5,3,63.06,Adapte,Adapte,Adapte / Adapte
4662,513,2020,Droit,6,4,QCM,0.726,0.19,0.69,9,9,7,2,1.0,77.78,7,2,72.6,Adapte,Adapte,Adapte / Adapte
513,514,2015,Droit,6,5,QCM,0.2009,0.28,0.21,66,31,13,18,2.13,41.94,13,53,20.09,Trop Difficile,Trop Difficile,Trop Difficile / Trop Difficile
1343,514,2016,Droit,6,5,QCM,0.8366,0.02,0.77,54,52,45,7,1.04,86.54,45,9,83.66,Facile,Facile,Facile / Facile
2173,514,2017,Droit,6,5,QCM,0.6493,0.13,0.45,55,36,36,0,1.53,100.0,36,19,64.93,Facile,Adapte,Facile / Adapte
3003,514,2018,Droit,6,5,QCM,0.6291,0.08,0.43,65,54,41,13,1.2,75.93,41,24,62.91,Adapte,Adapte,Adapte / Adapte
3833,514,2019,Droit,6,5,QCM,0.7284,0.3,0.57,58,56,42,14,1.04,75.0,42,16,72.84,Adapte,Adapte,Adapte / Adapte
4663,514,2020,Droit,6,5,QCM,0.6794,0.2,0.44,60,58,41,17,1.03,70.69,41,19,67.94,Adapte,Adapte,Adapte / Adapte
514,515,2015,Droit,6,6,QCM,0.7606,0.12,0.76,82,70,62,8,1.17,88.57,62,20,76.06,Facile,Facile,Facile / Facile
1344,515,2016,Droit,6,6,QCM,0.8381,0.04,0.79,66,60,55,5,1.1,91.67,55,11,83.81,Facile,Facile,Facile / Facile
2174,515,2017,Droit,6,6,QCM,0.8064,0.05,0.76,56,48,45,3,1.17,93.75,45,11,80.64,Facile,Facile,Facile / Facile
3004,515,2018,Droit,6,6,QCM,0.8038,0.07,0.73,63,52,51,1,1.21,98.08,51,12,80.38,Facile,Facile,Facile / Facile
3834,515,2019,Droit,6,6,QCM,0.7961,0.15,0.73,56,45,45,0,1.24,100.0,45,11,79.61,Facile,Facile,Facile / Facile
4664,515,2020,Droit,6,6,QCM,0.773,0.06,0.78,54,46,42,4,1.17,91.3,42,12,77.3,Facile,Facile,Facile / Facile
515,516,2015,Droit,6,7,QCM,0.6789,0.29,0.52,70,62,48,14,1.13,77.42,48,22,67.89,Adapte,Adapte,Adapte / Adapte
1345,516,2016,Droit,6,7,QCM,0.6793,0.04,0.46,59,44,40,4,1.34,90.91,40,19,67.93,Adapte,Adapte,Adapte / Adapte
2175,516,2017,Droit,6,7,QCM,0.689,0.07,0.68,68,54,47,7,1.26,87.04,47,21,68.9,Adapte,Adapte,Adapte / Adapte
3005,516,2018,Droit,6,7,QCM,0.7302,0.07,0.6,81,65,59,6,1.25,90.77,59,22,73.02,Adapte,Adapte,Adapte / Adapte
3835,516,2019,Droit,6,7,QCM,0.7056,0.23,0.61,87,71,61,10,1.23,85.92,61,26,70.56,Adapte,Adapte,Adapte / Adapte
4665,516,2020,Droit,6,7,QCM,0.741,0.1,0.61,70,57,52,5,1.23,91.23,52,18,74.1,Adapte,Adapte,Adapte / Adapte
516,517,2015,Droit,6,8,QCM,0.2663,0.18,0.33,41,32,11,21,1.28,34.38,11,30,26.63,Facile,Difficile,Facile / Difficile
1346,517,2016,Droit,6,8,QCM,0.7127,0.28,0.65,46,38,33,5,1.21,86.84,33,13,71.27,Facile,Adapte,Facile / Adapte
2176,517,2017,Droit,6,8,QCM,0.7172,0.12,0.53,43,34,31,3,1.26,91.18,31,12,71.72,Adapte,Adapte,Adapte / Adapte
3006,517,2018,Droit,6,8,QCM,0.6479,0.27,0.42,48,42,31,11,1.14,73.81,31,17,64.79,Adapte,Adapte,Adapte / Adapte
3836,517,2019,Droit,6,8,QCM,0.6702,0.19,0.47,55,47,37,10,1.17,78.72,37,18,67.02,Adapte,Adapte,Adapte / Adapte
4666,517,2020,Droit,6,8,QCM,0.6798,0.27,0.47,48,40,33,7,1.2,82.5,33,15,67.98,Adapte,Adapte,Adapte / Adapte
517,518,2015,Droit,7,1,QROC,0.4043,0.66,0.24,82,64,33,31,1.28,51.56,33,49,40.43,Difficile,Difficile,Difficile / Difficile
1347,518,2016,Droit,7,1,QROC,0.7711,0.17,0.65,70,60,54,6,1.17,90.0,54,16,77.11,Facile,Facile,Facile / Facile
2177,518,2017,Droit,7,1,QROC,0.698,0.25,0.38,61,54,43,11,1.13,79.63,43,18,69.8,Facile,Adapte,Facile / Adapte
3007,518,2018,Droit,7,1,QROC,0.71,0.32,0.38,50,40,36,4,1.25,90.0,36,14,71.0,Adapte,Adapte,Adapte / Adapte
3837,518,2019,Droit,7,1,QROC,0.6814,0.26,0.33,43,30,29,1,1.43,96.67,29,14,68.14,Adapte,Adapte,Adapte / Adapte
4667,518,2020,Droit,7,1,QROC,0.6381,0.3,0.4,51,34,33,1,1.5,97.06,33,18,63.81,Adapte,Adapte,Adapte / Adapte
518,519,2015,Droit,7,2,QCU,0.0961,0.21,0.23,85,31,8,23,2.74,25.81,8,77,9.61,Trop Difficile,Trop Difficile,Trop Difficile / Trop Difficile
1348,519,2016,Droit,7,2,QCU,0.7835,0.03,0.87,98,95,77,18,1.03,81.05,77,21,78.35,Trop Facile,Facile,Trop Facile / Facile
2178,519,2017,Droit,7,2,QCU,0.9026,0.0,0.98,92,91,83,8,1.01,91.21,83,9,90.26,Trop Facile,Trop Facile,Trop Facile / Trop Facile
3008,519,2018,Droit,7,2,QCU,0.9754,0.06,0.95,102,100,99,1,1.02,99.0,99,3,97.54,Trop Facile,Trop Facile,Trop Facile / Trop Facile
3838,519,2019,Droit,7,2,QCU,0.1056,0.17,0.29,91,36,10,26,2.53,27.78,10,81,10.56,Trop Facile,Trop Difficile,Trop Facile / Trop Difficile
4668,519,2020,Droit,7,2,QCU,0.8845,0.04,0.98,79,76,70,6,1.04,92.11,70,9,88.45,Trop Facile,Trop Facile,Trop Facile / Trop Facile
519,520,2015,Droit,8,1,QROC,0.9376,0.1,0.97,55,54,52,2,1.02,96.3,52,3,93.76,Difficile,Trop Facile,Difficile / Trop Facile
1349,520,2016,Droit,8,1,QROC,0.8274,0.07,0.55,44,39,36,3,1.13,92.31,36,8,82.74,Facile,Facile,Facile / Facile
2179,520,2017,Droit,8,1,QROC,0.5296,0.66,0.16,38,27,20,7,1.41,74.07,20,18,52.96,Facile,Difficile,Facile / Difficile
3009,520,2018,Droit,8,1,QROC,0.8285,0.05,0.41,38,33,31,2,1.15,93.94,31,7,82.85,Facile,Facile,Facile / Facile
3839,520,2019,Droit,8,1,QROC,0.888,0.02,0.62,40,40,36,4,1.0,90.0,36,4,88.8,Facile,Trop Facile,Facile / Trop Facile
4669,520,2020,Droit,8,1,QROC,0.7681,0.15,0.65,35,30,27,3,1.17,90.0,27,8,76.81,Facile,Facile,Facile / Facile
520,521,2015,Droit,8,2,QCU,0.131,0.67,0.25,10,6,1,5,1.67,16.67,1,9,13.1,Trop Difficile,Trop Difficile,Trop Difficile / Trop Difficile
1350,521,2016,Droit,8,2,QCU,0.6461,0.29,0.59,9,8,6,2,1.12,75.0,6,3,64.61,Trop Facile,Adapte,Trop Facile / Adapte
2180,521,2017,Droit,8,2,QCU,0.6509,0.23,0.64,10,7,7,0,1.43,100.0,7,3,65.09,Adapte,Adapte,Adapte / Adapte
3010,521,2018,Droit,8,2,QCU,0.6968,0.25,0.65,12,9,8,1,1.33,88.89,8,4,69.68,Adapte,Adapte,Adapte / Adapte
3840,521,2019,Droit,8,2,QCU,0.6956,0.1,0.59,13,11,9,2,1.18,81.82,9,4,69.56,Adapte,Adapte,Adapte / Adapte
4670,521,2020,Droit,8,2,QCU,0.7336,0.21,0.53,15,13,11,2,1.15,84.62,11,4,73.36,Adapte,Adapte,Adapte / Adapte
521,522,2015,Droit,8,3,QCM,0.2943,0.31,0.4,78,56,23,33,1.39,41.07,23,55,29.43,Difficile,Difficile,Difficile / Difficile
1351,522,2016,Droit,8,3,QCM,0.8016,0.05,0.73,83,72,67,5,1.15,93.06,67,16,80.16,Facile,Facile,Facile / Facile
2181,522,2017,Droit,8,3,QCM,0.8024,0.07,0.78,83,73,67,6,1.14,91.78,67,16,80.24,Facile,Facile,Facile / Facile
3011,522,2018,Droit,8,3,QCM,0.7825,0.15,0.77,78,77,61,16,1.01,79.22,61,17,78.25,Facile,Facile,Facile / Facile
3841,522,2019,Droit,8,3,QCM,0.9419,0.04,0.82,90,86,85,1,1.05,98.84,85,5,94.19,Facile,Trop Facile,Facile / Trop Facile
4671,522,2020,Droit,8,3,QCM,0.0402,0.27,0.28,99,48,4,44,2.06,8.33,4,95,4.02,Facile,Trop Difficile,Facile / Trop Difficile
522,523,2015,Droit,9,1,QCM,0.6447,0.14,0.51,77,59,50,9,1.31,84.75,50,27,64.47,Trop Facile,Adapte,Trop Facile / Adapte
1352,523,2016,Droit,9,1,QCM,0.6935,0.27,0.59,80,69,55,14,1.16,79.71,55,25,69.35,Adapte,Adapte,Adapte / Adapte
2182,523,2017,Droit,9,1,QCM,0.7408,0.1,0.47,66,52,49,3,1.27,94.23,49,17,74.08,Adapte,Adapte,Adapte / Adapte
3012,523,2018,Droit,9,1,QCM,0.7439,0.23,0.51,78,59,58,1,1.32,98.31,58,20,74.39,Adapte,Adapte,Adapte / Adapte
3842,523,2019,Droit,9,1,QCM,0.6139,0.11,0.41,85,78,52,26,1.09,66.67,52,33,61.39,Adapte,Adapte,Adapte / Adapte
4672,523,2020,Droit,9,1,QCM,0.6194,0.12,0.59,70,67,43,24,1.04,64.18,43,27,61.94,Adapte,Adapte,Adapte / Adapte
523,524,2015,Droit,9,2,QCM,0.2588,0.05,0.35,56,20,14,6,2.8,70.0,14,42,25.88,Difficile,Difficile,Difficile / Difficile
1353,524,2016,Droit,9,2,QCM,0.8036,0.1,0.72,65,54,52,2,1.2,96.3,52,13,80.36,Facile,Facile,Facile / Facile
2183,524,2017,Droit,9,2,QCM,0.7207,0.22,0.48,66,60,48,12,1.1,80.0,48,18,72.07,Facile,Adapte,Facile / Adapte
3013,524,2018,Droit,9,2,QCM,0.6433,0.0,0.44,53,49,34,15,1.08,69.39,34,19,64.33,Adapte,Adapte,Adapte / Adapte
3843,524,2019,Droit,9,2,QCM,0.7313,0.05,0.46,54,48,39,9,1.12,81.25,39,15,73.13,Adapte,Adapte,Adapte / Adapte
4673,524,2020,Droit,9,2,QCM,0.7441,0.07,0.48,63,57,47,10,1.11,82.46,47,16,74.41,Adapte,Adapte,Adapte / Adapte
524,525,2015,Droit,9,3,QCM,0.7801,0.16,0.72,27,26,21,5,1.04,80.77,21,6,78.01,Facile,Facile,Facile / Facile
1354,525,2016,Droit,9,3,QCM,0.7693,0.04,0.79,27,21,21,0,1.29,100.0,21,6,76.93,Facile,Facile,Facile / Facile
2184,525,2017,Droit,9,3,QCM,0.6868,0.14,0.61,27,21,19,2,1.29,90.48,19,8,68.68,Facile,Adapte,Facile / Adapte
3014,525,2018,Droit,9,3,QCM,0.6,0.27,0.69,29,18,17,1,1.61,94.44,17,12,60.0,Adapte,Adapte,Adapte / Adapte
3844,525,2019,Droit,9,3,QCM,0.6701,0.27,0.42,33,29,22,7,1.14,75.86,22,11,67.01,Adapte,Adapte,Adapte / Adapte
4674,525,2020,Droit,9,3,QCM,0.6276,0.25,0.57,36,34,23,11,1.06,67.65,23,13,62.76,Adapte,Adapte,Adapte / Adapte
525,526,2015,Droit,9,4,QROC,0.9787,0.03,0.59,97,97,95,2,1.0,97.94,95,2,97.87,Trop Facile,Trop Facile,Trop Facile / Trop Facile
1355,526,2016,Droit,9,4,QROC,0.3587,0.55,0.2,84,80,30,50,1.05,37.5,30,54,35.87,Facile,Difficile,Facile / Difficile
2185,526,2017,Droit,9,4,QROC,0.783,0.12,0.61,94,93,74,19,1.01,79.57,74,20,78.3,Facile,Facile,Facile / Facile
3015,526,2018,Droit,9,4,QROC,0.6212,0.41,0.35,82,77,51,26,1.06,66.23,51,31,62.12,Facile,Adapte,Facile / Adapte
3845,526,2019,Droit,9,4,QROC,0.7003,0.28,0.3,93,74,65,9,1.26,87.84,65,28,70.03,Adapte,Adapte,Adapte / Adapte
4675,526,2020,Droit,9,4,QROC,0.6582,0.48,0.27,103,88,68,20,1.17,77.27,68,35,65.82,Adapte,Adapte,Adapte / Adapte
526,527,2015,Droit,9,5,QROC,0.7747,0.08,0.61,53,46,41,5,1.15,89.13,41,12,77.47,Trop Difficile,Facile,Trop Difficile / Facile
1356,527,2016,Droit,9,5,QROC,0.8028,0.06,0.67,58,51,47,4,1.14,92.16,47,11,80.28,Facile,Facile,Facile / Facile
2186,527,2017,Droit,9,5,QROC,0.7974,0.06,0.65,59,57,47,10,1.04,82.46,47,12,79.74,Facile,Facile,Facile / Facile
3016,527,2018,Droit,9,5,QROC,0.7733,0.1,0.69,49,42,38,4,1.17,90.48,38,11,77.33,Facile,Facile,Facile / Facile
3846,527,2019,Droit,9,5,QROC,0.7942,0.19,0.49,45,40,36,4,1.12,90.0,36,9,79.42,Facile,Facile,Facile / Facile
4676,527,2020,Droit,9,5,QROC,0.9777,0.03,0.88,49,49,48,1,1.0,97.96,48,1,97.77,Facile,Trop Facile,Facile / Trop Facile
527,528,2015,Droit,9,6,QCM,0.7957,0.08,0.72,48,39,38,1,1.23,97.44,38,10,79.57,Facile,Facile,Facile / Facile
1357,528,2016,Droit,9,6,QCM,0.8338,0.03,0.72,44,44,37,7,1.0,84.09,37,7,83.38,Facile,Facile,Facile / Facile
2187,528,2017,Droit,9,6,QCM,0.8371,0.08,0.8,49,44,41,3,1.11,93.18,41,8,83.71,Facile,Facile,Facile / Facile
3017,528,2018,Droit,9,6,QCM,0.7895,0.08,0.79,44,42,35,7,1.05,83.33,35,9,78.95,Facile,Facile,Facile / Facile
3847,528,2019,Droit,9,6,QCM,0.824,0.01,0.79,40,39,33,6,1.03,84.62,33,7,82.4,Facile,Facile,Facile / Facile
4677,528,2020,Droit,9,6,QCM,0.8277,0.15,0.78,46,42,38,4,1.1,90.48,38,8,82.77,Facile,Facile,Facile / Facile
528,529,2015,Droit,9,7,QROC,0.3131,0.61,0.23,25,22,8,14,1.14,36.36,8,17,31.31,Difficile,Difficile,Difficile / Difficile
1358,529,2016,Droit,9,7,QROC,0.822,0.16,0.67,26,22,21,1,1.18,95.45,21,5,82.2,Facile,Facile,Facile / Facile
2188,529,2017,Droit,9,7,QROC,0.8371,0.07,0.65,26,22,22,0,1.18,100.0,22,4,83.71,Facile,Facile,Facile / Facile
3018,529,2018,Droit,9,7,QROC,0.8638,0.04,0.69,22,22,19,3,1.0,86.36,19,3,86.38,Facile,Trop Facile,Facile / Trop Facile
3848,529,2019,Droit,9,7,QROC,0.836,0.16,0.54,22,21,18,3,1.05,85.71,18,4,83.6,Facile,Facile,Facile / Facile
4678,529,2020,Droit,9,7,QROC,0.5854,0.63,0.24,21,12,12,0,1.75,100.0,12,9,58.54,Facile,Difficile,Facile / Difficile
529,530,2015,Droit,10,1,QCM,0.8401,0.06,0.71,17,16,14,2,1.06,87.5,14,3,84.01,Facile,Facile,Facile / Facile
1359,530,2016,Droit,10,1,QCM,0.822,0.08,0.8,16,15,13,2,1.07,86.67,13,3,82.2,Facile,Facile,Facile / Facile
2189,530,2017,Droit,10,1,QCM,0.4627,0.24,0.34,13,11,6,5,1.18,54.55,6,7,46.27,Facile,Difficile,Facile / Difficile
3019,530,2018,Droit,10,1,QCM,0.78,0.07,0.71,14,14,11,3,1.0,78.57,11,3,78.0,Facile,Facile,Facile / Facile
3849,530,2019,Droit,10,1,QCM,0.771,0.02,0.74,13,11,10,1,1.18,90.91,10,3,77.1,Facile,Facile,Facile / Facile
4679,530,2020,Droit,10,1,QCM,0.2299,0.67,0.29,10,6,2,4,1.67,33.33,2,8,22.99,Facile,Trop Difficile,Facile / Trop Difficile
530,531,2015,Droit,10,2,QROC,0.4844,0.68,0.24,35,21,17,4,1.67,80.95,17,18,48.44,Difficile,Difficile,Difficile / Difficile
1360,531,2016,Droit,10,2,QROC,0.8474,0.19,0.74,36,34,31,3,1.06,91.18,31,5,84.74,Facile,Facile,Facile / Facile
2190,531,2017,Droit,10,2,QROC,0.7906,0.01,0.51,39,35,31,4,1.11,88.57,31,8,79.06,Facile,Facile,Facile / Facile
3020,531,2018,Droit,10,2,QROC,0.8155,0.02,0.6,40,36,33,3,1.11,91.67,33,7,81.55,Facile,Facile,Facile / Facile
3850,531,2019,Droit,10,2,QROC,0.7063,0.36,0.26,42,41,30,11,1.02,73.17,30,12,70.63,Facile,Adapte,Facile / Adapte
4680,531,2020,Droit,10,2,QROC,0.7107,0.49,0.3,44,35,31,4,1.26,88.57,31,13,71.07,Adapte,Adapte,Adapte / Adapte
531,532,2015,Droit,10,3,QCM,0.6846,0.07,0.44,98,96,67,29,1.02,69.79,67,31,68.46,Adapte,Adapte,Adapte / Adapte
1361,532,2016,Droit,10,3,QCM,0.7103,0.25,0.56,88,86,63,23,1.02,73.26,63,25,71.03,Adapte,Adapte,Adapte / Adapte
2191,532,2017,Droit,10,3,QCM,0.7243,0.18,0.49,78,70,56,14,1.11,80.0,56,22,72.43,Adapte,Adapte,Adapte / Adapte
3021,532,2018,Droit,10,3,QCM,0.7038,0.3,0.69,72,53,51,2,1.36,96.23,51,21,70.38,Adapte,Adapte,Adapte / Adapte
3851,532,2019,Droit,10,3,QCM,0.6944,0.11,0.7,72,69,50,19,1.04,72.46,50,22,69.44,Adapte,Adapte,Adapte / Adapte
4681,532,2020,Droit,10,3,QCM,0.6304,0.28,0.7,80,72,50,22,1.11,69.44,50,30,63.04,Adapte,Adapte,Adapte / Adapte
532,533,2015,Droit,10,4,QCU,0.8279,0.06,0.89,40,35,33,2,1.14,94.29,33,7,82.79,Facile,Facile,Facile / Facile
1362,533,2016,Droit,10,4,QCU,0.8288,0.18,0.8,42,42,35,7,1.0,83.33,35,7,82.88,Trop Facile,Facile,Trop Facile / Facile
2192,533,2017,Droit,10,4,QCU,0.8668,0.01,0.98,36,35,31,4,1.03,88.57,31,5,86.68,Trop Facile,Trop Facile,Trop Facile / Trop Facile
3022,533,2018,Droit,10,4,QCU,0.2002,0.14,0.25,40,19,8,11,2.11,42.11,8,32,20.02,Trop Facile,Trop Difficile,Trop Facile / Trop Difficile
3852,533,2019,Droit,10,4,QCU,0.8926,0.06,0.97,41,39,37,2,1.05,94.87,37,4,89.26,Trop Facile,Trop Facile,Trop Facile / Trop Facile
4682,533,2020,Droit,10,4,QCU,0.8715,0.01,0.99,38,35,33,2,1.09,94.29,33,5,87.15,Trop Facile,Trop Facile,Trop Facile / Trop Facile
533,534,2015,Droit,10,5,QCM,0.1664,0.22,0.25,56,43,9,34,1.3,20.93,9,47,16.64,Trop Difficile,Trop Difficile,Trop Difficile / Trop Difficile
1363,534,2016,Droit,10,5,QCM,0.7704,0.2,0.72,64,61,49,12,1.05,80.33,49,15,77.04,Facile,Facile,Facile / Facile
2193,534,2017,Droit,10,5,QCM,0.6019,0.06,0.69,52,42,31,11,1.24,73.81,31,21,60.19,Facile,Adapte,Facile / Adapte
3023,534,2018,Droit,10,5,QCM,0.6577,0.05,0.45,54,47,36,11,1.15,76.6,36,18,65.77,Adapte,Adapte,Adapte / Adapte
3853,534,2019,Droit,10,5,QCM,0.6066,0.06,0.45,56,39,34,5,1.44,87.18,34,22,60.66,Adapte,Adapte,Adapte / Adapte
4683,534,2020,Droit,10,5,QCM,0.6946,0.02,0.46,61,45,42,3,1.36,93.33,42,19,69.46,Adapte,Adapte,Adapte / Adapte
534,535,2015,Droit,10,6,QROC,0.1397,0.92,0.1,29,19,4,15,1.53,21.05,4,25,13.97,Trop Difficile,Trop Difficile,Trop Difficile / Trop Difficile
1364,535,2016,Droit,10,6,QROC,0.779,0.05,0.41,29,26,23,3,1.12,88.46,23,6,77.9,Facile,Facile,Facile / Facile
2194,535,2017,Droit,10,6,QROC,0.9106,0.06,0.93,26,24,24,0,1.08,100.0,24,2,91.06,Facile,Trop Facile,Facile / Trop Facile
3024,535,2018,Droit,10,6,QROC,0.4957,0.63,0.23,21,17,10,7,1.24,58.82,10,11,49.57,Facile,Difficile,Facile / Difficile
3854,535,2019,Droit,10,6,QROC,0.7113,0.38,0.32,20,18,14,4,1.11,77.78,14,6,71.13,Facile,Adapte,Facile / Adapte
4684,535,2020,Droit,10,6,QROC,0.6083,0.27,0.36,23,19,14,5,1.21,73.68,14,9,60.83,Adapte,Adapte,Adapte / Adapte
535,536,2015,Droit,10,7,QCM,0.8214,0.19,0.78,6,5,5,0,1.2,100.0,5,1,82.14,Facile,Facile,Facile / Facile
1365,536,2016,Droit,10,7,QCM,0.6884,0.25,0.55,6,6,4,2,1.0,66.67,4,2,68.84,Facile,Adapte,Facile / Adapte
2195,536,2017,Droit,10,7,QCM,0.7088,0.09,0.49,6,5,4,1,1.2,80.0,4,2,70.88,Adapte,Adapte,Adapte / Adapte
3025,536,2018,Droit,10,7,QCM,0.6044,0.21,0.6,6,5,4,1,1.2,80.0,4,2,60.44,Adapte,Adapte,Adapte / Adapte
3855,536,2019,Droit,10,7,QCM,0.6188,0.21,0.58,5,4,3,1,1.25,75.0,3,2,61.88,Adapte,Adapte,Adapte / Adapte
4685,536,2020,Droit,10,7,QCM,0.6665,0.03,0.6,5,4,3,1,1.25,75.0,3,2,66.65,Adapte,Adapte,Adapte / Adapte
536,537,2015,Droit,10,8,QCU,0.7874,0.13,0.8,36,31,28,3,1.16,90.32,28,8,78.74,Facile,Facile,Facile / Facile
1366,537,2016,Droit,10,8,QCU,0.8642,0.08,0.91,30,30,26,4,1.0,86.67,26,4,86.42,Trop Facile,Trop Facile,Trop Facile / Trop Facile
2196,537,2017,Droit,10,8,QCU,0.9688,0.08,0.95,26,26,25,1,1.0,96.15,25,1,96.88,Trop Facile,Trop Facile,Trop Facile / Trop Facile
3026,537,2018,Droit,10,8,QCU,0.6284,0.24,0.44,26,25,16,9,1.04,64.0,16,10,62.84,Trop Facile,Adapte,Trop Facile / Adapte
3856,537,2019,Droit,10,8,QCU,0.7219,0.18,0.42,24,21,17,4,1.14,80.95,17,7,72.19,Adapte,Adapte,Adapte / Adapte
4686,537,2020,Droit,10,8,QCU,0.6086,0.08,0.43,19,12,12,0,1.58,100.0,12,7,60.86,Adapte,Adapte,Adapte / Adapte
537,538,2015,Droit,10,9,QCM,0.4265,0.19,0.36,62,47,26,21,1.32,55.32,26,36,42.65,Difficile,Difficile,Difficile / Difficile
1367,538,2016,Droit,10,9,QCM,0.3806,0.41,0.37,71,50,27,23,1.42,54.0,27,44,38.06,Facile,Difficile,Facile / Difficile
2197,538,2017,Droit,10,9,QCM,0.6983,0.19,0.49,84,71,59,12,1.18,83.1,59,25,69.83,Facile,Adapte,Facile / Adapte
3027,538,2018,Droit,10,9,QCM,0.6911,0.25,0.62,67,53,46,7,1.26,86.79,46,21,69.11,Adapte,Adapte,Adapte / Adapte
3857,538,2019,Droit,10,9,QCM,0.619,0.23,0.68,70,58,43,15,1.21,74.14,43,27,61.9,Adapte,Adapte,Adapte / Adapte
4687,538,2020,Droit,10,9,QCM,0.6299,0.2,0.57,56,37,35,2,1.51,94.59,35,21,62.99,Adapte,Adapte,Adapte / Adapte
538,539,2015,Droit,10,10,QCU,0.1074,0.68,0.2,38,33,4,29,1.15,12.12,4,34,10.74,Trop Difficile,Trop Difficile,Trop Difficile / Trop Difficile
1368,539,2016,Droit,10,10,QCU,0.9274,0.08,0.95,35,34,32,2,1.03,94.12,32,3,92.74,Trop Facile,Trop Facile,Trop Facile / Trop Facile
2198,539,2017,Droit,10,10,QCU,0.8367,0.19,0.77,38,34,32,2,1.12,94.12,32,6,83.67,Trop Facile,Facile,Trop Facile / Facile
3028,539,2018,Droit,10,10,QCU,0.9248,0.01,0.93,36,35,33,2,1.03,94.29,33,3,92.48,Trop Facile,Trop Facile,Trop Facile / Trop Facile
3858,539,2019,Droit,10,10,QCU,0.9834,0.07,0.99,39,39,38,1,1.0,97.44,38,1,98.34,Trop Facile,Trop Facile,Trop Facile / Trop Facile
4688,539,2020,Droit,10,10,QCU,0.7148,0.14,0.47,39,31,28,3,1.26,90.32,28,11,71.48,Trop Facile,Adapte,Trop Facile / Adapte
539,540,2015,Droit,10,11,QCM,0.2996,0.34,0.34,54,19,16,3,2.84,84.21,16,38,29.96,Difficile,Difficile,Difficile / Difficile
1369,540,2016,Droit,10,11,QCM,0.9907,0.03,0.82,43,43,43,0,1.0,100.0,43,0,99.07,Facile,Trop Facile,Facile / Trop Facile
2199,540,2017,Droit,10,11,QCM,0.7929,0.1,0.79,45,39,36,3,1.15,92.31,36,9,79.29,Facile,Facile,Facile / Facile
3029,540,2018,Droit,10,11,QCM,0.787,0.03,0.75,45,43,35,8,1.05,81.4,35,10,78.7,Facile,Facile,Facile / Facile
3859,540,2019,Droit,10,11,QCM,0.8389,0.03,0.72,49,49,41,8,1.0,83.67,41,8,83.89,Facile,Facile,Facile / Facile
4689,540,2020,Droit,10,11,QCM,0.7636,0.02,0.76,44,35,34,1,1.26,97.14,34,10,76.36,Facile,Facile,Facile / Facile
540,541,2015,Droit,10,12,QCU,0.8028,0.1,0.88,42,36,34,2,1.17,94.44,34,8,80.28,Trop Difficile,Facile,Trop Difficile / Facile
1370,541,2016,Droit,10,12,QCU,0.9289,0.08,0.96,47,45,44,1,1.04,97.78,44,3,92.89,Trop Facile,Trop Facile,Trop Facile / Trop Facile
2200,541,2017,Droit,10,12,QCU,0.4817,0.26,0.38,54,53,26,27,1.02,49.06,26,28,48.17,Trop Facile,Difficile,Trop Facile / Difficile
3030,541,2018,Droit,10,12,QCU,0.9945,0.05,0.91,62,62,62,0,1.0,100.0,62,0,99.45,Trop Facile,Trop Facile,Trop Facile / Trop Facile
3860,541,2019,Droit,10,12,QCU,0.9405,0.05,0.95,58,57,55,2,1.02,96.49,55,3,94.05,Trop Facile,Trop Facile,Trop Facile / Trop Facile
4690,541,2020,Droit,10,12,QCU,0.9684,0.07,0.94,53,52,51,1,1.02,98.08,51,2,96.84,Trop Facile,Trop Facile,Trop Facile / Trop Facile
541,542,2015,Droit,10,13,QCM,0.1266,0.73,0.22,56,30,7,23,1.87,23.33,7,49,12.66,Trop Difficile,Trop Difficile,Trop Difficile / Trop Difficile
1371,542,2016,Droit,10,13,QCM,0.7619,0.18,0.76,54,52,41,11,1.04,78.85,41,13,76.19,Facile,Facile,Facile / Facile
2201,542,2017,Droit,10,13,QCM,0.2735,0.5,0.31,65,53,18,35,1.23,33.96,18,47,27.35,Facile,Difficile,Facile / Difficile
3031,542,2018,Droit,10,13,QCM,0.8182,0.0,0.78,52,45,43,2,1.16,95.56,43,9,81.82,Facile,Facile,Facile / Facile
3861,542,2019,Droit,10,13,QCM,0.7918,0.11,0.7,56,49,44,5,1.14,89.8,44,12,79.18,Facile,Facile,Facile / Facile
4691,542,2020,Droit,10,13,QCM,0.7942,0.0,0.72,59,53,47,6,1.11,88.68,47,12,79.42,Facile,Facile,Facile / Facile
542,543,2015,Droit,10,14,QCU,0.0461,0.31,0.25,42,34,2,32,1.24,5.88,2,40,4.61,Trop Difficile,Trop Difficile,Trop Difficile / Trop Difficile
1372,543,2016,Droit,10,14,QCU,0.5074,0.32,0.36,50,38,25,13,1.32,65.79,25,25,50.74,Trop Facile,Difficile,Trop Facile / Difficile
2202,543,2017,Droit,10,14,QCU,0.901,0.02,0.97,51,50,46,4,1.02,92.0,46,5,90.1,Trop Facile,Trop Facile,Trop Facile / Trop Facile
3032,543,2018,Droit,10,14,QCU,0.8944,0.05,0.98,60,54,54,0,1.11,100.0,54,6,89.44,Trop Facile,Trop Facile,Trop Facile / Trop Facile
3862,543,2019,Droit,10,14,QCU,0.7925,0.05,0.77,50,50,40,10,1.0,80.0,40,10,79.25,Trop Facile,Facile,Trop Facile / Facile
4692,543,2020,Droit,10,14,QCU,0.9274,0.1,0.95,48,45,45,0,1.07,100.0,45,3,92.74,Trop Facile,Trop Facile,Trop Facile / Trop Facile
543,544,2015,Droit,11,1,QCM,0.909,0.08,0.82,46,43,42,1,1.07,97.67,42,4,90.9,Facile,Trop Facile,Facile / Trop Facile
1373,544,2016,Droit,11,1,QCM,0.7974,0.01,0.74,53,53,42,11,1.0,79.25,42,11,79.74,Facile,Facile,Facile / Facile
2203,544,2017,Droit,11,1,QCM,0.8464,0.05,0.78,49,47,41,6,1.04,87.23,41,8,84.64,Facile,Facile,Facile / Facile
3033,544,2018,Droit,11,1,QCM,0.804,0.04,0.71,44,42,35,7,1.05,83.33,35,9,80.4,Facile,Facile,Facile / Facile
3863,544,2019,Droit,11,1,QCM,0.7877,0.11,0.75,53,46,42,4,1.15,91.3,42,11,78.77,Facile,Facile,Facile / Facile
4693,544,2020,Droit,11,1,QCM,0.7876,0.17,0.73,44,40,35,5,1.1,87.5,35,9,78.76,Facile,Facile,Facile / Facile
544,545,2015,Droit,11,2,QROC,0.6896,0.47,0.33,78,77,54,23,1.01,70.13,54,24,68.96,Adapte,Adapte,Adapte / Adapte
1374,545,2016,Droit,11,2,QROC,0.7029,0.47,0.37,71,60,50,10,1.18,83.33,50,21,70.29,Adapte,Adapte,Adapte / Adapte
2204,545,2017,Droit,11,2,QROC,0.6483,0.39,0.36,72,64,47,17,1.12,73.44,47,25,64.83,Adapte,Adapte,Adapte / Adapte
3034,545,2018,Droit,11,2,QROC,0.6707,0.27,0.34,85,70,57,13,1.21,81.43,57,28,67.07,Adapte,Adapte,Adapte / Adapte
3864,545,2019,Droit,11,2,QROC,0.7469,0.42,0.3,76,67,57,10,1.13,85.07,57,19,74.69,Adapte,Adapte,Adapte / Adapte
4694,545,2020,Droit,11,2,QROC,0.7066,0.33,0.3,70,60,49,11,1.17,81.67,49,21,70.66,Adapte,Adapte,Adapte / Adapte
545,546,2015,Droit,11,3,QCM,0.4946,0.48,0.3,20,15,10,5,1.33,66.67,10,10,49.46,Facile,Difficile,Facile / Difficile
1375,546,2016,Droit,11,3,QCM,0.7813,0.19,0.71,24,20,19,1,1.2,95.0,19,5,78.13,Facile,Facile,Facile / Facile
2205,546,2017,Droit,11,3,QCM,0.8062,0.15,0.77,23,20,19,1,1.15,95.0,19,4,80.62,Facile,Facile,Facile / Facile
3035,546,2018,Droit,11,3,QCM,0.8286,0.08,0.76,24,20,20,0,1.2,100.0,20,4,82.86,Facile,Facile,Facile / Facile
3865,546,2019,Droit,11,3,QCM,0.788,0.06,0.79,23,19,18,1,1.21,94.74,18,5,78.8,Facile,Facile,Facile / Facile
4695,546,2020,Droit,11,3,QCM,0.8155,0.16,0.8,20,18,16,2,1.11,88.89,16,4,81.55,Facile,Facile,Facile / Facile
546,547,2015,Droit,11,4,QCM,0.3875,0.05,0.37,51,32,20,12,1.59,62.5,20,31,38.75,Difficile,Difficile,Difficile / Difficile
1376,547,2016,Droit,11,4,QCM,0.5069,0.35,0.31,55,41,28,13,1.34,68.29,28,27,50.69,Facile,Difficile,Facile / Difficile
2206,547,2017,Droit,11,4,QCM,0.8346,0.01,0.76,45,43,38,5,1.05,88.37,38,7,83.46,Facile,Facile,Facile / Facile
3036,547,2018,Droit,11,4,QCM,0.4572,0.24,0.31,48,31,22,9,1.55,70.97,22,26,45.72,Facile,Difficile,Facile / Difficile
3866,547,2019,Droit,11,4,QCM,0.6534,0.05,0.4,39,26,25,1,1.5,96.15,25,14,65.34,Facile,Adapte,Facile / Adapte
4696,547,2020,Droit,11,4,QCM,0.6793,0.22,0.7,31,27,21,6,1.15,77.78,21,10,67.93,Adapte,Adapte,Adapte / Adapte
547,548,2015,Droit,11,5,QCM,0.1602,0.26,0.25,80,65,13,52,1.23,20.0,13,67,16.02,Trop Difficile,Trop Difficile,Trop Difficile / Trop Difficile
1377,548,2016,Droit,11,5,QCM,0.2099,0.25,0.26,76,72,16,56,1.06,22.22,16,60,20.99,Facile,Trop Difficile,Facile / Trop Difficile
2207,548,2017,Droit,11,5,QCM,0.838,0.06,0.78,86,75,72,3,1.15,96.0,72,14,83.8,Facile,Facile,Facile / Facile
3037,548,2018,Droit,11,5,QCM,0.8452,0.04,0.78,92,88,78,10,1.05,88.64,78,14,84.52,Facile,Facile,Facile / Facile
3867,548,2019,Droit,11,5,QCM,0.7623,0.09,0.78,82,69,63,6,1.19,91.3,63,19,76.23,Facile,Facile,Facile / Facile
4697,548,2020,Droit,11,5,QCM,0.268,0.29,0.38,68,22,18,4,3.09,81.82,18,50,26.8,Facile,Difficile,Facile / Difficile
548,549,2015,Droit,11,6,QCU,0.1855,0.56,0.2,29,19,5,14,1.53,26.32,5,24,18.55,Trop Difficile,Trop Difficile,Trop Difficile / Trop Difficile
1378,549,2016,Droit,11,6,QCU,0.9397,0.1,0.91,28,27,26,1,1.04,96.3,26,2,93.97,Trop Facile,Trop Facile,Trop Facile / Trop Facile
2208,549,2017,Droit,11,6,QCU,0.9052,0.02,0.92,34,33,31,2,1.03,93.94,31,3,90.52,Trop Facile,Trop Facile,Trop Facile / Trop Facile
3038,549,2018,Droit,11,6,QCU,0.5104,0.23,0.34,30,16,15,1,1.88,93.75,15,15,51.04,Trop Facile,Difficile,Trop Facile / Difficile
3868,549,2019,Droit,11,6,QCU,0.8891,0.01,0.98,34,31,30,1,1.1,96.77,30,4,88.91,Trop Facile,Trop Facile,Trop Facile / Trop Facile
4698,549,2020,Droit,11,6,QCU,0.9113,0.05,0.97,32,31,29,2,1.03,93.55,29,3,91.13,Trop Facile,Trop Facile,Trop Facile / Trop Facile
549,550,2015,Droit,11,7,QCU,0.7803,0.17,0.86,31,31,24,7,1.0,77.42,24,7,78.03,Facile,Facile,Facile / Facile
1379,550,2016,Droit,11,7,QCU,0.3328,0.4,0.34,29,22,10,12,1.32,45.45,10,19,33.28,Trop Facile,Difficile,Trop Facile / Difficile
2209,550,2017,Droit,11,7,QCU,0.4348,0.28,0.38,33,33,14,19,1.0,42.42,14,19,43.48,Trop Facile,Difficile,Trop Facile / Difficile
3039,550,2018,Droit,11,7,QCU,0.9017,0.04,0.96,28,27,25,2,1.04,92.59,25,3,90.17,Trop Facile,Trop Facile,Trop Facile / Trop Facile
3869,550,2019,Droit,11,7,QCU,0.8647,0.07,0.96,28,25,24,1,1.12,96.0,24,4,86.47,Trop Facile,Trop Facile,Trop Facile / Trop Facile
4699,550,2020,Droit,11,7,QCU,0.9384,0.06,0.97,22,22,21,1,1.0,95.45,21,1,93.84,Trop Facile,Trop Facile,Trop Facile / Trop Facile
550,551,2015,Droit,11,8,QCU,0.0895,0.03,0.23,63,45,6,39,1.4,13.33,6,57,8.95,Trop Difficile,Trop Difficile,Trop Difficile / Trop Difficile
1380,551,2016,Droit,11,8,QCU,0.9637,0.03,0.98,71,69,68,1,1.03,98.55,68,3,96.37,Trop Facile,Trop Facile,Trop Facile / Trop Facile
2210,551,2017,Droit,11,8,QCU,0.9817,0.03,0.9,62,61,61,0,1.02,100.0,61,1,98.17,Trop Facile,Trop Facile,Trop Facile / Trop Facile
3040,551,2018,Droit,11,8,QCU,0.8814,0.08,0.97,54,50,48,2,1.08,96.0,48,6,88.14,Trop Facile,Trop Facile,Trop Facile / Trop Facile
3870,551,2019,Droit,11,8,QCU,0.9277,0.04,0.91,47,46,44,2,1.02,95.65,44,3,92.77,Trop Facile,Trop Facile,Trop Facile / Trop Facile
4700,551,2020,Droit,11,8,QCU,0.9585,0.03,0.95,55,54,53,1,1.02,98.15,53,2,95.85,Trop Facile,Trop Facile,Trop Facile / Trop Facile
551,552,2015,Droit,11,9,QCU,0.7797,0.16,0.87,9,7,7,0,1.29,100.0,7,2,77.97,Facile,Facile,Facile / Facile
1381,552,2016,Droit,11,9,QCU,0.6219,0.2,0.46,8,6,5,1,1.33,83.33,5,3,62.19,Trop Facile,Adapte,Trop Facile / Adapte
2211,552,2017,Droit,11,9,QCU,0.657,0.06,0.57,6,5,4,1,1.2,80.0,4,2,65.7,Adapte,Adapte,Adapte / Adapte
3041,552,2018,Droit,11,9,QCU,0.6561,0.02,0.5,7,6,5,1,1.17,83.33,5,2,65.61,Adapte,Adapte,Adapte / Adapte
3871,552,2019,Droit,11,9,QCU,0.6874,0.22,0.42,8,5,5,0,1.6,100.0,5,3,68.74,Adapte,Adapte,Adapte / Adapte
4701,552,2020,Droit,11,9,QCU,0.7344,0.04,0.57,6,4,4,0,1.5,100.0,4,2,73.44,Adapte,Adapte,Adapte / Adapte
552,553,2015,Droit,12,1,QCM,0.7758,0.13,0.72,77,77,60,17,1.0,77.92,60,17,77.58,Trop Facile,Facile,Trop Facile / Facile
1382,553,2016,Droit,12,1,QCM,0.407,0.04,0.38,82,37,33,4,2.22,89.19,33,49,40.7,Facile,Difficile,Facile / Difficile
2212,553,2017,Droit,12,1,QCM,0.5269,0.39,0.33,73,46,38,8,1.59,82.61,38,35,52.69,Facile,Difficile,Facile / Difficile
3042,553,2018,Droit,12,1,QCM,0.2577,0.01,0.34,72,60,19,41,1.2,31.67,19,53,25.77,Facile,Difficile,Facile / Difficile
3872,553,2019,Droit,12,1,QCM,0.849,0.1,0.73,72,69,61,8,1.04,88.41,61,11,84.9,Facile,Facile,Facile / Facile
4702,553,2020,Droit,12,1,QCM,0.8445,0.16,0.7,78,73,66,7,1.07,90.41,66,12,84.45,Facile,Facile,Facile / Facile
553,554,2015,Droit,12,2,QCM,0.4963,0.06,0.37,21,12,10,2,1.75,83.33,10,11,49.63,Difficile,Difficile,Difficile / Difficile
1383,554,2016,Droit,12,2,QCM,0.8047,0.18,0.77,18,17,14,3,1.06,82.35,14,4,80.47,Facile,Facile,Facile / Facile
2213,554,2017,Droit,12,2,QCM,0.8186,0.03,0.77,20,19,16,3,1.05,84.21,16,4,81.86,Facile,Facile,Facile / Facile
3043,554,2018,Droit,12,2,QCM,0.8276,0.13,0.7,19,19,16,3,1.0,84.21,16,3,82.76,Facile,Facile,Facile / Facile
3873,554,2019,Droit,12,2,QCM,0.8427,0.12,0.78,15,15,13,2,1.0,86.67,13,2,84.27,Facile,Facile,Facile / Facile
4703,554,2020,Droit,12,2,QCM,0.8416,0.17,0.75,13,12,11,1,1.08,91.67,11,2,84.16,Facile,Facile,Facile / Facile
554,555,2015,Droit,12,3,QCM,0.293,0.04,0.33,54,43,16,27,1.26,37.21,16,38,29.3,Trop Difficile,Difficile,Trop Difficile / Difficile
1384,555,2016,Droit,12,3,QCM,0.4189,0.34,0.39,48,23,20,3,2.09,86.96,20,28,41.89,Facile,Difficile,Facile / Difficile
2214,555,2017,Droit,12,3,QCM,0.8493,0.03,0.75,41,39,35,4,1.05,89.74,35,6,84.93,Facile,Facile,Facile / Facile
3044,555,2018,Droit,12,3,QCM,0.7942,0.14,0.76,40,39,32,7,1.03,82.05,32,8,79.42,Facile,Facile,Facile / Facile
3874,555,2019,Droit,12,3,QCM,0.3514,0.07,0.34,39,36,14,22,1.08,38.89,14,25,35.14,Facile,Difficile,Facile / Difficile
4704,555,2020,Droit,12,3,QCM,0.767,0.04,0.78,45,44,35,9,1.02,79.55,35,10,76.7,Facile,Facile,Facile / Facile
555,556,2015,Droit,12,4,QCU,0.2111,0.23,0.27,90,57,19,38,1.58,33.33,19,71,21.11,Trop Difficile,Trop Difficile,Trop Difficile / Trop Difficile
1385,556,2016,Droit,12,4,QCU,0.8962,0.02,0.93,88,82,79,3,1.07,96.34,79,9,89.62,Trop Facile,Trop Facile,Trop Facile / Trop Facile
2215,556,2017,Droit,12,4,QCU,0.9684,0.03,0.94,80,79,77,2,1.01,97.47,77,3,96.84,Trop Facile,Trop Facile,Trop Facile / Trop Facile
3045,556,2018,Droit,12,4,QCU,0.5685,0.07,0.32,73,73,42,31,1.0,57.53,42,31,56.85,Trop Facile,Difficile,Trop Facile / Difficile
3875,556,2019,Droit,12,4,QCU,0.7128,0.27,0.58,63,49,45,4,1.29,91.84,45,18,71.28,Trop Facile,Adapte,Trop Facile / Adapte
4705,556,2020,Droit,12,4,QCU,0.6636,0.16,0.6,53,42,35,7,1.26,83.33,35,18,66.36,Adapte,Adapte,Adapte / Adapte
556,557,2015,Droit,12,5,QCM,0.9506,0.04,0.97,89,86,85,1,1.03,98.84,85,4,95.06,Trop Facile,Trop Facile,Trop Facile / Trop Facile
1386,557,2016,Droit,12,5,QCM,0.8053,0.05,0.78,73,64,59,5,1.14,92.19,59,14,80.53,Facile,Facile,Facile / Facile
2216,557,2017,Droit,12,5,QCM,0.2759,0.21,0.36,64,54,18,36,1.19,33.33,18,46,27.59,Facile,Difficile,Facile / Difficile
3046,557,2018,Droit,12,5,QCM,0.777,0.11,0.72,52,47,40,7,1.11,85.11,40,12,77.7,Facile,Facile,Facile / Facile
3876,557,2019,Droit,12,5,QCM,0.7782,0.19,0.78,62,60,48,12,1.03,80.0,48,14,77.82,Facile,Facile,Facile / Facile
4706,557,2020,Droit,12,5,QCM,0.1861,0.6,0.23,74,59,14,45,1.25,23.73,14,60,18.61,Facile,Trop Difficile,Facile / Trop Difficile
557,558,2015,Droit,12,6,QCM,0.3978,0.06,0.39,47,21,19,2,2.24,90.48,19,28,39.78,Difficile,Difficile,Difficile / Difficile
1387,558,2016,Droit,12,6,QCM,0.8268,0.07,0.71,40,34,33,1,1.18,97.06,33,7,82.68,Facile,Facile,Facile / Facile
2217,558,2017,Droit,12,6,QCM,0.3085,0.22,0.35,34,32,10,22,1.06,31.25,10,24,30.85,Facile,Difficile,Facile / Difficile
3047,558,2018,Droit,12,6,QCM,0.7664,0.14,0.77,35,30,27,3,1.17,90.0,27,8,76.64,Facile,Facile,Facile / Facile
3877,558,2019,Droit,12,6,QCM,0.7618,0.17,0.76,40,33,30,3,1.21,90.91,30,10,76.18,Facile,Facile,Facile / Facile
4707,558,2020,Droit,12,6,QCM,0.7958,0.03,0.72,41,39,33,6,1.05,84.62,33,8,79.58,Facile,Facile,Facile / Facile
558,559,2015,Droit,12,7,QCM,0.0296,0.35,0.21,95,87,3,84,1.09,3.45,3,92,2.96,Trop Difficile,Trop Difficile,Trop Difficile / Trop Difficile
1388,559,2016,Droit,12,7,QCM,0.8236,0.04,0.73,89,82,73,9,1.09,89.02,73,16,82.36,Facile,Facile,Facile / Facile
2218,559,2017,Droit,12,7,QCM,0.7797,0.09,0.75,105,104,82,22,1.01,78.85,82,23,77.97,Facile,Facile,Facile / Facile
3048,559,2018,Droit,12,7,QCM,0.7715,0.18,0.77,100,91,77,14,1.1,84.62,77,23,77.15,Facile,Facile,Facile / Facile
3878,559,2019,Droit,12,7,QCM,0.7981,0.13,0.78,94,77,75,2,1.22,97.4,75,19,79.81,Facile,Facile,Facile / Facile
4708,559,2020,Droit,12,7,QCM,0.8092,0.06,0.72,94,78,76,2,1.21,97.44,76,18,80.92,Facile,Facile,Facile / Facile
559,560,2015,Droit,12,8,QCM,0.033,0.01,0.29,84,54,3,51,1.56,5.56,3,81,3.3,Trop Difficile,Trop Difficile,Trop Difficile / Trop Difficile
1389,560,2016,Droit,12,8,QCM,0.7741,0.16,0.74,92,72,71,1,1.28,98.61,71,21,77.41,Facile,Facile,Facile / Facile
2219,560,2017,Droit,12,8,QCM,0.6042,0.09,0.51,91,82,55,27,1.11,67.07,55,36,60.42,Facile,Adapte,Facile / Adapte
3049,560,2018,Droit,12,8,QCM,0.7109,0.03,0.61,102,90,73,17,1.13,81.11,73,29,71.09,Adapte,Adapte,Adapte / Adapte
3879,560,2019,Droit,12,8,QCM,0.6114,0.07,0.47,91,84,56,28,1.08,66.67,56,35,61.14,Adapte,Adapte,Adapte / Adapte
4709,560,2020,Droit,12,8,QCM,0.7148,0.12,0.68,77,74,55,19,1.04,74.32,55,22,71.48,Adapte,Adapte,Adapte / Adapte
560,561,2015,Droit,12,9,QCU,0.9118,0.05,0.99,21,21,19,2,1.0,90.48,19,2,91.18,Difficile,Trop Facile,Difficile / Trop Facile
1390,561,2016,Droit,12,9,QCU,0.82,0.16,0.81,23,20,19,1,1.15,95.0,19,4,82.0,Trop Facile,Facile,Trop Facile / Facile
2220,561,2017,Droit,12,9,QCU,0.7964,0.18,0.89,28,22,22,0,1.27,100.0,22,6,79.64,Trop Facile,Facile,Trop Facile / Facile
3050,561,2018,Droit,12,9,QCU,0.9399,0.07,0.95,29,27,27,0,1.07,100.0,27,2,93.99,Trop Facile,Trop Facile,Trop Facile / Trop Facile
3880,561,2019,Droit,12,9,QCU,0.7002,0.27,0.65,30,27,21,6,1.11,77.78,21,9,70.02,Trop Facile,Adapte,Trop Facile / Adapte
4710,561,2020,Droit,12,9,QCU,0.6345,0.02,0.57,26,17,16,1,1.53,94.12,16,10,63.45,Adapte,Adapte,Adapte / Adapte
561,562,2015,Droit,12,10,QCM,0.3246,0.4,0.32,16,10,5,5,1.6,50.0,5,11,32.46,Difficile,Difficile,Difficile / Difficile
1391,562,2016,Droit,12,10,QCM,0.0195,0.47,0.29,17,17,0,17,1.0,0.0,0,17,1.95,Facile,Trop Difficile,Facile / Trop Difficile
2221,562,2017,Droit,12,10,QCM,0.0183,0.02,0.23,15,15,0,15,1.0,0.0,0,15,1.83,Facile,Trop Difficile,Facile / Trop Difficile
3051,562,2018,Droit,12,10,QCM,0.7602,0.13,0.7,16,14,12,2,1.14,85.71,12,4,76.02,Facile,Facile,Facile / Facile
3881,562,2019,Droit,12,10,QCM,0.8281,0.19,0.72,18,17,15,2,1.06,88.24,15,3,82.81,Facile,Facile,Facile / Facile
4711,562,2020,Droit,12,10,QCM,0.7918,0.05,0.77,19,15,15,0,1.27,100.0,15,4,79.18,Facile,Facile,Facile / Facile
562,563,2015,Droit,13,1,QCM,0.428,0.19,0.36,76,59,33,26,1.29,55.93,33,43,42.8,Difficile,Difficile,Difficile / Difficile
1392,563,2016,Droit,13,1,QCM,0.8276,0.01,0.77,67,59,55,4,1.14,93.22,55,12,82.76,Facile,Facile,Facile / Facile
2222,563,2017,Droit,13,1,QCM,0.7974,0.04,0.71,58,54,46,8,1.07,85.19,46,12,79.74,Facile,Facile,Facile / Facile
3052,563,2018,Droit,13,1,QCM,0.7968,0.06,0.78,55,51,44,7,1.08,86.27,44,11,79.68,Facile,Facile,Facile / Facile
3882,563,2019,Droit,13,1,QCM,0.7779,0.07,0.8,46,45,36,9,1.02,80.0,36,10,77.79,Facile,Facile,Facile / Facile
4712,563,2020,Droit,13,1,QCM,0.8462,0.13,0.75,40,36,34,2,1.11,94.44,34,6,84.62,Facile,Facile,Facile / Facile
563,564,2015,Droit,13,2,QROC,0.9148,0.01,0.77,90,83,82,1,1.08,98.8,82,8,91.48,Difficile,Trop Facile,Difficile / Trop Facile
1393,564,2016,Droit,13,2,QROC,0.7981,0.07,0.73,99,97,79,18,1.02,81.44,79,20,79.81,Facile,Facile,Facile / Facile
2223,564,2017,Droit,13,2,QROC,0.8203,0.16,0.45,113,111,93,18,1.02,83.78,93,20,82.03,Facile,Facile,Facile / Facile
3053,564,2018,Droit,13,2,QROC,0.1434,0.78,0.06,92,42,13,29,2.19,30.95,13,79,14.34,Facile,Trop Difficile,Facile / Trop Difficile
3883,564,2019,Droit,13,2,QROC,0.8499,0.19,0.46,90,84,76,8,1.07,90.48,76,14,84.99,Facile,Facile,Facile / Facile
4713,564,2020,Droit,13,2,QROC,0.911,0.01,0.89,93,87,85,2,1.07,97.7,85,8,91.1,Facile,Trop Facile,Facile / Trop Facile
564,565,2015,Droit,13,3,QCU,0.1633,0.72,0.22,42,39,7,32,1.08,17.95,7,35,16.33,Difficile,Trop Difficile,Difficile / Trop Difficile
1394,565,2016,Droit,13,3,QCU,0.9837,0.0,0.98,49,49,48,1,1.0,97.96,48,1,98.37,Trop Facile,Trop Facile,Trop Facile / Trop Facile
2224,565,2017,Droit,13,3,QCU,0.3838,0.22,0.32,50,35,19,16,1.43,54.29,19,31,38.38,Trop Facile,Difficile,Trop Facile / Difficile
3054,565,2018,Droit,13,3,QCU,0.9756,0.08,0.91,57,56,56,0,1.02,100.0,56,1,97.56,Trop Facile,Trop Facile,Trop Facile / Trop Facile
3884,565,2019,Droit,13,3,QCU,0.861,0.0,0.97,63,59,54,5,1.07,91.53,54,9,86.1,Trop Facile,Trop Facile,Trop Facile / Trop Facile
4714,565,2020,Droit,13,3,QCU,0.896,0.05,0.9,72,66,65,1,1.09,98.48,65,7,89.6,Trop Facile,Trop Facile,Trop Facile / Trop Facile
565,566,2015,Droit,13,4,QCM,0.5487,0.37,0.35,20,15,11,4,1.33,73.33,11,9,54.87,Difficile,Difficile,Difficile / Difficile
1395,566,2016,Droit,13,4,QCM,0.7852,0.13,0.73,23,18,18,0,1.28,100.0,18,5,78.52,Facile,Facile,Facile / Facile
2225,566,2017,Droit,13,4,QCM,0.3867,0.38,0.37,20,18,8,10,1.11,44.44,8,12,38.67,Facile,Difficile,Facile / Difficile
3055,566,2018,Droit,13,4,QCM,0.8064,0.2,0.78,24,23,19,4,1.04,82.61,19,5,80.64,Facile,Facile,Facile / Facile
3885,566,2019,Droit,13,4,QCM,0.7917,0.15,0.74,21,20,17,3,1.05,85.0,17,4,79.17,Facile,Facile,Facile / Facile
4715,566,2020,Droit,13,4,QCM,0.9699,0.1,0.89,25,24,24,0,1.04,100.0,24,1,96.99,Facile,Trop Facile,Facile / Trop Facile
566,567,2015,Droit,13,5,QCU,0.6153,0.09,0.6,60,40,37,3,1.5,92.5,37,23,61.53,Trop Difficile,Adapte,Trop Difficile / Adapte
1396,567,2016,Droit,13,5,QCU,0.6823,0.15,0.45,53,39,36,3,1.36,92.31,36,17,68.23,Adapte,Adapte,Adapte / Adapte
2226,567,2017,Droit,13,5,QCU,0.6378,0.15,0.48,45,36,29,7,1.25,80.56,29,16,63.78,Adapte,Adapte,Adapte / Adapte
3056,567,2018,Droit,13,5,QCU,0.6725,0.02,0.62,39,32,26,6,1.22,81.25,26,13,67.25,Adapte,Adapte,Adapte / Adapte
3886,567,2019,Droit,13,5,QCU,0.7249,0.03,0.52,43,34,31,3,1.26,91.18,31,12,72.49,Adapte,Adapte,Adapte / Adapte
4716,567,2020,Droit,13,5,QCU,0.6624,0.25,0.66,46,44,30,14,1.05,68.18,30,16,66.24,Adapte,Adapte,Adapte / Adapte
567,568,2015,Droit,13,6,QCU,0.284,0.25,0.36,17,14,5,9,1.21,35.71,5,12,28.4,Trop Difficile,Difficile,Trop Difficile / Difficile
1397,568,2016,Droit,13,6,QCU,0.6272,0.28,0.51,15,11,9,2,1.36,81.82,9,6,62.72,Trop Facile,Adapte,Trop Facile / Adapte
2227,568,2017,Droit,13,6,QCU,0.668,0.08,0.41,13,11,9,2,1.18,81.82,9,4,66.8,Adapte,Adapte,Adapte / Adapte
3057,568,2018,Droit,13,6,QCU,0.6395,0.11,0.46,11,9,7,2,1.22,77.78,7,4,63.95,Adapte,Adapte,Adapte / Adapte
3887,568,2019,Droit,13,6,QCU,0.6469,0.18,0.41,10,8,6,2,1.25,75.0,6,4,64.69,Adapte,Adapte,Adapte / Adapte
4717,568,2020,Droit,13,6,QCU,0.6961,0.18,0.56,12,11,8,3,1.09,72.73,8,4,69.61,Adapte,Adapte,Adapte / Adapte
568,569,2015,Droit,13,7,QROC,0.0499,0.98,0.07,73,46,4,42,1.59,8.7,4,69,4.99,Facile,Trop Difficile,Facile / Trop Difficile
1398,569,2016,Droit,13,7,QROC,0.8009,0.04,0.46,59,53,47,6,1.11,88.68,47,12,80.09,Facile,Facile,Facile / Facile
2228,569,2017,Droit,13,7,QROC,0.7697,0.14,0.51,61,54,47,7,1.13,87.04,47,14,76.97,Facile,Facile,Facile / Facile
3058,569,2018,Droit,13,7,QROC,0.5485,0.73,0.25,59,40,32,8,1.48,80.0,32,27,54.85,Facile,Difficile,Facile / Difficile
3888,569,2019,Droit,13,7,QROC,0.8034,0.11,0.42,70,64,56,8,1.09,87.5,56,14,80.34,Facile,Facile,Facile / Facile
4718,569,2020,Droit,13,7,QROC,0.6846,0.32,0.29,82,58,56,2,1.41,96.55,56,26,68.46,Facile,Adapte,Facile / Adapte
569,570,2015,Droit,14,1,QCU,0.6021,0.28,0.55,98,59,59,0,1.66,100.0,59,39,60.21,Adapte,Adapte,Adapte / Adapte
1399,570,2016,Droit,14,1,QCU,0.7033,0.11,0.7,106,88,75,13,1.2,85.23,75,31,70.33,Adapte,Adapte,Adapte / Adapte
2229,570,2017,Droit,14,1,QCU,0.6261,0.16,0.67,105,70,66,4,1.5,94.29,66,39,62.61,Adapte,Adapte,Adapte / Adapte
3059,570,2018,Droit,14,1,QCU,0.6392,0.21,0.49,88,83,56,27,1.06,67.47,56,32,63.92,Adapte,Adapte,Adapte / Adapte
3889,570,2019,Droit,14,1,QCU,0.6143,0.16,0.6,101,100,62,38,1.01,62.0,62,39,61.43,Adapte,Adapte,Adapte / Adapte
4719,570,2020,Droit,14,1,QCU,0.66,0.24,0.62,113,93,75,18,1.22,80.65,75,38,66.0,Adapte,Adapte,Adapte / Adapte
570,571,2015,Droit,14,2,QCU,0.2005,0.65,0.25,54,20,11,9,2.7,55.0,11,43,20.05,Trop Difficile,Trop Difficile,Trop Difficile / Trop Difficile
1400,571,2016,Droit,14,2,QCU,0.8831,0.09,0.91,46,44,41,3,1.05,93.18,41,5,88.31,Trop Facile,Trop Facile,Trop Facile / Trop Facile
2230,571,2017,Droit,14,2,QCU,0.8689,0.04,1.0,41,38,36,2,1.08,94.74,36,5,86.89,Trop Facile,Trop Facile,Trop Facile / Trop Facile
3060,571,2018,Droit,14,2,QCU,0.8788,0.01,0.95,36,34,32,2,1.06,94.12,32,4,87.88,Trop Facile,Trop Facile,Trop Facile / Trop Facile
3890,571,2019,Droit,14,2,QCU,0.9407,0.01,0.92,39,39,37,2,1.0,94.87,37,2,94.07,Trop Facile,Trop Facile,Trop Facile / Trop Facile
4720,571,2020,Droit,14,2,QCU,0.77,0.16,0.76,31,25,24,1,1.24,96.0,24,7,77.0,Trop Facile,Facile,Trop Facile / Facile
571,572,2015,Droit,14,3,QCU,0.8273,0.06,0.86,99,99,82,17,1.0,82.83,82,17,82.73,Facile,Facile,Facile / Facile
1401,572,2016,Droit,14,3,QCU,0.1377,0.37,0.25,91,84,13,71,1.08,15.48,13,78,13.77,Trop Facile,Trop Difficile,Trop Facile / Trop Difficile
2231,572,2017,Droit,14,3,QCU,0.766,0.15,0.76,88,70,67,3,1.26,95.71,67,21,76.6,Trop Facile,Facile,Trop Facile / Facile
3061,572,2018,Droit,14,3,QCU,0.8611,0.03,0.94,89,79,77,2,1.13,97.47,77,12,86.11,Trop Facile,Trop Facile,Trop Facile / Trop Facile
3891,572,2019,Droit,14,3,QCU,0.7703,0.02,0.77,93,74,72,2,1.26,97.3,72,21,77.03,Trop Facile,Facile,Trop Facile / Facile
4721,572,2020,Droit,14,3,QCU,0.9266,0.02,0.99,106,106,98,8,1.0,92.45,98,8,92.66,Trop Facile,Trop Facile,Trop Facile / Trop Facile
572,573,2015,Droit,14,4,QCU,0.9952,0.0,0.97,70,70,70,0,1.0,100.0,70,0,99.52,Trop Difficile,Trop Facile,Trop Difficile / Trop Facile
1402,573,2016,Droit,14,4,QCU,0.5259,0.18,0.4,76,64,40,24,1.19,62.5,40,36,52.59,Trop Facile,Difficile,Trop Facile / Difficile
2232,573,2017,Droit,14,4,QCU,0.9495,0.05,0.96,72,68,68,0,1.06,100.0,68,4,94.95,Trop Facile,Trop Facile,Trop Facile / Trop Facile
3062,573,2018,Droit,14,4,QCU,0.9502,0.03,0.92,65,63,62,1,1.03,98.41,62,3,95.02,Trop Facile,Trop Facile,Trop Facile / Trop Facile
3892,573,2019,Droit,14,4,QCU,0.7436,0.26,0.54,53,42,39,3,1.26,92.86,39,14,74.36,Trop Facile,Adapte,Trop Facile / Adapte
4722,573,2020,Droit,14,4,QCU,0.635,0.08,0.43,50,38,32,6,1.32,84.21,32,18,63.5,Adapte,Adapte,Adapte / Adapte
573,574,2015,Droit,14,5,QCM,0.4148,0.29,0.32,46,20,19,1,2.3,95.0,19,27,41.48,Facile,Difficile,Facile / Difficile
1403,574,2016,Droit,14,5,QCM,0.8258,0.1,0.75,53,48,44,4,1.1,91.67,44,9,82.58,Facile,Facile,Facile / Facile
2233,574,2017,Droit,14,5,QCM,0.8396,0.16,0.74,55,49,46,3,1.12,93.88,46,9,83.96,Facile,Facile,Facile / Facile
3063,574,2018,Droit,14,5,QCM,0.7635,0.0,0.76,51,43,39,4,1.19,90.7,39,12,76.35,Facile,Facile,Facile / Facile
3893,574,2019,Droit,14,5,QCM,0.835,0.18,0.73,46,40,38,2,1.15,95.0,38,8,83.5,Facile,Facile,Facile / Facile
4723,574,2020,Droit,14,5,QCM,0.6704,0.03,0.47,40,36,27,9,1.11,75.0,27,13,67.04,Facile,Adapte,Facile / Adapte
574,575,2015,Droit,15,1,QCM,0.6338,0.3,0.43,58,44,37,7,1.32,84.09,37,21,63.38,Adapte,Adapte,Adapte / Adapte
1404,575,2016,Droit,15,1,QCM,0.6218,0.03,0.63,70,58,44,14,1.21,75.86,44,26,62.18,Adapte,Adapte,Adapte / Adapte
2234,575,2017,Droit,15,1,QCM,0.674,0.27,0.67,65,52,44,8,1.25,84.62,44,21,67.4,Adapte,Adapte,Adapte / Adapte
3064,575,2018,Droit,15,1,QCM,0.6318,0.12,0.68,56,43,35,8,1.3,81.4,35,21,63.18,Adapte,Adapte,Adapte / Adapte
3894,575,2019,Droit,15,1,QCM,0.675,0.17,0.45,48,37,32,5,1.3,86.49,32,16,67.5,Adapte,Adapte,Adapte / Adapte
4724,575,2020,Droit,15,1,QCM,0.6836,0.22,0.57,57,45,39,6,1.27,86.67,39,18,68.36,Adapte,Adapte,Adapte / Adapte
575,576,2015,Droit,15,2,QROC,0.6564,0.27,0.38,80,64,53,11,1.25,82.81,53,27,65.64,Adapte,Adapte,Adapte / Adapte
1405,576,2016,Droit,15,2,QROC,0.6486,0.44,0.38,75,74,49,25,1.01,66.22,49,26,64.86,Adapte,Adapte,Adapte / Adapte
2235,576,2017,Droit,15,2,QROC,0.6015,0.24,0.3,71,51,43,8,1.39,84.31,43,28,60.15,Adapte,Adapte,Adapte / Adapte
3065,576,2018,Droit,15,2,QROC,0.6926,0.28,0.36,60,56,42,14,1.07,75.0,42,18,69.26,Adapte,Adapte,Adapte / Adapte
3895,576,2019,Droit,15,2,QROC,0.6799,0.35,0.38,56,39,38,1,1.44,97.44,38,18,67.99,Adapte,Adapte,Adapte / Adapte
4725,576,2020,Droit,15,2,QROC,0.6897,0.38,0.34,54,50,37,13,1.08,74.0,37,17,68.97,Adapte,Adapte,Adapte / Adapte
576,577,2015,Droit,15,3,QCU,0.887,0.02,0.96,46,44,41,3,1.05,93.18,41,5,88.7,Trop Facile,Trop Facile,Trop Facile / Trop Facile
1406,577,2016,Droit,15,3,QCU,0.9053,0.0,0.93,53,49,48,1,1.08,97.96,48,5,90.53,Trop Facile,Trop Facile,Trop Facile / Trop Facile
2236,577,2017,Droit,15,3,QCU,0.865,0.09,0.99,50,50,43,7,1.0,86.0,43,7,86.5,Trop Facile,Trop Facile,Trop Facile / Trop Facile
3066,577,2018,Droit,15,3,QCU,0.9037,0.06,0.99,57,54,52,2,1.06,96.3,52,5,90.37,Trop Facile,Trop Facile,Trop Facile / Trop Facile
3896,577,2019,Droit,15,3,QCU,0.9371,0.07,0.94,62,61,58,3,1.02,95.08,58,4,93.71,Trop Facile,Trop Facile,Trop Facile / Trop Facile
4726,577,2020,Droit,15,3,QCU,0.9205,0.06,0.94,68,64,63,1,1.06,98.44,63,5,92.05,Trop Facile,Trop Facile,Trop Facile / Trop Facile
577,578,2015,Droit,15,4,QCU,0.6873,0.05,0.55,68,48,47,1,1.42,97.92,47,21,68.73,Adapte,Adapte,Adapte / Adapte
1407,578,2016,Droit,15,4,QCU,0.7148,0.04,0.53,70,65,50,15,1.08,76.92,50,20,71.48,Adapte,Adapte,Adapte / Adapte
2237,578,2017,Droit,15,4,QCU,0.7157,0.24,0.42,68,66,49,17,1.03,74.24,49,19,71.57,Adapte,Adapte,Adapte / Adapte
3067,578,2018,Droit,15,4,QCU,0.6647,0.09,0.69,64,52,43,9,1.23,82.69,43,21,66.47,Adapte,Adapte,Adapte / Adapte
3897,578,2019,Droit,15,4,QCU,0.6293,0.04,0.7,58,41,36,5,1.41,87.8,36,22,62.93,Adapte,Adapte,Adapte / Adapte
4727,578,2020,Droit,15,4,QCU,0.6782,0.13,0.58,59,54,40,14,1.09,74.07,40,19,67.82,Adapte,Adapte,Adapte / Adapte
578,579,2015,Droit,15,5,QCU,0.5355,0.34,0.33,49,31,26,5,1.58,83.87,26,23,53.55,Difficile,Difficile,Difficile / Difficile
1408,579,2016,Droit,15,5,QCU,0.9305,0.09,0.96,46,44,43,1,1.05,97.73,43,3,93.05,Trop Facile,Trop Facile,Trop Facile / Trop Facile
2238,579,2017,Droit,15,5,QCU,0.9263,0.03,0.92,48,44,44,0,1.09,100.0,44,4,92.63,Trop Facile,Trop Facile,Trop Facile / Trop Facile
3068,579,2018,Droit,15,5,QCU,0.231,0.32,0.25,49,41,11,30,1.2,26.83,11,38,23.1,Trop Facile,Trop Difficile,Trop Facile / Trop Difficile
3898,579,2019,Droit,15,5,QCU,0.95,0.02,0.91,54,53,51,2,1.02,96.23,51,3,95.0,Trop Facile,Trop Facile,Trop Facile / Trop Facile
4728,579,2020,Droit,15,5,QCU,0.7921,0.2,0.82,64,57,51,6,1.12,89.47,51,13,79.21,Trop Facile,Facile,Trop Facile / Facile
579,580,2015,Droit,15,6,QCM,0.6274,0.26,0.58,6,5,4,1,1.2,80.0,4,2,62.74,Trop Difficile,Adapte,Trop Difficile / Adapte
1409,580,2016,Droit,15,6,QCM,0.6491,0.18,0.49,6,5,4,1,1.2,80.0,4,2,64.91,Adapte,Adapte,Adapte / Adapte
2239,580,2017,Droit,15,6,QCM,0.6228,0.17,0.64,7,5,4,1,1.4,80.0,4,3,62.28,Adapte,Adapte,Adapte / Adapte
3069,580,2018,Droit,15,6,QCM,0.7437,0.24,0.52,6,5,4,1,1.2,80.0,4,2,74.37,Adapte,Adapte,Adapte / Adapte
3899,580,2019,Droit,15,6,QCM,0.7015,0.17,0.52,5,5,4,1,1.0,80.0,4,1,70.15,Adapte,Adapte,Adapte / Adapte
4729,580,2020,Droit,15,6,QCM,0.6738,0.02,0.63,5,4,3,1,1.25,75.0,3,2,67.38,Adapte,Adapte,Adapte / Adapte
580,581,2015,Droit,15,7,QCU,0.4417,0.03,0.34,46,39,20,19,1.18,51.28,20,26,44.17,Facile,Difficile,Facile / Difficile
1410,581,2016,Droit,15,7,QCU,0.9891,0.06,0.91,40,40,40,0,1.0,100.0,40,0,98.91,Trop Facile,Trop Facile,Trop Facile / Trop Facile
2240,581,2017,Droit,15,7,QCU,0.9444,0.06,0.93,32,31,30,1,1.03,96.77,30,2,94.44,Trop Facile,Trop Facile,Trop Facile / Trop Facile
3070,581,2018,Droit,15,7,QCU,0.3495,0.36,0.35,32,25,11,14,1.28,44.0,11,21,34.95,Trop Facile,Difficile,Trop Facile / Difficile
3900,581,2019,Droit,15,7,QCU,0.8271,0.13,0.83,29,27,24,3,1.07,88.89,24,5,82.71,Trop Facile,Facile,Trop Facile / Facile
4730,581,2020,Droit,15,7,QCU,0.9876,0.02,0.99,35,35,35,0,1.0,100.0,35,0,98.76,Trop Facile,Trop Facile,Trop Facile / Trop Facile
581,582,2015,Droit,15,8,QCU,0.5636,0.13,0.3,95,84,54,30,1.13,64.29,54,41,56.36,Facile,Difficile,Facile / Difficile
1411,582,2016,Droit,15,8,QCU,0.3383,0.24,0.34,91,78,31,47,1.17,39.74,31,60,33.83,Trop Facile,Difficile,Trop Facile / Difficile
2241,582,2017,Droit,15,8,QCU,0.9668,0.03,0.93,76,74,73,1,1.03,98.65,73,3,96.68,Trop Facile,Trop Facile,Trop Facile / Trop Facile
3071,582,2018,Droit,15,8,QCU,0.0054,0.13,0.29,80,61,0,61,1.31,0.0,0,80,0.54,Trop Facile,Trop Difficile,Trop Facile / Trop Difficile
3901,582,2019,Droit,15,8,QCU,0.9275,0.05,1.0,78,76,72,4,1.03,94.74,72,6,92.75,Trop Facile,Trop Facile,Trop Facile / Trop Facile
4731,582,2020,Droit,15,8,QCU,0.8791,0.07,0.95,91,88,80,8,1.03,90.91,80,11,87.91,Trop Facile,Trop Facile,Trop Facile / Trop Facile
582,583,2015,Droit,15,9,QO,0.8311,0.03,0.6,21,21,17,4,1.0,80.95,17,4,83.11,Trop Difficile,Facile,Trop Difficile / Facile
1412,583,2016,Droit,15,9,QO,0.7127,0.45,0.2,25,22,18,4,1.14,81.82,18,7,71.27,Adapte,Adapte,Adapte / Adapte
2242,583,2017,Droit,15,9,QO,0.6666,0.42,0.2,30,23,20,3,1.3,86.96,20,10,66.66,Adapte,Adapte,Adapte / Adapte
3072,583,2018,Droit,15,9,QO,0.6068,0.2,0.27,25,24,15,9,1.04,62.5,15,10,60.68,Adapte,Adapte,Adapte / Adapte
3902,583,2019,Droit,15,9,QO,0.6375,0.47,0.23,25,16,16,0,1.56,100.0,16,9,63.75,Adapte,Adapte,Adapte / Adapte
4732,583,2020,Droit,15,9,QO,0.6951,0.28,0.2,26,24,18,6,1.08,75.0,18,8,69.51,Adapte,Adapte,Adapte / Adapte
583,584,2015,Droit,16,1,QCU,0.7651,0.13,0.88,38,30,29,1,1.27,96.67,29,9,76.51,Difficile,Facile,Difficile / Facile
1413,584,2016,Droit,16,1,QCU,0.9898,0.03,0.99,41,41,41,0,1.0,100.0,41,0,98.98,Trop Facile,Trop Facile,Trop Facile / Trop Facile
2243,584,2017,Droit,16,1,QCU,0.1335,0.24,0.24,36,13,5,8,2.77,38.46,5,31,13.35,Trop Facile,Trop Difficile,Trop Facile / Trop Difficile
3073,584,2018,Droit,16,1,QCU,0.9778,0.08,0.94,37,37,36,1,1.0,97.3,36,1,97.78,Trop Facile,Trop Facile,Trop Facile / Trop Facile
3903,584,2019,Droit,16,1,QCU,0.7874,0.02,0.79,42,37,33,4,1.14,89.19,33,9,78.74,Trop Facile,Facile,Trop Facile / Facile
4733,584,2020,Droit,16,1,QCU,0.6779,0.06,0.55,44,39,30,9,1.13,76.92,30,14,67.79,Trop Facile,Adapte,Trop Facile / Adapte
584,585,2015,Droit,16,2,QCU,0.1173,0.65,0.28,28,25,3,22,1.12,12.0,3,25,11.73,Trop Difficile,Trop Difficile,Trop Difficile / Trop Difficile
1414,585,2016,Droit,16,2,QCU,0.906,0.08,0.97,25,24,23,1,1.04,95.83,23,2,90.6,Trop Facile,Trop Facile,Trop Facile / Trop Facile
2244,585,2017,Droit,16,2,QCU,0.9521,0.07,0.95,22,22,21,1,1.0,95.45,21,1,95.21,Trop Facile,Trop Facile,Trop Facile / Trop Facile
3074,585,2018,Droit,16,2,QCU,0.6155,0.12,0.53,25,17,15,2,1.47,88.24,15,10,61.55,Trop Facile,Adapte,Trop Facile / Adapte
3904,585,2019,Droit,16,2,QCU,0.6094,0.3,0.56,28,23,17,6,1.22,73.91,17,11,60.94,Adapte,Adapte,Adapte / Adapte
4734,585,2020,Droit,16,2,QCU,0.72,0.11,0.58,27,22,19,3,1.23,86.36,19,8,72.0,Adapte,Adapte,Adapte / Adapte
585,586,2015,Droit,16,3,QCM,0.8167,0.16,0.74,62,54,51,3,1.15,94.44,51,11,81.67,Difficile,Facile,Difficile / Facile
1415,586,2016,Droit,16,3,QCM,0.8096,0.09,0.75,60,58,49,9,1.03,84.48,49,11,80.96,Facile,Facile,Facile / Facile
2245,586,2017,Droit,16,3,QCM,0.7709,0.08,0.79,49,42,38,4,1.17,90.48,38,11,77.09,Facile,Facile,Facile / Facile
3075,586,2018,Droit,16,3,QCM,0.8009,0.03,0.71,40,36,32,4,1.11,88.89,32,8,80.09,Facile,Facile,Facile / Facile
3905,586,2019,Droit,16,3,QCM,0.7873,0.16,0.72,42,35,33,2,1.2,94.29,33,9,78.73,Facile,Facile,Facile / Facile
4735,586,2020,Droit,16,3,QCM,0.4593,0.23,0.36,34,23,16,7,1.48,69.57,16,18,45.93,Facile,Difficile,Facile / Difficile
586,587,2015,Droit,16,4,QCM,0.864,0.02,0.81,24,22,21,1,1.09,95.45,21,3,86.4,Trop Facile,Trop Facile,Trop Facile / Trop Facile
1416,587,2016,Droit,16,4,QCM,0.8665,0.06,0.94,23,23,20,3,1.0,86.96,20,3,86.65,Facile,Trop Facile,Facile / Trop Facile
2246,587,2017,Droit,16,4,QCM,0.7805,0.18,0.75,25,23,20,3,1.09,86.96,20,5,78.05,Facile,Facile,Facile / Facile
3076,587,2018,Droit,16,4,QCM,0.9715,0.02,0.87,23,23,22,1,1.0,95.65,22,1,97.15,Facile,Trop Facile,Facile / Trop Facile
3906,587,2019,Droit,16,4,QCM,0.7349,0.14,0.63,26,19,19,0,1.37,100.0,19,7,73.49,Facile,Adapte,Facile / Adapte
4736,587,2020,Droit,16,4,QCM,0.6473,0.22,0.53,30,23,19,4,1.3,82.61,19,11,64.73,Adapte,Adapte,Adapte / Adapte
587,588,2015,Droit,16,5,QCU,0.816,0.1,0.89,94,93,77,16,1.01,82.8,77,17,81.6,Facile,Facile,Facile / Facile
1417,588,2016,Droit,16,5,QCU,0.8708,0.03,1.0,93,90,81,9,1.03,90.0,81,12,87.08,Trop Facile,Trop Facile,Trop Facile / Trop Facile
2247,588,2017,Droit,16,5,QCU,0.9853,0.05,0.96,83,82,82,0,1.01,100.0,82,1,98.53,Trop Facile,Trop Facile,Trop Facile / Trop Facile
3077,588,2018,Droit,16,5,QCU,0.7733,0.07,0.77,94,84,73,11,1.12,86.9,73,21,77.33,Trop Facile,Facile,Trop Facile / Facile
3907,588,2019,Droit,16,5,QCU,0.9452,0.01,0.9,77,75,73,2,1.03,97.33,73,4,94.52,Trop Facile,Trop Facile,Trop Facile / Trop Facile
4737,588,2020,Droit,16,5,QCU,0.866,0.08,0.91,70,66,61,5,1.06,92.42,61,9,86.6,Trop Facile,Trop Facile,Trop Facile / Trop Facile
588,589,2015,Droit,16,6,QCM,0.4086,0.16,0.31,22,19,9,10,1.16,47.37,9,13,40.86,Difficile,Difficile,Difficile / Difficile
1418,589,2016,Droit,16,6,QCM,0.9965,0.01,0.93,26,26,26,0,1.0,100.0,26,0,99.65,Facile,Trop Facile,Facile / Trop Facile
2248,589,2017,Droit,16,6,QCM,0.3115,0.4,0.36,26,16,8,8,1.62,50.0,8,18,31.15,Facile,Difficile,Facile / Difficile
3078,589,2018,Droit,16,6,QCM,0.6256,0.29,0.52,23,19,14,5,1.21,73.68,14,9,62.56,Facile,Adapte,Facile / Adapte
3908,589,2019,Droit,16,6,QCM,0.7108,0.29,0.48,20,16,14,2,1.25,87.5,14,6,71.08,Adapte,Adapte,Adapte / Adapte
4738,589,2020,Droit,16,6,QCM,0.6314,0.04,0.52,20,18,13,5,1.11,72.22,13,7,63.14,Adapte,Adapte,Adapte / Adapte
589,590,2015,Droit,16,7,QCU,0.1126,0.11,0.22,94,85,11,74,1.11,12.94,11,83,11.26,Facile,Trop Difficile,Facile / Trop Difficile
1419,590,2016,Droit,16,7,QCU,0.9397,0.07,0.97,88,85,83,2,1.04,97.65,83,5,93.97,Trop Facile,Trop Facile,Trop Facile / Trop Facile
2249,590,2017,Droit,16,7,QCU,0.8271,0.05,0.89,76,70,63,7,1.09,90.0,63,13,82.71,Trop Facile,Facile,Trop Facile / Facile
3079,590,2018,Droit,16,7,QCU,0.0416,0.27,0.25,82,70,3,67,1.17,4.29,3,79,4.16,Trop Facile,Trop Difficile,Trop Facile / Trop Difficile
3909,590,2019,Droit,16,7,QCU,0.927,0.08,0.94,83,81,77,4,1.02,95.06,77,6,92.7,Trop Facile,Trop Facile,Trop Facile / Trop Facile
4739,590,2020,Droit,16,7,QCU,0.8777,0.07,0.99,79,74,69,5,1.07,93.24,69,10,87.77,Trop Facile,Trop Facile,Trop Facile / Trop Facile
590,591,2015,Droit,16,8,QCM,0.6953,0.21,0.44,84,65,58,7,1.29,89.23,58,26,69.53,Facile,Adapte,Facile / Adapte
1420,591,2016,Droit,16,8,QCM,0.7458,0.05,0.57,95,92,71,21,1.03,77.17,71,24,74.58,Adapte,Adapte,Adapte / Adapte
2250,591,2017,Droit,16,8,QCM,0.6592,0.28,0.56,113,106,74,32,1.07,69.81,74,39,65.92,Adapte,Adapte,Adapte / Adapte
3080,591,2018,Droit,16,8,QCM,0.6756,0.2,0.54,130,123,88,35,1.06,71.54,88,42,67.56,Adapte,Adapte,Adapte / Adapte
3910,591,2019,Droit,16,8,QCM,0.7212,0.14,0.63,107,87,77,10,1.23,88.51,77,30,72.12,Adapte,Adapte,Adapte / Adapte
4740,591,2020,Droit,16,8,QCM,0.6947,0.11,0.66,97,74,67,7,1.31,90.54,67,30,69.47,Adapte,Adapte,Adapte / Adapte
591,592,2015,Droit,16,9,QCU,0.6805,0.07,0.65,53,38,36,2,1.39,94.74,36,17,68.05,Facile,Adapte,Facile / Adapte
1421,592,2016,Droit,16,9,QCU,0.6922,0.14,0.52,52,37,36,1,1.41,97.3,36,16,69.22,Adapte,Adapte,Adapte / Adapte
2251,592,2017,Droit,16,9,QCU,0.6421,0.29,0.54,54,50,35,15,1.08,70.0,35,19,64.21,Adapte,Adapte,Adapte / Adapte
3081,592,2018,Droit,16,9,QCU,0.6864,0.04,0.49,47,40,32,8,1.18,80.0,32,15,68.64,Adapte,Adapte,Adapte / Adapte
3911,592,2019,Droit,16,9,QCU,0.6571,0.02,0.5,53,40,35,5,1.32,87.5,35,18,65.71,Adapte,Adapte,Adapte / Adapte
4741,592,2020,Droit,16,9,QCU,0.7322,0.14,0.53,64,57,47,10,1.12,82.46,47,17,73.22,Adapte,Adapte,Adapte / Adapte
592,593,2015,Droit,16,10,QCU,0.0307,0.71,0.24,48,26,1,25,1.85,3.85,1,47,3.07,Difficile,Trop Difficile,Difficile / Trop Difficile
1422,593,2016,Droit,16,10,QCU,0.6572,0.19,0.52,56,55,37,18,1.02,67.27,37,19,65.72,Trop Facile,Adapte,Trop Facile / Adapte
2252,593,2017,Droit,16,10,QCU,0.6996,0.01,0.56,48,39,34,5,1.23,87.18,34,14,69.96,Adapte,Adapte,Adapte / Adapte
3082,593,2018,Droit,16,10,QCU,0.6253,0.17,0.69,48,47,30,17,1.02,63.83,30,18,62.53,Adapte,Adapte,Adapte / Adapte
3912,593,2019,Droit,16,10,QCU,0.7004,0.08,0.61,56,54,39,15,1.04,72.22,39,17,70.04,Adapte,Adapte,Adapte / Adapte
4742,593,2020,Droit,16,10,QCU,0.6855,0.01,0.5,56,49,38,11,1.14,77.55,38,18,68.55,Adapte,Adapte,Adapte / Adapte
593,594,2015,Droit,16,11,QCU,0.8895,0.01,0.96,37,35,33,2,1.06,94.29,33,4,88.95,Facile,Trop Facile,Facile / Trop Facile
1423,594,2016,Droit,16,11,QCU,0.972,0.02,0.93,37,37,36,1,1.0,97.3,36,1,97.2,Trop Facile,Trop Facile,Trop Facile / Trop Facile
2253,594,2017,Droit,16,11,QCU,0.9091,0.04,0.96,43,40,39,1,1.07,97.5,39,4,90.91,Trop Facile,Trop Facile,Trop Facile / Trop Facile
3083,594,2018,Droit,16,11,QCU,0.9917,0.04,0.97,34,34,34,0,1.0,100.0,34,0,99.17,Trop Facile,Trop Facile,Trop Facile / Trop Facile
3913,594,2019,Droit,16,11,QCU,0.0491,0.17,0.27,35,13,2,11,2.69,15.38,2,33,4.91,Trop Facile,Trop Difficile,Trop Facile / Trop Difficile
4743,594,2020,Droit,16,11,QCU,0.9199,0.0,0.99,42,42,39,3,1.0,92.86,39,3,91.99,Trop Facile,Trop Facile,Trop Facile / Trop Facile
594,595,2015,Sociologie,1,1,QCU,0.3603,0.31,0.36,79,73,28,45,1.08,38.36,28,51,36.03,Difficile,Difficile,Difficile / Difficile
1424,595,2016,Sociologie,1,1,QCU,0.9748,0.04,0.92,86,84,84,0,1.02,100.0,84,2,97.48,Trop Facile,Trop Facile,Trop Facile / Trop Facile
2254,595,2017,Sociologie,1,1,QCU,0.9848,0.01,0.92,98,98,97,1,1.0,98.98,97,1,98.48,Trop Facile,Trop Facile,Trop Facile / Trop Facile
3084,595,2018,Sociologie,1,1,QCU,0.9699,0.0,0.96,112,110,109,1,1.02,99.09,109,3,96.99,Trop Facile,Trop Facile,Trop Facile / Trop Facile
3914,595,2019,Sociologie,1,1,QCU,0.7658,0.13,0.88,102,91,78,13,1.12,85.71,78,24,76.58,Trop Facile,Facile,Trop Facile / Facile
4744,595,2020,Sociologie,1,1,QCU,0.8664,0.01,0.9,103,92,89,3,1.12,96.74,89,14,86.64,Trop Facile,Trop Facile,Trop Facile / Trop Facile
595,596,2015,Sociologie,1,2,QCU,0.94,0.02,0.96,43,42,40,2,1.02,95.24,40,3,94.0,Facile,Trop Facile,Facile / Trop Facile
1425,596,2016,Sociologie,1,2,QCU,0.9207,0.0,0.99,46,45,42,3,1.02,93.33,42,4,92.07,Trop Facile,Trop Facile,Trop Facile / Trop Facile
2255,596,2017,Sociologie,1,2,QCU,0.8979,0.0,0.92,53,49,48,1,1.08,97.96,48,5,89.79,Trop Facile,Trop Facile,Trop Facile / Trop Facile
3085,596,2018,Sociologie,1,2,QCU,0.7456,0.03,0.42,63,54,47,7,1.17,87.04,47,16,74.56,Trop Facile,Adapte,Trop Facile / Adapte
3915,596,2019,Sociologie,1,2,QCU,0.6482,0.19,0.41,62,44,40,4,1.41,90.91,40,22,64.82,Adapte,Adapte,Adapte / Adapte
4745,596,2020,Sociologie,1,2,QCU,0.7032,0.07,0.51,59,58,41,17,1.02,70.69,41,18,70.32,Adapte,Adapte,Adapte / Adapte
596,597,2015,Sociologie,1,3,QCU,0.0338,0.21,0.28,17,14,1,13,1.21,7.14,1,16,3.38,Trop Facile,Trop Difficile,Trop Facile / Trop Difficile
1426,597,2016,Sociologie,1,3,QCU,0.9291,0.08,0.98,19,18,18,0,1.06,100.0,18,1,92.91,Trop Facile,Trop Facile,Trop Facile / Trop Facile
2256,597,2017,Sociologie,1,3,QCU,1.0,0.06,0.91,17,17,17,0,1.0,100.0,17,0,100.0,Trop Facile,Trop Facile,Trop Facile / Trop Facile
3086,597,2018,Sociologie,1,3,QCU,0.926,0.08,0.95,18,18,17,1,1.0,94.44,17,1,92.6,Trop Facile,Trop Facile,Trop Facile / Trop Facile
3916,597,2019,Sociologie,1,3,QCU,0.9428,0.03,0.91,16,15,15,0,1.07,100.0,15,1,94.28,Trop Facile,Trop Facile,Trop Facile / Trop Facile
4746,597,2020,Sociologie,1,3,QCU,0.896,0.08,0.95,16,15,14,1,1.07,93.33,14,2,89.6,Trop Facile,Trop Facile,Trop Facile / Trop Facile
597,598,2015,Sociologie,1,4,QCM,0.9415,0.01,0.94,95,92,89,3,1.03,96.74,89,6,94.15,Trop Facile,Trop Facile,Trop Facile / Trop Facile
1427,598,2016,Sociologie,1,4,QCM,0.8268,0.01,0.71,100,98,83,15,1.02,84.69,83,17,82.68,Facile,Facile,Facile / Facile
2257,598,2017,Sociologie,1,4,QCM,0.8273,0.17,0.76,92,80,76,4,1.15,95.0,76,16,82.73,Facile,Facile,Facile / Facile
3087,598,2018,Sociologie,1,4,QCM,0.7857,0.07,0.75,98,88,77,11,1.11,87.5,77,21,78.57,Facile,Facile,Facile / Facile
3917,598,2019,Sociologie,1,4,QCM,0.806,0.1,0.7,116,113,93,20,1.03,82.3,93,23,80.6,Facile,Facile,Facile / Facile
4747,598,2020,Sociologie,1,4,QCM,0.6646,0.26,0.46,131,128,87,41,1.02,67.97,87,44,66.46,Facile,Adapte,Facile / Adapte
598,599,2015,Sociologie,1,5,QCM,0.8144,0.09,0.72,33,29,27,2,1.14,93.1,27,6,81.44,Facile,Facile,Facile / Facile
1428,599,2016,Sociologie,1,5,QCM,0.0711,0.08,0.28,27,27,2,25,1.0,7.41,2,25,7.11,Facile,Trop Difficile,Facile / Trop Difficile
2258,599,2017,Sociologie,1,5,QCM,0.7758,0.17,0.7,32,25,25,0,1.28,100.0,25,7,77.58,Facile,Facile,Facile / Facile
3088,599,2018,Sociologie,1,5,QCM,0.7679,0.15,0.71,31,25,24,1,1.24,96.0,24,7,76.79,Facile,Facile,Facile / Facile
3918,599,2019,Sociologie,1,5,QCM,0.8358,0.06,0.71,28,27,23,4,1.04,85.19,23,5,83.58,Facile,Facile,Facile / Facile
4748,599,2020,Sociologie,1,5,QCM,0.8123,0.17,0.76,23,21,19,2,1.1,90.48,19,4,81.23,Facile,Facile,Facile / Facile
599,600,2015,Sociologie,1,6,QCU,0.8439,0.2,0.76,51,50,43,7,1.02,86.0,43,8,84.39,Adapte,Facile,Adapte / Facile
1429,600,2016,Sociologie,1,6,QCU,0.8745,0.02,0.92,46,41,40,1,1.12,97.56,40,6,87.45,Trop Facile,Trop Facile,Trop Facile / Trop Facile
2259,600,2017,Sociologie,1,6,QCU,0.8934,0.07,0.98,51,48,46,2,1.06,95.83,46,5,89.34,Trop Facile,Trop Facile,Trop Facile / Trop Facile
3089,600,2018,Sociologie,1,6,QCU,0.4674,0.3,0.39,52,41,24,17,1.27,58.54,24,28,46.74,Trop Facile,Difficile,Trop Facile / Difficile
3919,600,2019,Sociologie,1,6,QCU,0.9199,0.02,1.0,55,51,51,0,1.08,100.0,51,4,91.99,Trop Facile,Trop Facile,Trop Facile / Trop Facile
4749,600,2020,Sociologie,1,6,QCU,0.9266,0.01,0.92,61,58,57,1,1.05,98.28,57,4,92.66,Trop Facile,Trop Facile,Trop Facile / Trop Facile
600,601,2015,Sociologie,1,7,QCM,0.5625,0.42,0.34,45,30,25,5,1.5,83.33,25,20,56.25,Difficile,Difficile,Difficile / Difficile
1430,601,2016,Sociologie,1,7,QCM,0.7922,0.08,0.74,44,40,35,5,1.1,87.5,35,9,79.22,Facile,Facile,Facile / Facile
2260,601,2017,Sociologie,1,7,QCM,0.8197,0.1,0.75,46,42,38,4,1.1,90.48,38,8,81.97,Facile,Facile,Facile / Facile
3090,601,2018,Sociologie,1,7,QCM,0.8468,0.13,0.74,55,53,47,6,1.04,88.68,47,8,84.68,Facile,Facile,Facile / Facile
3920,601,2019,Sociologie,1,7,QCM,0.8265,0.04,0.77,55,52,45,7,1.06,86.54,45,10,82.65,Facile,Facile,Facile / Facile
4750,601,2020,Sociologie,1,7,QCM,0.7906,0.09,0.74,64,57,51,6,1.12,89.47,51,13,79.06,Facile,Facile,Facile / Facile
601,602,2015,Sociologie,1,8,QROC,0.7045,0.22,0.27,93,78,66,12,1.19,84.62,66,27,70.45,Trop Difficile,Adapte,Trop Difficile / Adapte
1431,602,2016,Sociologie,1,8,QROC,0.6422,0.27,0.36,107,100,69,31,1.07,69.0,69,38,64.22,Adapte,Adapte,Adapte / Adapte
2261,602,2017,Sociologie,1,8,QROC,0.6536,0.39,0.35,91,72,59,13,1.26,81.94,59,32,65.36,Adapte,Adapte,Adapte / Adapte
3091,602,2018,Sociologie,1,8,QROC,0.703,0.25,0.36,82,72,58,14,1.14,80.56,58,24,70.3,Adapte,Adapte,Adapte / Adapte
3921,602,2019,Sociologie,1,8,QROC,0.7193,0.38,0.33,71,68,51,17,1.04,75.0,51,20,71.93,Adapte,Adapte,Adapte / Adapte
4751,602,2020,Sociologie,1,8,QROC,0.6444,0.43,0.27,84,76,54,22,1.11,71.05,54,30,64.44,Adapte,Adapte,Adapte / Adapte
602,603,2015,Sociologie,1,9,QCM,0.7057,0.11,0.52,33,25,23,2,1.32,92.0,23,10,70.57,Facile,Adapte,Facile / Adapte
1432,603,2016,Sociologie,1,9,QCM,0.6596,0.19,0.6,39,32,26,6,1.22,81.25,26,13,65.96,Adapte,Adapte,Adapte / Adapte
2262,603,2017,Sociologie,1,9,QCM,0.6539,0.23,0.68,45,31,29,2,1.45,93.55,29,16,65.39,Adapte,Adapte,Adapte / Adapte
3092,603,2018,Sociologie,1,9,QCM,0.7044,0.16,0.63,52,41,37,4,1.27,90.24,37,15,70.44,Adapte,Adapte,Adapte / Adapte
3922,603,2019,Sociologie,1,9,QCM,0.6665,0.16,0.62,57,40,38,2,1.43,95.0,38,19,66.65,Adapte,Adapte,Adapte / Adapte
4752,603,2020,Sociologie,1,9,QCM,0.7337,0.16,0.46,51,41,37,4,1.24,90.24,37,14,73.37,Adapte,Adapte,Adapte / Adapte
603,604,2015,Sociologie,2,1,QCM,0.8075,0.06,0.79,33,28,27,1,1.18,96.43,27,6,80.75,Trop Difficile,Facile,Trop Difficile / Facile
1433,604,2016,Sociologie,2,1,QCM,0.848,0.09,0.8,27,24,23,1,1.12,95.83,23,4,84.8,Facile,Facile,Facile / Facile
2263,604,2017,Sociologie,2,1,QCM,0.6478,0.12,0.48,32,26,21,5,1.23,80.77,21,11,64.78,Facile,Adapte,Facile / Adapte
3093,604,2018,Sociologie,2,1,QCM,0.7226,0.12,0.63,36,34,26,8,1.06,76.47,26,10,72.26,Adapte,Adapte,Adapte / Adapte
3923,604,2019,Sociologie,2,1,QCM,0.7034,0.05,0.44,29,22,20,2,1.32,90.91,20,9,70.34,Adapte,Adapte,Adapte / Adapte
4753,604,2020,Sociologie,2,1,QCM,0.6661,0.21,0.59,25,20,17,3,1.25,85.0,17,8,66.61,Adapte,Adapte,Adapte / Adapte
604,605,2015,Sociologie,2,2,QROC,0.6292,0.26,0.26,46,41,29,12,1.12,70.73,29,17,62.92,Adapte,Adapte,Adapte / Adapte
1434,605,2016,Sociologie,2,2,QROC,0.6062,0.3,0.37,46,40,28,12,1.15,70.0,28,18,60.62,Adapte,Adapte,Adapte / Adapte
2264,605,2017,Sociologie,2,2,QROC,0.7,0.25,0.31,38,35,27,8,1.09,77.14,27,11,70.0,Adapte,Adapte,Adapte / Adapte
3094,605,2018,Sociologie,2,2,QROC,0.6037,0.42,0.29,40,36,24,12,1.11,66.67,24,16,60.37,Adapte,Adapte,Adapte / Adapte
3924,605,2019,Sociologie,2,2,QROC,0.6407,0.34,0.34,32,32,21,11,1.0,65.62,21,11,64.07,Adapte,Adapte,Adapte / Adapte
4754,605,2020,Sociologie,2,2,QROC,0.7097,0.44,0.35,32,27,23,4,1.19,85.19,23,9,70.97,Adapte,Adapte,Adapte / Adapte
605,606,2015,Sociologie,2,3,QCU,0.0059,0.1,0.22,70,55,0,55,1.27,0.0,0,70,0.59,Trop Difficile,Trop Difficile,Trop Difficile / Trop Difficile
1435,606,2016,Sociologie,2,3,QCU,0.9462,0.07,0.93,76,75,72,3,1.01,96.0,72,4,94.62,Trop Facile,Trop Facile,Trop Facile / Trop Facile
2265,606,2017,Sociologie,2,3,QCU,0.9429,0.04,0.93,74,73,70,3,1.01,95.89,70,4,94.29,Trop Facile,Trop Facile,Trop Facile / Trop Facile
3095,606,2018,Sociologie,2,3,QCU,0.8683,0.09,0.99,71,69,62,7,1.03,89.86,62,9,86.83,Trop Facile,Trop Facile,Trop Facile / Trop Facile
3925,606,2019,Sociologie,2,3,QCU,0.0323,0.38,0.23,84,69,3,66,1.22,4.35,3,81,3.23,Trop Facile,Trop Difficile,Trop Facile / Trop Difficile
4755,606,2020,Sociologie,2,3,QCU,0.8477,0.12,0.78,89,75,75,0,1.19,100.0,75,14,84.77,Trop Facile,Facile,Trop Facile / Facile
606,607,2015,Sociologie,2,4,QCM,0.9628,0.0,0.89,99,95,95,0,1.04,100.0,95,4,96.28,Trop Facile,Trop Facile,Trop Facile / Trop Facile
1436,607,2016,Sociologie,2,4,QCM,0.7619,0.15,0.8,102,87,78,9,1.17,89.66,78,24,76.19,Facile,Facile,Facile / Facile
2266,607,2017,Sociologie,2,4,QCM,0.9787,0.06,0.81,118,116,115,1,1.02,99.14,115,3,97.87,Facile,Trop Facile,Facile / Trop Facile
3096,607,2018,Sociologie,2,4,QCM,0.838,0.14,0.78,97,84,81,3,1.15,96.43,81,16,83.8,Facile,Facile,Facile / Facile
3926,607,2019,Sociologie,2,4,QCM,0.7875,0.05,0.76,97,92,76,16,1.05,82.61,76,21,78.75,Facile,Facile,Facile / Facile
4756,607,2020,Sociologie,2,4,QCM,0.8384,0.03,0.78,82,80,69,11,1.02,86.25,69,13,83.84,Facile,Facile,Facile / Facile
607,608,2015,Sociologie,2,5,QCM,0.5044,0.44,0.33,40,24,20,4,1.67,83.33,20,20,50.44,Difficile,Difficile,Difficile / Difficile
1437,608,2016,Sociologie,2,5,QCM,0.817,0.05,0.77,48,43,39,4,1.12,90.7,39,9,81.7,Facile,Facile,Facile / Facile
2267,608,2017,Sociologie,2,5,QCM,0.9136,0.05,1.0,57,57,52,5,1.0,91.23,52,5,91.36,Facile,Trop Facile,Facile / Trop Facile
3097,608,2018,Sociologie,2,5,QCM,0.7948,0.07,0.75,63,55,50,5,1.15,90.91,50,13,79.48,Facile,Facile,Facile / Facile
3927,608,2019,Sociologie,2,5,QCM,0.8297,0.12,0.79,75,69,62,7,1.09,89.86,62,13,82.97,Facile,Facile,Facile / Facile
4757,608,2020,Sociologie,2,5,QCM,0.8217,0.19,0.77,89,75,73,2,1.19,97.33,73,16,82.17,Facile,Facile,Facile / Facile
608,609,2015,Sociologie,2,6,QCU,0.8708,0.05,0.91,52,48,45,3,1.08,93.75,45,7,87.08,Difficile,Trop Facile,Difficile / Trop Facile
1438,609,2016,Sociologie,2,6,QCU,0.171,0.38,0.22,44,24,8,16,1.83,33.33,8,36,17.1,Trop Facile,Trop Difficile,Trop Facile / Trop Difficile
2268,609,2017,Sociologie,2,6,QCU,0.7335,0.12,0.54,47,38,34,4,1.24,89.47,34,13,73.35,Trop Facile,Adapte,Trop Facile / Adapte
3098,609,2018,Sociologie,2,6,QCU,0.6492,0.19,0.45,53,38,34,4,1.39,89.47,34,19,64.92,Adapte,Adapte,Adapte / Adapte
3928,609,2019,Sociologie,2,6,QCU,0.6189,0.05,0.66,47,33,29,4,1.42,87.88,29,18,61.89,Adapte,Adapte,Adapte / Adapte
4758,609,2020,Sociologie,2,6,QCU,0.7019,0.27,0.64,49,36,34,2,1.36,94.44,34,15,70.19,Adapte,Adapte,Adapte / Adapte
609,610,2015,Sociologie,2,7,QCU,0.9149,0.06,0.96,86,84,79,5,1.02,94.05,79,7,91.49,Trop Difficile,Trop Facile,Trop Difficile / Trop Facile
1439,610,2016,Sociologie,2,7,QCU,0.7399,0.21,0.65,83,68,61,7,1.22,89.71,61,22,73.99,Trop Facile,Adapte,Trop Facile / Adapte
2269,610,2017,Sociologie,2,7,QCU,0.6098,0.28,0.63,94,78,57,21,1.21,73.08,57,37,60.98,Adapte,Adapte,Adapte / Adapte
3099,610,2018,Sociologie,2,7,QCU,0.623,0.21,0.4,83,74,52,22,1.12,70.27,52,31,62.3,Adapte,Adapte,Adapte / Adapte
3929,610,2019,Sociologie,2,7,QCU,0.6318,0.28,0.42,77,62,49,13,1.24,79.03,49,28,63.18,Adapte,Adapte,Adapte / Adapte
4759,610,2020,Sociologie,2,7,QCU,0.6081,0.15,0.46,77,56,47,9,1.38,83.93,47,30,60.81,Adapte,Adapte,Adapte / Adapte
610,611,2015,Sociologie,2,8,QCM,0.6337,0.29,0.61,38,27,24,3,1.41,88.89,24,14,63.37,Facile,Adapte,Facile / Adapte
1440,611,2016,Sociologie,2,8,QCM,0.6249,0.26,0.63,37,31,23,8,1.19,74.19,23,14,62.49,Adapte,Adapte,Adapte / Adapte
2270,611,2017,Sociologie,2,8,QCM,0.7312,0.11,0.58,30,28,22,6,1.07,78.57,22,8,73.12,Adapte,Adapte,Adapte / Adapte
3100,611,2018,Sociologie,2,8,QCM,0.7494,0.02,0.61,34,33,25,8,1.03,75.76,25,9,74.94,Adapte,Adapte,Adapte / Adapte
3930,611,2019,Sociologie,2,8,QCM,0.7333,0.12,0.67,39,35,29,6,1.11,82.86,29,10,73.33,Adapte,Adapte,Adapte / Adapte
4760,611,2020,Sociologie,2,8,QCM,0.6925,0.28,0.55,38,37,26,11,1.03,70.27,26,12,69.25,Adapte,Adapte,Adapte / Adapte
611,612,2015,Sociologie,3,1,QCU,0.1375,0.72,0.29,86,37,12,25,2.32,32.43,12,74,13.75,Difficile,Trop Difficile,Difficile / Trop Difficile
1441,612,2016,Sociologie,3,1,QCU,0.9967,0.09,0.96,97,97,97,0,1.0,100.0,97,0,99.67,Trop Facile,Trop Facile,Trop Facile / Trop Facile
2271,612,2017,Sociologie,3,1,QCU,0.8935,0.07,0.96,84,76,75,1,1.11,98.68,75,9,89.35,Trop Facile,Trop Facile,Trop Facile / Trop Facile
3101,612,2018,Sociologie,3,1,QCU,0.796,0.01,0.84,94,77,75,2,1.22,97.4,75,19,79.6,Trop Facile,Facile,Trop Facile / Facile
3931,612,2019,Sociologie,3,1,QCU,0.7431,0.18,0.59,91,84,68,16,1.08,80.95,68,23,74.31,Trop Facile,Adapte,Trop Facile / Adapte
4761,612,2020,Sociologie,3,1,QCU,0.6774,0.19,0.65,98,75,66,9,1.31,88.0,66,32,67.74,Adapte,Adapte,Adapte / Adapte
612,613,2015,Sociologie,3,2,QROC,0.5499,0.56,0.22,88,79,48,31,1.11,60.76,48,40,54.99,Difficile,Difficile,Difficile / Difficile
1442,613,2016,Sociologie,3,2,QROC,0.8105,0.12,0.61,95,78,77,1,1.22,98.72,77,18,81.05,Facile,Facile,Facile / Facile
2272,613,2017,Sociologie,3,2,QROC,0.802,0.15,0.51,98,88,79,9,1.11,89.77,79,19,80.2,Facile,Facile,Facile / Facile
3102,613,2018,Sociologie,3,2,QROC,0.8221,0.01,0.44,96,88,79,9,1.09,89.77,79,17,82.21,Facile,Facile,Facile / Facile
3932,613,2019,Sociologie,3,2,QROC,0.7712,0.01,0.56,100,94,77,17,1.06,81.91,77,23,77.12,Facile,Facile,Facile / Facile
4762,613,2020,Sociologie,3,2,QROC,0.7971,0.15,0.61,106,102,84,18,1.04,82.35,84,22,79.71,Facile,Facile,Facile / Facile
613,614,2015,Sociologie,3,3,QCM,0.4418,0.33,0.3,72,45,32,13,1.6,71.11,32,40,44.18,Difficile,Difficile,Difficile / Difficile
1443,614,2016,Sociologie,3,3,QCM,0.8232,0.16,0.71,66,57,54,3,1.16,94.74,54,12,82.32,Facile,Facile,Facile / Facile
2273,614,2017,Sociologie,3,3,QCM,0.7925,0.13,0.71,65,52,52,0,1.25,100.0,52,13,79.25,Facile,Facile,Facile / Facile
3103,614,2018,Sociologie,3,3,QCM,0.8077,0.05,0.73,68,64,55,9,1.06,85.94,55,13,80.77,Facile,Facile,Facile / Facile
3933,614,2019,Sociologie,3,3,QCM,0.7499,0.1,0.54,73,70,55,15,1.04,78.57,55,18,74.99,Facile,Adapte,Facile / Adapte
4763,614,2020,Sociologie,3,3,QCM,0.6557,0.09,0.57,59,49,39,10,1.2,79.59,39,20,65.57,Adapte,Adapte,Adapte / Adapte
614,615,2015,Sociologie,3,4,QCM,0.0675,0.37,0.22,95,91,6,85,1.04,6.59,6,89,6.75,Adapte,Trop Difficile,Adapte / Trop Difficile
1444,615,2016,Sociologie,3,4,QCM,0.8227,0.09,0.72,98,93,81,12,1.05,87.1,81,17,82.27,Facile,Facile,Facile / Facile
2274,615,2017,Sociologie,3,4,QCM,0.4222,0.35,0.33,83,52,35,17,1.6,67.31,35,48,42.22,Facile,Difficile,Facile / Difficile
3104,615,2018,Sociologie,3,4,QCM,0.2868,0.49,0.4,82,61,24,37,1.34,39.34,24,58,28.68,Facile,Difficile,Facile / Difficile
3934,615,2019,Sociologie,3,4,QCM,0.8218,0.02,0.79,79,68,65,3,1.16,95.59,65,14,82.18,Facile,Facile,Facile / Facile
4764,615,2020,Sociologie,3,4,QCM,0.8321,0.06,0.77,69,61,57,4,1.13,93.44,57,12,83.21,Facile,Facile,Facile / Facile
615,616,2015,Sociologie,3,5,QCU,0.0381,0.6,0.25,100,53,4,49,1.89,7.55,4,96,3.81,Difficile,Trop Difficile,Difficile / Trop Difficile
1445,616,2016,Sociologie,3,5,QCU,0.9454,0.06,0.95,92,91,87,4,1.01,95.6,87,5,94.54,Trop Facile,Trop Facile,Trop Facile / Trop Facile
2275,616,2017,Sociologie,3,5,QCU,0.8693,0.1,0.92,100,98,87,11,1.02,88.78,87,13,86.93,Trop Facile,Trop Facile,Trop Facile / Trop Facile
3105,616,2018,Sociologie,3,5,QCU,0.966,0.01,0.97,107,103,103,0,1.04,100.0,103,4,96.6,Trop Facile,Trop Facile,Trop Facile / Trop Facile
3935,616,2019,Sociologie,3,5,QCU,0.9855,0.09,0.99,109,109,107,2,1.0,98.17,107,2,98.55,Trop Facile,Trop Facile,Trop Facile / Trop Facile
4765,616,2020,Sociologie,3,5,QCU,0.6245,0.3,0.46,110,90,69,21,1.22,76.67,69,41,62.45,Trop Facile,Adapte,Trop Facile / Adapte
616,617,2015,Sociologie,3,6,QCU,0.9243,0.04,0.98,60,59,55,4,1.02,93.22,55,5,92.43,Facile,Trop Facile,Facile / Trop Facile
1446,617,2016,Sociologie,3,6,QCU,0.9273,0.04,0.93,64,61,59,2,1.05,96.72,59,5,92.73,Trop Facile,Trop Facile,Trop Facile / Trop Facile
2276,617,2017,Sociologie,3,6,QCU,0.1935,0.42,0.24,70,68,14,54,1.03,20.59,14,56,19.35,Trop Facile,Trop Difficile,Trop Facile / Trop Difficile
3106,617,2018,Sociologie,3,6,QCU,0.0488,0.6,0.27,70,25,3,22,2.8,12.0,3,67,4.88,Trop Facile,Trop Difficile,Trop Facile / Trop Difficile
3936,617,2019,Sociologie,3,6,QCU,0.9227,0.02,0.93,62,58,57,1,1.07,98.28,57,5,92.27,Trop Facile,Trop Facile,Trop Facile / Trop Facile
4766,617,2020,Sociologie,3,6,QCU,0.9266,0.0,0.95,63,61,58,3,1.03,95.08,58,5,92.66,Trop Facile,Trop Facile,Trop Facile / Trop Facile
617,618,2015,Sociologie,3,7,QCM,0.1572,0.42,0.2,50,14,8,6,3.57,57.14,8,42,15.72,Trop Difficile,Trop Difficile,Trop Difficile / Trop Difficile
1447,618,2016,Sociologie,3,7,QCM,0.6396,0.17,0.52,45,30,29,1,1.5,96.67,29,16,63.96,Facile,Adapte,Facile / Adapte
2277,618,2017,Sociologie,3,7,QCM,0.6216,0.06,0.66,52,33,32,1,1.58,96.97,32,20,62.16,Adapte,Adapte,Adapte / Adapte
3107,618,2018,Sociologie,3,7,QCM,0.6803,0.23,0.67,57,45,39,6,1.27,86.67,39,18,68.03,Adapte,Adapte,Adapte / Adapte
3937,618,2019,Sociologie,3,7,QCM,0.6514,0.2,0.4,57,51,37,14,1.12,72.55,37,20,65.14,Adapte,Adapte,Adapte / Adapte
4767,618,2020,Sociologie,3,7,QCM,0.6785,0.24,0.52,57,44,39,5,1.3,88.64,39,18,67.85,Adapte,Adapte,Adapte / Adapte
618,619,2015,Sociologie,3,8,QCM,0.0544,0.55,0.29,60,15,3,12,4.0,20.0,3,57,5.44,Trop Difficile,Trop Difficile,Trop Difficile / Trop Difficile
1448,619,2016,Sociologie,3,8,QCM,0.7852,0.05,0.73,63,62,49,13,1.02,79.03,49,14,78.52,Facile,Facile,Facile / Facile
2278,619,2017,Sociologie,3,8,QCM,0.8044,0.13,0.79,69,64,56,8,1.08,87.5,56,13,80.44,Facile,Facile,Facile / Facile
3108,619,2018,Sociologie,3,8,QCM,0.7932,0.15,0.78,67,60,53,7,1.12,88.33,53,14,79.32,Facile,Facile,Facile / Facile
3938,619,2019,Sociologie,3,8,QCM,0.8129,0.07,0.71,60,56,49,7,1.07,87.5,49,11,81.29,Facile,Facile,Facile / Facile
4768,619,2020,Sociologie,3,8,QCM,0.6656,0.15,0.41,71,48,47,1,1.48,97.92,47,24,66.56,Facile,Adapte,Facile / Adapte
619,620,2015,Sociologie,3,9,QCU,0.7928,0.1,0.77,32,27,25,2,1.19,92.59,25,7,79.28,Facile,Facile,Facile / Facile
1449,620,2016,Sociologie,3,9,QCU,0.9014,0.05,0.97,34,32,31,1,1.06,96.88,31,3,90.14,Trop Facile,Trop Facile,Trop Facile / Trop Facile
2279,620,2017,Sociologie,3,9,QCU,0.9432,0.1,0.98,27,25,25,0,1.08,100.0,25,2,94.32,Trop Facile,Trop Facile,Trop Facile / Trop Facile
3109,620,2018,Sociologie,3,9,QCU,0.9498,0.07,0.96,32,30,30,0,1.07,100.0,30,2,94.98,Trop Facile,Trop Facile,Trop Facile / Trop Facile
3939,620,2019,Sociologie,3,9,QCU,0.8797,0.01,0.95,38,37,33,4,1.03,89.19,33,5,87.97,Trop Facile,Trop Facile,Trop Facile / Trop Facile
4769,620,2020,Sociologie,3,9,QCU,0.4517,0.24,0.3,37,26,17,9,1.42,65.38,17,20,45.17,Trop Facile,Difficile,Trop Facile / Difficile
620,621,2015,Sociologie,3,10,QCU,0.2049,0.16,0.29,10,8,2,6,1.25,25.0,2,8,20.49,Trop Difficile,Trop Difficile,Trop Difficile / Trop Difficile
1450,621,2016,Sociologie,3,10,QCU,0.9406,0.05,0.9,12,11,11,0,1.09,100.0,11,1,94.06,Trop Facile,Trop Facile,Trop Facile / Trop Facile
2280,621,2017,Sociologie,3,10,QCU,0.9487,0.01,0.93,10,9,9,0,1.11,100.0,9,1,94.87,Trop Facile,Trop Facile,Trop Facile / Trop Facile
3110,621,2018,Sociologie,3,10,QCU,0.4545,0.22,0.37,12,10,5,5,1.2,50.0,5,7,45.45,Trop Facile,Difficile,Trop Facile / Difficile
3940,621,2019,Sociologie,3,10,QCU,0.3392,0.16,0.33,12,9,4,5,1.33,44.44,4,8,33.92,Trop Facile,Difficile,Trop Facile / Difficile
4770,621,2020,Sociologie,3,10,QCU,0.9813,0.07,0.97,14,14,14,0,1.0,100.0,14,0,98.13,Trop Facile,Trop Facile,Trop Facile / Trop Facile
621,622,2015,Sociologie,3,11,QCM,0.8157,0.12,0.77,50,49,41,8,1.02,83.67,41,9,81.57,Facile,Facile,Facile / Facile
1451,622,2016,Sociologie,3,11,QCM,0.7299,0.14,0.57,49,41,36,5,1.2,87.8,36,13,72.99,Facile,Adapte,Facile / Adapte
2281,622,2017,Sociologie,3,11,QCM,0.6835,0.21,0.41,57,39,39,0,1.46,100.0,39,18,68.35,Adapte,Adapte,Adapte / Adapte
3111,622,2018,Sociologie,3,11,QCM,0.6272,0.22,0.47,62,42,39,3,1.48,92.86,39,23,62.72,Adapte,Adapte,Adapte / Adapte
3941,622,2019,Sociologie,3,11,QCM,0.7173,0.11,0.59,52,38,37,1,1.37,97.37,37,15,71.73,Adapte,Adapte,Adapte / Adapte
4771,622,2020,Sociologie,3,11,QCM,0.6193,0.01,0.67,50,46,31,15,1.09,67.39,31,19,61.93,Adapte,Adapte,Adapte / Adapte
622,623,2015,Sociologie,4,1,QCU,0.6257,0.03,0.55,16,14,10,4,1.14,71.43,10,6,62.57,Trop Facile,Adapte,Trop Facile / Adapte
1452,623,2016,Sociologie,4,1,QCU,0.6403,0.08,0.54,15,15,10,5,1.0,66.67,10,5,64.03,Adapte,Adapte,Adapte / Adapte
2282,623,2017,Sociologie,4,1,QCU,0.7245,0.28,0.67,17,12,12,0,1.42,100.0,12,5,72.45,Adapte,Adapte,Adapte / Adapte
3112,623,2018,Sociologie,4,1,QCU,0.6198,0.03,0.51,18,13,11,2,1.38,84.62,11,7,61.98,Adapte,Adapte,Adapte / Adapte
3942,623,2019,Sociologie,4,1,QCU,0.6649,0.01,0.42,18,14,12,2,1.29,85.71,12,6,66.49,Adapte,Adapte,Adapte / Adapte
4772,623,2020,Sociologie,4,1,QCU,0.6746,0.02,0.59,15,14,10,4,1.07,71.43,10,5,67.46,Adapte,Adapte,Adapte / Adapte
623,624,2015,Sociologie,4,2,QROC,0.7058,0.33,0.26,84,73,59,14,1.15,80.82,59,25,70.58,Trop Difficile,Adapte,Trop Difficile / Adapte
1453,624,2016,Sociologie,4,2,QROC,0.7039,0.29,0.34,81,62,57,5,1.31,91.94,57,24,70.39,Adapte,Adapte,Adapte / Adapte
2283,624,2017,Sociologie,4,2,QROC,0.7004,0.36,0.39,94,78,66,12,1.21,84.62,66,28,70.04,Adapte,Adapte,Adapte / Adapte
3113,624,2018,Sociologie,4,2,QROC,0.717,0.25,0.32,78,66,56,10,1.18,84.85,56,22,71.7,Adapte,Adapte,Adapte / Adapte
3943,624,2019,Sociologie,4,2,QROC,0.6829,0.36,0.39,68,55,46,9,1.24,83.64,46,22,68.29,Adapte,Adapte,Adapte / Adapte
4773,624,2020,Sociologie,4,2,QROC,0.6635,0.35,0.26,72,49,48,1,1.47,97.96,48,24,66.35,Adapte,Adapte,Adapte / Adapte
624,625,2015,Sociologie,4,3,QCU,0.7965,0.08,0.9,83,70,66,4,1.19,94.29,66,17,79.65,Facile,Facile,Facile / Facile
1454,625,2016,Sociologie,4,3,QCU,0.9127,0.1,0.96,79,74,72,2,1.07,97.3,72,7,91.27,Trop Facile,Trop Facile,Trop Facile / Trop Facile
2284,625,2017,Sociologie,4,3,QCU,0.8937,0.04,0.95,72,68,64,4,1.06,94.12,64,8,89.37,Trop Facile,Trop Facile,Trop Facile / Trop Facile
3114,625,2018,Sociologie,4,3,QCU,0.9821,0.09,0.93,77,76,76,0,1.01,100.0,76,1,98.21,Trop Facile,Trop Facile,Trop Facile / Trop Facile
3944,625,2019,Sociologie,4,3,QCU,0.9274,0.08,0.92,74,70,69,1,1.06,98.57,69,5,92.74,Trop Facile,Trop Facile,Trop Facile / Trop Facile
4774,625,2020,Sociologie,4,3,QCU,0.0311,0.08,0.25,63,54,2,52,1.17,3.7,2,61,3.11,Trop Facile,Trop Difficile,Trop Facile / Trop Difficile
625,626,2015,Sociologie,4,4,QCM,0.7687,0.09,0.72,79,72,61,11,1.1,84.72,61,18,76.87,Facile,Facile,Facile / Facile
1455,626,2016,Sociologie,4,4,QCM,0.629,0.17,0.63,89,56,56,0,1.59,100.0,56,33,62.9,Facile,Adapte,Facile / Adapte
2285,626,2017,Sociologie,4,4,QCM,0.6533,0.22,0.6,74,62,48,14,1.19,77.42,48,26,65.33,Adapte,Adapte,Adapte / Adapte
3115,626,2018,Sociologie,4,4,QCM,0.6124,0.14,0.64,62,44,38,6,1.41,86.36,38,24,61.24,Adapte,Adapte,Adapte / Adapte
3945,626,2019,Sociologie,4,4,QCM,0.6577,0.18,0.57,60,58,39,19,1.03,67.24,39,21,65.77,Adapte,Adapte,Adapte / Adapte
4775,626,2020,Sociologie,4,4,QCM,0.6711,0.25,0.58,65,57,44,13,1.14,77.19,44,21,67.11,Adapte,Adapte,Adapte / Adapte
626,627,2015,Sociologie,5,1,QCM,0.7691,0.06,0.78,81,73,62,11,1.11,84.93,62,19,76.91,Adapte,Facile,Adapte / Facile
1456,627,2016,Sociologie,5,1,QCM,0.7925,0.03,0.74,97,93,77,16,1.04,82.8,77,20,79.25,Facile,Facile,Facile / Facile
2286,627,2017,Sociologie,5,1,QCM,0.7777,0.17,0.7,84,83,65,18,1.01,78.31,65,19,77.77,Facile,Facile,Facile / Facile
3116,627,2018,Sociologie,5,1,QCM,0.761,0.05,0.79,74,61,56,5,1.21,91.8,56,18,76.1,Facile,Facile,Facile / Facile
3946,627,2019,Sociologie,5,1,QCM,0.7844,0.04,0.77,82,76,64,12,1.08,84.21,64,18,78.44,Facile,Facile,Facile / Facile
4776,627,2020,Sociologie,5,1,QCM,0.7773,0.18,0.73,88,74,68,6,1.19,91.89,68,20,77.73,Facile,Facile,Facile / Facile
627,628,2015,Sociologie,5,2,QCM,0.5648,0.24,0.36,89,68,50,18,1.31,73.53,50,39,56.48,Facile,Difficile,Facile / Difficile
1457,628,2016,Sociologie,5,2,QCM,0.8262,0.09,0.72,82,68,68,0,1.21,100.0,68,14,82.62,Facile,Facile,Facile / Facile
2287,628,2017,Sociologie,5,2,QCM,0.8081,0.05,0.8,93,80,75,5,1.16,93.75,75,18,80.81,Facile,Facile,Facile / Facile
3117,628,2018,Sociologie,5,2,QCM,0.8015,0.11,0.78,107,89,86,3,1.2,96.63,86,21,80.15,Facile,Facile,Facile / Facile
3947,628,2019,Sociologie,5,2,QCM,0.6844,0.26,0.68,115,102,79,23,1.13,77.45,79,36,68.44,Facile,Adapte,Facile / Adapte
4777,628,2020,Sociologie,5,2,QCM,0.6199,0.23,0.53,136,88,84,4,1.55,95.45,84,52,61.99,Adapte,Adapte,Adapte / Adapte
628,629,2015,Sociologie,5,3,QCM,0.7856,0.19,0.73,11,11,9,2,1.0,81.82,9,2,78.56,Facile,Facile,Facile / Facile
1458,629,2016,Sociologie,5,3,QCM,0.8006,0.18,0.74,11,10,9,1,1.1,90.0,9,2,80.06,Facile,Facile,Facile / Facile
2288,629,2017,Sociologie,5,3,QCM,0.7671,0.16,0.79,11,9,8,1,1.22,88.89,8,3,76.71,Facile,Facile,Facile / Facile
3118,629,2018,Sociologie,5,3,QCM,0.9344,0.06,0.96,11,10,10,0,1.1,100.0,10,1,93.44,Facile,Trop Facile,Facile / Trop Facile
3948,629,2019,Sociologie,5,3,QCM,0.8243,0.14,0.76,9,8,7,1,1.12,87.5,7,2,82.43,Facile,Facile,Facile / Facile
4778,629,2020,Sociologie,5,3,QCM,0.8464,0.06,0.71,11,10,9,1,1.1,90.0,9,2,84.64,Facile,Facile,Facile / Facile
629,630,2015,Sociologie,5,4,QCU,0.8668,0.09,0.94,76,73,66,7,1.04,90.41,66,10,86.68,Trop Facile,Trop Facile,Trop Facile / Trop Facile
1459,630,2016,Sociologie,5,4,QCU,0.7882,0.08,0.83,72,58,57,1,1.24,98.28,57,15,78.82,Trop Facile,Facile,Trop Facile / Facile
2289,630,2017,Sociologie,5,4,QCU,0.9601,0.03,0.98,61,61,59,2,1.0,96.72,59,2,96.01,Trop Facile,Trop Facile,Trop Facile / Trop Facile
3119,630,2018,Sociologie,5,4,QCU,0.0829,0.38,0.24,67,55,6,49,1.22,10.91,6,61,8.29,Trop Facile,Trop Difficile,Trop Facile / Trop Difficile
3949,630,2019,Sociologie,5,4,QCU,0.9837,0.01,0.97,54,54,53,1,1.0,98.15,53,1,98.37,Trop Facile,Trop Facile,Trop Facile / Trop Facile
4779,630,2020,Sociologie,5,4,QCU,0.1955,0.61,0.23,49,20,10,10,2.45,50.0,10,39,19.55,Trop Facile,Trop Difficile,Trop Facile / Trop Difficile
630,631,2015,Sociologie,5,5,QCM,0.2648,0.1,0.39,35,27,9,18,1.3,33.33,9,26,26.48,Difficile,Difficile,Difficile / Difficile
1460,631,2016,Sociologie,5,5,QCM,0.7766,0.05,0.75,41,33,32,1,1.24,96.97,32,9,77.66,Facile,Facile,Facile / Facile
2290,631,2017,Sociologie,5,5,QCM,0.7928,0.2,0.8,42,34,33,1,1.24,97.06,33,9,79.28,Facile,Facile,Facile / Facile
3120,631,2018,Sociologie,5,5,QCM,0.8127,0.08,0.79,40,39,33,6,1.03,84.62,33,7,81.27,Facile,Facile,Facile / Facile
3950,631,2019,Sociologie,5,5,QCM,0.8466,0.1,0.73,35,31,30,1,1.13,96.77,30,5,84.66,Facile,Facile,Facile / Facile
4780,631,2020,Sociologie,5,5,QCM,0.8008,0.09,0.77,40,32,32,0,1.25,100.0,32,8,80.08,Facile,Facile,Facile / Facile
631,632,2015,Sociologie,5,6,QROC,0.7648,0.03,0.6,52,44,40,4,1.18,90.91,40,12,76.48,Facile,Facile,Facile / Facile
1461,632,2016,Sociologie,5,6,QROC,0.8228,0.15,0.69,45,40,37,3,1.12,92.5,37,8,82.28,Facile,Facile,Facile / Facile
2291,632,2017,Sociologie,5,6,QROC,0.7748,0.1,0.57,46,39,36,3,1.18,92.31,36,10,77.48,Facile,Facile,Facile / Facile
3121,632,2018,Sociologie,5,6,QROC,0.7804,0.1,0.41,38,31,30,1,1.23,96.77,30,8,78.04,Facile,Facile,Facile / Facile
3951,632,2019,Sociologie,5,6,QROC,0.7822,0.06,0.46,33,29,26,3,1.14,89.66,26,7,78.22,Facile,Facile,Facile / Facile
4781,632,2020,Sociologie,5,6,QROC,0.9408,0.09,0.57,40,40,38,2,1.0,95.0,38,2,94.08,Facile,Trop Facile,Facile / Trop Facile
632,633,2015,Sociologie,5,7,QCM,0.0881,0.43,0.29,92,92,8,84,1.0,8.7,8,84,8.81,Trop Difficile,Trop Difficile,Trop Difficile / Trop Difficile
1462,633,2016,Sociologie,5,7,QCM,0.7907,0.08,0.76,74,60,59,1,1.23,98.33,59,15,79.07,Facile,Facile,Facile / Facile
2292,633,2017,Sociologie,5,7,QCM,0.7988,0.06,0.79,82,80,66,14,1.02,82.5,66,16,79.88,Facile,Facile,Facile / Facile
3122,633,2018,Sociologie,5,7,QCM,0.6444,0.09,0.52,97,72,63,9,1.35,87.5,63,34,64.44,Facile,Adapte,Facile / Adapte
3952,633,2019,Sociologie,5,7,QCM,0.6409,0.07,0.52,90,62,58,4,1.45,93.55,58,32,64.09,Adapte,Adapte,Adapte / Adapte
4782,633,2020,Sociologie,5,7,QCM,0.6451,0.04,0.5,105,103,68,35,1.02,66.02,68,37,64.51,Adapte,Adapte,Adapte / Adapte
633,634,2015,Sociologie,5,8,QCU,0.5454,0.14,0.36,78,78,43,35,1.0,55.13,43,35,54.54,Difficile,Difficile,Difficile / Difficile
1463,634,2016,Sociologie,5,8,QCU,0.8728,0.06,0.95,84,79,73,6,1.06,92.41,73,11,87.28,Trop Facile,Trop Facile,Trop Facile / Trop Facile
2293,634,2017,Sociologie,5,8,QCU,0.89,0.09,0.98,77,70,69,1,1.1,98.57,69,8,89.0,Trop Facile,Trop Facile,Trop Facile / Trop Facile
3123,634,2018,Sociologie,5,8,QCU,0.9097,0.1,0.96,74,73,67,6,1.01,91.78,67,7,90.97,Trop Facile,Trop Facile,Trop Facile / Trop Facile
3953,634,2019,Sociologie,5,8,QCU,0.9839,0.05,0.9,68,68,67,1,1.0,98.53,67,1,98.39,Trop Facile,Trop Facile,Trop Facile / Trop Facile
4783,634,2020,Sociologie,5,8,QCU,0.9082,0.03,0.93,81,78,74,4,1.04,94.87,74,7,90.82,Trop Facile,Trop Facile,Trop Facile / Trop Facile
634,635,2015,Sociologie,5,9,QCU,0.5173,0.31,0.4,79,54,41,13,1.46,75.93,41,38,51.73,Difficile,Difficile,Difficile / Difficile
1464,635,2016,Sociologie,5,9,QCU,0.9056,0.05,0.92,65,62,59,3,1.05,95.16,59,6,90.56,Trop Facile,Trop Facile,Trop Facile / Trop Facile
2294,635,2017,Sociologie,5,9,QCU,0.3967,0.16,0.33,58,27,23,4,2.15,85.19,23,35,39.67,Trop Facile,Difficile,Trop Facile / Difficile
3124,635,2018,Sociologie,5,9,QCU,0.9155,0.08,0.96,54,53,49,4,1.02,92.45,49,5,91.55,Trop Facile,Trop Facile,Trop Facile / Trop Facile
3954,635,2019,Sociologie,5,9,QCU,0.766,0.18,0.8,64,54,49,5,1.19,90.74,49,15,76.6,Trop Facile,Facile,Trop Facile / Facile
4784,635,2020,Sociologie,5,9,QCU,0.9816,0.07,0.93,69,69,68,1,1.0,98.55,68,1,98.16,Trop Facile,Trop Facile,Trop Facile / Trop Facile
635,636,2015,Sociologie,5,10,QCM,0.3775,0.29,0.38,67,54,25,29,1.24,46.3,25,42,37.75,Difficile,Difficile,Difficile / Difficile
1465,636,2016,Sociologie,5,10,QCM,0.8074,0.14,0.75,59,54,48,6,1.09,88.89,48,11,80.74,Facile,Facile,Facile / Facile
2295,636,2017,Sociologie,5,10,QCM,0.8046,0.01,0.7,53,45,43,2,1.18,95.56,43,10,80.46,Facile,Facile,Facile / Facile
3125,636,2018,Sociologie,5,10,QCM,0.7864,0.0,0.76,53,51,42,9,1.04,82.35,42,11,78.64,Facile,Facile,Facile / Facile
3955,636,2019,Sociologie,5,10,QCM,0.7604,0.09,0.71,55,46,42,4,1.2,91.3,42,13,76.04,Facile,Facile,Facile / Facile
4785,636,2020,Sociologie,5,10,QCM,0.8237,0.07,0.73,44,39,36,3,1.13,92.31,36,8,82.37,Facile,Facile,Facile / Facile
636,637,2015,Sociologie,5,11,QROC,0.9001,0.02,0.97,84,82,76,6,1.02,92.68,76,8,90.01,Difficile,Trop Facile,Difficile / Trop Facile
1466,637,2016,Sociologie,5,11,QROC,0.7641,0.06,0.69,73,68,56,12,1.07,82.35,56,17,76.41,Facile,Facile,Facile / Facile
2296,637,2017,Sociologie,5,11,QROC,0.8478,0.19,0.58,71,61,60,1,1.16,98.36,60,11,84.78,Facile,Facile,Facile / Facile
3126,637,2018,Sociologie,5,11,QROC,0.6272,0.32,0.38,62,57,39,18,1.09,68.42,39,23,62.72,Facile,Adapte,Facile / Adapte
3956,637,2019,Sociologie,5,11,QROC,0.6668,0.26,0.3,73,59,49,10,1.24,83.05,49,24,66.68,Adapte,Adapte,Adapte / Adapte
4786,637,2020,Sociologie,5,11,QROC,0.6332,0.38,0.29,61,44,39,5,1.39,88.64,39,22,63.32,Adapte,Adapte,Adapte / Adapte
637,638,2015,Sociologie,5,12,QCM,0.0387,0.03,0.23,18,13,1,12,1.38,7.69,1,17,3.87,Difficile,Trop Difficile,Difficile / Trop Difficile
1467,638,2016,Sociologie,5,12,QCM,0.2112,0.68,0.24,16,15,3,12,1.07,20.0,3,13,21.12,Facile,Trop Difficile,Facile / Trop Difficile
2297,638,2017,Sociologie,5,12,QCM,0.7644,0.2,0.79,15,11,11,0,1.36,100.0,11,4,76.44,Facile,Facile,Facile / Facile
3127,638,2018,Sociologie,5,12,QCM,0.7993,0.2,0.76,17,16,14,2,1.06,87.5,14,3,79.93,Facile,Facile,Facile / Facile
3957,638,2019,Sociologie,5,12,QCM,0.7216,0.1,0.6,20,15,14,1,1.33,93.33,14,6,72.16,Facile,Adapte,Facile / Adapte
4787,638,2020,Sociologie,5,12,QCM,0.6743,0.26,0.57,21,15,14,1,1.4,93.33,14,7,67.43,Adapte,Adapte,Adapte / Adapte
638,639,2015,Sociologie,5,13,QCU,0.8,0.01,0.77,79,77,63,14,1.03,81.82,63,16,80.0,Facile,Facile,Facile / Facile
1468,639,2016,Sociologie,5,13,QCU,0.7965,0.05,0.84,95,78,76,2,1.22,97.44,76,19,79.65,Trop Facile,Facile,Trop Facile / Facile
2298,639,2017,Sociologie,5,13,QCU,0.9071,0.03,0.98,84,82,76,6,1.02,92.68,76,8,90.71,Trop Facile,Trop Facile,Trop Facile / Trop Facile
3128,639,2018,Sociologie,5,13,QCU,0.1683,0.32,0.25,85,41,14,27,2.07,34.15,14,71,16.83,Trop Facile,Trop Difficile,Trop Facile / Trop Difficile
3958,639,2019,Sociologie,5,13,QCU,0.9674,0.07,0.91,87,87,84,3,1.0,96.55,84,3,96.74,Trop Facile,Trop Facile,Trop Facile / Trop Facile
4788,639,2020,Sociologie,5,13,QCU,0.0696,0.26,0.22,100,67,7,60,1.49,10.45,7,93,6.96,Trop Facile,Trop Difficile,Trop Facile / Trop Difficile
639,640,2015,Sociologie,5,14,QCM,0.8496,0.1,0.75,54,48,46,2,1.12,95.83,46,8,84.96,Facile,Facile,Facile / Facile
1469,640,2016,Sociologie,5,14,QCM,0.7021,0.08,0.64,57,52,40,12,1.1,76.92,40,17,70.21,Facile,Adapte,Facile / Adapte
2299,640,2017,Sociologie,5,14,QCM,0.6521,0.12,0.66,59,51,38,13,1.16,74.51,38,21,65.21,Adapte,Adapte,Adapte / Adapte
3129,640,2018,Sociologie,5,14,QCM,0.6785,0.12,0.49,55,39,37,2,1.41,94.87,37,18,67.85,Adapte,Adapte,Adapte / Adapte
3959,640,2019,Sociologie,5,14,QCM,0.6303,0.12,0.61,58,39,37,2,1.49,94.87,37,21,63.03,Adapte,Adapte,Adapte / Adapte
4789,640,2020,Sociologie,5,14,QCM,0.6823,0.19,0.55,51,49,35,14,1.04,71.43,35,16,68.23,Adapte,Adapte,Adapte / Adapte
640,641,2015,Sociologie,6,1,QCU,0.8641,0.04,1.0,14,12,12,0,1.17,100.0,12,2,86.41,Trop Difficile,Trop Facile,Trop Difficile / Trop Facile
1470,641,2016,Sociologie,6,1,QCU,0.9803,0.07,0.93,14,14,14,0,1.0,100.0,14,0,98.03,Trop Facile,Trop Facile,Trop Facile / Trop Facile
2300,641,2017,Sociologie,6,1,QCU,0.9262,0.06,0.98,14,13,13,0,1.08,100.0,13,1,92.62,Trop Facile,Trop Facile,Trop Facile / Trop Facile
3130,641,2018,Sociologie,6,1,QCU,0.4351,0.21,0.38,15,8,7,1,1.88,87.5,7,8,43.51,Trop Facile,Difficile,Trop Facile / Difficile
3960,641,2019,Sociologie,6,1,QCU,0.8942,0.09,0.92,13,13,12,1,1.0,92.31,12,1,89.42,Trop Facile,Trop Facile,Trop Facile / Trop Facile
4790,641,2020,Sociologie,6,1,QCU,0.9082,0.09,0.99,13,13,12,1,1.0,92.31,12,1,90.82,Trop Facile,Trop Facile,Trop Facile / Trop Facile
641,642,2015,Sociologie,6,2,QCU,0.8755,0.03,1.0,7,6,6,0,1.17,100.0,6,1,87.55,Trop Facile,Trop Facile,Trop Facile / Trop Facile
1471,642,2016,Sociologie,6,2,QCU,0.9926,0.02,0.97,8,8,8,0,1.0,100.0,8,0,99.26,Trop Facile,Trop Facile,Trop Facile / Trop Facile
2301,642,2017,Sociologie,6,2,QCU,0.6666,0.06,0.66,6,6,4,2,1.0,66.67,4,2,66.66,Trop Facile,Adapte,Trop Facile / Adapte
3131,642,2018,Sociologie,6,2,QCU,0.6478,0.29,0.7,6,6,4,2,1.0,66.67,4,2,64.78,Adapte,Adapte,Adapte / Adapte
3961,642,2019,Sociologie,6,2,QCU,0.6776,0.25,0.6,7,6,5,1,1.17,83.33,5,2,67.76,Adapte,Adapte,Adapte / Adapte
4791,642,2020,Sociologie,6,2,QCU,0.7422,0.11,0.6,6,4,4,0,1.5,100.0,4,2,74.22,Adapte,Adapte,Adapte / Adapte
642,643,2015,Sociologie,6,3,QCU,0.464,0.24,0.37,37,20,17,3,1.85,85.0,17,20,46.4,Facile,Difficile,Facile / Difficile
1472,643,2016,Sociologie,6,3,QCU,0.9457,0.03,0.91,36,35,34,1,1.03,97.14,34,2,94.57,Trop Facile,Trop Facile,Trop Facile / Trop Facile
2302,643,2017,Sociologie,6,3,QCU,0.9843,0.04,0.94,41,41,40,1,1.0,97.56,40,1,98.43,Trop Facile,Trop Facile,Trop Facile / Trop Facile
3132,643,2018,Sociologie,6,3,QCU,0.8746,0.09,0.9,41,37,36,1,1.11,97.3,36,5,87.46,Trop Facile,Trop Facile,Trop Facile / Trop Facile
3962,643,2019,Sociologie,6,3,QCU,0.8761,0.03,0.92,39,35,34,1,1.11,97.14,34,5,87.61,Trop Facile,Trop Facile,Trop Facile / Trop Facile
4792,643,2020,Sociologie,6,3,QCU,0.9965,0.04,0.98,36,36,36,0,1.0,100.0,36,0,99.65,Trop Facile,Trop Facile,Trop Facile / Trop Facile
643,644,2015,Sociologie,6,4,QCM,0.6569,0.13,0.64,8,5,5,0,1.6,100.0,5,3,65.69,Adapte,Adapte,Adapte / Adapte
1473,644,2016,Sociologie,6,4,QCM,0.6601,0.14,0.55,6,6,4,2,1.0,66.67,4,2,66.01,Adapte,Adapte,Adapte / Adapte
2303,644,2017,Sociologie,6,4,QCM,0.6256,0.26,0.7,7,7,4,3,1.0,57.14,4,3,62.56,Adapte,Adapte,Adapte / Adapte
3133,644,2018,Sociologie,6,4,QCM,0.6585,0.27,0.55,6,5,4,1,1.2,80.0,4,2,65.85,Adapte,Adapte,Adapte / Adapte
3963,644,2019,Sociologie,6,4,QCM,0.6446,0.03,0.62,7,6,5,1,1.17,83.33,5,2,64.46,Adapte,Adapte,Adapte / Adapte
4793,644,2020,Sociologie,6,4,QCM,0.6716,0.14,0.55,8,6,5,1,1.33,83.33,5,3,67.16,Adapte,Adapte,Adapte / Adapte
644,645,2015,Sociologie,6,5,QCU,0.863,0.03,0.96,93,84,80,4,1.11,95.24,80,13,86.3,Trop Facile,Trop Facile,Trop Facile / Trop Facile
1474,645,2016,Sociologie,6,5,QCU,0.0359,0.43,0.24,110,102,4,98,1.08,3.92,4,106,3.59,Trop Facile,Trop Difficile,Trop Facile / Trop Difficile
2304,645,2017,Sociologie,6,5,QCU,0.9082,0.06,0.94,113,112,103,9,1.01,91.96,103,10,90.82,Trop Facile,Trop Facile,Trop Facile / Trop Facile
3134,645,2018,Sociologie,6,5,QCU,0.9352,0.07,0.92,134,133,125,8,1.01,93.98,125,9,93.52,Trop Facile,Trop Facile,Trop Facile / Trop Facile
3964,645,2019,Sociologie,6,5,QCU,0.9508,0.08,0.98,117,115,111,4,1.02,96.52,111,6,95.08,Trop Facile,Trop Facile,Trop Facile / Trop Facile
4794,645,2020,Sociologie,6,5,QCU,0.1107,0.04,0.28,103,83,11,72,1.24,13.25,11,92,11.07,Trop Facile,Trop Difficile,Trop Facile / Trop Difficile
645,646,2015,Sociologie,6,6,QCU,0.3427,0.14,0.38,12,5,4,1,2.4,80.0,4,8,34.27,Difficile,Difficile,Difficile / Difficile
1475,646,2016,Sociologie,6,6,QCU,0.0105,0.59,0.23,11,9,0,9,1.22,0.0,0,11,1.05,Trop Facile,Trop Difficile,Trop Facile / Trop Difficile
2305,646,2017,Sociologie,6,6,QCU,0.7307,0.18,0.48,13,11,9,2,1.18,81.82,9,4,73.07,Trop Facile,Adapte,Trop Facile / Adapte
3135,646,2018,Sociologie,6,6,QCU,0.6526,0.03,0.65,12,12,8,4,1.0,66.67,8,4,65.26,Adapte,Adapte,Adapte / Adapte
3965,646,2019,Sociologie,6,6,QCU,0.6773,0.16,0.55,12,10,8,2,1.2,80.0,8,4,67.73,Adapte,Adapte,Adapte / Adapte
4795,646,2020,Sociologie,6,6,QCU,0.6124,0.07,0.6,14,13,9,4,1.08,69.23,9,5,61.24,Adapte,Adapte,Adapte / Adapte
646,647,2015,Sociologie,6,7,QCM,0.9145,0.06,0.84,31,31,28,3,1.0,90.32,28,3,91.45,Trop Facile,Trop Facile,Trop Facile / Trop Facile
1476,647,2016,Sociologie,6,7,QCM,0.8388,0.02,0.72,35,34,29,5,1.03,85.29,29,6,83.88,Facile,Facile,Facile / Facile
2306,647,2017,Sociologie,6,7,QCM,0.6262,0.29,0.59,29,18,18,0,1.61,100.0,18,11,62.62,Facile,Adapte,Facile / Adapte
3136,647,2018,Sociologie,6,7,QCM,0.6344,0.15,0.54,27,24,17,7,1.12,70.83,17,10,63.44,Adapte,Adapte,Adapte / Adapte
3966,647,2019,Sociologie,6,7,QCM,0.6463,0.11,0.66,26,20,17,3,1.3,85.0,17,9,64.63,Adapte,Adapte,Adapte / Adapte
4796,647,2020,Sociologie,6,7,QCM,0.7317,0.25,0.64,28,26,20,6,1.08,76.92,20,8,73.17,Adapte,Adapte,Adapte / Adapte
647,648,2015,Sociologie,6,8,QCM,0.7671,0.15,0.72,60,54,46,8,1.11,85.19,46,14,76.71,Facile,Facile,Facile / Facile
1477,648,2016,Sociologie,6,8,QCM,0.2388,0.06,0.27,62,58,15,43,1.07,25.86,15,47,23.88,Facile,Trop Difficile,Facile / Trop Difficile
2307,648,2017,Sociologie,6,8,QCM,0.2251,0.09,0.21,73,58,16,42,1.26,27.59,16,57,22.51,Facile,Trop Difficile,Facile / Trop Difficile
3137,648,2018,Sociologie,6,8,QCM,0.7871,0.16,0.73,80,73,63,10,1.1,86.3,63,17,78.71,Facile,Facile,Facile / Facile
3967,648,2019,Sociologie,6,8,QCM,0.7996,0.0,0.76,76,73,61,12,1.04,83.56,61,15,79.96,Facile,Facile,Facile / Facile
4797,648,2020,Sociologie,6,8,QCM,0.8303,0.1,0.71,62,57,51,6,1.09,89.47,51,11,83.03,Facile,Facile,Facile / Facile
648,649,2015,Sociologie,6,9,QCU,0.0319,0.12,0.29,6,3,0,3,2.0,0.0,0,6,3.19,Difficile,Trop Difficile,Difficile / Trop Difficile
1478,649,2016,Sociologie,6,9,QCU,0.8865,0.08,0.94,6,6,5,1,1.0,83.33,5,1,88.65,Trop Facile,Trop Facile,Trop Facile / Trop Facile
2308,649,2017,Sociologie,6,9,QCU,0.9055,0.06,1.0,7,7,6,1,1.0,85.71,6,1,90.55,Trop Facile,Trop Facile,Trop Facile / Trop Facile
3138,649,2018,Sociologie,6,9,QCU,0.5235,0.25,0.39,6,5,3,2,1.2,60.0,3,3,52.35,Trop Facile,Difficile,Trop Facile / Difficile
3968,649,2019,Sociologie,6,9,QCU,0.5456,0.07,0.3,6,3,3,0,2.0,100.0,3,3,54.56,Trop Facile,Difficile,Trop Facile / Difficile
4798,649,2020,Sociologie,6,9,QCU,0.9615,0.05,1.0,7,7,7,0,1.0,100.0,7,0,96.15,Trop Facile,Trop Facile,Trop Facile / Trop Facile
649,650,2015,Sociologie,7,1,QCM,0.7603,0.0,0.74,49,48,37,11,1.02,77.08,37,12,76.03,Adapte,Facile,Adapte / Facile
1479,650,2016,Sociologie,7,1,QCM,0.82,0.14,0.75,58,50,48,2,1.16,96.0,48,10,82.0,Facile,Facile,Facile / Facile
2309,650,2017,Sociologie,7,1,QCM,0.184,0.7,0.23,64,21,12,9,3.05,57.14,12,52,18.4,Facile,Trop Difficile,Facile / Trop Difficile
3139,650,2018,Sociologie,7,1,QCM,0.0981,0.4,0.3,61,47,6,41,1.3,12.77,6,55,9.81,Facile,Trop Difficile,Facile / Trop Difficile
3969,650,2019,Sociologie,7,1,QCM,0.0702,0.72,0.29,58,39,4,35,1.49,10.26,4,54,7.02,Facile,Trop Difficile,Facile / Trop Difficile
4799,650,2020,Sociologie,7,1,QCM,0.8389,0.17,0.8,58,54,49,5,1.07,90.74,49,9,83.89,Facile,Facile,Facile / Facile
650,651,2015,Sociologie,7,2,QROC,0.8021,0.1,0.71,82,79,66,13,1.04,83.54,66,16,80.21,Facile,Facile,Facile / Facile
1480,651,2016,Sociologie,7,2,QROC,0.5486,0.54,0.2,74,45,41,4,1.64,91.11,41,33,54.86,Facile,Difficile,Facile / Difficile
2310,651,2017,Sociologie,7,2,QROC,0.0361,0.98,0.09,81,58,3,55,1.4,5.17,3,78,3.61,Facile,Trop Difficile,Facile / Trop Difficile
3140,651,2018,Sociologie,7,2,QROC,0.8177,0.01,0.71,65,59,53,6,1.1,89.83,53,12,81.77,Facile,Facile,Facile / Facile
3970,651,2019,Sociologie,7,2,QROC,0.7302,0.4,0.31,63,50,46,4,1.26,92.0,46,17,73.02,Facile,Adapte,Facile / Adapte
4800,651,2020,Sociologie,7,2,QROC,0.6972,0.27,0.27,54,49,38,11,1.1,77.55,38,16,69.72,Adapte,Adapte,Adapte / Adapte
651,652,2015,Sociologie,7,3,QCM,0.663,0.11,0.64,76,70,50,20,1.09,71.43,50,26,66.3,Difficile,Adapte,Difficile / Adapte
1481,652,2016,Sociologie,7,3,QCM,0.6301,0.14,0.63,67,45,42,3,1.49,93.33,42,25,63.01,Adapte,Adapte,Adapte / Adapte
2311,652,2017,Sociologie,7,3,QCM,0.6726,0.29,0.55,61,49,41,8,1.24,83.67,41,20,67.26,Adapte,Adapte,Adapte / Adapte
3141,652,2018,Sociologie,7,3,QCM,0.668,0.08,0.67,63,48,42,6,1.31,87.5,42,21,66.8,Adapte,Adapte,Adapte / Adapte
3971,652,2019,Sociologie,7,3,QCM,0.7474,0.13,0.69,70,68,52,16,1.03,76.47,52,18,74.74,Adapte,Adapte,Adapte / Adapte
4801,652,2020,Sociologie,7,3,QCM,0.7257,0.12,0.61,59,46,43,3,1.28,93.48,43,16,72.57,Adapte,Adapte,Adapte / Adapte
652,653,2015,Sociologie,7,4,QCU,0.7609,0.18,0.86,78,68,59,9,1.15,86.76,59,19,76.09,Facile,Facile,Facile / Facile
1482,653,2016,Sociologie,7,4,QCU,0.9722,0.08,0.92,83,81,81,0,1.02,100.0,81,2,97.22,Trop Facile,Trop Facile,Trop Facile / Trop Facile
2312,653,2017,Sociologie,7,4,QCU,0.9568,0.05,0.92,99,98,95,3,1.01,96.94,95,4,95.68,Trop Facile,Trop Facile,Trop Facile / Trop Facile
3142,653,2018,Sociologie,7,4,QCU,0.6325,0.13,0.68,97,79,61,18,1.23,77.22,61,36,63.25,Trop Facile,Adapte,Trop Facile / Adapte
3972,653,2019,Sociologie,7,4,QCU,0.7204,0.22,0.65,85,81,61,20,1.05,75.31,61,24,72.04,Adapte,Adapte,Adapte / Adapte
4802,653,2020,Sociologie,7,4,QCU,0.6803,0.29,0.58,84,84,57,27,1.0,67.86,57,27,68.03,Adapte,Adapte,Adapte / Adapte
653,654,2015,Sociologie,7,5,QROC,0.5522,0.65,0.21,64,44,35,9,1.45,79.55,35,29,55.22,Facile,Difficile,Facile / Difficile
1483,654,2016,Sociologie,7,5,QROC,0.6007,0.49,0.39,51,34,31,3,1.5,91.18,31,20,60.07,Facile,Adapte,Facile / Adapte
2313,654,2017,Sociologie,7,5,QROC,0.6497,0.3,0.31,49,34,32,2,1.44,94.12,32,17,64.97,Adapte,Adapte,Adapte / Adapte
3143,654,2018,Sociologie,7,5,QROC,0.6649,0.46,0.39,45,41,30,11,1.1,73.17,30,15,66.49,Adapte,Adapte,Adapte / Adapte
3973,654,2019,Sociologie,7,5,QROC,0.636,0.3,0.38,48,37,31,6,1.3,83.78,31,17,63.6,Adapte,Adapte,Adapte / Adapte
4803,654,2020,Sociologie,7,5,QROC,0.7043,0.23,0.3,53,47,37,10,1.13,78.72,37,16,70.43,Adapte,Adapte,Adapte / Adapte
654,655,2015,Sociologie,7,6,QCM,0.7223,0.06,0.54,65,55,47,8,1.18,85.45,47,18,72.23,Adapte,Adapte,Adapte / Adapte
1484,655,2016,Sociologie,7,6,QCM,0.6319,0.29,0.47,55,42,35,7,1.31,83.33,35,20,63.19,Adapte,Adapte,Adapte / Adapte
2314,655,2017,Sociologie,7,6,QCM,0.6356,0.08,0.4,55,38,35,3,1.45,92.11,35,20,63.56,Adapte,Adapte,Adapte / Adapte
3144,655,2018,Sociologie,7,6,QCM,0.7453,0.21,0.66,66,55,49,6,1.2,89.09,49,17,74.53,Adapte,Adapte,Adapte / Adapte
3974,655,2019,Sociologie,7,6,QCM,0.745,0.11,0.56,58,51,43,8,1.14,84.31,43,15,74.5,Adapte,Adapte,Adapte / Adapte
4804,655,2020,Sociologie,7,6,QCM,0.6499,0.12,0.65,58,43,38,5,1.35,88.37,38,20,64.99,Adapte,Adapte,Adapte / Adapte
655,656,2015,Sociologie,7,7,QCU,0.6939,0.26,0.52,30,26,21,5,1.15,80.77,21,9,69.39,Trop Facile,Adapte,Trop Facile / Adapte
1485,656,2016,Sociologie,7,7,QCU,0.6057,0.09,0.56,31,21,19,2,1.48,90.48,19,12,60.57,Adapte,Adapte,Adapte / Adapte
2315,656,2017,Sociologie,7,7,QCU,0.666,0.19,0.67,26,19,17,2,1.37,89.47,17,9,66.6,Adapte,Adapte,Adapte / Adapte
3145,656,2018,Sociologie,7,7,QCU,0.6568,0.2,0.44,29,20,19,1,1.45,95.0,19,10,65.68,Adapte,Adapte,Adapte / Adapte
3975,656,2019,Sociologie,7,7,QCU,0.6488,0.27,0.5,35,33,23,10,1.06,69.7,23,12,64.88,Adapte,Adapte,Adapte / Adapte
4805,656,2020,Sociologie,7,7,QCU,0.6437,0.07,0.48,40,34,26,8,1.18,76.47,26,14,64.37,Adapte,Adapte,Adapte / Adapte
656,657,2015,Sociologie,7,8,QROC,0.3614,0.7,0.16,37,17,13,4,2.18,76.47,13,24,36.14,Difficile,Difficile,Difficile / Difficile
1486,657,2016,Sociologie,7,8,QROC,0.8154,0.06,0.58,39,38,32,6,1.03,84.21,32,7,81.54,Facile,Facile,Facile / Facile
2316,657,2017,Sociologie,7,8,QROC,0.0046,0.98,0.14,31,29,0,29,1.07,0.0,0,31,0.46,Facile,Trop Difficile,Facile / Trop Difficile
3146,657,2018,Sociologie,7,8,QROC,0.7777,0.08,0.46,35,29,27,2,1.21,93.1,27,8,77.77,Facile,Facile,Facile / Facile
3976,657,2019,Sociologie,7,8,QROC,0.7893,0.02,0.4,29,25,23,2,1.16,92.0,23,6,78.93,Facile,Facile,Facile / Facile
4806,657,2020,Sociologie,7,8,QROC,0.7977,0.09,0.63,32,30,26,4,1.07,86.67,26,6,79.77,Facile,Facile,Facile / Facile
657,658,2015,Sociologie,7,9,QCM,0.948,0.07,0.81,87,83,82,1,1.05,98.8,82,5,94.8,Difficile,Trop Facile,Difficile / Trop Facile
1487,658,2016,Sociologie,7,9,QCM,0.8731,0.03,0.98,89,80,78,2,1.11,97.5,78,11,87.31,Facile,Trop Facile,Facile / Trop Facile
2317,658,2017,Sociologie,7,9,QCM,0.8287,0.08,0.71,86,85,71,14,1.01,83.53,71,15,82.87,Facile,Facile,Facile / Facile
3147,658,2018,Sociologie,7,9,QCM,0.7681,0.16,0.75,80,69,61,8,1.16,88.41,61,19,76.81,Facile,Facile,Facile / Facile
3977,658,2019,Sociologie,7,9,QCM,0.7913,0.17,0.76,69,65,55,10,1.06,84.62,55,14,79.13,Facile,Facile,Facile / Facile
4807,658,2020,Sociologie,7,9,QCM,0.9555,0.01,0.9,81,79,77,2,1.03,97.47,77,4,95.55,Facile,Trop Facile,Facile / Trop Facile
658,659,2015,Sociologie,7,10,QCM,0.0363,0.15,0.28,32,18,1,17,1.78,5.56,1,31,3.63,Trop Difficile,Trop Difficile,Trop Difficile / Trop Difficile
1488,659,2016,Sociologie,7,10,QCM,0.5661,0.3,0.39,35,34,20,14,1.03,58.82,20,15,56.61,Facile,Difficile,Facile / Difficile
2318,659,2017,Sociologie,7,10,QCM,0.8059,0.07,0.75,37,36,30,6,1.03,83.33,30,7,80.59,Facile,Facile,Facile / Facile
3148,659,2018,Sociologie,7,10,QCM,0.817,0.02,0.78,39,35,32,3,1.11,91.43,32,7,81.7,Facile,Facile,Facile / Facile
3978,659,2019,Sociologie,7,10,QCM,0.7726,0.11,0.76,37,31,29,2,1.19,93.55,29,8,77.26,Facile,Facile,Facile / Facile
4808,659,2020,Sociologie,7,10,QCM,0.8024,0.18,0.76,41,38,33,5,1.08,86.84,33,8,80.24,Facile,Facile,Facile / Facile
659,660,2015,Sociologie,7,11,QCU,0.7843,0.14,0.79,40,36,31,5,1.11,86.11,31,9,78.43,Facile,Facile,Facile / Facile
1489,660,2016,Sociologie,7,11,QCU,0.3427,0.04,0.33,37,21,13,8,1.76,61.9,13,24,34.27,Trop Facile,Difficile,Trop Facile / Difficile
2319,660,2017,Sociologie,7,11,QCU,0.9843,0.07,0.92,36,35,35,0,1.03,100.0,35,1,98.43,Trop Facile,Trop Facile,Trop Facile / Trop Facile
3149,660,2018,Sociologie,7,11,QCU,0.6504,0.18,0.53,34,28,22,6,1.21,78.57,22,12,65.04,Trop Facile,Adapte,Trop Facile / Adapte
3979,660,2019,Sociologie,7,11,QCU,0.7054,0.16,0.41,28,22,20,2,1.27,90.91,20,8,70.54,Adapte,Adapte,Adapte / Adapte
4809,660,2020,Sociologie,7,11,QCU,0.7322,0.03,0.56,32,29,23,6,1.1,79.31,23,9,73.22,Adapte,Adapte,Adapte / Adapte
660,661,2015,Sociologie,7,12,QROC,0.4208,0.69,0.2,65,34,27,7,1.91,79.41,27,38,42.08,Difficile,Difficile,Difficile / Difficile
1490,661,2016,Sociologie,7,12,QROC,0.7601,0.06,0.48,53,49,40,9,1.08,81.63,40,13,76.01,Facile,Facile,Facile / Facile
2320,661,2017,Sociologie,7,12,QROC,0.8147,0.07,0.57,51,47,42,5,1.09,89.36,42,9,81.47,Facile,Facile,Facile / Facile
3150,661,2018,Sociologie,7,12,QROC,0.6485,0.24,0.26,48,44,31,13,1.09,70.45,31,17,64.85,Facile,Adapte,Facile / Adapte
3980,661,2019,Sociologie,7,12,QROC,0.6066,0.47,0.37,47,31,29,2,1.52,93.55,29,18,60.66,Adapte,Adapte,Adapte / Adapte
4810,661,2020,Sociologie,7,12,QROC,0.688,0.26,0.26,53,43,36,7,1.23,83.72,36,17,68.8,Adapte,Adapte,Adapte / Adapte
661,662,2015,Sociologie,7,13,QCM,0.7397,0.05,0.68,9,7,7,0,1.29,100.0,7,2,73.97,Facile,Adapte,Facile / Adapte
1491,662,2016,Sociologie,7,13,QCM,0.7305,0.24,0.52,7,6,5,1,1.17,83.33,5,2,73.05,Adapte,Adapte,Adapte / Adapte
2321,662,2017,Sociologie,7,13,QCM,0.6579,0.21,0.58,7,6,5,1,1.17,83.33,5,2,65.79,Adapte,Adapte,Adapte / Adapte
3151,662,2018,Sociologie,7,13,QCM,0.7086,0.25,0.69,6,4,4,0,1.5,100.0,4,2,70.86,Adapte,Adapte,Adapte / Adapte
3981,662,2019,Sociologie,7,13,QCM,0.6137,0.07,0.44,6,5,4,1,1.2,80.0,4,2,61.37,Adapte,Adapte,Adapte / Adapte
4811,662,2020,Sociologie,7,13,QCM,0.669,0.02,0.43,6,5,4,1,1.2,80.0,4,2,66.9,Adapte,Adapte,Adapte / Adapte
662,663,2015,Sociologie,8,1,QCM,0.3983,0.16,0.37,76,55,30,25,1.38,54.55,30,46,39.83,Difficile,Difficile,Difficile / Difficile
1492,663,2016,Sociologie,8,1,QCM,0.8313,0.13,0.79,65,54,54,0,1.2,100.0,54,11,83.13,Facile,Facile,Facile / Facile
2322,663,2017,Sociologie,8,1,QCM,0.807,0.16,0.77,77,71,62,9,1.08,87.32,62,15,80.7,Facile,Facile,Facile / Facile
3152,663,2018,Sociologie,8,1,QCM,0.7992,0.19,0.78,62,58,50,8,1.07,86.21,50,12,79.92,Facile,Facile,Facile / Facile
3982,663,2019,Sociologie,8,1,QCM,0.8359,0.11,0.8,56,54,47,7,1.04,87.04,47,9,83.59,Facile,Facile,Facile / Facile
4812,663,2020,Sociologie,8,1,QCM,0.3255,0.04,0.33,49,43,16,27,1.14,37.21,16,33,32.55,Facile,Difficile,Facile / Difficile
663,664,2015,Sociologie,8,2,QCU,0.9329,0.04,0.94,6,6,6,0,1.0,100.0,6,0,93.29,Trop Facile,Trop Facile,Trop Facile / Trop Facile
1493,664,2016,Sociologie,8,2,QCU,0.5757,0.33,0.4,7,4,4,0,1.75,100.0,4,3,57.57,Trop Facile,Difficile,Trop Facile / Difficile
2323,664,2017,Sociologie,8,2,QCU,0.0421,0.56,0.23,8,7,0,7,1.14,0.0,0,8,4.21,Trop Facile,Trop Difficile,Trop Facile / Trop Difficile
3153,664,2018,Sociologie,8,2,QCU,0.4633,0.27,0.33,7,4,3,1,1.75,75.0,3,4,46.33,Trop Facile,Difficile,Trop Facile / Difficile
3983,664,2019,Sociologie,8,2,QCU,0.8917,0.01,0.98,7,7,6,1,1.0,85.71,6,1,89.17,Trop Facile,Trop Facile,Trop Facile / Trop Facile
4813,664,2020,Sociologie,8,2,QCU,0.2123,0.56,0.27,7,5,1,4,1.4,20.0,1,6,21.23,Trop Facile,Trop Difficile,Trop Facile / Trop Difficile
664,665,2015,Sociologie,8,3,QCU,0.9038,0.01,0.93,61,60,55,5,1.02,91.67,55,6,90.38,Trop Facile,Trop Facile,Trop Facile / Trop Facile
1494,665,2016,Sociologie,8,3,QCU,0.6826,0.24,0.44,55,43,38,5,1.28,88.37,38,17,68.26,Trop Facile,Adapte,Trop Facile / Adapte
2324,665,2017,Sociologie,8,3,QCU,0.6154,0.07,0.56,66,63,41,22,1.05,65.08,41,25,61.54,Adapte,Adapte,Adapte / Adapte
3154,665,2018,Sociologie,8,3,QCU,0.6803,0.09,0.44,64,54,44,10,1.19,81.48,44,20,68.03,Adapte,Adapte,Adapte / Adapte
3984,665,2019,Sociologie,8,3,QCU,0.626,0.04,0.69,74,62,46,16,1.19,74.19,46,28,62.6,Adapte,Adapte,Adapte / Adapte
4814,665,2020,Sociologie,8,3,QCU,0.6314,0.06,0.47,63,51,40,11,1.24,78.43,40,23,63.14,Adapte,Adapte,Adapte / Adapte
665,666,2015,Sociologie,8,4,QCM,0.8374,0.13,0.78,23,21,19,2,1.1,90.48,19,4,83.74,Adapte,Facile,Adapte / Facile
1495,666,2016,Sociologie,8,4,QCM,0.5897,0.27,0.4,21,19,12,7,1.11,63.16,12,9,58.97,Facile,Difficile,Facile / Difficile
2325,666,2017,Sociologie,8,4,QCM,0.922,0.03,0.82,23,23,21,2,1.0,91.3,21,2,92.2,Facile,Trop Facile,Facile / Trop Facile
3155,666,2018,Sociologie,8,4,QCM,0.1885,0.31,0.25,21,12,4,8,1.75,33.33,4,17,18.85,Facile,Trop Difficile,Facile / Trop Difficile
3985,666,2019,Sociologie,8,4,QCM,0.8073,0.2,0.78,21,17,17,0,1.24,100.0,17,4,80.73,Facile,Facile,Facile / Facile
4815,666,2020,Sociologie,8,4,QCM,0.7952,0.09,0.77,24,20,19,1,1.2,95.0,19,5,79.52,Facile,Facile,Facile / Facile
666,667,2015,Sociologie,8,5,QCM,0.3836,0.16,0.36,44,26,17,9,1.69,65.38,17,27,38.36,Difficile,Difficile,Difficile / Difficile
1496,667,2016,Sociologie,8,5,QCM,0.3717,0.3,0.39,39,24,14,10,1.62,58.33,14,25,37.17,Facile,Difficile,Facile / Difficile
2326,667,2017,Sociologie,8,5,QCM,0.7776,0.01,0.71,42,40,33,7,1.05,82.5,33,9,77.76,Facile,Facile,Facile / Facile
3156,667,2018,Sociologie,8,5,QCM,0.7401,0.27,0.65,38,34,28,6,1.12,82.35,28,10,74.01,Facile,Adapte,Facile / Adapte
3986,667,2019,Sociologie,8,5,QCM,0.6752,0.16,0.69,34,34,23,11,1.0,67.65,23,11,67.52,Adapte,Adapte,Adapte / Adapte
4816,667,2020,Sociologie,8,5,QCM,0.6053,0.15,0.45,29,21,18,3,1.38,85.71,18,11,60.53,Adapte,Adapte,Adapte / Adapte
667,668,2015,Sociologie,8,6,QCU,0.0723,0.27,0.28,26,17,2,15,1.53,11.76,2,24,7.23,Trop Difficile,Trop Difficile,Trop Difficile / Trop Difficile
1497,668,2016,Sociologie,8,6,QCU,0.9708,0.02,0.91,28,28,27,1,1.0,96.43,27,1,97.08,Trop Facile,Trop Facile,Trop Facile / Trop Facile
2327,668,2017,Sociologie,8,6,QCU,0.9181,0.05,0.99,22,22,20,2,1.0,90.91,20,2,91.81,Trop Facile,Trop Facile,Trop Facile / Trop Facile
3157,668,2018,Sociologie,8,6,QCU,0.8624,0.03,0.98,19,17,16,1,1.12,94.12,16,3,86.24,Trop Facile,Trop Facile,Trop Facile / Trop Facile
3987,668,2019,Sociologie,8,6,QCU,0.8843,0.1,0.98,16,15,14,1,1.07,93.33,14,2,88.43,Trop Facile,Trop Facile,Trop Facile / Trop Facile
4817,668,2020,Sociologie,8,6,QCU,0.9977,0.08,0.99,14,14,14,0,1.0,100.0,14,0,99.77,Trop Facile,Trop Facile,Trop Facile / Trop Facile
668,669,2015,Sociologie,8,7,QCM,0.833,0.01,0.7,29,25,24,1,1.16,96.0,24,5,83.3,Facile,Facile,Facile / Facile
1498,669,2016,Sociologie,8,7,QCM,0.8093,0.05,0.74,28,25,23,2,1.12,92.0,23,5,80.93,Facile,Facile,Facile / Facile
2328,669,2017,Sociologie,8,7,QCM,0.7722,0.16,0.72,28,23,22,1,1.22,95.65,22,6,77.22,Facile,Facile,Facile / Facile
3158,669,2018,Sociologie,8,7,QCM,0.8161,0.13,0.8,24,24,20,4,1.0,83.33,20,4,81.61,Facile,Facile,Facile / Facile
3988,669,2019,Sociologie,8,7,QCM,0.8316,0.14,0.73,25,25,21,4,1.0,84.0,21,4,83.16,Facile,Facile,Facile / Facile
4818,669,2020,Sociologie,8,7,QCM,0.7763,0.05,0.77,28,23,22,1,1.22,95.65,22,6,77.63,Facile,Facile,Facile / Facile
669,670,2015,Sociologie,8,8,QCM,0.7927,0.09,0.7,18,15,14,1,1.2,93.33,14,4,79.27,Facile,Facile,Facile / Facile
1499,670,2016,Sociologie,8,8,QCM,0.8274,0.18,0.72,22,19,18,1,1.16,94.74,18,4,82.74,Facile,Facile,Facile / Facile
2329,670,2017,Sociologie,8,8,QCM,0.8136,0.09,0.71,25,24,20,4,1.04,83.33,20,5,81.36,Facile,Facile,Facile / Facile
3159,670,2018,Sociologie,8,8,QCM,0.0743,0.33,0.3,22,15,2,13,1.47,13.33,2,20,7.43,Facile,Trop Difficile,Facile / Trop Difficile
3989,670,2019,Sociologie,8,8,QCM,0.835,0.08,0.74,21,19,18,1,1.11,94.74,18,3,83.5,Facile,Facile,Facile / Facile
4819,670,2020,Sociologie,8,8,QCM,0.9994,0.04,0.94,23,23,23,0,1.0,100.0,23,0,99.94,Facile,Trop Facile,Facile / Trop Facile
670,671,2015,Sociologie,9,1,QCM,0.5702,0.43,0.38,6,5,3,2,1.2,60.0,3,3,57.02,Difficile,Difficile,Difficile / Difficile
1500,671,2016,Sociologie,9,1,QCM,0.8336,0.11,0.8,7,6,6,0,1.17,100.0,6,1,83.36,Facile,Facile,Facile / Facile
2330,671,2017,Sociologie,9,1,QCM,0.7694,0.1,0.77,6,6,5,1,1.0,83.33,5,1,76.94,Facile,Facile,Facile / Facile
3160,671,2018,Sociologie,9,1,QCM,0.8472,0.03,0.72,5,5,4,1,1.0,80.0,4,1,84.72,Facile,Facile,Facile / Facile
3990,671,2019,Sociologie,9,1,QCM,0.8452,0.13,0.78,6,6,5,1,1.0,83.33,5,1,84.52,Facile,Facile,Facile / Facile
4820,671,2020,Sociologie,9,1,QCM,0.8363,0.04,0.71,5,4,4,0,1.25,100.0,4,1,83.63,Facile,Facile,Facile / Facile
671,672,2015,Sociologie,9,2,QCM,0.0646,0.5,0.3,77,58,5,53,1.33,8.62,5,72,6.46,Trop Difficile,Trop Difficile,Trop Difficile / Trop Difficile
1501,672,2016,Sociologie,9,2,QCM,0.8494,0.08,0.75,68,62,58,4,1.1,93.55,58,10,84.94,Facile,Facile,Facile / Facile
2331,672,2017,Sociologie,9,2,QCM,0.7989,0.11,0.72,72,67,58,9,1.07,86.57,58,14,79.89,Facile,Facile,Facile / Facile
3161,672,2018,Sociologie,9,2,QCM,0.1574,0.69,0.24,81,55,13,42,1.47,23.64,13,68,15.74,Facile,Trop Difficile,Facile / Trop Difficile
3991,672,2019,Sociologie,9,2,QCM,0.7964,0.16,0.74,72,64,57,7,1.12,89.06,57,15,79.64,Facile,Facile,Facile / Facile
4821,672,2020,Sociologie,9,2,QCM,0.7698,0.19,0.72,66,51,51,0,1.29,100.0,51,15,76.98,Facile,Facile,Facile / Facile
672,673,2015,Sociologie,9,3,QCU,0.4783,0.19,0.34,64,52,31,21,1.23,59.62,31,33,47.83,Difficile,Difficile,Difficile / Difficile
1502,673,2016,Sociologie,9,3,QCU,0.9397,0.07,0.96,74,71,70,1,1.04,98.59,70,4,93.97,Trop Facile,Trop Facile,Trop Facile / Trop Facile
2332,673,2017,Sociologie,9,3,QCU,0.9984,0.06,0.96,79,79,79,0,1.0,100.0,79,0,99.84,Trop Facile,Trop Facile,Trop Facile / Trop Facile
3162,673,2018,Sociologie,9,3,QCU,0.8438,0.12,0.86,85,76,72,4,1.12,94.74,72,13,84.38,Trop Facile,Facile,Trop Facile / Facile
3992,673,2019,Sociologie,9,3,QCU,0.8766,0.07,0.91,90,89,79,10,1.01,88.76,79,11,87.66,Trop Facile,Trop Facile,Trop Facile / Trop Facile
4822,673,2020,Sociologie,9,3,QCU,0.8912,0.09,0.99,82,82,73,9,1.0,89.02,73,9,89.12,Trop Facile,Trop Facile,Trop Facile / Trop Facile
673,674,2015,Sociologie,9,4,QCU,0.0929,0.4,0.26,43,36,4,32,1.19,11.11,4,39,9.29,Adapte,Trop Difficile,Adapte / Trop Difficile
1503,674,2016,Sociologie,9,4,QCU,0.9549,0.01,0.92,45,44,43,1,1.02,97.73,43,2,95.49,Trop Facile,Trop Facile,Trop Facile / Trop Facile
2333,674,2017,Sociologie,9,4,QCU,0.9378,0.02,0.92,36,34,34,0,1.06,100.0,34,2,93.78,Trop Facile,Trop Facile,Trop Facile / Trop Facile
3163,674,2018,Sociologie,9,4,QCU,0.9999,0.0,0.93,33,33,33,0,1.0,100.0,33,0,99.99,Trop Facile,Trop Facile,Trop Facile / Trop Facile
3993,674,2019,Sociologie,9,4,QCU,0.6781,0.3,0.57,37,33,25,8,1.12,75.76,25,12,67.81,Trop Facile,Adapte,Trop Facile / Adapte
4823,674,2020,Sociologie,9,4,QCU,0.6125,0.27,0.49,43,37,26,11,1.16,70.27,26,17,61.25,Adapte,Adapte,Adapte / Adapte
674,675,2015,Sociologie,9,5,QCU,0.1018,0.55,0.24,70,51,7,44,1.37,13.73,7,63,10.18,Trop Difficile,Trop Difficile,Trop Difficile / Trop Difficile
1504,675,2016,Sociologie,9,5,QCU,0.8952,0.01,0.96,63,63,56,7,1.0,88.89,56,7,89.52,Trop Facile,Trop Facile,Trop Facile / Trop Facile
2334,675,2017,Sociologie,9,5,QCU,0.9938,0.03,0.96,60,60,60,0,1.0,100.0,60,0,99.38,Trop Facile,Trop Facile,Trop Facile / Trop Facile
3164,675,2018,Sociologie,9,5,QCU,0.9521,0.06,0.94,51,51,49,2,1.0,96.08,49,2,95.21,Trop Facile,Trop Facile,Trop Facile / Trop Facile
3994,675,2019,Sociologie,9,5,QCU,0.9527,0.08,0.97,51,51,49,2,1.0,96.08,49,2,95.27,Trop Facile,Trop Facile,Trop Facile / Trop Facile
4824,675,2020,Sociologie,9,5,QCU,0.9939,0.09,1.0,53,53,53,0,1.0,100.0,53,0,99.39,Trop Facile,Trop Facile,Trop Facile / Trop Facile
675,676,2015,Sociologie,9,6,QCU,0.6902,0.22,0.66,12,9,8,1,1.33,88.89,8,4,69.02,Adapte,Adapte,Adapte / Adapte
1505,676,2016,Sociologie,9,6,QCU,0.71,0.03,0.46,10,9,7,2,1.11,77.78,7,3,71.0,Adapte,Adapte,Adapte / Adapte
2335,676,2017,Sociologie,9,6,QCU,0.6972,0.11,0.43,12,11,8,3,1.09,72.73,8,4,69.72,Adapte,Adapte,Adapte / Adapte
3165,676,2018,Sociologie,9,6,QCU,0.6992,0.27,0.61,10,7,7,0,1.43,100.0,7,3,69.92,Adapte,Adapte,Adapte / Adapte
3995,676,2019,Sociologie,9,6,QCU,0.6623,0.16,0.42,8,6,5,1,1.33,83.33,5,3,66.23,Adapte,Adapte,Adapte / Adapte
4825,676,2020,Sociologie,9,6,QCU,0.6446,0.16,0.52,9,8,6,2,1.12,75.0,6,3,64.46,Adapte,Adapte,Adapte / Adapte
676,677,2015,Sociologie,9,7,QROC,0.5572,0.51,0.23,98,70,55,15,1.4,78.57,55,43,55.72,Difficile,Difficile,Difficile / Difficile
1506,677,2016,Sociologie,9,7,QROC,0.8492,0.12,0.5,78,71,66,5,1.1,92.96,66,12,84.92,Facile,Facile,Facile / Facile
2336,677,2017,Sociologie,9,7,QROC,0.8036,0.09,0.64,70,63,56,7,1.11,88.89,56,14,80.36,Facile,Facile,Facile / Facile
3166,677,2018,Sociologie,9,7,QROC,0.7198,0.36,0.27,63,60,45,15,1.05,75.0,45,18,71.98,Facile,Adapte,Facile / Adapte
3996,677,2019,Sociologie,9,7,QROC,0.7128,0.26,0.37,74,59,53,6,1.25,89.83,53,21,71.28,Adapte,Adapte,Adapte / Adapte
4826,677,2020,Sociologie,9,7,QROC,0.6501,0.45,0.36,61,48,40,8,1.27,83.33,40,21,65.01,Adapte,Adapte,Adapte / Adapte
677,678,2015,Sociologie,9,8,QROC,0.1597,0.8,0.0,6,5,1,4,1.2,20.0,1,5,15.97,Trop Difficile,Trop Difficile,Trop Difficile / Trop Difficile
1507,678,2016,Sociologie,9,8,QROC,0.1235,0.92,0.13,5,2,1,1,2.5,50.0,1,4,12.35,Facile,Trop Difficile,Facile / Trop Difficile
2337,678,2017,Sociologie,9,8,QROC,0.4579,0.59,0.22,6,5,3,2,1.2,60.0,3,3,45.79,Facile,Difficile,Facile / Difficile
3167,678,2018,Sociologie,9,8,QROC,0.3492,0.53,0.21,6,5,2,3,1.2,40.0,2,4,34.92,Facile,Difficile,Facile / Difficile
3997,678,2019,Sociologie,9,8,QROC,0.8048,0.15,0.49,7,6,6,0,1.17,100.0,6,1,80.48,Facile,Facile,Facile / Facile
4827,678,2020,Sociologie,9,8,QROC,0.8036,0.13,0.66,6,6,5,1,1.0,83.33,5,1,80.36,Facile,Facile,Facile / Facile
678,679,2015,Sociologie,9,9,QCM,0.3695,0.39,0.32,50,39,18,21,1.28,46.15,18,32,36.95,Difficile,Difficile,Difficile / Difficile
1508,679,2016,Sociologie,9,9,QCM,0.7897,0.18,0.73,56,53,44,9,1.06,83.02,44,12,78.97,Facile,Facile,Facile / Facile
2338,679,2017,Sociologie,9,9,QCM,0.8056,0.15,0.8,64,64,52,12,1.0,81.25,52,12,80.56,Facile,Facile,Facile / Facile
3168,679,2018,Sociologie,9,9,QCM,0.8884,0.01,0.99,71,71,63,8,1.0,88.73,63,8,88.84,Facile,Trop Facile,Facile / Trop Facile
3998,679,2019,Sociologie,9,9,QCM,0.7784,0.18,0.79,78,75,61,14,1.04,81.33,61,17,77.84,Facile,Facile,Facile / Facile
4828,679,2020,Sociologie,9,9,QCM,0.8468,0.03,0.71,82,82,69,13,1.0,84.15,69,13,84.68,Facile,Facile,Facile / Facile
679,680,2015,Sociologie,10,1,QROC,0.6475,0.34,0.33,15,14,10,4,1.07,71.43,10,5,64.75,Facile,Adapte,Facile / Adapte
1509,680,2016,Sociologie,10,1,QROC,0.6427,0.23,0.38,12,9,8,1,1.33,88.89,8,4,64.27,Adapte,Adapte,Adapte / Adapte
2339,680,2017,Sociologie,10,1,QROC,0.6089,0.41,0.28,13,9,8,1,1.44,88.89,8,5,60.89,Adapte,Adapte,Adapte / Adapte
3169,680,2018,Sociologie,10,1,QROC,0.6411,0.49,0.26,13,10,8,2,1.3,80.0,8,5,64.11,Adapte,Adapte,Adapte / Adapte
3999,680,2019,Sociologie,10,1,QROC,0.6283,0.32,0.36,13,11,8,3,1.18,72.73,8,5,62.83,Adapte,Adapte,Adapte / Adapte
4829,680,2020,Sociologie,10,1,QROC,0.7208,0.45,0.34,14,10,10,0,1.4,100.0,10,4,72.08,Adapte,Adapte,Adapte / Adapte
680,681,2015,Sociologie,10,2,QCU,0.7992,0.14,0.82,67,55,54,1,1.22,98.18,54,13,79.92,Facile,Facile,Facile / Facile
1510,681,2016,Sociologie,10,2,QCU,0.7404,0.16,0.47,74,60,55,5,1.23,91.67,55,19,74.04,Trop Facile,Adapte,Trop Facile / Adapte
2340,681,2017,Sociologie,10,2,QCU,0.618,0.08,0.52,87,61,54,7,1.43,88.52,54,33,61.8,Adapte,Adapte,Adapte / Adapte
3170,681,2018,Sociologie,10,2,QCU,0.6624,0.18,0.47,89,68,59,9,1.31,86.76,59,30,66.24,Adapte,Adapte,Adapte / Adapte
4000,681,2019,Sociologie,10,2,QCU,0.6312,0.09,0.69,85,58,54,4,1.47,93.1,54,31,63.12,Adapte,Adapte,Adapte / Adapte
4830,681,2020,Sociologie,10,2,QCU,0.7173,0.27,0.62,88,67,63,4,1.31,94.03,63,25,71.73,Adapte,Adapte,Adapte / Adapte
681,682,2015,Sociologie,11,1,QCM,0.8497,0.09,0.77,12,11,10,1,1.09,90.91,10,2,84.97,Facile,Facile,Facile / Facile
1511,682,2016,Sociologie,11,1,QCM,0.6335,0.14,0.41,12,12,8,4,1.0,66.67,8,4,63.35,Facile,Adapte,Facile / Adapte
2341,682,2017,Sociologie,11,1,QCM,0.7357,0.21,0.5,12,10,9,1,1.2,90.0,9,3,73.57,Adapte,Adapte,Adapte / Adapte
3171,682,2018,Sociologie,11,1,QCM,0.6308,0.01,0.63,12,10,8,2,1.2,80.0,8,4,63.08,Adapte,Adapte,Adapte / Adapte
4001,682,2019,Sociologie,11,1,QCM,0.6501,0.2,0.64,11,10,7,3,1.1,70.0,7,4,65.01,Adapte,Adapte,Adapte / Adapte
4831,682,2020,Sociologie,11,1,QCM,0.6234,0.17,0.47,13,9,8,1,1.44,88.89,8,5,62.34,Adapte,Adapte,Adapte / Adapte
682,683,2015,Sociologie,11,2,QCM,0.5747,0.21,0.33,44,36,25,11,1.22,69.44,25,19,57.47,Difficile,Difficile,Difficile / Difficile
1512,683,2016,Sociologie,11,2,QCM,0.6824,0.13,0.61,38,38,26,12,1.0,68.42,26,12,68.24,Facile,Adapte,Facile / Adapte
2342,683,2017,Sociologie,11,2,QCM,0.7265,0.14,0.41,33,27,24,3,1.22,88.89,24,9,72.65,Adapte,Adapte,Adapte / Adapte
3172,683,2018,Sociologie,11,2,QCM,0.6107,0.04,0.59,27,25,16,9,1.08,64.0,16,11,61.07,Adapte,Adapte,Adapte / Adapte
4002,683,2019,Sociologie,11,2,QCM,0.7223,0.08,0.61,28,26,20,6,1.08,76.92,20,8,72.23,Adapte,Adapte,Adapte / Adapte
4832,683,2020,Sociologie,11,2,QCM,0.6762,0.11,0.53,24,23,16,7,1.04,69.57,16,8,67.62,Adapte,Adapte,Adapte / Adapte
683,684,2015,Sociologie,11,3,QCU,0.8032,0.17,0.8,29,24,23,1,1.21,95.83,23,6,80.32,Trop Facile,Facile,Trop Facile / Facile
1513,684,2016,Sociologie,11,3,QCU,0.9374,0.02,0.9,23,22,22,0,1.05,100.0,22,1,93.74,Trop Facile,Trop Facile,Trop Facile / Trop Facile
2343,684,2017,Sociologie,11,3,QCU,0.8092,0.15,0.76,23,20,19,1,1.15,95.0,19,4,80.92,Trop Facile,Facile,Trop Facile / Facile
3173,684,2018,Sociologie,11,3,QCU,0.9146,0.07,0.98,25,25,23,2,1.0,92.0,23,2,91.46,Trop Facile,Trop Facile,Trop Facile / Trop Facile
4003,684,2019,Sociologie,11,3,QCU,0.9331,0.0,0.99,22,21,21,0,1.05,100.0,21,1,93.31,Trop Facile,Trop Facile,Trop Facile / Trop Facile
4833,684,2020,Sociologie,11,3,QCU,0.936,0.09,1.0,18,17,17,0,1.06,100.0,17,1,93.6,Trop Facile,Trop Facile,Trop Facile / Trop Facile
684,685,2015,Sociologie,11,4,QCU,0.2524,0.02,0.37,6,2,2,0,3.0,100.0,2,4,25.24,Difficile,Difficile,Difficile / Difficile
1514,685,2016,Sociologie,11,4,QCU,0.9446,0.01,0.97,6,6,6,0,1.0,100.0,6,0,94.46,Trop Facile,Trop Facile,Trop Facile / Trop Facile
2344,685,2017,Sociologie,11,4,QCU,0.9652,0.06,0.99,6,6,6,0,1.0,100.0,6,0,96.52,Trop Facile,Trop Facile,Trop Facile / Trop Facile
3174,685,2018,Sociologie,11,4,QCU,0.9781,0.01,0.92,6,6,6,0,1.0,100.0,6,0,97.81,Trop Facile,Trop Facile,Trop Facile / Trop Facile
4004,685,2019,Sociologie,11,4,QCU,0.9019,0.08,0.9,7,6,6,0,1.17,100.0,6,1,90.19,Trop Facile,Trop Facile,Trop Facile / Trop Facile
4834,685,2020,Sociologie,11,4,QCU,0.9665,0.04,0.97,6,6,6,0,1.0,100.0,6,0,96.65,Trop Facile,Trop Facile,Trop Facile / Trop Facile
685,686,2015,Sociologie,11,5,QROC,0.9797,0.07,0.84,15,15,15,0,1.0,100.0,15,0,97.97,Trop Facile,Trop Facile,Trop Facile / Trop Facile
1515,686,2016,Sociologie,11,5,QROC,0.1374,0.95,0.02,12,6,2,4,2.0,33.33,2,10,13.74,Facile,Trop Difficile,Facile / Trop Difficile
2345,686,2017,Sociologie,11,5,QROC,0.974,0.04,0.59,12,12,12,0,1.0,100.0,12,0,97.4,Facile,Trop Facile,Facile / Trop Facile
3175,686,2018,Sociologie,11,5,QROC,0.78,0.13,0.71,12,10,9,1,1.2,90.0,9,3,78.0,Facile,Facile,Facile / Facile
4005,686,2019,Sociologie,11,5,QROC,0.2376,0.79,0.08,12,12,3,9,1.0,25.0,3,9,23.76,Facile,Trop Difficile,Facile / Trop Difficile
4835,686,2020,Sociologie,11,5,QROC,0.7871,0.07,0.5,12,10,9,1,1.2,90.0,9,3,78.71,Facile,Facile,Facile / Facile
686,687,2015,Sociologie,11,6,QCM,0.6559,0.24,0.48,78,54,51,3,1.44,94.44,51,27,65.59,Adapte,Adapte,Adapte / Adapte
1516,687,2016,Sociologie,11,6,QCM,0.6593,0.26,0.63,77,64,51,13,1.2,79.69,51,26,65.93,Adapte,Adapte,Adapte / Adapte
2346,687,2017,Sociologie,11,6,QCM,0.6628,0.09,0.43,70,51,46,5,1.37,90.2,46,24,66.28,Adapte,Adapte,Adapte / Adapte
3176,687,2018,Sociologie,11,6,QCM,0.6581,0.08,0.48,73,55,48,7,1.33,87.27,48,25,65.81,Adapte,Adapte,Adapte / Adapte
4006,687,2019,Sociologie,11,6,QCM,0.7157,0.26,0.56,87,73,62,11,1.19,84.93,62,25,71.57,Adapte,Adapte,Adapte / Adapte
4836,687,2020,Sociologie,11,6,QCM,0.6382,0.25,0.43,73,55,47,8,1.33,85.45,47,26,63.82,Adapte,Adapte,Adapte / Adapte
687,688,2015,Sociologie,11,7,QCM,0.8341,0.15,0.8,32,30,27,3,1.07,90.0,27,5,83.41,Facile,Facile,Facile / Facile
1517,688,2016,Sociologie,11,7,QCM,0.4888,0.08,0.36,29,29,14,15,1.0,48.28,14,15,48.88,Facile,Difficile,Facile / Difficile
2347,688,2017,Sociologie,11,7,QCM,0.8078,0.1,0.77,32,27,26,1,1.19,96.3,26,6,80.78,Facile,Facile,Facile / Facile
3177,688,2018,Sociologie,11,7,QCM,0.7929,0.08,0.71,31,28,25,3,1.11,89.29,25,6,79.29,Facile,Facile,Facile / Facile
4007,688,2019,Sociologie,11,7,QCM,0.7428,0.09,0.69,27,25,20,5,1.08,80.0,20,7,74.28,Facile,Adapte,Facile / Adapte
4837,688,2020,Sociologie,11,7,QCM,0.6714,0.24,0.7,25,24,17,7,1.04,70.83,17,8,67.14,Adapte,Adapte,Adapte / Adapte
688,689,2015,Sociologie,11,8,QCM,0.8378,0.13,0.74,65,63,54,9,1.03,85.71,54,11,83.78,Trop Difficile,Facile,Trop Difficile / Facile
1518,689,2016,Sociologie,11,8,QCM,0.7841,0.01,0.71,75,60,59,1,1.25,98.33,59,16,78.41,Facile,Facile,Facile / Facile
2348,689,2017,Sociologie,11,8,QCM,0.779,0.04,0.72,61,52,48,4,1.17,92.31,48,13,77.9,Facile,Facile,Facile / Facile
3178,689,2018,Sociologie,11,8,QCM,0.6511,0.25,0.56,51,46,33,13,1.11,71.74,33,18,65.11,Facile,Adapte,Facile / Adapte
4008,689,2019,Sociologie,11,8,QCM,0.641,0.22,0.47,50,43,32,11,1.16,74.42,32,18,64.1,Adapte,Adapte,Adapte / Adapte
4838,689,2020,Sociologie,11,8,QCM,0.6573,0.16,0.44,55,45,36,9,1.22,80.0,36,19,65.73,Adapte,Adapte,Adapte / Adapte
689,690,2015,Sociologie,11,9,QCU,0.7388,0.14,0.44,25,25,18,7,1.0,72.0,18,7,73.88,Facile,Adapte,Facile / Adapte
1519,690,2016,Sociologie,11,9,QCU,0.6188,0.26,0.7,25,23,15,8,1.09,65.22,15,10,61.88,Adapte,Adapte,Adapte / Adapte
2349,690,2017,Sociologie,11,9,QCU,0.6488,0.14,0.56,21,17,14,3,1.24,82.35,14,7,64.88,Adapte,Adapte,Adapte / Adapte
3179,690,2018,Sociologie,11,9,QCU,0.7443,0.27,0.61,22,17,16,1,1.29,94.12,16,6,74.43,Adapte,Adapte,Adapte / Adapte
4009,690,2019,Sociologie,11,9,QCU,0.7059,0.17,0.52,24,18,17,1,1.33,94.44,17,7,70.59,Adapte,Adapte,Adapte / Adapte
4839,690,2020,Sociologie,11,9,QCU,0.6404,0.14,0.61,19,13,12,1,1.46,92.31,12,7,64.04,Adapte,Adapte,Adapte / Adapte
690,691,2015,Sociologie,11,10,QCU,0.7695,0.14,0.89,100,82,77,5,1.22,93.9,77,23,76.95,Facile,Facile,Facile / Facile
1520,691,2016,Sociologie,11,10,QCU,0.9621,0.04,0.93,120,115,115,0,1.04,100.0,115,5,96.21,Trop Facile,Trop Facile,Trop Facile / Trop Facile
2350,691,2017,Sociologie,11,10,QCU,0.4349,0.04,0.37,105,65,46,19,1.62,70.77,46,59,43.49,Trop Facile,Difficile,Trop Facile / Difficile
3180,691,2018,Sociologie,11,10,QCU,0.9248,0.05,0.94,125,121,116,5,1.03,95.87,116,9,92.48,Trop Facile,Trop Facile,Trop Facile / Trop Facile
4010,691,2019,Sociologie,11,10,QCU,0.9824,0.08,0.91,146,145,143,2,1.01,98.62,143,3,98.24,Trop Facile,Trop Facile,Trop Facile / Trop Facile
4840,691,2020,Sociologie,11,10,QCU,0.9531,0.08,0.9,118,112,112,0,1.05,100.0,112,6,95.31,Trop Facile,Trop Facile,Trop Facile / Trop Facile
691,692,2015,Sociologie,11,11,QO,0.8159,0.15,0.5,27,25,22,3,1.08,88.0,22,5,81.59,Facile,Facile,Facile / Facile
1521,692,2016,Sociologie,11,11,QO,0.4107,0.76,0.11,28,28,11,17,1.0,39.29,11,17,41.07,Adapte,Difficile,Adapte / Difficile
2351,692,2017,Sociologie,11,11,QO,0.6543,0.53,0.18,32,24,21,3,1.33,87.5,21,11,65.43,Adapte,Adapte,Adapte / Adapte
3181,692,2018,Sociologie,11,11,QO,0.6157,0.65,0.2,33,22,20,2,1.5,90.91,20,13,61.57,Adapte,Adapte,Adapte / Adapte
4011,692,2019,Sociologie,11,11,QO,0.6308,0.56,0.27,29,24,18,6,1.21,75.0,18,11,63.08,Adapte,Adapte,Adapte / Adapte
4841,692,2020,Sociologie,11,11,QO,0.6275,0.41,0.22,31,30,19,11,1.03,63.33,19,12,62.75,Adapte,Adapte,Adapte / Adapte
692,693,2015,Sociologie,11,12,QROC,0.768,0.01,0.73,74,70,57,13,1.06,81.43,57,17,76.8,Facile,Facile,Facile / Facile
1522,693,2016,Sociologie,11,12,QROC,0.7768,0.14,0.49,85,71,66,5,1.2,92.96,66,19,77.68,Facile,Facile,Facile / Facile
2352,693,2017,Sociologie,11,12,QROC,0.7833,0.02,0.74,71,61,56,5,1.16,91.8,56,15,78.33,Facile,Facile,Facile / Facile
3182,693,2018,Sociologie,11,12,QROC,0.0699,0.82,0.08,85,72,6,66,1.18,8.33,6,79,6.99,Facile,Trop Difficile,Facile / Trop Difficile
4012,693,2019,Sociologie,11,12,QROC,0.7825,0.01,0.59,75,63,59,4,1.19,93.65,59,16,78.25,Facile,Facile,Facile / Facile
4842,693,2020,Sociologie,11,12,QROC,0.9174,0.05,0.55,76,76,70,6,1.0,92.11,70,6,91.74,Facile,Trop Facile,Facile / Trop Facile
693,694,2015,Sociologie,11,13,QCU,0.2621,0.23,0.35,79,28,21,7,2.82,75.0,21,58,26.21,Difficile,Difficile,Difficile / Difficile
1523,694,2016,Sociologie,11,13,QCU,0.8992,0.04,0.94,92,87,83,4,1.06,95.4,83,9,89.92,Trop Facile,Trop Facile,Trop Facile / Trop Facile
2353,694,2017,Sociologie,11,13,QCU,0.8602,0.1,0.95,74,69,64,5,1.07,92.75,64,10,86.02,Trop Facile,Trop Facile,Trop Facile / Trop Facile
3183,694,2018,Sociologie,11,13,QCU,0.9545,0.08,0.99,72,70,69,1,1.03,98.57,69,3,95.45,Trop Facile,Trop Facile,Trop Facile / Trop Facile
4013,694,2019,Sociologie,11,13,QCU,0.0869,0.25,0.24,71,47,6,41,1.51,12.77,6,65,8.69,Trop Facile,Trop Difficile,Trop Facile / Trop Difficile
4843,694,2020,Sociologie,11,13,QCU,0.9263,0.0,0.98,70,70,65,5,1.0,92.86,65,5,92.63,Trop Facile,Trop Facile,Trop Facile / Trop Facile
694,695,2015,Sociologie,12,1,QCM,0.6019,0.24,0.68,19,18,11,7,1.06,61.11,11,8,60.19,Adapte,Adapte,Adapte / Adapte
1524,695,2016,Sociologie,12,1,QCM,0.6598,0.04,0.68,23,16,15,1,1.44,93.75,15,8,65.98,Adapte,Adapte,Adapte / Adapte
2354,695,2017,Sociologie,12,1,QCM,0.7499,0.27,0.47,25,23,19,4,1.09,82.61,19,6,74.99,Adapte,Adapte,Adapte / Adapte
3184,695,2018,Sociologie,12,1,QCM,0.7367,0.21,0.7,26,20,19,1,1.3,95.0,19,7,73.67,Adapte,Adapte,Adapte / Adapte
4014,695,2019,Sociologie,12,1,QCM,0.6076,0.02,0.53,24,17,15,2,1.41,88.24,15,9,60.76,Adapte,Adapte,Adapte / Adapte
4844,695,2020,Sociologie,12,1,QCM,0.6237,0.1,0.66,20,13,12,1,1.54,92.31,12,8,62.37,Adapte,Adapte,Adapte / Adapte
695,696,2015,Sociologie,12,2,QCU,0.9678,0.06,0.99,64,64,62,2,1.0,96.88,62,2,96.78,Trop Facile,Trop Facile,Trop Facile / Trop Facile
1525,696,2016,Sociologie,12,2,QCU,0.9431,0.06,0.99,64,63,60,3,1.02,95.24,60,4,94.31,Trop Facile,Trop Facile,Trop Facile / Trop Facile
2355,696,2017,Sociologie,12,2,QCU,0.2005,0.71,0.22,58,56,12,44,1.04,21.43,12,46,20.05,Trop Facile,Trop Difficile,Trop Facile / Trop Difficile
3185,696,2018,Sociologie,12,2,QCU,0.5158,0.29,0.36,50,28,26,2,1.79,92.86,26,24,51.58,Trop Facile,Difficile,Trop Facile / Difficile
4015,696,2019,Sociologie,12,2,QCU,0.9458,0.05,0.97,49,46,46,0,1.07,100.0,46,3,94.58,Trop Facile,Trop Facile,Trop Facile / Trop Facile
4845,696,2020,Sociologie,12,2,QCU,0.9826,0.01,0.97,41,40,40,0,1.02,100.0,40,1,98.26,Trop Facile,Trop Facile,Trop Facile / Trop Facile
696,697,2015,Sociologie,12,3,QCM,0.2109,0.17,0.24,41,38,9,29,1.08,23.68,9,32,21.09,Difficile,Trop Difficile,Difficile / Trop Difficile
1526,697,2016,Sociologie,12,3,QCM,0.1757,0.29,0.22,42,26,7,19,1.62,26.92,7,35,17.57,Facile,Trop Difficile,Facile / Trop Difficile
2356,697,2017,Sociologie,12,3,QCM,0.8077,0.05,0.76,41,33,33,0,1.24,100.0,33,8,80.77,Facile,Facile,Facile / Facile
3186,697,2018,Sociologie,12,3,QCM,0.8331,0.02,0.76,37,32,31,1,1.16,96.88,31,6,83.31,Facile,Facile,Facile / Facile
4016,697,2019,Sociologie,12,3,QCM,0.6052,0.12,0.53,30,21,18,3,1.43,85.71,18,12,60.52,Facile,Adapte,Facile / Adapte
4846,697,2020,Sociologie,12,3,QCM,0.7023,0.01,0.58,31,22,22,0,1.41,100.0,22,9,70.23,Adapte,Adapte,Adapte / Adapte
697,698,2015,Sociologie,12,4,QROC,0.8101,0.02,0.72,100,98,81,17,1.02,82.65,81,19,81.01,Difficile,Facile,Difficile / Facile
1527,698,2016,Sociologie,12,4,QROC,0.7901,0.14,0.43,111,108,88,20,1.03,81.48,88,23,79.01,Facile,Facile,Facile / Facile
2357,698,2017,Sociologie,12,4,QROC,0.8943,0.0,0.61,109,109,97,12,1.0,88.99,97,12,89.43,Facile,Trop Facile,Facile / Trop Facile
3187,698,2018,Sociologie,12,4,QROC,0.8385,0.12,0.59,115,99,96,3,1.16,96.97,96,19,83.85,Facile,Facile,Facile / Facile
4017,698,2019,Sociologie,12,4,QROC,0.7789,0.17,0.74,124,106,97,9,1.17,91.51,97,27,77.89,Facile,Facile,Facile / Facile
4847,698,2020,Sociologie,12,4,QROC,0.784,0.01,0.64,127,119,100,19,1.07,84.03,100,27,78.4,Facile,Facile,Facile / Facile
698,699,2015,Sociologie,12,5,QCU,0.3466,0.06,0.38,27,22,9,13,1.23,40.91,9,18,34.66,Difficile,Difficile,Difficile / Difficile
1528,699,2016,Sociologie,12,5,QCU,0.8666,0.08,0.99,23,20,20,0,1.15,100.0,20,3,86.66,Trop Facile,Trop Facile,Trop Facile / Trop Facile
2358,699,2017,Sociologie,12,5,QCU,0.6842,0.11,0.47,28,24,19,5,1.17,79.17,19,9,68.42,Trop Facile,Adapte,Trop Facile / Adapte
3188,699,2018,Sociologie,12,5,QCU,0.6157,0.11,0.57,22,22,14,8,1.0,63.64,14,8,61.57,Adapte,Adapte,Adapte / Adapte
4018,699,2019,Sociologie,12,5,QCU,0.6723,0.05,0.59,23,20,15,5,1.15,75.0,15,8,67.23,Adapte,Adapte,Adapte / Adapte
4848,699,2020,Sociologie,12,5,QCU,0.6037,0.29,0.67,24,20,14,6,1.2,70.0,14,10,60.37,Adapte,Adapte,Adapte / Adapte
699,700,2015,Sociologie,13,1,QROC,0.4574,0.51,0.2,41,37,19,18,1.11,51.35,19,22,45.74,Difficile,Difficile,Difficile / Difficile
1529,700,2016,Sociologie,13,1,QROC,0.7904,0.14,0.52,41,34,32,2,1.21,94.12,32,9,79.04,Facile,Facile,Facile / Facile
2359,700,2017,Sociologie,13,1,QROC,0.7831,0.12,0.64,47,45,37,8,1.04,82.22,37,10,78.31,Facile,Facile,Facile / Facile
3189,700,2018,Sociologie,13,1,QROC,0.7948,0.1,0.65,40,38,32,6,1.05,84.21,32,8,79.48,Facile,Facile,Facile / Facile
4019,700,2019,Sociologie,13,1,QROC,0.957,0.05,0.99,37,37,35,2,1.0,94.59,35,2,95.7,Facile,Trop Facile,Facile / Trop Facile
4849,700,2020,Sociologie,13,1,QROC,0.7926,0.01,0.63,30,27,24,3,1.11,88.89,24,6,79.26,Facile,Facile,Facile / Facile
700,701,2015,Sociologie,13,2,QCM,0.5148,0.18,0.37,77,65,40,25,1.18,61.54,40,37,51.48,Difficile,Difficile,Difficile / Difficile
1530,701,2016,Sociologie,13,2,QCM,0.7883,0.13,0.78,92,90,73,17,1.02,81.11,73,19,78.83,Facile,Facile,Facile / Facile
2360,701,2017,Sociologie,13,2,QCM,0.7683,0.17,0.73,86,72,66,6,1.19,91.67,66,20,76.83,Facile,Facile,Facile / Facile
3190,701,2018,Sociologie,13,2,QCM,0.586,0.5,0.38,89,57,52,5,1.56,91.23,52,37,58.6,Facile,Difficile,Facile / Difficile
4020,701,2019,Sociologie,13,2,QCM,0.6977,0.23,0.49,85,82,59,23,1.04,71.95,59,26,69.77,Facile,Adapte,Facile / Adapte
4850,701,2020,Sociologie,13,2,QCM,0.736,0.07,0.55,76,60,56,4,1.27,93.33,56,20,73.6,Adapte,Adapte,Adapte / Adapte
701,702,2015,Sociologie,13,3,QCU,0.8076,0.02,0.76,45,44,36,8,1.02,81.82,36,9,80.76,Trop Facile,Facile,Trop Facile / Facile
1531,702,2016,Sociologie,13,3,QCU,0.9468,0.05,0.95,37,36,35,1,1.03,97.22,35,2,94.68,Trop Facile,Trop Facile,Trop Facile / Trop Facile
2361,702,2017,Sociologie,13,3,QCU,0.9931,0.04,0.93,43,43,43,0,1.0,100.0,43,0,99.31,Trop Facile,Trop Facile,Trop Facile / Trop Facile
3191,702,2018,Sociologie,13,3,QCU,0.616,0.25,0.61,43,41,26,15,1.05,63.41,26,17,61.6,Trop Facile,Adapte,Trop Facile / Adapte
4021,702,2019,Sociologie,13,3,QCU,0.7213,0.25,0.47,44,44,32,12,1.0,72.73,32,12,72.13,Adapte,Adapte,Adapte / Adapte
4851,702,2020,Sociologie,13,3,QCU,0.6917,0.02,0.64,51,45,35,10,1.13,77.78,35,16,69.17,Adapte,Adapte,Adapte / Adapte
702,703,2015,Sociologie,13,4,QCM,0.7277,0.25,0.61,92,83,67,16,1.11,80.72,67,25,72.77,Adapte,Adapte,Adapte / Adapte
1532,703,2016,Sociologie,13,4,QCM,0.7215,0.02,0.64,96,83,69,14,1.16,83.13,69,27,72.15,Adapte,Adapte,Adapte / Adapte
2362,703,2017,Sociologie,13,4,QCM,0.7449,0.16,0.58,102,91,76,15,1.12,83.52,76,26,74.49,Adapte,Adapte,Adapte / Adapte
3192,703,2018,Sociologie,13,4,QCM,0.7456,0.03,0.42,99,80,74,6,1.24,92.5,74,25,74.56,Adapte,Adapte,Adapte / Adapte
4022,703,2019,Sociologie,13,4,QCM,0.7443,0.21,0.42,118,91,88,3,1.3,96.7,88,30,74.43,Adapte,Adapte,Adapte / Adapte
4852,703,2020,Sociologie,13,4,QCM,0.7446,0.05,0.49,96,91,71,20,1.05,78.02,71,25,74.46,Adapte,Adapte,Adapte / Adapte
703,704,2015,Sociologie,13,5,QCM,0.6582,0.07,0.57,18,13,12,1,1.38,92.31,12,6,65.82,Adapte,Adapte,Adapte / Adapte
1533,704,2016,Sociologie,13,5,QCM,0.6718,0.08,0.43,19,16,13,3,1.19,81.25,13,6,67.18,Adapte,Adapte,Adapte / Adapte
2363,704,2017,Sociologie,13,5,QCM,0.6376,0.28,0.62,15,10,10,0,1.5,100.0,10,5,63.76,Adapte,Adapte,Adapte / Adapte
3193,704,2018,Sociologie,13,5,QCM,0.642,0.26,0.42,12,11,8,3,1.09,72.73,8,4,64.2,Adapte,Adapte,Adapte / Adapte
4023,704,2019,Sociologie,13,5,QCM,0.6353,0.02,0.66,13,11,8,3,1.18,72.73,8,5,63.53,Adapte,Adapte,Adapte / Adapte
4853,704,2020,Sociologie,13,5,QCM,0.6497,0.18,0.56,16,14,10,4,1.14,71.43,10,6,64.97,Adapte,Adapte,Adapte / Adapte
704,705,2015,Sociologie,13,6,QCU,0.7496,0.15,0.56,56,52,42,10,1.08,80.77,42,14,74.96,Trop Facile,Adapte,Trop Facile / Adapte
1534,705,2016,Sociologie,13,6,QCU,0.6096,0.09,0.58,66,53,40,13,1.25,75.47,40,26,60.96,Adapte,Adapte,Adapte / Adapte
2364,705,2017,Sociologie,13,6,QCU,0.6839,0.13,0.66,74,69,51,18,1.07,73.91,51,23,68.39,Adapte,Adapte,Adapte / Adapte
3194,705,2018,Sociologie,13,6,QCU,0.6641,0.09,0.48,80,57,53,4,1.4,92.98,53,27,66.41,Adapte,Adapte,Adapte / Adapte
4024,705,2019,Sociologie,13,6,QCU,0.725,0.0,0.58,77,63,56,7,1.22,88.89,56,21,72.5,Adapte,Adapte,Adapte / Adapte
4854,705,2020,Sociologie,13,6,QCU,0.6267,0.17,0.56,64,41,40,1,1.56,97.56,40,24,62.67,Adapte,Adapte,Adapte / Adapte
705,706,2015,Sociologie,13,7,QCU,0.3443,0.34,0.39,23,22,8,14,1.05,36.36,8,15,34.43,Difficile,Difficile,Difficile / Difficile
1535,706,2016,Sociologie,13,7,QCU,0.972,0.04,0.94,22,21,21,0,1.05,100.0,21,1,97.2,Trop Facile,Trop Facile,Trop Facile / Trop Facile
2365,706,2017,Sociologie,13,7,QCU,0.9822,0.02,0.9,24,24,24,0,1.0,100.0,24,0,98.22,Trop Facile,Trop Facile,Trop Facile / Trop Facile
3195,706,2018,Sociologie,13,7,QCU,0.8639,0.08,0.99,22,20,19,1,1.1,95.0,19,3,86.39,Trop Facile,Trop Facile,Trop Facile / Trop Facile
4025,706,2019,Sociologie,13,7,QCU,0.9551,0.01,0.99,20,19,19,0,1.05,100.0,19,1,95.51,Trop Facile,Trop Facile,Trop Facile / Trop Facile
4855,706,2020,Sociologie,13,7,QCU,0.9884,0.04,0.99,16,16,16,0,1.0,100.0,16,0,98.84,Trop Facile,Trop Facile,Trop Facile / Trop Facile
706,707,2015,Sociologie,13,8,QCU,0.9301,0.04,0.93,47,44,44,0,1.07,100.0,44,3,93.01,Trop Facile,Trop Facile,Trop Facile / Trop Facile
1536,707,2016,Sociologie,13,8,QCU,0.9224,0.1,0.99,49,48,45,3,1.02,93.75,45,4,92.24,Trop Facile,Trop Facile,Trop Facile / Trop Facile
2366,707,2017,Sociologie,13,8,QCU,0.3917,0.03,0.38,52,47,20,27,1.11,42.55,20,32,39.17,Trop Facile,Difficile,Trop Facile / Difficile
3196,707,2018,Sociologie,13,8,QCU,0.4357,0.13,0.39,54,29,24,5,1.86,82.76,24,30,43.57,Trop Facile,Difficile,Trop Facile / Difficile
4026,707,2019,Sociologie,13,8,QCU,0.9802,0.02,0.98,52,52,51,1,1.0,98.08,51,1,98.02,Trop Facile,Trop Facile,Trop Facile / Trop Facile
4856,707,2020,Sociologie,13,8,QCU,0.9455,0.06,1.0,62,61,59,2,1.02,96.72,59,3,94.55,Trop Facile,Trop Facile,Trop Facile / Trop Facile
707,708,2015,Sociologie,13,9,QCU,0.7455,0.29,0.59,66,54,49,5,1.22,90.74,49,17,74.55,Difficile,Adapte,Difficile / Adapte
1537,708,2016,Sociologie,13,9,QCU,0.6487,0.13,0.65,65,61,42,19,1.07,68.85,42,23,64.87,Adapte,Adapte,Adapte / Adapte
2367,708,2017,Sociologie,13,9,QCU,0.7015,0.21,0.49,72,54,51,3,1.33,94.44,51,21,70.15,Adapte,Adapte,Adapte / Adapte
3197,708,2018,Sociologie,13,9,QCU,0.7462,0.17,0.69,74,64,55,9,1.16,85.94,55,19,74.62,Adapte,Adapte,Adapte / Adapte
4027,708,2019,Sociologie,13,9,QCU,0.7136,0.09,0.65,71,61,51,10,1.16,83.61,51,20,71.36,Adapte,Adapte,Adapte / Adapte
4857,708,2020,Sociologie,13,9,QCU,0.7027,0.21,0.49,62,47,44,3,1.32,93.62,44,18,70.27,Adapte,Adapte,Adapte / Adapte
708,709,2015,Sociologie,14,1,QCU,0.6722,0.07,0.47,83,59,56,3,1.41,94.92,56,27,67.22,Adapte,Adapte,Adapte / Adapte
1538,709,2016,Sociologie,14,1,QCU,0.6318,0.21,0.58,69,48,44,4,1.44,91.67,44,25,63.18,Adapte,Adapte,Adapte / Adapte
2368,709,2017,Sociologie,14,1,QCU,0.6646,0.08,0.54,66,61,44,17,1.08,72.13,44,22,66.46,Adapte,Adapte,Adapte / Adapte
3198,709,2018,Sociologie,14,1,QCU,0.6113,0.25,0.59,65,58,40,18,1.12,68.97,40,25,61.13,Adapte,Adapte,Adapte / Adapte
4028,709,2019,Sociologie,14,1,QCU,0.7159,0.05,0.53,65,63,47,16,1.03,74.6,47,18,71.59,Adapte,Adapte,Adapte / Adapte
4858,709,2020,Sociologie,14,1,QCU,0.7252,0.02,0.5,68,54,49,5,1.26,90.74,49,19,72.52,Adapte,Adapte,Adapte / Adapte
709,710,2015,Mathematique,1,1,QCM,0.9375,0.02,0.83,5,5,5,0,1.0,100.0,5,0,93.75,Trop Facile,Trop Facile,Trop Facile / Trop Facile
1539,710,2016,Mathematique,1,1,QCM,0.3579,0.37,0.34,5,2,2,0,2.5,100.0,2,3,35.79,Facile,Difficile,Facile / Difficile
2369,710,2017,Mathematique,1,1,QCM,0.8277,0.15,0.72,4,3,3,0,1.33,100.0,3,1,82.77,Facile,Facile,Facile / Facile
3199,710,2018,Mathematique,1,1,QCM,0.7822,0.12,0.71,4,4,3,1,1.0,75.0,3,1,78.22,Facile,Facile,Facile / Facile
4029,710,2019,Mathematique,1,1,QCM,0.8208,0.05,0.8,5,4,4,0,1.25,100.0,4,1,82.08,Facile,Facile,Facile / Facile
4859,710,2020,Mathematique,1,1,QCM,0.494,0.29,0.34,6,4,3,1,1.5,75.0,3,3,49.4,Facile,Difficile,Facile / Difficile
710,711,2015,Mathematique,1,2,QROC,0.7109,0.25,0.37,83,70,59,11,1.19,84.29,59,24,71.09,Trop Facile,Adapte,Trop Facile / Adapte
1540,711,2016,Mathematique,1,2,QROC,0.6627,0.48,0.35,68,65,45,20,1.05,69.23,45,23,66.27,Adapte,Adapte,Adapte / Adapte
2370,711,2017,Mathematique,1,2,QROC,0.6763,0.24,0.38,74,57,50,7,1.3,87.72,50,24,67.63,Adapte,Adapte,Adapte / Adapte
3200,711,2018,Mathematique,1,2,QROC,0.7108,0.5,0.27,76,63,54,9,1.21,85.71,54,22,71.08,Adapte,Adapte,Adapte / Adapte
4030,711,2019,Mathematique,1,2,QROC,0.7129,0.33,0.39,88,64,63,1,1.38,98.44,63,25,71.29,Adapte,Adapte,Adapte / Adapte
4860,711,2020,Mathematique,1,2,QROC,0.7151,0.48,0.36,94,90,67,23,1.04,74.44,67,27,71.51,Adapte,Adapte,Adapte / Adapte
711,712,2015,Mathematique,2,1,QCM,0.6478,0.3,0.68,91,74,59,15,1.23,79.73,59,32,64.78,Trop Difficile,Adapte,Trop Difficile / Adapte
1541,712,2016,Mathematique,2,1,QCM,0.6395,0.07,0.49,106,71,68,3,1.49,95.77,68,38,63.95,Adapte,Adapte,Adapte / Adapte
2371,712,2017,Mathematique,2,1,QCM,0.6357,0.29,0.66,118,97,75,22,1.22,77.32,75,43,63.57,Adapte,Adapte,Adapte / Adapte
3201,712,2018,Mathematique,2,1,QCM,0.6822,0.24,0.64,131,98,89,9,1.34,90.82,89,42,68.22,Adapte,Adapte,Adapte / Adapte
4031,712,2019,Mathematique,2,1,QCM,0.6315,0.09,0.65,144,133,91,42,1.08,68.42,91,53,63.15,Adapte,Adapte,Adapte / Adapte
4861,712,2020,Mathematique,2,1,QCM,0.7184,0.28,0.62,168,145,121,24,1.16,83.45,121,47,71.84,Adapte,Adapte,Adapte / Adapte
712,713,2015,Mathematique,2,2,QCU,0.983,0.05,1.0,76,75,75,0,1.01,100.0,75,1,98.3,Trop Facile,Trop Facile,Trop Facile / Trop Facile
1542,713,2016,Mathematique,2,2,QCU,0.7394,0.15,0.46,85,82,63,19,1.04,76.83,63,22,73.94,Trop Facile,Adapte,Trop Facile / Adapte
2372,713,2017,Mathematique,2,2,QCU,0.6929,0.25,0.61,91,64,63,1,1.42,98.44,63,28,69.29,Adapte,Adapte,Adapte / Adapte
3202,713,2018,Mathematique,2,2,QCU,0.6707,0.12,0.54,87,58,58,0,1.5,100.0,58,29,67.07,Adapte,Adapte,Adapte / Adapte
4032,713,2019,Mathematique,2,2,QCU,0.699,0.06,0.68,104,98,73,25,1.06,74.49,73,31,69.9,Adapte,Adapte,Adapte / Adapte
4862,713,2020,Mathematique,2,2,QCU,0.6292,0.18,0.6,96,89,60,29,1.08,67.42,60,36,62.92,Adapte,Adapte,Adapte / Adapte
713,714,2015,Mathematique,2,3,QO,0.7733,0.19,0.73,66,62,51,11,1.06,82.26,51,15,77.33,Difficile,Facile,Difficile / Facile
1543,714,2016,Mathematique,2,3,QO,0.6189,0.22,0.26,62,43,38,5,1.44,88.37,38,24,61.89,Adapte,Adapte,Adapte / Adapte
2373,714,2017,Mathematique,2,3,QO,0.7013,0.72,0.28,74,53,52,1,1.4,98.11,52,22,70.13,Adapte,Adapte,Adapte / Adapte
3203,714,2018,Mathematique,2,3,QO,0.6202,0.35,0.3,78,66,48,18,1.18,72.73,48,30,62.02,Adapte,Adapte,Adapte / Adapte
4033,714,2019,Mathematique,2,3,QO,0.657,0.31,0.2,93,83,61,22,1.12,73.49,61,32,65.7,Adapte,Adapte,Adapte / Adapte
4863,714,2020,Mathematique,2,3,QO,0.6745,0.45,0.18,81,58,55,3,1.4,94.83,55,26,67.45,Adapte,Adapte,Adapte / Adapte
714,715,2015,Mathematique,2,4,QCM,0.9956,0.05,0.9,42,42,42,0,1.0,100.0,42,0,99.56,Trop Facile,Trop Facile,Trop Facile / Trop Facile
1544,715,2016,Mathematique,2,4,QCM,0.4796,0.15,0.36,44,22,21,1,2.0,95.45,21,23,47.96,Facile,Difficile,Facile / Difficile
2374,715,2017,Mathematique,2,4,QCM,0.4119,0.46,0.38,48,34,20,14,1.41,58.82,20,28,41.19,Facile,Difficile,Facile / Difficile
3204,715,2018,Mathematique,2,4,QCM,0.8256,0.14,0.73,58,54,48,6,1.07,88.89,48,10,82.56,Facile,Facile,Facile / Facile
4034,715,2019,Mathematique,2,4,QCM,0.3681,0.49,0.33,51,30,19,11,1.7,63.33,19,32,36.81,Facile,Difficile,Facile / Difficile
4864,715,2020,Mathematique,2,4,QCM,0.8135,0.19,0.79,52,52,42,10,1.0,80.77,42,10,81.35,Facile,Facile,Facile / Facile
715,716,2015,Mathematique,2,5,QCU,0.842,0.15,0.9,9,8,8,0,1.12,100.0,8,1,84.2,Facile,Facile,Facile / Facile
1545,716,2016,Mathematique,2,5,QCU,0.6758,0.23,0.51,9,7,6,1,1.29,85.71,6,3,67.58,Trop Facile,Adapte,Trop Facile / Adapte
2375,716,2017,Mathematique,2,5,QCU,0.6805,0.0,0.66,10,9,7,2,1.11,77.78,7,3,68.05,Adapte,Adapte,Adapte / Adapte
3205,716,2018,Mathematique,2,5,QCU,0.7142,0.22,0.45,10,7,7,0,1.43,100.0,7,3,71.42,Adapte,Adapte,Adapte / Adapte
4035,716,2019,Mathematique,2,5,QCU,0.6532,0.01,0.67,10,7,7,0,1.43,100.0,7,3,65.32,Adapte,Adapte,Adapte / Adapte
4865,716,2020,Mathematique,2,5,QCU,0.6372,0.29,0.52,9,8,6,2,1.12,75.0,6,3,63.72,Adapte,Adapte,Adapte / Adapte
716,717,2015,Mathematique,2,6,QCM,0.1371,0.58,0.28,15,4,2,2,3.75,50.0,2,13,13.71,Trop Difficile,Trop Difficile,Trop Difficile / Trop Difficile
1546,717,2016,Mathematique,2,6,QCM,0.796,0.2,0.78,13,12,10,2,1.08,83.33,10,3,79.6,Facile,Facile,Facile / Facile
2376,717,2017,Mathematique,2,6,QCM,0.0149,0.41,0.2,15,12,0,12,1.25,0.0,0,15,1.49,Facile,Trop Difficile,Facile / Trop Difficile
3206,717,2018,Mathematique,2,6,QCM,0.8414,0.14,0.8,17,15,14,1,1.13,93.33,14,3,84.14,Facile,Facile,Facile / Facile
4036,717,2019,Mathematique,2,6,QCM,0.7667,0.0,0.79,15,12,12,0,1.25,100.0,12,3,76.67,Facile,Facile,Facile / Facile
4866,717,2020,Mathematique,2,6,QCM,0.9764,0.04,0.91,12,12,12,0,1.0,100.0,12,0,97.64,Facile,Trop Facile,Facile / Trop Facile
717,718,2015,Mathematique,2,7,QCU,0.6721,0.25,0.66,97,88,65,23,1.1,73.86,65,32,67.21,Adapte,Adapte,Adapte / Adapte
1547,718,2016,Mathematique,2,7,QCU,0.7236,0.25,0.61,109,101,79,22,1.08,78.22,79,30,72.36,Adapte,Adapte,Adapte / Adapte
2377,718,2017,Mathematique,2,7,QCU,0.6282,0.26,0.51,116,94,73,21,1.23,77.66,73,43,62.82,Adapte,Adapte,Adapte / Adapte
3207,718,2018,Mathematique,2,7,QCU,0.6346,0.06,0.46,138,103,88,15,1.34,85.44,88,50,63.46,Adapte,Adapte,Adapte / Adapte
4037,718,2019,Mathematique,2,7,QCU,0.7393,0.19,0.52,162,155,120,35,1.05,77.42,120,42,73.93,Adapte,Adapte,Adapte / Adapte
4867,718,2020,Mathematique,2,7,QCU,0.735,0.1,0.42,155,120,114,6,1.29,95.0,114,41,73.5,Adapte,Adapte,Adapte / Adapte
718,719,2015,Mathematique,2,8,QCU,0.3304,0.35,0.38,60,27,20,7,2.22,74.07,20,40,33.04,Difficile,Difficile,Difficile / Difficile
1548,719,2016,Mathematique,2,8,QCU,0.9651,0.02,0.96,57,55,55,0,1.04,100.0,55,2,96.51,Trop Facile,Trop Facile,Trop Facile / Trop Facile
2378,719,2017,Mathematique,2,8,QCU,0.8975,0.01,0.96,64,62,57,5,1.03,91.94,57,7,89.75,Trop Facile,Trop Facile,Trop Facile / Trop Facile
3208,719,2018,Mathematique,2,8,QCU,0.9842,0.02,0.95,57,56,56,0,1.02,100.0,56,1,98.42,Trop Facile,Trop Facile,Trop Facile / Trop Facile
4038,719,2019,Mathematique,2,8,QCU,0.8804,0.0,0.92,56,54,49,5,1.04,90.74,49,7,88.04,Trop Facile,Trop Facile,Trop Facile / Trop Facile
4868,719,2020,Mathematique,2,8,QCU,0.9266,0.0,0.96,59,57,55,2,1.04,96.49,55,4,92.66,Trop Facile,Trop Facile,Trop Facile / Trop Facile
719,720,2015,Mathematique,2,9,QCU,0.1668,0.3,0.24,50,39,8,31,1.28,20.51,8,42,16.68,Difficile,Trop Difficile,Difficile / Trop Difficile
1549,720,2016,Mathematique,2,9,QCU,0.6706,0.07,0.63,44,41,30,11,1.07,73.17,30,14,67.06,Trop Facile,Adapte,Trop Facile / Adapte
2379,720,2017,Mathematique,2,9,QCU,0.6823,0.17,0.62,44,32,30,2,1.38,93.75,30,14,68.23,Adapte,Adapte,Adapte / Adapte
3209,720,2018,Mathematique,2,9,QCU,0.6147,0.12,0.45,49,34,30,4,1.44,88.24,30,19,61.47,Adapte,Adapte,Adapte / Adapte
4039,720,2019,Mathematique,2,9,QCU,0.705,0.2,0.56,49,48,35,13,1.02,72.92,35,14,70.5,Adapte,Adapte,Adapte / Adapte
4869,720,2020,Mathematique,2,9,QCU,0.7124,0.12,0.68,44,36,31,5,1.22,86.11,31,13,71.24,Adapte,Adapte,Adapte / Adapte
720,721,2015,Mathematique,2,10,QCM,0.7361,0.1,0.45,27,26,20,6,1.04,76.92,20,7,73.61,Adapte,Adapte,Adapte / Adapte
1550,721,2016,Mathematique,2,10,QCM,0.6587,0.04,0.66,27,18,18,0,1.5,100.0,18,9,65.87,Adapte,Adapte,Adapte / Adapte
2380,721,2017,Mathematique,2,10,QCM,0.7297,0.05,0.64,26,20,19,1,1.3,95.0,19,7,72.97,Adapte,Adapte,Adapte / Adapte
3210,721,2018,Mathematique,2,10,QCM,0.6755,0.21,0.45,22,18,15,3,1.22,83.33,15,7,67.55,Adapte,Adapte,Adapte / Adapte
4040,721,2019,Mathematique,2,10,QCM,0.7136,0.21,0.65,23,18,16,2,1.28,88.89,16,7,71.36,Adapte,Adapte,Adapte / Adapte
4870,721,2020,Mathematique,2,10,QCM,0.617,0.01,0.42,19,12,12,0,1.58,100.0,12,7,61.7,Adapte,Adapte,Adapte / Adapte
721,722,2015,Mathematique,3,1,QO,0.2335,0.93,0.06,99,53,23,30,1.87,43.4,23,76,23.35,Trop Difficile,Trop Difficile,Trop Difficile / Trop Difficile
1551,722,2016,Mathematique,3,1,QO,0.3949,0.79,0.12,88,53,35,18,1.66,66.04,35,53,39.49,Adapte,Difficile,Adapte / Difficile
2381,722,2017,Mathematique,3,1,QO,0.7888,0.17,0.54,72,60,57,3,1.2,95.0,57,15,78.88,Adapte,Facile,Adapte / Facile
3211,722,2018,Mathematique,3,1,QO,0.6776,0.41,0.2,65,55,44,11,1.18,80.0,44,21,67.76,Adapte,Adapte,Adapte / Adapte
4041,722,2019,Mathematique,3,1,QO,0.6767,0.55,0.3,69,52,47,5,1.33,90.38,47,22,67.67,Adapte,Adapte,Adapte / Adapte
4871,722,2020,Mathematique,3,1,QO,0.6819,0.55,0.21,66,62,45,17,1.06,72.58,45,21,68.19,Adapte,Adapte,Adapte / Adapte
722,723,2015,Mathematique,3,2,QROC,0.6658,0.4,0.35,84,71,56,15,1.18,78.87,56,28,66.58,Difficile,Adapte,Difficile / Adapte
1552,723,2016,Mathematique,3,2,QROC,0.6838,0.47,0.26,75,62,51,11,1.21,82.26,51,24,68.38,Adapte,Adapte,Adapte / Adapte
2382,723,2017,Mathematique,3,2,QROC,0.7441,0.35,0.28,74,58,55,3,1.28,94.83,55,19,74.41,Adapte,Adapte,Adapte / Adapte
3212,723,2018,Mathematique,3,2,QROC,0.6691,0.23,0.4,71,56,48,8,1.27,85.71,48,23,66.91,Adapte,Adapte,Adapte / Adapte
4042,723,2019,Mathematique,3,2,QROC,0.7227,0.28,0.36,67,60,48,12,1.12,80.0,48,19,72.27,Adapte,Adapte,Adapte / Adapte
4872,723,2020,Mathematique,3,2,QROC,0.707,0.46,0.39,65,60,46,14,1.08,76.67,46,19,70.7,Adapte,Adapte,Adapte / Adapte
723,724,2015,Mathematique,3,3,QCU,0.2667,0.16,0.32,81,62,22,40,1.31,35.48,22,59,26.67,Difficile,Difficile,Difficile / Difficile
1553,724,2016,Mathematique,3,3,QCU,0.8921,0.02,0.98,75,71,67,4,1.06,94.37,67,8,89.21,Trop Facile,Trop Facile,Trop Facile / Trop Facile
2383,724,2017,Mathematique,3,3,QCU,0.9141,0.06,0.96,70,65,64,1,1.08,98.46,64,6,91.41,Trop Facile,Trop Facile,Trop Facile / Trop Facile
3213,724,2018,Mathematique,3,3,QCU,0.8657,0.08,0.95,63,57,55,2,1.11,96.49,55,8,86.57,Trop Facile,Trop Facile,Trop Facile / Trop Facile
4043,724,2019,Mathematique,3,3,QCU,0.916,0.04,0.94,70,64,64,0,1.09,100.0,64,6,91.6,Trop Facile,Trop Facile,Trop Facile / Trop Facile
4873,724,2020,Mathematique,3,3,QCU,0.8473,0.0,0.76,57,51,48,3,1.12,94.12,48,9,84.73,Trop Facile,Facile,Trop Facile / Facile
724,725,2015,Mathematique,3,4,QCU,0.7967,0.19,0.89,75,66,60,6,1.14,90.91,60,15,79.67,Facile,Facile,Facile / Facile
1554,725,2016,Mathematique,3,4,QCU,0.9453,0.01,1.0,80,77,76,1,1.04,98.7,76,4,94.53,Trop Facile,Trop Facile,Trop Facile / Trop Facile
2384,725,2017,Mathematique,3,4,QCU,0.9304,0.02,0.9,73,73,68,5,1.0,93.15,68,5,93.04,Trop Facile,Trop Facile,Trop Facile / Trop Facile
3214,725,2018,Mathematique,3,4,QCU,0.9571,0.03,0.99,83,80,79,1,1.04,98.75,79,4,95.71,Trop Facile,Trop Facile,Trop Facile / Trop Facile
4044,725,2019,Mathematique,3,4,QCU,0.8815,0.04,0.95,77,74,68,6,1.04,91.89,68,9,88.15,Trop Facile,Trop Facile,Trop Facile / Trop Facile
4874,725,2020,Mathematique,3,4,QCU,0.9542,0.01,0.95,76,76,73,3,1.0,96.05,73,3,95.42,Trop Facile,Trop Facile,Trop Facile / Trop Facile
725,726,2015,Mathematique,3,5,QROC,0.8044,0.03,0.54,57,54,46,8,1.06,85.19,46,11,80.44,Facile,Facile,Facile / Facile
1555,726,2016,Mathematique,3,5,QROC,0.6733,0.48,0.26,49,48,33,15,1.02,68.75,33,16,67.33,Facile,Adapte,Facile / Adapte
2385,726,2017,Mathematique,3,5,QROC,0.6972,0.48,0.38,54,52,38,14,1.04,73.08,38,16,69.72,Adapte,Adapte,Adapte / Adapte
3215,726,2018,Mathematique,3,5,QROC,0.7377,0.3,0.33,64,63,47,16,1.02,74.6,47,17,73.77,Adapte,Adapte,Adapte / Adapte
4045,726,2019,Mathematique,3,5,QROC,0.7472,0.38,0.34,67,61,50,11,1.1,81.97,50,17,74.72,Adapte,Adapte,Adapte / Adapte
4875,726,2020,Mathematique,3,5,QROC,0.6209,0.3,0.33,60,55,37,18,1.09,67.27,37,23,62.09,Adapte,Adapte,Adapte / Adapte
726,727,2015,Mathematique,3,6,QCU,0.8192,0.06,0.87,90,82,74,8,1.1,90.24,74,16,81.92,Facile,Facile,Facile / Facile
1556,727,2016,Mathematique,3,6,QCU,0.8749,0.05,0.97,72,69,63,6,1.04,91.3,63,9,87.49,Trop Facile,Trop Facile,Trop Facile / Trop Facile
2386,727,2017,Mathematique,3,6,QCU,0.9295,0.1,0.9,80,74,74,0,1.08,100.0,74,6,92.95,Trop Facile,Trop Facile,Trop Facile / Trop Facile
3216,727,2018,Mathematique,3,6,QCU,0.9246,0.02,0.97,94,90,87,3,1.04,96.67,87,7,92.46,Trop Facile,Trop Facile,Trop Facile / Trop Facile
4046,727,2019,Mathematique,3,6,QCU,0.2161,0.22,0.23,106,53,23,30,2.0,43.4,23,83,21.61,Trop Facile,Trop Difficile,Trop Facile / Trop Difficile
4876,727,2020,Mathematique,3,6,QCU,0.9553,0.09,0.95,95,91,91,0,1.04,100.0,91,4,95.53,Trop Facile,Trop Facile,Trop Facile / Trop Facile
727,728,2015,Mathematique,3,7,QCM,0.2844,0.14,0.38,50,15,14,1,3.33,93.33,14,36,28.44,Difficile,Difficile,Difficile / Difficile
1557,728,2016,Mathematique,3,7,QCM,0.7958,0.18,0.76,57,54,45,9,1.06,83.33,45,12,79.58,Facile,Facile,Facile / Facile
2387,728,2017,Mathematique,3,7,QCM,0.8358,0.17,0.79,54,48,45,3,1.12,93.75,45,9,83.58,Facile,Facile,Facile / Facile
3217,728,2018,Mathematique,3,7,QCM,0.9941,0.02,0.85,52,52,52,0,1.0,100.0,52,0,99.41,Facile,Trop Facile,Facile / Trop Facile
4047,728,2019,Mathematique,3,7,QCM,0.8266,0.17,0.75,62,51,51,0,1.22,100.0,51,11,82.66,Facile,Facile,Facile / Facile
4877,728,2020,Mathematique,3,7,QCM,0.7645,0.01,0.73,74,69,57,12,1.07,82.61,57,17,76.45,Facile,Facile,Facile / Facile
728,729,2015,Mathematique,3,8,QCU,0.3112,0.1,0.32,50,45,16,29,1.11,35.56,16,34,31.12,Facile,Difficile,Facile / Difficile
1558,729,2016,Mathematique,3,8,QCU,0.3899,0.36,0.39,45,28,18,10,1.61,64.29,18,27,38.99,Trop Facile,Difficile,Trop Facile / Difficile
2388,729,2017,Mathematique,3,8,QCU,0.8771,0.04,0.94,48,42,42,0,1.14,100.0,42,6,87.71,Trop Facile,Trop Facile,Trop Facile / Trop Facile
3218,729,2018,Mathematique,3,8,QCU,0.9544,0.08,0.92,38,37,36,1,1.03,97.3,36,2,95.44,Trop Facile,Trop Facile,Trop Facile / Trop Facile
4048,729,2019,Mathematique,3,8,QCU,0.9786,0.0,0.96,34,34,33,1,1.0,97.06,33,1,97.86,Trop Facile,Trop Facile,Trop Facile / Trop Facile
4878,729,2020,Mathematique,3,8,QCU,0.2602,0.18,0.32,34,14,9,5,2.43,64.29,9,25,26.02,Trop Facile,Difficile,Trop Facile / Difficile
729,730,2015,Mathematique,4,1,QCM,0.9281,0.07,0.9,91,87,84,3,1.05,96.55,84,7,92.81,Trop Difficile,Trop Facile,Trop Difficile / Trop Facile
1559,730,2016,Mathematique,4,1,QCM,0.8179,0.03,0.73,94,90,77,13,1.04,85.56,77,17,81.79,Facile,Facile,Facile / Facile
2389,730,2017,Mathematique,4,1,QCM,0.8094,0.1,0.73,105,97,85,12,1.08,87.63,85,20,80.94,Facile,Facile,Facile / Facile
3219,730,2018,Mathematique,4,1,QCM,0.3049,0.09,0.31,85,39,26,13,2.18,66.67,26,59,30.49,Facile,Difficile,Facile / Difficile
4049,730,2019,Mathematique,4,1,QCM,0.8176,0.02,0.8,93,82,76,6,1.13,92.68,76,17,81.76,Facile,Facile,Facile / Facile
4879,730,2020,Mathematique,4,1,QCM,0.5086,0.24,0.36,99,62,50,12,1.6,80.65,50,49,50.86,Facile,Difficile,Facile / Difficile
730,731,2015,Mathematique,4,2,QCM,0.6026,0.18,0.41,23,19,14,5,1.21,73.68,14,9,60.26,Adapte,Adapte,Adapte / Adapte
1560,731,2016,Mathematique,4,2,QCM,0.602,0.0,0.53,18,12,11,1,1.5,91.67,11,7,60.2,Adapte,Adapte,Adapte / Adapte
2390,731,2017,Mathematique,4,2,QCM,0.6418,0.3,0.49,15,13,10,3,1.15,76.92,10,5,64.18,Adapte,Adapte,Adapte / Adapte
3220,731,2018,Mathematique,4,2,QCM,0.649,0.07,0.44,17,13,11,2,1.31,84.62,11,6,64.9,Adapte,Adapte,Adapte / Adapte
4050,731,2019,Mathematique,4,2,QCM,0.6758,0.19,0.54,15,10,10,0,1.5,100.0,10,5,67.58,Adapte,Adapte,Adapte / Adapte
4880,731,2020,Mathematique,4,2,QCM,0.613,0.26,0.5,17,17,10,7,1.0,58.82,10,7,61.3,Adapte,Adapte,Adapte / Adapte
731,732,2015,Mathematique,4,3,QCM,0.2747,0.28,0.35,85,44,23,21,1.93,52.27,23,62,27.47,Difficile,Difficile,Difficile / Difficile
1561,732,2016,Mathematique,4,3,QCM,0.8086,0.03,0.76,79,77,64,13,1.03,83.12,64,15,80.86,Facile,Facile,Facile / Facile
2391,732,2017,Mathematique,4,3,QCM,0.7843,0.18,0.72,89,87,70,17,1.02,80.46,70,19,78.43,Facile,Facile,Facile / Facile
3221,732,2018,Mathematique,4,3,QCM,0.6076,0.24,0.48,84,66,51,15,1.27,77.27,51,33,60.76,Facile,Adapte,Facile / Adapte
4051,732,2019,Mathematique,4,3,QCM,0.711,0.12,0.57,98,94,70,24,1.04,74.47,70,28,71.1,Adapte,Adapte,Adapte / Adapte
4881,732,2020,Mathematique,4,3,QCM,0.7322,0.13,0.63,113,102,83,19,1.11,81.37,83,30,73.22,Adapte,Adapte,Adapte / Adapte
732,733,2015,Mathematique,4,4,QCU,0.7726,0.02,0.86,59,51,46,5,1.16,90.2,46,13,77.26,Facile,Facile,Facile / Facile
1562,733,2016,Mathematique,4,4,QCU,0.8342,0.15,0.78,58,52,48,4,1.12,92.31,48,10,83.42,Trop Facile,Facile,Trop Facile / Facile
2392,733,2017,Mathematique,4,4,QCU,0.8913,0.09,0.99,49,47,44,3,1.04,93.62,44,5,89.13,Trop Facile,Trop Facile,Trop Facile / Trop Facile
3222,733,2018,Mathematique,4,4,QCU,0.902,0.01,0.99,41,40,37,3,1.02,92.5,37,4,90.2,Trop Facile,Trop Facile,Trop Facile / Trop Facile
4052,733,2019,Mathematique,4,4,QCU,0.8853,0.04,0.99,42,39,37,2,1.08,94.87,37,5,88.53,Trop Facile,Trop Facile,Trop Facile / Trop Facile
4882,733,2020,Mathematique,4,4,QCU,0.8683,0.05,0.91,42,37,36,1,1.14,97.3,36,6,86.83,Trop Facile,Trop Facile,Trop Facile / Trop Facile
733,734,2015,Mathematique,4,5,QCU,0.7919,0.07,0.78,21,19,17,2,1.11,89.47,17,4,79.19,Facile,Facile,Facile / Facile
1563,734,2016,Mathematique,4,5,QCU,0.8134,0.15,0.81,25,25,20,5,1.0,80.0,20,5,81.34,Trop Facile,Facile,Trop Facile / Facile
2393,734,2017,Mathematique,4,5,QCU,0.9085,0.01,0.93,27,25,25,0,1.08,100.0,25,2,90.85,Trop Facile,Trop Facile,Trop Facile / Trop Facile
3223,734,2018,Mathematique,4,5,QCU,0.8819,0.07,0.9,26,25,23,2,1.04,92.0,23,3,88.19,Trop Facile,Trop Facile,Trop Facile / Trop Facile
4053,734,2019,Mathematique,4,5,QCU,0.0745,0.22,0.26,27,25,2,23,1.08,8.0,2,25,7.45,Trop Facile,Trop Difficile,Trop Facile / Trop Difficile
4883,734,2020,Mathematique,4,5,QCU,0.9462,0.08,0.97,28,28,26,2,1.0,92.86,26,2,94.62,Trop Facile,Trop Facile,Trop Facile / Trop Facile
734,735,2015,Mathematique,4,6,QROC,0.0318,0.88,0.01,67,39,2,37,1.72,5.13,2,65,3.18,Difficile,Trop Difficile,Difficile / Trop Difficile
1564,735,2016,Mathematique,4,6,QROC,0.8224,0.11,0.71,80,69,66,3,1.16,95.65,66,14,82.24,Facile,Facile,Facile / Facile
2394,735,2017,Mathematique,4,6,QROC,0.9602,0.08,0.5,90,87,86,1,1.03,98.85,86,4,96.02,Facile,Trop Facile,Facile / Trop Facile
3224,735,2018,Mathematique,4,6,QROC,0.7888,0.08,0.44,101,92,80,12,1.1,86.96,80,21,78.88,Facile,Facile,Facile / Facile
4054,735,2019,Mathematique,4,6,QROC,0.8322,0.19,0.41,85,80,71,9,1.06,88.75,71,14,83.22,Facile,Facile,Facile / Facile
4884,735,2020,Mathematique,4,6,QROC,0.8628,0.03,0.71,71,64,61,3,1.11,95.31,61,10,86.28,Facile,Trop Facile,Facile / Trop Facile
735,736,2015,Mathematique,4,7,QCU,0.8943,0.0,0.96,31,28,28,0,1.11,100.0,28,3,89.43,Difficile,Trop Facile,Difficile / Trop Facile
1565,736,2016,Mathematique,4,7,QCU,0.8667,0.04,0.94,36,35,31,4,1.03,88.57,31,5,86.67,Trop Facile,Trop Facile,Trop Facile / Trop Facile
2395,736,2017,Mathematique,4,7,QCU,0.8903,0.0,0.93,31,31,28,3,1.0,90.32,28,3,89.03,Trop Facile,Trop Facile,Trop Facile / Trop Facile
3225,736,2018,Mathematique,4,7,QCU,0.9769,0.03,0.99,30,29,29,0,1.03,100.0,29,1,97.69,Trop Facile,Trop Facile,Trop Facile / Trop Facile
4055,736,2019,Mathematique,4,7,QCU,0.873,0.04,0.95,28,25,24,1,1.12,96.0,24,4,87.3,Trop Facile,Trop Facile,Trop Facile / Trop Facile
4885,736,2020,Mathematique,4,7,QCU,0.9513,0.06,0.94,27,26,26,0,1.04,100.0,26,1,95.13,Trop Facile,Trop Facile,Trop Facile / Trop Facile
736,737,2015,Mathematique,5,1,QCU,0.8246,0.15,0.8,90,79,74,5,1.14,93.67,74,16,82.46,Facile,Facile,Facile / Facile
1566,737,2016,Mathematique,5,1,QCU,0.9881,0.02,0.95,88,87,87,0,1.01,100.0,87,1,98.81,Trop Facile,Trop Facile,Trop Facile / Trop Facile
2396,737,2017,Mathematique,5,1,QCU,0.969,0.09,0.99,83,80,80,0,1.04,100.0,80,3,96.9,Trop Facile,Trop Facile,Trop Facile / Trop Facile
3226,737,2018,Mathematique,5,1,QCU,0.7771,0.09,0.83,71,60,55,5,1.18,91.67,55,16,77.71,Trop Facile,Facile,Trop Facile / Facile
4056,737,2019,Mathematique,5,1,QCU,0.1628,0.68,0.26,76,66,12,54,1.15,18.18,12,64,16.28,Trop Facile,Trop Difficile,Trop Facile / Trop Difficile
4886,737,2020,Mathematique,5,1,QCU,0.9827,0.09,0.97,91,90,89,1,1.01,98.89,89,2,98.27,Trop Facile,Trop Facile,Trop Facile / Trop Facile
737,738,2015,Mathematique,5,2,QCM,0.8952,0.1,0.92,35,32,31,1,1.09,96.88,31,4,89.52,Trop Facile,Trop Facile,Trop Facile / Trop Facile
1567,738,2016,Mathematique,5,2,QCM,0.8273,0.19,0.73,31,27,26,1,1.15,96.3,26,5,82.73,Facile,Facile,Facile / Facile
2397,738,2017,Mathematique,5,2,QCM,0.7844,0.11,0.72,36,34,28,6,1.06,82.35,28,8,78.44,Facile,Facile,Facile / Facile
3227,738,2018,Mathematique,5,2,QCM,0.8423,0.15,0.7,40,36,34,2,1.11,94.44,34,6,84.23,Facile,Facile,Facile / Facile
4057,738,2019,Mathematique,5,2,QCM,0.7773,0.06,0.76,36,28,28,0,1.29,100.0,28,8,77.73,Facile,Facile,Facile / Facile
4887,738,2020,Mathematique,5,2,QCM,0.7973,0.1,0.75,36,35,29,6,1.03,82.86,29,7,79.73,Facile,Facile,Facile / Facile
738,739,2015,Mathematique,5,3,QCU,0.5358,0.26,0.37,57,40,31,9,1.43,77.5,31,26,53.58,Difficile,Difficile,Difficile / Difficile
1568,739,2016,Mathematique,5,3,QCU,0.6891,0.24,0.6,49,47,34,13,1.04,72.34,34,15,68.91,Trop Facile,Adapte,Trop Facile / Adapte
2398,739,2017,Mathematique,5,3,QCU,0.7331,0.14,0.6,42,31,31,0,1.35,100.0,31,11,73.31,Adapte,Adapte,Adapte / Adapte
3228,739,2018,Mathematique,5,3,QCU,0.6786,0.21,0.44,46,45,31,14,1.02,68.89,31,15,67.86,Adapte,Adapte,Adapte / Adapte
4058,739,2019,Mathematique,5,3,QCU,0.6637,0.0,0.52,40,35,27,8,1.14,77.14,27,13,66.37,Adapte,Adapte,Adapte / Adapte
4888,739,2020,Mathematique,5,3,QCU,0.6537,0.18,0.62,46,31,30,1,1.48,96.77,30,16,65.37,Adapte,Adapte,Adapte / Adapte
739,740,2015,Mathematique,5,4,QCU,0.7689,0.09,0.83,46,41,35,6,1.12,85.37,35,11,76.89,Facile,Facile,Facile / Facile
1569,740,2016,Mathematique,5,4,QCU,0.8985,0.0,1.0,54,49,49,0,1.1,100.0,49,5,89.85,Trop Facile,Trop Facile,Trop Facile / Trop Facile
2399,740,2017,Mathematique,5,4,QCU,0.9183,0.04,0.94,53,50,49,1,1.06,98.0,49,4,91.83,Trop Facile,Trop Facile,Trop Facile / Trop Facile
3229,740,2018,Mathematique,5,4,QCU,0.7442,0.26,0.65,58,58,43,15,1.0,74.14,43,15,74.42,Trop Facile,Adapte,Trop Facile / Adapte
4059,740,2019,Mathematique,5,4,QCU,0.7223,0.07,0.58,50,43,36,7,1.16,83.72,36,14,72.23,Adapte,Adapte,Adapte / Adapte
4889,740,2020,Mathematique,5,4,QCU,0.6842,0.07,0.54,42,39,29,10,1.08,74.36,29,13,68.42,Adapte,Adapte,Adapte / Adapte
740,741,2015,Mathematique,5,5,QO,0.3857,0.81,0.11,74,38,29,9,1.95,76.32,29,45,38.57,Difficile,Difficile,Difficile / Difficile
1570,741,2016,Mathematique,5,5,QO,0.6321,0.68,0.28,60,39,38,1,1.54,97.44,38,22,63.21,Adapte,Adapte,Adapte / Adapte
2400,741,2017,Mathematique,5,5,QO,0.652,0.69,0.18,60,56,39,17,1.07,69.64,39,21,65.2,Adapte,Adapte,Adapte / Adapte
3230,741,2018,Mathematique,5,5,QO,0.6009,0.67,0.19,52,37,31,6,1.41,83.78,31,21,60.09,Adapte,Adapte,Adapte / Adapte
4060,741,2019,Mathematique,5,5,QO,0.7069,0.25,0.18,58,43,41,2,1.35,95.35,41,17,70.69,Adapte,Adapte,Adapte / Adapte
4890,741,2020,Mathematique,5,5,QO,0.7427,0.21,0.2,69,69,51,18,1.0,73.91,51,18,74.27,Adapte,Adapte,Adapte / Adapte
741,742,2015,Mathematique,5,6,QCU,0.1783,0.46,0.28,93,35,17,18,2.66,48.57,17,76,17.83,Trop Facile,Trop Difficile,Trop Facile / Trop Difficile
1571,742,2016,Mathematique,5,6,QCU,0.8683,0.01,0.92,112,104,97,7,1.08,93.27,97,15,86.83,Trop Facile,Trop Facile,Trop Facile / Trop Facile
2401,742,2017,Mathematique,5,6,QCU,0.9697,0.02,0.97,103,100,100,0,1.03,100.0,100,3,96.97,Trop Facile,Trop Facile,Trop Facile / Trop Facile
3231,742,2018,Mathematique,5,6,QCU,0.3015,0.39,0.37,102,71,31,40,1.44,43.66,31,71,30.15,Trop Facile,Difficile,Trop Facile / Difficile
4061,742,2019,Mathematique,5,6,QCU,0.6939,0.04,0.55,83,68,58,10,1.22,85.29,58,25,69.39,Trop Facile,Adapte,Trop Facile / Adapte
4891,742,2020,Mathematique,5,6,QCU,0.6734,0.25,0.45,96,96,65,31,1.0,67.71,65,31,67.34,Adapte,Adapte,Adapte / Adapte
742,743,2015,Mathematique,5,7,QCU,0.6914,0.15,0.53,11,9,8,1,1.22,88.89,8,3,69.14,Trop Facile,Adapte,Trop Facile / Adapte
1572,743,2016,Mathematique,5,7,QCU,0.739,0.12,0.46,9,8,7,1,1.12,87.5,7,2,73.9,Adapte,Adapte,Adapte / Adapte
2402,743,2017,Mathematique,5,7,QCU,0.6162,0.1,0.64,7,4,4,0,1.75,100.0,4,3,61.62,Adapte,Adapte,Adapte / Adapte
3232,743,2018,Mathematique,5,7,QCU,0.7358,0.15,0.47,7,5,5,0,1.4,100.0,5,2,73.58,Adapte,Adapte,Adapte / Adapte
4062,743,2019,Mathematique,5,7,QCU,0.7099,0.24,0.49,8,8,6,2,1.0,75.0,6,2,70.99,Adapte,Adapte,Adapte / Adapte
4892,743,2020,Mathematique,5,7,QCU,0.7356,0.17,0.63,7,7,5,2,1.0,71.43,5,2,73.56,Adapte,Adapte,Adapte / Adapte
743,744,2015,Mathematique,5,8,QCM,0.4585,0.09,0.4,24,21,11,10,1.14,52.38,11,13,45.85,Difficile,Difficile,Difficile / Difficile
1573,744,2016,Mathematique,5,8,QCM,0.7738,0.13,0.72,21,19,16,3,1.11,84.21,16,5,77.38,Facile,Facile,Facile / Facile
2403,744,2017,Mathematique,5,8,QCM,0.4548,0.05,0.36,21,16,10,6,1.31,62.5,10,11,45.48,Facile,Difficile,Facile / Difficile
3233,744,2018,Mathematique,5,8,QCM,0.1029,0.27,0.26,17,14,2,12,1.21,14.29,2,15,10.29,Facile,Trop Difficile,Facile / Trop Difficile
4063,744,2019,Mathematique,5,8,QCM,0.771,0.1,0.77,20,17,15,2,1.18,88.24,15,5,77.1,Facile,Facile,Facile / Facile
4893,744,2020,Mathematique,5,8,QCM,0.836,0.2,0.79,18,16,15,1,1.12,93.75,15,3,83.6,Facile,Facile,Facile / Facile
744,745,2015,Mathematique,5,9,QO,0.7963,0.12,0.32,23,18,18,0,1.28,100.0,18,5,79.63,Facile,Facile,Facile / Facile
1574,745,2016,Mathematique,5,9,QO,0.7165,0.5,0.17,26,25,19,6,1.04,76.0,19,7,71.65,Adapte,Adapte,Adapte / Adapte
2404,745,2017,Mathematique,5,9,QO,0.7383,0.66,0.21,25,19,18,1,1.32,94.74,18,7,73.83,Adapte,Adapte,Adapte / Adapte
3234,745,2018,Mathematique,5,9,QO,0.631,0.31,0.18,25,23,16,7,1.09,69.57,16,9,63.1,Adapte,Adapte,Adapte / Adapte
4064,745,2019,Mathematique,5,9,QO,0.6851,0.53,0.15,30,23,21,2,1.3,91.3,21,9,68.51,Adapte,Adapte,Adapte / Adapte
4894,745,2020,Mathematique,5,9,QO,0.6009,0.7,0.25,26,17,16,1,1.53,94.12,16,10,60.09,Adapte,Adapte,Adapte / Adapte
745,746,2015,Mathematique,6,1,QROC,0.834,0.15,0.74,15,13,13,0,1.15,100.0,13,2,83.4,Facile,Facile,Facile / Facile
1575,746,2016,Mathematique,6,1,QROC,0.8195,0.16,0.49,18,16,15,1,1.12,93.75,15,3,81.95,Facile,Facile,Facile / Facile
2405,746,2017,Mathematique,6,1,QROC,0.7601,0.08,0.52,17,16,13,3,1.06,81.25,13,4,76.01,Facile,Facile,Facile / Facile
3235,746,2018,Mathematique,6,1,QROC,0.9466,0.1,0.83,20,19,19,0,1.05,100.0,19,1,94.66,Facile,Trop Facile,Facile / Trop Facile
4065,746,2019,Mathematique,6,1,QROC,0.6741,0.45,0.31,23,21,16,5,1.1,76.19,16,7,67.41,Facile,Adapte,Facile / Adapte
4895,746,2020,Mathematique,6,1,QROC,0.7352,0.34,0.29,28,27,21,6,1.04,77.78,21,7,73.52,Adapte,Adapte,Adapte / Adapte
746,747,2015,Mathematique,6,2,QCU,0.7661,0.12,0.84,7,7,5,2,1.0,71.43,5,2,76.61,Facile,Facile,Facile / Facile
1576,747,2016,Mathematique,6,2,QCU,0.9798,0.02,0.91,7,7,7,0,1.0,100.0,7,0,97.98,Trop Facile,Trop Facile,Trop Facile / Trop Facile
2406,747,2017,Mathematique,6,2,QCU,0.8603,0.07,0.96,8,8,7,1,1.0,87.5,7,1,86.03,Trop Facile,Trop Facile,Trop Facile / Trop Facile
3236,747,2018,Mathematique,6,2,QCU,0.4909,0.35,0.33,7,5,3,2,1.4,60.0,3,4,49.09,Trop Facile,Difficile,Trop Facile / Difficile
4066,747,2019,Mathematique,6,2,QCU,0.9745,0.04,0.96,8,8,8,0,1.0,100.0,8,0,97.45,Trop Facile,Trop Facile,Trop Facile / Trop Facile
4896,747,2020,Mathematique,6,2,QCU,0.1973,0.58,0.21,10,4,2,2,2.5,50.0,2,8,19.73,Trop Facile,Trop Difficile,Trop Facile / Trop Difficile
747,748,2015,Mathematique,6,3,QROC,0.2647,0.71,0.22,34,17,9,8,2.0,52.94,9,25,26.47,Difficile,Difficile,Difficile / Difficile
1577,748,2016,Mathematique,6,3,QROC,0.8195,0.18,0.6,36,31,30,1,1.16,96.77,30,6,81.95,Facile,Facile,Facile / Facile
2407,748,2017,Mathematique,6,3,QROC,0.7924,0.17,0.41,39,38,31,7,1.03,81.58,31,8,79.24,Facile,Facile,Facile / Facile
3237,748,2018,Mathematique,6,3,QROC,0.8157,0.14,0.71,47,45,38,7,1.04,84.44,38,9,81.57,Facile,Facile,Facile / Facile
4067,748,2019,Mathematique,6,3,QROC,0.7999,0.01,0.58,46,44,37,7,1.05,84.09,37,9,79.99,Facile,Facile,Facile / Facile
4897,748,2020,Mathematique,6,3,QROC,0.7971,0.19,0.63,55,48,44,4,1.15,91.67,44,11,79.71,Facile,Facile,Facile / Facile
748,749,2015,Mathematique,6,4,QCU,0.6416,0.24,0.51,37,25,24,1,1.48,96.0,24,13,64.16,Trop Facile,Adapte,Trop Facile / Adapte
1578,749,2016,Mathematique,6,4,QCU,0.6625,0.25,0.61,33,26,22,4,1.27,84.62,22,11,66.25,Adapte,Adapte,Adapte / Adapte
2408,749,2017,Mathematique,6,4,QCU,0.723,0.19,0.69,27,22,20,2,1.23,90.91,20,7,72.3,Adapte,Adapte,Adapte / Adapte
3238,749,2018,Mathematique,6,4,QCU,0.6573,0.24,0.67,32,31,21,10,1.03,67.74,21,11,65.73,Adapte,Adapte,Adapte / Adapte
4068,749,2019,Mathematique,6,4,QCU,0.6927,0.22,0.45,32,29,22,7,1.1,75.86,22,10,69.27,Adapte,Adapte,Adapte / Adapte
4898,749,2020,Mathematique,6,4,QCU,0.6745,0.05,0.49,35,31,24,7,1.13,77.42,24,11,67.45,Adapte,Adapte,Adapte / Adapte
749,750,2015,Mathematique,6,5,QCU,0.9801,0.08,0.99,83,82,81,1,1.01,98.78,81,2,98.01,Facile,Trop Facile,Facile / Trop Facile
1579,750,2016,Mathematique,6,5,QCU,0.9381,0.06,0.99,78,78,73,5,1.0,93.59,73,5,93.81,Trop Facile,Trop Facile,Trop Facile / Trop Facile
2409,750,2017,Mathematique,6,5,QCU,0.9789,0.09,0.99,80,79,78,1,1.01,98.73,78,2,97.89,Trop Facile,Trop Facile,Trop Facile / Trop Facile
3239,750,2018,Mathematique,6,5,QCU,0.9873,0.02,0.98,72,72,71,1,1.0,98.61,71,1,98.73,Trop Facile,Trop Facile,Trop Facile / Trop Facile
4069,750,2019,Mathematique,6,5,QCU,0.8844,0.08,0.99,58,54,51,3,1.07,94.44,51,7,88.44,Trop Facile,Trop Facile,Trop Facile / Trop Facile
4899,750,2020,Mathematique,6,5,QCU,0.8075,0.12,0.77,69,60,56,4,1.15,93.33,56,13,80.75,Trop Facile,Facile,Trop Facile / Facile
750,751,2015,Mathematique,6,6,QCM,0.3178,0.42,0.38,12,8,4,4,1.5,50.0,4,8,31.78,Trop Difficile,Difficile,Trop Difficile / Difficile
1580,751,2016,Mathematique,6,6,QCM,0.7696,0.12,0.74,14,12,11,1,1.17,91.67,11,3,76.96,Facile,Facile,Facile / Facile
2410,751,2017,Mathematique,6,6,QCM,0.8269,0.08,0.7,11,10,9,1,1.1,90.0,9,2,82.69,Facile,Facile,Facile / Facile
3240,751,2018,Mathematique,6,6,QCM,0.9885,0.02,0.87,13,13,13,0,1.0,100.0,13,0,98.85,Facile,Trop Facile,Facile / Trop Facile
4070,751,2019,Mathematique,6,6,QCM,0.8315,0.14,0.79,15,13,12,1,1.15,92.31,12,3,83.15,Facile,Facile,Facile / Facile
4900,751,2020,Mathematique,6,6,QCM,0.0555,0.64,0.2,12,6,1,5,2.0,16.67,1,11,5.55,Facile,Trop Difficile,Facile / Trop Difficile
751,752,2015,Mathematique,6,7,QCM,0.4907,0.15,0.39,90,51,44,7,1.76,86.27,44,46,49.07,Difficile,Difficile,Difficile / Difficile
1581,752,2016,Mathematique,6,7,QCM,0.8228,0.14,0.72,80,70,66,4,1.14,94.29,66,14,82.28,Facile,Facile,Facile / Facile
2411,752,2017,Mathematique,6,7,QCM,0.8256,0.1,0.71,78,66,64,2,1.18,96.97,64,14,82.56,Facile,Facile,Facile / Facile
3241,752,2018,Mathematique,6,7,QCM,0.7606,0.02,0.71,73,73,56,17,1.0,76.71,56,17,76.06,Facile,Facile,Facile / Facile
4071,752,2019,Mathematique,6,7,QCM,0.0444,0.19,0.26,60,44,3,41,1.36,6.82,3,57,4.44,Facile,Trop Difficile,Facile / Trop Difficile
4901,752,2020,Mathematique,6,7,QCM,0.4073,0.4,0.31,65,43,26,17,1.51,60.47,26,39,40.73,Facile,Difficile,Facile / Difficile
752,753,2015,Mathematique,6,8,QCM,0.4305,0.25,0.4,94,86,40,46,1.09,46.51,40,54,43.05,Facile,Difficile,Facile / Difficile
1582,753,2016,Mathematique,6,8,QCM,0.7606,0.01,0.75,96,76,73,3,1.26,96.05,73,23,76.06,Facile,Facile,Facile / Facile
2412,753,2017,Mathematique,6,8,QCM,0.8753,0.05,1.0,102,97,89,8,1.05,91.75,89,13,87.53,Facile,Trop Facile,Facile / Trop Facile
3242,753,2018,Mathematique,6,8,QCM,0.812,0.1,0.7,122,108,99,9,1.13,91.67,99,23,81.2,Facile,Facile,Facile / Facile
4072,753,2019,Mathematique,6,8,QCM,0.7942,0.19,0.76,145,116,115,1,1.25,99.14,115,30,79.42,Facile,Facile,Facile / Facile
4902,753,2020,Mathematique,6,8,QCM,0.9968,0.09,0.89,123,123,123,0,1.0,100.0,123,0,99.68,Facile,Trop Facile,Facile / Trop Facile
753,754,2015,Mathematique,6,9,QCU,0.766,0.02,0.88,55,42,42,0,1.31,100.0,42,13,76.6,Trop Difficile,Facile,Trop Difficile / Facile
1583,754,2016,Mathematique,6,9,QCU,0.9209,0.0,0.98,44,41,41,0,1.07,100.0,41,3,92.09,Trop Facile,Trop Facile,Trop Facile / Trop Facile
2413,754,2017,Mathematique,6,9,QCU,0.8666,0.1,0.91,45,42,39,3,1.07,92.86,39,6,86.66,Trop Facile,Trop Facile,Trop Facile / Trop Facile
3243,754,2018,Mathematique,6,9,QCU,0.9876,0.05,1.0,53,53,52,1,1.0,98.11,52,1,98.76,Trop Facile,Trop Facile,Trop Facile / Trop Facile
4073,754,2019,Mathematique,6,9,QCU,0.2948,0.34,0.32,54,37,16,21,1.46,43.24,16,38,29.48,Trop Facile,Difficile,Trop Facile / Difficile
4903,754,2020,Mathematique,6,9,QCU,0.9043,0.01,0.92,49,49,44,5,1.0,89.8,44,5,90.43,Trop Facile,Trop Facile,Trop Facile / Trop Facile
754,755,2015,Mathematique,6,10,QCM,0.1628,0.74,0.23,40,40,7,33,1.0,17.5,7,33,16.28,Trop Facile,Trop Difficile,Trop Facile / Trop Difficile
1584,755,2016,Mathematique,6,10,QCM,0.8026,0.01,0.78,48,42,39,3,1.14,92.86,39,9,80.26,Facile,Facile,Facile / Facile
2414,755,2017,Mathematique,6,10,QCM,0.8442,0.13,0.78,42,36,35,1,1.17,97.22,35,7,84.42,Facile,Facile,Facile / Facile
3244,755,2018,Mathematique,6,10,QCM,0.6885,0.23,0.52,34,26,23,3,1.31,88.46,23,11,68.85,Facile,Adapte,Facile / Adapte
4074,755,2019,Mathematique,6,10,QCM,0.6751,0.23,0.54,36,28,24,4,1.29,85.71,24,12,67.51,Adapte,Adapte,Adapte / Adapte
4904,755,2020,Mathematique,6,10,QCM,0.71,0.06,0.48,31,31,22,9,1.0,70.97,22,9,71.0,Adapte,Adapte,Adapte / Adapte
755,756,2015,Mathematique,6,11,QCU,0.3609,0.4,0.34,32,32,12,20,1.0,37.5,12,20,36.09,Difficile,Difficile,Difficile / Difficile
1585,756,2016,Mathematique,6,11,QCU,0.8955,0.0,0.91,36,35,32,3,1.03,91.43,32,4,89.55,Trop Facile,Trop Facile,Trop Facile / Trop Facile
2415,756,2017,Mathematique,6,11,QCU,0.9457,0.06,0.93,40,40,38,2,1.0,95.0,38,2,94.57,Trop Facile,Trop Facile,Trop Facile / Trop Facile
3245,756,2018,Mathematique,6,11,QCU,0.8116,0.15,0.84,45,38,37,1,1.18,97.37,37,8,81.16,Trop Facile,Facile,Trop Facile / Facile
4075,756,2019,Mathematique,6,11,QCU,0.8738,0.06,0.98,53,49,46,3,1.08,93.88,46,7,87.38,Trop Facile,Trop Facile,Trop Facile / Trop Facile
4905,756,2020,Mathematique,6,11,QCU,0.898,0.05,0.96,55,50,49,1,1.1,98.0,49,6,89.8,Trop Facile,Trop Facile,Trop Facile / Trop Facile
756,757,2015,Mathematique,6,12,QCU,0.9537,0.09,0.98,77,77,73,4,1.0,94.81,73,4,95.37,Trop Facile,Trop Facile,Trop Facile / Trop Facile
1586,757,2016,Mathematique,6,12,QCU,0.9772,0.02,0.92,65,65,64,1,1.0,98.46,64,1,97.72,Trop Facile,Trop Facile,Trop Facile / Trop Facile
2416,757,2017,Mathematique,6,12,QCU,0.7361,0.29,0.45,76,61,56,5,1.25,91.8,56,20,73.61,Trop Facile,Adapte,Trop Facile / Adapte
3246,757,2018,Mathematique,6,12,QCU,0.6046,0.04,0.67,91,56,55,1,1.62,98.21,55,36,60.46,Adapte,Adapte,Adapte / Adapte
4076,757,2019,Mathematique,6,12,QCU,0.6027,0.0,0.42,77,63,46,17,1.22,73.02,46,31,60.27,Adapte,Adapte,Adapte / Adapte
4906,757,2020,Mathematique,6,12,QCU,0.6187,0.29,0.49,68,62,42,20,1.1,67.74,42,26,61.87,Adapte,Adapte,Adapte / Adapte
757,758,2015,Mathematique,6,13,QCM,0.1435,0.02,0.22,41,20,6,14,2.05,30.0,6,35,14.35,Trop Difficile,Trop Difficile,Trop Difficile / Trop Difficile
1587,758,2016,Mathematique,6,13,QCM,0.829,0.19,0.77,37,32,31,1,1.16,96.88,31,6,82.9,Facile,Facile,Facile / Facile
2417,758,2017,Mathematique,6,13,QCM,0.8694,0.03,0.9,44,41,38,3,1.07,92.68,38,6,86.94,Facile,Trop Facile,Facile / Trop Facile
3247,758,2018,Mathematique,6,13,QCM,0.8241,0.11,0.75,43,41,35,6,1.05,85.37,35,8,82.41,Facile,Facile,Facile / Facile
4077,758,2019,Mathematique,6,13,QCM,0.814,0.04,0.74,36,36,29,7,1.0,80.56,29,7,81.4,Facile,Facile,Facile / Facile
4907,758,2020,Mathematique,6,13,QCM,0.8382,0.17,0.77,34,29,28,1,1.17,96.55,28,6,83.82,Facile,Facile,Facile / Facile
758,759,2015,Mathematique,7,1,QCM,0.3837,0.48,0.36,92,66,35,31,1.39,53.03,35,57,38.37,Facile,Difficile,Facile / Difficile
1588,759,2016,Mathematique,7,1,QCM,0.8446,0.05,0.74,106,91,90,1,1.16,98.9,90,16,84.46,Facile,Facile,Facile / Facile
2418,759,2017,Mathematique,7,1,QCM,0.9985,0.02,0.83,117,117,117,0,1.0,100.0,117,0,99.85,Facile,Trop Facile,Facile / Trop Facile
3248,759,2018,Mathematique,7,1,QCM,0.7618,0.08,0.72,95,87,72,15,1.09,82.76,72,23,76.18,Facile,Facile,Facile / Facile
4078,759,2019,Mathematique,7,1,QCM,0.8399,0.11,0.76,107,96,90,6,1.11,93.75,90,17,83.99,Facile,Facile,Facile / Facile
4908,759,2020,Mathematique,7,1,QCM,0.8446,0.0,0.76,121,115,102,13,1.05,88.7,102,19,84.46,Facile,Facile,Facile / Facile
759,760,2015,Mathematique,7,2,QCM,0.2071,0.01,0.28,85,38,18,20,2.24,47.37,18,67,20.71,Trop Difficile,Trop Difficile,Trop Difficile / Trop Difficile
1589,760,2016,Mathematique,7,2,QCM,0.2207,0.48,0.23,69,53,15,38,1.3,28.3,15,54,22.07,Facile,Trop Difficile,Facile / Trop Difficile
2419,760,2017,Mathematique,7,2,QCM,0.0293,0.44,0.21,69,62,2,60,1.11,3.23,2,67,2.93,Facile,Trop Difficile,Facile / Trop Difficile
3249,760,2018,Mathematique,7,2,QCM,0.8345,0.09,0.7,70,63,58,5,1.11,92.06,58,12,83.45,Facile,Facile,Facile / Facile
4079,760,2019,Mathematique,7,2,QCM,0.6922,0.26,0.7,56,56,39,17,1.0,69.64,39,17,69.22,Facile,Adapte,Facile / Adapte
4909,760,2020,Mathematique,7,2,QCM,0.6679,0.16,0.47,63,51,42,9,1.24,82.35,42,21,66.79,Adapte,Adapte,Adapte / Adapte
760,761,2015,Mathematique,7,3,QCU,0.0374,0.03,0.29,31,17,1,16,1.82,5.88,1,30,3.74,Trop Difficile,Trop Difficile,Trop Difficile / Trop Difficile
1590,761,2016,Mathematique,7,3,QCU,0.9919,0.04,0.93,33,33,33,0,1.0,100.0,33,0,99.19,Trop Facile,Trop Facile,Trop Facile / Trop Facile
2420,761,2017,Mathematique,7,3,QCU,0.9753,0.09,0.91,34,34,33,1,1.0,97.06,33,1,97.53,Trop Facile,Trop Facile,Trop Facile / Trop Facile
3250,761,2018,Mathematique,7,3,QCU,0.9061,0.01,0.95,31,28,28,0,1.11,100.0,28,3,90.61,Trop Facile,Trop Facile,Trop Facile / Trop Facile
4080,761,2019,Mathematique,7,3,QCU,0.9149,0.04,0.95,37,36,34,2,1.03,94.44,34,3,91.49,Trop Facile,Trop Facile,Trop Facile / Trop Facile
4910,761,2020,Mathematique,7,3,QCU,0.0935,0.75,0.25,44,39,4,35,1.13,10.26,4,40,9.35,Trop Facile,Trop Difficile,Trop Facile / Trop Difficile
761,762,2015,Mathematique,7,4,QCU,0.8864,0.09,0.92,6,6,5,1,1.0,83.33,5,1,88.64,Trop Facile,Trop Facile,Trop Facile / Trop Facile
1591,762,2016,Mathematique,7,4,QCU,0.5449,0.06,0.33,7,7,4,3,1.0,57.14,4,3,54.49,Trop Facile,Difficile,Trop Facile / Difficile
2421,762,2017,Mathematique,7,4,QCU,0.9584,0.09,0.96,7,7,7,0,1.0,100.0,7,0,95.84,Trop Facile,Trop Facile,Trop Facile / Trop Facile
3251,762,2018,Mathematique,7,4,QCU,0.9584,0.06,0.91,7,7,7,0,1.0,100.0,7,0,95.84,Trop Facile,Trop Facile,Trop Facile / Trop Facile
4081,762,2019,Mathematique,7,4,QCU,0.911,0.0,0.96,7,7,6,1,1.0,85.71,6,1,91.1,Trop Facile,Trop Facile,Trop Facile / Trop Facile
4911,762,2020,Mathematique,7,4,QCU,0.6973,0.07,0.56,8,6,6,0,1.33,100.0,6,2,69.73,Trop Facile,Adapte,Trop Facile / Adapte
762,763,2015,Mathematique,7,5,QCU,0.8438,0.19,0.86,88,77,74,3,1.14,96.1,74,14,84.38,Facile,Facile,Facile / Facile
1592,763,2016,Mathematique,7,5,QCU,0.9525,0.05,0.98,73,70,70,0,1.04,100.0,70,3,95.25,Trop Facile,Trop Facile,Trop Facile / Trop Facile
2422,763,2017,Mathematique,7,5,QCU,0.8748,0.04,0.95,78,76,68,8,1.03,89.47,68,10,87.48,Trop Facile,Trop Facile,Trop Facile / Trop Facile
3252,763,2018,Mathematique,7,5,QCU,0.199,0.28,0.25,67,37,13,24,1.81,35.14,13,54,19.9,Trop Facile,Trop Difficile,Trop Facile / Trop Difficile
4082,763,2019,Mathematique,7,5,QCU,0.9909,0.0,0.99,70,70,69,1,1.0,98.57,69,1,99.09,Trop Facile,Trop Facile,Trop Facile / Trop Facile
4912,763,2020,Mathematique,7,5,QCU,0.8491,0.08,0.82,80,76,68,8,1.05,89.47,68,12,84.91,Trop Facile,Facile,Trop Facile / Facile
763,764,2015,Mathematique,7,6,QROC,0.5835,0.72,0.23,86,65,50,15,1.32,76.92,50,36,58.35,Difficile,Difficile,Difficile / Difficile
1593,764,2016,Mathematique,7,6,QROC,0.9478,0.09,0.68,69,68,65,3,1.01,95.59,65,4,94.78,Facile,Trop Facile,Facile / Trop Facile
2423,764,2017,Mathematique,7,6,QROC,0.7725,0.03,0.65,81,73,63,10,1.11,86.3,63,18,77.25,Facile,Facile,Facile / Facile
3253,764,2018,Mathematique,7,6,QROC,0.8333,0.05,0.42,81,73,67,6,1.11,91.78,67,14,83.33,Facile,Facile,Facile / Facile
4083,764,2019,Mathematique,7,6,QROC,0.8092,0.08,0.63,82,78,66,12,1.05,84.62,66,16,80.92,Facile,Facile,Facile / Facile
4913,764,2020,Mathematique,7,6,QROC,0.6372,0.34,0.32,95,75,61,14,1.27,81.33,61,34,63.72,Facile,Adapte,Facile / Adapte
764,765,2015,Mathematique,7,7,QCU,0.405,0.32,0.3,90,74,36,38,1.22,48.65,36,54,40.5,Trop Difficile,Difficile,Trop Difficile / Difficile
1594,765,2016,Mathematique,7,7,QCU,0.8899,0.0,1.0,83,82,74,8,1.01,90.24,74,9,88.99,Trop Facile,Trop Facile,Trop Facile / Trop Facile
2424,765,2017,Mathematique,7,7,QCU,0.9502,0.07,0.99,76,75,72,3,1.01,96.0,72,4,95.02,Trop Facile,Trop Facile,Trop Facile / Trop Facile
3254,765,2018,Mathematique,7,7,QCU,0.8778,0.03,0.95,61,58,54,4,1.05,93.1,54,7,87.78,Trop Facile,Trop Facile,Trop Facile / Trop Facile
4084,765,2019,Mathematique,7,7,QCU,0.9156,0.07,0.98,55,52,50,2,1.06,96.15,50,5,91.56,Trop Facile,Trop Facile,Trop Facile / Trop Facile
4914,765,2020,Mathematique,7,7,QCU,0.688,0.09,0.42,44,40,30,10,1.1,75.0,30,14,68.8,Trop Facile,Adapte,Trop Facile / Adapte
765,766,2015,Mathematique,7,8,QCU,0.6031,0.29,0.64,52,32,31,1,1.62,96.88,31,21,60.31,Adapte,Adapte,Adapte / Adapte
1595,766,2016,Mathematique,7,8,QCU,0.6483,0.3,0.51,57,46,37,9,1.24,80.43,37,20,64.83,Adapte,Adapte,Adapte / Adapte
2425,766,2017,Mathematique,7,8,QCU,0.685,0.03,0.41,58,43,40,3,1.35,93.02,40,18,68.5,Adapte,Adapte,Adapte / Adapte
3255,766,2018,Mathematique,7,8,QCU,0.7073,0.2,0.42,53,50,37,13,1.06,74.0,37,16,70.73,Adapte,Adapte,Adapte / Adapte
4085,766,2019,Mathematique,7,8,QCU,0.7158,0.18,0.46,63,51,45,6,1.24,88.24,45,18,71.58,Adapte,Adapte,Adapte / Adapte
4915,766,2020,Mathematique,7,8,QCU,0.7414,0.17,0.63,58,45,43,2,1.29,95.56,43,15,74.14,Adapte,Adapte,Adapte / Adapte
766,767,2015,Mathematique,8,1,QCU,0.9479,0.03,0.94,40,39,38,1,1.03,97.44,38,2,94.79,Trop Facile,Trop Facile,Trop Facile / Trop Facile
1596,767,2016,Mathematique,8,1,QCU,0.8745,0.03,0.95,42,39,37,2,1.08,94.87,37,5,87.45,Trop Facile,Trop Facile,Trop Facile / Trop Facile
2426,767,2017,Mathematique,8,1,QCU,0.3353,0.38,0.39,41,28,14,14,1.46,50.0,14,27,33.53,Trop Facile,Difficile,Trop Facile / Difficile
3256,767,2018,Mathematique,8,1,QCU,0.9529,0.08,0.92,38,37,36,1,1.03,97.3,36,2,95.29,Trop Facile,Trop Facile,Trop Facile / Trop Facile
4086,767,2019,Mathematique,8,1,QCU,0.9752,0.04,0.98,39,38,38,0,1.03,100.0,38,1,97.52,Trop Facile,Trop Facile,Trop Facile / Trop Facile
4916,767,2020,Mathematique,8,1,QCU,0.4566,0.23,0.39,31,20,14,6,1.55,70.0,14,17,45.66,Trop Facile,Difficile,Trop Facile / Difficile
767,768,2015,Mathematique,8,2,QROC,0.0136,0.85,0.09,58,57,1,56,1.02,1.75,1,57,1.36,Trop Difficile,Trop Difficile,Trop Difficile / Trop Difficile
1597,768,2016,Mathematique,8,2,QROC,0.8006,0.12,0.68,70,62,56,6,1.13,90.32,56,14,80.06,Facile,Facile,Facile / Facile
2427,768,2017,Mathematique,8,2,QROC,0.2837,0.56,0.2,80,65,23,42,1.23,35.38,23,57,28.37,Facile,Difficile,Facile / Difficile
3257,768,2018,Mathematique,8,2,QROC,0.8237,0.05,0.5,80,72,66,6,1.11,91.67,66,14,82.37,Facile,Facile,Facile / Facile
4087,768,2019,Mathematique,8,2,QROC,0.8843,0.0,0.92,87,83,77,6,1.05,92.77,77,10,88.43,Facile,Trop Facile,Facile / Trop Facile
4917,768,2020,Mathematique,8,2,QROC,0.0663,0.83,0.0,89,81,6,75,1.1,7.41,6,83,6.63,Facile,Trop Difficile,Facile / Trop Difficile
768,769,2015,Mathematique,8,3,QCU,0.8431,0.0,0.86,99,88,83,5,1.12,94.32,83,16,84.31,Difficile,Facile,Difficile / Facile
1598,769,2016,Mathematique,8,3,QCU,0.8759,0.0,0.94,91,86,80,6,1.06,93.02,80,11,87.59,Trop Facile,Trop Facile,Trop Facile / Trop Facile
2428,769,2017,Mathematique,8,3,QCU,0.9001,0.1,0.93,105,99,95,4,1.06,95.96,95,10,90.01,Trop Facile,Trop Facile,Trop Facile / Trop Facile
3258,769,2018,Mathematique,8,3,QCU,0.476,0.3,0.33,115,115,55,60,1.0,47.83,55,60,47.6,Trop Facile,Difficile,Trop Facile / Difficile
4088,769,2019,Mathematique,8,3,QCU,0.9446,0.03,0.97,127,122,120,2,1.04,98.36,120,7,94.46,Trop Facile,Trop Facile,Trop Facile / Trop Facile
4918,769,2020,Mathematique,8,3,QCU,0.9416,0.1,0.92,129,129,121,8,1.0,93.8,121,8,94.16,Trop Facile,Trop Facile,Trop Facile / Trop Facile
769,770,2015,Mathematique,8,4,QCU,0.5643,0.19,0.31,19,12,11,1,1.58,91.67,11,8,56.43,Difficile,Difficile,Difficile / Difficile
1599,770,2016,Mathematique,8,4,QCU,0.2387,0.2,0.24,21,16,5,11,1.31,31.25,5,16,23.87,Trop Facile,Trop Difficile,Trop Facile / Trop Difficile
2429,770,2017,Mathematique,8,4,QCU,0.8736,0.02,0.98,17,17,15,2,1.0,88.24,15,2,87.36,Trop Facile,Trop Facile,Trop Facile / Trop Facile
3259,770,2018,Mathematique,8,4,QCU,0.8703,0.02,0.99,18,16,16,0,1.12,100.0,16,2,87.03,Trop Facile,Trop Facile,Trop Facile / Trop Facile
4089,770,2019,Mathematique,8,4,QCU,0.9695,0.01,0.96,17,16,16,0,1.06,100.0,16,1,96.95,Trop Facile,Trop Facile,Trop Facile / Trop Facile
4919,770,2020,Mathematique,8,4,QCU,0.2032,0.55,0.26,15,13,3,10,1.15,23.08,3,12,20.32,Trop Facile,Trop Difficile,Trop Facile / Trop Difficile
770,771,2015,Mathematique,8,5,QROC,0.4991,0.63,0.2,56,46,28,18,1.22,60.87,28,28,49.91,Difficile,Difficile,Difficile / Difficile
1600,771,2016,Mathematique,8,5,QROC,0.2603,0.71,0.23,53,36,14,22,1.47,38.89,14,39,26.03,Facile,Difficile,Facile / Difficile
2430,771,2017,Mathematique,8,5,QROC,0.8035,0.03,0.64,63,59,51,8,1.07,86.44,51,12,80.35,Facile,Facile,Facile / Facile
3260,771,2018,Mathematique,8,5,QROC,0.7899,0.01,0.62,63,50,50,0,1.26,100.0,50,13,78.99,Facile,Facile,Facile / Facile
4090,771,2019,Mathematique,8,5,QROC,0.8303,0.05,0.67,56,56,46,10,1.0,82.14,46,10,83.03,Facile,Facile,Facile / Facile
4920,771,2020,Mathematique,8,5,QROC,0.7875,0.01,0.67,62,59,49,10,1.05,83.05,49,13,78.75,Facile,Facile,Facile / Facile
771,772,2015,Mathematique,8,6,QCU,0.4665,0.15,0.33,45,36,21,15,1.25,58.33,21,24,46.65,Difficile,Difficile,Difficile / Difficile
1601,772,2016,Mathematique,8,6,QCU,0.3859,0.21,0.34,45,30,17,13,1.5,56.67,17,28,38.59,Trop Facile,Difficile,Trop Facile / Difficile
2431,772,2017,Mathematique,8,6,QCU,0.6159,0.24,0.69,45,39,28,11,1.15,71.79,28,17,61.59,Trop Facile,Adapte,Trop Facile / Adapte
3261,772,2018,Mathematique,8,6,QCU,0.6891,0.08,0.62,49,35,34,1,1.4,97.14,34,15,68.91,Adapte,Adapte,Adapte / Adapte
4091,772,2019,Mathematique,8,6,QCU,0.616,0.02,0.44,57,42,35,7,1.36,83.33,35,22,61.6,Adapte,Adapte,Adapte / Adapte
4921,772,2020,Mathematique,8,6,QCU,0.6957,0.17,0.65,67,63,47,16,1.06,74.6,47,20,69.57,Adapte,Adapte,Adapte / Adapte
772,773,2015,Mathematique,8,7,QCM,0.2143,0.3,0.25,47,37,10,27,1.27,27.03,10,37,21.43,Trop Difficile,Trop Difficile,Trop Difficile / Trop Difficile
1602,773,2016,Mathematique,8,7,QCM,0.7981,0.1,0.78,43,35,34,1,1.23,97.14,34,9,79.81,Facile,Facile,Facile / Facile
2432,773,2017,Mathematique,8,7,QCM,0.8029,0.01,0.74,45,37,36,1,1.22,97.3,36,9,80.29,Facile,Facile,Facile / Facile
3262,773,2018,Mathematique,8,7,QCM,0.8114,0.02,0.79,40,35,32,3,1.14,91.43,32,8,81.14,Facile,Facile,Facile / Facile
4092,773,2019,Mathematique,8,7,QCM,0.4163,0.06,0.37,39,29,16,13,1.34,55.17,16,23,41.63,Facile,Difficile,Facile / Difficile
4922,773,2020,Mathematique,8,7,QCM,0.7953,0.18,0.76,47,41,37,4,1.15,90.24,37,10,79.53,Facile,Facile,Facile / Facile
773,774,2015,Mathematique,9,1,QCU,0.2859,0.03,0.31,11,8,3,5,1.38,37.5,3,8,28.59,Difficile,Difficile,Difficile / Difficile
1603,774,2016,Mathematique,9,1,QCU,0.9283,0.04,0.99,11,10,10,0,1.1,100.0,10,1,92.83,Trop Facile,Trop Facile,Trop Facile / Trop Facile
2433,774,2017,Mathematique,9,1,QCU,0.9813,0.06,0.91,10,10,10,0,1.0,100.0,10,0,98.13,Trop Facile,Trop Facile,Trop Facile / Trop Facile
3263,774,2018,Mathematique,9,1,QCU,0.9914,0.06,0.91,9,9,9,0,1.0,100.0,9,0,99.14,Trop Facile,Trop Facile,Trop Facile / Trop Facile
4093,774,2019,Mathematique,9,1,QCU,0.7006,0.24,0.43,11,9,8,1,1.22,88.89,8,3,70.06,Trop Facile,Adapte,Trop Facile / Adapte
4923,774,2020,Mathematique,9,1,QCU,0.7428,0.27,0.53,9,8,7,1,1.12,87.5,7,2,74.28,Adapte,Adapte,Adapte / Adapte
774,775,2015,Mathematique,9,2,QCU,0.3278,0.04,0.38,90,33,30,3,2.73,90.91,30,60,32.78,Difficile,Difficile,Difficile / Difficile
1604,775,2016,Mathematique,9,2,QCU,0.5598,0.29,0.31,100,99,56,43,1.01,56.57,56,44,55.98,Trop Facile,Difficile,Trop Facile / Difficile
2434,775,2017,Mathematique,9,2,QCU,0.4097,0.17,0.39,104,55,43,12,1.89,78.18,43,61,40.97,Trop Facile,Difficile,Trop Facile / Difficile
3264,775,2018,Mathematique,9,2,QCU,0.0192,0.23,0.28,118,64,2,62,1.84,3.12,2,116,1.92,Trop Facile,Trop Difficile,Trop Facile / Trop Difficile
4094,775,2019,Mathematique,9,2,QCU,0.9913,0.1,0.9,110,110,109,1,1.0,99.09,109,1,99.13,Trop Facile,Trop Facile,Trop Facile / Trop Facile
4924,775,2020,Mathematique,9,2,QCU,0.949,0.09,0.99,104,104,99,5,1.0,95.19,99,5,94.9,Trop Facile,Trop Facile,Trop Facile / Trop Facile
775,776,2015,Mathematique,9,3,QCU,0.714,0.08,0.6,13,11,9,2,1.18,81.82,9,4,71.4,Difficile,Adapte,Difficile / Adapte
1605,776,2016,Mathematique,9,3,QCU,0.6771,0.26,0.47,14,10,9,1,1.4,90.0,9,5,67.71,Adapte,Adapte,Adapte / Adapte
2435,776,2017,Mathematique,9,3,QCU,0.7006,0.12,0.53,16,15,11,4,1.07,73.33,11,5,70.06,Adapte,Adapte,Adapte / Adapte
3265,776,2018,Mathematique,9,3,QCU,0.6388,0.01,0.51,17,11,11,0,1.55,100.0,11,6,63.88,Adapte,Adapte,Adapte / Adapte
4095,776,2019,Mathematique,9,3,QCU,0.6642,0.06,0.62,15,15,10,5,1.0,66.67,10,5,66.42,Adapte,Adapte,Adapte / Adapte
4925,776,2020,Mathematique,9,3,QCU,0.7458,0.1,0.51,17,16,13,3,1.06,81.25,13,4,74.58,Adapte,Adapte,Adapte / Adapte
776,777,2015,Mathematique,9,4,QCM,0.3018,0.39,0.32,64,34,19,15,1.88,55.88,19,45,30.18,Difficile,Difficile,Difficile / Difficile
1606,777,2016,Mathematique,9,4,QCM,0.7002,0.19,0.64,59,59,41,18,1.0,69.49,41,18,70.02,Facile,Adapte,Facile / Adapte
2436,777,2017,Mathematique,9,4,QCM,0.6902,0.22,0.65,49,40,34,6,1.23,85.0,34,15,69.02,Adapte,Adapte,Adapte / Adapte
3266,777,2018,Mathematique,9,4,QCM,0.7301,0.08,0.61,59,49,43,6,1.2,87.76,43,16,73.01,Adapte,Adapte,Adapte / Adapte
4096,777,2019,Mathematique,9,4,QCM,0.7092,0.01,0.52,58,49,41,8,1.18,83.67,41,17,70.92,Adapte,Adapte,Adapte / Adapte
4926,777,2020,Mathematique,9,4,QCM,0.7091,0.04,0.48,69,63,49,14,1.1,77.78,49,20,70.91,Adapte,Adapte,Adapte / Adapte
777,778,2015,Mathematique,9,5,QCM,0.0397,0.4,0.28,36,27,1,26,1.33,3.7,1,35,3.97,Trop Difficile,Trop Difficile,Trop Difficile / Trop Difficile
1607,778,2016,Mathematique,9,5,QCM,0.8069,0.1,0.74,34,32,27,5,1.06,84.38,27,7,80.69,Facile,Facile,Facile / Facile
2437,778,2017,Mathematique,9,5,QCM,0.773,0.01,0.72,40,33,31,2,1.21,93.94,31,9,77.3,Facile,Facile,Facile / Facile
3267,778,2018,Mathematique,9,5,QCM,0.2665,0.45,0.38,48,27,13,14,1.78,48.15,13,35,26.65,Facile,Difficile,Facile / Difficile
4097,778,2019,Mathematique,9,5,QCM,0.7697,0.17,0.78,49,48,38,10,1.02,79.17,38,11,76.97,Facile,Facile,Facile / Facile
4927,778,2020,Mathematique,9,5,QCM,0.226,0.34,0.27,42,26,9,17,1.62,34.62,9,33,22.6,Facile,Trop Difficile,Facile / Trop Difficile
778,779,2015,Mathematique,9,6,QCU,0.8469,0.07,0.85,68,58,58,0,1.17,100.0,58,10,84.69,Facile,Facile,Facile / Facile
1608,779,2016,Mathematique,9,6,QCU,0.3544,0.22,0.34,62,44,22,22,1.41,50.0,22,40,35.44,Trop Facile,Difficile,Trop Facile / Difficile
2438,779,2017,Mathematique,9,6,QCU,0.7055,0.01,0.58,57,43,40,3,1.33,93.02,40,17,70.55,Trop Facile,Adapte,Trop Facile / Adapte
3268,779,2018,Mathematique,9,6,QCU,0.6204,0.07,0.62,54,52,34,18,1.04,65.38,34,20,62.04,Adapte,Adapte,Adapte / Adapte
4098,779,2019,Mathematique,9,6,QCU,0.7396,0.17,0.48,45,36,33,3,1.25,91.67,33,12,73.96,Adapte,Adapte,Adapte / Adapte
4928,779,2020,Mathematique,9,6,QCU,0.7187,0.23,0.44,36,33,26,7,1.09,78.79,26,10,71.87,Adapte,Adapte,Adapte / Adapte
779,780,2015,Mathematique,10,1,QCU,0.953,0.0,0.95,73,71,70,1,1.03,98.59,70,3,95.3,Trop Facile,Trop Facile,Trop Facile / Trop Facile
1609,780,2016,Mathematique,10,1,QCU,0.9006,0.06,0.96,62,59,56,3,1.05,94.92,56,6,90.06,Trop Facile,Trop Facile,Trop Facile / Trop Facile
2439,780,2017,Mathematique,10,1,QCU,0.0495,0.01,0.21,64,47,3,44,1.36,6.38,3,61,4.95,Trop Facile,Trop Difficile,Trop Facile / Trop Difficile
3269,780,2018,Mathematique,10,1,QCU,0.9448,0.05,0.95,51,49,48,1,1.04,97.96,48,3,94.48,Trop Facile,Trop Facile,Trop Facile / Trop Facile
4099,780,2019,Mathematique,10,1,QCU,0.9346,0.08,0.93,57,55,53,2,1.04,96.36,53,4,93.46,Trop Facile,Trop Facile,Trop Facile / Trop Facile
4929,780,2020,Mathematique,10,1,QCU,0.4289,0.0,0.36,64,60,27,33,1.07,45.0,27,37,42.89,Trop Facile,Difficile,Trop Facile / Difficile
780,781,2015,Mathematique,10,2,QCU,0.9792,0.02,0.91,97,96,95,1,1.01,98.96,95,2,97.92,Trop Facile,Trop Facile,Trop Facile / Trop Facile
1610,781,2016,Mathematique,10,2,QCU,0.9995,0.04,0.99,90,90,90,0,1.0,100.0,90,0,99.95,Trop Facile,Trop Facile,Trop Facile / Trop Facile
2440,781,2017,Mathematique,10,2,QCU,0.0234,0.72,0.26,79,41,2,39,1.93,4.88,2,77,2.34,Trop Facile,Trop Difficile,Trop Facile / Trop Difficile
3270,781,2018,Mathematique,10,2,QCU,0.2308,0.04,0.3,87,49,20,29,1.78,40.82,20,67,23.08,Trop Facile,Trop Difficile,Trop Facile / Trop Difficile
4100,781,2019,Mathematique,10,2,QCU,0.0116,0.61,0.28,104,85,1,84,1.22,1.18,1,103,1.16,Trop Facile,Trop Difficile,Trop Facile / Trop Difficile
4930,781,2020,Mathematique,10,2,QCU,0.8461,0.14,0.75,103,99,87,12,1.04,87.88,87,16,84.61,Trop Facile,Facile,Trop Facile / Facile
781,782,2015,Mathematique,10,3,QCM,0.1749,0.31,0.26,33,22,6,16,1.5,27.27,6,27,17.49,Trop Difficile,Trop Difficile,Trop Difficile / Trop Difficile
1611,782,2016,Mathematique,10,3,QCM,0.7608,0.16,0.76,32,30,24,6,1.07,80.0,24,8,76.08,Facile,Facile,Facile / Facile
2441,782,2017,Mathematique,10,3,QCM,0.7865,0.09,0.73,35,35,28,7,1.0,80.0,28,7,78.65,Facile,Facile,Facile / Facile
3271,782,2018,Mathematique,10,3,QCM,0.7691,0.1,0.77,34,33,26,7,1.03,78.79,26,8,76.91,Facile,Facile,Facile / Facile
4101,782,2019,Mathematique,10,3,QCM,0.1211,0.55,0.3,41,20,5,15,2.05,25.0,5,36,12.11,Facile,Trop Difficile,Facile / Trop Difficile
4931,782,2020,Mathematique,10,3,QCM,0.7675,0.14,0.71,49,46,38,8,1.07,82.61,38,11,76.75,Facile,Facile,Facile / Facile
782,783,2015,Mathematique,10,4,QCM,0.0334,0.63,0.28,44,40,1,39,1.1,2.5,1,43,3.34,Trop Difficile,Trop Difficile,Trop Difficile / Trop Difficile
1612,783,2016,Mathematique,10,4,QCM,0.0055,0.61,0.25,41,11,0,11,3.73,0.0,0,41,0.55,Facile,Trop Difficile,Facile / Trop Difficile
2442,783,2017,Mathematique,10,4,QCM,0.8356,0.14,0.74,38,32,32,0,1.19,100.0,32,6,83.56,Facile,Facile,Facile / Facile
3272,783,2018,Mathematique,10,4,QCM,0.7647,0.06,0.76,46,36,35,1,1.28,97.22,35,11,76.47,Facile,Facile,Facile / Facile
4102,783,2019,Mathematique,10,4,QCM,0.8246,0.04,0.77,39,36,32,4,1.08,88.89,32,7,82.46,Facile,Facile,Facile / Facile
4932,783,2020,Mathematique,10,4,QCM,0.8004,0.1,0.79,44,38,35,3,1.16,92.11,35,9,80.04,Facile,Facile,Facile / Facile
783,784,2015,Mathematique,10,5,QCU,0.819,0.06,0.85,87,81,71,10,1.07,87.65,71,16,81.9,Facile,Facile,Facile / Facile
1613,784,2016,Mathematique,10,5,QCU,0.9065,0.04,0.95,87,81,79,2,1.07,97.53,79,8,90.65,Trop Facile,Trop Facile,Trop Facile / Trop Facile
2443,784,2017,Mathematique,10,5,QCU,0.9456,0.1,0.96,85,84,80,4,1.01,95.24,80,5,94.56,Trop Facile,Trop Facile,Trop Facile / Trop Facile
3273,784,2018,Mathematique,10,5,QCU,0.4625,0.01,0.35,81,76,37,39,1.07,48.68,37,44,46.25,Trop Facile,Difficile,Trop Facile / Difficile
4103,784,2019,Mathematique,10,5,QCU,0.7625,0.01,0.86,94,91,72,19,1.03,79.12,72,22,76.25,Trop Facile,Facile,Trop Facile / Facile
4933,784,2020,Mathematique,10,5,QCU,0.9627,0.04,0.97,84,84,81,3,1.0,96.43,81,3,96.27,Trop Facile,Trop Facile,Trop Facile / Trop Facile
784,785,2015,Mathematique,10,6,QCM,0.6797,0.05,0.66,8,7,5,2,1.14,71.43,5,3,67.97,Adapte,Adapte,Adapte / Adapte
1614,785,2016,Mathematique,10,6,QCM,0.7474,0.05,0.59,8,8,6,2,1.0,75.0,6,2,74.74,Adapte,Adapte,Adapte / Adapte
2444,785,2017,Mathematique,10,6,QCM,0.7324,0.1,0.56,6,5,4,1,1.2,80.0,4,2,73.24,Adapte,Adapte,Adapte / Adapte
3274,785,2018,Mathematique,10,6,QCM,0.6164,0.11,0.59,7,7,4,3,1.0,57.14,4,3,61.64,Adapte,Adapte,Adapte / Adapte
4104,785,2019,Mathematique,10,6,QCM,0.6162,0.22,0.51,6,5,4,1,1.2,80.0,4,2,61.62,Adapte,Adapte,Adapte / Adapte
4934,785,2020,Mathematique,10,6,QCM,0.6342,0.08,0.52,5,3,3,0,1.67,100.0,3,2,63.42,Adapte,Adapte,Adapte / Adapte
785,786,2015,Mathematique,10,7,QCM,0.8124,0.09,0.76,67,62,54,8,1.08,87.1,54,13,81.24,Trop Facile,Facile,Trop Facile / Facile
1615,786,2016,Mathematique,10,7,QCM,0.826,0.17,0.74,67,66,55,11,1.02,83.33,55,12,82.6,Facile,Facile,Facile / Facile
2445,786,2017,Mathematique,10,7,QCM,0.7385,0.12,0.49,62,49,46,3,1.27,93.88,46,16,73.85,Facile,Adapte,Facile / Adapte
3275,786,2018,Mathematique,10,7,QCM,0.693,0.0,0.44,55,46,38,8,1.2,82.61,38,17,69.3,Adapte,Adapte,Adapte / Adapte
4105,786,2019,Mathematique,10,7,QCM,0.6579,0.29,0.69,46,38,30,8,1.21,78.95,30,16,65.79,Adapte,Adapte,Adapte / Adapte
4935,786,2020,Mathematique,10,7,QCM,0.746,0.24,0.48,53,46,40,6,1.15,86.96,40,13,74.6,Adapte,Adapte,Adapte / Adapte
786,787,2015,Mathematique,10,8,QCU,0.6485,0.08,0.65,43,29,28,1,1.48,96.55,28,15,64.85,Facile,Adapte,Facile / Adapte
1616,787,2016,Mathematique,10,8,QCU,0.606,0.28,0.44,41,28,25,3,1.46,89.29,25,16,60.6,Adapte,Adapte,Adapte / Adapte
2446,787,2017,Mathematique,10,8,QCU,0.6605,0.09,0.46,39,35,26,9,1.11,74.29,26,13,66.05,Adapte,Adapte,Adapte / Adapte
3276,787,2018,Mathematique,10,8,QCU,0.7346,0.12,0.69,45,36,33,3,1.25,91.67,33,12,73.46,Adapte,Adapte,Adapte / Adapte
4106,787,2019,Mathematique,10,8,QCU,0.6702,0.01,0.51,47,33,31,2,1.42,93.94,31,16,67.02,Adapte,Adapte,Adapte / Adapte
4936,787,2020,Mathematique,10,8,QCU,0.6271,0.04,0.45,51,38,32,6,1.34,84.21,32,19,62.71,Adapte,Adapte,Adapte / Adapte
787,788,2015,Mathematique,10,9,QCU,0.9784,0.0,1.0,84,83,82,1,1.01,98.8,82,2,97.84,Trop Facile,Trop Facile,Trop Facile / Trop Facile
1617,788,2016,Mathematique,10,9,QCU,0.7496,0.25,0.69,85,68,64,4,1.25,94.12,64,21,74.96,Trop Facile,Adapte,Trop Facile / Adapte
2447,788,2017,Mathematique,10,9,QCU,0.7073,0.07,0.51,94,88,66,22,1.07,75.0,66,28,70.73,Adapte,Adapte,Adapte / Adapte
3277,788,2018,Mathematique,10,9,QCU,0.6837,0.13,0.61,103,97,70,27,1.06,72.16,70,33,68.37,Adapte,Adapte,Adapte / Adapte
4107,788,2019,Mathematique,10,9,QCU,0.7479,0.25,0.58,106,97,79,18,1.09,81.44,79,27,74.79,Adapte,Adapte,Adapte / Adapte
4937,788,2020,Mathematique,10,9,QCU,0.7473,0.14,0.64,97,88,72,16,1.1,81.82,72,25,74.73,Adapte,Adapte,Adapte / Adapte
788,789,2015,Mathematique,10,10,QROC,0.1959,0.89,0.05,66,56,13,43,1.18,23.21,13,53,19.59,Difficile,Trop Difficile,Difficile / Trop Difficile
1618,789,2016,Mathematique,10,10,QROC,0.8029,0.09,0.46,58,55,47,8,1.05,85.45,47,11,80.29,Facile,Facile,Facile / Facile
2448,789,2017,Mathematique,10,10,QROC,0.8203,0.04,0.68,58,56,48,8,1.04,85.71,48,10,82.03,Facile,Facile,Facile / Facile
3278,789,2018,Mathematique,10,10,QROC,0.4465,0.65,0.18,48,47,21,26,1.02,44.68,21,27,44.65,Facile,Difficile,Facile / Difficile
4108,789,2019,Mathematique,10,10,QROC,0.7291,0.44,0.27,53,46,39,7,1.15,84.78,39,14,72.91,Facile,Adapte,Facile / Adapte
4938,789,2020,Mathematique,10,10,QROC,0.6172,0.26,0.34,44,29,27,2,1.52,93.1,27,17,61.72,Adapte,Adapte,Adapte / Adapte
789,790,2015,Mathematique,11,1,QROC,0.9453,0.03,0.51,81,79,77,2,1.03,97.47,77,4,94.53,Trop Difficile,Trop Facile,Trop Difficile / Trop Facile
1619,790,2016,Mathematique,11,1,QROC,0.8063,0.11,0.69,85,71,69,2,1.2,97.18,69,16,80.63,Facile,Facile,Facile / Facile
2449,790,2017,Mathematique,11,1,QROC,0.7075,0.21,0.39,79,78,56,22,1.01,71.79,56,23,70.75,Facile,Adapte,Facile / Adapte
3279,790,2018,Mathematique,11,1,QROC,0.702,0.37,0.27,67,49,47,2,1.37,95.92,47,20,70.2,Adapte,Adapte,Adapte / Adapte
4109,790,2019,Mathematique,11,1,QROC,0.6422,0.45,0.33,61,46,39,7,1.33,84.78,39,22,64.22,Adapte,Adapte,Adapte / Adapte
4939,790,2020,Mathematique,11,1,QROC,0.7124,0.44,0.27,49,38,35,3,1.29,92.11,35,14,71.24,Adapte,Adapte,Adapte / Adapte
790,791,2015,Mathematique,11,2,QCU,0.0377,0.26,0.27,45,23,2,21,1.96,8.7,2,43,3.77,Trop Difficile,Trop Difficile,Trop Difficile / Trop Difficile
1620,791,2016,Mathematique,11,2,QCU,0.6389,0.29,0.48,51,38,33,5,1.34,86.84,33,18,63.89,Trop Facile,Adapte,Trop Facile / Adapte
2450,791,2017,Mathematique,11,2,QCU,0.7162,0.21,0.53,54,40,39,1,1.35,97.5,39,15,71.62,Adapte,Adapte,Adapte / Adapte
3280,791,2018,Mathematique,11,2,QCU,0.657,0.14,0.59,63,53,41,12,1.19,77.36,41,22,65.7,Adapte,Adapte,Adapte / Adapte
4110,791,2019,Mathematique,11,2,QCU,0.7066,0.1,0.58,62,61,44,17,1.02,72.13,44,18,70.66,Adapte,Adapte,Adapte / Adapte
4940,791,2020,Mathematique,11,2,QCU,0.6258,0.16,0.67,72,50,45,5,1.44,90.0,45,27,62.58,Adapte,Adapte,Adapte / Adapte
791,792,2015,Mathematique,11,3,QO,0.1101,0.96,0.02,15,8,2,6,1.88,25.0,2,13,11.01,Trop Difficile,Trop Difficile,Trop Difficile / Trop Difficile
1621,792,2016,Mathematique,11,3,QO,0.7461,0.69,0.23,16,13,12,1,1.23,92.31,12,4,74.61,Adapte,Adapte,Adapte / Adapte
2451,792,2017,Mathematique,11,3,QO,0.6274,0.42,0.17,15,12,9,3,1.25,75.0,9,6,62.74,Adapte,Adapte,Adapte / Adapte
3281,792,2018,Mathematique,11,3,QO,0.691,0.37,0.2,13,12,9,3,1.08,75.0,9,4,69.1,Adapte,Adapte,Adapte / Adapte
4111,792,2019,Mathematique,11,3,QO,0.6437,0.39,0.16,11,7,7,0,1.57,100.0,7,4,64.37,Adapte,Adapte,Adapte / Adapte
4941,792,2020,Mathematique,11,3,QO,0.6407,0.6,0.21,11,8,7,1,1.38,87.5,7,4,64.07,Adapte,Adapte,Adapte / Adapte
792,793,2015,Mathematique,11,4,QCU,0.8896,0.06,0.96,98,91,87,4,1.08,95.6,87,11,88.96,Facile,Trop Facile,Facile / Trop Facile
1622,793,2016,Mathematique,11,4,QCU,0.2285,0.17,0.23,115,96,26,70,1.2,27.08,26,89,22.85,Trop Facile,Trop Difficile,Trop Facile / Trop Difficile
2452,793,2017,Mathematique,11,4,QCU,0.9003,0.02,0.94,126,115,113,2,1.1,98.26,113,13,90.03,Trop Facile,Trop Facile,Trop Facile / Trop Facile
3282,793,2018,Mathematique,11,4,QCU,0.764,0.18,0.76,115,99,88,11,1.16,88.89,88,27,76.4,Trop Facile,Facile,Trop Facile / Facile
4112,793,2019,Mathematique,11,4,QCU,0.9312,0.06,0.95,138,129,129,0,1.07,100.0,129,9,93.12,Trop Facile,Trop Facile,Trop Facile / Trop Facile
4942,793,2020,Mathematique,11,4,QCU,0.9839,0.01,0.99,113,111,111,0,1.02,100.0,111,2,98.39,Trop Facile,Trop Facile,Trop Facile / Trop Facile
793,794,2015,Mathematique,11,5,QCU,0.6567,0.05,0.54,8,6,5,1,1.33,83.33,5,3,65.67,Adapte,Adapte,Adapte / Adapte
1623,794,2016,Mathematique,11,5,QCU,0.7104,0.19,0.44,9,8,6,2,1.12,75.0,6,3,71.04,Adapte,Adapte,Adapte / Adapte
2453,794,2017,Mathematique,11,5,QCU,0.6175,0.27,0.41,9,8,6,2,1.12,75.0,6,3,61.75,Adapte,Adapte,Adapte / Adapte
3283,794,2018,Mathematique,11,5,QCU,0.6975,0.04,0.62,7,7,5,2,1.0,71.43,5,2,69.75,Adapte,Adapte,Adapte / Adapte
4113,794,2019,Mathematique,11,5,QCU,0.7309,0.0,0.58,6,4,4,0,1.5,100.0,4,2,73.09,Adapte,Adapte,Adapte / Adapte
4943,794,2020,Mathematique,11,5,QCU,0.6464,0.02,0.64,5,4,3,1,1.25,75.0,3,2,64.64,Adapte,Adapte,Adapte / Adapte
794,795,2015,Mathematique,11,6,QCU,0.4538,0.26,0.34,36,31,16,15,1.16,51.61,16,20,45.38,Trop Facile,Difficile,Trop Facile / Difficile
1624,795,2016,Mathematique,11,6,QCU,0.8682,0.02,0.97,33,31,29,2,1.06,93.55,29,4,86.82,Trop Facile,Trop Facile,Trop Facile / Trop Facile
2454,795,2017,Mathematique,11,6,QCU,0.1334,0.14,0.23,31,29,4,25,1.07,13.79,4,27,13.34,Trop Facile,Trop Difficile,Trop Facile / Trop Difficile
3284,795,2018,Mathematique,11,6,QCU,0.9478,0.03,0.93,37,36,35,1,1.03,97.22,35,2,94.78,Trop Facile,Trop Facile,Trop Facile / Trop Facile
4114,795,2019,Mathematique,11,6,QCU,0.8645,0.0,0.96,40,36,35,1,1.11,97.22,35,5,86.45,Trop Facile,Trop Facile,Trop Facile / Trop Facile
4944,795,2020,Mathematique,11,6,QCU,0.945,0.04,0.94,40,39,38,1,1.03,97.44,38,2,94.5,Trop Facile,Trop Facile,Trop Facile / Trop Facile
795,796,2015,Mathematique,11,7,QCM,0.9885,0.02,0.9,26,26,26,0,1.0,100.0,26,0,98.85,Trop Facile,Trop Facile,Trop Facile / Trop Facile
1625,796,2016,Mathematique,11,7,QCM,0.8178,0.03,0.76,24,20,20,0,1.2,100.0,20,4,81.78,Facile,Facile,Facile / Facile
2455,796,2017,Mathematique,11,7,QCM,0.8215,0.11,0.71,29,25,24,1,1.16,96.0,24,5,82.15,Facile,Facile,Facile / Facile
3285,796,2018,Mathematique,11,7,QCM,0.7831,0.14,0.76,31,26,24,2,1.19,92.31,24,7,78.31,Facile,Facile,Facile / Facile
4115,796,2019,Mathematique,11,7,QCM,0.8337,0.09,0.79,36,35,30,5,1.03,85.71,30,6,83.37,Facile,Facile,Facile / Facile
4945,796,2020,Mathematique,11,7,QCM,0.1053,0.29,0.27,31,25,3,22,1.24,12.0,3,28,10.53,Facile,Trop Difficile,Facile / Trop Difficile
796,797,2015,Mathematique,11,8,QCM,0.1229,0.18,0.26,75,58,9,49,1.29,15.52,9,66,12.29,Trop Facile,Trop Difficile,Trop Facile / Trop Difficile
1626,797,2016,Mathematique,11,8,QCM,0.8386,0.01,0.73,86,75,72,3,1.15,96.0,72,14,83.86,Facile,Facile,Facile / Facile
2456,797,2017,Mathematique,11,8,QCM,0.83,0.09,0.72,99,87,82,5,1.14,94.25,82,17,83.0,Facile,Facile,Facile / Facile
3286,797,2018,Mathematique,11,8,QCM,0.8411,0.1,0.71,116,113,98,15,1.03,86.73,98,18,84.11,Facile,Facile,Facile / Facile
4116,797,2019,Mathematique,11,8,QCM,0.8383,0.15,0.7,132,112,111,1,1.18,99.11,111,21,83.83,Facile,Facile,Facile / Facile
4946,797,2020,Mathematique,11,8,QCM,0.3431,0.48,0.33,155,80,53,27,1.94,66.25,53,102,34.31,Facile,Difficile,Facile / Difficile
797,798,2015,Mathematique,12,1,QO,0.4443,0.86,0.02,84,42,37,5,2.0,88.1,37,47,44.43,Difficile,Difficile,Difficile / Difficile
1627,798,2016,Mathematique,12,1,QO,0.6279,0.23,0.27,83,79,52,27,1.05,65.82,52,31,62.79,Adapte,Adapte,Adapte / Adapte
2457,798,2017,Mathematique,12,1,QO,0.6786,0.73,0.26,80,66,54,12,1.21,81.82,54,26,67.86,Adapte,Adapte,Adapte / Adapte
3287,798,2018,Mathematique,12,1,QO,0.6737,0.55,0.29,86,82,58,24,1.05,70.73,58,28,67.37,Adapte,Adapte,Adapte / Adapte
4117,798,2019,Mathematique,12,1,QO,0.6788,0.69,0.25,92,81,62,19,1.14,76.54,62,30,67.88,Adapte,Adapte,Adapte / Adapte
4947,798,2020,Mathematique,12,1,QO,0.7251,0.48,0.28,83,61,60,1,1.36,98.36,60,23,72.51,Adapte,Adapte,Adapte / Adapte
798,799,2015,Mathematique,12,2,QCM,0.0524,0.5,0.27,23,9,1,8,2.56,11.11,1,22,5.24,Facile,Trop Difficile,Facile / Trop Difficile
1628,799,2016,Mathematique,12,2,QCM,0.8,0.01,0.71,19,19,15,4,1.0,78.95,15,4,80.0,Facile,Facile,Facile / Facile
2458,799,2017,Mathematique,12,2,QCM,0.8148,0.02,0.72,20,20,16,4,1.0,80.0,16,4,81.48,Facile,Facile,Facile / Facile
3288,799,2018,Mathematique,12,2,QCM,0.7612,0.1,0.77,23,22,18,4,1.05,81.82,18,5,76.12,Facile,Facile,Facile / Facile
4118,799,2019,Mathematique,12,2,QCM,0.7826,0.13,0.78,28,23,22,1,1.22,95.65,22,6,78.26,Facile,Facile,Facile / Facile
4948,799,2020,Mathematique,12,2,QCM,0.5432,0.05,0.32,26,20,14,6,1.3,70.0,14,12,54.32,Facile,Difficile,Facile / Difficile
799,800,2015,Mathematique,12,3,QROC,0.266,0.74,0.25,56,27,15,12,2.07,55.56,15,41,26.6,Difficile,Difficile,Difficile / Difficile
1629,800,2016,Mathematique,12,3,QROC,0.827,0.02,0.71,46,40,38,2,1.15,95.0,38,8,82.7,Facile,Facile,Facile / Facile
2459,800,2017,Mathematique,12,3,QROC,0.8397,0.0,0.5,43,39,36,3,1.1,92.31,36,7,83.97,Facile,Facile,Facile / Facile
3289,800,2018,Mathematique,12,3,QROC,0.5519,0.57,0.2,36,28,20,8,1.29,71.43,20,16,55.19,Facile,Difficile,Facile / Difficile
4119,800,2019,Mathematique,12,3,QROC,0.9565,0.02,0.98,36,35,34,1,1.03,97.14,34,2,95.65,Facile,Trop Facile,Facile / Trop Facile
4949,800,2020,Mathematique,12,3,QROC,0.0379,0.82,0.05,35,21,1,20,1.67,4.76,1,34,3.79,Facile,Trop Difficile,Facile / Trop Difficile
800,801,2015,Mathematique,12,4,QROC,0.3481,0.73,0.18,85,45,30,15,1.89,66.67,30,55,34.81,Difficile,Difficile,Difficile / Difficile
1630,801,2016,Mathematique,12,4,QROC,0.7976,0.07,0.65,91,78,73,5,1.17,93.59,73,18,79.76,Facile,Facile,Facile / Facile
2460,801,2017,Mathematique,12,4,QROC,0.9069,0.05,0.78,94,92,85,7,1.02,92.39,85,9,90.69,Facile,Trop Facile,Facile / Trop Facile
3290,801,2018,Mathematique,12,4,QROC,0.7834,0.06,0.72,98,91,77,14,1.08,84.62,77,21,78.34,Facile,Facile,Facile / Facile
4120,801,2019,Mathematique,12,4,QROC,0.7617,0.15,0.7,110,108,84,24,1.02,77.78,84,26,76.17,Facile,Facile,Facile / Facile
4950,801,2020,Mathematique,12,4,QROC,0.7822,0.11,0.67,132,107,103,4,1.23,96.26,103,29,78.22,Facile,Facile,Facile / Facile
801,802,2015,Mathematique,12,5,QCU,0.6338,0.09,0.5,69,66,44,22,1.05,66.67,44,25,63.38,Adapte,Adapte,Adapte / Adapte
1631,802,2016,Mathematique,12,5,QCU,0.6465,0.1,0.49,55,37,36,1,1.49,97.3,36,19,64.65,Adapte,Adapte,Adapte / Adapte
2461,802,2017,Mathematique,12,5,QCU,0.7273,0.03,0.42,49,43,36,7,1.14,83.72,36,13,72.73,Adapte,Adapte,Adapte / Adapte
3291,802,2018,Mathematique,12,5,QCU,0.6736,0.21,0.55,58,51,39,12,1.14,76.47,39,19,67.36,Adapte,Adapte,Adapte / Adapte
4121,802,2019,Mathematique,12,5,QCU,0.6165,0.06,0.56,54,38,33,5,1.42,86.84,33,21,61.65,Adapte,Adapte,Adapte / Adapte
4951,802,2020,Mathematique,12,5,QCU,0.6684,0.11,0.52,56,44,37,7,1.27,84.09,37,19,66.84,Adapte,Adapte,Adapte / Adapte
802,803,2015,Mathematique,12,6,QCU,0.0661,0.18,0.29,95,41,6,35,2.32,14.63,6,89,6.61,Adapte,Trop Difficile,Adapte / Trop Difficile
1632,803,2016,Mathematique,12,6,QCU,0.2357,0.2,0.21,77,44,18,26,1.75,40.91,18,59,23.57,Trop Facile,Trop Difficile,Trop Facile / Trop Difficile
2462,803,2017,Mathematique,12,6,QCU,0.9877,0.08,0.92,92,92,91,1,1.0,98.91,91,1,98.77,Trop Facile,Trop Facile,Trop Facile / Trop Facile
3292,803,2018,Mathematique,12,6,QCU,0.8884,0.07,0.98,81,74,72,2,1.09,97.3,72,9,88.84,Trop Facile,Trop Facile,Trop Facile / Trop Facile
4122,803,2019,Mathematique,12,6,QCU,0.9898,0.1,0.96,82,82,81,1,1.0,98.78,81,1,98.98,Trop Facile,Trop Facile,Trop Facile / Trop Facile
4952,803,2020,Mathematique,12,6,QCU,0.878,0.06,0.99,96,94,84,10,1.02,89.36,84,12,87.8,Trop Facile,Trop Facile,Trop Facile / Trop Facile
803,804,2015,Mathematique,12,7,QCU,0.7671,0.19,0.89,62,54,48,6,1.15,88.89,48,14,76.71,Facile,Facile,Facile / Facile
1633,804,2016,Mathematique,12,7,QCU,0.9839,0.01,0.99,58,57,57,0,1.02,100.0,57,1,98.39,Trop Facile,Trop Facile,Trop Facile / Trop Facile
2463,804,2017,Mathematique,12,7,QCU,0.9844,0.07,0.97,46,45,45,0,1.02,100.0,45,1,98.44,Trop Facile,Trop Facile,Trop Facile / Trop Facile
3293,804,2018,Mathematique,12,7,QCU,0.9255,0.04,0.91,46,45,43,2,1.02,95.56,43,3,92.55,Trop Facile,Trop Facile,Trop Facile / Trop Facile
4123,804,2019,Mathematique,12,7,QCU,0.8619,0.1,0.91,47,47,41,6,1.0,87.23,41,6,86.19,Trop Facile,Trop Facile,Trop Facile / Trop Facile
4953,804,2020,Mathematique,12,7,QCU,0.7746,0.17,0.78,39,36,30,6,1.08,83.33,30,9,77.46,Trop Facile,Facile,Trop Facile / Facile
804,805,2015,Mathematique,12,8,QCM,0.9263,0.09,0.95,11,11,10,1,1.0,90.91,10,1,92.63,Trop Facile,Trop Facile,Trop Facile / Trop Facile
1634,805,2016,Mathematique,12,8,QCM,0.7618,0.11,0.7,10,9,8,1,1.11,88.89,8,2,76.18,Facile,Facile,Facile / Facile
2464,805,2017,Mathematique,12,8,QCM,0.3853,0.33,0.32,12,11,5,6,1.09,45.45,5,7,38.53,Facile,Difficile,Facile / Difficile
3294,805,2018,Mathematique,12,8,QCM,0.7612,0.06,0.72,13,12,10,2,1.08,83.33,10,3,76.12,Facile,Facile,Facile / Facile
4124,805,2019,Mathematique,12,8,QCM,0.4166,0.33,0.36,11,5,5,0,2.2,100.0,5,6,41.66,Facile,Difficile,Facile / Difficile
4954,805,2020,Mathematique,12,8,QCM,0.7804,0.14,0.77,12,10,9,1,1.2,90.0,9,3,78.04,Facile,Facile,Facile / Facile
805,806,2015,Mathematique,13,1,QCU,0.0151,0.18,0.26,11,9,0,9,1.22,0.0,0,11,1.51,Trop Difficile,Trop Difficile,Trop Difficile / Trop Difficile
1635,806,2016,Mathematique,13,1,QCU,0.9149,0.01,1.0,10,9,9,0,1.11,100.0,9,1,91.49,Trop Facile,Trop Facile,Trop Facile / Trop Facile
2465,806,2017,Mathematique,13,1,QCU,0.1509,0.0,0.26,12,8,2,6,1.5,25.0,2,10,15.09,Trop Facile,Trop Difficile,Trop Facile / Trop Difficile
3295,806,2018,Mathematique,13,1,QCU,0.7659,0.0,0.77,12,10,9,1,1.2,90.0,9,3,76.59,Trop Facile,Facile,Trop Facile / Facile
4125,806,2019,Mathematique,13,1,QCU,0.9598,0.08,1.0,12,12,12,0,1.0,100.0,12,0,95.98,Trop Facile,Trop Facile,Trop Facile / Trop Facile
4955,806,2020,Mathematique,13,1,QCU,0.8317,0.15,0.87,11,10,9,1,1.1,90.0,9,2,83.17,Trop Facile,Facile,Trop Facile / Facile
806,807,2015,Mathematique,13,2,QO,0.3939,0.8,0.12,66,54,26,28,1.22,48.15,26,40,39.39,Difficile,Difficile,Difficile / Difficile
1636,807,2016,Mathematique,13,2,QO,0.57,0.78,0.08,65,38,37,1,1.71,97.37,37,28,57.0,Adapte,Difficile,Adapte / Difficile
2466,807,2017,Mathematique,13,2,QO,0.6562,0.71,0.29,76,58,50,8,1.31,86.21,50,26,65.62,Adapte,Adapte,Adapte / Adapte
3296,807,2018,Mathematique,13,2,QO,0.6607,0.71,0.21,61,59,40,19,1.03,67.8,40,21,66.07,Adapte,Adapte,Adapte / Adapte
4126,807,2019,Mathematique,13,2,QO,0.6746,0.41,0.18,56,52,38,14,1.08,73.08,38,18,67.46,Adapte,Adapte,Adapte / Adapte
4956,807,2020,Mathematique,13,2,QO,0.6796,0.61,0.17,58,58,39,19,1.0,67.24,39,19,67.96,Adapte,Adapte,Adapte / Adapte
807,808,2015,Mathematique,13,3,QCU,0.3401,0.21,0.35,69,27,23,4,2.56,85.19,23,46,34.01,Difficile,Difficile,Difficile / Difficile
1637,808,2016,Mathematique,13,3,QCU,0.9039,0.02,0.94,79,75,71,4,1.05,94.67,71,8,90.39,Trop Facile,Trop Facile,Trop Facile / Trop Facile
2467,808,2017,Mathematique,13,3,QCU,0.8859,0.07,0.95,78,73,69,4,1.07,94.52,69,9,88.59,Trop Facile,Trop Facile,Trop Facile / Trop Facile
3297,808,2018,Mathematique,13,3,QCU,0.839,0.09,0.87,75,65,63,2,1.15,96.92,63,12,83.9,Trop Facile,Facile,Trop Facile / Facile
4127,808,2019,Mathematique,13,3,QCU,0.1613,0.49,0.29,81,70,13,57,1.16,18.57,13,68,16.13,Trop Facile,Trop Difficile,Trop Facile / Trop Difficile
4957,808,2020,Mathematique,13,3,QCU,0.8899,0.09,0.94,89,84,79,5,1.06,94.05,79,10,88.99,Trop Facile,Trop Facile,Trop Facile / Trop Facile
808,809,2015,Mathematique,13,4,QCU,0.7901,0.03,0.75,22,20,17,3,1.1,85.0,17,5,79.01,Difficile,Facile,Difficile / Facile
1638,809,2016,Mathematique,13,4,QCU,0.6464,0.29,0.54,26,18,17,1,1.44,94.44,17,9,64.64,Trop Facile,Adapte,Trop Facile / Adapte
2468,809,2017,Mathematique,13,4,QCU,0.6686,0.17,0.43,31,27,21,6,1.15,77.78,21,10,66.86,Adapte,Adapte,Adapte / Adapte
3298,809,2018,Mathematique,13,4,QCU,0.6267,0.15,0.5,26,22,16,6,1.18,72.73,16,10,62.67,Adapte,Adapte,Adapte / Adapte
4128,809,2019,Mathematique,13,4,QCU,0.6534,0.29,0.51,31,25,20,5,1.24,80.0,20,11,65.34,Adapte,Adapte,Adapte / Adapte
4958,809,2020,Mathematique,13,4,QCU,0.6185,0.2,0.69,28,17,17,0,1.65,100.0,17,11,61.85,Adapte,Adapte,Adapte / Adapte
809,810,2015,Mathematique,13,5,QCU,0.8016,0.12,0.85,33,28,26,2,1.18,92.86,26,7,80.16,Facile,Facile,Facile / Facile
1639,810,2016,Mathematique,13,5,QCU,0.8983,0.09,0.96,36,33,32,1,1.09,96.97,32,4,89.83,Trop Facile,Trop Facile,Trop Facile / Trop Facile
2469,810,2017,Mathematique,13,5,QCU,0.8992,0.08,0.98,35,34,31,3,1.03,91.18,31,4,89.92,Trop Facile,Trop Facile,Trop Facile / Trop Facile
3299,810,2018,Mathematique,13,5,QCU,0.9214,0.0,0.96,38,36,35,1,1.06,97.22,35,3,92.14,Trop Facile,Trop Facile,Trop Facile / Trop Facile
4129,810,2019,Mathematique,13,5,QCU,0.9695,0.08,0.93,33,33,32,1,1.0,96.97,32,1,96.95,Trop Facile,Trop Facile,Trop Facile / Trop Facile
4959,810,2020,Mathematique,13,5,QCU,0.9989,0.03,0.9,34,34,34,0,1.0,100.0,34,0,99.89,Trop Facile,Trop Facile,Trop Facile / Trop Facile
810,811,2015,Mathematique,13,6,QCU,0.1135,0.11,0.26,100,35,11,24,2.86,31.43,11,89,11.35,Difficile,Trop Difficile,Difficile / Trop Difficile
1640,811,2016,Mathematique,13,6,QCU,0.0578,0.48,0.29,85,66,5,61,1.29,7.58,5,80,5.78,Trop Facile,Trop Difficile,Trop Facile / Trop Difficile
2470,811,2017,Mathematique,13,6,QCU,0.8653,0.03,0.98,79,77,68,9,1.03,88.31,68,11,86.53,Trop Facile,Trop Facile,Trop Facile / Trop Facile
3300,811,2018,Mathematique,13,6,QCU,0.9352,0.08,0.92,84,80,79,1,1.05,98.75,79,5,93.52,Trop Facile,Trop Facile,Trop Facile / Trop Facile
4130,811,2019,Mathematique,13,6,QCU,0.3774,0.33,0.31,76,45,29,16,1.69,64.44,29,47,37.74,Trop Facile,Difficile,Trop Facile / Difficile
4960,811,2020,Mathematique,13,6,QCU,0.8812,0.07,0.91,78,71,69,2,1.1,97.18,69,9,88.12,Trop Facile,Trop Facile,Trop Facile / Trop Facile
811,812,2015,Mathematique,13,7,QCU,0.0007,0.44,0.3,52,21,0,21,2.48,0.0,0,52,0.07,Trop Difficile,Trop Difficile,Trop Difficile / Trop Difficile
1641,812,2016,Mathematique,13,7,QCU,0.8257,0.17,0.88,56,47,46,1,1.19,97.87,46,10,82.57,Trop Facile,Facile,Trop Facile / Facile
2471,812,2017,Mathematique,13,7,QCU,0.0685,0.02,0.21,54,44,4,40,1.23,9.09,4,50,6.85,Trop Facile,Trop Difficile,Trop Facile / Trop Difficile
3301,812,2018,Mathematique,13,7,QCU,0.6075,0.02,0.66,64,58,39,19,1.1,67.24,39,25,60.75,Trop Facile,Adapte,Trop Facile / Adapte
4131,812,2019,Mathematique,13,7,QCU,0.7486,0.06,0.67,76,67,57,10,1.13,85.07,57,19,74.86,Adapte,Adapte,Adapte / Adapte
4961,812,2020,Mathematique,13,7,QCU,0.6777,0.07,0.6,84,66,57,9,1.27,86.36,57,27,67.77,Adapte,Adapte,Adapte / Adapte
812,813,2015,Mathematique,13,8,QCU,0.2667,0.26,0.34,75,53,20,33,1.42,37.74,20,55,26.67,Difficile,Difficile,Difficile / Difficile
1642,813,2016,Mathematique,13,8,QCU,0.9237,0.09,0.91,68,67,63,4,1.01,94.03,63,5,92.37,Trop Facile,Trop Facile,Trop Facile / Trop Facile
2472,813,2017,Mathematique,13,8,QCU,0.9186,0.07,0.92,65,65,60,5,1.0,92.31,60,5,91.86,Trop Facile,Trop Facile,Trop Facile / Trop Facile
3302,813,2018,Mathematique,13,8,QCU,0.8735,0.01,0.97,59,54,52,2,1.09,96.3,52,7,87.35,Trop Facile,Trop Facile,Trop Facile / Trop Facile
4132,813,2019,Mathematique,13,8,QCU,0.8977,0.1,1.0,54,49,48,1,1.1,97.96,48,6,89.77,Trop Facile,Trop Facile,Trop Facile / Trop Facile
4962,813,2020,Mathematique,13,8,QCU,0.9147,0.07,0.95,47,46,43,3,1.02,93.48,43,4,91.47,Trop Facile,Trop Facile,Trop Facile / Trop Facile
813,814,2015,Mathematique,13,9,QCU,0.028,0.31,0.26,10,5,0,5,2.0,0.0,0,10,2.8,Trop Difficile,Trop Difficile,Trop Difficile / Trop Difficile
1643,814,2016,Mathematique,13,9,QCU,0.9008,0.0,0.92,10,9,9,0,1.11,100.0,9,1,90.08,Trop Facile,Trop Facile,Trop Facile / Trop Facile
2473,814,2017,Mathematique,13,9,QCU,0.8853,0.03,0.98,12,11,11,0,1.09,100.0,11,1,88.53,Trop Facile,Trop Facile,Trop Facile / Trop Facile
3303,814,2018,Mathematique,13,9,QCU,0.1156,0.22,0.28,11,9,1,8,1.22,11.11,1,10,11.56,Trop Facile,Trop Difficile,Trop Facile / Trop Difficile
4133,814,2019,Mathematique,13,9,QCU,0.8646,0.01,0.98,13,12,11,1,1.08,91.67,11,2,86.46,Trop Facile,Trop Facile,Trop Facile / Trop Facile
4963,814,2020,Mathematique,13,9,QCU,0.0995,0.04,0.29,11,9,1,8,1.22,11.11,1,10,9.95,Trop Facile,Trop Difficile,Trop Facile / Trop Difficile
814,815,2015,Mathematique,13,10,QCU,0.4943,0.39,0.31,38,30,19,11,1.27,63.33,19,19,49.43,Difficile,Difficile,Difficile / Difficile
1644,815,2016,Mathematique,13,10,QCU,0.4033,0.28,0.35,37,18,15,3,2.06,83.33,15,22,40.33,Trop Facile,Difficile,Trop Facile / Difficile
2474,815,2017,Mathematique,13,10,QCU,0.908,0.02,0.93,40,40,36,4,1.0,90.0,36,4,90.8,Trop Facile,Trop Facile,Trop Facile / Trop Facile
3304,815,2018,Mathematique,13,10,QCU,0.2959,0.02,0.31,37,35,11,24,1.06,31.43,11,26,29.59,Trop Facile,Difficile,Trop Facile / Difficile
4134,815,2019,Mathematique,13,10,QCU,0.8806,0.03,0.99,43,41,38,3,1.05,92.68,38,5,88.06,Trop Facile,Trop Facile,Trop Facile / Trop Facile
4964,815,2020,Mathematique,13,10,QCU,0.8953,0.05,0.92,42,39,38,1,1.08,97.44,38,4,89.53,Trop Facile,Trop Facile,Trop Facile / Trop Facile
815,816,2015,Mathematique,13,11,QCU,0.9988,0.02,0.98,29,29,29,0,1.0,100.0,29,0,99.88,Trop Difficile,Trop Facile,Trop Difficile / Trop Facile
1645,816,2016,Mathematique,13,11,QCU,0.8674,0.07,0.94,23,20,20,0,1.15,100.0,20,3,86.74,Trop Facile,Trop Facile,Trop Facile / Trop Facile
2475,816,2017,Mathematique,13,11,QCU,0.9013,0.03,0.92,18,18,16,2,1.0,88.89,16,2,90.13,Trop Facile,Trop Facile,Trop Facile / Trop Facile
3305,816,2018,Mathematique,13,11,QCU,0.3118,0.26,0.38,15,8,5,3,1.88,62.5,5,10,31.18,Trop Facile,Difficile,Trop Facile / Difficile
4135,816,2019,Mathematique,13,11,QCU,0.9383,0.01,0.94,16,16,15,1,1.0,93.75,15,1,93.83,Trop Facile,Trop Facile,Trop Facile / Trop Facile
4965,816,2020,Mathematique,13,11,QCU,0.8687,0.1,0.94,14,14,12,2,1.0,85.71,12,2,86.87,Trop Facile,Trop Facile,Trop Facile / Trop Facile
816,817,2015,Mathematique,13,12,QCM,0.8277,0.0,0.72,71,67,59,8,1.06,88.06,59,12,82.77,Facile,Facile,Facile / Facile
1646,817,2016,Mathematique,13,12,QCM,0.7897,0.05,0.79,80,64,63,1,1.25,98.44,63,17,78.97,Facile,Facile,Facile / Facile
2476,817,2017,Mathematique,13,12,QCM,0.0855,0.4,0.29,84,51,7,44,1.65,13.73,7,77,8.55,Facile,Trop Difficile,Facile / Trop Difficile
3306,817,2018,Mathematique,13,12,QCM,0.8278,0.08,0.76,91,89,75,14,1.02,84.27,75,16,82.78,Facile,Facile,Facile / Facile
4136,817,2019,Mathematique,13,12,QCM,0.8495,0.05,0.74,100,99,85,14,1.01,85.86,85,15,84.95,Facile,Facile,Facile / Facile
4966,817,2020,Mathematique,13,12,QCM,0.829,0.03,0.8,114,102,95,7,1.12,93.14,95,19,82.9,Facile,Facile,Facile / Facile
817,818,2015,Mathematique,13,13,QCM,0.9695,0.03,0.99,99,96,96,0,1.03,100.0,96,3,96.95,Adapte,Trop Facile,Adapte / Trop Facile
1647,818,2016,Mathematique,13,13,QCM,0.9,0.07,0.92,105,104,94,10,1.01,90.38,94,11,90.0,Facile,Trop Facile,Facile / Trop Facile
2477,818,2017,Mathematique,13,13,QCM,0.7761,0.01,0.74,99,93,77,16,1.06,82.8,77,22,77.61,Facile,Facile,Facile / Facile
3307,818,2018,Mathematique,13,13,QCM,0.7274,0.07,0.63,92,75,67,8,1.23,89.33,67,25,72.74,Facile,Adapte,Facile / Adapte
4137,818,2019,Mathematique,13,13,QCM,0.7363,0.08,0.68,88,66,65,1,1.33,98.48,65,23,73.63,Adapte,Adapte,Adapte / Adapte
4967,818,2020,Mathematique,13,13,QCM,0.6973,0.17,0.41,100,71,70,1,1.41,98.59,70,30,69.73,Adapte,Adapte,Adapte / Adapte
818,819,2015,Mathematique,13,14,QCU,0.8694,0.04,0.92,6,5,5,0,1.2,100.0,5,1,86.94,Facile,Trop Facile,Facile / Trop Facile
1648,819,2016,Mathematique,13,14,QCU,0.8956,0.07,0.9,7,7,6,1,1.0,85.71,6,1,89.56,Trop Facile,Trop Facile,Trop Facile / Trop Facile
2478,819,2017,Mathematique,13,14,QCU,0.9718,0.04,0.98,8,8,8,0,1.0,100.0,8,0,97.18,Trop Facile,Trop Facile,Trop Facile / Trop Facile
3308,819,2018,Mathematique,13,14,QCU,0.3787,0.23,0.37,10,5,4,1,2.0,80.0,4,6,37.87,Trop Facile,Difficile,Trop Facile / Difficile
4138,819,2019,Mathematique,13,14,QCU,0.1841,0.45,0.21,12,7,2,5,1.71,28.57,2,10,18.41,Trop Facile,Trop Difficile,Trop Facile / Trop Difficile
4968,819,2020,Mathematique,13,14,QCU,0.7713,0.12,0.77,10,10,8,2,1.0,80.0,8,2,77.13,Trop Facile,Facile,Trop Facile / Facile
819,820,2015,Mathematique,14,1,QCM,0.6394,0.03,0.69,30,22,19,3,1.36,86.36,19,11,63.94,Adapte,Adapte,Adapte / Adapte
1649,820,2016,Mathematique,14,1,QCM,0.7268,0.29,0.45,24,18,17,1,1.33,94.44,17,7,72.68,Adapte,Adapte,Adapte / Adapte
2479,820,2017,Mathematique,14,1,QCM,0.6289,0.13,0.53,29,21,18,3,1.38,85.71,18,11,62.89,Adapte,Adapte,Adapte / Adapte
3309,820,2018,Mathematique,14,1,QCM,0.6819,0.09,0.67,24,21,16,5,1.14,76.19,16,8,68.19,Adapte,Adapte,Adapte / Adapte
4139,820,2019,Mathematique,14,1,QCM,0.6769,0.2,0.52,23,19,16,3,1.21,84.21,16,7,67.69,Adapte,Adapte,Adapte / Adapte
4969,820,2020,Mathematique,14,1,QCM,0.7196,0.09,0.54,19,14,14,0,1.36,100.0,14,5,71.96,Adapte,Adapte,Adapte / Adapte
820,821,2015,Mathematique,14,2,QCU,0.4138,0.27,0.32,35,32,14,18,1.09,43.75,14,21,41.38,Trop Facile,Difficile,Trop Facile / Difficile
1650,821,2016,Mathematique,14,2,QCU,0.9794,0.03,0.96,32,32,31,1,1.0,96.88,31,1,97.94,Trop Facile,Trop Facile,Trop Facile / Trop Facile
2480,821,2017,Mathematique,14,2,QCU,0.8971,0.03,0.95,34,34,31,3,1.0,91.18,31,3,89.71,Trop Facile,Trop Facile,Trop Facile / Trop Facile
3310,821,2018,Mathematique,14,2,QCU,0.9503,0.02,0.93,33,31,31,0,1.06,100.0,31,2,95.03,Trop Facile,Trop Facile,Trop Facile / Trop Facile
4140,821,2019,Mathematique,14,2,QCU,0.0586,0.13,0.25,39,37,2,35,1.05,5.41,2,37,5.86,Trop Facile,Trop Difficile,Trop Facile / Trop Difficile
4970,821,2020,Mathematique,14,2,QCU,0.9683,0.01,0.96,37,36,36,0,1.03,100.0,36,1,96.83,Trop Facile,Trop Facile,Trop Facile / Trop Facile
821,822,2015,Mathematique,14,3,QCU,0.2206,0.15,0.3,91,37,20,17,2.46,54.05,20,71,22.06,Trop Difficile,Trop Difficile,Trop Difficile / Trop Difficile
1651,822,2016,Mathematique,14,3,QCU,0.9106,0.04,0.94,79,76,72,4,1.04,94.74,72,7,91.06,Trop Facile,Trop Facile,Trop Facile / Trop Facile
2481,822,2017,Mathematique,14,3,QCU,0.9963,0.09,0.96,74,74,74,0,1.0,100.0,74,0,99.63,Trop Facile,Trop Facile,Trop Facile / Trop Facile
3311,822,2018,Mathematique,14,3,QCU,0.8635,0.0,0.92,59,56,51,5,1.05,91.07,51,8,86.35,Trop Facile,Trop Facile,Trop Facile / Trop Facile
4141,822,2019,Mathematique,14,3,QCU,0.6128,0.17,0.43,53,41,32,9,1.29,78.05,32,21,61.28,Trop Facile,Adapte,Trop Facile / Adapte
4971,822,2020,Mathematique,14,3,QCU,0.6204,0.0,0.4,45,33,28,5,1.36,84.85,28,17,62.04,Adapte,Adapte,Adapte / Adapte
822,823,2015,Mathematique,14,4,QROC,0.1938,0.82,0.11,19,13,4,9,1.46,30.77,4,15,19.38,Trop Difficile,Trop Difficile,Trop Difficile / Trop Difficile
1652,823,2016,Mathematique,14,4,QROC,0.3708,0.61,0.21,21,16,8,8,1.31,50.0,8,13,37.08,Facile,Difficile,Facile / Difficile
2482,823,2017,Mathematique,14,4,QROC,0.8475,0.16,0.53,19,17,16,1,1.12,94.12,16,3,84.75,Facile,Facile,Facile / Facile
3312,823,2018,Mathematique,14,4,QROC,0.7875,0.2,0.43,23,22,18,4,1.05,81.82,18,5,78.75,Facile,Facile,Facile / Facile
4142,823,2019,Mathematique,14,4,QROC,0.3547,0.68,0.24,26,16,9,7,1.62,56.25,9,17,35.47,Facile,Difficile,Facile / Difficile
4972,823,2020,Mathematique,14,4,QROC,0.277,0.63,0.22,25,12,7,5,2.08,58.33,7,18,27.7,Facile,Difficile,Facile / Difficile
823,824,2015,Mathematique,14,5,QCU,0.6869,0.06,0.45,98,94,67,27,1.04,71.28,67,31,68.69,Adapte,Adapte,Adapte / Adapte
1653,824,2016,Mathematique,14,5,QCU,0.7499,0.29,0.6,117,94,88,6,1.24,93.62,88,29,74.99,Adapte,Adapte,Adapte / Adapte
2483,824,2017,Mathematique,14,5,QCU,0.7137,0.07,0.63,108,85,77,8,1.27,90.59,77,31,71.37,Adapte,Adapte,Adapte / Adapte
3313,824,2018,Mathematique,14,5,QCU,0.695,0.28,0.44,124,124,86,38,1.0,69.35,86,38,69.5,Adapte,Adapte,Adapte / Adapte
4143,824,2019,Mathematique,14,5,QCU,0.6911,0.17,0.52,148,129,102,27,1.15,79.07,102,46,69.11,Adapte,Adapte,Adapte / Adapte
4973,824,2020,Mathematique,14,5,QCU,0.721,0.25,0.51,175,171,126,45,1.02,73.68,126,49,72.1,Adapte,Adapte,Adapte / Adapte
824,825,2015,Mathematique,14,6,QCM,0.1437,0.34,0.25,77,30,11,19,2.57,36.67,11,66,14.37,Trop Difficile,Trop Difficile,Trop Difficile / Trop Difficile
1654,825,2016,Mathematique,14,6,QCM,0.3785,0.21,0.37,78,73,30,43,1.07,41.1,30,48,37.85,Facile,Difficile,Facile / Difficile
2484,825,2017,Mathematique,14,6,QCM,0.7946,0.0,0.73,73,60,58,2,1.22,96.67,58,15,79.46,Facile,Facile,Facile / Facile
3314,825,2018,Mathematique,14,6,QCM,0.9075,0.07,0.97,75,74,68,6,1.01,91.89,68,7,90.75,Facile,Trop Facile,Facile / Trop Facile
4144,825,2019,Mathematique,14,6,QCM,0.8233,0.06,0.77,77,63,63,0,1.22,100.0,63,14,82.33,Facile,Facile,Facile / Facile
4974,825,2020,Mathematique,14,6,QCM,0.8092,0.13,0.73,68,63,55,8,1.08,87.3,55,13,80.92,Facile,Facile,Facile / Facile
825,826,2015,Mathematique,14,7,QCM,0.6895,0.04,0.61,12,11,8,3,1.09,72.73,8,4,68.95,Trop Facile,Adapte,Trop Facile / Adapte
1655,826,2016,Mathematique,14,7,QCM,0.6521,0.05,0.42,13,11,8,3,1.18,72.73,8,5,65.21,Adapte,Adapte,Adapte / Adapte
2485,826,2017,Mathematique,14,7,QCM,0.745,0.01,0.42,13,13,10,3,1.0,76.92,10,3,74.5,Adapte,Adapte,Adapte / Adapte
3315,826,2018,Mathematique,14,7,QCM,0.7211,0.2,0.62,11,10,8,2,1.1,80.0,8,3,72.11,Adapte,Adapte,Adapte / Adapte
4145,826,2019,Mathematique,14,7,QCM,0.7041,0.23,0.45,12,10,8,2,1.2,80.0,8,4,70.41,Adapte,Adapte,Adapte / Adapte
4975,826,2020,Mathematique,14,7,QCM,0.7426,0.06,0.55,13,10,10,0,1.3,100.0,10,3,74.26,Adapte,Adapte,Adapte / Adapte
826,827,2015,Mathematique,14,8,QCM,0.9063,0.09,0.94,84,83,76,7,1.01,91.57,76,8,90.63,Trop Difficile,Trop Facile,Trop Difficile / Trop Facile
1656,827,2016,Mathematique,14,8,QCM,0.8301,0.2,0.73,76,73,63,10,1.04,86.3,63,13,83.01,Facile,Facile,Facile / Facile
2486,827,2017,Mathematique,14,8,QCM,0.4566,0.37,0.36,68,66,31,35,1.03,46.97,31,37,45.66,Facile,Difficile,Facile / Difficile
3316,827,2018,Mathematique,14,8,QCM,0.8399,0.09,0.7,68,61,57,4,1.11,93.44,57,11,83.99,Facile,Facile,Facile / Facile
4146,827,2019,Mathematique,14,8,QCM,0.8012,0.15,0.7,67,64,54,10,1.05,84.38,54,13,80.12,Facile,Facile,Facile / Facile
4976,827,2020,Mathematique,14,8,QCM,0.6851,0.24,0.43,59,51,40,11,1.16,78.43,40,19,68.51,Facile,Adapte,Facile / Adapte
827,828,2015,Mathematique,15,1,QROC,0.829,0.15,0.69,42,40,35,5,1.05,87.5,35,7,82.9,Facile,Facile,Facile / Facile
1657,828,2016,Mathematique,15,1,QROC,0.7826,0.08,0.71,42,35,33,2,1.2,94.29,33,9,78.26,Facile,Facile,Facile / Facile
2487,828,2017,Mathematique,15,1,QROC,0.7642,0.18,0.62,43,35,33,2,1.23,94.29,33,10,76.42,Facile,Facile,Facile / Facile
3317,828,2018,Mathematique,15,1,QROC,0.7666,0.17,0.44,40,36,31,5,1.11,86.11,31,9,76.66,Facile,Facile,Facile / Facile
4147,828,2019,Mathematique,15,1,QROC,0.8326,0.13,0.53,34,33,28,5,1.03,84.85,28,6,83.26,Facile,Facile,Facile / Facile
4977,828,2020,Mathematique,15,1,QROC,0.8436,0.16,0.46,31,30,26,4,1.03,86.67,26,5,84.36,Facile,Facile,Facile / Facile
828,829,2015,Mathematique,15,2,QROC,0.2307,0.82,0.06,77,39,18,21,1.97,46.15,18,59,23.07,Trop Difficile,Trop Difficile,Trop Difficile / Trop Difficile
1658,829,2016,Mathematique,15,2,QROC,0.8203,0.11,0.6,88,87,72,15,1.01,82.76,72,16,82.03,Facile,Facile,Facile / Facile
2488,829,2017,Mathematique,15,2,QROC,0.8401,0.16,0.75,91,87,76,11,1.05,87.36,76,15,84.01,Facile,Facile,Facile / Facile
3318,829,2018,Mathematique,15,2,QROC,0.6288,0.22,0.33,73,57,46,11,1.28,80.7,46,27,62.88,Facile,Adapte,Facile / Adapte
4148,829,2019,Mathematique,15,2,QROC,0.623,0.33,0.34,81,59,50,9,1.37,84.75,50,31,62.3,Adapte,Adapte,Adapte / Adapte
4978,829,2020,Mathematique,15,2,QROC,0.6824,0.45,0.39,87,75,59,16,1.16,78.67,59,28,68.24,Adapte,Adapte,Adapte / Adapte
829,830,2015,Mathematique,15,3,QROC,0.8285,0.09,0.62,27,24,22,2,1.12,91.67,22,5,82.85,Facile,Facile,Facile / Facile
1659,830,2016,Mathematique,15,3,QROC,0.8316,0.01,0.46,30,27,25,2,1.11,92.59,25,5,83.16,Facile,Facile,Facile / Facile
2489,830,2017,Mathematique,15,3,QROC,0.762,0.1,0.73,29,25,22,3,1.16,88.0,22,7,76.2,Facile,Facile,Facile / Facile
3319,830,2018,Mathematique,15,3,QROC,0.7832,0.05,0.51,28,22,22,0,1.27,100.0,22,6,78.32,Facile,Facile,Facile / Facile
4149,830,2019,Mathematique,15,3,QROC,0.7831,0.16,0.64,29,24,23,1,1.21,95.83,23,6,78.31,Facile,Facile,Facile / Facile
4979,830,2020,Mathematique,15,3,QROC,0.1864,0.98,0.08,28,16,5,11,1.75,31.25,5,23,18.64,Facile,Trop Difficile,Facile / Trop Difficile
