,Quizz_ID,Year,Departement,Chapter_ID,Rank_onChapter,Quizz_Type,Number_Attempts,UniQ_Learner,Sucessful_Learners,Unsucessful_Learners,Avg_Attempts,Percent_Learners_Success,Success_Attempts,Failure_Attempts,TruePrct_Succes,Predict_Difficulty,Correct_Difficulty,Prediction/Correct Difficulty
0,1,2015,Ingenieurie,1,1,QCU,61,56,45,11,1.09,80.36,45,16,74.59,Trop Difficile,Adapte,Trop Difficile / Adapte
830,1,2016,Ingenieurie,1,1,QCU,65,51,44,7,1.27,86.27,44,21,67.86,Adapte,Adapte,Adapte / Adapte
1660,1,2017,Ingenieurie,1,1,QCU,56,55,38,17,1.02,69.09,38,18,67.2,Adapte,Adapte,Adapte / Adapte
2490,1,2018,Ingenieurie,1,1,QCU,55,39,38,1,1.41,97.44,38,17,68.28,Adapte,Adapte,Adapte / Adapte
3320,1,2019,Ingenieurie,1,1,QCU,60,43,41,2,1.4,95.35,41,19,68.29,Adapte,Adapte,Adapte / Adapte
4150,1,2020,Ingenieurie,1,1,QCU,72,57,45,12,1.26,78.95,45,27,63.08,Adapte,Adapte,Adapte / Adapte
1,2,2015,Ingenieurie,1,2,QO,17,16,14,2,1.06,87.5,14,3,84.17,Facile,Facile,Facile / Facile
831,2,2016,Ingenieurie,1,2,QO,19,13,4,9,1.46,30.77,4,15,21.11,Trop Difficile,Trop Difficile,Trop Difficile / Trop Difficile
1661,2,2017,Ingenieurie,1,2,QO,19,11,4,7,1.73,36.36,4,15,18.52,Trop Difficile,Trop Difficile,Trop Difficile / Trop Difficile
2491,2,2018,Ingenieurie,1,2,QO,21,12,1,11,1.75,8.33,1,20,3.02,Trop Difficile,Trop Difficile,Trop Difficile / Trop Difficile
3321,2,2019,Ingenieurie,1,2,QO,24,13,2,11,1.85,15.38,2,22,7.96,Trop Difficile,Trop Difficile,Trop Difficile / Trop Difficile
4151,2,2020,Ingenieurie,1,2,QO,21,18,0,18,1.17,0.0,0,21,1.68,Trop Difficile,Trop Difficile,Trop Difficile / Trop Difficile
2,3,2015,Ingenieurie,1,3,QCM,22,20,2,18,1.1,10.0,2,20,11.11,Trop Difficile,Trop Difficile,Trop Difficile / Trop Difficile
832,3,2016,Ingenieurie,1,3,QCM,23,12,7,5,1.92,58.33,7,16,31.44,Difficile,Difficile,Difficile / Difficile
1662,3,2017,Ingenieurie,1,3,QCM,28,22,18,4,1.27,81.82,18,10,63.62,Difficile,Adapte,Difficile / Adapte
2492,3,2018,Ingenieurie,1,3,QCM,29,20,18,2,1.45,90.0,18,11,62.97,Adapte,Adapte,Adapte / Adapte
3322,3,2019,Ingenieurie,1,3,QCM,28,21,18,3,1.33,85.71,18,10,63.24,Adapte,Adapte,Adapte / Adapte
4152,3,2020,Ingenieurie,1,3,QCM,22,14,13,1,1.57,92.86,13,9,61.17,Adapte,Adapte,Adapte / Adapte
3,4,2015,Ingenieurie,1,4,QCU,48,46,45,1,1.04,97.83,45,3,93.58,Trop Facile,Trop Facile,Trop Facile / Trop Facile
833,4,2016,Ingenieurie,1,4,QCU,47,22,19,3,2.14,86.36,19,28,41.37,Difficile,Difficile,Difficile / Difficile
1663,4,2017,Ingenieurie,1,4,QCU,39,38,21,17,1.03,55.26,21,18,54.82,Difficile,Difficile,Difficile / Difficile
2493,4,2018,Ingenieurie,1,4,QCU,44,43,16,27,1.02,37.21,16,28,36.27,Difficile,Difficile,Difficile / Difficile
3323,4,2019,Ingenieurie,1,4,QCU,41,27,24,3,1.52,88.89,24,17,57.81,Difficile,Difficile,Difficile / Difficile
4153,4,2020,Ingenieurie,1,4,QCU,40,33,12,21,1.21,36.36,12,28,29.66,Difficile,Difficile,Difficile / Difficile
4,5,2015,Ingenieurie,1,5,QCM,56,53,50,3,1.06,94.34,50,6,90.1,Trop Facile,Trop Facile,Trop Facile / Trop Facile
834,5,2016,Ingenieurie,1,5,QCM,67,39,16,23,1.72,41.03,16,51,23.38,Difficile,Trop Difficile,Difficile / Trop Difficile
1664,5,2017,Ingenieurie,1,5,QCM,62,25,16,9,2.48,64.0,16,46,25.78,Difficile,Difficile,Difficile / Difficile
2494,5,2018,Ingenieurie,1,5,QCM,52,31,19,12,1.68,61.29,19,33,36.05,Difficile,Difficile,Difficile / Difficile
3324,5,2019,Ingenieurie,1,5,QCM,56,49,17,32,1.14,34.69,17,39,30.54,Difficile,Difficile,Difficile / Difficile
4154,5,2020,Ingenieurie,1,5,QCM,67,64,39,25,1.05,60.94,39,28,58.32,Difficile,Difficile,Difficile / Difficile
5,6,2015,Ingenieurie,1,6,QROC,37,37,21,16,1.0,56.76,21,16,56.8,Difficile,Difficile,Difficile / Difficile
835,6,2016,Ingenieurie,1,6,QROC,34,29,17,12,1.17,58.62,17,17,51.3,Difficile,Difficile,Difficile / Difficile
1665,6,2017,Ingenieurie,1,6,QROC,28,13,7,6,2.15,53.85,7,21,26.02,Difficile,Difficile,Difficile / Difficile
2495,6,2018,Ingenieurie,1,6,QROC,31,28,7,21,1.11,25.0,7,24,21.74,Difficile,Trop Difficile,Difficile / Trop Difficile
3325,6,2019,Ingenieurie,1,6,QROC,35,31,19,12,1.13,61.29,19,16,52.97,Difficile,Difficile,Difficile / Difficile
4155,6,2020,Ingenieurie,1,6,QROC,40,21,13,8,1.9,61.9,13,27,33.04,Difficile,Difficile,Difficile / Difficile
6,7,2015,Ingenieurie,1,7,QO,74,54,51,3,1.37,94.44,51,23,69.48,Difficile,Adapte,Difficile / Adapte
836,7,2016,Ingenieurie,1,7,QO,63,53,44,9,1.19,83.02,44,19,70.58,Adapte,Adapte,Adapte / Adapte
1666,7,2017,Ingenieurie,1,7,QO,60,56,39,17,1.07,69.64,39,21,65.05,Adapte,Adapte,Adapte / Adapte
2496,7,2018,Ingenieurie,1,7,QO,64,64,40,24,1.0,62.5,40,24,61.88,Adapte,Adapte,Adapte / Adapte
3326,7,2019,Ingenieurie,1,7,QO,76,54,54,0,1.41,100.0,54,22,71.68,Adapte,Adapte,Adapte / Adapte
4156,7,2020,Ingenieurie,1,7,QO,80,58,56,2,1.38,96.55,56,24,69.81,Adapte,Adapte,Adapte / Adapte
7,8,2015,Ingenieurie,1,8,QCM,44,39,16,23,1.13,41.03,16,28,36.56,Facile,Difficile,Facile / Difficile
837,8,2016,Ingenieurie,1,8,QCM,42,38,14,24,1.11,36.84,14,28,33.88,Difficile,Difficile,Difficile / Difficile
1667,8,2017,Ingenieurie,1,8,QCM,39,13,11,2,3.0,84.62,11,28,27.76,Difficile,Difficile,Difficile / Difficile
2497,8,2018,Ingenieurie,1,8,QCM,36,29,18,11,1.24,62.07,18,18,50.42,Difficile,Difficile,Difficile / Difficile
3327,8,2019,Ingenieurie,1,8,QCM,31,31,30,1,1.0,96.77,30,1,96.71,Difficile,Trop Facile,Difficile / Trop Facile
4157,8,2020,Ingenieurie,1,8,QCM,28,25,7,18,1.12,28.0,7,21,25.77,Difficile,Difficile,Difficile / Difficile
8,9,2015,Ingenieurie,1,9,QCU,89,85,74,11,1.05,87.06,74,15,83.38,Adapte,Facile,Adapte / Facile
838,9,2016,Ingenieurie,1,9,QCU,95,79,65,14,1.2,82.28,65,30,68.4,Difficile,Adapte,Difficile / Adapte
1668,9,2017,Ingenieurie,1,9,QCU,108,107,78,29,1.01,72.9,78,30,72.15,Adapte,Adapte,Adapte / Adapte
2498,9,2018,Ingenieurie,1,9,QCU,121,89,74,15,1.36,83.15,74,47,60.89,Adapte,Adapte,Adapte / Adapte
3328,9,2019,Ingenieurie,1,9,QCU,100,93,62,31,1.08,66.67,62,38,62.01,Adapte,Adapte,Adapte / Adapte
4158,9,2020,Ingenieurie,1,9,QCU,106,83,76,7,1.28,91.57,76,30,71.27,Adapte,Adapte,Adapte / Adapte
9,10,2015,Ingenieurie,2,1,QCM,28,21,21,0,1.33,100.0,21,7,76.34,Difficile,Facile,Difficile / Facile
839,10,2016,Ingenieurie,2,1,QCM,32,32,0,32,1.0,0.0,0,32,1.24,Difficile,Trop Difficile,Difficile / Trop Difficile
1669,10,2017,Ingenieurie,2,1,QCM,38,27,19,8,1.41,70.37,19,19,50.8,Difficile,Difficile,Difficile / Difficile
2499,10,2018,Ingenieurie,2,1,QCM,45,42,29,13,1.07,69.05,29,16,65.46,Difficile,Adapte,Difficile / Adapte
3329,10,2019,Ingenieurie,2,1,QCM,42,38,29,9,1.11,76.32,29,13,70.14,Adapte,Adapte,Adapte / Adapte
4159,10,2020,Ingenieurie,2,1,QCM,38,33,25,8,1.15,75.76,25,13,65.23,Adapte,Adapte,Adapte / Adapte
10,11,2015,Ingenieurie,2,2,QCU,63,58,50,8,1.09,86.21,50,13,80.1,Facile,Facile,Facile / Facile
840,11,2016,Ingenieurie,2,2,QCU,56,51,26,25,1.1,50.98,26,30,45.67,Difficile,Difficile,Difficile / Difficile
1670,11,2017,Ingenieurie,2,2,QCU,59,58,54,4,1.02,93.1,54,5,91.43,Difficile,Trop Facile,Difficile / Trop Facile
2500,11,2018,Ingenieurie,2,2,QCU,66,47,32,15,1.4,68.09,32,34,47.86,Difficile,Difficile,Difficile / Difficile
3330,11,2019,Ingenieurie,2,2,QCU,59,52,23,29,1.13,44.23,23,36,38.66,Difficile,Difficile,Difficile / Difficile
4160,11,2020,Ingenieurie,2,2,QCU,58,58,58,0,1.0,100.0,58,0,99.23,Difficile,Trop Facile,Difficile / Trop Facile
11,12,2015,Ingenieurie,2,3,QCM,18,16,15,1,1.12,93.75,15,3,81.04,Facile,Facile,Facile / Facile
841,12,2016,Ingenieurie,2,3,QCM,15,14,12,2,1.07,85.71,12,3,76.79,Difficile,Facile,Difficile / Facile
1671,12,2017,Ingenieurie,2,3,QCM,15,12,2,10,1.25,16.67,2,13,12.97,Difficile,Trop Difficile,Difficile / Trop Difficile
2501,12,2018,Ingenieurie,2,3,QCM,18,17,11,6,1.06,64.71,11,7,58.5,Difficile,Difficile,Difficile / Difficile
3331,12,2019,Ingenieurie,2,3,QCM,15,13,12,1,1.15,92.31,12,3,79.79,Difficile,Facile,Difficile / Facile
4161,12,2020,Ingenieurie,2,3,QCM,16,16,12,4,1.0,75.0,12,4,77.54,Difficile,Facile,Difficile / Facile
12,13,2015,Ingenieurie,2,4,QCM,34,34,23,11,1.0,67.65,23,11,67.96,Trop Facile,Adapte,Trop Facile / Adapte
842,13,2016,Ingenieurie,2,4,QCM,29,22,18,4,1.32,81.82,18,11,61.65,Adapte,Adapte,Adapte / Adapte
1672,13,2017,Ingenieurie,2,4,QCM,35,27,23,4,1.3,85.19,23,12,65.21,Adapte,Adapte,Adapte / Adapte
2502,13,2018,Ingenieurie,2,4,QCM,38,35,27,8,1.09,77.14,27,11,72.33,Adapte,Adapte,Adapte / Adapte
3332,13,2019,Ingenieurie,2,4,QCM,32,23,23,0,1.39,100.0,23,9,72.84,Adapte,Adapte,Adapte / Adapte
4162,13,2020,Ingenieurie,2,4,QCM,31,26,23,3,1.19,88.46,23,8,74.11,Adapte,Adapte,Adapte / Adapte
13,14,2015,Ingenieurie,2,5,QCU,28,25,18,7,1.12,72.0,18,10,65.3,Difficile,Adapte,Difficile / Adapte
843,14,2016,Ingenieurie,2,5,QCU,22,20,15,5,1.1,75.0,15,7,67.24,Adapte,Adapte,Adapte / Adapte
1673,14,2017,Ingenieurie,2,5,QCU,18,14,13,1,1.29,92.86,13,5,69.48,Adapte,Adapte,Adapte / Adapte
2503,14,2018,Ingenieurie,2,5,QCU,17,15,10,5,1.13,66.67,10,7,60.76,Adapte,Adapte,Adapte / Adapte
3333,14,2019,Ingenieurie,2,5,QCU,20,14,14,0,1.43,100.0,14,6,71.14,Adapte,Adapte,Adapte / Adapte
4163,14,2020,Ingenieurie,2,5,QCU,18,17,12,5,1.06,70.59,12,6,65.53,Adapte,Adapte,Adapte / Adapte
14,15,2015,Ingenieurie,2,6,QROC,20,12,11,1,1.67,91.67,11,9,55.22,Difficile,Difficile,Difficile / Difficile
844,15,2016,Ingenieurie,2,6,QROC,23,12,6,6,1.92,50.0,6,17,27.03,Difficile,Difficile,Difficile / Difficile
1674,15,2017,Ingenieurie,2,6,QROC,23,17,8,9,1.35,47.06,8,15,36.79,Difficile,Difficile,Difficile / Difficile
2504,15,2018,Ingenieurie,2,6,QROC,19,19,19,0,1.0,100.0,19,0,98.02,Difficile,Trop Facile,Difficile / Trop Facile
3334,15,2019,Ingenieurie,2,6,QROC,18,16,8,8,1.12,50.0,8,10,45.38,Difficile,Difficile,Difficile / Difficile
4164,15,2020,Ingenieurie,2,6,QROC,14,9,1,8,1.56,11.11,1,13,10.7,Difficile,Trop Difficile,Difficile / Trop Difficile
15,16,2015,Ingenieurie,2,7,QCU,90,81,81,0,1.11,100.0,81,9,90.33,Trop Facile,Trop Facile,Trop Facile / Trop Facile
845,16,2016,Ingenieurie,2,7,QCU,92,55,35,20,1.67,63.64,35,57,37.81,Difficile,Difficile,Difficile / Difficile
1675,16,2017,Ingenieurie,2,7,QCU,81,52,47,5,1.56,90.38,47,34,57.77,Difficile,Difficile,Difficile / Difficile
2505,16,2018,Ingenieurie,2,7,QCU,84,63,16,47,1.33,25.4,16,68,18.81,Difficile,Trop Difficile,Difficile / Trop Difficile
3335,16,2019,Ingenieurie,2,7,QCU,73,45,21,24,1.62,46.67,21,52,28.68,Difficile,Difficile,Difficile / Difficile
4165,16,2020,Ingenieurie,2,7,QCU,60,53,53,0,1.13,100.0,53,7,88.34,Difficile,Trop Facile,Difficile / Trop Facile
16,17,2015,Ingenieurie,2,8,QCU,50,50,47,3,1.0,94.0,47,3,94.99,Trop Facile,Trop Facile,Trop Facile / Trop Facile
846,17,2016,Ingenieurie,2,8,QCU,40,26,20,6,1.54,76.92,20,20,49.95,Difficile,Difficile,Difficile / Difficile
1676,17,2017,Ingenieurie,2,8,QCU,38,37,32,5,1.03,86.49,32,6,84.5,Difficile,Facile,Difficile / Facile
2506,17,2018,Ingenieurie,2,8,QCU,30,28,17,11,1.07,60.71,17,13,56.72,Difficile,Difficile,Difficile / Difficile
3336,17,2019,Ingenieurie,2,8,QCU,24,18,18,0,1.33,100.0,18,6,73.82,Difficile,Adapte,Difficile / Adapte
4166,17,2020,Ingenieurie,2,8,QCU,25,19,18,1,1.32,94.74,18,7,71.24,Adapte,Adapte,Adapte / Adapte
17,18,2015,Ingenieurie,2,9,QCM,88,36,12,24,2.44,33.33,12,76,13.16,Difficile,Trop Difficile,Difficile / Trop Difficile
847,18,2016,Ingenieurie,2,9,QCM,87,85,80,5,1.02,94.12,80,7,92.18,Difficile,Trop Facile,Difficile / Trop Facile
1677,18,2017,Ingenieurie,2,9,QCM,97,56,54,2,1.73,96.43,54,43,55.67,Difficile,Difficile,Difficile / Difficile
2507,18,2018,Ingenieurie,2,9,QCM,113,48,38,10,2.35,79.17,38,75,33.36,Difficile,Difficile,Difficile / Difficile
3337,18,2019,Ingenieurie,2,9,QCM,118,99,54,45,1.19,54.55,54,64,46.03,Difficile,Difficile,Difficile / Difficile
4167,18,2020,Ingenieurie,2,9,QCM,119,51,35,16,2.33,68.63,35,84,29.82,Difficile,Difficile,Difficile / Difficile
18,19,2015,Ingenieurie,2,10,QCM,25,22,20,2,1.14,90.91,20,5,78.89,Facile,Facile,Facile / Facile
848,19,2016,Ingenieurie,2,10,QCM,24,21,11,10,1.14,52.38,11,13,46.78,Difficile,Difficile,Difficile / Difficile
1678,19,2017,Ingenieurie,2,10,QCM,29,26,6,20,1.12,23.08,6,23,21.82,Difficile,Trop Difficile,Difficile / Trop Difficile
2508,19,2018,Ingenieurie,2,10,QCM,27,26,14,12,1.04,53.85,14,13,53.23,Difficile,Difficile,Difficile / Difficile
3338,19,2019,Ingenieurie,2,10,QCM,32,22,10,12,1.45,45.45,10,22,29.78,Difficile,Difficile,Difficile / Difficile
4168,19,2020,Ingenieurie,2,10,QCM,27,22,19,3,1.23,86.36,19,8,72.15,Difficile,Adapte,Difficile / Adapte
19,20,2015,Ingenieurie,2,11,QCU,14,14,11,3,1.0,78.57,11,3,81.69,Difficile,Facile,Difficile / Facile
849,20,2016,Ingenieurie,2,11,QCU,13,11,5,6,1.18,45.45,5,8,35.43,Difficile,Difficile,Difficile / Difficile
1679,20,2017,Ingenieurie,2,11,QCU,12,12,10,2,1.0,83.33,10,2,86.59,Difficile,Trop Facile,Difficile / Trop Facile
2509,20,2018,Ingenieurie,2,11,QCU,14,14,5,9,1.0,35.71,5,9,36.68,Difficile,Difficile,Difficile / Difficile
3339,20,2019,Ingenieurie,2,11,QCU,17,15,8,7,1.13,53.33,8,9,45.72,Difficile,Difficile,Difficile / Difficile
4169,20,2020,Ingenieurie,2,11,QCU,18,13,3,10,1.38,23.08,3,15,17.31,Difficile,Trop Difficile,Difficile / Trop Difficile
20,21,2015,Ingenieurie,2,12,QCM,78,34,11,23,2.29,32.35,11,67,14.6,Trop Difficile,Trop Difficile,Trop Difficile / Trop Difficile
850,21,2016,Ingenieurie,2,12,QCM,62,58,51,7,1.07,87.93,51,11,81.7,Difficile,Facile,Difficile / Facile
1680,21,2017,Ingenieurie,2,12,QCM,69,54,22,32,1.28,40.74,22,47,31.88,Difficile,Difficile,Difficile / Difficile
2510,21,2018,Ingenieurie,2,12,QCM,55,45,14,31,1.22,31.11,14,41,25.38,Difficile,Difficile,Difficile / Difficile
3340,21,2019,Ingenieurie,2,12,QCM,56,41,23,18,1.37,56.1,23,33,40.55,Difficile,Difficile,Difficile / Difficile
4170,21,2020,Ingenieurie,2,12,QCM,49,42,29,13,1.17,69.05,29,20,58.79,Difficile,Difficile,Difficile / Difficile
21,22,2015,Ingenieurie,3,1,QCU,97,91,65,26,1.07,71.43,65,32,66.99,Trop Difficile,Adapte,Trop Difficile / Adapte
851,22,2016,Ingenieurie,3,1,QCU,79,72,54,18,1.1,75.0,54,25,67.77,Adapte,Adapte,Adapte / Adapte
1681,22,2017,Ingenieurie,3,1,QCU,87,64,61,3,1.36,95.31,61,26,70.11,Adapte,Adapte,Adapte / Adapte
2511,22,2018,Ingenieurie,3,1,QCU,86,65,62,3,1.32,95.38,62,24,71.73,Adapte,Adapte,Adapte / Adapte
3341,22,2019,Ingenieurie,3,1,QCU,89,88,62,26,1.01,70.45,62,27,69.43,Adapte,Adapte,Adapte / Adapte
4171,22,2020,Ingenieurie,3,1,QCU,99,88,67,21,1.12,76.14,67,32,67.83,Adapte,Adapte,Adapte / Adapte
22,23,2015,Ingenieurie,3,2,QCM,7,5,3,2,1.4,60.0,3,4,37.74,Difficile,Difficile,Difficile / Difficile
852,23,2016,Ingenieurie,3,2,QCM,7,5,4,1,1.4,80.0,4,3,56.41,Difficile,Difficile,Difficile / Difficile
1682,23,2017,Ingenieurie,3,2,QCM,6,4,3,1,1.5,75.0,3,3,57.7,Difficile,Difficile,Difficile / Difficile
2512,23,2018,Ingenieurie,3,2,QCM,5,4,3,1,1.25,75.0,3,2,66.6,Difficile,Adapte,Difficile / Adapte
3342,23,2019,Ingenieurie,3,2,QCM,6,6,4,2,1.0,66.67,4,2,63.18,Adapte,Adapte,Adapte / Adapte
4172,23,2020,Ingenieurie,3,2,QCM,6,5,4,1,1.2,80.0,4,2,64.99,Adapte,Adapte,Adapte / Adapte
23,24,2015,Ingenieurie,3,3,QCU,10,10,10,0,1.0,100.0,10,0,98.58,Trop Facile,Trop Facile,Trop Facile / Trop Facile
853,24,2016,Ingenieurie,3,3,QCU,12,11,10,1,1.09,90.91,10,2,83.9,Difficile,Facile,Difficile / Facile
1683,24,2017,Ingenieurie,3,3,QCU,11,10,9,1,1.1,90.0,9,2,79.53,Difficile,Facile,Difficile / Facile
2513,24,2018,Ingenieurie,3,3,QCU,9,6,2,4,1.5,33.33,2,7,20.44,Difficile,Trop Difficile,Difficile / Trop Difficile
3343,24,2019,Ingenieurie,3,3,QCU,10,9,6,3,1.11,66.67,6,4,64.76,Difficile,Adapte,Difficile / Adapte
4173,24,2020,Ingenieurie,3,3,QCU,10,9,7,2,1.11,77.78,7,3,66.78,Adapte,Adapte,Adapte / Adapte
24,25,2015,Ingenieurie,3,4,QCM,62,51,38,13,1.22,74.51,38,24,60.7,Trop Difficile,Adapte,Trop Difficile / Adapte
854,25,2016,Ingenieurie,3,4,QCM,63,54,45,9,1.17,83.33,45,18,70.95,Adapte,Adapte,Adapte / Adapte
1684,25,2017,Ingenieurie,3,4,QCM,72,48,44,4,1.5,91.67,44,28,61.02,Adapte,Adapte,Adapte / Adapte
2514,25,2018,Ingenieurie,3,4,QCM,63,52,41,11,1.21,78.85,41,22,64.48,Adapte,Adapte,Adapte / Adapte
3344,25,2019,Ingenieurie,3,4,QCM,76,73,46,27,1.04,63.01,46,30,60.1,Adapte,Adapte,Adapte / Adapte
4174,25,2020,Ingenieurie,3,4,QCM,84,71,51,20,1.18,71.83,51,33,61.25,Adapte,Adapte,Adapte / Adapte
25,26,2015,Ingenieurie,3,5,QCM,73,29,7,22,2.52,24.14,7,66,9.09,Trop Difficile,Trop Difficile,Trop Difficile / Trop Difficile
855,26,2016,Ingenieurie,3,5,QCM,69,32,21,11,2.16,65.62,21,48,29.99,Difficile,Difficile,Difficile / Difficile
1685,26,2017,Ingenieurie,3,5,QCM,77,42,39,3,1.83,92.86,39,38,50.4,Difficile,Difficile,Difficile / Difficile
2515,26,2018,Ingenieurie,3,5,QCM,91,87,46,41,1.05,52.87,46,45,50.93,Difficile,Difficile,Difficile / Difficile
3345,26,2019,Ingenieurie,3,5,QCM,109,82,44,38,1.33,53.66,44,65,40.38,Difficile,Difficile,Difficile / Difficile
4175,26,2020,Ingenieurie,3,5,QCM,125,120,109,11,1.04,90.83,109,16,87.01,Difficile,Trop Facile,Difficile / Trop Facile
26,27,2015,Ingenieurie,3,6,QCU,37,17,5,12,2.18,29.41,5,32,14.44,Trop Difficile,Trop Difficile,Trop Difficile / Trop Difficile
856,27,2016,Ingenieurie,3,6,QCU,44,35,27,8,1.26,77.14,27,17,62.49,Difficile,Adapte,Difficile / Adapte
1686,27,2017,Ingenieurie,3,6,QCU,43,35,30,5,1.23,85.71,30,13,70.81,Adapte,Adapte,Adapte / Adapte
2516,27,2018,Ingenieurie,3,6,QCU,34,28,24,4,1.21,85.71,24,10,71.88,Adapte,Adapte,Adapte / Adapte
3346,27,2019,Ingenieurie,3,6,QCU,30,23,22,1,1.3,95.65,22,8,71.93,Adapte,Adapte,Adapte / Adapte
4176,27,2020,Ingenieurie,3,6,QCU,36,35,25,10,1.03,71.43,25,11,68.87,Adapte,Adapte,Adapte / Adapte
27,28,2015,Ingenieurie,3,7,QCU,66,58,55,3,1.14,94.83,55,11,83.27,Facile,Facile,Facile / Facile
857,28,2016,Ingenieurie,3,7,QCU,64,46,10,36,1.39,21.74,10,54,16.32,Difficile,Trop Difficile,Difficile / Trop Difficile
1687,28,2017,Ingenieurie,3,7,QCU,52,35,26,9,1.49,74.29,26,26,50.38,Difficile,Difficile,Difficile / Difficile
2517,28,2018,Ingenieurie,3,7,QCU,44,39,26,13,1.13,66.67,26,18,58.07,Difficile,Difficile,Difficile / Difficile
3347,28,2019,Ingenieurie,3,7,QCU,42,38,36,2,1.11,94.74,36,6,84.94,Difficile,Facile,Difficile / Facile
4177,28,2020,Ingenieurie,3,7,QCU,49,47,45,2,1.04,95.74,45,4,91.72,Difficile,Trop Facile,Difficile / Trop Facile
28,29,2015,Ingenieurie,3,8,QROC,91,43,2,41,2.12,4.65,2,89,2.63,Trop Difficile,Trop Difficile,Trop Difficile / Trop Difficile
858,29,2016,Ingenieurie,3,8,QROC,85,61,27,34,1.39,44.26,27,58,31.26,Difficile,Difficile,Difficile / Difficile
1688,29,2017,Ingenieurie,3,8,QROC,87,86,78,8,1.01,90.7,78,9,89.31,Difficile,Trop Facile,Difficile / Trop Facile
2518,29,2018,Ingenieurie,3,8,QROC,99,83,55,28,1.19,66.27,55,44,55.26,Difficile,Difficile,Difficile / Difficile
3348,29,2019,Ingenieurie,3,8,QROC,87,84,82,2,1.04,97.62,82,5,94.66,Difficile,Trop Facile,Difficile / Trop Facile
4178,29,2020,Ingenieurie,3,8,QROC,81,73,33,40,1.11,45.21,33,48,40.25,Difficile,Difficile,Difficile / Difficile
29,30,2015,Ingenieurie,3,9,QCU,55,50,48,2,1.1,96.0,48,7,87.56,Difficile,Trop Facile,Difficile / Trop Facile
859,30,2016,Ingenieurie,3,9,QCU,60,49,31,18,1.22,63.27,31,29,51.32,Difficile,Difficile,Difficile / Difficile
1689,30,2017,Ingenieurie,3,9,QCU,66,54,25,29,1.22,46.3,25,41,37.98,Difficile,Difficile,Difficile / Difficile
2519,30,2018,Ingenieurie,3,9,QCU,72,64,36,28,1.12,56.25,36,36,49.66,Difficile,Difficile,Difficile / Difficile
3349,30,2019,Ingenieurie,3,9,QCU,83,62,26,36,1.34,41.94,26,57,31.08,Difficile,Difficile,Difficile / Difficile
4179,30,2020,Ingenieurie,3,9,QCU,81,53,51,2,1.53,96.23,51,30,62.87,Difficile,Adapte,Difficile / Adapte
30,31,2015,Ingenieurie,3,10,QCU,79,30,17,13,2.63,56.67,17,62,21.29,Trop Difficile,Trop Difficile,Trop Difficile / Trop Difficile
860,31,2016,Ingenieurie,3,10,QCU,75,54,4,50,1.39,7.41,4,71,4.89,Difficile,Trop Difficile,Difficile / Trop Difficile
1690,31,2017,Ingenieurie,3,10,QCU,90,84,27,57,1.07,32.14,27,63,30.42,Difficile,Difficile,Difficile / Difficile
2520,31,2018,Ingenieurie,3,10,QCU,74,69,36,33,1.07,52.17,36,38,48.17,Difficile,Difficile,Difficile / Difficile
3350,31,2019,Ingenieurie,3,10,QCU,78,53,33,20,1.47,62.26,33,45,42.57,Difficile,Difficile,Difficile / Difficile
4180,31,2020,Ingenieurie,3,10,QCU,87,80,80,0,1.09,100.0,80,7,92.29,Difficile,Trop Facile,Difficile / Trop Facile
31,32,2015,Ingenieurie,3,11,QCM,9,8,4,4,1.12,50.0,4,5,41.0,Difficile,Difficile,Difficile / Difficile
861,32,2016,Ingenieurie,3,11,QCM,11,7,5,2,1.57,71.43,5,6,41.06,Difficile,Difficile,Difficile / Difficile
1691,32,2017,Ingenieurie,3,11,QCM,13,8,7,1,1.62,87.5,7,6,50.88,Difficile,Difficile,Difficile / Difficile
2521,32,2018,Ingenieurie,3,11,QCM,13,12,4,8,1.08,33.33,4,9,34.32,Difficile,Difficile,Difficile / Difficile
3351,32,2019,Ingenieurie,3,11,QCM,14,6,0,6,2.33,0.0,0,14,0.28,Difficile,Trop Difficile,Difficile / Trop Difficile
4181,32,2020,Ingenieurie,3,11,QCM,14,10,6,4,1.4,60.0,6,8,45.63,Difficile,Difficile,Difficile / Difficile
32,33,2015,Ingenieurie,3,12,QCM,56,55,44,11,1.02,80.0,44,12,78.03,Facile,Facile,Facile / Facile
862,33,2016,Ingenieurie,3,12,QCM,46,44,29,15,1.05,65.91,29,17,62.99,Difficile,Adapte,Difficile / Adapte
1692,33,2017,Ingenieurie,3,12,QCM,48,47,29,18,1.02,61.7,29,19,60.86,Adapte,Adapte,Adapte / Adapte
2522,33,2018,Ingenieurie,3,12,QCM,42,32,30,2,1.31,93.75,30,12,70.41,Adapte,Adapte,Adapte / Adapte
3352,33,2019,Ingenieurie,3,12,QCM,44,44,28,16,1.0,63.64,28,16,62.61,Adapte,Adapte,Adapte / Adapte
4182,33,2020,Ingenieurie,3,12,QCM,44,35,29,6,1.26,82.86,29,15,66.81,Adapte,Adapte,Adapte / Adapte
33,34,2015,Ingenieurie,3,13,QCM,82,82,42,40,1.0,51.22,42,40,51.54,Difficile,Difficile,Difficile / Difficile
863,34,2016,Ingenieurie,3,13,QCM,93,54,53,1,1.72,98.15,53,40,57.13,Difficile,Difficile,Difficile / Difficile
1693,34,2017,Ingenieurie,3,13,QCM,112,50,43,7,2.24,86.0,43,69,37.98,Difficile,Difficile,Difficile / Difficile
2523,34,2018,Ingenieurie,3,13,QCM,93,67,28,39,1.39,41.79,28,65,29.83,Difficile,Difficile,Difficile / Difficile
3353,34,2019,Ingenieurie,3,13,QCM,91,91,88,3,1.0,96.7,88,3,97.24,Difficile,Trop Facile,Difficile / Trop Facile
4183,34,2020,Ingenieurie,3,13,QCM,105,90,51,39,1.17,56.67,51,54,48.63,Difficile,Difficile,Difficile / Difficile
34,35,2015,Ingenieurie,3,14,QCU,86,35,10,25,2.46,28.57,10,76,11.21,Trop Difficile,Trop Difficile,Trop Difficile / Trop Difficile
864,35,2016,Ingenieurie,3,14,QCU,93,60,17,43,1.55,28.33,17,76,17.84,Difficile,Trop Difficile,Difficile / Trop Difficile
1694,35,2017,Ingenieurie,3,14,QCU,110,53,39,14,2.08,73.58,39,71,35.19,Difficile,Difficile,Difficile / Difficile
2524,35,2018,Ingenieurie,3,14,QCU,123,74,66,8,1.66,89.19,66,57,53.57,Difficile,Difficile,Difficile / Difficile
3354,35,2019,Ingenieurie,3,14,QCU,111,103,43,60,1.08,41.75,43,68,38.58,Difficile,Difficile,Difficile / Difficile
4184,35,2020,Ingenieurie,3,14,QCU,106,66,40,26,1.61,60.61,40,66,37.59,Difficile,Difficile,Difficile / Difficile
35,36,2015,Ingenieurie,4,1,QCU,41,39,38,1,1.05,97.44,38,3,91.73,Trop Facile,Trop Facile,Trop Facile / Trop Facile
865,36,2016,Ingenieurie,4,1,QCU,36,31,17,14,1.16,54.84,17,19,46.58,Difficile,Difficile,Difficile / Difficile
1695,36,2017,Ingenieurie,4,1,QCU,40,29,14,15,1.38,48.28,14,26,35.03,Difficile,Difficile,Difficile / Difficile
2525,36,2018,Ingenieurie,4,1,QCU,32,26,20,6,1.23,76.92,20,12,63.44,Difficile,Adapte,Difficile / Adapte
3355,36,2019,Ingenieurie,4,1,QCU,37,34,28,6,1.09,82.35,28,9,74.55,Adapte,Adapte,Adapte / Adapte
4185,36,2020,Ingenieurie,4,1,QCU,32,28,22,6,1.14,78.57,22,10,67.52,Adapte,Adapte,Adapte / Adapte
36,37,2015,Ingenieurie,4,2,QCU,41,29,13,16,1.41,44.83,13,28,32.34,Difficile,Difficile,Difficile / Difficile
866,37,2016,Ingenieurie,4,2,QCU,42,40,22,18,1.05,55.0,22,20,51.69,Difficile,Difficile,Difficile / Difficile
1696,37,2017,Ingenieurie,4,2,QCU,44,39,36,3,1.13,92.31,36,8,81.92,Difficile,Facile,Difficile / Facile
2526,37,2018,Ingenieurie,4,2,QCU,38,30,20,10,1.27,66.67,20,18,51.49,Difficile,Difficile,Difficile / Difficile
3356,37,2019,Ingenieurie,4,2,QCU,39,16,11,5,2.44,68.75,11,28,28.67,Difficile,Difficile,Difficile / Difficile
4186,37,2020,Ingenieurie,4,2,QCU,38,25,14,11,1.52,56.0,14,24,36.42,Difficile,Difficile,Difficile / Difficile
37,38,2015,Ingenieurie,4,3,QCM,8,2,0,2,4.0,0.0,0,8,4.26,Facile,Trop Difficile,Facile / Trop Difficile
867,38,2016,Ingenieurie,4,3,QCM,7,4,4,0,1.75,100.0,4,3,52.51,Difficile,Difficile,Difficile / Difficile
1697,38,2017,Ingenieurie,4,3,QCM,8,3,2,1,2.67,66.67,2,6,28.41,Difficile,Difficile,Difficile / Difficile
2527,38,2018,Ingenieurie,4,3,QCM,8,7,3,4,1.14,42.86,3,5,31.94,Difficile,Difficile,Difficile / Difficile
3357,38,2019,Ingenieurie,4,3,QCM,9,9,8,1,1.0,88.89,8,1,87.78,Difficile,Trop Facile,Difficile / Trop Facile
4187,38,2020,Ingenieurie,4,3,QCM,11,7,3,4,1.57,42.86,3,8,31.15,Difficile,Difficile,Difficile / Difficile
38,39,2015,Ingenieurie,4,4,QCU,80,64,49,15,1.25,76.56,49,31,60.92,Difficile,Adapte,Difficile / Adapte
868,39,2016,Ingenieurie,4,4,QCU,76,57,54,3,1.33,94.74,54,22,71.62,Adapte,Adapte,Adapte / Adapte
1698,39,2017,Ingenieurie,4,4,QCU,86,80,63,17,1.07,78.75,63,23,72.92,Adapte,Adapte,Adapte / Adapte
2528,39,2018,Ingenieurie,4,4,QCU,76,72,52,20,1.06,72.22,52,24,68.29,Adapte,Adapte,Adapte / Adapte
3358,39,2019,Ingenieurie,4,4,QCU,66,52,42,10,1.27,80.77,42,24,63.94,Adapte,Adapte,Adapte / Adapte
4188,39,2020,Ingenieurie,4,4,QCU,74,64,55,9,1.16,85.94,55,19,74.26,Adapte,Adapte,Adapte / Adapte
39,40,2015,Ingenieurie,4,5,QCM,31,30,26,4,1.03,86.67,26,5,84.48,Facile,Facile,Facile / Facile
869,40,2016,Ingenieurie,4,5,QCM,28,25,14,11,1.12,56.0,14,14,48.64,Difficile,Difficile,Difficile / Difficile
1699,40,2017,Ingenieurie,4,5,QCM,34,34,11,23,1.0,32.35,11,23,31.86,Difficile,Difficile,Difficile / Difficile
2529,40,2018,Ingenieurie,4,5,QCM,35,27,18,9,1.3,66.67,18,17,50.13,Difficile,Difficile,Difficile / Difficile
3359,40,2019,Ingenieurie,4,5,QCM,41,37,36,1,1.11,97.3,36,5,88.0,Difficile,Trop Facile,Difficile / Trop Facile
4189,40,2020,Ingenieurie,4,5,QCM,38,33,15,18,1.15,45.45,15,23,38.78,Difficile,Difficile,Difficile / Difficile
40,41,2015,Ingenieurie,4,6,QCU,18,18,3,15,1.0,16.67,3,15,16.67,Trop Difficile,Trop Difficile,Trop Difficile / Trop Difficile
870,41,2016,Ingenieurie,4,6,QCU,15,6,4,2,2.5,66.67,4,11,26.45,Difficile,Difficile,Difficile / Difficile
1700,41,2017,Ingenieurie,4,6,QCU,14,13,10,3,1.08,76.92,10,4,73.12,Difficile,Adapte,Difficile / Adapte
2530,41,2018,Ingenieurie,4,6,QCU,15,13,11,2,1.15,84.62,11,4,74.42,Adapte,Adapte,Adapte / Adapte
3360,41,2019,Ingenieurie,4,6,QCU,13,8,8,0,1.62,100.0,8,5,60.52,Adapte,Adapte,Adapte / Adapte
4190,41,2020,Ingenieurie,4,6,QCU,15,12,11,1,1.25,91.67,11,4,71.99,Adapte,Adapte,Adapte / Adapte
41,42,2015,Ingenieurie,4,7,QCM,8,5,5,0,1.6,100.0,5,3,66.37,Adapte,Adapte,Adapte / Adapte
871,42,2016,Ingenieurie,4,7,QCM,10,8,7,1,1.25,87.5,7,3,73.84,Adapte,Adapte,Adapte / Adapte
1701,42,2017,Ingenieurie,4,7,QCM,9,9,6,3,1.0,66.67,6,3,66.66,Adapte,Adapte,Adapte / Adapte
2531,42,2018,Ingenieurie,4,7,QCM,9,7,6,1,1.29,85.71,6,3,71.12,Adapte,Adapte,Adapte / Adapte
3361,42,2019,Ingenieurie,4,7,QCM,7,6,5,1,1.17,83.33,5,2,65.63,Adapte,Adapte,Adapte / Adapte
4191,42,2020,Ingenieurie,4,7,QCM,6,4,4,0,1.5,100.0,4,2,71.19,Adapte,Adapte,Adapte / Adapte
42,43,2015,Ingenieurie,4,8,QCM,90,58,57,1,1.55,98.28,57,33,63.83,Facile,Adapte,Facile / Adapte
872,43,2016,Ingenieurie,4,8,QCM,97,88,66,22,1.1,75.0,66,31,67.89,Adapte,Adapte,Adapte / Adapte
1702,43,2017,Ingenieurie,4,8,QCM,91,83,61,22,1.1,73.49,61,30,66.59,Adapte,Adapte,Adapte / Adapte
2532,43,2018,Ingenieurie,4,8,QCM,105,86,68,18,1.22,79.07,68,37,65.01,Adapte,Adapte,Adapte / Adapte
3362,43,2019,Ingenieurie,4,8,QCM,124,94,78,16,1.32,82.98,78,46,63.08,Adapte,Adapte,Adapte / Adapte
4192,43,2020,Ingenieurie,4,8,QCM,108,73,68,5,1.48,93.15,68,40,62.51,Adapte,Adapte,Adapte / Adapte
43,44,2015,Ingenieurie,4,9,QCU,52,41,26,15,1.27,63.41,26,26,50.67,Difficile,Difficile,Difficile / Difficile
873,44,2016,Ingenieurie,4,9,QCU,52,44,30,14,1.18,68.18,30,22,58.35,Difficile,Difficile,Difficile / Difficile
1703,44,2017,Ingenieurie,4,9,QCU,51,42,13,29,1.21,30.95,13,38,25.17,Difficile,Difficile,Difficile / Difficile
2533,44,2018,Ingenieurie,4,9,QCU,59,55,21,34,1.07,38.18,21,38,36.08,Difficile,Difficile,Difficile / Difficile
3363,44,2019,Ingenieurie,4,9,QCU,47,30,14,16,1.57,46.67,14,33,30.13,Difficile,Difficile,Difficile / Difficile
4193,44,2020,Ingenieurie,4,9,QCU,49,44,41,3,1.11,93.18,41,8,84.4,Difficile,Facile,Difficile / Facile
44,45,2015,Ingenieurie,5,1,QCU,66,63,59,4,1.05,93.65,59,7,89.03,Adapte,Trop Facile,Adapte / Trop Facile
874,45,2016,Ingenieurie,5,1,QCU,79,32,2,30,2.47,6.25,2,77,2.67,Difficile,Trop Difficile,Difficile / Trop Difficile
1704,45,2017,Ingenieurie,5,1,QCU,81,80,27,53,1.01,33.75,27,54,33.59,Difficile,Difficile,Difficile / Difficile
2534,45,2018,Ingenieurie,5,1,QCU,82,69,64,5,1.19,92.75,64,18,78.04,Difficile,Facile,Difficile / Facile
3364,45,2019,Ingenieurie,5,1,QCU,71,58,18,40,1.22,31.03,18,53,25.17,Difficile,Difficile,Difficile / Difficile
4194,45,2020,Ingenieurie,5,1,QCU,62,44,25,19,1.41,56.82,25,37,39.76,Difficile,Difficile,Difficile / Difficile
45,46,2015,Ingenieurie,5,2,QCM,56,47,47,0,1.19,100.0,47,9,84.09,Facile,Facile,Facile / Facile
875,46,2016,Ingenieurie,5,2,QCM,64,53,28,25,1.21,52.83,28,36,43.23,Difficile,Difficile,Difficile / Difficile
1705,46,2017,Ingenieurie,5,2,QCM,51,28,16,12,1.82,57.14,16,35,30.56,Difficile,Difficile,Difficile / Difficile
2535,46,2018,Ingenieurie,5,2,QCM,57,51,11,40,1.12,21.57,11,46,18.76,Difficile,Trop Difficile,Difficile / Trop Difficile
3365,46,2019,Ingenieurie,5,2,QCM,57,54,29,25,1.06,53.7,29,28,50.53,Difficile,Difficile,Difficile / Difficile
4195,46,2020,Ingenieurie,5,2,QCM,52,32,29,3,1.62,90.62,29,23,55.64,Difficile,Difficile,Difficile / Difficile
46,47,2015,Ingenieurie,5,3,QCU,77,69,53,16,1.12,76.81,53,24,69.01,Adapte,Adapte,Adapte / Adapte
876,47,2016,Ingenieurie,5,3,QCU,65,62,47,15,1.05,75.81,47,18,72.98,Adapte,Adapte,Adapte / Adapte
1706,47,2017,Ingenieurie,5,3,QCU,64,52,42,10,1.23,80.77,42,22,65.04,Adapte,Adapte,Adapte / Adapte
2536,47,2018,Ingenieurie,5,3,QCU,76,72,50,22,1.06,69.44,50,26,65.85,Adapte,Adapte,Adapte / Adapte
3366,47,2019,Ingenieurie,5,3,QCU,74,69,47,22,1.07,68.12,47,27,63.51,Adapte,Adapte,Adapte / Adapte
4196,47,2020,Ingenieurie,5,3,QCU,60,56,45,11,1.07,80.36,45,15,74.59,Adapte,Adapte,Adapte / Adapte
47,48,2015,Ingenieurie,5,4,QO,100,74,47,27,1.35,63.51,47,53,47.41,Difficile,Difficile,Difficile / Difficile
877,48,2016,Ingenieurie,5,4,QO,117,113,43,70,1.04,38.05,43,74,36.66,Trop Difficile,Difficile,Trop Difficile / Difficile
1707,48,2017,Ingenieurie,5,4,QO,136,69,18,51,1.97,26.09,18,118,12.87,Trop Difficile,Trop Difficile,Trop Difficile / Trop Difficile
2537,48,2018,Ingenieurie,5,4,QO,133,94,4,90,1.41,4.26,4,129,2.93,Trop Difficile,Trop Difficile,Trop Difficile / Trop Difficile
3367,48,2019,Ingenieurie,5,4,QO,126,81,23,58,1.56,28.4,23,103,17.99,Trop Difficile,Trop Difficile,Trop Difficile / Trop Difficile
4197,48,2020,Ingenieurie,5,4,QO,114,101,92,9,1.13,91.09,92,22,80.69,Trop Difficile,Facile,Trop Difficile / Facile
48,49,2015,Ingenieurie,5,5,QCU,72,71,67,4,1.01,94.37,67,5,92.55,Trop Facile,Trop Facile,Trop Facile / Trop Facile
878,49,2016,Ingenieurie,5,5,QCU,65,52,36,16,1.25,69.23,36,29,55.4,Difficile,Difficile,Difficile / Difficile
1708,49,2017,Ingenieurie,5,5,QCU,74,72,71,1,1.03,98.61,71,3,95.65,Difficile,Trop Facile,Difficile / Trop Facile
2538,49,2018,Ingenieurie,5,5,QCU,78,59,36,23,1.32,61.02,36,42,46.03,Difficile,Difficile,Difficile / Difficile
3368,49,2019,Ingenieurie,5,5,QCU,78,54,44,10,1.44,81.48,44,34,56.1,Difficile,Difficile,Difficile / Difficile
4198,49,2020,Ingenieurie,5,5,QCU,86,69,50,19,1.25,72.46,50,36,58.03,Difficile,Difficile,Difficile / Difficile
49,50,2015,Ingenieurie,5,6,QO,27,20,13,7,1.35,65.0,13,14,47.74,Difficile,Difficile,Difficile / Difficile
879,50,2016,Ingenieurie,5,6,QO,28,19,3,16,1.47,15.79,3,25,9.79,Trop Difficile,Trop Difficile,Trop Difficile / Trop Difficile
1709,50,2017,Ingenieurie,5,6,QO,30,17,2,15,1.76,11.76,2,28,6.55,Trop Difficile,Trop Difficile,Trop Difficile / Trop Difficile
2539,50,2018,Ingenieurie,5,6,QO,35,20,1,19,1.75,5.0,1,34,2.35,Trop Difficile,Trop Difficile,Trop Difficile / Trop Difficile
3369,50,2019,Ingenieurie,5,6,QO,36,20,8,12,1.8,40.0,8,28,21.0,Trop Difficile,Trop Difficile,Trop Difficile / Trop Difficile
4199,50,2020,Ingenieurie,5,6,QO,33,25,3,22,1.32,12.0,3,30,8.01,Trop Difficile,Trop Difficile,Trop Difficile / Trop Difficile
50,51,2015,Ingenieurie,5,7,QCU,56,40,33,7,1.4,82.5,33,23,58.74,Difficile,Difficile,Difficile / Difficile
880,51,2016,Ingenieurie,5,7,QCU,55,39,21,18,1.41,53.85,21,34,39.07,Difficile,Difficile,Difficile / Difficile
1710,51,2017,Ingenieurie,5,7,QCU,44,36,36,0,1.22,100.0,36,8,81.98,Difficile,Facile,Difficile / Facile
2540,51,2018,Ingenieurie,5,7,QCU,48,17,2,15,2.82,11.76,2,46,4.65,Difficile,Trop Difficile,Difficile / Trop Difficile
3370,51,2019,Ingenieurie,5,7,QCU,56,51,19,32,1.1,37.25,19,37,33.88,Difficile,Difficile,Difficile / Difficile
4200,51,2020,Ingenieurie,5,7,QCU,51,42,20,22,1.21,47.62,20,31,38.49,Difficile,Difficile,Difficile / Difficile
51,52,2015,Ingenieurie,5,8,QCM,62,53,52,1,1.17,98.11,52,10,83.99,Difficile,Facile,Difficile / Facile
881,52,2016,Ingenieurie,5,8,QCM,63,42,42,0,1.5,100.0,42,21,66.23,Difficile,Adapte,Difficile / Adapte
1711,52,2017,Ingenieurie,5,8,QCM,56,54,36,18,1.04,66.67,36,20,63.94,Adapte,Adapte,Adapte / Adapte
2541,52,2018,Ingenieurie,5,8,QCM,59,55,37,18,1.07,67.27,37,22,63.25,Adapte,Adapte,Adapte / Adapte
3371,52,2019,Ingenieurie,5,8,QCM,71,63,49,14,1.13,77.78,49,22,68.9,Adapte,Adapte,Adapte / Adapte
4201,52,2020,Ingenieurie,5,8,QCM,65,64,45,19,1.02,70.31,45,20,69.3,Adapte,Adapte,Adapte / Adapte
52,53,2015,Ingenieurie,6,1,QCU,18,17,15,2,1.06,88.24,15,3,83.66,Difficile,Facile,Difficile / Facile
882,53,2016,Ingenieurie,6,1,QCU,16,11,7,4,1.45,63.64,7,9,41.71,Difficile,Difficile,Difficile / Difficile
1712,53,2017,Ingenieurie,6,1,QCU,13,7,2,5,1.86,28.57,2,11,17.09,Difficile,Trop Difficile,Difficile / Trop Difficile
2542,53,2018,Ingenieurie,6,1,QCU,16,15,14,1,1.07,93.33,14,2,89.06,Difficile,Trop Facile,Difficile / Trop Facile
3372,53,2019,Ingenieurie,6,1,QCU,16,8,5,3,2.0,62.5,5,11,31.83,Difficile,Difficile,Difficile / Difficile
4202,53,2020,Ingenieurie,6,1,QCU,19,18,7,11,1.06,38.89,7,12,38.8,Difficile,Difficile,Difficile / Difficile
53,54,2015,Ingenieurie,6,2,QCM,5,5,5,0,1.0,100.0,5,0,97.57,Trop Facile,Trop Facile,Trop Facile / Trop Facile
883,54,2016,Ingenieurie,6,2,QCM,6,2,1,1,3.0,50.0,1,5,11.39,Difficile,Trop Difficile,Difficile / Trop Difficile
1713,54,2017,Ingenieurie,6,2,QCM,5,4,2,2,1.25,50.0,2,3,39.27,Difficile,Difficile,Difficile / Difficile
2543,54,2018,Ingenieurie,6,2,QCM,5,5,4,1,1.0,80.0,4,1,84.21,Difficile,Facile,Difficile / Facile
3373,54,2019,Ingenieurie,6,2,QCM,5,5,1,4,1.0,20.0,1,4,18.84,Difficile,Trop Difficile,Difficile / Trop Difficile
4203,54,2020,Ingenieurie,6,2,QCM,6,5,2,3,1.2,40.0,2,4,27.09,Difficile,Difficile,Difficile / Difficile
54,55,2015,Ingenieurie,6,3,QCU,87,84,77,7,1.04,91.67,77,10,88.71,Facile,Trop Facile,Facile / Trop Facile
884,55,2016,Ingenieurie,6,3,QCU,80,52,24,28,1.54,46.15,24,56,30.28,Difficile,Difficile,Difficile / Difficile
1714,55,2017,Ingenieurie,6,3,QCU,91,49,30,19,1.86,61.22,30,61,33.44,Difficile,Difficile,Difficile / Difficile
2544,55,2018,Ingenieurie,6,3,QCU,81,62,24,38,1.31,38.71,24,57,29.71,Difficile,Difficile,Difficile / Difficile
3374,55,2019,Ingenieurie,6,3,QCU,69,44,19,25,1.57,43.18,19,50,27.89,Difficile,Difficile,Difficile / Difficile
4204,55,2020,Ingenieurie,6,3,QCU,57,54,16,38,1.06,29.63,16,41,28.83,Difficile,Difficile,Difficile / Difficile
55,56,2015,Ingenieurie,6,4,QCU,37,21,14,7,1.76,66.67,14,23,38.16,Trop Difficile,Difficile,Trop Difficile / Difficile
885,56,2016,Ingenieurie,6,4,QCU,40,36,29,7,1.11,80.56,29,11,71.84,Difficile,Adapte,Difficile / Adapte
1715,56,2017,Ingenieurie,6,4,QCU,33,33,22,11,1.0,66.67,22,11,66.68,Adapte,Adapte,Adapte / Adapte
2545,56,2018,Ingenieurie,6,4,QCU,27,24,17,7,1.12,70.83,17,10,63.81,Adapte,Adapte,Adapte / Adapte
3375,56,2019,Ingenieurie,6,4,QCU,26,26,19,7,1.0,73.08,19,7,72.03,Adapte,Adapte,Adapte / Adapte
4205,56,2020,Ingenieurie,6,4,QCU,23,20,15,5,1.15,75.0,15,8,64.48,Adapte,Adapte,Adapte / Adapte
56,57,2015,Ingenieurie,6,5,QCM,91,89,73,16,1.02,82.02,73,18,80.51,Facile,Facile,Facile / Facile
886,57,2016,Ingenieurie,6,5,QCM,85,24,12,12,3.54,50.0,12,73,13.96,Difficile,Trop Difficile,Difficile / Trop Difficile
1716,57,2017,Ingenieurie,6,5,QCM,92,86,77,9,1.07,89.53,77,15,83.78,Difficile,Facile,Difficile / Facile
2546,57,2018,Ingenieurie,6,5,QCM,95,94,54,40,1.01,57.45,54,41,57.32,Difficile,Difficile,Difficile / Difficile
3376,57,2019,Ingenieurie,6,5,QCM,99,97,49,48,1.02,50.52,49,50,49.58,Difficile,Difficile,Difficile / Difficile
4206,57,2020,Ingenieurie,6,5,QCM,98,87,36,51,1.13,41.38,36,62,37.18,Difficile,Difficile,Difficile / Difficile
57,58,2015,Ingenieurie,6,6,QCM,44,43,16,27,1.02,37.21,16,28,35.73,Difficile,Difficile,Difficile / Difficile
887,58,2016,Ingenieurie,6,6,QCM,40,31,15,16,1.29,48.39,15,25,36.6,Difficile,Difficile,Difficile / Difficile
1717,58,2017,Ingenieurie,6,6,QCM,35,26,11,15,1.35,42.31,11,24,32.48,Difficile,Difficile,Difficile / Difficile
2547,58,2018,Ingenieurie,6,6,QCM,28,28,23,5,1.0,82.14,23,5,81.66,Difficile,Facile,Difficile / Facile
3377,58,2019,Ingenieurie,6,6,QCM,32,28,15,13,1.14,53.57,15,17,47.25,Difficile,Difficile,Difficile / Difficile
4207,58,2020,Ingenieurie,6,6,QCM,27,21,18,3,1.29,85.71,18,9,67.27,Difficile,Adapte,Difficile / Adapte
58,59,2015,Ingenieurie,7,1,QCM,62,62,61,1,1.0,98.39,61,1,97.94,Trop Facile,Trop Facile,Trop Facile / Trop Facile
888,59,2016,Ingenieurie,7,1,QCM,53,37,16,21,1.43,43.24,16,37,29.95,Difficile,Difficile,Difficile / Difficile
1718,59,2017,Ingenieurie,7,1,QCM,56,40,25,15,1.4,62.5,25,31,44.58,Difficile,Difficile,Difficile / Difficile
2548,59,2018,Ingenieurie,7,1,QCM,49,44,41,3,1.11,93.18,41,8,83.55,Difficile,Facile,Difficile / Facile
3378,59,2019,Ingenieurie,7,1,QCM,53,51,51,0,1.04,100.0,51,2,97.05,Difficile,Trop Facile,Difficile / Trop Facile
4208,59,2020,Ingenieurie,7,1,QCM,44,23,21,2,1.91,91.3,21,23,47.8,Difficile,Difficile,Difficile / Difficile
59,60,2015,Ingenieurie,7,2,QCM,41,37,37,0,1.11,100.0,37,4,91.32,Trop Difficile,Trop Facile,Trop Difficile / Trop Facile
889,60,2016,Ingenieurie,7,2,QCM,40,37,7,30,1.08,18.92,7,33,17.51,Difficile,Trop Difficile,Difficile / Trop Difficile
1719,60,2017,Ingenieurie,7,2,QCM,38,20,6,14,1.9,30.0,6,32,16.68,Difficile,Trop Difficile,Difficile / Trop Difficile
2549,60,2018,Ingenieurie,7,2,QCM,39,37,22,15,1.05,59.46,22,17,56.26,Difficile,Difficile,Difficile / Difficile
3379,60,2019,Ingenieurie,7,2,QCM,41,31,12,19,1.32,38.71,12,29,30.05,Difficile,Difficile,Difficile / Difficile
4209,60,2020,Ingenieurie,7,2,QCM,33,23,11,12,1.43,47.83,11,22,32.24,Difficile,Difficile,Difficile / Difficile
60,61,2015,Ingenieurie,7,3,QCU,75,38,22,16,1.97,57.89,22,53,28.83,Trop Difficile,Difficile,Trop Difficile / Difficile
890,61,2016,Ingenieurie,7,3,QCU,70,70,26,44,1.0,37.14,26,44,37.19,Difficile,Difficile,Difficile / Difficile
1720,61,2017,Ingenieurie,7,3,QCU,57,55,52,3,1.04,94.55,52,5,91.12,Difficile,Trop Facile,Difficile / Trop Facile
2550,61,2018,Ingenieurie,7,3,QCU,64,43,9,34,1.49,20.93,9,55,13.88,Difficile,Trop Difficile,Difficile / Trop Difficile
3380,61,2019,Ingenieurie,7,3,QCU,77,54,43,11,1.43,79.63,43,34,56.38,Difficile,Difficile,Difficile / Difficile
4210,61,2020,Ingenieurie,7,3,QCU,67,37,28,9,1.81,75.68,28,39,41.61,Difficile,Difficile,Difficile / Difficile
61,62,2015,Ingenieurie,7,4,QCM,55,43,4,39,1.28,9.3,4,51,6.39,Difficile,Trop Difficile,Difficile / Trop Difficile
891,62,2016,Ingenieurie,7,4,QCM,46,34,21,13,1.35,61.76,21,25,46.34,Difficile,Difficile,Difficile / Difficile
1721,62,2017,Ingenieurie,7,4,QCM,51,28,21,7,1.82,75.0,21,30,40.53,Difficile,Difficile,Difficile / Difficile
2551,62,2018,Ingenieurie,7,4,QCM,54,38,16,22,1.42,42.11,16,38,30.06,Difficile,Difficile,Difficile / Difficile
3381,62,2019,Ingenieurie,7,4,QCM,49,44,43,1,1.11,97.73,43,6,88.77,Difficile,Trop Facile,Difficile / Trop Facile
4211,62,2020,Ingenieurie,7,4,QCM,51,51,22,29,1.0,43.14,22,29,43.74,Difficile,Difficile,Difficile / Difficile
62,63,2015,Ingenieurie,7,5,QCU,71,40,15,25,1.77,37.5,15,56,21.28,Difficile,Trop Difficile,Difficile / Trop Difficile
892,63,2016,Ingenieurie,7,5,QCU,67,47,34,13,1.43,72.34,34,33,50.25,Difficile,Difficile,Difficile / Difficile
1722,63,2017,Ingenieurie,7,5,QCU,65,64,63,1,1.02,98.44,63,2,97.63,Difficile,Trop Facile,Difficile / Trop Facile
2552,63,2018,Ingenieurie,7,5,QCU,72,58,58,0,1.24,100.0,58,14,80.68,Difficile,Facile,Difficile / Facile
3382,63,2019,Ingenieurie,7,5,QCU,65,59,25,34,1.1,42.37,25,40,38.14,Difficile,Difficile,Difficile / Difficile
4212,63,2020,Ingenieurie,7,5,QCU,73,40,24,16,1.82,60.0,24,49,32.93,Difficile,Difficile,Difficile / Difficile
63,64,2015,Ingenieurie,7,6,QCU,40,37,33,4,1.08,89.19,33,7,82.31,Difficile,Facile,Difficile / Facile
893,64,2016,Ingenieurie,7,6,QCU,47,36,16,20,1.31,44.44,16,31,33.43,Difficile,Difficile,Difficile / Difficile
1723,64,2017,Ingenieurie,7,6,QCU,43,28,25,3,1.54,89.29,25,18,57.88,Difficile,Difficile,Difficile / Difficile
2553,64,2018,Ingenieurie,7,6,QCU,34,21,14,7,1.62,66.67,14,20,40.44,Difficile,Difficile,Difficile / Difficile
3383,64,2019,Ingenieurie,7,6,QCU,39,39,33,6,1.0,84.62,33,6,83.95,Difficile,Facile,Difficile / Facile
4213,64,2020,Ingenieurie,7,6,QCU,43,38,34,4,1.13,89.47,34,9,78.06,Difficile,Facile,Difficile / Facile
64,65,2015,Ingenieurie,7,7,QCM,86,76,67,9,1.13,88.16,67,19,78.12,Facile,Facile,Facile / Facile
894,65,2016,Ingenieurie,7,7,QCM,91,88,47,41,1.03,53.41,47,44,51.1,Difficile,Difficile,Difficile / Difficile
1724,65,2017,Ingenieurie,7,7,QCM,77,61,25,36,1.26,40.98,25,52,33.11,Difficile,Difficile,Difficile / Difficile
2554,65,2018,Ingenieurie,7,7,QCM,68,34,24,10,2.0,70.59,24,44,34.9,Difficile,Difficile,Difficile / Difficile
3384,65,2019,Ingenieurie,7,7,QCM,66,49,39,10,1.35,79.59,39,27,58.48,Difficile,Difficile,Difficile / Difficile
4214,65,2020,Ingenieurie,7,7,QCM,57,41,18,23,1.39,43.9,18,39,31.07,Difficile,Difficile,Difficile / Difficile
65,66,2015,Ingenieurie,7,8,QROC,34,29,27,2,1.17,93.1,27,7,79.75,Trop Difficile,Facile,Trop Difficile / Facile
895,66,2016,Ingenieurie,7,8,QROC,39,39,39,0,1.0,100.0,39,0,99.46,Difficile,Trop Facile,Difficile / Trop Facile
1725,66,2017,Ingenieurie,7,8,QROC,45,42,13,29,1.07,30.95,13,32,29.16,Difficile,Difficile,Difficile / Difficile
2555,66,2018,Ingenieurie,7,8,QROC,48,45,44,1,1.07,97.78,44,4,91.44,Difficile,Trop Facile,Difficile / Trop Facile
3385,66,2019,Ingenieurie,7,8,QROC,53,49,19,30,1.08,38.78,19,34,36.03,Difficile,Difficile,Difficile / Difficile
4215,66,2020,Ingenieurie,7,8,QROC,50,33,16,17,1.52,48.48,16,34,32.21,Difficile,Difficile,Difficile / Difficile
66,67,2015,Ingenieurie,7,9,QCU,6,5,3,2,1.2,60.0,3,3,54.1,Difficile,Difficile,Difficile / Difficile
896,67,2016,Ingenieurie,7,9,QCU,7,4,3,1,1.75,75.0,3,4,41.78,Difficile,Difficile,Difficile / Difficile
1726,67,2017,Ingenieurie,7,9,QCU,7,3,2,1,2.33,66.67,2,5,27.48,Difficile,Difficile,Difficile / Difficile
2556,67,2018,Ingenieurie,7,9,QCU,8,8,4,4,1.0,50.0,4,4,52.43,Difficile,Difficile,Difficile / Difficile
3386,67,2019,Ingenieurie,7,9,QCU,7,7,6,1,1.0,85.71,6,1,91.13,Difficile,Trop Facile,Difficile / Trop Facile
4216,67,2020,Ingenieurie,7,9,QCU,8,3,3,0,2.67,100.0,3,5,34.66,Difficile,Difficile,Difficile / Difficile
67,68,2015,Ingenieurie,7,10,QCM,24,21,21,0,1.14,100.0,21,3,87.67,Trop Facile,Trop Facile,Trop Facile / Trop Facile
897,68,2016,Ingenieurie,7,10,QCM,29,27,13,14,1.07,48.15,13,16,44.84,Difficile,Difficile,Difficile / Difficile
1727,68,2017,Ingenieurie,7,10,QCM,33,27,23,4,1.22,85.19,23,10,71.15,Difficile,Adapte,Difficile / Adapte
2557,68,2018,Ingenieurie,7,10,QCM,32,28,20,8,1.14,71.43,20,12,61.16,Adapte,Adapte,Adapte / Adapte
3387,68,2019,Ingenieurie,7,10,QCM,26,24,17,7,1.08,70.83,17,9,65.2,Adapte,Adapte,Adapte / Adapte
4217,68,2020,Ingenieurie,7,10,QCM,27,26,18,8,1.04,69.23,18,9,66.76,Adapte,Adapte,Adapte / Adapte
68,69,2015,Ingenieurie,8,1,QCM,15,15,14,1,1.0,93.33,14,1,92.55,Difficile,Trop Facile,Difficile / Trop Facile
898,69,2016,Ingenieurie,8,1,QCM,12,6,6,0,2.0,100.0,6,6,48.23,Difficile,Difficile,Difficile / Difficile
1728,69,2017,Ingenieurie,8,1,QCM,10,5,5,0,2.0,100.0,5,5,52.84,Difficile,Difficile,Difficile / Difficile
2558,69,2018,Ingenieurie,8,1,QCM,10,9,5,4,1.11,55.56,5,5,48.86,Difficile,Difficile,Difficile / Difficile
3388,69,2019,Ingenieurie,8,1,QCM,12,11,11,0,1.09,100.0,11,1,90.9,Difficile,Trop Facile,Difficile / Trop Facile
4218,69,2020,Ingenieurie,8,1,QCM,13,7,2,5,1.86,28.57,2,11,16.6,Difficile,Trop Difficile,Difficile / Trop Difficile
69,70,2015,Ingenieurie,8,2,QCU,54,40,3,37,1.35,7.5,3,51,5.11,Trop Difficile,Trop Difficile,Trop Difficile / Trop Difficile
899,70,2016,Ingenieurie,8,2,QCU,63,27,22,5,2.33,81.48,22,41,35.32,Difficile,Difficile,Difficile / Difficile
1729,70,2017,Ingenieurie,8,2,QCU,52,41,16,25,1.27,39.02,16,36,30.54,Difficile,Difficile,Difficile / Difficile
2559,70,2018,Ingenieurie,8,2,QCU,57,49,29,20,1.16,59.18,29,28,50.14,Difficile,Difficile,Difficile / Difficile
3389,70,2019,Ingenieurie,8,2,QCU,64,49,24,25,1.31,48.98,24,40,37.0,Difficile,Difficile,Difficile / Difficile
4219,70,2020,Ingenieurie,8,2,QCU,68,63,58,5,1.08,92.06,58,10,84.7,Difficile,Facile,Difficile / Facile
70,71,2015,Ingenieurie,8,3,QCM,72,67,32,35,1.07,47.76,32,40,44.69,Difficile,Difficile,Difficile / Difficile
900,71,2016,Ingenieurie,8,3,QCM,80,67,59,8,1.19,88.06,59,21,74.1,Difficile,Adapte,Difficile / Adapte
1730,71,2017,Ingenieurie,8,3,QCM,66,60,48,12,1.1,80.0,48,18,73.41,Adapte,Adapte,Adapte / Adapte
2560,71,2018,Ingenieurie,8,3,QCM,62,55,41,14,1.13,74.55,41,21,66.32,Adapte,Adapte,Adapte / Adapte
3390,71,2019,Ingenieurie,8,3,QCM,73,69,54,15,1.06,78.26,54,19,73.33,Adapte,Adapte,Adapte / Adapte
4220,71,2020,Ingenieurie,8,3,QCM,63,59,47,12,1.07,79.66,47,16,73.83,Adapte,Adapte,Adapte / Adapte
71,72,2015,Ingenieurie,8,4,QCU,89,63,59,4,1.41,93.65,59,30,66.85,Adapte,Adapte,Adapte / Adapte
901,72,2016,Ingenieurie,8,4,QCU,85,64,57,7,1.33,89.06,57,28,67.28,Adapte,Adapte,Adapte / Adapte
1731,72,2017,Ingenieurie,8,4,QCU,86,84,58,26,1.02,69.05,58,28,67.57,Adapte,Adapte,Adapte / Adapte
2561,72,2018,Ingenieurie,8,4,QCU,102,76,71,5,1.34,93.42,71,31,69.33,Adapte,Adapte,Adapte / Adapte
3391,72,2019,Ingenieurie,8,4,QCU,119,102,77,25,1.17,75.49,77,42,64.99,Adapte,Adapte,Adapte / Adapte
4221,72,2020,Ingenieurie,8,4,QCU,96,78,59,19,1.23,75.64,59,37,61.14,Adapte,Adapte,Adapte / Adapte
72,73,2015,Ingenieurie,8,5,QCM,10,7,5,2,1.43,71.43,5,5,52.65,Difficile,Difficile,Difficile / Difficile
902,73,2016,Ingenieurie,8,5,QCM,10,10,8,2,1.0,80.0,8,2,83.27,Difficile,Facile,Difficile / Facile
1732,73,2017,Ingenieurie,8,5,QCM,10,7,3,4,1.43,42.86,3,7,31.88,Difficile,Difficile,Difficile / Difficile
2562,73,2018,Ingenieurie,8,5,QCM,10,8,0,8,1.25,0.0,0,10,4.45,Difficile,Trop Difficile,Difficile / Trop Difficile
3392,73,2019,Ingenieurie,8,5,QCM,10,9,3,6,1.11,33.33,3,7,34.84,Difficile,Difficile,Difficile / Difficile
4222,73,2020,Ingenieurie,8,5,QCM,10,5,3,2,2.0,60.0,3,7,26.46,Difficile,Difficile,Difficile / Difficile
73,74,2015,Ingenieurie,8,6,QCM,97,84,67,17,1.15,79.76,67,30,68.66,Difficile,Adapte,Difficile / Adapte
903,74,2016,Ingenieurie,8,6,QCM,110,89,79,10,1.24,88.76,79,31,71.94,Adapte,Adapte,Adapte / Adapte
1733,74,2017,Ingenieurie,8,6,QCM,99,93,71,22,1.06,76.34,71,28,71.98,Adapte,Adapte,Adapte / Adapte
2563,74,2018,Ingenieurie,8,6,QCM,108,88,71,17,1.23,80.68,71,37,65.48,Adapte,Adapte,Adapte / Adapte
3393,74,2019,Ingenieurie,8,6,QCM,97,80,67,13,1.21,83.75,67,30,68.98,Adapte,Adapte,Adapte / Adapte
4223,74,2020,Ingenieurie,8,6,QCM,91,86,55,31,1.06,63.95,55,36,60.88,Adapte,Adapte,Adapte / Adapte
74,75,2015,Ingenieurie,8,7,QROC,32,18,10,8,1.78,55.56,10,22,30.61,Difficile,Difficile,Difficile / Difficile
904,75,2016,Ingenieurie,8,7,QROC,31,27,16,11,1.15,59.26,16,15,50.13,Difficile,Difficile,Difficile / Difficile
1734,75,2017,Ingenieurie,8,7,QROC,30,29,26,3,1.03,89.66,26,4,87.25,Difficile,Trop Facile,Difficile / Trop Facile
2564,75,2018,Ingenieurie,8,7,QROC,29,17,9,8,1.71,52.94,9,20,29.97,Difficile,Difficile,Difficile / Difficile
3394,75,2019,Ingenieurie,8,7,QROC,26,21,13,8,1.24,61.9,13,13,50.07,Difficile,Difficile,Difficile / Difficile
4224,75,2020,Ingenieurie,8,7,QROC,29,29,27,2,1.0,93.1,27,2,91.79,Difficile,Trop Facile,Difficile / Trop Facile
75,76,2015,Ingenieurie,8,8,QCM,89,51,25,26,1.75,49.02,25,64,28.34,Difficile,Difficile,Difficile / Difficile
905,76,2016,Ingenieurie,8,8,QCM,77,51,21,30,1.51,41.18,21,56,27.89,Difficile,Difficile,Difficile / Difficile
1735,76,2017,Ingenieurie,8,8,QCM,73,70,34,36,1.04,48.57,34,39,47.19,Difficile,Difficile,Difficile / Difficile
2565,76,2018,Ingenieurie,8,8,QCM,73,70,32,38,1.04,45.71,32,41,44.06,Difficile,Difficile,Difficile / Difficile
3395,76,2019,Ingenieurie,8,8,QCM,66,63,35,28,1.05,55.56,35,31,53.53,Difficile,Difficile,Difficile / Difficile
4225,76,2020,Ingenieurie,8,8,QCM,70,66,35,31,1.06,53.03,35,35,50.45,Difficile,Difficile,Difficile / Difficile
76,77,2015,Ingenieurie,8,9,QCU,81,80,67,13,1.01,83.75,67,14,82.96,Facile,Facile,Facile / Facile
906,77,2016,Ingenieurie,8,9,QCU,74,50,19,31,1.48,38.0,19,55,25.82,Difficile,Difficile,Difficile / Difficile
1736,77,2017,Ingenieurie,8,9,QCU,79,51,41,10,1.55,80.39,41,38,51.67,Difficile,Difficile,Difficile / Difficile
2566,77,2018,Ingenieurie,8,9,QCU,70,44,43,1,1.59,97.73,43,27,61.72,Difficile,Adapte,Difficile / Adapte
3396,77,2019,Ingenieurie,8,9,QCU,68,67,44,23,1.01,65.67,44,24,64.35,Adapte,Adapte,Adapte / Adapte
4226,77,2020,Ingenieurie,8,9,QCU,73,70,52,18,1.04,74.29,52,21,70.98,Adapte,Adapte,Adapte / Adapte
77,78,2015,Ingenieurie,9,1,QCU,63,54,53,1,1.17,98.15,53,10,83.37,Facile,Facile,Facile / Facile
907,78,2016,Ingenieurie,9,1,QCU,72,65,64,1,1.11,98.46,64,8,88.78,Difficile,Trop Facile,Difficile / Trop Facile
1737,78,2017,Ingenieurie,9,1,QCU,73,37,26,11,1.97,70.27,26,47,35.37,Difficile,Difficile,Difficile / Difficile
2567,78,2018,Ingenieurie,9,1,QCU,88,77,44,33,1.14,57.14,44,44,50.54,Difficile,Difficile,Difficile / Difficile
3397,78,2019,Ingenieurie,9,1,QCU,89,86,38,48,1.03,44.19,38,51,42.38,Difficile,Difficile,Difficile / Difficile
4227,78,2020,Ingenieurie,9,1,QCU,87,47,36,11,1.85,76.6,36,51,41.75,Difficile,Difficile,Difficile / Difficile
78,79,2015,Ingenieurie,9,2,QROC,96,67,63,4,1.43,94.03,63,33,65.29,Adapte,Adapte,Adapte / Adapte
908,79,2016,Ingenieurie,9,2,QROC,112,109,71,38,1.03,65.14,71,41,63.5,Adapte,Adapte,Adapte / Adapte
1738,79,2017,Ingenieurie,9,2,QROC,115,112,75,37,1.03,66.96,75,40,65.04,Adapte,Adapte,Adapte / Adapte
2568,79,2018,Ingenieurie,9,2,QROC,97,78,72,6,1.24,92.31,72,25,74.44,Adapte,Adapte,Adapte / Adapte
3398,79,2019,Ingenieurie,9,2,QROC,78,69,56,13,1.13,81.16,56,22,72.28,Adapte,Adapte,Adapte / Adapte
4228,79,2020,Ingenieurie,9,2,QROC,80,50,49,1,1.6,98.0,49,31,61.85,Adapte,Adapte,Adapte / Adapte
79,80,2015,Ingenieurie,9,3,QCM,30,25,25,0,1.2,100.0,25,5,84.32,Trop Difficile,Facile,Trop Difficile / Facile
909,80,2016,Ingenieurie,9,3,QCM,24,17,11,6,1.41,64.71,11,13,45.59,Difficile,Difficile,Difficile / Difficile
1739,80,2017,Ingenieurie,9,3,QCM,19,16,2,14,1.19,12.5,2,17,10.44,Difficile,Trop Difficile,Difficile / Trop Difficile
2569,80,2018,Ingenieurie,9,3,QCM,18,14,6,8,1.29,42.86,6,12,33.52,Difficile,Difficile,Difficile / Difficile
3399,80,2019,Ingenieurie,9,3,QCM,16,15,7,8,1.07,46.67,7,9,42.98,Difficile,Difficile,Difficile / Difficile
4229,80,2020,Ingenieurie,9,3,QCM,13,12,11,1,1.08,91.67,11,2,82.77,Difficile,Facile,Difficile / Facile
80,81,2015,Ingenieurie,9,4,QROC,76,37,26,11,2.05,70.27,26,50,34.63,Difficile,Difficile,Difficile / Difficile
910,81,2016,Ingenieurie,9,4,QROC,72,56,36,20,1.29,64.29,36,36,50.17,Difficile,Difficile,Difficile / Difficile
1740,81,2017,Ingenieurie,9,4,QROC,79,44,30,14,1.8,68.18,30,49,37.53,Difficile,Difficile,Difficile / Difficile
2570,81,2018,Ingenieurie,9,4,QROC,82,78,66,12,1.05,84.62,66,16,80.69,Difficile,Facile,Difficile / Facile
3400,81,2019,Ingenieurie,9,4,QROC,77,74,57,17,1.04,77.03,57,20,74.61,Difficile,Adapte,Difficile / Adapte
4230,81,2020,Ingenieurie,9,4,QROC,82,61,55,6,1.34,90.16,55,27,67.58,Adapte,Adapte,Adapte / Adapte
81,82,2015,Ingenieurie,9,5,QCM,97,28,4,24,3.46,14.29,4,93,4.25,Trop Difficile,Trop Difficile,Trop Difficile / Trop Difficile
911,82,2016,Ingenieurie,9,5,QCM,116,95,61,34,1.22,64.21,61,55,52.21,Difficile,Difficile,Difficile / Difficile
1741,82,2017,Ingenieurie,9,5,QCM,122,113,59,54,1.08,52.21,59,63,48.69,Difficile,Difficile,Difficile / Difficile
2571,82,2018,Ingenieurie,9,5,QCM,99,39,33,6,2.54,84.62,33,66,33.51,Difficile,Difficile,Difficile / Difficile
3401,82,2019,Ingenieurie,9,5,QCM,86,55,29,26,1.56,52.73,29,57,34.25,Difficile,Difficile,Difficile / Difficile
4231,82,2020,Ingenieurie,9,5,QCM,94,88,73,15,1.07,82.95,73,21,77.22,Difficile,Facile,Difficile / Facile
82,83,2015,Ingenieurie,9,6,QCM,81,77,66,11,1.05,85.71,66,15,80.9,Trop Facile,Facile,Trop Facile / Facile
912,83,2016,Ingenieurie,9,6,QCM,71,50,41,9,1.42,82.0,41,30,58.05,Difficile,Difficile,Difficile / Difficile
1742,83,2017,Ingenieurie,9,6,QCM,72,67,36,31,1.07,53.73,36,36,50.25,Difficile,Difficile,Difficile / Difficile
2572,83,2018,Ingenieurie,9,6,QCM,85,83,37,46,1.02,44.58,37,48,43.1,Difficile,Difficile,Difficile / Difficile
3402,83,2019,Ingenieurie,9,6,QCM,93,36,31,5,2.58,86.11,31,62,33.71,Difficile,Difficile,Difficile / Difficile
4232,83,2020,Ingenieurie,9,6,QCM,95,70,64,6,1.36,91.43,64,31,67.58,Difficile,Adapte,Difficile / Adapte
83,84,2015,Ingenieurie,10,1,QROC,38,24,7,17,1.58,29.17,7,31,18.38,Trop Difficile,Trop Difficile,Trop Difficile / Trop Difficile
913,84,2016,Ingenieurie,10,1,QROC,43,35,24,11,1.23,68.57,24,19,56.09,Difficile,Difficile,Difficile / Difficile
1743,84,2017,Ingenieurie,10,1,QROC,49,43,23,20,1.14,53.49,23,26,47.82,Difficile,Difficile,Difficile / Difficile
2573,84,2018,Ingenieurie,10,1,QROC,58,53,53,0,1.09,100.0,53,5,91.94,Difficile,Trop Facile,Difficile / Trop Facile
3403,84,2019,Ingenieurie,10,1,QROC,55,45,42,3,1.22,93.33,42,13,76.34,Difficile,Facile,Difficile / Facile
4233,84,2020,Ingenieurie,10,1,QROC,62,47,18,29,1.32,38.3,18,44,29.65,Difficile,Difficile,Difficile / Difficile
84,85,2015,Ingenieurie,10,2,QCU,82,64,48,16,1.28,75.0,48,34,58.89,Difficile,Difficile,Difficile / Difficile
914,85,2016,Ingenieurie,10,2,QCU,89,89,86,3,1.0,96.63,86,3,97.06,Difficile,Trop Facile,Difficile / Trop Facile
1744,85,2017,Ingenieurie,10,2,QCU,73,50,33,17,1.46,66.0,33,40,44.81,Difficile,Difficile,Difficile / Difficile
2574,85,2018,Ingenieurie,10,2,QCU,64,60,16,44,1.07,26.67,16,48,25.07,Difficile,Difficile,Difficile / Difficile
3404,85,2019,Ingenieurie,10,2,QCU,63,62,62,0,1.02,100.0,62,1,98.07,Difficile,Trop Facile,Difficile / Trop Facile
4234,85,2020,Ingenieurie,10,2,QCU,74,53,48,5,1.4,90.57,48,26,64.63,Difficile,Adapte,Difficile / Adapte
85,86,2015,Ingenieurie,10,3,QO,99,94,92,2,1.05,97.87,92,7,92.58,Trop Facile,Trop Facile,Trop Facile / Trop Facile
915,86,2016,Ingenieurie,10,3,QO,100,89,17,72,1.12,19.1,17,83,17.45,Trop Difficile,Trop Difficile,Trop Difficile / Trop Difficile
1745,86,2017,Ingenieurie,10,3,QO,97,76,5,71,1.28,6.58,5,92,5.49,Trop Difficile,Trop Difficile,Trop Difficile / Trop Difficile
2575,86,2018,Ingenieurie,10,3,QO,112,108,19,89,1.04,17.59,19,93,16.69,Trop Difficile,Trop Difficile,Trop Difficile / Trop Difficile
3405,86,2019,Ingenieurie,10,3,QO,127,105,7,98,1.21,6.67,7,120,5.87,Trop Difficile,Trop Difficile,Trop Difficile / Trop Difficile
4235,86,2020,Ingenieurie,10,3,QO,121,120,118,2,1.01,98.33,118,3,97.61,Trop Difficile,Trop Facile,Trop Difficile / Trop Facile
86,87,2015,Ingenieurie,11,1,QCU,69,60,33,27,1.15,55.0,33,36,47.78,Difficile,Difficile,Difficile / Difficile
916,87,2016,Ingenieurie,11,1,QCU,68,68,51,17,1.0,75.0,51,17,74.69,Difficile,Adapte,Difficile / Adapte
1746,87,2017,Ingenieurie,11,1,QCU,62,43,37,6,1.44,86.05,37,25,60.38,Adapte,Adapte,Adapte / Adapte
2576,87,2018,Ingenieurie,11,1,QCU,53,48,35,13,1.1,72.92,35,18,65.27,Adapte,Adapte,Adapte / Adapte
3406,87,2019,Ingenieurie,11,1,QCU,52,51,33,18,1.02,64.71,33,19,62.63,Adapte,Adapte,Adapte / Adapte
4236,87,2020,Ingenieurie,11,1,QCU,42,35,30,5,1.2,85.71,30,12,71.8,Adapte,Adapte,Adapte / Adapte
87,88,2015,Ingenieurie,11,2,QCM,98,73,14,59,1.34,19.18,14,84,14.34,Trop Difficile,Trop Difficile,Trop Difficile / Trop Difficile
917,88,2016,Ingenieurie,11,2,QCM,111,76,46,30,1.46,60.53,46,65,41.15,Difficile,Difficile,Difficile / Difficile
1747,88,2017,Ingenieurie,11,2,QCM,98,82,67,15,1.2,81.71,67,31,68.11,Difficile,Adapte,Difficile / Adapte
2577,88,2018,Ingenieurie,11,2,QCM,90,74,56,18,1.22,75.68,56,34,62.29,Adapte,Adapte,Adapte / Adapte
3407,88,2019,Ingenieurie,11,2,QCM,86,85,62,23,1.01,72.94,62,24,72.46,Adapte,Adapte,Adapte / Adapte
4237,88,2020,Ingenieurie,11,2,QCM,86,73,59,14,1.18,80.82,59,27,68.94,Adapte,Adapte,Adapte / Adapte
88,89,2015,Ingenieurie,11,3,QROC,64,39,24,15,1.64,61.54,24,40,37.15,Difficile,Difficile,Difficile / Difficile
918,89,2016,Ingenieurie,11,3,QROC,53,36,29,7,1.47,80.56,29,24,54.04,Difficile,Difficile,Difficile / Difficile
1748,89,2017,Ingenieurie,11,3,QROC,61,50,26,24,1.22,52.0,26,35,42.85,Difficile,Difficile,Difficile / Difficile
2578,89,2018,Ingenieurie,11,3,QROC,73,39,17,22,1.87,43.59,17,56,22.98,Difficile,Trop Difficile,Difficile / Trop Difficile
3408,89,2019,Ingenieurie,11,3,QROC,58,24,16,8,2.42,66.67,16,42,26.79,Difficile,Difficile,Difficile / Difficile
4238,89,2020,Ingenieurie,11,3,QROC,50,46,21,25,1.09,45.65,21,29,42.12,Difficile,Difficile,Difficile / Difficile
89,90,2015,Ingenieurie,11,4,QCM,68,55,54,1,1.24,98.18,54,14,79.22,Trop Facile,Facile,Trop Facile / Facile
919,90,2016,Ingenieurie,11,4,QCM,81,65,26,39,1.25,40.0,26,55,31.53,Difficile,Difficile,Difficile / Difficile
1749,90,2017,Ingenieurie,11,4,QCM,94,87,46,41,1.08,52.87,46,48,49.12,Difficile,Difficile,Difficile / Difficile
2579,90,2018,Ingenieurie,11,4,QCM,80,71,45,26,1.13,63.38,45,35,55.72,Difficile,Difficile,Difficile / Difficile
3409,90,2019,Ingenieurie,11,4,QCM,72,63,57,6,1.14,90.48,57,15,78.99,Difficile,Facile,Difficile / Facile
4239,90,2020,Ingenieurie,11,4,QCM,63,28,23,5,2.25,82.14,23,40,37.04,Difficile,Difficile,Difficile / Difficile
90,91,2015,Ingenieurie,11,5,QROC,37,37,36,1,1.0,97.3,36,1,98.32,Trop Difficile,Trop Facile,Trop Difficile / Trop Facile
920,91,2016,Ingenieurie,11,5,QROC,44,32,32,0,1.38,100.0,32,12,73.24,Difficile,Adapte,Difficile / Adapte
1750,91,2017,Ingenieurie,11,5,QROC,49,44,31,13,1.11,70.45,31,18,63.64,Adapte,Adapte,Adapte / Adapte
2580,91,2018,Ingenieurie,11,5,QROC,55,42,40,2,1.31,95.24,40,15,72.71,Adapte,Adapte,Adapte / Adapte
3410,91,2019,Ingenieurie,11,5,QROC,62,62,45,17,1.0,72.58,45,17,72.72,Adapte,Adapte,Adapte / Adapte
4240,91,2020,Ingenieurie,11,5,QROC,72,55,51,4,1.31,92.73,51,21,70.56,Adapte,Adapte,Adapte / Adapte
91,92,2015,Ingenieurie,12,1,QROC,37,22,11,11,1.68,50.0,11,26,29.61,Difficile,Difficile,Difficile / Difficile
921,92,2016,Ingenieurie,12,1,QROC,42,33,18,15,1.27,54.55,18,24,42.25,Difficile,Difficile,Difficile / Difficile
1751,92,2017,Ingenieurie,12,1,QROC,45,25,17,8,1.8,68.0,17,28,38.01,Difficile,Difficile,Difficile / Difficile
2581,92,2018,Ingenieurie,12,1,QROC,44,31,19,12,1.42,61.29,19,25,43.57,Difficile,Difficile,Difficile / Difficile
3411,92,2019,Ingenieurie,12,1,QROC,41,29,16,13,1.41,55.17,16,25,38.47,Difficile,Difficile,Difficile / Difficile
4241,92,2020,Ingenieurie,12,1,QROC,40,35,33,2,1.14,94.29,33,7,81.37,Difficile,Facile,Difficile / Facile
92,93,2015,Ingenieurie,12,2,QO,96,48,8,40,2.0,16.67,8,88,8.25,Trop Difficile,Trop Difficile,Trop Difficile / Trop Difficile
922,93,2016,Ingenieurie,12,2,QO,93,87,12,75,1.07,13.79,12,81,13.08,Trop Difficile,Trop Difficile,Trop Difficile / Trop Difficile
1752,93,2017,Ingenieurie,12,2,QO,87,61,1,60,1.43,1.64,1,86,1.59,Trop Difficile,Trop Difficile,Trop Difficile / Trop Difficile
2582,93,2018,Ingenieurie,12,2,QO,88,80,7,73,1.1,8.75,7,81,8.24,Trop Difficile,Trop Difficile,Trop Difficile / Trop Difficile
3412,93,2019,Ingenieurie,12,2,QO,86,81,77,4,1.06,95.06,77,9,89.07,Trop Difficile,Trop Facile,Trop Difficile / Trop Facile
4242,93,2020,Ingenieurie,12,2,QO,81,60,8,52,1.35,13.33,8,73,10.43,Trop Difficile,Trop Difficile,Trop Difficile / Trop Difficile
93,94,2015,Ingenieurie,12,3,QCU,30,23,17,6,1.3,73.91,17,13,57.16,Difficile,Difficile,Difficile / Difficile
923,94,2016,Ingenieurie,12,3,QCU,30,16,9,7,1.88,56.25,9,21,31.44,Difficile,Difficile,Difficile / Difficile
1753,94,2017,Ingenieurie,12,3,QCU,36,33,33,0,1.09,100.0,33,3,90.94,Difficile,Trop Facile,Difficile / Trop Facile
2583,94,2018,Ingenieurie,12,3,QCU,42,20,17,3,2.1,85.0,17,25,40.18,Difficile,Difficile,Difficile / Difficile
3413,94,2019,Ingenieurie,12,3,QCU,41,34,34,0,1.21,100.0,34,7,83.47,Difficile,Facile,Difficile / Facile
4243,94,2020,Ingenieurie,12,3,QCU,37,33,16,17,1.12,48.48,16,21,42.03,Difficile,Difficile,Difficile / Difficile
94,95,2015,Ingenieurie,12,4,QCU,7,6,6,0,1.17,100.0,6,1,90.95,Trop Facile,Trop Facile,Trop Facile / Trop Facile
924,95,2016,Ingenieurie,12,4,QCU,6,3,2,1,2.0,66.67,2,4,41.54,Difficile,Difficile,Difficile / Difficile
1754,95,2017,Ingenieurie,12,4,QCU,7,3,2,1,2.33,66.67,2,5,26.47,Difficile,Difficile,Difficile / Difficile
2584,95,2018,Ingenieurie,12,4,QCU,8,3,0,3,2.67,0.0,0,8,0.7,Difficile,Trop Difficile,Difficile / Trop Difficile
3414,95,2019,Ingenieurie,12,4,QCU,8,3,3,0,2.67,100.0,3,5,39.09,Difficile,Difficile,Difficile / Difficile
4244,95,2020,Ingenieurie,12,4,QCU,7,7,4,3,1.0,57.14,4,3,50.51,Difficile,Difficile,Difficile / Difficile
95,96,2015,Ingenieurie,12,5,QO,38,33,21,12,1.15,63.64,21,17,54.39,Trop Facile,Difficile,Trop Facile / Difficile
925,96,2016,Ingenieurie,12,5,QO,46,39,10,29,1.18,25.64,10,36,22.16,Trop Difficile,Trop Difficile,Trop Difficile / Trop Difficile
1755,96,2017,Ingenieurie,12,5,QO,53,49,13,36,1.08,26.53,13,40,23.92,Trop Difficile,Trop Difficile,Trop Difficile / Trop Difficile
2585,96,2018,Ingenieurie,12,5,QO,43,28,3,25,1.54,10.71,3,40,5.94,Trop Difficile,Trop Difficile,Trop Difficile / Trop Difficile
3415,96,2019,Ingenieurie,12,5,QO,36,35,32,3,1.03,91.43,32,4,89.98,Trop Difficile,Trop Facile,Trop Difficile / Trop Facile
4245,96,2020,Ingenieurie,12,5,QO,34,28,1,27,1.21,3.57,1,33,3.97,Trop Difficile,Trop Difficile,Trop Difficile / Trop Difficile
96,97,2015,Ingenieurie,12,6,QCU,94,49,34,15,1.92,69.39,34,60,36.65,Facile,Difficile,Facile / Difficile
926,97,2016,Ingenieurie,12,6,QCU,109,105,104,1,1.04,99.05,104,5,95.55,Difficile,Trop Facile,Difficile / Trop Facile
1756,97,2017,Ingenieurie,12,6,QCU,111,93,59,34,1.19,63.44,59,52,53.53,Difficile,Difficile,Difficile / Difficile
2586,97,2018,Ingenieurie,12,6,QCU,95,47,33,14,2.02,70.21,33,62,34.54,Difficile,Difficile,Difficile / Difficile
3416,97,2019,Ingenieurie,12,6,QCU,94,36,3,33,2.61,8.33,3,91,2.9,Difficile,Trop Difficile,Difficile / Trop Difficile
4246,97,2020,Ingenieurie,12,6,QCU,101,91,28,63,1.11,30.77,28,73,27.73,Difficile,Difficile,Difficile / Difficile
97,98,2015,Ingenieurie,12,7,QCM,19,5,3,2,3.8,60.0,3,16,14.5,Trop Difficile,Trop Difficile,Trop Difficile / Trop Difficile
927,98,2016,Ingenieurie,12,7,QCM,23,21,11,10,1.1,52.38,11,12,47.44,Difficile,Difficile,Difficile / Difficile
1757,98,2017,Ingenieurie,12,7,QCM,28,25,16,9,1.12,64.0,16,12,58.0,Difficile,Difficile,Difficile / Difficile
2587,98,2018,Ingenieurie,12,7,QCM,26,25,14,11,1.04,56.0,14,12,54.46,Difficile,Difficile,Difficile / Difficile
3417,98,2019,Ingenieurie,12,7,QCM,29,27,11,16,1.07,40.74,11,18,37.84,Difficile,Difficile,Difficile / Difficile
4247,98,2020,Ingenieurie,12,7,QCM,31,30,28,2,1.03,93.33,28,3,89.01,Difficile,Trop Facile,Difficile / Trop Facile
98,99,2015,Ingenieurie,12,8,QROC,71,66,62,4,1.08,93.94,62,9,87.21,Difficile,Trop Facile,Difficile / Trop Facile
928,99,2016,Ingenieurie,12,8,QROC,77,71,10,61,1.08,14.08,10,67,13.37,Difficile,Trop Difficile,Difficile / Trop Difficile
1758,99,2017,Ingenieurie,12,8,QROC,69,45,37,8,1.53,82.22,37,32,54.18,Difficile,Difficile,Difficile / Difficile
2588,99,2018,Ingenieurie,12,8,QROC,55,25,18,7,2.2,72.0,18,37,32.57,Difficile,Difficile,Difficile / Difficile
3418,99,2019,Ingenieurie,12,8,QROC,56,46,46,0,1.22,100.0,46,10,81.88,Difficile,Facile,Difficile / Facile
4248,99,2020,Ingenieurie,12,8,QROC,60,60,56,4,1.0,93.33,56,4,93.36,Difficile,Trop Facile,Difficile / Trop Facile
99,100,2015,Ingenieurie,12,9,QCU,78,69,61,8,1.13,88.41,61,17,77.77,Facile,Facile,Facile / Facile
929,100,2016,Ingenieurie,12,9,QCU,88,81,34,47,1.09,41.98,34,54,38.74,Difficile,Difficile,Difficile / Difficile
1759,100,2017,Ingenieurie,12,9,QCU,80,77,13,64,1.04,16.88,13,67,16.8,Difficile,Trop Difficile,Difficile / Trop Difficile
2589,100,2018,Ingenieurie,12,9,QCU,89,76,48,28,1.17,63.16,48,41,54.01,Difficile,Difficile,Difficile / Difficile
3419,100,2019,Ingenieurie,12,9,QCU,106,102,40,62,1.04,39.22,40,66,37.56,Difficile,Difficile,Difficile / Difficile
4249,100,2020,Ingenieurie,12,9,QCU,101,63,52,11,1.6,82.54,52,49,51.44,Difficile,Difficile,Difficile / Difficile
100,101,2015,Ingenieurie,12,10,QCM,36,35,31,4,1.03,88.57,31,5,84.87,Facile,Facile,Facile / Facile
930,101,2016,Ingenieurie,12,10,QCM,42,31,5,26,1.35,16.13,5,37,12.0,Difficile,Trop Difficile,Difficile / Trop Difficile
1760,101,2017,Ingenieurie,12,10,QCM,50,29,26,3,1.72,89.66,26,24,51.0,Difficile,Difficile,Difficile / Difficile
2590,101,2018,Ingenieurie,12,10,QCM,59,21,21,0,2.81,100.0,21,38,35.97,Difficile,Difficile,Difficile / Difficile
3420,101,2019,Ingenieurie,12,10,QCM,65,39,21,18,1.67,53.85,21,44,31.77,Difficile,Difficile,Difficile / Difficile
4250,101,2020,Ingenieurie,12,10,QCM,66,31,28,3,2.13,90.32,28,38,41.69,Difficile,Difficile,Difficile / Difficile
101,102,2015,Ingenieurie,13,1,QCU,36,15,7,8,2.4,46.67,7,29,20.56,Adapte,Trop Difficile,Adapte / Trop Difficile
931,102,2016,Ingenieurie,13,1,QCU,30,25,9,16,1.2,36.0,9,21,31.13,Difficile,Difficile,Difficile / Difficile
1761,102,2017,Ingenieurie,13,1,QCU,28,25,7,18,1.12,28.0,7,21,26.59,Difficile,Difficile,Difficile / Difficile
2591,102,2018,Ingenieurie,13,1,QCU,30,27,10,17,1.11,37.04,10,20,34.63,Difficile,Difficile,Difficile / Difficile
3421,102,2019,Ingenieurie,13,1,QCU,24,19,17,2,1.26,89.47,17,7,72.86,Difficile,Adapte,Difficile / Adapte
4251,102,2020,Ingenieurie,13,1,QCU,27,19,19,0,1.42,100.0,19,8,69.08,Adapte,Adapte,Adapte / Adapte
102,103,2015,Ingenieurie,13,2,QROC,55,39,30,9,1.41,76.92,30,25,53.77,Difficile,Difficile,Difficile / Difficile
932,103,2016,Ingenieurie,13,2,QROC,61,25,6,19,2.44,24.0,6,55,10.22,Difficile,Trop Difficile,Difficile / Trop Difficile
1762,103,2017,Ingenieurie,13,2,QROC,63,48,35,13,1.31,72.92,35,28,55.86,Difficile,Difficile,Difficile / Difficile
2592,103,2018,Ingenieurie,13,2,QROC,65,32,23,9,2.03,71.88,23,42,35.22,Difficile,Difficile,Difficile / Difficile
3422,103,2019,Ingenieurie,13,2,QROC,53,22,18,4,2.41,81.82,18,35,34.6,Difficile,Difficile,Difficile / Difficile
4252,103,2020,Ingenieurie,13,2,QROC,54,47,7,40,1.15,14.89,7,47,12.7,Difficile,Trop Difficile,Difficile / Trop Difficile
103,104,2015,Ingenieurie,13,3,QCU,69,42,13,29,1.64,30.95,13,56,19.12,Trop Difficile,Trop Difficile,Trop Difficile / Trop Difficile
933,104,2016,Ingenieurie,13,3,QCU,74,50,40,10,1.48,80.0,40,34,54.27,Difficile,Difficile,Difficile / Difficile
1763,104,2017,Ingenieurie,13,3,QCU,89,67,49,18,1.33,73.13,49,40,55.11,Difficile,Difficile,Difficile / Difficile
2593,104,2018,Ingenieurie,13,3,QCU,99,71,46,25,1.39,64.79,46,53,46.31,Difficile,Difficile,Difficile / Difficile
3423,104,2019,Ingenieurie,13,3,QCU,86,35,23,12,2.46,65.71,23,63,26.9,Difficile,Difficile,Difficile / Difficile
4253,104,2020,Ingenieurie,13,3,QCU,94,48,25,23,1.96,52.08,25,69,26.34,Difficile,Difficile,Difficile / Difficile
104,105,2015,Ingenieurie,13,4,QCU,97,37,13,24,2.62,35.14,13,84,13.25,Trop Facile,Trop Difficile,Trop Facile / Trop Difficile
934,105,2016,Ingenieurie,13,4,QCU,107,70,40,30,1.53,57.14,40,67,37.12,Difficile,Difficile,Difficile / Difficile
1764,105,2017,Ingenieurie,13,4,QCU,121,100,96,4,1.21,96.0,96,25,79.38,Difficile,Facile,Difficile / Facile
2594,105,2018,Ingenieurie,13,4,QCU,101,92,75,17,1.1,81.52,75,26,73.95,Difficile,Adapte,Difficile / Adapte
3424,105,2019,Ingenieurie,13,4,QCU,96,73,64,9,1.32,87.67,64,32,66.29,Adapte,Adapte,Adapte / Adapte
4254,105,2020,Ingenieurie,13,4,QCU,95,82,67,15,1.16,81.71,67,28,70.1,Adapte,Adapte,Adapte / Adapte
105,106,2015,Ingenieurie,13,5,QCU,57,42,29,13,1.36,69.05,29,28,50.94,Difficile,Difficile,Difficile / Difficile
935,106,2016,Ingenieurie,13,5,QCU,59,38,22,16,1.55,57.89,22,37,37.22,Difficile,Difficile,Difficile / Difficile
1765,106,2017,Ingenieurie,13,5,QCU,57,21,10,11,2.71,47.62,10,47,16.88,Difficile,Trop Difficile,Difficile / Trop Difficile
2595,106,2018,Ingenieurie,13,5,QCU,59,39,21,18,1.51,53.85,21,38,34.79,Difficile,Difficile,Difficile / Difficile
3425,106,2019,Ingenieurie,13,5,QCU,58,53,29,24,1.09,54.72,29,29,49.63,Difficile,Difficile,Difficile / Difficile
4255,106,2020,Ingenieurie,13,5,QCU,58,50,15,35,1.16,30.0,15,43,26.71,Difficile,Difficile,Difficile / Difficile
106,107,2015,Ingenieurie,13,6,QROC,56,50,46,4,1.12,92.0,46,10,82.86,Facile,Facile,Facile / Facile
936,107,2016,Ingenieurie,13,6,QROC,53,26,19,7,2.04,73.08,19,34,35.1,Difficile,Difficile,Difficile / Difficile
1766,107,2017,Ingenieurie,13,6,QROC,48,41,24,17,1.17,58.54,24,24,50.69,Difficile,Difficile,Difficile / Difficile
2596,107,2018,Ingenieurie,13,6,QROC,38,38,16,22,1.0,42.11,16,22,41.3,Difficile,Difficile,Difficile / Difficile
3426,107,2019,Ingenieurie,13,6,QROC,44,37,36,1,1.19,97.3,36,8,80.82,Difficile,Facile,Difficile / Facile
4256,107,2020,Ingenieurie,13,6,QROC,40,24,16,8,1.67,66.67,16,24,40.62,Difficile,Difficile,Difficile / Difficile
107,108,2015,Ingenieurie,13,7,QCM,19,15,1,14,1.27,6.67,1,18,4.98,Trop Difficile,Trop Difficile,Trop Difficile / Trop Difficile
937,108,2016,Ingenieurie,13,7,QCM,19,18,16,2,1.06,88.89,16,3,82.29,Difficile,Facile,Difficile / Facile
1767,108,2017,Ingenieurie,13,7,QCM,21,13,10,3,1.62,76.92,10,11,46.93,Difficile,Difficile,Difficile / Difficile
2597,108,2018,Ingenieurie,13,7,QCM,22,21,18,3,1.05,85.71,18,4,81.58,Difficile,Facile,Difficile / Facile
3427,108,2019,Ingenieurie,13,7,QCM,24,23,19,4,1.04,82.61,19,5,77.22,Difficile,Facile,Difficile / Facile
4257,108,2020,Ingenieurie,13,7,QCM,19,18,9,9,1.06,50.0,9,10,45.4,Difficile,Difficile,Difficile / Difficile
108,109,2015,Ingenieurie,14,1,QROC,78,43,37,6,1.81,86.05,37,41,47.81,Difficile,Difficile,Difficile / Difficile
938,109,2016,Ingenieurie,14,1,QROC,73,54,43,11,1.35,79.63,43,30,58.96,Difficile,Difficile,Difficile / Difficile
1768,109,2017,Ingenieurie,14,1,QROC,70,40,31,9,1.75,77.5,31,39,43.93,Difficile,Difficile,Difficile / Difficile
2598,109,2018,Ingenieurie,14,1,QROC,63,51,44,7,1.24,86.27,44,19,69.42,Difficile,Adapte,Difficile / Adapte
3428,109,2019,Ingenieurie,14,1,QROC,59,45,36,9,1.31,80.0,36,23,61.71,Adapte,Adapte,Adapte / Adapte
4258,109,2020,Ingenieurie,14,1,QROC,59,42,41,1,1.4,97.62,41,18,68.86,Adapte,Adapte,Adapte / Adapte
109,110,2015,Ingenieurie,14,2,QCM,61,58,39,19,1.05,67.24,39,22,64.18,Difficile,Adapte,Difficile / Adapte
939,110,2016,Ingenieurie,14,2,QCM,64,49,44,5,1.31,89.8,44,20,68.37,Adapte,Adapte,Adapte / Adapte
1769,110,2017,Ingenieurie,14,2,QCM,77,65,49,16,1.18,75.38,49,28,63.69,Adapte,Adapte,Adapte / Adapte
2599,110,2018,Ingenieurie,14,2,QCM,90,76,58,18,1.18,76.32,58,32,63.95,Adapte,Adapte,Adapte / Adapte
3429,110,2019,Ingenieurie,14,2,QCM,101,77,75,2,1.31,97.4,75,26,74.18,Adapte,Adapte,Adapte / Adapte
4259,110,2020,Ingenieurie,14,2,QCM,112,107,72,35,1.05,67.29,72,40,64.55,Adapte,Adapte,Adapte / Adapte
110,111,2015,Ingenieurie,15,1,QCM,37,25,17,8,1.48,68.0,17,20,47.04,Difficile,Difficile,Difficile / Difficile
940,111,2016,Ingenieurie,15,1,QCM,37,11,10,1,3.36,90.91,10,27,27.23,Difficile,Difficile,Difficile / Difficile
1770,111,2017,Ingenieurie,15,1,QCM,38,10,2,8,3.8,20.0,2,36,5.78,Difficile,Trop Difficile,Difficile / Trop Difficile
2600,111,2018,Ingenieurie,15,1,QCM,42,25,22,3,1.68,88.0,22,20,53.54,Difficile,Difficile,Difficile / Difficile
3430,111,2019,Ingenieurie,15,1,QCM,36,36,36,0,1.0,100.0,36,0,99.72,Difficile,Trop Facile,Difficile / Trop Facile
4260,111,2020,Ingenieurie,15,1,QCM,39,19,17,2,2.05,89.47,17,22,43.97,Difficile,Difficile,Difficile / Difficile
111,112,2015,Management,1,1,QCM,72,56,44,12,1.29,78.57,44,28,61.54,Adapte,Adapte,Adapte / Adapte
941,112,2016,Management,1,1,QCM,59,49,42,7,1.2,85.71,42,17,70.41,Adapte,Adapte,Adapte / Adapte
1771,112,2017,Management,1,1,QCM,59,57,44,13,1.04,77.19,44,15,74.59,Adapte,Adapte,Adapte / Adapte
2601,112,2018,Management,1,1,QCM,54,46,37,9,1.17,80.43,37,17,68.45,Adapte,Adapte,Adapte / Adapte
3431,112,2019,Management,1,1,QCM,50,41,37,4,1.22,90.24,37,13,74.46,Adapte,Adapte,Adapte / Adapte
4261,112,2020,Management,1,1,QCM,45,43,31,12,1.05,72.09,31,14,68.37,Adapte,Adapte,Adapte / Adapte
112,113,2015,Management,1,2,QCU,17,15,14,1,1.13,93.33,14,3,84.2,Facile,Facile,Facile / Facile
942,113,2016,Management,1,2,QCU,16,14,3,11,1.14,21.43,3,13,18.04,Difficile,Trop Difficile,Difficile / Trop Difficile
1772,113,2017,Management,1,2,QCU,18,12,10,2,1.5,83.33,10,8,53.73,Difficile,Difficile,Difficile / Difficile
2602,113,2018,Management,1,2,QCU,22,20,18,2,1.1,90.0,18,4,80.15,Difficile,Facile,Difficile / Facile
3432,113,2019,Management,1,2,QCU,19,15,6,9,1.27,40.0,6,13,28.97,Difficile,Difficile,Difficile / Difficile
4262,113,2020,Management,1,2,QCU,21,18,17,1,1.17,94.44,17,4,81.15,Difficile,Facile,Difficile / Facile
113,114,2015,Management,1,3,QCU,11,10,6,4,1.1,60.0,6,5,54.88,Trop Facile,Difficile,Trop Facile / Difficile
943,114,2016,Management,1,3,QCU,10,8,6,2,1.25,75.0,6,4,60.27,Difficile,Adapte,Difficile / Adapte
1773,114,2017,Management,1,3,QCU,12,10,9,1,1.2,90.0,9,3,74.86,Adapte,Adapte,Adapte / Adapte
2603,114,2018,Management,1,3,QCU,11,10,8,2,1.1,80.0,8,3,70.55,Adapte,Adapte,Adapte / Adapte
3433,114,2019,Management,1,3,QCU,12,9,8,1,1.33,88.89,8,4,70.03,Adapte,Adapte,Adapte / Adapte
4263,114,2020,Management,1,3,QCU,10,9,7,2,1.11,77.78,7,3,66.32,Adapte,Adapte,Adapte / Adapte
114,115,2015,Management,1,4,QCU,58,44,0,44,1.32,0.0,0,58,0.64,Adapte,Trop Difficile,Adapte / Trop Difficile
944,115,2016,Management,1,4,QCU,62,43,31,12,1.44,72.09,31,31,49.36,Difficile,Difficile,Difficile / Difficile
1774,115,2017,Management,1,4,QCU,56,48,17,31,1.17,35.42,17,39,30.93,Difficile,Difficile,Difficile / Difficile
2604,115,2018,Management,1,4,QCU,51,27,26,1,1.89,96.3,26,25,50.77,Difficile,Difficile,Difficile / Difficile
3434,115,2019,Management,1,4,QCU,57,46,33,13,1.24,71.74,33,24,58.4,Difficile,Difficile,Difficile / Difficile
4264,115,2020,Management,1,4,QCU,56,49,30,19,1.14,61.22,30,26,53.52,Difficile,Difficile,Difficile / Difficile
115,116,2015,Management,1,5,QCU,25,25,21,4,1.0,84.0,21,4,83.17,Facile,Facile,Facile / Facile
945,116,2016,Management,1,5,QCU,24,18,8,10,1.33,44.44,8,16,32.69,Difficile,Difficile,Difficile / Difficile
1775,116,2017,Management,1,5,QCU,20,13,10,3,1.54,76.92,10,10,49.66,Difficile,Difficile,Difficile / Difficile
2605,116,2018,Management,1,5,QCU,17,7,6,1,2.43,85.71,6,11,36.65,Difficile,Difficile,Difficile / Difficile
3435,116,2019,Management,1,5,QCU,16,9,7,2,1.78,77.78,7,9,41.44,Difficile,Difficile,Difficile / Difficile
4265,116,2020,Management,1,5,QCU,16,14,11,3,1.14,78.57,11,5,70.04,Difficile,Adapte,Difficile / Adapte
116,117,2015,Management,2,1,QCU,49,32,26,6,1.53,81.25,26,23,53.23,Trop Facile,Difficile,Trop Facile / Difficile
946,117,2016,Management,2,1,QCU,58,55,48,7,1.05,87.27,48,10,82.8,Difficile,Facile,Difficile / Facile
1776,117,2017,Management,2,1,QCU,59,41,32,9,1.44,78.05,32,27,54.88,Difficile,Difficile,Difficile / Difficile
2606,117,2018,Management,2,1,QCU,63,61,21,40,1.03,34.43,21,42,33.56,Difficile,Difficile,Difficile / Difficile
3436,117,2019,Management,2,1,QCU,67,35,6,29,1.91,17.14,6,61,8.47,Difficile,Trop Difficile,Difficile / Trop Difficile
4266,117,2020,Management,2,1,QCU,77,73,23,50,1.05,31.51,23,54,29.62,Difficile,Difficile,Difficile / Difficile
117,118,2015,Management,2,2,QCU,84,68,68,0,1.24,100.0,68,16,81.28,Facile,Facile,Facile / Facile
947,118,2016,Management,2,2,QCU,68,33,28,5,2.06,84.85,28,40,40.92,Difficile,Difficile,Difficile / Difficile
1777,118,2017,Management,2,2,QCU,79,30,29,1,2.63,96.67,29,50,36.54,Difficile,Difficile,Difficile / Difficile
2607,118,2018,Management,2,2,QCU,88,83,68,15,1.06,81.93,68,20,77.03,Difficile,Facile,Difficile / Facile
3437,118,2019,Management,2,2,QCU,104,102,13,89,1.02,12.75,13,91,12.64,Difficile,Trop Difficile,Difficile / Trop Difficile
4267,118,2020,Management,2,2,QCU,104,55,52,3,1.89,94.55,52,52,50.0,Difficile,Difficile,Difficile / Difficile
118,119,2015,Management,2,3,QCM,92,85,19,66,1.08,22.35,19,73,21.01,Trop Difficile,Trop Difficile,Trop Difficile / Trop Difficile
948,119,2016,Management,2,3,QCM,83,63,61,2,1.32,96.83,61,22,73.35,Difficile,Adapte,Difficile / Adapte
1778,119,2017,Management,2,3,QCM,97,79,69,10,1.23,87.34,69,28,70.98,Adapte,Adapte,Adapte / Adapte
2608,119,2018,Management,2,3,QCM,101,65,63,2,1.55,96.92,63,38,62.64,Adapte,Adapte,Adapte / Adapte
3438,119,2019,Management,2,3,QCM,117,98,84,14,1.19,85.71,84,33,72.17,Adapte,Adapte,Adapte / Adapte
4268,119,2020,Management,2,3,QCM,137,129,102,27,1.06,79.07,102,35,74.6,Adapte,Adapte,Adapte / Adapte
119,120,2015,Management,2,4,QCM,5,5,4,1,1.0,80.0,4,1,76.47,Facile,Facile,Facile / Facile
949,120,2016,Management,2,4,QCM,5,4,4,0,1.25,100.0,4,1,70.08,Difficile,Adapte,Difficile / Adapte
1779,120,2017,Management,2,4,QCM,5,4,4,0,1.25,100.0,4,1,72.24,Adapte,Adapte,Adapte / Adapte
2609,120,2018,Management,2,4,QCM,4,4,3,1,1.0,75.0,3,1,62.83,Adapte,Adapte,Adapte / Adapte
3439,120,2019,Management,2,4,QCM,3,2,2,0,1.5,100.0,2,1,60.34,Adapte,Adapte,Adapte / Adapte
4269,120,2020,Management,2,4,QCM,4,4,3,1,1.0,75.0,3,1,74.91,Adapte,Adapte,Adapte / Adapte
120,121,2015,Management,2,5,QCU,35,21,3,18,1.67,14.29,3,32,8.5,Difficile,Trop Difficile,Difficile / Trop Difficile
950,121,2016,Management,2,5,QCU,29,19,14,5,1.53,73.68,14,15,47.37,Difficile,Difficile,Difficile / Difficile
1780,121,2017,Management,2,5,QCU,27,11,0,11,2.45,0.0,0,27,0.23,Difficile,Trop Difficile,Difficile / Trop Difficile
2610,121,2018,Management,2,5,QCU,24,24,22,2,1.0,91.67,22,2,89.83,Difficile,Trop Facile,Difficile / Trop Facile
3440,121,2019,Management,2,5,QCU,24,22,16,6,1.09,72.73,16,8,65.87,Difficile,Adapte,Difficile / Adapte
4270,121,2020,Management,2,5,QCU,24,18,15,3,1.33,83.33,15,9,61.52,Adapte,Adapte,Adapte / Adapte
121,122,2015,Management,2,6,QCU,94,94,21,73,1.0,22.34,21,73,22.25,Trop Difficile,Trop Difficile,Trop Difficile / Trop Difficile
951,122,2016,Management,2,6,QCU,87,71,48,23,1.23,67.61,48,39,54.94,Difficile,Difficile,Difficile / Difficile
1781,122,2017,Management,2,6,QCU,90,88,42,46,1.02,47.73,42,48,46.2,Difficile,Difficile,Difficile / Difficile
2611,122,2018,Management,2,6,QCU,77,62,24,38,1.24,38.71,24,53,31.49,Difficile,Difficile,Difficile / Difficile
3441,122,2019,Management,2,6,QCU,66,46,35,11,1.43,76.09,35,31,53.04,Difficile,Difficile,Difficile / Difficile
4271,122,2020,Management,2,6,QCU,76,60,56,4,1.27,93.33,56,20,73.1,Difficile,Adapte,Difficile / Adapte
122,123,2015,Management,2,7,QCU,66,66,65,1,1.0,98.48,65,1,98.15,Adapte,Trop Facile,Adapte / Trop Facile
952,123,2016,Management,2,7,QCU,63,43,36,7,1.47,83.72,36,27,57.91,Difficile,Difficile,Difficile / Difficile
1782,123,2017,Management,2,7,QCU,61,42,32,10,1.45,76.19,32,29,52.07,Difficile,Difficile,Difficile / Difficile
2612,123,2018,Management,2,7,QCU,55,22,20,2,2.5,90.91,20,35,36.41,Difficile,Difficile,Difficile / Difficile
3442,123,2019,Management,2,7,QCU,45,34,24,10,1.32,70.59,24,21,53.29,Difficile,Difficile,Difficile / Difficile
4272,123,2020,Management,2,7,QCU,53,27,1,26,1.96,3.7,1,52,1.32,Difficile,Trop Difficile,Difficile / Trop Difficile
123,124,2015,Management,2,8,QCU,47,29,0,29,1.62,0.0,0,47,0.42,Trop Difficile,Trop Difficile,Trop Difficile / Trop Difficile
953,124,2016,Management,2,8,QCU,52,21,14,7,2.48,66.67,14,38,26.98,Difficile,Difficile,Difficile / Difficile
1783,124,2017,Management,2,8,QCU,53,49,29,20,1.08,59.18,29,24,54.26,Difficile,Difficile,Difficile / Difficile
2613,124,2018,Management,2,8,QCU,57,33,14,19,1.73,42.42,14,43,25.11,Difficile,Difficile,Difficile / Difficile
3443,124,2019,Management,2,8,QCU,60,53,7,46,1.13,13.21,7,53,12.03,Difficile,Trop Difficile,Difficile / Trop Difficile
4273,124,2020,Management,2,8,QCU,62,52,50,2,1.19,96.15,50,12,79.91,Difficile,Facile,Difficile / Facile
124,125,2015,Management,2,9,QCM,18,16,12,4,1.12,75.0,12,6,69.32,Adapte,Adapte,Adapte / Adapte
954,125,2016,Management,2,9,QCM,20,18,12,6,1.11,66.67,12,8,61.14,Adapte,Adapte,Adapte / Adapte
1784,125,2017,Management,2,9,QCM,18,13,11,2,1.38,84.62,11,7,60.64,Adapte,Adapte,Adapte / Adapte
2614,125,2018,Management,2,9,QCM,16,14,11,3,1.14,78.57,11,5,67.37,Adapte,Adapte,Adapte / Adapte
3444,125,2019,Management,2,9,QCM,17,11,10,1,1.55,90.91,10,7,61.36,Adapte,Adapte,Adapte / Adapte
4274,125,2020,Management,2,9,QCM,20,15,13,2,1.33,86.67,13,7,63.27,Adapte,Adapte,Adapte / Adapte
125,126,2015,Management,2,10,QCU,80,66,62,4,1.21,93.94,62,18,77.45,Facile,Facile,Facile / Facile
955,126,2016,Management,2,10,QCU,96,54,29,25,1.78,53.7,29,67,29.76,Difficile,Difficile,Difficile / Difficile
1785,126,2017,Management,2,10,QCU,113,98,74,24,1.15,75.51,74,39,65.85,Difficile,Adapte,Difficile / Adapte
2615,126,2018,Management,2,10,QCU,98,91,72,19,1.08,79.12,72,26,73.5,Adapte,Adapte,Adapte / Adapte
3445,126,2019,Management,2,10,QCU,90,82,66,16,1.1,80.49,66,24,73.54,Adapte,Adapte,Adapte / Adapte
4275,126,2020,Management,2,10,QCU,73,51,48,3,1.43,94.12,48,25,65.58,Adapte,Adapte,Adapte / Adapte
126,127,2015,Management,2,11,QCM,94,83,80,3,1.13,96.39,80,14,84.67,Facile,Facile,Facile / Facile
956,127,2016,Management,2,11,QCM,97,93,79,14,1.04,84.95,79,18,81.9,Difficile,Facile,Difficile / Facile
1786,127,2017,Management,2,11,QCM,81,74,71,3,1.09,95.95,71,10,87.74,Difficile,Trop Facile,Difficile / Trop Facile
2616,127,2018,Management,2,11,QCM,95,61,54,7,1.56,88.52,54,41,57.34,Difficile,Difficile,Difficile / Difficile
3446,127,2019,Management,2,11,QCM,88,82,36,46,1.07,43.9,36,52,41.09,Difficile,Difficile,Difficile / Difficile
4276,127,2020,Management,2,11,QCM,75,50,36,14,1.5,72.0,36,39,47.91,Difficile,Difficile,Difficile / Difficile
127,128,2015,Management,3,1,QCM,67,59,41,18,1.14,69.49,41,26,61.45,Adapte,Adapte,Adapte / Adapte
957,128,2016,Management,3,1,QCM,73,65,46,19,1.12,70.77,46,27,63.52,Adapte,Adapte,Adapte / Adapte
1787,128,2017,Management,3,1,QCM,77,55,54,1,1.4,98.18,54,23,70.04,Adapte,Adapte,Adapte / Adapte
2617,128,2018,Management,3,1,QCM,91,76,57,19,1.2,75.0,57,34,63.04,Adapte,Adapte,Adapte / Adapte
3447,128,2019,Management,3,1,QCM,84,70,63,7,1.2,90.0,63,21,74.8,Adapte,Adapte,Adapte / Adapte
4277,128,2020,Management,3,1,QCM,70,62,49,13,1.13,79.03,49,21,69.54,Adapte,Adapte,Adapte / Adapte
128,129,2015,Management,3,2,QCU,59,39,4,35,1.51,10.26,4,55,6.02,Trop Difficile,Trop Difficile,Trop Difficile / Trop Difficile
958,129,2016,Management,3,2,QCU,65,51,48,3,1.27,94.12,48,17,73.41,Difficile,Adapte,Difficile / Adapte
1788,129,2017,Management,3,2,QCU,75,57,50,7,1.32,87.72,50,25,67.23,Adapte,Adapte,Adapte / Adapte
2618,129,2018,Management,3,2,QCU,87,80,63,17,1.09,78.75,63,24,72.52,Adapte,Adapte,Adapte / Adapte
3448,129,2019,Management,3,2,QCU,87,82,57,25,1.06,69.51,57,30,65.07,Adapte,Adapte,Adapte / Adapte
4278,129,2020,Management,3,2,QCU,83,69,52,17,1.2,75.36,52,31,62.12,Adapte,Adapte,Adapte / Adapte
129,130,2015,Management,3,3,QCU,91,75,30,45,1.21,40.0,30,61,32.74,Trop Difficile,Difficile,Trop Difficile / Difficile
959,130,2016,Management,3,3,QCU,82,30,23,7,2.73,76.67,23,59,28.26,Difficile,Difficile,Difficile / Difficile
1789,130,2017,Management,3,3,QCU,98,60,21,39,1.63,35.0,21,77,21.33,Difficile,Trop Difficile,Difficile / Trop Difficile
2619,130,2018,Management,3,3,QCU,83,35,25,10,2.37,71.43,25,58,29.94,Difficile,Difficile,Difficile / Difficile
3449,130,2019,Management,3,3,QCU,88,75,70,5,1.17,93.33,70,18,79.73,Difficile,Facile,Difficile / Facile
4279,130,2020,Management,3,3,QCU,86,52,43,9,1.65,82.69,43,43,50.15,Difficile,Difficile,Difficile / Difficile
130,131,2015,Management,3,4,QCU,84,80,70,10,1.05,87.5,70,14,83.47,Facile,Facile,Facile / Facile
960,131,2016,Management,3,4,QCU,85,70,41,29,1.21,58.57,41,44,47.77,Difficile,Difficile,Difficile / Difficile
1790,131,2017,Management,3,4,QCU,84,50,30,20,1.68,60.0,30,54,35.21,Difficile,Difficile,Difficile / Difficile
2620,131,2018,Management,3,4,QCU,89,64,46,18,1.39,71.88,46,43,51.85,Difficile,Difficile,Difficile / Difficile
3450,131,2019,Management,3,4,QCU,107,97,88,9,1.1,90.72,88,19,82.68,Difficile,Facile,Difficile / Facile
4280,131,2020,Management,3,4,QCU,102,72,34,38,1.42,47.22,34,68,33.82,Difficile,Difficile,Difficile / Difficile
131,132,2015,Management,3,5,QROC,64,49,45,4,1.31,91.84,45,19,69.72,Adapte,Adapte,Adapte / Adapte
961,132,2016,Management,3,5,QROC,57,50,36,14,1.14,72.0,36,21,62.82,Adapte,Adapte,Adapte / Adapte
1791,132,2017,Management,3,5,QROC,53,44,33,11,1.2,75.0,33,20,61.73,Adapte,Adapte,Adapte / Adapte
2621,132,2018,Management,3,5,QROC,62,57,42,15,1.09,73.68,42,20,67.51,Adapte,Adapte,Adapte / Adapte
3451,132,2019,Management,3,5,QROC,71,65,52,13,1.09,80.0,52,19,73.81,Adapte,Adapte,Adapte / Adapte
4281,132,2020,Management,3,5,QROC,74,53,51,2,1.4,96.23,51,23,69.18,Adapte,Adapte,Adapte / Adapte
132,133,2015,Management,3,6,QCU,84,74,62,12,1.14,83.78,62,22,73.49,Difficile,Adapte,Difficile / Adapte
962,133,2016,Management,3,6,QCU,75,70,54,16,1.07,77.14,54,21,71.6,Adapte,Adapte,Adapte / Adapte
1792,133,2017,Management,3,6,QCU,84,58,51,7,1.45,87.93,51,33,61.19,Adapte,Adapte,Adapte / Adapte
2622,133,2018,Management,3,6,QCU,98,77,65,12,1.27,84.42,65,33,66.19,Adapte,Adapte,Adapte / Adapte
3452,133,2019,Management,3,6,QCU,103,85,76,9,1.21,89.41,76,27,73.58,Adapte,Adapte,Adapte / Adapte
4282,133,2020,Management,3,6,QCU,117,112,77,35,1.04,68.75,77,40,65.57,Adapte,Adapte,Adapte / Adapte
133,134,2015,Management,3,7,QROC,31,29,19,10,1.07,65.52,19,12,61.12,Facile,Adapte,Facile / Adapte
963,134,2016,Management,3,7,QROC,26,22,19,3,1.18,86.36,19,7,74.8,Adapte,Adapte,Adapte / Adapte
1793,134,2017,Management,3,7,QROC,31,30,21,9,1.03,70.0,21,10,66.27,Adapte,Adapte,Adapte / Adapte
2623,134,2018,Management,3,7,QROC,30,25,20,5,1.2,80.0,20,10,67.16,Adapte,Adapte,Adapte / Adapte
3453,134,2019,Management,3,7,QROC,35,34,21,13,1.03,61.76,21,14,60.3,Adapte,Adapte,Adapte / Adapte
4283,134,2020,Management,3,7,QROC,42,36,28,8,1.17,77.78,28,14,66.09,Adapte,Adapte,Adapte / Adapte
134,135,2015,Management,3,8,QCU,19,17,11,6,1.12,64.71,11,8,56.94,Difficile,Difficile,Difficile / Difficile
964,135,2016,Management,3,8,QCU,19,15,14,1,1.27,93.33,14,5,73.35,Difficile,Adapte,Difficile / Adapte
1794,135,2017,Management,3,8,QCU,23,21,14,7,1.1,66.67,14,9,62.31,Adapte,Adapte,Adapte / Adapte
2624,135,2018,Management,3,8,QCU,19,18,12,6,1.06,66.67,12,7,64.36,Adapte,Adapte,Adapte / Adapte
3454,135,2019,Management,3,8,QCU,18,12,11,1,1.5,91.67,11,7,61.2,Adapte,Adapte,Adapte / Adapte
4284,135,2020,Management,3,8,QCU,17,12,10,2,1.42,83.33,10,7,60.65,Adapte,Adapte,Adapte / Adapte
135,136,2015,Management,3,9,QCM,99,97,73,24,1.02,75.26,73,26,74.01,Difficile,Adapte,Difficile / Adapte
965,136,2016,Management,3,9,QCM,113,107,82,25,1.06,76.64,82,31,72.2,Adapte,Adapte,Adapte / Adapte
1795,136,2017,Management,3,9,QCM,91,67,64,3,1.36,95.52,64,27,70.71,Adapte,Adapte,Adapte / Adapte
2625,136,2018,Management,3,9,QCM,74,66,54,12,1.12,81.82,54,20,72.54,Adapte,Adapte,Adapte / Adapte
3455,136,2019,Management,3,9,QCM,67,57,48,9,1.18,84.21,48,19,72.34,Adapte,Adapte,Adapte / Adapte
4285,136,2020,Management,3,9,QCM,58,54,42,12,1.07,77.78,42,16,72.97,Adapte,Adapte,Adapte / Adapte
136,137,2015,Management,3,10,QCM,57,45,44,1,1.27,97.78,44,13,77.97,Facile,Facile,Facile / Facile
966,137,2016,Management,3,10,QCM,55,16,15,1,3.44,93.75,15,40,27.39,Difficile,Difficile,Difficile / Difficile
1796,137,2017,Management,3,10,QCM,44,27,0,27,1.63,0.0,0,44,0.81,Difficile,Trop Difficile,Difficile / Trop Difficile
2626,137,2018,Management,3,10,QCM,47,37,23,14,1.27,62.16,23,24,49.35,Difficile,Difficile,Difficile / Difficile
3456,137,2019,Management,3,10,QCM,44,11,1,10,4.0,9.09,1,43,3.16,Difficile,Trop Difficile,Difficile / Trop Difficile
4286,137,2020,Management,3,10,QCM,44,30,17,13,1.47,56.67,17,27,37.82,Difficile,Difficile,Difficile / Difficile
137,138,2015,Management,3,11,QCU,33,22,11,11,1.5,50.0,11,22,33.25,Difficile,Difficile,Difficile / Difficile
967,138,2016,Management,3,11,QCU,33,24,9,15,1.38,37.5,9,24,28.55,Difficile,Difficile,Difficile / Difficile
1797,138,2017,Management,3,11,QCU,40,23,12,11,1.74,52.17,12,28,29.34,Difficile,Difficile,Difficile / Difficile
2627,138,2018,Management,3,11,QCU,39,28,22,6,1.39,78.57,22,17,55.56,Difficile,Difficile,Difficile / Difficile
3457,138,2019,Management,3,11,QCU,36,35,33,2,1.03,94.29,33,3,92.09,Difficile,Trop Facile,Difficile / Trop Facile
4287,138,2020,Management,3,11,QCU,34,27,20,7,1.26,74.07,20,14,58.06,Difficile,Difficile,Difficile / Difficile
138,139,2015,Management,3,12,QROC,6,6,4,2,1.0,66.67,4,2,67.63,Facile,Adapte,Facile / Adapte
968,139,2016,Management,3,12,QROC,7,7,4,3,1.0,57.14,4,3,63.4,Adapte,Adapte,Adapte / Adapte
1798,139,2017,Management,3,12,QROC,7,6,5,1,1.17,83.33,5,2,67.33,Adapte,Adapte,Adapte / Adapte
2628,139,2018,Management,3,12,QROC,7,6,5,1,1.17,83.33,5,2,67.72,Adapte,Adapte,Adapte / Adapte
3458,139,2019,Management,3,12,QROC,7,7,5,2,1.0,71.43,5,2,72.12,Adapte,Adapte,Adapte / Adapte
4288,139,2020,Management,3,12,QROC,6,5,4,1,1.2,80.0,4,2,70.78,Adapte,Adapte,Adapte / Adapte
139,140,2015,Management,3,13,QCU,6,5,5,0,1.2,100.0,5,1,76.14,Facile,Facile,Facile / Facile
969,140,2016,Management,3,13,QCU,5,3,1,2,1.67,33.33,1,4,28.15,Difficile,Difficile,Difficile / Difficile
1799,140,2017,Management,3,13,QCU,4,3,2,1,1.33,66.67,2,2,41.74,Difficile,Difficile,Difficile / Difficile
2629,140,2018,Management,3,13,QCU,5,4,3,1,1.25,75.0,3,2,52.12,Difficile,Difficile,Difficile / Difficile
3459,140,2019,Management,3,13,QCU,4,4,2,2,1.0,50.0,2,2,55.2,Difficile,Difficile,Difficile / Difficile
4289,140,2020,Management,3,13,QCU,3,3,2,1,1.0,66.67,2,1,80.74,Difficile,Facile,Difficile / Facile
140,141,2015,Management,3,14,QCU,77,76,60,16,1.01,78.95,60,17,78.37,Facile,Facile,Facile / Facile
970,141,2016,Management,3,14,QCU,88,83,72,11,1.06,86.75,72,16,81.36,Difficile,Facile,Difficile / Facile
1800,141,2017,Management,3,14,QCU,80,49,36,13,1.63,73.47,36,44,45.39,Difficile,Difficile,Difficile / Difficile
2630,141,2018,Management,3,14,QCU,77,76,42,34,1.01,55.26,42,35,54.17,Difficile,Difficile,Difficile / Difficile
3460,141,2019,Management,3,14,QCU,77,46,20,26,1.67,43.48,20,57,25.52,Difficile,Difficile,Difficile / Difficile
4290,141,2020,Management,3,14,QCU,63,47,29,18,1.34,61.7,29,34,45.52,Difficile,Difficile,Difficile / Difficile
141,142,2015,Management,4,1,QROC,70,70,16,54,1.0,22.86,16,54,22.41,Trop Difficile,Trop Difficile,Trop Difficile / Trop Difficile
971,142,2016,Management,4,1,QROC,73,71,69,2,1.03,97.18,69,4,94.92,Difficile,Trop Facile,Difficile / Trop Facile
1801,142,2017,Management,4,1,QROC,69,44,26,18,1.57,59.09,26,43,37.86,Difficile,Difficile,Difficile / Difficile
2631,142,2018,Management,4,1,QROC,55,32,31,1,1.72,96.88,31,24,56.06,Difficile,Difficile,Difficile / Difficile
3461,142,2019,Management,4,1,QROC,49,20,19,1,2.45,95.0,19,30,37.91,Difficile,Difficile,Difficile / Difficile
4291,142,2020,Management,4,1,QROC,49,47,32,15,1.04,68.09,32,17,66.3,Difficile,Adapte,Difficile / Adapte
142,143,2015,Management,4,2,QCM,25,17,17,0,1.47,100.0,17,8,66.31,Adapte,Adapte,Adapte / Adapte
972,143,2016,Management,4,2,QCM,22,19,13,6,1.16,68.42,13,9,60.38,Adapte,Adapte,Adapte / Adapte
1802,143,2017,Management,4,2,QCM,20,19,15,4,1.05,78.95,15,5,73.48,Adapte,Adapte,Adapte / Adapte
2632,143,2018,Management,4,2,QCM,24,16,14,2,1.5,87.5,14,10,60.3,Adapte,Adapte,Adapte / Adapte
3462,143,2019,Management,4,2,QCM,27,18,18,0,1.5,100.0,18,9,67.15,Adapte,Adapte,Adapte / Adapte
4292,143,2020,Management,4,2,QCM,28,26,21,5,1.08,80.77,21,7,73.35,Adapte,Adapte,Adapte / Adapte
143,144,2015,Management,4,3,QCM,73,64,5,59,1.14,7.81,5,68,7.24,Trop Difficile,Trop Difficile,Trop Difficile / Trop Difficile
973,144,2016,Management,4,3,QCM,88,53,51,2,1.66,96.23,51,37,57.51,Difficile,Difficile,Difficile / Difficile
1803,144,2017,Management,4,3,QCM,101,98,81,17,1.03,82.65,81,20,79.92,Difficile,Facile,Difficile / Facile
2633,144,2018,Management,4,3,QCM,106,103,96,7,1.03,93.2,96,10,90.12,Difficile,Trop Facile,Difficile / Trop Facile
3463,144,2019,Management,4,3,QCM,113,88,32,56,1.28,36.36,32,81,28.61,Difficile,Difficile,Difficile / Difficile
4293,144,2020,Management,4,3,QCM,116,101,34,67,1.15,33.66,34,82,29.13,Difficile,Difficile,Difficile / Difficile
144,145,2015,Management,4,4,QROC,44,31,5,26,1.42,16.13,5,39,11.29,Trop Difficile,Trop Difficile,Trop Difficile / Trop Difficile
974,145,2016,Management,4,4,QROC,41,20,19,1,2.05,95.0,19,22,45.9,Difficile,Difficile,Difficile / Difficile
1804,145,2017,Management,4,4,QROC,46,19,19,0,2.42,100.0,19,27,42.02,Difficile,Difficile,Difficile / Difficile
2634,145,2018,Management,4,4,QROC,44,31,17,14,1.42,54.84,17,27,38.59,Difficile,Difficile,Difficile / Difficile
3464,145,2019,Management,4,4,QROC,50,40,11,29,1.25,27.5,11,39,22.25,Difficile,Trop Difficile,Difficile / Trop Difficile
4294,145,2020,Management,4,4,QROC,50,33,21,12,1.52,63.64,21,29,41.86,Difficile,Difficile,Difficile / Difficile
145,146,2015,Management,4,5,QCU,83,62,58,4,1.34,93.55,58,25,69.3,Facile,Adapte,Facile / Adapte
975,146,2016,Management,4,5,QCU,90,72,66,6,1.25,91.67,66,24,72.89,Adapte,Adapte,Adapte / Adapte
1805,146,2017,Management,4,5,QCU,106,87,67,20,1.22,77.01,67,39,63.16,Adapte,Adapte,Adapte / Adapte
2635,146,2018,Management,4,5,QCU,91,81,56,25,1.12,69.14,56,35,61.8,Adapte,Adapte,Adapte / Adapte
3465,146,2019,Management,4,5,QCU,87,78,60,18,1.12,76.92,60,27,68.71,Adapte,Adapte,Adapte / Adapte
4295,146,2020,Management,4,5,QCU,103,100,70,30,1.03,70.0,70,33,68.01,Adapte,Adapte,Adapte / Adapte
146,147,2015,Management,4,6,QCU,50,17,16,1,2.94,94.12,16,34,32.95,Facile,Difficile,Facile / Difficile
976,147,2016,Management,4,6,QCU,50,48,34,14,1.04,70.83,34,16,67.61,Difficile,Adapte,Difficile / Adapte
1806,147,2017,Management,4,6,QCU,52,47,39,8,1.11,82.98,39,13,74.76,Adapte,Adapte,Adapte / Adapte
2636,147,2018,Management,4,6,QCU,57,49,36,13,1.16,73.47,36,21,63.71,Adapte,Adapte,Adapte / Adapte
3466,147,2019,Management,4,6,QCU,55,41,36,5,1.34,87.8,36,19,66.3,Adapte,Adapte,Adapte / Adapte
4296,147,2020,Management,4,6,QCU,58,54,41,13,1.07,75.93,41,17,70.94,Adapte,Adapte,Adapte / Adapte
147,148,2015,Management,4,7,QCU,7,6,2,4,1.17,33.33,2,5,29.16,Facile,Difficile,Facile / Difficile
977,148,2016,Management,4,7,QCU,8,6,4,2,1.33,66.67,4,4,54.23,Difficile,Difficile,Difficile / Difficile
1807,148,2017,Management,4,7,QCU,9,5,4,1,1.8,80.0,4,5,40.8,Difficile,Difficile,Difficile / Difficile
2637,148,2018,Management,4,7,QCU,8,7,7,0,1.14,100.0,7,1,86.89,Difficile,Trop Facile,Difficile / Trop Facile
3467,148,2019,Management,4,7,QCU,8,6,0,6,1.33,0.0,0,8,4.3,Difficile,Trop Difficile,Difficile / Trop Difficile
4297,148,2020,Management,4,7,QCU,8,7,6,1,1.14,85.71,6,2,80.99,Difficile,Facile,Difficile / Facile
148,149,2015,Management,4,8,QCU,68,61,52,9,1.11,85.25,52,16,76.06,Facile,Facile,Facile / Facile
978,149,2016,Management,4,8,QCU,71,66,60,6,1.08,90.91,60,11,84.84,Difficile,Facile,Difficile / Facile
1808,149,2017,Management,4,8,QCU,63,56,49,7,1.12,87.5,49,14,77.29,Difficile,Facile,Difficile / Facile
2638,149,2018,Management,4,8,QCU,51,46,45,1,1.11,97.83,45,6,88.44,Difficile,Trop Facile,Difficile / Trop Facile
3468,149,2019,Management,4,8,QCU,50,46,39,7,1.09,84.78,39,11,78.29,Difficile,Facile,Difficile / Facile
4298,149,2020,Management,4,8,QCU,46,43,13,30,1.07,30.23,13,33,29.08,Difficile,Difficile,Difficile / Difficile
149,150,2015,Management,4,9,QCM,88,76,71,5,1.16,93.42,71,17,80.4,Facile,Facile,Facile / Facile
979,150,2016,Management,4,9,QCM,77,68,41,27,1.13,60.29,41,36,53.19,Difficile,Difficile,Difficile / Difficile
1809,150,2017,Management,4,9,QCM,68,63,29,34,1.08,46.03,29,39,41.97,Difficile,Difficile,Difficile / Difficile
2639,150,2018,Management,4,9,QCM,65,33,13,20,1.97,39.39,13,52,19.87,Difficile,Trop Difficile,Difficile / Trop Difficile
3469,150,2019,Management,4,9,QCM,75,50,25,25,1.5,50.0,25,50,33.41,Difficile,Difficile,Difficile / Difficile
4299,150,2020,Management,4,9,QCM,70,43,20,23,1.63,46.51,20,50,28.25,Difficile,Difficile,Difficile / Difficile
150,151,2015,Management,4,10,QCU,56,35,32,3,1.6,91.43,32,24,57.91,Trop Difficile,Difficile,Trop Difficile / Difficile
980,151,2016,Management,4,10,QCU,67,40,24,16,1.68,60.0,24,43,35.34,Difficile,Difficile,Difficile / Difficile
1810,151,2017,Management,4,10,QCU,78,77,25,52,1.01,32.47,25,53,32.15,Difficile,Difficile,Difficile / Difficile
2640,151,2018,Management,4,10,QCU,78,58,33,25,1.34,56.9,33,45,42.88,Difficile,Difficile,Difficile / Difficile
3470,151,2019,Management,4,10,QCU,62,49,6,43,1.27,12.24,6,56,9.81,Difficile,Trop Difficile,Difficile / Trop Difficile
4300,151,2020,Management,4,10,QCU,70,69,56,13,1.01,81.16,56,14,79.45,Difficile,Facile,Difficile / Facile
151,152,2015,Management,5,1,QCM,22,16,15,1,1.38,93.75,15,7,67.25,Adapte,Adapte,Adapte / Adapte
981,152,2016,Management,5,1,QCM,21,20,15,5,1.05,75.0,15,6,71.13,Adapte,Adapte,Adapte / Adapte
1811,152,2017,Management,5,1,QCM,23,22,15,7,1.05,68.18,15,8,66.26,Adapte,Adapte,Adapte / Adapte
2641,152,2018,Management,5,1,QCM,28,23,21,2,1.22,91.3,21,7,74.52,Adapte,Adapte,Adapte / Adapte
3471,152,2019,Management,5,1,QCM,25,23,16,7,1.09,69.57,16,9,62.17,Adapte,Adapte,Adapte / Adapte
4301,152,2020,Management,5,1,QCM,24,19,15,4,1.26,78.95,15,9,63.71,Adapte,Adapte,Adapte / Adapte
152,153,2015,Management,5,2,QROC,94,78,67,11,1.21,85.9,67,27,70.87,Adapte,Adapte,Adapte / Adapte
982,153,2016,Management,5,2,QROC,89,79,64,15,1.13,81.01,64,25,72.02,Adapte,Adapte,Adapte / Adapte
1812,153,2017,Management,5,2,QROC,83,67,60,7,1.24,89.55,60,23,72.78,Adapte,Adapte,Adapte / Adapte
2642,153,2018,Management,5,2,QROC,84,69,57,12,1.22,82.61,57,27,67.92,Adapte,Adapte,Adapte / Adapte
3472,153,2019,Management,5,2,QROC,87,59,55,4,1.47,93.22,55,32,63.45,Adapte,Adapte,Adapte / Adapte
4302,153,2020,Management,5,2,QROC,78,72,47,25,1.08,65.28,47,31,60.15,Adapte,Adapte,Adapte / Adapte
153,154,2015,Management,5,3,QCU,82,70,67,3,1.17,95.71,67,15,81.92,Facile,Facile,Facile / Facile
983,154,2016,Management,5,3,QCU,83,77,77,0,1.08,100.0,77,6,92.2,Difficile,Trop Facile,Difficile / Trop Facile
1813,154,2017,Management,5,3,QCU,81,31,31,0,2.61,100.0,31,50,38.26,Difficile,Difficile,Difficile / Difficile
2643,154,2018,Management,5,3,QCU,92,78,48,30,1.18,61.54,48,44,52.17,Difficile,Difficile,Difficile / Difficile
3473,154,2019,Management,5,3,QCU,78,77,43,34,1.01,55.84,43,35,55.32,Difficile,Difficile,Difficile / Difficile
4303,154,2020,Management,5,3,QCU,88,61,47,14,1.44,77.05,47,41,53.58,Difficile,Difficile,Difficile / Difficile
154,155,2015,Management,5,4,QCU,27,17,3,14,1.59,17.65,3,24,10.76,Difficile,Trop Difficile,Difficile / Trop Difficile
984,155,2016,Management,5,4,QCU,31,30,29,1,1.03,96.67,29,2,95.16,Difficile,Trop Facile,Difficile / Trop Facile
1814,155,2017,Management,5,4,QCU,28,25,24,1,1.12,96.0,24,4,87.14,Difficile,Trop Facile,Difficile / Trop Facile
2644,155,2018,Management,5,4,QCU,32,26,16,10,1.23,61.54,16,16,51.05,Difficile,Difficile,Difficile / Difficile
3474,155,2019,Management,5,4,QCU,26,24,21,3,1.08,87.5,21,5,79.78,Difficile,Facile,Difficile / Facile
4304,155,2020,Management,5,4,QCU,27,22,10,12,1.23,45.45,10,17,35.23,Difficile,Difficile,Difficile / Difficile
155,156,2015,Management,5,5,QCM,78,68,9,59,1.15,13.24,9,69,11.36,Trop Difficile,Trop Difficile,Trop Difficile / Trop Difficile
985,156,2016,Management,5,5,QCM,94,87,83,4,1.08,95.4,83,11,87.86,Difficile,Trop Facile,Difficile / Trop Facile
1815,156,2017,Management,5,5,QCM,100,39,28,11,2.56,71.79,28,72,28.01,Difficile,Difficile,Difficile / Difficile
2645,156,2018,Management,5,5,QCM,91,46,46,0,1.98,100.0,46,45,50.27,Difficile,Difficile,Difficile / Difficile
3475,156,2019,Management,5,5,QCM,74,72,21,51,1.03,29.17,21,53,28.72,Difficile,Difficile,Difficile / Difficile
4305,156,2020,Management,5,5,QCM,82,58,48,10,1.41,82.76,48,34,58.51,Difficile,Difficile,Difficile / Difficile
156,157,2015,Management,5,6,QCM,15,14,12,2,1.07,85.71,12,3,77.73,Facile,Facile,Facile / Facile
986,157,2016,Management,5,6,QCM,14,9,6,3,1.56,66.67,6,8,39.6,Difficile,Difficile,Difficile / Difficile
1816,157,2017,Management,5,6,QCM,16,13,8,5,1.23,61.54,8,8,51.27,Difficile,Difficile,Difficile / Difficile
2646,157,2018,Management,5,6,QCM,15,11,5,6,1.36,45.45,5,10,33.62,Difficile,Difficile,Difficile / Difficile
3476,157,2019,Management,5,6,QCM,15,12,11,1,1.25,91.67,11,4,76.07,Difficile,Facile,Difficile / Facile
4306,157,2020,Management,5,6,QCM,17,9,5,4,1.89,55.56,5,12,28.44,Difficile,Difficile,Difficile / Difficile
157,158,2015,Management,6,1,QO,92,75,18,57,1.23,24.0,18,74,19.78,Facile,Trop Difficile,Facile / Trop Difficile
987,158,2016,Management,6,1,QO,101,75,1,74,1.35,1.33,1,100,0.64,Trop Difficile,Trop Difficile,Trop Difficile / Trop Difficile
1817,158,2017,Management,6,1,QO,100,94,88,6,1.06,93.62,88,12,88.31,Trop Difficile,Trop Facile,Trop Difficile / Trop Facile
2647,158,2018,Management,6,1,QO,101,89,15,74,1.13,16.85,15,86,14.64,Trop Difficile,Trop Difficile,Trop Difficile / Trop Difficile
3477,158,2019,Management,6,1,QO,96,95,78,17,1.01,82.11,78,18,80.76,Trop Difficile,Facile,Trop Difficile / Facile
4307,158,2020,Management,6,1,QO,91,64,37,27,1.42,57.81,37,54,40.5,Trop Difficile,Difficile,Trop Difficile / Difficile
158,159,2015,Management,6,2,QCM,26,25,19,6,1.04,76.0,19,7,71.21,Adapte,Adapte,Adapte / Adapte
988,159,2016,Management,6,2,QCM,24,23,15,8,1.04,65.22,15,9,61.29,Adapte,Adapte,Adapte / Adapte
1818,159,2017,Management,6,2,QCM,23,21,15,6,1.1,71.43,15,8,65.08,Adapte,Adapte,Adapte / Adapte
2648,159,2018,Management,6,2,QCM,28,24,19,5,1.17,79.17,19,9,69.53,Adapte,Adapte,Adapte / Adapte
3478,159,2019,Management,6,2,QCM,30,25,22,3,1.2,88.0,22,8,72.97,Adapte,Adapte,Adapte / Adapte
4308,159,2020,Management,6,2,QCM,27,19,19,0,1.42,100.0,19,8,70.28,Adapte,Adapte,Adapte / Adapte
159,160,2015,Management,6,3,QCU,9,8,5,3,1.12,62.5,5,4,61.04,Adapte,Adapte,Adapte / Adapte
989,160,2016,Management,6,3,QCU,10,9,7,2,1.11,77.78,7,3,69.33,Adapte,Adapte,Adapte / Adapte
1819,160,2017,Management,6,3,QCU,9,6,6,0,1.5,100.0,6,3,62.83,Adapte,Adapte,Adapte / Adapte
2649,160,2018,Management,6,3,QCU,11,8,8,0,1.38,100.0,8,3,72.47,Adapte,Adapte,Adapte / Adapte
3479,160,2019,Management,6,3,QCU,12,11,8,3,1.09,72.73,8,4,70.01,Adapte,Adapte,Adapte / Adapte
4309,160,2020,Management,6,3,QCU,11,9,7,2,1.22,77.78,7,4,64.86,Adapte,Adapte,Adapte / Adapte
160,161,2015,Management,6,4,QCM,40,36,16,20,1.11,44.44,16,24,39.8,Difficile,Difficile,Difficile / Difficile
990,161,2016,Management,6,4,QCM,34,30,18,12,1.13,60.0,18,16,52.8,Difficile,Difficile,Difficile / Difficile
1820,161,2017,Management,6,4,QCM,37,11,10,1,3.36,90.91,10,27,26.67,Difficile,Difficile,Difficile / Difficile
2650,161,2018,Management,6,4,QCM,43,28,16,12,1.54,57.14,16,27,38.33,Difficile,Difficile,Difficile / Difficile
3480,161,2019,Management,6,4,QCM,52,37,15,22,1.41,40.54,15,37,28.1,Difficile,Difficile,Difficile / Difficile
4310,161,2020,Management,6,4,QCM,45,15,14,1,3.0,93.33,14,31,30.04,Difficile,Difficile,Difficile / Difficile
161,162,2015,Management,6,5,QCM,61,52,48,4,1.17,92.31,48,13,78.25,Difficile,Facile,Difficile / Facile
991,162,2016,Management,6,5,QCM,66,22,16,6,3.0,72.73,16,50,23.62,Difficile,Trop Difficile,Difficile / Trop Difficile
1821,162,2017,Management,6,5,QCM,56,53,45,8,1.06,84.91,45,11,80.27,Difficile,Facile,Difficile / Facile
2651,162,2018,Management,6,5,QCM,60,34,29,5,1.76,85.29,29,31,47.95,Difficile,Difficile,Difficile / Difficile
3481,162,2019,Management,6,5,QCM,60,47,21,26,1.28,44.68,21,39,35.22,Difficile,Difficile,Difficile / Difficile
4311,162,2020,Management,6,5,QCM,60,34,20,14,1.76,58.82,20,40,33.02,Difficile,Difficile,Difficile / Difficile
162,163,2015,Management,6,6,QCU,6,4,3,1,1.5,75.0,3,3,44.15,Difficile,Difficile,Difficile / Difficile
992,163,2016,Management,6,6,QCU,6,4,0,4,1.5,0.0,0,6,0.06,Difficile,Trop Difficile,Difficile / Trop Difficile
1822,163,2017,Management,6,6,QCU,5,4,3,1,1.25,75.0,3,2,55.73,Difficile,Difficile,Difficile / Difficile
2652,163,2018,Management,6,6,QCU,5,4,3,1,1.25,75.0,3,2,66.74,Difficile,Adapte,Difficile / Adapte
3482,163,2019,Management,6,6,QCU,6,6,4,2,1.0,66.67,4,2,66.53,Adapte,Adapte,Adapte / Adapte
4312,163,2020,Management,6,6,QCU,6,6,4,2,1.0,66.67,4,2,68.63,Adapte,Adapte,Adapte / Adapte
163,164,2015,Management,6,7,QCU,18,17,16,1,1.06,94.12,16,2,90.74,Trop Facile,Trop Facile,Trop Facile / Trop Facile
993,164,2016,Management,6,7,QCU,15,10,10,0,1.5,100.0,10,5,66.49,Difficile,Adapte,Difficile / Adapte
1823,164,2017,Management,6,7,QCU,15,11,9,2,1.36,81.82,9,6,63.23,Adapte,Adapte,Adapte / Adapte
2653,164,2018,Management,6,7,QCU,12,11,9,2,1.09,81.82,9,3,71.07,Adapte,Adapte,Adapte / Adapte
3483,164,2019,Management,6,7,QCU,10,9,7,2,1.11,77.78,7,3,72.89,Adapte,Adapte,Adapte / Adapte
4313,164,2020,Management,6,7,QCU,9,9,7,2,1.0,77.78,7,2,72.48,Adapte,Adapte,Adapte / Adapte
164,165,2015,Management,7,1,QROC,71,46,0,46,1.54,0.0,0,71,0.55,Adapte,Trop Difficile,Adapte / Trop Difficile
994,165,2016,Management,7,1,QROC,73,52,40,12,1.4,76.92,40,33,54.84,Difficile,Difficile,Difficile / Difficile
1824,165,2017,Management,7,1,QROC,58,53,41,12,1.09,77.36,41,17,71.26,Difficile,Adapte,Difficile / Adapte
2654,165,2018,Management,7,1,QROC,64,63,41,22,1.02,65.08,41,23,63.31,Adapte,Adapte,Adapte / Adapte
3484,165,2019,Management,7,1,QROC,61,53,40,13,1.15,75.47,40,21,65.84,Adapte,Adapte,Adapte / Adapte
4314,165,2020,Management,7,1,QROC,58,51,43,8,1.14,84.31,43,15,74.09,Adapte,Adapte,Adapte / Adapte
165,166,2015,Management,7,2,QCM,17,10,1,9,1.7,10.0,1,16,4.67,Difficile,Trop Difficile,Difficile / Trop Difficile
995,166,2016,Management,7,2,QCM,18,16,4,12,1.12,25.0,4,14,19.71,Difficile,Trop Difficile,Difficile / Trop Difficile
1825,166,2017,Management,7,2,QCM,21,21,14,7,1.0,66.67,14,7,68.93,Difficile,Adapte,Difficile / Adapte
2655,166,2018,Management,7,2,QCM,19,15,13,2,1.27,86.67,13,6,67.18,Adapte,Adapte,Adapte / Adapte
3485,166,2019,Management,7,2,QCM,19,15,13,2,1.27,86.67,13,6,70.62,Adapte,Adapte,Adapte / Adapte
4315,166,2020,Management,7,2,QCM,20,16,14,2,1.25,87.5,14,6,68.32,Adapte,Adapte,Adapte / Adapte
166,167,2015,Management,7,3,QCU,58,47,46,1,1.23,97.87,46,12,78.99,Facile,Facile,Facile / Facile
996,167,2016,Management,7,3,QCU,47,46,35,11,1.02,76.09,35,12,74.41,Difficile,Adapte,Difficile / Adapte
1826,167,2017,Management,7,3,QCU,55,46,40,6,1.2,86.96,40,15,72.49,Adapte,Adapte,Adapte / Adapte
2656,167,2018,Management,7,3,QCU,59,36,36,0,1.64,100.0,36,23,61.85,Adapte,Adapte,Adapte / Adapte
3486,167,2019,Management,7,3,QCU,58,41,36,5,1.41,87.8,36,22,62.72,Adapte,Adapte,Adapte / Adapte
4316,167,2020,Management,7,3,QCU,57,41,35,6,1.39,85.37,35,22,60.91,Adapte,Adapte,Adapte / Adapte
167,168,2015,Management,7,4,QCU,84,62,6,56,1.35,9.68,6,78,7.36,Facile,Trop Difficile,Facile / Trop Difficile
997,168,2016,Management,7,4,QCU,88,51,31,20,1.73,60.78,31,57,35.3,Difficile,Difficile,Difficile / Difficile
1827,168,2017,Management,7,4,QCU,82,79,46,33,1.04,58.23,46,36,56.19,Difficile,Difficile,Difficile / Difficile
2657,168,2018,Management,7,4,QCU,76,55,36,19,1.38,65.45,36,40,46.84,Difficile,Difficile,Difficile / Difficile
3487,168,2019,Management,7,4,QCU,86,67,24,43,1.28,35.82,24,62,27.97,Difficile,Difficile,Difficile / Difficile
4317,168,2020,Management,7,4,QCU,102,86,47,39,1.19,54.65,47,55,46.29,Difficile,Difficile,Difficile / Difficile
168,169,2015,Management,7,5,QCM,46,45,45,0,1.02,100.0,45,1,97.53,Trop Facile,Trop Facile,Trop Facile / Trop Facile
998,169,2016,Management,7,5,QCM,55,53,29,24,1.04,54.72,29,26,52.04,Difficile,Difficile,Difficile / Difficile
1828,169,2017,Management,7,5,QCM,59,26,21,5,2.27,80.77,21,38,36.35,Difficile,Difficile,Difficile / Difficile
2658,169,2018,Management,7,5,QCM,70,63,56,7,1.11,88.89,56,14,80.01,Difficile,Facile,Difficile / Facile
3488,169,2019,Management,7,5,QCM,60,36,21,15,1.67,58.33,21,39,34.76,Difficile,Difficile,Difficile / Difficile
4318,169,2020,Management,7,5,QCM,54,39,22,17,1.38,56.41,22,32,40.35,Difficile,Difficile,Difficile / Difficile
169,170,2015,Management,8,1,QROC,74,60,59,1,1.23,98.33,59,15,79.89,Trop Difficile,Facile,Trop Difficile / Facile
999,170,2016,Management,8,1,QROC,82,68,38,30,1.21,55.88,38,44,46.32,Difficile,Difficile,Difficile / Difficile
1829,170,2017,Management,8,1,QROC,72,35,20,15,2.06,57.14,20,52,27.8,Difficile,Difficile,Difficile / Difficile
2659,170,2018,Management,8,1,QROC,60,50,33,17,1.2,66.0,33,27,54.22,Difficile,Difficile,Difficile / Difficile
3489,170,2019,Management,8,1,QROC,56,29,22,7,1.93,75.86,22,34,38.8,Difficile,Difficile,Difficile / Difficile
4319,170,2020,Management,8,1,QROC,57,51,6,45,1.12,11.76,6,51,11.23,Difficile,Trop Difficile,Difficile / Trop Difficile
170,171,2015,Management,8,2,QROC,89,65,61,4,1.37,93.85,61,28,68.77,Difficile,Adapte,Difficile / Adapte
1000,171,2016,Management,8,2,QROC,94,65,60,5,1.45,92.31,60,34,63.95,Adapte,Adapte,Adapte / Adapte
1830,171,2017,Management,8,2,QROC,88,87,64,23,1.01,73.56,64,24,72.69,Adapte,Adapte,Adapte / Adapte
2660,171,2018,Management,8,2,QROC,86,82,63,19,1.05,76.83,63,23,73.1,Adapte,Adapte,Adapte / Adapte
3490,171,2019,Management,8,2,QROC,78,59,48,11,1.32,81.36,48,30,61.34,Adapte,Adapte,Adapte / Adapte
4320,171,2020,Management,8,2,QROC,65,57,41,16,1.14,71.93,41,24,63.78,Adapte,Adapte,Adapte / Adapte
171,172,2015,Management,8,3,QCU,43,41,40,1,1.05,97.56,40,3,93.07,Trop Difficile,Trop Facile,Trop Difficile / Trop Facile
1001,172,2016,Management,8,3,QCU,48,40,24,16,1.2,60.0,24,24,50.54,Difficile,Difficile,Difficile / Difficile
1831,172,2017,Management,8,3,QCU,51,40,40,0,1.27,100.0,40,11,77.95,Difficile,Facile,Difficile / Facile
2661,172,2018,Management,8,3,QCU,52,33,20,13,1.58,60.61,20,32,37.5,Difficile,Difficile,Difficile / Difficile
3491,172,2019,Management,8,3,QCU,48,43,43,0,1.12,100.0,43,5,88.75,Difficile,Trop Facile,Difficile / Trop Facile
4321,172,2020,Management,8,3,QCU,57,38,35,3,1.5,92.11,35,22,60.94,Difficile,Adapte,Difficile / Adapte
172,173,2015,Management,8,4,QCU,50,45,34,11,1.11,75.56,34,16,67.85,Adapte,Adapte,Adapte / Adapte
1002,173,2016,Management,8,4,QCU,48,42,35,7,1.14,83.33,35,13,73.03,Adapte,Adapte,Adapte / Adapte
1832,173,2017,Management,8,4,QCU,45,43,31,12,1.05,72.09,31,14,68.7,Adapte,Adapte,Adapte / Adapte
2662,173,2018,Management,8,4,QCU,39,38,29,9,1.03,76.32,29,10,73.43,Adapte,Adapte,Adapte / Adapte
3492,173,2019,Management,8,4,QCU,47,45,32,13,1.04,71.11,32,15,67.59,Adapte,Adapte,Adapte / Adapte
4322,173,2020,Management,8,4,QCU,40,30,28,2,1.33,93.33,28,12,70.41,Adapte,Adapte,Adapte / Adapte
173,174,2015,Management,8,5,QCM,40,40,23,17,1.0,57.5,23,17,57.51,Difficile,Difficile,Difficile / Difficile
1003,174,2016,Management,8,5,QCM,42,41,22,19,1.02,53.66,22,20,53.06,Difficile,Difficile,Difficile / Difficile
1833,174,2017,Management,8,5,QCM,38,22,11,11,1.73,50.0,11,27,28.21,Difficile,Difficile,Difficile / Difficile
2663,174,2018,Management,8,5,QCM,34,33,12,21,1.03,36.36,12,22,34.79,Difficile,Difficile,Difficile / Difficile
3493,174,2019,Management,8,5,QCM,36,19,14,5,1.89,73.68,14,22,39.8,Difficile,Difficile,Difficile / Difficile
4323,174,2020,Management,8,5,QCM,33,15,15,0,2.2,100.0,15,18,44.08,Difficile,Difficile,Difficile / Difficile
174,175,2015,Management,8,6,QO,89,85,34,51,1.05,40.0,34,55,38.37,Difficile,Difficile,Difficile / Difficile
1004,175,2016,Management,8,6,QO,75,56,2,54,1.34,3.57,2,73,2.79,Trop Difficile,Trop Difficile,Trop Difficile / Trop Difficile
1834,175,2017,Management,8,6,QO,75,67,58,9,1.12,86.57,58,17,77.55,Trop Difficile,Facile,Trop Difficile / Facile
2664,175,2018,Management,8,6,QO,67,40,17,23,1.68,42.5,17,50,25.28,Trop Difficile,Difficile,Trop Difficile / Difficile
3494,175,2019,Management,8,6,QO,68,63,5,58,1.08,7.94,5,63,8.01,Trop Difficile,Trop Difficile,Trop Difficile / Trop Difficile
4324,175,2020,Management,8,6,QO,55,34,8,26,1.62,23.53,8,47,13.73,Trop Difficile,Trop Difficile,Trop Difficile / Trop Difficile
175,176,2015,Management,8,7,QCM,25,24,16,8,1.04,66.67,16,9,65.93,Adapte,Adapte,Adapte / Adapte
1005,176,2016,Management,8,7,QCM,24,24,15,9,1.0,62.5,15,9,62.45,Adapte,Adapte,Adapte / Adapte
1835,176,2017,Management,8,7,QCM,23,15,15,0,1.53,100.0,15,8,65.47,Adapte,Adapte,Adapte / Adapte
2665,176,2018,Management,8,7,QCM,25,23,16,7,1.09,69.57,16,9,63.14,Adapte,Adapte,Adapte / Adapte
3495,176,2019,Management,8,7,QCM,26,21,17,4,1.24,80.95,17,9,66.37,Adapte,Adapte,Adapte / Adapte
4325,176,2020,Management,8,7,QCM,26,18,18,0,1.44,100.0,18,8,70.14,Adapte,Adapte,Adapte / Adapte
176,177,2015,Management,8,8,QCM,69,54,47,7,1.28,87.04,47,22,67.88,Adapte,Adapte,Adapte / Adapte
1006,177,2016,Management,8,8,QCM,79,67,49,18,1.18,73.13,49,30,61.54,Adapte,Adapte,Adapte / Adapte
1836,177,2017,Management,8,8,QCM,78,76,55,21,1.03,72.37,55,23,70.46,Adapte,Adapte,Adapte / Adapte
2666,177,2018,Management,8,8,QCM,88,73,61,12,1.21,83.56,61,27,69.44,Adapte,Adapte,Adapte / Adapte
3496,177,2019,Management,8,8,QCM,91,74,62,12,1.23,83.78,62,29,68.3,Adapte,Adapte,Adapte / Adapte
4326,177,2020,Management,8,8,QCM,89,73,58,15,1.22,79.45,58,31,65.73,Adapte,Adapte,Adapte / Adapte
177,178,2015,Management,8,9,QROC,93,89,70,19,1.04,78.65,70,23,74.83,Difficile,Adapte,Difficile / Adapte
1007,178,2016,Management,8,9,QROC,93,77,63,14,1.21,81.82,63,30,67.24,Adapte,Adapte,Adapte / Adapte
1837,178,2017,Management,8,9,QROC,100,73,72,1,1.37,98.63,72,28,71.9,Adapte,Adapte,Adapte / Adapte
2667,178,2018,Management,8,9,QROC,115,97,85,12,1.19,87.63,85,30,74.33,Adapte,Adapte,Adapte / Adapte
3497,178,2019,Management,8,9,QROC,115,96,83,13,1.2,86.46,83,32,72.14,Adapte,Adapte,Adapte / Adapte
4327,178,2020,Management,8,9,QROC,132,99,92,7,1.33,92.93,92,40,69.34,Adapte,Adapte,Adapte / Adapte
178,179,2015,Management,8,10,QCU,11,8,3,5,1.38,37.5,3,8,28.36,Difficile,Difficile,Difficile / Difficile
1008,179,2016,Management,8,10,QCU,10,7,6,1,1.43,85.71,6,4,63.98,Difficile,Adapte,Difficile / Adapte
1838,179,2017,Management,8,10,QCU,10,7,6,1,1.43,85.71,6,4,63.92,Adapte,Adapte,Adapte / Adapte
2668,179,2018,Management,8,10,QCU,8,7,6,1,1.14,85.71,6,2,69.48,Adapte,Adapte,Adapte / Adapte
3498,179,2019,Management,8,10,QCU,6,4,4,0,1.5,100.0,4,2,69.8,Adapte,Adapte,Adapte / Adapte
4328,179,2020,Management,8,10,QCU,5,5,3,2,1.0,60.0,3,2,66.74,Adapte,Adapte,Adapte / Adapte
179,180,2015,Management,9,1,QROC,91,67,13,54,1.36,19.4,13,78,13.98,Trop Difficile,Trop Difficile,Trop Difficile / Trop Difficile
1009,180,2016,Management,9,1,QROC,80,78,76,2,1.03,97.44,76,4,95.24,Difficile,Trop Facile,Difficile / Trop Facile
1839,180,2017,Management,9,1,QROC,74,66,62,4,1.12,93.94,62,12,83.48,Difficile,Facile,Difficile / Facile
2669,180,2018,Management,9,1,QROC,63,60,59,1,1.05,98.33,59,4,93.52,Difficile,Trop Facile,Difficile / Trop Facile
3499,180,2019,Management,9,1,QROC,67,39,38,1,1.72,97.44,38,29,56.32,Difficile,Difficile,Difficile / Difficile
4329,180,2020,Management,9,1,QROC,60,36,22,14,1.67,61.11,22,38,36.52,Difficile,Difficile,Difficile / Difficile
180,181,2015,Management,9,2,QCU,87,74,73,1,1.18,98.65,73,14,83.76,Facile,Facile,Facile / Facile
1010,181,2016,Management,9,2,QCU,80,65,29,36,1.23,44.62,29,51,36.42,Difficile,Difficile,Difficile / Difficile
1840,181,2017,Management,9,2,QCU,86,79,72,7,1.09,91.14,72,14,83.81,Difficile,Facile,Difficile / Facile
2670,181,2018,Management,9,2,QCU,74,72,57,15,1.03,79.17,57,17,76.38,Difficile,Facile,Difficile / Facile
3500,181,2019,Management,9,2,QCU,85,54,39,15,1.57,72.22,39,46,45.46,Difficile,Difficile,Difficile / Difficile
4330,181,2020,Management,9,2,QCU,85,44,36,8,1.93,81.82,36,49,42.33,Difficile,Difficile,Difficile / Difficile
181,182,2015,Management,9,3,QCM,56,54,53,1,1.04,98.15,53,3,94.97,Trop Facile,Trop Facile,Trop Facile / Trop Facile
1011,182,2016,Management,9,3,QCM,58,58,57,1,1.0,98.28,57,1,97.48,Difficile,Trop Facile,Difficile / Trop Facile
1841,182,2017,Management,9,3,QCM,54,31,14,17,1.74,45.16,14,40,26.27,Difficile,Difficile,Difficile / Difficile
2671,182,2018,Management,9,3,QCM,63,62,56,6,1.02,90.32,56,7,88.56,Difficile,Trop Facile,Difficile / Trop Facile
3501,182,2019,Management,9,3,QCM,76,59,41,18,1.29,69.49,41,35,54.27,Difficile,Difficile,Difficile / Difficile
4331,182,2020,Management,9,3,QCM,89,88,30,58,1.01,34.09,30,59,33.28,Difficile,Difficile,Difficile / Difficile
182,183,2015,Management,9,4,QCM,76,74,73,1,1.03,98.65,73,3,96.35,Trop Facile,Trop Facile,Trop Facile / Trop Facile
1012,183,2016,Management,9,4,QCM,85,80,76,4,1.06,95.0,76,9,89.11,Difficile,Trop Facile,Difficile / Trop Facile
1842,183,2017,Management,9,4,QCM,79,46,21,25,1.72,45.65,21,58,26.82,Difficile,Difficile,Difficile / Difficile
2672,183,2018,Management,9,4,QCM,87,62,57,5,1.4,91.94,57,30,65.86,Difficile,Adapte,Difficile / Adapte
3502,183,2019,Management,9,4,QCM,93,90,63,27,1.03,70.0,63,30,67.95,Adapte,Adapte,Adapte / Adapte
4332,183,2020,Management,9,4,QCM,105,87,66,21,1.21,75.86,66,39,63.3,Adapte,Adapte,Adapte / Adapte
183,184,2015,Management,9,5,QCM,38,33,30,3,1.15,90.91,30,8,77.96,Facile,Facile,Facile / Facile
1013,184,2016,Management,9,5,QCM,32,26,12,14,1.23,46.15,12,20,37.98,Difficile,Difficile,Difficile / Difficile
1843,184,2017,Management,9,5,QCM,27,16,15,1,1.69,93.75,15,12,54.17,Difficile,Difficile,Difficile / Difficile
2673,184,2018,Management,9,5,QCM,29,11,5,6,2.64,45.45,5,24,17.59,Difficile,Trop Difficile,Difficile / Trop Difficile
3503,184,2019,Management,9,5,QCM,31,17,13,4,1.82,76.47,13,18,40.49,Difficile,Difficile,Difficile / Difficile
4333,184,2020,Management,9,5,QCM,37,17,17,0,2.18,100.0,17,20,45.16,Difficile,Difficile,Difficile / Difficile
184,185,2015,Management,9,6,QCM,71,68,59,9,1.04,86.76,59,12,83.05,Facile,Facile,Facile / Facile
1014,185,2016,Management,9,6,QCM,80,44,29,15,1.82,65.91,29,51,36.35,Difficile,Difficile,Difficile / Difficile
1844,185,2017,Management,9,6,QCM,92,64,55,9,1.44,85.94,55,37,60.27,Difficile,Adapte,Difficile / Adapte
2674,185,2018,Management,9,6,QCM,101,72,67,5,1.4,93.06,67,34,66.21,Adapte,Adapte,Adapte / Adapte
3504,185,2019,Management,9,6,QCM,114,109,73,36,1.05,66.97,73,41,63.62,Adapte,Adapte,Adapte / Adapte
4334,185,2020,Management,9,6,QCM,96,69,65,4,1.39,94.2,65,31,67.38,Adapte,Adapte,Adapte / Adapte
185,186,2015,Management,9,7,QCM,36,31,28,3,1.16,90.32,28,8,79.03,Facile,Facile,Facile / Facile
1015,186,2016,Management,9,7,QCM,42,41,40,1,1.02,97.56,40,2,95.84,Difficile,Trop Facile,Difficile / Trop Facile
1845,186,2017,Management,9,7,QCM,42,40,40,0,1.05,100.0,40,2,94.84,Difficile,Trop Facile,Difficile / Trop Facile
2675,186,2018,Management,9,7,QCM,38,35,20,15,1.09,57.14,20,18,51.98,Difficile,Difficile,Difficile / Difficile
3505,186,2019,Management,9,7,QCM,35,24,11,13,1.46,45.83,11,24,32.01,Difficile,Difficile,Difficile / Difficile
4335,186,2020,Management,9,7,QCM,39,33,23,10,1.18,69.7,23,16,58.69,Difficile,Difficile,Difficile / Difficile
186,187,2015,Management,9,8,QCU,47,45,44,1,1.04,97.78,44,3,93.11,Trop Facile,Trop Facile,Trop Facile / Trop Facile
1016,187,2016,Management,9,8,QCU,49,38,16,22,1.29,42.11,16,33,32.85,Difficile,Difficile,Difficile / Difficile
1846,187,2017,Management,9,8,QCU,46,43,15,28,1.07,34.88,15,31,33.54,Difficile,Difficile,Difficile / Difficile
2676,187,2018,Management,9,8,QCU,55,54,40,14,1.02,74.07,40,15,72.71,Difficile,Adapte,Difficile / Adapte
3506,187,2019,Management,9,8,QCU,63,46,38,8,1.37,82.61,38,25,60.34,Adapte,Adapte,Adapte / Adapte
4336,187,2020,Management,9,8,QCU,67,47,41,6,1.43,87.23,41,26,61.14,Adapte,Adapte,Adapte / Adapte
187,188,2015,Management,9,9,QCU,50,43,37,6,1.16,86.05,37,13,73.16,Adapte,Adapte,Adapte / Adapte
1017,188,2016,Management,9,9,QCU,41,34,28,6,1.21,82.35,28,13,68.95,Adapte,Adapte,Adapte / Adapte
1847,188,2017,Management,9,9,QCU,45,44,30,14,1.02,68.18,30,15,66.89,Adapte,Adapte,Adapte / Adapte
2677,188,2018,Management,9,9,QCU,36,28,22,6,1.29,78.57,22,14,61.13,Adapte,Adapte,Adapte / Adapte
3507,188,2019,Management,9,9,QCU,36,31,25,6,1.16,80.65,25,11,69.78,Adapte,Adapte,Adapte / Adapte
4337,188,2020,Management,9,9,QCU,41,31,28,3,1.32,90.32,28,13,69.22,Adapte,Adapte,Adapte / Adapte
188,189,2015,Management,9,10,QCM,42,33,33,0,1.27,100.0,33,9,77.6,Difficile,Facile,Difficile / Facile
1018,189,2016,Management,9,10,QCM,37,33,32,1,1.12,96.97,32,5,87.51,Difficile,Trop Facile,Difficile / Trop Facile
1848,189,2017,Management,9,10,QCM,35,32,29,3,1.09,90.62,29,6,82.66,Difficile,Facile,Difficile / Facile
2678,189,2018,Management,9,10,QCM,32,28,20,8,1.14,71.43,20,12,61.14,Difficile,Adapte,Difficile / Adapte
3508,189,2019,Management,9,10,QCM,29,25,18,7,1.16,72.0,18,11,61.01,Adapte,Adapte,Adapte / Adapte
4338,189,2020,Management,9,10,QCM,28,18,17,1,1.56,94.44,17,11,60.52,Adapte,Adapte,Adapte / Adapte
189,190,2015,Management,9,11,QCU,84,74,43,31,1.14,58.11,43,41,50.73,Difficile,Difficile,Difficile / Difficile
1019,190,2016,Management,9,11,QCU,101,85,39,46,1.19,45.88,39,62,38.83,Difficile,Difficile,Difficile / Difficile
1849,190,2017,Management,9,11,QCU,93,91,42,49,1.02,46.15,42,51,45.36,Difficile,Difficile,Difficile / Difficile
2679,190,2018,Management,9,11,QCU,93,46,36,10,2.02,78.26,36,57,38.77,Difficile,Difficile,Difficile / Difficile
3509,190,2019,Management,9,11,QCU,81,76,71,5,1.07,93.42,71,10,87.28,Difficile,Trop Facile,Difficile / Trop Facile
4339,190,2020,Management,9,11,QCU,84,49,30,19,1.71,61.22,30,54,36.16,Difficile,Difficile,Difficile / Difficile
190,191,2015,Management,10,1,QCM,92,79,72,7,1.16,91.14,72,20,78.25,Difficile,Facile,Difficile / Facile
1020,191,2016,Management,10,1,QCM,87,61,48,13,1.43,78.69,48,39,55.7,Difficile,Difficile,Difficile / Difficile
1850,191,2017,Management,10,1,QCM,78,71,63,8,1.1,88.73,63,15,80.63,Difficile,Facile,Difficile / Facile
2680,191,2018,Management,10,1,QCM,91,78,74,4,1.17,94.87,74,17,81.5,Difficile,Facile,Difficile / Facile
3510,191,2019,Management,10,1,QCM,85,57,34,23,1.49,59.65,34,51,39.99,Difficile,Difficile,Difficile / Difficile
4340,191,2020,Management,10,1,QCM,82,35,32,3,2.34,91.43,32,50,39.36,Difficile,Difficile,Difficile / Difficile
191,192,2015,Management,10,2,QCM,28,16,8,8,1.75,50.0,8,20,29.65,Difficile,Difficile,Difficile / Difficile
1021,192,2016,Management,10,2,QCM,25,24,22,2,1.04,91.67,22,3,86.63,Difficile,Trop Facile,Difficile / Trop Facile
1851,192,2017,Management,10,2,QCM,26,22,10,12,1.18,45.45,10,16,38.66,Difficile,Difficile,Difficile / Difficile
2681,192,2018,Management,10,2,QCM,31,27,23,4,1.15,85.19,23,8,74.12,Difficile,Adapte,Difficile / Adapte
3511,192,2019,Management,10,2,QCM,32,31,23,8,1.03,74.19,23,9,72.87,Adapte,Adapte,Adapte / Adapte
4341,192,2020,Management,10,2,QCM,37,34,27,7,1.09,79.41,27,10,73.49,Adapte,Adapte,Adapte / Adapte
192,193,2015,Management,10,3,QCU,57,42,15,27,1.36,35.71,15,42,26.25,Difficile,Difficile,Difficile / Difficile
1022,193,2016,Management,10,3,QCU,46,41,18,23,1.12,43.9,18,28,38.84,Difficile,Difficile,Difficile / Difficile
1852,193,2017,Management,10,3,QCU,48,30,13,17,1.6,43.33,13,35,27.25,Difficile,Difficile,Difficile / Difficile
2682,193,2018,Management,10,3,QCU,44,22,14,8,2.0,63.64,14,30,32.39,Difficile,Difficile,Difficile / Difficile
3512,193,2019,Management,10,3,QCU,46,29,13,16,1.59,44.83,13,33,28.53,Difficile,Difficile,Difficile / Difficile
4342,193,2020,Management,10,3,QCU,49,48,41,7,1.02,85.42,41,8,84.12,Difficile,Facile,Difficile / Facile
193,194,2015,Management,10,4,QCU,98,71,48,23,1.38,67.61,48,50,48.84,Facile,Difficile,Facile / Difficile
1023,194,2016,Management,10,4,QCU,93,64,54,10,1.45,84.38,54,39,58.41,Difficile,Difficile,Difficile / Difficile
1853,194,2017,Management,10,4,QCU,106,59,46,13,1.8,77.97,46,60,43.07,Difficile,Difficile,Difficile / Difficile
2683,194,2018,Management,10,4,QCU,117,67,53,14,1.75,79.1,53,64,45.31,Difficile,Difficile,Difficile / Difficile
3513,194,2019,Management,10,4,QCU,124,111,33,78,1.12,29.73,33,91,26.41,Difficile,Difficile,Difficile / Difficile
4343,194,2020,Management,10,4,QCU,120,88,69,19,1.36,78.41,69,51,57.61,Difficile,Difficile,Difficile / Difficile
194,195,2015,Management,10,5,QROC,36,25,24,1,1.44,96.0,24,12,66.73,Facile,Adapte,Facile / Adapte
1024,195,2016,Management,10,5,QROC,40,30,27,3,1.33,90.0,27,13,67.02,Adapte,Adapte,Adapte / Adapte
1854,195,2017,Management,10,5,QROC,36,27,26,1,1.33,96.3,26,10,73.51,Adapte,Adapte,Adapte / Adapte
2684,195,2018,Management,10,5,QROC,40,38,25,13,1.05,65.79,25,15,63.59,Adapte,Adapte,Adapte / Adapte
3514,195,2019,Management,10,5,QROC,47,38,35,3,1.24,92.11,35,12,73.47,Adapte,Adapte,Adapte / Adapte
4344,195,2020,Management,10,5,QROC,41,37,29,8,1.11,78.38,29,12,71.17,Adapte,Adapte,Adapte / Adapte
195,196,2015,Management,11,1,QCU,16,13,13,0,1.23,100.0,13,3,81.32,Facile,Facile,Facile / Facile
1025,196,2016,Management,11,1,QCU,15,13,9,4,1.15,69.23,9,6,56.88,Difficile,Difficile,Difficile / Difficile
1855,196,2017,Management,11,1,QCU,18,18,15,3,1.0,83.33,15,3,84.02,Difficile,Facile,Difficile / Facile
2685,196,2018,Management,11,1,QCU,18,17,16,1,1.06,94.12,16,2,87.75,Difficile,Trop Facile,Difficile / Trop Facile
3515,196,2019,Management,11,1,QCU,18,11,10,1,1.64,90.91,10,8,57.24,Difficile,Difficile,Difficile / Difficile
4345,196,2020,Management,11,1,QCU,14,7,4,3,2.0,57.14,4,10,25.31,Difficile,Difficile,Difficile / Difficile
196,197,2015,Management,11,2,QCU,6,2,1,1,3.0,50.0,1,5,9.54,Trop Difficile,Trop Difficile,Trop Difficile / Trop Difficile
1026,197,2016,Management,11,2,QCU,6,4,2,2,1.5,50.0,2,4,27.31,Difficile,Difficile,Difficile / Difficile
1856,197,2017,Management,11,2,QCU,7,7,6,1,1.0,85.71,6,1,87.59,Difficile,Trop Facile,Difficile / Trop Facile
2686,197,2018,Management,11,2,QCU,8,6,4,2,1.33,66.67,4,4,50.14,Difficile,Difficile,Difficile / Difficile
3516,197,2019,Management,11,2,QCU,8,3,2,1,2.67,66.67,2,6,30.92,Difficile,Difficile,Difficile / Difficile
4346,197,2020,Management,11,2,QCU,6,5,2,3,1.2,40.0,2,4,28.87,Difficile,Difficile,Difficile / Difficile
197,198,2015,Management,11,3,QROC,9,7,3,4,1.29,42.86,3,6,33.87,Difficile,Difficile,Difficile / Difficile
1027,198,2016,Management,11,3,QROC,7,5,3,2,1.4,60.0,3,4,37.54,Difficile,Difficile,Difficile / Difficile
1857,198,2017,Management,11,3,QROC,7,5,2,3,1.4,40.0,2,5,25.77,Difficile,Difficile,Difficile / Difficile
2687,198,2018,Management,11,3,QROC,8,7,4,3,1.14,57.14,4,4,56.17,Difficile,Difficile,Difficile / Difficile
3517,198,2019,Management,11,3,QROC,6,3,0,3,2.0,0.0,0,6,3.81,Difficile,Trop Difficile,Difficile / Trop Difficile
4347,198,2020,Management,11,3,QROC,6,4,4,0,1.5,100.0,4,2,68.24,Difficile,Adapte,Difficile / Adapte
198,199,2015,Management,11,4,QCM,27,21,11,10,1.29,52.38,11,16,38.9,Trop Facile,Difficile,Trop Facile / Difficile
1028,199,2016,Management,11,4,QCM,31,15,9,6,2.07,60.0,9,22,29.58,Difficile,Difficile,Difficile / Difficile
1858,199,2017,Management,11,4,QCM,32,30,17,13,1.07,56.67,17,15,52.39,Difficile,Difficile,Difficile / Difficile
2688,199,2018,Management,11,4,QCM,29,25,15,10,1.16,60.0,15,14,52.7,Difficile,Difficile,Difficile / Difficile
3518,199,2019,Management,11,4,QCM,24,23,12,11,1.04,52.17,12,12,51.17,Difficile,Difficile,Difficile / Difficile
4348,199,2020,Management,11,4,QCM,24,23,19,4,1.04,82.61,19,5,79.36,Difficile,Facile,Difficile / Facile
199,200,2015,Management,11,5,QROC,62,47,36,11,1.32,76.6,36,26,58.05,Facile,Difficile,Facile / Difficile
1029,200,2016,Management,11,5,QROC,56,30,19,11,1.87,63.33,19,37,33.99,Difficile,Difficile,Difficile / Difficile
1859,200,2017,Management,11,5,QROC,63,60,36,24,1.05,60.0,36,27,57.1,Difficile,Difficile,Difficile / Difficile
2689,200,2018,Management,11,5,QROC,62,62,48,14,1.0,77.42,48,14,78.19,Difficile,Facile,Difficile / Facile
3519,200,2019,Management,11,5,QROC,68,56,21,35,1.21,37.5,21,47,30.31,Difficile,Difficile,Difficile / Difficile
4349,200,2020,Management,11,5,QROC,82,55,50,5,1.49,90.91,50,32,60.52,Difficile,Adapte,Difficile / Adapte
200,201,2015,Management,11,6,QCM,27,14,10,4,1.93,71.43,10,17,36.18,Difficile,Difficile,Difficile / Difficile
1030,201,2016,Management,11,6,QCM,27,25,22,3,1.08,88.0,22,5,83.15,Difficile,Facile,Difficile / Facile
1860,201,2017,Management,11,6,QCM,23,21,15,6,1.1,71.43,15,8,66.08,Difficile,Adapte,Difficile / Adapte
2690,201,2018,Management,11,6,QCM,20,14,13,1,1.43,92.86,13,7,63.15,Adapte,Adapte,Adapte / Adapte
3520,201,2019,Management,11,6,QCM,21,14,14,0,1.5,100.0,14,7,67.48,Adapte,Adapte,Adapte / Adapte
4350,201,2020,Management,11,6,QCM,17,13,11,2,1.31,84.62,11,6,64.53,Adapte,Adapte,Adapte / Adapte
201,202,2015,Management,12,1,QCM,34,27,6,21,1.26,22.22,6,28,18.33,Facile,Trop Difficile,Facile / Trop Difficile
1031,202,2016,Management,12,1,QCM,34,33,31,2,1.03,93.94,31,3,91.66,Difficile,Trop Facile,Difficile / Trop Facile
1861,202,2017,Management,12,1,QCM,27,20,15,5,1.35,75.0,15,12,56.97,Difficile,Difficile,Difficile / Difficile
2691,202,2018,Management,12,1,QCM,27,19,13,6,1.42,68.42,13,14,48.72,Difficile,Difficile,Difficile / Difficile
3521,202,2019,Management,12,1,QCM,23,15,11,4,1.53,73.33,11,12,47.89,Difficile,Difficile,Difficile / Difficile
4351,202,2020,Management,12,1,QCM,20,17,15,2,1.18,88.24,15,5,76.7,Difficile,Facile,Difficile / Facile
202,203,2015,Management,12,2,QROC,25,19,5,14,1.32,26.32,5,20,20.07,Trop Difficile,Trop Difficile,Trop Difficile / Trop Difficile
1032,203,2016,Management,12,2,QROC,25,24,3,21,1.04,12.5,3,22,12.03,Difficile,Trop Difficile,Difficile / Trop Difficile
1862,203,2017,Management,12,2,QROC,24,20,18,2,1.2,90.0,18,6,76.52,Difficile,Facile,Difficile / Facile
2692,203,2018,Management,12,2,QROC,26,20,18,2,1.3,90.0,18,8,69.64,Difficile,Adapte,Difficile / Adapte
3522,203,2019,Management,12,2,QROC,29,26,21,5,1.12,80.77,21,8,71.22,Adapte,Adapte,Adapte / Adapte
4352,203,2020,Management,12,2,QROC,35,24,22,2,1.46,91.67,22,13,62.07,Adapte,Adapte,Adapte / Adapte
203,204,2015,Management,12,3,QROC,100,72,5,67,1.39,6.94,5,95,4.72,Trop Difficile,Trop Difficile,Trop Difficile / Trop Difficile
1033,204,2016,Management,12,3,QROC,115,105,57,48,1.1,54.29,57,58,49.19,Difficile,Difficile,Difficile / Difficile
1863,204,2017,Management,12,3,QROC,96,96,35,61,1.0,36.46,35,61,36.76,Difficile,Difficile,Difficile / Difficile
2693,204,2018,Management,12,3,QROC,90,55,44,11,1.64,80.0,44,46,48.35,Difficile,Difficile,Difficile / Difficile
3523,204,2019,Management,12,3,QROC,90,71,52,19,1.27,73.24,52,38,57.94,Difficile,Difficile,Difficile / Difficile
4353,204,2020,Management,12,3,QROC,96,84,30,54,1.14,35.71,30,66,30.85,Difficile,Difficile,Difficile / Difficile
204,205,2015,Management,12,4,QROC,37,32,26,6,1.16,81.25,26,11,71.35,Adapte,Adapte,Adapte / Adapte
1034,205,2016,Management,12,4,QROC,37,28,28,0,1.32,100.0,28,9,74.8,Adapte,Adapte,Adapte / Adapte
1864,205,2017,Management,12,4,QROC,34,27,23,4,1.26,85.19,23,11,67.57,Adapte,Adapte,Adapte / Adapte
2694,205,2018,Management,12,4,QROC,27,25,20,5,1.08,80.0,20,7,74.25,Adapte,Adapte,Adapte / Adapte
3524,205,2019,Management,12,4,QROC,26,22,17,5,1.18,77.27,17,9,65.5,Adapte,Adapte,Adapte / Adapte
4354,205,2020,Management,12,4,QROC,24,20,17,3,1.2,85.0,17,7,68.86,Adapte,Adapte,Adapte / Adapte
205,206,2015,Management,12,5,QCU,43,35,19,16,1.23,54.29,19,24,44.12,Facile,Difficile,Facile / Difficile
1035,206,2016,Management,12,5,QCU,38,31,31,0,1.23,100.0,31,7,82.42,Difficile,Facile,Difficile / Facile
1865,206,2017,Management,12,5,QCU,43,27,24,3,1.59,88.89,24,19,56.85,Difficile,Difficile,Difficile / Difficile
2695,206,2018,Management,12,5,QCU,45,40,3,37,1.12,7.5,3,42,5.76,Difficile,Trop Difficile,Difficile / Trop Difficile
3525,206,2019,Management,12,5,QCU,38,36,17,19,1.06,47.22,17,21,43.97,Difficile,Difficile,Difficile / Difficile
4355,206,2020,Management,12,5,QCU,39,37,24,13,1.05,64.86,24,15,60.34,Difficile,Adapte,Difficile / Adapte
206,207,2015,Management,12,6,QCU,37,22,16,6,1.68,72.73,16,21,43.96,Difficile,Difficile,Difficile / Difficile
1036,207,2016,Management,12,6,QCU,32,29,15,14,1.1,51.72,15,17,47.59,Difficile,Difficile,Difficile / Difficile
1866,207,2017,Management,12,6,QCU,27,20,12,8,1.35,60.0,12,15,46.17,Difficile,Difficile,Difficile / Difficile
2696,207,2018,Management,12,6,QCU,25,14,6,8,1.79,42.86,6,19,25.59,Difficile,Difficile,Difficile / Difficile
3526,207,2019,Management,12,6,QCU,23,18,10,8,1.28,55.56,10,13,43.46,Difficile,Difficile,Difficile / Difficile
4356,207,2020,Management,12,6,QCU,19,15,8,7,1.27,53.33,8,11,41.94,Difficile,Difficile,Difficile / Difficile
207,208,2015,Management,12,7,QCU,19,16,12,4,1.19,75.0,12,7,64.96,Adapte,Adapte,Adapte / Adapte
1037,208,2016,Management,12,7,QCU,23,20,15,5,1.15,75.0,15,8,64.98,Adapte,Adapte,Adapte / Adapte
1867,208,2017,Management,12,7,QCU,21,19,14,5,1.11,73.68,14,7,67.22,Adapte,Adapte,Adapte / Adapte
2697,208,2018,Management,12,7,QCU,22,16,13,3,1.38,81.25,13,9,60.79,Adapte,Adapte,Adapte / Adapte
3527,208,2019,Management,12,7,QCU,24,20,16,4,1.2,80.0,16,8,66.38,Adapte,Adapte,Adapte / Adapte
4357,208,2020,Management,12,7,QCU,28,25,19,6,1.12,76.0,19,9,69.03,Adapte,Adapte,Adapte / Adapte
208,209,2015,Management,12,8,QCM,21,9,4,5,2.33,44.44,4,17,17.71,Difficile,Trop Difficile,Difficile / Trop Difficile
1038,209,2016,Management,12,8,QCM,17,7,5,2,2.43,71.43,5,12,30.78,Difficile,Difficile,Difficile / Difficile
1868,209,2017,Management,12,8,QCM,14,13,8,5,1.08,61.54,8,6,54.16,Difficile,Difficile,Difficile / Difficile
2698,209,2018,Management,12,8,QCM,13,12,4,8,1.08,33.33,4,9,33.15,Difficile,Difficile,Difficile / Difficile
3528,209,2019,Management,12,8,QCM,12,9,3,6,1.33,33.33,3,9,25.25,Difficile,Difficile,Difficile / Difficile
4358,209,2020,Management,12,8,QCM,14,14,10,4,1.0,71.43,10,4,69.07,Difficile,Adapte,Difficile / Adapte
209,210,2015,Management,12,9,QCU,21,18,1,17,1.17,5.56,1,20,2.44,Trop Difficile,Trop Difficile,Trop Difficile / Trop Difficile
1039,210,2016,Management,12,9,QCU,17,11,8,3,1.55,72.73,8,9,44.14,Difficile,Difficile,Difficile / Difficile
1869,210,2017,Management,12,9,QCU,18,15,8,7,1.2,53.33,8,10,45.13,Difficile,Difficile,Difficile / Difficile
2699,210,2018,Management,12,9,QCU,19,18,16,2,1.06,88.89,16,3,82.24,Difficile,Facile,Difficile / Facile
3529,210,2019,Management,12,9,QCU,19,19,10,9,1.0,52.63,10,9,53.5,Difficile,Difficile,Difficile / Difficile
4359,210,2020,Management,12,9,QCU,22,18,8,10,1.22,44.44,8,14,38.38,Difficile,Difficile,Difficile / Difficile
210,211,2015,Management,13,1,QCU,90,74,60,14,1.22,81.08,60,30,67.08,Adapte,Adapte,Adapte / Adapte
1040,211,2016,Management,13,1,QCU,107,99,78,21,1.08,78.79,78,29,72.76,Adapte,Adapte,Adapte / Adapte
1870,211,2017,Management,13,1,QCU,87,58,58,0,1.5,100.0,58,29,66.56,Adapte,Adapte,Adapte / Adapte
2700,211,2018,Management,13,1,QCU,96,81,64,17,1.19,79.01,64,32,66.86,Adapte,Adapte,Adapte / Adapte
3530,211,2019,Management,13,1,QCU,94,79,69,10,1.19,87.34,69,25,73.81,Adapte,Adapte,Adapte / Adapte
4360,211,2020,Management,13,1,QCU,98,87,71,16,1.13,81.61,71,27,72.48,Adapte,Adapte,Adapte / Adapte
211,212,2015,Management,13,2,QCM,67,54,50,4,1.24,92.59,50,17,74.57,Adapte,Adapte,Adapte / Adapte
1041,212,2016,Management,13,2,QCM,55,41,38,3,1.34,92.68,38,17,69.59,Adapte,Adapte,Adapte / Adapte
1871,212,2017,Management,13,2,QCM,63,58,47,11,1.09,81.03,47,16,74.87,Adapte,Adapte,Adapte / Adapte
2701,212,2018,Management,13,2,QCM,73,61,47,14,1.2,77.05,47,26,63.83,Adapte,Adapte,Adapte / Adapte
3531,212,2019,Management,13,2,QCM,66,62,44,18,1.06,70.97,44,22,67.36,Adapte,Adapte,Adapte / Adapte
4361,212,2020,Management,13,2,QCM,75,67,53,14,1.12,79.1,53,22,70.19,Adapte,Adapte,Adapte / Adapte
212,213,2015,Management,13,3,QCM,45,37,7,30,1.22,18.92,7,38,15.43,Facile,Trop Difficile,Facile / Trop Difficile
1042,213,2016,Management,13,3,QCM,50,49,47,2,1.02,95.92,47,3,94.69,Difficile,Trop Facile,Difficile / Trop Facile
1872,213,2017,Management,13,3,QCM,46,15,12,3,3.07,80.0,12,34,26.96,Difficile,Difficile,Difficile / Difficile
2702,213,2018,Management,13,3,QCM,41,18,11,7,2.28,61.11,11,30,26.87,Difficile,Difficile,Difficile / Difficile
3532,213,2019,Management,13,3,QCM,46,40,20,20,1.15,50.0,20,26,42.8,Difficile,Difficile,Difficile / Difficile
4362,213,2020,Management,13,3,QCM,44,25,21,4,1.76,84.0,21,23,48.08,Difficile,Difficile,Difficile / Difficile
213,214,2015,Management,13,4,QCM,31,23,23,0,1.35,100.0,23,8,73.81,Difficile,Adapte,Difficile / Adapte
1043,214,2016,Management,13,4,QCM,28,27,19,8,1.04,70.37,19,9,66.44,Adapte,Adapte,Adapte / Adapte
1873,214,2017,Management,13,4,QCM,27,21,17,4,1.29,80.95,17,10,62.76,Adapte,Adapte,Adapte / Adapte
2703,214,2018,Management,13,4,QCM,27,25,16,9,1.08,64.0,16,11,61.0,Adapte,Adapte,Adapte / Adapte
3533,214,2019,Management,13,4,QCM,27,22,18,4,1.23,81.82,18,9,68.28,Adapte,Adapte,Adapte / Adapte
4363,214,2020,Management,13,4,QCM,27,21,20,1,1.29,95.24,20,7,74.82,Adapte,Adapte,Adapte / Adapte
214,215,2015,Management,13,5,QROC,9,4,4,0,2.25,100.0,4,5,44.91,Difficile,Difficile,Difficile / Difficile
1044,215,2016,Management,13,5,QROC,10,8,5,3,1.25,62.5,5,5,46.4,Difficile,Difficile,Difficile / Difficile
1874,215,2017,Management,13,5,QROC,9,7,7,0,1.29,100.0,7,2,80.93,Difficile,Facile,Difficile / Facile
2704,215,2018,Management,13,5,QROC,7,4,3,1,1.75,75.0,3,4,48.51,Difficile,Difficile,Difficile / Difficile
3534,215,2019,Management,13,5,QROC,8,5,4,1,1.6,80.0,4,4,52.42,Difficile,Difficile,Difficile / Difficile
4364,215,2020,Management,13,5,QROC,10,7,4,3,1.43,57.14,4,6,37.06,Difficile,Difficile,Difficile / Difficile
215,216,2015,Management,13,6,QCU,7,6,3,3,1.17,50.0,3,4,36.19,Difficile,Difficile,Difficile / Difficile
1045,216,2016,Management,13,6,QCU,8,4,4,0,2.0,100.0,4,4,52.59,Difficile,Difficile,Difficile / Difficile
1875,216,2017,Management,13,6,QCU,7,5,4,1,1.4,80.0,4,3,50.89,Difficile,Difficile,Difficile / Difficile
2705,216,2018,Management,13,6,QCU,8,4,3,1,2.0,75.0,3,5,32.71,Difficile,Difficile,Difficile / Difficile
3535,216,2019,Management,13,6,QCU,10,5,0,5,2.0,0.0,0,10,2.54,Difficile,Trop Difficile,Difficile / Trop Difficile
4365,216,2020,Management,13,6,QCU,9,6,5,1,1.5,83.33,5,4,57.07,Difficile,Difficile,Difficile / Difficile
216,217,2015,Management,14,1,QCM,39,39,38,1,1.0,97.44,38,1,98.45,Trop Difficile,Trop Facile,Trop Difficile / Trop Facile
1046,217,2016,Management,14,1,QCM,32,31,29,2,1.03,93.55,29,3,90.66,Difficile,Trop Facile,Difficile / Trop Facile
1876,217,2017,Management,14,1,QCM,34,28,15,13,1.21,53.57,15,19,42.68,Difficile,Difficile,Difficile / Difficile
2706,217,2018,Management,14,1,QCM,32,32,26,6,1.0,81.25,26,6,81.89,Difficile,Facile,Difficile / Facile
3536,217,2019,Management,14,1,QCM,29,13,9,4,2.23,69.23,9,20,32.65,Difficile,Difficile,Difficile / Difficile
4366,217,2020,Management,14,1,QCM,23,17,11,6,1.35,64.71,11,12,47.58,Difficile,Difficile,Difficile / Difficile
217,218,2015,Management,14,2,QCU,34,32,4,28,1.06,12.5,4,30,12.31,Trop Difficile,Trop Difficile,Trop Difficile / Trop Difficile
1047,218,2016,Management,14,2,QCU,35,34,13,21,1.03,38.24,13,22,38.06,Difficile,Difficile,Difficile / Difficile
1877,218,2017,Management,14,2,QCU,33,29,9,20,1.14,31.03,9,24,28.44,Difficile,Difficile,Difficile / Difficile
2707,218,2018,Management,14,2,QCU,30,29,25,4,1.03,86.21,25,5,81.72,Difficile,Facile,Difficile / Facile
3537,218,2019,Management,14,2,QCU,25,15,12,3,1.67,80.0,12,13,49.85,Difficile,Difficile,Difficile / Difficile
4367,218,2020,Management,14,2,QCU,30,27,24,3,1.11,88.89,24,6,79.96,Difficile,Facile,Difficile / Facile
218,219,2015,Management,14,3,QO,67,48,27,21,1.4,56.25,27,40,40.96,Difficile,Difficile,Difficile / Difficile
1048,219,2016,Management,14,3,QO,55,39,38,1,1.41,97.44,38,17,69.57,Trop Difficile,Adapte,Trop Difficile / Adapte
1878,219,2017,Management,14,3,QO,58,51,35,16,1.14,68.63,35,23,60.59,Adapte,Adapte,Adapte / Adapte
2708,219,2018,Management,14,3,QO,59,51,42,9,1.16,82.35,42,17,71.75,Adapte,Adapte,Adapte / Adapte
3538,219,2019,Management,14,3,QO,58,45,42,3,1.29,93.33,42,16,72.9,Adapte,Adapte,Adapte / Adapte
4368,219,2020,Management,14,3,QO,65,51,44,7,1.27,86.27,44,21,67.85,Adapte,Adapte,Adapte / Adapte
219,220,2015,Management,14,4,QCU,65,38,8,30,1.71,21.05,8,57,12.65,Trop Difficile,Trop Difficile,Trop Difficile / Trop Difficile
1049,220,2016,Management,14,4,QCU,64,50,49,1,1.28,98.0,49,15,76.26,Difficile,Facile,Difficile / Facile
1879,220,2017,Management,14,4,QCU,69,44,4,40,1.57,9.09,4,65,5.25,Difficile,Trop Difficile,Difficile / Trop Difficile
2709,220,2018,Management,14,4,QCU,78,68,62,6,1.15,91.18,62,16,79.9,Difficile,Facile,Difficile / Facile
3539,220,2019,Management,14,4,QCU,73,65,36,29,1.12,55.38,36,37,49.35,Difficile,Difficile,Difficile / Difficile
4369,220,2020,Management,14,4,QCU,80,41,40,1,1.95,97.56,40,40,49.75,Difficile,Difficile,Difficile / Difficile
220,221,2015,Management,14,5,QCU,34,33,27,6,1.03,81.82,27,7,78.07,Facile,Facile,Facile / Facile
1050,221,2016,Management,14,5,QCU,32,28,14,14,1.14,50.0,14,18,43.58,Difficile,Difficile,Difficile / Difficile
1880,221,2017,Management,14,5,QCU,28,17,10,7,1.65,58.82,10,18,37.21,Difficile,Difficile,Difficile / Difficile
2710,221,2018,Management,14,5,QCU,29,22,17,5,1.32,77.27,17,12,60.19,Difficile,Adapte,Difficile / Adapte
3540,221,2019,Management,14,5,QCU,32,24,22,2,1.33,91.67,22,10,68.04,Adapte,Adapte,Adapte / Adapte
4370,221,2020,Management,14,5,QCU,29,22,19,3,1.32,86.36,19,10,65.56,Adapte,Adapte,Adapte / Adapte
221,222,2015,Management,15,1,QCU,45,39,7,32,1.15,17.95,7,38,14.71,Facile,Trop Difficile,Facile / Trop Difficile
1051,222,2016,Management,15,1,QCU,36,32,25,7,1.12,78.12,25,11,70.01,Difficile,Adapte,Difficile / Adapte
1881,222,2017,Management,15,1,QCU,32,27,23,4,1.19,85.19,23,9,70.91,Adapte,Adapte,Adapte / Adapte
2711,222,2018,Management,15,1,QCU,38,36,23,13,1.06,63.89,23,15,60.37,Adapte,Adapte,Adapte / Adapte
3541,222,2019,Management,15,1,QCU,39,38,24,14,1.03,63.16,24,15,60.72,Adapte,Adapte,Adapte / Adapte
4371,222,2020,Management,15,1,QCU,46,46,32,14,1.0,69.57,32,14,69.66,Adapte,Adapte,Adapte / Adapte
222,223,2015,Management,15,2,QCM,27,16,15,1,1.69,93.75,15,12,55.17,Facile,Difficile,Facile / Difficile
1052,223,2016,Management,15,2,QCM,31,30,15,15,1.03,50.0,15,16,46.91,Difficile,Difficile,Difficile / Difficile
1882,223,2017,Management,15,2,QCM,29,22,11,11,1.32,50.0,11,18,39.25,Difficile,Difficile,Difficile / Difficile
2712,223,2018,Management,15,2,QCM,27,19,16,3,1.42,84.21,16,11,58.62,Difficile,Difficile,Difficile / Difficile
3542,223,2019,Management,15,2,QCM,30,23,9,14,1.3,39.13,9,21,30.4,Difficile,Difficile,Difficile / Difficile
4372,223,2020,Management,15,2,QCM,28,18,12,6,1.56,66.67,12,16,42.8,Difficile,Difficile,Difficile / Difficile
223,224,2015,Management,15,3,QCM,70,63,58,5,1.11,92.06,58,12,83.05,Facile,Facile,Facile / Facile
1053,224,2016,Management,15,3,QCM,76,43,37,6,1.77,86.05,37,39,49.22,Difficile,Difficile,Difficile / Difficile
1883,224,2017,Management,15,3,QCM,68,45,19,26,1.51,42.22,19,49,27.66,Difficile,Difficile,Difficile / Difficile
2713,224,2018,Management,15,3,QCM,72,60,58,2,1.2,96.67,58,14,80.17,Difficile,Facile,Difficile / Facile
3543,224,2019,Management,15,3,QCM,63,54,53,1,1.17,98.15,53,10,83.94,Difficile,Facile,Difficile / Facile
4373,224,2020,Management,15,3,QCM,56,55,24,31,1.02,43.64,24,32,43.13,Difficile,Difficile,Difficile / Difficile
224,225,2015,Management,15,4,QCU,36,31,28,3,1.16,90.32,28,8,76.78,Trop Facile,Facile,Trop Facile / Facile
1054,225,2016,Management,15,4,QCU,30,21,14,7,1.43,66.67,14,16,47.39,Difficile,Difficile,Difficile / Difficile
1884,225,2017,Management,15,4,QCU,27,19,14,5,1.42,73.68,14,13,51.52,Difficile,Difficile,Difficile / Difficile
2714,225,2018,Management,15,4,QCU,28,25,23,2,1.12,92.0,23,5,81.05,Difficile,Facile,Difficile / Facile
3544,225,2019,Management,15,4,QCU,29,29,11,18,1.0,37.93,11,18,36.71,Difficile,Difficile,Difficile / Difficile
4374,225,2020,Management,15,4,QCU,32,31,30,1,1.03,96.77,30,2,94.99,Difficile,Trop Facile,Difficile / Trop Facile
225,226,2015,Management,15,5,QCM,88,63,59,4,1.4,93.65,59,29,66.54,Difficile,Adapte,Difficile / Adapte
1055,226,2016,Management,15,5,QCM,98,79,61,18,1.24,77.22,61,37,62.12,Adapte,Adapte,Adapte / Adapte
1885,226,2017,Management,15,5,QCM,87,75,53,22,1.16,70.67,53,34,61.38,Adapte,Adapte,Adapte / Adapte
2715,226,2018,Management,15,5,QCM,78,52,47,5,1.5,90.38,47,31,60.19,Adapte,Adapte,Adapte / Adapte
3545,226,2019,Management,15,5,QCM,69,60,44,16,1.15,73.33,44,25,63.71,Adapte,Adapte,Adapte / Adapte
4375,226,2020,Management,15,5,QCM,63,49,40,9,1.29,81.63,40,23,64.06,Adapte,Adapte,Adapte / Adapte
226,227,2015,Management,15,6,QCU,9,8,8,0,1.12,100.0,8,1,84.45,Facile,Facile,Facile / Facile
1056,227,2016,Management,15,6,QCU,10,6,6,0,1.67,100.0,6,4,55.66,Difficile,Difficile,Difficile / Difficile
1886,227,2017,Management,15,6,QCU,8,6,5,1,1.33,83.33,5,3,63.19,Difficile,Adapte,Difficile / Adapte
2716,227,2018,Management,15,6,QCU,7,6,5,1,1.17,83.33,5,2,74.81,Adapte,Adapte,Adapte / Adapte
3546,227,2019,Management,15,6,QCU,8,7,6,1,1.14,85.71,6,2,74.02,Adapte,Adapte,Adapte / Adapte
4376,227,2020,Management,15,6,QCU,6,4,4,0,1.5,100.0,4,2,63.87,Adapte,Adapte,Adapte / Adapte
227,228,2015,Management,15,7,QCM,15,12,12,0,1.25,100.0,12,3,77.37,Facile,Facile,Facile / Facile
1057,228,2016,Management,15,7,QCM,12,12,12,0,1.0,100.0,12,0,98.46,Difficile,Trop Facile,Difficile / Trop Facile
1887,228,2017,Management,15,7,QCM,12,6,6,0,2.0,100.0,6,6,48.15,Difficile,Difficile,Difficile / Difficile
2717,228,2018,Management,15,7,QCM,12,3,3,0,4.0,100.0,3,9,22.79,Difficile,Trop Difficile,Difficile / Trop Difficile
3547,228,2019,Management,15,7,QCM,10,6,5,1,1.67,83.33,5,5,48.79,Difficile,Difficile,Difficile / Difficile
4377,228,2020,Management,15,7,QCM,11,9,4,5,1.22,44.44,4,7,36.8,Difficile,Difficile,Difficile / Difficile
228,229,2015,Management,16,1,QO,57,55,4,51,1.04,7.27,4,53,6.56,Difficile,Trop Difficile,Difficile / Trop Difficile
1058,229,2016,Management,16,1,QO,59,48,3,45,1.23,6.25,3,56,4.5,Trop Difficile,Trop Difficile,Trop Difficile / Trop Difficile
1888,229,2017,Management,16,1,QO,54,44,22,22,1.23,50.0,22,32,41.11,Trop Difficile,Difficile,Trop Difficile / Difficile
2718,229,2018,Management,16,1,QO,48,41,41,0,1.17,100.0,41,7,86.42,Trop Difficile,Trop Facile,Trop Difficile / Trop Facile
3548,229,2019,Management,16,1,QO,39,24,0,24,1.62,0.0,0,39,0.89,Trop Difficile,Trop Difficile,Trop Difficile / Trop Difficile
4378,229,2020,Management,16,1,QO,33,23,7,16,1.43,30.43,7,26,19.95,Trop Difficile,Trop Difficile,Trop Difficile / Trop Difficile
229,230,2015,Management,17,1,QCM,85,80,70,10,1.06,87.5,70,15,82.67,Difficile,Facile,Difficile / Facile
1059,230,2016,Management,17,1,QCM,98,94,92,2,1.04,97.87,92,6,93.8,Difficile,Trop Facile,Difficile / Trop Facile
1889,230,2017,Management,17,1,QCM,110,67,40,27,1.64,59.7,40,70,36.62,Difficile,Difficile,Difficile / Difficile
2719,230,2018,Management,17,1,QCM,110,110,46,64,1.0,41.82,46,64,41.65,Difficile,Difficile,Difficile / Difficile
3549,230,2019,Management,17,1,QCM,97,43,31,12,2.26,72.09,31,66,32.11,Difficile,Difficile,Difficile / Difficile
4379,230,2020,Management,17,1,QCM,100,78,44,34,1.28,56.41,44,56,44.01,Difficile,Difficile,Difficile / Difficile
230,231,2015,Informatique,1,1,QCM,18,18,12,6,1.0,66.67,12,6,65.48,Trop Facile,Adapte,Trop Facile / Adapte
1060,231,2016,Informatique,1,1,QCM,21,17,14,3,1.24,82.35,14,7,68.57,Adapte,Adapte,Adapte / Adapte
1890,231,2017,Informatique,1,1,QCM,18,16,13,3,1.12,81.25,13,5,71.86,Adapte,Adapte,Adapte / Adapte
2720,231,2018,Informatique,1,1,QCM,20,14,12,2,1.43,85.71,12,8,61.34,Adapte,Adapte,Adapte / Adapte
3550,231,2019,Informatique,1,1,QCM,19,18,12,6,1.06,66.67,12,7,62.64,Adapte,Adapte,Adapte / Adapte
4380,231,2020,Informatique,1,1,QCM,18,16,11,5,1.12,68.75,11,7,60.89,Adapte,Adapte,Adapte / Adapte
231,232,2015,Informatique,1,2,QO,34,33,30,3,1.03,90.91,30,4,88.1,Difficile,Trop Facile,Difficile / Trop Facile
1061,232,2016,Informatique,1,2,QO,38,33,2,31,1.15,6.06,2,36,4.78,Trop Difficile,Trop Difficile,Trop Difficile / Trop Difficile
1891,232,2017,Informatique,1,2,QO,39,35,4,31,1.11,11.43,4,35,10.11,Trop Difficile,Trop Difficile,Trop Difficile / Trop Difficile
2721,232,2018,Informatique,1,2,QO,47,47,41,6,1.0,87.23,41,6,86.9,Trop Difficile,Trop Facile,Trop Difficile / Trop Facile
3551,232,2019,Informatique,1,2,QO,47,36,8,28,1.31,22.22,8,39,16.82,Trop Difficile,Trop Difficile,Trop Difficile / Trop Difficile
4381,232,2020,Informatique,1,2,QO,38,25,0,25,1.52,0.0,0,38,0.5,Trop Difficile,Trop Difficile,Trop Difficile / Trop Difficile
232,233,2015,Informatique,1,3,QROC,50,36,2,34,1.39,5.56,2,48,4.55,Adapte,Trop Difficile,Adapte / Trop Difficile
1062,233,2016,Informatique,1,3,QROC,60,55,46,9,1.09,83.64,46,14,76.48,Difficile,Facile,Difficile / Facile
1892,233,2017,Informatique,1,3,QROC,52,35,27,8,1.49,77.14,27,25,52.34,Difficile,Difficile,Difficile / Difficile
2722,233,2018,Informatique,1,3,QROC,57,33,33,0,1.73,100.0,33,24,57.59,Difficile,Difficile,Difficile / Difficile
3552,233,2019,Informatique,1,3,QROC,67,53,28,25,1.26,52.83,28,39,41.08,Difficile,Difficile,Difficile / Difficile
4382,233,2020,Informatique,1,3,QROC,65,64,64,0,1.02,100.0,64,1,98.13,Difficile,Trop Facile,Difficile / Trop Facile
233,234,2015,Informatique,1,4,QCU,87,63,58,5,1.38,92.06,58,29,66.26,Trop Difficile,Adapte,Trop Difficile / Adapte
1063,234,2016,Informatique,1,4,QCU,86,74,58,16,1.16,78.38,58,28,66.88,Adapte,Adapte,Adapte / Adapte
1893,234,2017,Informatique,1,4,QCU,76,71,56,15,1.07,78.87,56,20,74.09,Adapte,Adapte,Adapte / Adapte
2723,234,2018,Informatique,1,4,QCU,71,55,49,6,1.29,89.09,49,22,69.71,Adapte,Adapte,Adapte / Adapte
3553,234,2019,Informatique,1,4,QCU,62,54,46,8,1.15,85.19,46,16,74.06,Adapte,Adapte,Adapte / Adapte
4383,234,2020,Informatique,1,4,QCU,57,54,38,16,1.06,70.37,38,19,66.8,Adapte,Adapte,Adapte / Adapte
234,235,2015,Informatique,1,5,QCU,96,66,61,5,1.45,92.42,61,35,63.9,Trop Facile,Adapte,Trop Facile / Adapte
1064,235,2016,Informatique,1,5,QCU,106,82,68,14,1.29,82.93,68,38,63.76,Adapte,Adapte,Adapte / Adapte
1894,235,2017,Informatique,1,5,QCU,103,102,67,35,1.01,65.69,67,36,64.98,Adapte,Adapte,Adapte / Adapte
2724,235,2018,Informatique,1,5,QCU,98,96,62,34,1.02,64.58,62,36,63.59,Adapte,Adapte,Adapte / Adapte
3554,235,2019,Informatique,1,5,QCU,93,69,60,9,1.35,86.96,60,33,64.99,Adapte,Adapte,Adapte / Adapte
4384,235,2020,Informatique,1,5,QCU,85,77,59,18,1.1,76.62,59,26,69.93,Adapte,Adapte,Adapte / Adapte
235,236,2015,Informatique,1,6,QCM,43,25,6,19,1.72,24.0,6,37,14.05,Trop Difficile,Trop Difficile,Trop Difficile / Trop Difficile
1065,236,2016,Informatique,1,6,QCM,44,34,18,16,1.29,52.94,18,26,40.04,Difficile,Difficile,Difficile / Difficile
1895,236,2017,Informatique,1,6,QCM,40,39,21,18,1.03,53.85,21,19,51.46,Difficile,Difficile,Difficile / Difficile
2725,236,2018,Informatique,1,6,QCM,34,31,28,3,1.1,90.32,28,6,83.48,Difficile,Facile,Difficile / Facile
3555,236,2019,Informatique,1,6,QCM,36,16,8,8,2.25,50.0,8,28,22.33,Difficile,Trop Difficile,Difficile / Trop Difficile
4385,236,2020,Informatique,1,6,QCM,38,31,6,25,1.23,19.35,6,32,16.0,Difficile,Trop Difficile,Difficile / Trop Difficile
236,237,2015,Informatique,1,7,QCU,72,68,67,1,1.06,98.53,67,5,93.49,Trop Facile,Trop Facile,Trop Facile / Trop Facile
1066,237,2016,Informatique,1,7,QCU,70,63,34,29,1.11,53.97,34,36,49.27,Difficile,Difficile,Difficile / Difficile
1896,237,2017,Informatique,1,7,QCU,82,78,21,57,1.05,26.92,21,61,26.07,Difficile,Difficile,Difficile / Difficile
2726,237,2018,Informatique,1,7,QCU,98,66,60,6,1.48,90.91,60,38,61.72,Difficile,Adapte,Difficile / Adapte
3556,237,2019,Informatique,1,7,QCU,81,66,58,8,1.23,87.88,58,23,71.71,Adapte,Adapte,Adapte / Adapte
4386,237,2020,Informatique,1,7,QCU,90,79,56,23,1.14,70.89,56,34,61.86,Adapte,Adapte,Adapte / Adapte
237,238,2015,Informatique,2,1,QCU,56,56,56,0,1.0,100.0,56,0,99.16,Trop Facile,Trop Facile,Trop Facile / Trop Facile
1067,238,2016,Informatique,2,1,QCU,45,39,36,3,1.15,92.31,36,9,79.96,Difficile,Facile,Difficile / Facile
1897,238,2017,Informatique,2,1,QCU,51,41,10,31,1.24,24.39,10,41,20.04,Difficile,Trop Difficile,Difficile / Trop Difficile
2727,238,2018,Informatique,2,1,QCU,53,52,48,4,1.02,92.31,48,5,90.97,Difficile,Trop Facile,Difficile / Trop Facile
3557,238,2019,Informatique,2,1,QCU,54,44,28,16,1.23,63.64,28,26,51.89,Difficile,Difficile,Difficile / Difficile
4387,238,2020,Informatique,2,1,QCU,61,52,31,21,1.17,59.62,31,30,50.64,Difficile,Difficile,Difficile / Difficile
238,239,2015,Informatique,2,2,QCU,41,40,40,0,1.02,100.0,40,1,96.78,Trop Facile,Trop Facile,Trop Facile / Trop Facile
1068,239,2016,Informatique,2,2,QCU,49,41,38,3,1.2,92.68,38,11,77.13,Difficile,Facile,Difficile / Facile
1898,239,2017,Informatique,2,2,QCU,46,28,17,11,1.64,60.71,17,29,36.53,Difficile,Difficile,Difficile / Difficile
2728,239,2018,Informatique,2,2,QCU,48,47,15,32,1.02,31.91,15,33,30.82,Difficile,Difficile,Difficile / Difficile
3558,239,2019,Informatique,2,2,QCU,51,51,48,3,1.0,94.12,48,3,93.58,Difficile,Trop Facile,Difficile / Trop Facile
4388,239,2020,Informatique,2,2,QCU,61,48,18,30,1.27,37.5,18,43,28.92,Difficile,Difficile,Difficile / Difficile
239,240,2015,Informatique,2,3,QCM,89,78,76,2,1.14,97.44,76,13,84.9,Facile,Facile,Facile / Facile
1069,240,2016,Informatique,2,3,QCM,80,80,79,1,1.0,98.75,79,1,98.68,Difficile,Trop Facile,Difficile / Trop Facile
1899,240,2017,Informatique,2,3,QCM,87,52,46,6,1.67,88.46,46,41,52.9,Difficile,Difficile,Difficile / Difficile
2729,240,2018,Informatique,2,3,QCM,94,79,72,7,1.19,91.14,72,22,76.09,Difficile,Facile,Difficile / Facile
3559,240,2019,Informatique,2,3,QCM,77,77,76,1,1.0,98.7,76,1,98.57,Difficile,Trop Facile,Difficile / Trop Facile
4389,240,2020,Informatique,2,3,QCM,80,74,24,50,1.08,32.43,24,56,30.38,Difficile,Difficile,Difficile / Difficile
240,241,2015,Informatique,3,1,QCU,69,69,65,4,1.0,94.2,65,4,94.54,Trop Facile,Trop Facile,Trop Facile / Trop Facile
1070,241,2016,Informatique,3,1,QCU,82,43,21,22,1.91,48.84,21,61,26.09,Difficile,Difficile,Difficile / Difficile
1900,241,2017,Informatique,3,1,QCU,75,69,63,6,1.09,91.3,63,12,83.56,Difficile,Facile,Difficile / Facile
2730,241,2018,Informatique,3,1,QCU,83,77,25,52,1.08,32.47,25,58,29.76,Difficile,Difficile,Difficile / Difficile
3560,241,2019,Informatique,3,1,QCU,80,47,40,7,1.7,85.11,40,40,50.3,Difficile,Difficile,Difficile / Difficile
4390,241,2020,Informatique,3,1,QCU,71,69,39,30,1.03,56.52,39,32,54.34,Difficile,Difficile,Difficile / Difficile
241,242,2015,Informatique,3,2,QCM,9,5,3,2,1.8,60.0,3,6,38.71,Difficile,Difficile,Difficile / Difficile
1071,242,2016,Informatique,3,2,QCM,10,6,4,2,1.67,66.67,4,6,39.34,Difficile,Difficile,Difficile / Difficile
1901,242,2017,Informatique,3,2,QCM,10,9,4,5,1.11,44.44,4,6,35.24,Difficile,Difficile,Difficile / Difficile
2731,242,2018,Informatique,3,2,QCM,11,7,3,4,1.57,42.86,3,8,29.79,Difficile,Difficile,Difficile / Difficile
3561,242,2019,Informatique,3,2,QCM,12,11,7,4,1.09,63.64,7,5,58.5,Difficile,Difficile,Difficile / Difficile
4391,242,2020,Informatique,3,2,QCM,11,9,6,3,1.22,66.67,6,5,55.04,Difficile,Difficile,Difficile / Difficile
242,243,2015,Informatique,3,3,QCM,52,51,41,10,1.02,80.39,41,11,77.99,Facile,Facile,Facile / Facile
1072,243,2016,Informatique,3,3,QCM,57,25,17,8,2.28,68.0,17,40,30.37,Difficile,Difficile,Difficile / Difficile
1902,243,2017,Informatique,3,3,QCM,53,31,18,13,1.71,58.06,18,35,34.12,Difficile,Difficile,Difficile / Difficile
2732,243,2018,Informatique,3,3,QCM,58,57,57,0,1.02,100.0,57,1,98.0,Difficile,Trop Facile,Difficile / Trop Facile
3562,243,2019,Informatique,3,3,QCM,68,62,38,24,1.1,61.29,38,30,56.5,Difficile,Difficile,Difficile / Difficile
4392,243,2020,Informatique,3,3,QCM,68,63,62,1,1.08,98.41,62,6,90.7,Difficile,Trop Facile,Difficile / Trop Facile
243,244,2015,Informatique,3,4,QCU,67,58,23,35,1.16,39.66,23,44,34.7,Difficile,Difficile,Difficile / Difficile
1073,244,2016,Informatique,3,4,QCU,67,34,28,6,1.97,82.35,28,39,41.39,Difficile,Difficile,Difficile / Difficile
1903,244,2017,Informatique,3,4,QCU,68,54,24,30,1.26,44.44,24,44,35.49,Difficile,Difficile,Difficile / Difficile
2733,244,2018,Informatique,3,4,QCU,69,54,52,2,1.28,96.3,52,17,74.92,Difficile,Adapte,Difficile / Adapte
3563,244,2019,Informatique,3,4,QCU,66,66,46,20,1.0,69.7,46,20,69.86,Adapte,Adapte,Adapte / Adapte
4393,244,2020,Informatique,3,4,QCU,72,53,52,1,1.36,98.11,52,20,71.65,Adapte,Adapte,Adapte / Adapte
244,245,2015,Informatique,3,5,QCU,40,30,3,27,1.33,10.0,3,37,8.69,Trop Difficile,Trop Difficile,Trop Difficile / Trop Difficile
1074,245,2016,Informatique,3,5,QCU,47,23,13,10,2.04,56.52,13,34,28.16,Difficile,Difficile,Difficile / Difficile
1904,245,2017,Informatique,3,5,QCU,42,33,14,19,1.27,42.42,14,28,32.63,Difficile,Difficile,Difficile / Difficile
2734,245,2018,Informatique,3,5,QCU,36,26,20,6,1.38,76.92,20,16,56.34,Difficile,Difficile,Difficile / Difficile
3564,245,2019,Informatique,3,5,QCU,37,24,12,12,1.54,50.0,12,25,31.95,Difficile,Difficile,Difficile / Difficile
4394,245,2020,Informatique,3,5,QCU,38,16,15,1,2.38,93.75,15,23,40.21,Difficile,Difficile,Difficile / Difficile
245,246,2015,Informatique,3,6,QCM,54,41,27,14,1.32,65.85,27,27,50.87,Difficile,Difficile,Difficile / Difficile
1075,246,2016,Informatique,3,6,QCM,65,41,8,33,1.59,19.51,8,57,11.8,Difficile,Trop Difficile,Difficile / Trop Difficile
1905,246,2017,Informatique,3,6,QCM,72,51,48,3,1.41,94.12,48,24,66.9,Difficile,Adapte,Difficile / Adapte
2735,246,2018,Informatique,3,6,QCM,59,54,41,13,1.09,75.93,41,18,69.86,Adapte,Adapte,Adapte / Adapte
3565,246,2019,Informatique,3,6,QCM,69,67,47,20,1.03,70.15,47,22,67.45,Adapte,Adapte,Adapte / Adapte
4395,246,2020,Informatique,3,6,QCM,71,58,51,7,1.22,87.93,51,20,71.35,Adapte,Adapte,Adapte / Adapte
246,247,2015,Informatique,3,7,QCU,44,40,34,6,1.1,85.0,34,10,77.08,Facile,Facile,Facile / Facile
1076,247,2016,Informatique,3,7,QCU,46,40,20,20,1.15,50.0,20,26,44.08,Difficile,Difficile,Difficile / Difficile
1906,247,2017,Informatique,3,7,QCU,47,47,24,23,1.0,51.06,24,23,50.43,Difficile,Difficile,Difficile / Difficile
2736,247,2018,Informatique,3,7,QCU,38,27,13,14,1.41,48.15,13,25,33.43,Difficile,Difficile,Difficile / Difficile
3566,247,2019,Informatique,3,7,QCU,30,22,17,5,1.36,77.27,17,13,56.33,Difficile,Difficile,Difficile / Difficile
4396,247,2020,Informatique,3,7,QCU,29,28,27,1,1.04,96.43,27,2,92.54,Difficile,Trop Facile,Difficile / Trop Facile
247,248,2015,Informatique,3,8,QCM,57,51,46,5,1.12,90.2,46,11,80.62,Trop Facile,Facile,Trop Facile / Facile
1077,248,2016,Informatique,3,8,QCM,58,37,33,4,1.57,89.19,33,25,56.44,Difficile,Difficile,Difficile / Difficile
1907,248,2017,Informatique,3,8,QCM,56,54,41,13,1.04,75.93,41,15,74.01,Difficile,Adapte,Difficile / Adapte
2737,248,2018,Informatique,3,8,QCM,52,46,32,14,1.13,69.57,32,20,61.38,Adapte,Adapte,Adapte / Adapte
3567,248,2019,Informatique,3,8,QCM,42,29,28,1,1.45,96.55,28,14,65.83,Adapte,Adapte,Adapte / Adapte
4397,248,2020,Informatique,3,8,QCM,50,34,31,3,1.47,91.18,31,19,62.15,Adapte,Adapte,Adapte / Adapte
248,249,2015,Informatique,3,9,QCM,25,22,14,8,1.14,63.64,14,11,56.0,Difficile,Difficile,Difficile / Difficile
1078,249,2016,Informatique,3,9,QCM,22,21,20,1,1.05,95.24,20,2,90.03,Difficile,Trop Facile,Difficile / Trop Facile
1908,249,2017,Informatique,3,9,QCM,19,9,9,0,2.11,100.0,9,10,47.68,Difficile,Difficile,Difficile / Difficile
2738,249,2018,Informatique,3,9,QCM,18,16,5,11,1.12,31.25,5,13,30.46,Difficile,Difficile,Difficile / Difficile
3568,249,2019,Informatique,3,9,QCM,14,13,5,8,1.08,38.46,5,9,32.72,Difficile,Difficile,Difficile / Difficile
4398,249,2020,Informatique,3,9,QCM,12,9,7,2,1.33,77.78,7,5,56.5,Difficile,Difficile,Difficile / Difficile
249,250,2015,Informatique,3,10,QCM,72,71,64,7,1.01,90.14,64,8,88.83,Trop Facile,Trop Facile,Trop Facile / Trop Facile
1079,250,2016,Informatique,3,10,QCM,84,55,32,23,1.53,58.18,32,52,37.96,Difficile,Difficile,Difficile / Difficile
1909,250,2017,Informatique,3,10,QCM,78,76,72,4,1.03,94.74,72,6,92.3,Difficile,Trop Facile,Difficile / Trop Facile
2739,250,2018,Informatique,3,10,QCM,72,66,58,8,1.09,87.88,58,14,80.21,Difficile,Facile,Difficile / Facile
3569,250,2019,Informatique,3,10,QCM,66,27,1,26,2.44,3.7,1,65,1.9,Difficile,Trop Difficile,Difficile / Trop Difficile
4399,250,2020,Informatique,3,10,QCM,62,28,24,4,2.21,85.71,24,38,38.45,Difficile,Difficile,Difficile / Difficile
250,251,2015,Informatique,3,11,QCU,99,43,28,15,2.3,65.12,28,71,28.57,Difficile,Difficile,Difficile / Difficile
1080,251,2016,Informatique,3,11,QCU,107,78,38,40,1.37,48.72,38,69,35.3,Difficile,Difficile,Difficile / Difficile
1910,251,2017,Informatique,3,11,QCU,87,48,34,14,1.81,70.83,34,53,39.27,Difficile,Difficile,Difficile / Difficile
2740,251,2018,Informatique,3,11,QCU,71,41,26,15,1.73,63.41,26,45,36.43,Difficile,Difficile,Difficile / Difficile
3570,251,2019,Informatique,3,11,QCU,74,55,4,51,1.35,7.27,4,70,5.19,Difficile,Trop Difficile,Difficile / Trop Difficile
4400,251,2020,Informatique,3,11,QCU,60,31,15,16,1.94,48.39,15,45,25.52,Difficile,Difficile,Difficile / Difficile
251,252,2015,Informatique,3,12,QCM,17,14,13,1,1.21,92.86,13,4,77.35,Facile,Facile,Facile / Facile
1081,252,2016,Informatique,3,12,QCM,17,16,8,8,1.06,50.0,8,9,49.57,Difficile,Difficile,Difficile / Difficile
1911,252,2017,Informatique,3,12,QCM,19,16,8,8,1.19,50.0,8,11,40.9,Difficile,Difficile,Difficile / Difficile
2741,252,2018,Informatique,3,12,QCM,15,8,5,3,1.88,62.5,5,10,31.59,Difficile,Difficile,Difficile / Difficile
3571,252,2019,Informatique,3,12,QCM,15,12,6,6,1.25,50.0,6,9,40.72,Difficile,Difficile,Difficile / Difficile
4401,252,2020,Informatique,3,12,QCM,12,6,6,0,2.0,100.0,6,6,53.82,Difficile,Difficile,Difficile / Difficile
252,253,2015,Informatique,4,1,QCM,23,20,18,2,1.15,90.0,18,5,76.92,Facile,Facile,Facile / Facile
1082,253,2016,Informatique,4,1,QCM,18,14,8,6,1.29,57.14,8,10,45.72,Difficile,Difficile,Difficile / Difficile
1912,253,2017,Informatique,4,1,QCM,15,10,4,6,1.5,40.0,4,11,29.7,Difficile,Difficile,Difficile / Difficile
2742,253,2018,Informatique,4,1,QCM,16,7,0,7,2.29,0.0,0,16,2.44,Difficile,Trop Difficile,Difficile / Trop Difficile
3572,253,2019,Informatique,4,1,QCM,13,8,6,2,1.62,75.0,6,7,43.87,Difficile,Difficile,Difficile / Difficile
4402,253,2020,Informatique,4,1,QCM,15,11,8,3,1.36,72.73,8,7,55.47,Difficile,Difficile,Difficile / Difficile
253,254,2015,Informatique,4,2,QCU,43,20,1,19,2.15,5.0,1,42,2.93,Adapte,Trop Difficile,Adapte / Trop Difficile
1083,254,2016,Informatique,4,2,QCU,39,37,14,23,1.05,37.84,14,25,34.96,Difficile,Difficile,Difficile / Difficile
1913,254,2017,Informatique,4,2,QCU,38,32,10,22,1.19,31.25,10,28,26.05,Difficile,Difficile,Difficile / Difficile
2743,254,2018,Informatique,4,2,QCU,36,32,21,11,1.12,65.62,21,15,57.85,Difficile,Difficile,Difficile / Difficile
3573,254,2019,Informatique,4,2,QCU,30,18,4,14,1.67,22.22,4,26,12.41,Difficile,Trop Difficile,Difficile / Trop Difficile
4403,254,2020,Informatique,4,2,QCU,33,33,17,16,1.0,51.52,17,16,50.58,Difficile,Difficile,Difficile / Difficile
254,255,2015,Informatique,4,3,QCU,6,6,5,1,1.0,83.33,5,1,84.11,Facile,Facile,Facile / Facile
1084,255,2016,Informatique,4,3,QCU,6,5,3,2,1.2,60.0,3,3,54.1,Difficile,Difficile,Difficile / Difficile
1914,255,2017,Informatique,4,3,QCU,6,5,5,0,1.2,100.0,5,1,89.94,Difficile,Trop Facile,Difficile / Trop Facile
2744,255,2018,Informatique,4,3,QCU,6,3,3,0,2.0,100.0,3,3,49.08,Difficile,Difficile,Difficile / Difficile
3574,255,2019,Informatique,4,3,QCU,6,4,2,2,1.5,50.0,2,4,39.16,Difficile,Difficile,Difficile / Difficile
4404,255,2020,Informatique,4,3,QCU,7,6,4,2,1.17,66.67,4,3,51.21,Difficile,Difficile,Difficile / Difficile
255,256,2015,Informatique,4,4,QCM,41,31,25,6,1.32,80.65,25,16,61.91,Adapte,Adapte,Adapte / Adapte
1085,256,2016,Informatique,4,4,QCM,35,27,22,5,1.3,81.48,22,13,63.03,Adapte,Adapte,Adapte / Adapte
1915,256,2017,Informatique,4,4,QCM,31,26,22,4,1.19,84.62,22,9,69.41,Adapte,Adapte,Adapte / Adapte
2745,256,2018,Informatique,4,4,QCM,36,27,22,5,1.33,81.48,22,14,61.96,Adapte,Adapte,Adapte / Adapte
3575,256,2019,Informatique,4,4,QCM,42,36,29,7,1.17,80.56,29,13,69.12,Adapte,Adapte,Adapte / Adapte
4405,256,2020,Informatique,4,4,QCM,50,37,31,6,1.35,83.78,31,19,61.46,Adapte,Adapte,Adapte / Adapte
256,257,2015,Informatique,4,5,QCM,8,2,1,1,4.0,50.0,1,7,17.65,Trop Difficile,Trop Difficile,Trop Difficile / Trop Difficile
1086,257,2016,Informatique,4,5,QCM,6,3,2,1,2.0,66.67,2,4,28.24,Difficile,Difficile,Difficile / Difficile
1916,257,2017,Informatique,4,5,QCM,5,4,3,1,1.25,75.0,3,2,61.21,Difficile,Adapte,Difficile / Adapte
2746,257,2018,Informatique,4,5,QCM,6,6,4,2,1.0,66.67,4,2,65.48,Adapte,Adapte,Adapte / Adapte
3576,257,2019,Informatique,4,5,QCM,7,6,5,1,1.17,83.33,5,2,70.73,Adapte,Adapte,Adapte / Adapte
4406,257,2020,Informatique,4,5,QCM,7,7,4,3,1.0,57.14,4,3,62.06,Adapte,Adapte,Adapte / Adapte
257,258,2015,Informatique,4,6,QCU,59,57,53,4,1.04,92.98,53,6,89.68,Trop Facile,Trop Facile,Trop Facile / Trop Facile
1087,258,2016,Informatique,4,6,QCU,51,27,16,11,1.89,59.26,16,35,30.87,Difficile,Difficile,Difficile / Difficile
1917,258,2017,Informatique,4,6,QCU,48,47,20,27,1.02,42.55,20,28,42.13,Difficile,Difficile,Difficile / Difficile
2747,258,2018,Informatique,4,6,QCU,52,49,48,1,1.06,97.96,48,4,93.15,Difficile,Trop Facile,Difficile / Trop Facile
3577,258,2019,Informatique,4,6,QCU,59,53,51,2,1.11,96.23,51,8,86.58,Difficile,Trop Facile,Difficile / Trop Facile
4407,258,2020,Informatique,4,6,QCU,49,48,48,0,1.02,100.0,48,1,98.37,Difficile,Trop Facile,Difficile / Trop Facile
258,259,2015,Informatique,4,7,QCU,46,44,43,1,1.05,97.73,43,3,93.07,Trop Facile,Trop Facile,Trop Facile / Trop Facile
1088,259,2016,Informatique,4,7,QCU,44,16,15,1,2.75,93.75,15,29,34.28,Difficile,Difficile,Difficile / Difficile
1918,259,2017,Informatique,4,7,QCU,47,46,16,30,1.02,34.78,16,31,34.63,Difficile,Difficile,Difficile / Difficile
2748,259,2018,Informatique,4,7,QCU,41,33,4,29,1.24,12.12,4,37,10.83,Difficile,Trop Difficile,Difficile / Trop Difficile
3578,259,2019,Informatique,4,7,QCU,33,29,10,19,1.14,34.48,10,23,30.36,Difficile,Difficile,Difficile / Difficile
4408,259,2020,Informatique,4,7,QCU,30,10,9,1,3.0,90.0,9,21,30.25,Difficile,Difficile,Difficile / Difficile
259,260,2015,Informatique,4,8,QCM,33,33,16,17,1.0,48.48,16,17,47.23,Difficile,Difficile,Difficile / Difficile
1089,260,2016,Informatique,4,8,QCM,38,38,37,1,1.0,97.37,37,1,97.35,Difficile,Trop Facile,Difficile / Trop Facile
1919,260,2017,Informatique,4,8,QCM,42,22,11,11,1.91,50.0,11,31,27.15,Difficile,Difficile,Difficile / Difficile
2749,260,2018,Informatique,4,8,QCM,50,26,21,5,1.92,80.77,21,29,41.79,Difficile,Difficile,Difficile / Difficile
3579,260,2019,Informatique,4,8,QCM,45,26,14,12,1.73,53.85,14,31,31.4,Difficile,Difficile,Difficile / Difficile
4409,260,2020,Informatique,4,8,QCM,44,30,21,9,1.47,70.0,21,23,48.64,Difficile,Difficile,Difficile / Difficile
260,261,2015,Informatique,5,1,QROC,96,90,75,15,1.07,83.33,75,21,78.28,Facile,Facile,Facile / Facile
1090,261,2016,Informatique,5,1,QROC,89,88,33,55,1.01,37.5,33,56,37.17,Difficile,Difficile,Difficile / Difficile
1920,261,2017,Informatique,5,1,QROC,75,73,47,26,1.03,64.38,47,28,63.18,Difficile,Adapte,Difficile / Adapte
2750,261,2018,Informatique,5,1,QROC,73,65,48,17,1.12,73.85,48,25,65.44,Adapte,Adapte,Adapte / Adapte
3580,261,2019,Informatique,5,1,QROC,74,71,47,24,1.04,66.2,47,27,63.91,Adapte,Adapte,Adapte / Adapte
4410,261,2020,Informatique,5,1,QROC,85,56,51,5,1.52,91.07,51,34,60.45,Adapte,Adapte,Adapte / Adapte
261,262,2015,Informatique,5,2,QCM,83,41,15,26,2.02,36.59,15,68,17.88,Trop Difficile,Trop Difficile,Trop Difficile / Trop Difficile
1091,262,2016,Informatique,5,2,QCM,93,55,55,0,1.69,100.0,55,38,58.7,Difficile,Difficile,Difficile / Difficile
1921,262,2017,Informatique,5,2,QCM,91,24,13,11,3.79,54.17,13,78,13.95,Difficile,Trop Difficile,Difficile / Trop Difficile
2751,262,2018,Informatique,5,2,QCM,92,66,39,27,1.39,59.09,39,53,42.73,Difficile,Difficile,Difficile / Difficile
3581,262,2019,Informatique,5,2,QCM,101,66,36,30,1.53,54.55,36,65,35.2,Difficile,Difficile,Difficile / Difficile
4411,262,2020,Informatique,5,2,QCM,115,77,66,11,1.49,85.71,66,49,57.7,Difficile,Difficile,Difficile / Difficile
262,263,2015,Informatique,5,3,QCU,85,72,55,17,1.18,76.39,55,30,64.49,Adapte,Adapte,Adapte / Adapte
1092,263,2016,Informatique,5,3,QCU,70,54,42,12,1.3,77.78,42,28,60.31,Adapte,Adapte,Adapte / Adapte
1922,263,2017,Informatique,5,3,QCU,58,58,39,19,1.0,67.24,39,19,67.09,Adapte,Adapte,Adapte / Adapte
2752,263,2018,Informatique,5,3,QCU,63,50,45,5,1.26,90.0,45,18,71.88,Adapte,Adapte,Adapte / Adapte
3582,263,2019,Informatique,5,3,QCU,53,42,36,6,1.26,85.71,36,17,68.06,Adapte,Adapte,Adapte / Adapte
4412,263,2020,Informatique,5,3,QCU,58,43,36,7,1.35,83.72,36,22,61.91,Adapte,Adapte,Adapte / Adapte
263,264,2015,Informatique,5,4,QCU,13,5,0,5,2.6,0.0,0,13,2.67,Facile,Trop Difficile,Facile / Trop Difficile
1093,264,2016,Informatique,5,4,QCU,15,13,4,9,1.15,30.77,4,11,26.06,Difficile,Difficile,Difficile / Difficile
1923,264,2017,Informatique,5,4,QCU,12,4,3,1,3.0,75.0,3,9,25.96,Difficile,Difficile,Difficile / Difficile
2753,264,2018,Informatique,5,4,QCU,12,10,9,1,1.2,90.0,9,3,77.72,Difficile,Facile,Difficile / Facile
3583,264,2019,Informatique,5,4,QCU,10,5,3,2,2.0,60.0,3,7,29.54,Difficile,Difficile,Difficile / Difficile
4413,264,2020,Informatique,5,4,QCU,8,4,4,0,2.0,100.0,4,4,45.48,Difficile,Difficile,Difficile / Difficile
264,265,2015,Informatique,5,5,QCU,79,62,26,36,1.27,41.94,26,53,33.2,Facile,Difficile,Facile / Difficile
1094,265,2016,Informatique,5,5,QCU,84,60,56,4,1.4,93.33,56,28,66.54,Difficile,Adapte,Difficile / Adapte
1924,265,2017,Informatique,5,5,QCU,93,75,59,16,1.24,78.67,59,34,63.48,Adapte,Adapte,Adapte / Adapte
2754,265,2018,Informatique,5,5,QCU,74,66,47,19,1.12,71.21,47,27,64.16,Adapte,Adapte,Adapte / Adapte
3584,265,2019,Informatique,5,5,QCU,89,83,63,20,1.07,75.9,63,26,71.01,Adapte,Adapte,Adapte / Adapte
4414,265,2020,Informatique,5,5,QCU,94,90,61,29,1.04,67.78,61,33,64.7,Adapte,Adapte,Adapte / Adapte
265,266,2015,Informatique,6,1,QCU,51,36,13,23,1.42,36.11,13,38,26.14,Difficile,Difficile,Difficile / Difficile
1095,266,2016,Informatique,6,1,QCU,56,35,30,5,1.6,85.71,30,26,54.16,Difficile,Difficile,Difficile / Difficile
1925,266,2017,Informatique,6,1,QCU,52,42,42,0,1.24,100.0,42,10,81.47,Difficile,Facile,Difficile / Facile
2755,266,2018,Informatique,6,1,QCU,48,40,26,14,1.2,65.0,26,22,53.28,Difficile,Difficile,Difficile / Difficile
3585,266,2019,Informatique,6,1,QCU,49,47,21,26,1.04,44.68,21,28,42.46,Difficile,Difficile,Difficile / Difficile
4415,266,2020,Informatique,6,1,QCU,53,28,20,8,1.89,71.43,20,33,37.26,Difficile,Difficile,Difficile / Difficile
266,267,2015,Informatique,6,2,QCU,78,42,10,32,1.86,23.81,10,68,13.43,Difficile,Trop Difficile,Difficile / Trop Difficile
1096,267,2016,Informatique,6,2,QCU,62,55,50,5,1.13,90.91,50,12,80.57,Difficile,Facile,Difficile / Facile
1926,267,2017,Informatique,6,2,QCU,65,40,32,8,1.62,80.0,32,33,48.88,Difficile,Difficile,Difficile / Difficile
2756,267,2018,Informatique,6,2,QCU,57,30,27,3,1.9,90.0,27,30,47.15,Difficile,Difficile,Difficile / Difficile
3586,267,2019,Informatique,6,2,QCU,51,29,14,15,1.76,48.28,14,37,26.65,Difficile,Difficile,Difficile / Difficile
4416,267,2020,Informatique,6,2,QCU,55,49,21,28,1.12,42.86,21,34,38.18,Difficile,Difficile,Difficile / Difficile
267,268,2015,Informatique,6,3,QCM,36,35,29,6,1.03,82.86,29,7,79.79,Facile,Facile,Facile / Facile
1097,268,2016,Informatique,6,3,QCM,30,29,9,20,1.03,31.03,9,21,29.51,Difficile,Difficile,Difficile / Difficile
1927,268,2017,Informatique,6,3,QCM,26,25,24,1,1.04,96.0,24,2,90.57,Difficile,Trop Facile,Difficile / Trop Facile
2757,268,2018,Informatique,6,3,QCM,29,26,12,14,1.12,46.15,12,17,40.72,Difficile,Difficile,Difficile / Difficile
3587,268,2019,Informatique,6,3,QCM,28,15,15,0,1.87,100.0,15,13,54.39,Difficile,Difficile,Difficile / Difficile
4417,268,2020,Informatique,6,3,QCM,27,15,11,4,1.8,73.33,11,16,41.23,Difficile,Difficile,Difficile / Difficile
268,269,2015,Informatique,6,4,QCU,59,36,31,5,1.64,86.11,31,28,53.02,Difficile,Difficile,Difficile / Difficile
1098,269,2016,Informatique,6,4,QCU,51,34,26,8,1.5,76.47,26,25,50.19,Difficile,Difficile,Difficile / Difficile
1928,269,2017,Informatique,6,4,QCU,47,19,16,3,2.47,84.21,16,31,34.32,Difficile,Difficile,Difficile / Difficile
2758,269,2018,Informatique,6,4,QCU,43,42,25,17,1.02,59.52,25,18,57.75,Difficile,Difficile,Difficile / Difficile
3588,269,2019,Informatique,6,4,QCU,44,37,36,1,1.19,97.3,36,8,81.47,Difficile,Facile,Difficile / Facile
4418,269,2020,Informatique,6,4,QCU,53,34,5,29,1.56,14.71,5,48,9.62,Difficile,Trop Difficile,Difficile / Trop Difficile
269,270,2015,Informatique,6,5,QROC,42,42,40,2,1.0,95.24,40,2,94.34,Trop Difficile,Trop Facile,Trop Difficile / Trop Facile
1099,270,2016,Informatique,6,5,QROC,36,35,33,2,1.03,94.29,33,3,91.43,Difficile,Trop Facile,Difficile / Trop Facile
1929,270,2017,Informatique,6,5,QROC,42,35,14,21,1.2,40.0,14,28,32.96,Difficile,Difficile,Difficile / Difficile
2759,270,2018,Informatique,6,5,QROC,36,34,25,9,1.06,73.53,25,11,70.22,Difficile,Adapte,Difficile / Adapte
3589,270,2019,Informatique,6,5,QROC,37,30,23,7,1.23,76.67,23,14,62.23,Adapte,Adapte,Adapte / Adapte
4419,270,2020,Informatique,6,5,QROC,43,42,29,13,1.02,69.05,29,14,68.2,Adapte,Adapte,Adapte / Adapte
270,271,2015,Informatique,6,6,QCU,32,27,27,0,1.19,100.0,27,5,83.53,Facile,Facile,Facile / Facile
1100,271,2016,Informatique,6,6,QCU,30,11,8,3,2.73,72.73,8,22,28.22,Difficile,Difficile,Difficile / Difficile
1930,271,2017,Informatique,6,6,QCU,27,20,18,2,1.35,90.0,18,9,68.32,Difficile,Adapte,Difficile / Adapte
2760,271,2018,Informatique,6,6,QCU,25,21,16,5,1.19,76.19,16,9,63.84,Adapte,Adapte,Adapte / Adapte
3590,271,2019,Informatique,6,6,QCU,30,21,18,3,1.43,85.71,18,12,60.45,Adapte,Adapte,Adapte / Adapte
4420,271,2020,Informatique,6,6,QCU,36,32,24,8,1.12,75.0,24,12,67.87,Adapte,Adapte,Adapte / Adapte
271,272,2015,Informatique,7,1,QROC,90,88,65,23,1.02,73.86,65,25,71.89,Difficile,Adapte,Difficile / Adapte
1101,272,2016,Informatique,7,1,QROC,72,71,53,18,1.01,74.65,53,19,73.86,Adapte,Adapte,Adapte / Adapte
1931,272,2017,Informatique,7,1,QROC,62,50,44,6,1.24,88.0,44,18,71.73,Adapte,Adapte,Adapte / Adapte
2761,272,2018,Informatique,7,1,QROC,62,44,42,2,1.41,95.45,42,20,67.21,Adapte,Adapte,Adapte / Adapte
3591,272,2019,Informatique,7,1,QROC,59,43,36,7,1.37,83.72,36,23,61.82,Adapte,Adapte,Adapte / Adapte
4421,272,2020,Informatique,7,1,QROC,71,63,51,12,1.13,80.95,51,20,71.18,Adapte,Adapte,Adapte / Adapte
272,273,2015,Informatique,7,2,QCU,36,31,30,1,1.16,96.77,30,6,82.77,Facile,Facile,Facile / Facile
1102,273,2016,Informatique,7,2,QCU,30,27,13,14,1.11,48.15,13,17,42.59,Difficile,Difficile,Difficile / Difficile
1932,273,2017,Informatique,7,2,QCU,24,17,13,4,1.41,76.47,13,11,53.84,Difficile,Difficile,Difficile / Difficile
2762,273,2018,Informatique,7,2,QCU,27,17,9,8,1.59,52.94,9,18,34.87,Difficile,Difficile,Difficile / Difficile
3592,273,2019,Informatique,7,2,QCU,29,26,11,15,1.12,42.31,11,18,38.93,Difficile,Difficile,Difficile / Difficile
4422,273,2020,Informatique,7,2,QCU,23,20,9,11,1.15,45.0,9,14,39.77,Difficile,Difficile,Difficile / Difficile
273,274,2015,Informatique,7,3,QCM,95,88,83,5,1.08,94.32,83,12,87.73,Adapte,Trop Facile,Adapte / Trop Facile
1103,274,2016,Informatique,7,3,QCM,98,67,38,29,1.46,56.72,38,60,39.27,Difficile,Difficile,Difficile / Difficile
1933,274,2017,Informatique,7,3,QCM,88,83,38,45,1.06,45.78,38,50,43.59,Difficile,Difficile,Difficile / Difficile
2763,274,2018,Informatique,7,3,QCM,84,77,65,12,1.09,84.42,65,19,77.19,Difficile,Facile,Difficile / Facile
3593,274,2019,Informatique,7,3,QCM,82,80,24,56,1.02,30.0,24,58,28.91,Difficile,Difficile,Difficile / Difficile
4423,274,2020,Informatique,7,3,QCM,86,81,80,1,1.06,98.77,80,6,92.87,Difficile,Trop Facile,Difficile / Trop Facile
274,275,2015,Informatique,7,4,QCM,52,52,46,6,1.0,88.46,46,6,87.55,Facile,Trop Facile,Facile / Trop Facile
1104,275,2016,Informatique,7,4,QCM,54,28,27,1,1.93,96.43,27,27,50.44,Difficile,Difficile,Difficile / Difficile
1934,275,2017,Informatique,7,4,QCM,59,31,21,10,1.9,67.74,21,38,35.22,Difficile,Difficile,Difficile / Difficile
2764,275,2018,Informatique,7,4,QCM,64,37,17,20,1.73,45.95,17,47,26.56,Difficile,Difficile,Difficile / Difficile
3594,275,2019,Informatique,7,4,QCM,77,42,40,2,1.83,95.24,40,37,52.13,Difficile,Difficile,Difficile / Difficile
4424,275,2020,Informatique,7,4,QCM,67,45,38,7,1.49,84.44,38,29,56.63,Difficile,Difficile,Difficile / Difficile
275,276,2015,Informatique,7,5,QCU,49,48,46,2,1.02,95.83,46,3,93.13,Difficile,Trop Facile,Difficile / Trop Facile
1105,276,2016,Informatique,7,5,QCU,57,28,27,1,2.04,96.43,27,30,47.33,Difficile,Difficile,Difficile / Difficile
1935,276,2017,Informatique,7,5,QCU,62,58,26,32,1.07,44.83,26,36,41.16,Difficile,Difficile,Difficile / Difficile
2765,276,2018,Informatique,7,5,QCU,53,33,17,16,1.61,51.52,17,36,32.34,Difficile,Difficile,Difficile / Difficile
3595,276,2019,Informatique,7,5,QCU,51,33,23,10,1.55,69.7,23,28,45.1,Difficile,Difficile,Difficile / Difficile
4425,276,2020,Informatique,7,5,QCU,43,38,10,28,1.13,26.32,10,33,23.99,Difficile,Trop Difficile,Difficile / Trop Difficile
276,277,2015,Informatique,7,6,QCU,54,41,37,4,1.32,90.24,37,17,68.91,Difficile,Adapte,Difficile / Adapte
1106,277,2016,Informatique,7,6,QCU,53,50,33,17,1.06,66.0,33,20,62.9,Adapte,Adapte,Adapte / Adapte
1936,277,2017,Informatique,7,6,QCU,61,53,37,16,1.15,69.81,37,24,60.82,Adapte,Adapte,Adapte / Adapte
2766,277,2018,Informatique,7,6,QCU,56,43,37,6,1.3,86.05,37,19,65.98,Adapte,Adapte,Adapte / Adapte
3596,277,2019,Informatique,7,6,QCU,57,41,40,1,1.39,97.56,40,17,69.9,Adapte,Adapte,Adapte / Adapte
4426,277,2020,Informatique,7,6,QCU,52,36,31,5,1.44,86.11,31,21,60.15,Adapte,Adapte,Adapte / Adapte
277,278,2015,Informatique,7,7,QCU,87,82,77,5,1.06,93.9,77,10,88.36,Trop Facile,Trop Facile,Trop Facile / Trop Facile
1107,278,2016,Informatique,7,7,QCU,93,69,47,22,1.35,68.12,47,46,50.32,Difficile,Difficile,Difficile / Difficile
1937,278,2017,Informatique,7,7,QCU,75,43,42,1,1.74,97.67,42,33,56.62,Difficile,Difficile,Difficile / Difficile
2767,278,2018,Informatique,7,7,QCU,87,83,13,70,1.05,15.66,13,74,14.69,Difficile,Trop Difficile,Difficile / Trop Difficile
3597,278,2019,Informatique,7,7,QCU,84,33,20,13,2.55,60.61,20,64,23.95,Difficile,Trop Difficile,Difficile / Trop Difficile
4427,278,2020,Informatique,7,7,QCU,68,58,20,38,1.17,34.48,20,48,29.33,Difficile,Difficile,Difficile / Difficile
278,279,2015,Informatique,7,8,QCU,94,85,65,20,1.11,76.47,65,29,68.74,Trop Facile,Adapte,Trop Facile / Adapte
1108,279,2016,Informatique,7,8,QCU,101,90,67,23,1.12,74.44,67,34,66.26,Adapte,Adapte,Adapte / Adapte
1938,279,2017,Informatique,7,8,QCU,86,73,62,11,1.18,84.93,62,24,72.54,Adapte,Adapte,Adapte / Adapte
2768,279,2018,Informatique,7,8,QCU,102,94,75,19,1.09,79.79,75,27,73.61,Adapte,Adapte,Adapte / Adapte
3598,279,2019,Informatique,7,8,QCU,100,96,61,35,1.04,63.54,61,39,60.84,Adapte,Adapte,Adapte / Adapte
4428,279,2020,Informatique,7,8,QCU,81,69,51,18,1.17,73.91,51,30,63.56,Adapte,Adapte,Adapte / Adapte
279,280,2015,Informatique,7,9,QCM,5,4,2,2,1.25,50.0,2,3,47.98,Trop Facile,Difficile,Trop Facile / Difficile
1109,280,2016,Informatique,7,9,QCM,6,5,4,1,1.2,80.0,4,2,64.95,Difficile,Adapte,Difficile / Adapte
1939,280,2017,Informatique,7,9,QCM,5,4,3,1,1.25,75.0,3,2,61.07,Adapte,Adapte,Adapte / Adapte
2769,280,2018,Informatique,7,9,QCM,6,6,4,2,1.0,66.67,4,2,73.09,Adapte,Adapte,Adapte / Adapte
3599,280,2019,Informatique,7,9,QCM,7,4,4,0,1.75,100.0,4,3,64.04,Adapte,Adapte,Adapte / Adapte
4429,280,2020,Informatique,7,9,QCM,8,7,6,1,1.14,85.71,6,2,71.61,Adapte,Adapte,Adapte / Adapte
280,281,2015,Informatique,8,1,QROC,59,32,29,3,1.84,90.62,29,30,49.73,Difficile,Difficile,Difficile / Difficile
1110,281,2016,Informatique,8,1,QROC,61,60,26,34,1.02,43.33,26,35,42.67,Difficile,Difficile,Difficile / Difficile
1940,281,2017,Informatique,8,1,QROC,71,56,11,45,1.27,19.64,11,60,15.25,Difficile,Trop Difficile,Difficile / Trop Difficile
2770,281,2018,Informatique,8,1,QROC,61,59,32,27,1.03,54.24,32,29,52.59,Difficile,Difficile,Difficile / Difficile
3600,281,2019,Informatique,8,1,QROC,59,59,15,44,1.0,25.42,15,44,25.59,Difficile,Difficile,Difficile / Difficile
4430,281,2020,Informatique,8,1,QROC,53,47,20,27,1.13,42.55,20,33,37.65,Difficile,Difficile,Difficile / Difficile
281,282,2015,Informatique,8,2,QCM,5,5,3,2,1.0,60.0,3,2,62.06,Adapte,Adapte,Adapte / Adapte
1111,282,2016,Informatique,8,2,QCM,4,3,3,0,1.33,100.0,3,1,65.65,Adapte,Adapte,Adapte / Adapte
1941,282,2017,Informatique,8,2,QCM,4,2,2,0,2.0,100.0,2,2,60.62,Adapte,Adapte,Adapte / Adapte
2771,282,2018,Informatique,8,2,QCM,3,3,2,1,1.0,66.67,2,1,61.38,Adapte,Adapte,Adapte / Adapte
3601,282,2019,Informatique,8,2,QCM,2,1,1,0,2.0,100.0,1,1,74.84,Adapte,Adapte,Adapte / Adapte
4431,282,2020,Informatique,8,2,QCM,2,1,1,0,2.0,100.0,1,1,61.93,Adapte,Adapte,Adapte / Adapte
282,283,2015,Informatique,8,3,QCM,38,34,26,8,1.12,76.47,26,12,67.33,Difficile,Adapte,Difficile / Adapte
1112,283,2016,Informatique,8,3,QCM,38,34,25,9,1.12,73.53,25,13,66.87,Adapte,Adapte,Adapte / Adapte
1942,283,2017,Informatique,8,3,QCM,39,28,26,2,1.39,92.86,26,13,66.96,Adapte,Adapte,Adapte / Adapte
2772,283,2018,Informatique,8,3,QCM,34,27,25,2,1.26,92.59,25,9,72.9,Adapte,Adapte,Adapte / Adapte
3602,283,2019,Informatique,8,3,QCM,41,38,30,8,1.08,78.95,30,11,73.1,Adapte,Adapte,Adapte / Adapte
4432,283,2020,Informatique,8,3,QCM,42,37,29,8,1.14,78.38,29,13,69.28,Adapte,Adapte,Adapte / Adapte
283,284,2015,Informatique,8,4,QCM,78,74,0,74,1.05,0.0,0,78,0.32,Trop Difficile,Trop Difficile,Trop Difficile / Trop Difficile
1113,284,2016,Informatique,8,4,QCM,68,53,19,34,1.28,35.85,19,49,27.36,Difficile,Difficile,Difficile / Difficile
1943,284,2017,Informatique,8,4,QCM,79,78,75,3,1.01,96.15,75,4,94.82,Difficile,Trop Facile,Difficile / Trop Facile
2773,284,2018,Informatique,8,4,QCM,85,61,26,35,1.39,42.62,26,59,30.39,Difficile,Difficile,Difficile / Difficile
3603,284,2019,Informatique,8,4,QCM,76,43,41,2,1.77,95.35,41,35,53.86,Difficile,Difficile,Difficile / Difficile
4433,284,2020,Informatique,8,4,QCM,80,61,45,16,1.31,73.77,45,35,56.41,Difficile,Difficile,Difficile / Difficile
284,285,2015,Informatique,8,5,QCU,37,37,36,1,1.0,97.3,36,1,97.76,Trop Facile,Trop Facile,Trop Facile / Trop Facile
1114,285,2016,Informatique,8,5,QCU,43,34,18,16,1.26,52.94,18,25,41.63,Difficile,Difficile,Difficile / Difficile
1944,285,2017,Informatique,8,5,QCU,46,36,27,9,1.28,75.0,27,19,58.4,Difficile,Difficile,Difficile / Difficile
2774,285,2018,Informatique,8,5,QCU,50,30,26,4,1.67,86.67,26,24,51.98,Difficile,Difficile,Difficile / Difficile
3604,285,2019,Informatique,8,5,QCU,50,33,13,20,1.52,39.39,13,37,26.65,Difficile,Difficile,Difficile / Difficile
4434,285,2020,Informatique,8,5,QCU,40,27,23,4,1.48,85.19,23,17,57.31,Difficile,Difficile,Difficile / Difficile
285,286,2015,Informatique,8,6,QCU,73,72,66,6,1.01,91.67,66,7,90.13,Difficile,Trop Facile,Difficile / Trop Facile
1115,286,2016,Informatique,8,6,QCU,79,69,32,37,1.14,46.38,32,47,40.26,Difficile,Difficile,Difficile / Difficile
1945,286,2017,Informatique,8,6,QCU,74,47,34,13,1.57,72.34,34,40,45.93,Difficile,Difficile,Difficile / Difficile
2775,286,2018,Informatique,8,6,QCU,67,51,47,4,1.31,92.16,47,20,70.62,Difficile,Adapte,Difficile / Adapte
3605,286,2019,Informatique,8,6,QCU,69,61,45,16,1.13,73.77,45,24,64.92,Adapte,Adapte,Adapte / Adapte
4435,286,2020,Informatique,8,6,QCU,60,54,41,13,1.11,75.93,41,19,67.94,Adapte,Adapte,Adapte / Adapte
286,287,2015,Informatique,8,7,QCM,47,25,6,19,1.88,24.0,6,41,13.32,Trop Difficile,Trop Difficile,Trop Difficile / Trop Difficile
1116,287,2016,Informatique,8,7,QCM,42,32,19,13,1.31,59.38,19,23,44.93,Difficile,Difficile,Difficile / Difficile
1946,287,2017,Informatique,8,7,QCM,45,36,24,12,1.25,66.67,24,21,54.37,Difficile,Difficile,Difficile / Difficile
2776,287,2018,Informatique,8,7,QCM,46,35,30,5,1.31,85.71,30,16,65.54,Difficile,Adapte,Difficile / Adapte
3606,287,2019,Informatique,8,7,QCM,48,45,30,15,1.07,66.67,30,18,61.48,Adapte,Adapte,Adapte / Adapte
4436,287,2020,Informatique,8,7,QCM,53,50,35,15,1.06,70.0,35,18,65.65,Adapte,Adapte,Adapte / Adapte
287,288,2015,Informatique,8,8,QCM,75,64,63,1,1.17,98.44,63,12,83.85,Facile,Facile,Facile / Facile
1117,288,2016,Informatique,8,8,QCM,76,41,39,2,1.85,95.12,39,37,51.9,Difficile,Difficile,Difficile / Difficile
1947,288,2017,Informatique,8,8,QCM,91,82,59,23,1.11,71.95,59,32,64.48,Difficile,Adapte,Difficile / Adapte
2777,288,2018,Informatique,8,8,QCM,108,77,68,9,1.4,88.31,68,40,62.59,Adapte,Adapte,Adapte / Adapte
3607,288,2019,Informatique,8,8,QCM,116,110,75,35,1.05,68.18,75,41,64.34,Adapte,Adapte,Adapte / Adapte
4437,288,2020,Informatique,8,8,QCM,113,99,69,30,1.14,69.7,69,44,61.06,Adapte,Adapte,Adapte / Adapte
288,289,2015,Informatique,8,9,QCU,35,34,29,5,1.03,85.29,29,6,83.67,Facile,Facile,Facile / Facile
1118,289,2016,Informatique,8,9,QCU,30,27,17,10,1.11,62.96,17,13,57.43,Difficile,Difficile,Difficile / Difficile
1948,289,2017,Informatique,8,9,QCU,31,16,13,3,1.94,81.25,13,18,42.25,Difficile,Difficile,Difficile / Difficile
2778,289,2018,Informatique,8,9,QCU,36,20,10,10,1.8,50.0,10,26,29.05,Difficile,Difficile,Difficile / Difficile
3608,289,2019,Informatique,8,9,QCU,34,23,17,6,1.48,73.91,17,17,51.18,Difficile,Difficile,Difficile / Difficile
4438,289,2020,Informatique,8,9,QCU,27,25,15,10,1.08,60.0,15,12,56.46,Difficile,Difficile,Difficile / Difficile
289,290,2015,Informatique,8,10,QO,23,16,5,11,1.44,31.25,5,18,22.64,Trop Difficile,Trop Difficile,Trop Difficile / Trop Difficile
1119,290,2016,Informatique,8,10,QO,23,13,6,7,1.77,46.15,6,17,28.1,Trop Difficile,Difficile,Trop Difficile / Difficile
1949,290,2017,Informatique,8,10,QO,28,27,1,26,1.04,3.7,1,27,2.38,Trop Difficile,Trop Difficile,Trop Difficile / Trop Difficile
2779,290,2018,Informatique,8,10,QO,32,16,14,2,2.0,87.5,14,18,45.16,Trop Difficile,Difficile,Trop Difficile / Difficile
3609,290,2019,Informatique,8,10,QO,37,25,4,21,1.48,16.0,4,33,12.03,Trop Difficile,Trop Difficile,Trop Difficile / Trop Difficile
4439,290,2020,Informatique,8,10,QO,34,30,4,26,1.13,13.33,4,30,11.21,Trop Difficile,Trop Difficile,Trop Difficile / Trop Difficile
290,291,2015,Informatique,8,11,QCM,5,4,3,1,1.25,75.0,3,2,64.22,Adapte,Adapte,Adapte / Adapte
1120,291,2016,Informatique,8,11,QCM,6,5,4,1,1.2,80.0,4,2,69.56,Adapte,Adapte,Adapte / Adapte
1950,291,2017,Informatique,8,11,QCM,7,6,4,2,1.17,66.67,4,3,62.81,Adapte,Adapte,Adapte / Adapte
2780,291,2018,Informatique,8,11,QCM,7,5,5,0,1.4,100.0,5,2,74.44,Adapte,Adapte,Adapte / Adapte
3610,291,2019,Informatique,8,11,QCM,7,6,5,1,1.17,83.33,5,2,64.95,Adapte,Adapte,Adapte / Adapte
4440,291,2020,Informatique,8,11,QCM,6,5,4,1,1.2,80.0,4,2,66.88,Adapte,Adapte,Adapte / Adapte
291,292,2015,Informatique,9,1,QCU,59,41,38,3,1.44,92.68,38,21,63.82,Difficile,Adapte,Difficile / Adapte
1121,292,2016,Informatique,9,1,QCU,64,61,43,18,1.05,70.49,43,21,67.02,Adapte,Adapte,Adapte / Adapte
1951,292,2017,Informatique,9,1,QCU,75,60,53,7,1.25,88.33,53,22,70.18,Adapte,Adapte,Adapte / Adapte
2781,292,2018,Informatique,9,1,QCU,70,56,46,10,1.25,82.14,46,24,65.34,Adapte,Adapte,Adapte / Adapte
3611,292,2019,Informatique,9,1,QCU,75,57,54,3,1.32,94.74,54,21,72.09,Adapte,Adapte,Adapte / Adapte
4441,292,2020,Informatique,9,1,QCU,84,77,56,21,1.09,72.73,56,28,66.87,Adapte,Adapte,Adapte / Adapte
292,293,2015,Informatique,9,2,QCU,5,3,1,2,1.67,33.33,1,4,25.28,Trop Difficile,Difficile,Trop Difficile / Difficile
1122,293,2016,Informatique,9,2,QCU,5,4,3,1,1.25,75.0,3,2,53.58,Difficile,Difficile,Difficile / Difficile
1952,293,2017,Informatique,9,2,QCU,5,4,3,1,1.25,75.0,3,2,60.5,Difficile,Adapte,Difficile / Adapte
2782,293,2018,Informatique,9,2,QCU,6,5,4,1,1.2,80.0,4,2,69.61,Adapte,Adapte,Adapte / Adapte
3612,293,2019,Informatique,9,2,QCU,7,4,4,0,1.75,100.0,4,3,63.49,Adapte,Adapte,Adapte / Adapte
4442,293,2020,Informatique,9,2,QCU,8,5,5,0,1.6,100.0,5,3,65.71,Adapte,Adapte,Adapte / Adapte
293,294,2015,Informatique,9,3,QCM,14,10,4,6,1.4,40.0,4,10,25.17,Difficile,Difficile,Difficile / Difficile
1123,294,2016,Informatique,9,3,QCM,15,6,5,1,2.5,83.33,5,10,35.9,Difficile,Difficile,Difficile / Difficile
1953,294,2017,Informatique,9,3,QCM,17,16,16,0,1.06,100.0,16,1,94.76,Difficile,Trop Facile,Difficile / Trop Facile
2783,294,2018,Informatique,9,3,QCM,18,11,5,6,1.64,45.45,5,13,25.97,Difficile,Difficile,Difficile / Difficile
3613,294,2019,Informatique,9,3,QCM,21,21,9,12,1.0,42.86,9,12,42.49,Difficile,Difficile,Difficile / Difficile
4443,294,2020,Informatique,9,3,QCM,23,15,13,2,1.53,86.67,13,10,57.06,Difficile,Difficile,Difficile / Difficile
294,295,2015,Informatique,9,4,QCM,16,15,14,1,1.07,93.33,14,2,88.09,Facile,Trop Facile,Facile / Trop Facile
1124,295,2016,Informatique,9,4,QCM,14,13,4,9,1.08,30.77,4,10,30.75,Difficile,Difficile,Difficile / Difficile
1954,295,2017,Informatique,9,4,QCM,16,15,12,3,1.07,80.0,12,4,72.65,Difficile,Adapte,Difficile / Adapte
2784,295,2018,Informatique,9,4,QCM,16,11,11,0,1.45,100.0,11,5,70.04,Adapte,Adapte,Adapte / Adapte
3614,295,2019,Informatique,9,4,QCM,18,15,13,2,1.2,86.67,13,5,73.4,Adapte,Adapte,Adapte / Adapte
4444,295,2020,Informatique,9,4,QCM,22,19,13,6,1.16,68.42,13,9,60.01,Adapte,Adapte,Adapte / Adapte
295,296,2015,Informatique,9,5,QCU,49,41,40,1,1.2,97.56,40,9,80.82,Facile,Facile,Facile / Facile
1125,296,2016,Informatique,9,5,QCU,57,55,41,14,1.04,74.55,41,16,72.61,Difficile,Adapte,Difficile / Adapte
1955,296,2017,Informatique,9,5,QCU,49,43,33,10,1.14,76.74,33,16,66.88,Adapte,Adapte,Adapte / Adapte
2785,296,2018,Informatique,9,5,QCU,52,46,36,10,1.13,78.26,36,16,69.08,Adapte,Adapte,Adapte / Adapte
3615,296,2019,Informatique,9,5,QCU,46,44,33,11,1.05,75.0,33,13,72.72,Adapte,Adapte,Adapte / Adapte
4445,296,2020,Informatique,9,5,QCU,41,36,30,6,1.14,83.33,30,11,73.09,Adapte,Adapte,Adapte / Adapte
296,297,2015,Informatique,9,6,QCU,77,63,57,6,1.22,90.48,57,20,74.51,Adapte,Adapte,Adapte / Adapte
1126,297,2016,Informatique,9,6,QCU,74,65,55,10,1.14,84.62,55,19,74.4,Adapte,Adapte,Adapte / Adapte
1956,297,2017,Informatique,9,6,QCU,78,75,52,23,1.04,69.33,52,26,67.05,Adapte,Adapte,Adapte / Adapte
2786,297,2018,Informatique,9,6,QCU,84,68,52,16,1.24,76.47,52,32,61.72,Adapte,Adapte,Adapte / Adapte
3616,297,2019,Informatique,9,6,QCU,78,64,54,10,1.22,84.38,54,24,69.17,Adapte,Adapte,Adapte / Adapte
4446,297,2020,Informatique,9,6,QCU,81,73,51,22,1.11,69.86,51,30,62.72,Adapte,Adapte,Adapte / Adapte
297,298,2015,Informatique,10,1,QCM,10,6,5,1,1.67,83.33,5,5,54.26,Difficile,Difficile,Difficile / Difficile
1127,298,2016,Informatique,10,1,QCM,12,4,4,0,3.0,100.0,4,8,29.21,Difficile,Difficile,Difficile / Difficile
1957,298,2017,Informatique,10,1,QCM,10,7,3,4,1.43,42.86,3,7,31.28,Difficile,Difficile,Difficile / Difficile
2787,298,2018,Informatique,10,1,QCM,12,6,3,3,2.0,50.0,3,9,28.81,Difficile,Difficile,Difficile / Difficile
3617,298,2019,Informatique,10,1,QCM,13,13,3,10,1.0,23.08,3,10,23.02,Difficile,Trop Difficile,Difficile / Trop Difficile
4447,298,2020,Informatique,10,1,QCM,13,12,12,0,1.08,100.0,12,1,94.93,Difficile,Trop Facile,Difficile / Trop Facile
298,299,2015,Informatique,10,2,QO,37,36,29,7,1.03,80.56,29,8,79.19,Difficile,Facile,Difficile / Facile
1128,299,2016,Informatique,10,2,QO,37,37,33,4,1.0,89.19,33,4,90.23,Trop Difficile,Trop Facile,Trop Difficile / Trop Facile
1958,299,2017,Informatique,10,2,QO,40,26,9,17,1.54,34.62,9,31,22.65,Trop Difficile,Trop Difficile,Trop Difficile / Trop Difficile
2788,299,2018,Informatique,10,2,QO,41,33,31,2,1.24,93.94,31,10,74.65,Trop Difficile,Adapte,Trop Difficile / Adapte
3618,299,2019,Informatique,10,2,QO,40,34,28,6,1.18,82.35,28,12,69.73,Adapte,Adapte,Adapte / Adapte
4448,299,2020,Informatique,10,2,QO,38,35,27,8,1.09,77.14,27,11,72.33,Adapte,Adapte,Adapte / Adapte
299,300,2015,Informatique,10,3,QCM,94,70,58,12,1.34,82.86,58,36,61.74,Trop Facile,Adapte,Trop Facile / Adapte
1129,300,2016,Informatique,10,3,QCM,99,75,70,5,1.32,93.33,70,29,70.33,Adapte,Adapte,Adapte / Adapte
1959,300,2017,Informatique,10,3,QCM,108,75,71,4,1.44,94.67,71,37,66.11,Adapte,Adapte,Adapte / Adapte
2789,300,2018,Informatique,10,3,QCM,97,76,71,5,1.28,93.42,71,26,72.95,Adapte,Adapte,Adapte / Adapte
3619,300,2019,Informatique,10,3,QCM,99,61,60,1,1.62,98.36,60,39,60.85,Adapte,Adapte,Adapte / Adapte
4449,300,2020,Informatique,10,3,QCM,96,85,64,21,1.13,75.29,64,32,66.29,Adapte,Adapte,Adapte / Adapte
300,301,2015,Informatique,10,4,QCM,63,57,56,1,1.11,98.25,56,7,88.96,Trop Facile,Trop Facile,Trop Facile / Trop Facile
1130,301,2016,Informatique,10,4,QCM,57,55,47,8,1.04,85.45,47,10,82.29,Difficile,Facile,Difficile / Facile
1960,301,2017,Informatique,10,4,QCM,50,30,3,27,1.67,10.0,3,47,6.17,Difficile,Trop Difficile,Difficile / Trop Difficile
2790,301,2018,Informatique,10,4,QCM,49,46,43,3,1.07,93.48,43,6,88.33,Difficile,Trop Facile,Difficile / Trop Facile
3620,301,2019,Informatique,10,4,QCM,56,28,15,13,2.0,53.57,15,41,26.47,Difficile,Difficile,Difficile / Difficile
4450,301,2020,Informatique,10,4,QCM,58,50,25,25,1.16,50.0,25,33,42.38,Difficile,Difficile,Difficile / Difficile
301,302,2015,Informatique,10,5,QCU,57,54,49,5,1.06,90.74,49,8,86.61,Trop Facile,Trop Facile,Trop Facile / Trop Facile
1131,302,2016,Informatique,10,5,QCU,64,27,21,6,2.37,77.78,21,43,32.19,Difficile,Difficile,Difficile / Difficile
1961,302,2017,Informatique,10,5,QCU,75,38,21,17,1.97,55.26,21,54,28.58,Difficile,Difficile,Difficile / Difficile
2791,302,2018,Informatique,10,5,QCU,87,42,41,1,2.07,97.62,41,46,47.09,Difficile,Difficile,Difficile / Difficile
3621,302,2019,Informatique,10,5,QCU,97,78,41,37,1.24,52.56,41,56,42.69,Difficile,Difficile,Difficile / Difficile
4451,302,2020,Informatique,10,5,QCU,83,50,27,23,1.66,54.0,27,56,32.14,Difficile,Difficile,Difficile / Difficile
302,303,2015,Informatique,10,6,QCM,48,45,33,12,1.07,73.33,33,15,68.41,Trop Facile,Adapte,Trop Facile / Adapte
1132,303,2016,Informatique,10,6,QCM,42,40,27,13,1.05,67.5,27,15,64.7,Adapte,Adapte,Adapte / Adapte
1962,303,2017,Informatique,10,6,QCM,34,33,21,12,1.03,63.64,21,13,62.47,Adapte,Adapte,Adapte / Adapte
2792,303,2018,Informatique,10,6,QCM,40,26,25,1,1.54,96.15,25,15,62.43,Adapte,Adapte,Adapte / Adapte
3622,303,2019,Informatique,10,6,QCM,38,37,24,13,1.03,64.86,24,14,62.53,Adapte,Adapte,Adapte / Adapte
4452,303,2020,Informatique,10,6,QCM,35,27,22,5,1.3,81.48,22,13,62.94,Adapte,Adapte,Adapte / Adapte
303,304,2015,Informatique,10,7,QCU,97,94,65,29,1.03,69.15,65,32,67.09,Adapte,Adapte,Adapte / Adapte
1133,304,2016,Informatique,10,7,QCU,86,86,60,26,1.0,69.77,60,26,69.9,Adapte,Adapte,Adapte / Adapte
1963,304,2017,Informatique,10,7,QCU,96,64,62,2,1.5,96.88,62,34,64.45,Adapte,Adapte,Adapte / Adapte
2793,304,2018,Informatique,10,7,QCU,101,90,66,24,1.12,73.33,66,35,65.09,Adapte,Adapte,Adapte / Adapte
3623,304,2019,Informatique,10,7,QCU,114,111,81,30,1.03,72.97,81,33,71.38,Adapte,Adapte,Adapte / Adapte
4453,304,2020,Informatique,10,7,QCU,125,98,93,5,1.28,94.9,93,32,74.33,Adapte,Adapte,Adapte / Adapte
304,305,2015,Informatique,10,8,QCU,70,67,58,9,1.04,86.57,58,12,82.15,Facile,Facile,Facile / Facile
1134,305,2016,Informatique,10,8,QCU,81,73,72,1,1.11,98.63,72,9,88.93,Difficile,Trop Facile,Difficile / Trop Facile
1964,305,2017,Informatique,10,8,QCU,86,47,36,11,1.83,76.6,36,50,41.67,Difficile,Difficile,Difficile / Difficile
2794,305,2018,Informatique,10,8,QCU,76,76,6,70,1.0,7.89,6,70,8.43,Difficile,Trop Difficile,Difficile / Trop Difficile
3624,305,2019,Informatique,10,8,QCU,68,52,37,15,1.31,71.15,37,31,54.02,Difficile,Difficile,Difficile / Difficile
4454,305,2020,Informatique,10,8,QCU,74,61,46,15,1.21,75.41,46,28,62.74,Difficile,Adapte,Difficile / Adapte
305,306,2015,Informatique,10,9,QCU,29,17,5,12,1.71,29.41,5,24,16.55,Difficile,Trop Difficile,Difficile / Trop Difficile
1135,306,2016,Informatique,10,9,QCU,35,35,20,15,1.0,57.14,20,15,56.65,Difficile,Difficile,Difficile / Difficile
1965,306,2017,Informatique,10,9,QCU,39,37,18,19,1.05,48.65,18,21,46.71,Difficile,Difficile,Difficile / Difficile
2795,306,2018,Informatique,10,9,QCU,32,30,18,12,1.07,60.0,18,14,54.87,Difficile,Difficile,Difficile / Difficile
3625,306,2019,Informatique,10,9,QCU,38,29,13,16,1.31,44.83,13,25,35.51,Difficile,Difficile,Difficile / Difficile
4455,306,2020,Informatique,10,9,QCU,42,17,14,3,2.47,82.35,14,28,33.38,Difficile,Difficile,Difficile / Difficile
306,307,2015,Informatique,10,10,QCU,96,82,76,6,1.17,92.68,76,20,79.46,Trop Difficile,Facile,Trop Difficile / Facile
1136,307,2016,Informatique,10,10,QCU,103,58,46,12,1.78,79.31,46,57,44.58,Difficile,Difficile,Difficile / Difficile
1966,307,2017,Informatique,10,10,QCU,90,53,23,30,1.7,43.4,23,67,25.95,Difficile,Difficile,Difficile / Difficile
2796,307,2018,Informatique,10,10,QCU,89,70,28,42,1.27,40.0,28,61,31.95,Difficile,Difficile,Difficile / Difficile
3626,307,2019,Informatique,10,10,QCU,94,73,29,44,1.29,39.73,29,65,31.29,Difficile,Difficile,Difficile / Difficile
4456,307,2020,Informatique,10,10,QCU,112,87,29,58,1.29,33.33,29,83,26.2,Difficile,Difficile,Difficile / Difficile
307,308,2015,Informatique,10,11,QROC,52,30,10,20,1.73,33.33,10,42,20.07,Trop Difficile,Trop Difficile,Trop Difficile / Trop Difficile
1137,308,2016,Informatique,10,11,QROC,58,52,43,9,1.12,82.69,43,15,74.46,Difficile,Adapte,Difficile / Adapte
1967,308,2017,Informatique,10,11,QROC,64,63,46,17,1.02,73.02,46,18,71.52,Adapte,Adapte,Adapte / Adapte
2797,308,2018,Informatique,10,11,QROC,69,55,47,8,1.25,85.45,47,22,68.54,Adapte,Adapte,Adapte / Adapte
3627,308,2019,Informatique,10,11,QROC,67,63,47,16,1.06,74.6,47,20,69.7,Adapte,Adapte,Adapte / Adapte
4457,308,2020,Informatique,10,11,QROC,68,67,47,20,1.01,70.15,47,21,69.31,Adapte,Adapte,Adapte / Adapte
308,309,2015,Informatique,11,1,QCM,66,57,52,5,1.16,91.23,52,14,78.93,Facile,Facile,Facile / Facile
1138,309,2016,Informatique,11,1,QCM,67,64,41,23,1.05,64.06,41,26,61.39,Difficile,Adapte,Difficile / Adapte
1968,309,2017,Informatique,11,1,QCM,60,49,42,7,1.22,85.71,42,18,69.94,Adapte,Adapte,Adapte / Adapte
2798,309,2018,Informatique,11,1,QCM,53,41,39,2,1.29,95.12,39,14,73.53,Adapte,Adapte,Adapte / Adapte
3628,309,2019,Informatique,11,1,QCM,50,49,34,15,1.02,69.39,34,16,68.15,Adapte,Adapte,Adapte / Adapte
4458,309,2020,Informatique,11,1,QCM,50,38,32,6,1.32,84.21,32,18,64.37,Adapte,Adapte,Adapte / Adapte
309,310,2015,Informatique,11,2,QROC,37,37,36,1,1.0,97.3,36,1,98.2,Trop Difficile,Trop Facile,Trop Difficile / Trop Facile
1139,310,2016,Informatique,11,2,QROC,41,20,11,9,2.05,55.0,11,30,27.44,Difficile,Difficile,Difficile / Difficile
1969,310,2017,Informatique,11,2,QROC,45,27,26,1,1.67,96.3,26,19,57.68,Difficile,Difficile,Difficile / Difficile
2799,310,2018,Informatique,11,2,QROC,41,29,14,15,1.41,48.28,14,27,33.93,Difficile,Difficile,Difficile / Difficile
3629,310,2019,Informatique,11,2,QROC,39,36,16,20,1.08,44.44,16,23,39.77,Difficile,Difficile,Difficile / Difficile
4459,310,2020,Informatique,11,2,QROC,45,38,18,20,1.18,47.37,18,27,39.5,Difficile,Difficile,Difficile / Difficile
310,311,2015,Informatique,11,3,QCU,76,71,69,2,1.07,97.18,69,7,91.32,Difficile,Trop Facile,Difficile / Trop Facile
1140,311,2016,Informatique,11,3,QCU,67,36,31,5,1.86,86.11,31,36,46.81,Difficile,Difficile,Difficile / Difficile
1970,311,2017,Informatique,11,3,QCU,78,67,54,13,1.16,80.6,54,24,68.86,Difficile,Adapte,Difficile / Adapte
2800,311,2018,Informatique,11,3,QCU,76,48,46,2,1.58,95.83,46,30,60.76,Adapte,Adapte,Adapte / Adapte
3630,311,2019,Informatique,11,3,QCU,67,53,41,12,1.26,77.36,41,26,61.66,Adapte,Adapte,Adapte / Adapte
4460,311,2020,Informatique,11,3,QCU,65,54,48,6,1.2,88.89,48,17,73.69,Adapte,Adapte,Adapte / Adapte
311,312,2015,Informatique,11,4,QCU,27,16,10,6,1.69,62.5,10,17,38.87,Difficile,Difficile,Difficile / Difficile
1141,312,2016,Informatique,11,4,QCU,24,23,19,4,1.04,82.61,19,5,79.94,Difficile,Facile,Difficile / Facile
1971,312,2017,Informatique,11,4,QCU,26,11,11,0,2.36,100.0,11,15,41.04,Difficile,Difficile,Difficile / Difficile
2801,312,2018,Informatique,11,4,QCU,22,21,14,7,1.05,66.67,14,8,65.14,Difficile,Adapte,Difficile / Adapte
3631,312,2019,Informatique,11,4,QCU,25,22,15,7,1.14,68.18,15,10,61.25,Adapte,Adapte,Adapte / Adapte
4461,312,2020,Informatique,11,4,QCU,29,23,20,3,1.26,86.96,20,9,70.55,Adapte,Adapte,Adapte / Adapte
312,313,2015,Informatique,11,5,QCU,8,7,7,0,1.14,100.0,7,1,84.38,Facile,Facile,Facile / Facile
1142,313,2016,Informatique,11,5,QCU,8,4,3,1,2.0,75.0,3,5,36.13,Difficile,Difficile,Difficile / Difficile
1972,313,2017,Informatique,11,5,QCU,6,4,3,1,1.5,75.0,3,3,52.51,Difficile,Difficile,Difficile / Difficile
2802,313,2018,Informatique,11,5,QCU,7,7,6,1,1.0,85.71,6,1,83.59,Difficile,Facile,Difficile / Facile
3632,313,2019,Informatique,11,5,QCU,7,7,3,4,1.0,42.86,3,4,38.86,Difficile,Difficile,Difficile / Difficile
4462,313,2020,Informatique,11,5,QCU,7,7,2,5,1.0,28.57,2,5,25.95,Difficile,Difficile,Difficile / Difficile
313,314,2015,Informatique,11,6,QROC,95,91,88,3,1.04,96.7,88,7,92.98,Trop Facile,Trop Facile,Trop Facile / Trop Facile
1143,314,2016,Informatique,11,6,QROC,93,91,30,61,1.02,32.97,30,63,32.11,Difficile,Difficile,Difficile / Difficile
1973,314,2017,Informatique,11,6,QROC,88,86,35,51,1.02,40.7,35,53,39.45,Difficile,Difficile,Difficile / Difficile
2803,314,2018,Informatique,11,6,QROC,77,69,61,8,1.12,88.41,61,16,78.61,Difficile,Facile,Difficile / Facile
3633,314,2019,Informatique,11,6,QROC,75,41,23,18,1.83,56.1,23,52,31.08,Difficile,Difficile,Difficile / Difficile
4463,314,2020,Informatique,11,6,QROC,79,79,71,8,1.0,89.87,71,8,89.32,Difficile,Trop Facile,Difficile / Trop Facile
314,315,2015,Informatique,12,1,QCU,52,33,10,23,1.58,30.3,10,42,19.22,Facile,Trop Difficile,Facile / Trop Difficile
1144,315,2016,Informatique,12,1,QCU,59,40,33,7,1.48,82.5,33,26,56.71,Difficile,Difficile,Difficile / Difficile
1974,315,2017,Informatique,12,1,QCU,65,54,28,26,1.2,51.85,28,37,42.54,Difficile,Difficile,Difficile / Difficile
2804,315,2018,Informatique,12,1,QCU,64,51,22,29,1.25,43.14,22,42,34.82,Difficile,Difficile,Difficile / Difficile
3634,315,2019,Informatique,12,1,QCU,67,38,26,12,1.76,68.42,26,41,38.59,Difficile,Difficile,Difficile / Difficile
4464,315,2020,Informatique,12,1,QCU,75,41,37,4,1.83,90.24,37,38,49.59,Difficile,Difficile,Difficile / Difficile
315,316,2015,Informatique,12,2,QO,92,46,29,17,2.0,63.04,29,63,31.52,Trop Difficile,Difficile,Trop Difficile / Difficile
1145,316,2016,Informatique,12,2,QO,75,55,44,11,1.36,80.0,44,31,58.34,Trop Difficile,Difficile,Trop Difficile / Difficile
1975,316,2017,Informatique,12,2,QO,81,59,2,57,1.37,3.39,2,79,2.29,Trop Difficile,Trop Difficile,Trop Difficile / Trop Difficile
2805,316,2018,Informatique,12,2,QO,73,56,3,53,1.3,5.36,3,70,3.51,Trop Difficile,Trop Difficile,Trop Difficile / Trop Difficile
3635,316,2019,Informatique,12,2,QO,67,60,46,14,1.12,76.67,46,21,67.96,Trop Difficile,Adapte,Trop Difficile / Adapte
4465,316,2020,Informatique,12,2,QO,54,47,40,7,1.15,85.11,40,14,74.71,Adapte,Adapte,Adapte / Adapte
316,317,2015,Informatique,13,1,QCM,69,48,7,41,1.44,14.58,7,62,10.82,Trop Difficile,Trop Difficile,Trop Difficile / Trop Difficile
1146,317,2016,Informatique,13,1,QCM,83,80,26,54,1.04,32.5,26,57,31.37,Difficile,Difficile,Difficile / Difficile
1976,317,2017,Informatique,13,1,QCM,93,36,2,34,2.58,5.56,2,91,1.68,Difficile,Trop Difficile,Difficile / Trop Difficile
2806,317,2018,Informatique,13,1,QCM,87,63,39,24,1.38,61.9,39,48,44.44,Difficile,Difficile,Difficile / Difficile
3636,317,2019,Informatique,13,1,QCM,73,63,59,4,1.16,93.65,59,14,80.6,Difficile,Facile,Difficile / Facile
4466,317,2020,Informatique,13,1,QCM,65,38,19,19,1.71,50.0,19,46,28.59,Difficile,Difficile,Difficile / Difficile
317,318,2015,Informatique,13,2,QCU,92,81,72,9,1.14,88.89,72,20,78.02,Facile,Facile,Facile / Facile
1147,318,2016,Informatique,13,2,QCU,96,87,48,39,1.1,55.17,48,48,49.59,Difficile,Difficile,Difficile / Difficile
1977,318,2017,Informatique,13,2,QCU,111,111,71,40,1.0,63.96,71,40,64.31,Difficile,Adapte,Difficile / Adapte
2807,318,2018,Informatique,13,2,QCU,128,107,81,26,1.2,75.7,81,47,63.63,Adapte,Adapte,Adapte / Adapte
3637,318,2019,Informatique,13,2,QCU,151,138,91,47,1.09,65.94,91,60,60.28,Adapte,Adapte,Adapte / Adapte
4467,318,2020,Informatique,13,2,QCU,128,96,81,15,1.33,84.38,81,47,62.93,Adapte,Adapte,Adapte / Adapte
318,319,2015,Informatique,13,3,QCU,99,82,80,2,1.21,97.56,80,19,81.31,Difficile,Facile,Difficile / Facile
1148,319,2016,Informatique,13,3,QCU,92,49,34,15,1.88,69.39,34,58,37.28,Difficile,Difficile,Difficile / Difficile
1978,319,2017,Informatique,13,3,QCU,83,75,42,33,1.11,56.0,42,41,50.97,Difficile,Difficile,Difficile / Difficile
2808,319,2018,Informatique,13,3,QCU,97,80,49,31,1.21,61.25,49,48,50.64,Difficile,Difficile,Difficile / Difficile
3638,319,2019,Informatique,13,3,QCU,96,95,91,4,1.01,95.79,91,5,94.9,Difficile,Trop Facile,Difficile / Trop Facile
4468,319,2020,Informatique,13,3,QCU,107,91,29,62,1.18,31.87,29,78,27.36,Difficile,Difficile,Difficile / Difficile
319,320,2015,Informatique,13,4,QCU,63,62,51,11,1.02,82.26,51,12,81.59,Difficile,Facile,Difficile / Facile
1149,320,2016,Informatique,13,4,QCU,67,58,33,25,1.16,56.9,33,34,48.62,Difficile,Difficile,Difficile / Difficile
1979,320,2017,Informatique,13,4,QCU,73,66,48,18,1.11,72.73,48,25,66.14,Difficile,Adapte,Difficile / Adapte
2809,320,2018,Informatique,13,4,QCU,69,55,44,11,1.25,80.0,44,25,63.77,Adapte,Adapte,Adapte / Adapte
3639,320,2019,Informatique,13,4,QCU,76,56,53,3,1.36,94.64,53,23,69.13,Adapte,Adapte,Adapte / Adapte
4469,320,2020,Informatique,13,4,QCU,77,63,56,7,1.22,88.89,56,21,72.61,Adapte,Adapte,Adapte / Adapte
320,321,2015,Informatique,13,5,QCU,27,26,22,4,1.04,84.62,22,5,79.69,Difficile,Facile,Difficile / Facile
1150,321,2016,Informatique,13,5,QCU,31,17,15,2,1.82,88.24,15,16,49.97,Difficile,Difficile,Difficile / Difficile
1980,321,2017,Informatique,13,5,QCU,31,29,26,3,1.07,89.66,26,5,83.12,Difficile,Facile,Difficile / Facile
2810,321,2018,Informatique,13,5,QCU,36,31,22,9,1.16,70.97,22,14,62.23,Difficile,Adapte,Difficile / Adapte
3640,321,2019,Informatique,13,5,QCU,34,31,25,6,1.1,80.65,25,9,72.13,Adapte,Adapte,Adapte / Adapte
4470,321,2020,Informatique,13,5,QCU,33,33,24,9,1.0,72.73,24,9,72.26,Adapte,Adapte,Adapte / Adapte
321,322,2015,Informatique,14,1,QCM,9,4,1,3,2.25,25.0,1,8,14.51,Trop Facile,Trop Difficile,Trop Facile / Trop Difficile
1151,322,2016,Informatique,14,1,QCM,10,4,1,3,2.5,25.0,1,9,14.74,Difficile,Trop Difficile,Difficile / Trop Difficile
1981,322,2017,Informatique,14,1,QCM,10,10,10,0,1.0,100.0,10,0,98.91,Difficile,Trop Facile,Difficile / Trop Facile
2811,322,2018,Informatique,14,1,QCM,12,4,3,1,3.0,75.0,3,9,25.56,Difficile,Difficile,Difficile / Difficile
3641,322,2019,Informatique,14,1,QCM,10,8,3,5,1.25,37.5,3,7,29.2,Difficile,Difficile,Difficile / Difficile
4471,322,2020,Informatique,14,1,QCM,10,8,7,1,1.25,87.5,7,3,65.56,Difficile,Adapte,Difficile / Adapte
322,323,2015,Informatique,14,2,QCU,10,5,4,1,2.0,80.0,4,6,36.89,Difficile,Difficile,Difficile / Difficile
1152,323,2016,Informatique,14,2,QCU,11,9,9,0,1.22,100.0,9,2,79.3,Difficile,Facile,Difficile / Facile
1982,323,2017,Informatique,14,2,QCU,9,7,4,3,1.29,57.14,4,5,48.25,Difficile,Difficile,Difficile / Difficile
2812,323,2018,Informatique,14,2,QCU,8,8,4,4,1.0,50.0,4,4,49.18,Difficile,Difficile,Difficile / Difficile
3642,323,2019,Informatique,14,2,QCU,10,6,5,1,1.67,83.33,5,5,51.8,Difficile,Difficile,Difficile / Difficile
4472,323,2020,Informatique,14,2,QCU,11,9,3,6,1.22,33.33,3,8,25.48,Difficile,Difficile,Difficile / Difficile
323,324,2015,Informatique,14,3,QCM,23,21,18,3,1.1,85.71,18,5,77.49,Trop Difficile,Facile,Trop Difficile / Facile
1153,324,2016,Informatique,14,3,QCM,25,19,6,13,1.32,31.58,6,19,22.37,Difficile,Trop Difficile,Difficile / Trop Difficile
1983,324,2017,Informatique,14,3,QCM,29,29,25,4,1.0,86.21,25,4,87.35,Difficile,Trop Facile,Difficile / Trop Facile
2813,324,2018,Informatique,14,3,QCM,24,24,14,10,1.0,58.33,14,10,58.07,Difficile,Difficile,Difficile / Difficile
3643,324,2019,Informatique,14,3,QCM,19,10,8,2,1.9,80.0,8,11,40.24,Difficile,Difficile,Difficile / Difficile
4473,324,2020,Informatique,14,3,QCM,15,13,13,0,1.15,100.0,13,2,84.9,Difficile,Facile,Difficile / Facile
324,325,2015,Informatique,14,4,QCM,53,37,31,6,1.43,83.78,31,22,57.73,Facile,Difficile,Facile / Difficile
1154,325,2016,Informatique,14,4,QCM,63,31,16,15,2.03,51.61,16,47,25.1,Difficile,Difficile,Difficile / Difficile
1984,325,2017,Informatique,14,4,QCM,57,37,12,25,1.54,32.43,12,45,21.34,Difficile,Trop Difficile,Difficile / Trop Difficile
2814,325,2018,Informatique,14,4,QCM,48,25,17,8,1.92,68.0,17,31,35.87,Difficile,Difficile,Difficile / Difficile
3644,325,2019,Informatique,14,4,QCM,53,49,18,31,1.08,36.73,18,35,34.77,Difficile,Difficile,Difficile / Difficile
4474,325,2020,Informatique,14,4,QCM,57,27,18,9,2.11,66.67,18,39,32.19,Difficile,Difficile,Difficile / Difficile
325,326,2015,Informatique,14,5,QCU,49,27,14,13,1.81,51.85,14,35,27.66,Difficile,Difficile,Difficile / Difficile
1155,326,2016,Informatique,14,5,QCU,58,58,55,3,1.0,94.83,55,3,95.62,Difficile,Trop Facile,Difficile / Trop Facile
1985,326,2017,Informatique,14,5,QCU,50,19,16,3,2.63,84.21,16,34,31.98,Difficile,Difficile,Difficile / Difficile
2815,326,2018,Informatique,14,5,QCU,43,26,23,3,1.65,88.46,23,20,54.03,Difficile,Difficile,Difficile / Difficile
3645,326,2019,Informatique,14,5,QCU,45,36,0,36,1.25,0.0,0,45,0.87,Difficile,Trop Difficile,Difficile / Trop Difficile
4475,326,2020,Informatique,14,5,QCU,39,28,21,7,1.39,75.0,21,18,53.79,Difficile,Difficile,Difficile / Difficile
326,327,2015,Informatique,14,6,QCM,96,95,66,29,1.01,69.47,66,30,68.9,Facile,Adapte,Facile / Adapte
1156,327,2016,Informatique,14,6,QCM,89,58,54,4,1.53,93.1,54,35,60.87,Adapte,Adapte,Adapte / Adapte
1986,327,2017,Informatique,14,6,QCM,84,68,58,10,1.24,85.29,58,26,68.57,Adapte,Adapte,Adapte / Adapte
2816,327,2018,Informatique,14,6,QCM,89,80,64,16,1.11,80.0,64,25,71.54,Adapte,Adapte,Adapte / Adapte
3646,327,2019,Informatique,14,6,QCM,105,71,71,0,1.48,100.0,71,34,67.48,Adapte,Adapte,Adapte / Adapte
4476,327,2020,Informatique,14,6,QCM,84,61,54,7,1.38,88.52,54,30,63.86,Adapte,Adapte,Adapte / Adapte
327,328,2015,Informatique,14,7,QCM,53,39,39,0,1.36,100.0,39,14,73.78,Adapte,Adapte,Adapte / Adapte
1157,328,2016,Informatique,14,7,QCM,60,47,44,3,1.28,93.62,44,16,73.58,Adapte,Adapte,Adapte / Adapte
1987,328,2017,Informatique,14,7,QCM,71,55,48,7,1.29,87.27,48,23,67.7,Adapte,Adapte,Adapte / Adapte
2817,328,2018,Informatique,14,7,QCM,82,53,53,0,1.55,100.0,53,29,64.26,Adapte,Adapte,Adapte / Adapte
3647,328,2019,Informatique,14,7,QCM,81,73,56,17,1.11,76.71,56,25,68.85,Adapte,Adapte,Adapte / Adapte
4477,328,2020,Informatique,14,7,QCM,85,66,59,7,1.29,89.39,59,26,69.59,Adapte,Adapte,Adapte / Adapte
328,329,2015,Informatique,14,8,QCU,77,45,42,3,1.71,93.33,42,35,54.82,Difficile,Difficile,Difficile / Difficile
1158,329,2016,Informatique,14,8,QCU,63,52,27,25,1.21,51.92,27,36,42.4,Difficile,Difficile,Difficile / Difficile
1988,329,2017,Informatique,14,8,QCU,72,71,69,2,1.01,97.18,69,3,95.4,Difficile,Trop Facile,Difficile / Trop Facile
2818,329,2018,Informatique,14,8,QCU,70,40,21,19,1.75,52.5,21,49,29.73,Difficile,Difficile,Difficile / Difficile
3648,329,2019,Informatique,14,8,QCU,66,62,48,14,1.06,77.42,48,18,72.27,Difficile,Adapte,Difficile / Adapte
4478,329,2020,Informatique,14,8,QCU,79,52,48,4,1.52,92.31,48,31,60.38,Adapte,Adapte,Adapte / Adapte
329,330,2015,Informatique,14,9,QROC,73,46,32,14,1.59,69.57,32,41,43.21,Difficile,Difficile,Difficile / Difficile
1159,330,2016,Informatique,14,9,QROC,64,56,51,5,1.14,91.07,51,13,80.24,Difficile,Facile,Difficile / Facile
1989,330,2017,Informatique,14,9,QROC,57,57,32,25,1.0,56.14,32,25,56.89,Difficile,Difficile,Difficile / Difficile
2819,330,2018,Informatique,14,9,QROC,67,32,28,4,2.09,87.5,28,39,42.53,Difficile,Difficile,Difficile / Difficile
3649,330,2019,Informatique,14,9,QROC,58,53,52,1,1.09,98.11,52,6,90.4,Difficile,Trop Facile,Difficile / Trop Facile
4479,330,2020,Informatique,14,9,QROC,53,24,19,5,2.21,79.17,19,34,35.27,Difficile,Difficile,Difficile / Difficile
330,331,2015,Informatique,14,10,QCM,95,80,66,14,1.19,82.5,66,29,69.37,Trop Facile,Adapte,Trop Facile / Adapte
1160,331,2016,Informatique,14,10,QCM,88,77,63,14,1.14,81.82,63,25,72.1,Adapte,Adapte,Adapte / Adapte
1990,331,2017,Informatique,14,10,QCM,77,74,57,17,1.04,77.03,57,20,73.54,Adapte,Adapte,Adapte / Adapte
2820,331,2018,Informatique,14,10,QCM,77,69,52,17,1.12,75.36,52,25,67.6,Adapte,Adapte,Adapte / Adapte
3650,331,2019,Informatique,14,10,QCM,78,71,54,17,1.1,76.06,54,24,69.29,Adapte,Adapte,Adapte / Adapte
4480,331,2020,Informatique,14,10,QCM,76,54,53,1,1.41,98.15,53,23,70.38,Adapte,Adapte,Adapte / Adapte
331,332,2015,Informatique,14,11,QCU,35,25,15,10,1.4,60.0,15,20,43.35,Difficile,Difficile,Difficile / Difficile
1161,332,2016,Informatique,14,11,QCU,42,22,17,5,1.91,77.27,17,25,39.82,Difficile,Difficile,Difficile / Difficile
1991,332,2017,Informatique,14,11,QCU,49,44,17,27,1.11,38.64,17,32,35.5,Difficile,Difficile,Difficile / Difficile
2821,332,2018,Informatique,14,11,QCU,52,38,28,10,1.37,73.68,28,24,54.48,Difficile,Difficile,Difficile / Difficile
3651,332,2019,Informatique,14,11,QCU,45,33,0,33,1.36,0.0,0,45,0.45,Difficile,Trop Difficile,Difficile / Trop Difficile
4481,332,2020,Informatique,14,11,QCU,39,19,15,4,2.05,78.95,15,24,39.5,Difficile,Difficile,Difficile / Difficile
332,333,2015,Informatique,15,1,QROC,70,63,13,50,1.11,20.63,13,57,18.45,Trop Facile,Trop Difficile,Trop Facile / Trop Difficile
1162,333,2016,Informatique,15,1,QROC,84,53,2,51,1.58,3.77,2,82,2.92,Difficile,Trop Difficile,Difficile / Trop Difficile
1992,333,2017,Informatique,15,1,QROC,80,70,29,41,1.14,41.43,29,51,35.97,Difficile,Difficile,Difficile / Difficile
2822,333,2018,Informatique,15,1,QROC,92,75,48,27,1.23,64.0,48,44,51.8,Difficile,Difficile,Difficile / Difficile
3652,333,2019,Informatique,15,1,QROC,83,51,25,26,1.63,49.02,25,58,30.15,Difficile,Difficile,Difficile / Difficile
4482,333,2020,Informatique,15,1,QROC,100,86,47,39,1.16,54.65,47,53,47.18,Difficile,Difficile,Difficile / Difficile
333,334,2015,Informatique,15,2,QCU,14,13,12,1,1.08,92.31,12,2,84.9,Trop Difficile,Facile,Trop Difficile / Facile
1163,334,2016,Informatique,15,2,QCU,17,7,6,1,2.43,85.71,6,11,32.57,Difficile,Difficile,Difficile / Difficile
1993,334,2017,Informatique,15,2,QCU,19,16,13,3,1.19,81.25,13,6,68.74,Difficile,Adapte,Difficile / Adapte
2823,334,2018,Informatique,15,2,QCU,18,14,11,3,1.29,78.57,11,7,61.01,Adapte,Adapte,Adapte / Adapte
3653,334,2019,Informatique,15,2,QCU,18,17,13,4,1.06,76.47,13,5,73.01,Adapte,Adapte,Adapte / Adapte
4483,334,2020,Informatique,15,2,QCU,22,21,16,5,1.05,76.19,16,6,72.56,Adapte,Adapte,Adapte / Adapte
334,335,2015,Informatique,15,3,QCM,58,51,48,3,1.14,94.12,48,10,82.15,Facile,Facile,Facile / Facile
1164,335,2016,Informatique,15,3,QCM,62,42,29,13,1.48,69.05,29,33,46.32,Difficile,Difficile,Difficile / Difficile
1994,335,2017,Informatique,15,3,QCM,59,46,34,12,1.28,73.91,34,25,57.46,Difficile,Difficile,Difficile / Difficile
2824,335,2018,Informatique,15,3,QCM,52,26,19,7,2.0,73.08,19,33,35.63,Difficile,Difficile,Difficile / Difficile
3654,335,2019,Informatique,15,3,QCM,46,34,12,22,1.35,35.29,12,34,25.22,Difficile,Difficile,Difficile / Difficile
4484,335,2020,Informatique,15,3,QCM,48,46,21,25,1.04,45.65,21,27,42.75,Difficile,Difficile,Difficile / Difficile
335,336,2015,Informatique,16,1,QCU,93,84,82,2,1.11,97.62,82,11,88.14,Trop Difficile,Trop Facile,Trop Difficile / Trop Facile
1165,336,2016,Informatique,16,1,QCU,101,69,10,59,1.46,14.49,10,91,9.87,Difficile,Trop Difficile,Difficile / Trop Difficile
1995,336,2017,Informatique,16,1,QCU,100,94,93,1,1.06,98.94,93,7,93.28,Difficile,Trop Facile,Difficile / Trop Facile
2825,336,2018,Informatique,16,1,QCU,91,72,38,34,1.26,52.78,38,53,41.68,Difficile,Difficile,Difficile / Difficile
3655,336,2019,Informatique,16,1,QCU,76,63,25,38,1.21,39.68,25,51,32.5,Difficile,Difficile,Difficile / Difficile
4485,336,2020,Informatique,16,1,QCU,75,73,36,37,1.03,49.32,36,39,48.49,Difficile,Difficile,Difficile / Difficile
336,337,2015,Informatique,16,2,QCU,53,48,48,0,1.1,100.0,48,5,90.9,Facile,Trop Facile,Facile / Trop Facile
1166,337,2016,Informatique,16,2,QCU,60,55,33,22,1.09,60.0,33,27,55.74,Difficile,Difficile,Difficile / Difficile
1996,337,2017,Informatique,16,2,QCU,68,58,12,46,1.17,20.69,12,56,17.83,Difficile,Trop Difficile,Difficile / Trop Difficile
2826,337,2018,Informatique,16,2,QCU,75,53,29,24,1.42,54.72,29,46,38.84,Difficile,Difficile,Difficile / Difficile
3656,337,2019,Informatique,16,2,QCU,60,50,17,33,1.2,34.0,17,43,28.49,Difficile,Difficile,Difficile / Difficile
4486,337,2020,Informatique,16,2,QCU,62,59,43,16,1.05,72.88,43,19,69.16,Difficile,Adapte,Difficile / Adapte
337,338,2015,Informatique,17,1,QCU,20,18,17,1,1.11,94.44,17,3,82.7,Trop Difficile,Facile,Trop Difficile / Facile
1167,338,2016,Informatique,17,1,QCU,22,12,8,4,1.83,66.67,8,14,38.14,Difficile,Difficile,Difficile / Difficile
1997,338,2017,Informatique,17,1,QCU,26,14,9,5,1.86,64.29,9,17,32.97,Difficile,Difficile,Difficile / Difficile
2827,338,2018,Informatique,17,1,QCU,28,21,15,6,1.33,71.43,15,13,52.3,Difficile,Difficile,Difficile / Difficile
3657,338,2019,Informatique,17,1,QCU,29,27,26,1,1.07,96.3,26,3,90.07,Difficile,Trop Facile,Difficile / Trop Facile
4487,338,2020,Informatique,17,1,QCU,26,18,10,8,1.44,55.56,10,16,37.02,Difficile,Difficile,Difficile / Difficile
338,339,2015,Informatique,17,2,QCU,18,15,14,1,1.2,93.33,14,4,77.16,Facile,Facile,Facile / Facile
1168,339,2016,Informatique,17,2,QCU,15,13,12,1,1.15,92.31,12,3,83.2,Difficile,Facile,Difficile / Facile
1998,339,2017,Informatique,17,2,QCU,12,11,10,1,1.09,90.91,10,2,84.15,Difficile,Facile,Difficile / Facile
2828,339,2018,Informatique,17,2,QCU,14,13,4,9,1.08,30.77,4,10,25.53,Difficile,Difficile,Difficile / Difficile
3658,339,2019,Informatique,17,2,QCU,15,12,4,8,1.25,33.33,4,11,25.74,Difficile,Difficile,Difficile / Difficile
4488,339,2020,Informatique,17,2,QCU,15,12,8,4,1.25,66.67,8,7,50.64,Difficile,Difficile,Difficile / Difficile
339,340,2015,Informatique,18,1,QCU,10,8,4,4,1.25,50.0,4,6,42.82,Adapte,Difficile,Adapte / Difficile
1169,340,2016,Informatique,18,1,QCU,10,7,4,3,1.43,57.14,4,6,39.73,Difficile,Difficile,Difficile / Difficile
1999,340,2017,Informatique,18,1,QCU,12,11,11,0,1.09,100.0,11,1,89.99,Difficile,Trop Facile,Difficile / Trop Facile
2829,340,2018,Informatique,18,1,QCU,12,11,3,8,1.09,27.27,3,9,26.56,Difficile,Difficile,Difficile / Difficile
3659,340,2019,Informatique,18,1,QCU,10,5,4,1,2.0,80.0,4,6,39.2,Difficile,Difficile,Difficile / Difficile
4489,340,2020,Informatique,18,1,QCU,11,6,2,4,1.83,33.33,2,9,18.84,Difficile,Trop Difficile,Difficile / Trop Difficile
340,341,2015,Art,1,1,QCU,48,46,36,10,1.04,78.26,36,12,74.8,Trop Facile,Adapte,Trop Facile / Adapte
1170,341,2016,Art,1,1,QCU,55,51,36,15,1.08,70.59,36,19,64.73,Adapte,Adapte,Adapte / Adapte
2000,341,2017,Art,1,1,QCU,57,42,38,4,1.36,90.48,38,19,66.81,Adapte,Adapte,Adapte / Adapte
2830,341,2018,Art,1,1,QCU,61,42,38,4,1.45,90.48,38,23,61.65,Adapte,Adapte,Adapte / Adapte
3660,341,2019,Art,1,1,QCU,50,38,33,5,1.32,86.84,33,17,65.47,Adapte,Adapte,Adapte / Adapte
4490,341,2020,Art,1,1,QCU,58,49,35,14,1.18,71.43,35,23,60.43,Adapte,Adapte,Adapte / Adapte
341,342,2015,Art,1,2,QCU,13,5,2,3,2.6,40.0,2,11,14.51,Trop Facile,Trop Difficile,Trop Facile / Trop Difficile
1171,342,2016,Art,1,2,QCU,15,12,7,5,1.25,58.33,7,8,44.05,Difficile,Difficile,Difficile / Difficile
2001,342,2017,Art,1,2,QCU,16,8,6,2,2.0,75.0,6,10,34.5,Difficile,Difficile,Difficile / Difficile
2831,342,2018,Art,1,2,QCU,18,11,9,2,1.64,81.82,9,9,49.0,Difficile,Difficile,Difficile / Difficile
3661,342,2019,Art,1,2,QCU,14,9,3,6,1.56,33.33,3,11,17.99,Difficile,Trop Difficile,Difficile / Trop Difficile
4491,342,2020,Art,1,2,QCU,15,15,11,4,1.0,73.33,11,4,70.79,Difficile,Adapte,Difficile / Adapte
342,343,2015,Art,1,3,QCU,26,25,23,2,1.04,92.0,23,3,88.06,Trop Facile,Trop Facile,Trop Facile / Trop Facile
1172,343,2016,Art,1,3,QCU,31,25,11,14,1.24,44.0,11,20,36.96,Difficile,Difficile,Difficile / Difficile
2002,343,2017,Art,1,3,QCU,28,26,12,14,1.08,46.15,12,16,41.91,Difficile,Difficile,Difficile / Difficile
2832,343,2018,Art,1,3,QCU,23,19,8,11,1.21,42.11,8,15,35.89,Difficile,Difficile,Difficile / Difficile
3662,343,2019,Art,1,3,QCU,19,14,10,4,1.36,71.43,10,9,51.78,Difficile,Difficile,Difficile / Difficile
4492,343,2020,Art,1,3,QCU,19,19,19,0,1.0,100.0,19,0,98.96,Difficile,Trop Facile,Difficile / Trop Facile
343,344,2015,Art,1,4,QCM,41,40,32,8,1.02,80.0,32,9,77.1,Facile,Facile,Facile / Facile
1173,344,2016,Art,1,4,QCM,36,25,20,5,1.44,80.0,20,16,56.49,Difficile,Difficile,Difficile / Difficile
2003,344,2017,Art,1,4,QCM,37,36,31,5,1.03,86.11,31,6,83.13,Difficile,Facile,Difficile / Facile
2833,344,2018,Art,1,4,QCM,41,36,19,17,1.14,52.78,19,22,46.49,Difficile,Difficile,Difficile / Difficile
3663,344,2019,Art,1,4,QCM,48,39,13,26,1.23,33.33,13,35,26.84,Difficile,Difficile,Difficile / Difficile
4493,344,2020,Art,1,4,QCM,45,34,13,21,1.32,38.24,13,32,29.93,Difficile,Difficile,Difficile / Difficile
344,345,2015,Art,1,5,QCU,60,50,50,0,1.2,100.0,50,10,84.01,Trop Facile,Facile,Trop Facile / Facile
1174,345,2016,Art,1,5,QCU,71,54,40,14,1.31,74.07,40,31,56.89,Difficile,Difficile,Difficile / Difficile
2004,345,2017,Art,1,5,QCU,71,42,41,1,1.69,97.62,41,30,57.18,Difficile,Difficile,Difficile / Difficile
2834,345,2018,Art,1,5,QCU,75,70,37,33,1.07,52.86,37,38,49.77,Difficile,Difficile,Difficile / Difficile
3664,345,2019,Art,1,5,QCU,61,25,25,0,2.44,100.0,25,36,40.7,Difficile,Difficile,Difficile / Difficile
4494,345,2020,Art,1,5,QCU,52,30,15,15,1.73,50.0,15,37,28.88,Difficile,Difficile,Difficile / Difficile
345,346,2015,Art,1,6,QCU,15,14,14,0,1.07,100.0,14,1,90.47,Trop Facile,Trop Facile,Trop Facile / Trop Facile
1175,346,2016,Art,1,6,QCU,12,8,5,3,1.5,62.5,5,7,37.65,Difficile,Difficile,Difficile / Difficile
2005,346,2017,Art,1,6,QCU,13,8,2,6,1.62,25.0,2,11,18.85,Difficile,Trop Difficile,Difficile / Trop Difficile
2835,346,2018,Art,1,6,QCU,11,10,6,4,1.1,60.0,6,5,54.17,Difficile,Difficile,Difficile / Difficile
3665,346,2019,Art,1,6,QCU,10,5,3,2,2.0,60.0,3,7,25.06,Difficile,Difficile,Difficile / Difficile
4495,346,2020,Art,1,6,QCU,12,10,5,5,1.2,50.0,5,7,41.4,Difficile,Difficile,Difficile / Difficile
346,347,2015,Art,1,7,QCU,48,47,39,8,1.02,82.98,39,9,80.37,Facile,Facile,Facile / Facile
1176,347,2016,Art,1,7,QCU,53,52,43,9,1.02,82.69,43,10,81.05,Difficile,Facile,Difficile / Facile
2006,347,2017,Art,1,7,QCU,48,41,17,24,1.17,41.46,17,31,36.38,Difficile,Difficile,Difficile / Difficile
2836,347,2018,Art,1,7,QCU,49,49,33,16,1.0,67.35,33,16,67.3,Difficile,Adapte,Difficile / Adapte
3666,347,2019,Art,1,7,QCU,55,40,38,2,1.38,95.0,38,17,69.12,Adapte,Adapte,Adapte / Adapte
4496,347,2020,Art,1,7,QCU,66,62,46,16,1.06,74.19,46,20,70.17,Adapte,Adapte,Adapte / Adapte
347,348,2015,Art,1,8,QCU,95,86,82,4,1.1,95.35,82,13,86.46,Trop Facile,Trop Facile,Trop Facile / Trop Facile
1177,348,2016,Art,1,8,QCU,80,80,59,21,1.0,73.75,59,21,73.21,Difficile,Adapte,Difficile / Adapte
2007,348,2017,Art,1,8,QCU,93,72,63,9,1.29,87.5,63,30,67.36,Adapte,Adapte,Adapte / Adapte
2837,348,2018,Art,1,8,QCU,100,97,62,35,1.03,63.92,62,38,61.52,Adapte,Adapte,Adapte / Adapte
3667,348,2019,Art,1,8,QCU,103,91,68,23,1.13,74.73,68,35,65.95,Adapte,Adapte,Adapte / Adapte
4497,348,2020,Art,1,8,QCU,123,104,87,17,1.18,83.65,87,36,71.12,Adapte,Adapte,Adapte / Adapte
348,349,2015,Art,2,1,QCM,74,72,71,1,1.03,98.61,71,3,96.5,Facile,Trop Facile,Facile / Trop Facile
1178,349,2016,Art,2,1,QCM,59,55,34,21,1.07,61.82,34,25,57.19,Difficile,Difficile,Difficile / Difficile
2008,349,2017,Art,2,1,QCM,57,46,33,13,1.24,71.74,33,24,58.14,Difficile,Difficile,Difficile / Difficile
2838,349,2018,Art,2,1,QCM,68,28,26,2,2.43,92.86,26,42,37.93,Difficile,Difficile,Difficile / Difficile
3668,349,2019,Art,2,1,QCM,62,54,23,31,1.15,42.59,23,39,37.9,Difficile,Difficile,Difficile / Difficile
4498,349,2020,Art,2,1,QCM,58,27,23,4,2.15,85.19,23,35,40.2,Difficile,Difficile,Difficile / Difficile
349,350,2015,Art,2,2,QCU,84,80,71,9,1.05,88.75,71,13,83.96,Facile,Facile,Facile / Facile
1179,350,2016,Art,2,2,QCU,71,69,26,43,1.03,37.68,26,45,36.62,Difficile,Difficile,Difficile / Difficile
2009,350,2017,Art,2,2,QCU,66,63,20,43,1.05,31.75,20,46,30.41,Difficile,Difficile,Difficile / Difficile
2839,350,2018,Art,2,2,QCU,67,53,39,14,1.26,73.58,39,28,57.98,Difficile,Difficile,Difficile / Difficile
3669,350,2019,Art,2,2,QCU,77,73,65,8,1.05,89.04,65,12,84.41,Difficile,Facile,Difficile / Facile
4499,350,2020,Art,2,2,QCU,78,56,28,28,1.39,50.0,28,50,36.36,Difficile,Difficile,Difficile / Difficile
350,351,2015,Art,2,3,QCM,44,14,6,8,3.14,42.86,6,38,14.24,Difficile,Trop Difficile,Difficile / Trop Difficile
1180,351,2016,Art,2,3,QCM,45,44,42,2,1.02,95.45,42,3,92.68,Difficile,Trop Facile,Difficile / Trop Facile
2010,351,2017,Art,2,3,QCM,38,29,19,10,1.31,65.52,19,19,50.82,Difficile,Difficile,Difficile / Difficile
2840,351,2018,Art,2,3,QCM,32,17,14,3,1.88,82.35,14,18,44.64,Difficile,Difficile,Difficile / Difficile
3670,351,2019,Art,2,3,QCM,30,19,11,8,1.58,57.89,11,19,35.95,Difficile,Difficile,Difficile / Difficile
4500,351,2020,Art,2,3,QCM,28,22,6,16,1.27,27.27,6,22,21.42,Difficile,Trop Difficile,Difficile / Trop Difficile
351,352,2015,Art,2,4,QCM,40,40,39,1,1.0,97.5,39,1,96.97,Trop Facile,Trop Facile,Trop Facile / Trop Facile
1181,352,2016,Art,2,4,QCM,33,31,27,4,1.06,87.1,27,6,82.12,Difficile,Facile,Difficile / Facile
2011,352,2017,Art,2,4,QCM,32,17,11,6,1.88,64.71,11,21,34.64,Difficile,Difficile,Difficile / Difficile
2841,352,2018,Art,2,4,QCM,28,21,13,8,1.33,61.9,13,15,48.2,Difficile,Difficile,Difficile / Difficile
3671,352,2019,Art,2,4,QCM,34,23,18,5,1.48,78.26,18,16,54.18,Difficile,Difficile,Difficile / Difficile
4501,352,2020,Art,2,4,QCM,31,26,24,2,1.19,92.31,24,7,77.3,Difficile,Facile,Difficile / Facile
352,353,2015,Art,2,5,QROC,85,57,46,11,1.49,80.7,46,39,54.22,Difficile,Difficile,Difficile / Difficile
1182,353,2016,Art,2,5,QROC,83,70,39,31,1.19,55.71,39,44,47.18,Difficile,Difficile,Difficile / Difficile
2012,353,2017,Art,2,5,QROC,100,95,35,60,1.05,36.84,35,65,35.02,Difficile,Difficile,Difficile / Difficile
2842,353,2018,Art,2,5,QROC,89,81,28,53,1.1,34.57,28,61,31.6,Difficile,Difficile,Difficile / Difficile
3672,353,2019,Art,2,5,QROC,75,61,11,50,1.23,18.03,11,64,14.14,Difficile,Trop Difficile,Difficile / Trop Difficile
4502,353,2020,Art,2,5,QROC,78,34,28,6,2.29,82.35,28,50,36.07,Difficile,Difficile,Difficile / Difficile
353,354,2015,Art,2,6,QROC,53,40,18,22,1.32,45.0,18,35,33.09,Difficile,Difficile,Difficile / Difficile
1183,354,2016,Art,2,6,QROC,63,28,28,0,2.25,100.0,28,35,44.83,Difficile,Difficile,Difficile / Difficile
2013,354,2017,Art,2,6,QROC,59,53,21,32,1.11,39.62,21,38,35.32,Difficile,Difficile,Difficile / Difficile
2843,354,2018,Art,2,6,QROC,48,47,35,12,1.02,74.47,35,13,72.38,Difficile,Adapte,Difficile / Adapte
3673,354,2019,Art,2,6,QROC,41,27,26,1,1.52,96.3,26,15,63.21,Adapte,Adapte,Adapte / Adapte
4503,354,2020,Art,2,6,QROC,39,37,26,11,1.05,70.27,26,13,66.47,Adapte,Adapte,Adapte / Adapte
354,355,2015,Art,2,7,QCM,65,60,50,10,1.08,83.33,50,15,77.03,Facile,Facile,Facile / Facile
1184,355,2016,Art,2,7,QCM,78,45,30,15,1.73,66.67,30,48,38.78,Difficile,Difficile,Difficile / Difficile
2014,355,2017,Art,2,7,QCM,73,52,31,21,1.4,59.62,31,42,42.12,Difficile,Difficile,Difficile / Difficile
2844,355,2018,Art,2,7,QCM,60,58,55,3,1.03,94.83,55,5,91.42,Difficile,Trop Facile,Difficile / Trop Facile
3674,355,2019,Art,2,7,QCM,50,48,27,21,1.04,56.25,27,23,53.56,Difficile,Difficile,Difficile / Difficile
4504,355,2020,Art,2,7,QCM,48,25,15,10,1.92,60.0,15,33,30.66,Difficile,Difficile,Difficile / Difficile
355,356,2015,Art,2,8,QCU,44,20,4,16,2.2,20.0,4,40,9.86,Adapte,Trop Difficile,Adapte / Trop Difficile
1185,356,2016,Art,2,8,QCU,36,24,1,23,1.5,4.17,1,35,1.76,Difficile,Trop Difficile,Difficile / Trop Difficile
2015,356,2017,Art,2,8,QCU,40,32,18,14,1.25,56.25,18,22,44.01,Difficile,Difficile,Difficile / Difficile
2845,356,2018,Art,2,8,QCU,44,20,18,2,2.2,90.0,18,26,39.99,Difficile,Difficile,Difficile / Difficile
3675,356,2019,Art,2,8,QCU,35,18,13,5,1.94,72.22,13,22,37.54,Difficile,Difficile,Difficile / Difficile
4505,356,2020,Art,2,8,QCU,36,32,19,13,1.12,59.38,19,17,51.69,Difficile,Difficile,Difficile / Difficile
356,357,2015,Art,2,9,QCM,24,21,19,2,1.14,90.48,19,5,78.0,Facile,Facile,Facile / Facile
1186,357,2016,Art,2,9,QCM,28,28,27,1,1.0,96.43,27,1,96.85,Difficile,Trop Facile,Difficile / Trop Facile
2016,357,2017,Art,2,9,QCM,22,14,12,2,1.57,85.71,12,10,53.47,Difficile,Difficile,Difficile / Difficile
2846,357,2018,Art,2,9,QCM,19,14,5,9,1.36,35.71,5,14,26.8,Difficile,Difficile,Difficile / Difficile
3676,357,2019,Art,2,9,QCM,15,12,6,6,1.25,50.0,6,9,40.27,Difficile,Difficile,Difficile / Difficile
4506,357,2020,Art,2,9,QCM,14,14,5,9,1.0,35.71,5,9,33.38,Difficile,Difficile,Difficile / Difficile
357,358,2015,Art,3,1,QCM,13,11,8,3,1.18,72.73,8,5,60.44,Adapte,Adapte,Adapte / Adapte
1187,358,2016,Art,3,1,QCM,14,12,9,3,1.17,75.0,9,5,66.39,Adapte,Adapte,Adapte / Adapte
2017,358,2017,Art,3,1,QCM,17,11,11,0,1.55,100.0,11,6,65.57,Adapte,Adapte,Adapte / Adapte
2847,358,2018,Art,3,1,QCM,19,13,13,0,1.46,100.0,13,6,70.14,Adapte,Adapte,Adapte / Adapte
3677,358,2019,Art,3,1,QCM,17,15,12,3,1.13,80.0,12,5,70.71,Adapte,Adapte,Adapte / Adapte
4507,358,2020,Art,3,1,QCM,20,15,13,2,1.33,86.67,13,7,66.52,Adapte,Adapte,Adapte / Adapte
358,359,2015,Art,3,2,QCU,60,58,19,39,1.03,32.76,19,41,31.47,Trop Facile,Difficile,Trop Facile / Difficile
1188,359,2016,Art,3,2,QCU,62,55,54,1,1.13,98.18,54,8,86.52,Difficile,Trop Facile,Difficile / Trop Facile
2018,359,2017,Art,3,2,QCU,67,52,26,26,1.29,50.0,26,41,38.88,Difficile,Difficile,Difficile / Difficile
2848,359,2018,Art,3,2,QCU,64,37,36,1,1.73,97.3,36,28,56.7,Difficile,Difficile,Difficile / Difficile
3678,359,2019,Art,3,2,QCU,64,57,50,7,1.12,87.72,50,14,78.71,Difficile,Facile,Difficile / Facile
4508,359,2020,Art,3,2,QCU,75,68,28,40,1.1,41.18,28,47,37.94,Difficile,Difficile,Difficile / Difficile
359,360,2015,Art,3,3,QCM,21,12,9,3,1.75,75.0,9,12,40.48,Difficile,Difficile,Difficile / Difficile
1189,360,2016,Art,3,3,QCM,22,22,18,4,1.0,81.82,18,4,81.28,Difficile,Facile,Difficile / Facile
2019,360,2017,Art,3,3,QCM,19,9,1,8,2.11,11.11,1,18,6.64,Difficile,Trop Difficile,Difficile / Trop Difficile
2849,360,2018,Art,3,3,QCM,15,12,5,7,1.25,41.67,5,10,30.73,Difficile,Difficile,Difficile / Difficile
3679,360,2019,Art,3,3,QCM,16,11,6,5,1.45,54.55,6,10,36.8,Difficile,Difficile,Difficile / Difficile
4509,360,2020,Art,3,3,QCM,18,15,9,6,1.2,60.0,9,9,49.91,Difficile,Difficile,Difficile / Difficile
360,361,2015,Art,3,4,QCM,87,71,56,15,1.23,78.87,56,31,64.78,Adapte,Adapte,Adapte / Adapte
1190,361,2016,Art,3,4,QCM,74,73,52,21,1.01,71.23,52,22,69.76,Adapte,Adapte,Adapte / Adapte
2020,361,2017,Art,3,4,QCM,86,76,54,22,1.13,71.05,54,32,63.24,Adapte,Adapte,Adapte / Adapte
2850,361,2018,Art,3,4,QCM,69,61,43,18,1.13,70.49,43,26,62.81,Adapte,Adapte,Adapte / Adapte
3680,361,2019,Art,3,4,QCM,77,62,56,6,1.24,90.32,56,21,72.44,Adapte,Adapte,Adapte / Adapte
4510,361,2020,Art,3,4,QCM,76,56,53,3,1.36,94.64,53,23,70.18,Adapte,Adapte,Adapte / Adapte
361,362,2015,Art,3,5,QCU,81,72,14,58,1.12,19.44,14,67,17.2,Trop Difficile,Trop Difficile,Trop Difficile / Trop Difficile
1191,362,2016,Art,3,5,QCU,93,70,0,70,1.33,0.0,0,93,0.41,Difficile,Trop Difficile,Difficile / Trop Difficile
2021,362,2017,Art,3,5,QCU,106,68,67,1,1.56,98.53,67,39,63.01,Difficile,Adapte,Difficile / Adapte
2851,362,2018,Art,3,5,QCU,124,111,76,35,1.12,68.47,76,48,61.66,Adapte,Adapte,Adapte / Adapte
3681,362,2019,Art,3,5,QCU,128,83,77,6,1.54,92.77,77,51,60.25,Adapte,Adapte,Adapte / Adapte
4511,362,2020,Art,3,5,QCU,129,108,82,26,1.19,75.93,82,47,63.55,Adapte,Adapte,Adapte / Adapte
362,363,2015,Art,4,1,QO,22,22,21,1,1.0,95.45,21,1,97.57,Facile,Trop Facile,Facile / Trop Facile
1192,363,2016,Art,4,1,QO,20,20,13,7,1.0,65.0,13,7,65.03,Trop Difficile,Adapte,Trop Difficile / Adapte
2022,363,2017,Art,4,1,QO,22,17,15,2,1.29,88.24,15,7,69.59,Adapte,Adapte,Adapte / Adapte
2852,363,2018,Art,4,1,QO,19,16,12,4,1.19,75.0,12,7,64.06,Adapte,Adapte,Adapte / Adapte
3682,363,2019,Art,4,1,QO,19,18,12,6,1.06,66.67,12,7,62.8,Adapte,Adapte,Adapte / Adapte
4512,363,2020,Art,4,1,QO,21,17,14,3,1.24,82.35,14,7,67.72,Adapte,Adapte,Adapte / Adapte
363,364,2015,Art,4,2,QCU,17,15,13,2,1.13,86.67,13,4,73.54,Adapte,Adapte,Adapte / Adapte
1193,364,2016,Art,4,2,QCU,18,14,12,2,1.29,85.71,12,6,64.44,Adapte,Adapte,Adapte / Adapte
2023,364,2017,Art,4,2,QCU,21,16,13,3,1.31,81.25,13,8,62.73,Adapte,Adapte,Adapte / Adapte
2853,364,2018,Art,4,2,QCU,18,14,11,3,1.29,78.57,11,7,61.05,Adapte,Adapte,Adapte / Adapte
3683,364,2019,Art,4,2,QCU,15,15,10,5,1.0,66.67,10,5,65.56,Adapte,Adapte,Adapte / Adapte
4513,364,2020,Art,4,2,QCU,13,11,9,2,1.18,81.82,9,4,68.87,Adapte,Adapte,Adapte / Adapte
364,365,2015,Art,4,3,QCU,10,7,6,1,1.43,85.71,6,4,62.51,Difficile,Adapte,Difficile / Adapte
1194,365,2016,Art,4,3,QCU,10,10,6,4,1.0,60.0,6,4,60.48,Adapte,Adapte,Adapte / Adapte
2024,365,2017,Art,4,3,QCU,8,7,5,2,1.14,71.43,5,3,65.83,Adapte,Adapte,Adapte / Adapte
2854,365,2018,Art,4,3,QCU,8,5,5,0,1.6,100.0,5,3,60.68,Adapte,Adapte,Adapte / Adapte
3684,365,2019,Art,4,3,QCU,7,4,4,0,1.75,100.0,4,3,62.82,Adapte,Adapte,Adapte / Adapte
4514,365,2020,Art,4,3,QCU,8,6,5,1,1.33,83.33,5,3,62.04,Adapte,Adapte,Adapte / Adapte
365,366,2015,Art,4,4,QCM,59,54,51,3,1.09,94.44,51,8,86.44,Adapte,Trop Facile,Adapte / Trop Facile
1195,366,2016,Art,4,4,QCM,60,35,21,14,1.71,60.0,21,39,34.27,Difficile,Difficile,Difficile / Difficile
2025,366,2017,Art,4,4,QCM,53,53,44,9,1.0,83.02,44,9,82.7,Difficile,Facile,Difficile / Facile
2855,366,2018,Art,4,4,QCM,63,40,23,17,1.57,57.5,23,40,37.25,Difficile,Difficile,Difficile / Difficile
3685,366,2019,Art,4,4,QCM,67,41,29,12,1.63,70.73,29,38,42.58,Difficile,Difficile,Difficile / Difficile
4515,366,2020,Art,4,4,QCM,62,53,16,37,1.17,30.19,16,46,25.2,Difficile,Difficile,Difficile / Difficile
366,367,2015,Art,4,5,QCM,62,54,18,36,1.15,33.33,18,44,28.83,Difficile,Difficile,Difficile / Difficile
1196,367,2016,Art,4,5,QCM,64,62,31,31,1.03,50.0,31,33,48.81,Difficile,Difficile,Difficile / Difficile
2026,367,2017,Art,4,5,QCM,66,55,0,55,1.2,0.0,0,66,0.27,Difficile,Trop Difficile,Difficile / Trop Difficile
2856,367,2018,Art,4,5,QCM,73,73,41,32,1.0,56.16,41,32,56.38,Difficile,Difficile,Difficile / Difficile
3686,367,2019,Art,4,5,QCM,79,42,32,10,1.88,76.19,32,47,39.91,Difficile,Difficile,Difficile / Difficile
4516,367,2020,Art,4,5,QCM,68,47,10,37,1.45,21.28,10,58,14.5,Difficile,Trop Difficile,Difficile / Trop Difficile
367,368,2015,Art,4,6,QCM,49,33,7,26,1.48,21.21,7,42,13.68,Trop Difficile,Trop Difficile,Trop Difficile / Trop Difficile
1197,368,2016,Art,4,6,QCM,57,36,33,3,1.58,91.67,33,24,57.98,Difficile,Difficile,Difficile / Difficile
2027,368,2017,Art,4,6,QCM,52,44,20,24,1.18,45.45,20,32,39.19,Difficile,Difficile,Difficile / Difficile
2857,368,2018,Art,4,6,QCM,45,41,39,2,1.1,95.12,39,6,86.67,Difficile,Trop Facile,Difficile / Trop Facile
3687,368,2019,Art,4,6,QCM,50,27,16,11,1.85,59.26,16,34,32.8,Difficile,Difficile,Difficile / Difficile
4517,368,2020,Art,4,6,QCM,48,36,24,12,1.33,66.67,24,24,49.56,Difficile,Difficile,Difficile / Difficile
368,369,2015,Art,5,1,QCU,80,63,52,11,1.27,82.54,52,28,64.64,Trop Facile,Adapte,Trop Facile / Adapte
1198,369,2016,Art,5,1,QCU,75,72,50,22,1.04,69.44,50,25,66.2,Adapte,Adapte,Adapte / Adapte
2028,369,2017,Art,5,1,QCU,90,73,56,17,1.23,76.71,56,34,62.38,Adapte,Adapte,Adapte / Adapte
2858,369,2018,Art,5,1,QCU,107,93,76,17,1.15,81.72,76,31,70.71,Adapte,Adapte,Adapte / Adapte
3688,369,2019,Art,5,1,QCU,102,74,69,5,1.38,93.24,69,33,67.92,Adapte,Adapte,Adapte / Adapte
4518,369,2020,Art,5,1,QCU,103,90,77,13,1.14,85.56,77,26,74.61,Adapte,Adapte,Adapte / Adapte
369,370,2015,Art,5,2,QCM,99,86,41,45,1.15,47.67,41,58,40.92,Facile,Difficile,Facile / Difficile
1199,370,2016,Art,5,2,QCM,109,105,96,9,1.04,91.43,96,13,88.23,Difficile,Trop Facile,Difficile / Trop Facile
2029,370,2017,Art,5,2,QCM,122,75,53,22,1.63,70.67,53,69,43.15,Difficile,Difficile,Difficile / Difficile
2859,370,2018,Art,5,2,QCM,135,127,50,77,1.06,39.37,50,85,37.21,Difficile,Difficile,Difficile / Difficile
3689,370,2019,Art,5,2,QCM,125,97,34,63,1.29,35.05,34,91,27.3,Difficile,Difficile,Difficile / Difficile
4519,370,2020,Art,5,2,QCM,116,114,103,11,1.02,90.35,103,13,88.93,Difficile,Trop Facile,Difficile / Trop Facile
370,371,2015,Art,5,3,QROC,31,13,4,9,2.38,30.77,4,27,14.45,Trop Difficile,Trop Difficile,Trop Difficile / Trop Difficile
1200,371,2016,Art,5,3,QROC,34,33,19,14,1.03,57.58,19,15,56.09,Difficile,Difficile,Difficile / Difficile
2030,371,2017,Art,5,3,QROC,40,24,2,22,1.67,8.33,2,38,5.55,Difficile,Trop Difficile,Difficile / Trop Difficile
2860,371,2018,Art,5,3,QROC,33,25,19,6,1.32,76.0,19,14,57.74,Difficile,Difficile,Difficile / Difficile
3690,371,2019,Art,5,3,QROC,40,17,12,5,2.35,70.59,12,28,29.68,Difficile,Difficile,Difficile / Difficile
4520,371,2020,Art,5,3,QROC,45,27,16,11,1.67,59.26,16,29,36.0,Difficile,Difficile,Difficile / Difficile
371,372,2015,Art,5,4,QO,54,43,28,15,1.26,65.12,28,26,51.46,Difficile,Difficile,Difficile / Difficile
1201,372,2016,Art,5,4,QO,48,42,5,37,1.14,11.9,5,43,9.93,Trop Difficile,Trop Difficile,Trop Difficile / Trop Difficile
2031,372,2017,Art,5,4,QO,55,37,6,31,1.49,16.22,6,49,10.07,Trop Difficile,Trop Difficile,Trop Difficile / Trop Difficile
2861,372,2018,Art,5,4,QO,66,39,11,28,1.69,28.21,11,55,16.12,Trop Difficile,Trop Difficile,Trop Difficile / Trop Difficile
3691,372,2019,Art,5,4,QO,61,40,37,3,1.52,92.5,37,24,60.82,Trop Difficile,Adapte,Trop Difficile / Adapte
4521,372,2020,Art,5,4,QO,71,44,44,0,1.61,100.0,44,27,61.6,Adapte,Adapte,Adapte / Adapte
372,373,2015,Art,5,5,QCM,13,6,5,1,2.17,83.33,5,8,39.84,Difficile,Difficile,Difficile / Difficile
1202,373,2016,Art,5,5,QCM,12,8,6,2,1.5,75.0,6,6,48.61,Difficile,Difficile,Difficile / Difficile
2032,373,2017,Art,5,5,QCM,11,9,6,3,1.22,66.67,6,5,56.76,Difficile,Difficile,Difficile / Difficile
2862,373,2018,Art,5,5,QCM,13,12,11,1,1.08,91.67,11,2,81.39,Difficile,Facile,Difficile / Facile
3692,373,2019,Art,5,5,QCM,13,8,7,1,1.62,87.5,7,6,52.72,Difficile,Difficile,Difficile / Difficile
4522,373,2020,Art,5,5,QCM,13,10,3,7,1.3,30.0,3,10,25.15,Difficile,Difficile,Difficile / Difficile
373,374,2015,Art,5,6,QCU,32,28,24,4,1.14,85.71,24,8,76.19,Adapte,Facile,Adapte / Facile
1203,374,2016,Art,5,6,QCU,33,27,12,15,1.22,44.44,12,21,37.11,Difficile,Difficile,Difficile / Difficile
2033,374,2017,Art,5,6,QCU,39,23,22,1,1.7,95.65,22,17,55.3,Difficile,Difficile,Difficile / Difficile
2863,374,2018,Art,5,6,QCU,38,31,15,16,1.23,48.39,15,23,38.83,Difficile,Difficile,Difficile / Difficile
3693,374,2019,Art,5,6,QCU,44,27,15,12,1.63,55.56,15,29,34.9,Difficile,Difficile,Difficile / Difficile
4523,374,2020,Art,5,6,QCU,46,30,20,10,1.53,66.67,20,26,43.94,Difficile,Difficile,Difficile / Difficile
374,375,2015,Art,5,7,QCU,93,59,21,38,1.58,35.59,21,72,22.63,Adapte,Trop Difficile,Adapte / Trop Difficile
1204,375,2016,Art,5,7,QCU,94,55,30,25,1.71,54.55,30,64,32.02,Difficile,Difficile,Difficile / Difficile
2034,375,2017,Art,5,7,QCU,95,42,42,0,2.26,100.0,42,53,43.76,Difficile,Difficile,Difficile / Difficile
2864,375,2018,Art,5,7,QCU,86,75,68,7,1.15,90.67,68,18,79.51,Difficile,Facile,Difficile / Facile
3694,375,2019,Art,5,7,QCU,73,54,40,14,1.35,74.07,40,33,54.34,Difficile,Difficile,Difficile / Difficile
4524,375,2020,Art,5,7,QCU,65,41,26,15,1.59,63.41,26,39,39.4,Difficile,Difficile,Difficile / Difficile
375,376,2015,Art,5,8,QCM,23,20,17,3,1.15,85.0,17,6,73.68,Difficile,Adapte,Difficile / Adapte
1205,376,2016,Art,5,8,QCM,24,23,16,7,1.04,69.57,16,8,67.84,Adapte,Adapte,Adapte / Adapte
2035,376,2017,Art,5,8,QCM,27,22,20,2,1.23,90.91,20,7,73.15,Adapte,Adapte,Adapte / Adapte
2865,376,2018,Art,5,8,QCM,30,27,18,9,1.11,66.67,18,12,61.11,Adapte,Adapte,Adapte / Adapte
3695,376,2019,Art,5,8,QCM,26,19,18,1,1.37,94.74,18,8,67.59,Adapte,Adapte,Adapte / Adapte
4525,376,2020,Art,5,8,QCM,29,24,19,5,1.21,79.17,19,10,66.28,Adapte,Adapte,Adapte / Adapte
376,377,2015,Art,5,9,QCU,40,37,15,22,1.08,40.54,15,25,36.7,Difficile,Difficile,Difficile / Difficile
1206,377,2016,Art,5,9,QCU,32,19,13,6,1.68,68.42,13,19,41.83,Difficile,Difficile,Difficile / Difficile
2036,377,2017,Art,5,9,QCU,26,25,13,12,1.04,52.0,13,13,51.25,Difficile,Difficile,Difficile / Difficile
2866,377,2018,Art,5,9,QCU,22,22,21,1,1.0,95.45,21,1,96.81,Difficile,Trop Facile,Difficile / Trop Facile
3696,377,2019,Art,5,9,QCU,24,23,16,7,1.04,69.57,16,8,66.38,Difficile,Adapte,Difficile / Adapte
4526,377,2020,Art,5,9,QCU,19,15,13,2,1.27,86.67,13,6,66.53,Adapte,Adapte,Adapte / Adapte
377,378,2015,Art,6,1,QROC,78,70,49,21,1.11,70.0,49,29,62.33,Facile,Adapte,Facile / Adapte
1207,378,2016,Art,6,1,QROC,63,54,47,7,1.17,87.04,47,16,73.81,Adapte,Adapte,Adapte / Adapte
2037,378,2017,Art,6,1,QROC,71,67,48,19,1.06,71.64,48,23,68.17,Adapte,Adapte,Adapte / Adapte
2867,378,2018,Art,6,1,QROC,75,64,50,14,1.17,78.12,50,25,66.03,Adapte,Adapte,Adapte / Adapte
3697,378,2019,Art,6,1,QROC,76,54,49,5,1.41,90.74,49,27,64.51,Adapte,Adapte,Adapte / Adapte
4527,378,2020,Art,6,1,QROC,67,56,49,7,1.2,87.5,49,18,72.87,Adapte,Adapte,Adapte / Adapte
378,379,2015,Art,6,2,QCU,43,38,34,4,1.13,89.47,34,9,78.13,Trop Facile,Facile,Trop Facile / Facile
1208,379,2016,Art,6,2,QCU,44,40,16,24,1.1,40.0,16,28,35.32,Difficile,Difficile,Difficile / Difficile
2038,379,2017,Art,6,2,QCU,42,19,18,1,2.21,94.74,18,24,41.81,Difficile,Difficile,Difficile / Difficile
2868,379,2018,Art,6,2,QCU,34,22,17,5,1.55,77.27,17,17,49.96,Difficile,Difficile,Difficile / Difficile
3698,379,2019,Art,6,2,QCU,27,16,8,8,1.69,50.0,8,19,29.84,Difficile,Difficile,Difficile / Difficile
4528,379,2020,Art,6,2,QCU,31,14,12,2,2.21,85.71,12,19,39.9,Difficile,Difficile,Difficile / Difficile
379,380,2015,Art,6,3,QCM,100,69,64,5,1.45,92.75,64,36,64.01,Adapte,Adapte,Adapte / Adapte
1209,380,2016,Art,6,3,QCM,120,96,87,9,1.25,90.62,87,33,72.87,Adapte,Adapte,Adapte / Adapte
2039,380,2017,Art,6,3,QCM,127,110,80,30,1.15,72.73,80,47,63.23,Adapte,Adapte,Adapte / Adapte
2869,380,2018,Art,6,3,QCM,105,98,67,31,1.07,68.37,67,38,63.84,Adapte,Adapte,Adapte / Adapte
3699,380,2019,Art,6,3,QCM,118,113,88,25,1.04,77.88,88,30,74.8,Adapte,Adapte,Adapte / Adapte
4529,380,2020,Art,6,3,QCM,100,71,65,6,1.41,91.55,65,35,65.15,Adapte,Adapte,Adapte / Adapte
380,381,2015,Art,6,4,QCM,62,54,15,39,1.15,27.78,15,47,23.52,Facile,Trop Difficile,Facile / Trop Difficile
1210,381,2016,Art,6,4,QCM,72,41,34,7,1.76,82.93,34,38,47.39,Difficile,Difficile,Difficile / Difficile
2040,381,2017,Art,6,4,QCM,77,70,62,8,1.1,88.57,62,15,80.69,Difficile,Facile,Difficile / Facile
2870,381,2018,Art,6,4,QCM,80,74,25,49,1.08,33.78,25,55,31.77,Difficile,Difficile,Difficile / Difficile
3700,381,2019,Art,6,4,QCM,66,54,46,8,1.22,85.19,46,20,69.58,Difficile,Adapte,Difficile / Adapte
4530,381,2020,Art,6,4,QCM,66,60,40,20,1.1,66.67,40,26,61.08,Adapte,Adapte,Adapte / Adapte
381,382,2015,Art,6,5,QCU,72,65,61,4,1.11,93.85,61,11,84.82,Facile,Facile,Facile / Facile
1211,382,2016,Art,6,5,QCU,70,45,23,22,1.56,51.11,23,47,32.32,Difficile,Difficile,Difficile / Difficile
2041,382,2017,Art,6,5,QCU,81,67,40,27,1.21,59.7,40,41,49.23,Difficile,Difficile,Difficile / Difficile
2871,382,2018,Art,6,5,QCU,81,32,31,1,2.53,96.88,31,50,37.67,Difficile,Difficile,Difficile / Difficile
3701,382,2019,Art,6,5,QCU,84,69,69,0,1.22,100.0,69,15,81.91,Difficile,Facile,Difficile / Facile
4531,382,2020,Art,6,5,QCU,69,49,30,19,1.41,61.22,30,39,43.48,Difficile,Difficile,Difficile / Difficile
382,383,2015,Art,6,6,QCM,33,32,27,5,1.03,84.38,27,6,82.5,Adapte,Facile,Adapte / Facile
1212,383,2016,Art,6,6,QCM,40,32,22,10,1.25,68.75,22,18,53.83,Difficile,Difficile,Difficile / Difficile
2042,383,2017,Art,6,6,QCM,41,38,20,18,1.08,52.63,20,21,48.88,Difficile,Difficile,Difficile / Difficile
2872,383,2018,Art,6,6,QCM,43,38,16,22,1.13,42.11,16,27,36.44,Difficile,Difficile,Difficile / Difficile
3702,383,2019,Art,6,6,QCM,39,30,12,18,1.3,40.0,12,27,31.68,Difficile,Difficile,Difficile / Difficile
4532,383,2020,Art,6,6,QCM,36,31,1,30,1.16,3.23,1,35,3.22,Difficile,Trop Difficile,Difficile / Trop Difficile
383,384,2015,Art,6,7,QROC,74,72,50,22,1.03,69.44,50,24,68.06,Adapte,Adapte,Adapte / Adapte
1213,384,2016,Art,6,7,QROC,60,59,39,20,1.02,66.1,39,21,64.87,Adapte,Adapte,Adapte / Adapte
2043,384,2017,Art,6,7,QROC,52,49,37,12,1.06,75.51,37,15,70.5,Adapte,Adapte,Adapte / Adapte
2873,384,2018,Art,6,7,QROC,59,54,43,11,1.09,79.63,43,16,72.81,Adapte,Adapte,Adapte / Adapte
3703,384,2019,Art,6,7,QROC,63,59,38,21,1.07,64.41,38,25,60.33,Adapte,Adapte,Adapte / Adapte
4533,384,2020,Art,6,7,QROC,65,64,47,17,1.02,73.44,47,18,72.24,Adapte,Adapte,Adapte / Adapte
384,385,2015,Art,6,8,QCM,28,9,7,2,3.11,77.78,7,21,23.29,Adapte,Trop Difficile,Adapte / Trop Difficile
1214,385,2016,Art,6,8,QCM,34,15,12,3,2.27,80.0,12,22,35.76,Difficile,Difficile,Difficile / Difficile
2044,385,2017,Art,6,8,QCM,35,15,10,5,2.33,66.67,10,25,29.48,Difficile,Difficile,Difficile / Difficile
2874,385,2018,Art,6,8,QCM,39,21,18,3,1.86,85.71,18,21,45.98,Difficile,Difficile,Difficile / Difficile
3704,385,2019,Art,6,8,QCM,34,29,9,20,1.17,31.03,9,25,26.5,Difficile,Difficile,Difficile / Difficile
4534,385,2020,Art,6,8,QCM,35,30,29,1,1.17,96.67,29,6,82.99,Difficile,Facile,Difficile / Facile
385,386,2015,Art,6,9,QCU,65,64,63,1,1.02,98.44,63,2,96.7,Trop Facile,Trop Facile,Trop Facile / Trop Facile
1215,386,2016,Art,6,9,QCU,61,39,33,6,1.56,84.62,33,28,54.49,Difficile,Difficile,Difficile / Difficile
2045,386,2017,Art,6,9,QCU,64,58,56,2,1.1,96.55,56,8,86.89,Difficile,Trop Facile,Difficile / Trop Facile
2875,386,2018,Art,6,9,QCU,77,75,63,12,1.03,84.0,63,14,81.39,Difficile,Facile,Difficile / Facile
3705,386,2019,Art,6,9,QCU,66,64,55,9,1.03,85.94,55,11,83.18,Difficile,Facile,Difficile / Facile
4535,386,2020,Art,6,9,QCU,55,20,18,2,2.75,90.0,18,37,32.78,Difficile,Difficile,Difficile / Difficile
386,387,2015,Art,6,10,QCM,7,3,0,3,2.33,0.0,0,7,6.38,Trop Difficile,Trop Difficile,Trop Difficile / Trop Difficile
1216,387,2016,Art,6,10,QCM,6,5,3,2,1.2,60.0,3,3,58.24,Difficile,Difficile,Difficile / Difficile
2046,387,2017,Art,6,10,QCM,5,5,4,1,1.0,80.0,4,1,80.78,Difficile,Facile,Difficile / Facile
2876,387,2018,Art,6,10,QCM,5,3,2,1,1.67,66.67,2,3,33.2,Difficile,Difficile,Difficile / Difficile
3706,387,2019,Art,6,10,QCM,6,6,3,3,1.0,50.0,3,3,55.03,Difficile,Difficile,Difficile / Difficile
4536,387,2020,Art,6,10,QCM,6,6,4,2,1.0,66.67,4,2,70.35,Difficile,Adapte,Difficile / Adapte
387,388,2015,Art,6,11,QCU,61,26,8,18,2.35,30.77,8,53,12.63,Trop Difficile,Trop Difficile,Trop Difficile / Trop Difficile
1217,388,2016,Art,6,11,QCU,55,50,46,4,1.1,92.0,46,9,83.9,Difficile,Facile,Difficile / Facile
2047,388,2017,Art,6,11,QCU,59,59,25,34,1.0,42.37,25,34,42.8,Difficile,Difficile,Difficile / Difficile
2877,388,2018,Art,6,11,QCU,49,45,43,2,1.09,95.56,43,6,87.59,Difficile,Trop Facile,Difficile / Trop Facile
3707,388,2019,Art,6,11,QCU,53,28,17,11,1.89,60.71,17,36,32.94,Difficile,Difficile,Difficile / Difficile
4537,388,2020,Art,6,11,QCU,61,57,49,8,1.07,85.96,49,12,80.9,Difficile,Facile,Difficile / Facile
388,389,2015,Art,6,12,QCU,35,30,28,2,1.17,93.33,28,7,79.18,Facile,Facile,Facile / Facile
1218,389,2016,Art,6,12,QCU,42,37,19,18,1.14,51.35,19,23,44.28,Difficile,Difficile,Difficile / Difficile
2048,389,2017,Art,6,12,QCU,45,35,4,31,1.29,11.43,4,41,7.79,Difficile,Trop Difficile,Difficile / Trop Difficile
2878,389,2018,Art,6,12,QCU,42,35,27,8,1.2,77.14,27,15,65.05,Difficile,Adapte,Difficile / Adapte
3708,389,2019,Art,6,12,QCU,40,30,25,5,1.33,83.33,25,15,61.84,Adapte,Adapte,Adapte / Adapte
4538,389,2020,Art,6,12,QCU,47,40,35,5,1.18,87.5,35,12,74.46,Adapte,Adapte,Adapte / Adapte
389,390,2015,Art,6,13,QCU,90,90,87,3,1.0,96.67,87,3,96.67,Difficile,Trop Facile,Difficile / Trop Facile
1219,390,2016,Art,6,13,QCU,105,75,49,26,1.4,65.33,49,56,47.13,Difficile,Difficile,Difficile / Difficile
2049,390,2017,Art,6,13,QCU,117,61,57,4,1.92,93.44,57,60,48.54,Difficile,Difficile,Difficile / Difficile
2879,390,2018,Art,6,13,QCU,126,98,91,7,1.29,92.86,91,35,72.53,Difficile,Adapte,Difficile / Adapte
3709,390,2019,Art,6,13,QCU,126,83,81,2,1.52,97.59,81,45,63.98,Adapte,Adapte,Adapte / Adapte
4539,390,2020,Art,6,13,QCU,141,125,99,26,1.13,79.2,99,42,70.47,Adapte,Adapte,Adapte / Adapte
390,391,2015,Art,6,14,QROC,85,77,74,3,1.1,96.1,74,11,87.28,Trop Facile,Trop Facile,Trop Facile / Trop Facile
1220,391,2016,Art,6,14,QROC,94,60,55,5,1.57,91.67,55,39,58.4,Difficile,Difficile,Difficile / Difficile
2050,391,2017,Art,6,14,QROC,76,74,62,12,1.03,83.78,62,14,81.3,Difficile,Facile,Difficile / Facile
2880,391,2018,Art,6,14,QROC,65,55,25,30,1.18,45.45,25,40,37.99,Difficile,Difficile,Difficile / Difficile
3710,391,2019,Art,6,14,QROC,66,47,17,30,1.4,36.17,17,49,25.37,Difficile,Difficile,Difficile / Difficile
4540,391,2020,Art,6,14,QROC,78,69,66,3,1.13,95.65,66,12,84.9,Difficile,Facile,Difficile / Facile
391,392,2015,Art,7,1,QCM,96,79,46,33,1.22,58.23,46,50,47.83,Difficile,Difficile,Difficile / Difficile
1221,392,2016,Art,7,1,QCM,109,90,56,34,1.21,62.22,56,53,50.98,Difficile,Difficile,Difficile / Difficile
2051,392,2017,Art,7,1,QCM,109,79,49,30,1.38,62.03,49,60,45.27,Difficile,Difficile,Difficile / Difficile
2881,392,2018,Art,7,1,QCM,114,67,29,38,1.7,43.28,29,85,25.02,Difficile,Difficile,Difficile / Difficile
3711,392,2019,Art,7,1,QCM,123,38,17,21,3.24,44.74,17,106,13.96,Difficile,Trop Difficile,Difficile / Trop Difficile
4541,392,2020,Art,7,1,QCM,128,109,49,60,1.17,44.95,49,79,38.34,Difficile,Difficile,Difficile / Difficile
392,393,2015,Art,7,2,QCU,47,41,39,2,1.15,95.12,39,8,82.86,Trop Difficile,Facile,Trop Difficile / Facile
1222,393,2016,Art,7,2,QCU,47,27,14,13,1.74,51.85,14,33,30.68,Difficile,Difficile,Difficile / Difficile
2052,393,2017,Art,7,2,QCU,38,36,15,21,1.06,41.67,15,23,40.53,Difficile,Difficile,Difficile / Difficile
2882,393,2018,Art,7,2,QCU,42,38,22,16,1.11,57.89,22,20,53.05,Difficile,Difficile,Difficile / Difficile
3712,393,2019,Art,7,2,QCU,40,33,32,1,1.21,96.97,32,8,80.75,Difficile,Facile,Difficile / Facile
4542,393,2020,Art,7,2,QCU,36,30,9,21,1.2,30.0,9,27,25.69,Difficile,Difficile,Difficile / Difficile
393,394,2015,Art,7,3,QCM,82,82,74,8,1.0,90.24,74,8,90.17,Trop Facile,Trop Facile,Trop Facile / Trop Facile
1223,394,2016,Art,7,3,QCM,83,65,32,33,1.28,49.23,32,51,38.61,Difficile,Difficile,Difficile / Difficile
2053,394,2017,Art,7,3,QCM,74,66,29,37,1.12,43.94,29,45,39.43,Difficile,Difficile,Difficile / Difficile
2883,394,2018,Art,7,3,QCM,82,55,14,41,1.49,25.45,14,68,17.53,Difficile,Trop Difficile,Difficile / Trop Difficile
3713,394,2019,Art,7,3,QCM,98,92,89,3,1.07,96.74,89,9,91.09,Difficile,Trop Facile,Difficile / Trop Facile
4543,394,2020,Art,7,3,QCM,87,79,43,36,1.1,54.43,43,44,48.98,Difficile,Difficile,Difficile / Difficile
394,395,2015,Art,7,4,QCM,93,89,39,50,1.04,43.82,39,54,42.16,Difficile,Difficile,Difficile / Difficile
1224,395,2016,Art,7,4,QCM,96,70,49,21,1.37,70.0,49,47,50.98,Difficile,Difficile,Difficile / Difficile
2054,395,2017,Art,7,4,QCM,90,80,27,53,1.12,33.75,27,63,29.66,Difficile,Difficile,Difficile / Difficile
2884,395,2018,Art,7,4,QCM,89,87,85,2,1.02,97.7,85,4,95.95,Difficile,Trop Facile,Difficile / Trop Facile
3714,395,2019,Art,7,4,QCM,96,72,40,32,1.33,55.56,40,56,41.16,Difficile,Difficile,Difficile / Difficile
4544,395,2020,Art,7,4,QCM,88,78,58,20,1.13,74.36,58,30,65.77,Difficile,Adapte,Difficile / Adapte
395,396,2015,Art,7,5,QCU,73,52,42,10,1.4,80.77,42,31,57.81,Difficile,Difficile,Difficile / Difficile
1225,396,2016,Art,7,5,QCU,70,52,46,6,1.35,88.46,46,24,65.31,Difficile,Adapte,Difficile / Adapte
2055,396,2017,Art,7,5,QCU,80,74,58,16,1.08,78.38,58,22,72.98,Adapte,Adapte,Adapte / Adapte
2885,396,2018,Art,7,5,QCU,67,60,49,11,1.12,81.67,49,18,73.35,Adapte,Adapte,Adapte / Adapte
3715,396,2019,Art,7,5,QCU,76,73,49,24,1.04,67.12,49,27,64.01,Adapte,Adapte,Adapte / Adapte
4545,396,2020,Art,7,5,QCU,75,55,50,5,1.36,90.91,50,25,66.13,Adapte,Adapte,Adapte / Adapte
396,397,2015,Art,7,6,QROC,44,43,42,1,1.02,97.67,42,2,96.21,Trop Facile,Trop Facile,Trop Facile / Trop Facile
1226,397,2016,Art,7,6,QROC,40,30,18,12,1.33,60.0,18,22,44.83,Difficile,Difficile,Difficile / Difficile
2056,397,2017,Art,7,6,QROC,33,24,13,11,1.38,54.17,13,20,39.46,Difficile,Difficile,Difficile / Difficile
2886,397,2018,Art,7,6,QROC,29,21,9,12,1.38,42.86,9,20,30.51,Difficile,Difficile,Difficile / Difficile
3716,397,2019,Art,7,6,QROC,28,23,20,3,1.22,86.96,20,8,70.67,Difficile,Adapte,Difficile / Adapte
4546,397,2020,Art,7,6,QROC,22,20,16,4,1.1,80.0,16,6,71.7,Adapte,Adapte,Adapte / Adapte
397,398,2015,Art,7,7,QCM,34,26,1,25,1.31,3.85,1,33,1.7,Trop Difficile,Trop Difficile,Trop Difficile / Trop Difficile
1227,398,2016,Art,7,7,QCM,28,19,9,10,1.47,47.37,9,19,33.19,Difficile,Difficile,Difficile / Difficile
2057,398,2017,Art,7,7,QCM,33,30,9,21,1.1,30.0,9,24,28.0,Difficile,Difficile,Difficile / Difficile
2887,398,2018,Art,7,7,QCM,39,24,22,2,1.62,91.67,22,17,55.52,Difficile,Difficile,Difficile / Difficile
3717,398,2019,Art,7,7,QCM,45,28,16,12,1.61,57.14,16,29,36.19,Difficile,Difficile,Difficile / Difficile
4547,398,2020,Art,7,7,QCM,43,39,29,10,1.1,74.36,29,14,68.33,Difficile,Adapte,Difficile / Adapte
398,399,2015,Art,7,8,QCU,27,9,8,1,3.0,88.89,8,19,28.67,Adapte,Difficile,Adapte / Difficile
1228,399,2016,Art,7,8,QCU,23,21,12,9,1.1,57.14,12,11,52.91,Difficile,Difficile,Difficile / Difficile
2058,399,2017,Art,7,8,QCU,19,17,6,11,1.12,35.29,6,13,30.89,Difficile,Difficile,Difficile / Difficile
2888,399,2018,Art,7,8,QCU,18,13,9,4,1.38,69.23,9,9,47.48,Difficile,Difficile,Difficile / Difficile
3718,399,2019,Art,7,8,QCU,21,15,6,9,1.4,40.0,6,15,27.67,Difficile,Difficile,Difficile / Difficile
4548,399,2020,Art,7,8,QCU,17,15,13,2,1.13,86.67,13,4,77.28,Difficile,Facile,Difficile / Facile
399,400,2015,Art,7,9,QCU,8,4,0,4,2.0,0.0,0,8,3.45,Difficile,Trop Difficile,Difficile / Trop Difficile
1229,400,2016,Art,7,9,QCU,7,6,4,2,1.17,66.67,4,3,51.34,Difficile,Difficile,Difficile / Difficile
2059,400,2017,Art,7,9,QCU,6,5,3,2,1.2,60.0,3,3,47.59,Difficile,Difficile,Difficile / Difficile
2889,400,2018,Art,7,9,QCU,5,2,0,2,2.5,0.0,0,5,6.62,Difficile,Trop Difficile,Difficile / Trop Difficile
3719,400,2019,Art,7,9,QCU,4,4,3,1,1.0,75.0,3,1,84.44,Difficile,Facile,Difficile / Facile
4549,400,2020,Art,7,9,QCU,4,2,2,0,2.0,100.0,2,2,48.61,Difficile,Difficile,Difficile / Difficile
400,401,2015,Art,8,1,QCU,34,31,27,4,1.1,87.1,27,7,78.43,Facile,Facile,Facile / Facile
1230,401,2016,Art,8,1,QCU,38,29,29,0,1.31,100.0,29,9,76.07,Difficile,Facile,Difficile / Facile
2060,401,2017,Art,8,1,QCU,40,25,15,10,1.6,60.0,15,25,37.94,Difficile,Difficile,Difficile / Difficile
2890,401,2018,Art,8,1,QCU,34,23,13,10,1.48,56.52,13,21,39.65,Difficile,Difficile,Difficile / Difficile
3720,401,2019,Art,8,1,QCU,33,22,19,3,1.5,86.36,19,14,57.65,Difficile,Difficile,Difficile / Difficile
4550,401,2020,Art,8,1,QCU,33,20,17,3,1.65,85.0,17,16,51.04,Difficile,Difficile,Difficile / Difficile
401,402,2015,Art,8,2,QCU,32,30,22,8,1.07,73.33,22,10,67.98,Adapte,Adapte,Adapte / Adapte
1231,402,2016,Art,8,2,QCU,29,27,18,9,1.07,66.67,18,11,60.75,Adapte,Adapte,Adapte / Adapte
2061,402,2017,Art,8,2,QCU,30,26,22,4,1.15,84.62,22,8,71.77,Adapte,Adapte,Adapte / Adapte
2891,402,2018,Art,8,2,QCU,25,24,15,9,1.04,62.5,15,10,61.91,Adapte,Adapte,Adapte / Adapte
3721,402,2019,Art,8,2,QCU,22,22,15,7,1.0,68.18,15,7,67.79,Adapte,Adapte,Adapte / Adapte
4551,402,2020,Art,8,2,QCU,21,15,13,2,1.4,86.67,13,8,63.54,Adapte,Adapte,Adapte / Adapte
402,403,2015,Art,8,3,QCU,97,75,66,9,1.29,88.0,66,31,68.34,Adapte,Adapte,Adapte / Adapte
1232,403,2016,Art,8,3,QCU,107,95,76,19,1.13,80.0,76,31,71.46,Adapte,Adapte,Adapte / Adapte
2062,403,2017,Art,8,3,QCU,86,78,63,15,1.1,80.77,63,23,73.82,Adapte,Adapte,Adapte / Adapte
2892,403,2018,Art,8,3,QCU,90,70,66,4,1.29,94.29,66,24,72.95,Adapte,Adapte,Adapte / Adapte
3722,403,2019,Art,8,3,QCU,107,78,65,13,1.37,83.33,65,42,60.59,Adapte,Adapte,Adapte / Adapte
4552,403,2020,Art,8,3,QCU,108,76,69,7,1.42,90.79,69,39,63.66,Adapte,Adapte,Adapte / Adapte
403,404,2015,Art,8,4,QCU,55,55,53,2,1.0,96.36,53,2,95.65,Trop Facile,Trop Facile,Trop Facile / Trop Facile
1233,404,2016,Art,8,4,QCU,59,55,41,14,1.07,74.55,41,18,68.83,Difficile,Adapte,Difficile / Adapte
2063,404,2017,Art,8,4,QCU,57,51,43,8,1.12,84.31,43,14,74.66,Adapte,Adapte,Adapte / Adapte
2893,404,2018,Art,8,4,QCU,59,45,36,9,1.31,80.0,36,23,60.48,Adapte,Adapte,Adapte / Adapte
3723,404,2019,Art,8,4,QCU,69,56,48,8,1.23,85.71,48,21,69.87,Adapte,Adapte,Adapte / Adapte
4553,404,2020,Art,8,4,QCU,77,66,48,18,1.17,72.73,48,29,62.22,Adapte,Adapte,Adapte / Adapte
404,405,2015,Art,8,5,QCU,71,49,48,1,1.45,97.96,48,23,67.57,Trop Facile,Adapte,Trop Facile / Adapte
1234,405,2016,Art,8,5,QCU,79,75,54,21,1.05,72.0,54,25,68.77,Adapte,Adapte,Adapte / Adapte
2064,405,2017,Art,8,5,QCU,71,63,52,11,1.13,82.54,52,19,73.71,Adapte,Adapte,Adapte / Adapte
2894,405,2018,Art,8,5,QCU,84,77,60,17,1.09,77.92,60,24,70.93,Adapte,Adapte,Adapte / Adapte
3724,405,2019,Art,8,5,QCU,89,66,64,2,1.35,96.97,64,25,72.33,Adapte,Adapte,Adapte / Adapte
4554,405,2020,Art,8,5,QCU,95,85,64,21,1.12,75.29,64,31,67.78,Adapte,Adapte,Adapte / Adapte
405,406,2015,Art,8,6,QROC,58,35,34,1,1.66,97.14,34,24,58.56,Difficile,Difficile,Difficile / Difficile
1235,406,2016,Art,8,6,QROC,46,26,18,8,1.77,69.23,18,28,39.03,Difficile,Difficile,Difficile / Difficile
2065,406,2017,Art,8,6,QROC,52,43,36,7,1.21,83.72,36,16,68.67,Difficile,Adapte,Difficile / Adapte
2895,406,2018,Art,8,6,QROC,59,57,43,14,1.04,75.44,43,16,72.19,Adapte,Adapte,Adapte / Adapte
3725,406,2019,Art,8,6,QROC,67,51,49,2,1.31,96.08,49,18,73.07,Adapte,Adapte,Adapte / Adapte
4555,406,2020,Art,8,6,QROC,66,49,45,4,1.35,91.84,45,21,67.51,Adapte,Adapte,Adapte / Adapte
406,407,2015,Art,8,7,QROC,22,17,12,5,1.29,70.59,12,10,55.39,Trop Difficile,Difficile,Trop Difficile / Difficile
1236,407,2016,Art,8,7,QROC,24,21,9,12,1.14,42.86,9,15,39.52,Difficile,Difficile,Difficile / Difficile
2066,407,2017,Art,8,7,QROC,21,14,1,13,1.5,7.14,1,20,6.86,Difficile,Trop Difficile,Difficile / Trop Difficile
2896,407,2018,Art,8,7,QROC,21,15,7,8,1.4,46.67,7,14,34.85,Difficile,Difficile,Difficile / Difficile
3726,407,2019,Art,8,7,QROC,18,15,6,9,1.2,40.0,6,12,30.75,Difficile,Difficile,Difficile / Difficile
4556,407,2020,Art,8,7,QROC,20,19,15,4,1.05,78.95,15,5,73.42,Difficile,Adapte,Difficile / Adapte
407,408,2015,Art,8,8,QROC,9,7,2,5,1.29,28.57,2,7,26.64,Facile,Difficile,Facile / Difficile
1237,408,2016,Art,8,8,QROC,11,8,6,2,1.38,75.0,6,5,51.2,Difficile,Difficile,Difficile / Difficile
2067,408,2017,Art,8,8,QROC,11,11,6,5,1.0,54.55,6,5,52.74,Difficile,Difficile,Difficile / Difficile
2897,408,2018,Art,8,8,QROC,13,9,5,4,1.44,55.56,5,8,36.23,Difficile,Difficile,Difficile / Difficile
3727,408,2019,Art,8,8,QROC,16,9,2,7,1.78,22.22,2,14,11.07,Difficile,Trop Difficile,Difficile / Trop Difficile
4557,408,2020,Art,8,8,QROC,16,16,4,12,1.0,25.0,4,12,26.44,Difficile,Difficile,Difficile / Difficile
408,409,2015,Art,8,9,QCM,29,22,8,14,1.32,36.36,8,21,27.65,Difficile,Difficile,Difficile / Difficile
1238,409,2016,Art,8,9,QCM,30,28,8,20,1.07,28.57,8,22,27.55,Difficile,Difficile,Difficile / Difficile
2068,409,2017,Art,8,9,QCM,34,18,12,6,1.89,66.67,12,22,36.36,Difficile,Difficile,Difficile / Difficile
2898,409,2018,Art,8,9,QCM,40,39,28,11,1.03,71.79,28,12,70.47,Difficile,Adapte,Difficile / Adapte
3728,409,2019,Art,8,9,QCM,35,29,21,8,1.21,72.41,21,14,60.37,Adapte,Adapte,Adapte / Adapte
4558,409,2020,Art,8,9,QCM,32,24,20,4,1.33,83.33,20,12,61.14,Adapte,Adapte,Adapte / Adapte
409,410,2015,Art,9,1,QCU,30,24,14,10,1.25,58.33,14,16,47.41,Trop Facile,Difficile,Trop Facile / Difficile
1239,410,2016,Art,9,1,QCU,32,31,13,18,1.03,41.94,13,19,41.93,Difficile,Difficile,Difficile / Difficile
2069,410,2017,Art,9,1,QCU,32,30,1,29,1.07,3.33,1,31,1.61,Difficile,Trop Difficile,Difficile / Trop Difficile
2899,410,2018,Art,9,1,QCU,36,33,19,14,1.09,57.58,19,17,54.11,Difficile,Difficile,Difficile / Difficile
3729,410,2019,Art,9,1,QCU,35,26,18,8,1.35,69.23,18,17,51.56,Difficile,Difficile,Difficile / Difficile
4559,410,2020,Art,9,1,QCU,31,28,18,10,1.11,64.29,18,13,56.8,Difficile,Difficile,Difficile / Difficile
410,411,2015,Art,9,2,QO,77,74,56,18,1.04,75.68,56,21,72.25,Trop Difficile,Adapte,Trop Difficile / Adapte
1240,411,2016,Art,9,2,QO,88,80,63,17,1.1,78.75,63,25,71.37,Adapte,Adapte,Adapte / Adapte
2070,411,2017,Art,9,2,QO,73,52,45,7,1.4,86.54,45,28,61.13,Adapte,Adapte,Adapte / Adapte
2900,411,2018,Art,9,2,QO,64,46,43,3,1.39,93.48,43,21,67.78,Adapte,Adapte,Adapte / Adapte
3730,411,2019,Art,9,2,QO,54,43,36,7,1.26,83.72,36,18,67.25,Adapte,Adapte,Adapte / Adapte
4560,411,2020,Art,9,2,QO,49,34,32,2,1.44,94.12,32,17,64.47,Adapte,Adapte,Adapte / Adapte
411,412,2015,Art,9,3,QCU,46,40,34,6,1.15,85.0,34,12,74.39,Adapte,Adapte,Adapte / Adapte
1241,412,2016,Art,9,3,QCU,43,43,31,12,1.0,72.09,31,12,71.39,Adapte,Adapte,Adapte / Adapte
2071,412,2017,Art,9,3,QCU,41,39,29,10,1.05,74.36,29,12,70.44,Adapte,Adapte,Adapte / Adapte
2901,412,2018,Art,9,3,QCU,41,32,27,5,1.28,84.38,27,14,66.82,Adapte,Adapte,Adapte / Adapte
3731,412,2019,Art,9,3,QCU,35,29,23,6,1.21,79.31,23,12,65.55,Adapte,Adapte,Adapte / Adapte
4561,412,2020,Art,9,3,QCU,33,31,24,7,1.06,77.42,24,9,73.22,Adapte,Adapte,Adapte / Adapte
412,413,2015,Art,9,4,QROC,24,15,15,0,1.6,100.0,15,9,61.58,Adapte,Adapte,Adapte / Adapte
1242,413,2016,Art,9,4,QROC,23,18,15,3,1.28,83.33,15,8,66.89,Adapte,Adapte,Adapte / Adapte
2072,413,2017,Art,9,4,QROC,19,14,13,1,1.36,92.86,13,6,66.63,Adapte,Adapte,Adapte / Adapte
2902,413,2018,Art,9,4,QROC,18,14,13,1,1.29,92.86,13,5,70.64,Adapte,Adapte,Adapte / Adapte
3732,413,2019,Art,9,4,QROC,14,11,9,2,1.27,81.82,9,5,67.71,Adapte,Adapte,Adapte / Adapte
4562,413,2020,Art,9,4,QROC,13,12,10,2,1.08,83.33,10,3,74.31,Adapte,Adapte,Adapte / Adapte
413,414,2015,Art,9,5,QROC,92,77,66,11,1.19,85.71,66,26,71.39,Adapte,Adapte,Adapte / Adapte
1243,414,2016,Art,9,5,QROC,80,63,60,3,1.27,95.24,60,20,74.63,Adapte,Adapte,Adapte / Adapte
2073,414,2017,Art,9,5,QROC,70,63,52,11,1.11,82.54,52,18,73.78,Adapte,Adapte,Adapte / Adapte
2903,414,2018,Art,9,5,QROC,67,58,44,14,1.16,75.86,44,23,66.25,Adapte,Adapte,Adapte / Adapte
3733,414,2019,Art,9,5,QROC,77,60,47,13,1.28,78.33,47,30,60.44,Adapte,Adapte,Adapte / Adapte
4563,414,2020,Art,9,5,QROC,68,51,46,5,1.33,90.2,46,22,66.94,Adapte,Adapte,Adapte / Adapte
414,415,2015,Art,9,6,QCU,42,31,29,2,1.35,93.55,29,13,69.63,Facile,Adapte,Facile / Adapte
1244,415,2016,Art,9,6,QCU,40,34,26,8,1.18,76.47,26,14,65.08,Adapte,Adapte,Adapte / Adapte
2074,415,2017,Art,9,6,QCU,42,28,26,2,1.5,92.86,26,16,61.93,Adapte,Adapte,Adapte / Adapte
2904,415,2018,Art,9,6,QCU,49,38,32,6,1.29,84.21,32,17,64.43,Adapte,Adapte,Adapte / Adapte
3734,415,2019,Art,9,6,QCU,50,40,35,5,1.25,87.5,35,15,70.86,Adapte,Adapte,Adapte / Adapte
4564,415,2020,Art,9,6,QCU,44,36,33,3,1.22,91.67,33,11,74.1,Adapte,Adapte,Adapte / Adapte
415,416,2015,Art,9,7,QROC,50,30,8,22,1.67,26.67,8,42,15.48,Trop Difficile,Trop Difficile,Trop Difficile / Trop Difficile
1245,416,2016,Art,9,7,QROC,58,58,31,27,1.0,53.45,31,27,53.94,Difficile,Difficile,Difficile / Difficile
2075,416,2017,Art,9,7,QROC,53,33,27,6,1.61,81.82,27,26,50.25,Difficile,Difficile,Difficile / Difficile
2905,416,2018,Art,9,7,QROC,55,50,42,8,1.1,84.0,42,13,76.79,Difficile,Facile,Difficile / Facile
3735,416,2019,Art,9,7,QROC,45,34,23,11,1.32,67.65,23,22,51.22,Difficile,Difficile,Difficile / Difficile
4565,416,2020,Art,9,7,QROC,42,19,6,13,2.21,31.58,6,36,14.98,Difficile,Trop Difficile,Difficile / Trop Difficile
416,417,2015,Art,10,1,QCM,49,40,5,35,1.23,12.5,5,44,10.44,Trop Difficile,Trop Difficile,Trop Difficile / Trop Difficile
1246,417,2016,Art,10,1,QCM,52,50,45,5,1.04,90.0,45,7,86.38,Difficile,Trop Facile,Difficile / Trop Facile
2076,417,2017,Art,10,1,QCM,62,49,31,18,1.27,63.27,31,31,50.54,Difficile,Difficile,Difficile / Difficile
2906,417,2018,Art,10,1,QCM,53,37,22,15,1.43,59.46,22,31,41.6,Difficile,Difficile,Difficile / Difficile
3736,417,2019,Art,10,1,QCM,46,31,13,18,1.48,41.94,13,33,28.67,Difficile,Difficile,Difficile / Difficile
4566,417,2020,Art,10,1,QCM,54,33,23,10,1.64,69.7,23,31,42.53,Difficile,Difficile,Difficile / Difficile
417,418,2015,Art,10,2,QCU,16,14,13,1,1.14,92.86,13,3,78.56,Facile,Facile,Facile / Facile
1247,418,2016,Art,10,2,QCU,17,12,8,4,1.42,66.67,8,9,45.24,Difficile,Difficile,Difficile / Difficile
2077,418,2017,Art,10,2,QCU,14,7,1,6,2.0,14.29,1,13,9.58,Difficile,Trop Difficile,Difficile / Trop Difficile
2907,418,2018,Art,10,2,QCU,14,12,8,4,1.17,66.67,8,6,57.03,Difficile,Difficile,Difficile / Difficile
3737,418,2019,Art,10,2,QCU,14,13,5,8,1.08,38.46,5,9,34.91,Difficile,Difficile,Difficile / Difficile
4567,418,2020,Art,10,2,QCU,13,12,5,7,1.08,41.67,5,8,38.33,Difficile,Difficile,Difficile / Difficile
418,419,2015,Art,11,1,QROC,90,54,2,52,1.67,3.7,2,88,2.74,Trop Difficile,Trop Difficile,Trop Difficile / Trop Difficile
1248,419,2016,Art,11,1,QROC,84,42,35,7,2.0,83.33,35,49,41.76,Difficile,Difficile,Difficile / Difficile
2078,419,2017,Art,11,1,QROC,68,62,3,59,1.1,4.84,3,65,5.09,Difficile,Trop Difficile,Difficile / Trop Difficile
2908,419,2018,Art,11,1,QROC,80,75,74,1,1.07,98.67,74,6,92.76,Difficile,Trop Facile,Difficile / Trop Facile
3738,419,2019,Art,11,1,QROC,93,73,39,34,1.27,53.42,39,54,41.48,Difficile,Difficile,Difficile / Difficile
4568,419,2020,Art,11,1,QROC,74,42,26,16,1.76,61.9,26,48,34.68,Difficile,Difficile,Difficile / Difficile
419,420,2015,Art,11,2,QCU,29,15,12,3,1.93,80.0,12,17,41.82,Difficile,Difficile,Difficile / Difficile
1249,420,2016,Art,11,2,QCU,27,24,18,6,1.12,75.0,18,9,65.11,Difficile,Adapte,Difficile / Adapte
2079,420,2017,Art,11,2,QCU,24,20,17,3,1.2,85.0,17,7,71.22,Adapte,Adapte,Adapte / Adapte
2909,420,2018,Art,11,2,QCU,19,13,13,0,1.46,100.0,13,6,67.71,Adapte,Adapte,Adapte / Adapte
3739,420,2019,Art,11,2,QCU,21,21,14,7,1.0,66.67,14,7,68.7,Adapte,Adapte,Adapte / Adapte
4569,420,2020,Art,11,2,QCU,20,15,13,2,1.33,86.67,13,7,64.99,Adapte,Adapte,Adapte / Adapte
420,421,2015,Art,11,3,QCU,84,83,79,4,1.01,95.18,79,5,93.51,Trop Facile,Trop Facile,Trop Facile / Trop Facile
1250,421,2016,Art,11,3,QCU,68,44,8,36,1.55,18.18,8,60,11.11,Difficile,Trop Difficile,Difficile / Trop Difficile
2080,421,2017,Art,11,3,QCU,77,50,9,41,1.54,18.0,9,68,11.5,Difficile,Trop Difficile,Difficile / Trop Difficile
2910,421,2018,Art,11,3,QCU,67,46,9,37,1.46,19.57,9,58,12.72,Difficile,Trop Difficile,Difficile / Trop Difficile
3740,421,2019,Art,11,3,QCU,63,34,24,10,1.85,70.59,24,39,37.86,Difficile,Difficile,Difficile / Difficile
4570,421,2020,Art,11,3,QCU,70,69,52,17,1.01,75.36,52,18,74.03,Difficile,Adapte,Difficile / Adapte
421,422,2015,Art,11,4,QROC,14,8,7,1,1.75,87.5,7,7,47.25,Difficile,Difficile,Difficile / Difficile
1251,422,2016,Art,11,4,QROC,15,7,5,2,2.14,71.43,5,10,30.82,Difficile,Difficile,Difficile / Difficile
2081,422,2017,Art,11,4,QROC,12,8,7,1,1.5,87.5,7,5,54.45,Difficile,Difficile,Difficile / Difficile
2911,422,2018,Art,11,4,QROC,10,7,5,2,1.43,71.43,5,5,54.71,Difficile,Difficile,Difficile / Difficile
3741,422,2019,Art,11,4,QROC,8,5,3,2,1.6,60.0,3,5,41.25,Difficile,Difficile,Difficile / Difficile
4571,422,2020,Art,11,4,QROC,8,8,8,0,1.0,100.0,8,0,98.28,Difficile,Trop Facile,Difficile / Trop Facile
422,423,2015,Art,11,5,QCU,27,23,18,5,1.17,78.26,18,9,66.37,Trop Facile,Adapte,Trop Facile / Adapte
1252,423,2016,Art,11,5,QCU,31,21,19,2,1.48,90.48,19,12,62.1,Adapte,Adapte,Adapte / Adapte
2082,423,2017,Art,11,5,QCU,28,19,19,0,1.47,100.0,19,9,69.1,Adapte,Adapte,Adapte / Adapte
2912,423,2018,Art,11,5,QCU,30,26,20,6,1.15,76.92,20,10,66.19,Adapte,Adapte,Adapte / Adapte
3742,423,2019,Art,11,5,QCU,26,22,16,6,1.18,72.73,16,10,62.49,Adapte,Adapte,Adapte / Adapte
4572,423,2020,Art,11,5,QCU,22,16,13,3,1.38,81.25,13,9,61.01,Adapte,Adapte,Adapte / Adapte
423,424,2015,Art,11,6,QCM,5,4,4,0,1.25,100.0,4,1,89.26,Trop Facile,Trop Facile,Trop Facile / Trop Facile
1253,424,2016,Art,11,6,QCM,5,2,2,0,2.5,100.0,2,3,45.03,Difficile,Difficile,Difficile / Difficile
2083,424,2017,Art,11,6,QCM,6,5,3,2,1.2,60.0,3,3,44.15,Difficile,Difficile,Difficile / Difficile
2913,424,2018,Art,11,6,QCM,7,5,3,2,1.4,60.0,3,4,40.87,Difficile,Difficile,Difficile / Difficile
3743,424,2019,Art,11,6,QCM,7,5,3,2,1.4,60.0,3,4,41.96,Difficile,Difficile,Difficile / Difficile
4573,424,2020,Art,11,6,QCM,8,7,3,4,1.14,42.86,3,5,40.28,Difficile,Difficile,Difficile / Difficile
424,425,2015,Art,11,7,QCU,88,86,79,7,1.02,91.86,79,9,90.21,Facile,Trop Facile,Facile / Trop Facile
1254,425,2016,Art,11,7,QCU,79,63,31,32,1.25,49.21,31,48,39.48,Difficile,Difficile,Difficile / Difficile
2084,425,2017,Art,11,7,QCU,76,58,35,23,1.31,60.34,35,41,45.43,Difficile,Difficile,Difficile / Difficile
2914,425,2018,Art,11,7,QCU,80,77,54,23,1.04,70.13,54,26,67.03,Difficile,Adapte,Difficile / Adapte
3744,425,2019,Art,11,7,QCU,66,54,41,13,1.22,75.93,41,25,61.94,Adapte,Adapte,Adapte / Adapte
4574,425,2020,Art,11,7,QCU,77,69,55,14,1.12,79.71,55,22,71.08,Adapte,Adapte,Adapte / Adapte
425,426,2015,Art,11,8,QCU,77,65,38,27,1.18,58.46,38,39,49.53,Difficile,Difficile,Difficile / Difficile
1255,426,2016,Art,11,8,QCU,68,39,27,12,1.74,69.23,27,41,40.11,Difficile,Difficile,Difficile / Difficile
2085,426,2017,Art,11,8,QCU,58,45,26,19,1.29,57.78,26,32,44.78,Difficile,Difficile,Difficile / Difficile
2915,426,2018,Art,11,8,QCU,66,43,31,12,1.53,72.09,31,35,46.36,Difficile,Difficile,Difficile / Difficile
3745,426,2019,Art,11,8,QCU,68,62,33,29,1.1,53.23,33,35,49.25,Difficile,Difficile,Difficile / Difficile
4575,426,2020,Art,11,8,QCU,56,46,14,32,1.22,30.43,14,42,25.16,Difficile,Difficile,Difficile / Difficile
426,427,2015,Art,11,9,QROC,20,8,1,7,2.5,12.5,1,19,6.3,Difficile,Trop Difficile,Difficile / Trop Difficile
1256,427,2016,Art,11,9,QROC,19,9,6,3,2.11,66.67,6,13,32.74,Difficile,Difficile,Difficile / Difficile
2086,427,2017,Art,11,9,QROC,23,21,20,1,1.1,95.24,20,3,88.62,Difficile,Trop Facile,Difficile / Trop Facile
2916,427,2018,Art,11,9,QROC,22,19,17,2,1.16,89.47,17,5,77.46,Difficile,Facile,Difficile / Facile
3746,427,2019,Art,11,9,QROC,23,20,8,12,1.15,40.0,8,15,34.88,Difficile,Difficile,Difficile / Difficile
4576,427,2020,Art,11,9,QROC,26,24,9,15,1.08,37.5,9,17,35.92,Difficile,Difficile,Difficile / Difficile
427,428,2015,Art,11,10,QCM,13,11,10,1,1.18,90.91,10,3,77.97,Facile,Facile,Facile / Facile
1257,428,2016,Art,11,10,QCM,16,11,9,2,1.45,81.82,9,7,57.67,Difficile,Difficile,Difficile / Difficile
2087,428,2017,Art,11,10,QCM,13,10,5,5,1.3,50.0,5,8,39.94,Difficile,Difficile,Difficile / Difficile
2917,428,2018,Art,11,10,QCM,10,6,4,2,1.67,66.67,4,6,40.12,Difficile,Difficile,Difficile / Difficile
3747,428,2019,Art,11,10,QCM,8,5,4,1,1.6,80.0,4,4,55.47,Difficile,Difficile,Difficile / Difficile
4577,428,2020,Art,11,10,QCM,10,7,6,1,1.43,85.71,6,4,58.19,Difficile,Difficile,Difficile / Difficile
428,429,2015,Art,11,11,QROC,8,6,5,1,1.33,83.33,5,3,58.21,Difficile,Difficile,Difficile / Difficile
1258,429,2016,Art,11,11,QROC,9,6,4,2,1.5,66.67,4,5,41.49,Difficile,Difficile,Difficile / Difficile
2088,429,2017,Art,11,11,QROC,11,9,5,4,1.22,55.56,5,6,41.88,Difficile,Difficile,Difficile / Difficile
2918,429,2018,Art,11,11,QROC,10,9,4,5,1.11,44.44,4,6,43.66,Difficile,Difficile,Difficile / Difficile
3748,429,2019,Art,11,11,QROC,8,7,3,4,1.14,42.86,3,5,40.78,Difficile,Difficile,Difficile / Difficile
4578,429,2020,Art,11,11,QROC,9,7,3,4,1.29,42.86,3,6,31.05,Difficile,Difficile,Difficile / Difficile
429,430,2015,Art,11,12,QCM,27,18,14,4,1.5,77.78,14,13,51.03,Facile,Difficile,Facile / Difficile
1259,430,2016,Art,11,12,QCM,32,17,9,8,1.88,52.94,9,23,26.97,Difficile,Difficile,Difficile / Difficile
2089,430,2017,Art,11,12,QCM,33,32,22,10,1.03,68.75,22,11,66.31,Difficile,Adapte,Difficile / Adapte
2919,430,2018,Art,11,12,QCM,37,32,22,10,1.16,68.75,22,15,60.28,Adapte,Adapte,Adapte / Adapte
3749,430,2019,Art,11,12,QCM,41,30,25,5,1.37,83.33,25,16,61.83,Adapte,Adapte,Adapte / Adapte
4579,430,2020,Art,11,12,QCM,47,46,28,18,1.02,60.87,28,19,60.48,Adapte,Adapte,Adapte / Adapte
430,431,2015,Art,11,13,QCU,13,11,11,0,1.18,100.0,11,2,83.23,Facile,Facile,Facile / Facile
1260,431,2016,Art,11,13,QCU,10,8,6,2,1.25,75.0,6,4,55.81,Difficile,Difficile,Difficile / Difficile
2090,431,2017,Art,11,13,QCU,12,5,4,1,2.4,80.0,4,8,33.15,Difficile,Difficile,Difficile / Difficile
2920,431,2018,Art,11,13,QCU,13,12,6,6,1.08,50.0,6,7,43.56,Difficile,Difficile,Difficile / Difficile
3750,431,2019,Art,11,13,QCU,15,8,4,4,1.88,50.0,4,11,25.33,Difficile,Difficile,Difficile / Difficile
4580,431,2020,Art,11,13,QCU,15,15,14,1,1.0,93.33,14,1,91.53,Difficile,Trop Facile,Difficile / Trop Facile
431,432,2015,Art,11,14,QCU,37,30,22,8,1.23,73.33,22,15,58.69,Trop Facile,Difficile,Trop Facile / Difficile
1261,432,2016,Art,11,14,QCU,42,34,15,19,1.24,44.12,15,27,34.88,Difficile,Difficile,Difficile / Difficile
2091,432,2017,Art,11,14,QCU,48,42,14,28,1.14,33.33,14,34,28.51,Difficile,Difficile,Difficile / Difficile
2921,432,2018,Art,11,14,QCU,46,34,13,21,1.35,38.24,13,33,28.12,Difficile,Difficile,Difficile / Difficile
3751,432,2019,Art,11,14,QCU,39,34,17,17,1.15,50.0,17,22,42.48,Difficile,Difficile,Difficile / Difficile
4581,432,2020,Art,11,14,QCU,37,32,29,3,1.16,90.62,29,8,78.08,Difficile,Facile,Difficile / Facile
432,433,2015,Art,12,1,QCU,68,58,44,14,1.17,75.86,44,24,64.73,Adapte,Adapte,Adapte / Adapte
1262,433,2016,Art,12,1,QCU,70,56,44,12,1.25,78.57,44,26,63.53,Adapte,Adapte,Adapte / Adapte
2092,433,2017,Art,12,1,QCU,67,62,47,15,1.08,75.81,47,20,69.48,Adapte,Adapte,Adapte / Adapte
2922,433,2018,Art,12,1,QCU,73,48,44,4,1.52,91.67,44,29,60.8,Adapte,Adapte,Adapte / Adapte
3752,433,2019,Art,12,1,QCU,65,43,42,1,1.51,97.67,42,23,63.97,Adapte,Adapte,Adapte / Adapte
4582,433,2020,Art,12,1,QCU,63,54,40,14,1.17,74.07,40,23,63.45,Adapte,Adapte,Adapte / Adapte
433,434,2015,Art,13,1,QROC,68,49,42,7,1.39,85.71,42,26,61.16,Trop Facile,Adapte,Trop Facile / Adapte
1263,434,2016,Art,13,1,QROC,59,40,40,0,1.48,100.0,40,19,67.7,Adapte,Adapte,Adapte / Adapte
2093,434,2017,Art,13,1,QROC,59,56,36,20,1.05,64.29,36,23,61.68,Adapte,Adapte,Adapte / Adapte
2923,434,2018,Art,13,1,QROC,66,66,47,19,1.0,71.21,47,19,71.07,Adapte,Adapte,Adapte / Adapte
3753,434,2019,Art,13,1,QROC,59,50,36,14,1.18,72.0,36,23,61.78,Adapte,Adapte,Adapte / Adapte
4583,434,2020,Art,13,1,QROC,47,40,35,5,1.18,87.5,35,12,73.49,Adapte,Adapte,Adapte / Adapte
434,435,2015,Art,13,2,QCU,100,90,90,0,1.11,100.0,90,10,90.19,Trop Facile,Trop Facile,Trop Facile / Trop Facile
1264,435,2016,Art,13,2,QCU,102,90,43,47,1.13,47.78,43,59,41.9,Difficile,Difficile,Difficile / Difficile
2094,435,2017,Art,13,2,QCU,92,92,47,45,1.0,51.09,47,45,50.67,Difficile,Difficile,Difficile / Difficile
2924,435,2018,Art,13,2,QCU,94,55,46,9,1.71,83.64,46,48,49.07,Difficile,Difficile,Difficile / Difficile
3754,435,2019,Art,13,2,QCU,82,63,25,38,1.3,39.68,25,57,30.76,Difficile,Difficile,Difficile / Difficile
4584,435,2020,Art,13,2,QCU,94,43,28,15,2.19,65.12,28,66,29.73,Difficile,Difficile,Difficile / Difficile
435,436,2015,Art,13,3,QCU,88,80,79,1,1.1,98.75,79,9,90.07,Trop Facile,Trop Facile,Trop Facile / Trop Facile
1265,436,2016,Art,13,3,QCU,105,38,30,8,2.76,78.95,30,75,28.67,Difficile,Difficile,Difficile / Difficile
2095,436,2017,Art,13,3,QCU,111,81,65,16,1.37,80.25,65,46,58.69,Difficile,Difficile,Difficile / Difficile
2925,436,2018,Art,13,3,QCU,110,46,43,3,2.39,93.48,43,67,39.1,Difficile,Difficile,Difficile / Difficile
3755,436,2019,Art,13,3,QCU,129,119,47,72,1.08,39.5,47,82,36.67,Difficile,Difficile,Difficile / Difficile
4585,436,2020,Art,13,3,QCU,116,66,57,9,1.76,86.36,57,59,48.94,Difficile,Difficile,Difficile / Difficile
436,437,2015,Art,13,4,QCM,75,70,70,0,1.07,100.0,70,5,93.49,Trop Facile,Trop Facile,Trop Facile / Trop Facile
1266,437,2016,Art,13,4,QCM,89,87,85,2,1.02,97.7,85,4,95.56,Difficile,Trop Facile,Difficile / Trop Facile
2096,437,2017,Art,13,4,QCM,106,105,91,14,1.01,86.67,91,15,86.13,Difficile,Trop Facile,Difficile / Trop Facile
2926,437,2018,Art,13,4,QCM,101,56,55,1,1.8,98.21,55,46,54.91,Difficile,Difficile,Difficile / Difficile
3756,437,2019,Art,13,4,QCM,100,83,36,47,1.2,43.37,36,64,36.11,Difficile,Difficile,Difficile / Difficile
4586,437,2020,Art,13,4,QCM,119,65,58,7,1.83,89.23,58,61,48.47,Difficile,Difficile,Difficile / Difficile
437,438,2015,Art,13,5,QCU,84,79,53,26,1.06,67.09,53,31,62.57,Trop Facile,Adapte,Trop Facile / Adapte
1267,438,2016,Art,13,5,QCU,85,62,59,3,1.37,95.16,59,26,69.91,Adapte,Adapte,Adapte / Adapte
2097,438,2017,Art,13,5,QCU,99,74,63,11,1.34,85.14,63,36,63.57,Adapte,Adapte,Adapte / Adapte
2927,438,2018,Art,13,5,QCU,104,97,75,22,1.07,77.32,75,29,71.87,Adapte,Adapte,Adapte / Adapte
3757,438,2019,Art,13,5,QCU,87,85,56,29,1.02,65.88,56,31,64.7,Adapte,Adapte,Adapte / Adapte
4587,438,2020,Art,13,5,QCU,78,57,51,6,1.37,89.47,51,27,65.45,Adapte,Adapte,Adapte / Adapte
438,439,2015,Art,13,6,QCM,62,57,50,7,1.09,87.72,50,12,80.12,Facile,Facile,Facile / Facile
1268,439,2016,Art,13,6,QCM,56,51,17,34,1.1,33.33,17,39,30.92,Difficile,Difficile,Difficile / Difficile
2098,439,2017,Art,13,6,QCM,50,41,40,1,1.22,97.56,40,10,79.09,Difficile,Facile,Difficile / Facile
2928,439,2018,Art,13,6,QCM,49,43,22,21,1.14,51.16,22,27,43.9,Difficile,Difficile,Difficile / Difficile
3758,439,2019,Art,13,6,QCM,49,46,20,26,1.07,43.48,20,29,41.53,Difficile,Difficile,Difficile / Difficile
4588,439,2020,Art,13,6,QCM,43,19,19,0,2.26,100.0,19,24,43.97,Difficile,Difficile,Difficile / Difficile
439,440,2015,Art,13,7,QCU,11,11,10,1,1.0,90.91,10,1,95.41,Trop Facile,Trop Facile,Trop Facile / Trop Facile
1269,440,2016,Art,13,7,QCU,11,9,6,3,1.22,66.67,6,5,51.58,Difficile,Difficile,Difficile / Difficile
2099,440,2017,Art,13,7,QCU,9,8,7,1,1.12,87.5,7,2,76.87,Difficile,Facile,Difficile / Facile
2929,440,2018,Art,13,7,QCU,8,6,5,1,1.33,83.33,5,3,65.28,Difficile,Adapte,Difficile / Adapte
3759,440,2019,Art,13,7,QCU,9,8,6,2,1.12,75.0,6,3,62.05,Adapte,Adapte,Adapte / Adapte
4589,440,2020,Art,13,7,QCU,10,8,7,1,1.25,87.5,7,3,74.77,Adapte,Adapte,Adapte / Adapte
440,441,2015,Art,13,8,QCU,45,45,28,17,1.0,62.22,28,17,63.25,Adapte,Adapte,Adapte / Adapte
1270,441,2016,Art,13,8,QCU,37,25,23,2,1.48,92.0,23,14,61.99,Adapte,Adapte,Adapte / Adapte
2100,441,2017,Art,13,8,QCU,44,30,27,3,1.47,90.0,27,17,60.55,Adapte,Adapte,Adapte / Adapte
2930,441,2018,Art,13,8,QCU,39,33,29,4,1.18,87.88,29,10,73.75,Adapte,Adapte,Adapte / Adapte
3760,441,2019,Art,13,8,QCU,31,27,20,7,1.15,74.07,20,11,63.82,Adapte,Adapte,Adapte / Adapte
4590,441,2020,Art,13,8,QCU,35,31,25,6,1.13,80.65,25,10,70.25,Adapte,Adapte,Adapte / Adapte
441,442,2015,Art,13,9,QROC,12,11,6,5,1.09,54.55,6,6,46.67,Difficile,Difficile,Difficile / Difficile
1271,442,2016,Art,13,9,QROC,10,6,3,3,1.67,50.0,3,7,29.79,Difficile,Difficile,Difficile / Difficile
2101,442,2017,Art,13,9,QROC,10,9,8,1,1.11,88.89,8,2,84.35,Difficile,Facile,Difficile / Facile
2931,442,2018,Art,13,9,QROC,8,6,2,4,1.33,33.33,2,6,28.75,Difficile,Difficile,Difficile / Difficile
3761,442,2019,Art,13,9,QROC,9,8,2,6,1.12,25.0,2,7,26.23,Difficile,Difficile,Difficile / Difficile
4591,442,2020,Art,13,9,QROC,11,9,6,3,1.22,66.67,6,5,55.88,Difficile,Difficile,Difficile / Difficile
442,443,2015,Art,13,10,QCM,73,60,49,11,1.22,81.67,49,24,66.66,Adapte,Adapte,Adapte / Adapte
1272,443,2016,Art,13,10,QCM,73,60,46,14,1.22,76.67,46,27,62.99,Adapte,Adapte,Adapte / Adapte
2102,443,2017,Art,13,10,QCM,76,66,53,13,1.15,80.3,53,23,69.38,Adapte,Adapte,Adapte / Adapte
2932,443,2018,Art,13,10,QCM,80,61,50,11,1.31,81.97,50,30,62.31,Adapte,Adapte,Adapte / Adapte
3762,443,2019,Art,13,10,QCM,83,73,57,16,1.14,78.08,57,26,68.66,Adapte,Adapte,Adapte / Adapte
4592,443,2020,Art,13,10,QCM,77,67,48,19,1.15,71.64,48,29,62.47,Adapte,Adapte,Adapte / Adapte
443,444,2015,Art,13,11,QCU,63,31,12,19,2.03,38.71,12,51,18.34,Adapte,Trop Difficile,Adapte / Trop Difficile
1273,444,2016,Art,13,11,QCU,66,32,2,30,2.06,6.25,2,64,2.79,Difficile,Trop Difficile,Difficile / Trop Difficile
2103,444,2017,Art,13,11,QCU,68,66,65,1,1.03,98.48,65,3,95.97,Difficile,Trop Facile,Difficile / Trop Facile
2933,444,2018,Art,13,11,QCU,80,46,42,4,1.74,91.3,42,38,52.35,Difficile,Difficile,Difficile / Difficile
3763,444,2019,Art,13,11,QCU,91,58,25,33,1.57,43.1,25,66,27.77,Difficile,Difficile,Difficile / Difficile
4593,444,2020,Art,13,11,QCU,89,65,27,38,1.37,41.54,27,62,30.55,Difficile,Difficile,Difficile / Difficile
444,445,2015,Art,13,12,QCU,81,79,7,72,1.03,8.86,7,74,8.03,Trop Difficile,Trop Difficile,Trop Difficile / Trop Difficile
1274,445,2016,Art,13,12,QCU,65,39,26,13,1.67,66.67,26,39,39.87,Difficile,Difficile,Difficile / Difficile
2104,445,2017,Art,13,12,QCU,72,69,56,13,1.04,81.16,56,16,77.72,Difficile,Facile,Difficile / Facile
2934,445,2018,Art,13,12,QCU,76,38,30,8,2.0,78.95,30,46,39.7,Difficile,Difficile,Difficile / Difficile
3764,445,2019,Art,13,12,QCU,79,56,36,20,1.41,64.29,36,43,45.92,Difficile,Difficile,Difficile / Difficile
4594,445,2020,Art,13,12,QCU,65,62,30,32,1.05,48.39,30,35,45.46,Difficile,Difficile,Difficile / Difficile
445,446,2015,Art,13,13,QCU,79,63,24,39,1.25,38.1,24,55,30.13,Difficile,Difficile,Difficile / Difficile
1275,446,2016,Art,13,13,QCU,82,80,45,35,1.02,56.25,45,37,54.85,Difficile,Difficile,Difficile / Difficile
2105,446,2017,Art,13,13,QCU,70,66,52,14,1.06,78.79,52,18,74.11,Difficile,Adapte,Difficile / Adapte
2935,446,2018,Art,13,13,QCU,58,54,36,18,1.07,66.67,36,22,62.46,Adapte,Adapte,Adapte / Adapte
3765,446,2019,Art,13,13,QCU,69,58,50,8,1.19,86.21,50,19,72.1,Adapte,Adapte,Adapte / Adapte
4595,446,2020,Art,13,13,QCU,67,54,46,8,1.24,85.19,46,21,68.42,Adapte,Adapte,Adapte / Adapte
446,447,2015,Art,13,14,QCU,35,18,9,9,1.94,50.0,9,26,26.0,Difficile,Difficile,Difficile / Difficile
1276,447,2016,Art,13,14,QCU,42,41,12,29,1.02,29.27,12,30,28.59,Difficile,Difficile,Difficile / Difficile
2106,447,2017,Art,13,14,QCU,47,37,26,11,1.27,70.27,26,21,54.45,Difficile,Difficile,Difficile / Difficile
2936,447,2018,Art,13,14,QCU,45,44,30,14,1.02,68.18,30,15,67.28,Difficile,Adapte,Difficile / Adapte
3766,447,2019,Art,13,14,QCU,43,38,31,7,1.13,81.58,31,12,71.27,Adapte,Adapte,Adapte / Adapte
4596,447,2020,Art,13,14,QCU,39,33,24,9,1.18,72.73,24,15,62.5,Adapte,Adapte,Adapte / Adapte
447,448,2015,Art,14,1,QCU,25,23,19,4,1.09,82.61,19,6,77.14,Facile,Facile,Facile / Facile
1277,448,2016,Art,14,1,QCU,26,21,14,7,1.24,66.67,14,12,54.36,Difficile,Difficile,Difficile / Difficile
2107,448,2017,Art,14,1,QCU,29,16,10,6,1.81,62.5,10,19,35.6,Difficile,Difficile,Difficile / Difficile
2937,448,2018,Art,14,1,QCU,24,16,2,14,1.5,12.5,2,22,6.92,Difficile,Trop Difficile,Difficile / Trop Difficile
3767,448,2019,Art,14,1,QCU,24,16,2,14,1.5,12.5,2,22,7.88,Difficile,Trop Difficile,Difficile / Trop Difficile
4597,448,2020,Art,14,1,QCU,29,18,12,6,1.61,66.67,12,17,40.64,Difficile,Difficile,Difficile / Difficile
448,449,2015,Art,14,2,QCU,23,17,14,3,1.35,82.35,14,9,60.69,Trop Difficile,Adapte,Trop Difficile / Adapte
1278,449,2016,Art,14,2,QCU,28,24,18,6,1.17,75.0,18,10,64.06,Adapte,Adapte,Adapte / Adapte
2108,449,2017,Art,14,2,QCU,25,19,15,4,1.32,78.95,15,10,61.86,Adapte,Adapte,Adapte / Adapte
2938,449,2018,Art,14,2,QCU,30,21,20,1,1.43,95.24,20,10,66.43,Adapte,Adapte,Adapte / Adapte
3768,449,2019,Art,14,2,QCU,31,30,20,10,1.03,66.67,20,11,65.4,Adapte,Adapte,Adapte / Adapte
4598,449,2020,Art,14,2,QCU,36,27,26,1,1.33,96.3,26,10,71.64,Adapte,Adapte,Adapte / Adapte
449,450,2015,Art,14,3,QROC,66,58,24,34,1.14,41.38,24,42,35.95,Trop Difficile,Difficile,Trop Difficile / Difficile
1279,450,2016,Art,14,3,QROC,70,63,59,4,1.11,93.65,59,11,84.16,Difficile,Facile,Difficile / Facile
2109,450,2017,Art,14,3,QROC,77,71,33,38,1.08,46.48,33,44,43.07,Difficile,Difficile,Difficile / Difficile
2939,450,2018,Art,14,3,QROC,81,75,26,49,1.08,34.67,26,55,32.28,Difficile,Difficile,Difficile / Difficile
3769,450,2019,Art,14,3,QROC,81,58,51,7,1.4,87.93,51,30,62.97,Difficile,Adapte,Difficile / Adapte
4599,450,2020,Art,14,3,QROC,66,65,40,25,1.02,61.54,40,26,61.33,Adapte,Adapte,Adapte / Adapte
450,451,2015,Art,14,4,QCU,93,92,79,13,1.01,85.87,79,14,84.46,Difficile,Facile,Difficile / Facile
1280,451,2016,Art,14,4,QCU,110,67,62,5,1.64,92.54,62,48,56.64,Difficile,Difficile,Difficile / Difficile
2110,451,2017,Art,14,4,QCU,114,110,48,62,1.04,43.64,48,66,42.28,Difficile,Difficile,Difficile / Difficile
2940,451,2018,Art,14,4,QCU,127,116,106,10,1.09,91.38,106,21,83.44,Difficile,Facile,Difficile / Facile
3770,451,2019,Art,14,4,QCU,107,74,49,25,1.45,66.22,49,58,45.68,Difficile,Difficile,Difficile / Difficile
4600,451,2020,Art,14,4,QCU,108,105,101,4,1.03,96.19,101,7,93.48,Difficile,Trop Facile,Difficile / Trop Facile
451,452,2015,Art,14,5,QCM,7,4,2,2,1.75,50.0,2,5,28.29,Difficile,Difficile,Difficile / Difficile
1281,452,2016,Art,14,5,QCM,7,3,3,0,2.33,100.0,3,4,41.55,Difficile,Difficile,Difficile / Difficile
2111,452,2017,Art,14,5,QCM,7,6,4,2,1.17,66.67,4,3,50.72,Difficile,Difficile,Difficile / Difficile
2941,452,2018,Art,14,5,QCM,7,5,4,1,1.4,80.0,4,3,53.77,Difficile,Difficile,Difficile / Difficile
3771,452,2019,Art,14,5,QCM,6,6,3,3,1.0,50.0,3,3,50.9,Difficile,Difficile,Difficile / Difficile
4601,452,2020,Art,14,5,QCM,6,5,3,2,1.2,60.0,3,3,53.6,Difficile,Difficile,Difficile / Difficile
452,453,2015,Art,14,6,QROC,29,25,23,2,1.16,92.0,23,6,78.12,Facile,Facile,Facile / Facile
1282,453,2016,Art,14,6,QROC,34,28,17,11,1.21,60.71,17,17,51.06,Difficile,Difficile,Difficile / Difficile
2112,453,2017,Art,14,6,QROC,39,18,2,16,2.17,11.11,2,37,4.22,Difficile,Trop Difficile,Difficile / Trop Difficile
2942,453,2018,Art,14,6,QROC,42,18,17,1,2.33,94.44,17,25,41.16,Difficile,Difficile,Difficile / Difficile
3772,453,2019,Art,14,6,QROC,43,18,18,0,2.39,100.0,18,25,40.86,Difficile,Difficile,Difficile / Difficile
4602,453,2020,Art,14,6,QROC,50,45,12,33,1.11,26.67,12,38,23.92,Difficile,Trop Difficile,Difficile / Trop Difficile
453,454,2015,Art,14,7,QCM,52,48,43,5,1.08,89.58,43,9,82.17,Facile,Facile,Facile / Facile
1283,454,2016,Art,14,7,QCM,56,47,19,28,1.19,40.43,19,37,34.58,Difficile,Difficile,Difficile / Difficile
2113,454,2017,Art,14,7,QCM,50,29,23,6,1.72,79.31,23,27,46.5,Difficile,Difficile,Difficile / Difficile
2943,454,2018,Art,14,7,QCM,47,45,9,36,1.04,20.0,9,38,20.13,Difficile,Trop Difficile,Difficile / Trop Difficile
3773,454,2019,Art,14,7,QCM,49,44,38,6,1.11,86.36,38,11,77.2,Difficile,Facile,Difficile / Facile
4603,454,2020,Art,14,7,QCM,46,36,24,12,1.28,66.67,24,22,52.29,Difficile,Difficile,Difficile / Difficile
454,455,2015,Art,15,1,QCU,19,15,9,6,1.27,60.0,9,10,48.11,Difficile,Difficile,Difficile / Difficile
1284,455,2016,Art,15,1,QCU,16,11,5,6,1.45,45.45,5,11,30.92,Difficile,Difficile,Difficile / Difficile
2114,455,2017,Art,15,1,QCU,15,15,4,11,1.0,26.67,4,11,25.08,Difficile,Difficile,Difficile / Difficile
2944,455,2018,Art,15,1,QCU,16,8,5,3,2.0,62.5,5,11,30.71,Difficile,Difficile,Difficile / Difficile
3774,455,2019,Art,15,1,QCU,15,12,2,10,1.25,16.67,2,13,10.32,Difficile,Trop Difficile,Difficile / Trop Difficile
4604,455,2020,Art,15,1,QCU,16,13,8,5,1.23,61.54,8,8,52.31,Difficile,Difficile,Difficile / Difficile
455,456,2015,Art,15,2,QCM,25,24,23,1,1.04,95.83,23,2,93.58,Trop Facile,Trop Facile,Trop Facile / Trop Facile
1285,456,2016,Art,15,2,QCM,26,26,26,0,1.0,100.0,26,0,99.93,Difficile,Trop Facile,Difficile / Trop Facile
2115,456,2017,Art,15,2,QCM,24,22,16,6,1.09,72.73,16,8,65.91,Difficile,Adapte,Difficile / Adapte
2945,456,2018,Art,15,2,QCM,23,20,17,3,1.15,85.0,17,6,71.8,Adapte,Adapte,Adapte / Adapte
3775,456,2019,Art,15,2,QCM,22,21,16,5,1.05,76.19,16,6,70.49,Adapte,Adapte,Adapte / Adapte
4605,456,2020,Art,15,2,QCM,26,26,17,9,1.0,65.38,17,9,64.65,Adapte,Adapte,Adapte / Adapte
456,457,2015,Art,15,3,QCM,72,67,61,6,1.07,91.04,61,11,84.89,Trop Difficile,Facile,Trop Difficile / Facile
1286,457,2016,Art,15,3,QCM,65,24,11,13,2.71,45.83,11,54,17.11,Difficile,Trop Difficile,Difficile / Trop Difficile
2116,457,2017,Art,15,3,QCM,53,35,26,9,1.51,74.29,26,27,49.58,Difficile,Difficile,Difficile / Difficile
2946,457,2018,Art,15,3,QCM,58,21,15,6,2.76,71.43,15,43,25.88,Difficile,Difficile,Difficile / Difficile
3776,457,2019,Art,15,3,QCM,48,44,22,22,1.09,50.0,22,26,45.6,Difficile,Difficile,Difficile / Difficile
4606,457,2020,Art,15,3,QCM,48,47,43,4,1.02,91.49,43,5,89.51,Difficile,Trop Facile,Difficile / Trop Facile
457,458,2015,Art,15,4,QCU,57,52,23,29,1.1,44.23,23,34,39.57,Difficile,Difficile,Difficile / Difficile
1287,458,2016,Art,15,4,QCU,64,29,21,8,2.21,72.41,21,43,32.92,Difficile,Difficile,Difficile / Difficile
2117,458,2017,Art,15,4,QCU,64,50,17,33,1.28,34.0,17,47,26.53,Difficile,Difficile,Difficile / Difficile
2947,458,2018,Art,15,4,QCU,63,24,16,8,2.62,66.67,16,47,25.03,Difficile,Difficile,Difficile / Difficile
3777,458,2019,Art,15,4,QCU,74,45,39,6,1.64,86.67,39,35,52.72,Difficile,Difficile,Difficile / Difficile
4607,458,2020,Art,15,4,QCU,68,59,49,10,1.15,83.05,49,19,71.41,Difficile,Adapte,Difficile / Adapte
458,459,2015,Art,15,5,QCU,6,4,3,1,1.5,75.0,3,3,53.12,Difficile,Difficile,Difficile / Difficile
1288,459,2016,Art,15,5,QCU,7,3,0,3,2.33,0.0,0,7,0.04,Difficile,Trop Difficile,Difficile / Trop Difficile
2118,459,2017,Art,15,5,QCU,8,7,2,5,1.14,28.57,2,6,30.87,Difficile,Difficile,Difficile / Difficile
2948,459,2018,Art,15,5,QCU,10,4,3,1,2.5,75.0,3,7,31.76,Difficile,Difficile,Difficile / Difficile
3778,459,2019,Art,15,5,QCU,9,4,3,1,2.25,75.0,3,6,35.37,Difficile,Difficile,Difficile / Difficile
4608,459,2020,Art,15,5,QCU,11,7,6,1,1.57,85.71,6,5,57.55,Difficile,Difficile,Difficile / Difficile
459,460,2015,Art,15,6,QROC,48,38,29,9,1.26,76.32,29,19,60.19,Trop Facile,Adapte,Trop Facile / Adapte
1289,460,2016,Art,15,6,QROC,55,35,33,2,1.57,94.29,33,22,60.45,Adapte,Adapte,Adapte / Adapte
2119,460,2017,Art,15,6,QROC,59,44,42,2,1.34,95.45,42,17,71.62,Adapte,Adapte,Adapte / Adapte
2949,460,2018,Art,15,6,QROC,61,57,40,17,1.07,70.18,40,21,66.19,Adapte,Adapte,Adapte / Adapte
3779,460,2019,Art,15,6,QROC,67,49,46,3,1.37,93.88,46,21,68.95,Adapte,Adapte,Adapte / Adapte
4609,460,2020,Art,15,6,QROC,67,49,45,4,1.37,91.84,45,22,67.49,Adapte,Adapte,Adapte / Adapte
460,461,2015,Art,15,7,QCM,43,31,27,4,1.39,87.1,27,16,62.18,Adapte,Adapte,Adapte / Adapte
1290,461,2016,Art,15,7,QCM,45,32,29,3,1.41,90.62,29,16,63.86,Adapte,Adapte,Adapte / Adapte
2120,461,2017,Art,15,7,QCM,43,40,26,14,1.07,65.0,26,17,61.0,Adapte,Adapte,Adapte / Adapte
2950,461,2018,Art,15,7,QCM,38,34,26,8,1.12,76.47,26,12,69.71,Adapte,Adapte,Adapte / Adapte
3780,461,2019,Art,15,7,QCM,46,44,32,12,1.05,72.73,32,14,70.27,Adapte,Adapte,Adapte / Adapte
4610,461,2020,Art,15,7,QCM,45,42,30,12,1.07,71.43,30,15,67.53,Adapte,Adapte,Adapte / Adapte
461,462,2015,Art,15,8,QCU,8,8,5,3,1.0,62.5,5,3,65.2,Adapte,Adapte,Adapte / Adapte
1291,462,2016,Art,15,8,QCU,6,5,4,1,1.2,80.0,4,2,63.96,Adapte,Adapte,Adapte / Adapte
2121,462,2017,Art,15,8,QCU,5,4,3,1,1.25,75.0,3,2,68.93,Adapte,Adapte,Adapte / Adapte
2951,462,2018,Art,15,8,QCU,4,3,2,1,1.33,66.67,2,2,61.91,Adapte,Adapte,Adapte / Adapte
3781,462,2019,Art,15,8,QCU,5,4,3,1,1.25,75.0,3,2,61.2,Adapte,Adapte,Adapte / Adapte
4611,462,2020,Art,15,8,QCU,6,5,4,1,1.2,80.0,4,2,62.04,Adapte,Adapte,Adapte / Adapte
462,463,2015,Art,16,1,QCU,42,28,26,2,1.5,92.86,26,16,62.16,Difficile,Adapte,Difficile / Adapte
1292,463,2016,Art,16,1,QCU,37,32,22,10,1.16,68.75,22,15,60.67,Adapte,Adapte,Adapte / Adapte
2122,463,2017,Art,16,1,QCU,43,39,29,10,1.1,74.36,29,14,66.85,Adapte,Adapte,Adapte / Adapte
2952,463,2018,Art,16,1,QCU,49,43,35,8,1.14,81.4,35,14,72.14,Adapte,Adapte,Adapte / Adapte
3782,463,2019,Art,16,1,QCU,57,40,40,0,1.43,100.0,40,17,69.43,Adapte,Adapte,Adapte / Adapte
4612,463,2020,Art,16,1,QCU,55,44,41,3,1.25,93.18,41,14,73.67,Adapte,Adapte,Adapte / Adapte
463,464,2015,Art,16,2,QCU,100,99,99,0,1.01,100.0,99,1,99.25,Trop Facile,Trop Facile,Trop Facile / Trop Facile
1293,464,2016,Art,16,2,QCU,89,76,48,28,1.17,63.16,48,41,53.49,Difficile,Difficile,Difficile / Difficile
2123,464,2017,Art,16,2,QCU,80,47,20,27,1.7,42.55,20,60,25.05,Difficile,Difficile,Difficile / Difficile
2953,464,2018,Art,16,2,QCU,89,87,71,16,1.02,81.61,71,18,80.06,Difficile,Facile,Difficile / Facile
3783,464,2019,Art,16,2,QCU,86,40,26,14,2.15,65.0,26,60,30.79,Difficile,Difficile,Difficile / Difficile
4613,464,2020,Art,16,2,QCU,74,69,33,36,1.07,47.83,33,41,44.24,Difficile,Difficile,Difficile / Difficile
464,465,2015,Art,17,1,QCU,40,15,5,10,2.67,33.33,5,35,12.38,Trop Difficile,Trop Difficile,Trop Difficile / Trop Difficile
1294,465,2016,Art,17,1,QCU,33,26,24,2,1.27,92.31,24,9,72.86,Difficile,Adapte,Difficile / Adapte
2124,465,2017,Art,17,1,QCU,37,32,27,5,1.16,84.38,27,10,73.15,Adapte,Adapte,Adapte / Adapte
2954,465,2018,Art,17,1,QCU,43,30,27,3,1.43,90.0,27,16,62.05,Adapte,Adapte,Adapte / Adapte
3784,465,2019,Art,17,1,QCU,42,40,31,9,1.05,77.5,31,11,73.2,Adapte,Adapte,Adapte / Adapte
4614,465,2020,Art,17,1,QCU,45,38,33,5,1.18,86.84,33,12,72.3,Adapte,Adapte,Adapte / Adapte
465,466,2015,Droit,1,1,QCM,21,7,2,5,3.0,28.57,2,19,7.43,Trop Difficile,Trop Difficile,Trop Difficile / Trop Difficile
1295,466,2016,Droit,1,1,QCM,23,19,10,9,1.21,52.63,10,13,41.32,Difficile,Difficile,Difficile / Difficile
2125,466,2017,Droit,1,1,QCM,22,8,8,0,2.75,100.0,8,14,34.43,Difficile,Difficile,Difficile / Difficile
2955,466,2018,Droit,1,1,QCM,24,16,12,4,1.5,75.0,12,12,51.81,Difficile,Difficile,Difficile / Difficile
3785,466,2019,Droit,1,1,QCM,23,14,6,8,1.64,42.86,6,17,26.54,Difficile,Difficile,Difficile / Difficile
4615,466,2020,Droit,1,1,QCM,24,15,10,5,1.6,66.67,10,14,41.52,Difficile,Difficile,Difficile / Difficile
466,467,2015,Droit,1,2,QCM,66,63,56,7,1.05,88.89,56,10,84.92,Facile,Facile,Facile / Facile
1296,467,2016,Droit,1,2,QCM,69,33,30,3,2.09,90.91,30,39,43.41,Difficile,Difficile,Difficile / Difficile
2126,467,2017,Droit,1,2,QCM,69,55,50,5,1.25,90.91,50,19,73.07,Difficile,Adapte,Difficile / Adapte
2956,467,2018,Droit,1,2,QCM,82,72,52,20,1.14,72.22,52,30,63.72,Adapte,Adapte,Adapte / Adapte
3786,467,2019,Droit,1,2,QCM,73,73,52,21,1.0,71.23,52,21,71.14,Adapte,Adapte,Adapte / Adapte
4616,467,2020,Droit,1,2,QCM,66,61,45,16,1.08,73.77,45,21,67.54,Adapte,Adapte,Adapte / Adapte
467,468,2015,Droit,1,3,QCU,23,22,22,0,1.05,100.0,22,1,96.06,Trop Facile,Trop Facile,Trop Facile / Trop Facile
1297,468,2016,Droit,1,3,QCU,28,26,20,6,1.08,76.92,20,8,70.69,Difficile,Adapte,Difficile / Adapte
2127,468,2017,Droit,1,3,QCU,26,24,18,6,1.08,75.0,18,8,69.72,Adapte,Adapte,Adapte / Adapte
2957,468,2018,Droit,1,3,QCU,21,15,15,0,1.4,100.0,15,6,70.86,Adapte,Adapte,Adapte / Adapte
3787,468,2019,Droit,1,3,QCU,19,15,13,2,1.27,86.67,13,6,66.86,Adapte,Adapte,Adapte / Adapte
4617,468,2020,Droit,1,3,QCU,20,16,15,1,1.25,93.75,15,5,72.59,Adapte,Adapte,Adapte / Adapte
468,469,2015,Droit,1,4,QROC,32,22,4,18,1.45,18.18,4,28,12.31,Trop Difficile,Trop Difficile,Trop Difficile / Trop Difficile
1298,469,2016,Droit,1,4,QROC,30,24,14,10,1.25,58.33,14,16,47.06,Difficile,Difficile,Difficile / Difficile
2128,469,2017,Droit,1,4,QROC,34,29,16,13,1.17,55.17,16,18,46.16,Difficile,Difficile,Difficile / Difficile
2958,469,2018,Droit,1,4,QROC,34,29,19,10,1.17,65.52,19,15,54.46,Difficile,Difficile,Difficile / Difficile
3788,469,2019,Droit,1,4,QROC,29,28,23,5,1.04,82.14,23,6,77.83,Difficile,Facile,Difficile / Facile
4618,469,2020,Droit,1,4,QROC,33,15,13,2,2.2,86.67,13,20,40.29,Difficile,Difficile,Difficile / Difficile
469,470,2015,Droit,1,5,QCU,17,17,11,6,1.0,64.71,11,6,66.63,Difficile,Adapte,Difficile / Adapte
1299,470,2016,Droit,1,5,QCU,15,15,10,5,1.0,66.67,10,5,67.83,Adapte,Adapte,Adapte / Adapte
2129,470,2017,Droit,1,5,QCU,14,11,8,3,1.27,72.73,8,6,60.49,Adapte,Adapte,Adapte / Adapte
2959,470,2018,Droit,1,5,QCU,14,12,8,4,1.17,66.67,8,6,60.13,Adapte,Adapte,Adapte / Adapte
3789,470,2019,Droit,1,5,QCU,15,12,11,1,1.25,91.67,11,4,70.45,Adapte,Adapte,Adapte / Adapte
4619,470,2020,Droit,1,5,QCU,16,15,12,3,1.07,80.0,12,4,72.39,Adapte,Adapte,Adapte / Adapte
470,471,2015,Droit,1,6,QCU,30,17,3,14,1.76,17.65,3,27,11.11,Trop Difficile,Trop Difficile,Trop Difficile / Trop Difficile
1300,471,2016,Droit,1,6,QCU,24,21,13,8,1.14,61.9,13,11,54.7,Difficile,Difficile,Difficile / Difficile
2130,471,2017,Droit,1,6,QCU,21,20,8,12,1.05,40.0,8,13,39.69,Difficile,Difficile,Difficile / Difficile
2960,471,2018,Droit,1,6,QCU,19,14,8,6,1.36,57.14,8,11,43.21,Difficile,Difficile,Difficile / Difficile
3790,471,2019,Droit,1,6,QCU,23,21,20,1,1.1,95.24,20,3,86.22,Difficile,Trop Facile,Difficile / Trop Facile
4620,471,2020,Droit,1,6,QCU,21,17,12,5,1.24,70.59,12,9,56.42,Difficile,Difficile,Difficile / Difficile
471,472,2015,Droit,1,7,QCU,49,23,8,15,2.13,34.78,8,41,16.08,Trop Difficile,Trop Difficile,Trop Difficile / Trop Difficile
1301,472,2016,Droit,1,7,QCU,50,28,9,19,1.79,32.14,9,41,18.68,Difficile,Trop Difficile,Difficile / Trop Difficile
2131,472,2017,Droit,1,7,QCU,54,20,19,1,2.7,95.0,19,35,34.74,Difficile,Difficile,Difficile / Difficile
2961,472,2018,Droit,1,7,QCU,65,45,28,17,1.44,62.22,28,37,43.82,Difficile,Difficile,Difficile / Difficile
3791,472,2019,Droit,1,7,QCU,74,73,71,2,1.01,97.26,71,3,96.15,Difficile,Trop Facile,Difficile / Trop Facile
4621,472,2020,Droit,1,7,QCU,87,56,23,33,1.55,41.07,23,64,26.09,Difficile,Difficile,Difficile / Difficile
472,473,2015,Droit,1,8,QCU,89,81,59,22,1.1,72.84,59,30,65.79,Adapte,Adapte,Adapte / Adapte
1302,473,2016,Droit,1,8,QCU,77,56,47,9,1.38,83.93,47,30,61.45,Adapte,Adapte,Adapte / Adapte
2132,473,2017,Droit,1,8,QCU,81,73,49,24,1.11,67.12,49,32,60.13,Adapte,Adapte,Adapte / Adapte
2962,473,2018,Droit,1,8,QCU,78,67,49,18,1.16,73.13,49,29,62.57,Adapte,Adapte,Adapte / Adapte
3792,473,2019,Droit,1,8,QCU,73,53,53,0,1.38,100.0,53,20,72.66,Adapte,Adapte,Adapte / Adapte
4622,473,2020,Droit,1,8,QCU,87,73,61,12,1.19,83.56,61,26,69.79,Adapte,Adapte,Adapte / Adapte
473,474,2015,Droit,1,9,QCM,96,74,68,6,1.3,91.89,68,28,71.06,Adapte,Adapte,Adapte / Adapte
1303,474,2016,Droit,1,9,QCM,101,86,72,14,1.17,83.72,72,29,71.5,Adapte,Adapte,Adapte / Adapte
2133,474,2017,Droit,1,9,QCM,86,74,57,17,1.16,77.03,57,29,66.05,Adapte,Adapte,Adapte / Adapte
2963,474,2018,Droit,1,9,QCM,88,68,63,5,1.29,92.65,63,25,71.17,Adapte,Adapte,Adapte / Adapte
3793,474,2019,Droit,1,9,QCM,101,87,61,26,1.16,70.11,61,40,60.67,Adapte,Adapte,Adapte / Adapte
4623,474,2020,Droit,1,9,QCM,104,103,72,31,1.01,69.9,72,32,69.19,Adapte,Adapte,Adapte / Adapte
474,475,2015,Droit,2,1,QROC,48,45,43,2,1.07,95.56,43,5,89.07,Trop Difficile,Trop Facile,Trop Difficile / Trop Facile
1304,475,2016,Droit,2,1,QROC,46,43,28,15,1.07,65.12,28,18,60.12,Difficile,Adapte,Difficile / Adapte
2134,475,2017,Droit,2,1,QROC,48,48,31,17,1.0,64.58,31,17,64.14,Adapte,Adapte,Adapte / Adapte
2964,475,2018,Droit,2,1,QROC,44,42,30,12,1.05,71.43,30,14,67.14,Adapte,Adapte,Adapte / Adapte
3794,475,2019,Droit,2,1,QROC,47,41,30,11,1.15,73.17,30,17,62.97,Adapte,Adapte,Adapte / Adapte
4624,475,2020,Droit,2,1,QROC,46,35,34,1,1.31,97.14,34,12,74.53,Adapte,Adapte,Adapte / Adapte
475,476,2015,Droit,2,2,QCM,68,33,7,26,2.06,21.21,7,61,10.48,Difficile,Trop Difficile,Difficile / Trop Difficile
1305,476,2016,Droit,2,2,QCM,54,30,17,13,1.8,56.67,17,37,31.05,Difficile,Difficile,Difficile / Difficile
2135,476,2017,Droit,2,2,QCM,63,31,27,4,2.03,87.1,27,36,42.49,Difficile,Difficile,Difficile / Difficile
2965,476,2018,Droit,2,2,QCM,76,65,61,4,1.17,93.85,61,15,80.92,Difficile,Facile,Difficile / Facile
3795,476,2019,Droit,2,2,QCM,91,81,36,45,1.12,44.44,36,55,39.31,Difficile,Difficile,Difficile / Difficile
4625,476,2020,Droit,2,2,QCM,106,90,56,34,1.18,62.22,56,50,52.91,Difficile,Difficile,Difficile / Difficile
476,477,2015,Droit,2,3,QCU,37,32,22,10,1.16,68.75,22,15,58.88,Difficile,Difficile,Difficile / Difficile
1306,477,2016,Droit,2,3,QCU,34,19,16,3,1.79,84.21,16,18,47.9,Difficile,Difficile,Difficile / Difficile
2136,477,2017,Droit,2,3,QCU,32,32,32,0,1.0,100.0,32,0,99.93,Difficile,Trop Facile,Difficile / Trop Facile
2966,477,2018,Droit,2,3,QCU,35,20,9,11,1.75,45.0,9,26,27.12,Difficile,Difficile,Difficile / Difficile
3796,477,2019,Droit,2,3,QCU,39,24,18,6,1.62,75.0,18,21,46.75,Difficile,Difficile,Difficile / Difficile
4626,477,2020,Droit,2,3,QCU,46,43,27,16,1.07,62.79,27,19,58.14,Difficile,Difficile,Difficile / Difficile
477,478,2015,Droit,2,4,QCU,99,84,77,7,1.18,91.67,77,22,77.83,Difficile,Facile,Difficile / Facile
1307,478,2016,Droit,2,4,QCU,81,55,39,16,1.47,70.91,39,42,47.94,Difficile,Difficile,Difficile / Difficile
2137,478,2017,Droit,2,4,QCU,77,41,39,2,1.88,95.12,39,38,50.95,Difficile,Difficile,Difficile / Difficile
2967,478,2018,Droit,2,4,QCU,88,85,63,22,1.04,74.12,63,25,71.28,Difficile,Adapte,Difficile / Adapte
3797,478,2019,Droit,2,4,QCU,73,59,45,14,1.24,76.27,45,28,61.75,Adapte,Adapte,Adapte / Adapte
4627,478,2020,Droit,2,4,QCU,58,43,38,5,1.35,88.37,38,20,64.77,Adapte,Adapte,Adapte / Adapte
478,479,2015,Droit,2,5,QROC,82,81,73,8,1.01,90.12,73,9,88.54,Trop Facile,Trop Facile,Trop Facile / Trop Facile
1308,479,2016,Droit,2,5,QROC,86,80,77,3,1.07,96.25,77,9,89.79,Difficile,Trop Facile,Difficile / Trop Facile
2138,479,2017,Droit,2,5,QROC,73,61,38,23,1.2,62.3,38,35,52.04,Difficile,Difficile,Difficile / Difficile
2968,479,2018,Droit,2,5,QROC,75,66,31,35,1.14,46.97,31,44,41.5,Difficile,Difficile,Difficile / Difficile
3798,479,2019,Droit,2,5,QROC,87,38,12,26,2.29,31.58,12,75,14.06,Difficile,Trop Difficile,Difficile / Trop Difficile
4628,479,2020,Droit,2,5,QROC,90,76,53,23,1.18,69.74,53,37,58.89,Difficile,Difficile,Difficile / Difficile
479,480,2015,Droit,2,6,QO,13,10,9,1,1.3,90.0,9,4,70.74,Trop Difficile,Adapte,Trop Difficile / Adapte
1309,480,2016,Droit,2,6,QO,14,14,9,5,1.0,64.29,9,5,64.22,Adapte,Adapte,Adapte / Adapte
2139,480,2017,Droit,2,6,QO,14,11,9,2,1.27,81.82,9,5,62.03,Adapte,Adapte,Adapte / Adapte
2969,480,2018,Droit,2,6,QO,11,7,7,0,1.57,100.0,7,4,67.78,Adapte,Adapte,Adapte / Adapte
3799,480,2019,Droit,2,6,QO,12,9,8,1,1.33,88.89,8,4,64.19,Adapte,Adapte,Adapte / Adapte
4629,480,2020,Droit,2,6,QO,11,8,7,1,1.38,87.5,7,4,67.18,Adapte,Adapte,Adapte / Adapte
480,481,2015,Droit,3,1,QCU,77,48,8,40,1.6,16.67,8,69,10.05,Trop Difficile,Trop Difficile,Trop Difficile / Trop Difficile
1310,481,2016,Droit,3,1,QCU,68,39,32,7,1.74,82.05,32,36,46.52,Difficile,Difficile,Difficile / Difficile
2140,481,2017,Droit,3,1,QCU,72,71,24,47,1.01,33.8,24,48,32.64,Difficile,Difficile,Difficile / Difficile
2970,481,2018,Droit,3,1,QCU,72,71,20,51,1.01,28.17,20,52,28.31,Difficile,Difficile,Difficile / Difficile
3800,481,2019,Droit,3,1,QCU,60,43,33,10,1.4,76.74,33,27,55.47,Difficile,Difficile,Difficile / Difficile
4630,481,2020,Droit,3,1,QCU,69,48,30,18,1.44,62.5,30,39,43.1,Difficile,Difficile,Difficile / Difficile
481,482,2015,Droit,3,2,QCM,21,18,17,1,1.17,94.44,17,4,78.96,Facile,Facile,Facile / Facile
1311,482,2016,Droit,3,2,QCM,24,20,20,0,1.2,100.0,20,4,83.31,Difficile,Facile,Difficile / Facile
2141,482,2017,Droit,3,2,QCM,19,18,6,12,1.06,33.33,6,13,33.96,Difficile,Difficile,Difficile / Difficile
2971,482,2018,Droit,3,2,QCM,21,20,15,5,1.05,75.0,15,6,71.46,Difficile,Adapte,Difficile / Adapte
3801,482,2019,Droit,3,2,QCM,22,16,14,2,1.38,87.5,14,8,63.62,Adapte,Adapte,Adapte / Adapte
4631,482,2020,Droit,3,2,QCM,20,19,13,6,1.05,68.42,13,7,63.5,Adapte,Adapte,Adapte / Adapte
482,483,2015,Droit,3,3,QCU,24,19,9,10,1.26,47.37,9,15,35.68,Difficile,Difficile,Difficile / Difficile
1312,483,2016,Droit,3,3,QCU,23,17,17,0,1.35,100.0,17,6,73.89,Difficile,Adapte,Difficile / Adapte
2142,483,2017,Droit,3,3,QCU,22,16,14,2,1.38,87.5,14,8,63.02,Adapte,Adapte,Adapte / Adapte
2972,483,2018,Droit,3,3,QCU,23,21,17,4,1.1,80.95,17,6,73.21,Adapte,Adapte,Adapte / Adapte
3802,483,2019,Droit,3,3,QCU,27,18,18,0,1.5,100.0,18,9,65.58,Adapte,Adapte,Adapte / Adapte
4632,483,2020,Droit,3,3,QCU,32,30,23,7,1.07,76.67,23,9,70.75,Adapte,Adapte,Adapte / Adapte
483,484,2015,Droit,3,4,QROC,59,57,48,9,1.04,84.21,48,11,80.92,Facile,Facile,Facile / Facile
1313,484,2016,Droit,3,4,QROC,70,70,70,0,1.0,100.0,70,0,99.82,Difficile,Trop Facile,Difficile / Trop Facile
2143,484,2017,Droit,3,4,QROC,83,55,21,34,1.51,38.18,21,62,25.15,Difficile,Difficile,Difficile / Difficile
2973,484,2018,Droit,3,4,QROC,69,58,35,23,1.19,60.34,35,34,50.74,Difficile,Difficile,Difficile / Difficile
3803,484,2019,Droit,3,4,QROC,83,81,31,50,1.02,38.27,31,52,37.15,Difficile,Difficile,Difficile / Difficile
4633,484,2020,Droit,3,4,QROC,70,49,25,24,1.43,51.02,25,45,35.57,Difficile,Difficile,Difficile / Difficile
484,485,2015,Droit,3,5,QCU,95,93,88,5,1.02,94.62,88,7,92.98,Trop Facile,Trop Facile,Trop Facile / Trop Facile
1314,485,2016,Droit,3,5,QCU,96,85,84,1,1.13,98.82,84,12,87.65,Difficile,Trop Facile,Difficile / Trop Facile
2144,485,2017,Droit,3,5,QCU,88,68,46,22,1.29,67.65,46,42,51.9,Difficile,Difficile,Difficile / Difficile
2974,485,2018,Droit,3,5,QCU,95,78,65,13,1.22,83.33,65,30,68.51,Difficile,Adapte,Difficile / Adapte
3804,485,2019,Droit,3,5,QCU,87,83,59,24,1.05,71.08,59,28,67.57,Adapte,Adapte,Adapte / Adapte
4634,485,2020,Droit,3,5,QCU,90,71,63,8,1.27,88.73,63,27,70.11,Adapte,Adapte,Adapte / Adapte
485,486,2015,Droit,3,6,QCU,11,9,7,2,1.22,77.78,7,4,68.06,Adapte,Adapte,Adapte / Adapte
1315,486,2016,Droit,3,6,QCU,9,7,6,1,1.29,85.71,6,3,68.54,Adapte,Adapte,Adapte / Adapte
2145,486,2017,Droit,3,6,QCU,11,10,8,2,1.1,80.0,8,3,74.55,Adapte,Adapte,Adapte / Adapte
2975,486,2018,Droit,3,6,QCU,13,11,9,2,1.18,81.82,9,4,71.82,Adapte,Adapte,Adapte / Adapte
3805,486,2019,Droit,3,6,QCU,11,7,7,0,1.57,100.0,7,4,67.36,Adapte,Adapte,Adapte / Adapte
4635,486,2020,Droit,3,6,QCU,11,8,8,0,1.38,100.0,8,3,71.68,Adapte,Adapte,Adapte / Adapte
486,487,2015,Droit,3,7,QCU,70,25,10,15,2.8,40.0,10,60,14.23,Trop Difficile,Trop Difficile,Trop Difficile / Trop Difficile
1316,487,2016,Droit,3,7,QCU,64,60,34,26,1.07,56.67,34,30,53.89,Difficile,Difficile,Difficile / Difficile
2146,487,2017,Droit,3,7,QCU,61,44,35,9,1.39,79.55,35,26,56.86,Difficile,Difficile,Difficile / Difficile
2976,487,2018,Droit,3,7,QCU,69,23,19,4,3.0,82.61,19,50,27.07,Difficile,Difficile,Difficile / Difficile
3806,487,2019,Droit,3,7,QCU,59,33,30,3,1.79,90.91,30,29,51.24,Difficile,Difficile,Difficile / Difficile
4636,487,2020,Droit,3,7,QCU,54,48,40,8,1.12,83.33,40,14,73.22,Difficile,Adapte,Difficile / Adapte
487,488,2015,Droit,3,8,QCM,67,33,4,29,2.03,12.12,4,63,6.36,Difficile,Trop Difficile,Difficile / Trop Difficile
1317,488,2016,Droit,3,8,QCM,75,36,19,17,2.08,52.78,19,56,25.03,Difficile,Difficile,Difficile / Difficile
2147,488,2017,Droit,3,8,QCM,79,73,61,12,1.08,83.56,61,18,77.64,Difficile,Facile,Difficile / Facile
2977,488,2018,Droit,3,8,QCM,93,82,82,0,1.13,100.0,82,11,88.59,Difficile,Trop Facile,Difficile / Trop Facile
3807,488,2019,Droit,3,8,QCM,78,72,42,30,1.08,58.33,42,36,53.24,Difficile,Difficile,Difficile / Difficile
4637,488,2020,Droit,3,8,QCM,83,66,26,40,1.26,39.39,26,57,30.92,Difficile,Difficile,Difficile / Difficile
488,489,2015,Droit,3,9,QCU,36,24,19,5,1.5,79.17,19,17,51.44,Difficile,Difficile,Difficile / Difficile
1318,489,2016,Droit,3,9,QCU,38,34,18,16,1.12,52.94,18,20,46.53,Difficile,Difficile,Difficile / Difficile
2148,489,2017,Droit,3,9,QCU,32,32,32,0,1.0,100.0,32,0,98.44,Difficile,Trop Facile,Difficile / Trop Facile
2978,489,2018,Droit,3,9,QCU,32,11,10,1,2.91,90.91,10,22,32.67,Difficile,Difficile,Difficile / Difficile
3808,489,2019,Droit,3,9,QCU,27,24,16,8,1.12,66.67,16,11,60.24,Difficile,Adapte,Difficile / Adapte
4638,489,2020,Droit,3,9,QCU,23,19,14,5,1.21,73.68,14,9,60.57,Adapte,Adapte,Adapte / Adapte
489,490,2015,Droit,3,10,QROC,51,35,29,6,1.46,82.86,29,22,56.01,Difficile,Difficile,Difficile / Difficile
1319,490,2016,Droit,3,10,QROC,61,55,23,32,1.11,41.82,23,38,37.43,Difficile,Difficile,Difficile / Difficile
2149,490,2017,Droit,3,10,QROC,49,20,17,3,2.45,85.0,17,32,34.1,Difficile,Difficile,Difficile / Difficile
2979,490,2018,Droit,3,10,QROC,51,37,31,6,1.38,83.78,31,20,61.35,Difficile,Adapte,Difficile / Adapte
3809,490,2019,Droit,3,10,QROC,45,43,27,16,1.05,62.79,27,18,60.53,Adapte,Adapte,Adapte / Adapte
4639,490,2020,Droit,3,10,QROC,47,41,32,9,1.15,78.05,32,15,67.09,Adapte,Adapte,Adapte / Adapte
490,491,2015,Droit,3,11,QCU,41,30,23,7,1.37,76.67,23,18,57.23,Difficile,Difficile,Difficile / Difficile
1320,491,2016,Droit,3,11,QCU,43,16,11,5,2.69,68.75,11,32,25.85,Difficile,Difficile,Difficile / Difficile
2150,491,2017,Droit,3,11,QCU,46,45,40,5,1.02,88.89,40,6,86.9,Difficile,Trop Facile,Difficile / Trop Facile
2980,491,2018,Droit,3,11,QCU,50,28,27,1,1.79,96.43,27,23,53.03,Difficile,Difficile,Difficile / Difficile
3810,491,2019,Droit,3,11,QCU,55,50,26,24,1.1,52.0,26,29,47.81,Difficile,Difficile,Difficile / Difficile
4640,491,2020,Droit,3,11,QCU,52,22,12,10,2.36,54.55,12,40,22.66,Difficile,Trop Difficile,Difficile / Trop Difficile
491,492,2015,Droit,3,12,QCU,87,86,72,14,1.01,83.72,72,15,82.59,Trop Difficile,Facile,Trop Difficile / Facile
1321,492,2016,Droit,3,12,QCU,86,81,43,38,1.06,53.09,43,43,50.08,Difficile,Difficile,Difficile / Difficile
2151,492,2017,Droit,3,12,QCU,93,68,37,31,1.37,54.41,37,56,40.05,Difficile,Difficile,Difficile / Difficile
2981,492,2018,Droit,3,12,QCU,87,66,62,4,1.32,93.94,62,25,70.82,Difficile,Adapte,Difficile / Adapte
3811,492,2019,Droit,3,12,QCU,94,89,64,25,1.06,71.91,64,30,68.61,Adapte,Adapte,Adapte / Adapte
4641,492,2020,Droit,3,12,QCU,96,64,63,1,1.5,98.44,63,33,65.33,Adapte,Adapte,Adapte / Adapte
492,493,2015,Droit,3,13,QCM,78,70,64,6,1.11,91.43,64,14,81.58,Facile,Facile,Facile / Facile
1322,493,2016,Droit,3,13,QCM,82,59,30,29,1.39,50.85,30,52,36.97,Difficile,Difficile,Difficile / Difficile
2152,493,2017,Droit,3,13,QCM,95,90,76,14,1.06,84.44,76,19,79.83,Difficile,Facile,Difficile / Facile
2982,493,2018,Droit,3,13,QCM,95,50,44,6,1.9,88.0,44,51,46.79,Difficile,Difficile,Difficile / Difficile
3812,493,2019,Droit,3,13,QCM,95,63,28,35,1.51,44.44,28,67,29.29,Difficile,Difficile,Difficile / Difficile
4642,493,2020,Droit,3,13,QCM,94,75,67,8,1.25,89.33,67,27,70.93,Difficile,Adapte,Difficile / Adapte
493,494,2015,Droit,4,1,QCM,74,30,2,28,2.47,6.67,2,72,3.18,Trop Difficile,Trop Difficile,Trop Difficile / Trop Difficile
1323,494,2016,Droit,4,1,QCM,63,32,23,9,1.97,71.88,23,40,35.8,Difficile,Difficile,Difficile / Difficile
2153,494,2017,Droit,4,1,QCM,68,29,25,4,2.34,86.21,25,43,36.46,Difficile,Difficile,Difficile / Difficile
2983,494,2018,Droit,4,1,QCM,68,63,45,18,1.08,71.43,45,23,66.83,Difficile,Adapte,Difficile / Adapte
3813,494,2019,Droit,4,1,QCM,62,55,45,10,1.13,81.82,45,17,72.21,Adapte,Adapte,Adapte / Adapte
4643,494,2020,Droit,4,1,QCM,53,41,39,2,1.29,95.12,39,14,74.21,Adapte,Adapte,Adapte / Adapte
494,495,2015,Droit,4,2,QCM,89,81,72,9,1.1,88.89,72,17,81.25,Facile,Facile,Facile / Facile
1324,495,2016,Droit,4,2,QCM,88,37,34,3,2.38,91.89,34,54,39.11,Difficile,Difficile,Difficile / Difficile
2154,495,2017,Droit,4,2,QCM,90,49,41,8,1.84,83.67,41,49,45.87,Difficile,Difficile,Difficile / Difficile
2984,495,2018,Droit,4,2,QCM,81,31,16,15,2.61,51.61,16,65,19.78,Difficile,Trop Difficile,Difficile / Trop Difficile
3814,495,2019,Droit,4,2,QCM,83,58,38,20,1.43,65.52,38,45,45.83,Difficile,Difficile,Difficile / Difficile
4644,495,2020,Droit,4,2,QCM,99,80,76,4,1.24,95.0,76,23,76.77,Difficile,Facile,Difficile / Facile
495,496,2015,Droit,4,3,QCM,80,75,38,37,1.07,50.67,38,42,47.73,Trop Facile,Difficile,Trop Facile / Difficile
1325,496,2016,Droit,4,3,QCM,72,49,36,13,1.47,73.47,36,36,49.56,Difficile,Difficile,Difficile / Difficile
2155,496,2017,Droit,4,3,QCM,84,78,36,42,1.08,46.15,36,48,42.65,Difficile,Difficile,Difficile / Difficile
2985,496,2018,Droit,4,3,QCM,81,67,56,11,1.21,83.58,56,25,68.91,Difficile,Adapte,Difficile / Adapte
3815,496,2019,Droit,4,3,QCM,79,58,48,10,1.36,82.76,48,31,61.04,Adapte,Adapte,Adapte / Adapte
4645,496,2020,Droit,4,3,QCM,68,50,49,1,1.36,98.0,49,19,71.98,Adapte,Adapte,Adapte / Adapte
496,497,2015,Droit,4,4,QCU,76,70,62,8,1.09,88.57,62,14,81.77,Facile,Facile,Facile / Facile
1326,497,2016,Droit,4,4,QCU,78,75,53,22,1.04,70.67,53,25,67.67,Difficile,Adapte,Difficile / Adapte
2156,497,2017,Droit,4,4,QCU,74,46,45,1,1.61,97.83,45,29,60.9,Adapte,Adapte,Adapte / Adapte
2986,497,2018,Droit,4,4,QCU,69,68,52,16,1.01,76.47,52,17,74.75,Adapte,Adapte,Adapte / Adapte
3816,497,2019,Droit,4,4,QCU,72,55,52,3,1.31,94.55,52,20,71.8,Adapte,Adapte,Adapte / Adapte
4646,497,2020,Droit,4,4,QCU,58,58,37,21,1.0,63.79,37,21,63.29,Adapte,Adapte,Adapte / Adapte
497,498,2015,Droit,4,5,QCM,90,89,89,0,1.01,100.0,89,1,99.15,Trop Difficile,Trop Facile,Trop Difficile / Trop Facile
1327,498,2016,Droit,4,5,QCM,89,83,70,13,1.07,84.34,70,19,79.18,Difficile,Facile,Difficile / Facile
2157,498,2017,Droit,4,5,QCM,103,88,39,49,1.17,44.32,39,64,37.51,Difficile,Difficile,Difficile / Difficile
2987,498,2018,Droit,4,5,QCM,117,104,67,37,1.12,64.42,67,50,56.87,Difficile,Difficile,Difficile / Difficile
3817,498,2019,Droit,4,5,QCM,113,78,9,69,1.45,11.54,9,104,8.19,Difficile,Trop Difficile,Difficile / Trop Difficile
4647,498,2020,Droit,4,5,QCM,126,82,41,41,1.54,50.0,41,85,32.75,Difficile,Difficile,Difficile / Difficile
498,499,2015,Droit,4,6,QCU,45,37,35,2,1.22,94.59,35,10,77.72,Facile,Facile,Facile / Facile
1328,499,2016,Droit,4,6,QCU,53,35,22,13,1.51,62.86,22,31,40.66,Difficile,Difficile,Difficile / Difficile
2158,499,2017,Droit,4,6,QCU,60,30,25,5,2.0,83.33,25,35,41.95,Difficile,Difficile,Difficile / Difficile
2988,499,2018,Droit,4,6,QCU,65,32,20,12,2.03,62.5,20,45,30.69,Difficile,Difficile,Difficile / Difficile
3818,499,2019,Droit,4,6,QCU,76,39,20,19,1.95,51.28,20,56,25.93,Difficile,Difficile,Difficile / Difficile
4648,499,2020,Droit,4,6,QCU,89,57,26,31,1.56,45.61,26,63,29.29,Difficile,Difficile,Difficile / Difficile
499,500,2015,Droit,4,7,QCM,14,13,13,0,1.08,100.0,13,1,90.43,Difficile,Trop Facile,Difficile / Trop Facile
1329,500,2016,Droit,4,7,QCM,13,12,4,8,1.08,33.33,4,9,27.91,Difficile,Difficile,Difficile / Difficile
2159,500,2017,Droit,4,7,QCM,14,14,14,0,1.0,100.0,14,0,96.45,Difficile,Trop Facile,Difficile / Trop Facile
2989,500,2018,Droit,4,7,QCM,13,13,12,1,1.0,92.31,12,1,93.32,Difficile,Trop Facile,Difficile / Trop Facile
3819,500,2019,Droit,4,7,QCM,10,8,8,0,1.25,100.0,8,2,77.77,Difficile,Facile,Difficile / Facile
4649,500,2020,Droit,4,7,QCM,11,11,6,5,1.0,54.55,6,5,56.79,Difficile,Difficile,Difficile / Difficile
500,501,2015,Droit,4,8,QO,18,14,13,1,1.29,92.86,13,5,70.47,Difficile,Adapte,Difficile / Adapte
1330,501,2016,Droit,4,8,QO,17,13,12,1,1.31,92.31,12,5,72.19,Adapte,Adapte,Adapte / Adapte
2160,501,2017,Droit,4,8,QO,17,11,10,1,1.55,90.91,10,7,60.33,Adapte,Adapte,Adapte / Adapte
2990,501,2018,Droit,4,8,QO,18,14,12,2,1.29,85.71,12,6,67.57,Adapte,Adapte,Adapte / Adapte
3820,501,2019,Droit,4,8,QO,20,19,13,6,1.05,68.42,13,7,63.84,Adapte,Adapte,Adapte / Adapte
4650,501,2020,Droit,4,8,QO,16,15,12,3,1.07,80.0,12,4,74.12,Adapte,Adapte,Adapte / Adapte
501,502,2015,Droit,4,9,QCM,23,22,15,7,1.05,68.18,15,8,64.45,Adapte,Adapte,Adapte / Adapte
1331,502,2016,Droit,4,9,QCM,26,19,18,1,1.37,94.74,18,8,67.37,Adapte,Adapte,Adapte / Adapte
2161,502,2017,Droit,4,9,QCM,24,23,16,7,1.04,69.57,16,8,68.14,Adapte,Adapte,Adapte / Adapte
2991,502,2018,Droit,4,9,QCM,22,16,15,1,1.38,93.75,15,7,69.36,Adapte,Adapte,Adapte / Adapte
3821,502,2019,Droit,4,9,QCM,25,20,15,5,1.25,75.0,15,10,60.18,Adapte,Adapte,Adapte / Adapte
4651,502,2020,Droit,4,9,QCM,22,18,16,2,1.22,88.89,16,6,72.07,Adapte,Adapte,Adapte / Adapte
502,503,2015,Droit,5,1,QCU,79,78,76,2,1.01,97.44,76,3,95.96,Trop Facile,Trop Facile,Trop Facile / Trop Facile
1332,503,2016,Droit,5,1,QCU,89,56,28,28,1.59,50.0,28,61,31.0,Difficile,Difficile,Difficile / Difficile
2162,503,2017,Droit,5,1,QCU,77,55,32,23,1.4,58.18,32,45,41.7,Difficile,Difficile,Difficile / Difficile
2992,503,2018,Droit,5,1,QCU,91,79,33,46,1.15,41.77,33,58,36.71,Difficile,Difficile,Difficile / Difficile
3822,503,2019,Droit,5,1,QCU,93,53,35,18,1.75,66.04,35,58,37.13,Difficile,Difficile,Difficile / Difficile
4652,503,2020,Droit,5,1,QCU,96,86,30,56,1.12,34.88,30,66,30.86,Difficile,Difficile,Difficile / Difficile
503,504,2015,Droit,5,2,QCM,9,8,3,5,1.12,37.5,3,6,28.59,Trop Difficile,Difficile,Trop Difficile / Difficile
1333,504,2016,Droit,5,2,QCM,8,8,3,5,1.0,37.5,3,5,33.43,Difficile,Difficile,Difficile / Difficile
2163,504,2017,Droit,5,2,QCM,7,3,0,3,2.33,0.0,0,7,0.23,Difficile,Trop Difficile,Difficile / Trop Difficile
2993,504,2018,Droit,5,2,QCM,8,2,0,2,4.0,0.0,0,8,1.6,Difficile,Trop Difficile,Difficile / Trop Difficile
3823,504,2019,Droit,5,2,QCM,8,6,5,1,1.33,83.33,5,3,56.49,Difficile,Difficile,Difficile / Difficile
4653,504,2020,Droit,5,2,QCM,9,8,7,1,1.12,87.5,7,2,81.01,Difficile,Facile,Difficile / Facile
504,505,2015,Droit,5,3,QCU,32,16,4,12,2.0,25.0,4,28,12.68,Trop Difficile,Trop Difficile,Trop Difficile / Trop Difficile
1334,505,2016,Droit,5,3,QCU,32,17,0,17,1.88,0.0,0,32,0.71,Difficile,Trop Difficile,Difficile / Trop Difficile
2164,505,2017,Droit,5,3,QCU,35,13,9,4,2.69,69.23,9,26,26.27,Difficile,Difficile,Difficile / Difficile
2994,505,2018,Droit,5,3,QCU,36,16,15,1,2.25,93.75,15,21,41.2,Difficile,Difficile,Difficile / Difficile
3824,505,2019,Droit,5,3,QCU,36,30,17,13,1.2,56.67,17,19,46.88,Difficile,Difficile,Difficile / Difficile
4654,505,2020,Droit,5,3,QCU,29,15,15,0,1.93,100.0,15,14,50.48,Difficile,Difficile,Difficile / Difficile
505,506,2015,Droit,5,4,QROC,29,29,27,2,1.0,93.1,27,2,94.0,Trop Difficile,Trop Facile,Trop Difficile / Trop Facile
1335,506,2016,Droit,5,4,QROC,25,21,21,0,1.19,100.0,21,4,83.82,Difficile,Facile,Difficile / Facile
2165,506,2017,Droit,5,4,QROC,29,27,16,11,1.07,59.26,16,13,53.55,Difficile,Difficile,Difficile / Difficile
2995,506,2018,Droit,5,4,QROC,35,29,24,5,1.21,82.76,24,11,68.48,Difficile,Adapte,Difficile / Adapte
3825,506,2019,Droit,5,4,QROC,41,33,27,6,1.24,81.82,27,14,66.43,Adapte,Adapte,Adapte / Adapte
4655,506,2020,Droit,5,4,QROC,34,31,22,9,1.1,70.97,22,12,65.34,Adapte,Adapte,Adapte / Adapte
506,507,2015,Droit,5,5,QCU,85,82,81,1,1.04,98.78,81,4,94.98,Difficile,Trop Facile,Difficile / Trop Facile
1336,507,2016,Droit,5,5,QCU,99,79,51,28,1.25,64.56,51,48,51.5,Difficile,Difficile,Difficile / Difficile
2166,507,2017,Droit,5,5,QCU,80,56,21,35,1.43,37.5,21,59,26.15,Difficile,Difficile,Difficile / Difficile
2996,507,2018,Droit,5,5,QCU,95,79,12,67,1.2,15.19,12,83,13.12,Difficile,Trop Difficile,Difficile / Trop Difficile
3826,507,2019,Droit,5,5,QCU,106,95,86,9,1.12,90.53,86,20,80.89,Difficile,Facile,Difficile / Facile
4656,507,2020,Droit,5,5,QCU,120,102,71,31,1.18,69.61,71,49,58.9,Difficile,Difficile,Difficile / Difficile
507,508,2015,Droit,5,6,QROC,42,37,33,4,1.14,89.19,33,9,78.15,Facile,Facile,Facile / Facile
1337,508,2016,Droit,5,6,QROC,37,32,30,2,1.16,93.75,30,7,82.26,Difficile,Facile,Difficile / Facile
2167,508,2017,Droit,5,6,QROC,35,27,11,16,1.3,40.74,11,24,30.56,Difficile,Difficile,Difficile / Difficile
2997,508,2018,Droit,5,6,QROC,42,22,11,11,1.91,50.0,11,31,26.82,Difficile,Difficile,Difficile / Difficile
3827,508,2019,Droit,5,6,QROC,41,24,16,8,1.71,66.67,16,25,39.95,Difficile,Difficile,Difficile / Difficile
4657,508,2020,Droit,5,6,QROC,35,34,19,15,1.03,55.88,19,16,54.39,Difficile,Difficile,Difficile / Difficile
508,509,2015,Droit,5,7,QCU,63,54,17,37,1.17,31.48,17,46,27.74,Difficile,Difficile,Difficile / Difficile
1338,509,2016,Droit,5,7,QCU,58,38,17,21,1.53,44.74,17,41,30.01,Difficile,Difficile,Difficile / Difficile
2168,509,2017,Droit,5,7,QCU,51,47,26,21,1.09,55.32,26,25,50.25,Difficile,Difficile,Difficile / Difficile
2998,509,2018,Droit,5,7,QCU,59,48,32,16,1.23,66.67,32,27,54.65,Difficile,Difficile,Difficile / Difficile
3828,509,2019,Droit,5,7,QCU,55,32,1,31,1.72,3.12,1,54,1.89,Difficile,Trop Difficile,Difficile / Trop Difficile
4658,509,2020,Droit,5,7,QCU,51,43,40,3,1.19,93.02,40,11,79.25,Difficile,Facile,Difficile / Facile
509,510,2015,Droit,5,8,QCU,99,99,67,32,1.0,67.68,67,32,67.6,Difficile,Adapte,Difficile / Adapte
1339,510,2016,Droit,5,8,QCU,99,72,62,10,1.38,86.11,62,37,62.95,Adapte,Adapte,Adapte / Adapte
2169,510,2017,Droit,5,8,QCU,81,65,60,5,1.25,92.31,60,21,73.49,Adapte,Adapte,Adapte / Adapte
2999,510,2018,Droit,5,8,QCU,70,60,46,14,1.17,76.67,46,24,66.41,Adapte,Adapte,Adapte / Adapte
3829,510,2019,Droit,5,8,QCU,73,61,53,8,1.2,86.89,53,20,72.36,Adapte,Adapte,Adapte / Adapte
4659,510,2020,Droit,5,8,QCU,65,63,41,22,1.03,65.08,41,24,62.52,Adapte,Adapte,Adapte / Adapte
510,511,2015,Droit,6,1,QO,28,27,22,5,1.04,81.48,22,6,80.35,Facile,Facile,Facile / Facile
1340,511,2016,Droit,6,1,QO,27,18,9,9,1.5,50.0,9,18,33.25,Trop Difficile,Difficile,Trop Difficile / Difficile
2170,511,2017,Droit,6,1,QO,31,24,6,18,1.29,25.0,6,25,18.65,Trop Difficile,Trop Difficile,Trop Difficile / Trop Difficile
3000,511,2018,Droit,6,1,QO,29,22,20,2,1.32,90.91,20,9,69.42,Trop Difficile,Adapte,Trop Difficile / Adapte
3830,511,2019,Droit,6,1,QO,32,21,20,1,1.52,95.24,20,12,63.65,Adapte,Adapte,Adapte / Adapte
4660,511,2020,Droit,6,1,QO,35,28,24,4,1.25,85.71,24,11,67.6,Adapte,Adapte,Adapte / Adapte
511,512,2015,Droit,6,2,QCM,23,22,22,0,1.05,100.0,22,1,94.61,Trop Facile,Trop Facile,Trop Facile / Trop Facile
1341,512,2016,Droit,6,2,QCM,22,21,6,15,1.05,28.57,6,16,26.32,Difficile,Difficile,Difficile / Difficile
2171,512,2017,Droit,6,2,QCM,20,18,11,7,1.11,61.11,11,9,53.55,Difficile,Difficile,Difficile / Difficile
3001,512,2018,Droit,6,2,QCM,17,17,14,3,1.0,82.35,14,3,81.66,Difficile,Facile,Difficile / Facile
3831,512,2019,Droit,6,2,QCM,15,9,8,1,1.67,88.89,8,7,53.2,Difficile,Difficile,Difficile / Difficile
4661,512,2020,Droit,6,2,QCM,12,12,6,6,1.0,50.0,6,6,48.89,Difficile,Difficile,Difficile / Difficile
512,513,2015,Droit,6,3,QCM,65,64,28,36,1.02,43.75,28,37,42.66,Difficile,Difficile,Difficile / Difficile
1342,513,2016,Droit,6,3,QCM,60,53,48,5,1.13,90.57,48,12,80.26,Difficile,Facile,Difficile / Facile
2172,513,2017,Droit,6,3,QCM,58,42,28,14,1.38,66.67,28,30,47.59,Difficile,Difficile,Difficile / Difficile
3002,513,2018,Droit,6,3,QCM,51,38,17,21,1.34,44.74,17,34,32.58,Difficile,Difficile,Difficile / Difficile
3832,513,2019,Droit,6,3,QCM,41,24,22,2,1.71,91.67,22,19,53.77,Difficile,Difficile,Difficile / Difficile
4662,513,2020,Droit,6,3,QCM,48,22,19,3,2.18,86.36,19,29,39.29,Difficile,Difficile,Difficile / Difficile
513,514,2015,Droit,6,4,QCU,100,99,95,4,1.01,95.96,95,5,94.91,Trop Facile,Trop Facile,Trop Facile / Trop Facile
1343,514,2016,Droit,6,4,QCU,100,95,78,17,1.05,82.11,78,22,77.64,Difficile,Facile,Difficile / Facile
2173,514,2017,Droit,6,4,QCU,83,30,23,7,2.77,76.67,23,60,28.09,Difficile,Difficile,Difficile / Difficile
3003,514,2018,Droit,6,4,QCU,84,66,38,28,1.27,57.58,38,46,44.81,Difficile,Difficile,Difficile / Difficile
3833,514,2019,Droit,6,4,QCU,99,91,89,2,1.09,97.8,89,10,90.4,Difficile,Trop Facile,Difficile / Trop Facile
4663,514,2020,Droit,6,4,QCU,97,94,48,46,1.03,51.06,48,49,48.99,Difficile,Difficile,Difficile / Difficile
514,515,2015,Droit,6,5,QCU,61,57,18,39,1.07,31.58,18,43,29.05,Difficile,Difficile,Difficile / Difficile
1344,515,2016,Droit,6,5,QCU,51,44,20,24,1.16,45.45,20,31,39.12,Difficile,Difficile,Difficile / Difficile
2174,515,2017,Droit,6,5,QCU,56,53,15,38,1.06,28.3,15,41,27.07,Difficile,Difficile,Difficile / Difficile
3004,515,2018,Droit,6,5,QCU,62,32,31,1,1.94,96.88,31,31,50.69,Difficile,Difficile,Difficile / Difficile
3834,515,2019,Droit,6,5,QCU,68,27,26,1,2.52,96.3,26,42,38.54,Difficile,Difficile,Difficile / Difficile
4664,515,2020,Droit,6,5,QCU,59,41,30,11,1.44,73.17,30,29,50.21,Difficile,Difficile,Difficile / Difficile
515,516,2015,Droit,6,6,QCU,83,75,67,8,1.11,89.33,67,16,80.18,Trop Difficile,Facile,Trop Difficile / Facile
1345,516,2016,Droit,6,6,QCU,85,79,9,70,1.08,11.39,9,76,11.04,Difficile,Trop Difficile,Difficile / Trop Difficile
2175,516,2017,Droit,6,6,QCU,100,93,72,21,1.08,77.42,72,28,72.26,Difficile,Adapte,Difficile / Adapte
3005,516,2018,Droit,6,6,QCU,117,108,82,26,1.08,75.93,82,35,70.37,Adapte,Adapte,Adapte / Adapte
3835,516,2019,Droit,6,6,QCU,117,106,72,34,1.1,67.92,72,45,61.2,Adapte,Adapte,Adapte / Adapte
4665,516,2020,Droit,6,6,QCU,137,98,91,7,1.4,92.86,91,46,66.6,Adapte,Adapte,Adapte / Adapte
516,517,2015,Droit,7,1,QROC,71,62,47,15,1.15,75.81,47,24,66.57,Adapte,Adapte,Adapte / Adapte
1346,517,2016,Droit,7,1,QROC,72,52,48,4,1.38,92.31,48,24,66.4,Adapte,Adapte,Adapte / Adapte
2176,517,2017,Droit,7,1,QROC,67,47,41,6,1.43,87.23,41,26,61.29,Adapte,Adapte,Adapte / Adapte
3006,517,2018,Droit,7,1,QROC,55,53,33,20,1.04,62.26,33,22,60.8,Adapte,Adapte,Adapte / Adapte
3836,517,2019,Droit,7,1,QROC,65,60,42,18,1.08,70.0,42,23,64.53,Adapte,Adapte,Adapte / Adapte
4666,517,2020,Droit,7,1,QROC,58,39,39,0,1.49,100.0,39,19,67.44,Adapte,Adapte,Adapte / Adapte
517,518,2015,Droit,7,2,QCM,17,11,3,8,1.55,27.27,3,14,17.8,Trop Difficile,Trop Difficile,Trop Difficile / Trop Difficile
1347,518,2016,Droit,7,2,QCM,19,10,7,3,1.9,70.0,7,12,35.77,Difficile,Difficile,Difficile / Difficile
2177,518,2017,Droit,7,2,QCM,18,17,17,0,1.06,100.0,17,1,95.17,Difficile,Trop Facile,Difficile / Trop Facile
3007,518,2018,Droit,7,2,QCM,20,16,12,4,1.25,75.0,12,8,58.87,Difficile,Difficile,Difficile / Difficile
3837,518,2019,Droit,7,2,QCM,17,7,5,2,2.43,71.43,5,12,27.41,Difficile,Difficile,Difficile / Difficile
4667,518,2020,Droit,7,2,QCM,18,17,10,7,1.06,58.82,10,8,54.72,Difficile,Difficile,Difficile / Difficile
518,519,2015,Droit,7,3,QCM,78,47,29,18,1.66,61.7,29,49,36.74,Difficile,Difficile,Difficile / Difficile
1348,519,2016,Droit,7,3,QCM,70,53,22,31,1.32,41.51,22,48,31.44,Difficile,Difficile,Difficile / Difficile
2178,519,2017,Droit,7,3,QCM,59,49,40,9,1.2,81.63,40,19,68.05,Difficile,Adapte,Difficile / Adapte
3008,519,2018,Droit,7,3,QCM,56,47,41,6,1.19,87.23,41,15,73.94,Adapte,Adapte,Adapte / Adapte
3838,519,2019,Droit,7,3,QCM,61,38,37,1,1.61,97.37,37,24,61.2,Adapte,Adapte,Adapte / Adapte
4668,519,2020,Droit,7,3,QCM,70,56,49,7,1.25,87.5,49,21,70.31,Adapte,Adapte,Adapte / Adapte
519,520,2015,Droit,7,4,QCM,6,5,4,1,1.2,80.0,4,2,63.86,Trop Difficile,Adapte,Trop Difficile / Adapte
1349,520,2016,Droit,7,4,QCM,7,4,4,0,1.75,100.0,4,3,62.5,Adapte,Adapte,Adapte / Adapte
2179,520,2017,Droit,7,4,QCM,8,6,5,1,1.33,83.33,5,3,68.51,Adapte,Adapte,Adapte / Adapte
3009,520,2018,Droit,7,4,QCM,7,7,5,2,1.0,71.43,5,2,71.18,Adapte,Adapte,Adapte / Adapte
3839,520,2019,Droit,7,4,QCM,7,5,5,0,1.4,100.0,5,2,74.88,Adapte,Adapte,Adapte / Adapte
4669,520,2020,Droit,7,4,QCM,7,6,5,1,1.17,83.33,5,2,74.86,Adapte,Adapte,Adapte / Adapte
520,521,2015,Droit,7,5,QCU,44,43,34,9,1.02,79.07,34,10,77.25,Facile,Facile,Facile / Facile
1350,521,2016,Droit,7,5,QCU,40,37,17,20,1.08,45.95,17,23,41.94,Difficile,Difficile,Difficile / Difficile
2180,521,2017,Droit,7,5,QCU,40,27,18,9,1.48,66.67,18,22,45.38,Difficile,Difficile,Difficile / Difficile
3010,521,2018,Droit,7,5,QCU,41,37,20,17,1.11,54.05,20,21,48.04,Difficile,Difficile,Difficile / Difficile
3840,521,2019,Droit,7,5,QCU,42,26,23,3,1.62,88.46,23,19,55.1,Difficile,Difficile,Difficile / Difficile
4670,521,2020,Droit,7,5,QCU,48,46,2,44,1.04,4.35,2,46,4.08,Difficile,Trop Difficile,Difficile / Trop Difficile
521,522,2015,Droit,7,6,QCU,79,68,64,4,1.16,94.12,64,15,81.28,Difficile,Facile,Difficile / Facile
1351,522,2016,Droit,7,6,QCU,85,75,41,34,1.13,54.67,41,44,48.42,Difficile,Difficile,Difficile / Difficile
2181,522,2017,Droit,7,6,QCU,69,64,35,29,1.08,54.69,35,34,50.42,Difficile,Difficile,Difficile / Difficile
3011,522,2018,Droit,7,6,QCU,69,46,31,15,1.5,67.39,31,38,45.32,Difficile,Difficile,Difficile / Difficile
3841,522,2019,Droit,7,6,QCU,64,31,28,3,2.06,90.32,28,36,44.41,Difficile,Difficile,Difficile / Difficile
4671,522,2020,Droit,7,6,QCU,57,38,33,5,1.5,86.84,33,24,58.59,Difficile,Difficile,Difficile / Difficile
522,523,2015,Droit,7,7,QCM,86,76,68,8,1.13,89.47,68,18,79.64,Facile,Facile,Facile / Facile
1352,523,2016,Droit,7,7,QCM,73,51,34,17,1.43,66.67,34,39,47.03,Difficile,Difficile,Difficile / Difficile
2182,523,2017,Droit,7,7,QCM,74,66,22,44,1.12,33.33,22,52,29.34,Difficile,Difficile,Difficile / Difficile
3012,523,2018,Droit,7,7,QCM,66,42,22,20,1.57,52.38,22,44,33.79,Difficile,Difficile,Difficile / Difficile
3842,523,2019,Droit,7,7,QCM,65,48,25,23,1.35,52.08,25,40,37.98,Difficile,Difficile,Difficile / Difficile
4672,523,2020,Droit,7,7,QCM,70,54,38,16,1.3,70.37,38,32,53.68,Difficile,Difficile,Difficile / Difficile
523,524,2015,Droit,7,8,QCU,22,16,3,13,1.38,18.75,3,19,12.7,Trop Difficile,Trop Difficile,Trop Difficile / Trop Difficile
1353,524,2016,Droit,7,8,QCU,19,16,10,6,1.19,62.5,10,9,51.75,Difficile,Difficile,Difficile / Difficile
2183,524,2017,Droit,7,8,QCU,23,11,6,5,2.09,54.55,6,17,27.19,Difficile,Difficile,Difficile / Difficile
3013,524,2018,Droit,7,8,QCU,20,16,10,6,1.25,62.5,10,10,47.98,Difficile,Difficile,Difficile / Difficile
3843,524,2019,Droit,7,8,QCU,19,15,10,5,1.27,66.67,10,9,53.87,Difficile,Difficile,Difficile / Difficile
4673,524,2020,Droit,7,8,QCU,17,12,7,5,1.42,58.33,7,10,42.77,Difficile,Difficile,Difficile / Difficile
524,525,2015,Droit,7,9,QCM,11,11,10,1,1.0,90.91,10,1,95.1,Adapte,Trop Facile,Adapte / Trop Facile
1354,525,2016,Droit,7,9,QCM,9,8,4,4,1.12,50.0,4,5,40.63,Difficile,Difficile,Difficile / Difficile
2184,525,2017,Droit,7,9,QCM,7,6,4,2,1.17,66.67,4,3,54.6,Difficile,Difficile,Difficile / Difficile
3014,525,2018,Droit,7,9,QCM,8,7,6,1,1.14,85.71,6,2,70.64,Difficile,Adapte,Difficile / Adapte
3844,525,2019,Droit,7,9,QCM,8,8,6,2,1.0,75.0,6,2,73.5,Adapte,Adapte,Adapte / Adapte
4674,525,2020,Droit,7,9,QCM,9,8,6,2,1.12,75.0,6,3,65.96,Adapte,Adapte,Adapte / Adapte
525,526,2015,Droit,8,1,QCM,88,77,72,5,1.14,93.51,72,16,81.82,Difficile,Facile,Difficile / Facile
1355,526,2016,Droit,8,1,QCM,73,60,58,2,1.22,96.67,58,15,78.81,Difficile,Facile,Difficile / Facile
2185,526,2017,Droit,8,1,QCM,76,38,30,8,2.0,78.95,30,46,38.94,Difficile,Difficile,Difficile / Difficile
3015,526,2018,Droit,8,1,QCM,74,64,23,41,1.16,35.94,23,51,30.93,Difficile,Difficile,Difficile / Difficile
3845,526,2019,Droit,8,1,QCM,86,86,76,10,1.0,88.37,76,10,88.93,Difficile,Trop Facile,Difficile / Trop Facile
4675,526,2020,Droit,8,1,QCM,79,78,68,10,1.01,87.18,68,11,86.23,Difficile,Trop Facile,Difficile / Trop Facile
526,527,2015,Droit,8,2,QCU,48,35,32,3,1.37,91.43,32,16,67.39,Adapte,Adapte,Adapte / Adapte
1356,527,2016,Droit,8,2,QCU,58,43,41,2,1.35,95.35,41,17,70.24,Adapte,Adapte,Adapte / Adapte
2186,527,2017,Droit,8,2,QCU,66,54,47,7,1.22,87.04,47,19,70.78,Adapte,Adapte,Adapte / Adapte
3016,527,2018,Droit,8,2,QCU,79,64,55,9,1.23,85.94,55,24,69.28,Adapte,Adapte,Adapte / Adapte
3846,527,2019,Droit,8,2,QCU,95,66,64,2,1.44,96.97,64,31,67.53,Adapte,Adapte,Adapte / Adapte
4676,527,2020,Droit,8,2,QCU,112,106,82,24,1.06,77.36,82,30,73.44,Adapte,Adapte,Adapte / Adapte
527,528,2015,Droit,8,3,QCM,29,25,6,19,1.16,24.0,6,23,19.78,Trop Difficile,Trop Difficile,Trop Difficile / Trop Difficile
1357,528,2016,Droit,8,3,QCM,24,17,6,11,1.41,35.29,6,18,23.49,Difficile,Trop Difficile,Difficile / Trop Difficile
2187,528,2017,Droit,8,3,QCM,21,15,12,3,1.4,80.0,12,9,57.74,Difficile,Difficile,Difficile / Difficile
3017,528,2018,Droit,8,3,QCM,19,18,5,13,1.06,27.78,5,14,27.96,Difficile,Difficile,Difficile / Difficile
3847,528,2019,Droit,8,3,QCM,22,20,15,5,1.1,75.0,15,7,66.72,Difficile,Adapte,Difficile / Adapte
4677,528,2020,Droit,8,3,QCM,25,24,17,7,1.04,70.83,17,8,69.28,Adapte,Adapte,Adapte / Adapte
528,529,2015,Droit,8,4,QO,29,16,11,5,1.81,68.75,11,18,39.16,Difficile,Difficile,Difficile / Difficile
1358,529,2016,Droit,8,4,QO,33,24,24,0,1.38,100.0,24,9,73.75,Trop Difficile,Adapte,Trop Difficile / Adapte
2188,529,2017,Droit,8,4,QO,35,26,25,1,1.35,96.15,25,10,70.29,Adapte,Adapte,Adapte / Adapte
3018,529,2018,Droit,8,4,QO,40,30,28,2,1.33,93.33,28,12,71.16,Adapte,Adapte,Adapte / Adapte
3848,529,2019,Droit,8,4,QO,35,22,21,1,1.59,95.45,21,14,60.56,Adapte,Adapte,Adapte / Adapte
4678,529,2020,Droit,8,4,QO,30,21,21,0,1.43,100.0,21,9,70.18,Adapte,Adapte,Adapte / Adapte
529,530,2015,Droit,8,5,QCU,58,56,55,1,1.04,98.21,55,3,95.57,Trop Facile,Trop Facile,Trop Facile / Trop Facile
1359,530,2016,Droit,8,5,QCU,62,58,57,1,1.07,98.28,57,5,92.18,Difficile,Trop Facile,Difficile / Trop Facile
2189,530,2017,Droit,8,5,QCU,70,37,23,14,1.89,62.16,23,47,32.41,Difficile,Difficile,Difficile / Difficile
3019,530,2018,Droit,8,5,QCU,68,43,29,14,1.58,67.44,29,39,41.97,Difficile,Difficile,Difficile / Difficile
3849,530,2019,Droit,8,5,QCU,69,49,33,16,1.41,67.35,33,36,48.13,Difficile,Difficile,Difficile / Difficile
4679,530,2020,Droit,8,5,QCU,56,47,25,22,1.19,53.19,25,31,45.17,Difficile,Difficile,Difficile / Difficile
530,531,2015,Droit,8,6,QCU,47,47,39,8,1.0,82.98,39,8,82.3,Trop Difficile,Facile,Trop Difficile / Facile
1360,531,2016,Droit,8,6,QCU,53,42,26,16,1.26,61.9,26,27,49.03,Difficile,Difficile,Difficile / Difficile
2190,531,2017,Droit,8,6,QCU,59,40,22,18,1.48,55.0,22,37,36.47,Difficile,Difficile,Difficile / Difficile
3020,531,2018,Droit,8,6,QCU,63,63,56,7,1.0,88.89,56,7,89.46,Difficile,Trop Facile,Difficile / Trop Facile
3850,531,2019,Droit,8,6,QCU,70,52,23,29,1.35,44.23,23,47,32.73,Difficile,Difficile,Difficile / Difficile
4680,531,2020,Droit,8,6,QCU,59,57,50,7,1.04,87.72,50,9,84.37,Difficile,Facile,Difficile / Facile
531,532,2015,Droit,8,7,QCU,99,67,30,37,1.48,44.78,30,69,30.45,Difficile,Difficile,Difficile / Difficile
1361,532,2016,Droit,8,7,QCU,113,88,58,30,1.28,65.91,58,55,51.18,Difficile,Difficile,Difficile / Difficile
2191,532,2017,Droit,8,7,QCU,132,60,38,22,2.2,63.33,38,94,28.57,Difficile,Difficile,Difficile / Difficile
3021,532,2018,Droit,8,7,QCU,157,126,40,86,1.25,31.75,40,117,25.58,Difficile,Difficile,Difficile / Difficile
3851,532,2019,Droit,8,7,QCU,159,63,44,19,2.52,69.84,44,115,27.44,Difficile,Difficile,Difficile / Difficile
4681,532,2020,Droit,8,7,QCU,168,137,98,39,1.23,71.53,98,70,58.16,Difficile,Difficile,Difficile / Difficile
532,533,2015,Droit,9,1,QCU,20,12,2,10,1.67,16.67,2,18,7.9,Trop Difficile,Trop Difficile,Trop Difficile / Trop Difficile
1362,533,2016,Droit,9,1,QCU,24,14,13,1,1.71,92.86,13,11,52.77,Difficile,Difficile,Difficile / Difficile
2192,533,2017,Droit,9,1,QCU,19,14,13,1,1.36,92.86,13,6,70.06,Difficile,Adapte,Difficile / Adapte
3022,533,2018,Droit,9,1,QCU,16,12,12,0,1.33,100.0,12,4,72.62,Adapte,Adapte,Adapte / Adapte
3852,533,2019,Droit,9,1,QCU,14,11,9,2,1.27,81.82,9,5,63.86,Adapte,Adapte,Adapte / Adapte
4682,533,2020,Droit,9,1,QCU,17,12,12,0,1.42,100.0,12,5,67.89,Adapte,Adapte,Adapte / Adapte
533,534,2015,Droit,9,2,QCU,13,12,10,2,1.08,83.33,10,3,80.37,Facile,Facile,Facile / Facile
1363,534,2016,Droit,9,2,QCU,10,9,8,1,1.11,88.89,8,2,80.15,Difficile,Facile,Difficile / Facile
2193,534,2017,Droit,9,2,QCU,9,9,9,0,1.0,100.0,9,0,99.34,Difficile,Trop Facile,Difficile / Trop Facile
3023,534,2018,Droit,9,2,QCU,9,8,8,0,1.12,100.0,8,1,89.83,Difficile,Trop Facile,Difficile / Trop Facile
3853,534,2019,Droit,9,2,QCU,8,3,1,2,2.67,33.33,1,7,7.19,Difficile,Trop Difficile,Difficile / Trop Difficile
4683,534,2020,Droit,9,2,QCU,8,6,4,2,1.33,66.67,4,4,50.61,Difficile,Difficile,Difficile / Difficile
534,535,2015,Droit,9,3,QCM,28,9,7,2,3.11,77.78,7,21,23.74,Trop Difficile,Trop Difficile,Trop Difficile / Trop Difficile
1364,535,2016,Droit,9,3,QCM,29,27,13,14,1.07,48.15,13,16,43.4,Difficile,Difficile,Difficile / Difficile
2194,535,2017,Droit,9,3,QCM,33,25,9,16,1.32,36.0,9,24,28.16,Difficile,Difficile,Difficile / Difficile
3024,535,2018,Droit,9,3,QCM,38,30,12,18,1.27,40.0,12,26,31.91,Difficile,Difficile,Difficile / Difficile
3854,535,2019,Droit,9,3,QCM,44,43,43,0,1.02,100.0,43,1,97.38,Difficile,Trop Facile,Difficile / Trop Facile
4684,535,2020,Droit,9,3,QCM,37,35,30,5,1.06,85.71,30,7,81.14,Difficile,Facile,Difficile / Facile
535,536,2015,Droit,10,1,QCU,74,47,9,38,1.57,19.15,9,65,12.31,Trop Facile,Trop Difficile,Trop Facile / Trop Difficile
1365,536,2016,Droit,10,1,QCU,83,49,40,9,1.69,81.63,40,43,47.69,Difficile,Difficile,Difficile / Difficile
2195,536,2017,Droit,10,1,QCU,75,36,21,15,2.08,58.33,21,54,27.88,Difficile,Difficile,Difficile / Difficile
3025,536,2018,Droit,10,1,QCU,68,40,23,17,1.7,57.5,23,45,33.92,Difficile,Difficile,Difficile / Difficile
3855,536,2019,Droit,10,1,QCU,75,64,50,14,1.17,78.12,50,25,66.38,Difficile,Adapte,Difficile / Adapte
4685,536,2020,Droit,10,1,QCU,83,58,54,4,1.43,93.1,54,29,65.12,Adapte,Adapte,Adapte / Adapte
536,537,2015,Droit,10,2,QCU,53,50,44,6,1.06,88.0,44,9,83.55,Facile,Facile,Facile / Facile
1366,537,2016,Droit,10,2,QCU,54,38,33,5,1.42,86.84,33,21,61.82,Difficile,Adapte,Difficile / Adapte
2196,537,2017,Droit,10,2,QCU,63,48,42,6,1.31,87.5,42,21,66.51,Adapte,Adapte,Adapte / Adapte
3026,537,2018,Droit,10,2,QCU,75,62,56,6,1.21,90.32,56,19,74.68,Adapte,Adapte,Adapte / Adapte
3856,537,2019,Droit,10,2,QCU,68,54,42,12,1.26,77.78,42,26,61.55,Adapte,Adapte,Adapte / Adapte
4686,537,2020,Droit,10,2,QCU,69,46,46,0,1.5,100.0,46,23,66.34,Adapte,Adapte,Adapte / Adapte
537,538,2015,Droit,10,3,QCM,66,50,49,1,1.32,98.0,49,17,73.86,Adapte,Adapte,Adapte / Adapte
1367,538,2016,Droit,10,3,QCM,70,61,52,9,1.15,85.25,52,18,74.91,Adapte,Adapte,Adapte / Adapte
2197,538,2017,Droit,10,3,QCM,71,51,51,0,1.39,100.0,51,20,71.69,Adapte,Adapte,Adapte / Adapte
3027,538,2018,Droit,10,3,QCM,78,76,55,21,1.03,72.37,55,23,70.32,Adapte,Adapte,Adapte / Adapte
3857,538,2019,Droit,10,3,QCM,64,54,44,10,1.19,81.48,44,20,68.45,Adapte,Adapte,Adapte / Adapte
4687,538,2020,Droit,10,3,QCM,63,62,47,15,1.02,75.81,47,16,74.08,Adapte,Adapte,Adapte / Adapte
538,539,2015,Droit,10,4,QCM,71,53,43,10,1.34,81.13,43,28,60.26,Adapte,Adapte,Adapte / Adapte
1368,539,2016,Droit,10,4,QCM,73,57,47,10,1.28,82.46,47,26,64.06,Adapte,Adapte,Adapte / Adapte
2198,539,2017,Droit,10,4,QCM,74,57,49,8,1.3,85.96,49,25,66.4,Adapte,Adapte,Adapte / Adapte
3028,539,2018,Droit,10,4,QCM,73,61,52,9,1.2,85.25,52,21,71.11,Adapte,Adapte,Adapte / Adapte
3858,539,2019,Droit,10,4,QCM,60,54,37,17,1.11,68.52,37,23,61.98,Adapte,Adapte,Adapte / Adapte
4688,539,2020,Droit,10,4,QCM,68,51,45,6,1.33,88.24,45,23,66.5,Adapte,Adapte,Adapte / Adapte
539,540,2015,Droit,10,5,QCM,86,46,31,15,1.87,67.39,31,55,36.07,Difficile,Difficile,Difficile / Difficile
1369,540,2016,Droit,10,5,QCM,97,93,80,13,1.04,86.02,80,17,82.81,Difficile,Facile,Difficile / Facile
2199,540,2017,Droit,10,5,QCM,100,88,63,25,1.14,71.59,63,37,62.95,Difficile,Adapte,Difficile / Adapte
3029,540,2018,Droit,10,5,QCM,86,55,53,2,1.56,96.36,53,33,61.95,Adapte,Adapte,Adapte / Adapte
3859,540,2019,Droit,10,5,QCM,102,81,63,18,1.26,77.78,63,39,61.82,Adapte,Adapte,Adapte / Adapte
4689,540,2020,Droit,10,5,QCM,105,96,71,25,1.09,73.96,71,34,67.43,Adapte,Adapte,Adapte / Adapte
540,541,2015,Droit,10,6,QROC,21,17,16,1,1.24,94.12,16,5,76.6,Trop Difficile,Facile,Trop Difficile / Facile
1370,541,2016,Droit,10,6,QROC,24,20,14,6,1.2,70.0,14,10,58.29,Difficile,Difficile,Difficile / Difficile
2200,541,2017,Droit,10,6,QROC,26,16,13,3,1.62,81.25,13,13,50.58,Difficile,Difficile,Difficile / Difficile
3030,541,2018,Droit,10,6,QROC,24,14,12,2,1.71,85.71,12,12,48.2,Difficile,Difficile,Difficile / Difficile
3860,541,2019,Droit,10,6,QROC,23,21,13,8,1.1,61.9,13,10,54.65,Difficile,Difficile,Difficile / Difficile
4690,541,2020,Droit,10,6,QROC,22,13,9,4,1.69,69.23,9,13,39.63,Difficile,Difficile,Difficile / Difficile
541,542,2015,Droit,10,7,QCM,50,21,3,18,2.38,14.29,3,47,6.17,Difficile,Trop Difficile,Difficile / Trop Difficile
1371,542,2016,Droit,10,7,QCM,60,49,31,18,1.22,63.27,31,29,51.56,Difficile,Difficile,Difficile / Difficile
2201,542,2017,Droit,10,7,QCM,63,54,52,2,1.17,96.3,52,11,83.05,Difficile,Facile,Difficile / Facile
3031,542,2018,Droit,10,7,QCM,67,62,60,2,1.08,96.77,60,7,89.36,Difficile,Trop Facile,Difficile / Trop Facile
3861,542,2019,Droit,10,7,QCM,64,60,16,44,1.07,26.67,16,48,25.52,Difficile,Difficile,Difficile / Difficile
4691,542,2020,Droit,10,7,QCM,63,53,35,18,1.19,66.04,35,28,55.61,Difficile,Difficile,Difficile / Difficile
542,543,2015,Droit,10,8,QCM,16,12,4,8,1.33,33.33,4,12,25.02,Difficile,Difficile,Difficile / Difficile
1372,543,2016,Droit,10,8,QCM,13,12,7,5,1.08,58.33,7,6,52.48,Difficile,Difficile,Difficile / Difficile
2202,543,2017,Droit,10,8,QCM,13,6,5,1,2.17,83.33,5,8,41.35,Difficile,Difficile,Difficile / Difficile
3032,543,2018,Droit,10,8,QCM,16,12,9,3,1.33,75.0,9,7,58.1,Difficile,Difficile,Difficile / Difficile
3862,543,2019,Droit,10,8,QCM,13,13,6,7,1.0,46.15,6,7,49.96,Difficile,Difficile,Difficile / Difficile
4692,543,2020,Droit,10,8,QCM,12,7,6,1,1.71,85.71,6,6,47.39,Difficile,Difficile,Difficile / Difficile
543,544,2015,Droit,10,9,QCU,50,37,29,8,1.35,78.38,29,21,58.53,Difficile,Difficile,Difficile / Difficile
1373,544,2016,Droit,10,9,QCU,40,32,7,25,1.25,21.88,7,33,16.88,Difficile,Trop Difficile,Difficile / Trop Difficile
2203,544,2017,Droit,10,9,QCU,48,40,37,3,1.2,92.5,37,11,77.06,Difficile,Facile,Difficile / Facile
3033,544,2018,Droit,10,9,QCU,54,41,23,18,1.32,56.1,23,31,42.65,Difficile,Difficile,Difficile / Difficile
3863,544,2019,Droit,10,9,QCU,59,35,12,23,1.69,34.29,12,47,19.92,Difficile,Trop Difficile,Difficile / Trop Difficile
4693,544,2020,Droit,10,9,QCU,65,30,18,12,2.17,60.0,18,47,28.2,Difficile,Difficile,Difficile / Difficile
544,545,2015,Droit,10,10,QROC,70,57,43,14,1.23,75.44,43,27,61.11,Trop Difficile,Adapte,Trop Difficile / Adapte
1374,545,2016,Droit,10,10,QROC,82,74,52,22,1.11,70.27,52,30,63.52,Adapte,Adapte,Adapte / Adapte
2204,545,2017,Droit,10,10,QROC,96,84,71,13,1.14,84.52,71,25,73.84,Adapte,Adapte,Adapte / Adapte
3034,545,2018,Droit,10,10,QROC,83,72,57,15,1.15,79.17,57,26,68.83,Adapte,Adapte,Adapte / Adapte
3864,545,2019,Droit,10,10,QROC,72,49,47,2,1.47,95.92,47,25,65.03,Adapte,Adapte,Adapte / Adapte
4694,545,2020,Droit,10,10,QROC,85,62,61,1,1.37,98.39,61,24,71.42,Adapte,Adapte,Adapte / Adapte
545,546,2015,Droit,10,11,QCM,23,17,15,2,1.35,88.24,15,8,65.15,Adapte,Adapte,Adapte / Adapte
1375,546,2016,Droit,10,11,QCM,20,15,14,1,1.33,93.33,14,6,69.75,Adapte,Adapte,Adapte / Adapte
2205,546,2017,Droit,10,11,QCM,23,21,17,4,1.1,80.95,17,6,72.33,Adapte,Adapte,Adapte / Adapte
3035,546,2018,Droit,10,11,QCM,22,20,16,4,1.1,80.0,16,6,72.89,Adapte,Adapte,Adapte / Adapte
3865,546,2019,Droit,10,11,QCM,23,22,17,5,1.05,77.27,17,6,74.27,Adapte,Adapte,Adapte / Adapte
4695,546,2020,Droit,10,11,QCM,20,19,14,5,1.05,73.68,14,6,70.27,Adapte,Adapte,Adapte / Adapte
546,547,2015,Droit,10,12,QCU,40,38,28,10,1.05,73.68,28,12,70.54,Facile,Adapte,Facile / Adapte
1376,547,2016,Droit,10,12,QCU,48,45,29,16,1.07,64.44,29,19,60.34,Adapte,Adapte,Adapte / Adapte
2206,547,2017,Droit,10,12,QCU,42,40,30,10,1.05,75.0,30,12,71.29,Adapte,Adapte,Adapte / Adapte
3036,547,2018,Droit,10,12,QCU,42,41,28,13,1.02,68.29,28,14,67.57,Adapte,Adapte,Adapte / Adapte
3866,547,2019,Droit,10,12,QCU,49,40,35,5,1.23,87.5,35,14,71.67,Adapte,Adapte,Adapte / Adapte
4696,547,2020,Droit,10,12,QCU,59,57,38,19,1.04,66.67,38,21,64.91,Adapte,Adapte,Adapte / Adapte
547,548,2015,Droit,11,1,QCM,24,20,20,0,1.2,100.0,20,4,81.31,Facile,Facile,Facile / Facile
1377,548,2016,Droit,11,1,QCM,23,23,22,1,1.0,95.65,22,1,96.89,Difficile,Trop Facile,Difficile / Trop Facile
2207,548,2017,Droit,11,1,QCM,18,18,8,10,1.0,44.44,8,10,43.19,Difficile,Difficile,Difficile / Difficile
3037,548,2018,Droit,11,1,QCM,20,13,7,6,1.54,53.85,7,13,37.29,Difficile,Difficile,Difficile / Difficile
3867,548,2019,Droit,11,1,QCM,20,15,5,10,1.33,33.33,5,15,25.93,Difficile,Difficile,Difficile / Difficile
4697,548,2020,Droit,11,1,QCM,17,15,1,14,1.13,6.67,1,16,4.65,Difficile,Trop Difficile,Difficile / Trop Difficile
548,549,2015,Droit,11,2,QCM,51,33,24,9,1.55,72.73,24,27,47.07,Difficile,Difficile,Difficile / Difficile
1378,549,2016,Droit,11,2,QCM,42,40,25,15,1.05,62.5,25,17,58.44,Difficile,Difficile,Difficile / Difficile
2208,549,2017,Droit,11,2,QCM,35,32,29,3,1.09,90.62,29,6,84.15,Difficile,Facile,Difficile / Facile
3038,549,2018,Droit,11,2,QCM,38,31,21,10,1.23,67.74,21,17,54.24,Difficile,Difficile,Difficile / Difficile
3868,549,2019,Droit,11,2,QCM,39,35,35,0,1.11,100.0,35,4,89.68,Difficile,Trop Facile,Difficile / Trop Facile
4698,549,2020,Droit,11,2,QCM,40,33,32,1,1.21,96.97,32,8,79.31,Difficile,Facile,Difficile / Facile
549,550,2015,Droit,11,3,QCM,45,33,29,4,1.36,87.88,29,16,64.64,Trop Difficile,Adapte,Trop Difficile / Adapte
1379,550,2016,Droit,11,3,QCM,38,37,24,13,1.03,64.86,24,14,63.96,Adapte,Adapte,Adapte / Adapte
2209,550,2017,Droit,11,3,QCM,30,27,21,6,1.11,77.78,21,9,68.62,Adapte,Adapte,Adapte / Adapte
3039,550,2018,Droit,11,3,QCM,24,20,16,4,1.2,80.0,16,8,66.35,Adapte,Adapte,Adapte / Adapte
3869,550,2019,Droit,11,3,QCM,27,23,20,3,1.17,86.96,20,7,72.31,Adapte,Adapte,Adapte / Adapte
4699,550,2020,Droit,11,3,QCM,31,28,23,5,1.11,82.14,23,8,72.66,Adapte,Adapte,Adapte / Adapte
550,551,2015,Droit,11,4,QCU,58,57,41,16,1.02,71.93,41,17,70.9,Trop Facile,Adapte,Trop Facile / Adapte
1380,551,2016,Droit,11,4,QCU,56,40,38,2,1.4,95.0,38,18,67.64,Adapte,Adapte,Adapte / Adapte
2210,551,2017,Droit,11,4,QCU,58,46,43,3,1.26,93.48,43,15,74.01,Adapte,Adapte,Adapte / Adapte
3040,551,2018,Droit,11,4,QCU,58,49,42,7,1.18,85.71,42,16,72.94,Adapte,Adapte,Adapte / Adapte
3870,551,2019,Droit,11,4,QCU,51,38,32,6,1.34,84.21,32,19,62.5,Adapte,Adapte,Adapte / Adapte
4700,551,2020,Droit,11,4,QCU,58,40,38,2,1.45,95.0,38,20,64.82,Adapte,Adapte,Adapte / Adapte
551,552,2015,Droit,11,5,QCU,36,34,28,6,1.06,82.35,28,8,76.82,Facile,Facile,Facile / Facile
1381,552,2016,Droit,11,5,QCU,36,28,27,1,1.29,96.43,27,9,76.2,Difficile,Facile,Difficile / Facile
2211,552,2017,Droit,11,5,QCU,31,23,14,9,1.35,60.87,14,17,46.15,Difficile,Difficile,Difficile / Difficile
3041,552,2018,Droit,11,5,QCU,25,23,8,15,1.09,34.78,8,17,31.31,Difficile,Difficile,Difficile / Difficile
3871,552,2019,Droit,11,5,QCU,20,9,2,7,2.22,22.22,2,18,9.06,Difficile,Trop Difficile,Difficile / Trop Difficile
4701,552,2020,Droit,11,5,QCU,23,16,14,2,1.44,87.5,14,9,58.94,Difficile,Difficile,Difficile / Difficile
552,553,2015,Droit,11,6,QCU,59,58,27,31,1.02,46.55,27,32,46.42,Difficile,Difficile,Difficile / Difficile
1382,553,2016,Droit,11,6,QCU,71,70,69,1,1.01,98.57,69,2,97.2,Difficile,Trop Facile,Difficile / Trop Facile
2212,553,2017,Droit,11,6,QCU,59,48,38,10,1.23,79.17,38,21,64.69,Difficile,Adapte,Difficile / Adapte
3042,553,2018,Droit,11,6,QCU,52,43,36,7,1.21,83.72,36,16,68.82,Adapte,Adapte,Adapte / Adapte
3872,553,2019,Droit,11,6,QCU,46,44,31,13,1.05,70.45,31,15,67.07,Adapte,Adapte,Adapte / Adapte
4702,553,2020,Droit,11,6,QCU,55,45,37,8,1.22,82.22,37,18,67.69,Adapte,Adapte,Adapte / Adapte
553,554,2015,Droit,12,1,QCM,58,56,55,1,1.04,98.21,55,3,95.67,Trop Facile,Trop Facile,Trop Facile / Trop Facile
1383,554,2016,Droit,12,1,QCM,58,35,18,17,1.66,51.43,18,40,30.62,Difficile,Difficile,Difficile / Difficile
2213,554,2017,Droit,12,1,QCM,54,25,16,9,2.16,64.0,16,38,29.33,Difficile,Difficile,Difficile / Difficile
3043,554,2018,Droit,12,1,QCM,49,48,41,7,1.02,85.42,41,8,84.2,Difficile,Facile,Difficile / Facile
3873,554,2019,Droit,12,1,QCM,58,44,4,40,1.32,9.09,4,54,6.46,Difficile,Trop Difficile,Difficile / Trop Difficile
4703,554,2020,Droit,12,1,QCM,69,41,26,15,1.68,63.41,26,43,37.1,Difficile,Difficile,Difficile / Difficile
554,555,2015,Droit,13,1,QCU,55,48,42,6,1.15,87.5,42,13,76.88,Facile,Facile,Facile / Facile
1384,555,2016,Droit,13,1,QCU,59,48,27,21,1.23,56.25,27,32,45.11,Difficile,Difficile,Difficile / Difficile
2214,555,2017,Droit,13,1,QCU,66,23,21,2,2.87,91.3,21,45,32.26,Difficile,Difficile,Difficile / Difficile
3044,555,2018,Droit,13,1,QCU,78,55,25,30,1.42,45.45,25,53,32.65,Difficile,Difficile,Difficile / Difficile
3874,555,2019,Droit,13,1,QCU,80,62,0,62,1.29,0.0,0,80,0.27,Difficile,Trop Difficile,Difficile / Trop Difficile
4704,555,2020,Droit,13,1,QCU,81,74,68,6,1.09,91.89,68,13,84.11,Difficile,Facile,Difficile / Facile
555,556,2015,Droit,13,2,QROC,12,9,1,8,1.33,11.11,1,11,11.17,Trop Difficile,Trop Difficile,Trop Difficile / Trop Difficile
1385,556,2016,Droit,13,2,QROC,13,8,4,4,1.62,50.0,4,9,30.41,Difficile,Difficile,Difficile / Difficile
2215,556,2017,Droit,13,2,QROC,14,13,13,0,1.08,100.0,13,1,94.46,Difficile,Trop Facile,Difficile / Trop Facile
3045,556,2018,Droit,13,2,QROC,14,12,6,6,1.17,50.0,6,8,43.5,Difficile,Difficile,Difficile / Difficile
3875,556,2019,Droit,13,2,QROC,15,12,5,7,1.25,41.67,5,10,31.51,Difficile,Difficile,Difficile / Difficile
4705,556,2020,Droit,13,2,QROC,17,11,8,3,1.55,72.73,8,9,45.98,Difficile,Difficile,Difficile / Difficile
556,557,2015,Droit,13,3,QCU,91,86,1,85,1.06,1.16,1,90,1.1,Trop Difficile,Trop Difficile,Trop Difficile / Trop Difficile
1386,557,2016,Droit,13,3,QCU,92,92,91,1,1.0,98.91,91,1,99.25,Difficile,Trop Facile,Difficile / Trop Facile
2216,557,2017,Droit,13,3,QCU,82,75,64,11,1.09,85.33,64,18,78.63,Difficile,Facile,Difficile / Facile
3046,557,2018,Droit,13,3,QCU,89,32,27,5,2.78,84.38,27,62,29.96,Difficile,Difficile,Difficile / Difficile
3876,557,2019,Droit,13,3,QCU,105,47,39,8,2.23,82.98,39,66,36.74,Difficile,Difficile,Difficile / Difficile
4706,557,2020,Droit,13,3,QCU,115,77,64,13,1.49,83.12,64,51,55.53,Difficile,Difficile,Difficile / Difficile
557,558,2015,Droit,13,4,QCM,22,15,9,6,1.47,60.0,9,13,39.54,Difficile,Difficile,Difficile / Difficile
1387,558,2016,Droit,13,4,QCM,24,21,17,4,1.14,80.95,17,7,70.76,Difficile,Adapte,Difficile / Adapte
2217,558,2017,Droit,13,4,QCM,29,20,19,1,1.45,95.0,19,10,65.69,Adapte,Adapte,Adapte / Adapte
3047,558,2018,Droit,13,4,QCM,25,23,16,7,1.09,69.57,16,9,63.29,Adapte,Adapte,Adapte / Adapte
3877,558,2019,Droit,13,4,QCM,21,17,15,2,1.24,88.24,15,6,73.48,Adapte,Adapte,Adapte / Adapte
4707,558,2020,Droit,13,4,QCM,18,18,13,5,1.0,72.22,13,5,74.0,Adapte,Adapte,Adapte / Adapte
558,559,2015,Droit,13,5,QCU,9,7,7,0,1.29,100.0,7,2,78.95,Facile,Facile,Facile / Facile
1388,559,2016,Droit,13,5,QCU,9,6,6,0,1.5,100.0,6,3,67.14,Difficile,Adapte,Difficile / Adapte
2218,559,2017,Droit,13,5,QCU,11,10,8,2,1.1,80.0,8,3,68.78,Adapte,Adapte,Adapte / Adapte
3048,559,2018,Droit,13,5,QCU,11,9,7,2,1.22,77.78,7,4,67.4,Adapte,Adapte,Adapte / Adapte
3878,559,2019,Droit,13,5,QCU,11,10,7,3,1.1,70.0,7,4,61.55,Adapte,Adapte,Adapte / Adapte
4708,559,2020,Droit,13,5,QCU,12,10,9,1,1.2,90.0,9,3,74.83,Adapte,Adapte,Adapte / Adapte
559,560,2015,Droit,13,6,QCM,62,37,5,32,1.68,13.51,5,57,8.21,Trop Difficile,Trop Difficile,Trop Difficile / Trop Difficile
1389,560,2016,Droit,13,6,QCM,57,46,10,36,1.24,21.74,10,47,17.1,Difficile,Trop Difficile,Difficile / Trop Difficile
2219,560,2017,Droit,13,6,QCM,57,52,51,1,1.1,98.08,51,6,90.04,Difficile,Trop Facile,Difficile / Trop Facile
3049,560,2018,Droit,13,6,QCM,63,35,27,8,1.8,77.14,27,36,43.49,Difficile,Difficile,Difficile / Difficile
3879,560,2019,Droit,13,6,QCM,64,38,28,10,1.68,73.68,28,36,43.42,Difficile,Difficile,Difficile / Difficile
4709,560,2020,Droit,13,6,QCM,59,42,34,8,1.4,80.95,34,25,56.82,Difficile,Difficile,Difficile / Difficile
560,561,2015,Droit,13,7,QCM,47,45,39,6,1.04,86.67,39,8,82.65,Facile,Facile,Facile / Facile
1390,561,2016,Droit,13,7,QCM,43,31,19,12,1.39,61.29,19,24,43.15,Difficile,Difficile,Difficile / Difficile
2220,561,2017,Droit,13,7,QCM,36,26,18,8,1.38,69.23,18,18,50.12,Difficile,Difficile,Difficile / Difficile
3050,561,2018,Droit,13,7,QCM,42,25,18,7,1.68,72.0,18,24,43.59,Difficile,Difficile,Difficile / Difficile
3880,561,2019,Droit,13,7,QCM,34,29,19,10,1.17,65.52,19,15,55.69,Difficile,Difficile,Difficile / Difficile
4710,561,2020,Droit,13,7,QCM,28,19,17,2,1.47,89.47,17,11,58.97,Difficile,Difficile,Difficile / Difficile
561,562,2015,Droit,13,8,QCM,44,33,6,27,1.33,18.18,6,38,14.63,Trop Difficile,Trop Difficile,Trop Difficile / Trop Difficile
1391,562,2016,Droit,13,8,QCM,48,22,16,6,2.18,72.73,16,32,32.69,Difficile,Difficile,Difficile / Difficile
2221,562,2017,Droit,13,8,QCM,46,25,17,8,1.84,68.0,17,29,37.91,Difficile,Difficile,Difficile / Difficile
3051,562,2018,Droit,13,8,QCM,47,42,31,11,1.12,73.81,31,16,66.49,Difficile,Adapte,Difficile / Adapte
3881,562,2019,Droit,13,8,QCM,46,42,32,10,1.1,76.19,32,14,69.68,Adapte,Adapte,Adapte / Adapte
4711,562,2020,Droit,13,8,QCM,49,47,30,17,1.04,63.83,30,19,62.04,Adapte,Adapte,Adapte / Adapte
562,563,2015,Droit,14,1,QCM,64,62,50,12,1.03,80.65,50,14,77.73,Adapte,Facile,Adapte / Facile
1392,563,2016,Droit,14,1,QCM,67,54,51,3,1.24,94.44,51,16,76.14,Difficile,Facile,Difficile / Facile
2222,563,2017,Droit,14,1,QCM,64,48,19,29,1.33,39.58,19,45,29.74,Difficile,Difficile,Difficile / Difficile
3052,563,2018,Droit,14,1,QCM,52,40,28,12,1.3,70.0,28,24,53.36,Difficile,Difficile,Difficile / Difficile
3882,563,2019,Droit,14,1,QCM,61,60,52,8,1.02,86.67,52,9,84.61,Difficile,Facile,Difficile / Facile
4712,563,2020,Droit,14,1,QCM,63,43,30,13,1.47,69.77,30,33,48.26,Difficile,Difficile,Difficile / Difficile
563,564,2015,Droit,14,2,QCM,86,86,69,17,1.0,80.23,69,17,80.33,Facile,Facile,Facile / Facile
1393,564,2016,Droit,14,2,QCM,89,59,40,19,1.51,67.8,40,49,44.9,Difficile,Difficile,Difficile / Difficile
2223,564,2017,Droit,14,2,QCM,86,81,33,48,1.06,40.74,33,53,37.87,Difficile,Difficile,Difficile / Difficile
3053,564,2018,Droit,14,2,QCM,81,52,48,4,1.56,92.31,48,33,58.73,Difficile,Difficile,Difficile / Difficile
3883,564,2019,Droit,14,2,QCM,95,90,33,57,1.06,36.67,33,62,34.78,Difficile,Difficile,Difficile / Difficile
4713,564,2020,Droit,14,2,QCM,83,72,55,17,1.15,76.39,55,28,65.99,Difficile,Adapte,Difficile / Adapte
564,565,2015,Droit,14,3,QCM,69,60,59,1,1.15,98.33,59,10,84.87,Facile,Facile,Facile / Facile
1394,565,2016,Droit,14,3,QCM,75,60,30,30,1.25,50.0,30,45,40.06,Difficile,Difficile,Difficile / Difficile
2224,565,2017,Droit,14,3,QCM,82,63,40,23,1.3,63.49,40,42,48.7,Difficile,Difficile,Difficile / Difficile
3054,565,2018,Droit,14,3,QCM,86,76,28,48,1.13,36.84,28,58,33.13,Difficile,Difficile,Difficile / Difficile
3884,565,2019,Droit,14,3,QCM,102,100,99,1,1.02,99.0,99,3,97.53,Difficile,Trop Facile,Difficile / Trop Facile
4714,565,2020,Droit,14,3,QCM,105,36,27,9,2.92,75.0,27,78,25.85,Difficile,Difficile,Difficile / Difficile
565,566,2015,Droit,15,1,QROC,47,43,2,41,1.09,4.65,2,45,5.15,Trop Difficile,Trop Difficile,Trop Difficile / Trop Difficile
1395,566,2016,Droit,15,1,QROC,45,29,1,28,1.55,3.45,1,44,3.06,Difficile,Trop Difficile,Difficile / Trop Difficile
2225,566,2017,Droit,15,1,QROC,42,20,1,19,2.1,5.0,1,41,1.37,Difficile,Trop Difficile,Difficile / Trop Difficile
3055,566,2018,Droit,15,1,QROC,41,41,37,4,1.0,90.24,37,4,90.5,Difficile,Trop Facile,Difficile / Trop Facile
3885,566,2019,Droit,15,1,QROC,40,34,4,30,1.18,11.76,4,36,9.29,Difficile,Trop Difficile,Difficile / Trop Difficile
4715,566,2020,Droit,15,1,QROC,43,32,7,25,1.34,21.88,7,36,16.51,Difficile,Trop Difficile,Difficile / Trop Difficile
566,567,2015,Droit,15,2,QROC,72,55,23,32,1.31,41.82,23,49,31.57,Adapte,Difficile,Adapte / Difficile
1396,567,2016,Droit,15,2,QROC,64,60,25,35,1.07,41.67,25,39,39.09,Difficile,Difficile,Difficile / Difficile
2226,567,2017,Droit,15,2,QROC,60,30,26,4,2.0,86.67,26,34,43.01,Difficile,Difficile,Difficile / Difficile
3056,567,2018,Droit,15,2,QROC,48,32,2,30,1.5,6.25,2,46,4.57,Difficile,Trop Difficile,Difficile / Trop Difficile
3886,567,2019,Droit,15,2,QROC,52,40,11,29,1.3,27.5,11,41,21.79,Difficile,Trop Difficile,Difficile / Trop Difficile
4716,567,2020,Droit,15,2,QROC,48,20,3,17,2.4,15.0,3,45,6.61,Difficile,Trop Difficile,Difficile / Trop Difficile
567,568,2015,Droit,15,3,QCM,23,22,18,4,1.05,81.82,18,5,76.66,Trop Facile,Facile,Trop Facile / Facile
1397,568,2016,Droit,15,3,QCM,18,16,6,10,1.12,37.5,6,12,34.11,Difficile,Difficile,Difficile / Difficile
2227,568,2017,Droit,15,3,QCM,17,13,9,4,1.31,69.23,9,8,53.4,Difficile,Difficile,Difficile / Difficile
3057,568,2018,Droit,15,3,QCM,20,13,10,3,1.54,76.92,10,10,52.21,Difficile,Difficile,Difficile / Difficile
3887,568,2019,Droit,15,3,QCM,24,12,10,2,2.0,83.33,10,14,43.4,Difficile,Difficile,Difficile / Difficile
4717,568,2020,Droit,15,3,QCM,28,7,5,2,4.0,71.43,5,23,18.24,Difficile,Trop Difficile,Difficile / Trop Difficile
568,569,2015,Droit,15,4,QCM,36,25,24,1,1.44,96.0,24,12,67.42,Difficile,Adapte,Difficile / Adapte
1398,569,2016,Droit,15,4,QCM,34,26,22,4,1.31,84.62,22,12,65.82,Adapte,Adapte,Adapte / Adapte
2228,569,2017,Droit,15,4,QCM,27,21,20,1,1.29,95.24,20,7,72.91,Adapte,Adapte,Adapte / Adapte
3058,569,2018,Droit,15,4,QCM,22,16,15,1,1.38,93.75,15,7,66.01,Adapte,Adapte,Adapte / Adapte
3888,569,2019,Droit,15,4,QCM,24,17,15,2,1.41,88.24,15,9,61.34,Adapte,Adapte,Adapte / Adapte
4718,569,2020,Droit,15,4,QCM,22,19,15,4,1.16,78.95,15,7,68.86,Adapte,Adapte,Adapte / Adapte
569,570,2015,Droit,15,5,QCU,53,40,3,37,1.32,7.5,3,50,5.92,Adapte,Trop Difficile,Adapte / Trop Difficile
1399,570,2016,Droit,15,5,QCU,62,30,24,6,2.07,80.0,24,38,38.51,Difficile,Difficile,Difficile / Difficile
2229,570,2017,Droit,15,5,QCU,74,37,31,6,2.0,83.78,31,43,42.19,Difficile,Difficile,Difficile / Difficile
3059,570,2018,Droit,15,5,QCU,68,64,62,2,1.06,96.88,62,6,91.9,Difficile,Trop Facile,Difficile / Trop Facile
3889,570,2019,Droit,15,5,QCU,71,53,23,30,1.34,43.4,23,48,32.45,Difficile,Difficile,Difficile / Difficile
4719,570,2020,Droit,15,5,QCU,72,54,32,22,1.33,59.26,32,40,43.99,Difficile,Difficile,Difficile / Difficile
570,571,2015,Droit,15,6,QCM,98,83,82,1,1.18,98.8,82,16,83.78,Facile,Facile,Facile / Facile
1400,571,2016,Droit,15,6,QCM,103,85,81,4,1.21,95.29,81,22,78.49,Difficile,Facile,Difficile / Facile
2230,571,2017,Droit,15,6,QCM,93,74,32,42,1.26,43.24,32,61,34.11,Difficile,Difficile,Difficile / Difficile
3060,571,2018,Droit,15,6,QCM,112,99,65,34,1.13,65.66,65,47,58.34,Difficile,Difficile,Difficile / Difficile
3890,571,2019,Droit,15,6,QCM,114,72,60,12,1.58,83.33,60,54,52.26,Difficile,Difficile,Difficile / Difficile
4720,571,2020,Droit,15,6,QCM,117,101,65,36,1.16,64.36,65,52,55.29,Difficile,Difficile,Difficile / Difficile
571,572,2015,Droit,15,7,QO,58,40,32,8,1.45,80.0,32,26,54.81,Trop Difficile,Difficile,Trop Difficile / Difficile
1401,572,2016,Droit,15,7,QO,64,60,13,47,1.07,21.67,13,51,19.94,Trop Difficile,Trop Difficile,Trop Difficile / Trop Difficile
2231,572,2017,Droit,15,7,QO,55,49,9,40,1.12,18.37,9,46,16.27,Trop Difficile,Trop Difficile,Trop Difficile / Trop Difficile
3061,572,2018,Droit,15,7,QO,61,51,14,37,1.2,27.45,14,47,23.29,Trop Difficile,Trop Difficile,Trop Difficile / Trop Difficile
3891,572,2019,Droit,15,7,QO,57,49,2,47,1.16,4.08,2,55,3.7,Trop Difficile,Trop Difficile,Trop Difficile / Trop Difficile
4721,572,2020,Droit,15,7,QO,62,48,41,7,1.29,85.42,41,21,65.49,Trop Difficile,Adapte,Trop Difficile / Adapte
572,573,2015,Droit,15,8,QCU,98,92,80,12,1.07,86.96,80,18,82.09,Facile,Facile,Facile / Facile
1402,573,2016,Droit,15,8,QCU,110,71,34,37,1.55,47.89,34,76,30.89,Difficile,Difficile,Difficile / Difficile
2232,573,2017,Droit,15,8,QCU,112,91,46,45,1.23,50.55,46,66,41.28,Difficile,Difficile,Difficile / Difficile
3062,573,2018,Droit,15,8,QCU,117,111,84,27,1.05,75.68,84,33,71.93,Difficile,Adapte,Difficile / Adapte
3892,573,2019,Droit,15,8,QCU,121,100,83,17,1.21,83.0,83,38,68.7,Adapte,Adapte,Adapte / Adapte
4722,573,2020,Droit,15,8,QCU,108,99,80,19,1.09,80.81,80,28,73.71,Adapte,Adapte,Adapte / Adapte
573,574,2015,Droit,15,9,QCM,88,83,12,71,1.06,14.46,12,76,13.51,Trop Difficile,Trop Difficile,Trop Difficile / Trop Difficile
1403,574,2016,Droit,15,9,QCM,81,43,41,2,1.88,95.35,41,40,50.6,Difficile,Difficile,Difficile / Difficile
2233,574,2017,Droit,15,9,QCM,72,72,65,7,1.0,90.28,65,7,90.72,Difficile,Trop Facile,Difficile / Trop Facile
3063,574,2018,Droit,15,9,QCM,68,64,35,29,1.06,54.69,35,33,51.21,Difficile,Difficile,Difficile / Difficile
3893,574,2019,Droit,15,9,QCM,73,66,36,30,1.11,54.55,36,37,48.86,Difficile,Difficile,Difficile / Difficile
4723,574,2020,Droit,15,9,QCM,81,73,46,27,1.11,63.01,46,35,56.9,Difficile,Difficile,Difficile / Difficile
574,575,2015,Droit,15,10,QCU,42,25,22,3,1.68,88.0,22,20,53.14,Difficile,Difficile,Difficile / Difficile
1404,575,2016,Droit,15,10,QCU,45,40,39,1,1.12,97.5,39,6,86.5,Difficile,Trop Facile,Difficile / Trop Facile
2234,575,2017,Droit,15,10,QCU,43,36,34,2,1.19,94.44,34,9,79.6,Difficile,Facile,Difficile / Facile
3064,575,2018,Droit,15,10,QCU,44,28,25,3,1.57,89.29,25,19,57.04,Difficile,Difficile,Difficile / Difficile
3894,575,2019,Droit,15,10,QCU,48,31,12,19,1.55,38.71,12,36,25.33,Difficile,Difficile,Difficile / Difficile
4724,575,2020,Droit,15,10,QCU,44,40,11,29,1.1,27.5,11,33,25.53,Difficile,Difficile,Difficile / Difficile
575,576,2015,Droit,15,11,QCU,46,40,33,7,1.15,82.5,33,13,72.69,Trop Difficile,Adapte,Trop Difficile / Adapte
1405,576,2016,Droit,15,11,QCU,46,34,33,1,1.35,97.06,33,13,72.63,Adapte,Adapte,Adapte / Adapte
2235,576,2017,Droit,15,11,QCU,54,46,34,12,1.17,73.91,34,20,63.6,Adapte,Adapte,Adapte / Adapte
3065,576,2018,Droit,15,11,QCU,48,40,35,5,1.2,87.5,35,13,71.91,Adapte,Adapte,Adapte / Adapte
3895,576,2019,Droit,15,11,QCU,52,46,32,14,1.13,69.57,32,20,61.5,Adapte,Adapte,Adapte / Adapte
4725,576,2020,Droit,15,11,QCU,62,50,43,7,1.24,86.0,43,19,68.91,Adapte,Adapte,Adapte / Adapte
576,577,2015,Droit,15,12,QCU,86,59,37,22,1.46,62.71,37,49,42.6,Facile,Difficile,Facile / Difficile
1406,577,2016,Droit,15,12,QCU,81,51,40,11,1.59,78.43,40,41,49.67,Difficile,Difficile,Difficile / Difficile
2236,577,2017,Droit,15,12,QCU,67,50,34,16,1.34,68.0,34,33,50.2,Difficile,Difficile,Difficile / Difficile
3066,577,2018,Droit,15,12,QCU,79,53,34,19,1.49,64.15,34,45,43.57,Difficile,Difficile,Difficile / Difficile
3896,577,2019,Droit,15,12,QCU,76,38,23,15,2.0,60.53,23,53,30.43,Difficile,Difficile,Difficile / Difficile
4726,577,2020,Droit,15,12,QCU,76,64,43,21,1.19,67.19,43,33,56.79,Difficile,Difficile,Difficile / Difficile
577,578,2015,Droit,15,13,QCU,70,42,35,7,1.67,83.33,35,35,50.54,Difficile,Difficile,Difficile / Difficile
1407,578,2016,Droit,15,13,QCU,82,68,52,16,1.21,76.47,52,30,63.8,Difficile,Adapte,Difficile / Adapte
2237,578,2017,Droit,15,13,QCU,66,65,49,16,1.02,75.38,49,17,73.98,Adapte,Adapte,Adapte / Adapte
3067,578,2018,Droit,15,13,QCU,55,44,41,3,1.25,93.18,41,14,74.82,Adapte,Adapte,Adapte / Adapte
3897,578,2019,Droit,15,13,QCU,66,65,45,20,1.02,69.23,45,21,68.17,Adapte,Adapte,Adapte / Adapte
4727,578,2020,Droit,15,13,QCU,64,62,47,15,1.03,75.81,47,17,73.92,Adapte,Adapte,Adapte / Adapte
578,579,2015,Droit,15,14,QROC,26,18,10,8,1.44,55.56,10,16,37.05,Difficile,Difficile,Difficile / Difficile
1408,579,2016,Droit,15,14,QROC,30,28,19,9,1.07,67.86,19,11,64.67,Difficile,Adapte,Difficile / Adapte
2238,579,2017,Droit,15,14,QROC,34,27,25,2,1.26,92.59,25,9,74.85,Adapte,Adapte,Adapte / Adapte
3068,579,2018,Droit,15,14,QROC,38,33,27,6,1.15,81.82,27,11,70.5,Adapte,Adapte,Adapte / Adapte
3898,579,2019,Droit,15,14,QROC,34,34,23,11,1.0,67.65,23,11,67.35,Adapte,Adapte,Adapte / Adapte
4728,579,2020,Droit,15,14,QROC,39,38,26,12,1.03,68.42,26,13,67.43,Adapte,Adapte,Adapte / Adapte
579,580,2015,Droit,16,1,QCU,12,10,9,1,1.2,90.0,9,3,76.44,Facile,Facile,Facile / Facile
1409,580,2016,Droit,16,1,QCU,11,10,10,0,1.1,100.0,10,1,88.3,Difficile,Trop Facile,Difficile / Trop Facile
2239,580,2017,Droit,16,1,QCU,12,12,10,2,1.0,83.33,10,2,80.98,Difficile,Facile,Difficile / Facile
3069,580,2018,Droit,16,1,QCU,10,6,4,2,1.67,66.67,4,6,41.93,Difficile,Difficile,Difficile / Difficile
3899,580,2019,Droit,16,1,QCU,9,7,4,3,1.29,57.14,4,5,42.56,Difficile,Difficile,Difficile / Difficile
4729,580,2020,Droit,16,1,QCU,9,7,2,5,1.29,28.57,2,7,27.73,Difficile,Difficile,Difficile / Difficile
580,581,2015,Droit,16,2,QCU,7,6,4,2,1.17,66.67,4,3,57.52,Adapte,Difficile,Adapte / Difficile
1410,581,2016,Droit,16,2,QCU,6,3,2,1,2.0,66.67,2,4,34.26,Difficile,Difficile,Difficile / Difficile
2240,581,2017,Droit,16,2,QCU,7,4,4,0,1.75,100.0,4,3,58.6,Difficile,Difficile,Difficile / Difficile
3070,581,2018,Droit,16,2,QCU,7,5,4,1,1.4,80.0,4,3,54.86,Difficile,Difficile,Difficile / Difficile
3900,581,2019,Droit,16,2,QCU,6,3,3,0,2.0,100.0,3,3,54.03,Difficile,Difficile,Difficile / Difficile
4730,581,2020,Droit,16,2,QCU,5,2,0,2,2.5,0.0,0,5,1.48,Difficile,Trop Difficile,Difficile / Trop Difficile
581,582,2015,Droit,16,3,QCM,57,56,35,21,1.02,62.5,35,22,62.18,Trop Facile,Adapte,Trop Facile / Adapte
1411,582,2016,Droit,16,3,QCM,56,48,37,11,1.17,77.08,37,19,66.05,Adapte,Adapte,Adapte / Adapte
2241,582,2017,Droit,16,3,QCM,48,43,32,11,1.12,74.42,32,16,67.55,Adapte,Adapte,Adapte / Adapte
3071,582,2018,Droit,16,3,QCM,47,40,34,6,1.18,85.0,34,13,73.3,Adapte,Adapte,Adapte / Adapte
3901,582,2019,Droit,16,3,QCM,40,37,27,10,1.08,72.97,27,13,68.36,Adapte,Adapte,Adapte / Adapte
4731,582,2020,Droit,16,3,QCM,33,28,24,4,1.18,85.71,24,9,74.12,Adapte,Adapte,Adapte / Adapte
582,583,2015,Droit,16,4,QCU,60,33,10,23,1.82,30.3,10,50,16.04,Trop Difficile,Trop Difficile,Trop Difficile / Trop Difficile
1412,583,2016,Droit,16,4,QCU,59,37,6,31,1.59,16.22,6,53,10.27,Difficile,Trop Difficile,Difficile / Trop Difficile
2242,583,2017,Droit,16,4,QCU,68,28,17,11,2.43,60.71,17,51,25.72,Difficile,Difficile,Difficile / Difficile
3072,583,2018,Droit,16,4,QCU,67,58,4,54,1.16,6.9,4,63,5.6,Difficile,Trop Difficile,Difficile / Trop Difficile
3902,583,2019,Droit,16,4,QCU,62,52,28,24,1.19,53.85,28,34,45.65,Difficile,Difficile,Difficile / Difficile
4732,583,2020,Droit,16,4,QCU,69,42,37,5,1.64,88.1,37,32,53.81,Difficile,Difficile,Difficile / Difficile
583,584,2015,Droit,16,5,QCU,86,66,37,29,1.3,56.06,37,49,42.67,Difficile,Difficile,Difficile / Difficile
1413,584,2016,Droit,16,5,QCU,101,97,28,69,1.04,28.87,28,73,27.71,Difficile,Difficile,Difficile / Difficile
2243,584,2017,Droit,16,5,QCU,82,53,48,5,1.55,90.57,48,34,58.55,Difficile,Difficile,Difficile / Difficile
3073,584,2018,Droit,16,5,QCU,66,35,34,1,1.89,97.14,34,32,51.65,Difficile,Difficile,Difficile / Difficile
3903,584,2019,Droit,16,5,QCU,74,74,31,43,1.0,41.89,31,43,41.38,Difficile,Difficile,Difficile / Difficile
4733,584,2020,Droit,16,5,QCU,88,81,56,25,1.09,69.14,56,32,63.32,Difficile,Adapte,Difficile / Adapte
584,585,2015,Droit,16,6,QCM,28,20,19,1,1.4,95.0,19,9,67.28,Adapte,Adapte,Adapte / Adapte
1414,585,2016,Droit,16,6,QCM,26,23,16,7,1.13,69.57,16,10,60.78,Adapte,Adapte,Adapte / Adapte
2244,585,2017,Droit,16,6,QCM,30,27,20,7,1.11,74.07,20,10,67.93,Adapte,Adapte,Adapte / Adapte
3074,585,2018,Droit,16,6,QCM,31,28,20,8,1.11,71.43,20,11,63.62,Adapte,Adapte,Adapte / Adapte
3904,585,2019,Droit,16,6,QCM,36,28,25,3,1.29,89.29,25,11,69.86,Adapte,Adapte,Adapte / Adapte
4734,585,2020,Droit,16,6,QCM,43,33,27,6,1.3,81.82,27,16,63.37,Adapte,Adapte,Adapte / Adapte
585,586,2015,Droit,16,7,QCM,50,42,35,7,1.19,83.33,35,15,70.61,Adapte,Adapte,Adapte / Adapte
1415,586,2016,Droit,16,7,QCM,40,34,29,5,1.18,85.29,29,11,72.08,Adapte,Adapte,Adapte / Adapte
2245,586,2017,Droit,16,7,QCM,32,25,24,1,1.28,96.0,24,8,73.48,Adapte,Adapte,Adapte / Adapte
3075,586,2018,Droit,16,7,QCM,31,29,23,6,1.07,79.31,23,8,73.04,Adapte,Adapte,Adapte / Adapte
3905,586,2019,Droit,16,7,QCM,33,25,24,1,1.32,96.0,24,9,72.55,Adapte,Adapte,Adapte / Adapte
4735,586,2020,Droit,16,7,QCM,32,28,24,4,1.14,85.71,24,8,74.55,Adapte,Adapte,Adapte / Adapte
586,587,2015,Droit,17,1,QCU,98,65,10,55,1.51,15.38,10,88,9.87,Trop Difficile,Trop Difficile,Trop Difficile / Trop Difficile
1416,587,2016,Droit,17,1,QCU,79,51,25,26,1.55,49.02,25,54,32.23,Difficile,Difficile,Difficile / Difficile
2246,587,2017,Droit,17,1,QCU,82,81,31,50,1.01,38.27,31,51,37.49,Difficile,Difficile,Difficile / Difficile
3076,587,2018,Droit,17,1,QCU,91,75,38,37,1.21,50.67,38,53,41.42,Difficile,Difficile,Difficile / Difficile
3906,587,2019,Droit,17,1,QCU,81,50,16,34,1.62,32.0,16,65,19.49,Difficile,Trop Difficile,Difficile / Trop Difficile
4736,587,2020,Droit,17,1,QCU,68,33,31,2,2.06,93.94,31,37,45.84,Difficile,Difficile,Difficile / Difficile
587,588,2015,Droit,17,2,QCM,27,9,5,4,3.0,55.56,5,22,16.75,Difficile,Trop Difficile,Difficile / Trop Difficile
1417,588,2016,Droit,17,2,QCM,25,21,21,0,1.19,100.0,21,4,83.19,Difficile,Facile,Difficile / Facile
2247,588,2017,Droit,17,2,QCM,29,23,19,4,1.26,82.61,19,10,64.81,Difficile,Adapte,Difficile / Adapte
3077,588,2018,Droit,17,2,QCM,31,30,22,8,1.03,73.33,22,9,71.64,Adapte,Adapte,Adapte / Adapte
3907,588,2019,Droit,17,2,QCM,32,30,21,9,1.07,70.0,21,11,64.71,Adapte,Adapte,Adapte / Adapte
4737,588,2020,Droit,17,2,QCM,29,28,21,7,1.04,75.0,21,8,73.55,Adapte,Adapte,Adapte / Adapte
588,589,2015,Droit,17,3,QCU,6,5,5,0,1.2,100.0,5,1,81.56,Facile,Facile,Facile / Facile
1418,589,2016,Droit,17,3,QCU,7,6,2,4,1.17,33.33,2,5,35.39,Difficile,Difficile,Difficile / Difficile
2248,589,2017,Droit,17,3,QCU,6,5,4,1,1.2,80.0,4,2,61.53,Difficile,Adapte,Difficile / Adapte
3078,589,2018,Droit,17,3,QCU,6,6,4,2,1.0,66.67,4,2,68.96,Adapte,Adapte,Adapte / Adapte
3908,589,2019,Droit,17,3,QCU,5,4,3,1,1.25,75.0,3,2,62.63,Adapte,Adapte,Adapte / Adapte
4738,589,2020,Droit,17,3,QCU,4,3,3,0,1.33,100.0,3,1,65.09,Adapte,Adapte,Adapte / Adapte
589,590,2015,Droit,17,4,QCM,63,42,26,16,1.5,61.9,26,37,40.48,Difficile,Difficile,Difficile / Difficile
1419,590,2016,Droit,17,4,QCM,72,66,55,11,1.09,83.33,55,17,77.01,Difficile,Facile,Difficile / Facile
2249,590,2017,Droit,17,4,QCM,70,54,27,27,1.3,50.0,27,43,38.83,Difficile,Difficile,Difficile / Difficile
3079,590,2018,Droit,17,4,QCM,63,61,17,44,1.03,27.87,17,46,26.95,Difficile,Difficile,Difficile / Difficile
3909,590,2019,Droit,17,4,QCM,64,44,24,20,1.45,54.55,24,40,38.18,Difficile,Difficile,Difficile / Difficile
4739,590,2020,Droit,17,4,QCM,51,33,32,1,1.55,96.97,32,19,62.71,Difficile,Adapte,Difficile / Adapte
590,591,2015,Droit,17,5,QCM,15,13,12,1,1.15,92.31,12,3,79.44,Facile,Facile,Facile / Facile
1420,591,2016,Droit,17,5,QCM,16,14,3,11,1.14,21.43,3,13,21.46,Difficile,Trop Difficile,Difficile / Trop Difficile
2250,591,2017,Droit,17,5,QCM,17,11,1,10,1.55,9.09,1,16,5.21,Difficile,Trop Difficile,Difficile / Trop Difficile
3080,591,2018,Droit,17,5,QCM,18,17,12,5,1.06,70.59,12,6,64.52,Difficile,Adapte,Difficile / Adapte
3910,591,2019,Droit,17,5,QCM,14,12,9,3,1.17,75.0,9,5,65.06,Adapte,Adapte,Adapte / Adapte
4740,591,2020,Droit,17,5,QCM,13,10,9,1,1.3,90.0,9,4,70.14,Adapte,Adapte,Adapte / Adapte
591,592,2015,Droit,17,6,QCU,26,16,4,12,1.62,25.0,4,22,14.95,Facile,Trop Difficile,Facile / Trop Difficile
1421,592,2016,Droit,17,6,QCU,31,14,11,3,2.21,78.57,11,20,34.09,Difficile,Difficile,Difficile / Difficile
2251,592,2017,Droit,17,6,QCU,36,33,29,4,1.09,87.88,29,7,81.5,Difficile,Facile,Difficile / Facile
3081,592,2018,Droit,17,6,QCU,41,36,7,29,1.14,19.44,7,34,17.7,Difficile,Trop Difficile,Difficile / Trop Difficile
3911,592,2019,Droit,17,6,QCU,49,44,28,16,1.11,63.64,28,21,57.14,Difficile,Difficile,Difficile / Difficile
4741,592,2020,Droit,17,6,QCU,59,24,16,8,2.46,66.67,16,43,27.38,Difficile,Difficile,Difficile / Difficile
592,593,2015,Droit,17,7,QROC,84,59,51,8,1.42,86.44,51,33,61.15,Difficile,Adapte,Difficile / Adapte
1422,593,2016,Droit,17,7,QROC,74,72,50,22,1.03,69.44,50,24,67.06,Adapte,Adapte,Adapte / Adapte
2252,593,2017,Droit,17,7,QROC,77,55,53,2,1.4,96.36,53,24,68.7,Adapte,Adapte,Adapte / Adapte
3082,593,2018,Droit,17,7,QROC,81,67,58,9,1.21,86.57,58,23,71.66,Adapte,Adapte,Adapte / Adapte
3912,593,2019,Droit,17,7,QROC,84,74,55,19,1.14,74.32,55,29,65.12,Adapte,Adapte,Adapte / Adapte
4742,593,2020,Droit,17,7,QROC,97,88,67,21,1.1,76.14,67,30,68.57,Adapte,Adapte,Adapte / Adapte
593,594,2015,Droit,18,1,QCM,88,74,69,5,1.19,93.24,69,19,78.05,Facile,Facile,Facile / Facile
1423,594,2016,Droit,18,1,QCM,91,81,50,31,1.12,61.73,50,41,55.2,Difficile,Difficile,Difficile / Difficile
2253,594,2017,Droit,18,1,QCM,74,67,36,31,1.1,53.73,36,38,48.43,Difficile,Difficile,Difficile / Difficile
3083,594,2018,Droit,18,1,QCM,84,39,31,8,2.15,79.49,31,53,37.15,Difficile,Difficile,Difficile / Difficile
3913,594,2019,Droit,18,1,QCM,93,51,41,10,1.82,80.39,41,52,44.02,Difficile,Difficile,Difficile / Difficile
4743,594,2020,Droit,18,1,QCM,93,80,50,30,1.16,62.5,50,43,53.78,Difficile,Difficile,Difficile / Difficile
594,595,2015,Sociologie,1,1,QCM,17,11,5,6,1.55,45.45,5,12,26.83,Trop Facile,Difficile,Trop Facile / Difficile
1424,595,2016,Sociologie,1,1,QCM,20,18,11,7,1.11,61.11,11,9,52.97,Difficile,Difficile,Difficile / Difficile
2254,595,2017,Sociologie,1,1,QCM,17,14,7,7,1.21,50.0,7,10,42.15,Difficile,Difficile,Difficile / Difficile
3084,595,2018,Sociologie,1,1,QCM,14,10,7,3,1.4,70.0,7,7,49.46,Difficile,Difficile,Difficile / Difficile
3914,595,2019,Sociologie,1,1,QCM,16,14,7,7,1.14,50.0,7,9,46.02,Difficile,Difficile,Difficile / Difficile
4744,595,2020,Sociologie,1,1,QCM,13,5,5,0,2.6,100.0,5,8,37.82,Difficile,Difficile,Difficile / Difficile
595,596,2015,Sociologie,1,2,QCU,79,77,75,2,1.03,97.4,75,4,94.99,Trop Facile,Trop Facile,Trop Facile / Trop Facile
1425,596,2016,Sociologie,1,2,QCU,88,85,83,2,1.04,97.65,83,5,94.55,Difficile,Trop Facile,Difficile / Trop Facile
2255,596,2017,Sociologie,1,2,QCU,78,72,67,5,1.08,93.06,67,11,86.45,Difficile,Trop Facile,Difficile / Trop Facile
3085,596,2018,Sociologie,1,2,QCU,80,68,45,23,1.18,66.18,45,35,56.23,Difficile,Difficile,Difficile / Difficile
3915,596,2019,Sociologie,1,2,QCU,74,31,31,0,2.39,100.0,31,43,42.39,Difficile,Difficile,Difficile / Difficile
4745,596,2020,Sociologie,1,2,QCU,83,82,34,48,1.01,41.46,34,49,41.4,Difficile,Difficile,Difficile / Difficile
596,597,2015,Sociologie,2,1,QCU,75,52,23,29,1.44,44.23,23,52,30.03,Difficile,Difficile,Difficile / Difficile
1426,597,2016,Sociologie,2,1,QCU,60,58,57,1,1.03,98.28,57,3,94.63,Difficile,Trop Facile,Difficile / Trop Facile
2256,597,2017,Sociologie,2,1,QCU,72,53,50,3,1.36,94.34,50,22,69.07,Difficile,Adapte,Difficile / Adapte
3086,597,2018,Sociologie,2,1,QCU,65,56,48,8,1.16,85.71,48,17,74.41,Adapte,Adapte,Adapte / Adapte
3916,597,2019,Sociologie,2,1,QCU,65,47,45,2,1.38,95.74,45,20,68.86,Adapte,Adapte,Adapte / Adapte
4746,597,2020,Sociologie,2,1,QCU,63,54,38,16,1.17,70.37,38,25,60.46,Adapte,Adapte,Adapte / Adapte
597,598,2015,Sociologie,2,2,QCM,67,28,19,9,2.39,67.86,19,48,27.9,Trop Facile,Difficile,Trop Facile / Difficile
1427,598,2016,Sociologie,2,2,QCM,57,35,3,32,1.63,8.57,3,54,5.3,Difficile,Trop Difficile,Difficile / Trop Difficile
2257,598,2017,Sociologie,2,2,QCM,65,42,23,19,1.55,54.76,23,42,34.79,Difficile,Difficile,Difficile / Difficile
3087,598,2018,Sociologie,2,2,QCM,63,40,27,13,1.57,67.5,27,36,43.59,Difficile,Difficile,Difficile / Difficile
3917,598,2019,Sociologie,2,2,QCM,69,69,68,1,1.0,98.55,68,1,98.52,Difficile,Trop Facile,Difficile / Trop Facile
4747,598,2020,Sociologie,2,2,QCM,77,76,31,45,1.01,40.79,31,46,40.27,Difficile,Difficile,Difficile / Difficile
598,599,2015,Sociologie,2,3,QCM,90,25,18,7,3.6,72.0,18,72,19.51,Trop Difficile,Trop Difficile,Trop Difficile / Trop Difficile
1428,599,2016,Sociologie,2,3,QCM,86,42,30,12,2.05,71.43,30,56,34.93,Difficile,Difficile,Difficile / Difficile
2258,599,2017,Sociologie,2,3,QCM,94,64,58,6,1.47,90.62,58,36,61.49,Difficile,Adapte,Difficile / Adapte
3088,599,2018,Sociologie,2,3,QCM,100,88,72,16,1.14,81.82,72,28,71.64,Adapte,Adapte,Adapte / Adapte
3918,599,2019,Sociologie,2,3,QCM,110,87,67,20,1.26,77.01,67,43,61.26,Adapte,Adapte,Adapte / Adapte
4748,599,2020,Sociologie,2,3,QCM,127,77,77,0,1.65,100.0,77,50,60.99,Adapte,Adapte,Adapte / Adapte
599,600,2015,Sociologie,3,1,QCM,50,49,48,1,1.02,97.96,48,2,96.28,Trop Facile,Trop Facile,Trop Facile / Trop Facile
1429,600,2016,Sociologie,3,1,QCM,40,26,15,11,1.54,57.69,15,25,37.29,Difficile,Difficile,Difficile / Difficile
2259,600,2017,Sociologie,3,1,QCM,34,25,7,18,1.36,28.0,7,27,20.62,Difficile,Trop Difficile,Difficile / Trop Difficile
3089,600,2018,Sociologie,3,1,QCM,29,17,12,5,1.71,70.59,12,17,41.94,Difficile,Difficile,Difficile / Difficile
3919,600,2019,Sociologie,3,1,QCM,35,29,6,23,1.21,20.69,6,29,16.33,Difficile,Trop Difficile,Difficile / Trop Difficile
4749,600,2020,Sociologie,3,1,QCM,31,13,12,1,2.38,92.31,12,19,37.4,Difficile,Difficile,Difficile / Difficile
600,601,2015,Sociologie,3,2,QCU,51,44,42,2,1.16,95.45,42,9,82.04,Adapte,Facile,Adapte / Facile
1430,601,2016,Sociologie,3,2,QCU,42,27,11,16,1.56,40.74,11,31,25.29,Difficile,Difficile,Difficile / Difficile
2260,601,2017,Sociologie,3,2,QCU,41,40,39,1,1.02,97.5,39,2,96.19,Difficile,Trop Facile,Difficile / Trop Facile
3090,601,2018,Sociologie,3,2,QCU,37,23,18,5,1.61,78.26,18,19,48.7,Difficile,Difficile,Difficile / Difficile
3920,601,2019,Sociologie,3,2,QCU,44,37,36,1,1.19,97.3,36,8,81.56,Difficile,Facile,Difficile / Facile
4750,601,2020,Sociologie,3,2,QCU,38,31,30,1,1.23,96.77,30,8,79.07,Difficile,Facile,Difficile / Facile
601,602,2015,Sociologie,3,3,QCM,76,62,10,52,1.23,16.13,10,66,13.35,Trop Difficile,Trop Difficile,Trop Difficile / Trop Difficile
1431,602,2016,Sociologie,3,3,QCM,80,34,18,16,2.35,52.94,18,62,22.8,Difficile,Trop Difficile,Difficile / Trop Difficile
2261,602,2017,Sociologie,3,3,QCM,69,52,50,2,1.33,96.15,50,19,72.55,Difficile,Adapte,Difficile / Adapte
3091,602,2018,Sociologie,3,3,QCM,66,46,44,2,1.43,95.65,44,22,66.89,Adapte,Adapte,Adapte / Adapte
3921,602,2019,Sociologie,3,3,QCM,79,65,56,9,1.22,86.15,56,23,71.1,Adapte,Adapte,Adapte / Adapte
4751,602,2020,Sociologie,3,3,QCM,74,54,48,6,1.37,88.89,48,26,64.23,Adapte,Adapte,Adapte / Adapte
602,603,2015,Sociologie,3,4,QCU,12,4,4,0,3.0,100.0,4,8,29.83,Difficile,Difficile,Difficile / Difficile
1432,603,2016,Sociologie,3,4,QCU,11,11,9,2,1.0,81.82,9,2,81.06,Difficile,Facile,Difficile / Facile
2262,603,2017,Sociologie,3,4,QCU,11,9,6,3,1.22,66.67,6,5,54.77,Difficile,Difficile,Difficile / Difficile
3092,603,2018,Sociologie,3,4,QCU,11,8,6,2,1.38,75.0,6,5,50.09,Difficile,Difficile,Difficile / Difficile
3922,603,2019,Sociologie,3,4,QCU,10,6,5,1,1.67,83.33,5,5,48.05,Difficile,Difficile,Difficile / Difficile
4752,603,2020,Sociologie,3,4,QCU,12,7,4,3,1.71,57.14,4,8,30.95,Difficile,Difficile,Difficile / Difficile
603,604,2015,Sociologie,3,5,QCU,28,26,1,25,1.08,3.85,1,27,4.16,Trop Difficile,Trop Difficile,Trop Difficile / Trop Difficile
1433,604,2016,Sociologie,3,5,QCU,27,27,13,14,1.0,48.15,13,14,49.53,Difficile,Difficile,Difficile / Difficile
2263,604,2017,Sociologie,3,5,QCU,31,25,19,6,1.24,76.0,19,12,61.29,Difficile,Adapte,Difficile / Adapte
3093,604,2018,Sociologie,3,5,QCU,33,23,22,1,1.43,95.65,22,11,65.77,Adapte,Adapte,Adapte / Adapte
3923,604,2019,Sociologie,3,5,QCU,28,17,17,0,1.65,100.0,17,11,62.15,Adapte,Adapte,Adapte / Adapte
4753,604,2020,Sociologie,3,5,QCU,24,22,15,7,1.09,68.18,15,9,62.05,Adapte,Adapte,Adapte / Adapte
604,605,2015,Sociologie,3,6,QCU,35,32,18,14,1.09,56.25,18,17,51.18,Difficile,Difficile,Difficile / Difficile
1434,605,2016,Sociologie,3,6,QCU,42,26,20,6,1.62,76.92,20,22,47.37,Difficile,Difficile,Difficile / Difficile
2264,605,2017,Sociologie,3,6,QCU,50,42,4,38,1.19,9.52,4,46,8.1,Difficile,Trop Difficile,Difficile / Trop Difficile
3094,605,2018,Sociologie,3,6,QCU,52,41,21,20,1.27,51.22,21,31,39.86,Difficile,Difficile,Difficile / Difficile
3924,605,2019,Sociologie,3,6,QCU,52,42,19,23,1.24,45.24,19,33,35.82,Difficile,Difficile,Difficile / Difficile
4754,605,2020,Sociologie,3,6,QCU,56,45,43,2,1.24,95.56,43,13,76.57,Difficile,Facile,Difficile / Facile
605,606,2015,Sociologie,3,7,QROC,53,43,38,5,1.23,88.37,38,15,72.48,Adapte,Adapte,Adapte / Adapte
1435,606,2016,Sociologie,3,7,QROC,44,39,30,9,1.13,76.92,30,14,67.92,Adapte,Adapte,Adapte / Adapte
2265,606,2017,Sociologie,3,7,QROC,42,41,31,10,1.02,75.61,31,11,74.29,Adapte,Adapte,Adapte / Adapte
3095,606,2018,Sociologie,3,7,QROC,50,48,37,11,1.04,77.08,37,13,73.29,Adapte,Adapte,Adapte / Adapte
3925,606,2019,Sociologie,3,7,QROC,57,46,35,11,1.24,76.09,35,22,61.68,Adapte,Adapte,Adapte / Adapte
4755,606,2020,Sociologie,3,7,QROC,48,43,33,10,1.12,76.74,33,15,68.43,Adapte,Adapte,Adapte / Adapte
606,607,2015,Sociologie,3,8,QCU,38,33,3,30,1.15,9.09,3,35,6.58,Trop Difficile,Trop Difficile,Trop Difficile / Trop Difficile
1436,607,2016,Sociologie,3,8,QCU,45,16,14,2,2.81,87.5,14,31,31.55,Difficile,Difficile,Difficile / Difficile
2266,607,2017,Sociologie,3,8,QCU,51,39,25,14,1.31,64.1,25,26,49.15,Difficile,Difficile,Difficile / Difficile
3096,607,2018,Sociologie,3,8,QCU,47,46,39,7,1.02,84.78,39,8,82.03,Difficile,Facile,Difficile / Facile
3926,607,2019,Sociologie,3,8,QCU,56,54,20,34,1.04,37.04,20,36,35.58,Difficile,Difficile,Difficile / Difficile
4756,607,2020,Sociologie,3,8,QCU,58,38,34,4,1.53,89.47,34,24,58.45,Difficile,Difficile,Difficile / Difficile
607,608,2015,Sociologie,4,1,QROC,85,68,59,9,1.25,86.76,59,26,69.76,Trop Difficile,Adapte,Trop Difficile / Adapte
1437,608,2016,Sociologie,4,1,QROC,91,83,61,22,1.1,73.49,61,30,66.9,Adapte,Adapte,Adapte / Adapte
2267,608,2017,Sociologie,4,1,QROC,104,63,63,0,1.65,100.0,63,41,60.59,Adapte,Adapte,Adapte / Adapte
3097,608,2018,Sociologie,4,1,QROC,90,72,56,16,1.25,77.78,56,34,62.65,Adapte,Adapte,Adapte / Adapte
3927,608,2019,Sociologie,4,1,QROC,107,102,73,29,1.05,71.57,73,34,68.46,Adapte,Adapte,Adapte / Adapte
4757,608,2020,Sociologie,4,1,QROC,96,93,66,27,1.03,70.97,66,30,69.18,Adapte,Adapte,Adapte / Adapte
608,609,2015,Sociologie,4,2,QCU,29,28,26,2,1.04,92.86,26,3,88.26,Trop Difficile,Trop Facile,Trop Difficile / Trop Facile
1438,609,2016,Sociologie,4,2,QCU,31,14,9,5,2.21,64.29,9,22,28.5,Difficile,Difficile,Difficile / Difficile
2268,609,2017,Sociologie,4,2,QCU,34,33,27,6,1.03,81.82,27,7,78.24,Difficile,Facile,Difficile / Facile
3098,609,2018,Sociologie,4,2,QCU,38,35,18,17,1.09,51.43,18,20,47.74,Difficile,Difficile,Difficile / Difficile
3928,609,2019,Sociologie,4,2,QCU,30,26,8,18,1.15,30.77,8,22,26.42,Difficile,Difficile,Difficile / Difficile
4758,609,2020,Sociologie,4,2,QCU,27,26,25,1,1.04,96.15,25,2,91.6,Difficile,Trop Facile,Difficile / Trop Facile
609,610,2015,Sociologie,4,3,QCU,67,59,52,7,1.14,88.14,52,15,78.23,Adapte,Facile,Adapte / Facile
1439,610,2016,Sociologie,4,3,QCU,72,72,72,0,1.0,100.0,72,0,99.8,Difficile,Trop Facile,Difficile / Trop Facile
2269,610,2017,Sociologie,4,3,QCU,82,57,50,7,1.44,87.72,50,32,60.87,Difficile,Adapte,Difficile / Adapte
3099,610,2018,Sociologie,4,3,QCU,67,66,49,17,1.02,74.24,49,18,72.83,Adapte,Adapte,Adapte / Adapte
3929,610,2019,Sociologie,4,3,QCU,70,59,46,13,1.19,77.97,46,24,65.22,Adapte,Adapte,Adapte / Adapte
4759,610,2020,Sociologie,4,3,QCU,65,55,44,11,1.18,80.0,44,21,68.35,Adapte,Adapte,Adapte / Adapte
610,611,2015,Sociologie,4,4,QCM,7,4,1,3,1.75,25.0,1,6,21.17,Difficile,Trop Difficile,Difficile / Trop Difficile
1440,611,2016,Sociologie,4,4,QCM,6,4,3,1,1.5,75.0,3,3,47.52,Difficile,Difficile,Difficile / Difficile
2270,611,2017,Sociologie,4,4,QCM,5,2,2,0,2.5,100.0,2,3,36.01,Difficile,Difficile,Difficile / Difficile
3100,611,2018,Sociologie,4,4,QCM,6,6,3,3,1.0,50.0,3,3,54.23,Difficile,Difficile,Difficile / Difficile
3930,611,2019,Sociologie,4,4,QCM,6,4,1,3,1.5,25.0,1,5,20.31,Difficile,Trop Difficile,Difficile / Trop Difficile
4760,611,2020,Sociologie,4,4,QCM,7,3,2,1,2.33,66.67,2,5,25.04,Difficile,Difficile,Difficile / Difficile
611,612,2015,Sociologie,4,5,QROC,11,6,5,1,1.83,83.33,5,6,42.6,Adapte,Difficile,Adapte / Difficile
1441,612,2016,Sociologie,4,5,QROC,13,13,1,12,1.0,7.69,1,12,7.57,Difficile,Trop Difficile,Difficile / Trop Difficile
2271,612,2017,Sociologie,4,5,QROC,11,7,7,0,1.57,100.0,7,4,61.61,Difficile,Adapte,Difficile / Adapte
3101,612,2018,Sociologie,4,5,QROC,12,12,9,3,1.0,75.0,9,3,71.5,Adapte,Adapte,Adapte / Adapte
3931,612,2019,Sociologie,4,5,QROC,11,10,8,2,1.1,80.0,8,3,73.29,Adapte,Adapte,Adapte / Adapte
4761,612,2020,Sociologie,4,5,QROC,9,9,6,3,1.0,66.67,6,3,66.37,Adapte,Adapte,Adapte / Adapte
612,613,2015,Sociologie,4,6,QCU,34,29,13,16,1.17,44.83,13,21,39.02,Adapte,Difficile,Adapte / Difficile
1442,613,2016,Sociologie,4,6,QCU,37,16,15,1,2.31,93.75,15,22,40.3,Difficile,Difficile,Difficile / Difficile
2272,613,2017,Sociologie,4,6,QCU,35,33,5,28,1.06,15.15,5,30,13.68,Difficile,Trop Difficile,Difficile / Trop Difficile
3102,613,2018,Sociologie,4,6,QCU,39,39,34,5,1.0,87.18,34,5,88.45,Difficile,Trop Facile,Difficile / Trop Facile
3932,613,2019,Sociologie,4,6,QCU,47,16,1,15,2.94,6.25,1,46,2.24,Difficile,Trop Difficile,Difficile / Trop Difficile
4762,613,2020,Sociologie,4,6,QCU,45,21,10,11,2.14,47.62,10,35,21.32,Difficile,Trop Difficile,Difficile / Trop Difficile
613,614,2015,Sociologie,4,7,QCU,64,46,1,45,1.39,2.17,1,63,1.11,Difficile,Trop Difficile,Difficile / Trop Difficile
1443,614,2016,Sociologie,4,7,QCU,75,61,60,1,1.23,98.36,60,15,79.65,Difficile,Facile,Difficile / Facile
2273,614,2017,Sociologie,4,7,QCU,81,62,47,15,1.31,75.81,47,34,58.34,Difficile,Difficile,Difficile / Difficile
3103,614,2018,Sociologie,4,7,QCU,86,62,44,18,1.39,70.97,44,42,51.27,Difficile,Difficile,Difficile / Difficile
3933,614,2019,Sociologie,4,7,QCU,76,57,31,26,1.33,54.39,31,45,40.27,Difficile,Difficile,Difficile / Difficile
4763,614,2020,Sociologie,4,7,QCU,89,82,35,47,1.09,42.68,35,54,39.81,Difficile,Difficile,Difficile / Difficile
614,615,2015,Sociologie,5,1,QO,53,47,43,4,1.13,91.49,43,10,82.06,Facile,Facile,Facile / Facile
1444,615,2016,Sociologie,5,1,QO,61,59,12,47,1.03,20.34,12,49,18.98,Trop Difficile,Trop Difficile,Trop Difficile / Trop Difficile
2274,615,2017,Sociologie,5,1,QO,54,52,18,34,1.04,34.62,18,36,33.82,Trop Difficile,Difficile,Trop Difficile / Difficile
3104,615,2018,Sociologie,5,1,QO,61,44,11,33,1.39,25.0,11,50,18.06,Trop Difficile,Trop Difficile,Trop Difficile / Trop Difficile
3934,615,2019,Sociologie,5,1,QO,53,41,29,12,1.29,70.73,29,24,55.35,Trop Difficile,Difficile,Trop Difficile / Difficile
4764,615,2020,Sociologie,5,1,QO,55,54,54,0,1.02,100.0,54,1,98.81,Trop Difficile,Trop Facile,Trop Difficile / Trop Facile
615,616,2015,Sociologie,5,2,QCU,29,29,23,6,1.0,79.31,23,6,78.78,Difficile,Facile,Difficile / Facile
1445,616,2016,Sociologie,5,2,QCU,33,14,10,4,2.36,71.43,10,23,28.85,Difficile,Difficile,Difficile / Difficile
2275,616,2017,Sociologie,5,2,QCU,36,14,10,4,2.57,71.43,10,26,27.53,Difficile,Difficile,Difficile / Difficile
3105,616,2018,Sociologie,5,2,QCU,32,31,16,15,1.03,51.61,16,16,51.04,Difficile,Difficile,Difficile / Difficile
3935,616,2019,Sociologie,5,2,QCU,28,19,14,5,1.47,73.68,14,14,48.6,Difficile,Difficile,Difficile / Difficile
4765,616,2020,Sociologie,5,2,QCU,26,11,7,4,2.36,63.64,7,19,28.79,Difficile,Difficile,Difficile / Difficile
616,617,2015,Sociologie,5,3,QCU,53,35,20,15,1.51,57.14,20,33,37.28,Difficile,Difficile,Difficile / Difficile
1446,617,2016,Sociologie,5,3,QCU,62,22,16,6,2.82,72.73,16,46,26.53,Difficile,Difficile,Difficile / Difficile
2276,617,2017,Sociologie,5,3,QCU,74,46,22,24,1.61,47.83,22,52,29.58,Difficile,Difficile,Difficile / Difficile
3106,617,2018,Sociologie,5,3,QCU,76,69,28,41,1.1,40.58,28,48,36.77,Difficile,Difficile,Difficile / Difficile
3936,617,2019,Sociologie,5,3,QCU,62,30,5,25,2.07,16.67,5,57,8.83,Difficile,Trop Difficile,Difficile / Trop Difficile
4766,617,2020,Sociologie,5,3,QCU,58,37,16,21,1.57,43.24,16,42,28.02,Difficile,Difficile,Difficile / Difficile
617,618,2015,Sociologie,5,4,QCM,89,78,75,3,1.14,96.15,75,14,84.31,Trop Facile,Facile,Trop Facile / Facile
1447,618,2016,Sociologie,5,4,QCM,82,70,32,38,1.17,45.71,32,50,38.62,Difficile,Difficile,Difficile / Difficile
2277,618,2017,Sociologie,5,4,QCM,67,39,24,15,1.72,61.54,24,43,35.41,Difficile,Difficile,Difficile / Difficile
3107,618,2018,Sociologie,5,4,QCM,76,46,35,11,1.65,76.09,35,41,45.53,Difficile,Difficile,Difficile / Difficile
3937,618,2019,Sociologie,5,4,QCM,77,70,28,42,1.1,40.0,28,49,36.51,Difficile,Difficile,Difficile / Difficile
4767,618,2020,Sociologie,5,4,QCM,81,48,27,21,1.69,56.25,27,54,32.75,Difficile,Difficile,Difficile / Difficile
618,619,2015,Sociologie,5,5,QCM,88,43,24,19,2.05,55.81,24,64,27.22,Difficile,Difficile,Difficile / Difficile
1448,619,2016,Sociologie,5,5,QCM,90,59,38,21,1.53,64.41,38,52,42.18,Difficile,Difficile,Difficile / Difficile
2278,619,2017,Sociologie,5,5,QCM,90,63,24,39,1.43,38.1,24,66,27.12,Difficile,Difficile,Difficile / Difficile
3108,619,2018,Sociologie,5,5,QCM,102,62,51,11,1.65,82.26,51,51,49.64,Difficile,Difficile,Difficile / Difficile
3938,619,2019,Sociologie,5,5,QCM,122,101,31,70,1.21,30.69,31,91,25.7,Difficile,Difficile,Difficile / Difficile
4768,619,2020,Sociologie,5,5,QCM,145,114,78,36,1.27,68.42,78,67,54.08,Difficile,Difficile,Difficile / Difficile
619,620,2015,Sociologie,5,6,QCM,96,55,46,9,1.75,83.64,46,50,47.89,Difficile,Difficile,Difficile / Difficile
1449,620,2016,Sociologie,5,6,QCM,83,77,76,1,1.08,98.7,76,7,91.68,Difficile,Trop Facile,Difficile / Trop Facile
2279,620,2017,Sociologie,5,6,QCM,81,35,24,11,2.31,68.57,24,57,29.42,Difficile,Difficile,Difficile / Difficile
3109,620,2018,Sociologie,5,6,QCM,86,75,43,32,1.15,57.33,43,43,50.49,Difficile,Difficile,Difficile / Difficile
3939,620,2019,Sociologie,5,6,QCM,69,46,24,22,1.5,52.17,24,45,34.29,Difficile,Difficile,Difficile / Difficile
4769,620,2020,Sociologie,5,6,QCM,65,57,9,48,1.14,15.79,9,56,13.98,Difficile,Trop Difficile,Difficile / Trop Difficile
620,621,2015,Sociologie,5,7,QCM,12,12,11,1,1.0,91.67,11,1,91.64,Difficile,Trop Facile,Difficile / Trop Facile
1450,621,2016,Sociologie,5,7,QCM,10,9,9,0,1.11,100.0,9,1,91.94,Difficile,Trop Facile,Difficile / Trop Facile
2280,621,2017,Sociologie,5,7,QCM,9,9,4,5,1.0,44.44,4,5,46.59,Difficile,Difficile,Difficile / Difficile
3110,621,2018,Sociologie,5,7,QCM,8,8,4,4,1.0,50.0,4,4,52.55,Difficile,Difficile,Difficile / Difficile
3940,621,2019,Sociologie,5,7,QCM,7,6,2,4,1.17,33.33,2,5,27.26,Difficile,Difficile,Difficile / Difficile
4770,621,2020,Sociologie,5,7,QCM,6,5,4,1,1.2,80.0,4,2,62.37,Difficile,Adapte,Difficile / Adapte
621,622,2015,Sociologie,5,8,QO,20,19,12,7,1.05,63.16,12,8,61.23,Trop Difficile,Adapte,Trop Difficile / Adapte
1451,622,2016,Sociologie,5,8,QO,19,15,13,2,1.27,86.67,13,6,71.01,Adapte,Adapte,Adapte / Adapte
2281,622,2017,Sociologie,5,8,QO,23,19,16,3,1.21,84.21,16,7,70.32,Adapte,Adapte,Adapte / Adapte
3111,622,2018,Sociologie,5,8,QO,26,21,16,5,1.24,76.19,16,10,61.74,Adapte,Adapte,Adapte / Adapte
3941,622,2019,Sociologie,5,8,QO,31,29,20,9,1.07,68.97,20,11,66.06,Adapte,Adapte,Adapte / Adapte
4771,622,2020,Sociologie,5,8,QO,31,24,21,3,1.29,87.5,21,10,67.52,Adapte,Adapte,Adapte / Adapte
622,623,2015,Sociologie,5,9,QCU,66,27,10,17,2.44,37.04,10,56,15.63,Trop Difficile,Trop Difficile,Trop Difficile / Trop Difficile
1452,623,2016,Sociologie,5,9,QCU,69,62,22,40,1.11,35.48,22,47,31.36,Difficile,Difficile,Difficile / Difficile
2282,623,2017,Sociologie,5,9,QCU,63,47,43,4,1.34,91.49,43,20,67.51,Difficile,Adapte,Difficile / Adapte
3112,623,2018,Sociologie,5,9,QCU,61,46,44,2,1.33,95.65,44,17,72.25,Adapte,Adapte,Adapte / Adapte
3942,623,2019,Sociologie,5,9,QCU,57,51,42,9,1.12,82.35,42,15,74.33,Adapte,Adapte,Adapte / Adapte
4772,623,2020,Sociologie,5,9,QCU,64,51,41,10,1.25,80.39,41,23,63.99,Adapte,Adapte,Adapte / Adapte
623,624,2015,Sociologie,6,1,QCM,23,20,18,2,1.15,90.0,18,5,77.98,Facile,Facile,Facile / Facile
1453,624,2016,Sociologie,6,1,QCM,25,11,6,5,2.27,54.55,6,19,25.68,Difficile,Difficile,Difficile / Difficile
2283,624,2017,Sociologie,6,1,QCM,20,14,12,2,1.43,85.71,12,8,58.18,Difficile,Difficile,Difficile / Difficile
3113,624,2018,Sociologie,6,1,QCM,20,9,6,3,2.22,66.67,6,14,32.36,Difficile,Difficile,Difficile / Difficile
3943,624,2019,Sociologie,6,1,QCM,16,14,1,13,1.14,7.14,1,15,7.14,Difficile,Trop Difficile,Difficile / Trop Difficile
4773,624,2020,Sociologie,6,1,QCM,13,12,6,6,1.08,50.0,6,7,43.25,Difficile,Difficile,Difficile / Difficile
624,625,2015,Sociologie,6,2,QCU,10,7,5,2,1.43,71.43,5,5,47.65,Trop Difficile,Difficile,Trop Difficile / Difficile
1454,625,2016,Sociologie,6,2,QCU,12,11,11,0,1.09,100.0,11,1,94.18,Difficile,Trop Facile,Difficile / Trop Facile
2284,625,2017,Sociologie,6,2,QCU,13,13,6,7,1.0,46.15,6,7,44.31,Difficile,Difficile,Difficile / Difficile
3114,625,2018,Sociologie,6,2,QCU,12,8,2,6,1.5,25.0,2,10,18.29,Difficile,Trop Difficile,Difficile / Trop Difficile
3944,625,2019,Sociologie,6,2,QCU,13,9,6,3,1.44,66.67,6,7,46.59,Difficile,Difficile,Difficile / Difficile
4774,625,2020,Sociologie,6,2,QCU,15,7,4,3,2.14,57.14,4,11,25.1,Difficile,Difficile,Difficile / Difficile
625,626,2015,Sociologie,6,3,QCU,43,35,9,26,1.23,25.71,9,34,20.91,Trop Difficile,Trop Difficile,Trop Difficile / Trop Difficile
1455,626,2016,Sociologie,6,3,QCU,40,34,12,22,1.18,35.29,12,28,30.75,Difficile,Difficile,Difficile / Difficile
2285,626,2017,Sociologie,6,3,QCU,35,24,7,17,1.46,29.17,7,28,19.76,Difficile,Trop Difficile,Difficile / Trop Difficile
3115,626,2018,Sociologie,6,3,QCU,42,30,17,13,1.4,56.67,17,25,40.76,Difficile,Difficile,Difficile / Difficile
3945,626,2019,Sociologie,6,3,QCU,36,17,12,5,2.12,70.59,12,24,33.4,Difficile,Difficile,Difficile / Difficile
4775,626,2020,Sociologie,6,3,QCU,41,36,25,11,1.14,69.44,25,16,62.19,Difficile,Adapte,Difficile / Adapte
626,627,2015,Sociologie,6,4,QCU,10,8,4,4,1.25,50.0,4,6,36.63,Difficile,Difficile,Difficile / Difficile
1456,627,2016,Sociologie,6,4,QCU,10,10,9,1,1.0,90.0,9,1,94.34,Difficile,Trop Facile,Difficile / Trop Facile
2286,627,2017,Sociologie,6,4,QCU,10,6,3,3,1.67,50.0,3,7,26.68,Difficile,Difficile,Difficile / Difficile
3116,627,2018,Sociologie,6,4,QCU,12,10,5,5,1.2,50.0,5,7,45.46,Difficile,Difficile,Difficile / Difficile
3946,627,2019,Sociologie,6,4,QCU,10,8,5,3,1.25,62.5,5,5,51.78,Difficile,Difficile,Difficile / Difficile
4776,627,2020,Sociologie,6,4,QCU,12,9,6,3,1.33,66.67,6,6,52.56,Difficile,Difficile,Difficile / Difficile
627,628,2015,Sociologie,6,5,QCU,65,55,44,11,1.18,80.0,44,21,68.41,Adapte,Adapte,Adapte / Adapte
1457,628,2016,Sociologie,6,5,QCU,61,61,41,20,1.0,67.21,41,20,67.63,Adapte,Adapte,Adapte / Adapte
2287,628,2017,Sociologie,6,5,QCU,63,41,39,2,1.54,95.12,39,24,62.24,Adapte,Adapte,Adapte / Adapte
3117,628,2018,Sociologie,6,5,QCU,57,40,35,5,1.43,87.5,35,22,62.27,Adapte,Adapte,Adapte / Adapte
3947,628,2019,Sociologie,6,5,QCU,49,32,31,1,1.53,96.88,31,18,62.38,Adapte,Adapte,Adapte / Adapte
4777,628,2020,Sociologie,6,5,QCU,44,29,27,2,1.52,93.1,27,17,62.32,Adapte,Adapte,Adapte / Adapte
628,629,2015,Sociologie,6,6,QCU,21,12,3,9,1.75,25.0,3,18,14.27,Trop Difficile,Trop Difficile,Trop Difficile / Trop Difficile
1458,629,2016,Sociologie,6,6,QCU,24,17,14,3,1.41,82.35,14,10,58.26,Difficile,Difficile,Difficile / Difficile
2288,629,2017,Sociologie,6,6,QCU,28,20,20,0,1.4,100.0,20,8,71.01,Difficile,Adapte,Difficile / Adapte
3118,629,2018,Sociologie,6,6,QCU,29,26,22,4,1.12,84.62,22,7,74.8,Adapte,Adapte,Adapte / Adapte
3948,629,2019,Sociologie,6,6,QCU,33,26,21,5,1.27,80.77,21,12,63.26,Adapte,Adapte,Adapte / Adapte
4778,629,2020,Sociologie,6,6,QCU,33,27,25,2,1.22,92.59,25,8,74.31,Adapte,Adapte,Adapte / Adapte
629,630,2015,Sociologie,6,7,QCU,68,64,56,8,1.06,87.5,56,12,82.91,Facile,Facile,Facile / Facile
1459,630,2016,Sociologie,6,7,QCU,61,59,32,27,1.03,54.24,32,29,52.51,Difficile,Difficile,Difficile / Difficile
2289,630,2017,Sociologie,6,7,QCU,53,51,28,23,1.04,54.9,28,25,52.26,Difficile,Difficile,Difficile / Difficile
3119,630,2018,Sociologie,6,7,QCU,60,60,59,1,1.0,98.33,59,1,98.81,Difficile,Trop Facile,Difficile / Trop Facile
3949,630,2019,Sociologie,6,7,QCU,48,36,30,6,1.33,83.33,30,18,63.47,Difficile,Adapte,Difficile / Adapte
4779,630,2020,Sociologie,6,7,QCU,39,35,26,9,1.11,74.29,26,13,65.68,Adapte,Adapte,Adapte / Adapte
630,631,2015,Sociologie,6,8,QCU,68,23,10,13,2.96,43.48,10,58,14.87,Trop Difficile,Trop Difficile,Trop Difficile / Trop Difficile
1460,631,2016,Sociologie,6,8,QCU,62,46,21,25,1.35,45.65,21,41,33.89,Difficile,Difficile,Difficile / Difficile
2290,631,2017,Sociologie,6,8,QCU,64,38,25,13,1.68,65.79,25,39,38.49,Difficile,Difficile,Difficile / Difficile
3120,631,2018,Sociologie,6,8,QCU,70,69,64,5,1.01,92.75,64,6,91.42,Difficile,Trop Facile,Difficile / Trop Facile
3950,631,2019,Sociologie,6,8,QCU,62,52,32,20,1.19,61.54,32,30,52.11,Difficile,Difficile,Difficile / Difficile
4780,631,2020,Sociologie,6,8,QCU,54,19,17,2,2.84,89.47,17,37,31.48,Difficile,Difficile,Difficile / Difficile
631,632,2015,Sociologie,7,1,QCU,31,14,7,7,2.21,50.0,7,24,22.79,Trop Difficile,Trop Difficile,Trop Difficile / Trop Difficile
1461,632,2016,Sociologie,7,1,QCU,35,19,10,9,1.84,52.63,10,25,29.84,Difficile,Difficile,Difficile / Difficile
2291,632,2017,Sociologie,7,1,QCU,30,19,11,8,1.58,57.89,11,19,35.82,Difficile,Difficile,Difficile / Difficile
3121,632,2018,Sociologie,7,1,QCU,34,18,18,0,1.89,100.0,18,16,53.38,Difficile,Difficile,Difficile / Difficile
3951,632,2019,Sociologie,7,1,QCU,38,14,10,4,2.71,71.43,10,28,26.72,Difficile,Difficile,Difficile / Difficile
4781,632,2020,Sociologie,7,1,QCU,32,18,17,1,1.78,94.44,17,15,53.7,Difficile,Difficile,Difficile / Difficile
632,633,2015,Sociologie,7,2,QCM,13,6,5,1,2.17,83.33,5,8,36.06,Difficile,Difficile,Difficile / Difficile
1462,633,2016,Sociologie,7,2,QCM,11,9,8,1,1.22,88.89,8,3,73.68,Difficile,Adapte,Difficile / Adapte
2292,633,2017,Sociologie,7,2,QCM,12,9,7,2,1.33,77.78,7,5,60.52,Adapte,Adapte,Adapte / Adapte
3122,633,2018,Sociologie,7,2,QCM,11,9,8,1,1.22,88.89,8,3,72.06,Adapte,Adapte,Adapte / Adapte
3952,633,2019,Sociologie,7,2,QCM,11,10,8,2,1.1,80.0,8,3,70.7,Adapte,Adapte,Adapte / Adapte
4782,633,2020,Sociologie,7,2,QCM,11,9,8,1,1.22,88.89,8,3,69.81,Adapte,Adapte,Adapte / Adapte
633,634,2015,Sociologie,7,3,QCU,74,55,19,36,1.35,34.55,19,55,25.32,Trop Facile,Difficile,Trop Facile / Difficile
1463,634,2016,Sociologie,7,3,QCU,70,66,18,48,1.06,27.27,18,52,25.21,Difficile,Difficile,Difficile / Difficile
2293,634,2017,Sociologie,7,3,QCU,71,59,58,1,1.2,98.31,58,13,82.04,Difficile,Facile,Difficile / Facile
3123,634,2018,Sociologie,7,3,QCU,59,39,31,8,1.51,79.49,31,28,52.56,Difficile,Difficile,Difficile / Difficile
3953,634,2019,Sociologie,7,3,QCU,54,49,18,31,1.1,36.73,18,36,33.63,Difficile,Difficile,Difficile / Difficile
4783,634,2020,Sociologie,7,3,QCU,44,41,35,6,1.07,85.37,35,9,78.42,Difficile,Facile,Difficile / Facile
634,635,2015,Sociologie,7,4,QCM,10,8,6,2,1.25,75.0,6,4,60.79,Trop Difficile,Adapte,Trop Difficile / Adapte
1464,635,2016,Sociologie,7,4,QCM,12,8,8,0,1.5,100.0,8,4,67.27,Adapte,Adapte,Adapte / Adapte
2294,635,2017,Sociologie,7,4,QCM,11,11,7,4,1.0,63.64,7,4,67.9,Adapte,Adapte,Adapte / Adapte
3124,635,2018,Sociologie,7,4,QCM,13,8,8,0,1.62,100.0,8,5,63.72,Adapte,Adapte,Adapte / Adapte
3954,635,2019,Sociologie,7,4,QCM,10,7,7,0,1.43,100.0,7,3,71.21,Adapte,Adapte,Adapte / Adapte
4784,635,2020,Sociologie,7,4,QCM,12,10,9,1,1.2,90.0,9,3,73.69,Adapte,Adapte,Adapte / Adapte
635,636,2015,Sociologie,7,5,QCU,79,45,7,38,1.76,15.56,7,72,8.69,Trop Difficile,Trop Difficile,Trop Difficile / Trop Difficile
1465,636,2016,Sociologie,7,5,QCU,64,53,52,1,1.21,98.11,52,12,80.68,Difficile,Facile,Difficile / Facile
2295,636,2017,Sociologie,7,5,QCU,74,67,30,37,1.1,44.78,30,44,40.04,Difficile,Difficile,Difficile / Difficile
3125,636,2018,Sociologie,7,5,QCU,74,69,64,5,1.07,92.75,64,10,86.05,Difficile,Trop Facile,Difficile / Trop Facile
3955,636,2019,Sociologie,7,5,QCU,69,68,67,1,1.01,98.53,67,2,97.08,Difficile,Trop Facile,Difficile / Trop Facile
4785,636,2020,Sociologie,7,5,QCU,82,77,44,33,1.06,57.14,44,38,54.08,Difficile,Difficile,Difficile / Difficile
636,637,2015,Sociologie,7,6,QCU,73,49,30,19,1.49,61.22,30,43,40.49,Difficile,Difficile,Difficile / Difficile
1466,637,2016,Sociologie,7,6,QCU,69,51,38,13,1.35,74.51,38,31,54.49,Difficile,Difficile,Difficile / Difficile
2296,637,2017,Sociologie,7,6,QCU,59,56,36,20,1.05,64.29,36,23,60.99,Difficile,Adapte,Difficile / Adapte
3126,637,2018,Sociologie,7,6,QCU,65,62,42,20,1.05,67.74,42,23,64.55,Adapte,Adapte,Adapte / Adapte
3956,637,2019,Sociologie,7,6,QCU,54,43,34,9,1.26,79.07,34,20,63.08,Adapte,Adapte,Adapte / Adapte
4786,637,2020,Sociologie,7,6,QCU,60,60,36,24,1.0,60.0,36,24,60.26,Adapte,Adapte,Adapte / Adapte
637,638,2015,Sociologie,7,7,QCU,77,52,47,5,1.48,90.38,47,30,60.81,Adapte,Adapte,Adapte / Adapte
1467,638,2016,Sociologie,7,7,QCU,91,66,64,2,1.38,96.97,64,27,70.71,Adapte,Adapte,Adapte / Adapte
2297,638,2017,Sociologie,7,7,QCU,100,93,67,26,1.08,72.04,67,33,66.84,Adapte,Adapte,Adapte / Adapte
3127,638,2018,Sociologie,7,7,QCU,106,90,77,13,1.18,85.56,77,29,72.41,Adapte,Adapte,Adapte / Adapte
3957,638,2019,Sociologie,7,7,QCU,93,86,57,29,1.08,66.28,57,36,60.93,Adapte,Adapte,Adapte / Adapte
4787,638,2020,Sociologie,7,7,QCU,86,82,60,22,1.05,73.17,60,26,69.98,Adapte,Adapte,Adapte / Adapte
638,639,2015,Sociologie,8,1,QCM,62,54,14,40,1.15,25.93,14,48,23.2,Trop Difficile,Trop Difficile,Trop Difficile / Trop Difficile
1468,639,2016,Sociologie,8,1,QCM,55,49,42,7,1.12,85.71,42,13,76.28,Difficile,Facile,Difficile / Facile
2298,639,2017,Sociologie,8,1,QCM,58,57,50,7,1.02,87.72,50,8,86.06,Difficile,Trop Facile,Difficile / Trop Facile
3128,639,2018,Sociologie,8,1,QCM,51,40,39,1,1.27,97.5,39,12,77.11,Difficile,Facile,Difficile / Facile
3958,639,2019,Sociologie,8,1,QCM,49,25,23,2,1.96,92.0,23,26,47.93,Difficile,Difficile,Difficile / Difficile
4788,639,2020,Sociologie,8,1,QCM,55,54,54,0,1.02,100.0,54,1,98.86,Difficile,Trop Facile,Difficile / Trop Facile
639,640,2015,Sociologie,8,2,QCU,53,38,31,7,1.39,81.58,31,22,58.28,Difficile,Difficile,Difficile / Difficile
1469,640,2016,Sociologie,8,2,QCU,55,53,37,16,1.04,69.81,37,18,66.79,Difficile,Adapte,Difficile / Adapte
2299,640,2017,Sociologie,8,2,QCU,47,36,32,4,1.31,88.89,32,15,67.25,Adapte,Adapte,Adapte / Adapte
3129,640,2018,Sociologie,8,2,QCU,40,35,27,8,1.14,77.14,27,13,67.25,Adapte,Adapte,Adapte / Adapte
3959,640,2019,Sociologie,8,2,QCU,32,32,24,8,1.0,75.0,24,8,74.91,Adapte,Adapte,Adapte / Adapte
4789,640,2020,Sociologie,8,2,QCU,30,29,20,9,1.03,68.97,20,10,67.47,Adapte,Adapte,Adapte / Adapte
640,641,2015,Sociologie,8,3,QCM,91,73,71,2,1.25,97.26,71,20,77.65,Facile,Facile,Facile / Facile
1470,641,2016,Sociologie,8,3,QCM,81,66,53,13,1.23,80.3,53,28,65.2,Difficile,Adapte,Difficile / Adapte
2300,641,2017,Sociologie,8,3,QCM,86,70,64,6,1.23,91.43,64,22,74.18,Adapte,Adapte,Adapte / Adapte
3130,641,2018,Sociologie,8,3,QCM,82,72,50,22,1.14,69.44,50,32,61.03,Adapte,Adapte,Adapte / Adapte
3960,641,2019,Sociologie,8,3,QCM,86,62,52,10,1.39,83.87,52,34,60.16,Adapte,Adapte,Adapte / Adapte
4790,641,2020,Sociologie,8,3,QCM,74,51,49,2,1.45,96.08,49,25,66.44,Adapte,Adapte,Adapte / Adapte
641,642,2015,Sociologie,8,4,QCU,82,75,63,12,1.09,84.0,63,19,76.77,Difficile,Facile,Difficile / Facile
1471,642,2016,Sociologie,8,4,QCU,89,75,74,1,1.19,98.67,74,15,83.44,Difficile,Facile,Difficile / Facile
2301,642,2017,Sociologie,8,4,QCU,89,82,36,46,1.09,43.9,36,53,40.47,Difficile,Difficile,Difficile / Difficile
3131,642,2018,Sociologie,8,4,QCU,88,67,61,6,1.31,91.04,61,27,69.54,Difficile,Adapte,Difficile / Adapte
3961,642,2019,Sociologie,8,4,QCU,93,85,64,21,1.09,75.29,64,29,69.09,Adapte,Adapte,Adapte / Adapte
4791,642,2020,Sociologie,8,4,QCU,111,101,79,22,1.1,78.22,79,32,71.31,Adapte,Adapte,Adapte / Adapte
642,643,2015,Sociologie,8,5,QCM,90,76,51,25,1.18,67.11,51,39,56.65,Difficile,Difficile,Difficile / Difficile
1472,643,2016,Sociologie,8,5,QCM,92,74,73,1,1.24,98.65,73,19,79.47,Difficile,Facile,Difficile / Facile
2302,643,2017,Sociologie,8,5,QCM,110,94,17,77,1.17,18.09,17,93,15.03,Difficile,Trop Difficile,Difficile / Trop Difficile
3132,643,2018,Sociologie,8,5,QCM,89,84,65,19,1.06,77.38,65,24,72.65,Difficile,Adapte,Difficile / Adapte
3962,643,2019,Sociologie,8,5,QCM,85,68,59,9,1.25,86.76,59,26,68.94,Adapte,Adapte,Adapte / Adapte
4792,643,2020,Sociologie,8,5,QCM,79,55,51,4,1.44,92.73,51,28,64.54,Adapte,Adapte,Adapte / Adapte
643,644,2015,Sociologie,8,6,QCM,39,33,10,23,1.18,30.3,10,29,25.8,Difficile,Difficile,Difficile / Difficile
1473,644,2016,Sociologie,8,6,QCM,32,27,25,2,1.19,92.59,25,7,78.38,Difficile,Facile,Difficile / Facile
2303,644,2017,Sociologie,8,6,QCM,38,23,3,20,1.65,13.04,3,35,7.23,Difficile,Trop Difficile,Difficile / Trop Difficile
3133,644,2018,Sociologie,8,6,QCM,34,31,20,11,1.1,64.52,20,14,58.81,Difficile,Difficile,Difficile / Difficile
3963,644,2019,Sociologie,8,6,QCM,30,18,13,5,1.67,72.22,13,17,44.59,Difficile,Difficile,Difficile / Difficile
4793,644,2020,Sociologie,8,6,QCM,30,28,19,9,1.07,67.86,19,11,62.91,Difficile,Adapte,Difficile / Adapte
644,645,2015,Sociologie,9,1,QROC,20,19,2,17,1.05,10.53,2,18,8.52,Trop Facile,Trop Difficile,Trop Facile / Trop Difficile
1474,645,2016,Sociologie,9,1,QROC,23,19,8,11,1.21,42.11,8,15,36.66,Difficile,Difficile,Difficile / Difficile
2304,645,2017,Sociologie,9,1,QROC,27,12,9,3,2.25,75.0,9,18,33.1,Difficile,Difficile,Difficile / Difficile
3134,645,2018,Sociologie,9,1,QROC,28,19,9,10,1.47,47.37,9,19,33.92,Difficile,Difficile,Difficile / Difficile
3964,645,2019,Sociologie,9,1,QROC,33,29,16,13,1.14,55.17,16,17,48.32,Difficile,Difficile,Difficile / Difficile
4794,645,2020,Sociologie,9,1,QROC,36,19,16,3,1.89,84.21,16,20,43.96,Difficile,Difficile,Difficile / Difficile
645,646,2015,Sociologie,9,2,QROC,76,67,64,3,1.13,95.52,64,12,84.43,Facile,Facile,Facile / Facile
1475,646,2016,Sociologie,9,2,QROC,88,78,62,16,1.13,79.49,62,26,69.9,Difficile,Adapte,Difficile / Adapte
2305,646,2017,Sociologie,9,2,QROC,82,59,50,9,1.39,84.75,50,32,61.36,Adapte,Adapte,Adapte / Adapte
3135,646,2018,Sociologie,9,2,QROC,87,67,54,13,1.3,80.6,54,33,61.66,Adapte,Adapte,Adapte / Adapte
3965,646,2019,Sociologie,9,2,QROC,71,66,49,17,1.08,74.24,49,22,68.62,Adapte,Adapte,Adapte / Adapte
4795,646,2020,Sociologie,9,2,QROC,74,71,48,23,1.04,67.61,48,26,64.47,Adapte,Adapte,Adapte / Adapte
646,647,2015,Sociologie,9,3,QCU,22,21,6,15,1.05,28.57,6,16,27.12,Difficile,Difficile,Difficile / Difficile
1476,647,2016,Sociologie,9,3,QCU,23,18,11,7,1.28,61.11,11,12,46.24,Difficile,Difficile,Difficile / Difficile
2306,647,2017,Sociologie,9,3,QCU,22,20,14,6,1.1,70.0,14,8,64.44,Difficile,Adapte,Difficile / Adapte
3136,647,2018,Sociologie,9,3,QCU,21,20,15,5,1.05,75.0,15,6,73.7,Adapte,Adapte,Adapte / Adapte
3966,647,2019,Sociologie,9,3,QCU,22,22,16,6,1.0,72.73,16,6,72.27,Adapte,Adapte,Adapte / Adapte
4796,647,2020,Sociologie,9,3,QCU,23,17,16,1,1.35,94.12,16,7,68.2,Adapte,Adapte,Adapte / Adapte
647,648,2015,Sociologie,9,4,QCM,38,32,8,24,1.19,25.0,8,30,21.21,Facile,Trop Difficile,Facile / Trop Difficile
1477,648,2016,Sociologie,9,4,QCM,32,18,8,10,1.78,44.44,8,24,23.49,Difficile,Trop Difficile,Difficile / Trop Difficile
2307,648,2017,Sociologie,9,4,QCM,31,28,13,15,1.11,46.43,13,18,43.47,Difficile,Difficile,Difficile / Difficile
3137,648,2018,Sociologie,9,4,QCM,27,26,26,0,1.04,100.0,26,1,95.86,Difficile,Trop Facile,Difficile / Trop Facile
3967,648,2019,Sociologie,9,4,QCM,23,12,6,6,1.92,50.0,6,17,26.97,Difficile,Difficile,Difficile / Difficile
4797,648,2020,Sociologie,9,4,QCM,18,8,5,3,2.25,62.5,5,13,28.41,Difficile,Difficile,Difficile / Difficile
648,649,2015,Sociologie,10,1,QROC,86,84,6,78,1.02,7.14,6,80,6.46,Trop Difficile,Trop Difficile,Trop Difficile / Trop Difficile
1478,649,2016,Sociologie,10,1,QROC,102,58,56,2,1.76,96.55,56,46,54.84,Difficile,Difficile,Difficile / Difficile
2308,649,2017,Sociologie,10,1,QROC,96,79,55,24,1.22,69.62,55,41,56.87,Difficile,Difficile,Difficile / Difficile
3138,649,2018,Sociologie,10,1,QROC,112,106,62,44,1.06,58.49,62,50,55.38,Difficile,Difficile,Difficile / Difficile
3968,649,2019,Sociologie,10,1,QROC,119,117,113,4,1.02,96.58,113,6,94.95,Difficile,Trop Facile,Difficile / Trop Facile
4798,649,2020,Sociologie,10,1,QROC,97,41,34,7,2.37,82.93,34,63,35.44,Difficile,Difficile,Difficile / Difficile
649,650,2015,Sociologie,10,2,QCM,11,11,7,4,1.0,63.64,7,4,64.07,Adapte,Adapte,Adapte / Adapte
1479,650,2016,Sociologie,10,2,QCM,9,9,7,2,1.0,77.78,7,2,73.76,Adapte,Adapte,Adapte / Adapte
2309,650,2017,Sociologie,10,2,QCM,8,6,5,1,1.33,83.33,5,3,67.88,Adapte,Adapte,Adapte / Adapte
3139,650,2018,Sociologie,10,2,QCM,8,5,5,0,1.6,100.0,5,3,65.57,Adapte,Adapte,Adapte / Adapte
3969,650,2019,Sociologie,10,2,QCM,10,6,6,0,1.67,100.0,6,4,62.91,Adapte,Adapte,Adapte / Adapte
4799,650,2020,Sociologie,10,2,QCM,9,9,7,2,1.0,77.78,7,2,74.62,Adapte,Adapte,Adapte / Adapte
650,651,2015,Sociologie,10,3,QCU,38,34,21,13,1.12,61.76,21,17,54.8,Trop Difficile,Difficile,Trop Difficile / Difficile
1480,651,2016,Sociologie,10,3,QCU,43,34,22,12,1.26,64.71,22,21,51.66,Difficile,Difficile,Difficile / Difficile
2310,651,2017,Sociologie,10,3,QCU,43,35,31,4,1.23,88.57,31,12,72.34,Difficile,Adapte,Difficile / Adapte
3140,651,2018,Sociologie,10,3,QCU,37,37,23,14,1.0,62.16,23,14,62.66,Adapte,Adapte,Adapte / Adapte
3970,651,2019,Sociologie,10,3,QCU,37,25,23,2,1.48,92.0,23,14,61.69,Adapte,Adapte,Adapte / Adapte
4800,651,2020,Sociologie,10,3,QCU,41,35,30,5,1.17,85.71,30,11,74.11,Adapte,Adapte,Adapte / Adapte
651,652,2015,Sociologie,10,4,QCU,68,57,19,38,1.19,33.33,19,49,28.18,Trop Difficile,Difficile,Trop Difficile / Difficile
1481,652,2016,Sociologie,10,4,QCU,61,53,28,25,1.15,52.83,28,33,46.5,Difficile,Difficile,Difficile / Difficile
2311,652,2017,Sociologie,10,4,QCU,53,39,29,10,1.36,74.36,29,24,55.23,Difficile,Difficile,Difficile / Difficile
3141,652,2018,Sociologie,10,4,QCU,49,39,14,25,1.26,35.9,14,35,29.3,Difficile,Difficile,Difficile / Difficile
3971,652,2019,Sociologie,10,4,QCU,59,59,57,2,1.0,96.61,57,2,96.22,Difficile,Trop Facile,Difficile / Trop Facile
4801,652,2020,Sociologie,10,4,QCU,57,26,21,5,2.19,80.77,21,36,36.57,Difficile,Difficile,Difficile / Difficile
652,653,2015,Sociologie,10,5,QCU,24,16,14,2,1.5,87.5,14,10,60.13,Adapte,Adapte,Adapte / Adapte
1482,653,2016,Sociologie,10,5,QCU,23,20,17,3,1.15,85.0,17,6,72.69,Adapte,Adapte,Adapte / Adapte
2312,653,2017,Sociologie,10,5,QCU,28,21,19,2,1.33,90.48,19,9,66.95,Adapte,Adapte,Adapte / Adapte
3142,653,2018,Sociologie,10,5,QCU,32,26,22,4,1.23,84.62,22,10,69.63,Adapte,Adapte,Adapte / Adapte
3972,653,2019,Sociologie,10,5,QCU,28,23,20,3,1.22,86.96,20,8,71.23,Adapte,Adapte,Adapte / Adapte
4802,653,2020,Sociologie,10,5,QCU,27,19,18,1,1.42,94.74,18,9,66.91,Adapte,Adapte,Adapte / Adapte
653,654,2015,Sociologie,10,6,QCU,23,20,16,4,1.15,80.0,16,7,69.55,Trop Difficile,Adapte,Trop Difficile / Adapte
1483,654,2016,Sociologie,10,6,QCU,24,19,15,4,1.26,78.95,15,9,62.49,Adapte,Adapte,Adapte / Adapte
2313,654,2017,Sociologie,10,6,QCU,29,27,19,8,1.07,70.37,19,10,64.24,Adapte,Adapte,Adapte / Adapte
3143,654,2018,Sociologie,10,6,QCU,27,21,19,2,1.29,90.48,19,8,69.72,Adapte,Adapte,Adapte / Adapte
3973,654,2019,Sociologie,10,6,QCU,25,22,17,5,1.14,77.27,17,8,68.05,Adapte,Adapte,Adapte / Adapte
4803,654,2020,Sociologie,10,6,QCU,25,16,15,1,1.56,93.75,15,10,61.84,Adapte,Adapte,Adapte / Adapte
654,655,2015,Sociologie,10,7,QCM,14,14,13,1,1.0,92.86,13,1,91.9,Trop Facile,Trop Facile,Trop Facile / Trop Facile
1484,655,2016,Sociologie,10,7,QCM,13,10,6,4,1.3,60.0,6,7,44.64,Difficile,Difficile,Difficile / Difficile
2314,655,2017,Sociologie,10,7,QCM,14,13,12,1,1.08,92.31,12,2,87.33,Difficile,Trop Facile,Difficile / Trop Facile
3144,655,2018,Sociologie,10,7,QCM,11,6,2,4,1.83,33.33,2,9,15.3,Difficile,Trop Difficile,Difficile / Trop Difficile
3974,655,2019,Sociologie,10,7,QCM,10,8,1,7,1.25,12.5,1,9,10.93,Difficile,Trop Difficile,Difficile / Trop Difficile
4804,655,2020,Sociologie,10,7,QCM,8,6,2,4,1.33,33.33,2,6,19.42,Difficile,Trop Difficile,Difficile / Trop Difficile
655,656,2015,Sociologie,10,8,QCU,39,34,32,2,1.15,94.12,32,7,81.4,Facile,Facile,Facile / Facile
1485,656,2016,Sociologie,10,8,QCU,33,33,22,11,1.0,66.67,22,11,66.02,Difficile,Adapte,Difficile / Adapte
2315,656,2017,Sociologie,10,8,QCU,36,29,24,5,1.24,82.76,24,12,66.27,Adapte,Adapte,Adapte / Adapte
3145,656,2018,Sociologie,10,8,QCU,35,27,25,2,1.3,92.59,25,10,71.4,Adapte,Adapte,Adapte / Adapte
3975,656,2019,Sociologie,10,8,QCU,37,28,23,5,1.32,82.14,23,14,61.67,Adapte,Adapte,Adapte / Adapte
4805,656,2020,Sociologie,10,8,QCU,30,28,22,6,1.07,78.57,22,8,74.95,Adapte,Adapte,Adapte / Adapte
656,657,2015,Sociologie,10,9,QO,71,70,60,10,1.01,85.71,60,11,84.78,Adapte,Facile,Adapte / Facile
1486,657,2016,Sociologie,10,9,QO,77,48,23,25,1.6,47.92,23,54,30.16,Trop Difficile,Difficile,Trop Difficile / Difficile
2316,657,2017,Sociologie,10,9,QO,73,42,8,34,1.74,19.05,8,65,11.52,Trop Difficile,Trop Difficile,Trop Difficile / Trop Difficile
3146,657,2018,Sociologie,10,9,QO,68,65,11,54,1.05,16.92,11,57,15.53,Trop Difficile,Trop Difficile,Trop Difficile / Trop Difficile
3976,657,2019,Sociologie,10,9,QO,70,54,12,42,1.3,22.22,12,58,17.22,Trop Difficile,Trop Difficile,Trop Difficile / Trop Difficile
4806,657,2020,Sociologie,10,9,QO,68,43,0,43,1.58,0.0,0,68,0.3,Trop Difficile,Trop Difficile,Trop Difficile / Trop Difficile
657,658,2015,Sociologie,10,10,QROC,98,84,82,2,1.17,97.62,82,16,84.05,Trop Facile,Facile,Trop Facile / Facile
1487,658,2016,Sociologie,10,10,QROC,88,36,34,2,2.44,94.44,34,54,39.06,Difficile,Difficile,Difficile / Difficile
2317,658,2017,Sociologie,10,10,QROC,70,69,9,60,1.01,13.04,9,61,12.79,Difficile,Trop Difficile,Difficile / Trop Difficile
3147,658,2018,Sociologie,10,10,QROC,63,59,57,2,1.07,96.61,57,6,89.8,Difficile,Trop Facile,Difficile / Trop Facile
3977,658,2019,Sociologie,10,10,QROC,52,35,24,11,1.49,68.57,24,28,46.02,Difficile,Difficile,Difficile / Difficile
4807,658,2020,Sociologie,10,10,QROC,42,41,39,2,1.02,95.12,39,3,91.79,Difficile,Trop Facile,Difficile / Trop Facile
658,659,2015,Sociologie,10,11,QCM,24,14,13,1,1.71,92.86,13,11,53.74,Difficile,Difficile,Difficile / Difficile
1488,659,2016,Sociologie,10,11,QCM,21,20,11,9,1.05,55.0,11,10,51.85,Difficile,Difficile,Difficile / Difficile
2318,659,2017,Sociologie,10,11,QCM,21,16,12,4,1.31,75.0,12,9,56.52,Difficile,Difficile,Difficile / Difficile
3148,659,2018,Sociologie,10,11,QCM,17,15,9,6,1.13,60.0,9,8,53.9,Difficile,Difficile,Difficile / Difficile
3978,659,2019,Sociologie,10,11,QCM,16,14,5,9,1.14,35.71,5,11,28.86,Difficile,Difficile,Difficile / Difficile
4808,659,2020,Sociologie,10,11,QCM,13,8,4,4,1.62,50.0,4,9,30.52,Difficile,Difficile,Difficile / Difficile
659,660,2015,Sociologie,10,12,QCM,87,82,81,1,1.06,98.78,81,6,93.6,Trop Difficile,Trop Facile,Trop Difficile / Trop Facile
1489,660,2016,Sociologie,10,12,QCM,71,66,50,16,1.08,75.76,50,21,70.7,Difficile,Adapte,Difficile / Adapte
2319,660,2017,Sociologie,10,12,QCM,84,74,51,23,1.14,68.92,51,33,61.23,Adapte,Adapte,Adapte / Adapte
3149,660,2018,Sociologie,10,12,QCM,84,77,62,15,1.09,80.52,62,22,74.03,Adapte,Adapte,Adapte / Adapte
3979,660,2019,Sociologie,10,12,QCM,72,64,48,16,1.12,75.0,48,24,66.21,Adapte,Adapte,Adapte / Adapte
4809,660,2020,Sociologie,10,12,QCM,81,59,50,9,1.37,84.75,50,31,62.27,Adapte,Adapte,Adapte / Adapte
660,661,2015,Sociologie,11,1,QROC,56,54,45,9,1.04,83.33,45,11,80.43,Facile,Facile,Facile / Facile
1490,661,2016,Sociologie,11,1,QROC,50,38,20,18,1.32,52.63,20,30,40.66,Difficile,Difficile,Difficile / Difficile
2320,661,2017,Sociologie,11,1,QROC,49,35,16,19,1.4,45.71,16,33,32.07,Difficile,Difficile,Difficile / Difficile
3150,661,2018,Sociologie,11,1,QROC,39,31,23,8,1.26,74.19,23,16,58.89,Difficile,Difficile,Difficile / Difficile
3980,661,2019,Sociologie,11,1,QROC,45,43,14,29,1.05,32.56,14,31,31.07,Difficile,Difficile,Difficile / Difficile
4810,661,2020,Sociologie,11,1,QROC,40,36,20,16,1.11,55.56,20,20,48.78,Difficile,Difficile,Difficile / Difficile
661,662,2015,Sociologie,11,2,QCM,71,44,1,43,1.61,2.27,1,70,1.7,Trop Difficile,Trop Difficile,Trop Difficile / Trop Difficile
1491,662,2016,Sociologie,11,2,QCM,65,55,52,3,1.18,94.55,52,13,80.49,Difficile,Facile,Difficile / Facile
2321,662,2017,Sociologie,11,2,QCM,61,37,25,12,1.65,67.57,25,36,40.67,Difficile,Difficile,Difficile / Difficile
3151,662,2018,Sociologie,11,2,QCM,62,35,34,1,1.77,97.14,34,28,55.59,Difficile,Difficile,Difficile / Difficile
3981,662,2019,Sociologie,11,2,QCM,67,53,35,18,1.26,66.04,35,32,52.0,Difficile,Difficile,Difficile / Difficile
4811,662,2020,Sociologie,11,2,QCM,70,68,10,58,1.03,14.71,10,60,14.62,Difficile,Trop Difficile,Difficile / Trop Difficile
662,663,2015,Sociologie,11,3,QCU,60,51,45,6,1.18,88.24,45,15,74.53,Adapte,Adapte,Adapte / Adapte
1492,663,2016,Sociologie,11,3,QCU,64,54,40,14,1.19,74.07,40,24,61.76,Adapte,Adapte,Adapte / Adapte
2322,663,2017,Sociologie,11,3,QCU,71,69,51,18,1.03,73.91,51,20,72.05,Adapte,Adapte,Adapte / Adapte
3152,663,2018,Sociologie,11,3,QCU,74,61,53,8,1.21,86.89,53,21,72.09,Adapte,Adapte,Adapte / Adapte
3982,663,2019,Sociologie,11,3,QCU,79,64,58,6,1.23,90.62,58,21,72.89,Adapte,Adapte,Adapte / Adapte
4812,663,2020,Sociologie,11,3,QCU,91,91,57,34,1.0,62.64,57,34,62.61,Adapte,Adapte,Adapte / Adapte
663,664,2015,Sociologie,11,4,QCU,82,66,57,9,1.24,86.36,57,25,69.26,Trop Difficile,Adapte,Trop Difficile / Adapte
1493,664,2016,Sociologie,11,4,QCU,80,54,48,6,1.48,88.89,48,32,60.16,Adapte,Adapte,Adapte / Adapte
2323,664,2017,Sociologie,11,4,QCU,70,49,43,6,1.43,87.76,43,27,61.03,Adapte,Adapte,Adapte / Adapte
3153,664,2018,Sociologie,11,4,QCU,75,64,46,18,1.17,71.88,46,29,60.96,Adapte,Adapte,Adapte / Adapte
3983,664,2019,Sociologie,11,4,QCU,83,82,58,24,1.01,70.73,58,25,70.06,Adapte,Adapte,Adapte / Adapte
4813,664,2020,Sociologie,11,4,QCU,96,86,58,28,1.12,67.44,58,38,60.45,Adapte,Adapte,Adapte / Adapte
664,665,2015,Sociologie,11,5,QCM,96,31,6,25,3.1,19.35,6,90,6.08,Trop Difficile,Trop Difficile,Trop Difficile / Trop Difficile
1494,665,2016,Sociologie,11,5,QCM,85,43,36,7,1.98,83.72,36,49,42.56,Difficile,Difficile,Difficile / Difficile
2324,665,2017,Sociologie,11,5,QCM,102,65,42,23,1.57,64.62,42,60,40.93,Difficile,Difficile,Difficile / Difficile
3154,665,2018,Sociologie,11,5,QCM,120,91,67,24,1.32,73.63,67,53,56.19,Difficile,Difficile,Difficile / Difficile
3984,665,2019,Sociologie,11,5,QCM,118,117,39,78,1.01,33.33,39,79,32.86,Difficile,Difficile,Difficile / Difficile
4814,665,2020,Sociologie,11,5,QCM,95,93,88,5,1.02,94.62,88,7,92.64,Difficile,Trop Facile,Difficile / Trop Facile
665,666,2015,Sociologie,11,6,QCU,45,41,41,0,1.1,100.0,41,4,92.21,Trop Facile,Trop Facile,Trop Facile / Trop Facile
1495,666,2016,Sociologie,11,6,QCU,51,42,31,11,1.21,73.81,31,20,60.74,Difficile,Adapte,Difficile / Adapte
2325,666,2017,Sociologie,11,6,QCU,54,44,33,11,1.23,75.0,33,21,61.61,Adapte,Adapte,Adapte / Adapte
3155,666,2018,Sociologie,11,6,QCU,49,46,32,14,1.07,69.57,32,17,65.91,Adapte,Adapte,Adapte / Adapte
3985,666,2019,Sociologie,11,6,QCU,57,43,41,2,1.33,95.35,41,16,71.57,Adapte,Adapte,Adapte / Adapte
4815,666,2020,Sociologie,11,6,QCU,49,43,31,12,1.14,72.09,31,18,64.16,Adapte,Adapte,Adapte / Adapte
666,667,2015,Sociologie,11,7,QROC,34,30,27,3,1.13,90.0,27,7,80.29,Facile,Facile,Facile / Facile
1496,667,2016,Sociologie,11,7,QROC,34,21,16,5,1.62,76.19,16,18,47.29,Difficile,Difficile,Difficile / Difficile
2326,667,2017,Sociologie,11,7,QROC,40,32,12,20,1.25,37.5,12,28,29.78,Difficile,Difficile,Difficile / Difficile
3156,667,2018,Sociologie,11,7,QROC,36,18,12,6,2.0,66.67,12,24,33.75,Difficile,Difficile,Difficile / Difficile
3986,667,2019,Sociologie,11,7,QROC,30,22,17,5,1.36,77.27,17,13,56.62,Difficile,Difficile,Difficile / Difficile
4816,667,2020,Sociologie,11,7,QROC,32,13,9,4,2.46,69.23,9,23,29.0,Difficile,Difficile,Difficile / Difficile
667,668,2015,Sociologie,12,1,QROC,37,26,16,10,1.42,61.54,16,21,42.49,Difficile,Difficile,Difficile / Difficile
1497,668,2016,Sociologie,12,1,QROC,32,29,27,2,1.1,93.1,27,5,82.98,Difficile,Facile,Difficile / Facile
2327,668,2017,Sociologie,12,1,QROC,32,26,17,9,1.23,65.38,17,15,53.39,Difficile,Difficile,Difficile / Difficile
3157,668,2018,Sociologie,12,1,QROC,27,27,25,2,1.0,92.59,25,2,94.11,Difficile,Trop Facile,Difficile / Trop Facile
3987,668,2019,Sociologie,12,1,QROC,25,25,21,4,1.0,84.0,21,4,84.56,Difficile,Facile,Difficile / Facile
4817,668,2020,Sociologie,12,1,QROC,21,19,19,0,1.11,100.0,19,2,92.4,Difficile,Trop Facile,Difficile / Trop Facile
668,669,2015,Sociologie,12,2,QCU,46,45,42,3,1.02,93.33,42,4,91.68,Trop Facile,Trop Facile,Trop Facile / Trop Facile
1498,669,2016,Sociologie,12,2,QCU,52,37,24,13,1.41,64.86,24,28,46.1,Difficile,Difficile,Difficile / Difficile
2328,669,2017,Sociologie,12,2,QCU,42,36,34,2,1.17,94.44,34,8,80.33,Difficile,Facile,Difficile / Facile
3158,669,2018,Sociologie,12,2,QCU,48,40,22,18,1.2,55.0,22,26,46.15,Difficile,Difficile,Difficile / Difficile
3988,669,2019,Sociologie,12,2,QCU,45,32,25,7,1.41,78.12,25,20,56.18,Difficile,Difficile,Difficile / Difficile
4818,669,2020,Sociologie,12,2,QCU,51,43,24,19,1.19,55.81,24,27,46.81,Difficile,Difficile,Difficile / Difficile
669,670,2015,Sociologie,12,3,QCM,5,4,4,0,1.25,100.0,4,1,80.39,Adapte,Facile,Adapte / Facile
1499,670,2016,Sociologie,12,3,QCM,6,5,3,2,1.2,60.0,3,3,55.7,Difficile,Difficile,Difficile / Difficile
2329,670,2017,Sociologie,12,3,QCM,7,5,3,2,1.4,60.0,3,4,46.76,Difficile,Difficile,Difficile / Difficile
3159,670,2018,Sociologie,12,3,QCM,8,6,4,2,1.33,66.67,4,4,44.37,Difficile,Difficile,Difficile / Difficile
3989,670,2019,Sociologie,12,3,QCM,9,7,1,6,1.29,14.29,1,8,7.07,Difficile,Trop Difficile,Difficile / Trop Difficile
4819,670,2020,Sociologie,12,3,QCM,7,5,2,3,1.4,40.0,2,5,30.1,Difficile,Difficile,Difficile / Difficile
670,671,2015,Sociologie,12,4,QCM,11,11,11,0,1.0,100.0,11,0,96.8,Facile,Trop Facile,Facile / Trop Facile
1500,671,2016,Sociologie,12,4,QCM,12,11,5,6,1.09,45.45,5,7,44.03,Difficile,Difficile,Difficile / Difficile
2330,671,2017,Sociologie,12,4,QCM,12,9,7,2,1.33,77.78,7,5,58.79,Difficile,Difficile,Difficile / Difficile
3160,671,2018,Sociologie,12,4,QCM,13,11,5,6,1.18,45.45,5,8,35.92,Difficile,Difficile,Difficile / Difficile
3990,671,2019,Sociologie,12,4,QCM,11,10,6,4,1.1,60.0,6,5,52.82,Difficile,Difficile,Difficile / Difficile
4820,671,2020,Sociologie,12,4,QCM,9,8,3,5,1.12,37.5,3,6,32.66,Difficile,Difficile,Difficile / Difficile
671,672,2015,Sociologie,12,5,QROC,29,28,19,9,1.04,67.86,19,10,64.46,Trop Facile,Adapte,Trop Facile / Adapte
1501,672,2016,Sociologie,12,5,QROC,25,23,15,8,1.09,65.22,15,10,61.63,Adapte,Adapte,Adapte / Adapte
2331,672,2017,Sociologie,12,5,QROC,20,17,13,4,1.18,76.47,13,7,63.23,Adapte,Adapte,Adapte / Adapte
3161,672,2018,Sociologie,12,5,QROC,21,20,13,7,1.05,65.0,13,8,62.86,Adapte,Adapte,Adapte / Adapte
3991,672,2019,Sociologie,12,5,QROC,24,20,16,4,1.2,80.0,16,8,67.57,Adapte,Adapte,Adapte / Adapte
4821,672,2020,Sociologie,12,5,QROC,27,26,18,8,1.04,69.23,18,9,67.63,Adapte,Adapte,Adapte / Adapte
672,673,2015,Sociologie,12,6,QCM,83,83,81,2,1.0,97.59,81,2,97.04,Facile,Trop Facile,Facile / Trop Facile
1502,673,2016,Sociologie,12,6,QCM,72,71,44,27,1.01,61.97,44,28,60.95,Difficile,Adapte,Difficile / Adapte
2332,673,2017,Sociologie,12,6,QCM,68,48,41,7,1.42,85.42,41,27,60.62,Adapte,Adapte,Adapte / Adapte
3162,673,2018,Sociologie,12,6,QCM,64,52,45,7,1.23,86.54,45,19,69.98,Adapte,Adapte,Adapte / Adapte
3992,673,2019,Sociologie,12,6,QCM,72,50,48,2,1.44,96.0,48,24,66.73,Adapte,Adapte,Adapte / Adapte
4822,673,2020,Sociologie,12,6,QCM,65,59,48,11,1.1,81.36,48,17,74.45,Adapte,Adapte,Adapte / Adapte
673,674,2015,Sociologie,12,7,QCU,79,72,71,1,1.1,98.61,71,8,89.5,Trop Facile,Trop Facile,Trop Facile / Trop Facile
1503,674,2016,Sociologie,12,7,QCU,91,81,32,49,1.12,39.51,32,59,35.62,Difficile,Difficile,Difficile / Difficile
2333,674,2017,Sociologie,12,7,QCU,79,37,31,6,2.14,83.78,31,48,39.43,Difficile,Difficile,Difficile / Difficile
3163,674,2018,Sociologie,12,7,QCU,72,42,22,20,1.71,52.38,22,50,30.26,Difficile,Difficile,Difficile / Difficile
3993,674,2019,Sociologie,12,7,QCU,77,59,22,37,1.31,37.29,22,55,28.58,Difficile,Difficile,Difficile / Difficile
4823,674,2020,Sociologie,12,7,QCU,73,54,32,22,1.35,59.26,32,41,44.1,Difficile,Difficile,Difficile / Difficile
674,675,2015,Sociologie,12,8,QCM,73,69,68,1,1.06,98.55,68,5,93.37,Trop Facile,Trop Facile,Trop Facile / Trop Facile
1504,675,2016,Sociologie,12,8,QCM,60,29,17,12,2.07,58.62,17,43,29.02,Difficile,Difficile,Difficile / Difficile
2334,675,2017,Sociologie,12,8,QCM,50,30,27,3,1.67,90.0,27,23,53.23,Difficile,Difficile,Difficile / Difficile
3164,675,2018,Sociologie,12,8,QCM,58,55,15,40,1.05,27.27,15,43,26.17,Difficile,Difficile,Difficile / Difficile
3994,675,2019,Sociologie,12,8,QCM,69,48,40,8,1.44,83.33,40,29,57.33,Difficile,Difficile,Difficile / Difficile
4824,675,2020,Sociologie,12,8,QCM,59,17,15,2,3.47,88.24,15,44,26.24,Difficile,Difficile,Difficile / Difficile
675,676,2015,Sociologie,12,9,QCU,40,25,2,23,1.6,8.0,2,38,5.67,Trop Difficile,Trop Difficile,Trop Difficile / Trop Difficile
1505,676,2016,Sociologie,12,9,QCU,33,32,32,0,1.03,100.0,32,1,96.09,Difficile,Trop Facile,Difficile / Trop Facile
2335,676,2017,Sociologie,12,9,QCU,36,29,15,14,1.24,51.72,15,21,41.88,Difficile,Difficile,Difficile / Difficile
3165,676,2018,Sociologie,12,9,QCU,41,32,10,22,1.28,31.25,10,31,23.4,Difficile,Trop Difficile,Difficile / Trop Difficile
3995,676,2019,Sociologie,12,9,QCU,43,26,19,7,1.65,73.08,19,24,44.74,Difficile,Difficile,Difficile / Difficile
4825,676,2020,Sociologie,12,9,QCU,38,30,21,9,1.27,70.0,21,17,55.55,Difficile,Difficile,Difficile / Difficile
676,677,2015,Sociologie,12,10,QCM,16,13,11,2,1.23,84.62,11,5,65.88,Facile,Adapte,Facile / Adapte
1506,677,2016,Sociologie,12,10,QCM,17,12,11,1,1.42,91.67,11,6,63.57,Adapte,Adapte,Adapte / Adapte
2336,677,2017,Sociologie,12,10,QCM,14,14,9,5,1.0,64.29,9,5,65.46,Adapte,Adapte,Adapte / Adapte
3166,677,2018,Sociologie,12,10,QCM,13,10,9,1,1.3,90.0,9,4,71.71,Adapte,Adapte,Adapte / Adapte
3996,677,2019,Sociologie,12,10,QCM,14,11,8,3,1.27,72.73,8,6,60.42,Adapte,Adapte,Adapte / Adapte
4826,677,2020,Sociologie,12,10,QCM,16,13,12,1,1.23,92.31,12,4,72.85,Adapte,Adapte,Adapte / Adapte
677,678,2015,Sociologie,13,1,QCM,96,91,89,2,1.05,97.8,89,7,92.59,Trop Difficile,Trop Facile,Trop Difficile / Trop Facile
1507,678,2016,Sociologie,13,1,QCM,112,62,37,25,1.81,59.68,37,75,32.9,Difficile,Difficile,Difficile / Difficile
2337,678,2017,Sociologie,13,1,QCM,119,82,79,3,1.45,96.34,79,40,66.75,Difficile,Adapte,Difficile / Adapte
3167,678,2018,Sociologie,13,1,QCM,139,109,96,13,1.28,88.07,96,43,69.28,Adapte,Adapte,Adapte / Adapte
3997,678,2019,Sociologie,13,1,QCM,158,121,109,12,1.31,90.08,109,49,69.21,Adapte,Adapte,Adapte / Adapte
4827,678,2020,Sociologie,13,1,QCM,139,132,87,45,1.05,65.91,87,52,62.54,Adapte,Adapte,Adapte / Adapte
678,679,2015,Sociologie,13,2,QCU,35,32,6,26,1.09,18.75,6,29,16.42,Trop Facile,Trop Difficile,Trop Facile / Trop Difficile
1508,679,2016,Sociologie,13,2,QCU,38,31,13,18,1.23,41.94,13,25,33.78,Difficile,Difficile,Difficile / Difficile
2338,679,2017,Sociologie,13,2,QCU,43,17,11,6,2.53,64.71,11,32,25.99,Difficile,Difficile,Difficile / Difficile
3168,679,2018,Sociologie,13,2,QCU,36,32,18,14,1.12,56.25,18,18,50.16,Difficile,Difficile,Difficile / Difficile
3998,679,2019,Sociologie,13,2,QCU,37,13,5,8,2.85,38.46,5,32,13.32,Difficile,Trop Difficile,Difficile / Trop Difficile
4828,679,2020,Sociologie,13,2,QCU,41,29,27,2,1.41,93.1,27,14,65.05,Difficile,Adapte,Difficile / Adapte
679,680,2015,Sociologie,13,3,QROC,89,72,11,61,1.24,15.28,11,78,12.44,Trop Difficile,Trop Difficile,Trop Difficile / Trop Difficile
1509,680,2016,Sociologie,13,3,QROC,76,59,15,44,1.29,25.42,15,61,19.62,Difficile,Trop Difficile,Difficile / Trop Difficile
2339,680,2017,Sociologie,13,3,QROC,76,37,32,5,2.05,86.49,32,44,41.73,Difficile,Difficile,Difficile / Difficile
3169,680,2018,Sociologie,13,3,QROC,76,75,74,1,1.01,98.67,74,2,97.91,Difficile,Trop Facile,Difficile / Trop Facile
3999,680,2019,Sociologie,13,3,QROC,85,59,4,55,1.44,6.78,4,81,4.14,Difficile,Trop Difficile,Difficile / Trop Difficile
4829,680,2020,Sociologie,13,3,QROC,81,78,30,48,1.04,38.46,30,51,37.24,Difficile,Difficile,Difficile / Difficile
680,681,2015,Sociologie,13,4,QROC,38,36,23,13,1.06,63.89,23,15,60.71,Trop Difficile,Adapte,Trop Difficile / Adapte
1510,681,2016,Sociologie,13,4,QROC,45,39,31,8,1.15,79.49,31,14,68.06,Adapte,Adapte,Adapte / Adapte
2340,681,2017,Sociologie,13,4,QROC,50,40,36,4,1.25,90.0,36,14,72.34,Adapte,Adapte,Adapte / Adapte
3170,681,2018,Sociologie,13,4,QROC,46,37,30,7,1.24,81.08,30,16,65.7,Adapte,Adapte,Adapte / Adapte
4000,681,2019,Sociologie,13,4,QROC,50,43,30,13,1.16,69.77,30,20,60.87,Adapte,Adapte,Adapte / Adapte
4830,681,2020,Sociologie,13,4,QROC,59,47,43,4,1.26,91.49,43,16,73.06,Adapte,Adapte,Adapte / Adapte
681,682,2015,Sociologie,13,5,QCU,6,3,1,2,2.0,33.33,1,5,22.05,Trop Difficile,Trop Difficile,Trop Difficile / Trop Difficile
1511,682,2016,Sociologie,13,5,QCU,5,3,3,0,1.67,100.0,3,2,54.52,Difficile,Difficile,Difficile / Difficile
2341,682,2017,Sociologie,13,5,QCU,6,5,1,4,1.2,20.0,1,5,20.53,Difficile,Trop Difficile,Difficile / Trop Difficile
3171,682,2018,Sociologie,13,5,QCU,5,3,2,1,1.67,66.67,2,3,36.84,Difficile,Difficile,Difficile / Difficile
4001,682,2019,Sociologie,13,5,QCU,6,5,3,2,1.2,60.0,3,3,44.6,Difficile,Difficile,Difficile / Difficile
4831,682,2020,Sociologie,13,5,QCU,6,3,2,1,2.0,66.67,2,4,32.65,Difficile,Difficile,Difficile / Difficile
682,683,2015,Sociologie,13,6,QCU,17,12,1,11,1.42,8.33,1,16,4.66,Trop Difficile,Trop Difficile,Trop Difficile / Trop Difficile
1512,683,2016,Sociologie,13,6,QCU,17,15,13,2,1.13,86.67,13,4,76.04,Difficile,Facile,Difficile / Facile
2342,683,2017,Sociologie,13,6,QCU,17,17,7,10,1.0,41.18,7,10,40.92,Difficile,Difficile,Difficile / Difficile
3172,683,2018,Sociologie,13,6,QCU,19,9,6,3,2.11,66.67,6,13,29.65,Difficile,Difficile,Difficile / Difficile
4002,683,2019,Sociologie,13,6,QCU,15,12,10,2,1.25,83.33,10,5,65.25,Difficile,Adapte,Difficile / Adapte
4832,683,2020,Sociologie,13,6,QCU,12,9,8,1,1.33,88.89,8,4,63.39,Adapte,Adapte,Adapte / Adapte
683,684,2015,Sociologie,13,7,QCM,59,55,54,1,1.07,98.18,54,5,90.68,Trop Facile,Trop Facile,Trop Facile / Trop Facile
1513,684,2016,Sociologie,13,7,QCM,50,45,34,11,1.11,75.56,34,16,68.93,Difficile,Adapte,Difficile / Adapte
2343,684,2017,Sociologie,13,7,QCM,51,40,34,6,1.27,85.0,34,17,67.24,Adapte,Adapte,Adapte / Adapte
3173,684,2018,Sociologie,13,7,QCM,57,47,40,7,1.21,85.11,40,17,69.51,Adapte,Adapte,Adapte / Adapte
4003,684,2019,Sociologie,13,7,QCM,65,44,40,4,1.48,90.91,40,25,61.44,Adapte,Adapte,Adapte / Adapte
4833,684,2020,Sociologie,13,7,QCM,69,67,44,23,1.03,65.67,44,25,63.1,Adapte,Adapte,Adapte / Adapte
684,685,2015,Sociologie,13,8,QCM,58,57,48,9,1.02,84.21,48,10,83.29,Facile,Facile,Facile / Facile
1514,685,2016,Sociologie,13,8,QCM,61,41,23,18,1.49,56.1,23,38,36.94,Difficile,Difficile,Difficile / Difficile
2344,685,2017,Sociologie,13,8,QCM,68,39,34,5,1.74,87.18,34,34,49.79,Difficile,Difficile,Difficile / Difficile
3174,685,2018,Sociologie,13,8,QCM,59,54,20,34,1.09,37.04,20,39,33.96,Difficile,Difficile,Difficile / Difficile
4004,685,2019,Sociologie,13,8,QCM,64,53,21,32,1.21,39.62,21,43,33.59,Difficile,Difficile,Difficile / Difficile
4834,685,2020,Sociologie,13,8,QCM,54,39,21,18,1.38,53.85,21,33,38.07,Difficile,Difficile,Difficile / Difficile
685,686,2015,Sociologie,13,9,QCM,49,47,34,13,1.04,72.34,34,15,68.4,Adapte,Adapte,Adapte / Adapte
1515,686,2016,Sociologie,13,9,QCM,46,39,30,9,1.18,76.92,30,16,65.98,Adapte,Adapte,Adapte / Adapte
2345,686,2017,Sociologie,13,9,QCM,44,33,27,6,1.33,81.82,27,17,61.94,Adapte,Adapte,Adapte / Adapte
3175,686,2018,Sociologie,13,9,QCM,36,27,27,0,1.33,100.0,27,9,74.28,Adapte,Adapte,Adapte / Adapte
4005,686,2019,Sociologie,13,9,QCM,36,30,24,6,1.2,80.0,24,12,66.29,Adapte,Adapte,Adapte / Adapte
4835,686,2020,Sociologie,13,9,QCM,35,32,23,9,1.09,71.88,23,12,64.85,Adapte,Adapte,Adapte / Adapte
686,687,2015,Sociologie,14,1,QO,93,91,36,55,1.02,39.56,36,57,38.67,Difficile,Difficile,Difficile / Difficile
1516,687,2016,Sociologie,14,1,QO,87,60,17,43,1.45,28.33,17,70,19.26,Trop Difficile,Trop Difficile,Trop Difficile / Trop Difficile
2346,687,2017,Sociologie,14,1,QO,101,87,20,67,1.16,22.99,20,81,19.38,Trop Difficile,Trop Difficile,Trop Difficile / Trop Difficile
3176,687,2018,Sociologie,14,1,QO,118,100,17,83,1.18,17.0,17,101,14.79,Trop Difficile,Trop Difficile,Trop Difficile / Trop Difficile
4006,687,2019,Sociologie,14,1,QO,97,74,14,60,1.31,18.92,14,83,14.41,Trop Difficile,Trop Difficile,Trop Difficile / Trop Difficile
4836,687,2020,Sociologie,14,1,QO,93,75,59,16,1.24,78.67,59,34,63.92,Trop Difficile,Adapte,Trop Difficile / Adapte
687,688,2015,Sociologie,14,2,QCM,93,77,64,13,1.21,83.12,64,29,68.42,Adapte,Adapte,Adapte / Adapte
1517,688,2016,Sociologie,14,2,QCM,78,60,53,7,1.3,88.33,53,25,67.78,Adapte,Adapte,Adapte / Adapte
2347,688,2017,Sociologie,14,2,QCM,91,82,55,27,1.11,67.07,55,36,60.87,Adapte,Adapte,Adapte / Adapte
3177,688,2018,Sociologie,14,2,QCM,76,71,54,17,1.07,76.06,54,22,71.61,Adapte,Adapte,Adapte / Adapte
4007,688,2019,Sociologie,14,2,QCM,85,82,61,21,1.04,74.39,61,24,71.47,Adapte,Adapte,Adapte / Adapte
4837,688,2020,Sociologie,14,2,QCM,70,51,51,0,1.37,100.0,51,19,73.54,Adapte,Adapte,Adapte / Adapte
688,689,2015,Sociologie,14,3,QCU,99,58,24,34,1.71,41.38,24,75,23.8,Trop Difficile,Trop Difficile,Trop Difficile / Trop Difficile
1518,689,2016,Sociologie,14,3,QCU,98,77,34,43,1.27,44.16,34,64,34.98,Difficile,Difficile,Difficile / Difficile
2348,689,2017,Sociologie,14,3,QCU,93,55,23,32,1.69,41.82,23,70,25.25,Difficile,Difficile,Difficile / Difficile
3178,689,2018,Sociologie,14,3,QCU,109,67,42,25,1.63,62.69,42,67,38.99,Difficile,Difficile,Difficile / Difficile
4008,689,2019,Sociologie,14,3,QCU,120,76,0,76,1.58,0.0,0,120,0.4,Difficile,Trop Difficile,Difficile / Trop Difficile
4838,689,2020,Sociologie,14,3,QCU,109,52,28,24,2.1,53.85,28,81,25.98,Difficile,Difficile,Difficile / Difficile
689,690,2015,Sociologie,14,4,QCM,39,35,35,0,1.11,100.0,35,4,89.2,Trop Facile,Trop Facile,Trop Facile / Trop Facile
1519,690,2016,Sociologie,14,4,QCM,45,43,20,23,1.05,46.51,20,25,45.09,Difficile,Difficile,Difficile / Difficile
2349,690,2017,Sociologie,14,4,QCM,46,45,15,30,1.02,33.33,15,31,32.55,Difficile,Difficile,Difficile / Difficile
3179,690,2018,Sociologie,14,4,QCM,55,40,24,16,1.38,60.0,24,31,43.25,Difficile,Difficile,Difficile / Difficile
4009,690,2019,Sociologie,14,4,QCM,64,41,18,23,1.56,43.9,18,46,28.25,Difficile,Difficile,Difficile / Difficile
4839,690,2020,Sociologie,14,4,QCM,74,66,55,11,1.12,83.33,55,19,73.78,Difficile,Adapte,Difficile / Adapte
690,691,2015,Sociologie,14,5,QCM,63,47,44,3,1.34,93.62,44,19,70.6,Difficile,Adapte,Difficile / Adapte
1520,691,2016,Sociologie,14,5,QCM,74,69,49,20,1.07,71.01,49,25,66.68,Adapte,Adapte,Adapte / Adapte
2350,691,2017,Sociologie,14,5,QCM,82,70,59,11,1.17,84.29,59,23,72.09,Adapte,Adapte,Adapte / Adapte
3180,691,2018,Sociologie,14,5,QCM,84,69,58,11,1.22,84.06,58,26,68.92,Adapte,Adapte,Adapte / Adapte
4010,691,2019,Sociologie,14,5,QCM,76,50,50,0,1.52,100.0,50,26,65.55,Adapte,Adapte,Adapte / Adapte
4840,691,2020,Sociologie,14,5,QCM,75,64,45,19,1.17,70.31,45,30,60.34,Adapte,Adapte,Adapte / Adapte
691,692,2015,Sociologie,14,6,QCU,86,74,2,72,1.16,2.7,2,84,2.13,Trop Difficile,Trop Difficile,Trop Difficile / Trop Difficile
1521,692,2016,Sociologie,14,6,QCU,71,60,36,24,1.18,60.0,36,35,50.74,Difficile,Difficile,Difficile / Difficile
2351,692,2017,Sociologie,14,6,QCU,60,37,35,2,1.62,94.59,35,25,58.52,Difficile,Difficile,Difficile / Difficile
3181,692,2018,Sociologie,14,6,QCU,71,61,30,31,1.16,49.18,30,41,41.87,Difficile,Difficile,Difficile / Difficile
4011,692,2019,Sociologie,14,6,QCU,77,41,37,4,1.88,90.24,37,40,48.68,Difficile,Difficile,Difficile / Difficile
4841,692,2020,Sociologie,14,6,QCU,89,36,23,13,2.47,63.89,23,66,25.9,Difficile,Difficile,Difficile / Difficile
692,693,2015,Sociologie,14,7,QROC,91,90,80,10,1.01,88.89,80,11,88.39,Difficile,Trop Facile,Difficile / Trop Facile
1522,693,2016,Sociologie,14,7,QROC,90,85,70,15,1.06,82.35,70,20,77.77,Difficile,Facile,Difficile / Facile
2352,693,2017,Sociologie,14,7,QROC,102,82,44,38,1.24,53.66,44,58,43.27,Difficile,Difficile,Difficile / Difficile
3182,693,2018,Sociologie,14,7,QROC,101,100,61,39,1.01,61.0,61,40,60.86,Difficile,Adapte,Difficile / Adapte
4012,693,2019,Sociologie,14,7,QROC,92,70,65,5,1.31,92.86,65,27,71.11,Adapte,Adapte,Adapte / Adapte
4842,693,2020,Sociologie,14,7,QROC,85,77,63,14,1.1,81.82,63,22,74.33,Adapte,Adapte,Adapte / Adapte
693,694,2015,Sociologie,14,8,QCU,100,83,43,40,1.2,51.81,43,57,42.78,Facile,Difficile,Facile / Difficile
1523,694,2016,Sociologie,14,8,QCU,89,81,80,1,1.1,98.77,80,9,89.34,Difficile,Trop Facile,Difficile / Trop Facile
2353,694,2017,Sociologie,14,8,QCU,82,43,28,15,1.91,65.12,28,54,34.01,Difficile,Difficile,Difficile / Difficile
3183,694,2018,Sociologie,14,8,QCU,97,90,76,14,1.08,84.44,76,21,78.05,Difficile,Facile,Difficile / Facile
4013,694,2019,Sociologie,14,8,QCU,79,56,37,19,1.41,66.07,37,42,46.31,Difficile,Difficile,Difficile / Difficile
4843,694,2020,Sociologie,14,8,QCU,86,85,84,1,1.01,98.82,84,2,98.09,Difficile,Trop Facile,Difficile / Trop Facile
694,695,2015,Sociologie,15,1,QCU,29,16,11,5,1.81,68.75,11,18,37.32,Adapte,Difficile,Adapte / Difficile
1524,695,2016,Sociologie,15,1,QCU,31,23,16,7,1.35,69.57,16,15,50.11,Difficile,Difficile,Difficile / Difficile
2354,695,2017,Sociologie,15,1,QCU,28,28,23,5,1.0,82.14,23,5,82.65,Difficile,Facile,Difficile / Facile
3184,695,2018,Sociologie,15,1,QCU,26,15,8,7,1.73,53.33,8,18,30.25,Difficile,Difficile,Difficile / Difficile
4014,695,2019,Sociologie,15,1,QCU,26,20,10,10,1.3,50.0,10,16,38.35,Difficile,Difficile,Difficile / Difficile
4844,695,2020,Sociologie,15,1,QCU,23,18,8,10,1.28,44.44,8,15,34.65,Difficile,Difficile,Difficile / Difficile
695,696,2015,Sociologie,15,2,QCM,97,52,31,21,1.87,59.62,31,66,32.39,Difficile,Difficile,Difficile / Difficile
1525,696,2016,Sociologie,15,2,QCM,109,76,61,15,1.43,80.26,61,48,56.27,Difficile,Difficile,Difficile / Difficile
2355,696,2017,Sociologie,15,2,QCM,97,92,92,0,1.05,100.0,92,5,95.18,Difficile,Trop Facile,Difficile / Trop Facile
3185,696,2018,Sociologie,15,2,QCM,112,61,6,55,1.84,9.84,6,106,5.59,Difficile,Trop Difficile,Difficile / Trop Difficile
4015,696,2019,Sociologie,15,2,QCM,106,103,56,47,1.03,54.37,56,50,53.24,Difficile,Difficile,Difficile / Difficile
4845,696,2020,Sociologie,15,2,QCM,109,106,80,26,1.03,75.47,80,29,73.21,Difficile,Adapte,Difficile / Adapte
696,697,2015,Sociologie,15,3,QCM,70,61,52,9,1.15,85.25,52,18,73.76,Trop Difficile,Adapte,Trop Difficile / Adapte
1526,697,2016,Sociologie,15,3,QCM,62,50,40,10,1.24,80.0,40,22,65.26,Adapte,Adapte,Adapte / Adapte
2356,697,2017,Sociologie,15,3,QCM,54,36,35,1,1.5,97.22,35,19,64.32,Adapte,Adapte,Adapte / Adapte
3186,697,2018,Sociologie,15,3,QCM,55,48,38,10,1.15,79.17,38,17,68.43,Adapte,Adapte,Adapte / Adapte
4016,697,2019,Sociologie,15,3,QCM,63,50,43,7,1.26,86.0,43,20,68.4,Adapte,Adapte,Adapte / Adapte
4846,697,2020,Sociologie,15,3,QCM,66,49,47,2,1.35,95.92,47,19,70.82,Adapte,Adapte,Adapte / Adapte
697,698,2015,Sociologie,15,4,QCU,84,78,69,9,1.08,88.46,69,15,82.71,Facile,Facile,Facile / Facile
1527,698,2016,Sociologie,15,4,QCU,99,48,30,18,2.06,62.5,30,69,30.0,Difficile,Difficile,Difficile / Difficile
2357,698,2017,Sociologie,15,4,QCU,80,65,27,38,1.23,41.54,27,53,33.34,Difficile,Difficile,Difficile / Difficile
3187,698,2018,Sociologie,15,4,QCU,71,48,28,20,1.48,58.33,28,43,38.93,Difficile,Difficile,Difficile / Difficile
4017,698,2019,Sociologie,15,4,QCU,62,61,59,2,1.02,96.72,59,3,94.89,Difficile,Trop Facile,Difficile / Trop Facile
4847,698,2020,Sociologie,15,4,QCU,68,46,17,29,1.48,36.96,17,51,25.4,Difficile,Difficile,Difficile / Difficile
698,699,2015,Sociologie,16,1,QROC,33,32,31,1,1.03,96.88,31,2,93.44,Trop Difficile,Trop Facile,Trop Difficile / Trop Facile
1528,699,2016,Sociologie,16,1,QROC,38,23,11,12,1.65,47.83,11,27,29.71,Difficile,Difficile,Difficile / Difficile
2358,699,2017,Sociologie,16,1,QROC,42,35,31,4,1.2,88.57,31,11,73.44,Difficile,Adapte,Difficile / Adapte
3188,699,2018,Sociologie,16,1,QROC,42,37,29,8,1.14,78.38,29,13,68.52,Adapte,Adapte,Adapte / Adapte
4018,699,2019,Sociologie,16,1,QROC,39,31,29,2,1.26,93.55,29,10,73.34,Adapte,Adapte,Adapte / Adapte
4848,699,2020,Sociologie,16,1,QROC,34,23,21,2,1.48,91.3,21,13,61.54,Adapte,Adapte,Adapte / Adapte
699,700,2015,Sociologie,16,2,QCU,64,39,21,18,1.64,53.85,21,43,32.67,Difficile,Difficile,Difficile / Difficile
1529,700,2016,Sociologie,16,2,QCU,63,63,62,1,1.0,98.41,62,1,97.8,Difficile,Trop Facile,Difficile / Trop Facile
2359,700,2017,Sociologie,16,2,QCU,70,64,63,1,1.09,98.44,63,7,89.92,Difficile,Trop Facile,Difficile / Trop Facile
3189,700,2018,Sociologie,16,2,QCU,70,48,39,9,1.46,81.25,39,31,56.04,Difficile,Difficile,Difficile / Difficile
4019,700,2019,Sociologie,16,2,QCU,84,78,33,45,1.08,42.31,33,51,38.9,Difficile,Difficile,Difficile / Difficile
4849,700,2020,Sociologie,16,2,QCU,76,68,59,9,1.12,86.76,59,17,77.62,Difficile,Facile,Difficile / Facile
700,701,2015,Sociologie,16,3,QCU,7,6,5,1,1.17,83.33,5,2,76.06,Facile,Facile,Facile / Facile
1530,701,2016,Sociologie,16,3,QCU,6,6,3,3,1.0,50.0,3,3,49.38,Difficile,Difficile,Difficile / Difficile
2360,701,2017,Sociologie,16,3,QCU,5,4,4,0,1.25,100.0,4,1,83.33,Difficile,Facile,Difficile / Facile
3190,701,2018,Sociologie,16,3,QCU,4,2,1,1,2.0,50.0,1,3,33.85,Difficile,Difficile,Difficile / Difficile
4020,701,2019,Sociologie,16,3,QCU,5,2,2,0,2.5,100.0,2,3,47.55,Difficile,Difficile,Difficile / Difficile
4850,701,2020,Sociologie,16,3,QCU,5,4,2,2,1.25,50.0,2,3,37.54,Difficile,Difficile,Difficile / Difficile
701,702,2015,Sociologie,16,4,QCU,85,33,4,29,2.58,12.12,4,81,4.91,Trop Difficile,Trop Difficile,Trop Difficile / Trop Difficile
1531,702,2016,Sociologie,16,4,QCU,94,85,73,12,1.11,85.88,73,21,77.56,Difficile,Facile,Difficile / Facile
2361,702,2017,Sociologie,16,4,QCU,111,61,39,22,1.82,63.93,39,72,34.92,Difficile,Difficile,Difficile / Difficile
3191,702,2018,Sociologie,16,4,QCU,102,88,31,57,1.16,35.23,31,71,30.47,Difficile,Difficile,Difficile / Difficile
4021,702,2019,Sociologie,16,4,QCU,85,84,58,26,1.01,69.05,58,27,68.27,Difficile,Adapte,Difficile / Adapte
4851,702,2020,Sociologie,16,4,QCU,71,52,46,6,1.37,88.46,46,25,64.64,Adapte,Adapte,Adapte / Adapte
702,703,2015,Sociologie,16,5,QROC,98,77,63,14,1.27,81.82,63,35,64.64,Difficile,Adapte,Difficile / Adapte
1532,703,2016,Sociologie,16,5,QROC,95,78,67,11,1.22,85.9,67,28,70.43,Adapte,Adapte,Adapte / Adapte
2362,703,2017,Sociologie,16,5,QROC,86,74,53,21,1.16,71.62,53,33,62.0,Adapte,Adapte,Adapte / Adapte
3192,703,2018,Sociologie,16,5,QROC,97,79,63,16,1.23,79.75,63,34,65.17,Adapte,Adapte,Adapte / Adapte
4022,703,2019,Sociologie,16,5,QROC,97,79,67,12,1.23,84.81,67,30,69.39,Adapte,Adapte,Adapte / Adapte
4852,703,2020,Sociologie,16,5,QROC,98,95,65,30,1.03,68.42,65,33,66.26,Adapte,Adapte,Adapte / Adapte
703,704,2015,Sociologie,16,6,QCU,59,48,26,22,1.23,54.17,26,33,43.44,Difficile,Difficile,Difficile / Difficile
1533,704,2016,Sociologie,16,6,QCU,52,46,29,17,1.13,63.04,29,23,54.88,Difficile,Difficile,Difficile / Difficile
2363,704,2017,Sociologie,16,6,QCU,44,42,18,24,1.05,42.86,18,26,40.54,Difficile,Difficile,Difficile / Difficile
3193,704,2018,Sociologie,16,6,QCU,45,35,21,14,1.29,60.0,21,24,46.61,Difficile,Difficile,Difficile / Difficile
4023,704,2019,Sociologie,16,6,QCU,46,33,31,2,1.39,93.94,31,15,67.37,Difficile,Adapte,Difficile / Adapte
4853,704,2020,Sociologie,16,6,QCU,46,42,33,9,1.1,78.57,33,13,71.09,Adapte,Adapte,Adapte / Adapte
704,705,2015,Sociologie,16,7,QROC,85,48,36,12,1.77,75.0,36,49,42.47,Difficile,Difficile,Difficile / Difficile
1534,705,2016,Sociologie,16,7,QROC,81,59,45,14,1.37,76.27,45,36,55.6,Difficile,Difficile,Difficile / Difficile
2364,705,2017,Sociologie,16,7,QROC,73,68,42,26,1.07,61.76,42,31,57.37,Difficile,Difficile,Difficile / Difficile
3194,705,2018,Sociologie,16,7,QROC,87,58,56,2,1.5,96.55,56,31,64.23,Difficile,Adapte,Difficile / Adapte
4024,705,2019,Sociologie,16,7,QROC,99,91,66,25,1.09,72.53,66,33,67.02,Adapte,Adapte,Adapte / Adapte
4854,705,2020,Sociologie,16,7,QROC,94,87,68,19,1.08,78.16,68,26,72.79,Adapte,Adapte,Adapte / Adapte
705,706,2015,Sociologie,17,1,QCU,23,22,18,4,1.05,81.82,18,5,78.98,Facile,Facile,Facile / Facile
1535,706,2016,Sociologie,17,1,QCU,26,10,8,2,2.6,80.0,8,18,31.44,Difficile,Difficile,Difficile / Difficile
2365,706,2017,Sociologie,17,1,QCU,23,23,22,1,1.0,95.65,22,1,96.17,Difficile,Trop Facile,Difficile / Trop Facile
3195,706,2018,Sociologie,17,1,QCU,28,17,2,15,1.65,11.76,2,26,6.25,Difficile,Trop Difficile,Difficile / Trop Difficile
4025,706,2019,Sociologie,17,1,QCU,32,30,13,17,1.07,43.33,13,19,40.59,Difficile,Difficile,Difficile / Difficile
4855,706,2020,Sociologie,17,1,QCU,36,31,21,10,1.16,67.74,21,15,57.8,Difficile,Difficile,Difficile / Difficile
706,707,2015,Sociologie,17,2,QROC,87,62,62,0,1.4,100.0,62,25,71.07,Adapte,Adapte,Adapte / Adapte
1536,707,2016,Sociologie,17,2,QROC,86,82,64,18,1.05,78.05,64,22,74.54,Adapte,Adapte,Adapte / Adapte
2366,707,2017,Sociologie,17,2,QROC,86,66,56,10,1.3,84.85,56,30,64.95,Adapte,Adapte,Adapte / Adapte
3196,707,2018,Sociologie,17,2,QROC,80,72,53,19,1.11,73.61,53,27,66.21,Adapte,Adapte,Adapte / Adapte
4026,707,2019,Sociologie,17,2,QROC,95,78,65,13,1.22,83.33,65,30,68.67,Adapte,Adapte,Adapte / Adapte
4856,707,2020,Sociologie,17,2,QROC,105,92,67,25,1.14,72.83,67,38,63.83,Adapte,Adapte,Adapte / Adapte
707,708,2015,Sociologie,18,1,QCM,51,48,40,8,1.06,83.33,40,11,78.62,Facile,Facile,Facile / Facile
1537,708,2016,Sociologie,18,1,QCM,50,41,39,2,1.22,95.12,39,11,77.8,Difficile,Facile,Difficile / Facile
2367,708,2017,Sociologie,18,1,QCM,43,17,8,9,2.53,47.06,8,35,19.52,Difficile,Trop Difficile,Difficile / Trop Difficile
3197,708,2018,Sociologie,18,1,QCM,36,16,10,6,2.25,62.5,10,26,28.54,Difficile,Difficile,Difficile / Difficile
4027,708,2019,Sociologie,18,1,QCM,40,27,17,10,1.48,62.96,17,23,43.23,Difficile,Difficile,Difficile / Difficile
4857,708,2020,Sociologie,18,1,QCM,45,14,11,3,3.21,78.57,11,34,25.54,Difficile,Difficile,Difficile / Difficile
708,709,2015,Sociologie,18,2,QCM,30,27,25,2,1.11,92.59,25,5,84.25,Facile,Facile,Facile / Facile
1538,709,2016,Sociologie,18,2,QCM,28,24,0,24,1.17,0.0,0,28,0.94,Difficile,Trop Difficile,Difficile / Trop Difficile
2368,709,2017,Sociologie,18,2,QCM,29,20,17,3,1.45,85.0,17,12,58.11,Difficile,Difficile,Difficile / Difficile
3198,709,2018,Sociologie,18,2,QCM,26,23,15,8,1.13,65.22,15,11,57.31,Difficile,Difficile,Difficile / Difficile
4028,709,2019,Sociologie,18,2,QCM,24,20,17,3,1.2,85.0,17,7,71.22,Difficile,Adapte,Difficile / Adapte
4858,709,2020,Sociologie,18,2,QCM,25,23,18,5,1.09,78.26,18,7,73.24,Adapte,Adapte,Adapte / Adapte
709,710,2015,Mathématique,1,1,QCU,11,6,4,2,1.83,66.67,4,7,38.18,Difficile,Difficile,Difficile / Difficile
1539,710,2016,Mathématique,1,1,QCU,10,9,5,4,1.11,55.56,5,5,47.78,Difficile,Difficile,Difficile / Difficile
2369,710,2017,Mathématique,1,1,QCU,11,8,5,3,1.38,62.5,5,6,45.7,Difficile,Difficile,Difficile / Difficile
3199,710,2018,Mathématique,1,1,QCU,12,10,9,1,1.2,90.0,9,3,77.07,Difficile,Facile,Difficile / Facile
4029,710,2019,Mathématique,1,1,QCU,10,8,5,3,1.25,62.5,5,5,54.53,Difficile,Difficile,Difficile / Difficile
4859,710,2020,Mathématique,1,1,QCU,11,11,4,7,1.0,36.36,4,7,34.17,Difficile,Difficile,Difficile / Difficile
710,711,2015,Mathématique,1,2,QCU,46,25,5,20,1.84,20.0,5,41,11.1,Trop Difficile,Trop Difficile,Trop Difficile / Trop Difficile
1540,711,2016,Mathématique,1,2,QCU,38,35,34,1,1.09,97.14,34,4,88.92,Difficile,Trop Facile,Difficile / Trop Facile
2370,711,2017,Mathématique,1,2,QCU,41,30,20,10,1.37,66.67,20,21,48.51,Difficile,Difficile,Difficile / Difficile
3200,711,2018,Mathématique,1,2,QCU,43,37,2,35,1.16,5.41,2,41,5.61,Difficile,Trop Difficile,Difficile / Trop Difficile
4030,711,2019,Mathématique,1,2,QCU,46,27,18,9,1.7,66.67,18,28,39.74,Difficile,Difficile,Difficile / Difficile
4860,711,2020,Mathématique,1,2,QCU,50,25,23,2,2.0,92.0,23,27,46.63,Difficile,Difficile,Difficile / Difficile
711,712,2015,Mathématique,1,3,QCM,15,15,14,1,1.0,93.33,14,1,96.28,Facile,Trop Facile,Facile / Trop Facile
1541,712,2016,Mathématique,1,3,QCM,17,12,9,3,1.42,75.0,9,8,50.23,Difficile,Difficile,Difficile / Difficile
2371,712,2017,Mathématique,1,3,QCM,16,14,12,2,1.14,85.71,12,4,77.79,Difficile,Facile,Difficile / Facile
3201,712,2018,Mathématique,1,3,QCM,16,14,11,3,1.14,78.57,11,5,67.68,Difficile,Adapte,Difficile / Adapte
4031,712,2019,Mathématique,1,3,QCM,16,13,11,2,1.23,84.62,11,5,68.37,Adapte,Adapte,Adapte / Adapte
4861,712,2020,Mathématique,1,3,QCM,15,13,10,3,1.15,76.92,10,5,66.02,Adapte,Adapte,Adapte / Adapte
712,713,2015,Mathématique,1,4,QCU,9,8,7,1,1.12,87.5,7,2,82.6,Trop Difficile,Facile,Trop Difficile / Facile
1542,713,2016,Mathématique,1,4,QCU,10,7,5,2,1.43,71.43,5,5,47.05,Difficile,Difficile,Difficile / Difficile
2372,713,2017,Mathématique,1,4,QCU,11,11,9,2,1.0,81.82,9,2,77.74,Difficile,Facile,Difficile / Facile
3202,713,2018,Mathématique,1,4,QCU,10,5,4,1,2.0,80.0,4,6,39.84,Difficile,Difficile,Difficile / Difficile
4032,713,2019,Mathématique,1,4,QCU,9,7,5,2,1.29,71.43,5,4,58.63,Difficile,Difficile,Difficile / Difficile
4862,713,2020,Mathématique,1,4,QCU,10,9,1,8,1.11,11.11,1,9,7.19,Difficile,Trop Difficile,Difficile / Trop Difficile
713,714,2015,Mathématique,1,5,QCM,84,73,8,65,1.15,10.96,8,76,9.26,Difficile,Trop Difficile,Difficile / Trop Difficile
1543,714,2016,Mathématique,1,5,QCM,68,54,35,19,1.26,64.81,35,33,50.84,Difficile,Difficile,Difficile / Difficile
2373,714,2017,Mathématique,1,5,QCM,76,65,6,59,1.17,9.23,6,70,8.5,Difficile,Trop Difficile,Difficile / Trop Difficile
3203,714,2018,Mathématique,1,5,QCM,81,71,35,36,1.14,49.3,35,46,43.44,Difficile,Difficile,Difficile / Difficile
4033,714,2019,Mathématique,1,5,QCM,80,73,70,3,1.1,95.89,70,10,88.03,Difficile,Trop Facile,Difficile / Trop Facile
4863,714,2020,Mathématique,1,5,QCM,94,84,53,31,1.12,63.1,53,41,56.34,Difficile,Difficile,Difficile / Difficile
714,715,2015,Mathématique,1,6,QCM,94,70,63,7,1.34,90.0,63,31,66.64,Difficile,Adapte,Difficile / Adapte
1544,715,2016,Mathématique,1,6,QCM,96,86,72,14,1.12,83.72,72,24,74.49,Adapte,Adapte,Adapte / Adapte
2374,715,2017,Mathématique,1,6,QCM,89,89,58,31,1.0,65.17,58,31,65.1,Adapte,Adapte,Adapte / Adapte
3204,715,2018,Mathématique,1,6,QCM,107,87,64,23,1.23,73.56,64,43,60.07,Adapte,Adapte,Adapte / Adapte
4034,715,2019,Mathématique,1,6,QCM,87,69,64,5,1.26,92.75,64,23,73.34,Adapte,Adapte,Adapte / Adapte
4864,715,2020,Mathématique,1,6,QCM,75,50,46,4,1.5,92.0,46,29,61.25,Adapte,Adapte,Adapte / Adapte
715,716,2015,Mathématique,1,7,QCM,83,70,37,33,1.19,52.86,37,46,44.29,Difficile,Difficile,Difficile / Difficile
1545,716,2016,Mathématique,1,7,QCM,68,36,18,18,1.89,50.0,18,50,25.77,Difficile,Difficile,Difficile / Difficile
2375,716,2017,Mathématique,1,7,QCM,81,51,18,33,1.59,35.29,18,63,22.58,Difficile,Trop Difficile,Difficile / Trop Difficile
3205,716,2018,Mathématique,1,7,QCM,83,82,23,59,1.01,28.05,23,60,27.5,Difficile,Difficile,Difficile / Difficile
4035,716,2019,Mathématique,1,7,QCM,68,59,52,7,1.15,88.14,52,16,76.52,Difficile,Facile,Difficile / Facile
4865,716,2020,Mathématique,1,7,QCM,66,56,46,10,1.18,82.14,46,20,69.63,Difficile,Adapte,Difficile / Adapte
716,717,2015,Mathématique,1,8,QROC,64,60,53,7,1.07,88.33,53,11,82.72,Trop Difficile,Facile,Trop Difficile / Facile
1546,717,2016,Mathématique,1,8,QROC,55,50,43,7,1.1,86.0,43,12,78.82,Difficile,Facile,Difficile / Facile
2376,717,2017,Mathématique,1,8,QROC,47,32,25,7,1.47,78.12,25,22,54.23,Difficile,Difficile,Difficile / Difficile
3206,717,2018,Mathématique,1,8,QROC,44,34,30,4,1.29,88.24,30,14,67.67,Difficile,Adapte,Difficile / Adapte
4036,717,2019,Mathématique,1,8,QROC,52,31,31,0,1.68,100.0,31,21,60.12,Adapte,Adapte,Adapte / Adapte
4866,717,2020,Mathématique,1,8,QROC,45,35,28,7,1.29,80.0,28,17,62.18,Adapte,Adapte,Adapte / Adapte
717,718,2015,Mathématique,1,9,QCM,64,62,60,2,1.03,96.77,60,4,93.25,Facile,Trop Facile,Facile / Trop Facile
1547,718,2016,Mathématique,1,9,QCM,76,37,8,29,2.05,21.62,8,68,10.49,Difficile,Trop Difficile,Difficile / Trop Difficile
2377,718,2017,Mathématique,1,9,QCM,74,73,69,4,1.01,94.52,69,5,92.58,Difficile,Trop Facile,Difficile / Trop Facile
3207,718,2018,Mathématique,1,9,QCM,66,66,62,4,1.0,93.94,62,4,93.44,Difficile,Trop Facile,Difficile / Trop Facile
4037,718,2019,Mathématique,1,9,QCM,62,46,35,11,1.35,76.09,35,27,57.19,Difficile,Difficile,Difficile / Difficile
4867,718,2020,Mathématique,1,9,QCM,69,63,11,52,1.1,17.46,11,58,15.67,Difficile,Trop Difficile,Difficile / Trop Difficile
718,719,2015,Mathématique,2,1,QCU,14,12,11,1,1.17,91.67,11,3,76.69,Facile,Facile,Facile / Facile
1548,719,2016,Mathématique,2,1,QCU,12,7,5,2,1.71,71.43,5,7,42.93,Difficile,Difficile,Difficile / Difficile
2378,719,2017,Mathématique,2,1,QCU,11,10,6,4,1.1,60.0,6,5,57.24,Difficile,Difficile,Difficile / Difficile
3208,719,2018,Mathématique,2,1,QCU,9,6,3,3,1.5,50.0,3,6,33.92,Difficile,Difficile,Difficile / Difficile
4038,719,2019,Mathématique,2,1,QCU,7,4,2,2,1.75,50.0,2,5,28.1,Difficile,Difficile,Difficile / Difficile
4868,719,2020,Mathématique,2,1,QCU,7,3,2,1,2.33,66.67,2,5,29.96,Difficile,Difficile,Difficile / Difficile
719,720,2015,Mathématique,2,2,QCU,89,81,73,8,1.1,90.12,73,16,81.79,Facile,Facile,Facile / Facile
1549,720,2016,Mathématique,2,2,QCU,89,68,41,27,1.31,60.29,41,48,46.34,Difficile,Difficile,Difficile / Difficile
2379,720,2017,Mathématique,2,2,QCU,73,67,53,14,1.09,79.1,53,20,72.14,Difficile,Adapte,Difficile / Adapte
3209,720,2018,Mathématique,2,2,QCU,71,57,51,6,1.25,89.47,51,20,71.57,Adapte,Adapte,Adapte / Adapte
4039,720,2019,Mathématique,2,2,QCU,84,74,61,13,1.14,82.43,61,23,73.11,Adapte,Adapte,Adapte / Adapte
4869,720,2020,Mathématique,2,2,QCU,98,87,66,21,1.13,75.86,66,32,67.2,Adapte,Adapte,Adapte / Adapte
720,721,2015,Mathématique,2,3,QCU,76,58,12,46,1.31,20.69,12,64,15.6,Trop Difficile,Trop Difficile,Trop Difficile / Trop Difficile
1550,721,2016,Mathématique,2,3,QCU,74,65,63,2,1.14,96.92,63,11,84.84,Difficile,Facile,Difficile / Facile
2380,721,2017,Mathématique,2,3,QCU,86,53,15,38,1.62,28.3,15,71,17.69,Difficile,Trop Difficile,Difficile / Trop Difficile
3210,721,2018,Mathématique,2,3,QCU,100,98,42,56,1.02,42.86,42,58,41.9,Difficile,Difficile,Difficile / Difficile
4040,721,2019,Mathématique,2,3,QCU,86,77,73,4,1.12,94.81,73,13,84.49,Difficile,Facile,Difficile / Facile
4870,721,2020,Mathématique,2,3,QCU,69,40,39,1,1.73,97.5,39,30,56.86,Difficile,Difficile,Difficile / Difficile
721,722,2015,Mathématique,2,4,QCU,45,41,39,2,1.1,95.12,39,6,86.45,Trop Facile,Trop Facile,Trop Facile / Trop Facile
1551,722,2016,Mathématique,2,4,QCU,46,22,11,11,2.09,50.0,11,35,23.98,Difficile,Trop Difficile,Difficile / Trop Difficile
2381,722,2017,Mathématique,2,4,QCU,38,27,22,5,1.41,81.48,22,16,57.31,Difficile,Difficile,Difficile / Difficile
3211,722,2018,Mathématique,2,4,QCU,40,31,15,16,1.29,48.39,15,25,38.09,Difficile,Difficile,Difficile / Difficile
4041,722,2019,Mathématique,2,4,QCU,36,17,11,6,2.12,64.71,11,25,29.94,Difficile,Difficile,Difficile / Difficile
4871,722,2020,Mathématique,2,4,QCU,33,31,16,15,1.06,51.61,16,17,47.58,Difficile,Difficile,Difficile / Difficile
722,723,2015,Mathématique,2,5,QCU,58,51,50,1,1.14,98.04,50,8,86.65,Trop Facile,Trop Facile,Trop Facile / Trop Facile
1552,723,2016,Mathématique,2,5,QCU,62,41,34,7,1.51,82.93,34,28,54.4,Difficile,Difficile,Difficile / Difficile
2382,723,2017,Mathématique,2,5,QCU,53,35,27,8,1.51,77.14,27,26,50.6,Difficile,Difficile,Difficile / Difficile
3212,723,2018,Mathématique,2,5,QCU,48,31,28,3,1.55,90.32,28,20,58.83,Difficile,Difficile,Difficile / Difficile
4042,723,2019,Mathématique,2,5,QCU,45,43,20,23,1.05,46.51,20,25,43.93,Difficile,Difficile,Difficile / Difficile
4872,723,2020,Mathématique,2,5,QCU,38,27,21,6,1.41,77.78,21,17,54.12,Difficile,Difficile,Difficile / Difficile
723,724,2015,Mathématique,2,6,QROC,96,49,35,14,1.96,71.43,35,61,36.35,Difficile,Difficile,Difficile / Difficile
1553,724,2016,Mathématique,2,6,QROC,78,76,76,0,1.03,100.0,76,2,97.92,Difficile,Trop Facile,Difficile / Trop Facile
2383,724,2017,Mathématique,2,6,QROC,87,49,36,13,1.78,73.47,36,51,41.44,Difficile,Difficile,Difficile / Difficile
3213,724,2018,Mathématique,2,6,QROC,81,52,38,14,1.56,73.08,38,43,46.88,Difficile,Difficile,Difficile / Difficile
4043,724,2019,Mathématique,2,6,QROC,67,27,27,0,2.48,100.0,27,40,41.04,Difficile,Difficile,Difficile / Difficile
4873,724,2020,Mathématique,2,6,QROC,63,49,35,14,1.29,71.43,35,28,55.58,Difficile,Difficile,Difficile / Difficile
724,725,2015,Mathématique,2,7,QCU,98,72,63,9,1.36,87.5,63,35,64.12,Adapte,Adapte,Adapte / Adapte
1554,725,2016,Mathématique,2,7,QCU,112,90,74,16,1.24,82.22,74,38,65.84,Adapte,Adapte,Adapte / Adapte
2384,725,2017,Mathématique,2,7,QCU,90,88,60,28,1.02,68.18,60,30,67.06,Adapte,Adapte,Adapte / Adapte
3214,725,2018,Mathématique,2,7,QCU,75,64,48,16,1.17,75.0,48,27,64.32,Adapte,Adapte,Adapte / Adapte
4044,725,2019,Mathématique,2,7,QCU,71,62,53,9,1.15,85.48,53,18,74.03,Adapte,Adapte,Adapte / Adapte
4874,725,2020,Mathématique,2,7,QCU,58,49,43,6,1.18,87.76,43,15,73.79,Adapte,Adapte,Adapte / Adapte
725,726,2015,Mathématique,2,8,QCM,28,27,22,5,1.04,81.48,22,6,78.15,Facile,Facile,Facile / Facile
1555,726,2016,Mathématique,2,8,QCM,22,20,17,3,1.1,85.0,17,5,77.24,Difficile,Facile,Difficile / Facile
2385,726,2017,Mathématique,2,8,QCM,24,15,11,4,1.6,73.33,11,13,45.19,Difficile,Difficile,Difficile / Difficile
3215,726,2018,Mathématique,2,8,QCM,24,24,23,1,1.0,95.83,23,1,94.9,Difficile,Trop Facile,Difficile / Trop Facile
4045,726,2019,Mathématique,2,8,QCM,19,18,3,15,1.06,16.67,3,16,13.7,Difficile,Trop Difficile,Difficile / Trop Difficile
4875,726,2020,Mathématique,2,8,QCM,23,21,20,1,1.1,95.24,20,3,84.81,Difficile,Facile,Difficile / Facile
726,727,2015,Mathématique,2,9,QCU,61,56,55,1,1.09,98.21,55,6,90.3,Trop Facile,Trop Facile,Trop Facile / Trop Facile
1556,727,2016,Mathématique,2,9,QCU,60,43,35,8,1.4,81.4,35,25,58.74,Difficile,Difficile,Difficile / Difficile
2386,727,2017,Mathématique,2,9,QCU,72,60,23,37,1.2,38.33,23,49,32.6,Difficile,Difficile,Difficile / Difficile
3216,727,2018,Mathématique,2,9,QCU,80,79,9,70,1.01,11.39,9,71,10.83,Difficile,Trop Difficile,Difficile / Trop Difficile
4046,727,2019,Mathématique,2,9,QCU,91,62,47,15,1.47,75.81,47,44,51.45,Difficile,Difficile,Difficile / Difficile
4876,727,2020,Mathématique,2,9,QCU,107,84,34,50,1.27,40.48,34,73,32.16,Difficile,Difficile,Difficile / Difficile
727,728,2015,Mathématique,3,1,QCM,33,28,27,1,1.18,96.43,27,6,83.12,Trop Facile,Facile,Trop Facile / Facile
1557,728,2016,Mathématique,3,1,QCM,39,39,39,0,1.0,100.0,39,0,98.95,Difficile,Trop Facile,Difficile / Trop Facile
2387,728,2017,Mathématique,3,1,QCM,34,31,18,13,1.1,58.06,18,16,51.67,Difficile,Difficile,Difficile / Difficile
3217,728,2018,Mathématique,3,1,QCM,36,35,27,8,1.03,77.14,27,9,76.04,Difficile,Facile,Difficile / Facile
4047,728,2019,Mathématique,3,1,QCM,41,39,37,2,1.05,94.87,37,4,89.98,Difficile,Trop Facile,Difficile / Trop Facile
4877,728,2020,Mathématique,3,1,QCM,46,37,23,14,1.24,62.16,23,23,49.32,Difficile,Difficile,Difficile / Difficile
728,729,2015,Mathématique,3,2,QCM,40,27,22,5,1.48,81.48,22,18,53.91,Difficile,Difficile,Difficile / Difficile
1558,729,2016,Mathématique,3,2,QCM,40,23,22,1,1.74,95.65,22,18,55.21,Difficile,Difficile,Difficile / Difficile
2388,729,2017,Mathématique,3,2,QCM,39,29,15,14,1.34,51.72,15,24,39.29,Difficile,Difficile,Difficile / Difficile
3218,729,2018,Mathématique,3,2,QCM,34,18,13,5,1.89,72.22,13,21,37.34,Difficile,Difficile,Difficile / Difficile
4048,729,2019,Mathématique,3,2,QCM,31,23,9,14,1.35,39.13,9,22,28.89,Difficile,Difficile,Difficile / Difficile
4878,729,2020,Mathématique,3,2,QCM,30,28,27,1,1.07,96.43,27,3,91.11,Difficile,Trop Facile,Difficile / Trop Facile
729,730,2015,Mathématique,3,3,QROC,64,62,60,2,1.03,96.77,60,4,93.14,Facile,Trop Facile,Facile / Trop Facile
1559,730,2016,Mathématique,3,3,QROC,52,52,42,10,1.0,80.77,42,10,81.67,Difficile,Facile,Difficile / Facile
2389,730,2017,Mathématique,3,3,QROC,46,45,45,0,1.02,100.0,45,1,96.74,Difficile,Trop Facile,Difficile / Trop Facile
3219,730,2018,Mathématique,3,3,QROC,53,49,25,24,1.08,51.02,25,28,46.75,Difficile,Difficile,Difficile / Difficile
4049,730,2019,Mathématique,3,3,QROC,54,46,24,22,1.17,52.17,24,30,44.43,Difficile,Difficile,Difficile / Difficile
4879,730,2020,Mathématique,3,3,QROC,45,45,44,1,1.0,97.78,44,1,97.14,Difficile,Trop Facile,Difficile / Trop Facile
730,731,2015,Mathématique,3,4,QCU,79,73,62,11,1.08,84.93,62,17,79.01,Facile,Facile,Facile / Facile
1560,731,2016,Mathématique,3,4,QCU,86,77,24,53,1.12,31.17,24,62,28.14,Difficile,Difficile,Difficile / Difficile
2390,731,2017,Mathématique,3,4,QCU,85,71,25,46,1.2,35.21,25,60,29.45,Difficile,Difficile,Difficile / Difficile
3220,731,2018,Mathématique,3,4,QCU,74,42,39,3,1.76,92.86,39,35,52.48,Difficile,Difficile,Difficile / Difficile
4050,731,2019,Mathématique,3,4,QCU,59,30,24,6,1.97,80.0,24,35,39.98,Difficile,Difficile,Difficile / Difficile
4880,731,2020,Mathématique,3,4,QCU,71,57,39,18,1.25,68.42,39,32,54.48,Difficile,Difficile,Difficile / Difficile
731,732,2015,Mathématique,3,5,QCU,90,52,19,33,1.73,36.54,19,71,20.97,Trop Difficile,Trop Difficile,Trop Difficile / Trop Difficile
1561,732,2016,Mathématique,3,5,QCU,108,74,48,26,1.46,64.86,48,60,44.25,Difficile,Difficile,Difficile / Difficile
2391,732,2017,Mathématique,3,5,QCU,95,88,85,3,1.08,96.59,85,10,89.78,Difficile,Trop Facile,Difficile / Trop Facile
3221,732,2018,Mathématique,3,5,QCU,108,91,49,42,1.19,53.85,49,59,45.83,Difficile,Difficile,Difficile / Difficile
4051,732,2019,Mathématique,3,5,QCU,116,109,59,50,1.06,54.13,59,57,50.92,Difficile,Difficile,Difficile / Difficile
4881,732,2020,Mathématique,3,5,QCU,125,109,67,42,1.15,61.47,67,58,53.43,Difficile,Difficile,Difficile / Difficile
732,733,2015,Mathématique,3,6,QCM,27,11,1,10,2.45,9.09,1,26,4.06,Trop Difficile,Trop Difficile,Trop Difficile / Trop Difficile
1562,733,2016,Mathématique,3,6,QCM,31,29,13,16,1.07,44.83,13,18,43.18,Difficile,Difficile,Difficile / Difficile
2392,733,2017,Mathématique,3,6,QCM,37,29,11,18,1.28,37.93,11,26,29.58,Difficile,Difficile,Difficile / Difficile
3222,733,2018,Mathématique,3,6,QCM,30,26,25,1,1.15,96.15,25,5,82.47,Difficile,Facile,Difficile / Facile
4052,733,2019,Mathématique,3,6,QCM,27,27,25,2,1.0,92.59,25,2,92.21,Difficile,Trop Facile,Difficile / Trop Facile
4882,733,2020,Mathématique,3,6,QCM,24,20,11,9,1.2,55.0,11,13,46.93,Difficile,Difficile,Difficile / Difficile
733,734,2015,Mathématique,3,7,QCU,57,52,50,2,1.1,96.15,50,7,88.12,Trop Facile,Trop Facile,Trop Facile / Trop Facile
1563,734,2016,Mathématique,3,7,QCU,58,49,26,23,1.18,53.06,26,32,44.42,Difficile,Difficile,Difficile / Difficile
2393,734,2017,Mathématique,3,7,QCU,48,27,12,15,1.78,44.44,12,36,25.09,Difficile,Difficile,Difficile / Difficile
3223,734,2018,Mathématique,3,7,QCU,58,48,31,17,1.21,64.58,31,27,52.63,Difficile,Difficile,Difficile / Difficile
4053,734,2019,Mathématique,3,7,QCU,67,52,49,3,1.29,94.23,49,18,73.7,Difficile,Adapte,Difficile / Adapte
4883,734,2020,Mathématique,3,7,QCU,69,54,45,9,1.28,83.33,45,24,64.85,Adapte,Adapte,Adapte / Adapte
734,735,2015,Mathématique,4,1,QCM,83,70,7,63,1.19,10.0,7,76,8.95,Trop Difficile,Trop Difficile,Trop Difficile / Trop Difficile
1564,735,2016,Mathématique,4,1,QCM,71,51,18,33,1.39,35.29,18,53,25.64,Difficile,Difficile,Difficile / Difficile
2394,735,2017,Mathématique,4,1,QCM,80,65,55,10,1.23,84.62,55,25,68.61,Difficile,Adapte,Difficile / Adapte
3224,735,2018,Mathématique,4,1,QCM,84,72,52,20,1.17,72.22,52,32,61.52,Adapte,Adapte,Adapte / Adapte
4054,735,2019,Mathématique,4,1,QCM,77,69,53,16,1.12,76.81,53,24,68.29,Adapte,Adapte,Adapte / Adapte
4884,735,2020,Mathématique,4,1,QCM,86,67,52,15,1.28,77.61,52,34,60.38,Adapte,Adapte,Adapte / Adapte
735,736,2015,Mathématique,4,2,QCU,73,43,29,14,1.7,67.44,29,44,40.38,Trop Difficile,Difficile,Trop Difficile / Difficile
1565,736,2016,Mathématique,4,2,QCU,88,69,50,19,1.28,72.46,50,38,57.02,Difficile,Difficile,Difficile / Difficile
2395,736,2017,Mathématique,4,2,QCU,79,70,66,4,1.13,94.29,66,13,83.64,Difficile,Facile,Difficile / Facile
3225,736,2018,Mathématique,4,2,QCU,67,37,31,6,1.81,83.78,31,36,46.28,Difficile,Difficile,Difficile / Difficile
4055,736,2019,Mathématique,4,2,QCU,57,51,31,20,1.12,60.78,31,26,53.7,Difficile,Difficile,Difficile / Difficile
4885,736,2020,Mathématique,4,2,QCU,64,64,53,11,1.0,82.81,53,11,83.09,Difficile,Facile,Difficile / Facile
736,737,2015,Mathématique,4,3,QCM,51,45,23,22,1.13,51.11,23,28,44.39,Difficile,Difficile,Difficile / Difficile
1566,737,2016,Mathématique,4,3,QCM,49,48,32,16,1.02,66.67,32,17,64.89,Difficile,Adapte,Difficile / Adapte
2396,737,2017,Mathématique,4,3,QCM,59,49,40,9,1.2,81.63,40,19,67.14,Adapte,Adapte,Adapte / Adapte
3226,737,2018,Mathématique,4,3,QCM,59,52,41,11,1.13,78.85,41,18,68.88,Adapte,Adapte,Adapte / Adapte
4056,737,2019,Mathématique,4,3,QCM,65,45,40,5,1.44,88.89,40,25,60.93,Adapte,Adapte,Adapte / Adapte
4886,737,2020,Mathématique,4,3,QCM,64,50,40,10,1.28,80.0,40,24,63.14,Adapte,Adapte,Adapte / Adapte
737,738,2015,Mathématique,4,4,QCU,54,24,15,9,2.25,62.5,15,39,28.31,Difficile,Difficile,Difficile / Difficile
1567,738,2016,Mathématique,4,4,QCU,54,43,25,18,1.26,58.14,25,29,45.57,Difficile,Difficile,Difficile / Difficile
2397,738,2017,Mathématique,4,4,QCU,46,32,15,17,1.44,46.88,15,31,33.29,Difficile,Difficile,Difficile / Difficile
3227,738,2018,Mathématique,4,4,QCU,54,32,30,2,1.69,93.75,30,24,56.39,Difficile,Difficile,Difficile / Difficile
4057,738,2019,Mathématique,4,4,QCU,55,55,29,26,1.0,52.73,29,26,52.42,Difficile,Difficile,Difficile / Difficile
4887,738,2020,Mathématique,4,4,QCU,52,28,24,4,1.86,85.71,24,28,46.06,Difficile,Difficile,Difficile / Difficile
738,739,2015,Mathématique,4,5,QCM,9,8,8,0,1.12,100.0,8,1,84.15,Difficile,Facile,Difficile / Facile
1568,739,2016,Mathématique,4,5,QCM,10,10,8,2,1.0,80.0,8,2,77.64,Difficile,Facile,Difficile / Facile
2398,739,2017,Mathématique,4,5,QCM,12,9,7,2,1.33,77.78,7,5,54.51,Difficile,Difficile,Difficile / Difficile
3228,739,2018,Mathématique,4,5,QCM,12,10,8,2,1.2,80.0,8,4,69.27,Difficile,Adapte,Difficile / Adapte
4058,739,2019,Mathématique,4,5,QCM,13,13,9,4,1.0,69.23,9,4,69.52,Adapte,Adapte,Adapte / Adapte
4888,739,2020,Mathématique,4,5,QCM,11,8,8,0,1.38,100.0,8,3,72.72,Adapte,Adapte,Adapte / Adapte
739,740,2015,Mathématique,4,6,QCU,41,35,34,1,1.17,97.14,34,7,82.09,Facile,Facile,Facile / Facile
1569,740,2016,Mathématique,4,6,QCU,48,34,20,14,1.41,58.82,20,28,41.5,Difficile,Difficile,Difficile / Difficile
2399,740,2017,Mathématique,4,6,QCU,45,32,21,11,1.41,65.62,21,24,46.57,Difficile,Difficile,Difficile / Difficile
3229,740,2018,Mathématique,4,6,QCU,54,51,31,20,1.06,60.78,31,23,58.16,Difficile,Difficile,Difficile / Difficile
4059,740,2019,Mathématique,4,6,QCU,46,45,41,4,1.02,91.11,41,5,89.88,Difficile,Trop Facile,Difficile / Trop Facile
4889,740,2020,Mathématique,4,6,QCU,37,21,11,10,1.76,52.38,11,26,29.53,Difficile,Difficile,Difficile / Difficile
740,741,2015,Mathématique,4,7,QCU,63,53,52,1,1.19,98.11,52,11,83.26,Facile,Facile,Facile / Facile
1570,741,2016,Mathématique,4,7,QCU,71,50,41,9,1.42,82.0,41,30,57.74,Difficile,Difficile,Difficile / Difficile
2400,741,2017,Mathématique,4,7,QCU,75,69,39,30,1.09,56.52,39,36,52.42,Difficile,Difficile,Difficile / Difficile
3230,741,2018,Mathématique,4,7,QCU,89,81,31,50,1.1,38.27,31,58,34.42,Difficile,Difficile,Difficile / Difficile
4060,741,2019,Mathématique,4,7,QCU,91,91,91,0,1.0,100.0,91,0,99.53,Difficile,Trop Facile,Difficile / Trop Facile
4890,741,2020,Mathématique,4,7,QCU,103,69,51,18,1.49,73.91,51,52,49.82,Difficile,Difficile,Difficile / Difficile
741,742,2015,Mathématique,4,8,QCM,77,68,64,4,1.13,94.12,64,13,82.65,Facile,Facile,Facile / Facile
1571,742,2016,Mathématique,4,8,QCM,80,21,3,18,3.81,14.29,3,77,3.76,Difficile,Trop Difficile,Difficile / Trop Difficile
2401,742,2017,Mathématique,4,8,QCM,86,83,60,23,1.04,72.29,60,26,69.53,Difficile,Adapte,Difficile / Adapte
3231,742,2018,Mathématique,4,8,QCM,100,91,60,31,1.1,65.93,60,40,60.01,Adapte,Adapte,Adapte / Adapte
4061,742,2019,Mathématique,4,8,QCM,93,61,59,2,1.52,96.72,59,34,63.27,Adapte,Adapte,Adapte / Adapte
4891,742,2020,Mathématique,4,8,QCM,103,80,67,13,1.29,83.75,67,36,64.71,Adapte,Adapte,Adapte / Adapte
742,743,2015,Mathématique,4,9,QCU,13,13,12,1,1.0,92.31,12,1,95.24,Trop Facile,Trop Facile,Trop Facile / Trop Facile
1572,743,2016,Mathématique,4,9,QCU,14,13,12,1,1.08,92.31,12,2,87.06,Difficile,Trop Facile,Difficile / Trop Facile
2402,743,2017,Mathématique,4,9,QCU,14,11,5,6,1.27,45.45,5,9,36.6,Difficile,Difficile,Difficile / Difficile
3232,743,2018,Mathématique,4,9,QCU,12,11,5,6,1.09,45.45,5,7,42.87,Difficile,Difficile,Difficile / Difficile
4062,743,2019,Mathématique,4,9,QCU,13,11,10,1,1.18,90.91,10,3,76.53,Difficile,Facile,Difficile / Facile
4892,743,2020,Mathématique,4,9,QCU,16,15,7,8,1.07,46.67,7,9,44.8,Difficile,Difficile,Difficile / Difficile
743,744,2015,Mathématique,5,1,QCU,13,11,8,3,1.18,72.73,8,5,57.95,Difficile,Difficile,Difficile / Difficile
1573,744,2016,Mathématique,5,1,QCU,15,12,7,5,1.25,58.33,7,8,49.1,Difficile,Difficile,Difficile / Difficile
2403,744,2017,Mathématique,5,1,QCU,14,14,6,8,1.0,42.86,6,8,41.55,Difficile,Difficile,Difficile / Difficile
3233,744,2018,Mathématique,5,1,QCU,12,6,3,3,2.0,50.0,3,9,20.93,Difficile,Trop Difficile,Difficile / Trop Difficile
4063,744,2019,Mathématique,5,1,QCU,13,8,3,5,1.62,37.5,3,10,26.52,Difficile,Difficile,Difficile / Difficile
4893,744,2020,Mathématique,5,1,QCU,13,6,5,1,2.17,83.33,5,8,36.3,Difficile,Difficile,Difficile / Difficile
744,745,2015,Mathématique,5,2,QCM,70,62,43,19,1.13,69.35,43,27,60.85,Difficile,Adapte,Difficile / Adapte
1574,745,2016,Mathématique,5,2,QCM,84,69,52,17,1.22,75.36,52,32,62.01,Adapte,Adapte,Adapte / Adapte
2404,745,2017,Mathématique,5,2,QCM,77,62,50,12,1.24,80.65,50,27,65.44,Adapte,Adapte,Adapte / Adapte
3234,745,2018,Mathématique,5,2,QCM,75,62,50,12,1.21,80.65,50,25,66.16,Adapte,Adapte,Adapte / Adapte
4064,745,2019,Mathématique,5,2,QCM,67,48,44,4,1.4,91.67,44,23,65.25,Adapte,Adapte,Adapte / Adapte
4894,745,2020,Mathématique,5,2,QCM,75,63,47,16,1.19,74.6,47,28,62.66,Adapte,Adapte,Adapte / Adapte
745,746,2015,Mathématique,5,3,QCU,32,16,7,9,2.0,43.75,7,25,21.91,Facile,Trop Difficile,Facile / Trop Difficile
1575,746,2016,Mathématique,5,3,QCU,31,24,13,11,1.29,54.17,13,18,40.47,Difficile,Difficile,Difficile / Difficile
2405,746,2017,Mathématique,5,3,QCU,29,27,27,0,1.07,100.0,27,2,91.47,Difficile,Trop Facile,Difficile / Trop Facile
3235,746,2018,Mathématique,5,3,QCU,27,27,26,1,1.0,96.3,26,1,96.84,Difficile,Trop Facile,Difficile / Trop Facile
4065,746,2019,Mathématique,5,3,QCU,28,26,22,4,1.08,84.62,22,6,78.9,Difficile,Facile,Difficile / Facile
4895,746,2020,Mathématique,5,3,QCU,24,19,12,7,1.26,63.16,12,12,49.59,Difficile,Difficile,Difficile / Difficile
746,747,2015,Mathématique,5,4,QCU,97,72,7,65,1.35,9.72,7,90,7.04,Trop Difficile,Trop Difficile,Trop Difficile / Trop Difficile
1576,747,2016,Mathématique,5,4,QCU,101,55,46,9,1.84,83.64,46,55,45.53,Difficile,Difficile,Difficile / Difficile
2406,747,2017,Mathématique,5,4,QCU,105,92,84,8,1.14,91.3,84,21,80.32,Difficile,Facile,Difficile / Facile
3236,747,2018,Mathématique,5,4,QCU,104,63,48,15,1.65,76.19,48,56,46.48,Difficile,Difficile,Difficile / Difficile
4066,747,2019,Mathématique,5,4,QCU,116,102,94,8,1.14,92.16,94,22,80.95,Difficile,Facile,Difficile / Facile
4896,747,2020,Mathématique,5,4,QCU,129,59,48,11,2.19,81.36,48,81,37.28,Difficile,Difficile,Difficile / Difficile
747,748,2015,Mathématique,5,5,QCM,14,10,8,2,1.4,80.0,8,6,57.45,Difficile,Difficile,Difficile / Difficile
1577,748,2016,Mathématique,5,5,QCM,14,8,7,1,1.75,87.5,7,7,53.39,Difficile,Difficile,Difficile / Difficile
2407,748,2017,Mathématique,5,5,QCM,16,12,11,1,1.33,91.67,11,5,66.3,Difficile,Adapte,Difficile / Adapte
3237,748,2018,Mathématique,5,5,QCM,18,17,13,4,1.06,76.47,13,5,72.69,Adapte,Adapte,Adapte / Adapte
4067,748,2019,Mathématique,5,5,QCM,18,18,11,7,1.0,61.11,11,7,60.88,Adapte,Adapte,Adapte / Adapte
4897,748,2020,Mathématique,5,5,QCM,22,18,15,3,1.22,83.33,15,7,68.56,Adapte,Adapte,Adapte / Adapte
748,749,2015,Mathématique,6,1,QCM,98,94,91,3,1.04,96.81,91,7,92.41,Adapte,Trop Facile,Adapte / Trop Facile
1578,749,2016,Mathématique,6,1,QCM,106,74,55,19,1.43,74.32,55,51,51.96,Difficile,Difficile,Difficile / Difficile
2408,749,2017,Mathématique,6,1,QCM,111,69,55,14,1.61,79.71,55,56,49.6,Difficile,Difficile,Difficile / Difficile
3238,749,2018,Mathématique,6,1,QCM,117,63,49,14,1.86,77.78,49,68,42.23,Difficile,Difficile,Difficile / Difficile
4068,749,2019,Mathématique,6,1,QCM,127,108,59,49,1.18,54.63,59,68,46.2,Difficile,Difficile,Difficile / Difficile
4898,749,2020,Mathématique,6,1,QCM,134,36,18,18,3.72,50.0,18,116,13.17,Difficile,Trop Difficile,Difficile / Trop Difficile
749,750,2015,Mathématique,6,2,QCU,97,85,54,31,1.14,63.53,54,43,55.34,Difficile,Difficile,Difficile / Difficile
1579,750,2016,Mathématique,6,2,QCU,83,70,35,35,1.19,50.0,35,48,42.55,Difficile,Difficile,Difficile / Difficile
2409,750,2017,Mathématique,6,2,QCU,93,66,48,18,1.41,72.73,48,45,51.21,Difficile,Difficile,Difficile / Difficile
3239,750,2018,Mathématique,6,2,QCU,99,64,52,12,1.55,81.25,52,47,52.63,Difficile,Difficile,Difficile / Difficile
4069,750,2019,Mathématique,6,2,QCU,116,94,58,36,1.23,61.7,58,58,49.71,Difficile,Difficile,Difficile / Difficile
4899,750,2020,Mathématique,6,2,QCU,108,97,70,27,1.11,72.16,70,38,64.8,Difficile,Adapte,Difficile / Adapte
750,751,2015,Mathématique,6,3,QROC,45,43,41,2,1.05,95.35,41,4,90.56,Difficile,Trop Facile,Difficile / Trop Facile
1580,751,2016,Mathématique,6,3,QROC,41,30,23,7,1.37,76.67,23,18,55.9,Difficile,Difficile,Difficile / Difficile
2410,751,2017,Mathématique,6,3,QROC,43,18,14,4,2.39,77.78,14,29,32.83,Difficile,Difficile,Difficile / Difficile
3240,751,2018,Mathématique,6,3,QROC,50,26,24,2,1.92,92.31,24,26,48.97,Difficile,Difficile,Difficile / Difficile
4070,751,2019,Mathématique,6,3,QROC,48,45,27,18,1.07,60.0,27,21,55.56,Difficile,Difficile,Difficile / Difficile
4900,751,2020,Mathématique,6,3,QROC,40,21,18,3,1.9,85.71,18,22,45.43,Difficile,Difficile,Difficile / Difficile
751,752,2015,Mathématique,6,4,QCU,79,73,66,7,1.08,90.41,66,13,83.03,Facile,Facile,Facile / Facile
1581,752,2016,Mathématique,6,4,QCU,86,75,47,28,1.15,62.67,47,39,55.16,Difficile,Difficile,Difficile / Difficile
2411,752,2017,Mathématique,6,4,QCU,80,79,79,0,1.01,100.0,79,1,98.24,Difficile,Trop Facile,Difficile / Trop Facile
3241,752,2018,Mathématique,6,4,QCU,83,41,30,11,2.02,73.17,30,53,36.17,Difficile,Difficile,Difficile / Difficile
4071,752,2019,Mathématique,6,4,QCU,99,41,26,15,2.41,63.41,26,73,26.76,Difficile,Difficile,Difficile / Difficile
4901,752,2020,Mathématique,6,4,QCU,108,91,62,29,1.19,68.13,62,46,57.09,Difficile,Difficile,Difficile / Difficile
752,753,2015,Mathématique,6,5,QCU,5,5,5,0,1.0,100.0,5,0,91.32,Trop Difficile,Trop Facile,Trop Difficile / Trop Facile
1582,753,2016,Mathématique,6,5,QCU,6,5,3,2,1.2,60.0,3,3,57.24,Difficile,Difficile,Difficile / Difficile
2412,753,2017,Mathématique,6,5,QCU,7,4,2,2,1.75,50.0,2,5,32.26,Difficile,Difficile,Difficile / Difficile
3242,753,2018,Mathématique,6,5,QCU,8,7,4,3,1.14,57.14,4,4,50.23,Difficile,Difficile,Difficile / Difficile
4072,753,2019,Mathématique,6,5,QCU,9,4,3,1,2.25,75.0,3,6,34.96,Difficile,Difficile,Difficile / Difficile
4902,753,2020,Mathématique,6,5,QCU,11,7,5,2,1.57,71.43,5,6,41.99,Difficile,Difficile,Difficile / Difficile
753,754,2015,Mathématique,6,6,QCU,66,64,60,4,1.03,93.75,60,6,91.34,Trop Facile,Trop Facile,Trop Facile / Trop Facile
1583,754,2016,Mathématique,6,6,QCU,54,28,20,8,1.93,71.43,20,34,37.6,Difficile,Difficile,Difficile / Difficile
2413,754,2017,Mathématique,6,6,QCU,59,40,15,25,1.48,37.5,15,44,26.14,Difficile,Difficile,Difficile / Difficile
3243,754,2018,Mathématique,6,6,QCU,68,59,33,26,1.15,55.93,33,35,47.94,Difficile,Difficile,Difficile / Difficile
4073,754,2019,Mathématique,6,6,QCU,66,24,20,4,2.75,83.33,20,46,30.19,Difficile,Difficile,Difficile / Difficile
4903,754,2020,Mathématique,6,6,QCU,64,44,32,12,1.45,72.73,32,32,49.94,Difficile,Difficile,Difficile / Difficile
754,755,2015,Mathématique,6,7,QCM,81,42,25,17,1.93,59.52,25,56,31.4,Facile,Difficile,Facile / Difficile
1584,755,2016,Mathématique,6,7,QCM,93,90,87,3,1.03,96.67,87,6,93.75,Difficile,Trop Facile,Difficile / Trop Facile
2414,755,2017,Mathématique,6,7,QCM,107,94,7,87,1.14,7.45,7,100,6.19,Difficile,Trop Difficile,Difficile / Trop Difficile
3244,755,2018,Mathématique,6,7,QCM,126,116,105,11,1.09,90.52,105,21,83.63,Difficile,Facile,Difficile / Facile
4074,755,2019,Mathématique,6,7,QCM,134,126,71,55,1.06,56.35,71,63,52.82,Difficile,Difficile,Difficile / Difficile
4904,755,2020,Mathématique,6,7,QCM,128,55,40,15,2.33,72.73,40,88,31.54,Difficile,Difficile,Difficile / Difficile
755,756,2015,Mathématique,6,8,QCU,49,34,30,4,1.44,88.24,30,19,60.72,Difficile,Adapte,Difficile / Adapte
1585,756,2016,Mathématique,6,8,QCU,54,45,38,7,1.2,84.44,38,16,70.94,Adapte,Adapte,Adapte / Adapte
2415,756,2017,Mathématique,6,8,QCU,48,34,31,3,1.41,91.18,31,17,63.9,Adapte,Adapte,Adapte / Adapte
3245,756,2018,Mathématique,6,8,QCU,40,32,26,6,1.25,81.25,26,14,64.38,Adapte,Adapte,Adapte / Adapte
4075,756,2019,Mathématique,6,8,QCU,39,35,25,10,1.11,71.43,25,14,63.33,Adapte,Adapte,Adapte / Adapte
4905,756,2020,Mathématique,6,8,QCU,35,28,26,2,1.25,92.86,26,9,74.1,Adapte,Adapte,Adapte / Adapte
756,757,2015,Mathématique,7,1,QCU,95,92,75,17,1.03,81.52,75,20,79.38,Facile,Facile,Facile / Facile
1586,757,2016,Mathématique,7,1,QCU,98,92,53,39,1.07,57.61,53,45,54.07,Difficile,Difficile,Difficile / Difficile
2416,757,2017,Mathématique,7,1,QCU,78,57,25,32,1.37,43.86,25,53,32.11,Difficile,Difficile,Difficile / Difficile
3246,757,2018,Mathématique,7,1,QCU,63,42,37,5,1.5,88.1,37,26,58.65,Difficile,Difficile,Difficile / Difficile
4076,757,2019,Mathématique,7,1,QCU,62,38,27,11,1.63,71.05,27,35,43.69,Difficile,Difficile,Difficile / Difficile
4906,757,2020,Mathématique,7,1,QCU,69,54,20,34,1.28,37.04,20,49,28.71,Difficile,Difficile,Difficile / Difficile
757,758,2015,Mathématique,7,2,QCM,77,65,49,16,1.18,75.38,49,28,63.05,Adapte,Adapte,Adapte / Adapte
1587,758,2016,Mathématique,7,2,QCM,80,70,60,10,1.14,85.71,60,20,74.44,Adapte,Adapte,Adapte / Adapte
2417,758,2017,Mathématique,7,2,QCM,80,79,49,30,1.01,62.03,49,31,61.54,Adapte,Adapte,Adapte / Adapte
3247,758,2018,Mathématique,7,2,QCM,65,63,47,16,1.03,74.6,47,18,72.75,Adapte,Adapte,Adapte / Adapte
4077,758,2019,Mathématique,7,2,QCM,53,40,36,4,1.32,90.0,36,17,67.72,Adapte,Adapte,Adapte / Adapte
4907,758,2020,Mathématique,7,2,QCM,60,47,42,5,1.28,89.36,42,18,69.54,Adapte,Adapte,Adapte / Adapte
758,759,2015,Mathématique,7,3,QCU,36,30,14,16,1.2,46.67,14,22,40.07,Trop Difficile,Difficile,Trop Difficile / Difficile
1588,759,2016,Mathématique,7,3,QCU,32,19,13,6,1.68,68.42,13,19,39.65,Difficile,Difficile,Difficile / Difficile
2418,759,2017,Mathématique,7,3,QCU,31,23,16,7,1.35,69.57,16,15,51.23,Difficile,Difficile,Difficile / Difficile
3248,759,2018,Mathématique,7,3,QCU,29,18,16,2,1.61,88.89,16,13,55.97,Difficile,Difficile,Difficile / Difficile
4078,759,2019,Mathématique,7,3,QCU,31,12,11,1,2.58,91.67,11,20,36.12,Difficile,Difficile,Difficile / Difficile
4908,759,2020,Mathématique,7,3,QCU,36,13,11,2,2.77,84.62,11,25,31.76,Difficile,Difficile,Difficile / Difficile
759,760,2015,Mathématique,7,4,QCM,67,38,27,11,1.76,71.05,27,40,40.58,Difficile,Difficile,Difficile / Difficile
1589,760,2016,Mathématique,7,4,QCM,58,57,26,31,1.02,45.61,26,32,44.71,Difficile,Difficile,Difficile / Difficile
2419,760,2017,Mathématique,7,4,QCM,46,21,4,17,2.19,19.05,4,42,8.39,Difficile,Trop Difficile,Difficile / Trop Difficile
3249,760,2018,Mathématique,7,4,QCM,41,15,11,4,2.73,73.33,11,30,25.92,Difficile,Difficile,Difficile / Difficile
4079,760,2019,Mathématique,7,4,QCM,39,35,4,31,1.11,11.43,4,35,10.39,Difficile,Trop Difficile,Difficile / Trop Difficile
4909,760,2020,Mathématique,7,4,QCM,43,28,25,3,1.54,89.29,25,18,58.61,Difficile,Difficile,Difficile / Difficile
760,761,2015,Mathématique,7,5,QCU,30,30,9,21,1.0,30.0,9,21,29.69,Trop Difficile,Difficile,Trop Difficile / Difficile
1590,761,2016,Mathématique,7,5,QCU,35,33,32,1,1.06,96.97,32,3,90.13,Difficile,Trop Facile,Difficile / Trop Facile
2420,761,2017,Mathématique,7,5,QCU,39,31,15,16,1.26,48.39,15,24,37.53,Difficile,Difficile,Difficile / Difficile
3250,761,2018,Mathématique,7,5,QCU,44,23,18,5,1.91,78.26,18,26,41.95,Difficile,Difficile,Difficile / Difficile
4080,761,2019,Mathématique,7,5,QCU,48,16,12,4,3.0,75.0,12,36,25.64,Difficile,Difficile,Difficile / Difficile
4910,761,2020,Mathématique,7,5,QCU,48,43,27,16,1.12,62.79,27,21,56.57,Difficile,Difficile,Difficile / Difficile
761,762,2015,Mathématique,7,6,QCM,14,13,4,9,1.08,30.77,4,10,26.95,Difficile,Difficile,Difficile / Difficile
1591,762,2016,Mathématique,7,6,QCM,14,13,3,10,1.08,23.08,3,11,22.37,Difficile,Trop Difficile,Difficile / Trop Difficile
2421,762,2017,Mathématique,7,6,QCM,14,13,5,8,1.08,38.46,5,9,34.0,Difficile,Difficile,Difficile / Difficile
3251,762,2018,Mathématique,7,6,QCM,16,13,9,4,1.23,69.23,9,7,58.38,Difficile,Difficile,Difficile / Difficile
4081,762,2019,Mathématique,7,6,QCM,19,17,13,4,1.12,76.47,13,6,66.58,Difficile,Adapte,Difficile / Adapte
4911,762,2020,Mathématique,7,6,QCM,16,12,12,0,1.33,100.0,12,4,72.15,Adapte,Adapte,Adapte / Adapte
762,763,2015,Mathématique,8,1,QCU,83,37,6,31,2.24,16.22,6,77,6.84,Adapte,Trop Difficile,Adapte / Trop Difficile
1592,763,2016,Mathématique,8,1,QCU,66,55,31,24,1.2,56.36,31,35,46.36,Difficile,Difficile,Difficile / Difficile
2422,763,2017,Mathématique,8,1,QCU,69,58,28,30,1.19,48.28,28,41,40.26,Difficile,Difficile,Difficile / Difficile
3252,763,2018,Mathématique,8,1,QCU,62,30,16,14,2.07,53.33,16,46,26.54,Difficile,Difficile,Difficile / Difficile
4082,763,2019,Mathématique,8,1,QCU,72,68,18,50,1.06,26.47,18,54,25.15,Difficile,Difficile,Difficile / Difficile
4912,763,2020,Mathématique,8,1,QCU,62,39,31,8,1.59,79.49,31,31,50.09,Difficile,Difficile,Difficile / Difficile
763,764,2015,Mathématique,8,2,QROC,69,59,54,5,1.17,91.53,54,15,77.67,Facile,Facile,Facile / Facile
1593,764,2016,Mathématique,8,2,QROC,81,74,13,61,1.09,17.57,13,68,16.59,Difficile,Trop Difficile,Difficile / Trop Difficile
2423,764,2017,Mathématique,8,2,QROC,78,36,28,8,2.17,77.78,28,50,35.78,Difficile,Difficile,Difficile / Difficile
3253,764,2018,Mathématique,8,2,QROC,94,87,84,3,1.08,96.55,84,10,89.88,Difficile,Trop Facile,Difficile / Trop Facile
4083,764,2019,Mathématique,8,2,QROC,111,52,42,10,2.13,80.77,42,69,37.82,Difficile,Difficile,Difficile / Difficile
4913,764,2020,Mathématique,8,2,QROC,97,50,28,22,1.94,56.0,28,69,29.35,Difficile,Difficile,Difficile / Difficile
764,765,2015,Mathématique,8,3,QCU,61,61,49,12,1.0,80.33,49,12,79.76,Trop Difficile,Facile,Trop Difficile / Facile
1594,765,2016,Mathématique,8,3,QCU,50,28,17,11,1.79,60.71,17,33,33.02,Difficile,Difficile,Difficile / Difficile
2424,765,2017,Mathématique,8,3,QCU,41,37,9,28,1.11,24.32,9,32,22.21,Difficile,Trop Difficile,Difficile / Trop Difficile
3254,765,2018,Mathématique,8,3,QCU,38,36,34,2,1.06,94.44,34,4,89.55,Difficile,Trop Facile,Difficile / Trop Facile
4084,765,2019,Mathématique,8,3,QCU,38,27,14,13,1.41,51.85,14,24,37.8,Difficile,Difficile,Difficile / Difficile
4914,765,2020,Mathématique,8,3,QCU,45,16,13,3,2.81,81.25,13,32,27.8,Difficile,Difficile,Difficile / Difficile
765,766,2015,Mathématique,8,4,QCM,57,55,36,19,1.04,65.45,36,21,63.25,Adapte,Adapte,Adapte / Adapte
1595,766,2016,Mathématique,8,4,QCM,60,56,36,20,1.07,64.29,36,24,60.68,Adapte,Adapte,Adapte / Adapte
2425,766,2017,Mathématique,8,4,QCM,67,51,49,2,1.31,96.08,49,18,72.47,Adapte,Adapte,Adapte / Adapte
3255,766,2018,Mathématique,8,4,QCM,54,43,34,9,1.26,79.07,34,20,63.42,Adapte,Adapte,Adapte / Adapte
4085,766,2019,Mathématique,8,4,QCM,60,54,44,10,1.11,81.48,44,16,73.62,Adapte,Adapte,Adapte / Adapte
4915,766,2020,Mathématique,8,4,QCM,63,61,43,18,1.03,70.49,43,20,68.32,Adapte,Adapte,Adapte / Adapte
766,767,2015,Mathématique,8,5,QROC,67,60,6,54,1.12,10.0,6,61,9.04,Trop Difficile,Trop Difficile,Trop Difficile / Trop Difficile
1596,767,2016,Mathématique,8,5,QROC,63,36,17,19,1.75,47.22,17,46,27.12,Difficile,Difficile,Difficile / Difficile
2426,767,2017,Mathématique,8,5,QROC,50,48,46,2,1.04,95.83,46,4,91.62,Difficile,Trop Facile,Difficile / Trop Facile
3256,767,2018,Mathématique,8,5,QROC,55,37,0,37,1.49,0.0,0,55,0.33,Difficile,Trop Difficile,Difficile / Trop Difficile
4086,767,2019,Mathématique,8,5,QROC,45,43,43,0,1.05,100.0,43,2,95.03,Difficile,Trop Facile,Difficile / Trop Facile
4916,767,2020,Mathématique,8,5,QROC,36,33,28,5,1.09,84.85,28,8,76.46,Difficile,Facile,Difficile / Facile
767,768,2015,Mathématique,8,6,QCM,27,17,17,0,1.59,100.0,17,10,63.1,Adapte,Adapte,Adapte / Adapte
1597,768,2016,Mathématique,8,6,QCM,22,21,14,7,1.05,66.67,14,8,61.45,Adapte,Adapte,Adapte / Adapte
2427,768,2017,Mathématique,8,6,QCM,20,17,13,4,1.18,76.47,13,7,64.45,Adapte,Adapte,Adapte / Adapte
3257,768,2018,Mathématique,8,6,QCM,24,23,16,7,1.04,69.57,16,8,66.56,Adapte,Adapte,Adapte / Adapte
4087,768,2019,Mathématique,8,6,QCM,26,23,18,5,1.13,78.26,18,8,70.14,Adapte,Adapte,Adapte / Adapte
4917,768,2020,Mathématique,8,6,QCM,26,26,19,7,1.0,73.08,19,7,74.05,Adapte,Adapte,Adapte / Adapte
768,769,2015,Mathématique,8,7,QCM,34,23,23,0,1.48,100.0,23,11,66.87,Adapte,Adapte,Adapte / Adapte
1598,769,2016,Mathématique,8,7,QCM,34,34,25,9,1.0,73.53,25,9,73.89,Adapte,Adapte,Adapte / Adapte
2428,769,2017,Mathématique,8,7,QCM,34,31,22,9,1.1,70.97,22,12,64.04,Adapte,Adapte,Adapte / Adapte
3258,769,2018,Mathématique,8,7,QCM,35,29,22,7,1.21,75.86,22,13,64.05,Adapte,Adapte,Adapte / Adapte
4088,769,2019,Mathématique,8,7,QCM,34,26,25,1,1.31,96.15,25,9,73.05,Adapte,Adapte,Adapte / Adapte
4918,769,2020,Mathématique,8,7,QCM,33,24,21,3,1.38,87.5,21,12,63.77,Adapte,Adapte,Adapte / Adapte
769,770,2015,Mathématique,9,1,QCU,60,57,55,2,1.05,96.49,55,5,92.26,Trop Facile,Trop Facile,Trop Facile / Trop Facile
1599,770,2016,Mathématique,9,1,QCU,72,59,31,28,1.22,52.54,31,41,42.88,Difficile,Difficile,Difficile / Difficile
2429,770,2017,Mathématique,9,1,QCU,67,65,41,24,1.03,63.08,41,26,61.92,Difficile,Adapte,Difficile / Adapte
3259,770,2018,Mathématique,9,1,QCU,66,56,46,10,1.18,82.14,46,20,69.53,Adapte,Adapte,Adapte / Adapte
4089,770,2019,Mathématique,9,1,QCU,56,52,38,14,1.08,73.08,38,18,67.08,Adapte,Adapte,Adapte / Adapte
4919,770,2020,Mathématique,9,1,QCU,54,48,40,8,1.12,83.33,40,14,73.43,Adapte,Adapte,Adapte / Adapte
770,771,2015,Mathématique,9,2,QROC,79,68,66,2,1.16,97.06,66,13,83.06,Facile,Facile,Facile / Facile
1600,771,2016,Mathématique,9,2,QROC,82,69,67,2,1.19,97.1,67,15,81.63,Difficile,Facile,Difficile / Facile
2430,771,2017,Mathématique,9,2,QROC,87,61,48,13,1.43,78.69,48,39,55.4,Difficile,Difficile,Difficile / Difficile
3260,771,2018,Mathématique,9,2,QROC,82,73,68,5,1.12,93.15,68,14,82.75,Difficile,Facile,Difficile / Facile
4090,771,2019,Mathématique,9,2,QROC,92,74,71,3,1.24,95.95,71,21,77.57,Difficile,Facile,Difficile / Facile
4920,771,2020,Mathématique,9,2,QROC,89,53,18,35,1.68,33.96,18,71,19.97,Difficile,Trop Difficile,Difficile / Trop Difficile
771,772,2015,Mathématique,9,3,QCU,94,85,78,7,1.11,91.76,78,16,82.46,Facile,Facile,Facile / Facile
1601,772,2016,Mathématique,9,3,QCU,103,82,26,56,1.26,31.71,26,77,25.15,Difficile,Difficile,Difficile / Difficile
2431,772,2017,Mathématique,9,3,QCU,82,48,25,23,1.71,52.08,25,57,30.76,Difficile,Difficile,Difficile / Difficile
3261,772,2018,Mathématique,9,3,QCU,92,64,51,13,1.44,79.69,51,41,55.83,Difficile,Difficile,Difficile / Difficile
4091,772,2019,Mathématique,9,3,QCU,81,39,36,3,2.08,92.31,36,45,44.13,Difficile,Difficile,Difficile / Difficile
4921,772,2020,Mathématique,9,3,QCU,83,64,45,19,1.3,70.31,45,38,54.12,Difficile,Difficile,Difficile / Difficile
772,773,2015,Mathématique,9,4,QCU,56,55,18,37,1.02,32.73,18,38,31.95,Difficile,Difficile,Difficile / Difficile
1602,773,2016,Mathématique,9,4,QCU,49,39,29,10,1.26,74.36,29,20,58.19,Difficile,Difficile,Difficile / Difficile
2432,773,2017,Mathématique,9,4,QCU,52,28,17,11,1.86,60.71,17,35,32.49,Difficile,Difficile,Difficile / Difficile
3262,773,2018,Mathématique,9,4,QCU,55,41,26,15,1.34,63.41,26,29,46.83,Difficile,Difficile,Difficile / Difficile
4092,773,2019,Mathématique,9,4,QCU,57,40,32,8,1.43,80.0,32,25,56.92,Difficile,Difficile,Difficile / Difficile
4922,773,2020,Mathématique,9,4,QCU,65,41,29,12,1.59,70.73,29,36,44.49,Difficile,Difficile,Difficile / Difficile
773,774,2015,Mathématique,9,5,QCU,88,74,55,19,1.19,74.32,55,33,62.51,Adapte,Adapte,Adapte / Adapte
1603,774,2016,Mathématique,9,5,QCU,105,83,64,19,1.27,77.11,64,41,60.61,Adapte,Adapte,Adapte / Adapte
2433,774,2017,Mathématique,9,5,QCU,106,99,76,23,1.07,76.77,76,30,71.55,Adapte,Adapte,Adapte / Adapte
3263,774,2018,Mathématique,9,5,QCU,111,76,72,4,1.46,94.74,72,39,64.63,Adapte,Adapte,Adapte / Adapte
4093,774,2019,Mathématique,9,5,QCU,133,112,83,29,1.19,74.11,83,50,62.44,Adapte,Adapte,Adapte / Adapte
4923,774,2020,Mathématique,9,5,QCU,121,121,90,31,1.0,74.38,90,31,74.45,Adapte,Adapte,Adapte / Adapte
774,775,2015,Mathématique,9,6,QCM,6,3,3,0,2.0,100.0,3,3,44.82,Difficile,Difficile,Difficile / Difficile
1604,775,2016,Mathématique,9,6,QCM,7,6,3,3,1.17,50.0,3,4,40.24,Difficile,Difficile,Difficile / Difficile
2434,775,2017,Mathématique,9,6,QCM,7,7,6,1,1.0,85.71,6,1,90.82,Difficile,Trop Facile,Difficile / Trop Facile
3264,775,2018,Mathématique,9,6,QCM,8,4,2,2,2.0,50.0,2,6,26.75,Difficile,Difficile,Difficile / Difficile
4094,775,2019,Mathématique,9,6,QCM,10,9,5,4,1.11,55.56,5,5,46.15,Difficile,Difficile,Difficile / Difficile
4924,775,2020,Mathématique,9,6,QCM,8,6,6,0,1.33,100.0,6,2,72.59,Difficile,Adapte,Difficile / Adapte
775,776,2015,Mathématique,9,7,QCU,80,78,51,27,1.03,65.38,51,29,64.13,Facile,Adapte,Facile / Adapte
1605,776,2016,Mathématique,9,7,QCU,95,89,70,19,1.07,78.65,70,25,73.19,Adapte,Adapte,Adapte / Adapte
2435,776,2017,Mathématique,9,7,QCU,94,65,59,6,1.45,90.77,59,35,62.47,Adapte,Adapte,Adapte / Adapte
3265,776,2018,Mathématique,9,7,QCU,107,103,77,26,1.04,74.76,77,30,71.98,Adapte,Adapte,Adapte / Adapte
4095,776,2019,Mathématique,9,7,QCU,121,108,77,31,1.12,71.3,77,44,63.72,Adapte,Adapte,Adapte / Adapte
4925,776,2020,Mathématique,9,7,QCU,136,99,98,1,1.37,98.99,98,38,71.7,Adapte,Adapte,Adapte / Adapte
776,777,2015,Mathématique,9,8,QCU,19,18,16,2,1.06,88.89,16,3,81.81,Facile,Facile,Facile / Facile
1606,777,2016,Mathématique,9,8,QCU,15,6,4,2,2.5,66.67,4,11,26.76,Difficile,Difficile,Difficile / Difficile
2436,777,2017,Mathématique,9,8,QCU,12,9,4,5,1.33,44.44,4,8,34.78,Difficile,Difficile,Difficile / Difficile
3266,777,2018,Mathématique,9,8,QCU,12,7,4,3,1.71,57.14,4,8,30.63,Difficile,Difficile,Difficile / Difficile
4096,777,2019,Mathématique,9,8,QCU,12,9,8,1,1.33,88.89,8,4,67.63,Difficile,Adapte,Difficile / Adapte
4926,777,2020,Mathématique,9,8,QCU,12,10,9,1,1.2,90.0,9,3,74.97,Adapte,Adapte,Adapte / Adapte
777,778,2015,Mathématique,9,9,QCU,7,5,3,2,1.4,60.0,3,4,45.27,Difficile,Difficile,Difficile / Difficile
1607,778,2016,Mathématique,9,9,QCU,6,6,4,2,1.0,66.67,4,2,64.09,Difficile,Adapte,Difficile / Adapte
2437,778,2017,Mathématique,9,9,QCU,6,6,4,2,1.0,66.67,4,2,63.67,Adapte,Adapte,Adapte / Adapte
3267,778,2018,Mathématique,9,9,QCU,7,5,5,0,1.4,100.0,5,2,65.06,Adapte,Adapte,Adapte / Adapte
4097,778,2019,Mathématique,9,9,QCU,7,4,4,0,1.75,100.0,4,3,64.15,Adapte,Adapte,Adapte / Adapte
4927,778,2020,Mathématique,9,9,QCU,7,6,5,1,1.17,83.33,5,2,73.21,Adapte,Adapte,Adapte / Adapte
778,779,2015,Mathématique,9,10,QCM,53,24,5,19,2.21,20.83,5,48,8.98,Trop Difficile,Trop Difficile,Trop Difficile / Trop Difficile
1608,779,2016,Mathématique,9,10,QCM,46,42,19,23,1.1,45.24,19,27,40.34,Difficile,Difficile,Difficile / Difficile
2438,779,2017,Mathématique,9,10,QCM,48,44,37,7,1.09,84.09,37,11,78.04,Difficile,Facile,Difficile / Facile
3268,779,2018,Mathématique,9,10,QCM,44,43,29,14,1.02,67.44,29,15,66.08,Difficile,Adapte,Difficile / Adapte
4098,779,2019,Mathématique,9,10,QCM,47,38,34,4,1.24,89.47,34,13,73.23,Adapte,Adapte,Adapte / Adapte
4928,779,2020,Mathématique,9,10,QCM,52,43,37,6,1.21,86.05,37,15,70.29,Adapte,Adapte,Adapte / Adapte
779,780,2015,Mathématique,9,11,QCU,49,39,29,10,1.26,74.36,29,20,58.96,Difficile,Difficile,Difficile / Difficile
1609,780,2016,Mathématique,9,11,QCU,41,19,14,5,2.16,73.68,14,27,35.33,Difficile,Difficile,Difficile / Difficile
2439,780,2017,Mathématique,9,11,QCU,38,17,8,9,2.24,47.06,8,30,22.18,Difficile,Trop Difficile,Difficile / Trop Difficile
3269,780,2018,Mathématique,9,11,QCU,32,21,7,14,1.52,33.33,7,25,23.22,Difficile,Trop Difficile,Difficile / Trop Difficile
4099,780,2019,Mathématique,9,11,QCU,34,20,10,10,1.7,50.0,10,24,28.21,Difficile,Difficile,Difficile / Difficile
4929,780,2020,Mathématique,9,11,QCU,40,39,33,6,1.03,84.62,33,7,81.53,Difficile,Facile,Difficile / Facile
780,781,2015,Mathématique,9,12,QCM,56,34,4,30,1.65,11.76,4,52,6.61,Trop Difficile,Trop Difficile,Trop Difficile / Trop Difficile
1610,781,2016,Mathématique,9,12,QCM,50,28,25,3,1.79,89.29,25,25,49.74,Difficile,Difficile,Difficile / Difficile
2440,781,2017,Mathématique,9,12,QCM,60,55,51,4,1.09,92.73,51,9,84.17,Difficile,Facile,Difficile / Facile
3270,781,2018,Mathématique,9,12,QCM,59,49,8,41,1.2,16.33,8,51,13.87,Difficile,Trop Difficile,Difficile / Trop Difficile
4100,781,2019,Mathématique,9,12,QCM,64,48,18,30,1.33,37.5,18,46,27.95,Difficile,Difficile,Difficile / Difficile
4930,781,2020,Mathématique,9,12,QCM,71,64,62,2,1.11,96.88,62,9,87.96,Difficile,Trop Facile,Difficile / Trop Facile
781,782,2015,Mathématique,10,1,QCU,72,56,46,10,1.29,82.14,46,26,63.2,Adapte,Adapte,Adapte / Adapte
1611,782,2016,Mathématique,10,1,QCU,64,56,39,17,1.14,69.64,39,25,60.88,Adapte,Adapte,Adapte / Adapte
2441,782,2017,Mathématique,10,1,QCU,64,60,39,21,1.07,65.0,39,25,61.04,Adapte,Adapte,Adapte / Adapte
3271,782,2018,Mathématique,10,1,QCU,74,71,50,21,1.04,70.42,50,24,66.95,Adapte,Adapte,Adapte / Adapte
4101,782,2019,Mathématique,10,1,QCU,61,58,38,20,1.05,65.52,38,23,62.64,Adapte,Adapte,Adapte / Adapte
4931,782,2020,Mathématique,10,1,QCU,62,50,40,10,1.24,80.0,40,22,65.2,Adapte,Adapte,Adapte / Adapte
782,783,2015,Mathématique,11,1,QCU,15,15,1,14,1.0,6.67,1,14,5.11,Facile,Trop Difficile,Facile / Trop Difficile
1612,783,2016,Mathématique,11,1,QCU,18,8,7,1,2.25,87.5,7,11,39.83,Difficile,Difficile,Difficile / Difficile
2442,783,2017,Mathématique,11,1,QCU,17,17,12,5,1.0,70.59,12,5,72.14,Difficile,Adapte,Difficile / Adapte
3272,783,2018,Mathématique,11,1,QCU,19,14,13,1,1.36,92.86,13,6,67.15,Adapte,Adapte,Adapte / Adapte
4102,783,2019,Mathématique,11,1,QCU,16,16,11,5,1.0,68.75,11,5,66.98,Adapte,Adapte,Adapte / Adapte
4932,783,2020,Mathématique,11,1,QCU,17,12,11,1,1.42,91.67,11,6,63.69,Adapte,Adapte,Adapte / Adapte
783,784,2015,Mathématique,11,2,QCU,70,62,55,7,1.13,88.71,55,15,78.62,Difficile,Facile,Difficile / Facile
1613,784,2016,Mathématique,11,2,QCU,83,64,42,22,1.3,65.62,42,41,50.87,Difficile,Difficile,Difficile / Difficile
2443,784,2017,Mathématique,11,2,QCU,99,53,40,13,1.87,75.47,40,59,40.47,Difficile,Difficile,Difficile / Difficile
3273,784,2018,Mathématique,11,2,QCU,91,64,52,12,1.42,81.25,52,39,57.08,Difficile,Difficile,Difficile / Difficile
4103,784,2019,Mathématique,11,2,QCU,89,79,65,14,1.13,82.28,65,24,73.37,Difficile,Adapte,Difficile / Adapte
4933,784,2020,Mathématique,11,2,QCU,85,62,52,10,1.37,83.87,52,33,60.82,Adapte,Adapte,Adapte / Adapte
784,785,2015,Mathématique,11,3,QCU,93,87,85,2,1.07,97.7,85,8,91.89,Trop Facile,Trop Facile,Trop Facile / Trop Facile
1614,785,2016,Mathématique,11,3,QCU,107,83,48,35,1.29,57.83,48,59,45.28,Difficile,Difficile,Difficile / Difficile
2444,785,2017,Mathématique,11,3,QCU,101,68,47,21,1.49,69.12,47,54,46.26,Difficile,Difficile,Difficile / Difficile
3274,785,2018,Mathématique,11,3,QCU,103,83,48,35,1.24,57.83,48,55,46.43,Difficile,Difficile,Difficile / Difficile
4104,785,2019,Mathématique,11,3,QCU,104,57,40,17,1.82,70.18,40,64,38.22,Difficile,Difficile,Difficile / Difficile
4934,785,2020,Mathématique,11,3,QCU,93,90,51,39,1.03,56.67,51,42,54.65,Difficile,Difficile,Difficile / Difficile
785,786,2015,Mathématique,12,1,QCU,7,7,7,0,1.0,100.0,7,0,98.74,Trop Facile,Trop Facile,Trop Facile / Trop Facile
1615,786,2016,Mathématique,12,1,QCU,7,6,2,4,1.17,33.33,2,5,35.33,Difficile,Difficile,Difficile / Difficile
2445,786,2017,Mathématique,12,1,QCU,6,4,3,1,1.5,75.0,3,3,44.21,Difficile,Difficile,Difficile / Difficile
3275,786,2018,Mathématique,12,1,QCU,5,4,2,2,1.25,50.0,2,3,49.91,Difficile,Difficile,Difficile / Difficile
4105,786,2019,Mathématique,12,1,QCU,4,4,2,2,1.0,50.0,2,2,56.53,Difficile,Difficile,Difficile / Difficile
4935,786,2020,Mathématique,12,1,QCU,5,5,3,2,1.0,60.0,3,2,53.8,Difficile,Difficile,Difficile / Difficile
786,787,2015,Mathématique,12,2,QCM,100,98,48,50,1.02,48.98,48,52,47.9,Adapte,Difficile,Adapte / Difficile
1616,787,2016,Mathématique,12,2,QCM,94,93,24,69,1.01,25.81,24,70,25.27,Difficile,Difficile,Difficile / Difficile
2446,787,2017,Mathématique,12,2,QCM,101,56,51,5,1.8,91.07,51,50,50.91,Difficile,Difficile,Difficile / Difficile
3276,787,2018,Mathématique,12,2,QCM,101,93,28,65,1.09,30.11,28,73,28.01,Difficile,Difficile,Difficile / Difficile
4106,787,2019,Mathématique,12,2,QCM,114,99,89,10,1.15,89.9,89,25,78.42,Difficile,Facile,Difficile / Facile
4936,787,2020,Mathématique,12,2,QCM,135,125,68,57,1.08,54.4,68,67,50.3,Difficile,Difficile,Difficile / Difficile
787,788,2015,Mathématique,12,3,QCU,51,46,44,2,1.11,95.65,44,7,86.21,Trop Facile,Trop Facile,Trop Facile / Trop Facile
1617,788,2016,Mathématique,12,3,QCU,59,32,19,13,1.84,59.38,19,40,32.76,Difficile,Difficile,Difficile / Difficile
2447,788,2017,Mathématique,12,3,QCU,71,37,32,5,1.92,86.49,32,39,45.21,Difficile,Difficile,Difficile / Difficile
3277,788,2018,Mathématique,12,3,QCU,60,51,47,4,1.18,92.16,47,13,78.44,Difficile,Facile,Difficile / Facile
4107,788,2019,Mathématique,12,3,QCU,50,49,48,1,1.02,97.96,48,2,96.81,Difficile,Trop Facile,Difficile / Trop Facile
4937,788,2020,Mathématique,12,3,QCU,44,31,25,6,1.42,80.65,25,19,56.59,Difficile,Difficile,Difficile / Difficile
788,789,2015,Mathématique,12,4,QCU,6,6,3,3,1.0,50.0,3,3,43.52,Difficile,Difficile,Difficile / Difficile
1618,789,2016,Mathématique,12,4,QCU,6,4,2,2,1.5,50.0,2,4,41.39,Difficile,Difficile,Difficile / Difficile
2448,789,2017,Mathématique,12,4,QCU,7,6,3,3,1.17,50.0,3,4,45.05,Difficile,Difficile,Difficile / Difficile
3278,789,2018,Mathématique,12,4,QCU,7,5,1,4,1.4,20.0,1,6,18.5,Difficile,Trop Difficile,Difficile / Trop Difficile
4108,789,2019,Mathématique,12,4,QCU,6,5,4,1,1.2,80.0,4,2,60.62,Difficile,Adapte,Difficile / Adapte
4938,789,2020,Mathématique,12,4,QCU,7,5,5,0,1.4,100.0,5,2,72.71,Adapte,Adapte,Adapte / Adapte
789,790,2015,Mathématique,12,5,QROC,15,15,14,1,1.0,93.33,14,1,95.59,Difficile,Trop Facile,Difficile / Trop Facile
1619,790,2016,Mathématique,12,5,QROC,12,10,7,3,1.2,70.0,7,5,61.81,Difficile,Adapte,Difficile / Adapte
2449,790,2017,Mathématique,12,5,QROC,10,8,6,2,1.25,75.0,6,4,60.26,Adapte,Adapte,Adapte / Adapte
3279,790,2018,Mathématique,12,5,QROC,12,11,9,2,1.09,81.82,9,3,74.43,Adapte,Adapte,Adapte / Adapte
4109,790,2019,Mathématique,12,5,QROC,10,9,7,2,1.11,77.78,7,3,74.78,Adapte,Adapte,Adapte / Adapte
4939,790,2020,Mathématique,12,5,QROC,9,8,6,2,1.12,75.0,6,3,61.6,Adapte,Adapte,Adapte / Adapte
790,791,2015,Mathématique,12,6,QCU,16,12,7,5,1.33,58.33,7,9,41.63,Difficile,Difficile,Difficile / Difficile
1620,791,2016,Mathématique,12,6,QCU,16,16,10,6,1.0,62.5,10,6,65.26,Difficile,Adapte,Difficile / Adapte
2450,791,2017,Mathématique,12,6,QCU,15,14,10,4,1.07,71.43,10,5,69.59,Adapte,Adapte,Adapte / Adapte
3280,791,2018,Mathématique,12,6,QCU,18,14,11,3,1.29,78.57,11,7,63.74,Adapte,Adapte,Adapte / Adapte
4110,791,2019,Mathématique,12,6,QCU,20,16,15,1,1.25,93.75,15,5,74.63,Adapte,Adapte,Adapte / Adapte
4940,791,2020,Mathématique,12,6,QCU,16,14,11,3,1.14,78.57,11,5,69.32,Adapte,Adapte,Adapte / Adapte
791,792,2015,Mathématique,12,7,QCU,88,87,87,0,1.01,100.0,87,1,99.16,Trop Facile,Trop Facile,Trop Facile / Trop Facile
1621,792,2016,Mathématique,12,7,QCU,72,71,49,22,1.01,69.01,49,23,68.23,Difficile,Adapte,Difficile / Adapte
2451,792,2017,Mathématique,12,7,QCU,76,75,49,26,1.01,65.33,49,27,64.49,Adapte,Adapte,Adapte / Adapte
3281,792,2018,Mathématique,12,7,QCU,88,70,53,17,1.26,75.71,53,35,60.3,Adapte,Adapte,Adapte / Adapte
4111,792,2019,Mathématique,12,7,QCU,105,104,74,30,1.01,71.15,74,31,70.13,Adapte,Adapte,Adapte / Adapte
4941,792,2020,Mathématique,12,7,QCU,116,96,84,12,1.21,87.5,84,32,72.69,Adapte,Adapte,Adapte / Adapte
792,793,2015,Mathématique,13,1,QCU,57,34,4,30,1.68,11.76,4,53,7.36,Adapte,Trop Difficile,Adapte / Trop Difficile
1622,793,2016,Mathématique,13,1,QCU,61,57,28,29,1.07,49.12,28,33,46.44,Difficile,Difficile,Difficile / Difficile
2452,793,2017,Mathématique,13,1,QCU,57,37,26,11,1.54,70.27,26,31,46.36,Difficile,Difficile,Difficile / Difficile
3282,793,2018,Mathématique,13,1,QCU,46,36,7,29,1.28,19.44,7,39,15.4,Difficile,Trop Difficile,Difficile / Trop Difficile
4112,793,2019,Mathématique,13,1,QCU,45,39,18,21,1.15,46.15,18,27,39.9,Difficile,Difficile,Difficile / Difficile
4942,793,2020,Mathématique,13,1,QCU,42,24,19,5,1.75,79.17,19,23,44.81,Difficile,Difficile,Difficile / Difficile
793,794,2015,Mathématique,13,2,QCM,19,18,18,0,1.06,100.0,18,1,92.17,Trop Facile,Trop Facile,Trop Facile / Trop Facile
1623,794,2016,Mathématique,13,2,QCM,17,9,6,3,1.89,66.67,6,11,35.95,Difficile,Difficile,Difficile / Difficile
2453,794,2017,Mathématique,13,2,QCM,18,12,6,6,1.5,50.0,6,12,34.8,Difficile,Difficile,Difficile / Difficile
3283,794,2018,Mathématique,13,2,QCM,18,10,9,1,1.8,90.0,9,9,47.91,Difficile,Difficile,Difficile / Difficile
4113,794,2019,Mathématique,13,2,QCM,21,15,13,2,1.4,86.67,13,8,60.07,Difficile,Adapte,Difficile / Adapte
4943,794,2020,Mathématique,13,2,QCM,23,18,15,3,1.28,83.33,15,8,63.74,Adapte,Adapte,Adapte / Adapte
794,795,2015,Mathématique,13,3,QROC,60,58,50,8,1.03,86.21,50,10,83.71,Facile,Facile,Facile / Facile
1624,795,2016,Mathématique,13,3,QROC,67,65,22,43,1.03,33.85,22,45,33.11,Difficile,Difficile,Difficile / Difficile
2454,795,2017,Mathématique,13,3,QROC,63,63,61,2,1.0,96.83,61,2,97.03,Difficile,Trop Facile,Difficile / Trop Facile
3284,795,2018,Mathématique,13,3,QROC,69,60,54,6,1.15,90.0,54,15,78.16,Difficile,Facile,Difficile / Facile
4114,795,2019,Mathématique,13,3,QROC,80,51,35,16,1.57,68.63,35,45,43.9,Difficile,Difficile,Difficile / Difficile
4944,795,2020,Mathématique,13,3,QROC,73,72,22,50,1.01,30.56,22,51,30.76,Difficile,Difficile,Difficile / Difficile
795,796,2015,Mathématique,13,4,QO,71,60,26,34,1.18,43.33,26,45,35.98,Adapte,Difficile,Adapte / Difficile
1625,796,2016,Mathématique,13,4,QO,85,81,65,16,1.05,80.25,65,20,76.5,Trop Difficile,Facile,Trop Difficile / Facile
2455,796,2017,Mathématique,13,4,QO,76,76,70,6,1.0,92.11,70,6,92.76,Trop Difficile,Trop Facile,Trop Difficile / Trop Facile
3285,796,2018,Mathématique,13,4,QO,67,66,42,24,1.02,63.64,42,25,62.33,Trop Difficile,Adapte,Trop Difficile / Adapte
4115,796,2019,Mathématique,13,4,QO,61,49,39,10,1.24,79.59,39,22,63.26,Adapte,Adapte,Adapte / Adapte
4945,796,2020,Mathématique,13,4,QO,49,38,36,2,1.29,94.74,36,13,72.7,Adapte,Adapte,Adapte / Adapte
796,797,2015,Mathématique,13,5,QROC,82,82,5,77,1.0,6.1,5,77,6.55,Trop Difficile,Trop Difficile,Trop Difficile / Trop Difficile
1626,797,2016,Mathématique,13,5,QROC,74,43,39,4,1.72,90.7,39,35,52.41,Difficile,Difficile,Difficile / Difficile
2456,797,2017,Mathématique,13,5,QROC,69,68,35,33,1.01,51.47,35,34,51.08,Difficile,Difficile,Difficile / Difficile
3286,797,2018,Mathématique,13,5,QROC,66,33,30,3,2.0,90.91,30,36,44.96,Difficile,Difficile,Difficile / Difficile
4116,797,2019,Mathématique,13,5,QROC,62,61,41,20,1.02,67.21,41,21,65.95,Difficile,Adapte,Difficile / Adapte
4946,797,2020,Mathématique,13,5,QROC,54,37,33,4,1.46,89.19,33,21,61.2,Adapte,Adapte,Adapte / Adapte
797,798,2015,Mathématique,13,6,QCM,41,39,12,27,1.05,30.77,12,29,29.21,Facile,Difficile,Facile / Difficile
1627,798,2016,Mathématique,13,6,QCM,47,37,15,22,1.27,40.54,15,32,31.07,Difficile,Difficile,Difficile / Difficile
2457,798,2017,Mathématique,13,6,QCM,41,29,26,3,1.41,89.66,26,15,63.71,Difficile,Adapte,Difficile / Adapte
3287,798,2018,Mathématique,13,6,QCM,38,34,24,10,1.12,70.59,24,14,61.96,Adapte,Adapte,Adapte / Adapte
4117,798,2019,Mathématique,13,6,QCM,41,40,26,14,1.02,65.0,26,15,64.15,Adapte,Adapte,Adapte / Adapte
4947,798,2020,Mathématique,13,6,QCM,48,47,31,16,1.02,65.96,31,17,64.63,Adapte,Adapte,Adapte / Adapte
798,799,2015,Mathématique,13,7,QCU,65,61,61,0,1.07,100.0,61,4,93.16,Trop Facile,Trop Facile,Trop Facile / Trop Facile
1628,799,2016,Mathématique,13,7,QCU,71,37,2,35,1.92,5.41,2,69,2.37,Difficile,Trop Difficile,Difficile / Trop Difficile
2458,799,2017,Mathématique,13,7,QCU,78,57,28,29,1.37,49.12,28,50,36.35,Difficile,Difficile,Difficile / Difficile
3288,799,2018,Mathématique,13,7,QCU,80,77,22,55,1.04,28.57,22,58,27.92,Difficile,Difficile,Difficile / Difficile
4118,799,2019,Mathématique,13,7,QCU,73,38,26,12,1.92,68.42,26,47,35.17,Difficile,Difficile,Difficile / Difficile
4948,799,2020,Mathématique,13,7,QCU,72,67,64,3,1.07,95.52,64,8,88.29,Difficile,Trop Facile,Difficile / Trop Facile
799,800,2015,Mathématique,13,8,QCU,88,78,58,20,1.13,74.36,58,30,65.58,Adapte,Adapte,Adapte / Adapte
1629,800,2016,Mathématique,13,8,QCU,102,90,65,25,1.13,72.22,65,37,63.43,Adapte,Adapte,Adapte / Adapte
2459,800,2017,Mathématique,13,8,QCU,94,78,69,9,1.21,88.46,69,25,73.36,Adapte,Adapte,Adapte / Adapte
3289,800,2018,Mathématique,13,8,QCU,93,71,66,5,1.31,92.96,66,27,71.25,Adapte,Adapte,Adapte / Adapte
4119,800,2019,Mathématique,13,8,QCU,100,82,68,14,1.22,82.93,68,32,68.47,Adapte,Adapte,Adapte / Adapte
4949,800,2020,Mathématique,13,8,QCU,84,76,58,18,1.11,76.32,58,26,68.86,Adapte,Adapte,Adapte / Adapte
800,801,2015,Mathématique,13,9,QCU,22,22,20,2,1.0,90.91,20,2,90.58,Difficile,Trop Facile,Difficile / Trop Facile
1630,801,2016,Mathématique,13,9,QCU,23,9,3,6,2.56,33.33,3,20,14.67,Difficile,Trop Difficile,Difficile / Trop Difficile
2460,801,2017,Mathématique,13,9,QCU,28,27,27,0,1.04,100.0,27,1,95.63,Difficile,Trop Facile,Difficile / Trop Facile
3290,801,2018,Mathématique,13,9,QCU,26,22,11,11,1.18,50.0,11,15,42.36,Difficile,Difficile,Difficile / Difficile
4120,801,2019,Mathématique,13,9,QCU,21,10,8,2,2.1,80.0,8,13,39.24,Difficile,Difficile,Difficile / Difficile
4950,801,2020,Mathématique,13,9,QCU,25,14,13,1,1.79,92.86,13,12,53.57,Difficile,Difficile,Difficile / Difficile
801,802,2015,Mathématique,14,1,QCM,51,19,13,6,2.68,68.42,13,38,26.35,Difficile,Difficile,Difficile / Difficile
1631,802,2016,Mathématique,14,1,QCM,55,42,19,23,1.31,45.24,19,36,34.04,Difficile,Difficile,Difficile / Difficile
2461,802,2017,Mathématique,14,1,QCM,44,35,35,0,1.26,100.0,35,9,78.75,Difficile,Facile,Difficile / Facile
3291,802,2018,Mathématique,14,1,QCM,36,22,15,7,1.64,68.18,15,21,42.54,Difficile,Difficile,Difficile / Difficile
4121,802,2019,Mathématique,14,1,QCM,39,39,16,23,1.0,41.03,16,23,40.82,Difficile,Difficile,Difficile / Difficile
4951,802,2020,Mathématique,14,1,QCM,46,38,19,19,1.21,50.0,19,27,42.23,Difficile,Difficile,Difficile / Difficile
802,803,2015,Mathématique,14,2,QCU,87,83,73,10,1.05,87.95,73,14,83.96,Facile,Facile,Facile / Facile
1632,803,2016,Mathématique,14,2,QCU,103,63,39,24,1.63,61.9,39,64,37.73,Difficile,Difficile,Difficile / Difficile
2462,803,2017,Mathématique,14,2,QCU,116,72,42,30,1.61,58.33,42,74,36.52,Difficile,Difficile,Difficile / Difficile
3292,803,2018,Mathématique,14,2,QCU,135,74,3,71,1.82,4.05,3,132,2.17,Difficile,Trop Difficile,Difficile / Trop Difficile
4122,803,2019,Mathématique,14,2,QCU,116,94,31,63,1.23,32.98,31,85,26.49,Difficile,Difficile,Difficile / Difficile
4952,803,2020,Mathématique,14,2,QCU,126,70,30,40,1.8,42.86,30,96,23.86,Difficile,Trop Difficile,Difficile / Trop Difficile
803,804,2015,Mathématique,14,3,QCM,80,60,52,8,1.33,86.67,52,28,64.84,Trop Facile,Adapte,Trop Facile / Adapte
1633,804,2016,Mathématique,14,3,QCM,96,95,71,24,1.01,74.74,71,25,73.86,Adapte,Adapte,Adapte / Adapte
2463,804,2017,Mathématique,14,3,QCM,82,75,60,15,1.09,80.0,60,22,73.57,Adapte,Adapte,Adapte / Adapte
3293,804,2018,Mathématique,14,3,QCM,77,60,53,7,1.28,88.33,53,24,68.88,Adapte,Adapte,Adapte / Adapte
4123,804,2019,Mathématique,14,3,QCM,81,60,58,2,1.35,96.67,58,23,71.7,Adapte,Adapte,Adapte / Adapte
4953,804,2020,Mathématique,14,3,QCM,90,78,61,17,1.15,78.21,61,29,67.3,Adapte,Adapte,Adapte / Adapte
804,805,2015,Mathématique,14,4,QCU,18,16,16,0,1.12,100.0,16,2,90.0,Trop Facile,Trop Facile,Trop Facile / Trop Facile
1634,805,2016,Mathématique,14,4,QCU,19,13,10,3,1.46,76.92,10,9,53.14,Difficile,Difficile,Difficile / Difficile
2464,805,2017,Mathématique,14,4,QCU,18,14,14,0,1.29,100.0,14,4,79.17,Difficile,Facile,Difficile / Facile
3294,805,2018,Mathématique,14,4,QCU,16,15,13,2,1.07,86.67,13,3,82.99,Difficile,Facile,Difficile / Facile
4124,805,2019,Mathématique,14,4,QCU,17,16,14,2,1.06,87.5,14,3,82.48,Difficile,Facile,Difficile / Facile
4954,805,2020,Mathématique,14,4,QCU,15,12,6,6,1.25,50.0,6,9,36.79,Difficile,Difficile,Difficile / Difficile
805,806,2015,Mathématique,14,5,QROC,18,18,18,0,1.0,100.0,18,0,97.48,Difficile,Trop Facile,Difficile / Trop Facile
1635,806,2016,Mathématique,14,5,QROC,17,15,14,1,1.13,93.33,14,3,84.74,Difficile,Facile,Difficile / Facile
2465,806,2017,Mathématique,14,5,QROC,20,11,6,5,1.82,54.55,6,14,31.04,Difficile,Difficile,Difficile / Difficile
3295,806,2018,Mathématique,14,5,QROC,22,11,2,9,2.0,18.18,2,20,9.84,Difficile,Trop Difficile,Difficile / Trop Difficile
4125,806,2019,Mathématique,14,5,QROC,18,15,5,10,1.2,33.33,5,13,29.28,Difficile,Difficile,Difficile / Difficile
4955,806,2020,Mathématique,14,5,QROC,14,13,8,5,1.08,61.54,8,6,54.39,Difficile,Difficile,Difficile / Difficile
806,807,2015,Mathématique,14,6,QCU,88,84,41,43,1.05,48.81,41,47,46.47,Difficile,Difficile,Difficile / Difficile
1636,807,2016,Mathématique,14,6,QCU,72,64,41,23,1.12,64.06,41,31,57.21,Difficile,Difficile,Difficile / Difficile
2466,807,2017,Mathématique,14,6,QCU,84,63,49,14,1.33,77.78,49,35,58.1,Difficile,Difficile,Difficile / Difficile
3296,807,2018,Mathématique,14,6,QCU,78,76,22,54,1.03,28.95,22,56,27.67,Difficile,Difficile,Difficile / Difficile
4126,807,2019,Mathématique,14,6,QCU,62,58,47,11,1.07,81.03,47,15,76.24,Difficile,Facile,Difficile / Facile
4956,807,2020,Mathématique,14,6,QCU,59,44,43,1,1.34,97.73,43,16,73.28,Difficile,Adapte,Difficile / Adapte
807,808,2015,Mathématique,14,7,QCU,64,36,28,8,1.78,77.78,28,36,43.41,Difficile,Difficile,Difficile / Difficile
1637,808,2016,Mathématique,14,7,QCU,74,68,31,37,1.09,45.59,31,43,42.44,Difficile,Difficile,Difficile / Difficile
2467,808,2017,Mathématique,14,7,QCU,78,43,32,11,1.81,74.42,32,46,40.76,Difficile,Difficile,Difficile / Difficile
3297,808,2018,Mathématique,14,7,QCU,65,61,30,31,1.07,49.18,30,35,46.51,Difficile,Difficile,Difficile / Difficile
4127,808,2019,Mathématique,14,7,QCU,57,54,25,29,1.06,46.3,25,32,43.59,Difficile,Difficile,Difficile / Difficile
4957,808,2020,Mathématique,14,7,QCU,66,40,24,16,1.65,60.0,24,42,36.77,Difficile,Difficile,Difficile / Difficile
808,809,2015,Mathématique,14,8,QCU,6,6,5,1,1.0,83.33,5,1,76.93,Difficile,Facile,Difficile / Facile
1638,809,2016,Mathématique,14,8,QCU,7,7,3,4,1.0,42.86,3,4,41.88,Difficile,Difficile,Difficile / Difficile
2468,809,2017,Mathématique,14,8,QCU,8,3,3,0,2.67,100.0,3,5,36.3,Difficile,Difficile,Difficile / Difficile
3298,809,2018,Mathématique,14,8,QCU,8,7,3,4,1.14,42.86,3,5,36.53,Difficile,Difficile,Difficile / Difficile
4128,809,2019,Mathématique,14,8,QCU,7,6,5,1,1.17,83.33,5,2,76.21,Difficile,Facile,Difficile / Facile
4958,809,2020,Mathématique,14,8,QCU,6,2,1,1,3.0,50.0,1,5,23.41,Difficile,Trop Difficile,Difficile / Trop Difficile
809,810,2015,Mathématique,14,9,QCU,7,6,6,0,1.17,100.0,6,1,87.52,Difficile,Trop Facile,Difficile / Trop Facile
1639,810,2016,Mathématique,14,9,QCU,8,3,3,0,2.67,100.0,3,5,37.43,Difficile,Difficile,Difficile / Difficile
2469,810,2017,Mathématique,14,9,QCU,10,9,7,2,1.11,77.78,7,3,65.55,Difficile,Adapte,Difficile / Adapte
3299,810,2018,Mathématique,14,9,QCU,9,8,6,2,1.12,75.0,6,3,71.44,Adapte,Adapte,Adapte / Adapte
4129,810,2019,Mathématique,14,9,QCU,7,4,4,0,1.75,100.0,4,3,63.53,Adapte,Adapte,Adapte / Adapte
4959,810,2020,Mathématique,14,9,QCU,7,7,5,2,1.0,71.43,5,2,73.11,Adapte,Adapte,Adapte / Adapte
810,811,2015,Mathématique,15,1,QCM,32,16,1,15,2.0,6.25,1,31,3.35,Trop Difficile,Trop Difficile,Trop Difficile / Trop Difficile
1640,811,2016,Mathématique,15,1,QCM,29,26,26,0,1.12,100.0,26,3,88.39,Difficile,Trop Facile,Difficile / Trop Facile
2470,811,2017,Mathématique,15,1,QCM,35,32,1,31,1.09,3.12,1,34,2.22,Difficile,Trop Difficile,Difficile / Trop Difficile
3300,811,2018,Mathématique,15,1,QCM,29,15,11,4,1.93,73.33,11,18,37.4,Difficile,Difficile,Difficile / Difficile
4130,811,2019,Mathématique,15,1,QCM,28,27,24,3,1.04,88.89,24,4,87.39,Difficile,Trop Facile,Difficile / Trop Facile
4960,811,2020,Mathématique,15,1,QCM,34,18,4,14,1.89,22.22,4,30,11.19,Difficile,Trop Difficile,Difficile / Trop Difficile
811,812,2015,Mathématique,15,2,QCU,95,84,80,4,1.13,95.24,80,15,83.81,Facile,Facile,Facile / Facile
1641,812,2016,Mathématique,15,2,QCU,95,91,59,32,1.04,64.84,59,36,62.23,Difficile,Adapte,Difficile / Adapte
2471,812,2017,Mathématique,15,2,QCU,90,78,58,20,1.15,74.36,58,32,64.01,Adapte,Adapte,Adapte / Adapte
3301,812,2018,Mathématique,15,2,QCU,99,84,64,20,1.18,76.19,64,35,64.71,Adapte,Adapte,Adapte / Adapte
4131,812,2019,Mathématique,15,2,QCU,105,100,78,22,1.05,78.0,78,27,74.32,Adapte,Adapte,Adapte / Adapte
4961,812,2020,Mathématique,15,2,QCU,113,106,73,33,1.07,68.87,73,40,64.98,Adapte,Adapte,Adapte / Adapte
812,813,2015,Mathématique,15,3,QCM,13,13,12,1,1.0,92.31,12,1,90.93,Trop Difficile,Trop Facile,Trop Difficile / Trop Facile
1642,813,2016,Mathématique,15,3,QCM,15,8,8,0,1.88,100.0,8,7,55.61,Difficile,Difficile,Difficile / Difficile
2472,813,2017,Mathématique,15,3,QCM,18,17,15,2,1.06,88.24,15,3,84.04,Difficile,Facile,Difficile / Facile
3302,813,2018,Mathématique,15,3,QCM,15,12,12,0,1.25,100.0,12,3,78.48,Difficile,Facile,Difficile / Facile
4132,813,2019,Mathématique,15,3,QCM,17,16,6,10,1.06,37.5,6,11,35.83,Difficile,Difficile,Difficile / Difficile
4962,813,2020,Mathématique,15,3,QCM,16,15,9,6,1.07,60.0,9,7,57.89,Difficile,Difficile,Difficile / Difficile
813,814,2015,Mathématique,15,4,QCU,33,27,2,25,1.22,7.41,2,31,5.22,Trop Difficile,Trop Difficile,Trop Difficile / Trop Difficile
1643,814,2016,Mathématique,15,4,QCU,37,33,33,0,1.12,100.0,33,4,89.3,Difficile,Trop Facile,Difficile / Trop Facile
2473,814,2017,Mathématique,15,4,QCU,38,24,13,11,1.58,54.17,13,25,35.33,Difficile,Difficile,Difficile / Difficile
3303,814,2018,Mathématique,15,4,QCU,32,30,15,15,1.07,50.0,15,17,46.37,Difficile,Difficile,Difficile / Difficile
4133,814,2019,Mathématique,15,4,QCU,33,20,19,1,1.65,95.0,19,14,56.67,Difficile,Difficile,Difficile / Difficile
4963,814,2020,Mathématique,15,4,QCU,34,28,14,14,1.21,50.0,14,20,41.51,Difficile,Difficile,Difficile / Difficile
814,815,2015,Mathématique,15,5,QCM,67,63,56,7,1.06,88.89,56,11,83.74,Difficile,Facile,Difficile / Facile
1644,815,2016,Mathématique,15,5,QCM,61,52,49,3,1.17,94.23,49,12,79.96,Difficile,Facile,Difficile / Facile
2474,815,2017,Mathématique,15,5,QCM,49,44,28,16,1.11,63.64,28,21,56.43,Difficile,Difficile,Difficile / Difficile
3304,815,2018,Mathématique,15,5,QCM,43,42,13,29,1.02,30.95,13,30,30.89,Difficile,Difficile,Difficile / Difficile
4134,815,2019,Mathématique,15,5,QCM,47,41,28,13,1.15,68.29,28,19,58.72,Difficile,Difficile,Difficile / Difficile
4964,815,2020,Mathématique,15,5,QCM,38,24,20,4,1.58,83.33,20,18,52.01,Difficile,Difficile,Difficile / Difficile
815,816,2015,Mathématique,16,1,QCU,90,85,72,13,1.06,84.71,72,18,79.65,Facile,Facile,Facile / Facile
1645,816,2016,Mathématique,16,1,QCU,80,52,46,6,1.54,88.46,46,34,57.37,Difficile,Difficile,Difficile / Difficile
2475,816,2017,Mathématique,16,1,QCU,68,42,19,23,1.62,45.24,19,49,28.58,Difficile,Difficile,Difficile / Difficile
3305,816,2018,Mathématique,16,1,QCU,79,67,67,0,1.18,100.0,67,12,84.3,Difficile,Facile,Difficile / Facile
4135,816,2019,Mathématique,16,1,QCU,88,72,6,66,1.22,8.33,6,82,6.43,Difficile,Trop Difficile,Difficile / Trop Difficile
4965,816,2020,Mathématique,16,1,QCU,84,65,46,19,1.29,70.77,46,38,55.22,Difficile,Difficile,Difficile / Difficile
816,817,2015,Mathématique,16,2,QCU,57,57,57,0,1.0,100.0,57,0,99.86,Trop Facile,Trop Facile,Trop Facile / Trop Facile
1646,817,2016,Mathématique,16,2,QCU,63,29,0,29,2.17,0.0,0,63,0.55,Difficile,Trop Difficile,Difficile / Trop Difficile
2476,817,2017,Mathématique,16,2,QCU,67,65,18,47,1.03,27.69,18,49,26.32,Difficile,Difficile,Difficile / Difficile
3306,817,2018,Mathématique,16,2,QCU,65,29,17,12,2.24,58.62,17,48,26.61,Difficile,Difficile,Difficile / Difficile
4136,817,2019,Mathématique,16,2,QCU,78,29,3,26,2.69,10.34,3,75,3.48,Difficile,Trop Difficile,Difficile / Trop Difficile
4966,817,2020,Mathématique,16,2,QCU,91,63,43,20,1.44,68.25,43,48,47.25,Difficile,Difficile,Difficile / Difficile
817,818,2015,Mathématique,16,3,QROC,100,68,67,1,1.47,98.53,67,33,67.3,Adapte,Adapte,Adapte / Adapte
1647,818,2016,Mathématique,16,3,QROC,110,80,79,1,1.38,98.75,79,31,72.03,Adapte,Adapte,Adapte / Adapte
2477,818,2017,Mathématique,16,3,QROC,112,111,74,37,1.01,66.67,74,38,66.23,Adapte,Adapte,Adapte / Adapte
3307,818,2018,Mathématique,16,3,QROC,103,72,65,7,1.43,90.28,65,38,63.21,Adapte,Adapte,Adapte / Adapte
4137,818,2019,Mathématique,16,3,QROC,94,69,63,6,1.36,91.3,63,31,66.94,Adapte,Adapte,Adapte / Adapte
4967,818,2020,Mathématique,16,3,QROC,93,58,57,1,1.6,98.28,57,36,61.51,Adapte,Adapte,Adapte / Adapte
818,819,2015,Mathématique,16,4,QCU,91,53,40,13,1.72,75.47,40,51,44.36,Difficile,Difficile,Difficile / Difficile
1648,819,2016,Mathématique,16,4,QCU,94,88,3,85,1.07,3.41,3,91,2.69,Difficile,Trop Difficile,Difficile / Trop Difficile
2478,819,2017,Mathématique,16,4,QCU,109,81,69,12,1.35,85.19,69,40,62.93,Difficile,Adapte,Difficile / Adapte
3308,819,2018,Mathématique,16,4,QCU,130,94,90,4,1.38,95.74,90,40,69.12,Adapte,Adapte,Adapte / Adapte
4138,819,2019,Mathématique,16,4,QCU,150,110,91,19,1.36,82.73,91,59,60.87,Adapte,Adapte,Adapte / Adapte
4968,819,2020,Mathématique,16,4,QCU,135,123,98,25,1.1,79.67,98,37,72.95,Adapte,Adapte,Adapte / Adapte
819,820,2015,Mathématique,16,5,QCU,49,23,17,6,2.13,73.91,17,32,35.26,Facile,Difficile,Facile / Difficile
1649,820,2016,Mathématique,16,5,QCU,59,51,31,20,1.16,60.78,31,28,53.22,Difficile,Difficile,Difficile / Difficile
2479,820,2017,Mathématique,16,5,QCU,63,56,33,23,1.12,58.93,33,30,53.1,Difficile,Difficile,Difficile / Difficile
3309,820,2018,Mathématique,16,5,QCU,61,58,35,23,1.05,60.34,35,26,58.04,Difficile,Difficile,Difficile / Difficile
4139,820,2019,Mathématique,16,5,QCU,50,41,21,20,1.22,51.22,21,29,42.47,Difficile,Difficile,Difficile / Difficile
4969,820,2020,Mathématique,16,5,QCU,51,46,36,10,1.11,78.26,36,15,70.86,Difficile,Adapte,Difficile / Adapte
820,821,2015,Mathématique,16,6,QCM,82,21,18,3,3.9,85.71,18,64,22.03,Trop Difficile,Trop Difficile,Trop Difficile / Trop Difficile
1650,821,2016,Mathématique,16,6,QCM,74,47,40,7,1.57,85.11,40,34,53.49,Difficile,Difficile,Difficile / Difficile
2480,821,2017,Mathématique,16,6,QCM,85,81,76,5,1.05,93.83,76,9,89.51,Difficile,Trop Facile,Difficile / Trop Facile
3310,821,2018,Mathématique,16,6,QCM,68,61,34,27,1.11,55.74,34,34,49.29,Difficile,Difficile,Difficile / Difficile
4140,821,2019,Mathématique,16,6,QCM,71,59,37,22,1.2,62.71,37,34,52.28,Difficile,Difficile,Difficile / Difficile
4970,821,2020,Mathématique,16,6,QCM,67,37,30,7,1.81,81.08,30,37,44.74,Difficile,Difficile,Difficile / Difficile
821,822,2015,Mathématique,17,1,QCU,89,82,45,37,1.09,54.88,45,44,50.19,Difficile,Difficile,Difficile / Difficile
1651,822,2016,Mathématique,17,1,QCU,82,38,23,15,2.16,60.53,23,59,28.15,Difficile,Difficile,Difficile / Difficile
2481,822,2017,Mathématique,17,1,QCU,66,24,23,1,2.75,95.83,23,43,35.38,Difficile,Difficile,Difficile / Difficile
3311,822,2018,Mathématique,17,1,QCU,58,56,25,31,1.04,44.64,25,33,43.04,Difficile,Difficile,Difficile / Difficile
4141,822,2019,Mathématique,17,1,QCU,51,34,15,19,1.5,44.12,15,36,28.65,Difficile,Difficile,Difficile / Difficile
4971,822,2020,Mathématique,17,1,QCU,53,49,22,27,1.08,44.9,22,31,42.16,Difficile,Difficile,Difficile / Difficile
822,823,2015,Mathématique,17,2,QCU,78,72,60,12,1.08,83.33,60,18,77.53,Difficile,Facile,Difficile / Facile
1652,823,2016,Mathématique,17,2,QCU,84,65,49,16,1.29,75.38,49,35,58.87,Difficile,Difficile,Difficile / Difficile
2482,823,2017,Mathématique,17,2,QCU,90,84,60,24,1.07,71.43,60,30,66.34,Difficile,Adapte,Difficile / Adapte
3312,823,2018,Mathématique,17,2,QCU,83,64,58,6,1.3,90.62,58,25,69.47,Adapte,Adapte,Adapte / Adapte
4142,823,2019,Mathématique,17,2,QCU,90,89,66,23,1.01,74.16,66,24,72.8,Adapte,Adapte,Adapte / Adapte
4972,823,2020,Mathématique,17,2,QCU,97,96,67,29,1.01,69.79,67,30,68.62,Adapte,Adapte,Adapte / Adapte
823,824,2015,Mathématique,17,3,QCU,59,56,48,8,1.05,85.71,48,11,80.63,Facile,Facile,Facile / Facile
1653,824,2016,Mathématique,17,3,QCU,58,57,33,24,1.02,57.89,33,25,57.62,Difficile,Difficile,Difficile / Difficile
2483,824,2017,Mathématique,17,3,QCU,61,54,2,52,1.13,3.7,2,59,2.49,Difficile,Trop Difficile,Difficile / Trop Difficile
3313,824,2018,Mathématique,17,3,QCU,70,58,2,56,1.21,3.45,2,68,2.78,Difficile,Trop Difficile,Difficile / Trop Difficile
4143,824,2019,Mathématique,17,3,QCU,58,36,17,19,1.61,47.22,17,41,29.98,Difficile,Difficile,Difficile / Difficile
4973,824,2020,Mathématique,17,3,QCU,53,35,30,5,1.51,85.71,30,23,57.01,Difficile,Difficile,Difficile / Difficile
824,825,2015,Mathématique,17,4,QCU,14,13,10,3,1.08,76.92,10,4,71.29,Adapte,Adapte,Adapte / Adapte
1654,825,2016,Mathématique,17,4,QCU,15,11,9,2,1.36,81.82,9,6,60.13,Adapte,Adapte,Adapte / Adapte
2484,825,2017,Mathématique,17,4,QCU,13,10,8,2,1.3,80.0,8,5,62.93,Adapte,Adapte,Adapte / Adapte
3314,825,2018,Mathématique,17,4,QCU,14,11,9,2,1.27,81.82,9,5,62.66,Adapte,Adapte,Adapte / Adapte
4144,825,2019,Mathématique,17,4,QCU,17,16,12,4,1.06,75.0,12,5,72.55,Adapte,Adapte,Adapte / Adapte
4974,825,2020,Mathématique,17,4,QCU,17,13,11,2,1.31,84.62,11,6,62.73,Adapte,Adapte,Adapte / Adapte
825,826,2015,Mathématique,17,5,QCM,9,9,9,0,1.0,100.0,9,0,94.45,Trop Facile,Trop Facile,Trop Facile / Trop Facile
1655,826,2016,Mathématique,17,5,QCM,7,4,2,2,1.75,50.0,2,5,29.48,Difficile,Difficile,Difficile / Difficile
2485,826,2017,Mathématique,17,5,QCM,8,4,3,1,2.0,75.0,3,5,36.61,Difficile,Difficile,Difficile / Difficile
3315,826,2018,Mathématique,17,5,QCM,6,3,1,2,2.0,33.33,1,5,19.86,Difficile,Trop Difficile,Difficile / Trop Difficile
4145,826,2019,Mathématique,17,5,QCM,7,2,1,1,3.5,50.0,1,6,13.38,Difficile,Trop Difficile,Difficile / Trop Difficile
4975,826,2020,Mathématique,17,5,QCM,7,6,6,0,1.17,100.0,6,1,81.96,Difficile,Facile,Difficile / Facile
826,827,2015,Mathématique,17,6,QCU,65,60,53,7,1.08,88.33,53,12,81.92,Trop Difficile,Facile,Trop Difficile / Facile
1656,827,2016,Mathématique,17,6,QCU,70,48,35,13,1.46,72.92,35,35,49.45,Difficile,Difficile,Difficile / Difficile
2486,827,2017,Mathématique,17,6,QCU,63,57,52,5,1.11,91.23,52,11,82.93,Difficile,Facile,Difficile / Facile
3316,827,2018,Mathématique,17,6,QCU,61,30,16,14,2.03,53.33,16,45,26.97,Difficile,Difficile,Difficile / Difficile
4146,827,2019,Mathématique,17,6,QCU,65,39,19,20,1.67,48.72,19,46,29.94,Difficile,Difficile,Difficile / Difficile
4976,827,2020,Mathématique,17,6,QCU,71,61,59,2,1.16,96.72,59,12,83.26,Difficile,Facile,Difficile / Facile
827,828,2015,Mathématique,18,1,QROC,17,13,5,8,1.31,38.46,5,12,27.0,Difficile,Difficile,Difficile / Difficile
1657,828,2016,Mathématique,18,1,QROC,16,15,9,6,1.07,60.0,9,7,54.69,Difficile,Difficile,Difficile / Difficile
2487,828,2017,Mathématique,18,1,QROC,13,8,2,6,1.62,25.0,2,11,12.25,Difficile,Trop Difficile,Difficile / Trop Difficile
3317,828,2018,Mathématique,18,1,QROC,16,12,6,6,1.33,50.0,6,10,38.63,Difficile,Difficile,Difficile / Difficile
4147,828,2019,Mathématique,18,1,QROC,16,14,9,5,1.14,64.29,9,7,56.33,Difficile,Difficile,Difficile / Difficile
4977,828,2020,Mathématique,18,1,QROC,16,14,7,7,1.14,50.0,7,9,45.37,Difficile,Difficile,Difficile / Difficile
828,829,2015,Mathématique,18,2,QCU,82,81,50,31,1.01,61.73,50,32,60.98,Difficile,Adapte,Difficile / Adapte
1658,829,2016,Mathématique,18,2,QCU,87,83,65,18,1.05,78.31,65,22,74.59,Adapte,Adapte,Adapte / Adapte
2488,829,2017,Mathématique,18,2,QCU,85,85,60,25,1.0,70.59,60,25,70.73,Adapte,Adapte,Adapte / Adapte
3318,829,2018,Mathématique,18,2,QCU,88,79,55,24,1.11,69.62,55,33,62.91,Adapte,Adapte,Adapte / Adapte
4148,829,2019,Mathématique,18,2,QCU,88,61,56,5,1.44,91.8,56,32,63.37,Adapte,Adapte,Adapte / Adapte
4978,829,2020,Mathématique,18,2,QCU,85,83,57,26,1.02,68.67,57,28,67.43,Adapte,Adapte,Adapte / Adapte
829,830,2015,Mathématique,19,1,QCU,26,24,23,1,1.08,95.83,23,3,88.02,Difficile,Trop Facile,Difficile / Trop Facile
1659,830,2016,Mathématique,19,1,QCU,30,13,9,4,2.31,69.23,9,21,30.16,Difficile,Difficile,Difficile / Difficile
2489,830,2017,Mathématique,19,1,QCU,29,16,15,1,1.81,93.75,15,14,50.95,Difficile,Difficile,Difficile / Difficile
3319,830,2018,Mathématique,19,1,QCU,24,16,12,4,1.5,75.0,12,12,51.47,Difficile,Difficile,Difficile / Difficile
4149,830,2019,Mathématique,19,1,QCU,26,20,12,8,1.3,60.0,12,14,46.59,Difficile,Difficile,Difficile / Difficile
4979,830,2020,Mathématique,19,1,QCU,31,18,12,6,1.72,66.67,12,19,38.65,Difficile,Difficile,Difficile / Difficile
