,Quizz_ID,Year,Departement,Chapter_ID,Rank_onChapter,Quizz_Type,B,Slip,Guess,Number_Attempts,UniQ_Learner,Sucessful_Learners,Unsucessful_Learners,Avg_Attempts,Percent_Learners_Success,Success_Attempts,Failure_Attempts,TruePrct_Succes,Predict_Difficulty,Correct_Difficulty,Prediction/Correct Difficulty
0,1,2015,Ingenieurie,1,1,QCU,0.7459,0.22,0.51,61,58,45,13,1.05,77.59,45,16,74.59,Trop Difficile,Adapte,Trop Difficile / Adapte
830,1,2016,Ingenieurie,1,1,QCU,0.6831,0.16,0.61,69,69,47,22,1.0,68.12,47,22,68.31,Adapte,Adapte,Adapte / Adapte
1660,1,2017,Ingenieurie,1,1,QCU,0.7167,0.13,0.53,67,53,48,5,1.26,90.57,48,19,71.67,Adapte,Adapte,Adapte / Adapte
2490,1,2018,Ingenieurie,1,1,QCU,0.7055,0.19,0.42,60,55,42,13,1.09,76.36,42,18,70.55,Adapte,Adapte,Adapte / Adapte
3320,1,2019,Ingenieurie,1,1,QCU,0.6466,0.14,0.63,51,44,33,11,1.16,75.0,33,18,64.66,Adapte,Adapte,Adapte / Adapte
4150,1,2020,Ingenieurie,1,1,QCU,0.6096,0.08,0.48,49,48,30,18,1.02,62.5,30,19,60.96,Adapte,Adapte,Adapte / Adapte
1,2,2015,Ingenieurie,1,2,QCU,0.705,0.3,0.68,62,48,44,4,1.29,91.67,44,18,70.5,Adapte,Adapte,Adapte / Adapte
831,2,2016,Ingenieurie,1,2,QCU,0.6519,0.21,0.47,54,40,35,5,1.35,87.5,35,19,65.19,Adapte,Adapte,Adapte / Adapte
1661,2,2017,Ingenieurie,1,2,QCU,0.7241,0.19,0.57,43,37,31,6,1.16,83.78,31,12,72.41,Adapte,Adapte,Adapte / Adapte
2491,2,2018,Ingenieurie,1,2,QCU,0.7288,0.12,0.54,39,38,28,10,1.03,73.68,28,11,72.88,Adapte,Adapte,Adapte / Adapte
3321,2,2019,Ingenieurie,1,2,QCU,0.7144,0.29,0.68,33,31,24,7,1.06,77.42,24,9,71.44,Adapte,Adapte,Adapte / Adapte
4151,2,2020,Ingenieurie,1,2,QCU,0.7476,0.06,0.6,30,26,22,4,1.15,84.62,22,8,74.76,Adapte,Adapte,Adapte / Adapte
2,3,2015,Ingenieurie,1,3,QCU,0.4043,0.18,0.36,9,5,4,1,1.8,80.0,4,5,40.43,Difficile,Difficile,Difficile / Difficile
832,3,2016,Ingenieurie,1,3,QCU,0.9865,0.1,0.97,11,11,11,0,1.0,100.0,11,0,98.65,Trop Facile,Trop Facile,Trop Facile / Trop Facile
1662,3,2017,Ingenieurie,1,3,QCU,0.8269,0.06,0.82,13,12,11,1,1.08,91.67,11,2,82.69,Trop Facile,Facile,Trop Facile / Facile
2492,3,2018,Ingenieurie,1,3,QCU,0.9241,0.07,0.99,12,12,11,1,1.0,91.67,11,1,92.41,Trop Facile,Trop Facile,Trop Facile / Trop Facile
3322,3,2019,Ingenieurie,1,3,QCU,0.6737,0.29,0.4,11,10,7,3,1.1,70.0,7,4,67.37,Trop Facile,Adapte,Trop Facile / Adapte
4152,3,2020,Ingenieurie,1,3,QCU,0.6362,0.09,0.45,12,9,8,1,1.33,88.89,8,4,63.62,Adapte,Adapte,Adapte / Adapte
3,4,2015,Ingenieurie,1,4,QCU,0.7942,0.1,0.86,7,7,6,1,1.0,85.71,6,1,79.42,Facile,Facile,Facile / Facile
833,4,2016,Ingenieurie,1,4,QCU,0.9986,0.02,0.98,7,7,7,0,1.0,100.0,7,0,99.86,Trop Facile,Trop Facile,Trop Facile / Trop Facile
1663,4,2017,Ingenieurie,1,4,QCU,0.5068,0.15,0.36,6,4,3,1,1.5,75.0,3,3,50.68,Trop Facile,Difficile,Trop Facile / Difficile
2493,4,2018,Ingenieurie,1,4,QCU,0.7952,0.16,0.87,5,4,4,0,1.25,100.0,4,1,79.52,Trop Facile,Facile,Trop Facile / Facile
3323,4,2019,Ingenieurie,1,4,QCU,0.8719,0.09,0.99,4,4,3,1,1.0,75.0,3,1,87.19,Trop Facile,Trop Facile,Trop Facile / Trop Facile
4153,4,2020,Ingenieurie,1,4,QCU,0.6583,0.07,0.49,4,4,3,1,1.0,75.0,3,1,65.83,Trop Facile,Adapte,Trop Facile / Adapte
4,5,2015,Ingenieurie,1,5,QCM,0.1858,0.66,0.25,46,45,9,36,1.02,20.0,9,37,18.58,Trop Difficile,Trop Difficile,Trop Difficile / Trop Difficile
834,5,2016,Ingenieurie,1,5,QCM,0.0241,0.31,0.23,48,30,1,29,1.6,3.33,1,47,2.41,Trop Facile,Trop Difficile,Trop Facile / Trop Difficile
1664,5,2017,Ingenieurie,1,5,QCM,0.9043,0.01,0.99,46,45,42,3,1.02,93.33,42,4,90.43,Trop Facile,Trop Facile,Trop Facile / Trop Facile
2494,5,2018,Ingenieurie,1,5,QCM,0.8673,0.09,0.82,51,49,44,5,1.04,89.8,44,7,86.73,Trop Facile,Trop Facile,Trop Facile / Trop Facile
3324,5,2019,Ingenieurie,1,5,QCM,0.9647,0.05,0.84,52,50,50,0,1.04,100.0,50,2,96.47,Trop Facile,Trop Facile,Trop Facile / Trop Facile
4154,5,2020,Ingenieurie,1,5,QCM,0.8827,0.1,0.86,44,41,39,2,1.07,95.12,39,5,88.27,Trop Facile,Trop Facile,Trop Facile / Trop Facile
5,6,2015,Ingenieurie,1,6,QCU,0.747,0.07,0.47,93,86,69,17,1.08,80.23,69,24,74.7,Facile,Adapte,Facile / Adapte
835,6,2016,Ingenieurie,1,6,QCU,0.7019,0.24,0.64,105,96,74,22,1.09,77.08,74,31,70.19,Adapte,Adapte,Adapte / Adapte
1665,6,2017,Ingenieurie,1,6,QCU,0.7221,0.07,0.69,118,111,85,26,1.06,76.58,85,33,72.21,Adapte,Adapte,Adapte / Adapte
2495,6,2018,Ingenieurie,1,6,QCU,0.6275,0.03,0.56,101,67,63,4,1.51,94.03,63,38,62.75,Adapte,Adapte,Adapte / Adapte
3325,6,2019,Ingenieurie,1,6,QCU,0.622,0.22,0.46,97,75,60,15,1.29,80.0,60,37,62.2,Adapte,Adapte,Adapte / Adapte
4155,6,2020,Ingenieurie,1,6,QCU,0.6548,0.28,0.41,105,71,69,2,1.48,97.18,69,36,65.48,Adapte,Adapte,Adapte / Adapte
6,7,2015,Ingenieurie,1,7,QROC,0.4077,0.7,0.24,63,51,26,25,1.24,50.98,26,37,40.77,Difficile,Difficile,Difficile / Difficile
836,7,2016,Ingenieurie,1,7,QROC,0.9972,0.03,0.57,53,53,53,0,1.0,100.0,53,0,99.72,Trop Facile,Trop Facile,Trop Facile / Trop Facile
1666,7,2017,Ingenieurie,1,7,QROC,0.9,0.09,0.64,46,42,41,1,1.1,97.62,41,5,90.0,Trop Facile,Trop Facile,Trop Facile / Trop Facile
2496,7,2018,Ingenieurie,1,7,QROC,0.9229,0.09,0.74,50,47,46,1,1.06,97.87,46,4,92.29,Trop Facile,Trop Facile,Trop Facile / Trop Facile
3326,7,2019,Ingenieurie,1,7,QROC,0.9711,0.0,0.61,55,55,53,2,1.0,96.36,53,2,97.11,Trop Facile,Trop Facile,Trop Facile / Trop Facile
4156,7,2020,Ingenieurie,1,7,QROC,0.9675,0.09,0.74,51,50,49,1,1.02,98.0,49,2,96.75,Trop Facile,Trop Facile,Trop Facile / Trop Facile
7,8,2015,Ingenieurie,1,8,QCU,0.0861,0.08,0.28,47,40,4,36,1.18,10.0,4,43,8.61,Trop Difficile,Trop Difficile,Trop Difficile / Trop Difficile
837,8,2016,Ingenieurie,1,8,QCU,0.9565,0.02,0.97,47,46,45,1,1.02,97.83,45,2,95.65,Trop Facile,Trop Facile,Trop Facile / Trop Facile
1667,8,2017,Ingenieurie,1,8,QCU,0.9426,0.06,0.94,51,49,48,1,1.04,97.96,48,3,94.26,Trop Facile,Trop Facile,Trop Facile / Trop Facile
2497,8,2018,Ingenieurie,1,8,QCU,0.9626,0.08,0.95,42,41,40,1,1.02,97.56,40,2,96.26,Trop Facile,Trop Facile,Trop Facile / Trop Facile
3327,8,2019,Ingenieurie,1,8,QCU,0.7062,0.06,0.62,43,31,30,1,1.39,96.77,30,13,70.62,Trop Facile,Adapte,Trop Facile / Adapte
4157,8,2020,Ingenieurie,1,8,QCU,0.6254,0.29,0.58,45,31,28,3,1.45,90.32,28,17,62.54,Adapte,Adapte,Adapte / Adapte
8,9,2015,Ingenieurie,1,9,QCU,0.6104,0.25,0.56,78,66,48,18,1.18,72.73,48,30,61.04,Trop Facile,Adapte,Trop Facile / Adapte
838,9,2016,Ingenieurie,1,9,QCU,0.7269,0.14,0.66,94,81,68,13,1.16,83.95,68,26,72.69,Adapte,Adapte,Adapte / Adapte
1668,9,2017,Ingenieurie,1,9,QCU,0.627,0.13,0.56,108,84,68,16,1.29,80.95,68,40,62.7,Adapte,Adapte,Adapte / Adapte
2498,9,2018,Ingenieurie,1,9,QCU,0.7039,0.24,0.42,109,81,77,4,1.35,95.06,77,32,70.39,Adapte,Adapte,Adapte / Adapte
3328,9,2019,Ingenieurie,1,9,QCU,0.6759,0.0,0.47,119,90,80,10,1.32,88.89,80,39,67.59,Adapte,Adapte,Adapte / Adapte
4158,9,2020,Ingenieurie,1,9,QCU,0.6428,0.21,0.68,97,95,62,33,1.02,65.26,62,35,64.28,Adapte,Adapte,Adapte / Adapte
9,10,2015,Ingenieurie,2,1,QCU,0.6747,0.09,0.42,7,5,5,0,1.4,100.0,5,2,67.47,Trop Facile,Adapte,Trop Facile / Adapte
839,10,2016,Ingenieurie,2,1,QCU,0.6684,0.21,0.47,8,6,5,1,1.33,83.33,5,3,66.84,Adapte,Adapte,Adapte / Adapte
1669,10,2017,Ingenieurie,2,1,QCU,0.7454,0.14,0.57,9,7,7,0,1.29,100.0,7,2,74.54,Adapte,Adapte,Adapte / Adapte
2499,10,2018,Ingenieurie,2,1,QCU,0.6476,0.15,0.45,8,5,5,0,1.6,100.0,5,3,64.76,Adapte,Adapte,Adapte / Adapte
3329,10,2019,Ingenieurie,2,1,QCU,0.6666,0.26,0.49,9,8,6,2,1.12,75.0,6,3,66.66,Adapte,Adapte,Adapte / Adapte
4159,10,2020,Ingenieurie,2,1,QCU,0.6495,0.03,0.48,7,5,5,0,1.4,100.0,5,2,64.95,Adapte,Adapte,Adapte / Adapte
10,11,2015,Ingenieurie,2,2,QO,0.4741,0.78,0.15,71,62,34,28,1.15,54.84,34,37,47.41,Difficile,Difficile,Difficile / Difficile
840,11,2016,Ingenieurie,2,2,QO,0.896,0.0,0.86,69,63,62,1,1.1,98.41,62,7,89.6,Trop Facile,Trop Facile,Trop Facile / Trop Facile
1670,11,2017,Ingenieurie,2,2,QO,0.9041,0.05,0.69,74,70,67,3,1.06,95.71,67,7,90.41,Trop Facile,Trop Facile,Trop Facile / Trop Facile
2500,11,2018,Ingenieurie,2,2,QO,0.802,0.16,0.51,67,58,54,4,1.16,93.1,54,13,80.2,Trop Facile,Facile,Trop Facile / Facile
3330,11,2019,Ingenieurie,2,2,QO,0.9324,0.08,1.0,70,70,65,5,1.0,92.86,65,5,93.24,Trop Facile,Trop Facile,Trop Facile / Trop Facile
4160,11,2020,Ingenieurie,2,2,QO,0.9338,0.07,0.95,82,80,77,3,1.02,96.25,77,5,93.38,Trop Facile,Trop Facile,Trop Facile / Trop Facile
11,12,2015,Ingenieurie,2,3,QCM,0.9733,0.08,0.9,22,22,21,1,1.0,95.45,21,1,97.33,Difficile,Trop Facile,Difficile / Trop Facile
841,12,2016,Ingenieurie,2,3,QCM,0.8944,0.03,0.89,20,19,18,1,1.05,94.74,18,2,89.44,Trop Facile,Trop Facile,Trop Facile / Trop Facile
1671,12,2017,Ingenieurie,2,3,QCM,0.9321,0.06,0.85,20,19,19,0,1.05,100.0,19,1,93.21,Trop Facile,Trop Facile,Trop Facile / Trop Facile
2501,12,2018,Ingenieurie,2,3,QCM,0.8997,0.02,0.91,24,23,22,1,1.04,95.65,22,2,89.97,Trop Facile,Trop Facile,Trop Facile / Trop Facile
3331,12,2019,Ingenieurie,2,3,QCM,0.9168,0.1,0.97,21,20,19,1,1.05,95.0,19,2,91.68,Trop Facile,Trop Facile,Trop Facile / Trop Facile
4161,12,2020,Ingenieurie,2,3,QCM,0.8968,0.05,0.85,22,21,20,1,1.05,95.24,20,2,89.68,Trop Facile,Trop Facile,Trop Facile / Trop Facile
12,13,2015,Ingenieurie,2,4,QCU,0.9586,0.09,0.97,58,56,56,0,1.04,100.0,56,2,95.86,Trop Facile,Trop Facile,Trop Facile / Trop Facile
842,13,2016,Ingenieurie,2,4,QCU,0.9712,0.05,0.93,51,50,50,0,1.02,100.0,50,1,97.12,Trop Facile,Trop Facile,Trop Facile / Trop Facile
1672,13,2017,Ingenieurie,2,4,QCU,0.9418,0.09,0.94,54,53,51,2,1.02,96.23,51,3,94.18,Trop Facile,Trop Facile,Trop Facile / Trop Facile
2502,13,2018,Ingenieurie,2,4,QCU,0.7976,0.13,0.76,65,55,52,3,1.18,94.55,52,13,79.76,Trop Facile,Facile,Trop Facile / Facile
3332,13,2019,Ingenieurie,2,4,QCU,0.9216,0.08,0.98,72,69,66,3,1.04,95.65,66,6,92.16,Trop Facile,Trop Facile,Trop Facile / Trop Facile
4162,13,2020,Ingenieurie,2,4,QCU,0.6325,0.13,0.43,83,69,52,17,1.2,75.36,52,31,63.25,Trop Facile,Adapte,Trop Facile / Adapte
13,14,2015,Ingenieurie,2,5,QCU,0.9038,0.04,0.95,39,38,35,3,1.03,92.11,35,4,90.38,Trop Difficile,Trop Facile,Trop Difficile / Trop Facile
843,14,2016,Ingenieurie,2,5,QCU,0.9799,0.05,0.93,32,32,31,1,1.0,96.88,31,1,97.99,Trop Facile,Trop Facile,Trop Facile / Trop Facile
1673,14,2017,Ingenieurie,2,5,QCU,0.0142,0.67,0.21,30,22,0,22,1.36,0.0,0,30,1.42,Trop Facile,Trop Difficile,Trop Facile / Trop Difficile
2503,14,2018,Ingenieurie,2,5,QCU,0.9576,0.08,0.91,27,27,26,1,1.0,96.3,26,1,95.76,Trop Facile,Trop Facile,Trop Facile / Trop Facile
3333,14,2019,Ingenieurie,2,5,QCU,0.9236,0.03,0.97,27,25,25,0,1.08,100.0,25,2,92.36,Trop Facile,Trop Facile,Trop Facile / Trop Facile
4163,14,2020,Ingenieurie,2,5,QCU,0.3134,0.33,0.3,32,23,10,13,1.39,43.48,10,22,31.34,Trop Facile,Difficile,Trop Facile / Difficile
14,15,2015,Ingenieurie,2,6,QCU,0.7184,0.07,0.56,76,74,55,19,1.03,74.32,55,21,71.84,Adapte,Adapte,Adapte / Adapte
844,15,2016,Ingenieurie,2,6,QCU,0.6731,0.15,0.67,86,84,58,26,1.02,69.05,58,28,67.31,Adapte,Adapte,Adapte / Adapte
1674,15,2017,Ingenieurie,2,6,QCU,0.7091,0.1,0.45,85,75,60,15,1.13,80.0,60,25,70.91,Adapte,Adapte,Adapte / Adapte
2504,15,2018,Ingenieurie,2,6,QCU,0.6691,0.03,0.4,92,83,62,21,1.11,74.7,62,30,66.91,Adapte,Adapte,Adapte / Adapte
3334,15,2019,Ingenieurie,2,6,QCU,0.6392,0.09,0.54,87,68,56,12,1.28,82.35,56,31,63.92,Adapte,Adapte,Adapte / Adapte
4164,15,2020,Ingenieurie,2,6,QCU,0.724,0.17,0.6,83,71,60,11,1.17,84.51,60,23,72.4,Adapte,Adapte,Adapte / Adapte
15,16,2015,Ingenieurie,2,7,QCM,0.0878,0.51,0.27,60,33,5,28,1.82,15.15,5,55,8.78,Trop Difficile,Trop Difficile,Trop Difficile / Trop Difficile
845,16,2016,Ingenieurie,2,7,QCM,0.8905,0.09,0.92,63,60,56,4,1.05,93.33,56,7,89.05,Trop Facile,Trop Facile,Trop Facile / Trop Facile
1675,16,2017,Ingenieurie,2,7,QCM,0.9905,0.09,0.91,72,72,71,1,1.0,98.61,71,1,99.05,Trop Facile,Trop Facile,Trop Facile / Trop Facile
2505,16,2018,Ingenieurie,2,7,QCM,0.9261,0.03,0.84,79,77,73,4,1.03,94.81,73,6,92.61,Trop Facile,Trop Facile,Trop Facile / Trop Facile
3335,16,2019,Ingenieurie,2,7,QCM,0.9135,0.04,0.8,75,73,69,4,1.03,94.52,69,6,91.35,Trop Facile,Trop Facile,Trop Facile / Trop Facile
4165,16,2020,Ingenieurie,2,7,QCM,0.8418,0.19,0.77,87,75,73,2,1.16,97.33,73,14,84.18,Trop Facile,Facile,Trop Facile / Facile
16,17,2015,Ingenieurie,2,8,QCU,0.8296,0.02,0.78,81,81,67,14,1.0,82.72,67,14,82.96,Facile,Facile,Facile / Facile
846,17,2016,Ingenieurie,2,8,QCU,0.9483,0.02,0.93,95,95,90,5,1.0,94.74,90,5,94.83,Trop Facile,Trop Facile,Trop Facile / Trop Facile
1676,17,2017,Ingenieurie,2,8,QCU,0.9671,0.01,0.96,111,109,107,2,1.02,98.17,107,4,96.71,Trop Facile,Trop Facile,Trop Facile / Trop Facile
2506,17,2018,Ingenieurie,2,8,QCU,0.888,0.08,0.93,114,104,101,3,1.1,97.12,101,13,88.8,Trop Facile,Trop Facile,Trop Facile / Trop Facile
3336,17,2019,Ingenieurie,2,8,QCU,0.9108,0.04,0.94,120,117,109,8,1.03,93.16,109,11,91.08,Trop Facile,Trop Facile,Trop Facile / Trop Facile
4166,17,2020,Ingenieurie,2,8,QCU,0.9234,0.01,0.95,100,92,92,0,1.09,100.0,92,8,92.34,Trop Facile,Trop Facile,Trop Facile / Trop Facile
17,18,2015,Ingenieurie,2,9,QCU,0.2053,0.72,0.25,63,32,13,19,1.97,40.62,13,50,20.53,Trop Difficile,Trop Difficile,Trop Difficile / Trop Difficile
847,18,2016,Ingenieurie,2,9,QCU,0.9516,0.08,0.95,61,58,58,0,1.05,100.0,58,3,95.16,Trop Facile,Trop Facile,Trop Facile / Trop Facile
1677,18,2017,Ingenieurie,2,9,QCU,0.9105,0.05,0.99,56,54,51,3,1.04,94.44,51,5,91.05,Trop Facile,Trop Facile,Trop Facile / Trop Facile
2507,18,2018,Ingenieurie,2,9,QCU,0.9288,0.09,0.95,66,64,61,3,1.03,95.31,61,5,92.88,Trop Facile,Trop Facile,Trop Facile / Trop Facile
3337,18,2019,Ingenieurie,2,9,QCU,0.993,0.05,0.99,77,77,76,1,1.0,98.7,76,1,99.3,Trop Facile,Trop Facile,Trop Facile / Trop Facile
4167,18,2020,Ingenieurie,2,9,QCU,0.867,0.0,0.96,68,64,59,5,1.06,92.19,59,9,86.7,Trop Facile,Trop Facile,Trop Facile / Trop Facile
18,19,2015,Ingenieurie,2,10,QCM,0.0427,0.46,0.3,85,34,4,30,2.5,11.76,4,81,4.27,Trop Difficile,Trop Difficile,Trop Difficile / Trop Difficile
848,19,2016,Ingenieurie,2,10,QCM,0.6049,0.03,0.58,92,72,56,16,1.28,77.78,56,36,60.49,Trop Facile,Adapte,Trop Facile / Adapte
1678,19,2017,Ingenieurie,2,10,QCM,0.6966,0.18,0.49,98,87,68,19,1.13,78.16,68,30,69.66,Adapte,Adapte,Adapte / Adapte
2508,19,2018,Ingenieurie,2,10,QCM,0.6831,0.14,0.68,81,64,55,9,1.27,85.94,55,26,68.31,Adapte,Adapte,Adapte / Adapte
3338,19,2019,Ingenieurie,2,10,QCM,0.6174,0.29,0.49,84,60,52,8,1.4,86.67,52,32,61.74,Adapte,Adapte,Adapte / Adapte
4168,19,2020,Ingenieurie,2,10,QCM,0.6495,0.15,0.5,70,47,45,2,1.49,95.74,45,25,64.95,Adapte,Adapte,Adapte / Adapte
19,20,2015,Ingenieurie,3,1,QROC,0.0317,0.84,0.03,24,22,1,21,1.09,4.55,1,23,3.17,Facile,Trop Difficile,Facile / Trop Difficile
849,20,2016,Ingenieurie,3,1,QROC,0.1808,0.99,0.08,25,20,5,15,1.25,25.0,5,20,18.08,Trop Facile,Trop Difficile,Trop Facile / Trop Difficile
1679,20,2017,Ingenieurie,3,1,QROC,0.1084,0.84,0.08,24,15,3,12,1.6,20.0,3,21,10.84,Trop Facile,Trop Difficile,Trop Facile / Trop Difficile
2509,20,2018,Ingenieurie,3,1,QROC,0.9286,0.02,0.92,22,21,20,1,1.05,95.24,20,2,92.86,Trop Facile,Trop Facile,Trop Facile / Trop Facile
3339,20,2019,Ingenieurie,3,1,QROC,0.9591,0.09,0.99,22,22,21,1,1.0,95.45,21,1,95.91,Trop Facile,Trop Facile,Trop Facile / Trop Facile
4169,20,2020,Ingenieurie,3,1,QROC,0.9755,0.06,0.63,18,18,18,0,1.0,100.0,18,0,97.55,Trop Facile,Trop Facile,Trop Facile / Trop Facile
20,21,2015,Ingenieurie,3,2,QCU,0.0857,0.42,0.25,41,24,4,20,1.71,16.67,4,37,8.57,Trop Difficile,Trop Difficile,Trop Difficile / Trop Difficile
850,21,2016,Ingenieurie,3,2,QCU,0.9927,0.06,0.96,39,39,39,0,1.0,100.0,39,0,99.27,Trop Facile,Trop Facile,Trop Facile / Trop Facile
1680,21,2017,Ingenieurie,3,2,QCU,0.8895,0.03,0.93,33,33,29,4,1.0,87.88,29,4,88.95,Trop Facile,Trop Facile,Trop Facile / Trop Facile
2510,21,2018,Ingenieurie,3,2,QCU,0.9154,0.03,0.92,26,24,24,0,1.08,100.0,24,2,91.54,Trop Facile,Trop Facile,Trop Facile / Trop Facile
3340,21,2019,Ingenieurie,3,2,QCU,0.9207,0.04,0.98,31,29,29,0,1.07,100.0,29,2,92.07,Trop Facile,Trop Facile,Trop Facile / Trop Facile
4170,21,2020,Ingenieurie,3,2,QCU,0.8725,0.01,0.94,32,29,28,1,1.1,96.55,28,4,87.25,Trop Facile,Trop Facile,Trop Facile / Trop Facile
21,22,2015,Ingenieurie,3,3,QCM,0.4761,0.07,0.35,46,36,22,14,1.28,61.11,22,24,47.61,Difficile,Difficile,Difficile / Difficile
851,22,2016,Ingenieurie,3,3,QCM,0.3285,0.43,0.38,42,42,14,28,1.0,33.33,14,28,32.85,Trop Facile,Difficile,Trop Facile / Difficile
1681,22,2017,Ingenieurie,3,3,QCM,0.8813,0.05,0.83,43,43,38,5,1.0,88.37,38,5,88.13,Trop Facile,Trop Facile,Trop Facile / Trop Facile
2511,22,2018,Ingenieurie,3,3,QCM,0.7307,0.26,0.63,37,34,27,7,1.09,79.41,27,10,73.07,Trop Facile,Adapte,Trop Facile / Adapte
3341,22,2019,Ingenieurie,3,3,QCM,0.6341,0.26,0.51,30,28,19,9,1.07,67.86,19,11,63.41,Adapte,Adapte,Adapte / Adapte
4171,22,2020,Ingenieurie,3,3,QCM,0.7121,0.09,0.48,30,22,21,1,1.36,95.45,21,9,71.21,Adapte,Adapte,Adapte / Adapte
22,23,2015,Ingenieurie,3,4,QCU,0.2074,0.64,0.28,18,15,4,11,1.2,26.67,4,14,20.74,Difficile,Trop Difficile,Difficile / Trop Difficile
852,23,2016,Ingenieurie,3,4,QCU,0.9362,0.03,0.92,19,18,18,0,1.06,100.0,18,1,93.62,Trop Facile,Trop Facile,Trop Facile / Trop Facile
1682,23,2017,Ingenieurie,3,4,QCU,0.6081,0.11,0.61,19,17,12,5,1.12,70.59,12,7,60.81,Trop Facile,Adapte,Trop Facile / Adapte
2512,23,2018,Ingenieurie,3,4,QCU,0.7027,0.14,0.41,15,12,11,1,1.25,91.67,11,4,70.27,Adapte,Adapte,Adapte / Adapte
3342,23,2019,Ingenieurie,3,4,QCU,0.6295,0.16,0.51,17,17,11,6,1.0,64.71,11,6,62.95,Adapte,Adapte,Adapte / Adapte
4172,23,2020,Ingenieurie,3,4,QCU,0.6973,0.13,0.56,14,13,10,3,1.08,76.92,10,4,69.73,Adapte,Adapte,Adapte / Adapte
23,24,2015,Ingenieurie,3,5,QCM,0.6998,0.03,0.43,92,78,64,14,1.18,82.05,64,28,69.98,Adapte,Adapte,Adapte / Adapte
853,24,2016,Ingenieurie,3,5,QCM,0.6446,0.09,0.58,109,71,70,1,1.54,98.59,70,39,64.46,Adapte,Adapte,Adapte / Adapte
1683,24,2017,Ingenieurie,3,5,QCM,0.689,0.22,0.46,127,106,88,18,1.2,83.02,88,39,68.9,Adapte,Adapte,Adapte / Adapte
2513,24,2018,Ingenieurie,3,5,QCM,0.6094,0.22,0.58,150,132,91,41,1.14,68.94,91,59,60.94,Adapte,Adapte,Adapte / Adapte
3343,24,2019,Ingenieurie,3,5,QCM,0.7495,0.18,0.63,126,98,94,4,1.29,95.92,94,32,74.95,Adapte,Adapte,Adapte / Adapte
4173,24,2020,Ingenieurie,3,5,QCM,0.6094,0.03,0.56,137,119,83,36,1.15,69.75,83,54,60.94,Adapte,Adapte,Adapte / Adapte
24,25,2015,Ingenieurie,3,6,QCU,0.0499,0.68,0.27,56,48,3,45,1.17,6.25,3,53,4.99,Difficile,Trop Difficile,Difficile / Trop Difficile
854,25,2016,Ingenieurie,3,6,QCU,0.9068,0.06,0.93,55,53,50,3,1.04,94.34,50,5,90.68,Trop Facile,Trop Facile,Trop Facile / Trop Facile
1684,25,2017,Ingenieurie,3,6,QCU,0.9116,0.0,0.94,52,48,47,1,1.08,97.92,47,5,91.16,Trop Facile,Trop Facile,Trop Facile / Trop Facile
2514,25,2018,Ingenieurie,3,6,QCU,0.9725,0.03,0.93,56,55,54,1,1.02,98.18,54,2,97.25,Trop Facile,Trop Facile,Trop Facile / Trop Facile
3344,25,2019,Ingenieurie,3,6,QCU,0.8735,0.0,0.95,63,61,55,6,1.03,90.16,55,8,87.35,Trop Facile,Trop Facile,Trop Facile / Trop Facile
4174,25,2020,Ingenieurie,3,6,QCU,0.7867,0.03,0.89,51,43,40,3,1.19,93.02,40,11,78.67,Trop Facile,Facile,Trop Facile / Facile
25,26,2015,Ingenieurie,3,7,QROC,0.9722,0.05,0.83,35,35,34,1,1.0,97.14,34,1,97.22,Trop Facile,Trop Facile,Trop Facile / Trop Facile
855,26,2016,Ingenieurie,3,7,QROC,0.8854,0.01,0.76,41,40,36,4,1.02,90.0,36,5,88.54,Trop Facile,Trop Facile,Trop Facile / Trop Facile
1685,26,2017,Ingenieurie,3,7,QROC,0.8127,0.16,0.7,42,37,34,3,1.14,91.89,34,8,81.27,Trop Facile,Facile,Trop Facile / Facile
2515,26,2018,Ingenieurie,3,7,QROC,0.9229,0.03,0.78,44,43,41,2,1.02,95.35,41,3,92.29,Trop Facile,Trop Facile,Trop Facile / Trop Facile
3345,26,2019,Ingenieurie,3,7,QROC,0.5737,0.62,0.19,47,38,27,11,1.24,71.05,27,20,57.37,Trop Facile,Difficile,Trop Facile / Difficile
4175,26,2020,Ingenieurie,3,7,QROC,0.8995,0.08,0.5,52,49,47,2,1.06,95.92,47,5,89.95,Trop Facile,Trop Facile,Trop Facile / Trop Facile
26,27,2015,Ingenieurie,3,8,QO,0.3198,0.9,0.14,35,35,11,24,1.0,31.43,11,24,31.98,Trop Difficile,Difficile,Trop Difficile / Difficile
856,27,2016,Ingenieurie,3,8,QO,0.8899,0.08,0.8,39,39,35,4,1.0,89.74,35,4,88.99,Trop Facile,Trop Facile,Trop Facile / Trop Facile
1686,27,2017,Ingenieurie,3,8,QO,0.905,0.09,0.84,38,34,34,0,1.12,100.0,34,4,90.5,Trop Facile,Trop Facile,Trop Facile / Trop Facile
2516,27,2018,Ingenieurie,3,8,QO,0.7439,0.36,0.22,40,32,30,2,1.25,93.75,30,10,74.39,Trop Facile,Adapte,Trop Facile / Adapte
3346,27,2019,Ingenieurie,3,8,QO,0.6195,0.46,0.22,37,31,23,8,1.19,74.19,23,14,61.95,Adapte,Adapte,Adapte / Adapte
4176,27,2020,Ingenieurie,3,8,QO,0.7412,0.47,0.16,30,23,22,1,1.3,95.65,22,8,74.12,Adapte,Adapte,Adapte / Adapte
27,28,2015,Ingenieurie,3,9,QCU,0.842,0.0,0.84,69,67,58,9,1.03,86.57,58,11,84.2,Trop Difficile,Facile,Trop Difficile / Facile
857,28,2016,Ingenieurie,3,9,QCU,0.903,0.03,0.97,65,64,59,5,1.02,92.19,59,6,90.3,Trop Facile,Trop Facile,Trop Facile / Trop Facile
1687,28,2017,Ingenieurie,3,9,QCU,0.848,0.05,0.8,77,72,65,7,1.07,90.28,65,12,84.8,Trop Facile,Facile,Trop Facile / Facile
2517,28,2018,Ingenieurie,3,9,QCU,0.8798,0.06,0.91,71,68,62,6,1.04,91.18,62,9,87.98,Trop Facile,Trop Facile,Trop Facile / Trop Facile
3347,28,2019,Ingenieurie,3,9,QCU,0.5817,0.04,0.34,71,68,41,27,1.04,60.29,41,30,58.17,Trop Facile,Difficile,Trop Facile / Difficile
4177,28,2020,Ingenieurie,3,9,QCU,0.2267,0.47,0.22,60,45,14,31,1.33,31.11,14,46,22.67,Trop Facile,Trop Difficile,Trop Facile / Trop Difficile
28,29,2015,Ingenieurie,3,10,QCU,0.7349,0.04,0.63,84,65,62,3,1.29,95.38,62,22,73.49,Difficile,Adapte,Difficile / Adapte
858,29,2016,Ingenieurie,3,10,QCU,0.6062,0.11,0.44,93,70,56,14,1.33,80.0,56,37,60.62,Adapte,Adapte,Adapte / Adapte
1688,29,2017,Ingenieurie,3,10,QCU,0.6078,0.01,0.47,94,58,57,1,1.62,98.28,57,37,60.78,Adapte,Adapte,Adapte / Adapte
2518,29,2018,Ingenieurie,3,10,QCU,0.6006,0.12,0.68,102,89,61,28,1.15,68.54,61,41,60.06,Adapte,Adapte,Adapte / Adapte
3348,29,2019,Ingenieurie,3,10,QCU,0.6499,0.28,0.65,106,81,69,12,1.31,85.19,69,37,64.99,Adapte,Adapte,Adapte / Adapte
4178,29,2020,Ingenieurie,3,10,QCU,0.6032,0.13,0.42,99,72,60,12,1.38,83.33,60,39,60.32,Adapte,Adapte,Adapte / Adapte
29,30,2015,Ingenieurie,3,11,QO,0.9816,0.04,0.84,61,60,60,0,1.02,100.0,60,1,98.16,Trop Facile,Trop Facile,Trop Facile / Trop Facile
859,30,2016,Ingenieurie,3,11,QO,0.9034,0.05,0.89,60,59,54,5,1.02,91.53,54,6,90.34,Trop Facile,Trop Facile,Trop Facile / Trop Facile
1689,30,2017,Ingenieurie,3,11,QO,0.9534,0.1,0.85,69,69,66,3,1.0,95.65,66,3,95.34,Trop Facile,Trop Facile,Trop Facile / Trop Facile
2519,30,2018,Ingenieurie,3,11,QO,0.9182,0.03,0.95,81,77,74,3,1.05,96.1,74,7,91.82,Trop Facile,Trop Facile,Trop Facile / Trop Facile
3349,30,2019,Ingenieurie,3,11,QO,0.6896,0.56,0.27,73,68,50,18,1.07,73.53,50,23,68.96,Trop Facile,Adapte,Trop Facile / Adapte
4179,30,2020,Ingenieurie,3,11,QO,0.7435,0.36,0.27,58,56,43,13,1.04,76.79,43,15,74.35,Adapte,Adapte,Adapte / Adapte
30,31,2015,Ingenieurie,3,12,QCU,0.8084,0.19,0.83,58,51,47,4,1.14,92.16,47,11,80.84,Facile,Facile,Facile / Facile
860,31,2016,Ingenieurie,3,12,QCU,0.9908,0.03,0.92,55,54,54,0,1.02,100.0,54,1,99.08,Trop Facile,Trop Facile,Trop Facile / Trop Facile
1690,31,2017,Ingenieurie,3,12,QCU,0.9377,0.07,0.91,53,51,50,1,1.04,98.04,50,3,93.77,Trop Facile,Trop Facile,Trop Facile / Trop Facile
2520,31,2018,Ingenieurie,3,12,QCU,0.9975,0.04,0.93,57,57,57,0,1.0,100.0,57,0,99.75,Trop Facile,Trop Facile,Trop Facile / Trop Facile
3350,31,2019,Ingenieurie,3,12,QCU,0.9887,0.1,0.92,50,49,49,0,1.02,100.0,49,1,98.87,Trop Facile,Trop Facile,Trop Facile / Trop Facile
4180,31,2020,Ingenieurie,3,12,QCU,0.9083,0.09,0.93,43,42,39,3,1.02,92.86,39,4,90.83,Trop Facile,Trop Facile,Trop Facile / Trop Facile
31,32,2015,Ingenieurie,3,13,QCM,0.052,0.37,0.25,35,10,2,8,3.5,20.0,2,33,5.2,Trop Difficile,Trop Difficile,Trop Difficile / Trop Difficile
861,32,2016,Ingenieurie,3,13,QCM,0.0426,0.14,0.26,29,20,1,19,1.45,5.0,1,28,4.26,Trop Facile,Trop Difficile,Trop Facile / Trop Difficile
1691,32,2017,Ingenieurie,3,13,QCM,0.1231,0.4,0.2,28,9,3,6,3.11,33.33,3,25,12.31,Trop Facile,Trop Difficile,Trop Facile / Trop Difficile
2521,32,2018,Ingenieurie,3,13,QCM,0.262,0.48,0.38,32,26,8,18,1.23,30.77,8,24,26.2,Trop Facile,Difficile,Trop Facile / Difficile
3351,32,2019,Ingenieurie,3,13,QCM,0.63,0.24,0.57,28,19,18,1,1.47,94.74,18,10,63.0,Trop Facile,Adapte,Trop Facile / Adapte
4181,32,2020,Ingenieurie,3,13,QCM,0.671,0.15,0.55,29,25,19,6,1.16,76.0,19,10,67.1,Adapte,Adapte,Adapte / Adapte
32,33,2015,Ingenieurie,3,14,QCU,0.0993,0.47,0.23,86,62,9,53,1.39,14.52,9,77,9.93,Difficile,Trop Difficile,Difficile / Trop Difficile
862,33,2016,Ingenieurie,3,14,QCU,0.9454,0.03,0.95,70,69,66,3,1.01,95.65,66,4,94.54,Trop Facile,Trop Facile,Trop Facile / Trop Facile
1692,33,2017,Ingenieurie,3,14,QCU,0.8902,0.06,0.95,82,81,73,8,1.01,90.12,73,9,89.02,Trop Facile,Trop Facile,Trop Facile / Trop Facile
2522,33,2018,Ingenieurie,3,14,QCU,0.7267,0.1,0.62,82,74,60,14,1.11,81.08,60,22,72.67,Trop Facile,Adapte,Trop Facile / Adapte
3352,33,2019,Ingenieurie,3,14,QCU,0.7474,0.11,0.66,78,61,58,3,1.28,95.08,58,20,74.74,Adapte,Adapte,Adapte / Adapte
4182,33,2020,Ingenieurie,3,14,QCU,0.7272,0.2,0.57,84,77,61,16,1.09,79.22,61,23,72.72,Adapte,Adapte,Adapte / Adapte
33,34,2015,Ingenieurie,4,1,QCU,0.3684,0.12,0.38,90,39,33,6,2.31,84.62,33,57,36.84,Difficile,Difficile,Difficile / Difficile
863,34,2016,Ingenieurie,4,1,QCU,0.91,0.02,0.93,77,71,70,1,1.08,98.59,70,7,91.0,Trop Facile,Trop Facile,Trop Facile / Trop Facile
1693,34,2017,Ingenieurie,4,1,QCU,0.8913,0.06,0.92,66,64,59,5,1.03,92.19,59,7,89.13,Trop Facile,Trop Facile,Trop Facile / Trop Facile
2523,34,2018,Ingenieurie,4,1,QCU,0.1002,0.37,0.28,77,36,8,28,2.14,22.22,8,69,10.02,Trop Facile,Trop Difficile,Trop Facile / Trop Difficile
3353,34,2019,Ingenieurie,4,1,QCU,0.9401,0.08,0.93,84,83,79,4,1.01,95.18,79,5,94.01,Trop Facile,Trop Facile,Trop Facile / Trop Facile
4183,34,2020,Ingenieurie,4,1,QCU,0.6415,0.29,0.65,90,61,58,3,1.48,95.08,58,32,64.15,Trop Facile,Adapte,Trop Facile / Adapte
34,35,2015,Ingenieurie,4,2,QCU,0.4415,0.3,0.36,6,3,3,0,2.0,100.0,3,3,44.15,Difficile,Difficile,Difficile / Difficile
864,35,2016,Ingenieurie,4,2,QCU,0.9081,0.04,0.95,6,5,5,0,1.2,100.0,5,1,90.81,Trop Facile,Trop Facile,Trop Facile / Trop Facile
1694,35,2017,Ingenieurie,4,2,QCU,0.9682,0.1,0.99,5,5,5,0,1.0,100.0,5,0,96.82,Trop Facile,Trop Facile,Trop Facile / Trop Facile
2524,35,2018,Ingenieurie,4,2,QCU,0.6343,0.29,0.67,5,5,3,2,1.0,60.0,3,2,63.43,Trop Facile,Adapte,Trop Facile / Adapte
3354,35,2019,Ingenieurie,4,2,QCU,0.6548,0.06,0.68,4,4,3,1,1.0,75.0,3,1,65.48,Adapte,Adapte,Adapte / Adapte
4184,35,2020,Ingenieurie,4,2,QCU,0.6735,0.01,0.64,3,2,2,0,1.5,100.0,2,1,67.35,Adapte,Adapte,Adapte / Adapte
35,36,2015,Ingenieurie,4,3,QCU,0.0736,0.1,0.28,84,81,6,75,1.04,7.41,6,78,7.36,Facile,Trop Difficile,Facile / Trop Difficile
865,36,2016,Ingenieurie,4,3,QCU,0.8905,0.0,0.97,69,65,61,4,1.06,93.85,61,8,89.05,Trop Facile,Trop Facile,Trop Facile / Trop Facile
1695,36,2017,Ingenieurie,4,3,QCU,0.9921,0.06,0.95,71,70,70,0,1.01,100.0,70,1,99.21,Trop Facile,Trop Facile,Trop Facile / Trop Facile
2525,36,2018,Ingenieurie,4,3,QCU,0.1937,0.7,0.27,62,22,12,10,2.82,54.55,12,50,19.37,Trop Facile,Trop Difficile,Trop Facile / Trop Difficile
3355,36,2019,Ingenieurie,4,3,QCU,0.9982,0.04,0.97,51,51,51,0,1.0,100.0,51,0,99.82,Trop Facile,Trop Facile,Trop Facile / Trop Facile
4185,36,2020,Ingenieurie,4,3,QCU,0.9383,0.06,0.94,47,45,44,1,1.04,97.78,44,3,93.83,Trop Facile,Trop Facile,Trop Facile / Trop Facile
36,37,2015,Ingenieurie,4,4,QCU,0.8016,0.05,0.9,27,22,22,0,1.23,100.0,22,5,80.16,Facile,Facile,Facile / Facile
866,37,2016,Ingenieurie,4,4,QCU,0.3882,0.22,0.33,26,22,10,12,1.18,45.45,10,16,38.82,Trop Facile,Difficile,Trop Facile / Difficile
1696,37,2017,Ingenieurie,4,4,QCU,0.9844,0.01,0.93,27,27,27,0,1.0,100.0,27,0,98.44,Trop Facile,Trop Facile,Trop Facile / Trop Facile
2526,37,2018,Ingenieurie,4,4,QCU,0.6548,0.02,0.47,23,20,15,5,1.15,75.0,15,8,65.48,Trop Facile,Adapte,Trop Facile / Adapte
3356,37,2019,Ingenieurie,4,4,QCU,0.6648,0.02,0.55,19,17,13,4,1.12,76.47,13,6,66.48,Adapte,Adapte,Adapte / Adapte
4186,37,2020,Ingenieurie,4,4,QCU,0.656,0.11,0.56,22,14,14,0,1.57,100.0,14,8,65.6,Adapte,Adapte,Adapte / Adapte
37,38,2015,Ingenieurie,4,5,QCM,0.673,0.09,0.41,37,30,25,5,1.23,83.33,25,12,67.3,Difficile,Adapte,Difficile / Adapte
867,38,2016,Ingenieurie,4,5,QCM,0.7282,0.22,0.47,41,36,30,6,1.14,83.33,30,11,72.82,Adapte,Adapte,Adapte / Adapte
1697,38,2017,Ingenieurie,4,5,QCM,0.6465,0.04,0.64,35,27,23,4,1.3,85.19,23,12,64.65,Adapte,Adapte,Adapte / Adapte
2527,38,2018,Ingenieurie,4,5,QCM,0.6163,0.27,0.6,42,32,26,6,1.31,81.25,26,16,61.63,Adapte,Adapte,Adapte / Adapte
3357,38,2019,Ingenieurie,4,5,QCM,0.6236,0.0,0.64,47,42,29,13,1.12,69.05,29,18,62.36,Adapte,Adapte,Adapte / Adapte
4187,38,2020,Ingenieurie,4,5,QCM,0.7474,0.09,0.61,53,49,40,9,1.08,81.63,40,13,74.74,Adapte,Adapte,Adapte / Adapte
38,39,2015,Ingenieurie,4,6,QROC,0.6944,0.4,0.37,13,13,9,4,1.0,69.23,9,4,69.44,Difficile,Adapte,Difficile / Adapte
868,39,2016,Ingenieurie,4,6,QROC,0.7157,0.36,0.36,14,14,10,4,1.0,71.43,10,4,71.57,Adapte,Adapte,Adapte / Adapte
1698,39,2017,Ingenieurie,4,6,QROC,0.7201,0.26,0.3,15,14,11,3,1.07,78.57,11,4,72.01,Adapte,Adapte,Adapte / Adapte
2528,39,2018,Ingenieurie,4,6,QROC,0.7417,0.33,0.29,12,11,9,2,1.09,81.82,9,3,74.17,Adapte,Adapte,Adapte / Adapte
3358,39,2019,Ingenieurie,4,6,QROC,0.6253,0.22,0.39,12,10,8,2,1.2,80.0,8,4,62.53,Adapte,Adapte,Adapte / Adapte
4188,39,2020,Ingenieurie,4,6,QROC,0.7337,0.42,0.33,10,10,7,3,1.0,70.0,7,3,73.37,Adapte,Adapte,Adapte / Adapte
39,40,2015,Ingenieurie,4,7,QCM,0.6519,0.14,0.53,17,11,11,0,1.55,100.0,11,6,65.19,Trop Difficile,Adapte,Trop Difficile / Adapte
869,40,2016,Ingenieurie,4,7,QCM,0.629,0.11,0.66,20,14,13,1,1.43,92.86,13,7,62.9,Adapte,Adapte,Adapte / Adapte
1699,40,2017,Ingenieurie,4,7,QCM,0.6195,0.06,0.63,23,15,14,1,1.53,93.33,14,9,61.95,Adapte,Adapte,Adapte / Adapte
2529,40,2018,Ingenieurie,4,7,QCM,0.6443,0.23,0.65,18,13,12,1,1.38,92.31,12,6,64.43,Adapte,Adapte,Adapte / Adapte
3359,40,2019,Ingenieurie,4,7,QCM,0.6618,0.11,0.47,22,22,15,7,1.0,68.18,15,7,66.18,Adapte,Adapte,Adapte / Adapte
4189,40,2020,Ingenieurie,4,7,QCM,0.6578,0.19,0.46,22,19,14,5,1.16,73.68,14,8,65.78,Adapte,Adapte,Adapte / Adapte
40,41,2015,Ingenieurie,5,1,QCM,0.4776,0.29,0.39,10,6,5,1,1.67,83.33,5,5,47.76,Difficile,Difficile,Difficile / Difficile
870,41,2016,Ingenieurie,5,1,QCM,0.1756,0.09,0.24,12,5,2,3,2.4,40.0,2,10,17.56,Trop Facile,Trop Difficile,Trop Facile / Trop Difficile
1700,41,2017,Ingenieurie,5,1,QCM,0.9953,0.01,0.94,13,13,13,0,1.0,100.0,13,0,99.53,Trop Facile,Trop Facile,Trop Facile / Trop Facile
2530,41,2018,Ingenieurie,5,1,QCM,0.8807,0.08,0.94,16,16,14,2,1.0,87.5,14,2,88.07,Trop Facile,Trop Facile,Trop Facile / Trop Facile
3360,41,2019,Ingenieurie,5,1,QCM,0.8665,0.04,1.0,18,17,16,1,1.06,94.12,16,2,86.65,Trop Facile,Trop Facile,Trop Facile / Trop Facile
4190,41,2020,Ingenieurie,5,1,QCM,0.896,0.06,0.96,22,22,20,2,1.0,90.91,20,2,89.6,Trop Facile,Trop Facile,Trop Facile / Trop Facile
41,42,2015,Ingenieurie,5,2,QCU,0.8201,0.17,0.83,22,20,18,2,1.1,90.0,18,4,82.01,Facile,Facile,Facile / Facile
871,42,2016,Ingenieurie,5,2,QCU,0.9688,0.01,0.95,19,18,18,0,1.06,100.0,18,1,96.88,Trop Facile,Trop Facile,Trop Facile / Trop Facile
1701,42,2017,Ingenieurie,5,2,QCU,0.9926,0.06,0.95,15,15,15,0,1.0,100.0,15,0,99.26,Trop Facile,Trop Facile,Trop Facile / Trop Facile
2531,42,2018,Ingenieurie,5,2,QCU,0.9237,0.03,0.91,17,16,16,0,1.06,100.0,16,1,92.37,Trop Facile,Trop Facile,Trop Facile / Trop Facile
3361,42,2019,Ingenieurie,5,2,QCU,0.8859,0.06,0.98,18,17,16,1,1.06,94.12,16,2,88.59,Trop Facile,Trop Facile,Trop Facile / Trop Facile
4191,42,2020,Ingenieurie,5,2,QCU,0.8269,0.13,0.85,14,13,12,1,1.08,92.31,12,2,82.69,Trop Facile,Facile,Trop Facile / Facile
42,43,2015,Ingenieurie,5,3,QCU,0.8376,0.03,0.83,35,34,29,5,1.03,85.29,29,6,83.76,Facile,Facile,Facile / Facile
872,43,2016,Ingenieurie,5,3,QCU,0.9675,0.0,0.98,36,35,35,0,1.03,100.0,35,1,96.75,Trop Facile,Trop Facile,Trop Facile / Trop Facile
1702,43,2017,Ingenieurie,5,3,QCU,0.9319,0.01,0.95,39,36,36,0,1.08,100.0,36,3,93.19,Trop Facile,Trop Facile,Trop Facile / Trop Facile
2532,43,2018,Ingenieurie,5,3,QCU,0.9119,0.08,0.91,42,41,38,3,1.02,92.68,38,4,91.19,Trop Facile,Trop Facile,Trop Facile / Trop Facile
3362,43,2019,Ingenieurie,5,3,QCU,0.8999,0.09,0.94,50,46,45,1,1.09,97.83,45,5,89.99,Trop Facile,Trop Facile,Trop Facile / Trop Facile
4192,43,2020,Ingenieurie,5,3,QCU,0.9992,0.09,1.0,59,59,59,0,1.0,100.0,59,0,99.92,Trop Facile,Trop Facile,Trop Facile / Trop Facile
43,44,2015,Ingenieurie,5,4,QROC,0.2234,0.75,0.11,70,52,16,36,1.35,30.77,16,54,22.34,Difficile,Trop Difficile,Difficile / Trop Difficile
873,44,2016,Ingenieurie,5,4,QROC,0.9156,0.09,0.66,80,77,73,4,1.04,94.81,73,7,91.56,Trop Facile,Trop Facile,Trop Facile / Trop Facile
1703,44,2017,Ingenieurie,5,4,QROC,0.0503,0.89,0.13,79,45,4,41,1.76,8.89,4,75,5.03,Trop Facile,Trop Difficile,Trop Facile / Trop Difficile
2533,44,2018,Ingenieurie,5,4,QROC,0.8626,0.09,0.61,94,88,81,7,1.07,92.05,81,13,86.26,Trop Facile,Trop Facile,Trop Facile / Trop Facile
3363,44,2019,Ingenieurie,5,4,QROC,0.9481,0.0,0.88,78,76,74,2,1.03,97.37,74,4,94.81,Trop Facile,Trop Facile,Trop Facile / Trop Facile
4193,44,2020,Ingenieurie,5,4,QROC,0.9978,0.1,0.61,80,80,80,0,1.0,100.0,80,0,99.78,Trop Facile,Trop Facile,Trop Facile / Trop Facile
44,45,2015,Ingenieurie,5,5,QCU,0.9247,0.02,0.97,11,11,10,1,1.0,90.91,10,1,92.47,Trop Facile,Trop Facile,Trop Facile / Trop Facile
874,45,2016,Ingenieurie,5,5,QCU,0.193,0.2,0.3,11,11,2,9,1.0,18.18,2,9,19.3,Trop Facile,Trop Difficile,Trop Facile / Trop Difficile
1704,45,2017,Ingenieurie,5,5,QCU,0.9481,0.07,0.9,9,9,9,0,1.0,100.0,9,0,94.81,Trop Facile,Trop Facile,Trop Facile / Trop Facile
2534,45,2018,Ingenieurie,5,5,QCU,0.9808,0.09,0.99,11,11,11,0,1.0,100.0,11,0,98.08,Trop Facile,Trop Facile,Trop Facile / Trop Facile
3364,45,2019,Ingenieurie,5,5,QCU,0.9551,0.03,0.96,13,12,12,0,1.08,100.0,12,1,95.51,Trop Facile,Trop Facile,Trop Facile / Trop Facile
4194,45,2020,Ingenieurie,5,5,QCU,0.9789,0.03,0.91,15,15,15,0,1.0,100.0,15,0,97.89,Trop Facile,Trop Facile,Trop Facile / Trop Facile
45,46,2015,Ingenieurie,5,6,QCM,0.2336,0.71,0.3,25,21,6,15,1.19,28.57,6,19,23.36,Trop Difficile,Trop Difficile,Trop Difficile / Trop Difficile
875,46,2016,Ingenieurie,5,6,QCM,0.8643,0.07,0.82,20,17,17,0,1.18,100.0,17,3,86.43,Trop Facile,Trop Facile,Trop Facile / Trop Facile
1705,46,2017,Ingenieurie,5,6,QCM,0.4343,0.22,0.33,20,15,9,6,1.33,60.0,9,11,43.43,Trop Facile,Difficile,Trop Facile / Difficile
2535,46,2018,Ingenieurie,5,6,QCM,0.9815,0.02,0.86,23,23,23,0,1.0,100.0,23,0,98.15,Trop Facile,Trop Facile,Trop Facile / Trop Facile
3365,46,2019,Ingenieurie,5,6,QCM,0.9352,0.05,0.89,25,24,23,1,1.04,95.83,23,2,93.52,Trop Facile,Trop Facile,Trop Facile / Trop Facile
4195,46,2020,Ingenieurie,5,6,QCM,0.8999,0.01,0.97,22,21,20,1,1.05,95.24,20,2,89.99,Trop Facile,Trop Facile,Trop Facile / Trop Facile
46,47,2015,Ingenieurie,5,7,QCM,0.6252,0.01,0.45,27,27,17,10,1.0,62.96,17,10,62.52,Difficile,Adapte,Difficile / Adapte
876,47,2016,Ingenieurie,5,7,QCM,0.6036,0.12,0.46,23,19,14,5,1.21,73.68,14,9,60.36,Adapte,Adapte,Adapte / Adapte
1706,47,2017,Ingenieurie,5,7,QCM,0.6029,0.25,0.43,19,14,11,3,1.36,78.57,11,8,60.29,Adapte,Adapte,Adapte / Adapte
2536,47,2018,Ingenieurie,5,7,QCM,0.6234,0.26,0.64,22,22,14,8,1.0,63.64,14,8,62.34,Adapte,Adapte,Adapte / Adapte
3366,47,2019,Ingenieurie,5,7,QCM,0.6559,0.24,0.56,20,15,13,2,1.33,86.67,13,7,65.59,Adapte,Adapte,Adapte / Adapte
4196,47,2020,Ingenieurie,5,7,QCM,0.616,0.19,0.58,21,16,13,3,1.31,81.25,13,8,61.6,Adapte,Adapte,Adapte / Adapte
47,48,2015,Ingenieurie,5,8,QO,0.1051,0.92,0.07,19,17,2,15,1.12,11.76,2,17,10.51,Difficile,Trop Difficile,Difficile / Trop Difficile
877,48,2016,Ingenieurie,5,8,QO,0.6551,0.58,0.15,23,19,15,4,1.21,78.95,15,8,65.51,Trop Facile,Adapte,Trop Facile / Adapte
1707,48,2017,Ingenieurie,5,8,QO,0.7107,0.62,0.27,24,18,17,1,1.33,94.44,17,7,71.07,Adapte,Adapte,Adapte / Adapte
2537,48,2018,Ingenieurie,5,8,QO,0.7211,0.27,0.28,27,26,19,7,1.04,73.08,19,8,72.11,Adapte,Adapte,Adapte / Adapte
3367,48,2019,Ingenieurie,5,8,QO,0.7056,0.22,0.29,25,20,18,2,1.25,90.0,18,7,70.56,Adapte,Adapte,Adapte / Adapte
4197,48,2020,Ingenieurie,5,8,QO,0.6474,0.55,0.21,27,18,17,1,1.5,94.44,17,10,64.74,Adapte,Adapte,Adapte / Adapte
48,49,2015,Ingenieurie,5,9,QO,0.0656,0.92,0.09,57,39,4,35,1.46,10.26,4,53,6.56,Difficile,Trop Difficile,Difficile / Trop Difficile
878,49,2016,Ingenieurie,5,9,QO,0.9391,0.09,0.63,49,48,46,2,1.02,95.83,46,3,93.91,Trop Facile,Trop Facile,Trop Facile / Trop Facile
1708,49,2017,Ingenieurie,5,9,QO,0.8852,0.04,0.75,44,42,39,3,1.05,92.86,39,5,88.52,Trop Facile,Trop Facile,Trop Facile / Trop Facile
2538,49,2018,Ingenieurie,5,9,QO,0.9621,0.0,0.92,35,34,34,0,1.03,100.0,34,1,96.21,Trop Facile,Trop Facile,Trop Facile / Trop Facile
3368,49,2019,Ingenieurie,5,9,QO,0.6183,0.63,0.2,31,27,19,8,1.15,70.37,19,12,61.83,Trop Facile,Adapte,Trop Facile / Adapte
4198,49,2020,Ingenieurie,5,9,QO,0.6797,0.61,0.25,26,24,18,6,1.08,75.0,18,8,67.97,Adapte,Adapte,Adapte / Adapte
49,50,2015,Ingenieurie,5,10,QROC,0.0987,0.83,0.04,92,45,9,36,2.04,20.0,9,83,9.87,Trop Difficile,Trop Difficile,Trop Difficile / Trop Difficile
879,50,2016,Ingenieurie,5,10,QROC,0.9801,0.06,0.61,91,90,89,1,1.01,98.89,89,2,98.01,Trop Facile,Trop Facile,Trop Facile / Trop Facile
1709,50,2017,Ingenieurie,5,10,QROC,0.7679,0.09,0.64,87,78,67,11,1.12,85.9,67,20,76.79,Trop Facile,Facile,Trop Facile / Facile
2539,50,2018,Ingenieurie,5,10,QROC,0.6851,0.48,0.37,102,72,70,2,1.42,97.22,70,32,68.51,Trop Facile,Adapte,Trop Facile / Adapte
3369,50,2019,Ingenieurie,5,10,QROC,0.6687,0.49,0.29,109,95,73,22,1.15,76.84,73,36,66.87,Adapte,Adapte,Adapte / Adapte
4199,50,2020,Ingenieurie,5,10,QROC,0.6365,0.48,0.33,114,96,73,23,1.19,76.04,73,41,63.65,Adapte,Adapte,Adapte / Adapte
50,51,2015,Ingenieurie,6,1,QCM,0.7896,0.01,0.74,62,57,49,8,1.09,85.96,49,13,78.96,Facile,Facile,Facile / Facile
880,51,2016,Ingenieurie,6,1,QCM,0.2833,0.17,0.34,55,39,16,23,1.41,41.03,16,39,28.33,Trop Facile,Difficile,Trop Facile / Difficile
1710,51,2017,Ingenieurie,6,1,QCM,0.7659,0.08,0.72,66,62,51,11,1.06,82.26,51,15,76.59,Trop Facile,Facile,Trop Facile / Facile
2540,51,2018,Ingenieurie,6,1,QCM,0.9197,0.0,0.81,64,63,59,4,1.02,93.65,59,5,91.97,Trop Facile,Trop Facile,Trop Facile / Trop Facile
3370,51,2019,Ingenieurie,6,1,QCM,0.8893,0.1,0.99,77,69,68,1,1.12,98.55,68,9,88.93,Trop Facile,Trop Facile,Trop Facile / Trop Facile
4200,51,2020,Ingenieurie,6,1,QCM,0.9789,0.08,0.9,91,90,89,1,1.01,98.89,89,2,97.89,Trop Facile,Trop Facile,Trop Facile / Trop Facile
51,52,2015,Ingenieurie,6,2,QCM,0.0206,0.21,0.22,48,15,1,14,3.2,6.67,1,47,2.06,Trop Difficile,Trop Difficile,Trop Difficile / Trop Difficile
881,52,2016,Ingenieurie,6,2,QCM,0.9849,0.04,0.82,42,41,41,0,1.02,100.0,41,1,98.49,Trop Facile,Trop Facile,Trop Facile / Trop Facile
1711,52,2017,Ingenieurie,6,2,QCM,0.7452,0.1,0.51,46,42,34,8,1.1,80.95,34,12,74.52,Trop Facile,Adapte,Trop Facile / Adapte
2541,52,2018,Ingenieurie,6,2,QCM,0.6627,0.18,0.53,48,34,32,2,1.41,94.12,32,16,66.27,Adapte,Adapte,Adapte / Adapte
3371,52,2019,Ingenieurie,6,2,QCM,0.6157,0.01,0.45,52,51,32,19,1.02,62.75,32,20,61.57,Adapte,Adapte,Adapte / Adapte
4201,52,2020,Ingenieurie,6,2,QCM,0.6997,0.13,0.57,47,42,33,9,1.12,78.57,33,14,69.97,Adapte,Adapte,Adapte / Adapte
52,53,2015,Ingenieurie,6,3,QCM,0.402,0.35,0.35,66,64,27,37,1.03,42.19,27,39,40.2,Trop Facile,Difficile,Trop Facile / Difficile
882,53,2016,Ingenieurie,6,3,QCM,0.474,0.48,0.37,69,59,33,26,1.17,55.93,33,36,47.4,Trop Facile,Difficile,Trop Facile / Difficile
1712,53,2017,Ingenieurie,6,3,QCM,0.2809,0.36,0.34,77,62,22,40,1.24,35.48,22,55,28.09,Trop Facile,Difficile,Trop Facile / Difficile
2542,53,2018,Ingenieurie,6,3,QCM,0.1914,0.19,0.27,69,25,13,12,2.76,52.0,13,56,19.14,Trop Facile,Trop Difficile,Trop Facile / Trop Difficile
3372,53,2019,Ingenieurie,6,3,QCM,0.8615,0.05,0.84,67,60,58,2,1.12,96.67,58,9,86.15,Trop Facile,Trop Facile,Trop Facile / Trop Facile
4202,53,2020,Ingenieurie,6,3,QCM,0.6285,0.06,0.54,62,40,39,1,1.55,97.5,39,23,62.85,Trop Facile,Adapte,Trop Facile / Adapte
53,54,2015,Ingenieurie,6,4,QCM,0.9251,0.03,0.88,88,85,81,4,1.04,95.29,81,7,92.51,Trop Facile,Trop Facile,Trop Facile / Trop Facile
883,54,2016,Ingenieurie,6,4,QCM,0.8774,0.05,0.87,106,95,93,2,1.12,97.89,93,13,87.74,Trop Facile,Trop Facile,Trop Facile / Trop Facile
1713,54,2017,Ingenieurie,6,4,QCM,0.6188,0.19,0.67,96,94,59,35,1.02,62.77,59,37,61.88,Trop Facile,Adapte,Trop Facile / Adapte
2543,54,2018,Ingenieurie,6,4,QCM,0.7037,0.26,0.48,103,95,72,23,1.08,75.79,72,31,70.37,Adapte,Adapte,Adapte / Adapte
3373,54,2019,Ingenieurie,6,4,QCM,0.6795,0.11,0.69,102,77,69,8,1.32,89.61,69,33,67.95,Adapte,Adapte,Adapte / Adapte
4203,54,2020,Ingenieurie,6,4,QCM,0.7034,0.11,0.55,121,101,85,16,1.2,84.16,85,36,70.34,Adapte,Adapte,Adapte / Adapte
54,55,2015,Ingenieurie,7,1,QCU,0.8823,0.08,0.92,58,58,51,7,1.0,87.93,51,7,88.23,Trop Facile,Trop Facile,Trop Facile / Trop Facile
884,55,2016,Ingenieurie,7,1,QCU,0.8055,0.12,0.82,60,58,48,10,1.03,82.76,48,12,80.55,Trop Facile,Facile,Trop Facile / Facile
1714,55,2017,Ingenieurie,7,1,QCU,0.9206,0.05,0.99,63,62,58,4,1.02,93.55,58,5,92.06,Trop Facile,Trop Facile,Trop Facile / Trop Facile
2544,55,2018,Ingenieurie,7,1,QCU,0.8628,0.03,0.95,56,50,48,2,1.12,96.0,48,8,86.28,Trop Facile,Trop Facile,Trop Facile / Trop Facile
3374,55,2019,Ingenieurie,7,1,QCU,0.9457,0.02,0.95,61,60,58,2,1.02,96.67,58,3,94.57,Trop Facile,Trop Facile,Trop Facile / Trop Facile
4204,55,2020,Ingenieurie,7,1,QCU,0.8713,0.09,0.9,69,64,60,4,1.08,93.75,60,9,87.13,Trop Facile,Trop Facile,Trop Facile / Trop Facile
55,56,2015,Ingenieurie,7,2,QCM,0.2659,0.19,0.32,82,72,22,50,1.14,30.56,22,60,26.59,Difficile,Difficile,Difficile / Difficile
885,56,2016,Ingenieurie,7,2,QCM,0.8636,0.04,0.86,95,87,82,5,1.09,94.25,82,13,86.36,Trop Facile,Trop Facile,Trop Facile / Trop Facile
1715,56,2017,Ingenieurie,7,2,QCM,0.8872,0.05,0.9,91,82,81,1,1.11,98.78,81,10,88.72,Trop Facile,Trop Facile,Trop Facile / Trop Facile
2545,56,2018,Ingenieurie,7,2,QCM,0.6794,0.24,0.5,100,79,68,11,1.27,86.08,68,32,67.94,Trop Facile,Adapte,Trop Facile / Adapte
3375,56,2019,Ingenieurie,7,2,QCM,0.6584,0.15,0.61,90,74,59,15,1.22,79.73,59,31,65.84,Adapte,Adapte,Adapte / Adapte
4205,56,2020,Ingenieurie,7,2,QCM,0.6478,0.1,0.64,79,60,51,9,1.32,85.0,51,28,64.78,Adapte,Adapte,Adapte / Adapte
56,57,2015,Ingenieurie,7,3,QCU,0.8223,0.15,0.86,43,37,35,2,1.16,94.59,35,8,82.23,Facile,Facile,Facile / Facile
886,57,2016,Ingenieurie,7,3,QCU,0.8694,0.01,0.9,41,37,36,1,1.11,97.3,36,5,86.94,Trop Facile,Trop Facile,Trop Facile / Trop Facile
1716,57,2017,Ingenieurie,7,3,QCU,0.9154,0.05,0.99,44,40,40,0,1.1,100.0,40,4,91.54,Trop Facile,Trop Facile,Trop Facile / Trop Facile
2546,57,2018,Ingenieurie,7,3,QCU,0.7686,0.11,0.84,50,44,38,6,1.14,86.36,38,12,76.86,Trop Facile,Facile,Trop Facile / Facile
3376,57,2019,Ingenieurie,7,3,QCU,0.9638,0.04,0.93,48,47,46,1,1.02,97.87,46,2,96.38,Trop Facile,Trop Facile,Trop Facile / Trop Facile
4206,57,2020,Ingenieurie,7,3,QCU,0.9523,0.03,0.96,58,58,55,3,1.0,94.83,55,3,95.23,Trop Facile,Trop Facile,Trop Facile / Trop Facile
57,58,2015,Ingenieurie,7,4,QROC,0.7184,0.41,0.27,58,53,42,11,1.09,79.25,42,16,71.84,Adapte,Adapte,Adapte / Adapte
887,58,2016,Ingenieurie,7,4,QROC,0.7106,0.45,0.28,64,54,45,9,1.19,83.33,45,19,71.06,Adapte,Adapte,Adapte / Adapte
1717,58,2017,Ingenieurie,7,4,QROC,0.6744,0.32,0.29,52,36,35,1,1.44,97.22,35,17,67.44,Adapte,Adapte,Adapte / Adapte
2547,58,2018,Ingenieurie,7,4,QROC,0.7215,0.29,0.33,54,42,39,3,1.29,92.86,39,15,72.15,Adapte,Adapte,Adapte / Adapte
3377,58,2019,Ingenieurie,7,4,QROC,0.6519,0.27,0.39,57,41,37,4,1.39,90.24,37,20,65.19,Adapte,Adapte,Adapte / Adapte
4207,58,2020,Ingenieurie,7,4,QROC,0.6464,0.47,0.38,56,37,36,1,1.51,97.3,36,20,64.64,Adapte,Adapte,Adapte / Adapte
58,59,2015,Ingenieurie,7,5,QCU,0.9851,0.03,0.99,41,41,40,1,1.0,97.56,40,1,98.51,Trop Facile,Trop Facile,Trop Facile / Trop Facile
888,59,2016,Ingenieurie,7,5,QCU,0.0173,0.06,0.26,46,37,1,36,1.24,2.7,1,45,1.73,Trop Facile,Trop Difficile,Trop Facile / Trop Difficile
1718,59,2017,Ingenieurie,7,5,QCU,0.2251,0.1,0.21,53,21,12,9,2.52,57.14,12,41,22.51,Trop Facile,Trop Difficile,Trop Facile / Trop Difficile
2548,59,2018,Ingenieurie,7,5,QCU,0.8788,0.08,0.93,52,51,46,5,1.02,90.2,46,6,87.88,Trop Facile,Trop Facile,Trop Facile / Trop Facile
3378,59,2019,Ingenieurie,7,5,QCU,0.9076,0.01,1.0,54,51,49,2,1.06,96.08,49,5,90.76,Trop Facile,Trop Facile,Trop Facile / Trop Facile
4208,59,2020,Ingenieurie,7,5,QCU,0.5827,0.03,0.37,49,39,29,10,1.26,74.36,29,20,58.27,Trop Facile,Difficile,Trop Facile / Difficile
59,60,2015,Ingenieurie,7,6,QROC,0.9639,0.1,0.77,90,87,87,0,1.03,100.0,87,3,96.39,Difficile,Trop Facile,Difficile / Trop Facile
889,60,2016,Ingenieurie,7,6,QROC,0.9753,0.02,0.63,87,85,85,0,1.02,100.0,85,2,97.53,Trop Facile,Trop Facile,Trop Facile / Trop Facile
1719,60,2017,Ingenieurie,7,6,QROC,0.9273,0.05,0.91,85,80,79,1,1.06,98.75,79,6,92.73,Trop Facile,Trop Facile,Trop Facile / Trop Facile
2549,60,2018,Ingenieurie,7,6,QROC,0.9102,0.0,0.51,75,73,68,5,1.03,93.15,68,7,91.02,Trop Facile,Trop Facile,Trop Facile / Trop Facile
3379,60,2019,Ingenieurie,7,6,QROC,0.8818,0.08,0.93,62,59,55,4,1.05,93.22,55,7,88.18,Trop Facile,Trop Facile,Trop Facile / Trop Facile
4209,60,2020,Ingenieurie,7,6,QROC,0.9667,0.1,0.9,73,71,71,0,1.03,100.0,71,2,96.67,Trop Facile,Trop Facile,Trop Facile / Trop Facile
60,61,2015,Ingenieurie,7,7,QCM,0.7285,0.05,0.57,31,31,23,8,1.0,74.19,23,8,72.85,Trop Difficile,Adapte,Trop Difficile / Adapte
890,61,2016,Ingenieurie,7,7,QCM,0.6943,0.06,0.61,29,28,20,8,1.04,71.43,20,9,69.43,Adapte,Adapte,Adapte / Adapte
1720,61,2017,Ingenieurie,7,7,QCM,0.6997,0.22,0.51,28,26,20,6,1.08,76.92,20,8,69.97,Adapte,Adapte,Adapte / Adapte
2550,61,2018,Ingenieurie,7,7,QCM,0.6041,0.27,0.64,34,29,21,8,1.17,72.41,21,13,60.41,Adapte,Adapte,Adapte / Adapte
3380,61,2019,Ingenieurie,7,7,QCM,0.7241,0.06,0.64,37,35,27,8,1.06,77.14,27,10,72.41,Adapte,Adapte,Adapte / Adapte
4210,61,2020,Ingenieurie,7,7,QCM,0.7232,0.05,0.56,43,41,31,10,1.05,75.61,31,12,72.32,Adapte,Adapte,Adapte / Adapte
61,62,2015,Ingenieurie,7,8,QROC,0.9008,0.07,0.56,85,83,77,6,1.02,92.77,77,8,90.08,Difficile,Trop Facile,Difficile / Trop Facile
891,62,2016,Ingenieurie,7,8,QROC,0.9037,0.05,0.95,101,94,91,3,1.07,96.81,91,10,90.37,Trop Facile,Trop Facile,Trop Facile / Trop Facile
1721,62,2017,Ingenieurie,7,8,QROC,0.8786,0.02,0.52,94,90,83,7,1.04,92.22,83,11,87.86,Trop Facile,Trop Facile,Trop Facile / Trop Facile
2551,62,2018,Ingenieurie,7,8,QROC,0.901,0.0,0.85,77,76,69,7,1.01,90.79,69,8,90.1,Trop Facile,Trop Facile,Trop Facile / Trop Facile
3381,62,2019,Ingenieurie,7,8,QROC,0.9648,0.07,0.77,85,83,82,1,1.02,98.8,82,3,96.48,Trop Facile,Trop Facile,Trop Facile / Trop Facile
4211,62,2020,Ingenieurie,7,8,QROC,0.2937,0.74,0.24,77,59,23,36,1.31,38.98,23,54,29.37,Trop Facile,Difficile,Trop Facile / Difficile
62,63,2015,Ingenieurie,8,1,QCU,0.0769,0.35,0.3,20,14,2,12,1.43,14.29,2,18,7.69,Trop Difficile,Trop Difficile,Trop Difficile / Trop Difficile
892,63,2016,Ingenieurie,8,1,QCU,0.988,0.09,1.0,20,20,20,0,1.0,100.0,20,0,98.8,Trop Facile,Trop Facile,Trop Facile / Trop Facile
1722,63,2017,Ingenieurie,8,1,QCU,0.9676,0.05,0.92,16,16,15,1,1.0,93.75,15,1,96.76,Trop Facile,Trop Facile,Trop Facile / Trop Facile
2552,63,2018,Ingenieurie,8,1,QCU,0.7853,0.14,0.76,15,14,12,2,1.07,85.71,12,3,78.53,Trop Facile,Facile,Trop Facile / Facile
3382,63,2019,Ingenieurie,8,1,QCU,0.8653,0.01,0.98,17,16,15,1,1.06,93.75,15,2,86.53,Trop Facile,Trop Facile,Trop Facile / Trop Facile
4212,63,2020,Ingenieurie,8,1,QCU,0.2506,0.05,0.3,14,11,4,7,1.27,36.36,4,10,25.06,Trop Facile,Difficile,Trop Facile / Difficile
63,64,2015,Ingenieurie,8,2,QROC,0.4722,0.61,0.2,47,27,22,5,1.74,81.48,22,25,47.22,Difficile,Difficile,Difficile / Difficile
893,64,2016,Ingenieurie,8,2,QROC,0.8106,0.19,0.67,55,50,45,5,1.1,90.0,45,10,81.06,Trop Facile,Facile,Trop Facile / Facile
1723,64,2017,Ingenieurie,8,2,QROC,0.6889,0.37,0.39,56,55,39,16,1.02,70.91,39,17,68.89,Trop Facile,Adapte,Trop Facile / Adapte
2553,64,2018,Ingenieurie,8,2,QROC,0.7095,0.3,0.29,50,49,35,14,1.02,71.43,35,15,70.95,Adapte,Adapte,Adapte / Adapte
3383,64,2019,Ingenieurie,8,2,QROC,0.6801,0.24,0.35,59,45,40,5,1.31,88.89,40,19,68.01,Adapte,Adapte,Adapte / Adapte
4213,64,2020,Ingenieurie,8,2,QROC,0.6208,0.24,0.26,70,61,43,18,1.15,70.49,43,27,62.08,Adapte,Adapte,Adapte / Adapte
64,65,2015,Ingenieurie,8,3,QO,0.121,0.95,0.03,82,63,10,53,1.3,15.87,10,72,12.1,Trop Difficile,Trop Difficile,Trop Difficile / Trop Difficile
894,65,2016,Ingenieurie,8,3,QO,0.9606,0.06,0.68,83,82,80,2,1.01,97.56,80,3,96.06,Trop Facile,Trop Facile,Trop Facile / Trop Facile
1724,65,2017,Ingenieurie,8,3,QO,0.6974,0.58,0.28,73,62,51,11,1.18,82.26,51,22,69.74,Trop Facile,Adapte,Trop Facile / Adapte
2554,65,2018,Ingenieurie,8,3,QO,0.667,0.37,0.17,88,70,59,11,1.26,84.29,59,29,66.7,Adapte,Adapte,Adapte / Adapte
3384,65,2019,Ingenieurie,8,3,QO,0.6971,0.35,0.27,99,77,69,8,1.29,89.61,69,30,69.71,Adapte,Adapte,Adapte / Adapte
4214,65,2020,Ingenieurie,8,3,QO,0.7235,0.62,0.22,108,87,78,9,1.24,89.66,78,30,72.35,Adapte,Adapte,Adapte / Adapte
65,66,2015,Ingenieurie,8,4,QO,0.2803,0.86,0.05,24,21,7,14,1.14,33.33,7,17,28.03,Difficile,Difficile,Difficile / Difficile
895,66,2016,Ingenieurie,8,4,QO,0.8007,0.17,0.33,23,20,18,2,1.15,90.0,18,5,80.07,Trop Facile,Facile,Trop Facile / Facile
1725,66,2017,Ingenieurie,8,4,QO,0.9438,0.0,0.63,19,18,18,0,1.06,100.0,18,1,94.38,Trop Facile,Trop Facile,Trop Facile / Trop Facile
2555,66,2018,Ingenieurie,8,4,QO,0.9445,0.06,0.87,18,17,17,0,1.06,100.0,17,1,94.45,Trop Facile,Trop Facile,Trop Facile / Trop Facile
3385,66,2019,Ingenieurie,8,4,QO,0.9913,0.06,0.57,15,15,15,0,1.0,100.0,15,0,99.13,Trop Facile,Trop Facile,Trop Facile / Trop Facile
4215,66,2020,Ingenieurie,8,4,QO,0.9432,0.05,0.65,12,11,11,0,1.09,100.0,11,1,94.32,Trop Facile,Trop Facile,Trop Facile / Trop Facile
66,67,2015,Ingenieurie,8,5,QCM,0.046,0.68,0.24,26,23,1,22,1.13,4.35,1,25,4.6,Trop Difficile,Trop Difficile,Trop Difficile / Trop Difficile
896,67,2016,Ingenieurie,8,5,QCM,0.8744,0.04,0.83,29,28,25,3,1.04,89.29,25,4,87.44,Trop Facile,Trop Facile,Trop Facile / Trop Facile
1726,67,2017,Ingenieurie,8,5,QCM,0.8633,0.03,0.87,25,24,22,2,1.04,91.67,22,3,86.33,Trop Facile,Trop Facile,Trop Facile / Trop Facile
2556,67,2018,Ingenieurie,8,5,QCM,0.5462,0.04,0.37,22,16,12,4,1.38,75.0,12,10,54.62,Trop Facile,Difficile,Trop Facile / Difficile
3386,67,2019,Ingenieurie,8,5,QCM,0.9607,0.01,0.92,24,24,23,1,1.0,95.83,23,1,96.07,Trop Facile,Trop Facile,Trop Facile / Trop Facile
4216,67,2020,Ingenieurie,8,5,QCM,0.9391,0.04,0.86,19,19,18,1,1.0,94.74,18,1,93.91,Trop Facile,Trop Facile,Trop Facile / Trop Facile
67,68,2015,Ingenieurie,8,6,QCU,0.3375,0.33,0.3,88,58,30,28,1.52,51.72,30,58,33.75,Difficile,Difficile,Difficile / Difficile
897,68,2016,Ingenieurie,8,6,QCU,0.9368,0.01,0.91,75,70,70,0,1.07,100.0,70,5,93.68,Trop Facile,Trop Facile,Trop Facile / Trop Facile
1727,68,2017,Ingenieurie,8,6,QCU,0.9726,0.03,1.0,73,73,71,2,1.0,97.26,71,2,97.26,Trop Facile,Trop Facile,Trop Facile / Trop Facile
2557,68,2018,Ingenieurie,8,6,QCU,0.4602,0.21,0.35,70,36,32,4,1.94,88.89,32,38,46.02,Trop Facile,Difficile,Trop Facile / Difficile
3387,68,2019,Ingenieurie,8,6,QCU,0.8305,0.18,0.89,68,57,56,1,1.19,98.25,56,12,83.05,Trop Facile,Facile,Trop Facile / Facile
4217,68,2020,Ingenieurie,8,6,QCU,0.6853,0.15,0.65,80,72,55,17,1.11,76.39,55,25,68.53,Trop Facile,Adapte,Trop Facile / Adapte
68,69,2015,Ingenieurie,8,7,QCM,0.5575,0.15,0.38,86,51,48,3,1.69,94.12,48,38,55.75,Difficile,Difficile,Difficile / Difficile
898,69,2016,Ingenieurie,8,7,QCM,0.8728,0.1,0.97,95,94,83,11,1.01,88.3,83,12,87.28,Trop Facile,Trop Facile,Trop Facile / Trop Facile
1728,69,2017,Ingenieurie,8,7,QCM,0.6133,0.17,0.56,111,70,68,2,1.59,97.14,68,43,61.33,Trop Facile,Adapte,Trop Facile / Adapte
2558,69,2018,Ingenieurie,8,7,QCM,0.743,0.15,0.54,111,102,82,20,1.09,80.39,82,29,74.3,Adapte,Adapte,Adapte / Adapte
3388,69,2019,Ingenieurie,8,7,QCM,0.7064,0.15,0.48,99,86,70,16,1.15,81.4,70,29,70.64,Adapte,Adapte,Adapte / Adapte
4218,69,2020,Ingenieurie,8,7,QCM,0.6938,0.24,0.7,94,70,65,5,1.34,92.86,65,29,69.38,Adapte,Adapte,Adapte / Adapte
69,70,2015,Ingenieurie,9,1,QCM,0.0398,0.29,0.26,95,78,4,74,1.22,5.13,4,91,3.98,Trop Difficile,Trop Difficile,Trop Difficile / Trop Difficile
899,70,2016,Ingenieurie,9,1,QCM,0.9796,0.06,0.97,106,106,104,2,1.0,98.11,104,2,97.96,Trop Facile,Trop Facile,Trop Facile / Trop Facile
1729,70,2017,Ingenieurie,9,1,QCM,0.7812,0.07,0.72,119,106,93,13,1.12,87.74,93,26,78.12,Trop Facile,Facile,Trop Facile / Facile
2559,70,2018,Ingenieurie,9,1,QCM,0.8838,0.07,0.87,125,119,110,9,1.05,92.44,110,15,88.38,Trop Facile,Trop Facile,Trop Facile / Trop Facile
3389,70,2019,Ingenieurie,9,1,QCM,0.9889,0.05,0.88,101,100,100,0,1.01,100.0,100,1,98.89,Trop Facile,Trop Facile,Trop Facile / Trop Facile
4219,70,2020,Ingenieurie,9,1,QCM,0.8888,0.03,0.81,105,95,93,2,1.11,97.89,93,12,88.88,Trop Facile,Trop Facile,Trop Facile / Trop Facile
70,71,2015,Ingenieurie,9,2,QROC,0.2134,0.99,0.03,41,35,9,26,1.17,25.71,9,32,21.34,Trop Difficile,Trop Difficile,Trop Difficile / Trop Difficile
900,71,2016,Ingenieurie,9,2,QROC,0.9283,0.08,0.61,48,47,45,2,1.02,95.74,45,3,92.83,Trop Facile,Trop Facile,Trop Facile / Trop Facile
1730,71,2017,Ingenieurie,9,2,QROC,0.9954,0.09,0.73,46,46,46,0,1.0,100.0,46,0,99.54,Trop Facile,Trop Facile,Trop Facile / Trop Facile
2560,71,2018,Ingenieurie,9,2,QROC,0.7234,0.45,0.29,51,42,37,5,1.21,88.1,37,14,72.34,Trop Facile,Adapte,Trop Facile / Adapte
3390,71,2019,Ingenieurie,9,2,QROC,0.6007,0.24,0.27,59,53,35,18,1.11,66.04,35,24,60.07,Adapte,Adapte,Adapte / Adapte
4220,71,2020,Ingenieurie,9,2,QROC,0.67,0.35,0.29,57,41,38,3,1.39,92.68,38,19,67.0,Adapte,Adapte,Adapte / Adapte
71,72,2015,Ingenieurie,9,3,QO,0.5672,0.76,0.0,92,66,52,14,1.39,78.79,52,40,56.72,Difficile,Difficile,Difficile / Difficile
901,72,2016,Ingenieurie,9,3,QO,0.9723,0.06,0.82,87,86,85,1,1.01,98.84,85,2,97.23,Trop Facile,Trop Facile,Trop Facile / Trop Facile
1731,72,2017,Ingenieurie,9,3,QO,0.906,0.09,0.57,100,100,91,9,1.0,91.0,91,9,90.6,Trop Facile,Trop Facile,Trop Facile / Trop Facile
2561,72,2018,Ingenieurie,9,3,QO,0.8636,0.0,0.9,118,114,102,12,1.04,89.47,102,16,86.36,Trop Facile,Trop Facile,Trop Facile / Trop Facile
3391,72,2019,Ingenieurie,9,3,QO,0.7982,0.07,0.51,138,131,110,21,1.05,83.97,110,28,79.82,Trop Facile,Facile,Trop Facile / Facile
4221,72,2020,Ingenieurie,9,3,QO,0.9193,0.01,0.93,125,121,115,6,1.03,95.04,115,10,91.93,Trop Facile,Trop Facile,Trop Facile / Trop Facile
72,73,2015,Ingenieurie,9,4,QCM,0.4568,0.22,0.33,60,46,27,19,1.3,58.7,27,33,45.68,Difficile,Difficile,Difficile / Difficile
902,73,2016,Ingenieurie,9,4,QCM,0.5483,0.01,0.33,68,44,37,7,1.55,84.09,37,31,54.83,Trop Facile,Difficile,Trop Facile / Difficile
1732,73,2017,Ingenieurie,9,4,QCM,0.8212,0.02,0.74,75,72,62,10,1.04,86.11,62,13,82.12,Trop Facile,Facile,Trop Facile / Facile
2562,73,2018,Ingenieurie,9,4,QCM,0.7749,0.1,0.74,69,64,53,11,1.08,82.81,53,16,77.49,Trop Facile,Facile,Trop Facile / Facile
3392,73,2019,Ingenieurie,9,4,QCM,0.9729,0.09,0.8,62,61,60,1,1.02,98.36,60,2,97.29,Trop Facile,Trop Facile,Trop Facile / Trop Facile
4222,73,2020,Ingenieurie,9,4,QCM,0.9896,0.01,0.87,55,54,54,0,1.02,100.0,54,1,98.96,Trop Facile,Trop Facile,Trop Facile / Trop Facile
73,74,2015,Ingenieurie,9,5,QCM,0.4669,0.44,0.39,80,59,37,22,1.36,62.71,37,43,46.69,Difficile,Difficile,Difficile / Difficile
903,74,2016,Ingenieurie,9,5,QCM,0.9351,0.03,0.84,93,89,87,2,1.04,97.75,87,6,93.51,Trop Facile,Trop Facile,Trop Facile / Trop Facile
1733,74,2017,Ingenieurie,9,5,QCM,0.9167,0.01,0.9,99,95,91,4,1.04,95.79,91,8,91.67,Trop Facile,Trop Facile,Trop Facile / Trop Facile
2563,74,2018,Ingenieurie,9,5,QCM,0.8921,0.02,0.95,85,85,76,9,1.0,89.41,76,9,89.21,Trop Facile,Trop Facile,Trop Facile / Trop Facile
3393,74,2019,Ingenieurie,9,5,QCM,0.8993,0.03,0.95,76,71,68,3,1.07,95.77,68,8,89.93,Trop Facile,Trop Facile,Trop Facile / Trop Facile
4223,74,2020,Ingenieurie,9,5,QCM,0.9168,0.08,0.93,68,64,62,2,1.06,96.88,62,6,91.68,Trop Facile,Trop Facile,Trop Facile / Trop Facile
74,75,2015,Ingenieurie,9,6,QCM,0.9284,0.01,0.96,95,91,88,3,1.04,96.7,88,7,92.84,Trop Facile,Trop Facile,Trop Facile / Trop Facile
904,75,2016,Ingenieurie,9,6,QCM,0.9193,0.07,0.89,113,113,104,9,1.0,92.04,104,9,91.93,Trop Facile,Trop Facile,Trop Facile / Trop Facile
1734,75,2017,Ingenieurie,9,6,QCM,0.6177,0.11,0.6,90,65,56,9,1.38,86.15,56,34,61.77,Trop Facile,Adapte,Trop Facile / Adapte
2564,75,2018,Ingenieurie,9,6,QCM,0.6129,0.11,0.51,85,78,52,26,1.09,66.67,52,33,61.29,Adapte,Adapte,Adapte / Adapte
3394,75,2019,Ingenieurie,9,6,QCM,0.6471,0.11,0.62,91,62,59,3,1.47,95.16,59,32,64.71,Adapte,Adapte,Adapte / Adapte
4224,75,2020,Ingenieurie,9,6,QCM,0.732,0.12,0.58,107,84,78,6,1.27,92.86,78,29,73.2,Adapte,Adapte,Adapte / Adapte
75,76,2015,Ingenieurie,9,7,QCM,0.6044,0.1,0.65,13,9,8,1,1.44,88.89,8,5,60.44,Adapte,Adapte,Adapte / Adapte
905,76,2016,Ingenieurie,9,7,QCM,0.6515,0.11,0.51,15,15,10,5,1.0,66.67,10,5,65.15,Adapte,Adapte,Adapte / Adapte
1735,76,2017,Ingenieurie,9,7,QCM,0.6757,0.09,0.63,12,10,8,2,1.2,80.0,8,4,67.57,Adapte,Adapte,Adapte / Adapte
2565,76,2018,Ingenieurie,9,7,QCM,0.6442,0.2,0.55,13,12,8,4,1.08,66.67,8,5,64.42,Adapte,Adapte,Adapte / Adapte
3395,76,2019,Ingenieurie,9,7,QCM,0.7284,0.08,0.61,13,10,9,1,1.3,90.0,9,4,72.84,Adapte,Adapte,Adapte / Adapte
4225,76,2020,Ingenieurie,9,7,QCM,0.7424,0.12,0.6,12,11,9,2,1.09,81.82,9,3,74.24,Adapte,Adapte,Adapte / Adapte
76,77,2015,Ingenieurie,9,8,QCM,0.7668,0.15,0.73,38,30,29,1,1.27,96.67,29,9,76.68,Difficile,Facile,Difficile / Facile
906,77,2016,Ingenieurie,9,8,QCM,0.7374,0.29,0.63,30,25,22,3,1.2,88.0,22,8,73.74,Trop Facile,Adapte,Trop Facile / Adapte
1736,77,2017,Ingenieurie,9,8,QCM,0.7487,0.02,0.43,36,36,27,9,1.0,75.0,27,9,74.87,Adapte,Adapte,Adapte / Adapte
2566,77,2018,Ingenieurie,9,8,QCM,0.7118,0.05,0.52,34,26,24,2,1.31,92.31,24,10,71.18,Adapte,Adapte,Adapte / Adapte
3396,77,2019,Ingenieurie,9,8,QCM,0.7272,0.19,0.65,31,26,23,3,1.19,88.46,23,8,72.72,Adapte,Adapte,Adapte / Adapte
4226,77,2020,Ingenieurie,9,8,QCM,0.695,0.25,0.4,37,35,26,9,1.06,74.29,26,11,69.5,Adapte,Adapte,Adapte / Adapte
77,78,2015,Ingenieurie,9,9,QROC,0.1686,0.78,0.02,77,34,13,21,2.26,38.24,13,64,16.86,Trop Difficile,Trop Difficile,Trop Difficile / Trop Difficile
907,78,2016,Ingenieurie,9,9,QROC,0.9911,0.03,0.87,75,75,74,1,1.0,98.67,74,1,99.11,Trop Facile,Trop Facile,Trop Facile / Trop Facile
1737,78,2017,Ingenieurie,9,9,QROC,0.2809,0.55,0.17,74,52,21,31,1.42,40.38,21,53,28.09,Trop Facile,Difficile,Trop Facile / Difficile
2567,78,2018,Ingenieurie,9,9,QROC,0.8622,0.07,0.71,63,57,54,3,1.11,94.74,54,9,86.22,Trop Facile,Trop Facile,Trop Facile / Trop Facile
3397,78,2019,Ingenieurie,9,9,QROC,0.8727,0.03,0.94,60,55,52,3,1.09,94.55,52,8,87.27,Trop Facile,Trop Facile,Trop Facile / Trop Facile
4227,78,2020,Ingenieurie,9,9,QROC,0.9985,0.1,0.96,57,57,57,0,1.0,100.0,57,0,99.85,Trop Facile,Trop Facile,Trop Facile / Trop Facile
78,79,2015,Ingenieurie,9,10,QCU,0.7809,0.13,0.83,27,25,21,4,1.08,84.0,21,6,78.09,Facile,Facile,Facile / Facile
908,79,2016,Ingenieurie,9,10,QCU,0.9564,0.1,0.9,25,24,24,0,1.04,100.0,24,1,95.64,Trop Facile,Trop Facile,Trop Facile / Trop Facile
1738,79,2017,Ingenieurie,9,10,QCU,0.9859,0.04,0.98,24,24,24,0,1.0,100.0,24,0,98.59,Trop Facile,Trop Facile,Trop Facile / Trop Facile
2568,79,2018,Ingenieurie,9,10,QCU,0.9976,0.06,0.93,24,24,24,0,1.0,100.0,24,0,99.76,Trop Facile,Trop Facile,Trop Facile / Trop Facile
3398,79,2019,Ingenieurie,9,10,QCU,0.9557,0.09,0.93,26,25,25,0,1.04,100.0,25,1,95.57,Trop Facile,Trop Facile,Trop Facile / Trop Facile
4228,79,2020,Ingenieurie,9,10,QCU,0.9892,0.03,0.97,26,26,26,0,1.0,100.0,26,0,98.92,Trop Facile,Trop Facile,Trop Facile / Trop Facile
79,80,2015,Ingenieurie,9,11,QCM,0.1373,0.66,0.27,43,23,6,17,1.87,26.09,6,37,13.73,Adapte,Trop Difficile,Adapte / Trop Difficile
909,80,2016,Ingenieurie,9,11,QCM,0.9397,0.01,0.83,40,38,38,0,1.05,100.0,38,2,93.97,Trop Facile,Trop Facile,Trop Facile / Trop Facile
1739,80,2017,Ingenieurie,9,11,QCM,0.9706,0.01,0.89,47,46,46,0,1.02,100.0,46,1,97.06,Trop Facile,Trop Facile,Trop Facile / Trop Facile
2569,80,2018,Ingenieurie,9,11,QCM,0.9754,0.01,0.95,40,39,39,0,1.03,100.0,39,1,97.54,Trop Facile,Trop Facile,Trop Facile / Trop Facile
3399,80,2019,Ingenieurie,9,11,QCM,0.6651,0.06,0.55,38,34,25,9,1.12,73.53,25,13,66.51,Trop Facile,Adapte,Trop Facile / Adapte
4229,80,2020,Ingenieurie,9,11,QCM,0.6668,0.18,0.66,31,22,21,1,1.41,95.45,21,10,66.68,Adapte,Adapte,Adapte / Adapte
80,81,2015,Ingenieurie,9,12,QCM,0.6608,0.27,0.66,77,75,51,24,1.03,68.0,51,26,66.08,Adapte,Adapte,Adapte / Adapte
910,81,2016,Ingenieurie,9,12,QCM,0.6319,0.27,0.5,66,46,42,4,1.43,91.3,42,24,63.19,Adapte,Adapte,Adapte / Adapte
1740,81,2017,Ingenieurie,9,12,QCM,0.6914,0.06,0.65,56,43,39,4,1.3,90.7,39,17,69.14,Adapte,Adapte,Adapte / Adapte
2570,81,2018,Ingenieurie,9,12,QCM,0.6194,0.2,0.47,58,45,36,9,1.29,80.0,36,22,61.94,Adapte,Adapte,Adapte / Adapte
3400,81,2019,Ingenieurie,9,12,QCM,0.6415,0.03,0.51,55,48,35,13,1.15,72.92,35,20,64.15,Adapte,Adapte,Adapte / Adapte
4230,81,2020,Ingenieurie,9,12,QCM,0.6596,0.07,0.54,61,55,40,15,1.11,72.73,40,21,65.96,Adapte,Adapte,Adapte / Adapte
81,82,2015,Ingenieurie,9,13,QCM,0.6922,0.16,0.57,65,55,45,10,1.18,81.82,45,20,69.22,Difficile,Adapte,Difficile / Adapte
911,82,2016,Ingenieurie,9,13,QCM,0.6915,0.17,0.62,64,50,44,6,1.28,88.0,44,20,69.15,Adapte,Adapte,Adapte / Adapte
1741,82,2017,Ingenieurie,9,13,QCM,0.7315,0.15,0.45,69,51,50,1,1.35,98.04,50,19,73.15,Adapte,Adapte,Adapte / Adapte
2571,82,2018,Ingenieurie,9,13,QCM,0.6973,0.03,0.59,55,50,38,12,1.1,76.0,38,17,69.73,Adapte,Adapte,Adapte / Adapte
3401,82,2019,Ingenieurie,9,13,QCM,0.7057,0.28,0.51,49,39,35,4,1.26,89.74,35,14,70.57,Adapte,Adapte,Adapte / Adapte
4231,82,2020,Ingenieurie,9,13,QCM,0.6127,0.07,0.55,58,54,36,18,1.07,66.67,36,22,61.27,Adapte,Adapte,Adapte / Adapte
82,83,2015,Ingenieurie,10,1,QCM,0.8175,0.09,0.77,53,46,43,3,1.15,93.48,43,10,81.75,Difficile,Facile,Difficile / Facile
912,83,2016,Ingenieurie,10,1,QCM,0.9313,0.07,0.84,64,63,60,3,1.02,95.24,60,4,93.13,Trop Facile,Trop Facile,Trop Facile / Trop Facile
1742,83,2017,Ingenieurie,10,1,QCM,0.019,0.43,0.23,53,35,1,34,1.51,2.86,1,52,1.9,Trop Facile,Trop Difficile,Trop Facile / Trop Difficile
2572,83,2018,Ingenieurie,10,1,QCM,0.9314,0.01,0.96,51,49,48,1,1.04,97.96,48,3,93.14,Trop Facile,Trop Facile,Trop Facile / Trop Facile
3402,83,2019,Ingenieurie,10,1,QCM,0.9437,0.01,0.83,47,45,44,1,1.04,97.78,44,3,94.37,Trop Facile,Trop Facile,Trop Facile / Trop Facile
4232,83,2020,Ingenieurie,10,1,QCM,0.6347,0.0,0.55,55,36,35,1,1.53,97.22,35,20,63.47,Trop Facile,Adapte,Trop Facile / Adapte
83,84,2015,Ingenieurie,10,2,QO,0.9902,0.01,0.72,83,82,82,0,1.01,100.0,82,1,99.02,Trop Difficile,Trop Facile,Trop Difficile / Trop Facile
913,84,2016,Ingenieurie,10,2,QO,0.1771,0.95,0.02,79,52,14,38,1.52,26.92,14,65,17.71,Trop Facile,Trop Difficile,Trop Facile / Trop Difficile
1743,84,2017,Ingenieurie,10,2,QO,0.821,0.1,0.74,87,86,71,15,1.01,82.56,71,16,82.1,Trop Facile,Facile,Trop Facile / Facile
2573,84,2018,Ingenieurie,10,2,QO,0.8196,0.19,0.46,88,80,72,8,1.1,90.0,72,16,81.96,Trop Facile,Facile,Trop Facile / Facile
3403,84,2019,Ingenieurie,10,2,QO,0.9183,0.08,0.76,105,100,96,4,1.05,96.0,96,9,91.83,Trop Facile,Trop Facile,Trop Facile / Trop Facile
4233,84,2020,Ingenieurie,10,2,QO,0.9023,0.05,0.65,84,84,76,8,1.0,90.48,76,8,90.23,Trop Facile,Trop Facile,Trop Facile / Trop Facile
84,85,2015,Ingenieurie,10,3,QCM,0.9046,0.06,0.84,76,74,69,5,1.03,93.24,69,7,90.46,Trop Facile,Trop Facile,Trop Facile / Trop Facile
914,85,2016,Ingenieurie,10,3,QCM,0.9247,0.05,0.89,70,68,65,3,1.03,95.59,65,5,92.47,Trop Facile,Trop Facile,Trop Facile / Trop Facile
1744,85,2017,Ingenieurie,10,3,QCM,0.4084,0.29,0.4,74,33,30,3,2.24,90.91,30,44,40.84,Trop Facile,Difficile,Trop Facile / Difficile
2574,85,2018,Ingenieurie,10,3,QCM,0.5349,0.05,0.31,72,61,39,22,1.18,63.93,39,33,53.49,Trop Facile,Difficile,Trop Facile / Difficile
3404,85,2019,Ingenieurie,10,3,QCM,0.8368,0.1,0.73,66,61,55,6,1.08,90.16,55,11,83.68,Trop Facile,Facile,Trop Facile / Facile
4234,85,2020,Ingenieurie,10,3,QCM,0.6475,0.01,0.52,63,46,41,5,1.37,89.13,41,22,64.75,Trop Facile,Adapte,Trop Facile / Adapte
85,86,2015,Ingenieurie,10,4,QCM,0.1487,0.22,0.22,59,34,9,25,1.74,26.47,9,50,14.87,Trop Difficile,Trop Difficile,Trop Difficile / Trop Difficile
915,86,2016,Ingenieurie,10,4,QCM,0.9694,0.04,0.82,68,68,66,2,1.0,97.06,66,2,96.94,Trop Facile,Trop Facile,Trop Facile / Trop Facile
1745,86,2017,Ingenieurie,10,4,QCM,0.9898,0.07,0.84,58,58,57,1,1.0,98.28,57,1,98.98,Trop Facile,Trop Facile,Trop Facile / Trop Facile
2575,86,2018,Ingenieurie,10,4,QCM,0.9255,0.02,0.97,52,49,48,1,1.06,97.96,48,4,92.55,Trop Facile,Trop Facile,Trop Facile / Trop Facile
3405,86,2019,Ingenieurie,10,4,QCM,0.0893,0.2,0.22,54,19,5,14,2.84,26.32,5,49,8.93,Trop Facile,Trop Difficile,Trop Facile / Trop Difficile
4235,86,2020,Ingenieurie,10,4,QCM,0.3588,0.06,0.35,54,39,19,20,1.38,48.72,19,35,35.88,Trop Facile,Difficile,Trop Facile / Difficile
86,87,2015,Ingenieurie,10,5,QCM,0.4237,0.38,0.32,41,32,17,15,1.28,53.12,17,24,42.37,Trop Difficile,Difficile,Trop Difficile / Difficile
916,87,2016,Ingenieurie,10,5,QCM,0.9093,0.06,0.82,41,41,37,4,1.0,90.24,37,4,90.93,Trop Facile,Trop Facile,Trop Facile / Trop Facile
1746,87,2017,Ingenieurie,10,5,QCM,0.9128,0.01,0.9,49,47,45,2,1.04,95.74,45,4,91.28,Trop Facile,Trop Facile,Trop Facile / Trop Facile
2576,87,2018,Ingenieurie,10,5,QCM,0.934,0.07,1.0,42,41,39,2,1.02,95.12,39,3,93.4,Trop Facile,Trop Facile,Trop Facile / Trop Facile
3406,87,2019,Ingenieurie,10,5,QCM,0.8835,0.09,0.94,40,36,35,1,1.11,97.22,35,5,88.35,Trop Facile,Trop Facile,Trop Facile / Trop Facile
4236,87,2020,Ingenieurie,10,5,QCM,0.8708,0.01,0.97,39,36,34,2,1.08,94.44,34,5,87.08,Trop Facile,Trop Facile,Trop Facile / Trop Facile
87,88,2015,Ingenieurie,10,6,QCM,0.6356,0.29,0.6,98,92,62,30,1.07,67.39,62,36,63.56,Trop Difficile,Adapte,Trop Difficile / Adapte
917,88,2016,Ingenieurie,10,6,QCM,0.7467,0.27,0.51,107,98,80,18,1.09,81.63,80,27,74.67,Adapte,Adapte,Adapte / Adapte
1747,88,2017,Ingenieurie,10,6,QCM,0.6796,0.21,0.49,103,90,70,20,1.14,77.78,70,33,67.96,Adapte,Adapte,Adapte / Adapte
2577,88,2018,Ingenieurie,10,6,QCM,0.6193,0.18,0.58,100,69,62,7,1.45,89.86,62,38,61.93,Adapte,Adapte,Adapte / Adapte
3407,88,2019,Ingenieurie,10,6,QCM,0.7458,0.03,0.57,118,118,88,30,1.0,74.58,88,30,74.58,Adapte,Adapte,Adapte / Adapte
4237,88,2020,Ingenieurie,10,6,QCM,0.6194,0.18,0.47,105,82,65,17,1.28,79.27,65,40,61.94,Adapte,Adapte,Adapte / Adapte
88,89,2015,Ingenieurie,10,7,QCM,0.8169,0.08,0.7,91,77,74,3,1.18,96.1,74,17,81.69,Facile,Facile,Facile / Facile
918,89,2016,Ingenieurie,10,7,QCM,0.91,0.0,0.96,78,76,71,5,1.03,93.42,71,7,91.0,Trop Facile,Trop Facile,Trop Facile / Trop Facile
1748,89,2017,Ingenieurie,10,7,QCM,0.7615,0.19,0.73,77,65,59,6,1.18,90.77,59,18,76.15,Trop Facile,Facile,Trop Facile / Facile
2578,89,2018,Ingenieurie,10,7,QCM,0.8102,0.16,0.77,81,77,66,11,1.05,85.71,66,15,81.02,Trop Facile,Facile,Trop Facile / Facile
3408,89,2019,Ingenieurie,10,7,QCM,0.932,0.03,0.95,89,88,83,5,1.01,94.32,83,6,93.2,Trop Facile,Trop Facile,Trop Facile / Trop Facile
4238,89,2020,Ingenieurie,10,7,QCM,0.9102,0.05,0.87,104,96,95,1,1.08,98.96,95,9,91.02,Trop Facile,Trop Facile,Trop Facile / Trop Facile
89,90,2015,Ingenieurie,10,8,QCU,0.972,0.05,0.99,91,90,88,2,1.01,97.78,88,3,97.2,Difficile,Trop Facile,Difficile / Trop Facile
919,90,2016,Ingenieurie,10,8,QCU,0.4459,0.02,0.37,98,57,44,13,1.72,77.19,44,54,44.59,Trop Facile,Difficile,Trop Facile / Difficile
1749,90,2017,Ingenieurie,10,8,QCU,0.9205,0.07,0.94,96,95,88,7,1.01,92.63,88,8,92.05,Trop Facile,Trop Facile,Trop Facile / Trop Facile
2579,90,2018,Ingenieurie,10,8,QCU,0.8616,0.07,0.92,80,69,69,0,1.16,100.0,69,11,86.16,Trop Facile,Trop Facile,Trop Facile / Trop Facile
3409,90,2019,Ingenieurie,10,8,QCU,0.8783,0.03,0.99,76,76,67,9,1.0,88.16,67,9,87.83,Trop Facile,Trop Facile,Trop Facile / Trop Facile
4239,90,2020,Ingenieurie,10,8,QCU,0.766,0.06,0.83,82,79,63,16,1.04,79.75,63,19,76.6,Trop Facile,Facile,Trop Facile / Facile
90,91,2015,Ingenieurie,10,9,QCM,0.288,0.16,0.39,8,4,2,2,2.0,50.0,2,6,28.8,Difficile,Difficile,Difficile / Difficile
920,91,2016,Ingenieurie,10,9,QCM,0.8761,0.03,0.81,6,5,5,0,1.2,100.0,5,1,87.61,Trop Facile,Trop Facile,Trop Facile / Trop Facile
1750,91,2017,Ingenieurie,10,9,QCM,0.9068,0.04,0.89,6,5,5,0,1.2,100.0,5,1,90.68,Trop Facile,Trop Facile,Trop Facile / Trop Facile
2580,91,2018,Ingenieurie,10,9,QCM,0.8658,0.1,0.92,5,5,4,1,1.0,80.0,4,1,86.58,Trop Facile,Trop Facile,Trop Facile / Trop Facile
3410,91,2019,Ingenieurie,10,9,QCM,0.4288,0.07,0.32,5,4,2,2,1.25,50.0,2,3,42.88,Trop Facile,Difficile,Trop Facile / Difficile
4240,91,2020,Ingenieurie,10,9,QCM,0.9065,0.09,1.0,5,5,5,0,1.0,100.0,5,0,90.65,Trop Facile,Trop Facile,Trop Facile / Trop Facile
91,92,2015,Ingenieurie,10,10,QCU,0.2398,0.4,0.23,6,5,1,4,1.2,20.0,1,5,23.98,Facile,Trop Difficile,Facile / Trop Difficile
921,92,2016,Ingenieurie,10,10,QCU,0.9195,0.03,0.96,5,5,5,0,1.0,100.0,5,0,91.95,Trop Facile,Trop Facile,Trop Facile / Trop Facile
1751,92,2017,Ingenieurie,10,10,QCU,0.9078,0.03,0.96,6,6,5,1,1.0,83.33,5,1,90.78,Trop Facile,Trop Facile,Trop Facile / Trop Facile
2581,92,2018,Ingenieurie,10,10,QCU,0.8817,0.0,0.92,7,7,6,1,1.0,85.71,6,1,88.17,Trop Facile,Trop Facile,Trop Facile / Trop Facile
3411,92,2019,Ingenieurie,10,10,QCU,0.8802,0.1,0.98,7,7,6,1,1.0,85.71,6,1,88.02,Trop Facile,Trop Facile,Trop Facile / Trop Facile
4241,92,2020,Ingenieurie,10,10,QCU,0.7888,0.18,0.85,8,6,6,0,1.33,100.0,6,2,78.88,Trop Facile,Facile,Trop Facile / Facile
92,93,2015,Ingenieurie,10,11,QCM,0.151,0.29,0.24,34,28,5,23,1.21,17.86,5,29,15.1,Trop Facile,Trop Difficile,Trop Facile / Trop Difficile
922,93,2016,Ingenieurie,10,11,QCM,0.9317,0.01,0.81,37,34,34,0,1.09,100.0,34,3,93.17,Trop Facile,Trop Facile,Trop Facile / Trop Facile
1752,93,2017,Ingenieurie,10,11,QCM,0.9102,0.09,0.91,43,39,39,0,1.1,100.0,39,4,91.02,Trop Facile,Trop Facile,Trop Facile / Trop Facile
2582,93,2018,Ingenieurie,10,11,QCM,0.9723,0.02,0.84,42,42,41,1,1.0,97.62,41,1,97.23,Trop Facile,Trop Facile,Trop Facile / Trop Facile
3412,93,2019,Ingenieurie,10,11,QCM,0.9446,0.01,0.87,44,44,42,2,1.0,95.45,42,2,94.46,Trop Facile,Trop Facile,Trop Facile / Trop Facile
4242,93,2020,Ingenieurie,10,11,QCM,0.8685,0.05,0.8,46,45,40,5,1.02,88.89,40,6,86.85,Trop Facile,Trop Facile,Trop Facile / Trop Facile
93,94,2015,Ingenieurie,10,12,QROC,0.8123,0.03,0.63,42,38,34,4,1.11,89.47,34,8,81.23,Adapte,Facile,Adapte / Facile
923,94,2016,Ingenieurie,10,12,QROC,0.9409,0.05,0.64,41,41,39,2,1.0,95.12,39,2,94.09,Trop Facile,Trop Facile,Trop Facile / Trop Facile
1753,94,2017,Ingenieurie,10,12,QROC,0.9398,0.07,0.99,40,40,38,2,1.0,95.0,38,2,93.98,Trop Facile,Trop Facile,Trop Facile / Trop Facile
2583,94,2018,Ingenieurie,10,12,QROC,0.1196,0.89,0.04,44,27,5,22,1.63,18.52,5,39,11.96,Trop Facile,Trop Difficile,Trop Facile / Trop Difficile
3413,94,2019,Ingenieurie,10,12,QROC,0.8975,0.04,0.63,46,45,41,4,1.02,91.11,41,5,89.75,Trop Facile,Trop Facile,Trop Facile / Trop Facile
4243,94,2020,Ingenieurie,10,12,QROC,0.7866,0.17,0.52,53,47,42,5,1.13,89.36,42,11,78.66,Trop Facile,Facile,Trop Facile / Facile
94,95,2015,Ingenieurie,10,13,QCM,0.5409,0.46,0.34,54,51,29,22,1.06,56.86,29,25,54.09,Facile,Difficile,Facile / Difficile
924,95,2016,Ingenieurie,10,13,QCM,0.9916,0.05,0.83,44,44,44,0,1.0,100.0,44,0,99.16,Trop Facile,Trop Facile,Trop Facile / Trop Facile
1754,95,2017,Ingenieurie,10,13,QCM,0.9762,0.0,1.0,48,48,47,1,1.0,97.92,47,1,97.62,Trop Facile,Trop Facile,Trop Facile / Trop Facile
2584,95,2018,Ingenieurie,10,13,QCM,0.8748,0.02,0.82,54,50,47,3,1.08,94.0,47,7,87.48,Trop Facile,Trop Facile,Trop Facile / Trop Facile
3414,95,2019,Ingenieurie,10,13,QCM,0.7277,0.28,0.7,49,39,36,3,1.26,92.31,36,13,72.77,Trop Facile,Adapte,Trop Facile / Adapte
4244,95,2020,Ingenieurie,10,13,QCM,0.7132,0.05,0.47,40,37,29,8,1.08,78.38,29,11,71.32,Adapte,Adapte,Adapte / Adapte
95,96,2015,Ingenieurie,11,1,QCU,0.4811,0.22,0.31,19,18,9,9,1.06,50.0,9,10,48.11,Difficile,Difficile,Difficile / Difficile
925,96,2016,Ingenieurie,11,1,QCU,0.9236,0.03,0.91,23,22,21,1,1.05,95.45,21,2,92.36,Trop Facile,Trop Facile,Trop Facile / Trop Facile
1755,96,2017,Ingenieurie,11,1,QCU,0.8613,0.04,0.98,24,23,21,2,1.04,91.3,21,3,86.13,Trop Facile,Trop Facile,Trop Facile / Trop Facile
2585,96,2018,Ingenieurie,11,1,QCU,0.8107,0.14,0.9,21,20,17,3,1.05,85.0,17,4,81.07,Trop Facile,Facile,Trop Facile / Facile
3415,96,2019,Ingenieurie,11,1,QCU,0.9693,0.04,0.97,23,23,22,1,1.0,95.65,22,1,96.93,Trop Facile,Trop Facile,Trop Facile / Trop Facile
4245,96,2020,Ingenieurie,11,1,QCU,0.9849,0.01,0.9,21,21,21,0,1.0,100.0,21,0,98.49,Trop Facile,Trop Facile,Trop Facile / Trop Facile
96,97,2015,Ingenieurie,11,2,QCU,0.2969,0.14,0.35,39,34,12,22,1.15,35.29,12,27,29.69,Difficile,Difficile,Difficile / Difficile
926,97,2016,Ingenieurie,11,2,QCU,0.9658,0.07,0.95,39,38,38,0,1.03,100.0,38,1,96.58,Trop Facile,Trop Facile,Trop Facile / Trop Facile
1756,97,2017,Ingenieurie,11,2,QCU,0.8914,0.01,0.98,47,43,42,1,1.09,97.67,42,5,89.14,Trop Facile,Trop Facile,Trop Facile / Trop Facile
2586,97,2018,Ingenieurie,11,2,QCU,0.011,0.5,0.26,48,26,1,25,1.85,3.85,1,47,1.1,Trop Facile,Trop Difficile,Trop Facile / Trop Difficile
3416,97,2019,Ingenieurie,11,2,QCU,0.9199,0.03,0.94,54,51,50,1,1.06,98.04,50,4,91.99,Trop Facile,Trop Facile,Trop Facile / Trop Facile
4246,97,2020,Ingenieurie,11,2,QCU,0.9334,0.01,0.98,43,40,40,0,1.07,100.0,40,3,93.34,Trop Facile,Trop Facile,Trop Facile / Trop Facile
97,98,2015,Ingenieurie,11,3,QCU,0.0178,0.71,0.28,35,22,1,21,1.59,4.55,1,34,1.78,Trop Difficile,Trop Difficile,Trop Difficile / Trop Difficile
927,98,2016,Ingenieurie,11,3,QCU,0.6389,0.27,0.65,28,26,18,8,1.08,69.23,18,10,63.89,Trop Facile,Adapte,Trop Facile / Adapte
1757,98,2017,Ingenieurie,11,3,QCU,0.6474,0.14,0.63,33,23,21,2,1.43,91.3,21,12,64.74,Adapte,Adapte,Adapte / Adapte
2587,98,2018,Ingenieurie,11,3,QCU,0.7316,0.11,0.65,30,28,22,6,1.07,78.57,22,8,73.16,Adapte,Adapte,Adapte / Adapte
3417,98,2019,Ingenieurie,11,3,QCU,0.6724,0.13,0.57,27,18,18,0,1.5,100.0,18,9,67.24,Adapte,Adapte,Adapte / Adapte
4247,98,2020,Ingenieurie,11,3,QCU,0.7025,0.29,0.65,28,20,20,0,1.4,100.0,20,8,70.25,Adapte,Adapte,Adapte / Adapte
98,99,2015,Ingenieurie,11,4,QCU,0.782,0.06,0.9,38,35,30,5,1.09,85.71,30,8,78.2,Facile,Facile,Facile / Facile
928,99,2016,Ingenieurie,11,4,QCU,0.8216,0.06,0.87,36,31,30,1,1.16,96.77,30,6,82.16,Trop Facile,Facile,Trop Facile / Facile
1758,99,2017,Ingenieurie,11,4,QCU,0.9152,0.03,0.9,37,36,34,2,1.03,94.44,34,3,91.52,Trop Facile,Trop Facile,Trop Facile / Trop Facile
2588,99,2018,Ingenieurie,11,4,QCU,0.9196,0.09,0.94,43,42,40,2,1.02,95.24,40,3,91.96,Trop Facile,Trop Facile,Trop Facile / Trop Facile
3418,99,2019,Ingenieurie,11,4,QCU,0.7776,0.11,0.87,52,45,40,5,1.16,88.89,40,12,77.76,Trop Facile,Facile,Trop Facile / Facile
4248,99,2020,Ingenieurie,11,4,QCU,0.6092,0.12,0.59,54,43,33,10,1.26,76.74,33,21,60.92,Trop Facile,Adapte,Trop Facile / Adapte
99,100,2015,Ingenieurie,11,5,QCU,0.9919,0.01,0.9,64,63,63,0,1.02,100.0,63,1,99.19,Trop Facile,Trop Facile,Trop Facile / Trop Facile
929,100,2016,Ingenieurie,11,5,QCU,0.9388,0.06,0.97,60,58,56,2,1.03,96.55,56,4,93.88,Trop Facile,Trop Facile,Trop Facile / Trop Facile
1759,100,2017,Ingenieurie,11,5,QCU,0.905,0.05,0.94,62,60,56,4,1.03,93.33,56,6,90.5,Trop Facile,Trop Facile,Trop Facile / Trop Facile
2589,100,2018,Ingenieurie,11,5,QCU,0.7452,0.1,0.4,70,53,52,1,1.32,98.11,52,18,74.52,Trop Facile,Adapte,Trop Facile / Adapte
3419,100,2019,Ingenieurie,11,5,QCU,0.6752,0.12,0.42,80,74,54,20,1.08,72.97,54,26,67.52,Adapte,Adapte,Adapte / Adapte
4249,100,2020,Ingenieurie,11,5,QCU,0.744,0.1,0.53,75,62,56,6,1.21,90.32,56,19,74.4,Adapte,Adapte,Adapte / Adapte
100,101,2015,Ingenieurie,11,6,QROC,0.8314,0.11,0.56,100,98,83,15,1.02,84.69,83,17,83.14,Trop Difficile,Facile,Trop Difficile / Facile
930,101,2016,Ingenieurie,11,6,QROC,0.3209,0.52,0.18,106,58,34,24,1.83,58.62,34,72,32.09,Trop Facile,Difficile,Trop Facile / Difficile
1760,101,2017,Ingenieurie,11,6,QROC,0.9933,0.06,0.59,91,91,90,1,1.0,98.9,90,1,99.33,Trop Facile,Trop Facile,Trop Facile / Trop Facile
2590,101,2018,Ingenieurie,11,6,QROC,0.9512,0.05,0.79,99,94,94,0,1.05,100.0,94,5,95.12,Trop Facile,Trop Facile,Trop Facile / Trop Facile
3420,101,2019,Ingenieurie,11,6,QROC,0.6739,0.34,0.27,116,108,78,30,1.07,72.22,78,38,67.39,Trop Facile,Adapte,Trop Facile / Adapte
4250,101,2020,Ingenieurie,11,6,QROC,0.637,0.46,0.25,103,92,66,26,1.12,71.74,66,37,63.7,Adapte,Adapte,Adapte / Adapte
101,102,2015,Ingenieurie,11,7,QCU,0.6879,0.13,0.46,97,83,67,16,1.17,80.72,67,30,68.79,Difficile,Adapte,Difficile / Adapte
931,102,2016,Ingenieurie,11,7,QCU,0.615,0.01,0.47,93,69,57,12,1.35,82.61,57,36,61.5,Adapte,Adapte,Adapte / Adapte
1761,102,2017,Ingenieurie,11,7,QCU,0.7128,0.02,0.66,75,71,53,18,1.06,74.65,53,22,71.28,Adapte,Adapte,Adapte / Adapte
2591,102,2018,Ingenieurie,11,7,QCU,0.6418,0.09,0.66,74,68,47,21,1.09,69.12,47,27,64.18,Adapte,Adapte,Adapte / Adapte
3421,102,2019,Ingenieurie,11,7,QCU,0.6075,0.28,0.67,78,76,47,29,1.03,61.84,47,31,60.75,Adapte,Adapte,Adapte / Adapte
4251,102,2020,Ingenieurie,11,7,QCU,0.6751,0.18,0.52,94,75,63,12,1.25,84.0,63,31,67.51,Adapte,Adapte,Adapte / Adapte
102,103,2015,Ingenieurie,11,8,QO,0.4129,0.79,0.13,88,63,36,27,1.4,57.14,36,52,41.29,Difficile,Difficile,Difficile / Difficile
932,103,2016,Ingenieurie,11,8,QO,0.6124,0.27,0.28,72,52,44,8,1.38,84.62,44,28,61.24,Trop Facile,Adapte,Trop Facile / Adapte
1762,103,2017,Ingenieurie,11,8,QO,0.7185,0.52,0.22,82,71,59,12,1.15,83.1,59,23,71.85,Adapte,Adapte,Adapte / Adapte
2592,103,2018,Ingenieurie,11,8,QO,0.6258,0.61,0.21,93,67,58,9,1.39,86.57,58,35,62.58,Adapte,Adapte,Adapte / Adapte
3422,103,2019,Ingenieurie,11,8,QO,0.6876,0.25,0.19,77,71,53,18,1.08,74.65,53,24,68.76,Adapte,Adapte,Adapte / Adapte
4252,103,2020,Ingenieurie,11,8,QO,0.6107,0.36,0.27,79,65,48,17,1.22,73.85,48,31,61.07,Adapte,Adapte,Adapte / Adapte
103,104,2015,Ingenieurie,12,1,QCU,0.5723,0.38,0.37,32,31,18,13,1.03,58.06,18,14,57.23,Facile,Difficile,Facile / Difficile
933,104,2016,Ingenieurie,12,1,QCU,0.9855,0.08,0.95,26,26,26,0,1.0,100.0,26,0,98.55,Trop Facile,Trop Facile,Trop Facile / Trop Facile
1763,104,2017,Ingenieurie,12,1,QCU,0.8468,0.19,0.76,24,23,20,3,1.04,86.96,20,4,84.68,Trop Facile,Facile,Trop Facile / Facile
2593,104,2018,Ingenieurie,12,1,QCU,0.7041,0.3,0.43,27,26,19,7,1.04,73.08,19,8,70.41,Trop Facile,Adapte,Trop Facile / Adapte
3423,104,2019,Ingenieurie,12,1,QCU,0.7125,0.22,0.7,29,25,21,4,1.16,84.0,21,8,71.25,Adapte,Adapte,Adapte / Adapte
4253,104,2020,Ingenieurie,12,1,QCU,0.6832,0.24,0.57,35,35,24,11,1.0,68.57,24,11,68.32,Adapte,Adapte,Adapte / Adapte
104,105,2015,Ingenieurie,12,2,QCM,0.9368,0.06,0.87,57,56,53,3,1.02,94.64,53,4,93.68,Facile,Trop Facile,Facile / Trop Facile
934,105,2016,Ingenieurie,12,2,QCM,0.9149,0.04,0.93,66,62,60,2,1.06,96.77,60,6,91.49,Trop Facile,Trop Facile,Trop Facile / Trop Facile
1764,105,2017,Ingenieurie,12,2,QCM,0.8921,0.01,0.95,59,56,53,3,1.05,94.64,53,6,89.21,Trop Facile,Trop Facile,Trop Facile / Trop Facile
2594,105,2018,Ingenieurie,12,2,QCM,0.8786,0.01,0.9,71,67,62,5,1.06,92.54,62,9,87.86,Trop Facile,Trop Facile,Trop Facile / Trop Facile
3424,105,2019,Ingenieurie,12,2,QCM,0.9473,0.08,0.91,79,77,75,2,1.03,97.4,75,4,94.73,Trop Facile,Trop Facile,Trop Facile / Trop Facile
4254,105,2020,Ingenieurie,12,2,QCM,0.9375,0.04,0.86,69,67,65,2,1.03,97.01,65,4,93.75,Trop Facile,Trop Facile,Trop Facile / Trop Facile
105,106,2015,Ingenieurie,12,3,QCU,0.9466,0.01,0.91,59,58,56,2,1.02,96.55,56,3,94.66,Trop Facile,Trop Facile,Trop Facile / Trop Facile
935,106,2016,Ingenieurie,12,3,QCU,0.4324,0.31,0.31,60,51,26,25,1.18,50.98,26,34,43.24,Trop Facile,Difficile,Trop Facile / Difficile
1765,106,2017,Ingenieurie,12,3,QCU,0.8806,0.07,0.99,57,54,50,4,1.06,92.59,50,7,88.06,Trop Facile,Trop Facile,Trop Facile / Trop Facile
2595,106,2018,Ingenieurie,12,3,QCU,0.9202,0.06,0.91,58,58,53,5,1.0,91.38,53,5,92.02,Trop Facile,Trop Facile,Trop Facile / Trop Facile
3425,106,2019,Ingenieurie,12,3,QCU,0.9683,0.07,0.9,50,50,48,2,1.0,96.0,48,2,96.83,Trop Facile,Trop Facile,Trop Facile / Trop Facile
4255,106,2020,Ingenieurie,12,3,QCU,0.014,0.69,0.25,46,41,1,40,1.12,2.44,1,45,1.4,Trop Facile,Trop Difficile,Trop Facile / Trop Difficile
106,107,2015,Ingenieurie,12,4,QCM,0.411,0.0,0.36,30,16,12,4,1.88,75.0,12,18,41.1,Difficile,Difficile,Difficile / Difficile
936,107,2016,Ingenieurie,12,4,QCM,0.5166,0.22,0.38,30,15,15,0,2.0,100.0,15,15,51.66,Trop Facile,Difficile,Trop Facile / Difficile
1766,107,2017,Ingenieurie,12,4,QCM,0.8682,0.07,1.0,35,30,30,0,1.17,100.0,30,5,86.82,Trop Facile,Trop Facile,Trop Facile / Trop Facile
2596,107,2018,Ingenieurie,12,4,QCM,0.9774,0.01,0.8,39,38,38,0,1.03,100.0,38,1,97.74,Trop Facile,Trop Facile,Trop Facile / Trop Facile
3426,107,2019,Ingenieurie,12,4,QCM,0.7702,0.08,0.73,42,39,32,7,1.08,82.05,32,10,77.02,Trop Facile,Facile,Trop Facile / Facile
4256,107,2020,Ingenieurie,12,4,QCM,0.9756,0.07,0.97,38,38,37,1,1.0,97.37,37,1,97.56,Trop Facile,Trop Facile,Trop Facile / Trop Facile
107,108,2015,Ingenieurie,12,5,QROC,0.7741,0.14,0.62,29,28,22,6,1.04,78.57,22,7,77.41,Facile,Facile,Facile / Facile
937,108,2016,Ingenieurie,12,5,QROC,0.9035,0.01,0.76,27,24,24,0,1.12,100.0,24,3,90.35,Trop Facile,Trop Facile,Trop Facile / Trop Facile
1767,108,2017,Ingenieurie,12,5,QROC,0.9426,0.03,0.72,26,26,25,1,1.0,96.15,25,1,94.26,Trop Facile,Trop Facile,Trop Facile / Trop Facile
2597,108,2018,Ingenieurie,12,5,QROC,0.8928,0.09,0.86,24,23,21,2,1.04,91.3,21,3,89.28,Trop Facile,Trop Facile,Trop Facile / Trop Facile
3427,108,2019,Ingenieurie,12,5,QROC,0.8414,0.14,0.62,27,24,23,1,1.12,95.83,23,4,84.14,Trop Facile,Facile,Trop Facile / Facile
4257,108,2020,Ingenieurie,12,5,QROC,0.9737,0.04,0.9,31,30,30,0,1.03,100.0,30,1,97.37,Trop Facile,Trop Facile,Trop Facile / Trop Facile
108,109,2015,Ingenieurie,12,6,QCU,0.2905,0.09,0.38,61,59,18,41,1.03,30.51,18,43,29.05,Difficile,Difficile,Difficile / Difficile
938,109,2016,Ingenieurie,12,6,QCU,0.9357,0.1,0.99,58,58,54,4,1.0,93.1,54,4,93.57,Trop Facile,Trop Facile,Trop Facile / Trop Facile
1768,109,2017,Ingenieurie,12,6,QCU,0.1463,0.13,0.27,60,33,9,24,1.82,27.27,9,51,14.63,Trop Facile,Trop Difficile,Trop Facile / Trop Difficile
2598,109,2018,Ingenieurie,12,6,QCU,0.9069,0.06,0.95,49,48,44,4,1.02,91.67,44,5,90.69,Trop Facile,Trop Facile,Trop Facile / Trop Facile
3428,109,2019,Ingenieurie,12,6,QCU,0.8927,0.01,0.98,53,48,47,1,1.1,97.92,47,6,89.27,Trop Facile,Trop Facile,Trop Facile / Trop Facile
4258,109,2020,Ingenieurie,12,6,QCU,0.9754,0.0,0.91,49,49,48,1,1.0,97.96,48,1,97.54,Trop Facile,Trop Facile,Trop Facile / Trop Facile
109,110,2015,Ingenieurie,13,1,QROC,0.073,0.95,0.1,33,23,2,21,1.43,8.7,2,31,7.3,Difficile,Trop Difficile,Difficile / Trop Difficile
939,110,2016,Ingenieurie,13,1,QROC,0.871,0.04,0.66,31,31,27,4,1.0,87.1,27,4,87.1,Trop Facile,Trop Facile,Trop Facile / Trop Facile
1769,110,2017,Ingenieurie,13,1,QROC,0.901,0.1,0.9,31,31,28,3,1.0,90.32,28,3,90.1,Trop Facile,Trop Facile,Trop Facile / Trop Facile
2599,110,2018,Ingenieurie,13,1,QROC,0.9249,0.08,0.67,36,35,33,2,1.03,94.29,33,3,92.49,Trop Facile,Trop Facile,Trop Facile / Trop Facile
3429,110,2019,Ingenieurie,13,1,QROC,0.9239,0.08,0.56,35,34,32,2,1.03,94.12,32,3,92.39,Trop Facile,Trop Facile,Trop Facile / Trop Facile
4259,110,2020,Ingenieurie,13,1,QROC,0.9446,0.02,0.53,39,38,37,1,1.03,97.37,37,2,94.46,Trop Facile,Trop Facile,Trop Facile / Trop Facile
110,111,2015,Ingenieurie,14,1,QCU,0.8188,0.13,0.79,97,97,79,18,1.0,81.44,79,18,81.88,Facile,Facile,Facile / Facile
940,111,2016,Ingenieurie,14,1,QCU,0.978,0.03,0.94,114,112,111,1,1.02,99.11,111,3,97.8,Trop Facile,Trop Facile,Trop Facile / Trop Facile
1770,111,2017,Ingenieurie,14,1,QCU,0.9498,0.01,0.97,105,101,100,1,1.04,99.01,100,5,94.98,Trop Facile,Trop Facile,Trop Facile / Trop Facile
2600,111,2018,Ingenieurie,14,1,QCU,0.9873,0.04,0.97,87,86,86,0,1.01,100.0,86,1,98.73,Trop Facile,Trop Facile,Trop Facile / Trop Facile
3430,111,2019,Ingenieurie,14,1,QCU,0.9767,0.07,0.96,87,86,85,1,1.01,98.84,85,2,97.67,Trop Facile,Trop Facile,Trop Facile / Trop Facile
4260,111,2020,Ingenieurie,14,1,QCU,0.8242,0.07,0.76,84,75,69,6,1.12,92.0,69,15,82.42,Trop Facile,Facile,Trop Facile / Facile
111,112,2015,Management,1,1,QO,0.5571,0.76,0.03,80,62,45,17,1.29,72.58,45,35,55.71,Difficile,Difficile,Difficile / Difficile
941,112,2016,Management,1,1,QO,0.9275,0.1,0.75,67,64,62,2,1.05,96.88,62,5,92.75,Trop Facile,Trop Facile,Trop Facile / Trop Facile
1771,112,2017,Management,1,1,QO,0.8414,0.19,0.43,73,69,61,8,1.06,88.41,61,12,84.14,Trop Facile,Facile,Trop Facile / Facile
2601,112,2018,Management,1,1,QO,0.8618,0.1,0.51,59,55,51,4,1.07,92.73,51,8,86.18,Trop Facile,Trop Facile,Trop Facile / Trop Facile
3431,112,2019,Management,1,1,QO,0.7033,0.42,0.22,49,42,34,8,1.17,80.95,34,15,70.33,Trop Facile,Adapte,Trop Facile / Adapte
4261,112,2020,Management,1,1,QO,0.6881,0.64,0.26,42,41,29,12,1.02,70.73,29,13,68.81,Adapte,Adapte,Adapte / Adapte
112,113,2015,Management,1,2,QCU,0.9358,0.04,0.92,96,93,90,3,1.03,96.77,90,6,93.58,Trop Difficile,Trop Facile,Trop Difficile / Trop Facile
942,113,2016,Management,1,2,QCU,0.9781,0.04,0.95,114,114,112,2,1.0,98.25,112,2,97.81,Trop Facile,Trop Facile,Trop Facile / Trop Facile
1772,113,2017,Management,1,2,QCU,0.8912,0.06,0.96,105,102,94,8,1.03,92.16,94,11,89.12,Trop Facile,Trop Facile,Trop Facile / Trop Facile
2602,113,2018,Management,1,2,QCU,0.7795,0.11,0.76,96,83,75,8,1.16,90.36,75,21,77.95,Trop Facile,Facile,Trop Facile / Facile
3432,113,2019,Management,1,2,QCU,0.2168,0.1,0.21,80,45,17,28,1.78,37.78,17,63,21.68,Trop Facile,Trop Difficile,Trop Facile / Trop Difficile
4262,113,2020,Management,1,2,QCU,0.1781,0.73,0.25,77,36,14,22,2.14,38.89,14,63,17.81,Trop Facile,Trop Difficile,Trop Facile / Trop Difficile
113,114,2015,Management,1,3,QCM,0.5626,0.08,0.34,9,9,5,4,1.0,55.56,5,4,56.26,Facile,Difficile,Facile / Difficile
943,114,2016,Management,1,3,QCM,0.8968,0.09,0.82,9,9,8,1,1.0,88.89,8,1,89.68,Trop Facile,Trop Facile,Trop Facile / Trop Facile
1773,114,2017,Management,1,3,QCM,0.9304,0.07,0.9,11,10,10,0,1.1,100.0,10,1,93.04,Trop Facile,Trop Facile,Trop Facile / Trop Facile
2603,114,2018,Management,1,3,QCM,0.7812,0.06,0.72,11,10,9,1,1.1,90.0,9,2,78.12,Trop Facile,Facile,Trop Facile / Facile
3433,114,2019,Management,1,3,QCM,0.6924,0.18,0.42,9,9,6,3,1.0,66.67,6,3,69.24,Trop Facile,Adapte,Trop Facile / Adapte
4263,114,2020,Management,1,3,QCM,0.7084,0.01,0.65,8,6,6,0,1.33,100.0,6,2,70.84,Adapte,Adapte,Adapte / Adapte
114,115,2015,Management,1,4,QROC,0.6111,0.24,0.28,70,52,43,9,1.35,82.69,43,27,61.11,Trop Difficile,Adapte,Trop Difficile / Adapte
944,115,2016,Management,1,4,QROC,0.6277,0.36,0.38,80,58,50,8,1.38,86.21,50,30,62.77,Adapte,Adapte,Adapte / Adapte
1774,115,2017,Management,1,4,QROC,0.7233,0.22,0.34,92,83,67,16,1.11,80.72,67,25,72.33,Adapte,Adapte,Adapte / Adapte
2604,115,2018,Management,1,4,QROC,0.6445,0.22,0.28,109,104,70,34,1.05,67.31,70,39,64.45,Adapte,Adapte,Adapte / Adapte
3434,115,2019,Management,1,4,QROC,0.7403,0.26,0.35,117,99,87,12,1.18,87.88,87,30,74.03,Adapte,Adapte,Adapte / Adapte
4264,115,2020,Management,1,4,QROC,0.7353,0.44,0.39,113,88,83,5,1.28,94.32,83,30,73.53,Adapte,Adapte,Adapte / Adapte
115,116,2015,Management,1,5,QCM,0.6464,0.24,0.58,45,32,29,3,1.41,90.62,29,16,64.64,Trop Difficile,Adapte,Trop Difficile / Adapte
945,116,2016,Management,1,5,QCM,0.6071,0.12,0.44,46,41,28,13,1.12,68.29,28,18,60.71,Adapte,Adapte,Adapte / Adapte
1775,116,2017,Management,1,5,QCM,0.6372,0.1,0.67,47,35,30,5,1.34,85.71,30,17,63.72,Adapte,Adapte,Adapte / Adapte
2605,116,2018,Management,1,5,QCM,0.6875,0.29,0.52,43,40,30,10,1.07,75.0,30,13,68.75,Adapte,Adapte,Adapte / Adapte
3435,116,2019,Management,1,5,QCM,0.6351,0.08,0.4,51,34,32,2,1.5,94.12,32,19,63.51,Adapte,Adapte,Adapte / Adapte
4265,116,2020,Management,1,5,QCM,0.6748,0.21,0.46,44,44,30,14,1.0,68.18,30,14,67.48,Adapte,Adapte,Adapte / Adapte
116,117,2015,Management,1,6,QROC,0.1266,0.81,0.15,41,19,5,14,2.16,26.32,5,36,12.66,Difficile,Trop Difficile,Difficile / Trop Difficile
946,117,2016,Management,1,6,QROC,0.9207,0.05,0.79,35,33,32,1,1.06,96.97,32,3,92.07,Trop Facile,Trop Facile,Trop Facile / Trop Facile
1776,117,2017,Management,1,6,QROC,0.9429,0.07,0.59,38,36,36,0,1.06,100.0,36,2,94.29,Trop Facile,Trop Facile,Trop Facile / Trop Facile
2606,117,2018,Management,1,6,QROC,0.8963,0.07,0.52,34,30,30,0,1.13,100.0,30,4,89.63,Trop Facile,Trop Facile,Trop Facile / Trop Facile
3436,117,2019,Management,1,6,QROC,0.3214,0.61,0.17,33,30,11,19,1.1,36.67,11,22,32.14,Trop Facile,Difficile,Trop Facile / Difficile
4266,117,2020,Management,1,6,QROC,0.962,0.09,0.89,35,35,34,1,1.0,97.14,34,1,96.2,Trop Facile,Trop Facile,Trop Facile / Trop Facile
117,118,2015,Management,1,7,QCU,0.0876,0.38,0.22,36,34,3,31,1.06,8.82,3,33,8.76,Trop Difficile,Trop Difficile,Trop Difficile / Trop Difficile
947,118,2016,Management,1,7,QCU,0.7007,0.22,0.51,30,22,21,1,1.36,95.45,21,9,70.07,Trop Facile,Adapte,Trop Facile / Adapte
1777,118,2017,Management,1,7,QCU,0.7253,0.01,0.61,33,31,24,7,1.06,77.42,24,9,72.53,Adapte,Adapte,Adapte / Adapte
2607,118,2018,Management,1,7,QCU,0.7023,0.07,0.53,33,26,23,3,1.27,88.46,23,10,70.23,Adapte,Adapte,Adapte / Adapte
3437,118,2019,Management,1,7,QCU,0.6337,0.25,0.68,30,25,19,6,1.2,76.0,19,11,63.37,Adapte,Adapte,Adapte / Adapte
4267,118,2020,Management,1,7,QCU,0.6562,0.27,0.65,29,29,19,10,1.0,65.52,19,10,65.62,Adapte,Adapte,Adapte / Adapte
118,119,2015,Management,1,8,QCU,0.6413,0.27,0.64,56,42,36,6,1.33,85.71,36,20,64.13,Facile,Adapte,Facile / Adapte
948,119,2016,Management,1,8,QCU,0.7212,0.21,0.48,60,50,43,7,1.2,86.0,43,17,72.12,Adapte,Adapte,Adapte / Adapte
1778,119,2017,Management,1,8,QCU,0.6776,0.25,0.49,66,48,45,3,1.38,93.75,45,21,67.76,Adapte,Adapte,Adapte / Adapte
2608,119,2018,Management,1,8,QCU,0.6322,0.29,0.63,68,67,43,24,1.01,64.18,43,25,63.22,Adapte,Adapte,Adapte / Adapte
3438,119,2019,Management,1,8,QCU,0.6759,0.08,0.63,64,58,43,15,1.1,74.14,43,21,67.59,Adapte,Adapte,Adapte / Adapte
4268,119,2020,Management,1,8,QCU,0.7284,0.16,0.56,70,55,51,4,1.27,92.73,51,19,72.84,Adapte,Adapte,Adapte / Adapte
119,120,2015,Management,1,9,QCM,0.3099,0.2,0.36,37,14,11,3,2.64,78.57,11,26,30.99,Difficile,Difficile,Difficile / Difficile
949,120,2016,Management,1,9,QCM,0.951,0.07,0.9,36,35,34,1,1.03,97.14,34,2,95.1,Trop Facile,Trop Facile,Trop Facile / Trop Facile
1779,120,2017,Management,1,9,QCM,0.9913,0.03,0.96,43,43,43,0,1.0,100.0,43,0,99.13,Trop Facile,Trop Facile,Trop Facile / Trop Facile
2609,120,2018,Management,1,9,QCM,0.9359,0.02,0.93,51,49,48,1,1.04,97.96,48,3,93.59,Trop Facile,Trop Facile,Trop Facile / Trop Facile
3439,120,2019,Management,1,9,QCM,0.9386,0.02,0.96,54,52,51,1,1.04,98.08,51,3,93.86,Trop Facile,Trop Facile,Trop Facile / Trop Facile
4269,120,2020,Management,1,9,QCM,0.0897,0.14,0.23,59,28,5,23,2.11,17.86,5,54,8.97,Trop Facile,Trop Difficile,Trop Facile / Trop Difficile
120,121,2015,Management,1,10,QCU,0.0102,0.58,0.28,52,39,1,38,1.33,2.56,1,51,1.02,Difficile,Trop Difficile,Difficile / Trop Difficile
950,121,2016,Management,1,10,QCU,0.8687,0.08,0.92,54,47,47,0,1.15,100.0,47,7,86.87,Trop Facile,Trop Facile,Trop Facile / Trop Facile
1780,121,2017,Management,1,10,QCU,0.7768,0.2,0.84,51,50,40,10,1.02,80.0,40,11,77.68,Trop Facile,Facile,Trop Facile / Facile
2610,121,2018,Management,1,10,QCU,0.9563,0.06,0.95,44,43,42,1,1.02,97.67,42,2,95.63,Trop Facile,Trop Facile,Trop Facile / Trop Facile
3440,121,2019,Management,1,10,QCU,0.9459,0.03,0.99,35,33,33,0,1.06,100.0,33,2,94.59,Trop Facile,Trop Facile,Trop Facile / Trop Facile
4270,121,2020,Management,1,10,QCU,0.8861,0.05,0.96,29,28,26,2,1.04,92.86,26,3,88.61,Trop Facile,Trop Facile,Trop Facile / Trop Facile
121,122,2015,Management,1,11,QO,0.7285,0.44,0.23,12,11,9,2,1.09,81.82,9,3,72.85,Adapte,Adapte,Adapte / Adapte
951,122,2016,Management,1,11,QO,0.6292,0.69,0.18,11,8,7,1,1.38,87.5,7,4,62.92,Adapte,Adapte,Adapte / Adapte
1781,122,2017,Management,1,11,QO,0.6268,0.61,0.22,10,8,6,2,1.25,75.0,6,4,62.68,Adapte,Adapte,Adapte / Adapte
2611,122,2018,Management,1,11,QO,0.7225,0.39,0.16,10,9,7,2,1.11,77.78,7,3,72.25,Adapte,Adapte,Adapte / Adapte
3441,122,2019,Management,1,11,QO,0.727,0.54,0.27,11,10,8,2,1.1,80.0,8,3,72.7,Adapte,Adapte,Adapte / Adapte
4271,122,2020,Management,1,11,QO,0.7289,0.62,0.25,9,8,7,1,1.12,87.5,7,2,72.89,Adapte,Adapte,Adapte / Adapte
122,123,2015,Management,1,12,QCM,0.1325,0.29,0.24,41,13,5,8,3.15,38.46,5,36,13.25,Trop Difficile,Trop Difficile,Trop Difficile / Trop Difficile
952,123,2016,Management,1,12,QCM,0.7781,0.12,0.77,33,32,26,6,1.03,81.25,26,7,77.81,Trop Facile,Facile,Trop Facile / Facile
1782,123,2017,Management,1,12,QCM,0.9001,0.09,0.99,26,24,23,1,1.08,95.83,23,3,90.01,Trop Facile,Trop Facile,Trop Facile / Trop Facile
2612,123,2018,Management,1,12,QCM,0.7954,0.07,0.8,29,24,23,1,1.21,95.83,23,6,79.54,Trop Facile,Facile,Trop Facile / Facile
3442,123,2019,Management,1,12,QCM,0.0088,0.26,0.24,33,21,0,21,1.57,0.0,0,33,0.88,Trop Facile,Trop Difficile,Trop Facile / Trop Difficile
4272,123,2020,Management,1,12,QCM,0.7295,0.09,0.65,38,30,28,2,1.27,93.33,28,10,72.95,Trop Facile,Adapte,Trop Facile / Adapte
123,124,2015,Management,1,13,QCM,0.2795,0.32,0.36,88,60,25,35,1.47,41.67,25,63,27.95,Difficile,Difficile,Difficile / Difficile
953,124,2016,Management,1,13,QCM,0.1832,0.38,0.29,88,72,16,56,1.22,22.22,16,72,18.32,Trop Facile,Trop Difficile,Trop Facile / Trop Difficile
1783,124,2017,Management,1,13,QCM,0.9793,0.09,0.92,100,98,98,0,1.02,100.0,98,2,97.93,Trop Facile,Trop Facile,Trop Facile / Trop Facile
2613,124,2018,Management,1,13,QCM,0.8378,0.16,0.74,105,96,88,8,1.09,91.67,88,17,83.78,Trop Facile,Facile,Trop Facile / Facile
3443,124,2019,Management,1,13,QCM,0.9177,0.04,0.83,125,119,115,4,1.05,96.64,115,10,91.77,Trop Facile,Trop Facile,Trop Facile / Trop Facile
4273,124,2020,Management,1,13,QCM,0.9736,0.07,0.88,127,125,124,1,1.02,99.2,124,3,97.36,Trop Facile,Trop Facile,Trop Facile / Trop Facile
124,125,2015,Management,2,1,QCM,0.6044,0.23,0.66,68,56,41,15,1.21,73.21,41,27,60.44,Adapte,Adapte,Adapte / Adapte
954,125,2016,Management,2,1,QCM,0.614,0.16,0.5,57,35,35,0,1.63,100.0,35,22,61.4,Adapte,Adapte,Adapte / Adapte
1784,125,2017,Management,2,1,QCM,0.6785,0.22,0.54,66,65,45,20,1.02,69.23,45,21,67.85,Adapte,Adapte,Adapte / Adapte
2614,125,2018,Management,2,1,QCM,0.7398,0.1,0.6,66,50,49,1,1.32,98.0,49,17,73.98,Adapte,Adapte,Adapte / Adapte
3444,125,2019,Management,2,1,QCM,0.672,0.07,0.44,70,55,47,8,1.27,85.45,47,23,67.2,Adapte,Adapte,Adapte / Adapte
4274,125,2020,Management,2,1,QCM,0.6221,0.2,0.4,65,60,40,20,1.08,66.67,40,25,62.21,Adapte,Adapte,Adapte / Adapte
125,126,2015,Management,2,2,QCU,0.8096,0.06,0.8,72,59,58,1,1.22,98.31,58,14,80.96,Difficile,Facile,Difficile / Facile
955,126,2016,Management,2,2,QCU,0.1938,0.75,0.29,63,32,12,20,1.97,37.5,12,51,19.38,Trop Facile,Trop Difficile,Trop Facile / Trop Difficile
1785,126,2017,Management,2,2,QCU,0.9137,0.02,0.97,55,53,50,3,1.04,94.34,50,5,91.37,Trop Facile,Trop Facile,Trop Facile / Trop Facile
2615,126,2018,Management,2,2,QCU,0.0232,0.59,0.21,47,21,1,20,2.24,4.76,1,46,2.32,Trop Facile,Trop Difficile,Trop Facile / Trop Difficile
3445,126,2019,Management,2,2,QCU,0.8931,0.08,1.0,44,39,39,0,1.13,100.0,39,5,89.31,Trop Facile,Trop Facile,Trop Facile / Trop Facile
4275,126,2020,Management,2,2,QCU,0.9228,0.09,0.99,40,39,37,2,1.03,94.87,37,3,92.28,Trop Facile,Trop Facile,Trop Facile / Trop Facile
126,127,2015,Management,2,3,QROC,0.0355,0.8,0.05,29,28,1,27,1.04,3.57,1,28,3.55,Trop Difficile,Trop Difficile,Trop Difficile / Trop Difficile
956,127,2016,Management,2,3,QROC,0.4151,0.7,0.16,32,18,13,5,1.78,72.22,13,19,41.51,Trop Facile,Difficile,Trop Facile / Difficile
1786,127,2017,Management,2,3,QROC,0.8799,0.09,0.62,32,32,28,4,1.0,87.5,28,4,87.99,Trop Facile,Trop Facile,Trop Facile / Trop Facile
2616,127,2018,Management,2,3,QROC,0.9196,0.09,0.64,34,32,31,1,1.06,96.88,31,3,91.96,Trop Facile,Trop Facile,Trop Facile / Trop Facile
3446,127,2019,Management,2,3,QROC,0.064,0.98,0.12,34,16,2,14,2.12,12.5,2,32,6.4,Trop Facile,Trop Difficile,Trop Facile / Trop Difficile
4276,127,2020,Management,2,3,QROC,0.7645,0.19,0.44,34,32,26,6,1.06,81.25,26,8,76.45,Trop Facile,Facile,Trop Facile / Facile
127,128,2015,Management,2,4,QCU,0.5601,0.07,0.38,31,25,17,8,1.24,68.0,17,14,56.01,Difficile,Difficile,Difficile / Difficile
957,128,2016,Management,2,4,QCU,0.915,0.08,1.0,28,27,26,1,1.04,96.3,26,2,91.5,Trop Facile,Trop Facile,Trop Facile / Trop Facile
1787,128,2017,Management,2,4,QCU,0.9606,0.08,0.99,26,25,25,0,1.04,100.0,25,1,96.06,Trop Facile,Trop Facile,Trop Facile / Trop Facile
2617,128,2018,Management,2,4,QCU,0.9743,0.0,0.96,21,21,20,1,1.0,95.24,20,1,97.43,Trop Facile,Trop Facile,Trop Facile / Trop Facile
3447,128,2019,Management,2,4,QCU,0.9128,0.08,0.92,21,20,19,1,1.05,95.0,19,2,91.28,Trop Facile,Trop Facile,Trop Facile / Trop Facile
4277,128,2020,Management,2,4,QCU,0.0266,0.14,0.26,25,11,1,10,2.27,9.09,1,24,2.66,Trop Facile,Trop Difficile,Trop Facile / Trop Difficile
128,129,2015,Management,2,5,QCM,0.7642,0.14,0.7,50,45,38,7,1.11,84.44,38,12,76.42,Adapte,Facile,Adapte / Facile
958,129,2016,Management,2,5,QCM,0.9295,0.02,0.91,48,45,45,0,1.07,100.0,45,3,92.95,Trop Facile,Trop Facile,Trop Facile / Trop Facile
1788,129,2017,Management,2,5,QCM,0.0756,0.21,0.24,47,45,4,41,1.04,8.89,4,43,7.56,Trop Facile,Trop Difficile,Trop Facile / Trop Difficile
2618,129,2018,Management,2,5,QCM,0.7466,0.12,0.54,55,54,41,13,1.02,75.93,41,14,74.66,Trop Facile,Adapte,Trop Facile / Adapte
3448,129,2019,Management,2,5,QCM,0.6597,0.22,0.4,52,49,34,15,1.06,69.39,34,18,65.97,Adapte,Adapte,Adapte / Adapte
4278,129,2020,Management,2,5,QCM,0.6655,0.27,0.49,50,43,33,10,1.16,76.74,33,17,66.55,Adapte,Adapte,Adapte / Adapte
129,130,2015,Management,2,6,QO,0.8291,0.16,0.51,74,66,61,5,1.12,92.42,61,13,82.91,Facile,Facile,Facile / Facile
959,130,2016,Management,2,6,QO,0.7962,0.2,0.64,60,58,48,10,1.03,82.76,48,12,79.62,Trop Facile,Facile,Trop Facile / Facile
1789,130,2017,Management,2,6,QO,0.8694,0.08,0.61,54,50,47,3,1.08,94.0,47,7,86.94,Trop Facile,Trop Facile,Trop Facile / Trop Facile
2619,130,2018,Management,2,6,QO,0.8897,0.02,0.51,52,49,46,3,1.06,93.88,46,6,88.97,Trop Facile,Trop Facile,Trop Facile / Trop Facile
3449,130,2019,Management,2,6,QO,0.9365,0.09,0.92,46,44,43,1,1.05,97.73,43,3,93.65,Trop Facile,Trop Facile,Trop Facile / Trop Facile
4279,130,2020,Management,2,6,QO,0.9422,0.0,0.87,51,49,48,1,1.04,97.96,48,3,94.22,Trop Facile,Trop Facile,Trop Facile / Trop Facile
130,131,2015,Management,2,7,QCU,0.3125,0.24,0.38,27,20,8,12,1.35,40.0,8,19,31.25,Trop Facile,Difficile,Trop Facile / Difficile
960,131,2016,Management,2,7,QCU,0.9224,0.03,0.91,31,29,29,0,1.07,100.0,29,2,92.24,Trop Facile,Trop Facile,Trop Facile / Trop Facile
1790,131,2017,Management,2,7,QCU,0.7816,0.02,0.78,37,36,29,7,1.03,80.56,29,8,78.16,Trop Facile,Facile,Trop Facile / Facile
2620,131,2018,Management,2,7,QCU,0.9015,0.05,1.0,37,37,33,4,1.0,89.19,33,4,90.15,Trop Facile,Trop Facile,Trop Facile / Trop Facile
3450,131,2019,Management,2,7,QCU,0.9633,0.04,0.92,43,43,41,2,1.0,95.35,41,2,96.33,Trop Facile,Trop Facile,Trop Facile / Trop Facile
4280,131,2020,Management,2,7,QCU,0.8995,0.05,0.92,35,33,31,2,1.06,93.94,31,4,89.95,Trop Facile,Trop Facile,Trop Facile / Trop Facile
131,132,2015,Management,2,8,QCM,0.664,0.29,0.67,88,82,58,24,1.07,70.73,58,30,66.4,Adapte,Adapte,Adapte / Adapte
961,132,2016,Management,2,8,QCM,0.6693,0.28,0.69,97,96,65,31,1.01,67.71,65,32,66.93,Adapte,Adapte,Adapte / Adapte
1791,132,2017,Management,2,8,QCM,0.6317,0.07,0.53,86,81,54,27,1.06,66.67,54,32,63.17,Adapte,Adapte,Adapte / Adapte
2621,132,2018,Management,2,8,QCM,0.6765,0.04,0.6,91,65,62,3,1.4,95.38,62,29,67.65,Adapte,Adapte,Adapte / Adapte
3451,132,2019,Management,2,8,QCM,0.7421,0.28,0.41,84,83,62,21,1.01,74.7,62,22,74.21,Adapte,Adapte,Adapte / Adapte
4281,132,2020,Management,2,8,QCM,0.7229,0.01,0.57,75,62,54,8,1.21,87.1,54,21,72.29,Adapte,Adapte,Adapte / Adapte
132,133,2015,Management,2,9,QCU,0.741,0.23,0.58,74,61,55,6,1.21,90.16,55,19,74.1,Adapte,Adapte,Adapte / Adapte
962,133,2016,Management,2,9,QCU,0.6262,0.13,0.52,88,72,55,17,1.22,76.39,55,33,62.62,Adapte,Adapte,Adapte / Adapte
1792,133,2017,Management,2,9,QCU,0.7065,0.26,0.45,89,67,63,4,1.33,94.03,63,26,70.65,Adapte,Adapte,Adapte / Adapte
2622,133,2018,Management,2,9,QCU,0.6106,0.03,0.41,83,70,51,19,1.19,72.86,51,32,61.06,Adapte,Adapte,Adapte / Adapte
3452,133,2019,Management,2,9,QCU,0.7434,0.19,0.48,88,74,65,9,1.19,87.84,65,23,74.34,Adapte,Adapte,Adapte / Adapte
4282,133,2020,Management,2,9,QCU,0.7203,0.27,0.62,87,72,63,9,1.21,87.5,63,24,72.03,Adapte,Adapte,Adapte / Adapte
133,134,2015,Management,2,10,QCU,0.9751,0.02,0.94,20,20,20,0,1.0,100.0,20,0,97.51,Trop Facile,Trop Facile,Trop Facile / Trop Facile
963,134,2016,Management,2,10,QCU,0.0675,0.28,0.23,19,15,1,14,1.27,6.67,1,18,6.75,Trop Facile,Trop Difficile,Trop Facile / Trop Difficile
1793,134,2017,Management,2,10,QCU,0.8607,0.08,0.91,19,18,16,2,1.06,88.89,16,3,86.07,Trop Facile,Trop Facile,Trop Facile / Trop Facile
2623,134,2018,Management,2,10,QCU,0.6556,0.22,0.41,23,21,15,6,1.1,71.43,15,8,65.56,Trop Facile,Adapte,Trop Facile / Adapte
3453,134,2019,Management,2,10,QCU,0.7242,0.04,0.46,27,25,20,5,1.08,80.0,20,7,72.42,Adapte,Adapte,Adapte / Adapte
4283,134,2020,Management,2,10,QCU,0.693,0.13,0.62,30,25,21,4,1.2,84.0,21,9,69.3,Adapte,Adapte,Adapte / Adapte
134,135,2015,Management,2,11,QCU,0.9817,0.07,0.96,81,81,80,1,1.0,98.77,80,1,98.17,Difficile,Trop Facile,Difficile / Trop Facile
964,135,2016,Management,2,11,QCU,0.0434,0.34,0.24,76,51,3,48,1.49,5.88,3,73,4.34,Trop Facile,Trop Difficile,Trop Facile / Trop Difficile
1794,135,2017,Management,2,11,QCU,0.994,0.05,0.9,73,73,73,0,1.0,100.0,73,0,99.4,Trop Facile,Trop Facile,Trop Facile / Trop Facile
2624,135,2018,Management,2,11,QCU,0.9825,0.04,0.92,66,65,65,0,1.02,100.0,65,1,98.25,Trop Facile,Trop Facile,Trop Facile / Trop Facile
3454,135,2019,Management,2,11,QCU,0.8839,0.09,0.95,61,58,54,4,1.05,93.1,54,7,88.39,Trop Facile,Trop Facile,Trop Facile / Trop Facile
4284,135,2020,Management,2,11,QCU,0.9918,0.06,1.0,69,69,68,1,1.0,98.55,68,1,99.18,Trop Facile,Trop Facile,Trop Facile / Trop Facile
135,136,2015,Management,2,12,QCM,0.9903,0.04,0.98,21,21,21,0,1.0,100.0,21,0,99.03,Trop Facile,Trop Facile,Trop Facile / Trop Facile
965,136,2016,Management,2,12,QCM,0.814,0.17,0.77,18,16,15,1,1.12,93.75,15,3,81.4,Trop Facile,Facile,Trop Facile / Facile
1795,136,2017,Management,2,12,QCM,0.8648,0.03,0.86,17,15,15,0,1.13,100.0,15,2,86.48,Trop Facile,Trop Facile,Trop Facile / Trop Facile
2625,136,2018,Management,2,12,QCM,0.8902,0.07,0.97,15,15,13,2,1.0,86.67,13,2,89.02,Trop Facile,Trop Facile,Trop Facile / Trop Facile
3455,136,2019,Management,2,12,QCM,0.9752,0.04,0.93,12,12,12,0,1.0,100.0,12,0,97.52,Trop Facile,Trop Facile,Trop Facile / Trop Facile
4285,136,2020,Management,2,12,QCM,0.9887,0.08,0.99,14,14,14,0,1.0,100.0,14,0,98.87,Trop Facile,Trop Facile,Trop Facile / Trop Facile
136,137,2015,Management,2,13,QROC,0.2571,0.61,0.18,68,56,17,39,1.21,30.36,17,51,25.71,Adapte,Difficile,Adapte / Difficile
966,137,2016,Management,2,13,QROC,0.8808,0.01,0.99,74,73,65,8,1.01,89.04,65,9,88.08,Trop Facile,Trop Facile,Trop Facile / Trop Facile
1796,137,2017,Management,2,13,QROC,0.9075,0.0,0.67,65,65,59,6,1.0,90.77,59,6,90.75,Trop Facile,Trop Facile,Trop Facile / Trop Facile
2626,137,2018,Management,2,13,QROC,0.7078,0.26,0.33,56,43,40,3,1.3,93.02,40,16,70.78,Trop Facile,Adapte,Trop Facile / Adapte
3456,137,2019,Management,2,13,QROC,0.6991,0.35,0.32,50,45,35,10,1.11,77.78,35,15,69.91,Adapte,Adapte,Adapte / Adapte
4286,137,2020,Management,2,13,QROC,0.6925,0.31,0.34,51,50,35,15,1.02,70.0,35,16,69.25,Adapte,Adapte,Adapte / Adapte
137,138,2015,Management,3,1,QCU,0.632,0.02,0.7,64,43,40,3,1.49,93.02,40,24,63.2,Adapte,Adapte,Adapte / Adapte
967,138,2016,Management,3,1,QCU,0.6252,0.27,0.6,62,50,39,11,1.24,78.0,39,23,62.52,Adapte,Adapte,Adapte / Adapte
1797,138,2017,Management,3,1,QCU,0.662,0.12,0.7,72,52,48,4,1.38,92.31,48,24,66.2,Adapte,Adapte,Adapte / Adapte
2627,138,2018,Management,3,1,QCU,0.7031,0.19,0.44,66,49,46,3,1.35,93.88,46,20,70.31,Adapte,Adapte,Adapte / Adapte
3457,138,2019,Management,3,1,QCU,0.6869,0.24,0.55,63,54,43,11,1.17,79.63,43,20,68.69,Adapte,Adapte,Adapte / Adapte
4287,138,2020,Management,3,1,QCU,0.722,0.07,0.64,72,62,52,10,1.16,83.87,52,20,72.2,Adapte,Adapte,Adapte / Adapte
138,139,2015,Management,3,2,QCU,0.9707,0.04,0.92,42,41,41,0,1.02,100.0,41,1,97.07,Difficile,Trop Facile,Difficile / Trop Facile
968,139,2016,Management,3,2,QCU,0.9764,0.05,0.92,38,37,37,0,1.03,100.0,37,1,97.64,Trop Facile,Trop Facile,Trop Facile / Trop Facile
1798,139,2017,Management,3,2,QCU,0.8725,0.05,0.91,30,26,26,0,1.15,100.0,26,4,87.25,Trop Facile,Trop Facile,Trop Facile / Trop Facile
2628,139,2018,Management,3,2,QCU,0.942,0.04,0.95,26,24,24,0,1.08,100.0,24,2,94.2,Trop Facile,Trop Facile,Trop Facile / Trop Facile
3458,139,2019,Management,3,2,QCU,0.9417,0.04,0.91,28,27,26,1,1.04,96.3,26,2,94.17,Trop Facile,Trop Facile,Trop Facile / Trop Facile
4288,139,2020,Management,3,2,QCU,0.9155,0.04,0.98,30,29,27,2,1.03,93.1,27,3,91.55,Trop Facile,Trop Facile,Trop Facile / Trop Facile
139,140,2015,Management,3,3,QCM,0.0016,0.45,0.24,83,44,0,44,1.89,0.0,0,83,0.16,Trop Difficile,Trop Difficile,Trop Difficile / Trop Difficile
969,140,2016,Management,3,3,QCM,0.9937,0.07,0.96,73,73,73,0,1.0,100.0,73,0,99.37,Trop Facile,Trop Facile,Trop Facile / Trop Facile
1799,140,2017,Management,3,3,QCM,0.9247,0.09,0.95,83,82,77,5,1.01,93.9,77,6,92.47,Trop Facile,Trop Facile,Trop Facile / Trop Facile
2629,140,2018,Management,3,3,QCM,0.9083,0.07,0.86,78,77,71,6,1.01,92.21,71,7,90.83,Trop Facile,Trop Facile,Trop Facile / Trop Facile
3459,140,2019,Management,3,3,QCM,0.9948,0.05,0.85,85,85,85,0,1.0,100.0,85,0,99.48,Trop Facile,Trop Facile,Trop Facile / Trop Facile
4289,140,2020,Management,3,3,QCM,0.9465,0.1,0.94,93,89,88,1,1.04,98.88,88,5,94.65,Trop Facile,Trop Facile,Trop Facile / Trop Facile
140,141,2015,Management,4,1,QCU,0.3591,0.11,0.35,69,63,25,38,1.1,39.68,25,44,35.91,Difficile,Difficile,Difficile / Difficile
970,141,2016,Management,4,1,QCU,0.8168,0.15,0.9,65,60,53,7,1.08,88.33,53,12,81.68,Trop Facile,Facile,Trop Facile / Facile
1800,141,2017,Management,4,1,QCU,0.9731,0.09,0.94,67,66,65,1,1.02,98.48,65,2,97.31,Trop Facile,Trop Facile,Trop Facile / Trop Facile
2630,141,2018,Management,4,1,QCU,0.0745,0.14,0.25,54,34,4,30,1.59,11.76,4,50,7.45,Trop Facile,Trop Difficile,Trop Facile / Trop Difficile
3460,141,2019,Management,4,1,QCU,0.8697,0.05,0.92,65,65,57,8,1.0,87.69,57,8,86.97,Trop Facile,Trop Facile,Trop Facile / Trop Facile
4290,141,2020,Management,4,1,QCU,0.8683,0.05,0.99,75,66,65,1,1.14,98.48,65,10,86.83,Trop Facile,Trop Facile,Trop Facile / Trop Facile
141,142,2015,Management,4,2,QCM,0.9704,0.07,0.96,83,82,81,1,1.01,98.78,81,2,97.04,Facile,Trop Facile,Facile / Trop Facile
971,142,2016,Management,4,2,QCM,0.1853,0.3,0.21,87,38,16,22,2.29,42.11,16,71,18.53,Trop Facile,Trop Difficile,Trop Facile / Trop Difficile
1801,142,2017,Management,4,2,QCM,0.9277,0.07,0.88,74,73,69,4,1.01,94.52,69,5,92.77,Trop Facile,Trop Facile,Trop Facile / Trop Facile
2631,142,2018,Management,4,2,QCM,0.9575,0.06,0.89,82,80,79,1,1.02,98.75,79,3,95.75,Trop Facile,Trop Facile,Trop Facile / Trop Facile
3461,142,2019,Management,4,2,QCM,0.1093,0.38,0.27,90,76,10,66,1.18,13.16,10,80,10.93,Trop Facile,Trop Difficile,Trop Facile / Trop Difficile
4291,142,2020,Management,4,2,QCM,0.9331,0.04,0.97,90,89,84,5,1.01,94.38,84,6,93.31,Trop Facile,Trop Facile,Trop Facile / Trop Facile
142,143,2015,Management,4,3,QCM,0.8024,0.15,0.79,36,32,29,3,1.12,90.62,29,7,80.24,Trop Difficile,Facile,Trop Difficile / Facile
972,143,2016,Management,4,3,QCM,0.9144,0.03,0.84,34,32,31,1,1.06,96.88,31,3,91.44,Trop Facile,Trop Facile,Trop Facile / Trop Facile
1802,143,2017,Management,4,3,QCM,0.0814,0.05,0.2,32,30,3,27,1.07,10.0,3,29,8.14,Trop Facile,Trop Difficile,Trop Facile / Trop Difficile
2632,143,2018,Management,4,3,QCM,0.8795,0.05,0.8,28,28,25,3,1.0,89.29,25,3,87.95,Trop Facile,Trop Facile,Trop Facile / Trop Facile
3462,143,2019,Management,4,3,QCM,0.9391,0.07,0.93,28,26,26,0,1.08,100.0,26,2,93.91,Trop Facile,Trop Facile,Trop Facile / Trop Facile
4292,143,2020,Management,4,3,QCM,0.9328,0.09,0.98,22,21,21,0,1.05,100.0,21,1,93.28,Trop Facile,Trop Facile,Trop Facile / Trop Facile
143,144,2015,Management,4,4,QCU,0.0359,0.32,0.29,79,41,3,38,1.93,7.32,3,76,3.59,Trop Difficile,Trop Difficile,Trop Difficile / Trop Difficile
973,144,2016,Management,4,4,QCU,1.0,0.03,0.97,71,71,71,0,1.0,100.0,71,0,100.0,Trop Facile,Trop Facile,Trop Facile / Trop Facile
1803,144,2017,Management,4,4,QCU,0.9849,0.04,0.97,79,78,78,0,1.01,100.0,78,1,98.49,Trop Facile,Trop Facile,Trop Facile / Trop Facile
2633,144,2018,Management,4,4,QCU,0.9709,0.07,0.97,79,77,77,0,1.03,100.0,77,2,97.09,Trop Facile,Trop Facile,Trop Facile / Trop Facile
3463,144,2019,Management,4,4,QCU,0.0775,0.64,0.27,78,72,6,66,1.08,8.33,6,72,7.75,Trop Facile,Trop Difficile,Trop Facile / Trop Difficile
4293,144,2020,Management,4,4,QCU,0.9936,0.09,0.96,76,76,76,0,1.0,100.0,76,0,99.36,Trop Facile,Trop Facile,Trop Facile / Trop Facile
144,145,2015,Management,4,5,QCM,0.7439,0.15,0.67,23,18,17,1,1.28,94.44,17,6,74.39,Difficile,Adapte,Difficile / Adapte
974,145,2016,Management,4,5,QCM,0.7407,0.06,0.6,20,20,15,5,1.0,75.0,15,5,74.07,Adapte,Adapte,Adapte / Adapte
1804,145,2017,Management,4,5,QCM,0.6206,0.22,0.56,22,16,14,2,1.38,87.5,14,8,62.06,Adapte,Adapte,Adapte / Adapte
2634,145,2018,Management,4,5,QCM,0.7333,0.13,0.41,26,24,19,5,1.08,79.17,19,7,73.33,Adapte,Adapte,Adapte / Adapte
3464,145,2019,Management,4,5,QCM,0.7473,0.11,0.41,30,25,22,3,1.2,88.0,22,8,74.73,Adapte,Adapte,Adapte / Adapte
4294,145,2020,Management,4,5,QCM,0.6781,0.12,0.44,27,20,18,2,1.35,90.0,18,9,67.81,Adapte,Adapte,Adapte / Adapte
145,146,2015,Management,4,6,QCU,0.2066,0.0,0.28,70,47,14,33,1.49,29.79,14,56,20.66,Trop Difficile,Trop Difficile,Trop Difficile / Trop Difficile
975,146,2016,Management,4,6,QCU,0.8745,0.02,0.96,77,68,67,1,1.13,98.53,67,10,87.45,Trop Facile,Trop Facile,Trop Facile / Trop Facile
1805,146,2017,Management,4,6,QCU,0.6632,0.26,0.61,67,65,44,21,1.03,67.69,44,23,66.32,Trop Facile,Adapte,Trop Facile / Adapte
2635,146,2018,Management,4,6,QCU,0.7023,0.22,0.62,65,65,46,19,1.0,70.77,46,19,70.23,Adapte,Adapte,Adapte / Adapte
3465,146,2019,Management,4,6,QCU,0.6598,0.22,0.53,69,62,46,16,1.11,74.19,46,23,65.98,Adapte,Adapte,Adapte / Adapte
4295,146,2020,Management,4,6,QCU,0.6592,0.07,0.62,60,50,40,10,1.2,80.0,40,20,65.92,Adapte,Adapte,Adapte / Adapte
146,147,2015,Management,4,7,QCM,0.8174,0.07,0.72,36,35,29,6,1.03,82.86,29,7,81.74,Facile,Facile,Facile / Facile
976,147,2016,Management,4,7,QCM,0.8802,0.07,0.85,34,32,30,2,1.06,93.75,30,4,88.02,Trop Facile,Trop Facile,Trop Facile / Trop Facile
1806,147,2017,Management,4,7,QCM,0.6101,0.01,0.58,29,28,18,10,1.04,64.29,18,11,61.01,Trop Facile,Adapte,Trop Facile / Adapte
2636,147,2018,Management,4,7,QCM,0.6541,0.07,0.5,30,21,20,1,1.43,95.24,20,10,65.41,Adapte,Adapte,Adapte / Adapte
3466,147,2019,Management,4,7,QCM,0.623,0.01,0.43,25,24,16,8,1.04,66.67,16,9,62.3,Adapte,Adapte,Adapte / Adapte
4296,147,2020,Management,4,7,QCM,0.7306,0.18,0.52,20,17,15,2,1.18,88.24,15,5,73.06,Adapte,Adapte,Adapte / Adapte
147,148,2015,Management,4,8,QCU,0.792,0.18,0.8,63,63,50,13,1.0,79.37,50,13,79.2,Trop Facile,Facile,Trop Facile / Facile
977,148,2016,Management,4,8,QCU,0.9929,0.08,0.96,55,55,55,0,1.0,100.0,55,0,99.29,Trop Facile,Trop Facile,Trop Facile / Trop Facile
1807,148,2017,Management,4,8,QCU,0.7284,0.27,0.69,55,50,40,10,1.1,80.0,40,15,72.84,Trop Facile,Adapte,Trop Facile / Adapte
2637,148,2018,Management,4,8,QCU,0.6725,0.16,0.43,45,44,30,14,1.02,68.18,30,15,67.25,Adapte,Adapte,Adapte / Adapte
3467,148,2019,Management,4,8,QCU,0.6349,0.21,0.5,48,35,30,5,1.37,85.71,30,18,63.49,Adapte,Adapte,Adapte / Adapte
4297,148,2020,Management,4,8,QCU,0.6662,0.02,0.47,40,37,27,10,1.08,72.97,27,13,66.62,Adapte,Adapte,Adapte / Adapte
148,149,2015,Management,4,9,QCM,0.5696,0.27,0.4,11,9,6,3,1.22,66.67,6,5,56.96,Trop Facile,Difficile,Trop Facile / Difficile
978,149,2016,Management,4,9,QCM,0.9916,0.04,0.82,10,10,10,0,1.0,100.0,10,0,99.16,Trop Facile,Trop Facile,Trop Facile / Trop Facile
1808,149,2017,Management,4,9,QCM,0.1379,0.23,0.26,8,7,1,6,1.14,14.29,1,7,13.79,Trop Facile,Trop Difficile,Trop Facile / Trop Difficile
2638,149,2018,Management,4,9,QCM,0.884,0.06,0.83,9,8,8,0,1.12,100.0,8,1,88.4,Trop Facile,Trop Facile,Trop Facile / Trop Facile
3468,149,2019,Management,4,9,QCM,0.9925,0.09,0.85,9,9,9,0,1.0,100.0,9,0,99.25,Trop Facile,Trop Facile,Trop Facile / Trop Facile
4298,149,2020,Management,4,9,QCM,0.9537,0.06,0.93,9,9,9,0,1.0,100.0,9,0,95.37,Trop Facile,Trop Facile,Trop Facile / Trop Facile
149,150,2015,Management,4,10,QCU,0.6581,0.03,0.51,6,4,4,0,1.5,100.0,4,2,65.81,Trop Difficile,Adapte,Trop Difficile / Adapte
979,150,2016,Management,4,10,QCU,0.696,0.23,0.6,5,3,3,0,1.67,100.0,3,2,69.6,Adapte,Adapte,Adapte / Adapte
1809,150,2017,Management,4,10,QCU,0.6565,0.03,0.68,5,5,3,2,1.0,60.0,3,2,65.65,Adapte,Adapte,Adapte / Adapte
2639,150,2018,Management,4,10,QCU,0.6129,0.23,0.49,4,2,2,0,2.0,100.0,2,2,61.29,Adapte,Adapte,Adapte / Adapte
3469,150,2019,Management,4,10,QCU,0.6259,0.24,0.65,5,4,3,1,1.25,75.0,3,2,62.59,Adapte,Adapte,Adapte / Adapte
4299,150,2020,Management,4,10,QCU,0.696,0.15,0.41,5,4,3,1,1.25,75.0,3,2,69.6,Adapte,Adapte,Adapte / Adapte
150,151,2015,Management,4,11,QCU,0.6457,0.12,0.58,82,57,53,4,1.44,92.98,53,29,64.57,Difficile,Adapte,Difficile / Adapte
980,151,2016,Management,4,11,QCU,0.6378,0.17,0.66,97,87,62,25,1.11,71.26,62,35,63.78,Adapte,Adapte,Adapte / Adapte
1810,151,2017,Management,4,11,QCU,0.7021,0.1,0.56,88,84,62,22,1.05,73.81,62,26,70.21,Adapte,Adapte,Adapte / Adapte
2640,151,2018,Management,4,11,QCU,0.6222,0.17,0.59,86,73,54,19,1.18,73.97,54,32,62.22,Adapte,Adapte,Adapte / Adapte
3470,151,2019,Management,4,11,QCU,0.6438,0.04,0.64,102,79,66,13,1.29,83.54,66,36,64.38,Adapte,Adapte,Adapte / Adapte
4300,151,2020,Management,4,11,QCU,0.6239,0.25,0.66,89,75,56,19,1.19,74.67,56,33,62.39,Adapte,Adapte,Adapte / Adapte
151,152,2015,Management,4,12,QCM,0.6962,0.07,0.59,14,10,10,0,1.4,100.0,10,4,69.62,Trop Difficile,Adapte,Trop Difficile / Adapte
981,152,2016,Management,4,12,QCM,0.6274,0.08,0.57,13,12,8,4,1.08,66.67,8,5,62.74,Adapte,Adapte,Adapte / Adapte
1811,152,2017,Management,4,12,QCM,0.7293,0.06,0.43,14,14,10,4,1.0,71.43,10,4,72.93,Adapte,Adapte,Adapte / Adapte
2641,152,2018,Management,4,12,QCM,0.6632,0.19,0.61,14,14,9,5,1.0,64.29,9,5,66.32,Adapte,Adapte,Adapte / Adapte
3471,152,2019,Management,4,12,QCM,0.7044,0.25,0.64,13,10,9,1,1.3,90.0,9,4,70.44,Adapte,Adapte,Adapte / Adapte
4301,152,2020,Management,4,12,QCM,0.6496,0.06,0.54,11,10,7,3,1.1,70.0,7,4,64.96,Adapte,Adapte,Adapte / Adapte
152,153,2015,Management,5,1,QCM,0.7148,0.07,0.49,22,18,16,2,1.22,88.89,16,6,71.48,Adapte,Adapte,Adapte / Adapte
982,153,2016,Management,5,1,QCM,0.7372,0.06,0.65,21,16,15,1,1.31,93.75,15,6,73.72,Adapte,Adapte,Adapte / Adapte
1812,153,2017,Management,5,1,QCM,0.7466,0.06,0.62,17,15,13,2,1.13,86.67,13,4,74.66,Adapte,Adapte,Adapte / Adapte
2642,153,2018,Management,5,1,QCM,0.743,0.01,0.62,19,17,14,3,1.12,82.35,14,5,74.3,Adapte,Adapte,Adapte / Adapte
3472,153,2019,Management,5,1,QCM,0.673,0.08,0.52,23,18,15,3,1.28,83.33,15,8,67.3,Adapte,Adapte,Adapte / Adapte
4302,153,2020,Management,5,1,QCM,0.7254,0.14,0.65,19,18,14,4,1.06,77.78,14,5,72.54,Adapte,Adapte,Adapte / Adapte
153,154,2015,Management,5,2,QO,0.4319,0.8,0.02,83,64,36,28,1.3,56.25,36,47,43.19,Difficile,Difficile,Difficile / Difficile
983,154,2016,Management,5,2,QO,0.9255,0.01,0.54,70,67,65,2,1.04,97.01,65,5,92.55,Trop Facile,Trop Facile,Trop Facile / Trop Facile
1813,154,2017,Management,5,2,QO,0.7933,0.0,0.67,76,70,60,10,1.09,85.71,60,16,79.33,Trop Facile,Facile,Trop Facile / Facile
2643,154,2018,Management,5,2,QO,0.9733,0.08,0.57,70,68,68,0,1.03,100.0,68,2,97.33,Trop Facile,Trop Facile,Trop Facile / Trop Facile
3473,154,2019,Management,5,2,QO,0.9456,0.02,0.67,63,60,60,0,1.05,100.0,60,3,94.56,Trop Facile,Trop Facile,Trop Facile / Trop Facile
4303,154,2020,Management,5,2,QO,0.9022,0.02,0.94,58,54,52,2,1.07,96.3,52,6,90.22,Trop Facile,Trop Facile,Trop Facile / Trop Facile
154,155,2015,Management,5,3,QCM,0.7814,0.03,0.76,29,24,23,1,1.21,95.83,23,6,78.14,Facile,Facile,Facile / Facile
984,155,2016,Management,5,3,QCM,0.883,0.1,0.97,35,34,31,3,1.03,91.18,31,4,88.3,Trop Facile,Trop Facile,Trop Facile / Trop Facile
1814,155,2017,Management,5,3,QCM,0.9763,0.01,0.98,41,41,40,1,1.0,97.56,40,1,97.63,Trop Facile,Trop Facile,Trop Facile / Trop Facile
2644,155,2018,Management,5,3,QCM,0.7474,0.0,0.52,44,35,33,2,1.26,94.29,33,11,74.74,Trop Facile,Adapte,Trop Facile / Adapte
3474,155,2019,Management,5,3,QCM,0.6679,0.03,0.48,41,29,27,2,1.41,93.1,27,14,66.79,Adapte,Adapte,Adapte / Adapte
4304,155,2020,Management,5,3,QCM,0.7264,0.25,0.49,41,39,30,9,1.05,76.92,30,11,72.64,Adapte,Adapte,Adapte / Adapte
155,156,2015,Management,5,4,QROC,0.9014,0.05,0.83,22,21,20,1,1.05,95.24,20,2,90.14,Trop Difficile,Trop Facile,Trop Difficile / Trop Facile
985,156,2016,Management,5,4,QROC,0.8776,0.07,0.7,20,19,18,1,1.05,94.74,18,2,87.76,Trop Facile,Trop Facile,Trop Facile / Trop Facile
1815,156,2017,Management,5,4,QROC,0.8844,0.04,0.63,21,21,19,2,1.0,90.48,19,2,88.44,Trop Facile,Trop Facile,Trop Facile / Trop Facile
2645,156,2018,Management,5,4,QROC,0.933,0.02,0.74,24,23,22,1,1.04,95.65,22,2,93.3,Trop Facile,Trop Facile,Trop Facile / Trop Facile
3475,156,2019,Management,5,4,QROC,0.6596,0.34,0.35,27,23,18,5,1.17,78.26,18,9,65.96,Trop Facile,Adapte,Trop Facile / Adapte
4305,156,2020,Management,5,4,QROC,0.7122,0.24,0.39,30,24,21,3,1.25,87.5,21,9,71.22,Adapte,Adapte,Adapte / Adapte
156,157,2015,Management,5,5,QCM,0.7934,0.04,0.75,57,49,45,4,1.16,91.84,45,12,79.34,Facile,Facile,Facile / Facile
986,157,2016,Management,5,5,QCM,0.0467,0.29,0.24,58,32,3,29,1.81,9.38,3,55,4.67,Trop Facile,Trop Difficile,Trop Facile / Trop Difficile
1816,157,2017,Management,5,5,QCM,0.8669,0.0,0.93,63,60,55,5,1.05,91.67,55,8,86.69,Trop Facile,Trop Facile,Trop Facile / Trop Facile
2646,157,2018,Management,5,5,QCM,0.1915,0.61,0.22,74,30,14,16,2.47,46.67,14,60,19.15,Trop Facile,Trop Difficile,Trop Facile / Trop Difficile
3476,157,2019,Management,5,5,QCM,0.9171,0.07,0.92,59,56,54,2,1.05,96.43,54,5,91.71,Trop Facile,Trop Facile,Trop Facile / Trop Facile
4306,157,2020,Management,5,5,QCM,0.9653,0.02,0.81,54,54,52,2,1.0,96.3,52,2,96.53,Trop Facile,Trop Facile,Trop Facile / Trop Facile
157,158,2015,Management,5,6,QCU,0.0559,0.24,0.2,63,24,4,20,2.62,16.67,4,59,5.59,Trop Difficile,Trop Difficile,Trop Difficile / Trop Difficile
987,158,2016,Management,5,6,QCU,0.5183,0.34,0.36,55,44,29,15,1.25,65.91,29,26,51.83,Trop Facile,Difficile,Trop Facile / Difficile
1817,158,2017,Management,5,6,QCU,0.0758,0.71,0.29,49,36,4,32,1.36,11.11,4,45,7.58,Trop Facile,Trop Difficile,Trop Facile / Trop Difficile
2647,158,2018,Management,5,6,QCU,0.8952,0.0,0.92,50,47,45,2,1.06,95.74,45,5,89.52,Trop Facile,Trop Facile,Trop Facile / Trop Facile
3477,158,2019,Management,5,6,QCU,0.9195,0.03,0.96,57,55,52,3,1.04,94.55,52,5,91.95,Trop Facile,Trop Facile,Trop Facile / Trop Facile
4307,158,2020,Management,5,6,QCU,0.9261,0.07,0.99,61,60,56,4,1.02,93.33,56,5,92.61,Trop Facile,Trop Facile,Trop Facile / Trop Facile
158,159,2015,Management,5,7,QCU,0.8406,0.14,0.85,76,74,64,10,1.03,86.49,64,12,84.06,Facile,Facile,Facile / Facile
988,159,2016,Management,5,7,QCU,0.936,0.1,0.98,68,67,64,3,1.01,95.52,64,4,93.6,Trop Facile,Trop Facile,Trop Facile / Trop Facile
1818,159,2017,Management,5,7,QCU,0.8944,0.07,0.99,81,79,72,7,1.03,91.14,72,9,89.44,Trop Facile,Trop Facile,Trop Facile / Trop Facile
2648,159,2018,Management,5,7,QCU,0.9774,0.05,0.96,96,94,94,0,1.02,100.0,94,2,97.74,Trop Facile,Trop Facile,Trop Facile / Trop Facile
3478,159,2019,Management,5,7,QCU,0.8812,0.04,0.99,94,89,83,6,1.06,93.26,83,11,88.12,Trop Facile,Trop Facile,Trop Facile / Trop Facile
4308,159,2020,Management,5,7,QCU,0.8977,0.05,0.97,110,104,99,5,1.06,95.19,99,11,89.77,Trop Facile,Trop Facile,Trop Facile / Trop Facile
159,160,2015,Management,5,8,QCM,0.4153,0.16,0.39,24,19,10,9,1.26,52.63,10,14,41.53,Trop Difficile,Difficile,Trop Difficile / Difficile
989,160,2016,Management,5,8,QCM,0.4977,0.39,0.33,23,15,11,4,1.53,73.33,11,12,49.77,Trop Facile,Difficile,Trop Facile / Difficile
1819,160,2017,Management,5,8,QCM,0.9039,0.05,0.82,25,24,23,1,1.04,95.83,23,2,90.39,Trop Facile,Trop Facile,Trop Facile / Trop Facile
2649,160,2018,Management,5,8,QCM,0.9482,0.09,0.98,24,23,23,0,1.04,100.0,23,1,94.82,Trop Facile,Trop Facile,Trop Facile / Trop Facile
3479,160,2019,Management,5,8,QCM,0.8699,0.05,0.82,20,18,17,1,1.11,94.44,17,3,86.99,Trop Facile,Trop Facile,Trop Facile / Trop Facile
4309,160,2020,Management,5,8,QCM,0.9289,0.02,0.98,24,23,22,1,1.04,95.65,22,2,92.89,Trop Facile,Trop Facile,Trop Facile / Trop Facile
160,161,2015,Management,5,9,QCU,0.8427,0.06,0.83,61,55,51,4,1.11,92.73,51,10,84.27,Facile,Facile,Facile / Facile
990,161,2016,Management,5,9,QCU,0.7654,0.14,0.89,72,57,55,2,1.26,96.49,55,17,76.54,Trop Facile,Facile,Trop Facile / Facile
1820,161,2017,Management,5,9,QCU,0.6717,0.24,0.64,78,63,52,11,1.24,82.54,52,26,67.17,Trop Facile,Adapte,Trop Facile / Adapte
2650,161,2018,Management,5,9,QCU,0.685,0.04,0.57,65,49,45,4,1.33,91.84,45,20,68.5,Adapte,Adapte,Adapte / Adapte
3480,161,2019,Management,5,9,QCU,0.6674,0.04,0.52,74,66,49,17,1.12,74.24,49,25,66.74,Adapte,Adapte,Adapte / Adapte
4310,161,2020,Management,5,9,QCU,0.7462,0.06,0.62,70,67,52,15,1.04,77.61,52,18,74.62,Adapte,Adapte,Adapte / Adapte
161,162,2015,Management,5,10,QCM,0.8033,0.12,0.71,31,29,25,4,1.07,86.21,25,6,80.33,Facile,Facile,Facile / Facile
991,162,2016,Management,5,10,QCM,0.9497,0.02,0.89,35,35,33,2,1.0,94.29,33,2,94.97,Trop Facile,Trop Facile,Trop Facile / Trop Facile
1821,162,2017,Management,5,10,QCM,0.9813,0.0,0.95,31,31,30,1,1.0,96.77,30,1,98.13,Trop Facile,Trop Facile,Trop Facile / Trop Facile
2651,162,2018,Management,5,10,QCM,0.8872,0.06,0.93,37,34,33,1,1.09,97.06,33,4,88.72,Trop Facile,Trop Facile,Trop Facile / Trop Facile
3481,162,2019,Management,5,10,QCM,0.2348,0.55,0.22,42,40,10,30,1.05,25.0,10,32,23.48,Trop Facile,Trop Difficile,Trop Facile / Trop Difficile
4311,162,2020,Management,5,10,QCM,0.8918,0.04,0.9,42,38,37,1,1.11,97.37,37,5,89.18,Trop Facile,Trop Facile,Trop Facile / Trop Facile
162,163,2015,Management,5,11,QCM,0.6149,0.25,0.41,23,19,14,5,1.21,73.68,14,9,61.49,Adapte,Adapte,Adapte / Adapte
992,163,2016,Management,5,11,QCM,0.7176,0.21,0.48,28,24,20,4,1.17,83.33,20,8,71.76,Adapte,Adapte,Adapte / Adapte
1822,163,2017,Management,5,11,QCM,0.7389,0.11,0.6,28,26,21,5,1.08,80.77,21,7,73.89,Adapte,Adapte,Adapte / Adapte
2652,163,2018,Management,5,11,QCM,0.7497,0.04,0.47,34,33,25,8,1.03,75.76,25,9,74.97,Adapte,Adapte,Adapte / Adapte
3482,163,2019,Management,5,11,QCM,0.6567,0.29,0.52,27,19,18,1,1.42,94.74,18,9,65.67,Adapte,Adapte,Adapte / Adapte
4312,163,2020,Management,5,11,QCM,0.6184,0.23,0.56,25,21,15,6,1.19,71.43,15,10,61.84,Adapte,Adapte,Adapte / Adapte
163,164,2015,Management,5,12,QCU,0.4527,0.04,0.37,7,4,3,1,1.75,75.0,3,4,45.27,Difficile,Difficile,Difficile / Difficile
993,164,2016,Management,5,12,QCU,0.8745,0.02,0.95,6,5,5,0,1.2,100.0,5,1,87.45,Trop Facile,Trop Facile,Trop Facile / Trop Facile
1823,164,2017,Management,5,12,QCU,0.7816,0.03,0.87,6,5,5,0,1.2,100.0,5,1,78.16,Trop Facile,Facile,Trop Facile / Facile
2653,164,2018,Management,5,12,QCU,0.8992,0.02,1.0,7,7,6,1,1.0,85.71,6,1,89.92,Trop Facile,Trop Facile,Trop Facile / Trop Facile
3483,164,2019,Management,5,12,QCU,0.9575,0.0,0.97,7,7,7,0,1.0,100.0,7,0,95.75,Trop Facile,Trop Facile,Trop Facile / Trop Facile
4313,164,2020,Management,5,12,QCU,0.9064,0.08,0.91,7,6,6,0,1.17,100.0,6,1,90.64,Trop Facile,Trop Facile,Trop Facile / Trop Facile
164,165,2015,Management,5,13,QCU,0.0511,0.22,0.25,15,8,1,7,1.88,12.5,1,14,5.11,Facile,Trop Difficile,Facile / Trop Difficile
994,165,2016,Management,5,13,QCU,0.9626,0.0,0.91,17,16,16,0,1.06,100.0,16,1,96.26,Trop Facile,Trop Facile,Trop Facile / Trop Facile
1824,165,2017,Management,5,13,QCU,0.7143,0.21,0.42,14,14,10,4,1.0,71.43,10,4,71.43,Trop Facile,Adapte,Trop Facile / Adapte
2654,165,2018,Management,5,13,QCU,0.7406,0.2,0.5,14,12,10,2,1.17,83.33,10,4,74.06,Adapte,Adapte,Adapte / Adapte
3484,165,2019,Management,5,13,QCU,0.6593,0.27,0.63,14,11,9,2,1.27,81.82,9,5,65.93,Adapte,Adapte,Adapte / Adapte
4314,165,2020,Management,5,13,QCU,0.7085,0.08,0.47,13,10,9,1,1.3,90.0,9,4,70.85,Adapte,Adapte,Adapte / Adapte
165,166,2015,Management,5,14,QCU,0.8431,0.05,0.76,29,28,24,4,1.04,85.71,24,5,84.31,Facile,Facile,Facile / Facile
995,166,2016,Management,5,14,QCU,0.2236,0.58,0.27,33,25,7,18,1.32,28.0,7,26,22.36,Trop Facile,Trop Difficile,Trop Facile / Trop Difficile
1825,166,2017,Management,5,14,QCU,0.0599,0.1,0.26,38,18,2,16,2.11,11.11,2,36,5.99,Trop Facile,Trop Difficile,Trop Facile / Trop Difficile
2655,166,2018,Management,5,14,QCU,0.9919,0.04,0.94,37,37,37,0,1.0,100.0,37,0,99.19,Trop Facile,Trop Facile,Trop Facile / Trop Facile
3485,166,2019,Management,5,14,QCU,0.9925,0.03,0.94,31,31,31,0,1.0,100.0,31,0,99.25,Trop Facile,Trop Facile,Trop Facile / Trop Facile
4315,166,2020,Management,5,14,QCU,0.4745,0.2,0.32,28,18,13,5,1.56,72.22,13,15,47.45,Trop Facile,Difficile,Trop Facile / Difficile
166,167,2015,Management,6,1,QCU,0.5006,0.1,0.36,93,84,47,37,1.11,55.95,47,46,50.06,Facile,Difficile,Facile / Difficile
996,167,2016,Management,6,1,QCU,0.692,0.05,0.51,80,69,55,14,1.16,79.71,55,25,69.2,Trop Facile,Adapte,Trop Facile / Adapte
1826,167,2017,Management,6,1,QCU,0.6204,0.21,0.44,65,63,40,23,1.03,63.49,40,25,62.04,Adapte,Adapte,Adapte / Adapte
2656,167,2018,Management,6,1,QCU,0.6452,0.05,0.63,69,65,45,20,1.06,69.23,45,24,64.52,Adapte,Adapte,Adapte / Adapte
3486,167,2019,Management,6,1,QCU,0.6222,0.21,0.7,59,55,37,18,1.07,67.27,37,22,62.22,Adapte,Adapte,Adapte / Adapte
4316,167,2020,Management,6,1,QCU,0.6268,0.22,0.49,53,35,33,2,1.51,94.29,33,20,62.68,Adapte,Adapte,Adapte / Adapte
167,168,2015,Management,6,2,QO,0.7655,0.1,0.65,93,75,71,4,1.24,94.67,71,22,76.55,Difficile,Facile,Difficile / Facile
997,168,2016,Management,6,2,QO,0.9933,0.0,0.85,81,81,80,1,1.0,98.77,80,1,99.33,Trop Facile,Trop Facile,Trop Facile / Trop Facile
1827,168,2017,Management,6,2,QO,0.8817,0.08,0.81,96,89,85,4,1.08,95.51,85,11,88.17,Trop Facile,Trop Facile,Trop Facile / Trop Facile
2657,168,2018,Management,6,2,QO,0.6087,0.43,0.16,109,83,66,17,1.31,79.52,66,43,60.87,Trop Facile,Adapte,Trop Facile / Adapte
3487,168,2019,Management,6,2,QO,0.6452,0.38,0.18,125,117,81,36,1.07,69.23,81,44,64.52,Adapte,Adapte,Adapte / Adapte
4317,168,2020,Management,6,2,QO,0.7191,0.51,0.16,142,136,102,34,1.04,75.0,102,40,71.91,Adapte,Adapte,Adapte / Adapte
168,169,2015,Management,6,3,QCU,0.4966,0.12,0.38,65,34,32,2,1.91,94.12,32,33,49.66,Difficile,Difficile,Difficile / Difficile
998,169,2016,Management,6,3,QCU,0.9914,0.09,0.96,77,77,76,1,1.0,98.7,76,1,99.14,Trop Facile,Trop Facile,Trop Facile / Trop Facile
1828,169,2017,Management,6,3,QCU,0.9305,0.08,0.96,84,82,78,4,1.02,95.12,78,6,93.05,Trop Facile,Trop Facile,Trop Facile / Trop Facile
2658,169,2018,Management,6,3,QCU,0.9582,0.05,0.97,90,88,86,2,1.02,97.73,86,4,95.82,Trop Facile,Trop Facile,Trop Facile / Trop Facile
3488,169,2019,Management,6,3,QCU,0.9624,0.09,0.94,91,89,88,1,1.02,98.88,88,3,96.24,Trop Facile,Trop Facile,Trop Facile / Trop Facile
4318,169,2020,Management,6,3,QCU,0.8181,0.17,0.78,73,63,60,3,1.16,95.24,60,13,81.81,Trop Facile,Facile,Trop Facile / Facile
169,170,2015,Management,6,4,QCM,0.6081,0.04,0.65,73,67,44,23,1.09,65.67,44,29,60.81,Adapte,Adapte,Adapte / Adapte
999,170,2016,Management,6,4,QCM,0.712,0.27,0.54,79,73,56,17,1.08,76.71,56,23,71.2,Adapte,Adapte,Adapte / Adapte
1829,170,2017,Management,6,4,QCM,0.6553,0.11,0.47,89,64,58,6,1.39,90.62,58,31,65.53,Adapte,Adapte,Adapte / Adapte
2659,170,2018,Management,6,4,QCM,0.6507,0.0,0.69,92,86,60,26,1.07,69.77,60,32,65.07,Adapte,Adapte,Adapte / Adapte
3489,170,2019,Management,6,4,QCM,0.6298,0.24,0.63,74,70,47,23,1.06,67.14,47,27,62.98,Adapte,Adapte,Adapte / Adapte
4319,170,2020,Management,6,4,QCM,0.7345,0.07,0.59,61,55,45,10,1.11,81.82,45,16,73.45,Adapte,Adapte,Adapte / Adapte
170,171,2015,Management,6,5,QCM,0.5655,0.29,0.34,79,78,45,33,1.01,57.69,45,34,56.55,Difficile,Difficile,Difficile / Difficile
1000,171,2016,Management,6,5,QCM,0.8621,0.04,0.86,66,59,57,2,1.12,96.61,57,9,86.21,Trop Facile,Trop Facile,Trop Facile / Trop Facile
1830,171,2017,Management,6,5,QCM,0.9363,0.09,0.96,72,71,67,4,1.01,94.37,67,5,93.63,Trop Facile,Trop Facile,Trop Facile / Trop Facile
2660,171,2018,Management,6,5,QCM,0.8112,0.17,0.71,76,64,62,2,1.19,96.88,62,14,81.12,Trop Facile,Facile,Trop Facile / Facile
3490,171,2019,Management,6,5,QCM,0.9539,0.04,0.93,84,83,80,3,1.01,96.39,80,4,95.39,Trop Facile,Trop Facile,Trop Facile / Trop Facile
4320,171,2020,Management,6,5,QCM,0.8648,0.08,0.83,87,78,75,3,1.12,96.15,75,12,86.48,Trop Facile,Trop Facile,Trop Facile / Trop Facile
171,172,2015,Management,6,6,QCU,0.7842,0.13,0.86,51,51,40,11,1.0,78.43,40,11,78.42,Difficile,Facile,Difficile / Facile
1001,172,2016,Management,6,6,QCU,0.8764,0.06,0.93,57,55,50,5,1.04,90.91,50,7,87.64,Trop Facile,Trop Facile,Trop Facile / Trop Facile
1831,172,2017,Management,6,6,QCU,0.7344,0.05,0.52,55,42,40,2,1.31,95.24,40,15,73.44,Trop Facile,Adapte,Trop Facile / Adapte
2661,172,2018,Management,6,6,QCU,0.6695,0.04,0.42,65,53,44,9,1.23,83.02,44,21,66.95,Adapte,Adapte,Adapte / Adapte
3491,172,2019,Management,6,6,QCU,0.6564,0.19,0.55,68,53,45,8,1.28,84.91,45,23,65.64,Adapte,Adapte,Adapte / Adapte
4321,172,2020,Management,6,6,QCU,0.6816,0.21,0.61,58,52,40,12,1.12,76.92,40,18,68.16,Adapte,Adapte,Adapte / Adapte
172,173,2015,Management,6,7,QROC,0.1734,0.82,0.13,76,55,13,42,1.38,23.64,13,63,17.34,Difficile,Trop Difficile,Difficile / Trop Difficile
1002,173,2016,Management,6,7,QROC,0.9331,0.03,0.91,80,75,75,0,1.07,100.0,75,5,93.31,Trop Facile,Trop Facile,Trop Facile / Trop Facile
1832,173,2017,Management,6,7,QROC,0.9355,0.1,0.61,74,73,69,4,1.01,94.52,69,5,93.55,Trop Facile,Trop Facile,Trop Facile / Trop Facile
2662,173,2018,Management,6,7,QROC,0.924,0.04,0.93,67,65,62,3,1.03,95.38,62,5,92.4,Trop Facile,Trop Facile,Trop Facile / Trop Facile
3492,173,2019,Management,6,7,QROC,0.9349,0.02,0.56,76,76,71,5,1.0,93.42,71,5,93.49,Trop Facile,Trop Facile,Trop Facile / Trop Facile
4322,173,2020,Management,6,7,QROC,0.9246,0.01,0.84,76,72,70,2,1.06,97.22,70,6,92.46,Trop Facile,Trop Facile,Trop Facile / Trop Facile
173,174,2015,Management,7,1,QCU,0.1485,0.49,0.2,34,13,5,8,2.62,38.46,5,29,14.85,Trop Difficile,Trop Difficile,Trop Difficile / Trop Difficile
1003,174,2016,Management,7,1,QCU,0.9195,0.02,0.93,35,32,32,0,1.09,100.0,32,3,91.95,Trop Facile,Trop Facile,Trop Facile / Trop Facile
1833,174,2017,Management,7,1,QCU,0.9236,0.09,0.94,36,35,33,2,1.03,94.29,33,3,92.36,Trop Facile,Trop Facile,Trop Facile / Trop Facile
2663,174,2018,Management,7,1,QCU,0.9002,0.02,0.94,32,31,29,2,1.03,93.55,29,3,90.02,Trop Facile,Trop Facile,Trop Facile / Trop Facile
3493,174,2019,Management,7,1,QCU,0.124,0.26,0.24,31,12,4,8,2.58,33.33,4,27,12.4,Trop Facile,Trop Difficile,Trop Facile / Trop Difficile
4323,174,2020,Management,7,1,QCU,0.3544,0.16,0.35,36,18,13,5,2.0,72.22,13,23,35.44,Trop Facile,Difficile,Trop Facile / Difficile
174,175,2015,Management,7,2,QROC,0.6217,0.46,0.26,39,34,24,10,1.15,70.59,24,15,62.17,Difficile,Adapte,Difficile / Adapte
1004,175,2016,Management,7,2,QROC,0.647,0.2,0.26,41,38,27,11,1.08,71.05,27,14,64.7,Adapte,Adapte,Adapte / Adapte
1834,175,2017,Management,7,2,QROC,0.7435,0.47,0.26,42,33,31,2,1.27,93.94,31,11,74.35,Adapte,Adapte,Adapte / Adapte
2664,175,2018,Management,7,2,QROC,0.7181,0.28,0.35,38,36,27,9,1.06,75.0,27,11,71.81,Adapte,Adapte,Adapte / Adapte
3494,175,2019,Management,7,2,QROC,0.6923,0.5,0.39,37,37,26,11,1.0,70.27,26,11,69.23,Adapte,Adapte,Adapte / Adapte
4324,175,2020,Management,7,2,QROC,0.6341,0.35,0.32,35,30,22,8,1.17,73.33,22,13,63.41,Adapte,Adapte,Adapte / Adapte
175,176,2015,Management,7,3,QCM,0.2783,0.36,0.4,83,81,23,58,1.02,28.4,23,60,27.83,Difficile,Difficile,Difficile / Difficile
1005,176,2016,Management,7,3,QCM,0.2344,0.75,0.28,83,33,19,14,2.52,57.58,19,64,23.44,Trop Facile,Trop Difficile,Trop Facile / Trop Difficile
1835,176,2017,Management,7,3,QCM,0.8772,0.05,0.91,99,91,87,4,1.09,95.6,87,12,87.72,Trop Facile,Trop Facile,Trop Facile / Trop Facile
2665,176,2018,Management,7,3,QCM,0.7332,0.17,0.7,88,66,65,1,1.33,98.48,65,23,73.32,Trop Facile,Adapte,Trop Facile / Adapte
3495,176,2019,Management,7,3,QCM,0.6561,0.03,0.63,73,65,48,17,1.12,73.85,48,25,65.61,Adapte,Adapte,Adapte / Adapte
4325,176,2020,Management,7,3,QCM,0.7183,0.24,0.68,67,62,48,14,1.08,77.42,48,19,71.83,Adapte,Adapte,Adapte / Adapte
176,177,2015,Management,7,4,QCU,0.8104,0.01,0.79,26,23,21,2,1.13,91.3,21,5,81.04,Facile,Facile,Facile / Facile
1006,177,2016,Management,7,4,QCU,0.8759,0.03,0.92,24,23,21,2,1.04,91.3,21,3,87.59,Trop Facile,Trop Facile,Trop Facile / Trop Facile
1836,177,2017,Management,7,4,QCU,0.9676,0.09,0.94,28,27,27,0,1.04,100.0,27,1,96.76,Trop Facile,Trop Facile,Trop Facile / Trop Facile
2666,177,2018,Management,7,4,QCU,0.9717,0.1,0.93,29,29,28,1,1.0,96.55,28,1,97.17,Trop Facile,Trop Facile,Trop Facile / Trop Facile
3496,177,2019,Management,7,4,QCU,0.875,0.07,0.9,35,33,31,2,1.06,93.94,31,4,87.5,Trop Facile,Trop Facile,Trop Facile / Trop Facile
4326,177,2020,Management,7,4,QCU,0.9593,0.03,0.98,38,37,36,1,1.03,97.3,36,2,95.93,Trop Facile,Trop Facile,Trop Facile / Trop Facile
177,178,2015,Management,7,5,QCM,0.0884,0.4,0.21,25,11,2,9,2.27,18.18,2,23,8.84,Trop Difficile,Trop Difficile,Trop Difficile / Trop Difficile
1007,178,2016,Management,7,5,QCM,0.8672,0.05,0.81,24,23,21,2,1.04,91.3,21,3,86.72,Trop Facile,Trop Facile,Trop Facile / Trop Facile
1837,178,2017,Management,7,5,QCM,0.9305,0.07,0.82,29,29,27,2,1.0,93.1,27,2,93.05,Trop Facile,Trop Facile,Trop Facile / Trop Facile
2667,178,2018,Management,7,5,QCM,0.9435,0.06,0.92,30,30,28,2,1.0,93.33,28,2,94.35,Trop Facile,Trop Facile,Trop Facile / Trop Facile
3497,178,2019,Management,7,5,QCM,0.8695,0.04,0.9,28,25,24,1,1.12,96.0,24,4,86.95,Trop Facile,Trop Facile,Trop Facile / Trop Facile
4327,178,2020,Management,7,5,QCM,0.9278,0.09,0.96,34,33,32,1,1.03,96.97,32,2,92.78,Trop Facile,Trop Facile,Trop Facile / Trop Facile
178,179,2015,Management,7,6,QCU,0.1243,0.42,0.23,86,83,11,72,1.04,13.25,11,75,12.43,Trop Facile,Trop Difficile,Trop Facile / Trop Difficile
1008,179,2016,Management,7,6,QCU,0.8664,0.0,1.0,74,65,64,1,1.14,98.46,64,10,86.64,Trop Facile,Trop Facile,Trop Facile / Trop Facile
1838,179,2017,Management,7,6,QCU,0.9145,0.05,0.98,81,77,74,3,1.05,96.1,74,7,91.45,Trop Facile,Trop Facile,Trop Facile / Trop Facile
2668,179,2018,Management,7,6,QCU,0.9248,0.02,0.92,86,81,80,1,1.06,98.77,80,6,92.48,Trop Facile,Trop Facile,Trop Facile / Trop Facile
3498,179,2019,Management,7,6,QCU,0.9562,0.05,0.96,101,101,97,4,1.0,96.04,97,4,95.62,Trop Facile,Trop Facile,Trop Facile / Trop Facile
4328,179,2020,Management,7,6,QCU,0.8935,0.09,0.97,108,97,96,1,1.11,98.97,96,12,89.35,Trop Facile,Trop Facile,Trop Facile / Trop Facile
179,180,2015,Management,7,7,QCM,0.7299,0.23,0.47,42,34,31,3,1.24,91.18,31,11,72.99,Adapte,Adapte,Adapte / Adapte
1009,180,2016,Management,7,7,QCM,0.6061,0.15,0.47,34,32,21,11,1.06,65.62,21,13,60.61,Adapte,Adapte,Adapte / Adapte
1839,180,2017,Management,7,7,QCM,0.7088,0.06,0.64,27,19,19,0,1.42,100.0,19,8,70.88,Adapte,Adapte,Adapte / Adapte
2669,180,2018,Management,7,7,QCM,0.6134,0.06,0.48,27,18,17,1,1.5,94.44,17,10,61.34,Adapte,Adapte,Adapte / Adapte
3499,180,2019,Management,7,7,QCM,0.6706,0.05,0.68,30,21,20,1,1.43,95.24,20,10,67.06,Adapte,Adapte,Adapte / Adapte
4329,180,2020,Management,7,7,QCM,0.6341,0.25,0.62,30,20,19,1,1.5,95.0,19,11,63.41,Adapte,Adapte,Adapte / Adapte
180,181,2015,Management,7,8,QCU,0.6668,0.23,0.41,96,96,64,32,1.0,66.67,64,32,66.68,Trop Facile,Adapte,Trop Facile / Adapte
1010,181,2016,Management,7,8,QCU,0.7282,0.13,0.68,115,91,84,7,1.26,92.31,84,31,72.82,Adapte,Adapte,Adapte / Adapte
1840,181,2017,Management,7,8,QCU,0.6889,0.07,0.42,109,102,75,27,1.07,73.53,75,34,68.89,Adapte,Adapte,Adapte / Adapte
2670,181,2018,Management,7,8,QCU,0.6034,0.08,0.7,100,94,60,34,1.06,63.83,60,40,60.34,Adapte,Adapte,Adapte / Adapte
3500,181,2019,Management,7,8,QCU,0.6318,0.12,0.41,86,58,54,4,1.48,93.1,54,32,63.18,Adapte,Adapte,Adapte / Adapte
4330,181,2020,Management,7,8,QCU,0.6748,0.17,0.6,78,57,53,4,1.37,92.98,53,25,67.48,Adapte,Adapte,Adapte / Adapte
181,182,2015,Management,7,9,QCU,0.941,0.03,0.93,50,48,47,1,1.04,97.92,47,3,94.1,Trop Facile,Trop Facile,Trop Facile / Trop Facile
1011,182,2016,Management,7,9,QCU,0.9158,0.05,0.95,59,59,54,5,1.0,91.53,54,5,91.58,Trop Facile,Trop Facile,Trop Facile / Trop Facile
1841,182,2017,Management,7,9,QCU,0.8607,0.07,1.0,66,59,57,2,1.12,96.61,57,9,86.07,Trop Facile,Trop Facile,Trop Facile / Trop Facile
2671,182,2018,Management,7,9,QCU,0.969,0.09,1.0,65,65,63,2,1.0,96.92,63,2,96.9,Trop Facile,Trop Facile,Trop Facile / Trop Facile
3501,182,2019,Management,7,9,QCU,0.9607,0.04,0.97,58,56,56,0,1.04,100.0,56,2,96.07,Trop Facile,Trop Facile,Trop Facile / Trop Facile
4331,182,2020,Management,7,9,QCU,0.9283,0.07,1.0,65,63,60,3,1.03,95.24,60,5,92.83,Trop Facile,Trop Facile,Trop Facile / Trop Facile
182,183,2015,Management,8,1,QCM,0.7797,0.17,0.76,84,69,65,4,1.22,94.2,65,19,77.97,Difficile,Facile,Difficile / Facile
1012,183,2016,Management,8,1,QCM,0.9851,0.05,0.84,96,95,95,0,1.01,100.0,95,1,98.51,Trop Facile,Trop Facile,Trop Facile / Trop Facile
1842,183,2017,Management,8,1,QCM,0.9598,0.06,0.98,99,97,95,2,1.02,97.94,95,4,95.98,Trop Facile,Trop Facile,Trop Facile / Trop Facile
2672,183,2018,Management,8,1,QCM,0.9153,0.06,0.99,79,73,72,1,1.08,98.63,72,7,91.53,Trop Facile,Trop Facile,Trop Facile / Trop Facile
3502,183,2019,Management,8,1,QCM,0.0651,0.31,0.29,80,41,5,36,1.95,12.2,5,75,6.51,Trop Facile,Trop Difficile,Trop Facile / Trop Difficile
4332,183,2020,Management,8,1,QCM,0.9558,0.06,0.86,75,73,72,1,1.03,98.63,72,3,95.58,Trop Facile,Trop Facile,Trop Facile / Trop Facile
183,184,2015,Management,8,2,QCU,0.6669,0.12,0.64,58,51,39,12,1.14,76.47,39,19,66.69,Adapte,Adapte,Adapte / Adapte
1013,184,2016,Management,8,2,QCU,0.6718,0.27,0.4,55,39,37,2,1.41,94.87,37,18,67.18,Adapte,Adapte,Adapte / Adapte
1843,184,2017,Management,8,2,QCU,0.6474,0.24,0.68,55,38,36,2,1.45,94.74,36,19,64.74,Adapte,Adapte,Adapte / Adapte
2673,184,2018,Management,8,2,QCU,0.7028,0.22,0.65,63,51,44,7,1.24,86.27,44,19,70.28,Adapte,Adapte,Adapte / Adapte
3503,184,2019,Management,8,2,QCU,0.7372,0.22,0.57,67,52,49,3,1.29,94.23,49,18,73.72,Adapte,Adapte,Adapte / Adapte
4333,184,2020,Management,8,2,QCU,0.6619,0.19,0.44,75,74,50,24,1.01,67.57,50,25,66.19,Adapte,Adapte,Adapte / Adapte
184,185,2015,Management,8,3,QCM,0.1968,0.25,0.23,26,14,5,9,1.86,35.71,5,21,19.68,Trop Difficile,Trop Difficile,Trop Difficile / Trop Difficile
1014,185,2016,Management,8,3,QCM,0.9145,0.05,0.9,25,25,23,2,1.0,92.0,23,2,91.45,Trop Facile,Trop Facile,Trop Facile / Trop Facile
1844,185,2017,Management,8,3,QCM,0.8438,0.08,0.76,21,21,18,3,1.0,85.71,18,3,84.38,Trop Facile,Facile,Trop Facile / Facile
2674,185,2018,Management,8,3,QCM,0.9792,0.05,0.82,20,20,20,0,1.0,100.0,20,0,97.92,Trop Facile,Trop Facile,Trop Facile / Trop Facile
3504,185,2019,Management,8,3,QCM,0.9464,0.01,0.88,16,15,15,0,1.07,100.0,15,1,94.64,Trop Facile,Trop Facile,Trop Facile / Trop Facile
4334,185,2020,Management,8,3,QCM,0.0983,0.51,0.29,19,14,2,12,1.36,14.29,2,17,9.83,Trop Facile,Trop Difficile,Trop Facile / Trop Difficile
185,186,2015,Management,8,4,QO,0.3886,0.88,0.1,48,42,19,23,1.14,45.24,19,29,38.86,Difficile,Difficile,Difficile / Difficile
1015,186,2016,Management,8,4,QO,0.8701,0.02,0.61,47,43,41,2,1.09,95.35,41,6,87.01,Trop Facile,Trop Facile,Trop Facile / Trop Facile
1845,186,2017,Management,8,4,QO,0.8933,0.08,0.94,51,49,46,3,1.04,93.88,46,5,89.33,Trop Facile,Trop Facile,Trop Facile / Trop Facile
2675,186,2018,Management,8,4,QO,0.4698,0.89,0.03,51,49,24,25,1.04,48.98,24,27,46.98,Trop Facile,Difficile,Trop Facile / Difficile
3505,186,2019,Management,8,4,QO,0.3813,0.86,0.04,48,28,18,10,1.71,64.29,18,30,38.13,Trop Facile,Difficile,Trop Facile / Difficile
4335,186,2020,Management,8,4,QO,0.8665,0.04,0.91,47,42,41,1,1.12,97.62,41,6,86.65,Trop Facile,Trop Facile,Trop Facile / Trop Facile
186,187,2015,Management,9,1,QCU,0.9653,0.01,1.0,69,69,67,2,1.0,97.1,67,2,96.53,Trop Facile,Trop Facile,Trop Facile / Trop Facile
1016,187,2016,Management,9,1,QCU,0.9884,0.09,0.92,61,60,60,0,1.02,100.0,60,1,98.84,Trop Facile,Trop Facile,Trop Facile / Trop Facile
1846,187,2017,Management,9,1,QCU,0.884,0.03,1.0,56,51,50,1,1.1,98.04,50,6,88.4,Trop Facile,Trop Facile,Trop Facile / Trop Facile
2676,187,2018,Management,9,1,QCU,0.0616,0.38,0.22,58,31,4,27,1.87,12.9,4,54,6.16,Trop Facile,Trop Difficile,Trop Facile / Trop Difficile
3506,187,2019,Management,9,1,QCU,0.1184,0.59,0.25,54,48,6,42,1.12,12.5,6,48,11.84,Trop Facile,Trop Difficile,Trop Facile / Trop Difficile
4336,187,2020,Management,9,1,QCU,0.3764,0.16,0.33,57,26,21,5,2.19,80.77,21,36,37.64,Trop Facile,Difficile,Trop Facile / Difficile
187,188,2015,Management,9,2,QCM,0.9729,0.03,0.8,18,18,18,0,1.0,100.0,18,0,97.29,Difficile,Trop Facile,Difficile / Trop Facile
1017,188,2016,Management,9,2,QCM,0.6291,0.26,0.66,18,15,11,4,1.2,73.33,11,7,62.91,Trop Facile,Adapte,Trop Facile / Adapte
1847,188,2017,Management,9,2,QCM,0.6346,0.27,0.59,19,17,12,5,1.12,70.59,12,7,63.46,Adapte,Adapte,Adapte / Adapte
2677,188,2018,Management,9,2,QCM,0.6182,0.18,0.45,17,15,11,4,1.13,73.33,11,6,61.82,Adapte,Adapte,Adapte / Adapte
3507,188,2019,Management,9,2,QCM,0.7497,0.2,0.69,19,14,14,0,1.36,100.0,14,5,74.97,Adapte,Adapte,Adapte / Adapte
4337,188,2020,Management,9,2,QCM,0.6972,0.13,0.43,17,13,12,1,1.31,92.31,12,5,69.72,Adapte,Adapte,Adapte / Adapte
188,189,2015,Management,9,3,QROC,0.0191,0.98,0.14,45,41,1,40,1.1,2.44,1,44,1.91,Trop Difficile,Trop Difficile,Trop Difficile / Trop Difficile
1018,189,2016,Management,9,3,QROC,0.7103,0.37,0.34,45,33,32,1,1.36,96.97,32,13,71.03,Trop Facile,Adapte,Trop Facile / Adapte
1848,189,2017,Management,9,3,QROC,0.6773,0.22,0.35,54,48,37,11,1.12,77.08,37,17,67.73,Adapte,Adapte,Adapte / Adapte
2678,189,2018,Management,9,3,QROC,0.718,0.37,0.38,51,46,37,9,1.11,80.43,37,14,71.8,Adapte,Adapte,Adapte / Adapte
3508,189,2019,Management,9,3,QROC,0.6332,0.46,0.37,60,44,38,6,1.36,86.36,38,22,63.32,Adapte,Adapte,Adapte / Adapte
4338,189,2020,Management,9,3,QROC,0.6387,0.36,0.3,52,37,33,4,1.41,89.19,33,19,63.87,Adapte,Adapte,Adapte / Adapte
189,190,2015,Management,9,4,QCU,0.73,0.11,0.54,50,46,36,10,1.09,78.26,36,14,73.0,Trop Facile,Adapte,Trop Facile / Adapte
1019,190,2016,Management,9,4,QCU,0.6135,0.18,0.5,46,40,28,12,1.15,70.0,28,18,61.35,Adapte,Adapte,Adapte / Adapte
1849,190,2017,Management,9,4,QCU,0.7093,0.12,0.52,55,53,39,14,1.04,73.58,39,16,70.93,Adapte,Adapte,Adapte / Adapte
2679,190,2018,Management,9,4,QCU,0.6961,0.17,0.51,57,52,40,12,1.1,76.92,40,17,69.61,Adapte,Adapte,Adapte / Adapte
3509,190,2019,Management,9,4,QCU,0.7326,0.25,0.68,56,43,41,2,1.3,95.35,41,15,73.26,Adapte,Adapte,Adapte / Adapte
4339,190,2020,Management,9,4,QCU,0.7062,0.16,0.57,56,43,40,3,1.3,93.02,40,16,70.62,Adapte,Adapte,Adapte / Adapte
190,191,2015,Management,9,5,QCU,0.2988,0.06,0.35,91,85,27,58,1.07,31.76,27,64,29.88,Difficile,Difficile,Difficile / Difficile
1020,191,2016,Management,9,5,QCU,0.8738,0.1,0.97,106,93,93,0,1.14,100.0,93,13,87.38,Trop Facile,Trop Facile,Trop Facile / Trop Facile
1850,191,2017,Management,9,5,QCU,0.8854,0.06,0.94,93,91,82,9,1.02,90.11,82,11,88.54,Trop Facile,Trop Facile,Trop Facile / Trop Facile
2680,191,2018,Management,9,5,QCU,0.9322,0.01,0.92,79,75,74,1,1.05,98.67,74,5,93.22,Trop Facile,Trop Facile,Trop Facile / Trop Facile
3510,191,2019,Management,9,5,QCU,0.97,0.04,0.9,68,68,66,2,1.0,97.06,66,2,97.0,Trop Facile,Trop Facile,Trop Facile / Trop Facile
4340,191,2020,Management,9,5,QCU,0.8618,0.1,0.95,71,66,61,5,1.08,92.42,61,10,86.18,Trop Facile,Trop Facile,Trop Facile / Trop Facile
191,192,2015,Management,9,6,QCM,0.7666,0.19,0.72,12,11,9,2,1.09,81.82,9,3,76.66,Facile,Facile,Facile / Facile
1021,192,2016,Management,9,6,QCM,0.9415,0.0,0.91,14,13,13,0,1.08,100.0,13,1,94.15,Trop Facile,Trop Facile,Trop Facile / Trop Facile
1851,192,2017,Management,9,6,QCM,0.9179,0.01,0.82,15,14,14,0,1.07,100.0,14,1,91.79,Trop Facile,Trop Facile,Trop Facile / Trop Facile
2681,192,2018,Management,9,6,QCM,0.8908,0.01,0.89,13,13,12,1,1.0,92.31,12,1,89.08,Trop Facile,Trop Facile,Trop Facile / Trop Facile
3511,192,2019,Management,9,6,QCM,0.5535,0.1,0.39,16,15,9,6,1.07,60.0,9,7,55.35,Trop Facile,Difficile,Trop Facile / Difficile
4341,192,2020,Management,9,6,QCM,0.9293,0.04,1.0,17,16,16,0,1.06,100.0,16,1,92.93,Trop Facile,Trop Facile,Trop Facile / Trop Facile
192,193,2015,Management,9,7,QCM,0.9436,0.05,0.84,59,57,56,1,1.04,98.25,56,3,94.36,Adapte,Trop Facile,Adapte / Trop Facile
1022,193,2016,Management,9,7,QCM,0.9735,0.04,0.93,60,59,58,1,1.02,98.31,58,2,97.35,Trop Facile,Trop Facile,Trop Facile / Trop Facile
1852,193,2017,Management,9,7,QCM,0.9777,0.01,0.84,66,65,65,0,1.02,100.0,65,1,97.77,Trop Facile,Trop Facile,Trop Facile / Trop Facile
2682,193,2018,Management,9,7,QCM,0.5596,0.06,0.3,58,35,32,3,1.66,91.43,32,26,55.96,Trop Facile,Difficile,Trop Facile / Difficile
3512,193,2019,Management,9,7,QCM,0.958,0.05,0.9,52,51,50,1,1.02,98.04,50,2,95.8,Trop Facile,Trop Facile,Trop Facile / Trop Facile
4342,193,2020,Management,9,7,QCM,0.8673,0.06,0.81,57,56,49,7,1.02,87.5,49,8,86.73,Trop Facile,Trop Facile,Trop Facile / Trop Facile
193,194,2015,Management,9,8,QCM,0.0197,0.18,0.27,60,28,1,27,2.14,3.57,1,59,1.97,Trop Difficile,Trop Difficile,Trop Difficile / Trop Difficile
1023,194,2016,Management,9,8,QCM,0.1649,0.2,0.23,52,32,9,23,1.62,28.12,9,43,16.49,Trop Facile,Trop Difficile,Trop Facile / Trop Difficile
1853,194,2017,Management,9,8,QCM,0.9299,0.03,0.9,61,61,57,4,1.0,93.44,57,4,92.99,Trop Facile,Trop Facile,Trop Facile / Trop Facile
2683,194,2018,Management,9,8,QCM,0.9738,0.09,0.94,70,68,68,0,1.03,100.0,68,2,97.38,Trop Facile,Trop Facile,Trop Facile / Trop Facile
3513,194,2019,Management,9,8,QCM,0.9357,0.01,0.92,77,73,72,1,1.05,98.63,72,5,93.57,Trop Facile,Trop Facile,Trop Facile / Trop Facile
4343,194,2020,Management,9,8,QCM,0.9368,0.1,0.95,66,64,62,2,1.03,96.88,62,4,93.68,Trop Facile,Trop Facile,Trop Facile / Trop Facile
194,195,2015,Management,9,9,QROC,0.3129,0.66,0.2,81,52,25,27,1.56,48.08,25,56,31.29,Difficile,Difficile,Difficile / Difficile
1024,195,2016,Management,9,9,QROC,0.9871,0.03,0.83,96,95,95,0,1.01,100.0,95,1,98.71,Trop Facile,Trop Facile,Trop Facile / Trop Facile
1854,195,2017,Management,9,9,QROC,0.9358,0.04,0.84,112,112,105,7,1.0,93.75,105,7,93.58,Trop Facile,Trop Facile,Trop Facile / Trop Facile
2684,195,2018,Management,9,9,QROC,0.8669,0.08,0.79,99,89,86,3,1.11,96.63,86,13,86.69,Trop Facile,Trop Facile,Trop Facile / Trop Facile
3514,195,2019,Management,9,9,QROC,0.9733,0.05,0.99,79,78,77,1,1.01,98.72,77,2,97.33,Trop Facile,Trop Facile,Trop Facile / Trop Facile
4344,195,2020,Management,9,9,QROC,0.9659,0.01,0.62,78,76,75,1,1.03,98.68,75,3,96.59,Trop Facile,Trop Facile,Trop Facile / Trop Facile
195,196,2015,Management,9,10,QCM,0.9389,0.1,0.9,14,13,13,0,1.08,100.0,13,1,93.89,Trop Facile,Trop Facile,Trop Facile / Trop Facile
1025,196,2016,Management,9,10,QCM,0.921,0.01,0.98,15,15,14,1,1.0,93.33,14,1,92.1,Trop Facile,Trop Facile,Trop Facile / Trop Facile
1855,196,2017,Management,9,10,QCM,0.457,0.15,0.38,17,13,8,5,1.31,61.54,8,9,45.7,Trop Facile,Difficile,Trop Facile / Difficile
2685,196,2018,Management,9,10,QCM,0.1188,0.33,0.29,17,6,2,4,2.83,33.33,2,15,11.88,Trop Facile,Trop Difficile,Trop Facile / Trop Difficile
3515,196,2019,Management,9,10,QCM,0.9826,0.09,0.81,16,16,16,0,1.0,100.0,16,0,98.26,Trop Facile,Trop Facile,Trop Facile / Trop Facile
4345,196,2020,Management,9,10,QCM,0.9997,0.05,0.84,18,18,18,0,1.0,100.0,18,0,99.97,Trop Facile,Trop Facile,Trop Facile / Trop Facile
196,197,2015,Management,9,11,QCU,0.8775,0.02,0.99,41,40,36,4,1.02,90.0,36,5,87.75,Trop Difficile,Trop Facile,Trop Difficile / Trop Facile
1026,197,2016,Management,9,11,QCU,0.6029,0.22,0.53,37,28,22,6,1.32,78.57,22,15,60.29,Trop Facile,Adapte,Trop Facile / Adapte
1856,197,2017,Management,9,11,QCU,0.7048,0.24,0.67,36,31,25,6,1.16,80.65,25,11,70.48,Adapte,Adapte,Adapte / Adapte
2686,197,2018,Management,9,11,QCU,0.7459,0.07,0.67,35,29,26,3,1.21,89.66,26,9,74.59,Adapte,Adapte,Adapte / Adapte
3516,197,2019,Management,9,11,QCU,0.7021,0.17,0.69,28,25,20,5,1.12,80.0,20,8,70.21,Adapte,Adapte,Adapte / Adapte
4346,197,2020,Management,9,11,QCU,0.6799,0.21,0.63,30,29,20,9,1.03,68.97,20,10,67.99,Adapte,Adapte,Adapte / Adapte
197,198,2015,Management,9,12,QO,0.2516,0.78,0.03,33,23,8,15,1.43,34.78,8,25,25.16,Difficile,Difficile,Difficile / Difficile
1027,198,2016,Management,9,12,QO,0.8845,0.04,0.81,28,26,25,1,1.08,96.15,25,3,88.45,Trop Facile,Trop Facile,Trop Facile / Trop Facile
1857,198,2017,Management,9,12,QO,0.9198,0.03,0.54,23,22,21,1,1.05,95.45,21,2,91.98,Trop Facile,Trop Facile,Trop Facile / Trop Facile
2687,198,2018,Management,9,12,QO,0.8748,0.0,0.76,19,18,17,1,1.06,94.44,17,2,87.48,Trop Facile,Trop Facile,Trop Facile / Trop Facile
3517,198,2019,Management,9,12,QO,0.926,0.08,0.65,16,16,15,1,1.0,93.75,15,1,92.6,Trop Facile,Trop Facile,Trop Facile / Trop Facile
4347,198,2020,Management,9,12,QO,0.9731,0.02,0.68,19,18,18,0,1.06,100.0,18,1,97.31,Trop Facile,Trop Facile,Trop Facile / Trop Facile
198,199,2015,Management,10,1,QCU,0.1951,0.33,0.26,62,50,12,38,1.24,24.0,12,50,19.51,Trop Difficile,Trop Difficile,Trop Difficile / Trop Difficile
1028,199,2016,Management,10,1,QCU,0.9618,0.03,0.91,70,69,67,2,1.01,97.1,67,3,96.18,Trop Facile,Trop Facile,Trop Facile / Trop Facile
1858,199,2017,Management,10,1,QCU,0.713,0.04,0.6,62,61,44,17,1.02,72.13,44,18,71.3,Trop Facile,Adapte,Trop Facile / Adapte
2688,199,2018,Management,10,1,QCU,0.6841,0.05,0.42,56,43,38,5,1.3,88.37,38,18,68.41,Adapte,Adapte,Adapte / Adapte
3518,199,2019,Management,10,1,QCU,0.6167,0.08,0.64,50,32,31,1,1.56,96.88,31,19,61.67,Adapte,Adapte,Adapte / Adapte
4348,199,2020,Management,10,1,QCU,0.7438,0.12,0.66,59,47,44,3,1.26,93.62,44,15,74.38,Adapte,Adapte,Adapte / Adapte
199,200,2015,Management,10,2,QCU,0.0703,0.51,0.22,33,14,2,12,2.36,14.29,2,31,7.03,Trop Difficile,Trop Difficile,Trop Difficile / Trop Difficile
1029,200,2016,Management,10,2,QCU,0.9897,0.03,0.95,29,29,29,0,1.0,100.0,29,0,98.97,Trop Facile,Trop Facile,Trop Facile / Trop Facile
1859,200,2017,Management,10,2,QCU,0.8835,0.03,0.92,25,24,22,2,1.04,91.67,22,3,88.35,Trop Facile,Trop Facile,Trop Facile / Trop Facile
2689,200,2018,Management,10,2,QCU,0.7258,0.22,0.7,23,23,17,6,1.0,73.91,17,6,72.58,Trop Facile,Adapte,Trop Facile / Adapte
3519,200,2019,Management,10,2,QCU,0.7079,0.28,0.49,22,17,16,1,1.29,94.12,16,6,70.79,Adapte,Adapte,Adapte / Adapte
4349,200,2020,Management,10,2,QCU,0.749,0.22,0.46,19,15,14,1,1.27,93.33,14,5,74.9,Adapte,Adapte,Adapte / Adapte
200,201,2015,Management,10,3,QCU,0.4992,0.18,0.37,38,29,19,10,1.31,65.52,19,19,49.92,Difficile,Difficile,Difficile / Difficile
1030,201,2016,Management,10,3,QCU,0.8613,0.07,0.92,43,43,37,6,1.0,86.05,37,6,86.13,Trop Facile,Trop Facile,Trop Facile / Trop Facile
1860,201,2017,Management,10,3,QCU,0.795,0.03,0.87,35,33,28,5,1.06,84.85,28,7,79.5,Trop Facile,Facile,Trop Facile / Facile
2690,201,2018,Management,10,3,QCU,0.891,0.02,0.96,34,30,30,0,1.13,100.0,30,4,89.1,Trop Facile,Trop Facile,Trop Facile / Trop Facile
3520,201,2019,Management,10,3,QCU,0.8734,0.05,0.92,40,36,35,1,1.11,97.22,35,5,87.34,Trop Facile,Trop Facile,Trop Facile / Trop Facile
4350,201,2020,Management,10,3,QCU,0.1857,0.21,0.21,47,47,9,38,1.0,19.15,9,38,18.57,Trop Facile,Trop Difficile,Trop Facile / Trop Difficile
201,202,2015,Management,10,4,QCU,0.9555,0.05,0.9,61,60,58,2,1.02,96.67,58,3,95.55,Trop Facile,Trop Facile,Trop Facile / Trop Facile
1031,202,2016,Management,10,4,QCU,0.8719,0.05,0.91,72,64,63,1,1.12,98.44,63,9,87.19,Trop Facile,Trop Facile,Trop Facile / Trop Facile
1861,202,2017,Management,10,4,QCU,0.7146,0.18,0.58,78,63,56,7,1.24,88.89,56,22,71.46,Trop Facile,Adapte,Trop Facile / Adapte
2691,202,2018,Management,10,4,QCU,0.6835,0.27,0.59,64,57,44,13,1.12,77.19,44,20,68.35,Adapte,Adapte,Adapte / Adapte
3521,202,2019,Management,10,4,QCU,0.7227,0.17,0.4,65,48,47,1,1.35,97.92,47,18,72.27,Adapte,Adapte,Adapte / Adapte
4351,202,2020,Management,10,4,QCU,0.6012,0.15,0.52,66,49,40,9,1.35,81.63,40,26,60.12,Adapte,Adapte,Adapte / Adapte
202,203,2015,Management,10,5,QROC,0.2211,0.87,0.01,60,47,13,34,1.28,27.66,13,47,22.11,Trop Difficile,Trop Difficile,Trop Difficile / Trop Difficile
1032,203,2016,Management,10,5,QROC,0.974,0.03,0.84,49,49,48,1,1.0,97.96,48,1,97.4,Trop Facile,Trop Facile,Trop Facile / Trop Facile
1862,203,2017,Management,10,5,QROC,0.9432,0.01,0.58,56,54,53,1,1.04,98.15,53,3,94.32,Trop Facile,Trop Facile,Trop Facile / Trop Facile
2692,203,2018,Management,10,5,QROC,0.9348,0.03,0.98,57,56,53,3,1.02,94.64,53,4,93.48,Trop Facile,Trop Facile,Trop Facile / Trop Facile
3522,203,2019,Management,10,5,QROC,0.8661,0.02,0.87,62,58,54,4,1.07,93.1,54,8,86.61,Trop Facile,Trop Facile,Trop Facile / Trop Facile
4352,203,2020,Management,10,5,QROC,0.8398,0.1,0.47,69,62,58,4,1.11,93.55,58,11,83.98,Trop Facile,Facile,Trop Facile / Facile
203,204,2015,Management,11,1,QROC,0.0632,0.96,0.09,81,78,5,73,1.04,6.41,5,76,6.32,Trop Difficile,Trop Difficile,Trop Difficile / Trop Difficile
1033,204,2016,Management,11,1,QROC,0.984,0.08,0.54,80,80,79,1,1.0,98.75,79,1,98.4,Trop Facile,Trop Facile,Trop Facile / Trop Facile
1863,204,2017,Management,11,1,QROC,0.6704,0.44,0.34,73,71,49,22,1.03,69.01,49,24,67.04,Trop Facile,Adapte,Trop Facile / Adapte
2693,204,2018,Management,11,1,QROC,0.7442,0.38,0.28,72,64,54,10,1.12,84.38,54,18,74.42,Adapte,Adapte,Adapte / Adapte
3523,204,2019,Management,11,1,QROC,0.7078,0.33,0.39,81,68,57,11,1.19,83.82,57,24,70.78,Adapte,Adapte,Adapte / Adapte
4353,204,2020,Management,11,1,QROC,0.6382,0.37,0.26,81,54,52,2,1.5,96.3,52,29,63.82,Adapte,Adapte,Adapte / Adapte
204,205,2015,Management,11,2,QO,0.3516,0.76,0.09,36,31,13,18,1.16,41.94,13,23,35.16,Difficile,Difficile,Difficile / Difficile
1034,205,2016,Management,11,2,QO,0.7982,0.15,0.4,41,40,33,7,1.02,82.5,33,8,79.82,Trop Facile,Facile,Trop Facile / Facile
1864,205,2017,Management,11,2,QO,0.9875,0.1,0.91,41,41,40,1,1.0,97.56,40,1,98.75,Trop Facile,Trop Facile,Trop Facile / Trop Facile
2694,205,2018,Management,11,2,QO,0.938,0.0,0.72,40,38,38,0,1.05,100.0,38,2,93.8,Trop Facile,Trop Facile,Trop Facile / Trop Facile
3524,205,2019,Management,11,2,QO,0.9839,0.02,0.99,45,45,44,1,1.0,97.78,44,1,98.39,Trop Facile,Trop Facile,Trop Facile / Trop Facile
4354,205,2020,Management,11,2,QO,0.9986,0.0,0.98,42,42,42,0,1.0,100.0,42,0,99.86,Trop Facile,Trop Facile,Trop Facile / Trop Facile
205,206,2015,Management,11,3,QCU,0.4643,0.38,0.35,48,47,22,25,1.02,46.81,22,26,46.43,Difficile,Difficile,Difficile / Difficile
1035,206,2016,Management,11,3,QCU,0.8164,0.07,0.9,38,33,31,2,1.15,93.94,31,7,81.64,Trop Facile,Facile,Trop Facile / Facile
1865,206,2017,Management,11,3,QCU,0.9337,0.0,0.91,31,30,29,1,1.03,96.67,29,2,93.37,Trop Facile,Trop Facile,Trop Facile / Trop Facile
2695,206,2018,Management,11,3,QCU,0.8976,0.06,0.93,36,34,32,2,1.06,94.12,32,4,89.76,Trop Facile,Trop Facile,Trop Facile / Trop Facile
3525,206,2019,Management,11,3,QCU,0.6248,0.11,0.5,39,31,24,7,1.26,77.42,24,15,62.48,Trop Facile,Adapte,Trop Facile / Adapte
4355,206,2020,Management,11,3,QCU,0.6143,0.09,0.43,44,30,27,3,1.47,90.0,27,17,61.43,Adapte,Adapte,Adapte / Adapte
206,207,2015,Management,12,1,QCM,0.3253,0.02,0.31,52,18,17,1,2.89,94.44,17,35,32.53,Difficile,Difficile,Difficile / Difficile
1036,207,2016,Management,12,1,QCM,0.0847,0.72,0.27,48,31,4,27,1.55,12.9,4,44,8.47,Trop Facile,Trop Difficile,Trop Facile / Trop Difficile
1866,207,2017,Management,12,1,QCM,0.7733,0.09,0.73,54,52,42,10,1.04,80.77,42,12,77.33,Trop Facile,Facile,Trop Facile / Facile
2696,207,2018,Management,12,1,QCM,0.88,0.02,0.96,63,61,55,6,1.03,90.16,55,8,88.0,Trop Facile,Trop Facile,Trop Facile / Trop Facile
3526,207,2019,Management,12,1,QCM,0.8869,0.0,0.92,53,51,47,4,1.04,92.16,47,6,88.69,Trop Facile,Trop Facile,Trop Facile / Trop Facile
4356,207,2020,Management,12,1,QCM,0.9786,0.02,0.99,53,52,52,0,1.02,100.0,52,1,97.86,Trop Facile,Trop Facile,Trop Facile / Trop Facile
207,208,2015,Management,12,2,QCM,0.786,0.12,0.8,91,86,72,14,1.06,83.72,72,19,78.6,Facile,Facile,Facile / Facile
1037,208,2016,Management,12,2,QCM,0.8867,0.02,0.86,100,97,89,8,1.03,91.75,89,11,88.67,Trop Facile,Trop Facile,Trop Facile / Trop Facile
1867,208,2017,Management,12,2,QCM,0.1311,0.11,0.25,106,70,14,56,1.51,20.0,14,92,13.11,Trop Facile,Trop Difficile,Trop Facile / Trop Difficile
2697,208,2018,Management,12,2,QCM,0.9771,0.05,0.9,96,94,94,0,1.02,100.0,94,2,97.71,Trop Facile,Trop Facile,Trop Facile / Trop Facile
3527,208,2019,Management,12,2,QCM,0.9931,0.09,0.87,91,91,90,1,1.0,98.9,90,1,99.31,Trop Facile,Trop Facile,Trop Facile / Trop Facile
4357,208,2020,Management,12,2,QCM,0.8972,0.1,0.97,88,87,79,8,1.01,90.8,79,9,89.72,Trop Facile,Trop Facile,Trop Facile / Trop Facile
208,209,2015,Management,12,3,QCU,0.178,0.68,0.27,60,53,11,42,1.13,20.75,11,49,17.8,Trop Difficile,Trop Difficile,Trop Difficile / Trop Difficile
1038,209,2016,Management,12,3,QCU,0.4479,0.14,0.39,67,45,30,15,1.49,66.67,30,37,44.79,Trop Facile,Difficile,Trop Facile / Difficile
1868,209,2017,Management,12,3,QCU,0.6566,0.09,0.6,59,58,39,19,1.02,67.24,39,20,65.66,Trop Facile,Adapte,Trop Facile / Adapte
2698,209,2018,Management,12,3,QCU,0.7495,0.1,0.58,50,40,37,3,1.25,92.5,37,13,74.95,Adapte,Adapte,Adapte / Adapte
3528,209,2019,Management,12,3,QCU,0.6133,0.24,0.41,43,34,26,8,1.26,76.47,26,17,61.33,Adapte,Adapte,Adapte / Adapte
4358,209,2020,Management,12,3,QCU,0.6032,0.16,0.42,37,23,22,1,1.61,95.65,22,15,60.32,Adapte,Adapte,Adapte / Adapte
209,210,2015,Management,12,4,QCU,0.0797,0.44,0.24,70,37,6,31,1.89,16.22,6,64,7.97,Trop Difficile,Trop Difficile,Trop Difficile / Trop Difficile
1039,210,2016,Management,12,4,QCU,0.9328,0.06,0.91,62,60,58,2,1.03,96.67,58,4,93.28,Trop Facile,Trop Facile,Trop Facile / Trop Facile
1869,210,2017,Management,12,4,QCU,0.3891,0.36,0.33,69,44,27,17,1.57,61.36,27,42,38.91,Trop Facile,Difficile,Trop Facile / Difficile
2699,210,2018,Management,12,4,QCU,0.8626,0.06,0.97,71,64,61,3,1.11,95.31,61,10,86.26,Trop Facile,Trop Facile,Trop Facile / Trop Facile
3529,210,2019,Management,12,4,QCU,0.6305,0.29,0.65,74,66,47,19,1.12,71.21,47,27,63.05,Trop Facile,Adapte,Trop Facile / Adapte
4359,210,2020,Management,12,4,QCU,0.7474,0.28,0.46,62,61,46,15,1.02,75.41,46,16,74.74,Adapte,Adapte,Adapte / Adapte
210,211,2015,Management,12,5,QCU,0.4675,0.36,0.36,29,18,14,4,1.61,77.78,14,15,46.75,Trop Difficile,Difficile,Trop Difficile / Difficile
1040,211,2016,Management,12,5,QCU,0.8629,0.02,0.95,26,23,22,1,1.13,95.65,22,4,86.29,Trop Facile,Trop Facile,Trop Facile / Trop Facile
1870,211,2017,Management,12,5,QCU,0.3932,0.21,0.33,26,17,10,7,1.53,58.82,10,16,39.32,Trop Facile,Difficile,Trop Facile / Difficile
2700,211,2018,Management,12,5,QCU,0.8771,0.09,0.94,29,25,25,0,1.16,100.0,25,4,87.71,Trop Facile,Trop Facile,Trop Facile / Trop Facile
3530,211,2019,Management,12,5,QCU,0.7317,0.23,0.56,28,21,20,1,1.33,95.24,20,8,73.17,Trop Facile,Adapte,Trop Facile / Adapte
4360,211,2020,Management,12,5,QCU,0.6655,0.01,0.64,24,23,16,7,1.04,69.57,16,8,66.55,Adapte,Adapte,Adapte / Adapte
211,212,2015,Management,12,6,QCM,0.3072,0.21,0.3,78,54,24,30,1.44,44.44,24,54,30.72,Facile,Difficile,Facile / Difficile
1041,212,2016,Management,12,6,QCM,0.8051,0.17,0.75,74,72,60,12,1.03,83.33,60,14,80.51,Trop Facile,Facile,Trop Facile / Facile
1871,212,2017,Management,12,6,QCM,0.1986,0.37,0.29,74,20,15,5,3.7,75.0,15,59,19.86,Trop Facile,Trop Difficile,Trop Facile / Trop Difficile
2701,212,2018,Management,12,6,QCM,0.9085,0.06,0.92,86,85,78,7,1.01,91.76,78,8,90.85,Trop Facile,Trop Facile,Trop Facile / Trop Facile
3531,212,2019,Management,12,6,QCM,0.8796,0.0,0.87,92,92,81,11,1.0,88.04,81,11,87.96,Trop Facile,Trop Facile,Trop Facile / Trop Facile
4361,212,2020,Management,12,6,QCM,0.9898,0.02,0.94,102,102,101,1,1.0,99.02,101,1,98.98,Trop Facile,Trop Facile,Trop Facile / Trop Facile
212,213,2015,Management,12,7,QROC,0.4265,0.73,0.19,19,19,8,11,1.0,42.11,8,11,42.65,Difficile,Difficile,Difficile / Difficile
1042,213,2016,Management,12,7,QROC,0.831,0.01,0.45,23,20,19,1,1.15,95.0,19,4,83.1,Trop Facile,Facile,Trop Facile / Facile
1872,213,2017,Management,12,7,QROC,0.9833,0.09,0.85,21,21,21,0,1.0,100.0,21,0,98.33,Trop Facile,Trop Facile,Trop Facile / Trop Facile
2702,213,2018,Management,12,7,QROC,0.9169,0.09,0.95,21,21,19,2,1.0,90.48,19,2,91.69,Trop Facile,Trop Facile,Trop Facile / Trop Facile
3532,213,2019,Management,12,7,QROC,0.9569,0.08,0.55,19,19,18,1,1.0,94.74,18,1,95.69,Trop Facile,Trop Facile,Trop Facile / Trop Facile
4362,213,2020,Management,12,7,QROC,0.9461,0.06,0.6,18,17,17,0,1.06,100.0,17,1,94.61,Trop Facile,Trop Facile,Trop Facile / Trop Facile
213,214,2015,Management,12,8,QCM,0.2293,0.48,0.23,74,51,17,34,1.45,33.33,17,57,22.93,Difficile,Trop Difficile,Difficile / Trop Difficile
1043,214,2016,Management,12,8,QCM,0.7062,0.2,0.52,61,53,43,10,1.15,81.13,43,18,70.62,Trop Facile,Adapte,Trop Facile / Adapte
1873,214,2017,Management,12,8,QCM,0.7005,0.06,0.55,53,46,37,9,1.15,80.43,37,16,70.05,Adapte,Adapte,Adapte / Adapte
2703,214,2018,Management,12,8,QCM,0.7317,0.09,0.62,60,45,44,1,1.33,97.78,44,16,73.17,Adapte,Adapte,Adapte / Adapte
3533,214,2019,Management,12,8,QCM,0.6705,0.07,0.4,56,47,38,9,1.19,80.85,38,18,67.05,Adapte,Adapte,Adapte / Adapte
4363,214,2020,Management,12,8,QCM,0.6975,0.07,0.43,66,52,46,6,1.27,88.46,46,20,69.75,Adapte,Adapte,Adapte / Adapte
214,215,2015,Management,12,9,QCM,0.7757,0.02,0.78,56,56,43,13,1.0,76.79,43,13,77.57,Adapte,Facile,Adapte / Facile
1044,215,2016,Management,12,9,QCM,0.0334,0.71,0.29,45,29,2,27,1.55,6.9,2,43,3.34,Trop Facile,Trop Difficile,Trop Facile / Trop Difficile
1874,215,2017,Management,12,9,QCM,0.9502,0.05,1.0,41,39,39,0,1.05,100.0,39,2,95.02,Trop Facile,Trop Facile,Trop Facile / Trop Facile
2704,215,2018,Management,12,9,QCM,0.5392,0.35,0.37,46,36,25,11,1.28,69.44,25,21,53.92,Trop Facile,Difficile,Trop Facile / Difficile
3534,215,2019,Management,12,9,QCM,0.9049,0.04,0.91,55,52,50,2,1.06,96.15,50,5,90.49,Trop Facile,Trop Facile,Trop Facile / Trop Facile
4364,215,2020,Management,12,9,QCM,0.9531,0.03,0.98,51,51,49,2,1.0,96.08,49,2,95.31,Trop Facile,Trop Facile,Trop Facile / Trop Facile
215,216,2015,Management,13,1,QCU,0.0468,0.36,0.25,68,35,3,32,1.94,8.57,3,65,4.68,Trop Difficile,Trop Difficile,Trop Difficile / Trop Difficile
1045,216,2016,Management,13,1,QCU,0.932,0.02,0.91,56,52,52,0,1.08,100.0,52,4,93.2,Trop Facile,Trop Facile,Trop Facile / Trop Facile
1875,216,2017,Management,13,1,QCU,0.0487,0.19,0.27,46,28,2,26,1.64,7.14,2,44,4.87,Trop Facile,Trop Difficile,Trop Facile / Trop Difficile
2705,216,2018,Management,13,1,QCU,0.0527,0.45,0.28,51,30,3,27,1.7,10.0,3,48,5.27,Trop Facile,Trop Difficile,Trop Facile / Trop Difficile
3535,216,2019,Management,13,1,QCU,0.6275,0.07,0.52,58,58,36,22,1.0,62.07,36,22,62.75,Trop Facile,Adapte,Trop Facile / Adapte
4365,216,2020,Management,13,1,QCU,0.7264,0.11,0.66,52,43,38,5,1.21,88.37,38,14,72.64,Adapte,Adapte,Adapte / Adapte
216,217,2015,Management,13,2,QCM,0.762,0.14,0.74,25,21,19,2,1.19,90.48,19,6,76.2,Trop Facile,Facile,Trop Facile / Facile
1046,217,2016,Management,13,2,QCM,0.9375,0.09,0.86,24,23,22,1,1.04,95.65,22,2,93.75,Trop Facile,Trop Facile,Trop Facile / Trop Facile
1876,217,2017,Management,13,2,QCM,0.95,0.02,0.93,20,19,19,0,1.05,100.0,19,1,95.0,Trop Facile,Trop Facile,Trop Facile / Trop Facile
2706,217,2018,Management,13,2,QCM,0.8778,0.04,0.8,24,24,21,3,1.0,87.5,21,3,87.78,Trop Facile,Trop Facile,Trop Facile / Trop Facile
3536,217,2019,Management,13,2,QCM,0.6467,0.29,0.61,28,28,18,10,1.0,64.29,18,10,64.67,Trop Facile,Adapte,Trop Facile / Adapte
4366,217,2020,Management,13,2,QCM,0.6574,0.15,0.42,26,24,17,7,1.08,70.83,17,9,65.74,Adapte,Adapte,Adapte / Adapte
217,218,2015,Management,13,3,QCU,0.7682,0.15,0.86,11,9,8,1,1.22,88.89,8,3,76.82,Facile,Facile,Facile / Facile
1047,218,2016,Management,13,3,QCU,0.6036,0.12,0.68,10,7,6,1,1.43,85.71,6,4,60.36,Trop Facile,Adapte,Trop Facile / Adapte
1877,218,2017,Management,13,3,QCU,0.6135,0.28,0.61,9,8,6,2,1.12,75.0,6,3,61.35,Adapte,Adapte,Adapte / Adapte
2707,218,2018,Management,13,3,QCU,0.7461,0.12,0.46,7,7,5,2,1.0,71.43,5,2,74.61,Adapte,Adapte,Adapte / Adapte
3537,218,2019,Management,13,3,QCU,0.6497,0.25,0.53,7,6,5,1,1.17,83.33,5,2,64.97,Adapte,Adapte,Adapte / Adapte
4367,218,2020,Management,13,3,QCU,0.6769,0.25,0.53,8,7,5,2,1.14,71.43,5,3,67.69,Adapte,Adapte,Adapte / Adapte
218,219,2015,Management,13,4,QCU,0.7943,0.12,0.9,100,94,79,15,1.06,84.04,79,21,79.43,Trop Difficile,Facile,Trop Difficile / Facile
1048,219,2016,Management,13,4,QCU,0.8439,0.18,0.85,100,84,84,0,1.19,100.0,84,16,84.39,Trop Facile,Facile,Trop Facile / Facile
1878,219,2017,Management,13,4,QCU,0.9777,0.06,0.95,101,99,99,0,1.02,100.0,99,2,97.77,Trop Facile,Trop Facile,Trop Facile / Trop Facile
2708,219,2018,Management,13,4,QCU,0.9257,0.03,0.99,95,93,88,5,1.02,94.62,88,7,92.57,Trop Facile,Trop Facile,Trop Facile / Trop Facile
3538,219,2019,Management,13,4,QCU,0.9332,0.04,0.97,99,98,92,6,1.01,93.88,92,7,93.32,Trop Facile,Trop Facile,Trop Facile / Trop Facile
4368,219,2020,Management,13,4,QCU,0.964,0.07,0.92,106,105,102,3,1.01,97.14,102,4,96.4,Trop Facile,Trop Facile,Trop Facile / Trop Facile
219,220,2015,Management,13,5,QCU,0.0577,0.26,0.26,83,40,5,35,2.08,12.5,5,78,5.77,Trop Facile,Trop Difficile,Trop Facile / Trop Difficile
1049,220,2016,Management,13,5,QCU,0.793,0.18,0.86,66,53,52,1,1.25,98.11,52,14,79.3,Trop Facile,Facile,Trop Facile / Facile
1879,220,2017,Management,13,5,QCU,0.8776,0.06,0.94,53,48,47,1,1.1,97.92,47,6,87.76,Trop Facile,Trop Facile,Trop Facile / Trop Facile
2709,220,2018,Management,13,5,QCU,0.1925,0.74,0.27,51,44,10,34,1.16,22.73,10,41,19.25,Trop Facile,Trop Difficile,Trop Facile / Trop Difficile
3539,220,2019,Management,13,5,QCU,0.8263,0.06,0.77,42,42,35,7,1.0,83.33,35,7,82.63,Trop Facile,Facile,Trop Facile / Facile
4369,220,2020,Management,13,5,QCU,0.9296,0.03,0.94,40,37,37,0,1.08,100.0,37,3,92.96,Trop Facile,Trop Facile,Trop Facile / Trop Facile
220,221,2015,Management,13,6,QCU,0.8732,0.07,0.97,62,57,54,3,1.09,94.74,54,8,87.32,Difficile,Trop Facile,Difficile / Trop Facile
1050,221,2016,Management,13,6,QCU,0.8967,0.02,0.96,56,55,50,5,1.02,90.91,50,6,89.67,Trop Facile,Trop Facile,Trop Facile / Trop Facile
1880,221,2017,Management,13,6,QCU,0.8605,0.08,0.97,59,52,51,1,1.13,98.08,51,8,86.05,Trop Facile,Trop Facile,Trop Facile / Trop Facile
2710,221,2018,Management,13,6,QCU,0.869,0.08,0.91,60,53,52,1,1.13,98.11,52,8,86.9,Trop Facile,Trop Facile,Trop Facile / Trop Facile
3540,221,2019,Management,13,6,QCU,0.8701,0.0,0.97,51,51,44,7,1.0,86.27,44,7,87.01,Trop Facile,Trop Facile,Trop Facile / Trop Facile
4370,221,2020,Management,13,6,QCU,0.9429,0.06,0.97,48,48,45,3,1.0,93.75,45,3,94.29,Trop Facile,Trop Facile,Trop Facile / Trop Facile
221,222,2015,Management,13,7,QO,0.6626,0.5,0.18,67,65,44,21,1.03,67.69,44,23,66.26,Adapte,Adapte,Adapte / Adapte
1051,222,2016,Management,13,7,QO,0.6016,0.37,0.28,60,51,36,15,1.18,70.59,36,24,60.16,Adapte,Adapte,Adapte / Adapte
1881,222,2017,Management,13,7,QO,0.6399,0.72,0.2,68,66,44,22,1.03,66.67,44,24,63.99,Adapte,Adapte,Adapte / Adapte
2711,222,2018,Management,13,7,QO,0.6132,0.55,0.27,71,54,44,10,1.31,81.48,44,27,61.32,Adapte,Adapte,Adapte / Adapte
3541,222,2019,Management,13,7,QO,0.6185,0.66,0.24,62,60,38,22,1.03,63.33,38,24,61.85,Adapte,Adapte,Adapte / Adapte
4371,222,2020,Management,13,7,QO,0.691,0.57,0.2,51,50,35,15,1.02,70.0,35,16,69.1,Adapte,Adapte,Adapte / Adapte
222,223,2015,Management,13,8,QCU,0.2342,0.69,0.21,22,16,5,11,1.38,31.25,5,17,23.42,Adapte,Trop Difficile,Adapte / Trop Difficile
1052,223,2016,Management,13,8,QCU,0.2868,0.36,0.36,23,8,7,1,2.88,87.5,7,16,28.68,Trop Facile,Difficile,Trop Facile / Difficile
1882,223,2017,Management,13,8,QCU,0.9708,0.07,0.96,28,28,27,1,1.0,96.43,27,1,97.08,Trop Facile,Trop Facile,Trop Facile / Trop Facile
2712,223,2018,Management,13,8,QCU,0.8701,0.03,0.92,30,26,26,0,1.15,100.0,26,4,87.01,Trop Facile,Trop Facile,Trop Facile / Trop Facile
3542,223,2019,Management,13,8,QCU,0.8857,0.06,0.95,28,26,25,1,1.08,96.15,25,3,88.57,Trop Facile,Trop Facile,Trop Facile / Trop Facile
4372,223,2020,Management,13,8,QCU,0.723,0.01,0.58,27,21,20,1,1.29,95.24,20,7,72.3,Trop Facile,Adapte,Trop Facile / Adapte
223,224,2015,Management,13,9,QCM,0.4411,0.01,0.3,97,94,43,51,1.03,45.74,43,54,44.11,Trop Difficile,Difficile,Trop Difficile / Difficile
1053,224,2016,Management,13,9,QCM,0.7252,0.07,0.57,92,69,67,2,1.33,97.1,67,25,72.52,Trop Facile,Adapte,Trop Facile / Adapte
1883,224,2017,Management,13,9,QCM,0.7291,0.07,0.67,86,67,63,4,1.28,94.03,63,23,72.91,Adapte,Adapte,Adapte / Adapte
2713,224,2018,Management,13,9,QCM,0.6452,0.2,0.55,95,65,61,4,1.46,93.85,61,34,64.52,Adapte,Adapte,Adapte / Adapte
3543,224,2019,Management,13,9,QCM,0.75,0.17,0.59,113,93,85,8,1.22,91.4,85,28,75.0,Adapte,Adapte,Adapte / Adapte
4373,224,2020,Management,13,9,QCM,0.6332,0.16,0.58,131,90,83,7,1.46,92.22,83,48,63.32,Adapte,Adapte,Adapte / Adapte
224,225,2015,Management,13,10,QROC,0.8182,0.05,0.51,98,89,80,9,1.1,89.89,80,18,81.82,Difficile,Facile,Difficile / Facile
1054,225,2016,Management,13,10,QROC,0.9834,0.09,0.65,89,89,88,1,1.0,98.88,88,1,98.34,Trop Facile,Trop Facile,Trop Facile / Trop Facile
1884,225,2017,Management,13,10,QROC,0.8877,0.08,0.77,104,96,92,4,1.08,95.83,92,12,88.77,Trop Facile,Trop Facile,Trop Facile / Trop Facile
2714,225,2018,Management,13,10,QROC,0.2225,0.96,0.0,101,59,22,37,1.71,37.29,22,79,22.25,Trop Facile,Trop Difficile,Trop Facile / Trop Difficile
3544,225,2019,Management,13,10,QROC,0.1953,0.9,0.11,97,85,19,66,1.14,22.35,19,78,19.53,Trop Facile,Trop Difficile,Trop Facile / Trop Difficile
4374,225,2020,Management,13,10,QROC,0.0808,0.86,0.09,86,35,7,28,2.46,20.0,7,79,8.08,Trop Facile,Trop Difficile,Trop Facile / Trop Difficile
225,226,2015,Management,14,1,QCU,0.3995,0.1,0.32,89,65,36,29,1.37,55.38,36,53,39.95,Trop Difficile,Difficile,Trop Difficile / Difficile
1055,226,2016,Management,14,1,QCU,0.9513,0.09,1.0,84,82,80,2,1.02,97.56,80,4,95.13,Trop Facile,Trop Facile,Trop Facile / Trop Facile
1885,226,2017,Management,14,1,QCU,0.979,0.03,0.99,79,79,77,2,1.0,97.47,77,2,97.9,Trop Facile,Trop Facile,Trop Facile / Trop Facile
2715,226,2018,Management,14,1,QCU,0.996,0.06,0.94,77,77,77,0,1.0,100.0,77,0,99.6,Trop Facile,Trop Facile,Trop Facile / Trop Facile
3545,226,2019,Management,14,1,QCU,0.918,0.01,0.93,68,67,62,5,1.01,92.54,62,6,91.8,Trop Facile,Trop Facile,Trop Facile / Trop Facile
4375,226,2020,Management,14,1,QCU,0.9249,0.06,0.96,59,57,55,2,1.04,96.49,55,4,92.49,Trop Facile,Trop Facile,Trop Facile / Trop Facile
226,227,2015,Management,15,1,QCU,0.3442,0.12,0.39,16,9,6,3,1.78,66.67,6,10,34.42,Trop Difficile,Difficile,Trop Difficile / Difficile
1056,227,2016,Management,15,1,QCU,0.8694,0.06,0.97,17,16,15,1,1.06,93.75,15,2,86.94,Trop Facile,Trop Facile,Trop Facile / Trop Facile
1886,227,2017,Management,15,1,QCU,0.935,0.03,0.95,16,15,15,0,1.07,100.0,15,1,93.5,Trop Facile,Trop Facile,Trop Facile / Trop Facile
2716,227,2018,Management,15,1,QCU,0.6304,0.08,0.57,13,12,8,4,1.08,66.67,8,5,63.04,Trop Facile,Adapte,Trop Facile / Adapte
3546,227,2019,Management,15,1,QCU,0.6631,0.27,0.68,14,13,9,4,1.08,69.23,9,5,66.31,Adapte,Adapte,Adapte / Adapte
4376,227,2020,Management,15,1,QCU,0.6448,0.17,0.51,14,11,9,2,1.27,81.82,9,5,64.48,Adapte,Adapte,Adapte / Adapte
227,228,2015,Management,15,2,QROC,0.845,0.19,0.52,99,91,84,7,1.09,92.31,84,15,84.5,Facile,Facile,Facile / Facile
1057,228,2016,Management,15,2,QROC,0.9222,0.05,0.74,111,110,102,8,1.01,92.73,102,9,92.22,Trop Facile,Trop Facile,Trop Facile / Trop Facile
1887,228,2017,Management,15,2,QROC,0.9798,0.03,0.86,126,125,123,2,1.01,98.4,123,3,97.98,Trop Facile,Trop Facile,Trop Facile / Trop Facile
2717,228,2018,Management,15,2,QROC,0.8156,0.18,0.75,140,135,114,21,1.04,84.44,114,26,81.56,Trop Facile,Facile,Trop Facile / Facile
3547,228,2019,Management,15,2,QROC,0.6871,0.35,0.37,113,100,78,22,1.13,78.0,78,35,68.71,Trop Facile,Adapte,Trop Facile / Adapte
4377,228,2020,Management,15,2,QROC,0.6088,0.33,0.35,91,71,55,16,1.28,77.46,55,36,60.88,Adapte,Adapte,Adapte / Adapte
228,229,2015,Management,15,3,QCM,0.4588,0.17,0.3,5,5,2,3,1.0,40.0,2,3,45.88,Difficile,Difficile,Difficile / Difficile
1058,229,2016,Management,15,3,QCM,0.0135,0.06,0.23,6,4,0,4,1.5,0.0,0,6,1.35,Trop Facile,Trop Difficile,Trop Facile / Trop Difficile
1888,229,2017,Management,15,3,QCM,0.8674,0.1,0.99,7,7,6,1,1.0,85.71,6,1,86.74,Trop Facile,Trop Facile,Trop Facile / Trop Facile
2718,229,2018,Management,15,3,QCM,0.9194,0.08,0.95,7,6,6,0,1.17,100.0,6,1,91.94,Trop Facile,Trop Facile,Trop Facile / Trop Facile
3548,229,2019,Management,15,3,QCM,0.9077,0.08,0.93,6,5,5,0,1.2,100.0,5,1,90.77,Trop Facile,Trop Facile,Trop Facile / Trop Facile
4378,229,2020,Management,15,3,QCM,0.9389,0.05,0.99,7,7,7,0,1.0,100.0,7,0,93.89,Trop Facile,Trop Facile,Trop Facile / Trop Facile
229,230,2015,Management,16,1,QCM,0.1131,0.52,0.26,39,24,4,20,1.62,16.67,4,35,11.31,Trop Difficile,Trop Difficile,Trop Difficile / Trop Difficile
1059,230,2016,Management,16,1,QCM,0.9942,0.04,0.91,32,32,32,0,1.0,100.0,32,0,99.42,Trop Facile,Trop Facile,Trop Facile / Trop Facile
1889,230,2017,Management,16,1,QCM,0.417,0.04,0.33,33,29,14,15,1.14,48.28,14,19,41.7,Trop Facile,Difficile,Trop Facile / Difficile
2719,230,2018,Management,16,1,QCM,0.9931,0.07,0.94,30,30,30,0,1.0,100.0,30,0,99.31,Trop Facile,Trop Facile,Trop Facile / Trop Facile
3549,230,2019,Management,16,1,QCM,0.9094,0.1,0.86,36,36,33,3,1.0,91.67,33,3,90.94,Trop Facile,Trop Facile,Trop Facile / Trop Facile
4379,230,2020,Management,16,1,QCM,0.8931,0.02,0.99,32,30,29,1,1.07,96.67,29,3,89.31,Trop Facile,Trop Facile,Trop Facile / Trop Facile
230,231,2015,Informatique,1,1,QROC,0.5509,0.51,0.16,65,36,36,0,1.81,100.0,36,29,55.09,Difficile,Difficile,Difficile / Difficile
1060,231,2016,Informatique,1,1,QROC,0.9909,0.04,0.8,60,60,59,1,1.0,98.33,59,1,99.09,Trop Facile,Trop Facile,Trop Facile / Trop Facile
1890,231,2017,Informatique,1,1,QROC,0.898,0.08,0.56,48,45,43,2,1.07,95.56,43,5,89.8,Trop Facile,Trop Facile,Trop Facile / Trop Facile
2720,231,2018,Informatique,1,1,QROC,0.9434,0.07,0.97,42,42,40,2,1.0,95.24,40,2,94.34,Trop Facile,Trop Facile,Trop Facile / Trop Facile
3550,231,2019,Informatique,1,1,QROC,0.8968,0.06,0.62,49,45,44,1,1.09,97.78,44,5,89.68,Trop Facile,Trop Facile,Trop Facile / Trop Facile
4380,231,2020,Informatique,1,1,QROC,0.9927,0.03,0.98,56,56,56,0,1.0,100.0,56,0,99.27,Trop Facile,Trop Facile,Trop Facile / Trop Facile
231,232,2015,Informatique,1,2,QCU,0.9538,0.03,0.96,24,24,23,1,1.0,95.83,23,1,95.38,Trop Facile,Trop Facile,Trop Facile / Trop Facile
1061,232,2016,Informatique,1,2,QCU,0.6522,0.09,0.56,24,16,16,0,1.5,100.0,16,8,65.22,Trop Facile,Adapte,Trop Facile / Adapte
1891,232,2017,Informatique,1,2,QCU,0.6984,0.28,0.59,28,24,20,4,1.17,83.33,20,8,69.84,Adapte,Adapte,Adapte / Adapte
2721,232,2018,Informatique,1,2,QCU,0.6686,0.03,0.57,24,19,16,3,1.26,84.21,16,8,66.86,Adapte,Adapte,Adapte / Adapte
3551,232,2019,Informatique,1,2,QCU,0.6141,0.04,0.6,26,26,16,10,1.0,61.54,16,10,61.41,Adapte,Adapte,Adapte / Adapte
4381,232,2020,Informatique,1,2,QCU,0.6489,0.2,0.64,27,26,18,8,1.04,69.23,18,9,64.89,Adapte,Adapte,Adapte / Adapte
232,233,2015,Informatique,1,3,QCM,0.7698,0.17,0.71,66,55,51,4,1.2,92.73,51,15,76.98,Facile,Facile,Facile / Facile
1062,233,2016,Informatique,1,3,QCM,0.9289,0.06,0.88,58,56,54,2,1.04,96.43,54,4,92.89,Trop Facile,Trop Facile,Trop Facile / Trop Facile
1892,233,2017,Informatique,1,3,QCM,0.9835,0.04,0.93,49,49,48,1,1.0,97.96,48,1,98.35,Trop Facile,Trop Facile,Trop Facile / Trop Facile
2722,233,2018,Informatique,1,3,QCM,0.9352,0.06,0.96,50,50,47,3,1.0,94.0,47,3,93.52,Trop Facile,Trop Facile,Trop Facile / Trop Facile
3552,233,2019,Informatique,1,3,QCM,0.9075,0.1,0.81,45,42,41,1,1.07,97.62,41,4,90.75,Trop Facile,Trop Facile,Trop Facile / Trop Facile
4382,233,2020,Informatique,1,3,QCM,0.9986,0.1,0.86,54,54,54,0,1.0,100.0,54,0,99.86,Trop Facile,Trop Facile,Trop Facile / Trop Facile
233,234,2015,Informatique,1,4,QCM,0.0167,0.49,0.26,47,15,1,14,3.13,6.67,1,46,1.67,Trop Difficile,Trop Difficile,Trop Difficile / Trop Difficile
1063,234,2016,Informatique,1,4,QCM,0.8644,0.09,0.97,53,53,46,7,1.0,86.79,46,7,86.44,Trop Facile,Trop Facile,Trop Facile / Trop Facile
1893,234,2017,Informatique,1,4,QCM,0.9044,0.09,0.88,61,58,55,3,1.05,94.83,55,6,90.44,Trop Facile,Trop Facile,Trop Facile / Trop Facile
2723,234,2018,Informatique,1,4,QCM,0.7612,0.13,0.73,49,41,37,4,1.2,90.24,37,12,76.12,Trop Facile,Facile,Trop Facile / Facile
3553,234,2019,Informatique,1,4,QCM,0.9212,0.09,0.85,39,37,36,1,1.05,97.3,36,3,92.12,Trop Facile,Trop Facile,Trop Facile / Trop Facile
4383,234,2020,Informatique,1,4,QCM,0.9386,0.07,0.9,38,37,36,1,1.03,97.3,36,2,93.86,Trop Facile,Trop Facile,Trop Facile / Trop Facile
234,235,2015,Informatique,1,5,QCU,0.8154,0.1,0.88,51,48,42,6,1.06,87.5,42,9,81.54,Trop Facile,Facile,Trop Facile / Facile
1064,235,2016,Informatique,1,5,QCU,0.9837,0.1,0.98,52,52,51,1,1.0,98.08,51,1,98.37,Trop Facile,Trop Facile,Trop Facile / Trop Facile
1894,235,2017,Informatique,1,5,QCU,0.9175,0.07,0.96,53,52,49,3,1.02,94.23,49,4,91.75,Trop Facile,Trop Facile,Trop Facile / Trop Facile
2724,235,2018,Informatique,1,5,QCU,0.7248,0.03,0.53,53,45,38,7,1.18,84.44,38,15,72.48,Trop Facile,Adapte,Trop Facile / Adapte
3554,235,2019,Informatique,1,5,QCU,0.6229,0.26,0.51,51,32,32,0,1.59,100.0,32,19,62.29,Adapte,Adapte,Adapte / Adapte
4384,235,2020,Informatique,1,5,QCU,0.6847,0.1,0.6,55,54,38,16,1.02,70.37,38,17,68.47,Adapte,Adapte,Adapte / Adapte
235,236,2015,Informatique,1,6,QCU,0.7473,0.08,0.68,16,16,12,4,1.0,75.0,12,4,74.73,Adapte,Adapte,Adapte / Adapte
1065,236,2016,Informatique,1,6,QCU,0.6789,0.14,0.5,17,14,12,2,1.21,85.71,12,5,67.89,Adapte,Adapte,Adapte / Adapte
1895,236,2017,Informatique,1,6,QCU,0.7248,0.28,0.5,19,17,14,3,1.12,82.35,14,5,72.48,Adapte,Adapte,Adapte / Adapte
2725,236,2018,Informatique,1,6,QCU,0.7327,0.08,0.47,20,19,15,4,1.05,78.95,15,5,73.27,Adapte,Adapte,Adapte / Adapte
3555,236,2019,Informatique,1,6,QCU,0.6708,0.18,0.48,22,16,15,1,1.38,93.75,15,7,67.08,Adapte,Adapte,Adapte / Adapte
4385,236,2020,Informatique,1,6,QCU,0.6488,0.06,0.63,19,19,12,7,1.0,63.16,12,7,64.88,Adapte,Adapte,Adapte / Adapte
236,237,2015,Informatique,1,7,QCM,0.8392,0.02,0.77,7,6,6,0,1.17,100.0,6,1,83.92,Difficile,Facile,Difficile / Facile
1066,237,2016,Informatique,1,7,QCM,0.2815,0.29,0.36,7,5,2,3,1.4,40.0,2,5,28.15,Trop Facile,Difficile,Trop Facile / Difficile
1896,237,2017,Informatique,1,7,QCM,0.9156,0.09,0.89,6,6,5,1,1.0,83.33,5,1,91.56,Trop Facile,Trop Facile,Trop Facile / Trop Facile
2726,237,2018,Informatique,1,7,QCM,0.8822,0.05,0.82,6,5,5,0,1.2,100.0,5,1,88.22,Trop Facile,Trop Facile,Trop Facile / Trop Facile
3556,237,2019,Informatique,1,7,QCM,0.8708,0.0,0.92,7,7,6,1,1.0,85.71,6,1,87.08,Trop Facile,Trop Facile,Trop Facile / Trop Facile
4386,237,2020,Informatique,1,7,QCM,0.0354,0.05,0.23,8,5,0,5,1.6,0.0,0,8,3.54,Trop Facile,Trop Difficile,Trop Facile / Trop Difficile
237,238,2015,Informatique,2,1,QCM,0.7704,0.15,0.77,57,55,44,11,1.04,80.0,44,13,77.04,Facile,Facile,Facile / Facile
1067,238,2016,Informatique,2,1,QCM,0.3256,0.04,0.37,60,44,20,24,1.36,45.45,20,40,32.56,Trop Facile,Difficile,Trop Facile / Difficile
1897,238,2017,Informatique,2,1,QCM,0.9886,0.09,0.98,64,63,63,0,1.02,100.0,63,1,98.86,Trop Facile,Trop Facile,Trop Facile / Trop Facile
2727,238,2018,Informatique,2,1,QCM,0.9894,0.09,0.98,75,75,74,1,1.0,98.67,74,1,98.94,Trop Facile,Trop Facile,Trop Facile / Trop Facile
3557,238,2019,Informatique,2,1,QCM,0.8426,0.14,0.79,63,61,53,8,1.03,86.89,53,10,84.26,Trop Facile,Facile,Trop Facile / Facile
4387,238,2020,Informatique,2,1,QCM,0.5569,0.26,0.38,73,63,41,22,1.16,65.08,41,32,55.69,Trop Facile,Difficile,Trop Facile / Difficile
238,239,2015,Informatique,2,2,QCU,0.3464,0.33,0.38,41,37,14,23,1.11,37.84,14,27,34.64,Difficile,Difficile,Difficile / Difficile
1068,239,2016,Informatique,2,2,QCU,0.8705,0.08,0.97,42,37,37,0,1.14,100.0,37,5,87.05,Trop Facile,Trop Facile,Trop Facile / Trop Facile
1898,239,2017,Informatique,2,2,QCU,0.9433,0.04,0.91,39,38,37,1,1.03,97.37,37,2,94.33,Trop Facile,Trop Facile,Trop Facile / Trop Facile
2728,239,2018,Informatique,2,2,QCU,0.0401,0.17,0.24,42,15,2,13,2.8,13.33,2,40,4.01,Trop Facile,Trop Difficile,Trop Facile / Trop Difficile
3558,239,2019,Informatique,2,2,QCU,0.6675,0.26,0.52,37,27,25,2,1.37,92.59,25,12,66.75,Trop Facile,Adapte,Trop Facile / Adapte
4388,239,2020,Informatique,2,2,QCU,0.7418,0.09,0.57,32,30,24,6,1.07,80.0,24,8,74.18,Adapte,Adapte,Adapte / Adapte
239,240,2015,Informatique,2,3,QROC,0.575,0.66,0.21,77,61,44,17,1.26,72.13,44,33,57.5,Difficile,Difficile,Difficile / Difficile
1069,240,2016,Informatique,2,3,QROC,0.9597,0.07,1.0,72,70,69,1,1.03,98.57,69,3,95.97,Trop Facile,Trop Facile,Trop Facile / Trop Facile
1899,240,2017,Informatique,2,3,QROC,0.9647,0.05,0.52,74,73,71,2,1.01,97.26,71,3,96.47,Trop Facile,Trop Facile,Trop Facile / Trop Facile
2729,240,2018,Informatique,2,3,QROC,0.9282,0.08,0.87,71,69,66,3,1.03,95.65,66,5,92.82,Trop Facile,Trop Facile,Trop Facile / Trop Facile
3559,240,2019,Informatique,2,3,QROC,0.6701,0.45,0.4,60,54,40,14,1.11,74.07,40,20,67.01,Trop Facile,Adapte,Trop Facile / Adapte
4389,240,2020,Informatique,2,3,QROC,0.7136,0.41,0.35,71,62,51,11,1.15,82.26,51,20,71.36,Adapte,Adapte,Adapte / Adapte
240,241,2015,Informatique,2,4,QCU,0.0213,0.39,0.21,46,36,1,35,1.28,2.78,1,45,2.13,Trop Difficile,Trop Difficile,Trop Difficile / Trop Difficile
1070,241,2016,Informatique,2,4,QCU,0.814,0.14,0.78,44,44,36,8,1.0,81.82,36,8,81.4,Trop Facile,Facile,Trop Facile / Facile
1900,241,2017,Informatique,2,4,QCU,0.8779,0.04,0.97,46,41,40,1,1.12,97.56,40,6,87.79,Trop Facile,Trop Facile,Trop Facile / Trop Facile
2730,241,2018,Informatique,2,4,QCU,0.9501,0.07,0.93,48,47,46,1,1.02,97.87,46,2,95.01,Trop Facile,Trop Facile,Trop Facile / Trop Facile
3560,241,2019,Informatique,2,4,QCU,0.9921,0.07,0.93,43,43,43,0,1.0,100.0,43,0,99.21,Trop Facile,Trop Facile,Trop Facile / Trop Facile
4390,241,2020,Informatique,2,4,QCU,0.879,0.07,1.0,43,42,38,4,1.02,90.48,38,5,87.9,Trop Facile,Trop Facile,Trop Facile / Trop Facile
241,242,2015,Informatique,2,5,QCM,0.5328,0.19,0.36,17,10,9,1,1.7,90.0,9,8,53.28,Adapte,Difficile,Adapte / Difficile
1071,242,2016,Informatique,2,5,QCM,0.666,0.1,0.47,17,16,11,5,1.06,68.75,11,6,66.6,Trop Facile,Adapte,Trop Facile / Adapte
1901,242,2017,Informatique,2,5,QCM,0.6494,0.14,0.61,20,17,13,4,1.18,76.47,13,7,64.94,Adapte,Adapte,Adapte / Adapte
2731,242,2018,Informatique,2,5,QCM,0.6645,0.11,0.57,20,20,13,7,1.0,65.0,13,7,66.45,Adapte,Adapte,Adapte / Adapte
3561,242,2019,Informatique,2,5,QCM,0.696,0.06,0.51,17,16,12,4,1.06,75.0,12,5,69.6,Adapte,Adapte,Adapte / Adapte
4391,242,2020,Informatique,2,5,QCM,0.6219,0.16,0.57,20,14,12,2,1.43,85.71,12,8,62.19,Adapte,Adapte,Adapte / Adapte
242,243,2015,Informatique,2,6,QCU,0.2102,0.51,0.22,96,65,20,45,1.48,30.77,20,76,21.02,Trop Difficile,Trop Difficile,Trop Difficile / Trop Difficile
1072,243,2016,Informatique,2,6,QCU,0.9113,0.08,0.95,90,83,82,1,1.08,98.8,82,8,91.13,Trop Facile,Trop Facile,Trop Facile / Trop Facile
1902,243,2017,Informatique,2,6,QCU,0.9258,0.08,0.92,77,72,71,1,1.07,98.61,71,6,92.58,Trop Facile,Trop Facile,Trop Facile / Trop Facile
2732,243,2018,Informatique,2,6,QCU,0.9296,0.08,0.93,90,88,84,4,1.02,95.45,84,6,92.96,Trop Facile,Trop Facile,Trop Facile / Trop Facile
3562,243,2019,Informatique,2,6,QCU,0.8807,0.02,0.95,98,95,86,9,1.03,90.53,86,12,88.07,Trop Facile,Trop Facile,Trop Facile / Trop Facile
4392,243,2020,Informatique,2,6,QCU,0.0732,0.21,0.3,101,57,7,50,1.77,12.28,7,94,7.32,Trop Facile,Trop Difficile,Trop Facile / Trop Difficile
243,244,2015,Informatique,2,7,QROC,0.4067,0.69,0.16,51,39,21,18,1.31,53.85,21,30,40.67,Difficile,Difficile,Difficile / Difficile
1073,244,2016,Informatique,2,7,QROC,0.8898,0.1,0.95,51,45,45,0,1.13,100.0,45,6,88.98,Trop Facile,Trop Facile,Trop Facile / Trop Facile
1903,244,2017,Informatique,2,7,QROC,0.0489,0.76,0.1,49,48,2,46,1.02,4.17,2,47,4.89,Trop Facile,Trop Difficile,Trop Facile / Trop Difficile
2733,244,2018,Informatique,2,7,QROC,0.9059,0.09,0.7,51,48,46,2,1.06,95.83,46,5,90.59,Trop Facile,Trop Facile,Trop Facile / Trop Facile
3563,244,2019,Informatique,2,7,QROC,0.9464,0.03,0.75,47,46,44,2,1.02,95.65,44,3,94.64,Trop Facile,Trop Facile,Trop Facile / Trop Facile
4393,244,2020,Informatique,2,7,QROC,0.9302,0.04,0.71,53,52,49,3,1.02,94.23,49,4,93.02,Trop Facile,Trop Facile,Trop Facile / Trop Facile
244,245,2015,Informatique,2,8,QCM,0.6553,0.25,0.51,49,34,32,2,1.44,94.12,32,17,65.53,Difficile,Adapte,Difficile / Adapte
1074,245,2016,Informatique,2,8,QCM,0.609,0.27,0.58,52,36,32,4,1.44,88.89,32,20,60.9,Adapte,Adapte,Adapte / Adapte
1904,245,2017,Informatique,2,8,QCM,0.6501,0.19,0.57,58,48,38,10,1.21,79.17,38,20,65.01,Adapte,Adapte,Adapte / Adapte
2734,245,2018,Informatique,2,8,QCM,0.7082,0.15,0.41,53,43,38,5,1.23,88.37,38,15,70.82,Adapte,Adapte,Adapte / Adapte
3564,245,2019,Informatique,2,8,QCM,0.6013,0.23,0.52,51,36,31,5,1.42,86.11,31,20,60.13,Adapte,Adapte,Adapte / Adapte
4394,245,2020,Informatique,2,8,QCM,0.6457,0.28,0.57,47,33,30,3,1.42,90.91,30,17,64.57,Adapte,Adapte,Adapte / Adapte
245,246,2015,Informatique,2,9,QCU,0.8423,0.18,0.81,18,16,15,1,1.12,93.75,15,3,84.23,Difficile,Facile,Difficile / Facile
1075,246,2016,Informatique,2,9,QCU,0.8792,0.02,0.94,16,16,14,2,1.0,87.5,14,2,87.92,Trop Facile,Trop Facile,Trop Facile / Trop Facile
1905,246,2017,Informatique,2,9,QCU,0.9254,0.02,0.93,18,18,17,1,1.0,94.44,17,1,92.54,Trop Facile,Trop Facile,Trop Facile / Trop Facile
2735,246,2018,Informatique,2,9,QCU,0.7183,0.27,0.4,16,11,11,0,1.45,100.0,11,5,71.83,Trop Facile,Adapte,Trop Facile / Adapte
3565,246,2019,Informatique,2,9,QCU,0.7407,0.19,0.54,17,14,13,1,1.21,92.86,13,4,74.07,Adapte,Adapte,Adapte / Adapte
4395,246,2020,Informatique,2,9,QCU,0.6565,0.23,0.55,20,19,13,6,1.05,68.42,13,7,65.65,Adapte,Adapte,Adapte / Adapte
246,247,2015,Informatique,3,1,QCM,0.3547,0.34,0.31,96,76,34,42,1.26,44.74,34,62,35.47,Difficile,Difficile,Difficile / Difficile
1076,247,2016,Informatique,3,1,QCM,0.1551,0.41,0.26,114,59,18,41,1.93,30.51,18,96,15.51,Trop Facile,Trop Difficile,Trop Facile / Trop Difficile
1906,247,2017,Informatique,3,1,QCM,0.9588,0.01,0.99,95,91,91,0,1.04,100.0,91,4,95.88,Trop Facile,Trop Facile,Trop Facile / Trop Facile
2736,247,2018,Informatique,3,1,QCM,0.9235,0.07,0.9,89,83,82,1,1.07,98.8,82,7,92.35,Trop Facile,Trop Facile,Trop Facile / Trop Facile
3566,247,2019,Informatique,3,1,QCM,0.869,0.07,0.95,86,78,75,3,1.1,96.15,75,11,86.9,Trop Facile,Trop Facile,Trop Facile / Trop Facile
4396,247,2020,Informatique,3,1,QCM,0.923,0.02,0.83,74,72,68,4,1.03,94.44,68,6,92.3,Trop Facile,Trop Facile,Trop Facile / Trop Facile
247,248,2015,Informatique,3,2,QCU,0.8998,0.01,0.95,10,9,9,0,1.11,100.0,9,1,89.98,Trop Facile,Trop Facile,Trop Facile / Trop Facile
1077,248,2016,Informatique,3,2,QCU,0.8084,0.08,0.85,8,7,6,1,1.14,85.71,6,2,80.84,Trop Facile,Facile,Trop Facile / Facile
1907,248,2017,Informatique,3,2,QCU,0.6576,0.05,0.67,6,4,4,0,1.5,100.0,4,2,65.76,Trop Facile,Adapte,Trop Facile / Adapte
2737,248,2018,Informatique,3,2,QCU,0.6897,0.03,0.59,6,6,4,2,1.0,66.67,4,2,68.97,Adapte,Adapte,Adapte / Adapte
3567,248,2019,Informatique,3,2,QCU,0.638,0.01,0.65,6,5,4,1,1.2,80.0,4,2,63.8,Adapte,Adapte,Adapte / Adapte
4397,248,2020,Informatique,3,2,QCU,0.6528,0.19,0.58,6,4,4,0,1.5,100.0,4,2,65.28,Adapte,Adapte,Adapte / Adapte
248,249,2015,Informatique,3,3,QCM,0.6228,0.03,0.64,81,51,50,1,1.59,98.04,50,31,62.28,Adapte,Adapte,Adapte / Adapte
1078,249,2016,Informatique,3,3,QCM,0.682,0.24,0.66,92,64,63,1,1.44,98.44,63,29,68.2,Adapte,Adapte,Adapte / Adapte
1908,249,2017,Informatique,3,3,QCM,0.7252,0.18,0.62,75,59,54,5,1.27,91.53,54,21,72.52,Adapte,Adapte,Adapte / Adapte
2738,249,2018,Informatique,3,3,QCM,0.6502,0.15,0.6,68,51,44,7,1.33,86.27,44,24,65.02,Adapte,Adapte,Adapte / Adapte
3568,249,2019,Informatique,3,3,QCM,0.6445,0.11,0.42,73,47,47,0,1.55,100.0,47,26,64.45,Adapte,Adapte,Adapte / Adapte
4398,249,2020,Informatique,3,3,QCM,0.6437,0.03,0.64,72,72,46,26,1.0,63.89,46,26,64.37,Adapte,Adapte,Adapte / Adapte
249,250,2015,Informatique,3,4,QROC,0.6398,0.27,0.26,23,20,15,5,1.15,75.0,15,8,63.98,Adapte,Adapte,Adapte / Adapte
1079,250,2016,Informatique,3,4,QROC,0.7469,0.23,0.28,27,21,20,1,1.29,95.24,20,7,74.69,Adapte,Adapte,Adapte / Adapte
1909,250,2017,Informatique,3,4,QROC,0.7183,0.29,0.39,31,26,22,4,1.19,84.62,22,9,71.83,Adapte,Adapte,Adapte / Adapte
2739,250,2018,Informatique,3,4,QROC,0.6594,0.21,0.26,31,23,20,3,1.35,86.96,20,11,65.94,Adapte,Adapte,Adapte / Adapte
3569,250,2019,Informatique,3,4,QROC,0.6209,0.26,0.39,31,22,19,3,1.41,86.36,19,12,62.09,Adapte,Adapte,Adapte / Adapte
4399,250,2020,Informatique,3,4,QROC,0.7485,0.26,0.33,26,24,19,5,1.08,79.17,19,7,74.85,Adapte,Adapte,Adapte / Adapte
250,251,2015,Informatique,3,5,QCM,0.8326,0.06,0.73,40,36,33,3,1.11,91.67,33,7,83.26,Difficile,Facile,Difficile / Facile
1080,251,2016,Informatique,3,5,QCM,0.9033,0.1,0.96,41,38,37,1,1.08,97.37,37,4,90.33,Trop Facile,Trop Facile,Trop Facile / Trop Facile
1910,251,2017,Informatique,3,5,QCM,0.9356,0.0,0.99,43,42,40,2,1.02,95.24,40,3,93.56,Trop Facile,Trop Facile,Trop Facile / Trop Facile
2740,251,2018,Informatique,3,5,QCM,0.9585,0.02,0.98,52,50,50,0,1.04,100.0,50,2,95.85,Trop Facile,Trop Facile,Trop Facile / Trop Facile
3570,251,2019,Informatique,3,5,QCM,0.9347,0.02,0.97,60,58,56,2,1.03,96.55,56,4,93.47,Trop Facile,Trop Facile,Trop Facile / Trop Facile
4400,251,2020,Informatique,3,5,QCM,0.8769,0.02,0.87,65,63,57,6,1.03,90.48,57,8,87.69,Trop Facile,Trop Facile,Trop Facile / Trop Facile
251,252,2015,Informatique,4,1,QCU,0.2057,0.64,0.29,49,45,10,35,1.09,22.22,10,39,20.57,Trop Difficile,Trop Difficile,Trop Difficile / Trop Difficile
1081,252,2016,Informatique,4,1,QCU,0.0798,0.05,0.24,39,38,3,35,1.03,7.89,3,36,7.98,Trop Facile,Trop Difficile,Trop Facile / Trop Difficile
1911,252,2017,Informatique,4,1,QCU,0.7637,0.17,0.77,47,39,36,3,1.21,92.31,36,11,76.37,Trop Facile,Facile,Trop Facile / Facile
2741,252,2018,Informatique,4,1,QCU,0.9024,0.09,0.94,39,37,35,2,1.05,94.59,35,4,90.24,Trop Facile,Trop Facile,Trop Facile / Trop Facile
3571,252,2019,Informatique,4,1,QCU,0.8849,0.08,0.94,36,33,32,1,1.09,96.97,32,4,88.49,Trop Facile,Trop Facile,Trop Facile / Trop Facile
4401,252,2020,Informatique,4,1,QCU,0.8996,0.02,0.94,43,40,39,1,1.07,97.5,39,4,89.96,Trop Facile,Trop Facile,Trop Facile / Trop Facile
252,253,2015,Informatique,4,2,QCU,0.7862,0.12,0.88,32,31,25,6,1.03,80.65,25,7,78.62,Facile,Facile,Facile / Facile
1082,253,2016,Informatique,4,2,QCU,0.4783,0.24,0.39,26,19,12,7,1.37,63.16,12,14,47.83,Trop Facile,Difficile,Trop Facile / Difficile
1912,253,2017,Informatique,4,2,QCU,0.774,0.06,0.76,27,26,21,5,1.04,80.77,21,6,77.4,Trop Facile,Facile,Trop Facile / Facile
2742,253,2018,Informatique,4,2,QCU,0.8302,0.1,0.76,31,30,26,4,1.03,86.67,26,5,83.02,Trop Facile,Facile,Trop Facile / Facile
3572,253,2019,Informatique,4,2,QCU,0.996,0.03,0.9,29,29,29,0,1.0,100.0,29,0,99.6,Trop Facile,Trop Facile,Trop Facile / Trop Facile
4402,253,2020,Informatique,4,2,QCU,0.8249,0.12,0.89,31,27,26,1,1.15,96.3,26,5,82.49,Trop Facile,Facile,Trop Facile / Facile
253,254,2015,Informatique,4,3,QCU,0.0955,0.61,0.3,9,6,1,5,1.5,16.67,1,8,9.55,Trop Difficile,Trop Difficile,Trop Difficile / Trop Difficile
1083,254,2016,Informatique,4,3,QCU,0.8843,0.1,0.91,9,8,8,0,1.12,100.0,8,1,88.43,Trop Facile,Trop Facile,Trop Facile / Trop Facile
1913,254,2017,Informatique,4,3,QCU,0.9912,0.07,1.0,8,8,8,0,1.0,100.0,8,0,99.12,Trop Facile,Trop Facile,Trop Facile / Trop Facile
2743,254,2018,Informatique,4,3,QCU,0.0949,0.68,0.22,10,7,1,6,1.43,14.29,1,9,9.49,Trop Facile,Trop Difficile,Trop Facile / Trop Difficile
3573,254,2019,Informatique,4,3,QCU,0.9091,0.09,0.95,12,12,11,1,1.0,91.67,11,1,90.91,Trop Facile,Trop Facile,Trop Facile / Trop Facile
4403,254,2020,Informatique,4,3,QCU,0.9947,0.0,0.91,11,11,11,0,1.0,100.0,11,0,99.47,Trop Facile,Trop Facile,Trop Facile / Trop Facile
254,255,2015,Informatique,4,4,QCM,0.0759,0.01,0.28,28,24,2,22,1.17,8.33,2,26,7.59,Trop Difficile,Trop Difficile,Trop Difficile / Trop Difficile
1084,255,2016,Informatique,4,4,QCM,0.8922,0.04,0.98,29,26,26,0,1.12,100.0,26,3,89.22,Trop Facile,Trop Facile,Trop Facile / Trop Facile
1914,255,2017,Informatique,4,4,QCM,0.9578,0.09,0.94,28,28,27,1,1.0,96.43,27,1,95.78,Trop Facile,Trop Facile,Trop Facile / Trop Facile
2744,255,2018,Informatique,4,4,QCM,0.8129,0.19,0.79,27,25,22,3,1.08,88.0,22,5,81.29,Trop Facile,Facile,Trop Facile / Facile
3574,255,2019,Informatique,4,4,QCM,0.6441,0.09,0.47,30,20,19,1,1.5,95.0,19,11,64.41,Trop Facile,Adapte,Trop Facile / Adapte
4404,255,2020,Informatique,4,4,QCM,0.7311,0.28,0.56,31,29,23,6,1.07,79.31,23,8,73.11,Adapte,Adapte,Adapte / Adapte
255,256,2015,Informatique,4,5,QCU,0.8765,0.02,0.96,59,54,52,2,1.09,96.3,52,7,87.65,Difficile,Trop Facile,Difficile / Trop Facile
1085,256,2016,Informatique,4,5,QCU,0.75,0.22,0.44,71,66,53,13,1.08,80.3,53,18,75.0,Trop Facile,Adapte,Trop Facile / Adapte
1915,256,2017,Informatique,4,5,QCU,0.6455,0.14,0.54,60,53,39,14,1.13,73.58,39,21,64.55,Adapte,Adapte,Adapte / Adapte
2745,256,2018,Informatique,4,5,QCU,0.616,0.29,0.43,67,60,41,19,1.12,68.33,41,26,61.6,Adapte,Adapte,Adapte / Adapte
3575,256,2019,Informatique,4,5,QCU,0.7132,0.08,0.63,61,58,44,14,1.05,75.86,44,17,71.32,Adapte,Adapte,Adapte / Adapte
4405,256,2020,Informatique,4,5,QCU,0.6725,0.13,0.64,69,51,46,5,1.35,90.2,46,23,67.25,Adapte,Adapte,Adapte / Adapte
256,257,2015,Informatique,4,6,QCU,0.7752,0.18,0.89,22,20,17,3,1.1,85.0,17,5,77.52,Facile,Facile,Facile / Facile
1086,257,2016,Informatique,4,6,QCU,0.8635,0.07,0.91,23,22,20,2,1.05,90.91,20,3,86.35,Trop Facile,Trop Facile,Trop Facile / Trop Facile
1916,257,2017,Informatique,4,6,QCU,0.9167,0.08,0.99,27,27,25,2,1.0,92.59,25,2,91.67,Trop Facile,Trop Facile,Trop Facile / Trop Facile
2746,257,2018,Informatique,4,6,QCU,0.9217,0.05,0.97,31,31,29,2,1.0,93.55,29,2,92.17,Trop Facile,Trop Facile,Trop Facile / Trop Facile
3576,257,2019,Informatique,4,6,QCU,0.9454,0.07,0.95,32,32,30,2,1.0,93.75,30,2,94.54,Trop Facile,Trop Facile,Trop Facile / Trop Facile
4406,257,2020,Informatique,4,6,QCU,0.9359,0.08,0.94,36,36,34,2,1.0,94.44,34,2,93.59,Trop Facile,Trop Facile,Trop Facile / Trop Facile
257,258,2015,Informatique,4,7,QCU,0.3954,0.33,0.36,96,52,38,14,1.85,73.08,38,58,39.54,Trop Facile,Difficile,Trop Facile / Difficile
1087,258,2016,Informatique,4,7,QCU,0.0654,0.29,0.2,102,71,7,64,1.44,9.86,7,95,6.54,Trop Facile,Trop Difficile,Trop Facile / Trop Difficile
1917,258,2017,Informatique,4,7,QCU,0.9193,0.04,0.9,83,83,76,7,1.0,91.57,76,7,91.93,Trop Facile,Trop Facile,Trop Facile / Trop Facile
2747,258,2018,Informatique,4,7,QCU,0.535,0.38,0.38,92,87,49,38,1.06,56.32,49,43,53.5,Trop Facile,Difficile,Trop Facile / Difficile
3577,258,2019,Informatique,4,7,QCU,0.066,0.37,0.3,90,69,6,63,1.3,8.7,6,84,6.6,Trop Facile,Trop Difficile,Trop Facile / Trop Difficile
4407,258,2020,Informatique,4,7,QCU,0.068,0.17,0.21,81,62,6,56,1.31,9.68,6,75,6.8,Trop Facile,Trop Difficile,Trop Facile / Trop Difficile
258,259,2015,Informatique,4,8,QCM,0.906,0.03,0.99,70,64,63,1,1.09,98.44,63,7,90.6,Trop Facile,Trop Facile,Trop Facile / Trop Facile
1088,259,2016,Informatique,4,8,QCM,0.4231,0.43,0.36,80,42,34,8,1.9,80.95,34,46,42.31,Trop Facile,Difficile,Trop Facile / Difficile
1918,259,2017,Informatique,4,8,QCM,0.7079,0.2,0.62,81,70,57,13,1.16,81.43,57,24,70.79,Trop Facile,Adapte,Trop Facile / Adapte
2748,259,2018,Informatique,4,8,QCM,0.6532,0.12,0.61,80,71,52,19,1.13,73.24,52,28,65.32,Adapte,Adapte,Adapte / Adapte
3578,259,2019,Informatique,4,8,QCM,0.7065,0.11,0.42,83,63,59,4,1.32,93.65,59,24,70.65,Adapte,Adapte,Adapte / Adapte
4408,259,2020,Informatique,4,8,QCM,0.6774,0.25,0.56,93,78,63,15,1.19,80.77,63,30,67.74,Adapte,Adapte,Adapte / Adapte
259,260,2015,Informatique,5,1,QCU,0.6336,0.09,0.52,75,58,48,10,1.29,82.76,48,27,63.36,Facile,Adapte,Facile / Adapte
1089,260,2016,Informatique,5,1,QCU,0.7137,0.24,0.61,84,65,60,5,1.29,92.31,60,24,71.37,Adapte,Adapte,Adapte / Adapte
1919,260,2017,Informatique,5,1,QCU,0.6511,0.22,0.41,93,75,61,14,1.24,81.33,61,32,65.11,Adapte,Adapte,Adapte / Adapte
2749,260,2018,Informatique,5,1,QCU,0.6351,0.12,0.67,88,80,56,24,1.1,70.0,56,32,63.51,Adapte,Adapte,Adapte / Adapte
3579,260,2019,Informatique,5,1,QCU,0.6661,0.05,0.68,96,88,64,24,1.09,72.73,64,32,66.61,Adapte,Adapte,Adapte / Adapte
4409,260,2020,Informatique,5,1,QCU,0.6819,0.05,0.58,91,70,62,8,1.3,88.57,62,29,68.19,Adapte,Adapte,Adapte / Adapte
260,261,2015,Informatique,5,2,QROC,0.3014,0.72,0.2,63,32,19,13,1.97,59.38,19,44,30.14,Difficile,Difficile,Difficile / Difficile
1090,261,2016,Informatique,5,2,QROC,0.8809,0.05,0.52,59,56,52,4,1.05,92.86,52,7,88.09,Trop Facile,Trop Facile,Trop Facile / Trop Facile
1920,261,2017,Informatique,5,2,QROC,0.9853,0.02,0.54,58,58,57,1,1.0,98.28,57,1,98.53,Trop Facile,Trop Facile,Trop Facile / Trop Facile
2750,261,2018,Informatique,5,2,QROC,0.9075,0.04,0.84,65,60,59,1,1.08,98.33,59,6,90.75,Trop Facile,Trop Facile,Trop Facile / Trop Facile
3580,261,2019,Informatique,5,2,QROC,0.1902,0.97,0.05,55,43,10,33,1.28,23.26,10,45,19.02,Trop Facile,Trop Difficile,Trop Facile / Trop Difficile
4410,261,2020,Informatique,5,2,QROC,0.9406,0.03,0.87,58,58,55,3,1.0,94.83,55,3,94.06,Trop Facile,Trop Facile,Trop Facile / Trop Facile
261,262,2015,Informatique,5,3,QCU,0.6642,0.04,0.61,24,18,16,2,1.33,88.89,16,8,66.42,Trop Difficile,Adapte,Trop Difficile / Adapte
1091,262,2016,Informatique,5,3,QCU,0.6981,0.19,0.57,21,19,15,4,1.11,78.95,15,6,69.81,Adapte,Adapte,Adapte / Adapte
1921,262,2017,Informatique,5,3,QCU,0.6873,0.25,0.55,17,16,12,4,1.06,75.0,12,5,68.73,Adapte,Adapte,Adapte / Adapte
2751,262,2018,Informatique,5,3,QCU,0.6317,0.29,0.51,19,14,12,2,1.36,85.71,12,7,63.17,Adapte,Adapte,Adapte / Adapte
3581,262,2019,Informatique,5,3,QCU,0.6539,0.24,0.4,20,15,13,2,1.33,86.67,13,7,65.39,Adapte,Adapte,Adapte / Adapte
4411,262,2020,Informatique,5,3,QCU,0.6731,0.25,0.6,20,18,13,5,1.11,72.22,13,7,67.31,Adapte,Adapte,Adapte / Adapte
262,263,2015,Informatique,5,4,QCU,0.7928,0.07,0.78,42,35,33,2,1.2,94.29,33,9,79.28,Facile,Facile,Facile / Facile
1092,263,2016,Informatique,5,4,QCU,0.9115,0.09,0.94,40,37,36,1,1.08,97.3,36,4,91.15,Trop Facile,Trop Facile,Trop Facile / Trop Facile
1922,263,2017,Informatique,5,4,QCU,0.9637,0.05,0.97,42,41,40,1,1.02,97.56,40,2,96.37,Trop Facile,Trop Facile,Trop Facile / Trop Facile
2752,263,2018,Informatique,5,4,QCU,0.868,0.07,0.91,46,40,40,0,1.15,100.0,40,6,86.8,Trop Facile,Trop Facile,Trop Facile / Trop Facile
3582,263,2019,Informatique,5,4,QCU,0.9682,0.01,0.97,51,51,49,2,1.0,96.08,49,2,96.82,Trop Facile,Trop Facile,Trop Facile / Trop Facile
4412,263,2020,Informatique,5,4,QCU,0.8638,0.08,0.96,42,41,36,5,1.02,87.8,36,6,86.38,Trop Facile,Trop Facile,Trop Facile / Trop Facile
263,264,2015,Informatique,5,5,QCM,0.4215,0.36,0.37,51,48,21,27,1.06,43.75,21,30,42.15,Difficile,Difficile,Difficile / Difficile
1093,264,2016,Informatique,5,5,QCM,0.912,0.01,0.8,41,37,37,0,1.11,100.0,37,4,91.2,Trop Facile,Trop Facile,Trop Facile / Trop Facile
1923,264,2017,Informatique,5,5,QCM,0.6881,0.12,0.65,35,31,24,7,1.13,77.42,24,11,68.81,Trop Facile,Adapte,Trop Facile / Adapte
2753,264,2018,Informatique,5,5,QCM,0.6251,0.06,0.47,42,42,26,16,1.0,61.9,26,16,62.51,Adapte,Adapte,Adapte / Adapte
3583,264,2019,Informatique,5,5,QCM,0.7466,0.13,0.56,42,37,31,6,1.14,83.78,31,11,74.66,Adapte,Adapte,Adapte / Adapte
4413,264,2020,Informatique,5,5,QCM,0.6007,0.28,0.41,40,29,24,5,1.38,82.76,24,16,60.07,Adapte,Adapte,Adapte / Adapte
264,265,2015,Informatique,5,6,QCM,0.2792,0.33,0.37,22,11,6,5,2.0,54.55,6,16,27.92,Difficile,Difficile,Difficile / Difficile
1094,265,2016,Informatique,5,6,QCM,0.9357,0.08,0.83,22,21,21,0,1.05,100.0,21,1,93.57,Trop Facile,Trop Facile,Trop Facile / Trop Facile
1924,265,2017,Informatique,5,6,QCM,0.0515,0.47,0.26,23,22,1,21,1.05,4.55,1,22,5.15,Trop Facile,Trop Difficile,Trop Facile / Trop Difficile
2754,265,2018,Informatique,5,6,QCM,0.6682,0.01,0.61,25,25,17,8,1.0,68.0,17,8,66.82,Trop Facile,Adapte,Trop Facile / Adapte
3584,265,2019,Informatique,5,6,QCM,0.693,0.13,0.64,28,22,19,3,1.27,86.36,19,9,69.3,Adapte,Adapte,Adapte / Adapte
4414,265,2020,Informatique,5,6,QCM,0.6139,0.21,0.53,22,22,14,8,1.0,63.64,14,8,61.39,Adapte,Adapte,Adapte / Adapte
265,266,2015,Informatique,6,1,QCU,0.7641,0.19,0.8,32,28,24,4,1.14,85.71,24,8,76.41,Facile,Facile,Facile / Facile
1095,266,2016,Informatique,6,1,QCU,0.2173,0.0,0.25,36,21,8,13,1.71,38.1,8,28,21.73,Trop Facile,Trop Difficile,Trop Facile / Trop Difficile
1925,266,2017,Informatique,6,1,QCU,0.7083,0.01,0.64,43,39,30,9,1.1,76.92,30,13,70.83,Trop Facile,Adapte,Trop Facile / Adapte
2755,266,2018,Informatique,6,1,QCU,0.7359,0.29,0.6,39,34,29,5,1.15,85.29,29,10,73.59,Adapte,Adapte,Adapte / Adapte
3585,266,2019,Informatique,6,1,QCU,0.6246,0.22,0.66,43,42,27,15,1.02,64.29,27,16,62.46,Adapte,Adapte,Adapte / Adapte
4415,266,2020,Informatique,6,1,QCU,0.6274,0.08,0.68,35,31,22,9,1.13,70.97,22,13,62.74,Adapte,Adapte,Adapte / Adapte
266,267,2015,Informatique,7,1,QCU,0.3579,0.0,0.35,56,27,20,7,2.07,74.07,20,36,35.79,Difficile,Difficile,Difficile / Difficile
1096,267,2016,Informatique,7,1,QCU,0.0349,0.07,0.23,65,57,2,55,1.14,3.51,2,63,3.49,Trop Facile,Trop Difficile,Trop Facile / Trop Difficile
1926,267,2017,Informatique,7,1,QCU,0.8665,0.09,0.94,67,61,58,3,1.1,95.08,58,9,86.65,Trop Facile,Trop Facile,Trop Facile / Trop Facile
2756,267,2018,Informatique,7,1,QCU,0.9602,0.01,0.96,61,61,59,2,1.0,96.72,59,2,96.02,Trop Facile,Trop Facile,Trop Facile / Trop Facile
3586,267,2019,Informatique,7,1,QCU,0.8268,0.08,0.89,70,63,58,5,1.11,92.06,58,12,82.68,Trop Facile,Facile,Trop Facile / Facile
4416,267,2020,Informatique,7,1,QCU,0.862,0.04,0.91,83,78,72,6,1.06,92.31,72,11,86.2,Trop Facile,Trop Facile,Trop Facile / Trop Facile
267,268,2015,Informatique,7,2,QCM,0.9059,0.05,0.96,91,91,82,9,1.0,90.11,82,9,90.59,Difficile,Trop Facile,Difficile / Trop Facile
1097,268,2016,Informatique,7,2,QCM,0.7002,0.28,0.43,76,65,53,12,1.17,81.54,53,23,70.02,Trop Facile,Adapte,Trop Facile / Adapte
1927,268,2017,Informatique,7,2,QCM,0.735,0.26,0.6,75,62,55,7,1.21,88.71,55,20,73.5,Adapte,Adapte,Adapte / Adapte
2757,268,2018,Informatique,7,2,QCM,0.6798,0.28,0.61,69,61,47,14,1.13,77.05,47,22,67.98,Adapte,Adapte,Adapte / Adapte
3587,268,2019,Informatique,7,2,QCM,0.6202,0.26,0.61,67,57,42,15,1.18,73.68,42,25,62.02,Adapte,Adapte,Adapte / Adapte
4417,268,2020,Informatique,7,2,QCM,0.7408,0.1,0.51,80,71,59,12,1.13,83.1,59,21,74.08,Adapte,Adapte,Adapte / Adapte
268,269,2015,Informatique,7,3,QROC,0.0856,0.79,0.04,80,65,7,58,1.23,10.77,7,73,8.56,Trop Difficile,Trop Difficile,Trop Difficile / Trop Difficile
1098,269,2016,Informatique,7,3,QROC,0.8801,0.03,0.81,80,80,70,10,1.0,87.5,70,10,88.01,Trop Facile,Trop Facile,Trop Facile / Trop Facile
1928,269,2017,Informatique,7,3,QROC,0.9717,0.08,0.84,79,78,77,1,1.01,98.72,77,2,97.17,Trop Facile,Trop Facile,Trop Facile / Trop Facile
2758,269,2018,Informatique,7,3,QROC,0.8756,0.01,0.55,74,67,65,2,1.1,97.01,65,9,87.56,Trop Facile,Trop Facile,Trop Facile / Trop Facile
3588,269,2019,Informatique,7,3,QROC,0.9317,0.09,0.99,64,63,60,3,1.02,95.24,60,4,93.17,Trop Facile,Trop Facile,Trop Facile / Trop Facile
4418,269,2020,Informatique,7,3,QROC,0.9492,0.04,0.62,67,64,64,0,1.05,100.0,64,3,94.92,Trop Facile,Trop Facile,Trop Facile / Trop Facile
269,270,2015,Informatique,7,4,QROC,0.0335,0.95,0.08,36,30,1,29,1.2,3.33,1,35,3.35,Trop Difficile,Trop Difficile,Trop Difficile / Trop Difficile
1099,270,2016,Informatique,7,4,QROC,0.8607,0.01,0.92,34,31,29,2,1.1,93.55,29,5,86.07,Trop Facile,Trop Facile,Trop Facile / Trop Facile
1929,270,2017,Informatique,7,4,QROC,0.9337,0.09,0.61,28,26,26,0,1.08,100.0,26,2,93.37,Trop Facile,Trop Facile,Trop Facile / Trop Facile
2759,270,2018,Informatique,7,4,QROC,0.9352,0.03,0.72,31,29,29,0,1.07,100.0,29,2,93.52,Trop Facile,Trop Facile,Trop Facile / Trop Facile
3589,270,2019,Informatique,7,4,QROC,0.9158,0.04,0.99,25,24,23,1,1.04,95.83,23,2,91.58,Trop Facile,Trop Facile,Trop Facile / Trop Facile
4419,270,2020,Informatique,7,4,QROC,0.82,0.01,0.51,22,18,18,0,1.22,100.0,18,4,82.0,Trop Facile,Facile,Trop Facile / Facile
270,271,2015,Informatique,7,5,QCU,0.3717,0.36,0.33,33,27,12,15,1.22,44.44,12,21,37.17,Facile,Difficile,Facile / Difficile
1100,271,2016,Informatique,7,5,QCU,0.6201,0.29,0.6,27,20,17,3,1.35,85.0,17,10,62.01,Trop Facile,Adapte,Trop Facile / Adapte
1930,271,2017,Informatique,7,5,QCU,0.6194,0.29,0.49,22,18,14,4,1.22,77.78,14,8,61.94,Adapte,Adapte,Adapte / Adapte
2760,271,2018,Informatique,7,5,QCU,0.7199,0.1,0.64,24,22,17,5,1.09,77.27,17,7,71.99,Adapte,Adapte,Adapte / Adapte
3590,271,2019,Informatique,7,5,QCU,0.6281,0.18,0.6,28,19,18,1,1.47,94.74,18,10,62.81,Adapte,Adapte,Adapte / Adapte
4420,271,2020,Informatique,7,5,QCU,0.6002,0.0,0.44,34,24,20,4,1.42,83.33,20,14,60.02,Adapte,Adapte,Adapte / Adapte
271,272,2015,Informatique,7,6,QCU,0.1502,0.67,0.25,11,5,2,3,2.2,40.0,2,9,15.02,Trop Facile,Trop Difficile,Trop Facile / Trop Difficile
1101,272,2016,Informatique,7,6,QCU,0.9125,0.1,0.92,9,8,8,0,1.12,100.0,8,1,91.25,Trop Facile,Trop Facile,Trop Facile / Trop Facile
1931,272,2017,Informatique,7,6,QCU,0.112,0.04,0.28,7,4,1,3,1.75,25.0,1,6,11.2,Trop Facile,Trop Difficile,Trop Facile / Trop Difficile
2761,272,2018,Informatique,7,6,QCU,0.8723,0.02,0.98,8,8,7,1,1.0,87.5,7,1,87.23,Trop Facile,Trop Facile,Trop Facile / Trop Facile
3591,272,2019,Informatique,7,6,QCU,0.8649,0.02,0.97,7,6,6,0,1.17,100.0,6,1,86.49,Trop Facile,Trop Facile,Trop Facile / Trop Facile
4421,272,2020,Informatique,7,6,QCU,0.907,0.07,0.91,6,5,5,0,1.2,100.0,5,1,90.7,Trop Facile,Trop Facile,Trop Facile / Trop Facile
272,273,2015,Informatique,7,7,QCM,0.3272,0.08,0.36,9,8,3,5,1.12,37.5,3,6,32.72,Difficile,Difficile,Difficile / Difficile
1102,273,2016,Informatique,7,7,QCM,0.9944,0.03,0.88,11,11,11,0,1.0,100.0,11,0,99.44,Trop Facile,Trop Facile,Trop Facile / Trop Facile
1932,273,2017,Informatique,7,7,QCM,0.097,0.34,0.25,12,11,1,10,1.09,9.09,1,11,9.7,Trop Facile,Trop Difficile,Trop Facile / Trop Difficile
2762,273,2018,Informatique,7,7,QCM,0.913,0.07,0.86,13,13,12,1,1.0,92.31,12,1,91.3,Trop Facile,Trop Facile,Trop Facile / Trop Facile
3592,273,2019,Informatique,7,7,QCM,0.9781,0.05,0.88,14,14,14,0,1.0,100.0,14,0,97.81,Trop Facile,Trop Facile,Trop Facile / Trop Facile
4422,273,2020,Informatique,7,7,QCM,0.9924,0.09,0.87,12,12,12,0,1.0,100.0,12,0,99.24,Trop Facile,Trop Facile,Trop Facile / Trop Facile
273,274,2015,Informatique,7,8,QCU,0.7608,0.01,0.8,29,23,22,1,1.26,95.65,22,7,76.08,Trop Difficile,Facile,Trop Difficile / Facile
1103,274,2016,Informatique,7,8,QCU,0.9778,0.09,0.91,32,31,31,0,1.03,100.0,31,1,97.78,Trop Facile,Trop Facile,Trop Facile / Trop Facile
1933,274,2017,Informatique,7,8,QCU,0.8916,0.02,0.95,30,29,27,2,1.03,93.1,27,3,89.16,Trop Facile,Trop Facile,Trop Facile / Trop Facile
2763,274,2018,Informatique,7,8,QCU,0.9648,0.04,0.93,33,32,32,0,1.03,100.0,32,1,96.48,Trop Facile,Trop Facile,Trop Facile / Trop Facile
3593,274,2019,Informatique,7,8,QCU,0.0399,0.47,0.25,40,25,2,23,1.6,8.0,2,38,3.99,Trop Facile,Trop Difficile,Trop Facile / Trop Difficile
4423,274,2020,Informatique,7,8,QCU,0.7427,0.07,0.5,32,26,24,2,1.23,92.31,24,8,74.27,Trop Facile,Adapte,Trop Facile / Adapte
274,275,2015,Informatique,7,9,QCU,0.8774,0.03,0.97,63,61,55,6,1.03,90.16,55,8,87.74,Trop Facile,Trop Facile,Trop Facile / Trop Facile
1104,275,2016,Informatique,7,9,QCU,0.7626,0.2,0.76,54,42,41,1,1.29,97.62,41,13,76.26,Trop Facile,Facile,Trop Facile / Facile
1934,275,2017,Informatique,7,9,QCU,0.9322,0.05,0.91,43,40,40,0,1.07,100.0,40,3,93.22,Trop Facile,Trop Facile,Trop Facile / Trop Facile
2764,275,2018,Informatique,7,9,QCU,0.8703,0.07,0.95,47,45,41,4,1.04,91.11,41,6,87.03,Trop Facile,Trop Facile,Trop Facile / Trop Facile
3594,275,2019,Informatique,7,9,QCU,0.9741,0.09,1.0,38,37,37,0,1.03,100.0,37,1,97.41,Trop Facile,Trop Facile,Trop Facile / Trop Facile
4424,275,2020,Informatique,7,9,QCU,0.9244,0.08,0.94,39,39,36,3,1.0,92.31,36,3,92.44,Trop Facile,Trop Facile,Trop Facile / Trop Facile
275,276,2015,Informatique,8,1,QCU,0.2205,0.74,0.26,26,21,6,15,1.24,28.57,6,20,22.05,Trop Difficile,Trop Difficile,Trop Difficile / Trop Difficile
1105,276,2016,Informatique,8,1,QCU,0.9772,0.09,0.96,29,28,28,0,1.04,100.0,28,1,97.72,Trop Facile,Trop Facile,Trop Facile / Trop Facile
1935,276,2017,Informatique,8,1,QCU,0.9692,0.03,0.92,23,22,22,0,1.05,100.0,22,1,96.92,Trop Facile,Trop Facile,Trop Facile / Trop Facile
2765,276,2018,Informatique,8,1,QCU,0.911,0.05,0.92,26,26,24,2,1.0,92.31,24,2,91.1,Trop Facile,Trop Facile,Trop Facile / Trop Facile
3595,276,2019,Informatique,8,1,QCU,0.8621,0.06,0.95,30,29,26,3,1.03,89.66,26,4,86.21,Trop Facile,Trop Facile,Trop Facile / Trop Facile
4425,276,2020,Informatique,8,1,QCU,0.2616,0.0,0.31,29,13,8,5,2.23,61.54,8,21,26.16,Trop Facile,Difficile,Trop Facile / Difficile
276,277,2015,Informatique,8,2,QCM,0.3666,0.49,0.36,34,20,12,8,1.7,60.0,12,22,36.66,Difficile,Difficile,Difficile / Difficile
1106,277,2016,Informatique,8,2,QCM,0.8927,0.09,0.88,36,34,32,2,1.06,94.12,32,4,89.27,Trop Facile,Trop Facile,Trop Facile / Trop Facile
1936,277,2017,Informatique,8,2,QCM,0.9911,0.09,0.84,31,31,31,0,1.0,100.0,31,0,99.11,Trop Facile,Trop Facile,Trop Facile / Trop Facile
2766,277,2018,Informatique,8,2,QCM,0.9322,0.05,0.85,35,33,33,0,1.06,100.0,33,2,93.22,Trop Facile,Trop Facile,Trop Facile / Trop Facile
3596,277,2019,Informatique,8,2,QCM,0.5651,0.26,0.32,40,25,23,2,1.6,92.0,23,17,56.51,Trop Facile,Difficile,Trop Facile / Difficile
4426,277,2020,Informatique,8,2,QCM,0.9842,0.06,0.9,42,41,41,0,1.02,100.0,41,1,98.42,Trop Facile,Trop Facile,Trop Facile / Trop Facile
277,278,2015,Informatique,8,3,QCM,0.484,0.37,0.38,31,20,15,5,1.55,75.0,15,16,48.4,Adapte,Difficile,Adapte / Difficile
1107,278,2016,Informatique,8,3,QCM,0.8893,0.02,0.92,28,27,25,2,1.04,92.59,25,3,88.93,Trop Facile,Trop Facile,Trop Facile / Trop Facile
1937,278,2017,Informatique,8,3,QCM,0.939,0.04,0.83,23,23,22,1,1.0,95.65,22,1,93.9,Trop Facile,Trop Facile,Trop Facile / Trop Facile
2767,278,2018,Informatique,8,3,QCM,0.6449,0.15,0.4,24,18,15,3,1.33,83.33,15,9,64.49,Trop Facile,Adapte,Trop Facile / Adapte
3597,278,2019,Informatique,8,3,QCM,0.711,0.02,0.69,23,21,16,5,1.1,76.19,16,7,71.1,Adapte,Adapte,Adapte / Adapte
4427,278,2020,Informatique,8,3,QCM,0.7237,0.09,0.46,28,28,20,8,1.0,71.43,20,8,72.37,Adapte,Adapte,Adapte / Adapte
278,279,2015,Informatique,8,4,QCU,0.9533,0.05,0.94,30,30,29,1,1.0,96.67,29,1,95.33,Trop Facile,Trop Facile,Trop Facile / Trop Facile
1108,279,2016,Informatique,8,4,QCU,0.9,0.06,0.97,33,32,30,2,1.03,93.75,30,3,90.0,Trop Facile,Trop Facile,Trop Facile / Trop Facile
1938,279,2017,Informatique,8,4,QCU,0.9525,0.04,0.93,29,29,28,1,1.0,96.55,28,1,95.25,Trop Facile,Trop Facile,Trop Facile / Trop Facile
2768,279,2018,Informatique,8,4,QCU,0.8924,0.07,0.99,31,30,28,2,1.03,93.33,28,3,89.24,Trop Facile,Trop Facile,Trop Facile / Trop Facile
3598,279,2019,Informatique,8,4,QCU,0.5247,0.14,0.4,32,17,17,0,1.88,100.0,17,15,52.47,Trop Facile,Difficile,Trop Facile / Difficile
4428,279,2020,Informatique,8,4,QCU,0.4815,0.25,0.32,31,19,15,4,1.63,78.95,15,16,48.15,Trop Facile,Difficile,Trop Facile / Difficile
279,280,2015,Informatique,8,5,QCM,0.4053,0.03,0.35,28,20,11,9,1.4,55.0,11,17,40.53,Facile,Difficile,Facile / Difficile
1109,280,2016,Informatique,8,5,QCM,0.9435,0.02,1.0,29,27,27,0,1.07,100.0,27,2,94.35,Trop Facile,Trop Facile,Trop Facile / Trop Facile
1939,280,2017,Informatique,8,5,QCM,0.9413,0.04,0.89,25,25,24,1,1.0,96.0,24,1,94.13,Trop Facile,Trop Facile,Trop Facile / Trop Facile
2769,280,2018,Informatique,8,5,QCM,0.6082,0.28,0.44,21,17,13,4,1.24,76.47,13,8,60.82,Trop Facile,Adapte,Trop Facile / Adapte
3599,280,2019,Informatique,8,5,QCM,0.7064,0.27,0.52,22,19,16,3,1.16,84.21,16,6,70.64,Adapte,Adapte,Adapte / Adapte
4429,280,2020,Informatique,8,5,QCM,0.6299,0.08,0.65,20,15,13,2,1.33,86.67,13,7,62.99,Adapte,Adapte,Adapte / Adapte
280,281,2015,Informatique,8,6,QROC,0.2199,0.76,0.1,73,63,16,47,1.16,25.4,16,57,21.99,Trop Difficile,Trop Difficile,Trop Difficile / Trop Difficile
1110,281,2016,Informatique,8,6,QROC,0.9044,0.07,0.8,75,72,68,4,1.04,94.44,68,7,90.44,Trop Facile,Trop Facile,Trop Facile / Trop Facile
1940,281,2017,Informatique,8,6,QROC,0.9332,0.03,0.92,87,84,81,3,1.04,96.43,81,6,93.32,Trop Facile,Trop Facile,Trop Facile / Trop Facile
2770,281,2018,Informatique,8,6,QROC,0.4806,0.66,0.18,72,69,35,34,1.04,50.72,35,37,48.06,Trop Facile,Difficile,Trop Facile / Difficile
3600,281,2019,Informatique,8,6,QROC,0.895,0.0,0.89,58,57,52,5,1.02,91.23,52,6,89.5,Trop Facile,Trop Facile,Trop Facile / Trop Facile
4430,281,2020,Informatique,8,6,QROC,0.9038,0.1,0.8,66,62,60,2,1.06,96.77,60,6,90.38,Trop Facile,Trop Facile,Trop Facile / Trop Facile
281,282,2015,Informatique,8,7,QCU,0.2727,0.09,0.33,93,31,25,6,3.0,80.65,25,68,27.27,Trop Facile,Difficile,Trop Facile / Difficile
1111,282,2016,Informatique,8,7,QCU,0.943,0.1,0.96,78,74,74,0,1.05,100.0,74,4,94.3,Trop Facile,Trop Facile,Trop Facile / Trop Facile
1941,282,2017,Informatique,8,7,QCU,0.9027,0.06,0.93,89,83,80,3,1.07,96.39,80,9,90.27,Trop Facile,Trop Facile,Trop Facile / Trop Facile
2771,282,2018,Informatique,8,7,QCU,0.9797,0.1,0.92,79,78,77,1,1.01,98.72,77,2,97.97,Trop Facile,Trop Facile,Trop Facile / Trop Facile
3601,282,2019,Informatique,8,7,QCU,0.9769,0.01,0.95,68,67,66,1,1.01,98.51,66,2,97.69,Trop Facile,Trop Facile,Trop Facile / Trop Facile
4431,282,2020,Informatique,8,7,QCU,0.9197,0.07,0.94,73,71,67,4,1.03,94.37,67,6,91.97,Trop Facile,Trop Facile,Trop Facile / Trop Facile
282,283,2015,Informatique,8,8,QCU,0.9221,0.09,0.95,26,25,24,1,1.04,96.0,24,2,92.21,Trop Facile,Trop Facile,Trop Facile / Trop Facile
1112,283,2016,Informatique,8,8,QCU,0.8646,0.05,0.94,26,24,22,2,1.08,91.67,22,4,86.46,Trop Facile,Trop Facile,Trop Facile / Trop Facile
1942,283,2017,Informatique,8,8,QCU,0.9949,0.04,0.96,31,31,31,0,1.0,100.0,31,0,99.49,Trop Facile,Trop Facile,Trop Facile / Trop Facile
2772,283,2018,Informatique,8,8,QCU,0.8914,0.09,1.0,34,30,30,0,1.13,100.0,30,4,89.14,Trop Facile,Trop Facile,Trop Facile / Trop Facile
3602,283,2019,Informatique,8,8,QCU,0.8979,0.08,0.93,28,27,25,2,1.04,92.59,25,3,89.79,Trop Facile,Trop Facile,Trop Facile / Trop Facile
4432,283,2020,Informatique,8,8,QCU,0.9488,0.03,0.91,29,29,28,1,1.0,96.55,28,1,94.88,Trop Facile,Trop Facile,Trop Facile / Trop Facile
283,284,2015,Informatique,8,9,QCM,0.4691,0.34,0.33,83,49,39,10,1.69,79.59,39,44,46.91,Facile,Difficile,Facile / Difficile
1113,284,2016,Informatique,8,9,QCM,0.9133,0.06,0.82,66,66,60,6,1.0,90.91,60,6,91.33,Trop Facile,Trop Facile,Trop Facile / Trop Facile
1943,284,2017,Informatique,8,9,QCM,0.565,0.31,0.39,62,47,35,12,1.32,74.47,35,27,56.5,Trop Facile,Difficile,Trop Facile / Difficile
2773,284,2018,Informatique,8,9,QCM,0.6726,0.28,0.65,58,51,39,12,1.14,76.47,39,19,67.26,Trop Facile,Adapte,Trop Facile / Adapte
3603,284,2019,Informatique,8,9,QCM,0.6547,0.19,0.53,52,45,34,11,1.16,75.56,34,18,65.47,Adapte,Adapte,Adapte / Adapte
4433,284,2020,Informatique,8,9,QCM,0.7088,0.26,0.54,61,46,43,3,1.33,93.48,43,18,70.88,Adapte,Adapte,Adapte / Adapte
284,285,2015,Informatique,8,10,QCU,0.4066,0.01,0.35,27,16,11,5,1.69,68.75,11,16,40.66,Difficile,Difficile,Difficile / Difficile
1114,285,2016,Informatique,8,10,QCU,0.9097,0.03,0.97,32,31,29,2,1.03,93.55,29,3,90.97,Trop Facile,Trop Facile,Trop Facile / Trop Facile
1944,285,2017,Informatique,8,10,QCU,0.8093,0.02,0.77,35,28,28,0,1.25,100.0,28,7,80.93,Trop Facile,Facile,Trop Facile / Facile
2774,285,2018,Informatique,8,10,QCU,0.9945,0.06,0.96,30,30,30,0,1.0,100.0,30,0,99.45,Trop Facile,Trop Facile,Trop Facile / Trop Facile
3604,285,2019,Informatique,8,10,QCU,0.9839,0.09,0.95,32,32,31,1,1.0,96.88,31,1,98.39,Trop Facile,Trop Facile,Trop Facile / Trop Facile
4434,285,2020,Informatique,8,10,QCU,0.9883,0.03,0.94,37,37,37,0,1.0,100.0,37,0,98.83,Trop Facile,Trop Facile,Trop Facile / Trop Facile
285,286,2015,Informatique,8,11,QCM,0.7407,0.12,0.59,77,73,57,16,1.05,78.08,57,20,74.07,Adapte,Adapte,Adapte / Adapte
1115,286,2016,Informatique,8,11,QCM,0.7037,0.16,0.67,73,52,51,1,1.4,98.08,51,22,70.37,Adapte,Adapte,Adapte / Adapte
1945,286,2017,Informatique,8,11,QCM,0.7471,0.1,0.67,65,54,49,5,1.2,90.74,49,16,74.71,Adapte,Adapte,Adapte / Adapte
2775,286,2018,Informatique,8,11,QCM,0.614,0.3,0.69,54,37,33,4,1.46,89.19,33,21,61.4,Adapte,Adapte,Adapte / Adapte
3605,286,2019,Informatique,8,11,QCM,0.7434,0.27,0.66,61,48,45,3,1.27,93.75,45,16,74.34,Adapte,Adapte,Adapte / Adapte
4435,286,2020,Informatique,8,11,QCM,0.6536,0.17,0.52,64,43,42,1,1.49,97.67,42,22,65.36,Adapte,Adapte,Adapte / Adapte
286,287,2015,Informatique,8,12,QCU,0.3673,0.12,0.34,11,8,4,4,1.38,50.0,4,7,36.73,Difficile,Difficile,Difficile / Difficile
1116,287,2016,Informatique,8,12,QCU,0.6813,0.05,0.7,11,10,7,3,1.1,70.0,7,4,68.13,Trop Facile,Adapte,Trop Facile / Adapte
1946,287,2017,Informatique,8,12,QCU,0.6043,0.09,0.45,13,10,8,2,1.3,80.0,8,5,60.43,Adapte,Adapte,Adapte / Adapte
2776,287,2018,Informatique,8,12,QCU,0.6546,0.1,0.6,12,9,8,1,1.33,88.89,8,4,65.46,Adapte,Adapte,Adapte / Adapte
3606,287,2019,Informatique,8,12,QCU,0.7496,0.02,0.41,13,12,10,2,1.08,83.33,10,3,74.96,Adapte,Adapte,Adapte / Adapte
4436,287,2020,Informatique,8,12,QCU,0.6952,0.06,0.43,13,10,9,1,1.3,90.0,9,4,69.52,Adapte,Adapte,Adapte / Adapte
287,288,2015,Informatique,8,13,QCM,0.6873,0.06,0.58,15,14,10,4,1.07,71.43,10,5,68.73,Difficile,Adapte,Difficile / Adapte
1117,288,2016,Informatique,8,13,QCM,0.6793,0.17,0.67,13,13,9,4,1.0,69.23,9,4,67.93,Adapte,Adapte,Adapte / Adapte
1947,288,2017,Informatique,8,13,QCM,0.7151,0.23,0.6,12,10,9,1,1.2,90.0,9,3,71.51,Adapte,Adapte,Adapte / Adapte
2777,288,2018,Informatique,8,13,QCM,0.6279,0.1,0.4,10,7,6,1,1.43,85.71,6,4,62.79,Adapte,Adapte,Adapte / Adapte
3607,288,2019,Informatique,8,13,QCM,0.6187,0.16,0.59,10,6,6,0,1.67,100.0,6,4,61.87,Adapte,Adapte,Adapte / Adapte
4437,288,2020,Informatique,8,13,QCM,0.6497,0.03,0.52,11,10,7,3,1.1,70.0,7,4,64.97,Adapte,Adapte,Adapte / Adapte
288,289,2015,Informatique,8,14,QCU,0.1595,0.19,0.27,8,4,1,3,2.0,25.0,1,7,15.95,Trop Difficile,Trop Difficile,Trop Difficile / Trop Difficile
1118,289,2016,Informatique,8,14,QCU,0.9972,0.03,0.99,10,10,10,0,1.0,100.0,10,0,99.72,Trop Facile,Trop Facile,Trop Facile / Trop Facile
1948,289,2017,Informatique,8,14,QCU,0.8665,0.02,0.99,10,9,9,0,1.11,100.0,9,1,86.65,Trop Facile,Trop Facile,Trop Facile / Trop Facile
2778,289,2018,Informatique,8,14,QCU,0.0041,0.7,0.29,8,4,0,4,2.0,0.0,0,8,0.41,Trop Facile,Trop Difficile,Trop Facile / Trop Difficile
3608,289,2019,Informatique,8,14,QCU,0.8973,0.01,0.96,9,9,8,1,1.0,88.89,8,1,89.73,Trop Facile,Trop Facile,Trop Facile / Trop Facile
4438,289,2020,Informatique,8,14,QCU,0.8708,0.0,0.97,8,7,7,0,1.14,100.0,7,1,87.08,Trop Facile,Trop Facile,Trop Facile / Trop Facile
289,290,2015,Informatique,9,1,QCU,0.5074,0.05,0.33,14,9,7,2,1.56,77.78,7,7,50.74,Difficile,Difficile,Difficile / Difficile
1119,290,2016,Informatique,9,1,QCU,0.9298,0.04,0.92,14,13,13,0,1.08,100.0,13,1,92.98,Trop Facile,Trop Facile,Trop Facile / Trop Facile
1949,290,2017,Informatique,9,1,QCU,0.9008,0.1,0.9,15,15,14,1,1.0,93.33,14,1,90.08,Trop Facile,Trop Facile,Trop Facile / Trop Facile
2779,290,2018,Informatique,9,1,QCU,0.8839,0.03,0.95,17,16,15,1,1.06,93.75,15,2,88.39,Trop Facile,Trop Facile,Trop Facile / Trop Facile
3609,290,2019,Informatique,9,1,QCU,0.9907,0.07,0.91,18,18,18,0,1.0,100.0,18,0,99.07,Trop Facile,Trop Facile,Trop Facile / Trop Facile
4439,290,2020,Informatique,9,1,QCU,0.7758,0.04,0.81,18,14,14,0,1.29,100.0,14,4,77.58,Trop Facile,Facile,Trop Facile / Facile
290,291,2015,Informatique,9,2,QROC,0.6848,0.25,0.36,97,75,66,9,1.29,88.0,66,31,68.48,Adapte,Adapte,Adapte / Adapte
1120,291,2016,Informatique,9,2,QROC,0.7111,0.47,0.38,115,94,82,12,1.22,87.23,82,33,71.11,Adapte,Adapte,Adapte / Adapte
1950,291,2017,Informatique,9,2,QROC,0.6624,0.3,0.26,138,109,91,18,1.27,83.49,91,47,66.24,Adapte,Adapte,Adapte / Adapte
2780,291,2018,Informatique,9,2,QROC,0.7474,0.35,0.38,118,114,88,26,1.04,77.19,88,30,74.74,Adapte,Adapte,Adapte / Adapte
3610,291,2019,Informatique,9,2,QROC,0.7379,0.41,0.31,114,93,84,9,1.23,90.32,84,30,73.79,Adapte,Adapte,Adapte / Adapte
4440,291,2020,Informatique,9,2,QROC,0.6555,0.38,0.29,91,73,60,13,1.25,82.19,60,31,65.55,Adapte,Adapte,Adapte / Adapte
291,292,2015,Informatique,10,1,QCM,0.785,0.14,0.75,80,80,63,17,1.0,78.75,63,17,78.5,Facile,Facile,Facile / Facile
1121,292,2016,Informatique,10,1,QCM,0.8455,0.02,0.75,72,71,61,10,1.01,85.92,61,11,84.55,Trop Facile,Facile,Trop Facile / Facile
1951,292,2017,Informatique,10,1,QCM,0.9625,0.0,0.82,86,85,83,2,1.01,97.65,83,3,96.25,Trop Facile,Trop Facile,Trop Facile / Trop Facile
2781,292,2018,Informatique,10,1,QCM,0.7308,0.02,0.53,71,56,52,4,1.27,92.86,52,19,73.08,Trop Facile,Adapte,Trop Facile / Adapte
3611,292,2019,Informatique,10,1,QCM,0.6348,0.21,0.45,68,50,43,7,1.36,86.0,43,25,63.48,Adapte,Adapte,Adapte / Adapte
4441,292,2020,Informatique,10,1,QCM,0.6344,0.21,0.68,69,63,44,19,1.1,69.84,44,25,63.44,Adapte,Adapte,Adapte / Adapte
292,293,2015,Informatique,10,2,QROC,0.6291,0.36,0.28,41,30,26,4,1.37,86.67,26,15,62.91,Trop Facile,Adapte,Trop Facile / Adapte
1122,293,2016,Informatique,10,2,QROC,0.643,0.34,0.25,42,42,27,15,1.0,64.29,27,15,64.3,Adapte,Adapte,Adapte / Adapte
1952,293,2017,Informatique,10,2,QROC,0.6224,0.36,0.33,47,44,29,15,1.07,65.91,29,18,62.24,Adapte,Adapte,Adapte / Adapte
2782,293,2018,Informatique,10,2,QROC,0.6036,0.35,0.4,51,43,31,12,1.19,72.09,31,20,60.36,Adapte,Adapte,Adapte / Adapte
3612,293,2019,Informatique,10,2,QROC,0.6611,0.24,0.32,43,35,28,7,1.23,80.0,28,15,66.11,Adapte,Adapte,Adapte / Adapte
4442,293,2020,Informatique,10,2,QROC,0.6187,0.32,0.39,37,33,23,10,1.12,69.7,23,14,61.87,Adapte,Adapte,Adapte / Adapte
293,294,2015,Informatique,10,3,QCU,0.1667,0.14,0.28,43,22,7,15,1.95,31.82,7,36,16.67,Trop Facile,Trop Difficile,Trop Facile / Trop Difficile
1123,294,2016,Informatique,10,3,QCU,0.9459,0.02,0.94,50,49,47,2,1.02,95.92,47,3,94.59,Trop Facile,Trop Facile,Trop Facile / Trop Facile
1953,294,2017,Informatique,10,3,QCU,0.9474,0.05,0.91,57,54,54,0,1.06,100.0,54,3,94.74,Trop Facile,Trop Facile,Trop Facile / Trop Facile
2783,294,2018,Informatique,10,3,QCU,0.276,0.09,0.36,59,46,16,30,1.28,34.78,16,43,27.6,Trop Facile,Difficile,Trop Facile / Difficile
3613,294,2019,Informatique,10,3,QCU,0.6887,0.28,0.66,53,37,37,0,1.43,100.0,37,16,68.87,Trop Facile,Adapte,Trop Facile / Adapte
4443,294,2020,Informatique,10,3,QCU,0.6075,0.21,0.69,62,58,38,20,1.07,65.52,38,24,60.75,Adapte,Adapte,Adapte / Adapte
294,295,2015,Informatique,10,4,QROC,0.0205,0.85,0.06,25,15,1,14,1.67,6.67,1,24,2.05,Trop Difficile,Trop Difficile,Trop Difficile / Trop Difficile
1124,295,2016,Informatique,10,4,QROC,0.3959,0.6,0.24,24,17,10,7,1.41,58.82,10,14,39.59,Trop Facile,Difficile,Trop Facile / Difficile
1954,295,2017,Informatique,10,4,QROC,0.8908,0.09,0.88,24,23,21,2,1.04,91.3,21,3,89.08,Trop Facile,Trop Facile,Trop Facile / Trop Facile
2784,295,2018,Informatique,10,4,QROC,0.1228,0.9,0.07,28,12,3,9,2.33,25.0,3,25,12.28,Trop Facile,Trop Difficile,Trop Facile / Trop Difficile
3614,295,2019,Informatique,10,4,QROC,0.7088,0.25,0.39,23,21,16,5,1.1,76.19,16,7,70.88,Trop Facile,Adapte,Trop Facile / Adapte
4444,295,2020,Informatique,10,4,QROC,0.6915,0.24,0.26,27,24,19,5,1.12,79.17,19,8,69.15,Adapte,Adapte,Adapte / Adapte
295,296,2015,Informatique,10,5,QCM,0.9349,0.0,0.96,54,52,50,2,1.04,96.15,50,4,93.49,Adapte,Trop Facile,Adapte / Trop Facile
1125,296,2016,Informatique,10,5,QCM,0.9542,0.02,0.97,58,56,55,1,1.04,98.21,55,3,95.42,Trop Facile,Trop Facile,Trop Facile / Trop Facile
1955,296,2017,Informatique,10,5,QCM,0.9816,0.06,0.81,67,66,66,0,1.02,100.0,66,1,98.16,Trop Facile,Trop Facile,Trop Facile / Trop Facile
2785,296,2018,Informatique,10,5,QCM,0.8952,0.04,0.9,62,57,56,1,1.09,98.25,56,6,89.52,Trop Facile,Trop Facile,Trop Facile / Trop Facile
3615,296,2019,Informatique,10,5,QCM,0.8961,0.05,0.99,70,67,63,4,1.04,94.03,63,7,89.61,Trop Facile,Trop Facile,Trop Facile / Trop Facile
4445,296,2020,Informatique,10,5,QCM,0.8451,0.19,0.78,62,57,52,5,1.09,91.23,52,10,84.51,Trop Facile,Facile,Trop Facile / Facile
296,297,2015,Informatique,10,6,QCU,0.1818,0.13,0.27,5,3,1,2,1.67,33.33,1,4,18.18,Difficile,Trop Difficile,Difficile / Trop Difficile
1126,297,2016,Informatique,10,6,QCU,0.9565,0.04,0.95,4,4,4,0,1.0,100.0,4,0,95.65,Trop Facile,Trop Facile,Trop Facile / Trop Facile
1956,297,2017,Informatique,10,6,QCU,0.9774,0.01,0.94,4,4,4,0,1.0,100.0,4,0,97.74,Trop Facile,Trop Facile,Trop Facile / Trop Facile
2786,297,2018,Informatique,10,6,QCU,0.8184,0.19,0.87,5,4,4,0,1.25,100.0,4,1,81.84,Trop Facile,Facile,Trop Facile / Facile
3616,297,2019,Informatique,10,6,QCU,0.9514,0.08,0.94,4,4,4,0,1.0,100.0,4,0,95.14,Trop Facile,Trop Facile,Trop Facile / Trop Facile
4446,297,2020,Informatique,10,6,QCU,0.7437,0.05,0.54,3,3,2,1,1.0,66.67,2,1,74.37,Trop Facile,Adapte,Trop Facile / Adapte
297,298,2015,Informatique,10,7,QCU,0.431,0.34,0.35,55,28,24,4,1.96,85.71,24,31,43.1,Difficile,Difficile,Difficile / Difficile
1127,298,2016,Informatique,10,7,QCU,0.9688,0.07,0.91,48,47,47,0,1.02,100.0,47,1,96.88,Trop Facile,Trop Facile,Trop Facile / Trop Facile
1957,298,2017,Informatique,10,7,QCU,0.9421,0.02,0.93,55,54,52,2,1.02,96.3,52,3,94.21,Trop Facile,Trop Facile,Trop Facile / Trop Facile
2787,298,2018,Informatique,10,7,QCU,0.9411,0.04,0.97,61,58,57,1,1.05,98.28,57,4,94.11,Trop Facile,Trop Facile,Trop Facile / Trop Facile
3617,298,2019,Informatique,10,7,QCU,0.9942,0.07,0.95,71,71,71,0,1.0,100.0,71,0,99.42,Trop Facile,Trop Facile,Trop Facile / Trop Facile
4447,298,2020,Informatique,10,7,QCU,0.9491,0.01,0.93,77,76,73,3,1.01,96.05,73,4,94.91,Trop Facile,Trop Facile,Trop Facile / Trop Facile
298,299,2015,Informatique,10,8,QCM,0.1335,0.03,0.3,44,38,6,32,1.16,15.79,6,38,13.35,Trop Difficile,Trop Difficile,Trop Difficile / Trop Difficile
1128,299,2016,Informatique,10,8,QCM,0.6002,0.22,0.56,52,45,31,14,1.16,68.89,31,21,60.02,Trop Facile,Adapte,Trop Facile / Adapte
1958,299,2017,Informatique,10,8,QCM,0.6332,0.2,0.41,51,46,32,14,1.11,69.57,32,19,63.32,Adapte,Adapte,Adapte / Adapte
2788,299,2018,Informatique,10,8,QCM,0.7011,0.09,0.65,47,43,33,10,1.09,76.74,33,14,70.11,Adapte,Adapte,Adapte / Adapte
3618,299,2019,Informatique,10,8,QCM,0.6262,0.03,0.63,54,39,34,5,1.38,87.18,34,20,62.62,Adapte,Adapte,Adapte / Adapte
4448,299,2020,Informatique,10,8,QCM,0.602,0.15,0.68,46,37,28,9,1.24,75.68,28,18,60.2,Adapte,Adapte,Adapte / Adapte
299,300,2015,Informatique,10,9,QCM,0.6362,0.16,0.59,6,5,4,1,1.2,80.0,4,2,63.62,Adapte,Adapte,Adapte / Adapte
1129,300,2016,Informatique,10,9,QCM,0.6796,0.08,0.46,7,6,5,1,1.17,83.33,5,2,67.96,Adapte,Adapte,Adapte / Adapte
1959,300,2017,Informatique,10,9,QCM,0.6799,0.21,0.44,6,6,4,2,1.0,66.67,4,2,67.99,Adapte,Adapte,Adapte / Adapte
2789,300,2018,Informatique,10,9,QCM,0.7029,0.01,0.64,5,4,4,0,1.25,100.0,4,1,70.29,Adapte,Adapte,Adapte / Adapte
3619,300,2019,Informatique,10,9,QCM,0.631,0.12,0.57,5,5,3,2,1.0,60.0,3,2,63.1,Adapte,Adapte,Adapte / Adapte
4449,300,2020,Informatique,10,9,QCM,0.6111,0.3,0.48,4,2,2,0,2.0,100.0,2,2,61.11,Adapte,Adapte,Adapte / Adapte
300,301,2015,Informatique,10,10,QCU,0.1148,0.54,0.21,75,71,9,62,1.06,12.68,9,66,11.48,Trop Difficile,Trop Difficile,Trop Difficile / Trop Difficile
1130,301,2016,Informatique,10,10,QCU,0.9357,0.08,0.98,64,63,60,3,1.02,95.24,60,4,93.57,Trop Facile,Trop Facile,Trop Facile / Trop Facile
1960,301,2017,Informatique,10,10,QCU,0.8614,0.02,0.92,61,60,53,7,1.02,88.33,53,8,86.14,Trop Facile,Trop Facile,Trop Facile / Trop Facile
2790,301,2018,Informatique,10,10,QCU,0.8844,0.08,0.98,50,46,44,2,1.09,95.65,44,6,88.44,Trop Facile,Trop Facile,Trop Facile / Trop Facile
3620,301,2019,Informatique,10,10,QCU,0.9936,0.01,0.97,43,43,43,0,1.0,100.0,43,0,99.36,Trop Facile,Trop Facile,Trop Facile / Trop Facile
4450,301,2020,Informatique,10,10,QCU,0.9288,0.08,1.0,35,34,33,1,1.03,97.06,33,2,92.88,Trop Facile,Trop Facile,Trop Facile / Trop Facile
301,302,2015,Informatique,10,11,QCU,0.9219,0.08,0.94,73,67,67,0,1.09,100.0,67,6,92.19,Trop Facile,Trop Facile,Trop Facile / Trop Facile
1131,302,2016,Informatique,10,11,QCU,0.9695,0.09,0.98,69,69,67,2,1.0,97.1,67,2,96.95,Trop Facile,Trop Facile,Trop Facile / Trop Facile
1961,302,2017,Informatique,10,11,QCU,0.9406,0.01,0.96,60,57,56,1,1.05,98.25,56,4,94.06,Trop Facile,Trop Facile,Trop Facile / Trop Facile
2791,302,2018,Informatique,10,11,QCU,0.8866,0.04,0.94,59,58,52,6,1.02,89.66,52,7,88.66,Trop Facile,Trop Facile,Trop Facile / Trop Facile
3621,302,2019,Informatique,10,11,QCU,0.9687,0.05,0.95,47,46,46,0,1.02,100.0,46,1,96.87,Trop Facile,Trop Facile,Trop Facile / Trop Facile
4451,302,2020,Informatique,10,11,QCU,0.9591,0.09,0.96,41,39,39,0,1.05,100.0,39,2,95.91,Trop Facile,Trop Facile,Trop Facile / Trop Facile
302,303,2015,Informatique,10,12,QCU,0.6616,0.19,0.68,94,65,62,3,1.45,95.38,62,32,66.16,Facile,Adapte,Facile / Adapte
1132,303,2016,Informatique,10,12,QCU,0.6967,0.25,0.65,92,73,64,9,1.26,87.67,64,28,69.67,Adapte,Adapte,Adapte / Adapte
1962,303,2017,Informatique,10,12,QCU,0.626,0.1,0.42,78,50,49,1,1.56,98.0,49,29,62.6,Adapte,Adapte,Adapte / Adapte
2792,303,2018,Informatique,10,12,QCU,0.6899,0.24,0.45,84,60,58,2,1.4,96.67,58,26,68.99,Adapte,Adapte,Adapte / Adapte
3622,303,2019,Informatique,10,12,QCU,0.7085,0.01,0.53,85,79,60,19,1.08,75.95,60,25,70.85,Adapte,Adapte,Adapte / Adapte
4452,303,2020,Informatique,10,12,QCU,0.685,0.17,0.7,91,69,62,7,1.32,89.86,62,29,68.5,Adapte,Adapte,Adapte / Adapte
303,304,2015,Informatique,11,1,QCU,0.449,0.28,0.36,16,9,7,2,1.78,77.78,7,9,44.9,Trop Difficile,Difficile,Trop Difficile / Difficile
1133,304,2016,Informatique,11,1,QCU,0.544,0.18,0.38,16,13,9,4,1.23,69.23,9,7,54.4,Trop Facile,Difficile,Trop Facile / Difficile
1963,304,2017,Informatique,11,1,QCU,0.7225,0.05,0.43,14,12,10,2,1.17,83.33,10,4,72.25,Trop Facile,Adapte,Trop Facile / Adapte
2793,304,2018,Informatique,11,1,QCU,0.706,0.11,0.46,17,17,12,5,1.0,70.59,12,5,70.6,Adapte,Adapte,Adapte / Adapte
3623,304,2019,Informatique,11,1,QCU,0.63,0.28,0.67,16,11,10,1,1.45,90.91,10,6,63.0,Adapte,Adapte,Adapte / Adapte
4453,304,2020,Informatique,11,1,QCU,0.6143,0.1,0.56,17,13,10,3,1.31,76.92,10,7,61.43,Adapte,Adapte,Adapte / Adapte
304,305,2015,Informatique,11,2,QCU,0.9552,0.05,0.96,62,61,59,2,1.02,96.72,59,3,95.52,Trop Facile,Trop Facile,Trop Facile / Trop Facile
1134,305,2016,Informatique,11,2,QCU,0.96,0.02,0.93,68,66,65,1,1.03,98.48,65,3,96.0,Trop Facile,Trop Facile,Trop Facile / Trop Facile
1964,305,2017,Informatique,11,2,QCU,0.8883,0.04,0.96,59,55,52,3,1.07,94.55,52,7,88.83,Trop Facile,Trop Facile,Trop Facile / Trop Facile
2794,305,2018,Informatique,11,2,QCU,0.9604,0.0,0.95,59,58,57,1,1.02,98.28,57,2,96.04,Trop Facile,Trop Facile,Trop Facile / Trop Facile
3624,305,2019,Informatique,11,2,QCU,0.9203,0.07,0.97,60,58,55,3,1.03,94.83,55,5,92.03,Trop Facile,Trop Facile,Trop Facile / Trop Facile
4454,305,2020,Informatique,11,2,QCU,0.0742,0.19,0.27,68,40,5,35,1.7,12.5,5,63,7.42,Trop Facile,Trop Difficile,Trop Facile / Trop Difficile
305,306,2015,Informatique,12,1,QCU,0.6438,0.17,0.57,13,10,8,2,1.3,80.0,8,5,64.38,Adapte,Adapte,Adapte / Adapte
1135,306,2016,Informatique,12,1,QCU,0.7406,0.18,0.54,14,14,10,4,1.0,71.43,10,4,74.06,Adapte,Adapte,Adapte / Adapte
1965,306,2017,Informatique,12,1,QCU,0.7158,0.29,0.67,11,9,8,1,1.22,88.89,8,3,71.58,Adapte,Adapte,Adapte / Adapte
2795,306,2018,Informatique,12,1,QCU,0.695,0.26,0.56,12,11,8,3,1.09,72.73,8,4,69.5,Adapte,Adapte,Adapte / Adapte
3625,306,2019,Informatique,12,1,QCU,0.7008,0.29,0.6,14,13,10,3,1.08,76.92,10,4,70.08,Adapte,Adapte,Adapte / Adapte
4455,306,2020,Informatique,12,1,QCU,0.7282,0.11,0.58,13,11,9,2,1.18,81.82,9,4,72.82,Adapte,Adapte,Adapte / Adapte
306,307,2015,Informatique,12,2,QO,0.3151,0.81,0.03,44,41,14,27,1.07,34.15,14,30,31.51,Difficile,Difficile,Difficile / Difficile
1136,307,2016,Informatique,12,2,QO,0.9042,0.1,0.63,52,48,47,1,1.08,97.92,47,5,90.42,Trop Facile,Trop Facile,Trop Facile / Trop Facile
1966,307,2017,Informatique,12,2,QO,0.8642,0.05,0.81,58,54,50,4,1.07,92.59,50,8,86.42,Trop Facile,Trop Facile,Trop Facile / Trop Facile
2796,307,2018,Informatique,12,2,QO,0.9118,0.08,0.99,56,53,51,2,1.06,96.23,51,5,91.18,Trop Facile,Trop Facile,Trop Facile / Trop Facile
3626,307,2019,Informatique,12,2,QO,0.8891,0.04,0.75,56,53,50,3,1.06,94.34,50,6,88.91,Trop Facile,Trop Facile,Trop Facile / Trop Facile
4456,307,2020,Informatique,12,2,QO,0.9801,0.01,0.95,54,53,53,0,1.02,100.0,53,1,98.01,Trop Facile,Trop Facile,Trop Facile / Trop Facile
307,308,2015,Informatique,12,3,QROC,0.0307,0.77,0.09,21,11,1,10,1.91,9.09,1,20,3.07,Trop Difficile,Trop Difficile,Trop Difficile / Trop Difficile
1137,308,2016,Informatique,12,3,QROC,0.2247,0.77,0.02,25,23,6,17,1.09,26.09,6,19,22.47,Trop Facile,Trop Difficile,Trop Facile / Trop Difficile
1967,308,2017,Informatique,12,3,QROC,0.0421,0.79,0.13,24,21,1,20,1.14,4.76,1,23,4.21,Trop Facile,Trop Difficile,Trop Facile / Trop Difficile
2797,308,2018,Informatique,12,3,QROC,0.0949,0.88,0.08,21,18,2,16,1.17,11.11,2,19,9.49,Trop Facile,Trop Difficile,Trop Facile / Trop Difficile
3627,308,2019,Informatique,12,3,QROC,0.8349,0.03,0.74,25,24,21,3,1.04,87.5,21,4,83.49,Trop Facile,Facile,Trop Facile / Facile
4457,308,2020,Informatique,12,3,QROC,0.8767,0.04,0.52,26,25,23,2,1.04,92.0,23,3,87.67,Trop Facile,Trop Facile,Trop Facile / Trop Facile
308,309,2015,Informatique,12,4,QCU,0.0296,0.01,0.27,52,28,2,26,1.86,7.14,2,50,2.96,Trop Difficile,Trop Difficile,Trop Difficile / Trop Difficile
1138,309,2016,Informatique,12,4,QCU,0.9134,0.06,0.9,61,61,56,5,1.0,91.8,56,5,91.34,Trop Facile,Trop Facile,Trop Facile / Trop Facile
1968,309,2017,Informatique,12,4,QCU,0.8728,0.05,0.98,67,60,58,2,1.12,96.67,58,9,87.28,Trop Facile,Trop Facile,Trop Facile / Trop Facile
2798,309,2018,Informatique,12,4,QCU,0.263,0.23,0.4,80,55,21,34,1.45,38.18,21,59,26.3,Trop Facile,Difficile,Trop Facile / Difficile
3628,309,2019,Informatique,12,4,QCU,0.0741,0.3,0.26,67,50,5,45,1.34,10.0,5,62,7.41,Trop Facile,Trop Difficile,Trop Facile / Trop Difficile
4458,309,2020,Informatique,12,4,QCU,0.123,0.5,0.28,71,67,9,58,1.06,13.43,9,62,12.3,Trop Facile,Trop Difficile,Trop Facile / Trop Difficile
309,310,2015,Informatique,12,5,QROC,0.0885,0.8,0.1,86,63,8,55,1.37,12.7,8,78,8.85,Trop Difficile,Trop Difficile,Trop Difficile / Trop Difficile
1139,310,2016,Informatique,12,5,QROC,0.9858,0.04,0.9,85,85,84,1,1.0,98.82,84,1,98.58,Trop Facile,Trop Facile,Trop Facile / Trop Facile
1969,310,2017,Informatique,12,5,QROC,0.8215,0.05,0.6,69,64,57,7,1.08,89.06,57,12,82.15,Trop Facile,Facile,Trop Facile / Facile
2799,310,2018,Informatique,12,5,QROC,0.9231,0.03,0.57,74,73,68,5,1.01,93.15,68,6,92.31,Trop Facile,Trop Facile,Trop Facile / Trop Facile
3629,310,2019,Informatique,12,5,QROC,0.6868,0.2,0.34,62,60,43,17,1.03,71.67,43,19,68.68,Trop Facile,Adapte,Trop Facile / Adapte
4459,310,2020,Informatique,12,5,QROC,0.6735,0.49,0.31,52,49,35,14,1.06,71.43,35,17,67.35,Adapte,Adapte,Adapte / Adapte
310,311,2015,Informatique,12,6,QCU,0.7688,0.19,0.82,5,5,4,1,1.0,80.0,4,1,76.88,Facile,Facile,Facile / Facile
1140,311,2016,Informatique,12,6,QCU,0.9237,0.03,0.98,5,5,5,0,1.0,100.0,5,0,92.37,Trop Facile,Trop Facile,Trop Facile / Trop Facile
1970,311,2017,Informatique,12,6,QCU,0.9128,0.05,0.92,6,6,5,1,1.0,83.33,5,1,91.28,Trop Facile,Trop Facile,Trop Facile / Trop Facile
2800,311,2018,Informatique,12,6,QCU,0.5593,0.22,0.33,7,6,4,2,1.17,66.67,4,3,55.93,Trop Facile,Difficile,Trop Facile / Difficile
3630,311,2019,Informatique,12,6,QCU,0.4437,0.13,0.35,7,5,3,2,1.4,60.0,3,4,44.37,Trop Facile,Difficile,Trop Facile / Difficile
4460,311,2020,Informatique,12,6,QCU,0.8373,0.19,0.81,7,7,6,1,1.0,85.71,6,1,83.73,Trop Facile,Facile,Trop Facile / Facile
311,312,2015,Informatique,12,7,QCU,0.0936,0.56,0.27,93,62,9,53,1.5,14.52,9,84,9.36,Adapte,Trop Difficile,Adapte / Trop Difficile
1141,312,2016,Informatique,12,7,QCU,0.9517,0.03,0.92,90,87,86,1,1.03,98.85,86,4,95.17,Trop Facile,Trop Facile,Trop Facile / Trop Facile
1971,312,2017,Informatique,12,7,QCU,0.7609,0.14,0.78,77,62,59,3,1.24,95.16,59,18,76.09,Trop Facile,Facile,Trop Facile / Facile
2801,312,2018,Informatique,12,7,QCU,0.9701,0.04,0.91,81,80,79,1,1.01,98.75,79,2,97.01,Trop Facile,Trop Facile,Trop Facile / Trop Facile
3631,312,2019,Informatique,12,7,QCU,0.9565,0.08,0.91,78,76,75,1,1.03,98.68,75,3,95.65,Trop Facile,Trop Facile,Trop Facile / Trop Facile
4461,312,2020,Informatique,12,7,QCU,0.9872,0.04,0.98,73,72,72,0,1.01,100.0,72,1,98.72,Trop Facile,Trop Facile,Trop Facile / Trop Facile
312,313,2015,Informatique,12,8,QCM,0.8074,0.1,0.77,97,91,78,13,1.07,85.71,78,19,80.74,Facile,Facile,Facile / Facile
1142,313,2016,Informatique,12,8,QCM,0.4249,0.04,0.36,84,79,36,43,1.06,45.57,36,48,42.49,Trop Facile,Difficile,Trop Facile / Difficile
1972,313,2017,Informatique,12,8,QCM,0.9288,0.05,0.82,76,74,71,3,1.03,95.95,71,5,92.88,Trop Facile,Trop Facile,Trop Facile / Trop Facile
2802,313,2018,Informatique,12,8,QCM,0.9695,0.01,0.81,79,77,77,0,1.03,100.0,77,2,96.95,Trop Facile,Trop Facile,Trop Facile / Trop Facile
3632,313,2019,Informatique,12,8,QCM,0.9099,0.04,0.85,67,67,61,6,1.0,91.04,61,6,90.99,Trop Facile,Trop Facile,Trop Facile / Trop Facile
4462,313,2020,Informatique,12,8,QCM,0.8645,0.09,0.93,65,57,56,1,1.14,98.25,56,9,86.45,Trop Facile,Trop Facile,Trop Facile / Trop Facile
313,314,2015,Informatique,12,9,QROC,0.6547,0.49,0.28,91,65,60,5,1.4,92.31,60,31,65.47,Adapte,Adapte,Adapte / Adapte
1143,314,2016,Informatique,12,9,QROC,0.7005,0.28,0.28,99,88,69,19,1.12,78.41,69,30,70.05,Adapte,Adapte,Adapte / Adapte
1973,314,2017,Informatique,12,9,QROC,0.6241,0.21,0.4,110,72,69,3,1.53,95.83,69,41,62.41,Adapte,Adapte,Adapte / Adapte
2803,314,2018,Informatique,12,9,QROC,0.6541,0.42,0.36,123,121,80,41,1.02,66.12,80,43,65.41,Adapte,Adapte,Adapte / Adapte
3633,314,2019,Informatique,12,9,QROC,0.6247,0.32,0.32,148,122,92,30,1.21,75.41,92,56,62.47,Adapte,Adapte,Adapte / Adapte
4463,314,2020,Informatique,12,9,QROC,0.6376,0.49,0.26,134,103,85,18,1.3,82.52,85,49,63.76,Adapte,Adapte,Adapte / Adapte
314,315,2015,Informatique,13,1,QCM,0.8296,0.04,0.71,41,40,34,6,1.02,85.0,34,7,82.96,Facile,Facile,Facile / Facile
1144,315,2016,Informatique,13,1,QCM,0.9952,0.08,0.96,45,45,45,0,1.0,100.0,45,0,99.52,Trop Facile,Trop Facile,Trop Facile / Trop Facile
1974,315,2017,Informatique,13,1,QCM,0.9857,0.1,0.81,45,45,44,1,1.0,97.78,44,1,98.57,Trop Facile,Trop Facile,Trop Facile / Trop Facile
2804,315,2018,Informatique,13,1,QCM,0.993,0.01,0.96,47,47,47,0,1.0,100.0,47,0,99.3,Trop Facile,Trop Facile,Trop Facile / Trop Facile
3634,315,2019,Informatique,13,1,QCM,0.7907,0.1,0.71,42,35,33,2,1.2,94.29,33,9,79.07,Trop Facile,Facile,Trop Facile / Facile
4464,315,2020,Informatique,13,1,QCM,0.9734,0.07,0.87,42,41,41,0,1.02,100.0,41,1,97.34,Trop Facile,Trop Facile,Trop Facile / Trop Facile
315,316,2015,Informatique,13,2,QROC,0.0898,0.79,0.1,62,41,6,35,1.51,14.63,6,56,8.98,Trop Difficile,Trop Difficile,Trop Difficile / Trop Difficile
1145,316,2016,Informatique,13,2,QROC,0.802,0.18,0.46,63,57,51,6,1.11,89.47,51,12,80.2,Trop Facile,Facile,Trop Facile / Facile
1975,316,2017,Informatique,13,2,QROC,0.8615,0.02,0.7,71,63,61,2,1.13,96.83,61,10,86.15,Trop Facile,Trop Facile,Trop Facile / Trop Facile
2805,316,2018,Informatique,13,2,QROC,0.6595,0.27,0.3,69,56,46,10,1.23,82.14,46,23,65.95,Trop Facile,Adapte,Trop Facile / Adapte
3635,316,2019,Informatique,13,2,QROC,0.673,0.21,0.39,80,62,54,8,1.29,87.1,54,26,67.3,Adapte,Adapte,Adapte / Adapte
4465,316,2020,Informatique,13,2,QROC,0.6141,0.32,0.26,71,69,44,25,1.03,63.77,44,27,61.41,Adapte,Adapte,Adapte / Adapte
316,317,2015,Informatique,13,3,QROC,0.9898,0.06,0.56,93,92,92,0,1.01,100.0,92,1,98.98,Difficile,Trop Facile,Difficile / Trop Facile
1146,317,2016,Informatique,13,3,QROC,0.8201,0.16,0.72,94,82,77,5,1.15,93.9,77,17,82.01,Trop Facile,Facile,Trop Facile / Facile
1976,317,2017,Informatique,13,3,QROC,0.9695,0.01,0.6,99,96,96,0,1.03,100.0,96,3,96.95,Trop Facile,Trop Facile,Trop Facile / Trop Facile
2806,317,2018,Informatique,13,3,QROC,0.9474,0.07,0.52,101,98,96,2,1.03,97.96,96,5,94.74,Trop Facile,Trop Facile,Trop Facile / Trop Facile
3636,317,2019,Informatique,13,3,QROC,0.8919,0.07,0.53,118,114,105,9,1.04,92.11,105,13,89.19,Trop Facile,Trop Facile,Trop Facile / Trop Facile
4466,317,2020,Informatique,13,3,QROC,0.9701,0.02,0.92,105,103,102,1,1.02,99.03,102,3,97.01,Trop Facile,Trop Facile,Trop Facile / Trop Facile
317,318,2015,Informatique,13,4,QO,0.7081,0.59,0.24,17,12,12,0,1.42,100.0,12,5,70.81,Trop Difficile,Adapte,Trop Difficile / Adapte
1147,318,2016,Informatique,13,4,QO,0.6572,0.4,0.27,20,17,13,4,1.18,76.47,13,7,65.72,Adapte,Adapte,Adapte / Adapte
1977,318,2017,Informatique,13,4,QO,0.6969,0.31,0.19,16,13,11,2,1.23,84.62,11,5,69.69,Adapte,Adapte,Adapte / Adapte
2807,318,2018,Informatique,13,4,QO,0.6847,0.36,0.19,15,12,10,2,1.25,83.33,10,5,68.47,Adapte,Adapte,Adapte / Adapte
3637,318,2019,Informatique,13,4,QO,0.6739,0.51,0.24,12,9,8,1,1.33,88.89,8,4,67.39,Adapte,Adapte,Adapte / Adapte
4467,318,2020,Informatique,13,4,QO,0.6237,0.38,0.27,12,9,7,2,1.33,77.78,7,5,62.37,Adapte,Adapte,Adapte / Adapte
318,319,2015,Informatique,13,5,QCM,0.6391,0.07,0.46,29,29,19,10,1.0,65.52,19,10,63.91,Adapte,Adapte,Adapte / Adapte
1148,319,2016,Informatique,13,5,QCM,0.6267,0.11,0.44,30,24,19,5,1.25,79.17,19,11,62.67,Adapte,Adapte,Adapte / Adapte
1978,319,2017,Informatique,13,5,QCM,0.6751,0.16,0.68,35,32,24,8,1.09,75.0,24,11,67.51,Adapte,Adapte,Adapte / Adapte
2808,319,2018,Informatique,13,5,QCM,0.673,0.21,0.51,42,29,28,1,1.45,96.55,28,14,67.3,Adapte,Adapte,Adapte / Adapte
3638,319,2019,Informatique,13,5,QCM,0.7034,0.21,0.58,47,46,33,13,1.02,71.74,33,14,70.34,Adapte,Adapte,Adapte / Adapte
4468,319,2020,Informatique,13,5,QCM,0.7195,0.01,0.47,55,44,40,4,1.25,90.91,40,15,71.95,Adapte,Adapte,Adapte / Adapte
319,320,2015,Informatique,13,6,QCM,0.2823,0.04,0.3,41,12,12,0,3.42,100.0,12,29,28.23,Difficile,Difficile,Difficile / Difficile
1149,320,2016,Informatique,13,6,QCM,0.8958,0.03,0.81,34,33,30,3,1.03,90.91,30,4,89.58,Trop Facile,Trop Facile,Trop Facile / Trop Facile
1979,320,2017,Informatique,13,6,QCM,0.9398,0.07,0.84,30,30,28,2,1.0,93.33,28,2,93.98,Trop Facile,Trop Facile,Trop Facile / Trop Facile
2809,320,2018,Informatique,13,6,QCM,0.9886,0.07,0.88,27,27,27,0,1.0,100.0,27,0,98.86,Trop Facile,Trop Facile,Trop Facile / Trop Facile
3639,320,2019,Informatique,13,6,QCM,0.867,0.06,0.86,29,27,25,2,1.07,92.59,25,4,86.7,Trop Facile,Trop Facile,Trop Facile / Trop Facile
4469,320,2020,Informatique,13,6,QCM,0.9979,0.01,0.88,26,26,26,0,1.0,100.0,26,0,99.79,Trop Facile,Trop Facile,Trop Facile / Trop Facile
320,321,2015,Informatique,14,1,QCU,0.4609,0.18,0.37,8,5,4,1,1.6,80.0,4,4,46.09,Difficile,Difficile,Difficile / Difficile
1150,321,2016,Informatique,14,1,QCU,0.8971,0.06,0.94,10,10,9,1,1.0,90.0,9,1,89.71,Trop Facile,Trop Facile,Trop Facile / Trop Facile
1980,321,2017,Informatique,14,1,QCU,0.8856,0.03,0.96,8,8,7,1,1.0,87.5,7,1,88.56,Trop Facile,Trop Facile,Trop Facile / Trop Facile
2810,321,2018,Informatique,14,1,QCU,0.87,0.02,0.93,10,9,9,0,1.11,100.0,9,1,87.0,Trop Facile,Trop Facile,Trop Facile / Trop Facile
3640,321,2019,Informatique,14,1,QCU,0.9576,0.04,0.91,11,11,11,0,1.0,100.0,11,0,95.76,Trop Facile,Trop Facile,Trop Facile / Trop Facile
4470,321,2020,Informatique,14,1,QCU,0.8316,0.1,0.89,12,10,10,0,1.2,100.0,10,2,83.16,Trop Facile,Facile,Trop Facile / Facile
321,322,2015,Informatique,14,2,QCU,0.7825,0.01,0.83,30,28,23,5,1.07,82.14,23,7,78.25,Difficile,Facile,Difficile / Facile
1151,322,2016,Informatique,14,2,QCU,0.8957,0.09,0.95,34,32,30,2,1.06,93.75,30,4,89.57,Trop Facile,Trop Facile,Trop Facile / Trop Facile
1981,322,2017,Informatique,14,2,QCU,0.9595,0.04,0.98,28,28,27,1,1.0,96.43,27,1,95.95,Trop Facile,Trop Facile,Trop Facile / Trop Facile
2811,322,2018,Informatique,14,2,QCU,0.9181,0.09,0.9,30,29,28,1,1.03,96.55,28,2,91.81,Trop Facile,Trop Facile,Trop Facile / Trop Facile
3641,322,2019,Informatique,14,2,QCU,0.8407,0.05,0.87,29,29,24,5,1.0,82.76,24,5,84.07,Trop Facile,Facile,Trop Facile / Facile
4471,322,2020,Informatique,14,2,QCU,0.691,0.19,0.51,32,28,22,6,1.14,78.57,22,10,69.1,Trop Facile,Adapte,Trop Facile / Adapte
322,323,2015,Informatique,14,3,QROC,0.0493,0.78,0.08,6,6,0,6,1.0,0.0,0,6,4.93,Difficile,Trop Difficile,Difficile / Trop Difficile
1152,323,2016,Informatique,14,3,QROC,0.0288,0.83,0.07,7,6,0,6,1.17,0.0,0,7,2.88,Trop Facile,Trop Difficile,Trop Facile / Trop Difficile
1982,323,2017,Informatique,14,3,QROC,0.9704,0.09,0.86,7,7,7,0,1.0,100.0,7,0,97.04,Trop Facile,Trop Facile,Trop Facile / Trop Facile
2812,323,2018,Informatique,14,3,QROC,0.9171,0.05,0.91,6,6,6,0,1.0,100.0,6,0,91.71,Trop Facile,Trop Facile,Trop Facile / Trop Facile
3642,323,2019,Informatique,14,3,QROC,0.8819,0.1,0.99,7,6,6,0,1.17,100.0,6,1,88.19,Trop Facile,Trop Facile,Trop Facile / Trop Facile
4472,323,2020,Informatique,14,3,QROC,0.3382,0.75,0.15,6,6,2,4,1.0,33.33,2,4,33.82,Trop Facile,Difficile,Trop Facile / Difficile
323,324,2015,Informatique,14,4,QCM,0.1274,0.47,0.25,33,18,4,14,1.83,22.22,4,29,12.74,Difficile,Trop Difficile,Difficile / Trop Difficile
1153,324,2016,Informatique,14,4,QCM,0.9402,0.1,0.82,40,39,38,1,1.03,97.44,38,2,94.02,Trop Facile,Trop Facile,Trop Facile / Trop Facile
1983,324,2017,Informatique,14,4,QCM,0.975,0.02,0.8,46,46,45,1,1.0,97.83,45,1,97.5,Trop Facile,Trop Facile,Trop Facile / Trop Facile
2813,324,2018,Informatique,14,4,QCM,0.9341,0.0,0.97,51,50,48,2,1.02,96.0,48,3,93.41,Trop Facile,Trop Facile,Trop Facile / Trop Facile
3643,324,2019,Informatique,14,4,QCM,0.9576,0.0,0.9,41,40,39,1,1.02,97.5,39,2,95.76,Trop Facile,Trop Facile,Trop Facile / Trop Facile
4473,324,2020,Informatique,14,4,QCM,0.9896,0.06,0.83,33,33,33,0,1.0,100.0,33,0,98.96,Trop Facile,Trop Facile,Trop Facile / Trop Facile
324,325,2015,Informatique,14,5,QROC,0.5366,0.74,0.17,10,5,5,0,2.0,100.0,5,5,53.66,Difficile,Difficile,Difficile / Difficile
1154,325,2016,Informatique,14,5,QROC,0.1456,0.98,0.02,9,5,1,4,1.8,20.0,1,8,14.56,Trop Facile,Trop Difficile,Trop Facile / Trop Difficile
1984,325,2017,Informatique,14,5,QROC,0.9433,0.1,0.65,9,9,8,1,1.0,88.89,8,1,94.33,Trop Facile,Trop Facile,Trop Facile / Trop Facile
2814,325,2018,Informatique,14,5,QROC,0.8758,0.06,0.67,7,6,6,0,1.17,100.0,6,1,87.58,Trop Facile,Trop Facile,Trop Facile / Trop Facile
3644,325,2019,Informatique,14,5,QROC,0.8446,0.13,0.41,7,7,6,1,1.0,85.71,6,1,84.46,Trop Facile,Facile,Trop Facile / Facile
4474,325,2020,Informatique,14,5,QROC,0.7836,0.1,0.58,7,6,5,1,1.17,83.33,5,2,78.36,Trop Facile,Facile,Trop Facile / Facile
325,326,2015,Informatique,14,6,QROC,0.6113,0.3,0.26,17,11,10,1,1.55,90.91,10,7,61.13,Facile,Adapte,Facile / Adapte
1155,326,2016,Informatique,14,6,QROC,0.6172,0.37,0.31,14,11,9,2,1.27,81.82,9,5,61.72,Adapte,Adapte,Adapte / Adapte
1985,326,2017,Informatique,14,6,QROC,0.6443,0.33,0.3,12,9,8,1,1.33,88.89,8,4,64.43,Adapte,Adapte,Adapte / Adapte
2815,326,2018,Informatique,14,6,QROC,0.7082,0.22,0.35,11,11,8,3,1.0,72.73,8,3,70.82,Adapte,Adapte,Adapte / Adapte
3645,326,2019,Informatique,14,6,QROC,0.6658,0.49,0.27,11,7,7,0,1.57,100.0,7,4,66.58,Adapte,Adapte,Adapte / Adapte
4475,326,2020,Informatique,14,6,QROC,0.6493,0.22,0.35,11,11,7,4,1.0,63.64,7,4,64.93,Adapte,Adapte,Adapte / Adapte
326,327,2015,Informatique,14,7,QCM,0.6212,0.08,0.48,6,6,4,2,1.0,66.67,4,2,62.12,Adapte,Adapte,Adapte / Adapte
1156,327,2016,Informatique,14,7,QCM,0.6353,0.11,0.47,7,5,4,1,1.4,80.0,4,3,63.53,Adapte,Adapte,Adapte / Adapte
1986,327,2017,Informatique,14,7,QCM,0.7009,0.02,0.57,7,5,5,0,1.4,100.0,5,2,70.09,Adapte,Adapte,Adapte / Adapte
2816,327,2018,Informatique,14,7,QCM,0.6107,0.14,0.66,7,6,4,2,1.17,66.67,4,3,61.07,Adapte,Adapte,Adapte / Adapte
3646,327,2019,Informatique,14,7,QCM,0.6814,0.17,0.4,7,5,5,0,1.4,100.0,5,2,68.14,Adapte,Adapte,Adapte / Adapte
4476,327,2020,Informatique,14,7,QCM,0.6328,0.3,0.48,7,4,4,0,1.75,100.0,4,3,63.28,Adapte,Adapte,Adapte / Adapte
327,328,2015,Informatique,14,8,QO,0.2367,0.94,0.01,8,5,2,3,1.6,40.0,2,6,23.67,Difficile,Trop Difficile,Difficile / Trop Difficile
1157,328,2016,Informatique,14,8,QO,0.9549,0.06,0.63,6,6,6,0,1.0,100.0,6,0,95.49,Trop Facile,Trop Facile,Trop Facile / Trop Facile
1987,328,2017,Informatique,14,8,QO,0.1753,0.92,0.0,7,6,1,5,1.17,16.67,1,6,17.53,Trop Facile,Trop Difficile,Trop Facile / Trop Difficile
2817,328,2018,Informatique,14,8,QO,0.8987,0.04,0.74,6,5,5,0,1.2,100.0,5,1,89.87,Trop Facile,Trop Facile,Trop Facile / Trop Facile
3647,328,2019,Informatique,14,8,QO,0.8656,0.02,0.59,7,7,6,1,1.0,85.71,6,1,86.56,Trop Facile,Trop Facile,Trop Facile / Trop Facile
4477,328,2020,Informatique,14,8,QO,0.8114,0.04,0.43,8,7,6,1,1.14,85.71,6,2,81.14,Trop Facile,Facile,Trop Facile / Facile
328,329,2015,Informatique,14,9,QCU,0.8315,0.02,0.77,78,71,65,6,1.1,91.55,65,13,83.15,Trop Facile,Facile,Trop Facile / Facile
1158,329,2016,Informatique,14,9,QCU,0.9785,0.1,0.91,69,68,68,0,1.01,100.0,68,1,97.85,Trop Facile,Trop Facile,Trop Facile / Trop Facile
1988,329,2017,Informatique,14,9,QCU,0.8829,0.05,0.97,67,60,59,1,1.12,98.33,59,8,88.29,Trop Facile,Trop Facile,Trop Facile / Trop Facile
2818,329,2018,Informatique,14,9,QCU,0.746,0.2,0.6,79,60,59,1,1.32,98.33,59,20,74.6,Trop Facile,Adapte,Trop Facile / Adapte
3648,329,2019,Informatique,14,9,QCU,0.7385,0.21,0.64,94,83,69,14,1.13,83.13,69,25,73.85,Adapte,Adapte,Adapte / Adapte
4478,329,2020,Informatique,14,9,QCU,0.7048,0.2,0.43,109,104,77,27,1.05,74.04,77,32,70.48,Adapte,Adapte,Adapte / Adapte
329,330,2015,Informatique,14,10,QO,0.8824,0.04,0.81,54,48,48,0,1.12,100.0,48,6,88.24,Trop Difficile,Trop Facile,Trop Difficile / Trop Facile
1159,330,2016,Informatique,14,10,QO,0.865,0.06,0.76,62,55,54,1,1.13,98.18,54,8,86.5,Trop Facile,Trop Facile,Trop Facile / Trop Facile
1989,330,2017,Informatique,14,10,QO,0.8737,0.08,0.93,55,54,48,6,1.02,88.89,48,7,87.37,Trop Facile,Trop Facile,Trop Facile / Trop Facile
2819,330,2018,Informatique,14,10,QO,0.7634,0.18,0.3,46,40,35,5,1.15,87.5,35,11,76.34,Trop Facile,Facile,Trop Facile / Facile
3649,330,2019,Informatique,14,10,QO,0.9812,0.04,0.51,49,49,48,1,1.0,97.96,48,1,98.12,Trop Facile,Trop Facile,Trop Facile / Trop Facile
4479,330,2020,Informatique,14,10,QO,0.9427,0.04,0.54,58,57,55,2,1.02,96.49,55,3,94.27,Trop Facile,Trop Facile,Trop Facile / Trop Facile
330,331,2015,Informatique,14,11,QCM,0.5062,0.35,0.39,21,17,11,6,1.24,64.71,11,10,50.62,Difficile,Difficile,Difficile / Difficile
1160,331,2016,Informatique,14,11,QCM,0.9017,0.07,0.87,21,20,19,1,1.05,95.0,19,2,90.17,Trop Facile,Trop Facile,Trop Facile / Trop Facile
1990,331,2017,Informatique,14,11,QCM,0.8713,0.09,0.95,18,18,16,2,1.0,88.89,16,2,87.13,Trop Facile,Trop Facile,Trop Facile / Trop Facile
2820,331,2018,Informatique,14,11,QCM,0.9441,0.08,0.83,21,20,20,0,1.05,100.0,20,1,94.41,Trop Facile,Trop Facile,Trop Facile / Trop Facile
3650,331,2019,Informatique,14,11,QCM,0.8388,0.16,0.73,19,16,16,0,1.19,100.0,16,3,83.88,Trop Facile,Facile,Trop Facile / Facile
4480,331,2020,Informatique,14,11,QCM,0.8675,0.05,0.83,22,22,19,3,1.0,86.36,19,3,86.75,Trop Facile,Trop Facile,Trop Facile / Trop Facile
331,332,2015,Informatique,15,1,QCU,0.0515,0.25,0.23,7,7,0,7,1.0,0.0,0,7,5.15,Trop Difficile,Trop Difficile,Trop Difficile / Trop Difficile
1161,332,2016,Informatique,15,1,QCU,0.8818,0.09,0.96,8,8,7,1,1.0,87.5,7,1,88.18,Trop Facile,Trop Facile,Trop Facile / Trop Facile
1991,332,2017,Informatique,15,1,QCU,0.9224,0.08,0.99,9,8,8,0,1.12,100.0,8,1,92.24,Trop Facile,Trop Facile,Trop Facile / Trop Facile
2821,332,2018,Informatique,15,1,QCU,0.2079,0.01,0.27,10,4,2,2,2.5,50.0,2,8,20.79,Trop Facile,Trop Difficile,Trop Facile / Trop Difficile
3651,332,2019,Informatique,15,1,QCU,0.9136,0.02,1.0,9,9,8,1,1.0,88.89,8,1,91.36,Trop Facile,Trop Facile,Trop Facile / Trop Facile
4481,332,2020,Informatique,15,1,QCU,0.9334,0.08,0.94,7,7,7,0,1.0,100.0,7,0,93.34,Trop Facile,Trop Facile,Trop Facile / Trop Facile
332,333,2015,Informatique,15,2,QCU,0.7902,0.07,0.85,55,50,43,7,1.1,86.0,43,12,79.02,Facile,Facile,Facile / Facile
1162,333,2016,Informatique,15,2,QCU,0.9147,0.02,0.93,56,52,51,1,1.08,98.08,51,5,91.47,Trop Facile,Trop Facile,Trop Facile / Trop Facile
1992,333,2017,Informatique,15,2,QCU,0.9759,0.06,0.99,67,67,65,2,1.0,97.01,65,2,97.59,Trop Facile,Trop Facile,Trop Facile / Trop Facile
2822,333,2018,Informatique,15,2,QCU,0.9382,0.05,0.94,54,53,51,2,1.02,96.23,51,3,93.82,Trop Facile,Trop Facile,Trop Facile / Trop Facile
3652,333,2019,Informatique,15,2,QCU,0.767,0.19,0.8,61,55,47,8,1.11,85.45,47,14,76.7,Trop Facile,Facile,Trop Facile / Facile
4482,333,2020,Informatique,15,2,QCU,0.9179,0.08,0.97,69,68,63,5,1.01,92.65,63,6,91.79,Trop Facile,Trop Facile,Trop Facile / Trop Facile
333,334,2015,Informatique,15,3,QCM,0.7276,0.22,0.65,94,87,68,19,1.08,78.16,68,26,72.76,Adapte,Adapte,Adapte / Adapte
1163,334,2016,Informatique,15,3,QCM,0.6926,0.0,0.45,97,77,67,10,1.26,87.01,67,30,69.26,Adapte,Adapte,Adapte / Adapte
1993,334,2017,Informatique,15,3,QCM,0.741,0.2,0.49,105,98,78,20,1.07,79.59,78,27,74.1,Adapte,Adapte,Adapte / Adapte
2823,334,2018,Informatique,15,3,QCM,0.7458,0.04,0.55,121,106,90,16,1.14,84.91,90,31,74.58,Adapte,Adapte,Adapte / Adapte
3653,334,2019,Informatique,15,3,QCM,0.6091,0.29,0.69,142,135,86,49,1.05,63.7,86,56,60.91,Adapte,Adapte,Adapte / Adapte
4483,334,2020,Informatique,15,3,QCM,0.6499,0.08,0.45,162,137,105,32,1.18,76.64,105,57,64.99,Adapte,Adapte,Adapte / Adapte
334,335,2015,Informatique,15,4,QROC,0.2133,0.98,0.06,41,40,9,31,1.02,22.5,9,32,21.33,Difficile,Trop Difficile,Difficile / Trop Difficile
1164,335,2016,Informatique,15,4,QROC,0.8986,0.05,0.66,41,39,37,2,1.05,94.87,37,4,89.86,Trop Facile,Trop Facile,Trop Facile / Trop Facile
1994,335,2017,Informatique,15,4,QROC,0.9574,0.0,0.93,44,42,42,0,1.05,100.0,42,2,95.74,Trop Facile,Trop Facile,Trop Facile / Trop Facile
2824,335,2018,Informatique,15,4,QROC,0.9448,0.01,0.79,40,39,38,1,1.03,97.44,38,2,94.48,Trop Facile,Trop Facile,Trop Facile / Trop Facile
3654,335,2019,Informatique,15,4,QROC,0.9306,0.08,0.79,44,43,41,2,1.02,95.35,41,3,93.06,Trop Facile,Trop Facile,Trop Facile / Trop Facile
4484,335,2020,Informatique,15,4,QROC,0.9417,0.03,0.58,53,51,50,1,1.04,98.04,50,3,94.17,Trop Facile,Trop Facile,Trop Facile / Trop Facile
335,336,2015,Informatique,15,5,QCM,0.8744,0.04,0.88,96,89,84,5,1.08,94.38,84,12,87.44,Adapte,Trop Facile,Adapte / Trop Facile
1165,336,2016,Informatique,15,5,QCM,0.729,0.3,0.42,97,93,71,22,1.04,76.34,71,26,72.9,Trop Facile,Adapte,Trop Facile / Adapte
1995,336,2017,Informatique,15,5,QCM,0.6154,0.0,0.42,97,80,60,20,1.21,75.0,60,37,61.54,Adapte,Adapte,Adapte / Adapte
2825,336,2018,Informatique,15,5,QCM,0.7385,0.18,0.66,85,65,63,2,1.31,96.92,63,22,73.85,Adapte,Adapte,Adapte / Adapte
3655,336,2019,Informatique,15,5,QCM,0.6053,0.13,0.7,93,78,56,22,1.19,71.79,56,37,60.53,Adapte,Adapte,Adapte / Adapte
4485,336,2020,Informatique,15,5,QCM,0.7278,0.19,0.4,107,82,78,4,1.3,95.12,78,29,72.78,Adapte,Adapte,Adapte / Adapte
336,337,2015,Informatique,15,6,QROC,0.5171,0.58,0.2,59,44,31,13,1.34,70.45,31,28,51.71,Difficile,Difficile,Difficile / Difficile
1166,337,2016,Informatique,15,6,QROC,0.7954,0.08,0.49,68,57,54,3,1.19,94.74,54,14,79.54,Trop Facile,Facile,Trop Facile / Facile
1996,337,2017,Informatique,15,6,QROC,0.9458,0.05,0.79,57,56,54,2,1.02,96.43,54,3,94.58,Trop Facile,Trop Facile,Trop Facile / Trop Facile
2826,337,2018,Informatique,15,6,QROC,0.9096,0.06,0.59,55,51,50,1,1.08,98.04,50,5,90.96,Trop Facile,Trop Facile,Trop Facile / Trop Facile
3656,337,2019,Informatique,15,6,QROC,0.1182,0.84,0.04,49,26,6,20,1.88,23.08,6,43,11.82,Trop Facile,Trop Difficile,Trop Facile / Trop Difficile
4486,337,2020,Informatique,15,6,QROC,0.9165,0.05,0.5,45,45,41,4,1.0,91.11,41,4,91.65,Trop Facile,Trop Facile,Trop Facile / Trop Facile
337,338,2015,Informatique,15,7,QCU,0.6025,0.14,0.6,29,23,17,6,1.26,73.91,17,12,60.25,Trop Facile,Adapte,Trop Facile / Adapte
1167,338,2016,Informatique,15,7,QCU,0.6031,0.26,0.56,23,18,14,4,1.28,77.78,14,9,60.31,Adapte,Adapte,Adapte / Adapte
1997,338,2017,Informatique,15,7,QCU,0.6349,0.14,0.41,26,20,17,3,1.3,85.0,17,9,63.49,Adapte,Adapte,Adapte / Adapte
2827,338,2018,Informatique,15,7,QCU,0.6958,0.17,0.44,25,23,17,6,1.09,73.91,17,8,69.58,Adapte,Adapte,Adapte / Adapte
3657,338,2019,Informatique,15,7,QCU,0.6653,0.03,0.53,21,18,14,4,1.17,77.78,14,7,66.53,Adapte,Adapte,Adapte / Adapte
4487,338,2020,Informatique,15,7,QCU,0.6208,0.13,0.47,25,24,16,8,1.04,66.67,16,9,62.08,Adapte,Adapte,Adapte / Adapte
338,339,2015,Informatique,15,8,QCU,0.0485,0.72,0.27,15,10,1,9,1.5,10.0,1,14,4.85,Facile,Trop Difficile,Facile / Trop Difficile
1168,339,2016,Informatique,15,8,QCU,0.9617,0.07,0.96,12,12,12,0,1.0,100.0,12,0,96.17,Trop Facile,Trop Facile,Trop Facile / Trop Facile
1998,339,2017,Informatique,15,8,QCU,0.9036,0.05,1.0,11,10,10,0,1.1,100.0,10,1,90.36,Trop Facile,Trop Facile,Trop Facile / Trop Facile
2828,339,2018,Informatique,15,8,QCU,0.1651,0.57,0.27,11,8,2,6,1.38,25.0,2,9,16.51,Trop Facile,Trop Difficile,Trop Facile / Trop Difficile
3658,339,2019,Informatique,15,8,QCU,0.0569,0.49,0.29,13,10,1,9,1.3,10.0,1,12,5.69,Trop Facile,Trop Difficile,Trop Facile / Trop Difficile
4488,339,2020,Informatique,15,8,QCU,0.8306,0.02,0.76,10,10,8,2,1.0,80.0,8,2,83.06,Trop Facile,Facile,Trop Facile / Facile
339,340,2015,Informatique,15,9,QCU,0.9345,0.02,0.94,71,69,66,3,1.03,95.65,66,5,93.45,Difficile,Trop Facile,Difficile / Trop Facile
1169,340,2016,Informatique,15,9,QCU,0.5584,0.05,0.35,60,55,34,21,1.09,61.82,34,26,55.84,Trop Facile,Difficile,Trop Facile / Difficile
1999,340,2017,Informatique,15,9,QCU,0.9838,0.05,0.99,60,60,59,1,1.0,98.33,59,1,98.38,Trop Facile,Trop Facile,Trop Facile / Trop Facile
2829,340,2018,Informatique,15,9,QCU,0.9796,0.03,0.97,70,70,69,1,1.0,98.57,69,1,97.96,Trop Facile,Trop Facile,Trop Facile / Trop Facile
3659,340,2019,Informatique,15,9,QCU,0.9774,0.05,0.99,59,58,58,0,1.02,100.0,58,1,97.74,Trop Facile,Trop Facile,Trop Facile / Trop Facile
4489,340,2020,Informatique,15,9,QCU,0.7719,0.05,0.9,55,54,42,12,1.02,77.78,42,13,77.19,Trop Facile,Facile,Trop Facile / Facile
340,341,2015,Art,1,1,QROC,0.8181,0.1,0.7,13,13,11,2,1.0,84.62,11,2,81.81,Facile,Facile,Facile / Facile
1170,341,2016,Art,1,1,QROC,0.9776,0.08,0.75,16,16,16,0,1.0,100.0,16,0,97.76,Trop Facile,Trop Facile,Trop Facile / Trop Facile
2000,341,2017,Art,1,1,QROC,0.8706,0.04,0.58,14,14,12,2,1.0,85.71,12,2,87.06,Trop Facile,Trop Facile,Trop Facile / Trop Facile
2830,341,2018,Art,1,1,QROC,0.9073,0.08,0.64,16,15,15,0,1.07,100.0,15,1,90.73,Trop Facile,Trop Facile,Trop Facile / Trop Facile
3660,341,2019,Art,1,1,QROC,0.9643,0.06,0.76,14,14,14,0,1.0,100.0,14,0,96.43,Trop Facile,Trop Facile,Trop Facile / Trop Facile
4490,341,2020,Art,1,1,QROC,0.0733,0.81,0.02,15,9,1,8,1.67,11.11,1,14,7.33,Trop Facile,Trop Difficile,Trop Facile / Trop Difficile
341,342,2015,Art,1,2,QCM,0.1001,0.52,0.2,21,19,2,17,1.11,10.53,2,19,10.01,Trop Difficile,Trop Difficile,Trop Difficile / Trop Difficile
1171,342,2016,Art,1,2,QCM,0.8659,0.02,0.9,21,18,18,0,1.17,100.0,18,3,86.59,Trop Facile,Trop Facile,Trop Facile / Trop Facile
2001,342,2017,Art,1,2,QCM,0.9672,0.0,0.9,19,19,18,1,1.0,94.74,18,1,96.72,Trop Facile,Trop Facile,Trop Facile / Trop Facile
2831,342,2018,Art,1,2,QCM,0.8336,0.06,0.73,22,21,18,3,1.05,85.71,18,4,83.36,Trop Facile,Facile,Trop Facile / Facile
3661,342,2019,Art,1,2,QCM,0.888,0.01,0.9,23,22,20,2,1.05,90.91,20,3,88.8,Trop Facile,Trop Facile,Trop Facile / Trop Facile
4491,342,2020,Art,1,2,QCM,0.9687,0.05,0.95,25,24,24,0,1.04,100.0,24,1,96.87,Trop Facile,Trop Facile,Trop Facile / Trop Facile
342,343,2015,Art,1,3,QCM,0.8381,0.04,0.72,46,44,39,5,1.05,88.64,39,7,83.81,Difficile,Facile,Difficile / Facile
1172,343,2016,Art,1,3,QCM,0.9946,0.01,0.97,45,45,45,0,1.0,100.0,45,0,99.46,Trop Facile,Trop Facile,Trop Facile / Trop Facile
2002,343,2017,Art,1,3,QCM,0.8358,0.1,0.76,47,41,39,2,1.15,95.12,39,8,83.58,Trop Facile,Facile,Trop Facile / Facile
2832,343,2018,Art,1,3,QCM,0.5202,0.38,0.31,46,35,24,11,1.31,68.57,24,22,52.02,Trop Facile,Difficile,Trop Facile / Difficile
3662,343,2019,Art,1,3,QCM,0.999,0.1,0.85,48,48,48,0,1.0,100.0,48,0,99.9,Trop Facile,Trop Facile,Trop Facile / Trop Facile
4492,343,2020,Art,1,3,QCM,0.8349,0.07,0.76,41,36,34,2,1.14,94.44,34,7,83.49,Trop Facile,Facile,Trop Facile / Facile
343,344,2015,Art,1,4,QO,0.8127,0.1,0.45,50,42,41,1,1.19,97.62,41,9,81.27,Trop Difficile,Facile,Trop Difficile / Facile
1173,344,2016,Art,1,4,QO,0.174,0.93,0.05,52,31,9,22,1.68,29.03,9,43,17.4,Trop Facile,Trop Difficile,Trop Facile / Trop Difficile
2003,344,2017,Art,1,4,QO,0.8779,0.02,0.92,56,52,49,3,1.08,94.23,49,7,87.79,Trop Facile,Trop Facile,Trop Facile / Trop Facile
2833,344,2018,Art,1,4,QO,0.8954,0.1,0.74,67,63,60,3,1.06,95.24,60,7,89.54,Trop Facile,Trop Facile,Trop Facile / Trop Facile
3663,344,2019,Art,1,4,QO,0.7029,0.42,0.27,69,53,49,4,1.3,92.45,49,20,70.29,Trop Facile,Adapte,Trop Facile / Adapte
4493,344,2020,Art,1,4,QO,0.728,0.25,0.22,61,54,44,10,1.13,81.48,44,17,72.8,Adapte,Adapte,Adapte / Adapte
344,345,2015,Art,1,5,QCU,0.3174,0.32,0.35,29,19,9,10,1.53,47.37,9,20,31.74,Facile,Difficile,Facile / Difficile
1174,345,2016,Art,1,5,QCU,0.577,0.19,0.34,35,30,20,10,1.17,66.67,20,15,57.7,Trop Facile,Difficile,Trop Facile / Difficile
2004,345,2017,Art,1,5,QCU,0.9912,0.0,0.97,41,41,41,0,1.0,100.0,41,0,99.12,Trop Facile,Trop Facile,Trop Facile / Trop Facile
2834,345,2018,Art,1,5,QCU,0.3209,0.13,0.35,36,16,12,4,2.25,75.0,12,24,32.09,Trop Facile,Difficile,Trop Facile / Difficile
3664,345,2019,Art,1,5,QCU,0.9623,0.08,0.9,43,42,41,1,1.02,97.62,41,2,96.23,Trop Facile,Trop Facile,Trop Facile / Trop Facile
4494,345,2020,Art,1,5,QCU,0.2349,0.24,0.27,43,29,10,19,1.48,34.48,10,33,23.49,Trop Facile,Trop Difficile,Trop Facile / Trop Difficile
345,346,2015,Art,1,6,QCU,0.9926,0.1,0.95,40,40,40,0,1.0,100.0,40,0,99.26,Trop Facile,Trop Facile,Trop Facile / Trop Facile
1175,346,2016,Art,1,6,QCU,0.897,0.08,0.92,40,40,36,4,1.0,90.0,36,4,89.7,Trop Facile,Trop Facile,Trop Facile / Trop Facile
2005,346,2017,Art,1,6,QCU,0.9177,0.08,0.97,42,40,39,1,1.05,97.5,39,3,91.77,Trop Facile,Trop Facile,Trop Facile / Trop Facile
2835,346,2018,Art,1,6,QCU,0.9838,0.05,0.97,49,49,48,1,1.0,97.96,48,1,98.38,Trop Facile,Trop Facile,Trop Facile / Trop Facile
3665,346,2019,Art,1,6,QCU,0.918,0.03,0.98,47,47,43,4,1.0,91.49,43,4,91.8,Trop Facile,Trop Facile,Trop Facile / Trop Facile
4495,346,2020,Art,1,6,QCU,0.9645,0.09,0.95,38,38,37,1,1.0,97.37,37,1,96.45,Trop Facile,Trop Facile,Trop Facile / Trop Facile
346,347,2015,Art,1,7,QROC,0.5728,0.55,0.22,49,34,28,6,1.44,82.35,28,21,57.28,Difficile,Difficile,Difficile / Difficile
1176,347,2016,Art,1,7,QROC,0.9037,0.06,0.72,55,53,50,3,1.04,94.34,50,5,90.37,Trop Facile,Trop Facile,Trop Facile / Trop Facile
2006,347,2017,Art,1,7,QROC,0.9991,0.01,0.51,48,48,48,0,1.0,100.0,48,0,99.91,Trop Facile,Trop Facile,Trop Facile / Trop Facile
2836,347,2018,Art,1,7,QROC,0.8836,0.04,0.91,45,42,40,2,1.07,95.24,40,5,88.36,Trop Facile,Trop Facile,Trop Facile / Trop Facile
3666,347,2019,Art,1,7,QROC,0.9114,0.09,0.97,54,50,49,1,1.08,98.0,49,5,91.14,Trop Facile,Trop Facile,Trop Facile / Trop Facile
4496,347,2020,Art,1,7,QROC,0.9005,0.0,0.8,57,56,51,5,1.02,91.07,51,6,90.05,Trop Facile,Trop Facile,Trop Facile / Trop Facile
347,348,2015,Art,1,8,QCU,0.5076,0.01,0.4,91,69,46,23,1.32,66.67,46,45,50.76,Difficile,Difficile,Difficile / Difficile
1177,348,2016,Art,1,8,QCU,0.8657,0.09,0.96,92,87,80,7,1.06,91.95,80,12,86.57,Trop Facile,Trop Facile,Trop Facile / Trop Facile
2007,348,2017,Art,1,8,QCU,0.9455,0.04,0.95,104,99,98,1,1.05,98.99,98,6,94.55,Trop Facile,Trop Facile,Trop Facile / Trop Facile
2837,348,2018,Art,1,8,QCU,0.5638,0.35,0.39,88,66,50,16,1.33,75.76,50,38,56.38,Trop Facile,Difficile,Trop Facile / Difficile
3667,348,2019,Art,1,8,QCU,0.4786,0.34,0.34,91,75,44,31,1.21,58.67,44,47,47.86,Trop Facile,Difficile,Trop Facile / Difficile
4497,348,2020,Art,1,8,QCU,0.9996,0.02,0.99,103,103,103,0,1.0,100.0,103,0,99.96,Trop Facile,Trop Facile,Trop Facile / Trop Facile
348,349,2015,Art,1,9,QCM,0.7207,0.05,0.4,49,41,35,6,1.2,85.37,35,14,72.07,Trop Difficile,Adapte,Trop Difficile / Adapte
1178,349,2016,Art,1,9,QCM,0.7349,0.04,0.41,44,33,32,1,1.33,96.97,32,12,73.49,Adapte,Adapte,Adapte / Adapte
2008,349,2017,Art,1,9,QCM,0.683,0.03,0.54,36,26,25,1,1.38,96.15,25,11,68.3,Adapte,Adapte,Adapte / Adapte
2838,349,2018,Art,1,9,QCM,0.7466,0.23,0.65,36,27,27,0,1.33,100.0,27,9,74.66,Adapte,Adapte,Adapte / Adapte
3668,349,2019,Art,1,9,QCM,0.7144,0.01,0.51,30,27,21,6,1.11,77.78,21,9,71.44,Adapte,Adapte,Adapte / Adapte
4498,349,2020,Art,1,9,QCM,0.6049,0.12,0.53,25,22,15,7,1.14,68.18,15,10,60.49,Adapte,Adapte,Adapte / Adapte
349,350,2015,Art,2,1,QCM,0.9998,0.02,0.99,26,26,26,0,1.0,100.0,26,0,99.98,Trop Facile,Trop Facile,Trop Facile / Trop Facile
1179,350,2016,Art,2,1,QCM,0.9538,0.05,0.94,30,30,29,1,1.0,96.67,29,1,95.38,Trop Facile,Trop Facile,Trop Facile / Trop Facile
2009,350,2017,Art,2,1,QCM,0.8619,0.05,0.81,34,30,29,1,1.13,96.67,29,5,86.19,Trop Facile,Trop Facile,Trop Facile / Trop Facile
2839,350,2018,Art,2,1,QCM,0.8884,0.05,0.89,30,27,27,0,1.11,100.0,27,3,88.84,Trop Facile,Trop Facile,Trop Facile / Trop Facile
3669,350,2019,Art,2,1,QCM,0.2379,0.63,0.27,32,32,8,24,1.0,25.0,8,24,23.79,Trop Facile,Trop Difficile,Trop Facile / Trop Difficile
4499,350,2020,Art,2,1,QCM,0.955,0.0,0.87,28,28,27,1,1.0,96.43,27,1,95.5,Trop Facile,Trop Facile,Trop Facile / Trop Facile
350,351,2015,Art,2,2,QO,0.2715,0.76,0.13,60,31,16,15,1.94,51.61,16,44,27.15,Difficile,Difficile,Difficile / Difficile
1180,351,2016,Art,2,2,QO,0.9104,0.09,0.76,61,56,56,0,1.09,100.0,56,5,91.04,Trop Facile,Trop Facile,Trop Facile / Trop Facile
2010,351,2017,Art,2,2,QO,0.9878,0.06,0.86,65,65,64,1,1.0,98.46,64,1,98.78,Trop Facile,Trop Facile,Trop Facile / Trop Facile
2840,351,2018,Art,2,2,QO,0.8694,0.04,0.69,54,49,47,2,1.1,95.92,47,7,86.94,Trop Facile,Trop Facile,Trop Facile / Trop Facile
3670,351,2019,Art,2,2,QO,0.9245,0.05,0.54,49,48,45,3,1.02,93.75,45,4,92.45,Trop Facile,Trop Facile,Trop Facile / Trop Facile
4500,351,2020,Art,2,2,QO,0.8642,0.1,0.85,44,40,38,2,1.1,95.0,38,6,86.42,Trop Facile,Trop Facile,Trop Facile / Trop Facile
351,352,2015,Art,2,3,QCU,0.1868,0.02,0.21,59,45,11,34,1.31,24.44,11,48,18.68,Difficile,Trop Difficile,Difficile / Trop Difficile
1181,352,2016,Art,2,3,QCU,0.9142,0.05,0.92,59,55,54,1,1.07,98.18,54,5,91.42,Trop Facile,Trop Facile,Trop Facile / Trop Facile
2011,352,2017,Art,2,3,QCU,0.9855,0.09,0.97,56,56,55,1,1.0,98.21,55,1,98.55,Trop Facile,Trop Facile,Trop Facile / Trop Facile
2841,352,2018,Art,2,3,QCU,0.9403,0.06,0.91,65,62,61,1,1.05,98.39,61,4,94.03,Trop Facile,Trop Facile,Trop Facile / Trop Facile
3671,352,2019,Art,2,3,QCU,0.9146,0.05,0.98,62,61,57,4,1.02,93.44,57,5,91.46,Trop Facile,Trop Facile,Trop Facile / Trop Facile
4501,352,2020,Art,2,3,QCU,0.9981,0.05,0.9,74,74,74,0,1.0,100.0,74,0,99.81,Trop Facile,Trop Facile,Trop Facile / Trop Facile
352,353,2015,Art,2,4,QCU,0.4628,0.16,0.34,18,13,8,5,1.38,61.54,8,10,46.28,Difficile,Difficile,Difficile / Difficile
1182,353,2016,Art,2,4,QCU,0.9052,0.06,1.0,18,16,16,0,1.12,100.0,16,2,90.52,Trop Facile,Trop Facile,Trop Facile / Trop Facile
2012,353,2017,Art,2,4,QCU,0.5821,0.16,0.35,16,13,9,4,1.23,69.23,9,7,58.21,Trop Facile,Difficile,Trop Facile / Difficile
2842,353,2018,Art,2,4,QCU,0.8669,0.1,0.95,15,14,13,1,1.07,92.86,13,2,86.69,Trop Facile,Trop Facile,Trop Facile / Trop Facile
3672,353,2019,Art,2,4,QCU,0.9457,0.04,0.94,14,13,13,0,1.08,100.0,13,1,94.57,Trop Facile,Trop Facile,Trop Facile / Trop Facile
4502,353,2020,Art,2,4,QCU,0.9823,0.0,0.99,12,12,12,0,1.0,100.0,12,0,98.23,Trop Facile,Trop Facile,Trop Facile / Trop Facile
353,354,2015,Art,2,5,QCU,0.8498,0.19,0.88,39,35,33,2,1.11,94.29,33,6,84.98,Facile,Facile,Facile / Facile
1183,354,2016,Art,2,5,QCU,0.8708,0.03,0.92,45,44,39,5,1.02,88.64,39,6,87.08,Trop Facile,Trop Facile,Trop Facile / Trop Facile
2013,354,2017,Art,2,5,QCU,0.8939,0.05,0.94,41,38,37,1,1.08,97.37,37,4,89.39,Trop Facile,Trop Facile,Trop Facile / Trop Facile
2843,354,2018,Art,2,5,QCU,0.9953,0.05,0.94,41,41,41,0,1.0,100.0,41,0,99.53,Trop Facile,Trop Facile,Trop Facile / Trop Facile
3673,354,2019,Art,2,5,QCU,0.9623,0.01,0.97,45,44,43,1,1.02,97.73,43,2,96.23,Trop Facile,Trop Facile,Trop Facile / Trop Facile
4503,354,2020,Art,2,5,QCU,0.9325,0.01,0.96,36,35,34,1,1.03,97.14,34,2,93.25,Trop Facile,Trop Facile,Trop Facile / Trop Facile
354,355,2015,Art,2,6,QCU,0.0557,0.61,0.23,49,36,3,33,1.36,8.33,3,46,5.57,Trop Difficile,Trop Difficile,Trop Difficile / Trop Difficile
1184,355,2016,Art,2,6,QCU,0.9667,0.02,0.91,45,45,44,1,1.0,97.78,44,1,96.67,Trop Facile,Trop Facile,Trop Facile / Trop Facile
2014,355,2017,Art,2,6,QCU,0.9165,0.09,0.91,37,35,34,1,1.06,97.14,34,3,91.65,Trop Facile,Trop Facile,Trop Facile / Trop Facile
2844,355,2018,Art,2,6,QCU,0.927,0.02,0.99,38,37,35,2,1.03,94.59,35,3,92.7,Trop Facile,Trop Facile,Trop Facile / Trop Facile
3674,355,2019,Art,2,6,QCU,0.3231,0.11,0.31,39,24,13,11,1.62,54.17,13,26,32.31,Trop Facile,Difficile,Trop Facile / Difficile
4504,355,2020,Art,2,6,QCU,0.9464,0.04,0.9,34,33,32,1,1.03,96.97,32,2,94.64,Trop Facile,Trop Facile,Trop Facile / Trop Facile
355,356,2015,Art,3,1,QCM,0.4117,0.49,0.33,90,59,37,22,1.53,62.71,37,53,41.17,Difficile,Difficile,Difficile / Difficile
1185,356,2016,Art,3,1,QCM,0.1342,0.42,0.25,106,54,14,40,1.96,25.93,14,92,13.42,Trop Facile,Trop Difficile,Trop Facile / Trop Difficile
2015,356,2017,Art,3,1,QCM,0.975,0.01,0.98,124,124,121,3,1.0,97.58,121,3,97.5,Trop Facile,Trop Facile,Trop Facile / Trop Facile
2845,356,2018,Art,3,1,QCM,0.9853,0.06,0.99,132,131,130,1,1.01,99.24,130,2,98.53,Trop Facile,Trop Facile,Trop Facile / Trop Facile
3675,356,2019,Art,3,1,QCM,0.4285,0.04,0.36,149,134,64,70,1.11,47.76,64,85,42.85,Trop Facile,Difficile,Trop Facile / Difficile
4505,356,2020,Art,3,1,QCM,0.8975,0.01,0.92,163,161,146,15,1.01,90.68,146,17,89.75,Trop Facile,Trop Facile,Trop Facile / Trop Facile
356,357,2015,Art,3,2,QCU,0.9199,0.0,0.92,38,36,35,1,1.06,97.22,35,3,91.99,Trop Facile,Trop Facile,Trop Facile / Trop Facile
1186,357,2016,Art,3,2,QCU,0.1169,0.49,0.21,41,19,5,14,2.16,26.32,5,36,11.69,Trop Facile,Trop Difficile,Trop Facile / Trop Difficile
2016,357,2017,Art,3,2,QCU,0.0258,0.53,0.24,42,39,1,38,1.08,2.56,1,41,2.58,Trop Facile,Trop Difficile,Trop Facile / Trop Difficile
2846,357,2018,Art,3,2,QCU,0.9665,0.07,0.97,49,48,47,1,1.02,97.92,47,2,96.65,Trop Facile,Trop Facile,Trop Facile / Trop Facile
3676,357,2019,Art,3,2,QCU,0.6108,0.06,0.44,48,30,29,1,1.6,96.67,29,19,61.08,Trop Facile,Adapte,Trop Facile / Adapte
4506,357,2020,Art,3,2,QCU,0.7228,0.01,0.49,53,41,38,3,1.29,92.68,38,15,72.28,Adapte,Adapte,Adapte / Adapte
357,358,2015,Art,3,3,QO,0.9112,0.05,0.99,39,38,36,2,1.03,94.74,36,3,91.12,Trop Facile,Trop Facile,Trop Facile / Trop Facile
1187,358,2016,Art,3,3,QO,0.998,0.04,0.8,45,45,45,0,1.0,100.0,45,0,99.8,Trop Facile,Trop Facile,Trop Facile / Trop Facile
2017,358,2017,Art,3,3,QO,0.1722,0.93,0.07,50,42,9,33,1.19,21.43,9,41,17.22,Trop Facile,Trop Difficile,Trop Facile / Trop Difficile
2847,358,2018,Art,3,3,QO,0.4632,0.85,0.13,50,46,23,23,1.09,50.0,23,27,46.32,Trop Facile,Difficile,Trop Facile / Difficile
3677,358,2019,Art,3,3,QO,0.1835,0.92,0.05,58,39,11,28,1.49,28.21,11,47,18.35,Trop Facile,Trop Difficile,Trop Facile / Trop Difficile
4507,358,2020,Art,3,3,QO,0.9934,0.04,0.7,54,54,54,0,1.0,100.0,54,0,99.34,Trop Facile,Trop Facile,Trop Facile / Trop Facile
358,359,2015,Art,3,4,QCU,0.7988,0.03,0.79,40,33,32,1,1.21,96.97,32,8,79.88,Trop Facile,Facile,Trop Facile / Facile
1188,359,2016,Art,3,4,QCU,0.8703,0.02,0.99,44,41,38,3,1.07,92.68,38,6,87.03,Trop Facile,Trop Facile,Trop Facile / Trop Facile
2018,359,2017,Art,3,4,QCU,0.9741,0.01,0.98,41,40,40,0,1.02,100.0,40,1,97.41,Trop Facile,Trop Facile,Trop Facile / Trop Facile
2848,359,2018,Art,3,4,QCU,0.8325,0.06,0.76,49,44,41,3,1.11,93.18,41,8,83.25,Trop Facile,Facile,Trop Facile / Facile
3678,359,2019,Art,3,4,QCU,0.6643,0.29,0.61,49,45,33,12,1.09,73.33,33,16,66.43,Trop Facile,Adapte,Trop Facile / Adapte
4508,359,2020,Art,3,4,QCU,0.7146,0.19,0.65,54,52,39,13,1.04,75.0,39,15,71.46,Adapte,Adapte,Adapte / Adapte
359,360,2015,Art,3,5,QCU,0.7462,0.16,0.45,63,51,47,4,1.24,92.16,47,16,74.62,Difficile,Adapte,Difficile / Adapte
1189,360,2016,Art,3,5,QCU,0.6886,0.2,0.66,74,52,51,1,1.42,98.08,51,23,68.86,Adapte,Adapte,Adapte / Adapte
2019,360,2017,Art,3,5,QCU,0.7479,0.21,0.57,63,60,47,13,1.05,78.33,47,16,74.79,Adapte,Adapte,Adapte / Adapte
2849,360,2018,Art,3,5,QCU,0.6021,0.2,0.67,62,42,37,5,1.48,88.1,37,25,60.21,Adapte,Adapte,Adapte / Adapte
3679,360,2019,Art,3,5,QCU,0.7225,0.21,0.47,55,42,40,2,1.31,95.24,40,15,72.25,Adapte,Adapte,Adapte / Adapte
4509,360,2020,Art,3,5,QCU,0.7453,0.07,0.42,61,59,45,14,1.03,76.27,45,16,74.53,Adapte,Adapte,Adapte / Adapte
360,361,2015,Art,3,6,QCU,0.9594,0.03,1.0,23,23,22,1,1.0,95.65,22,1,95.94,Trop Facile,Trop Facile,Trop Facile / Trop Facile
1190,361,2016,Art,3,6,QCU,0.9782,0.05,0.98,26,25,25,0,1.04,100.0,25,1,97.82,Trop Facile,Trop Facile,Trop Facile / Trop Facile
2020,361,2017,Art,3,6,QCU,0.3554,0.09,0.32,21,20,7,13,1.05,35.0,7,14,35.54,Trop Facile,Difficile,Trop Facile / Difficile
2850,361,2018,Art,3,6,QCU,0.2785,0.19,0.39,25,19,7,12,1.32,36.84,7,18,27.85,Trop Facile,Difficile,Trop Facile / Difficile
3680,361,2019,Art,3,6,QCU,0.9257,0.04,0.91,21,19,19,0,1.11,100.0,19,2,92.57,Trop Facile,Trop Facile,Trop Facile / Trop Facile
4510,361,2020,Art,3,6,QCU,0.779,0.08,0.8,17,14,13,1,1.21,92.86,13,4,77.9,Trop Facile,Facile,Trop Facile / Facile
361,362,2015,Art,3,7,QROC,0.7924,0.06,0.53,83,75,66,9,1.11,88.0,66,17,79.24,Facile,Facile,Facile / Facile
1191,362,2016,Art,3,7,QROC,0.0722,0.75,0.11,89,48,6,42,1.85,12.5,6,83,7.22,Trop Facile,Trop Difficile,Trop Facile / Trop Difficile
2021,362,2017,Art,3,7,QROC,0.9135,0.09,0.91,83,76,76,0,1.09,100.0,76,7,91.35,Trop Facile,Trop Facile,Trop Facile / Trop Facile
2851,362,2018,Art,3,7,QROC,0.8856,0.1,0.97,93,82,82,0,1.13,100.0,82,11,88.56,Trop Facile,Trop Facile,Trop Facile / Trop Facile
3681,362,2019,Art,3,7,QROC,0.9881,0.02,0.55,76,75,75,0,1.01,100.0,75,1,98.81,Trop Facile,Trop Facile,Trop Facile / Trop Facile
4511,362,2020,Art,3,7,QROC,0.9516,0.04,0.59,62,61,59,2,1.02,96.72,59,3,95.16,Trop Facile,Trop Facile,Trop Facile / Trop Facile
362,363,2015,Art,3,8,QROC,0.8747,0.06,0.71,57,56,50,6,1.02,89.29,50,7,87.47,Facile,Trop Facile,Facile / Trop Facile
1192,363,2016,Art,3,8,QROC,0.8767,0.06,0.9,62,57,54,3,1.09,94.74,54,8,87.67,Trop Facile,Trop Facile,Trop Facile / Trop Facile
2022,363,2017,Art,3,8,QROC,0.9068,0.04,0.88,70,64,63,1,1.09,98.44,63,7,90.68,Trop Facile,Trop Facile,Trop Facile / Trop Facile
2852,363,2018,Art,3,8,QROC,0.6224,0.28,0.26,62,44,39,5,1.41,88.64,39,23,62.24,Trop Facile,Adapte,Trop Facile / Adapte
3682,363,2019,Art,3,8,QROC,0.6483,0.2,0.39,60,53,39,14,1.13,73.58,39,21,64.83,Adapte,Adapte,Adapte / Adapte
4512,363,2020,Art,3,8,QROC,0.6801,0.23,0.34,59,48,40,8,1.23,83.33,40,19,68.01,Adapte,Adapte,Adapte / Adapte
363,364,2015,Art,3,9,QCU,0.8903,0.01,0.94,25,22,22,0,1.14,100.0,22,3,89.03,Trop Facile,Trop Facile,Trop Facile / Trop Facile
1193,364,2016,Art,3,9,QCU,0.9786,0.06,0.91,28,28,27,1,1.0,96.43,27,1,97.86,Trop Facile,Trop Facile,Trop Facile / Trop Facile
2023,364,2017,Art,3,9,QCU,0.9039,0.03,0.94,24,22,22,0,1.09,100.0,22,2,90.39,Trop Facile,Trop Facile,Trop Facile / Trop Facile
2853,364,2018,Art,3,9,QCU,0.8757,0.02,0.91,23,21,20,1,1.1,95.24,20,3,87.57,Trop Facile,Trop Facile,Trop Facile / Trop Facile
3683,364,2019,Art,3,9,QCU,0.4466,0.07,0.34,28,22,13,9,1.27,59.09,13,15,44.66,Trop Facile,Difficile,Trop Facile / Difficile
4513,364,2020,Art,3,9,QCU,0.9917,0.01,0.94,27,27,27,0,1.0,100.0,27,0,99.17,Trop Facile,Trop Facile,Trop Facile / Trop Facile
364,365,2015,Art,3,10,QROC,0.1584,0.88,0.07,77,49,12,37,1.57,24.49,12,65,15.84,Trop Difficile,Trop Difficile,Trop Difficile / Trop Difficile
1194,365,2016,Art,3,10,QROC,0.8933,0.03,0.7,90,80,80,0,1.12,100.0,80,10,89.33,Trop Facile,Trop Facile,Trop Facile / Trop Facile
2024,365,2017,Art,3,10,QROC,0.9961,0.08,0.76,92,92,92,0,1.0,100.0,92,0,99.61,Trop Facile,Trop Facile,Trop Facile / Trop Facile
2854,365,2018,Art,3,10,QROC,0.8667,0.04,0.57,104,91,90,1,1.14,98.9,90,14,86.67,Trop Facile,Trop Facile,Trop Facile / Trop Facile
3684,365,2019,Art,3,10,QROC,0.5703,0.52,0.21,84,66,48,18,1.27,72.73,48,36,57.03,Trop Facile,Difficile,Trop Facile / Difficile
4514,365,2020,Art,3,10,QROC,0.7766,0.12,0.64,67,55,52,3,1.22,94.55,52,15,77.66,Trop Facile,Facile,Trop Facile / Facile
365,366,2015,Art,4,1,QO,0.3185,0.82,0.04,56,43,18,25,1.3,41.86,18,38,31.85,Difficile,Difficile,Difficile / Difficile
1195,366,2016,Art,4,1,QO,0.971,0.03,0.58,63,62,61,1,1.02,98.39,61,2,97.1,Trop Facile,Trop Facile,Trop Facile / Trop Facile
2025,366,2017,Art,4,1,QO,0.953,0.03,0.71,67,64,64,0,1.05,100.0,64,3,95.3,Trop Facile,Trop Facile,Trop Facile / Trop Facile
2855,366,2018,Art,4,1,QO,0.6737,0.71,0.21,80,71,54,17,1.13,76.06,54,26,67.37,Trop Facile,Adapte,Trop Facile / Adapte
3685,366,2019,Art,4,1,QO,0.6784,0.39,0.17,70,67,47,20,1.04,70.15,47,23,67.84,Adapte,Adapte,Adapte / Adapte
4515,366,2020,Art,4,1,QO,0.623,0.47,0.21,81,64,50,14,1.27,78.12,50,31,62.3,Adapte,Adapte,Adapte / Adapte
366,367,2015,Art,4,2,QCU,0.8063,0.12,0.76,82,78,66,12,1.05,84.62,66,16,80.63,Difficile,Facile,Difficile / Facile
1196,367,2016,Art,4,2,QCU,0.9898,0.05,0.95,84,84,83,1,1.0,98.81,83,1,98.98,Trop Facile,Trop Facile,Trop Facile / Trop Facile
2026,367,2017,Art,4,2,QCU,0.779,0.0,0.85,80,74,62,12,1.08,83.78,62,18,77.9,Trop Facile,Facile,Trop Facile / Facile
2856,367,2018,Art,4,2,QCU,0.9237,0.08,0.95,74,71,68,3,1.04,95.77,68,6,92.37,Trop Facile,Trop Facile,Trop Facile / Trop Facile
3686,367,2019,Art,4,2,QCU,0.3215,0.14,0.36,73,29,23,6,2.52,79.31,23,50,32.15,Trop Facile,Difficile,Trop Facile / Difficile
4516,367,2020,Art,4,2,QCU,0.9394,0.0,0.94,82,79,77,2,1.04,97.47,77,5,93.94,Trop Facile,Trop Facile,Trop Facile / Trop Facile
367,368,2015,Art,4,3,QCU,0.9725,0.02,0.95,9,9,9,0,1.0,100.0,9,0,97.25,Trop Facile,Trop Facile,Trop Facile / Trop Facile
1197,368,2016,Art,4,3,QCU,0.6886,0.01,0.58,10,8,7,1,1.25,87.5,7,3,68.86,Trop Facile,Adapte,Trop Facile / Adapte
2027,368,2017,Art,4,3,QCU,0.7042,0.17,0.43,8,7,6,1,1.14,85.71,6,2,70.42,Adapte,Adapte,Adapte / Adapte
2857,368,2018,Art,4,3,QCU,0.6804,0.02,0.43,7,6,5,1,1.17,83.33,5,2,68.04,Adapte,Adapte,Adapte / Adapte
3687,368,2019,Art,4,3,QCU,0.6621,0.07,0.45,7,6,5,1,1.17,83.33,5,2,66.21,Adapte,Adapte,Adapte / Adapte
4517,368,2020,Art,4,3,QCU,0.6907,0.2,0.65,7,7,5,2,1.0,71.43,5,2,69.07,Adapte,Adapte,Adapte / Adapte
368,369,2015,Art,4,4,QCU,0.782,0.09,0.87,17,14,13,1,1.21,92.86,13,4,78.2,Facile,Facile,Facile / Facile
1198,369,2016,Art,4,4,QCU,0.9309,0.04,0.93,16,16,15,1,1.0,93.75,15,1,93.09,Trop Facile,Trop Facile,Trop Facile / Trop Facile
2028,369,2017,Art,4,4,QCU,0.7436,0.03,0.58,16,13,12,1,1.23,92.31,12,4,74.36,Trop Facile,Adapte,Trop Facile / Adapte
2858,369,2018,Art,4,4,QCU,0.6964,0.12,0.44,13,10,9,1,1.3,90.0,9,4,69.64,Adapte,Adapte,Adapte / Adapte
3688,369,2019,Art,4,4,QCU,0.6893,0.28,0.52,12,9,8,1,1.33,88.89,8,4,68.93,Adapte,Adapte,Adapte / Adapte
4518,369,2020,Art,4,4,QCU,0.6653,0.04,0.55,14,9,9,0,1.56,100.0,9,5,66.53,Adapte,Adapte,Adapte / Adapte
369,370,2015,Art,4,5,QCU,0.7807,0.09,0.81,15,14,12,2,1.07,85.71,12,3,78.07,Facile,Facile,Facile / Facile
1199,370,2016,Art,4,5,QCU,0.9662,0.1,0.93,13,13,13,0,1.0,100.0,13,0,96.62,Trop Facile,Trop Facile,Trop Facile / Trop Facile
2029,370,2017,Art,4,5,QCU,0.6867,0.06,0.58,15,11,10,1,1.36,90.91,10,5,68.67,Trop Facile,Adapte,Trop Facile / Adapte
2859,370,2018,Art,4,5,QCU,0.6884,0.16,0.68,14,11,10,1,1.27,90.91,10,4,68.84,Adapte,Adapte,Adapte / Adapte
3689,370,2019,Art,4,5,QCU,0.6815,0.11,0.6,11,11,7,4,1.0,63.64,7,4,68.15,Adapte,Adapte,Adapte / Adapte
4519,370,2020,Art,4,5,QCU,0.7201,0.2,0.68,12,10,9,1,1.2,90.0,9,3,72.01,Adapte,Adapte,Adapte / Adapte
370,371,2015,Art,4,6,QCU,0.7798,0.16,0.8,62,55,48,7,1.13,87.27,48,14,77.98,Trop Facile,Facile,Trop Facile / Facile
1200,371,2016,Art,4,6,QCU,0.195,0.28,0.29,53,40,10,30,1.32,25.0,10,43,19.5,Trop Facile,Trop Difficile,Trop Facile / Trop Difficile
2030,371,2017,Art,4,6,QCU,0.9179,0.03,0.94,44,40,40,0,1.1,100.0,40,4,91.79,Trop Facile,Trop Facile,Trop Facile / Trop Facile
2860,371,2018,Art,4,6,QCU,0.9843,0.03,0.92,38,38,37,1,1.0,97.37,37,1,98.43,Trop Facile,Trop Facile,Trop Facile / Trop Facile
3690,371,2019,Art,4,6,QCU,0.9587,0.07,1.0,33,32,32,0,1.03,100.0,32,1,95.87,Trop Facile,Trop Facile,Trop Facile / Trop Facile
4520,371,2020,Art,4,6,QCU,0.9303,0.06,0.96,30,28,28,0,1.07,100.0,28,2,93.03,Trop Facile,Trop Facile,Trop Facile / Trop Facile
371,372,2015,Art,4,7,QROC,0.7256,0.28,0.32,8,6,6,0,1.33,100.0,6,2,72.56,Trop Difficile,Adapte,Trop Difficile / Adapte
1201,372,2016,Art,4,7,QROC,0.6862,0.4,0.32,7,7,5,2,1.0,71.43,5,2,68.62,Adapte,Adapte,Adapte / Adapte
2031,372,2017,Art,4,7,QROC,0.6859,0.37,0.28,7,5,5,0,1.4,100.0,5,2,68.59,Adapte,Adapte,Adapte / Adapte
2861,372,2018,Art,4,7,QROC,0.6232,0.32,0.31,7,5,4,1,1.4,80.0,4,3,62.32,Adapte,Adapte,Adapte / Adapte
3691,372,2019,Art,4,7,QROC,0.6611,0.46,0.28,8,7,5,2,1.14,71.43,5,3,66.11,Adapte,Adapte,Adapte / Adapte
4521,372,2020,Art,4,7,QROC,0.6318,0.37,0.26,8,6,5,1,1.33,83.33,5,3,63.18,Adapte,Adapte,Adapte / Adapte
372,373,2015,Art,4,8,QCM,0.7757,0.03,0.71,52,49,40,9,1.06,81.63,40,12,77.57,Facile,Facile,Facile / Facile
1202,373,2016,Art,4,8,QCM,0.9327,0.08,0.95,54,51,50,1,1.06,98.04,50,4,93.27,Trop Facile,Trop Facile,Trop Facile / Trop Facile
2032,373,2017,Art,4,8,QCM,0.8995,0.09,0.91,53,48,48,0,1.1,100.0,48,5,89.95,Trop Facile,Trop Facile,Trop Facile / Trop Facile
2862,373,2018,Art,4,8,QCM,0.3459,0.05,0.37,56,52,19,33,1.08,36.54,19,37,34.59,Trop Facile,Difficile,Trop Facile / Difficile
3692,373,2019,Art,4,8,QCM,0.9494,0.09,0.85,62,60,59,1,1.03,98.33,59,3,94.94,Trop Facile,Trop Facile,Trop Facile / Trop Facile
4522,373,2020,Art,4,8,QCM,0.9176,0.03,1.0,52,48,48,0,1.08,100.0,48,4,91.76,Trop Facile,Trop Facile,Trop Facile / Trop Facile
373,374,2015,Art,4,9,QO,0.1168,0.91,0.03,25,22,3,19,1.14,13.64,3,22,11.68,Trop Difficile,Trop Difficile,Trop Difficile / Trop Difficile
1203,374,2016,Art,4,9,QO,0.9842,0.07,0.53,22,22,22,0,1.0,100.0,22,0,98.42,Trop Facile,Trop Facile,Trop Facile / Trop Facile
2033,374,2017,Art,4,9,QO,0.8606,0.05,0.62,21,19,18,1,1.11,94.74,18,3,86.06,Trop Facile,Trop Facile,Trop Facile / Trop Facile
2863,374,2018,Art,4,9,QO,0.6625,0.36,0.28,21,17,14,3,1.24,82.35,14,7,66.25,Trop Facile,Adapte,Trop Facile / Adapte
3693,374,2019,Art,4,9,QO,0.6176,0.54,0.21,19,17,12,5,1.12,70.59,12,7,61.76,Adapte,Adapte,Adapte / Adapte
4523,374,2020,Art,4,9,QO,0.6463,0.24,0.22,18,12,12,0,1.5,100.0,12,6,64.63,Adapte,Adapte,Adapte / Adapte
374,375,2015,Art,4,10,QROC,0.9528,0.09,0.9,94,90,90,0,1.04,100.0,90,4,95.28,Facile,Trop Facile,Facile / Trop Facile
1204,375,2016,Art,4,10,QROC,0.9604,0.05,0.69,104,104,100,4,1.0,96.15,100,4,96.04,Trop Facile,Trop Facile,Trop Facile / Trop Facile
2034,375,2017,Art,4,10,QROC,0.7059,0.23,0.26,90,68,64,4,1.32,94.12,64,26,70.59,Trop Facile,Adapte,Trop Facile / Adapte
2864,375,2018,Art,4,10,QROC,0.6621,0.22,0.36,91,89,60,29,1.02,67.42,60,31,66.21,Adapte,Adapte,Adapte / Adapte
3694,375,2019,Art,4,10,QROC,0.6388,0.42,0.35,97,77,62,15,1.26,80.52,62,35,63.88,Adapte,Adapte,Adapte / Adapte
4524,375,2020,Art,4,10,QROC,0.6409,0.46,0.3,89,65,57,8,1.37,87.69,57,32,64.09,Adapte,Adapte,Adapte / Adapte
375,376,2015,Art,4,11,QCM,0.9255,0.06,0.82,73,72,68,4,1.01,94.44,68,5,92.55,Trop Facile,Trop Facile,Trop Facile / Trop Facile
1205,376,2016,Art,4,11,QCM,0.8753,0.08,0.91,65,60,57,3,1.08,95.0,57,8,87.53,Trop Facile,Trop Facile,Trop Facile / Trop Facile
2035,376,2017,Art,4,11,QCM,0.9213,0.08,0.9,63,60,58,2,1.05,96.67,58,5,92.13,Trop Facile,Trop Facile,Trop Facile / Trop Facile
2865,376,2018,Art,4,11,QCM,0.9104,0.0,0.82,62,59,56,3,1.05,94.92,56,6,91.04,Trop Facile,Trop Facile,Trop Facile / Trop Facile
3695,376,2019,Art,4,11,QCM,0.8837,0.02,0.98,62,61,55,6,1.02,90.16,55,7,88.37,Trop Facile,Trop Facile,Trop Facile / Trop Facile
4525,376,2020,Art,4,11,QCM,0.8994,0.09,0.83,57,54,51,3,1.06,94.44,51,6,89.94,Trop Facile,Trop Facile,Trop Facile / Trop Facile
376,377,2015,Art,4,12,QCU,0.7699,0.13,0.88,89,82,69,13,1.09,84.15,69,20,76.99,Adapte,Facile,Adapte / Facile
1206,377,2016,Art,4,12,QCU,0.6593,0.25,0.48,97,78,64,14,1.24,82.05,64,33,65.93,Trop Facile,Adapte,Trop Facile / Adapte
2036,377,2017,Art,4,12,QCU,0.7099,0.1,0.41,83,81,59,22,1.02,72.84,59,24,70.99,Adapte,Adapte,Adapte / Adapte
2866,377,2018,Art,4,12,QCU,0.7223,0.05,0.53,98,87,71,16,1.13,81.61,71,27,72.23,Adapte,Adapte,Adapte / Adapte
3696,377,2019,Art,4,12,QCU,0.7329,0.11,0.4,102,101,75,26,1.01,74.26,75,27,73.29,Adapte,Adapte,Adapte / Adapte
4526,377,2020,Art,4,12,QCU,0.6589,0.08,0.6,86,80,57,23,1.07,71.25,57,29,65.89,Adapte,Adapte,Adapte / Adapte
377,378,2015,Art,4,13,QCU,0.7678,0.12,0.81,97,75,74,1,1.29,98.67,74,23,76.78,Facile,Facile,Facile / Facile
1207,378,2016,Art,4,13,QCU,0.9562,0.08,0.97,82,79,78,1,1.04,98.73,78,4,95.62,Trop Facile,Trop Facile,Trop Facile / Trop Facile
2037,378,2017,Art,4,13,QCU,0.9721,0.01,0.94,90,89,87,2,1.01,97.75,87,3,97.21,Trop Facile,Trop Facile,Trop Facile / Trop Facile
2867,378,2018,Art,4,13,QCU,0.9638,0.05,0.91,99,98,95,3,1.01,96.94,95,4,96.38,Trop Facile,Trop Facile,Trop Facile / Trop Facile
3697,378,2019,Art,4,13,QCU,0.9764,0.07,0.96,105,104,103,1,1.01,99.04,103,2,97.64,Trop Facile,Trop Facile,Trop Facile / Trop Facile
4527,378,2020,Art,4,13,QCU,0.8814,0.01,0.9,118,113,104,9,1.04,92.04,104,14,88.14,Trop Facile,Trop Facile,Trop Facile / Trop Facile
378,379,2015,Art,5,1,QCM,0.2789,0.43,0.32,99,55,28,27,1.8,50.91,28,71,27.89,Difficile,Difficile,Difficile / Difficile
1208,379,2016,Art,5,1,QCM,0.4321,0.19,0.35,86,80,37,43,1.07,46.25,37,49,43.21,Trop Facile,Difficile,Trop Facile / Difficile
2038,379,2017,Art,5,1,QCM,0.9032,0.0,0.88,88,84,79,5,1.05,94.05,79,9,90.32,Trop Facile,Trop Facile,Trop Facile / Trop Facile
2868,379,2018,Art,5,1,QCM,0.3736,0.1,0.39,78,32,29,3,2.44,90.62,29,49,37.36,Trop Facile,Difficile,Trop Facile / Difficile
3698,379,2019,Art,5,1,QCM,0.6079,0.05,0.69,77,52,47,5,1.48,90.38,47,30,60.79,Trop Facile,Adapte,Trop Facile / Adapte
4528,379,2020,Art,5,1,QCM,0.7461,0.03,0.67,63,58,47,11,1.09,81.03,47,16,74.61,Adapte,Adapte,Adapte / Adapte
379,380,2015,Art,5,2,QCU,0.3773,0.27,0.33,16,14,6,8,1.14,42.86,6,10,37.73,Difficile,Difficile,Difficile / Difficile
1209,380,2016,Art,5,2,QCU,0.9965,0.06,0.94,14,14,14,0,1.0,100.0,14,0,99.65,Trop Facile,Trop Facile,Trop Facile / Trop Facile
2039,380,2017,Art,5,2,QCU,0.3007,0.29,0.33,11,5,3,2,2.2,60.0,3,8,30.07,Trop Facile,Difficile,Trop Facile / Difficile
2869,380,2018,Art,5,2,QCU,0.9593,0.09,0.9,10,10,10,0,1.0,100.0,10,0,95.93,Trop Facile,Trop Facile,Trop Facile / Trop Facile
3699,380,2019,Art,5,2,QCU,0.94,0.05,0.97,10,10,9,1,1.0,90.0,9,1,94.0,Trop Facile,Trop Facile,Trop Facile / Trop Facile
4529,380,2020,Art,5,2,QCU,0.9928,0.02,0.94,8,8,8,0,1.0,100.0,8,0,99.28,Trop Facile,Trop Facile,Trop Facile / Trop Facile
380,381,2015,Art,5,3,QCU,0.0219,0.69,0.22,31,13,1,12,2.38,7.69,1,30,2.19,Difficile,Trop Difficile,Difficile / Trop Difficile
1210,381,2016,Art,5,3,QCU,0.9521,0.01,0.9,30,30,29,1,1.0,96.67,29,1,95.21,Trop Facile,Trop Facile,Trop Facile / Trop Facile
2040,381,2017,Art,5,3,QCU,0.6376,0.26,0.63,34,24,22,2,1.42,91.67,22,12,63.76,Trop Facile,Adapte,Trop Facile / Adapte
2870,381,2018,Art,5,3,QCU,0.6103,0.18,0.59,30,23,18,5,1.3,78.26,18,12,61.03,Adapte,Adapte,Adapte / Adapte
3700,381,2019,Art,5,3,QCU,0.6159,0.05,0.52,26,25,16,9,1.04,64.0,16,10,61.59,Adapte,Adapte,Adapte / Adapte
4530,381,2020,Art,5,3,QCU,0.6339,0.28,0.66,21,16,13,3,1.31,81.25,13,8,63.39,Adapte,Adapte,Adapte / Adapte
381,382,2015,Art,6,1,QCM,0.8877,0.07,0.99,34,34,30,4,1.0,88.24,30,4,88.77,Facile,Trop Facile,Facile / Trop Facile
1211,382,2016,Art,6,1,QCM,0.928,0.08,0.84,36,36,33,3,1.0,91.67,33,3,92.8,Trop Facile,Trop Facile,Trop Facile / Trop Facile
2041,382,2017,Art,6,1,QCM,0.3751,0.17,0.31,34,20,13,7,1.7,65.0,13,21,37.51,Trop Facile,Difficile,Trop Facile / Difficile
2871,382,2018,Art,6,1,QCM,0.9292,0.06,0.81,29,29,27,2,1.0,93.1,27,2,92.92,Trop Facile,Trop Facile,Trop Facile / Trop Facile
3701,382,2019,Art,6,1,QCM,0.8807,0.07,0.98,34,34,30,4,1.0,88.24,30,4,88.07,Trop Facile,Trop Facile,Trop Facile / Trop Facile
4531,382,2020,Art,6,1,QCM,0.4519,0.33,0.33,35,34,16,18,1.03,47.06,16,19,45.19,Trop Facile,Difficile,Trop Facile / Difficile
382,383,2015,Art,6,2,QO,0.1263,0.98,0.06,88,74,11,63,1.19,14.86,11,77,12.63,Trop Difficile,Trop Difficile,Trop Difficile / Trop Difficile
1212,383,2016,Art,6,2,QO,0.9091,0.08,0.8,72,69,65,4,1.04,94.2,65,7,90.91,Trop Facile,Trop Facile,Trop Facile / Trop Facile
2042,383,2017,Art,6,2,QO,0.8992,0.01,0.84,73,71,66,5,1.03,92.96,66,7,89.92,Trop Facile,Trop Facile,Trop Facile / Trop Facile
2872,383,2018,Art,6,2,QO,0.9075,0.09,0.7,75,75,68,7,1.0,90.67,68,7,90.75,Trop Facile,Trop Facile,Trop Facile / Trop Facile
3702,383,2019,Art,6,2,QO,0.4492,0.79,0.06,68,47,31,16,1.45,65.96,31,37,44.92,Trop Facile,Difficile,Trop Facile / Difficile
4532,383,2020,Art,6,2,QO,0.9841,0.08,0.9,65,64,64,0,1.02,100.0,64,1,98.41,Trop Facile,Trop Facile,Trop Facile / Trop Facile
383,384,2015,Art,6,3,QCU,0.7816,0.13,0.76,81,79,63,16,1.03,79.75,63,18,78.16,Facile,Facile,Facile / Facile
1213,384,2016,Art,6,3,QCU,0.9549,0.07,0.92,88,86,84,2,1.02,97.67,84,4,95.49,Trop Facile,Trop Facile,Trop Facile / Trop Facile
2043,384,2017,Art,6,3,QCU,0.7727,0.04,0.87,82,72,63,9,1.14,87.5,63,19,77.27,Trop Facile,Facile,Trop Facile / Facile
2873,384,2018,Art,6,3,QCU,0.4233,0.4,0.34,78,46,33,13,1.7,71.74,33,45,42.33,Trop Facile,Difficile,Trop Facile / Difficile
3703,384,2019,Art,6,3,QCU,0.8759,0.01,0.94,64,61,56,5,1.05,91.8,56,8,87.59,Trop Facile,Trop Facile,Trop Facile / Trop Facile
4533,384,2020,Art,6,3,QCU,0.8451,0.05,0.84,70,61,59,2,1.15,96.72,59,11,84.51,Trop Facile,Facile,Trop Facile / Facile
384,385,2015,Art,6,4,QCM,0.8235,0.13,0.76,43,42,35,7,1.02,83.33,35,8,82.35,Difficile,Facile,Difficile / Facile
1214,385,2016,Art,6,4,QCM,0.8769,0.06,0.84,38,35,33,2,1.09,94.29,33,5,87.69,Trop Facile,Trop Facile,Trop Facile / Trop Facile
2044,385,2017,Art,6,4,QCM,0.262,0.34,0.31,41,19,11,8,2.16,57.89,11,30,26.2,Trop Facile,Difficile,Trop Facile / Difficile
2874,385,2018,Art,6,4,QCM,0.8804,0.09,0.82,49,44,43,1,1.11,97.73,43,6,88.04,Trop Facile,Trop Facile,Trop Facile / Trop Facile
3704,385,2019,Art,6,4,QCM,0.1564,0.35,0.28,49,16,8,8,3.06,50.0,8,41,15.64,Trop Facile,Trop Difficile,Trop Facile / Trop Difficile
4534,385,2020,Art,6,4,QCM,0.6312,0.19,0.57,45,32,28,4,1.41,87.5,28,17,63.12,Trop Facile,Adapte,Trop Facile / Adapte
385,386,2015,Art,6,5,QCU,0.8365,0.06,0.87,78,66,65,1,1.18,98.48,65,13,83.65,Facile,Facile,Facile / Facile
1215,386,2016,Art,6,5,QCU,0.7046,0.19,0.6,64,60,45,15,1.07,75.0,45,19,70.46,Trop Facile,Adapte,Trop Facile / Adapte
2045,386,2017,Art,6,5,QCU,0.7493,0.13,0.58,51,44,38,6,1.16,86.36,38,13,74.93,Adapte,Adapte,Adapte / Adapte
2875,386,2018,Art,6,5,QCU,0.6966,0.07,0.52,60,49,42,7,1.22,85.71,42,18,69.66,Adapte,Adapte,Adapte / Adapte
3705,386,2019,Art,6,5,QCU,0.653,0.26,0.47,54,40,35,5,1.35,87.5,35,19,65.3,Adapte,Adapte,Adapte / Adapte
4535,386,2020,Art,6,5,QCU,0.7073,0.01,0.49,52,50,37,13,1.04,74.0,37,15,70.73,Adapte,Adapte,Adapte / Adapte
386,387,2015,Art,6,6,QCU,0.8724,0.05,0.94,57,54,50,4,1.06,92.59,50,7,87.24,Trop Facile,Trop Facile,Trop Facile / Trop Facile
1216,387,2016,Art,6,6,QCU,0.9203,0.06,1.0,57,53,52,1,1.08,98.11,52,5,92.03,Trop Facile,Trop Facile,Trop Facile / Trop Facile
2046,387,2017,Art,6,6,QCU,0.9467,0.05,0.97,58,56,55,1,1.04,98.21,55,3,94.67,Trop Facile,Trop Facile,Trop Facile / Trop Facile
2876,387,2018,Art,6,6,QCU,0.9336,0.04,0.92,54,51,50,1,1.06,98.04,50,4,93.36,Trop Facile,Trop Facile,Trop Facile / Trop Facile
3706,387,2019,Art,6,6,QCU,0.8671,0.0,0.92,58,52,50,2,1.12,96.15,50,8,86.71,Trop Facile,Trop Facile,Trop Facile / Trop Facile
4536,387,2020,Art,6,6,QCU,0.8696,0.01,0.9,64,59,56,3,1.08,94.92,56,8,86.96,Trop Facile,Trop Facile,Trop Facile / Trop Facile
387,388,2015,Art,6,7,QCM,0.8393,0.08,0.72,46,46,39,7,1.0,84.78,39,7,83.93,Facile,Facile,Facile / Facile
1217,388,2016,Art,6,7,QCM,0.991,0.01,0.83,54,54,54,0,1.0,100.0,54,0,99.1,Trop Facile,Trop Facile,Trop Facile / Trop Facile
2047,388,2017,Art,6,7,QCM,0.9329,0.05,0.99,60,59,56,3,1.02,94.92,56,4,93.29,Trop Facile,Trop Facile,Trop Facile / Trop Facile
2877,388,2018,Art,6,7,QCM,0.8216,0.09,0.77,52,50,43,7,1.04,86.0,43,9,82.16,Trop Facile,Facile,Trop Facile / Facile
3707,388,2019,Art,6,7,QCM,0.233,0.03,0.21,55,19,13,6,2.89,68.42,13,42,23.3,Trop Facile,Trop Difficile,Trop Facile / Trop Difficile
4537,388,2020,Art,6,7,QCM,0.0004,0.35,0.24,49,29,0,29,1.69,0.0,0,49,0.04,Trop Facile,Trop Difficile,Trop Facile / Trop Difficile
388,389,2015,Art,6,8,QROC,0.6205,0.2,0.32,68,49,42,7,1.39,85.71,42,26,62.05,Adapte,Adapte,Adapte / Adapte
1218,389,2016,Art,6,8,QROC,0.6248,0.29,0.36,57,40,36,4,1.43,90.0,36,21,62.48,Adapte,Adapte,Adapte / Adapte
2048,389,2017,Art,6,8,QROC,0.6731,0.27,0.33,66,60,44,16,1.1,73.33,44,22,67.31,Adapte,Adapte,Adapte / Adapte
2878,389,2018,Art,6,8,QROC,0.6361,0.28,0.35,71,58,45,13,1.22,77.59,45,26,63.61,Adapte,Adapte,Adapte / Adapte
3708,389,2019,Art,6,8,QROC,0.7073,0.36,0.31,60,56,42,14,1.07,75.0,42,18,70.73,Adapte,Adapte,Adapte / Adapte
4538,389,2020,Art,6,8,QROC,0.672,0.38,0.31,54,49,36,13,1.1,73.47,36,18,67.2,Adapte,Adapte,Adapte / Adapte
389,390,2015,Art,7,1,QCU,0.7865,0.12,0.77,76,67,60,7,1.13,89.55,60,16,78.65,Facile,Facile,Facile / Facile
1219,390,2016,Art,7,1,QCU,0.8735,0.02,0.94,80,78,70,8,1.03,89.74,70,10,87.35,Trop Facile,Trop Facile,Trop Facile / Trop Facile
2049,390,2017,Art,7,1,QCU,0.1289,0.45,0.25,82,67,11,56,1.22,16.42,11,71,12.89,Trop Facile,Trop Difficile,Trop Facile / Trop Difficile
2879,390,2018,Art,7,1,QCU,0.9172,0.08,0.92,96,91,88,3,1.05,96.7,88,8,91.72,Trop Facile,Trop Facile,Trop Facile / Trop Facile
3709,390,2019,Art,7,1,QCU,0.9016,0.08,0.91,83,79,75,4,1.05,94.94,75,8,90.16,Trop Facile,Trop Facile,Trop Facile / Trop Facile
4539,390,2020,Art,7,1,QCU,0.8774,0.04,0.91,100,97,88,9,1.03,90.72,88,12,87.74,Trop Facile,Trop Facile,Trop Facile / Trop Facile
390,391,2015,Art,7,2,QROC,0.5194,0.54,0.24,66,55,34,21,1.2,61.82,34,32,51.94,Difficile,Difficile,Difficile / Difficile
1220,391,2016,Art,7,2,QROC,0.1351,0.76,0.09,71,69,10,59,1.03,14.49,10,61,13.51,Trop Facile,Trop Difficile,Trop Facile / Trop Difficile
2050,391,2017,Art,7,2,QROC,0.9422,0.01,0.77,60,59,57,2,1.02,96.61,57,3,94.22,Trop Facile,Trop Facile,Trop Facile / Trop Facile
2880,391,2018,Art,7,2,QROC,0.9889,0.0,0.99,72,72,71,1,1.0,98.61,71,1,98.89,Trop Facile,Trop Facile,Trop Facile / Trop Facile
3710,391,2019,Art,7,2,QROC,0.9147,0.09,0.91,86,79,79,0,1.09,100.0,79,7,91.47,Trop Facile,Trop Facile,Trop Facile / Trop Facile
4540,391,2020,Art,7,2,QROC,0.9526,0.05,0.74,77,74,73,1,1.04,98.65,73,4,95.26,Trop Facile,Trop Facile,Trop Facile / Trop Facile
391,392,2015,Art,7,3,QCM,0.75,0.29,0.48,97,96,73,23,1.01,76.04,73,24,75.0,Adapte,Adapte,Adapte / Adapte
1221,392,2016,Art,7,3,QCM,0.6588,0.14,0.68,81,76,53,23,1.07,69.74,53,28,65.88,Adapte,Adapte,Adapte / Adapte
2051,392,2017,Art,7,3,QCM,0.6716,0.14,0.59,71,56,48,8,1.27,85.71,48,23,67.16,Adapte,Adapte,Adapte / Adapte
2881,392,2018,Art,7,3,QCM,0.6195,0.3,0.53,62,57,38,19,1.09,66.67,38,24,61.95,Adapte,Adapte,Adapte / Adapte
3711,392,2019,Art,7,3,QCM,0.647,0.23,0.54,50,39,32,7,1.28,82.05,32,18,64.7,Adapte,Adapte,Adapte / Adapte
4541,392,2020,Art,7,3,QCM,0.676,0.03,0.65,57,41,39,2,1.39,95.12,39,18,67.6,Adapte,Adapte,Adapte / Adapte
392,393,2015,Art,7,4,QCU,0.3579,0.31,0.32,37,24,13,11,1.54,54.17,13,24,35.79,Difficile,Difficile,Difficile / Difficile
1222,393,2016,Art,7,4,QCU,0.9209,0.02,0.92,37,36,34,2,1.03,94.44,34,3,92.09,Trop Facile,Trop Facile,Trop Facile / Trop Facile
2052,393,2017,Art,7,4,QCU,0.62,0.14,0.47,37,30,23,7,1.23,76.67,23,14,62.0,Trop Facile,Adapte,Trop Facile / Adapte
2882,393,2018,Art,7,4,QCU,0.6902,0.1,0.66,41,28,28,0,1.46,100.0,28,13,69.02,Adapte,Adapte,Adapte / Adapte
3712,393,2019,Art,7,4,QCU,0.7353,0.22,0.49,34,30,25,5,1.13,83.33,25,9,73.53,Adapte,Adapte,Adapte / Adapte
4542,393,2020,Art,7,4,QCU,0.6282,0.24,0.43,37,33,23,10,1.12,69.7,23,14,62.82,Adapte,Adapte,Adapte / Adapte
393,394,2015,Art,7,5,QROC,0.4913,0.54,0.25,87,84,43,41,1.04,51.19,43,44,49.13,Difficile,Difficile,Difficile / Difficile
1223,394,2016,Art,7,5,QROC,0.7802,0.16,0.65,84,77,66,11,1.09,85.71,66,18,78.02,Trop Facile,Facile,Trop Facile / Facile
2053,394,2017,Art,7,5,QROC,0.8783,0.04,0.53,80,72,70,2,1.11,97.22,70,10,87.83,Trop Facile,Trop Facile,Trop Facile / Trop Facile
2883,394,2018,Art,7,5,QROC,0.9173,0.05,0.88,78,74,72,2,1.05,97.3,72,6,91.73,Trop Facile,Trop Facile,Trop Facile / Trop Facile
3713,394,2019,Art,7,5,QROC,0.9855,0.06,0.54,82,82,81,1,1.0,98.78,81,1,98.55,Trop Facile,Trop Facile,Trop Facile / Trop Facile
4543,394,2020,Art,7,5,QROC,0.7861,0.14,0.57,97,86,76,10,1.13,88.37,76,21,78.61,Trop Facile,Facile,Trop Facile / Facile
394,395,2015,Art,8,1,QROC,0.3341,0.57,0.17,65,51,22,29,1.27,43.14,22,43,33.41,Difficile,Difficile,Difficile / Difficile
1224,395,2016,Art,8,1,QROC,0.8924,0.05,0.96,74,72,66,6,1.03,91.67,66,8,89.24,Trop Facile,Trop Facile,Trop Facile / Trop Facile
2054,395,2017,Art,8,1,QROC,0.9233,0.06,0.67,77,72,71,1,1.07,98.61,71,6,92.33,Trop Facile,Trop Facile,Trop Facile / Trop Facile
2884,395,2018,Art,8,1,QROC,0.9992,0.04,0.75,72,72,72,0,1.0,100.0,72,0,99.92,Trop Facile,Trop Facile,Trop Facile / Trop Facile
3714,395,2019,Art,8,1,QROC,0.9406,0.04,0.83,84,81,79,2,1.04,97.53,79,5,94.06,Trop Facile,Trop Facile,Trop Facile / Trop Facile
4544,395,2020,Art,8,1,QROC,0.0499,0.86,0.14,101,48,5,43,2.1,10.42,5,96,4.99,Trop Facile,Trop Difficile,Trop Facile / Trop Difficile
395,396,2015,Art,8,2,QCM,0.9057,0.0,0.98,43,40,39,1,1.07,97.5,39,4,90.57,Trop Difficile,Trop Facile,Trop Difficile / Trop Facile
1225,396,2016,Art,8,2,QCM,0.9567,0.02,0.87,49,47,47,0,1.04,100.0,47,2,95.67,Trop Facile,Trop Facile,Trop Facile / Trop Facile
2055,396,2017,Art,8,2,QCM,0.9978,0.05,1.0,51,51,51,0,1.0,100.0,51,0,99.78,Trop Facile,Trop Facile,Trop Facile / Trop Facile
2885,396,2018,Art,8,2,QCM,0.9839,0.04,0.82,44,44,43,1,1.0,97.73,43,1,98.39,Trop Facile,Trop Facile,Trop Facile / Trop Facile
3715,396,2019,Art,8,2,QCM,0.8237,0.1,0.78,53,47,44,3,1.13,93.62,44,9,82.37,Trop Facile,Facile,Trop Facile / Facile
4545,396,2020,Art,8,2,QCM,0.8927,0.02,0.84,61,55,54,1,1.11,98.18,54,7,89.27,Trop Facile,Trop Facile,Trop Facile / Trop Facile
396,397,2015,Art,8,3,QCM,0.8364,0.07,0.72,96,94,80,14,1.02,85.11,80,16,83.64,Difficile,Facile,Difficile / Facile
1226,397,2016,Art,8,3,QCM,0.8997,0.08,0.83,108,105,97,8,1.03,92.38,97,11,89.97,Trop Facile,Trop Facile,Trop Facile / Trop Facile
2056,397,2017,Art,8,3,QCM,0.1892,0.14,0.23,112,93,21,72,1.2,22.58,21,91,18.92,Trop Facile,Trop Difficile,Trop Facile / Trop Difficile
2886,397,2018,Art,8,3,QCM,0.9728,0.04,0.8,132,131,128,3,1.01,97.71,128,4,97.28,Trop Facile,Trop Facile,Trop Facile / Trop Facile
3716,397,2019,Art,8,3,QCM,0.8925,0.04,0.98,132,128,118,10,1.03,92.19,118,14,89.25,Trop Facile,Trop Facile,Trop Facile / Trop Facile
4546,397,2020,Art,8,3,QCM,0.9383,0.05,0.8,126,119,118,1,1.06,99.16,118,8,93.83,Trop Facile,Trop Facile,Trop Facile / Trop Facile
397,398,2015,Art,8,4,QCM,0.7405,0.04,0.4,22,19,16,3,1.16,84.21,16,6,74.05,Facile,Adapte,Facile / Adapte
1227,398,2016,Art,8,4,QCM,0.6048,0.02,0.48,25,17,15,2,1.47,88.24,15,10,60.48,Adapte,Adapte,Adapte / Adapte
2057,398,2017,Art,8,4,QCM,0.6833,0.27,0.51,23,16,16,0,1.44,100.0,16,7,68.33,Adapte,Adapte,Adapte / Adapte
2887,398,2018,Art,8,4,QCM,0.6155,0.27,0.49,19,19,12,7,1.0,63.16,12,7,61.55,Adapte,Adapte,Adapte / Adapte
3717,398,2019,Art,8,4,QCM,0.704,0.23,0.54,23,20,16,4,1.15,80.0,16,7,70.4,Adapte,Adapte,Adapte / Adapte
4547,398,2020,Art,8,4,QCM,0.6753,0.23,0.53,20,15,14,1,1.33,93.33,14,6,67.53,Adapte,Adapte,Adapte / Adapte
398,399,2015,Art,8,5,QCM,0.0543,0.28,0.25,20,10,1,9,2.0,10.0,1,19,5.43,Trop Difficile,Trop Difficile,Trop Difficile / Trop Difficile
1228,399,2016,Art,8,5,QCM,0.8644,0.0,0.99,22,19,19,0,1.16,100.0,19,3,86.44,Trop Facile,Trop Facile,Trop Facile / Trop Facile
2058,399,2017,Art,8,5,QCM,0.8691,0.02,0.9,20,18,17,1,1.11,94.44,17,3,86.91,Trop Facile,Trop Facile,Trop Facile / Trop Facile
2888,399,2018,Art,8,5,QCM,0.0699,0.59,0.26,24,15,2,13,1.6,13.33,2,22,6.99,Trop Facile,Trop Difficile,Trop Facile / Trop Difficile
3718,399,2019,Art,8,5,QCM,0.1814,0.16,0.2,26,10,5,5,2.6,50.0,5,21,18.14,Trop Facile,Trop Difficile,Trop Facile / Trop Difficile
4548,399,2020,Art,8,5,QCM,0.9044,0.1,0.81,22,22,20,2,1.0,90.91,20,2,90.44,Trop Facile,Trop Facile,Trop Facile / Trop Facile
399,400,2015,Art,8,6,QCU,0.0688,0.74,0.2,96,78,7,71,1.23,8.97,7,89,6.88,Trop Facile,Trop Difficile,Trop Facile / Trop Difficile
1229,400,2016,Art,8,6,QCU,0.8645,0.04,0.94,87,86,75,11,1.01,87.21,75,12,86.45,Trop Facile,Trop Facile,Trop Facile / Trop Facile
2059,400,2017,Art,8,6,QCU,0.0039,0.61,0.29,104,89,0,89,1.17,0.0,0,104,0.39,Trop Facile,Trop Difficile,Trop Facile / Trop Difficile
2889,400,2018,Art,8,6,QCU,0.9597,0.04,0.91,90,87,86,1,1.03,98.85,86,4,95.97,Trop Facile,Trop Facile,Trop Facile / Trop Facile
3719,400,2019,Art,8,6,QCU,0.979,0.09,0.92,99,98,97,1,1.01,98.98,97,2,97.9,Trop Facile,Trop Facile,Trop Facile / Trop Facile
4549,400,2020,Art,8,6,QCU,0.8371,0.05,0.77,98,92,82,10,1.07,89.13,82,16,83.71,Trop Facile,Facile,Trop Facile / Facile
400,401,2015,Art,8,7,QROC,0.2331,0.89,0.02,48,45,11,34,1.07,24.44,11,37,23.31,Trop Difficile,Trop Difficile,Trop Difficile / Trop Difficile
1230,401,2016,Art,8,7,QROC,0.9311,0.05,0.74,46,44,43,1,1.05,97.73,43,3,93.11,Trop Facile,Trop Facile,Trop Facile / Trop Facile
2060,401,2017,Art,8,7,QROC,0.9843,0.0,0.62,40,40,39,1,1.0,97.5,39,1,98.43,Trop Facile,Trop Facile,Trop Facile / Trop Facile
2890,401,2018,Art,8,7,QROC,0.6716,0.29,0.25,40,36,27,9,1.11,75.0,27,13,67.16,Trop Facile,Adapte,Trop Facile / Adapte
3720,401,2019,Art,8,7,QROC,0.6656,0.34,0.29,35,25,23,2,1.4,92.0,23,12,66.56,Adapte,Adapte,Adapte / Adapte
4550,401,2020,Art,8,7,QROC,0.6679,0.44,0.34,34,28,23,5,1.21,82.14,23,11,66.79,Adapte,Adapte,Adapte / Adapte
401,402,2015,Art,9,1,QCU,0.8284,0.14,0.87,29,26,24,2,1.12,92.31,24,5,82.84,Facile,Facile,Facile / Facile
1231,402,2016,Art,9,1,QCU,0.8629,0.04,0.96,28,28,24,4,1.0,85.71,24,4,86.29,Trop Facile,Trop Facile,Trop Facile / Trop Facile
2061,402,2017,Art,9,1,QCU,0.9344,0.09,0.93,31,29,29,0,1.07,100.0,29,2,93.44,Trop Facile,Trop Facile,Trop Facile / Trop Facile
2891,402,2018,Art,9,1,QCU,0.981,0.01,0.95,37,36,36,0,1.03,100.0,36,1,98.1,Trop Facile,Trop Facile,Trop Facile / Trop Facile
3721,402,2019,Art,9,1,QCU,0.9373,0.05,0.91,44,41,41,0,1.07,100.0,41,3,93.73,Trop Facile,Trop Facile,Trop Facile / Trop Facile
4551,402,2020,Art,9,1,QCU,0.9179,0.01,0.95,38,35,35,0,1.09,100.0,35,3,91.79,Trop Facile,Trop Facile,Trop Facile / Trop Facile
402,403,2015,Art,9,2,QCU,0.3036,0.02,0.33,71,41,22,19,1.73,53.66,22,49,30.36,Difficile,Difficile,Difficile / Difficile
1232,403,2016,Art,9,2,QCU,0.6231,0.08,0.59,71,53,44,9,1.34,83.02,44,27,62.31,Trop Facile,Adapte,Trop Facile / Adapte
2062,403,2017,Art,9,2,QCU,0.6962,0.24,0.7,70,69,49,20,1.01,71.01,49,21,69.62,Adapte,Adapte,Adapte / Adapte
2892,403,2018,Art,9,2,QCU,0.6416,0.07,0.45,83,55,53,2,1.51,96.36,53,30,64.16,Adapte,Adapte,Adapte / Adapte
3722,403,2019,Art,9,2,QCU,0.701,0.24,0.68,84,61,59,2,1.38,96.72,59,25,70.1,Adapte,Adapte,Adapte / Adapte
4552,403,2020,Art,9,2,QCU,0.6084,0.19,0.58,92,76,56,20,1.21,73.68,56,36,60.84,Adapte,Adapte,Adapte / Adapte
403,404,2015,Art,9,3,QCU,0.3676,0.34,0.34,41,23,15,8,1.78,65.22,15,26,36.76,Difficile,Difficile,Difficile / Difficile
1233,404,2016,Art,9,3,QCU,0.5565,0.18,0.39,40,27,22,5,1.48,81.48,22,18,55.65,Trop Facile,Difficile,Trop Facile / Difficile
2063,404,2017,Art,9,3,QCU,0.9058,0.02,0.96,39,38,35,3,1.03,92.11,35,4,90.58,Trop Facile,Trop Facile,Trop Facile / Trop Facile
2893,404,2018,Art,9,3,QCU,0.9903,0.0,0.97,41,41,41,0,1.0,100.0,41,0,99.03,Trop Facile,Trop Facile,Trop Facile / Trop Facile
3723,404,2019,Art,9,3,QCU,0.7615,0.17,0.76,46,40,35,5,1.15,87.5,35,11,76.15,Trop Facile,Facile,Trop Facile / Facile
4553,404,2020,Art,9,3,QCU,0.8679,0.07,0.94,41,37,36,1,1.11,97.3,36,5,86.79,Trop Facile,Trop Facile,Trop Facile / Trop Facile
404,405,2015,Art,9,4,QCM,0.6537,0.02,0.7,73,65,48,17,1.12,73.85,48,25,65.37,Adapte,Adapte,Adapte / Adapte
1234,405,2016,Art,9,4,QCM,0.6772,0.19,0.65,79,54,53,1,1.46,98.15,53,26,67.72,Adapte,Adapte,Adapte / Adapte
2064,405,2017,Art,9,4,QCM,0.676,0.03,0.46,70,63,47,16,1.11,74.6,47,23,67.6,Adapte,Adapte,Adapte / Adapte
2894,405,2018,Art,9,4,QCM,0.6212,0.21,0.48,62,61,39,22,1.02,63.93,39,23,62.12,Adapte,Adapte,Adapte / Adapte
3724,405,2019,Art,9,4,QCM,0.64,0.08,0.49,63,62,40,22,1.02,64.52,40,23,64.0,Adapte,Adapte,Adapte / Adapte
4554,405,2020,Art,9,4,QCM,0.6413,0.26,0.63,55,45,35,10,1.22,77.78,35,20,64.13,Adapte,Adapte,Adapte / Adapte
405,406,2015,Art,9,5,QCU,0.2173,0.43,0.26,81,42,18,24,1.93,42.86,18,63,21.73,Difficile,Trop Difficile,Difficile / Trop Difficile
1235,406,2016,Art,9,5,QCU,0.9103,0.06,0.95,84,78,76,2,1.08,97.44,76,8,91.03,Trop Facile,Trop Facile,Trop Facile / Trop Facile
2065,406,2017,Art,9,5,QCU,0.9344,0.08,1.0,90,87,84,3,1.03,96.55,84,6,93.44,Trop Facile,Trop Facile,Trop Facile / Trop Facile
2895,406,2018,Art,9,5,QCU,0.8463,0.09,0.88,94,85,80,5,1.11,94.12,80,14,84.63,Trop Facile,Facile,Trop Facile / Facile
3725,406,2019,Art,9,5,QCU,0.9316,0.09,0.94,79,75,74,1,1.05,98.67,74,5,93.16,Trop Facile,Trop Facile,Trop Facile / Trop Facile
4555,406,2020,Art,9,5,QCU,0.5847,0.07,0.33,84,49,49,0,1.71,100.0,49,35,58.47,Trop Facile,Difficile,Trop Facile / Difficile
406,407,2015,Art,9,6,QCM,0.2227,0.29,0.26,59,17,13,4,3.47,76.47,13,46,22.27,Trop Difficile,Trop Difficile,Trop Difficile / Trop Difficile
1236,407,2016,Art,9,6,QCM,0.9754,0.04,0.85,52,51,51,0,1.02,100.0,51,1,97.54,Trop Facile,Trop Facile,Trop Facile / Trop Facile
2066,407,2017,Art,9,6,QCM,0.8919,0.09,0.94,59,53,53,0,1.11,100.0,53,6,89.19,Trop Facile,Trop Facile,Trop Facile / Trop Facile
2896,407,2018,Art,9,6,QCM,0.8631,0.08,0.89,68,62,59,3,1.1,95.16,59,9,86.31,Trop Facile,Trop Facile,Trop Facile / Trop Facile
3726,407,2019,Art,9,6,QCM,0.9328,0.05,0.88,60,59,56,3,1.02,94.92,56,4,93.28,Trop Facile,Trop Facile,Trop Facile / Trop Facile
4556,407,2020,Art,9,6,QCM,0.147,0.68,0.25,50,45,7,38,1.11,15.56,7,43,14.7,Trop Facile,Trop Difficile,Trop Facile / Trop Difficile
407,408,2015,Art,9,7,QCU,0.8355,0.03,0.75,46,38,38,0,1.21,100.0,38,8,83.55,Facile,Facile,Facile / Facile
1237,408,2016,Art,9,7,QCU,0.9544,0.0,0.93,55,53,52,1,1.04,98.11,52,3,95.44,Trop Facile,Trop Facile,Trop Facile / Trop Facile
2067,408,2017,Art,9,7,QCU,0.8708,0.02,0.93,57,56,50,6,1.02,89.29,50,7,87.08,Trop Facile,Trop Facile,Trop Facile / Trop Facile
2897,408,2018,Art,9,7,QCU,0.1264,0.2,0.26,54,35,7,28,1.54,20.0,7,47,12.64,Trop Facile,Trop Difficile,Trop Facile / Trop Difficile
3727,408,2019,Art,9,7,QCU,0.9439,0.01,0.93,57,56,54,2,1.02,96.43,54,3,94.39,Trop Facile,Trop Facile,Trop Facile / Trop Facile
4557,408,2020,Art,9,7,QCU,0.9242,0.04,0.92,49,46,45,1,1.07,97.83,45,4,92.42,Trop Facile,Trop Facile,Trop Facile / Trop Facile
408,409,2015,Art,9,8,QCU,0.7075,0.23,0.46,58,53,41,12,1.09,77.36,41,17,70.75,Difficile,Adapte,Difficile / Adapte
1238,409,2016,Art,9,8,QCU,0.6788,0.14,0.62,56,52,38,14,1.08,73.08,38,18,67.88,Adapte,Adapte,Adapte / Adapte
2068,409,2017,Art,9,8,QCU,0.6872,0.05,0.6,57,39,39,0,1.46,100.0,39,18,68.72,Adapte,Adapte,Adapte / Adapte
2898,409,2018,Art,9,8,QCU,0.704,0.11,0.56,52,40,37,3,1.3,92.5,37,15,70.4,Adapte,Adapte,Adapte / Adapte
3728,409,2019,Art,9,8,QCU,0.6821,0.2,0.64,61,47,42,5,1.3,89.36,42,19,68.21,Adapte,Adapte,Adapte / Adapte
4558,409,2020,Art,9,8,QCU,0.6648,0.07,0.41,59,41,39,2,1.44,95.12,39,20,66.48,Adapte,Adapte,Adapte / Adapte
409,410,2015,Art,10,1,QCM,0.2847,0.06,0.33,53,26,15,11,2.04,57.69,15,38,28.47,Difficile,Difficile,Difficile / Difficile
1239,410,2016,Art,10,1,QCM,0.9821,0.0,0.94,58,58,57,1,1.0,98.28,57,1,98.21,Trop Facile,Trop Facile,Trop Facile / Trop Facile
2069,410,2017,Art,10,1,QCM,0.9858,0.06,0.99,60,59,59,0,1.02,100.0,59,1,98.58,Trop Facile,Trop Facile,Trop Facile / Trop Facile
2899,410,2018,Art,10,1,QCM,0.5892,0.35,0.32,64,50,38,12,1.28,76.0,38,26,58.92,Trop Facile,Difficile,Trop Facile / Difficile
3729,410,2019,Art,10,1,QCM,0.9067,0.07,0.87,56,53,51,2,1.06,96.23,51,5,90.67,Trop Facile,Trop Facile,Trop Facile / Trop Facile
4559,410,2020,Art,10,1,QCM,0.9479,0.04,0.95,65,64,62,2,1.02,96.88,62,3,94.79,Trop Facile,Trop Facile,Trop Facile / Trop Facile
410,411,2015,Art,10,2,QROC,0.9965,0.06,0.66,76,76,76,0,1.0,100.0,76,0,99.65,Trop Difficile,Trop Facile,Trop Difficile / Trop Facile
1240,411,2016,Art,10,2,QROC,0.8265,0.13,0.67,76,70,63,7,1.09,90.0,63,13,82.65,Trop Facile,Facile,Trop Facile / Facile
2070,411,2017,Art,10,2,QROC,0.8399,0.06,0.43,87,83,73,10,1.05,87.95,73,14,83.99,Trop Facile,Facile,Trop Facile / Facile
2900,411,2018,Art,10,2,QROC,0.0052,0.97,0.14,79,57,0,57,1.39,0.0,0,79,0.52,Trop Facile,Trop Difficile,Trop Facile / Trop Difficile
3730,411,2019,Art,10,2,QROC,0.9115,0.01,0.96,77,71,70,1,1.08,98.59,70,7,91.15,Trop Facile,Trop Facile,Trop Facile / Trop Facile
4560,411,2020,Art,10,2,QROC,0.8948,0.09,0.72,80,79,72,7,1.01,91.14,72,8,89.48,Trop Facile,Trop Facile,Trop Facile / Trop Facile
411,412,2015,Art,10,3,QCU,0.2032,0.37,0.23,23,20,5,15,1.15,25.0,5,18,20.32,Trop Difficile,Trop Difficile,Trop Difficile / Trop Difficile
1241,412,2016,Art,10,3,QCU,0.8982,0.08,0.96,27,27,24,3,1.0,88.89,24,3,89.82,Trop Facile,Trop Facile,Trop Facile / Trop Facile
2071,412,2017,Art,10,3,QCU,0.3743,0.39,0.33,29,29,11,18,1.0,37.93,11,18,37.43,Trop Facile,Difficile,Trop Facile / Difficile
2901,412,2018,Art,10,3,QCU,0.9056,0.0,0.97,32,32,29,3,1.0,90.62,29,3,90.56,Trop Facile,Trop Facile,Trop Facile / Trop Facile
3731,412,2019,Art,10,3,QCU,0.3637,0.04,0.32,30,23,11,12,1.3,47.83,11,19,36.37,Trop Facile,Difficile,Trop Facile / Difficile
4561,412,2020,Art,10,3,QCU,0.2564,0.26,0.31,24,15,6,9,1.6,40.0,6,18,25.64,Trop Facile,Difficile,Trop Facile / Difficile
412,413,2015,Art,10,4,QCM,0.8056,0.0,0.76,43,43,35,8,1.0,81.4,35,8,80.56,Facile,Facile,Facile / Facile
1242,413,2016,Art,10,4,QCM,0.8886,0.06,0.84,38,36,34,2,1.06,94.44,34,4,88.86,Trop Facile,Trop Facile,Trop Facile / Trop Facile
2072,413,2017,Art,10,4,QCM,0.0923,0.28,0.25,32,25,3,22,1.28,12.0,3,29,9.23,Trop Facile,Trop Difficile,Trop Facile / Trop Difficile
2902,413,2018,Art,10,4,QCM,0.9325,0.04,0.81,31,29,29,0,1.07,100.0,29,2,93.25,Trop Facile,Trop Facile,Trop Facile / Trop Facile
3732,413,2019,Art,10,4,QCM,0.0486,0.07,0.21,37,31,2,29,1.19,6.45,2,35,4.86,Trop Facile,Trop Difficile,Trop Facile / Trop Difficile
4562,413,2020,Art,10,4,QCM,0.8979,0.04,0.84,37,35,33,2,1.06,94.29,33,4,89.79,Trop Facile,Trop Facile,Trop Facile / Trop Facile
413,414,2015,Art,11,1,QCM,0.0323,0.42,0.24,46,20,1,19,2.3,5.0,1,45,3.23,Difficile,Trop Difficile,Difficile / Trop Difficile
1243,414,2016,Art,11,1,QCM,0.8718,0.04,0.9,41,37,36,1,1.11,97.3,36,5,87.18,Trop Facile,Trop Facile,Trop Facile / Trop Facile
2073,414,2017,Art,11,1,QCM,0.9025,0.07,0.92,36,34,32,2,1.06,94.12,32,4,90.25,Trop Facile,Trop Facile,Trop Facile / Trop Facile
2903,414,2018,Art,11,1,QCM,0.9159,0.07,0.84,40,38,37,1,1.05,97.37,37,3,91.59,Trop Facile,Trop Facile,Trop Facile / Trop Facile
3733,414,2019,Art,11,1,QCM,0.9968,0.06,0.91,32,32,32,0,1.0,100.0,32,0,99.68,Trop Facile,Trop Facile,Trop Facile / Trop Facile
4563,414,2020,Art,11,1,QCM,0.9802,0.1,0.8,28,28,27,1,1.0,96.43,27,1,98.02,Trop Facile,Trop Facile,Trop Facile / Trop Facile
414,415,2015,Art,12,1,QROC,0.3059,0.54,0.24,22,15,7,8,1.47,46.67,7,15,30.59,Difficile,Difficile,Difficile / Difficile
1244,415,2016,Art,12,1,QROC,0.8834,0.05,0.59,23,23,20,3,1.0,86.96,20,3,88.34,Trop Facile,Trop Facile,Trop Facile / Trop Facile
2074,415,2017,Art,12,1,QROC,0.9515,0.04,0.67,19,18,18,0,1.06,100.0,18,1,95.15,Trop Facile,Trop Facile,Trop Facile / Trop Facile
2904,415,2018,Art,12,1,QROC,0.9401,0.05,0.99,20,19,19,0,1.05,100.0,19,1,94.01,Trop Facile,Trop Facile,Trop Facile / Trop Facile
3734,415,2019,Art,12,1,QROC,0.8827,0.04,0.97,20,19,18,1,1.05,94.74,18,2,88.27,Trop Facile,Trop Facile,Trop Facile / Trop Facile
4564,415,2020,Art,12,1,QROC,0.9438,0.07,0.73,17,16,16,0,1.06,100.0,16,1,94.38,Trop Facile,Trop Facile,Trop Facile / Trop Facile
415,416,2015,Art,13,1,QCU,0.5218,0.02,0.39,41,25,21,4,1.64,84.0,21,20,52.18,Difficile,Difficile,Difficile / Difficile
1245,416,2016,Art,13,1,QCU,0.9128,0.01,0.92,39,39,36,3,1.0,92.31,36,3,91.28,Trop Facile,Trop Facile,Trop Facile / Trop Facile
2075,416,2017,Art,13,1,QCU,0.4007,0.18,0.3,43,36,17,19,1.19,47.22,17,26,40.07,Trop Facile,Difficile,Trop Facile / Difficile
2905,416,2018,Art,13,1,QCU,0.9286,0.09,0.94,36,36,33,3,1.0,91.67,33,3,92.86,Trop Facile,Trop Facile,Trop Facile / Trop Facile
3735,416,2019,Art,13,1,QCU,0.9264,0.01,0.97,34,34,31,3,1.0,91.18,31,3,92.64,Trop Facile,Trop Facile,Trop Facile / Trop Facile
4565,416,2020,Art,13,1,QCU,0.9446,0.07,0.92,37,36,35,1,1.03,97.22,35,2,94.46,Trop Facile,Trop Facile,Trop Facile / Trop Facile
416,417,2015,Art,13,2,QCU,0.5864,0.01,0.31,95,62,56,6,1.53,90.32,56,39,58.64,Trop Facile,Difficile,Trop Facile / Difficile
1246,417,2016,Art,13,2,QCU,0.0718,0.29,0.22,79,52,6,46,1.52,11.54,6,73,7.18,Trop Facile,Trop Difficile,Trop Facile / Trop Difficile
2076,417,2017,Art,13,2,QCU,0.949,0.08,0.95,73,71,69,2,1.03,97.18,69,4,94.9,Trop Facile,Trop Facile,Trop Facile / Trop Facile
2906,417,2018,Art,13,2,QCU,0.2626,0.25,0.33,81,37,21,16,2.19,56.76,21,60,26.26,Trop Facile,Difficile,Trop Facile / Difficile
3736,417,2019,Art,13,2,QCU,0.9687,0.1,0.95,93,91,90,1,1.02,98.9,90,3,96.87,Trop Facile,Trop Facile,Trop Facile / Trop Facile
4566,417,2020,Art,13,2,QCU,0.9166,0.07,0.96,89,86,82,4,1.03,95.35,82,7,91.66,Trop Facile,Trop Facile,Trop Facile / Trop Facile
417,418,2015,Art,13,3,QCU,0.5627,0.27,0.38,67,47,38,9,1.43,80.85,38,29,56.27,Facile,Difficile,Facile / Difficile
1247,418,2016,Art,13,3,QCU,0.8952,0.05,0.95,62,56,56,0,1.11,100.0,56,6,89.52,Trop Facile,Trop Facile,Trop Facile / Trop Facile
2077,418,2017,Art,13,3,QCU,0.95,0.07,0.97,53,51,50,1,1.04,98.04,50,3,95.0,Trop Facile,Trop Facile,Trop Facile / Trop Facile
2907,418,2018,Art,13,3,QCU,0.6986,0.09,0.5,59,44,41,3,1.34,93.18,41,18,69.86,Trop Facile,Adapte,Trop Facile / Adapte
3737,418,2019,Art,13,3,QCU,0.7071,0.05,0.6,62,46,44,2,1.35,95.65,44,18,70.71,Adapte,Adapte,Adapte / Adapte
4567,418,2020,Art,13,3,QCU,0.6542,0.08,0.42,64,43,42,1,1.49,97.67,42,22,65.42,Adapte,Adapte,Adapte / Adapte
418,419,2015,Art,13,4,QCU,0.1736,0.32,0.25,61,21,11,10,2.9,52.38,11,50,17.36,Facile,Trop Difficile,Facile / Trop Difficile
1248,419,2016,Art,13,4,QCU,0.8779,0.06,0.93,53,47,47,0,1.13,100.0,47,6,87.79,Trop Facile,Trop Facile,Trop Facile / Trop Facile
2078,419,2017,Art,13,4,QCU,0.4404,0.23,0.37,57,25,25,0,2.28,100.0,25,32,44.04,Trop Facile,Difficile,Trop Facile / Difficile
2908,419,2018,Art,13,4,QCU,0.9989,0.02,0.91,46,46,46,0,1.0,100.0,46,0,99.89,Trop Facile,Trop Facile,Trop Facile / Trop Facile
3738,419,2019,Art,13,4,QCU,0.0447,0.11,0.3,47,26,2,24,1.81,7.69,2,45,4.47,Trop Facile,Trop Difficile,Trop Facile / Trop Difficile
4568,419,2020,Art,13,4,QCU,0.8446,0.14,0.79,41,38,35,3,1.08,92.11,35,6,84.46,Trop Facile,Facile,Trop Facile / Facile
419,420,2015,Art,13,5,QROC,0.9139,0.03,0.78,30,29,27,2,1.03,93.1,27,3,91.39,Difficile,Trop Facile,Difficile / Trop Facile
1249,420,2016,Art,13,5,QROC,0.8896,0.1,0.57,33,32,29,3,1.03,90.62,29,4,88.96,Trop Facile,Trop Facile,Trop Facile / Trop Facile
2079,420,2017,Art,13,5,QROC,0.9285,0.0,0.94,32,30,30,0,1.07,100.0,30,2,92.85,Trop Facile,Trop Facile,Trop Facile / Trop Facile
2909,420,2018,Art,13,5,QROC,0.2534,0.51,0.2,28,20,7,13,1.4,35.0,7,21,25.34,Trop Facile,Difficile,Trop Facile / Difficile
3739,420,2019,Art,13,5,QROC,0.9607,0.1,0.84,28,27,27,0,1.04,100.0,27,1,96.07,Trop Facile,Trop Facile,Trop Facile / Trop Facile
4569,420,2020,Art,13,5,QROC,0.6113,0.37,0.26,25,18,15,3,1.39,83.33,15,10,61.13,Trop Facile,Adapte,Trop Facile / Adapte
420,421,2015,Art,13,6,QCM,0.2025,0.38,0.27,59,28,12,16,2.11,42.86,12,47,20.25,Trop Difficile,Trop Difficile,Trop Difficile / Trop Difficile
1250,421,2016,Art,13,6,QCM,0.83,0.09,0.72,61,58,51,7,1.05,87.93,51,10,83.0,Trop Facile,Facile,Trop Facile / Facile
2080,421,2017,Art,13,6,QCM,0.1888,0.08,0.28,67,43,13,30,1.56,30.23,13,54,18.88,Trop Facile,Trop Difficile,Trop Facile / Trop Difficile
2910,421,2018,Art,13,6,QCM,0.951,0.09,0.96,78,74,74,0,1.05,100.0,74,4,95.1,Trop Facile,Trop Facile,Trop Facile / Trop Facile
3740,421,2019,Art,13,6,QCM,0.6246,0.2,0.61,72,60,45,15,1.2,75.0,45,27,62.46,Trop Facile,Adapte,Trop Facile / Adapte
4570,421,2020,Art,13,6,QCM,0.7156,0.03,0.42,67,60,48,12,1.12,80.0,48,19,71.56,Adapte,Adapte,Adapte / Adapte
421,422,2015,Art,14,1,QCU,0.329,0.39,0.39,9,4,3,1,2.25,75.0,3,6,32.9,Difficile,Difficile,Difficile / Difficile
1251,422,2016,Art,14,1,QCU,0.9771,0.09,1.0,9,9,9,0,1.0,100.0,9,0,97.71,Trop Facile,Trop Facile,Trop Facile / Trop Facile
2081,422,2017,Art,14,1,QCU,0.2535,0.09,0.39,9,6,2,4,1.5,33.33,2,7,25.35,Trop Facile,Difficile,Trop Facile / Difficile
2911,422,2018,Art,14,1,QCU,0.1014,0.55,0.25,8,5,1,4,1.6,20.0,1,7,10.14,Trop Facile,Trop Difficile,Trop Facile / Trop Difficile
3741,422,2019,Art,14,1,QCU,0.7237,0.03,0.45,7,5,5,0,1.4,100.0,5,2,72.37,Trop Facile,Adapte,Trop Facile / Adapte
4571,422,2020,Art,14,1,QCU,0.6412,0.28,0.63,7,5,4,1,1.4,80.0,4,3,64.12,Adapte,Adapte,Adapte / Adapte
422,423,2015,Art,15,1,QCM,0.8792,0.02,0.84,25,25,22,3,1.0,88.0,22,3,87.92,Facile,Trop Facile,Facile / Trop Facile
1252,423,2016,Art,15,1,QCM,0.7832,0.09,0.75,27,26,21,5,1.04,80.77,21,6,78.32,Trop Facile,Facile,Trop Facile / Facile
2082,423,2017,Art,15,1,QCM,0.9272,0.08,0.8,32,31,30,1,1.03,96.77,30,2,92.72,Trop Facile,Trop Facile,Trop Facile / Trop Facile
2912,423,2018,Art,15,1,QCM,0.9896,0.01,0.87,35,35,35,0,1.0,100.0,35,0,98.96,Trop Facile,Trop Facile,Trop Facile / Trop Facile
3742,423,2019,Art,15,1,QCM,0.9179,0.08,0.87,30,30,28,2,1.0,93.33,28,2,91.79,Trop Facile,Trop Facile,Trop Facile / Trop Facile
4572,423,2020,Art,15,1,QCM,0.9697,0.06,0.98,34,34,33,1,1.0,97.06,33,1,96.97,Trop Facile,Trop Facile,Trop Facile / Trop Facile
423,424,2015,Art,15,2,QCU,0.7648,0.01,0.79,86,68,66,2,1.26,97.06,66,20,76.48,Facile,Facile,Facile / Facile
1253,424,2016,Art,15,2,QCU,0.9641,0.05,0.92,100,96,96,0,1.04,100.0,96,4,96.41,Trop Facile,Trop Facile,Trop Facile / Trop Facile
2083,424,2017,Art,15,2,QCU,0.9735,0.07,0.96,99,96,96,0,1.03,100.0,96,3,97.35,Trop Facile,Trop Facile,Trop Facile / Trop Facile
2913,424,2018,Art,15,2,QCU,0.611,0.06,0.54,105,76,64,12,1.38,84.21,64,41,61.1,Trop Facile,Adapte,Trop Facile / Adapte
3743,424,2019,Art,15,2,QCU,0.6603,0.08,0.67,104,97,69,28,1.07,71.13,69,35,66.03,Adapte,Adapte,Adapte / Adapte
4573,424,2020,Art,15,2,QCU,0.6363,0.22,0.68,98,87,62,25,1.13,71.26,62,36,63.63,Adapte,Adapte,Adapte / Adapte
424,425,2015,Art,16,1,QCU,0.0224,0.31,0.21,51,24,1,23,2.12,4.17,1,50,2.24,Facile,Trop Difficile,Facile / Trop Difficile
1254,425,2016,Art,16,1,QCU,0.9576,0.02,0.91,57,55,55,0,1.04,100.0,55,2,95.76,Trop Facile,Trop Facile,Trop Facile / Trop Facile
2084,425,2017,Art,16,1,QCU,0.9319,0.03,0.93,67,64,62,2,1.05,96.88,62,5,93.19,Trop Facile,Trop Facile,Trop Facile / Trop Facile
2914,425,2018,Art,16,1,QCU,0.919,0.07,0.95,77,75,71,4,1.03,94.67,71,6,91.9,Trop Facile,Trop Facile,Trop Facile / Trop Facile
3744,425,2019,Art,16,1,QCU,0.9382,0.08,0.97,87,85,82,3,1.02,96.47,82,5,93.82,Trop Facile,Trop Facile,Trop Facile / Trop Facile
4574,425,2020,Art,16,1,QCU,0.1201,0.52,0.22,73,25,9,16,2.92,36.0,9,64,12.01,Trop Facile,Trop Difficile,Trop Facile / Trop Difficile
425,426,2015,Art,16,2,QCM,0.0666,0.54,0.25,22,6,1,5,3.67,16.67,1,21,6.66,Trop Difficile,Trop Difficile,Trop Difficile / Trop Difficile
1255,426,2016,Art,16,2,QCM,0.907,0.08,0.85,24,23,22,1,1.04,95.65,22,2,90.7,Trop Facile,Trop Facile,Trop Facile / Trop Facile
2085,426,2017,Art,16,2,QCM,0.7147,0.04,0.62,29,27,21,6,1.07,77.78,21,8,71.47,Trop Facile,Adapte,Trop Facile / Adapte
2915,426,2018,Art,16,2,QCM,0.6509,0.02,0.42,35,27,23,4,1.3,85.19,23,12,65.09,Adapte,Adapte,Adapte / Adapte
3745,426,2019,Art,16,2,QCM,0.6637,0.05,0.64,38,35,25,10,1.09,71.43,25,13,66.37,Adapte,Adapte,Adapte / Adapte
4575,426,2020,Art,16,2,QCM,0.7465,0.21,0.54,38,38,28,10,1.0,73.68,28,10,74.65,Adapte,Adapte,Adapte / Adapte
426,427,2015,Art,16,3,QCU,0.7644,0.03,0.86,72,63,55,8,1.14,87.3,55,17,76.44,Facile,Facile,Facile / Facile
1256,427,2016,Art,16,3,QCU,0.9884,0.01,0.96,71,70,70,0,1.01,100.0,70,1,98.84,Trop Facile,Trop Facile,Trop Facile / Trop Facile
2086,427,2017,Art,16,3,QCU,0.9655,0.07,0.92,62,62,60,2,1.0,96.77,60,2,96.55,Trop Facile,Trop Facile,Trop Facile / Trop Facile
2916,427,2018,Art,16,3,QCU,0.81,0.12,0.76,53,45,43,2,1.18,95.56,43,10,81.0,Trop Facile,Facile,Trop Facile / Facile
3746,427,2019,Art,16,3,QCU,0.0291,0.16,0.24,51,44,1,43,1.16,2.27,1,50,2.91,Trop Facile,Trop Difficile,Trop Facile / Trop Difficile
4576,427,2020,Art,16,3,QCU,0.7773,0.18,0.8,55,46,43,3,1.2,93.48,43,12,77.73,Trop Facile,Facile,Trop Facile / Facile
427,428,2015,Art,16,4,QO,0.0449,0.92,0.05,26,20,1,19,1.3,5.0,1,25,4.49,Trop Difficile,Trop Difficile,Trop Difficile / Trop Difficile
1257,428,2016,Art,16,4,QO,0.9878,0.07,0.64,22,22,22,0,1.0,100.0,22,0,98.78,Trop Facile,Trop Facile,Trop Facile / Trop Facile
2087,428,2017,Art,16,4,QO,0.9,0.07,0.76,21,20,19,1,1.05,95.0,19,2,90.0,Trop Facile,Trop Facile,Trop Facile / Trop Facile
2917,428,2018,Art,16,4,QO,0.9393,0.0,0.58,17,17,16,1,1.0,94.12,16,1,93.93,Trop Facile,Trop Facile,Trop Facile / Trop Facile
3747,428,2019,Art,16,4,QO,0.8698,0.05,0.86,14,13,12,1,1.08,92.31,12,2,86.98,Trop Facile,Trop Facile,Trop Facile / Trop Facile
4577,428,2020,Art,16,4,QO,0.8472,0.06,0.43,11,9,9,0,1.22,100.0,9,2,84.72,Trop Facile,Facile,Trop Facile / Facile
428,429,2015,Art,16,5,QCU,0.612,0.29,0.63,63,40,39,1,1.57,97.5,39,24,61.2,Trop Difficile,Adapte,Trop Difficile / Adapte
1258,429,2016,Art,16,5,QCU,0.6935,0.13,0.7,67,60,46,14,1.12,76.67,46,21,69.35,Adapte,Adapte,Adapte / Adapte
2088,429,2017,Art,16,5,QCU,0.693,0.1,0.7,61,51,42,9,1.2,82.35,42,19,69.3,Adapte,Adapte,Adapte / Adapte
2918,429,2018,Art,16,5,QCU,0.674,0.15,0.52,66,62,44,18,1.06,70.97,44,22,67.4,Adapte,Adapte,Adapte / Adapte
3748,429,2019,Art,16,5,QCU,0.7032,0.12,0.68,53,52,37,15,1.02,71.15,37,16,70.32,Adapte,Adapte,Adapte / Adapte
4578,429,2020,Art,16,5,QCU,0.6768,0.01,0.67,46,33,31,2,1.39,93.94,31,15,67.68,Adapte,Adapte,Adapte / Adapte
429,430,2015,Art,16,6,QCU,0.7968,0.05,0.81,81,72,65,7,1.12,90.28,65,16,79.68,Facile,Facile,Facile / Facile
1259,430,2016,Art,16,6,QCU,0.6717,0.25,0.46,83,64,56,8,1.3,87.5,56,27,67.17,Trop Facile,Adapte,Trop Facile / Adapte
2089,430,2017,Art,16,6,QCU,0.7062,0.26,0.47,79,60,56,4,1.32,93.33,56,23,70.62,Adapte,Adapte,Adapte / Adapte
2919,430,2018,Art,16,6,QCU,0.6768,0.3,0.59,65,54,44,10,1.2,81.48,44,21,67.68,Adapte,Adapte,Adapte / Adapte
3749,430,2019,Art,16,6,QCU,0.6061,0.21,0.47,60,60,36,24,1.0,60.0,36,24,60.61,Adapte,Adapte,Adapte / Adapte
4579,430,2020,Art,16,6,QCU,0.6187,0.1,0.49,58,45,36,9,1.29,80.0,36,22,61.87,Adapte,Adapte,Adapte / Adapte
430,431,2015,Art,16,7,QROC,0.8435,0.08,0.51,15,13,13,0,1.15,100.0,13,2,84.35,Facile,Facile,Facile / Facile
1260,431,2016,Art,16,7,QROC,0.0105,0.88,0.02,17,15,0,15,1.13,0.0,0,17,1.05,Trop Facile,Trop Difficile,Trop Facile / Trop Difficile
2090,431,2017,Art,16,7,QROC,0.6444,0.21,0.31,17,13,11,2,1.31,84.62,11,6,64.44,Trop Facile,Adapte,Trop Facile / Adapte
2920,431,2018,Art,16,7,QROC,0.7445,0.3,0.28,19,15,14,1,1.27,93.33,14,5,74.45,Adapte,Adapte,Adapte / Adapte
3750,431,2019,Art,16,7,QROC,0.6592,0.35,0.37,15,14,10,4,1.07,71.43,10,5,65.92,Adapte,Adapte,Adapte / Adapte
4580,431,2020,Art,16,7,QROC,0.6534,0.46,0.34,17,15,11,4,1.13,73.33,11,6,65.34,Adapte,Adapte,Adapte / Adapte
431,432,2015,Art,16,8,QROC,0.2642,0.53,0.17,46,43,12,31,1.07,27.91,12,34,26.42,Difficile,Difficile,Difficile / Difficile
1261,432,2016,Art,16,8,QROC,0.9889,0.05,0.7,42,42,42,0,1.0,100.0,42,0,98.89,Trop Facile,Trop Facile,Trop Facile / Trop Facile
2091,432,2017,Art,16,8,QROC,0.8783,0.04,0.87,36,36,32,4,1.0,88.89,32,4,87.83,Trop Facile,Trop Facile,Trop Facile / Trop Facile
2921,432,2018,Art,16,8,QROC,0.9199,0.08,0.66,42,41,39,2,1.02,95.12,39,3,91.99,Trop Facile,Trop Facile,Trop Facile / Trop Facile
3751,432,2019,Art,16,8,QROC,0.9309,0.08,0.85,49,47,46,1,1.04,97.87,46,3,93.09,Trop Facile,Trop Facile,Trop Facile / Trop Facile
4581,432,2020,Art,16,8,QROC,0.6508,0.49,0.34,46,31,30,1,1.48,96.77,30,16,65.08,Trop Facile,Adapte,Trop Facile / Adapte
432,433,2015,Art,16,9,QCU,0.5137,0.23,0.33,65,33,33,0,1.97,100.0,33,32,51.37,Difficile,Difficile,Difficile / Difficile
1262,433,2016,Art,16,9,QCU,0.9812,0.07,0.96,73,73,72,1,1.0,98.63,72,1,98.12,Trop Facile,Trop Facile,Trop Facile / Trop Facile
2092,433,2017,Art,16,9,QCU,0.7972,0.07,0.84,81,77,65,12,1.05,84.42,65,16,79.72,Trop Facile,Facile,Trop Facile / Facile
2922,433,2018,Art,16,9,QCU,0.5759,0.23,0.32,80,73,46,27,1.1,63.01,46,34,57.59,Trop Facile,Difficile,Trop Facile / Difficile
3752,433,2019,Art,16,9,QCU,0.9583,0.01,0.91,65,63,62,1,1.03,98.41,62,3,95.83,Trop Facile,Trop Facile,Trop Facile / Trop Facile
4582,433,2020,Art,16,9,QCU,0.954,0.08,0.91,60,58,57,1,1.03,98.28,57,3,95.4,Trop Facile,Trop Facile,Trop Facile / Trop Facile
433,434,2015,Art,16,10,QCU,0.7957,0.11,0.76,5,5,4,1,1.0,80.0,4,1,79.57,Trop Difficile,Facile,Trop Difficile / Facile
1263,434,2016,Art,16,10,QCU,0.9621,0.03,0.97,4,4,4,0,1.0,100.0,4,0,96.21,Trop Facile,Trop Facile,Trop Facile / Trop Facile
2093,434,2017,Art,16,10,QCU,0.954,0.02,0.98,5,5,5,0,1.0,100.0,5,0,95.4,Trop Facile,Trop Facile,Trop Facile / Trop Facile
2923,434,2018,Art,16,10,QCU,0.8753,0.09,0.97,5,5,4,1,1.0,80.0,4,1,87.53,Trop Facile,Trop Facile,Trop Facile / Trop Facile
3753,434,2019,Art,16,10,QCU,0.9196,0.05,0.98,6,6,6,0,1.0,100.0,6,0,91.96,Trop Facile,Trop Facile,Trop Facile / Trop Facile
4583,434,2020,Art,16,10,QCU,0.9424,0.07,0.91,7,7,7,0,1.0,100.0,7,0,94.24,Trop Facile,Trop Facile,Trop Facile / Trop Facile
434,435,2015,Art,16,11,QCU,0.4152,0.38,0.34,40,38,17,21,1.05,44.74,17,23,41.52,Difficile,Difficile,Difficile / Difficile
1264,435,2016,Art,16,11,QCU,0.9352,0.07,0.91,37,36,35,1,1.03,97.22,35,2,93.52,Trop Facile,Trop Facile,Trop Facile / Trop Facile
2094,435,2017,Art,16,11,QCU,0.1685,0.75,0.24,33,18,6,12,1.83,33.33,6,27,16.85,Trop Facile,Trop Difficile,Trop Facile / Trop Difficile
2924,435,2018,Art,16,11,QCU,0.1705,0.72,0.23,39,22,7,15,1.77,31.82,7,32,17.05,Trop Facile,Trop Difficile,Trop Facile / Trop Difficile
3754,435,2019,Art,16,11,QCU,0.5768,0.27,0.35,34,22,20,2,1.55,90.91,20,14,57.68,Trop Facile,Difficile,Trop Facile / Difficile
4584,435,2020,Art,16,11,QCU,0.0894,0.4,0.21,32,29,3,26,1.1,10.34,3,29,8.94,Trop Facile,Trop Difficile,Trop Facile / Trop Difficile
435,436,2015,Art,16,12,QCM,0.6416,0.1,0.7,58,41,37,4,1.41,90.24,37,21,64.16,Adapte,Adapte,Adapte / Adapte
1265,436,2016,Art,16,12,QCM,0.7276,0.06,0.48,48,44,35,9,1.09,79.55,35,13,72.76,Adapte,Adapte,Adapte / Adapte
2095,436,2017,Art,16,12,QCM,0.7204,0.07,0.68,55,48,40,8,1.15,83.33,40,15,72.04,Adapte,Adapte,Adapte / Adapte
2925,436,2018,Art,16,12,QCM,0.6512,0.09,0.46,62,61,40,21,1.02,65.57,40,22,65.12,Adapte,Adapte,Adapte / Adapte
3755,436,2019,Art,16,12,QCM,0.6119,0.19,0.6,51,39,31,8,1.31,79.49,31,20,61.19,Adapte,Adapte,Adapte / Adapte
4585,436,2020,Art,16,12,QCM,0.6471,0.08,0.64,57,47,37,10,1.21,78.72,37,20,64.71,Adapte,Adapte,Adapte / Adapte
436,437,2015,Art,16,13,QCM,0.496,0.12,0.36,90,84,45,39,1.07,53.57,45,45,49.6,Difficile,Difficile,Difficile / Difficile
1266,437,2016,Art,16,13,QCM,0.9781,0.05,0.82,83,83,81,2,1.0,97.59,81,2,97.81,Trop Facile,Trop Facile,Trop Facile / Trop Facile
2096,437,2017,Art,16,13,QCM,0.9423,0.04,0.95,66,64,62,2,1.03,96.88,62,4,94.23,Trop Facile,Trop Facile,Trop Facile / Trop Facile
2926,437,2018,Art,16,13,QCM,0.9755,0.0,0.88,73,71,71,0,1.03,100.0,71,2,97.55,Trop Facile,Trop Facile,Trop Facile / Trop Facile
3756,437,2019,Art,16,13,QCM,0.6013,0.16,0.41,71,59,43,16,1.2,72.88,43,28,60.13,Trop Facile,Adapte,Trop Facile / Adapte
4586,437,2020,Art,16,13,QCM,0.633,0.04,0.43,77,71,49,22,1.08,69.01,49,28,63.3,Adapte,Adapte,Adapte / Adapte
437,438,2015,Art,17,1,QCM,0.9078,0.06,0.92,9,9,8,1,1.0,88.89,8,1,90.78,Trop Facile,Trop Facile,Trop Facile / Trop Facile
1267,438,2016,Art,17,1,QCM,0.9851,0.06,0.91,11,11,11,0,1.0,100.0,11,0,98.51,Trop Facile,Trop Facile,Trop Facile / Trop Facile
2097,438,2017,Art,17,1,QCM,0.8905,0.01,0.81,13,13,12,1,1.0,92.31,12,1,89.05,Trop Facile,Trop Facile,Trop Facile / Trop Facile
2927,438,2018,Art,17,1,QCM,0.8693,0.03,0.99,13,11,11,0,1.18,100.0,11,2,86.93,Trop Facile,Trop Facile,Trop Facile / Trop Facile
3757,438,2019,Art,17,1,QCM,0.8058,0.02,0.79,11,10,9,1,1.1,90.0,9,2,80.58,Trop Facile,Facile,Trop Facile / Facile
4587,438,2020,Art,17,1,QCM,0.9497,0.1,0.92,10,10,9,1,1.0,90.0,9,1,94.97,Trop Facile,Trop Facile,Trop Facile / Trop Facile
438,439,2015,Art,17,2,QROC,0.1631,0.75,0.12,27,14,4,10,1.93,28.57,4,23,16.31,Difficile,Trop Difficile,Difficile / Trop Difficile
1268,439,2016,Art,17,2,QROC,0.9925,0.08,0.75,25,25,25,0,1.0,100.0,25,0,99.25,Trop Facile,Trop Facile,Trop Facile / Trop Facile
2098,439,2017,Art,17,2,QROC,0.8936,0.06,0.83,22,20,20,0,1.1,100.0,20,2,89.36,Trop Facile,Trop Facile,Trop Facile / Trop Facile
2928,439,2018,Art,17,2,QROC,0.9233,0.05,0.94,23,22,21,1,1.05,95.45,21,2,92.33,Trop Facile,Trop Facile,Trop Facile / Trop Facile
3758,439,2019,Art,17,2,QROC,0.038,0.92,0.13,18,8,1,7,2.25,12.5,1,17,3.8,Trop Facile,Trop Difficile,Trop Facile / Trop Difficile
4588,439,2020,Art,17,2,QROC,0.9181,0.08,0.83,20,18,18,0,1.11,100.0,18,2,91.81,Trop Facile,Trop Facile,Trop Facile / Trop Facile
439,440,2015,Art,17,3,QCM,0.6188,0.19,0.58,20,14,12,2,1.43,85.71,12,8,61.88,Adapte,Adapte,Adapte / Adapte
1269,440,2016,Art,17,3,QCM,0.681,0.24,0.47,22,19,15,4,1.16,78.95,15,7,68.1,Adapte,Adapte,Adapte / Adapte
2099,440,2017,Art,17,3,QCM,0.7235,0.27,0.41,24,21,17,4,1.14,80.95,17,7,72.35,Adapte,Adapte,Adapte / Adapte
2929,440,2018,Art,17,3,QCM,0.6998,0.04,0.59,19,18,13,5,1.06,72.22,13,6,69.98,Adapte,Adapte,Adapte / Adapte
3759,440,2019,Art,17,3,QCM,0.6482,0.08,0.51,17,13,11,2,1.31,84.62,11,6,64.82,Adapte,Adapte,Adapte / Adapte
4589,440,2020,Art,17,3,QCM,0.6652,0.11,0.59,20,15,13,2,1.33,86.67,13,7,66.52,Adapte,Adapte,Adapte / Adapte
440,441,2015,Art,17,4,QCM,0.4695,0.09,0.3,68,54,32,22,1.26,59.26,32,36,46.95,Difficile,Difficile,Difficile / Difficile
1270,441,2016,Art,17,4,QCM,0.405,0.11,0.34,59,55,24,31,1.07,43.64,24,35,40.5,Trop Facile,Difficile,Trop Facile / Difficile
2100,441,2017,Art,17,4,QCM,0.9442,0.06,0.98,62,59,59,0,1.05,100.0,59,3,94.42,Trop Facile,Trop Facile,Trop Facile / Trop Facile
2930,441,2018,Art,17,4,QCM,0.8841,0.1,0.91,65,58,57,1,1.12,98.28,57,8,88.41,Trop Facile,Trop Facile,Trop Facile / Trop Facile
3760,441,2019,Art,17,4,QCM,0.803,0.03,0.71,57,49,46,3,1.16,93.88,46,11,80.3,Trop Facile,Facile,Trop Facile / Facile
4590,441,2020,Art,17,4,QCM,0.9471,0.07,0.98,60,59,57,2,1.02,96.61,57,3,94.71,Trop Facile,Trop Facile,Trop Facile / Trop Facile
441,442,2015,Art,17,5,QCU,0.9898,0.09,0.99,38,38,38,0,1.0,100.0,38,0,98.98,Difficile,Trop Facile,Difficile / Trop Facile
1271,442,2016,Art,17,5,QCU,0.7071,0.08,0.68,36,26,25,1,1.38,96.15,25,11,70.71,Trop Facile,Adapte,Trop Facile / Adapte
2101,442,2017,Art,17,5,QCU,0.6221,0.07,0.53,30,27,19,8,1.11,70.37,19,11,62.21,Adapte,Adapte,Adapte / Adapte
2931,442,2018,Art,17,5,QCU,0.6826,0.06,0.5,30,26,20,6,1.15,76.92,20,10,68.26,Adapte,Adapte,Adapte / Adapte
3761,442,2019,Art,17,5,QCU,0.6004,0.22,0.41,33,22,20,2,1.5,90.91,20,13,60.04,Adapte,Adapte,Adapte / Adapte
4591,442,2020,Art,17,5,QCU,0.6678,0.13,0.44,26,19,17,2,1.37,89.47,17,9,66.78,Adapte,Adapte,Adapte / Adapte
442,443,2015,Art,17,6,QROC,0.7846,0.01,0.67,97,82,76,6,1.18,92.68,76,21,78.46,Facile,Facile,Facile / Facile
1272,443,2016,Art,17,6,QROC,0.8907,0.04,0.94,85,84,76,8,1.01,90.48,76,9,89.07,Trop Facile,Trop Facile,Trop Facile / Trop Facile
2102,443,2017,Art,17,6,QROC,0.9278,0.0,0.59,85,85,79,6,1.0,92.94,79,6,92.78,Trop Facile,Trop Facile,Trop Facile / Trop Facile
2932,443,2018,Art,17,6,QROC,0.8752,0.03,0.53,101,93,88,5,1.09,94.62,88,13,87.52,Trop Facile,Trop Facile,Trop Facile / Trop Facile
3762,443,2019,Art,17,6,QROC,0.1413,0.97,0.04,81,71,11,60,1.14,15.49,11,70,14.13,Trop Facile,Trop Difficile,Trop Facile / Trop Difficile
4592,443,2020,Art,17,6,QROC,0.6392,0.22,0.27,86,79,55,24,1.09,69.62,55,31,63.92,Trop Facile,Adapte,Trop Facile / Adapte
443,444,2015,Art,17,7,QO,0.4969,0.8,0.06,91,66,45,21,1.38,68.18,45,46,49.69,Difficile,Difficile,Difficile / Difficile
1273,444,2016,Art,17,7,QO,0.0046,0.93,0.05,101,54,0,54,1.87,0.0,0,101,0.46,Trop Facile,Trop Difficile,Trop Facile / Trop Difficile
2103,444,2017,Art,17,7,QO,0.9008,0.08,0.56,86,86,77,9,1.0,89.53,77,9,90.08,Trop Facile,Trop Facile,Trop Facile / Trop Facile
2933,444,2018,Art,17,7,QO,0.8604,0.09,0.83,95,85,82,3,1.12,96.47,82,13,86.04,Trop Facile,Trop Facile,Trop Facile / Trop Facile
3763,444,2019,Art,17,7,QO,0.8901,0.01,0.79,80,79,71,8,1.01,89.87,71,9,89.01,Trop Facile,Trop Facile,Trop Facile / Trop Facile
4593,444,2020,Art,17,7,QO,0.8353,0.06,0.46,72,65,60,5,1.11,92.31,60,12,83.53,Trop Facile,Facile,Trop Facile / Facile
444,445,2015,Art,17,8,QCU,0.1428,0.44,0.22,23,11,3,8,2.09,27.27,3,20,14.28,Trop Difficile,Trop Difficile,Trop Difficile / Trop Difficile
1274,445,2016,Art,17,8,QCU,0.8247,0.13,0.86,26,26,21,5,1.0,80.77,21,5,82.47,Trop Facile,Facile,Trop Facile / Facile
2104,445,2017,Art,17,8,QCU,0.3753,0.39,0.34,30,18,11,7,1.67,61.11,11,19,37.53,Trop Facile,Difficile,Trop Facile / Difficile
2934,445,2018,Art,17,8,QCU,0.9268,0.07,0.95,28,28,26,2,1.0,92.86,26,2,92.68,Trop Facile,Trop Facile,Trop Facile / Trop Facile
3764,445,2019,Art,17,8,QCU,0.8818,0.08,0.99,31,28,27,1,1.11,96.43,27,4,88.18,Trop Facile,Trop Facile,Trop Facile / Trop Facile
4594,445,2020,Art,17,8,QCU,0.9051,0.05,0.94,31,29,28,1,1.07,96.55,28,3,90.51,Trop Facile,Trop Facile,Trop Facile / Trop Facile
445,446,2015,Art,17,9,QCM,0.3207,0.28,0.33,15,7,5,2,2.14,71.43,5,10,32.07,Difficile,Difficile,Difficile / Difficile
1275,446,2016,Art,17,9,QCM,0.9965,0.08,0.9,14,14,14,0,1.0,100.0,14,0,99.65,Trop Facile,Trop Facile,Trop Facile / Trop Facile
2105,446,2017,Art,17,9,QCM,0.7233,0.05,0.56,16,12,12,0,1.33,100.0,12,4,72.33,Trop Facile,Adapte,Trop Facile / Adapte
2935,446,2018,Art,17,9,QCM,0.677,0.29,0.65,18,12,12,0,1.5,100.0,12,6,67.7,Adapte,Adapte,Adapte / Adapte
3765,446,2019,Art,17,9,QCM,0.6115,0.1,0.64,14,13,9,4,1.08,69.23,9,5,61.15,Adapte,Adapte,Adapte / Adapte
4595,446,2020,Art,17,9,QCM,0.7424,0.12,0.46,17,14,13,1,1.21,92.86,13,4,74.24,Adapte,Adapte,Adapte / Adapte
446,447,2015,Art,17,10,QCM,0.118,0.36,0.29,59,36,7,29,1.64,19.44,7,52,11.8,Trop Difficile,Trop Difficile,Trop Difficile / Trop Difficile
1276,447,2016,Art,17,10,QCM,0.993,0.04,0.87,51,51,51,0,1.0,100.0,51,0,99.3,Trop Facile,Trop Facile,Trop Facile / Trop Facile
2106,447,2017,Art,17,10,QCM,0.8842,0.06,0.84,53,49,47,2,1.08,95.92,47,6,88.42,Trop Facile,Trop Facile,Trop Facile / Trop Facile
2936,447,2018,Art,17,10,QCM,0.7729,0.15,0.79,54,45,42,3,1.2,93.33,42,12,77.29,Trop Facile,Facile,Trop Facile / Facile
3766,447,2019,Art,17,10,QCM,0.8872,0.07,0.94,63,57,56,1,1.11,98.25,56,7,88.72,Trop Facile,Trop Facile,Trop Facile / Trop Facile
4596,447,2020,Art,17,10,QCM,0.5733,0.42,0.32,74,68,42,26,1.09,61.76,42,32,57.33,Trop Facile,Difficile,Trop Facile / Difficile
447,448,2015,Art,17,11,QCU,0.2331,0.25,0.22,98,43,23,20,2.28,53.49,23,75,23.31,Trop Facile,Trop Difficile,Trop Facile / Trop Difficile
1277,448,2016,Art,17,11,QCU,0.3664,0.07,0.37,116,81,43,38,1.43,53.09,43,73,36.64,Trop Facile,Difficile,Trop Facile / Difficile
2107,448,2017,Art,17,11,QCU,0.9638,0.08,0.98,126,125,121,4,1.01,96.8,121,5,96.38,Trop Facile,Trop Facile,Trop Facile / Trop Facile
2937,448,2018,Art,17,11,QCU,0.9329,0.03,0.99,133,132,124,8,1.01,93.94,124,9,93.29,Trop Facile,Trop Facile,Trop Facile / Trop Facile
3767,448,2019,Art,17,11,QCU,0.9762,0.03,0.99,138,135,135,0,1.02,100.0,135,3,97.62,Trop Facile,Trop Facile,Trop Facile / Trop Facile
4597,448,2020,Art,17,11,QCU,0.7335,0.07,0.53,141,131,103,28,1.08,78.63,103,38,73.35,Trop Facile,Adapte,Trop Facile / Adapte
448,449,2015,Art,17,12,QCM,0.0795,0.06,0.26,44,22,3,19,2.0,13.64,3,41,7.95,Trop Difficile,Trop Difficile,Trop Difficile / Trop Difficile
1278,449,2016,Art,17,12,QCM,0.8966,0.03,0.86,47,44,42,2,1.07,95.45,42,5,89.66,Trop Facile,Trop Facile,Trop Facile / Trop Facile
2108,449,2017,Art,17,12,QCM,0.4209,0.49,0.33,40,37,17,20,1.08,45.95,17,23,42.09,Trop Facile,Difficile,Trop Facile / Difficile
2938,449,2018,Art,17,12,QCM,0.9196,0.03,0.88,40,40,37,3,1.0,92.5,37,3,91.96,Trop Facile,Trop Facile,Trop Facile / Trop Facile
3768,449,2019,Art,17,12,QCM,0.906,0.09,0.87,43,42,39,3,1.02,92.86,39,4,90.6,Trop Facile,Trop Facile,Trop Facile / Trop Facile
4598,449,2020,Art,17,12,QCM,0.9861,0.03,0.89,42,41,41,0,1.02,100.0,41,1,98.61,Trop Facile,Trop Facile,Trop Facile / Trop Facile
449,450,2015,Art,17,13,QCM,0.8095,0.01,0.79,47,47,38,9,1.0,80.85,38,9,80.95,Facile,Facile,Facile / Facile
1279,450,2016,Art,17,13,QCM,0.5194,0.36,0.39,46,44,24,20,1.05,54.55,24,22,51.94,Trop Facile,Difficile,Trop Facile / Difficile
2109,450,2017,Art,17,13,QCM,0.8954,0.07,0.96,55,51,49,2,1.08,96.08,49,6,89.54,Trop Facile,Trop Facile,Trop Facile / Trop Facile
2939,450,2018,Art,17,13,QCM,0.8764,0.07,0.99,65,57,57,0,1.14,100.0,57,8,87.64,Trop Facile,Trop Facile,Trop Facile / Trop Facile
3769,450,2019,Art,17,13,QCM,0.9666,0.0,0.87,68,67,66,1,1.01,98.51,66,2,96.66,Trop Facile,Trop Facile,Trop Facile / Trop Facile
4599,450,2020,Art,17,13,QCM,0.9444,0.07,0.85,66,65,62,3,1.02,95.38,62,4,94.44,Trop Facile,Trop Facile,Trop Facile / Trop Facile
450,451,2015,Art,17,14,QCM,0.0751,0.6,0.29,80,62,6,56,1.29,9.68,6,74,7.51,Trop Difficile,Trop Difficile,Trop Difficile / Trop Difficile
1280,451,2016,Art,17,14,QCM,0.7968,0.01,0.79,85,81,68,13,1.05,83.95,68,17,79.68,Trop Facile,Facile,Trop Facile / Facile
2110,451,2017,Art,17,14,QCM,0.8902,0.07,0.85,98,88,87,1,1.11,98.86,87,11,89.02,Trop Facile,Trop Facile,Trop Facile / Trop Facile
2940,451,2018,Art,17,14,QCM,0.9577,0.01,0.81,100,98,96,2,1.02,97.96,96,4,95.77,Trop Facile,Trop Facile,Trop Facile / Trop Facile
3770,451,2019,Art,17,14,QCM,0.9323,0.04,0.87,106,106,99,7,1.0,93.4,99,7,93.23,Trop Facile,Trop Facile,Trop Facile / Trop Facile
4600,451,2020,Art,17,14,QCM,0.9453,0.09,0.97,100,96,95,1,1.04,98.96,95,5,94.53,Trop Facile,Trop Facile,Trop Facile / Trop Facile
451,452,2015,Art,18,1,QCM,0.5621,0.35,0.37,11,9,6,3,1.22,66.67,6,5,56.21,Facile,Difficile,Facile / Difficile
1281,452,2016,Art,18,1,QCM,0.9852,0.06,0.83,13,13,13,0,1.0,100.0,13,0,98.52,Trop Facile,Trop Facile,Trop Facile / Trop Facile
2111,452,2017,Art,18,1,QCM,0.9637,0.09,0.8,12,12,12,0,1.0,100.0,12,0,96.37,Trop Facile,Trop Facile,Trop Facile / Trop Facile
2941,452,2018,Art,18,1,QCM,0.9895,0.02,0.87,13,13,13,0,1.0,100.0,13,0,98.95,Trop Facile,Trop Facile,Trop Facile / Trop Facile
3771,452,2019,Art,18,1,QCM,0.9468,0.04,0.81,11,10,10,0,1.1,100.0,10,1,94.68,Trop Facile,Trop Facile,Trop Facile / Trop Facile
4601,452,2020,Art,18,1,QCM,0.0761,0.19,0.23,12,5,1,4,2.4,20.0,1,11,7.61,Trop Facile,Trop Difficile,Trop Facile / Trop Difficile
452,453,2015,Art,18,2,QCU,0.3013,0.19,0.3,24,10,7,3,2.4,70.0,7,17,30.13,Difficile,Difficile,Difficile / Difficile
1282,453,2016,Art,18,2,QCU,0.9766,0.03,0.99,28,27,27,0,1.04,100.0,27,1,97.66,Trop Facile,Trop Facile,Trop Facile / Trop Facile
2112,453,2017,Art,18,2,QCU,0.9797,0.05,0.93,29,28,28,0,1.04,100.0,28,1,97.97,Trop Facile,Trop Facile,Trop Facile / Trop Facile
2942,453,2018,Art,18,2,QCU,0.8928,0.01,0.96,23,21,21,0,1.1,100.0,21,2,89.28,Trop Facile,Trop Facile,Trop Facile / Trop Facile
3772,453,2019,Art,18,2,QCU,0.9738,0.07,0.92,21,21,20,1,1.0,95.24,20,1,97.38,Trop Facile,Trop Facile,Trop Facile / Trop Facile
4602,453,2020,Art,18,2,QCU,0.492,0.22,0.39,22,22,11,11,1.0,50.0,11,11,49.2,Trop Facile,Difficile,Trop Facile / Difficile
453,454,2015,Art,18,3,QCU,0.4454,0.18,0.33,99,89,44,45,1.11,49.44,44,55,44.54,Difficile,Difficile,Difficile / Difficile
1283,454,2016,Art,18,3,QCU,0.0662,0.12,0.29,116,94,8,86,1.23,8.51,8,108,6.62,Trop Facile,Trop Difficile,Trop Facile / Trop Difficile
2113,454,2017,Art,18,3,QCU,0.9894,0.03,0.98,137,136,136,0,1.01,100.0,136,1,98.94,Trop Facile,Trop Facile,Trop Facile / Trop Facile
2943,454,2018,Art,18,3,QCU,0.902,0.07,0.96,137,129,124,5,1.06,96.12,124,13,90.2,Trop Facile,Trop Facile,Trop Facile / Trop Facile
3773,454,2019,Art,18,3,QCU,0.9476,0.04,0.98,137,132,130,2,1.04,98.48,130,7,94.76,Trop Facile,Trop Facile,Trop Facile / Trop Facile
4603,454,2020,Art,18,3,QCU,0.8702,0.09,0.9,156,147,136,11,1.06,92.52,136,20,87.02,Trop Facile,Trop Facile,Trop Facile / Trop Facile
454,455,2015,Art,19,1,QROC,0.0299,0.86,0.1,64,29,2,27,2.21,6.9,2,62,2.99,Trop Difficile,Trop Difficile,Trop Difficile / Trop Difficile
1284,455,2016,Art,19,1,QROC,0.9067,0.06,0.7,58,55,53,2,1.05,96.36,53,5,90.67,Trop Facile,Trop Facile,Trop Facile / Trop Facile
2114,455,2017,Art,19,1,QROC,0.8937,0.04,0.55,67,65,60,5,1.03,92.31,60,7,89.37,Trop Facile,Trop Facile,Trop Facile / Trop Facile
2944,455,2018,Art,19,1,QROC,0.9817,0.04,0.56,74,73,73,0,1.01,100.0,73,1,98.17,Trop Facile,Trop Facile,Trop Facile / Trop Facile
3774,455,2019,Art,19,1,QROC,0.5614,0.63,0.2,60,50,34,16,1.2,68.0,34,26,56.14,Trop Facile,Difficile,Trop Facile / Difficile
4604,455,2020,Art,19,1,QROC,0.9543,0.01,0.76,55,53,52,1,1.04,98.11,52,3,95.43,Trop Facile,Trop Facile,Trop Facile / Trop Facile
455,456,2015,Art,20,1,QCM,0.8144,0.02,0.77,76,72,62,10,1.06,86.11,62,14,81.44,Facile,Facile,Facile / Facile
1285,456,2016,Art,20,1,QCM,0.9558,0.02,0.99,79,78,76,2,1.01,97.44,76,3,95.58,Trop Facile,Trop Facile,Trop Facile / Trop Facile
2115,456,2017,Art,20,1,QCM,0.991,0.02,0.87,86,85,85,0,1.01,100.0,85,1,99.1,Trop Facile,Trop Facile,Trop Facile / Trop Facile
2945,456,2018,Art,20,1,QCM,0.184,0.23,0.3,88,84,16,68,1.05,19.05,16,72,18.4,Trop Facile,Trop Difficile,Trop Facile / Trop Difficile
3775,456,2019,Art,20,1,QCM,0.9271,0.09,0.8,99,94,92,2,1.05,97.87,92,7,92.71,Trop Facile,Trop Facile,Trop Facile / Trop Facile
4605,456,2020,Art,20,1,QCM,0.6981,0.05,0.43,119,101,83,18,1.18,82.18,83,36,69.81,Trop Facile,Adapte,Trop Facile / Adapte
456,457,2015,Art,20,2,QCM,0.6255,0.12,0.47,69,54,43,11,1.28,79.63,43,26,62.55,Adapte,Adapte,Adapte / Adapte
1286,457,2016,Art,20,2,QCM,0.6163,0.15,0.6,67,62,41,21,1.08,66.13,41,26,61.63,Adapte,Adapte,Adapte / Adapte
2116,457,2017,Art,20,2,QCM,0.6048,0.03,0.68,60,60,36,24,1.0,60.0,36,24,60.48,Adapte,Adapte,Adapte / Adapte
2946,457,2018,Art,20,2,QCM,0.6246,0.02,0.67,59,55,37,18,1.07,67.27,37,22,62.46,Adapte,Adapte,Adapte / Adapte
3776,457,2019,Art,20,2,QCM,0.6954,0.06,0.41,60,59,42,17,1.02,71.19,42,18,69.54,Adapte,Adapte,Adapte / Adapte
4606,457,2020,Art,20,2,QCM,0.711,0.03,0.58,62,50,44,6,1.24,88.0,44,18,71.1,Adapte,Adapte,Adapte / Adapte
457,458,2015,Art,20,3,QCU,0.8164,0.11,0.78,42,41,34,7,1.02,82.93,34,8,81.64,Facile,Facile,Facile / Facile
1287,458,2016,Art,20,3,QCU,0.9335,0.08,0.95,42,40,39,1,1.05,97.5,39,3,93.35,Trop Facile,Trop Facile,Trop Facile / Trop Facile
2117,458,2017,Art,20,3,QCU,0.0689,0.29,0.25,34,21,2,19,1.62,9.52,2,32,6.89,Trop Facile,Trop Difficile,Trop Facile / Trop Difficile
2947,458,2018,Art,20,3,QCU,0.1422,0.17,0.29,30,15,4,11,2.0,26.67,4,26,14.22,Trop Facile,Trop Difficile,Trop Facile / Trop Difficile
3777,458,2019,Art,20,3,QCU,0.5314,0.03,0.35,32,24,17,7,1.33,70.83,17,15,53.14,Trop Facile,Difficile,Trop Facile / Difficile
4607,458,2020,Art,20,3,QCU,0.9959,0.04,0.99,37,37,37,0,1.0,100.0,37,0,99.59,Trop Facile,Trop Facile,Trop Facile / Trop Facile
458,459,2015,Art,20,4,QO,0.8483,0.05,0.36,22,20,19,1,1.1,95.0,19,3,84.83,Adapte,Facile,Adapte / Facile
1288,459,2016,Art,20,4,QO,0.8649,0.05,0.9,19,17,16,1,1.12,94.12,16,3,86.49,Trop Facile,Trop Facile,Trop Facile / Trop Facile
2118,459,2017,Art,20,4,QO,0.9841,0.02,0.92,20,20,20,0,1.0,100.0,20,0,98.41,Trop Facile,Trop Facile,Trop Facile / Trop Facile
2948,459,2018,Art,20,4,QO,0.9529,0.0,0.68,21,21,20,1,1.0,95.24,20,1,95.29,Trop Facile,Trop Facile,Trop Facile / Trop Facile
3778,459,2019,Art,20,4,QO,0.9633,0.0,0.54,25,25,24,1,1.0,96.0,24,1,96.33,Trop Facile,Trop Facile,Trop Facile / Trop Facile
4608,459,2020,Art,20,4,QO,0.9774,0.1,0.89,26,26,25,1,1.0,96.15,25,1,97.74,Trop Facile,Trop Facile,Trop Facile / Trop Facile
459,460,2015,Art,20,5,QCM,0.4974,0.28,0.39,29,25,14,11,1.16,56.0,14,15,49.74,Difficile,Difficile,Difficile / Difficile
1289,460,2016,Art,20,5,QCM,0.8165,0.05,0.77,23,22,19,3,1.05,86.36,19,4,81.65,Trop Facile,Facile,Trop Facile / Facile
2119,460,2017,Art,20,5,QCM,0.2089,0.58,0.22,26,7,5,2,3.71,71.43,5,21,20.89,Trop Facile,Trop Difficile,Trop Facile / Trop Difficile
2949,460,2018,Art,20,5,QCM,0.8796,0.08,0.9,23,22,20,2,1.05,90.91,20,3,87.96,Trop Facile,Trop Facile,Trop Facile / Trop Facile
3779,460,2019,Art,20,5,QCM,0.9407,0.02,0.93,19,18,18,0,1.06,100.0,18,1,94.07,Trop Facile,Trop Facile,Trop Facile / Trop Facile
4609,460,2020,Art,20,5,QCM,0.8678,0.09,0.82,23,22,20,2,1.05,90.91,20,3,86.78,Trop Facile,Trop Facile,Trop Facile / Trop Facile
460,461,2015,Art,20,6,QCU,0.8075,0.06,0.77,93,88,75,13,1.06,85.23,75,18,80.75,Facile,Facile,Facile / Facile
1290,461,2016,Art,20,6,QCU,0.3713,0.21,0.39,96,87,36,51,1.1,41.38,36,60,37.13,Trop Facile,Difficile,Trop Facile / Difficile
2120,461,2017,Art,20,6,QCU,0.366,0.36,0.31,108,40,40,0,2.7,100.0,40,68,36.6,Trop Facile,Difficile,Trop Facile / Difficile
2950,461,2018,Art,20,6,QCU,0.413,0.39,0.37,127,118,52,66,1.08,44.07,52,75,41.3,Trop Facile,Difficile,Trop Facile / Difficile
3780,461,2019,Art,20,6,QCU,0.9476,0.05,0.99,110,110,104,6,1.0,94.55,104,6,94.76,Trop Facile,Trop Facile,Trop Facile / Trop Facile
4610,461,2020,Art,20,6,QCU,0.9209,0.07,0.96,96,96,88,8,1.0,91.67,88,8,92.09,Trop Facile,Trop Facile,Trop Facile / Trop Facile
461,462,2015,Art,20,7,QCU,0.8201,0.03,0.89,38,36,31,5,1.06,86.11,31,7,82.01,Facile,Facile,Facile / Facile
1291,462,2016,Art,20,7,QCU,0.9085,0.03,0.91,44,40,40,0,1.1,100.0,40,4,90.85,Trop Facile,Trop Facile,Trop Facile / Trop Facile
2121,462,2017,Art,20,7,QCU,0.8794,0.07,0.99,44,39,39,0,1.13,100.0,39,5,87.94,Trop Facile,Trop Facile,Trop Facile / Trop Facile
2951,462,2018,Art,20,7,QCU,0.9705,0.01,0.95,44,43,43,0,1.02,100.0,43,1,97.05,Trop Facile,Trop Facile,Trop Facile / Trop Facile
3781,462,2019,Art,20,7,QCU,0.2708,0.37,0.36,38,20,10,10,1.9,50.0,10,28,27.08,Trop Facile,Difficile,Trop Facile / Difficile
4611,462,2020,Art,20,7,QCU,0.0392,0.53,0.21,35,24,1,23,1.46,4.17,1,34,3.92,Trop Facile,Trop Difficile,Trop Facile / Trop Difficile
462,463,2015,Art,20,8,QCM,0.9282,0.0,0.81,13,13,12,1,1.0,92.31,12,1,92.82,Trop Facile,Trop Facile,Trop Facile / Trop Facile
1292,463,2016,Art,20,8,QCM,0.636,0.27,0.57,11,10,7,3,1.1,70.0,7,4,63.6,Trop Facile,Adapte,Trop Facile / Adapte
2122,463,2017,Art,20,8,QCM,0.6539,0.16,0.5,13,10,9,1,1.3,90.0,9,4,65.39,Adapte,Adapte,Adapte / Adapte
2952,463,2018,Art,20,8,QCM,0.6489,0.28,0.67,13,13,8,5,1.0,61.54,8,5,64.89,Adapte,Adapte,Adapte / Adapte
3782,463,2019,Art,20,8,QCM,0.7343,0.21,0.54,13,12,10,2,1.08,83.33,10,3,73.43,Adapte,Adapte,Adapte / Adapte
4612,463,2020,Art,20,8,QCM,0.6634,0.29,0.69,14,11,9,2,1.27,81.82,9,5,66.34,Adapte,Adapte,Adapte / Adapte
463,464,2015,Art,20,9,QCM,0.0481,0.22,0.28,16,4,1,3,4.0,25.0,1,15,4.81,Trop Difficile,Trop Difficile,Trop Difficile / Trop Difficile
1293,464,2016,Art,20,9,QCM,0.5394,0.36,0.37,13,9,7,2,1.44,77.78,7,6,53.94,Trop Facile,Difficile,Trop Facile / Difficile
2123,464,2017,Art,20,9,QCM,0.4258,0.04,0.34,12,7,5,2,1.71,71.43,5,7,42.58,Trop Facile,Difficile,Trop Facile / Difficile
2953,464,2018,Art,20,9,QCM,0.9615,0.08,0.89,10,10,10,0,1.0,100.0,10,0,96.15,Trop Facile,Trop Facile,Trop Facile / Trop Facile
3783,464,2019,Art,20,9,QCM,0.9827,0.07,0.86,12,12,12,0,1.0,100.0,12,0,98.27,Trop Facile,Trop Facile,Trop Facile / Trop Facile
4613,464,2020,Art,20,9,QCM,0.9276,0.03,0.86,13,12,12,0,1.08,100.0,12,1,92.76,Trop Facile,Trop Facile,Trop Facile / Trop Facile
464,465,2015,Art,20,10,QCM,0.9114,0.07,0.95,83,77,76,1,1.08,98.7,76,7,91.14,Trop Facile,Trop Facile,Trop Facile / Trop Facile
1294,465,2016,Art,20,10,QCM,0.3923,0.42,0.38,93,68,36,32,1.37,52.94,36,57,39.23,Trop Facile,Difficile,Trop Facile / Difficile
2124,465,2017,Art,20,10,QCM,0.0975,0.64,0.3,100,67,10,57,1.49,14.93,10,90,9.75,Trop Facile,Trop Difficile,Trop Facile / Trop Difficile
2954,465,2018,Art,20,10,QCM,0.865,0.09,0.91,97,91,84,7,1.07,92.31,84,13,86.5,Trop Facile,Trop Facile,Trop Facile / Trop Facile
3784,465,2019,Art,20,10,QCM,0.3911,0.01,0.38,109,102,43,59,1.07,42.16,43,66,39.11,Trop Facile,Difficile,Trop Facile / Difficile
4614,465,2020,Art,20,10,QCM,0.8862,0.02,0.99,108,105,96,9,1.03,91.43,96,12,88.62,Trop Facile,Trop Facile,Trop Facile / Trop Facile
465,466,2015,Droit,1,1,QROC,0.6753,0.3,0.38,75,61,51,10,1.23,83.61,51,24,67.53,Facile,Adapte,Facile / Adapte
1295,466,2016,Droit,1,1,QROC,0.6088,0.34,0.31,78,48,47,1,1.62,97.92,47,31,60.88,Adapte,Adapte,Adapte / Adapte
2125,466,2017,Droit,1,1,QROC,0.7402,0.31,0.38,86,74,64,10,1.16,86.49,64,22,74.02,Adapte,Adapte,Adapte / Adapte
2955,466,2018,Droit,1,1,QROC,0.6485,0.4,0.25,94,61,61,0,1.54,100.0,61,33,64.85,Adapte,Adapte,Adapte / Adapte
3785,466,2019,Droit,1,1,QROC,0.6587,0.5,0.31,102,84,67,17,1.21,79.76,67,35,65.87,Adapte,Adapte,Adapte / Adapte
4615,466,2020,Droit,1,1,QROC,0.6246,0.49,0.33,106,81,66,15,1.31,81.48,66,40,62.46,Adapte,Adapte,Adapte / Adapte
466,467,2015,Droit,1,2,QCU,0.3463,0.12,0.36,5,3,2,1,1.67,66.67,2,3,34.63,Difficile,Difficile,Difficile / Difficile
1296,467,2016,Droit,1,2,QCU,0.9007,0.09,0.95,6,6,5,1,1.0,83.33,5,1,90.07,Trop Facile,Trop Facile,Trop Facile / Trop Facile
2126,467,2017,Droit,1,2,QCU,0.9375,0.02,0.95,7,7,7,0,1.0,100.0,7,0,93.75,Trop Facile,Trop Facile,Trop Facile / Trop Facile
2956,467,2018,Droit,1,2,QCU,0.9905,0.03,0.92,8,8,8,0,1.0,100.0,8,0,99.05,Trop Facile,Trop Facile,Trop Facile / Trop Facile
3786,467,2019,Droit,1,2,QCU,0.9886,0.07,0.96,6,6,6,0,1.0,100.0,6,0,98.86,Trop Facile,Trop Facile,Trop Facile / Trop Facile
4616,467,2020,Droit,1,2,QCU,0.7619,0.08,0.77,5,5,4,1,1.0,80.0,4,1,76.19,Trop Facile,Facile,Trop Facile / Facile
467,468,2015,Droit,1,3,QROC,0.8139,0.02,0.61,7,6,6,0,1.17,100.0,6,1,81.39,Facile,Facile,Facile / Facile
1297,468,2016,Droit,1,3,QROC,0.8742,0.03,0.92,6,5,5,0,1.2,100.0,5,1,87.42,Trop Facile,Trop Facile,Trop Facile / Trop Facile
2127,468,2017,Droit,1,3,QROC,0.91,0.05,0.96,6,6,5,1,1.0,83.33,5,1,91.0,Trop Facile,Trop Facile,Trop Facile / Trop Facile
2957,468,2018,Droit,1,3,QROC,0.9861,0.07,0.67,6,6,6,0,1.0,100.0,6,0,98.61,Trop Facile,Trop Facile,Trop Facile / Trop Facile
3787,468,2019,Droit,1,3,QROC,0.7974,0.12,0.43,6,5,5,0,1.2,100.0,5,1,79.74,Trop Facile,Facile,Trop Facile / Facile
4617,468,2020,Droit,1,3,QROC,0.3596,0.59,0.22,5,2,2,0,2.5,100.0,2,3,35.96,Trop Facile,Difficile,Trop Facile / Difficile
468,469,2015,Droit,1,4,QCM,0.1938,0.25,0.29,31,23,6,17,1.35,26.09,6,25,19.38,Trop Difficile,Trop Difficile,Trop Difficile / Trop Difficile
1298,469,2016,Droit,1,4,QCM,0.7236,0.22,0.58,32,29,23,6,1.1,79.31,23,9,72.36,Trop Facile,Adapte,Trop Facile / Adapte
2128,469,2017,Droit,1,4,QCM,0.6414,0.26,0.49,29,20,19,1,1.45,95.0,19,10,64.14,Adapte,Adapte,Adapte / Adapte
2958,469,2018,Droit,1,4,QCM,0.6227,0.29,0.5,24,22,15,7,1.09,68.18,15,9,62.27,Adapte,Adapte,Adapte / Adapte
3788,469,2019,Droit,1,4,QCM,0.6914,0.15,0.58,19,16,13,3,1.19,81.25,13,6,69.14,Adapte,Adapte,Adapte / Adapte
4618,469,2020,Droit,1,4,QCM,0.7114,0.08,0.48,16,13,11,2,1.23,84.62,11,5,71.14,Adapte,Adapte,Adapte / Adapte
469,470,2015,Droit,2,1,QCM,0.8855,0.02,0.94,29,26,26,0,1.12,100.0,26,3,88.55,Adapte,Trop Facile,Adapte / Trop Facile
1299,470,2016,Droit,2,1,QCM,0.8649,0.04,0.99,26,23,22,1,1.13,95.65,22,4,86.49,Trop Facile,Trop Facile,Trop Facile / Trop Facile
2129,470,2017,Droit,2,1,QCM,0.909,0.05,0.81,25,25,23,2,1.0,92.0,23,2,90.9,Trop Facile,Trop Facile,Trop Facile / Trop Facile
2959,470,2018,Droit,2,1,QCM,0.1834,0.67,0.26,30,8,6,2,3.75,75.0,6,24,18.34,Trop Facile,Trop Difficile,Trop Facile / Trop Difficile
3789,470,2019,Droit,2,1,QCM,0.5607,0.15,0.34,27,19,15,4,1.42,78.95,15,12,56.07,Trop Facile,Difficile,Trop Facile / Difficile
4619,470,2020,Droit,2,1,QCM,0.9196,0.09,0.9,30,30,28,2,1.0,93.33,28,2,91.96,Trop Facile,Trop Facile,Trop Facile / Trop Facile
470,471,2015,Droit,2,2,QCM,0.5734,0.1,0.32,70,68,40,28,1.03,58.82,40,30,57.34,Difficile,Difficile,Difficile / Difficile
1300,471,2016,Droit,2,2,QCM,0.1298,0.7,0.27,58,45,8,37,1.29,17.78,8,50,12.98,Trop Facile,Trop Difficile,Trop Facile / Trop Difficile
2130,471,2017,Droit,2,2,QCM,0.0496,0.61,0.22,60,47,3,44,1.28,6.38,3,57,4.96,Trop Facile,Trop Difficile,Trop Facile / Trop Difficile
2960,471,2018,Droit,2,2,QCM,0.8684,0.04,0.94,55,50,48,2,1.1,96.0,48,7,86.84,Trop Facile,Trop Facile,Trop Facile / Trop Facile
3790,471,2019,Droit,2,2,QCM,0.9489,0.04,0.89,52,51,49,2,1.02,96.08,49,3,94.89,Trop Facile,Trop Facile,Trop Facile / Trop Facile
4620,471,2020,Droit,2,2,QCM,0.343,0.29,0.39,51,39,17,22,1.31,43.59,17,34,34.3,Trop Facile,Difficile,Trop Facile / Difficile
471,472,2015,Droit,2,3,QROC,0.9107,0.03,0.75,57,56,52,4,1.02,92.86,52,5,91.07,Trop Facile,Trop Facile,Trop Facile / Trop Facile
1301,472,2016,Droit,2,3,QROC,0.9248,0.05,0.68,53,51,49,2,1.04,96.08,49,4,92.48,Trop Facile,Trop Facile,Trop Facile / Trop Facile
2131,472,2017,Droit,2,3,QROC,0.946,0.07,1.0,42,41,40,1,1.02,97.56,40,2,94.6,Trop Facile,Trop Facile,Trop Facile / Trop Facile
2961,472,2018,Droit,2,3,QROC,0.7995,0.13,0.54,47,42,38,4,1.12,90.48,38,9,79.95,Trop Facile,Facile,Trop Facile / Facile
3791,472,2019,Droit,2,3,QROC,0.6596,0.41,0.32,39,35,26,9,1.11,74.29,26,13,65.96,Trop Facile,Adapte,Trop Facile / Adapte
4621,472,2020,Droit,2,3,QROC,0.6305,0.37,0.27,39,35,25,10,1.11,71.43,25,14,63.05,Adapte,Adapte,Adapte / Adapte
472,473,2015,Droit,2,4,QCM,0.8097,0.13,0.77,50,45,40,5,1.11,88.89,40,10,80.97,Facile,Facile,Facile / Facile
1302,473,2016,Droit,2,4,QCM,0.9989,0.0,0.97,54,54,54,0,1.0,100.0,54,0,99.89,Trop Facile,Trop Facile,Trop Facile / Trop Facile
2132,473,2017,Droit,2,4,QCM,0.8915,0.1,0.85,54,52,48,4,1.04,92.31,48,6,89.15,Trop Facile,Trop Facile,Trop Facile / Trop Facile
2962,473,2018,Droit,2,4,QCM,0.9917,0.08,0.87,55,55,55,0,1.0,100.0,55,0,99.17,Trop Facile,Trop Facile,Trop Facile / Trop Facile
3792,473,2019,Droit,2,4,QCM,0.4545,0.25,0.35,62,45,28,17,1.38,62.22,28,34,45.45,Trop Facile,Difficile,Trop Facile / Difficile
4622,473,2020,Droit,2,4,QCM,0.0584,0.16,0.26,69,27,4,23,2.56,14.81,4,65,5.84,Trop Facile,Trop Difficile,Trop Facile / Trop Difficile
473,474,2015,Droit,2,5,QCU,0.7145,0.07,0.56,56,47,40,7,1.19,85.11,40,16,71.45,Adapte,Adapte,Adapte / Adapte
1303,474,2016,Droit,2,5,QCU,0.6212,0.3,0.66,48,42,30,12,1.14,71.43,30,18,62.12,Adapte,Adapte,Adapte / Adapte
2133,474,2017,Droit,2,5,QCU,0.6066,0.17,0.57,47,29,29,0,1.62,100.0,29,18,60.66,Adapte,Adapte,Adapte / Adapte
2963,474,2018,Droit,2,5,QCU,0.6024,0.22,0.51,54,35,33,2,1.54,94.29,33,21,60.24,Adapte,Adapte,Adapte / Adapte
3793,474,2019,Droit,2,5,QCU,0.7128,0.2,0.63,50,47,36,11,1.06,76.6,36,14,71.28,Adapte,Adapte,Adapte / Adapte
4623,474,2020,Droit,2,5,QCU,0.7132,0.2,0.65,53,52,38,14,1.02,73.08,38,15,71.32,Adapte,Adapte,Adapte / Adapte
474,475,2015,Droit,3,1,QROC,0.8035,0.18,0.52,80,71,64,7,1.13,90.14,64,16,80.35,Trop Difficile,Facile,Trop Difficile / Facile
1304,475,2016,Droit,3,1,QROC,0.1595,0.86,0.03,90,46,14,32,1.96,30.43,14,76,15.95,Trop Facile,Trop Difficile,Trop Facile / Trop Difficile
2134,475,2017,Droit,3,1,QROC,0.6133,0.33,0.26,91,73,56,17,1.25,76.71,56,35,61.33,Trop Facile,Adapte,Trop Facile / Adapte
2964,475,2018,Droit,3,1,QROC,0.6763,0.46,0.33,107,91,72,19,1.18,79.12,72,35,67.63,Adapte,Adapte,Adapte / Adapte
3794,475,2019,Droit,3,1,QROC,0.6811,0.41,0.38,113,95,77,18,1.19,81.05,77,36,68.11,Adapte,Adapte,Adapte / Adapte
4624,475,2020,Droit,3,1,QROC,0.607,0.23,0.35,124,102,75,27,1.22,73.53,75,49,60.7,Adapte,Adapte,Adapte / Adapte
475,476,2015,Droit,3,2,QCU,0.9522,0.07,0.95,41,40,39,1,1.02,97.5,39,2,95.22,Trop Facile,Trop Facile,Trop Facile / Trop Facile
1305,476,2016,Droit,3,2,QCU,0.9951,0.01,0.91,33,33,33,0,1.0,100.0,33,0,99.51,Trop Facile,Trop Facile,Trop Facile / Trop Facile
2135,476,2017,Droit,3,2,QCU,0.9004,0.09,0.92,39,38,35,3,1.03,92.11,35,4,90.04,Trop Facile,Trop Facile,Trop Facile / Trop Facile
2965,476,2018,Droit,3,2,QCU,0.9067,0.03,0.97,37,36,34,2,1.03,94.44,34,3,90.67,Trop Facile,Trop Facile,Trop Facile / Trop Facile
3795,476,2019,Droit,3,2,QCU,0.9325,0.1,0.98,43,42,40,2,1.02,95.24,40,3,93.25,Trop Facile,Trop Facile,Trop Facile / Trop Facile
4625,476,2020,Droit,3,2,QCU,0.8694,0.04,0.98,41,38,36,2,1.08,94.74,36,5,86.94,Trop Facile,Trop Facile,Trop Facile / Trop Facile
476,477,2015,Droit,3,3,QCU,0.9718,0.02,0.94,88,88,86,2,1.0,97.73,86,2,97.18,Facile,Trop Facile,Facile / Trop Facile
1306,477,2016,Droit,3,3,QCU,0.8943,0.01,0.99,106,97,95,2,1.09,97.94,95,11,89.43,Trop Facile,Trop Facile,Trop Facile / Trop Facile
2136,477,2017,Droit,3,3,QCU,0.7802,0.12,0.82,113,96,88,8,1.18,91.67,88,25,78.02,Trop Facile,Facile,Trop Facile / Facile
2966,477,2018,Droit,3,3,QCU,0.9268,0.01,0.94,119,113,110,3,1.05,97.35,110,9,92.68,Trop Facile,Trop Facile,Trop Facile / Trop Facile
3796,477,2019,Droit,3,3,QCU,0.7995,0.19,0.9,130,108,104,4,1.2,96.3,104,26,79.95,Trop Facile,Facile,Trop Facile / Facile
4626,477,2020,Droit,3,3,QCU,0.9724,0.05,0.99,133,132,129,3,1.01,97.73,129,4,97.24,Trop Facile,Trop Facile,Trop Facile / Trop Facile
477,478,2015,Droit,3,4,QCU,0.1376,0.1,0.23,10,6,1,5,1.67,16.67,1,9,13.76,Trop Difficile,Trop Difficile,Trop Difficile / Trop Difficile
1307,478,2016,Droit,3,4,QCU,0.2172,0.33,0.22,12,5,3,2,2.4,60.0,3,9,21.72,Trop Facile,Trop Difficile,Trop Facile / Trop Difficile
2137,478,2017,Droit,3,4,QCU,0.9153,0.07,0.91,13,12,12,0,1.08,100.0,12,1,91.53,Trop Facile,Trop Facile,Trop Facile / Trop Facile
2967,478,2018,Droit,3,4,QCU,0.4556,0.32,0.35,15,12,7,5,1.25,58.33,7,8,45.56,Trop Facile,Difficile,Trop Facile / Difficile
3797,478,2019,Droit,3,4,QCU,0.0578,0.02,0.27,15,14,1,13,1.07,7.14,1,14,5.78,Trop Facile,Trop Difficile,Trop Facile / Trop Difficile
4627,478,2020,Droit,3,4,QCU,0.9782,0.08,0.96,17,17,17,0,1.0,100.0,17,0,97.82,Trop Facile,Trop Facile,Trop Facile / Trop Facile
478,479,2015,Droit,3,5,QCM,0.7971,0.05,0.7,69,62,55,7,1.11,88.71,55,14,79.71,Facile,Facile,Facile / Facile
1308,479,2016,Droit,3,5,QCM,0.998,0.01,0.93,83,83,83,0,1.0,100.0,83,0,99.8,Trop Facile,Trop Facile,Trop Facile / Trop Facile
2138,479,2017,Droit,3,5,QCM,0.9769,0.01,0.95,77,77,75,2,1.0,97.4,75,2,97.69,Trop Facile,Trop Facile,Trop Facile / Trop Facile
2968,479,2018,Droit,3,5,QCM,0.6422,0.06,0.46,89,88,57,31,1.01,64.77,57,32,64.22,Trop Facile,Adapte,Trop Facile / Adapte
3798,479,2019,Droit,3,5,QCM,0.633,0.24,0.67,83,72,53,19,1.15,73.61,53,30,63.3,Adapte,Adapte,Adapte / Adapte
4628,479,2020,Droit,3,5,QCM,0.6335,0.21,0.43,81,71,51,20,1.14,71.83,51,30,63.35,Adapte,Adapte,Adapte / Adapte
479,480,2015,Droit,3,6,QCM,0.3979,0.49,0.4,68,64,27,37,1.06,42.19,27,41,39.79,Trop Difficile,Difficile,Trop Difficile / Difficile
1309,480,2016,Droit,3,6,QCM,0.9716,0.04,0.93,70,70,68,2,1.0,97.14,68,2,97.16,Trop Facile,Trop Facile,Trop Facile / Trop Facile
2139,480,2017,Droit,3,6,QCM,0.918,0.0,0.91,77,73,71,2,1.05,97.26,71,6,91.8,Trop Facile,Trop Facile,Trop Facile / Trop Facile
2969,480,2018,Droit,3,6,QCM,0.5213,0.04,0.4,75,47,39,8,1.6,82.98,39,36,52.13,Trop Facile,Difficile,Trop Facile / Difficile
3799,480,2019,Droit,3,6,QCM,0.9886,0.02,0.86,70,69,69,0,1.01,100.0,69,1,98.86,Trop Facile,Trop Facile,Trop Facile / Trop Facile
4629,480,2020,Droit,3,6,QCM,0.8973,0.05,0.81,68,65,61,4,1.05,93.85,61,7,89.73,Trop Facile,Trop Facile,Trop Facile / Trop Facile
480,481,2015,Droit,3,7,QCU,0.0053,0.35,0.27,51,45,0,45,1.13,0.0,0,51,0.53,Trop Difficile,Trop Difficile,Trop Difficile / Trop Difficile
1310,481,2016,Droit,3,7,QCU,0.9562,0.06,0.97,47,46,45,1,1.02,97.83,45,2,95.62,Trop Facile,Trop Facile,Trop Facile / Trop Facile
2140,481,2017,Droit,3,7,QCU,0.8613,0.03,0.99,52,47,45,2,1.11,95.74,45,7,86.13,Trop Facile,Trop Facile,Trop Facile / Trop Facile
2970,481,2018,Droit,3,7,QCU,0.4785,0.15,0.35,47,23,22,1,2.04,95.65,22,25,47.85,Trop Facile,Difficile,Trop Facile / Difficile
3800,481,2019,Droit,3,7,QCU,0.9865,0.05,0.92,45,44,44,0,1.02,100.0,44,1,98.65,Trop Facile,Trop Facile,Trop Facile / Trop Facile
4630,481,2020,Droit,3,7,QCU,0.9353,0.03,0.98,50,50,47,3,1.0,94.0,47,3,93.53,Trop Facile,Trop Facile,Trop Facile / Trop Facile
481,482,2015,Droit,3,8,QCU,0.8775,0.07,0.96,39,38,34,4,1.03,89.47,34,5,87.75,Trop Facile,Trop Facile,Trop Facile / Trop Facile
1311,482,2016,Droit,3,8,QCU,0.935,0.1,0.9,33,32,31,1,1.03,96.88,31,2,93.5,Trop Facile,Trop Facile,Trop Facile / Trop Facile
2141,482,2017,Droit,3,8,QCU,0.8651,0.09,0.91,39,39,34,5,1.0,87.18,34,5,86.51,Trop Facile,Trop Facile,Trop Facile / Trop Facile
2971,482,2018,Droit,3,8,QCU,0.9813,0.07,0.92,38,37,37,0,1.03,100.0,37,1,98.13,Trop Facile,Trop Facile,Trop Facile / Trop Facile
3801,482,2019,Droit,3,8,QCU,0.9363,0.09,0.99,39,39,37,2,1.0,94.87,37,2,93.63,Trop Facile,Trop Facile,Trop Facile / Trop Facile
4631,482,2020,Droit,3,8,QCU,0.0809,0.66,0.26,33,27,3,24,1.22,11.11,3,30,8.09,Trop Facile,Trop Difficile,Trop Facile / Trop Difficile
482,483,2015,Droit,3,9,QCM,0.7046,0.0,0.61,51,44,36,8,1.16,81.82,36,15,70.46,Difficile,Adapte,Difficile / Adapte
1312,483,2016,Droit,3,9,QCM,0.6846,0.25,0.41,49,40,34,6,1.23,85.0,34,15,68.46,Adapte,Adapte,Adapte / Adapte
2142,483,2017,Droit,3,9,QCM,0.6092,0.24,0.56,46,31,28,3,1.48,90.32,28,18,60.92,Adapte,Adapte,Adapte / Adapte
2972,483,2018,Droit,3,9,QCM,0.727,0.11,0.52,50,48,36,12,1.04,75.0,36,14,72.7,Adapte,Adapte,Adapte / Adapte
3802,483,2019,Droit,3,9,QCM,0.6009,0.12,0.62,40,25,24,1,1.6,96.0,24,16,60.09,Adapte,Adapte,Adapte / Adapte
4632,483,2020,Droit,3,9,QCM,0.6042,0.27,0.58,45,40,27,13,1.12,67.5,27,18,60.42,Adapte,Adapte,Adapte / Adapte
483,484,2015,Droit,4,1,QCU,0.1055,0.52,0.26,50,32,5,27,1.56,15.62,5,45,10.55,Trop Difficile,Trop Difficile,Trop Difficile / Trop Difficile
1313,484,2016,Droit,4,1,QCU,0.9273,0.09,0.97,60,57,56,1,1.05,98.25,56,4,92.73,Trop Facile,Trop Facile,Trop Facile / Trop Facile
2143,484,2017,Droit,4,1,QCU,0.9657,0.04,0.93,68,67,66,1,1.01,98.51,66,2,96.57,Trop Facile,Trop Facile,Trop Facile / Trop Facile
2973,484,2018,Droit,4,1,QCU,0.581,0.32,0.33,72,56,42,14,1.29,75.0,42,30,58.1,Trop Facile,Difficile,Trop Facile / Difficile
3803,484,2019,Droit,4,1,QCU,0.8253,0.06,0.85,84,76,69,7,1.11,90.79,69,15,82.53,Trop Facile,Facile,Trop Facile / Facile
4633,484,2020,Droit,4,1,QCU,0.943,0.01,1.0,79,79,74,5,1.0,93.67,74,5,94.3,Trop Facile,Trop Facile,Trop Facile / Trop Facile
484,485,2015,Droit,4,2,QCU,0.4791,0.2,0.34,21,20,10,10,1.05,50.0,10,11,47.91,Facile,Difficile,Facile / Difficile
1314,485,2016,Droit,4,2,QCU,0.8018,0.01,0.8,22,22,18,4,1.0,81.82,18,4,80.18,Trop Facile,Facile,Trop Facile / Facile
2144,485,2017,Droit,4,2,QCU,0.9267,0.01,0.92,18,18,17,1,1.0,94.44,17,1,92.67,Trop Facile,Trop Facile,Trop Facile / Trop Facile
2974,485,2018,Droit,4,2,QCU,0.9736,0.06,0.95,14,14,14,0,1.0,100.0,14,0,97.36,Trop Facile,Trop Facile,Trop Facile / Trop Facile
3804,485,2019,Droit,4,2,QCU,0.8694,0.09,0.99,15,14,13,1,1.07,92.86,13,2,86.94,Trop Facile,Trop Facile,Trop Facile / Trop Facile
4634,485,2020,Droit,4,2,QCU,0.8959,0.08,0.94,13,12,12,0,1.08,100.0,12,1,89.59,Trop Facile,Trop Facile,Trop Facile / Trop Facile
485,486,2015,Droit,4,3,QCM,0.5305,0.13,0.36,25,16,13,3,1.56,81.25,13,12,53.05,Adapte,Difficile,Adapte / Difficile
1315,486,2016,Droit,4,3,QCM,0.9617,0.07,0.97,27,27,26,1,1.0,96.3,26,1,96.17,Trop Facile,Trop Facile,Trop Facile / Trop Facile
2145,486,2017,Droit,4,3,QCM,0.7885,0.0,0.7,24,22,19,3,1.09,86.36,19,5,78.85,Trop Facile,Facile,Trop Facile / Facile
2975,486,2018,Droit,4,3,QCM,0.8699,0.06,0.82,21,21,18,3,1.0,85.71,18,3,86.99,Trop Facile,Trop Facile,Trop Facile / Trop Facile
3805,486,2019,Droit,4,3,QCM,0.6656,0.14,0.44,21,19,14,5,1.11,73.68,14,7,66.56,Trop Facile,Adapte,Trop Facile / Adapte
4635,486,2020,Droit,4,3,QCM,0.6124,0.02,0.53,25,19,15,4,1.32,78.95,15,10,61.24,Adapte,Adapte,Adapte / Adapte
486,487,2015,Droit,4,4,QCM,0.9839,0.07,0.96,87,86,86,0,1.01,100.0,86,1,98.39,Trop Facile,Trop Facile,Trop Facile / Trop Facile
1316,487,2016,Droit,4,4,QCM,0.9564,0.0,0.81,88,87,84,3,1.01,96.55,84,4,95.64,Trop Facile,Trop Facile,Trop Facile / Trop Facile
2146,487,2017,Droit,4,4,QCM,0.9077,0.1,0.96,79,77,72,5,1.03,93.51,72,7,90.77,Trop Facile,Trop Facile,Trop Facile / Trop Facile
2976,487,2018,Droit,4,4,QCM,0.974,0.07,0.85,76,75,74,1,1.01,98.67,74,2,97.4,Trop Facile,Trop Facile,Trop Facile / Trop Facile
3806,487,2019,Droit,4,4,QCM,0.911,0.0,0.84,80,73,73,0,1.1,100.0,73,7,91.1,Trop Facile,Trop Facile,Trop Facile / Trop Facile
4636,487,2020,Droit,4,4,QCM,0.8865,0.08,0.86,76,74,67,7,1.03,90.54,67,9,88.65,Trop Facile,Trop Facile,Trop Facile / Trop Facile
487,488,2015,Droit,4,5,QCU,0.0818,0.26,0.21,44,18,4,14,2.44,22.22,4,40,8.18,Trop Difficile,Trop Difficile,Trop Difficile / Trop Difficile
1317,488,2016,Droit,4,5,QCU,0.9289,0.1,0.98,40,39,37,2,1.03,94.87,37,3,92.89,Trop Facile,Trop Facile,Trop Facile / Trop Facile
2147,488,2017,Droit,4,5,QCU,0.8984,0.09,0.97,42,39,38,1,1.08,97.44,38,4,89.84,Trop Facile,Trop Facile,Trop Facile / Trop Facile
2977,488,2018,Droit,4,5,QCU,0.8793,0.02,0.97,37,37,33,4,1.0,89.19,33,4,87.93,Trop Facile,Trop Facile,Trop Facile / Trop Facile
3807,488,2019,Droit,4,5,QCU,0.9689,0.02,0.91,41,40,40,0,1.02,100.0,40,1,96.89,Trop Facile,Trop Facile,Trop Facile / Trop Facile
4637,488,2020,Droit,4,5,QCU,0.8621,0.09,0.92,43,37,37,0,1.16,100.0,37,6,86.21,Trop Facile,Trop Facile,Trop Facile / Trop Facile
488,489,2015,Droit,4,6,QCU,0.7609,0.07,0.88,53,44,40,4,1.2,90.91,40,13,76.09,Facile,Facile,Facile / Facile
1318,489,2016,Droit,4,6,QCU,0.9338,0.04,0.9,57,56,53,3,1.02,94.64,53,4,93.38,Trop Facile,Trop Facile,Trop Facile / Trop Facile
2148,489,2017,Droit,4,6,QCU,0.9892,0.05,0.99,46,46,46,0,1.0,100.0,46,0,98.92,Trop Facile,Trop Facile,Trop Facile / Trop Facile
2978,489,2018,Droit,4,6,QCU,0.962,0.07,0.92,41,41,39,2,1.0,95.12,39,2,96.2,Trop Facile,Trop Facile,Trop Facile / Trop Facile
3808,489,2019,Droit,4,6,QCU,0.6082,0.12,0.58,42,35,26,9,1.2,74.29,26,16,60.82,Trop Facile,Adapte,Trop Facile / Adapte
4638,489,2020,Droit,4,6,QCU,0.6583,0.01,0.49,49,45,32,13,1.09,71.11,32,17,65.83,Adapte,Adapte,Adapte / Adapte
489,490,2015,Droit,4,7,QCM,0.2558,0.3,0.33,84,70,21,49,1.2,30.0,21,63,25.58,Adapte,Difficile,Adapte / Difficile
1319,490,2016,Droit,4,7,QCM,0.9425,0.04,0.82,90,85,85,0,1.06,100.0,85,5,94.25,Trop Facile,Trop Facile,Trop Facile / Trop Facile
2149,490,2017,Droit,4,7,QCM,0.8908,0.1,0.9,92,83,82,1,1.11,98.8,82,10,89.08,Trop Facile,Trop Facile,Trop Facile / Trop Facile
2979,490,2018,Droit,4,7,QCM,0.9746,0.01,0.85,109,107,106,1,1.02,99.07,106,3,97.46,Trop Facile,Trop Facile,Trop Facile / Trop Facile
3809,490,2019,Droit,4,7,QCM,0.8743,0.03,0.81,87,85,76,9,1.02,89.41,76,11,87.43,Trop Facile,Trop Facile,Trop Facile / Trop Facile
4639,490,2020,Droit,4,7,QCM,0.9569,0.03,0.8,87,83,83,0,1.05,100.0,83,4,95.69,Trop Facile,Trop Facile,Trop Facile / Trop Facile
490,491,2015,Droit,4,8,QCU,0.1327,0.51,0.28,8,8,1,7,1.0,12.5,1,7,13.27,Trop Difficile,Trop Difficile,Trop Difficile / Trop Difficile
1320,491,2016,Droit,4,8,QCU,0.904,0.04,0.99,8,7,7,0,1.14,100.0,7,1,90.4,Trop Facile,Trop Facile,Trop Facile / Trop Facile
2150,491,2017,Droit,4,8,QCU,0.866,0.07,0.91,9,8,8,0,1.12,100.0,8,1,86.6,Trop Facile,Trop Facile,Trop Facile / Trop Facile
2980,491,2018,Droit,4,8,QCU,0.6499,0.18,0.56,10,7,6,1,1.43,85.71,6,4,64.99,Trop Facile,Adapte,Trop Facile / Adapte
3810,491,2019,Droit,4,8,QCU,0.7371,0.2,0.5,9,8,7,1,1.12,87.5,7,2,73.71,Adapte,Adapte,Adapte / Adapte
4640,491,2020,Droit,4,8,QCU,0.7132,0.24,0.6,10,9,7,2,1.11,77.78,7,3,71.32,Adapte,Adapte,Adapte / Adapte
491,492,2015,Droit,5,1,QCM,0.7953,0.16,0.75,84,68,67,1,1.24,98.53,67,17,79.53,Facile,Facile,Facile / Facile
1321,492,2016,Droit,5,1,QCM,0.9243,0.07,0.97,78,74,72,2,1.05,97.3,72,6,92.43,Trop Facile,Trop Facile,Trop Facile / Trop Facile
2151,492,2017,Droit,5,1,QCM,0.982,0.1,0.88,64,63,63,0,1.02,100.0,63,1,98.2,Trop Facile,Trop Facile,Trop Facile / Trop Facile
2981,492,2018,Droit,5,1,QCM,0.5346,0.27,0.33,55,45,29,16,1.22,64.44,29,26,53.46,Trop Facile,Difficile,Trop Facile / Difficile
3811,492,2019,Droit,5,1,QCM,0.878,0.06,0.92,48,47,42,5,1.02,89.36,42,6,87.8,Trop Facile,Trop Facile,Trop Facile / Trop Facile
4641,492,2020,Droit,5,1,QCM,0.8608,0.07,0.9,44,40,38,2,1.1,95.0,38,6,86.08,Trop Facile,Trop Facile,Trop Facile / Trop Facile
492,493,2015,Droit,5,2,QCM,0.1387,0.62,0.28,79,21,11,10,3.76,52.38,11,68,13.87,Trop Facile,Trop Difficile,Trop Facile / Trop Difficile
1322,493,2016,Droit,5,2,QCM,0.9815,0.05,0.83,67,66,66,0,1.02,100.0,66,1,98.15,Trop Facile,Trop Facile,Trop Facile / Trop Facile
2152,493,2017,Droit,5,2,QCM,0.626,0.28,0.67,80,56,50,6,1.43,89.29,50,30,62.6,Trop Facile,Adapte,Trop Facile / Adapte
2982,493,2018,Droit,5,2,QCM,0.6867,0.23,0.5,84,70,58,12,1.2,82.86,58,26,68.67,Adapte,Adapte,Adapte / Adapte
3812,493,2019,Droit,5,2,QCM,0.7181,0.21,0.52,87,63,62,1,1.38,98.41,62,25,71.81,Adapte,Adapte,Adapte / Adapte
4642,493,2020,Droit,5,2,QCM,0.7438,0.28,0.69,76,58,57,1,1.31,98.28,57,19,74.38,Adapte,Adapte,Adapte / Adapte
493,494,2015,Droit,5,3,QCU,0.1976,0.1,0.21,38,28,8,20,1.36,28.57,8,30,19.76,Trop Difficile,Trop Difficile,Trop Difficile / Trop Difficile
1323,494,2016,Droit,5,3,QCU,0.1532,0.31,0.29,30,10,5,5,3.0,50.0,5,25,15.32,Trop Facile,Trop Difficile,Trop Facile / Trop Difficile
2153,494,2017,Droit,5,3,QCU,0.9081,0.06,0.91,36,34,33,1,1.06,97.06,33,3,90.81,Trop Facile,Trop Facile,Trop Facile / Trop Facile
2983,494,2018,Droit,5,3,QCU,0.97,0.06,0.97,33,33,32,1,1.0,96.97,32,1,97.0,Trop Facile,Trop Facile,Trop Facile / Trop Facile
3813,494,2019,Droit,5,3,QCU,0.9698,0.07,0.93,33,32,32,0,1.03,100.0,32,1,96.98,Trop Facile,Trop Facile,Trop Facile / Trop Facile
4643,494,2020,Droit,5,3,QCU,0.9471,0.08,0.96,40,40,38,2,1.0,95.0,38,2,94.71,Trop Facile,Trop Facile,Trop Facile / Trop Facile
494,495,2015,Droit,5,4,QCM,0.8916,0.05,0.87,32,31,29,2,1.03,93.55,29,3,89.16,Difficile,Trop Facile,Difficile / Trop Facile
1324,495,2016,Droit,5,4,QCM,0.9547,0.08,0.94,38,38,36,2,1.0,94.74,36,2,95.47,Trop Facile,Trop Facile,Trop Facile / Trop Facile
2154,495,2017,Droit,5,4,QCM,0.8616,0.05,0.96,45,44,39,5,1.02,88.64,39,6,86.16,Trop Facile,Trop Facile,Trop Facile / Trop Facile
2984,495,2018,Droit,5,4,QCM,0.9067,0.07,0.9,37,37,34,3,1.0,91.89,34,3,90.67,Trop Facile,Trop Facile,Trop Facile / Trop Facile
3814,495,2019,Droit,5,4,QCM,0.961,0.04,0.94,37,37,36,1,1.0,97.3,36,1,96.1,Trop Facile,Trop Facile,Trop Facile / Trop Facile
4644,495,2020,Droit,5,4,QCM,0.9818,0.06,0.84,31,30,30,0,1.03,100.0,30,1,98.18,Trop Facile,Trop Facile,Trop Facile / Trop Facile
495,496,2015,Droit,6,1,QO,0.3676,0.89,0.13,84,49,31,18,1.71,63.27,31,53,36.76,Trop Facile,Difficile,Trop Facile / Difficile
1325,496,2016,Droit,6,1,QO,0.8854,0.03,0.93,82,81,73,8,1.01,90.12,73,9,88.54,Trop Facile,Trop Facile,Trop Facile / Trop Facile
2155,496,2017,Droit,6,1,QO,0.6715,0.6,0.27,74,61,50,11,1.21,81.97,50,24,67.15,Trop Facile,Adapte,Trop Facile / Adapte
2985,496,2018,Droit,6,1,QO,0.6879,0.56,0.15,70,68,48,20,1.03,70.59,48,22,68.79,Adapte,Adapte,Adapte / Adapte
3815,496,2019,Droit,6,1,QO,0.6629,0.47,0.24,69,57,46,11,1.21,80.7,46,23,66.29,Adapte,Adapte,Adapte / Adapte
4645,496,2020,Droit,6,1,QO,0.6477,0.67,0.25,59,53,38,15,1.11,71.7,38,21,64.77,Adapte,Adapte,Adapte / Adapte
496,497,2015,Droit,6,2,QCU,0.8912,0.04,0.96,11,11,10,1,1.0,90.91,10,1,89.12,Trop Facile,Trop Facile,Trop Facile / Trop Facile
1326,497,2016,Droit,6,2,QCU,0.8652,0.03,0.97,11,11,10,1,1.0,90.91,10,1,86.52,Trop Facile,Trop Facile,Trop Facile / Trop Facile
2156,497,2017,Droit,6,2,QCU,0.9325,0.05,0.99,9,8,8,0,1.12,100.0,8,1,93.25,Trop Facile,Trop Facile,Trop Facile / Trop Facile
2986,497,2018,Droit,6,2,QCU,0.0005,0.65,0.22,7,3,0,3,2.33,0.0,0,7,0.05,Trop Facile,Trop Difficile,Trop Facile / Trop Difficile
3816,497,2019,Droit,6,2,QCU,0.9549,0.02,0.94,8,8,8,0,1.0,100.0,8,0,95.49,Trop Facile,Trop Facile,Trop Facile / Trop Facile
4646,497,2020,Droit,6,2,QCU,0.9188,0.01,0.92,6,6,6,0,1.0,100.0,6,0,91.88,Trop Facile,Trop Facile,Trop Facile / Trop Facile
497,498,2015,Droit,6,3,QCU,0.6534,0.28,0.69,98,90,64,26,1.09,71.11,64,34,65.34,Difficile,Adapte,Difficile / Adapte
1327,498,2016,Droit,6,3,QCU,0.7334,0.16,0.41,94,86,69,17,1.09,80.23,69,25,73.34,Adapte,Adapte,Adapte / Adapte
2157,498,2017,Droit,6,3,QCU,0.7132,0.28,0.63,79,70,56,14,1.13,80.0,56,23,71.32,Adapte,Adapte,Adapte / Adapte
2987,498,2018,Droit,6,3,QCU,0.7203,0.28,0.42,67,54,48,6,1.24,88.89,48,19,72.03,Adapte,Adapte,Adapte / Adapte
3817,498,2019,Droit,6,3,QCU,0.6369,0.15,0.6,74,62,47,15,1.19,75.81,47,27,63.69,Adapte,Adapte,Adapte / Adapte
4647,498,2020,Droit,6,3,QCU,0.637,0.0,0.4,67,59,43,16,1.14,72.88,43,24,63.7,Adapte,Adapte,Adapte / Adapte
498,499,2015,Droit,6,4,QCM,0.7117,0.05,0.52,88,85,63,22,1.04,74.12,63,25,71.17,Difficile,Adapte,Difficile / Adapte
1328,499,2016,Droit,6,4,QCM,0.7105,0.1,0.48,92,78,65,13,1.18,83.33,65,27,71.05,Adapte,Adapte,Adapte / Adapte
2158,499,2017,Droit,6,4,QCM,0.6049,0.15,0.43,84,56,51,5,1.5,91.07,51,33,60.49,Adapte,Adapte,Adapte / Adapte
2988,499,2018,Droit,6,4,QCM,0.6196,0.12,0.47,79,78,49,29,1.01,62.82,49,30,61.96,Adapte,Adapte,Adapte / Adapte
3818,499,2019,Droit,6,4,QCM,0.6165,0.06,0.52,73,67,45,22,1.09,67.16,45,28,61.65,Adapte,Adapte,Adapte / Adapte
4648,499,2020,Droit,6,4,QCM,0.6507,0.08,0.52,64,61,42,19,1.05,68.85,42,22,65.07,Adapte,Adapte,Adapte / Adapte
499,500,2015,Droit,6,5,QCM,0.7465,0.22,0.58,34,34,25,9,1.0,73.53,25,9,74.65,Adapte,Adapte,Adapte / Adapte
1329,500,2016,Droit,6,5,QCM,0.6581,0.08,0.41,40,36,26,10,1.11,72.22,26,14,65.81,Adapte,Adapte,Adapte / Adapte
2159,500,2017,Droit,6,5,QCM,0.7404,0.23,0.51,42,39,31,8,1.08,79.49,31,11,74.04,Adapte,Adapte,Adapte / Adapte
2989,500,2018,Droit,6,5,QCM,0.6207,0.03,0.51,35,32,22,10,1.09,68.75,22,13,62.07,Adapte,Adapte,Adapte / Adapte
3819,500,2019,Droit,6,5,QCM,0.652,0.29,0.64,38,33,25,8,1.15,75.76,25,13,65.2,Adapte,Adapte,Adapte / Adapte
4649,500,2020,Droit,6,5,QCM,0.646,0.16,0.42,36,34,23,11,1.06,67.65,23,13,64.6,Adapte,Adapte,Adapte / Adapte
500,501,2015,Droit,6,6,QCU,0.7897,0.06,0.86,14,13,11,2,1.08,84.62,11,3,78.97,Facile,Facile,Facile / Facile
1330,501,2016,Droit,6,6,QCU,0.9101,0.03,0.91,11,10,10,0,1.1,100.0,10,1,91.01,Trop Facile,Trop Facile,Trop Facile / Trop Facile
2160,501,2017,Droit,6,6,QCU,0.8834,0.07,0.94,9,9,8,1,1.0,88.89,8,1,88.34,Trop Facile,Trop Facile,Trop Facile / Trop Facile
2990,501,2018,Droit,6,6,QCU,0.996,0.02,0.97,11,11,11,0,1.0,100.0,11,0,99.6,Trop Facile,Trop Facile,Trop Facile / Trop Facile
3820,501,2019,Droit,6,6,QCU,0.9048,0.1,0.91,12,11,11,0,1.09,100.0,11,1,90.48,Trop Facile,Trop Facile,Trop Facile / Trop Facile
4650,501,2020,Droit,6,6,QCU,0.7715,0.13,0.89,11,10,8,2,1.1,80.0,8,3,77.15,Trop Facile,Facile,Trop Facile / Facile
501,502,2015,Droit,6,7,QCM,0.6097,0.07,0.42,26,21,16,5,1.24,76.19,16,10,60.97,Adapte,Adapte,Adapte / Adapte
1331,502,2016,Droit,6,7,QCM,0.6762,0.17,0.42,29,26,20,6,1.12,76.92,20,9,67.62,Adapte,Adapte,Adapte / Adapte
2161,502,2017,Droit,6,7,QCM,0.6569,0.13,0.44,30,22,20,2,1.36,90.91,20,10,65.69,Adapte,Adapte,Adapte / Adapte
2991,502,2018,Droit,6,7,QCM,0.6666,0.06,0.46,24,21,16,5,1.14,76.19,16,8,66.66,Adapte,Adapte,Adapte / Adapte
3821,502,2019,Droit,6,7,QCM,0.7048,0.07,0.45,23,21,16,5,1.1,76.19,16,7,70.48,Adapte,Adapte,Adapte / Adapte
4651,502,2020,Droit,6,7,QCM,0.7099,0.18,0.5,22,19,16,3,1.16,84.21,16,6,70.99,Adapte,Adapte,Adapte / Adapte
502,503,2015,Droit,6,8,QCU,0.0391,0.09,0.28,91,88,4,84,1.03,4.55,4,87,3.91,Trop Difficile,Trop Difficile,Trop Difficile / Trop Difficile
1332,503,2016,Droit,6,8,QCU,0.4605,0.31,0.38,108,90,50,40,1.2,55.56,50,58,46.05,Trop Facile,Difficile,Trop Facile / Difficile
2162,503,2017,Droit,6,8,QCU,0.9653,0.07,0.97,110,110,106,4,1.0,96.36,106,4,96.53,Trop Facile,Trop Facile,Trop Facile / Trop Facile
2992,503,2018,Droit,6,8,QCU,0.2664,0.25,0.34,117,72,31,41,1.62,43.06,31,86,26.64,Trop Facile,Difficile,Trop Facile / Difficile
3822,503,2019,Droit,6,8,QCU,0.8982,0.03,0.97,119,113,107,6,1.05,94.69,107,12,89.82,Trop Facile,Trop Facile,Trop Facile / Trop Facile
4652,503,2020,Droit,6,8,QCU,0.8738,0.01,1.0,131,128,114,14,1.02,89.06,114,17,87.38,Trop Facile,Trop Facile,Trop Facile / Trop Facile
503,504,2015,Droit,6,9,QCM,0.2373,0.58,0.26,44,44,10,34,1.0,22.73,10,34,23.73,Trop Difficile,Trop Difficile,Trop Difficile / Trop Difficile
1333,504,2016,Droit,6,9,QCM,0.6935,0.14,0.62,46,42,32,10,1.1,76.19,32,14,69.35,Trop Facile,Adapte,Trop Facile / Adapte
2163,504,2017,Droit,6,9,QCM,0.707,0.14,0.45,53,43,37,6,1.23,86.05,37,16,70.7,Adapte,Adapte,Adapte / Adapte
2993,504,2018,Droit,6,9,QCM,0.6693,0.16,0.51,62,50,41,9,1.24,82.0,41,21,66.93,Adapte,Adapte,Adapte / Adapte
3823,504,2019,Droit,6,9,QCM,0.7115,0.21,0.52,51,43,36,7,1.19,83.72,36,15,71.15,Adapte,Adapte,Adapte / Adapte
4653,504,2020,Droit,6,9,QCM,0.6008,0.23,0.56,56,50,34,16,1.12,68.0,34,22,60.08,Adapte,Adapte,Adapte / Adapte
504,505,2015,Droit,7,1,QCU,0.8289,0.14,0.8,66,63,55,8,1.05,87.3,55,11,82.89,Facile,Facile,Facile / Facile
1334,505,2016,Droit,7,1,QCU,0.9899,0.04,0.9,57,56,56,0,1.02,100.0,56,1,98.99,Trop Facile,Trop Facile,Trop Facile / Trop Facile
2164,505,2017,Droit,7,1,QCU,0.4258,0.2,0.4,66,29,28,1,2.28,96.55,28,38,42.58,Trop Facile,Difficile,Trop Facile / Difficile
2994,505,2018,Droit,7,1,QCU,0.8981,0.05,0.92,57,51,51,0,1.12,100.0,51,6,89.81,Trop Facile,Trop Facile,Trop Facile / Trop Facile
3824,505,2019,Droit,7,1,QCU,0.8674,0.02,0.96,46,42,40,2,1.1,95.24,40,6,86.74,Trop Facile,Trop Facile,Trop Facile / Trop Facile
4654,505,2020,Droit,7,1,QCU,0.7945,0.16,0.85,53,44,42,2,1.2,95.45,42,11,79.45,Trop Facile,Facile,Trop Facile / Facile
505,506,2015,Droit,7,2,QROC,0.4977,0.56,0.18,34,26,17,9,1.31,65.38,17,17,49.77,Difficile,Difficile,Difficile / Difficile
1335,506,2016,Droit,7,2,QROC,0.8692,0.07,0.55,30,30,26,4,1.0,86.67,26,4,86.92,Trop Facile,Trop Facile,Trop Facile / Trop Facile
2165,506,2017,Droit,7,2,QROC,0.6454,0.42,0.26,31,23,20,3,1.35,86.96,20,11,64.54,Trop Facile,Adapte,Trop Facile / Adapte
2995,506,2018,Droit,7,2,QROC,0.7426,0.3,0.32,25,25,19,6,1.0,76.0,19,6,74.26,Adapte,Adapte,Adapte / Adapte
3825,506,2019,Droit,7,2,QROC,0.7064,0.34,0.36,25,20,18,2,1.25,90.0,18,7,70.64,Adapte,Adapte,Adapte / Adapte
4655,506,2020,Droit,7,2,QROC,0.6656,0.42,0.25,22,16,15,1,1.38,93.75,15,7,66.56,Adapte,Adapte,Adapte / Adapte
506,507,2015,Droit,7,3,QCU,0.7666,0.18,0.88,81,69,62,7,1.17,89.86,62,19,76.66,Facile,Facile,Facile / Facile
1336,507,2016,Droit,7,3,QCU,0.0968,0.5,0.22,73,70,7,63,1.04,10.0,7,66,9.68,Trop Facile,Trop Difficile,Trop Facile / Trop Difficile
2166,507,2017,Droit,7,3,QCU,0.8235,0.12,0.81,86,74,71,3,1.16,95.95,71,15,82.35,Trop Facile,Facile,Trop Facile / Facile
2996,507,2018,Droit,7,3,QCU,0.8903,0.04,0.96,80,77,71,6,1.04,92.21,71,9,89.03,Trop Facile,Trop Facile,Trop Facile / Trop Facile
3826,507,2019,Droit,7,3,QCU,0.907,0.02,0.97,91,86,83,3,1.06,96.51,83,8,90.7,Trop Facile,Trop Facile,Trop Facile / Trop Facile
4656,507,2020,Droit,7,3,QCU,0.9782,0.0,0.96,103,102,101,1,1.01,99.02,101,2,97.82,Trop Facile,Trop Facile,Trop Facile / Trop Facile
507,508,2015,Droit,7,4,QCM,0.1717,0.13,0.24,50,29,9,20,1.72,31.03,9,41,17.17,Trop Difficile,Trop Difficile,Trop Difficile / Trop Difficile
1337,508,2016,Droit,7,4,QCM,0.8928,0.08,0.84,51,50,46,4,1.02,92.0,46,5,89.28,Trop Facile,Trop Facile,Trop Facile / Trop Facile
2167,508,2017,Droit,7,4,QCM,0.8949,0.0,0.85,56,53,50,3,1.06,94.34,50,6,89.49,Trop Facile,Trop Facile,Trop Facile / Trop Facile
2997,508,2018,Droit,7,4,QCM,0.7435,0.01,0.41,45,38,33,5,1.18,86.84,33,12,74.35,Trop Facile,Adapte,Trop Facile / Adapte
3827,508,2019,Droit,7,4,QCM,0.6353,0.16,0.4,48,36,30,6,1.33,83.33,30,18,63.53,Adapte,Adapte,Adapte / Adapte
4657,508,2020,Droit,7,4,QCM,0.7339,0.21,0.49,44,34,32,2,1.29,94.12,32,12,73.39,Adapte,Adapte,Adapte / Adapte
508,509,2015,Droit,7,5,QROC,0.7847,0.06,0.47,14,13,11,2,1.08,84.62,11,3,78.47,Facile,Facile,Facile / Facile
1338,509,2016,Droit,7,5,QROC,0.9615,0.05,0.53,12,12,12,0,1.0,100.0,12,0,96.15,Trop Facile,Trop Facile,Trop Facile / Trop Facile
2168,509,2017,Droit,7,5,QROC,0.7732,0.04,0.42,10,8,8,0,1.25,100.0,8,2,77.32,Trop Facile,Facile,Trop Facile / Facile
2998,509,2018,Droit,7,5,QROC,0.9232,0.01,0.87,10,10,9,1,1.0,90.0,9,1,92.32,Trop Facile,Trop Facile,Trop Facile / Trop Facile
3828,509,2019,Droit,7,5,QROC,0.5546,0.53,0.21,12,11,7,4,1.09,63.64,7,5,55.46,Trop Facile,Difficile,Trop Facile / Difficile
4658,509,2020,Droit,7,5,QROC,0.8714,0.09,0.58,12,12,10,2,1.0,83.33,10,2,87.14,Trop Facile,Trop Facile,Trop Facile / Trop Facile
509,510,2015,Droit,7,6,QCU,0.8942,0.1,0.91,17,17,15,2,1.0,88.24,15,2,89.42,Trop Facile,Trop Facile,Trop Facile / Trop Facile
1339,510,2016,Droit,7,6,QCU,0.8638,0.06,0.95,14,12,12,0,1.17,100.0,12,2,86.38,Trop Facile,Trop Facile,Trop Facile / Trop Facile
2169,510,2017,Droit,7,6,QCU,0.1804,0.39,0.23,15,13,3,10,1.15,23.08,3,12,18.04,Trop Facile,Trop Difficile,Trop Facile / Trop Difficile
2999,510,2018,Droit,7,6,QCU,0.9078,0.05,0.94,16,15,15,0,1.07,100.0,15,1,90.78,Trop Facile,Trop Facile,Trop Facile / Trop Facile
3829,510,2019,Droit,7,6,QCU,0.8992,0.07,0.98,16,14,14,0,1.14,100.0,14,2,89.92,Trop Facile,Trop Facile,Trop Facile / Trop Facile
4659,510,2020,Droit,7,6,QCU,0.2566,0.07,0.34,19,15,5,10,1.27,33.33,5,14,25.66,Trop Facile,Difficile,Trop Facile / Difficile
510,511,2015,Droit,7,7,QO,0.5107,0.88,0.12,54,53,28,25,1.02,52.83,28,26,51.07,Difficile,Difficile,Difficile / Difficile
1340,511,2016,Droit,7,7,QO,0.9723,0.05,0.54,54,54,53,1,1.0,98.15,53,1,97.23,Trop Facile,Trop Facile,Trop Facile / Trop Facile
2170,511,2017,Droit,7,7,QO,0.9399,0.04,0.99,57,55,54,1,1.04,98.18,54,3,93.99,Trop Facile,Trop Facile,Trop Facile / Trop Facile
3000,511,2018,Droit,7,7,QO,0.9831,0.03,0.54,60,60,59,1,1.0,98.33,59,1,98.31,Trop Facile,Trop Facile,Trop Facile / Trop Facile
3830,511,2019,Droit,7,7,QO,0.8617,0.09,0.89,72,67,62,5,1.07,92.54,62,10,86.17,Trop Facile,Trop Facile,Trop Facile / Trop Facile
4660,511,2020,Droit,7,7,QO,0.9725,0.06,0.83,59,59,57,2,1.0,96.61,57,2,97.25,Trop Facile,Trop Facile,Trop Facile / Trop Facile
511,512,2015,Droit,7,8,QROC,0.5171,0.73,0.21,37,34,19,15,1.09,55.88,19,18,51.71,Difficile,Difficile,Difficile / Difficile
1341,512,2016,Droit,7,8,QROC,0.2634,0.57,0.24,33,30,9,21,1.1,30.0,9,24,26.34,Trop Facile,Difficile,Trop Facile / Difficile
2171,512,2017,Droit,7,8,QROC,0.8665,0.05,0.73,38,34,33,1,1.12,97.06,33,5,86.65,Trop Facile,Trop Facile,Trop Facile / Trop Facile
3001,512,2018,Droit,7,8,QROC,0.9015,0.02,0.6,31,30,28,2,1.03,93.33,28,3,90.15,Trop Facile,Trop Facile,Trop Facile / Trop Facile
3831,512,2019,Droit,7,8,QROC,0.9154,0.02,0.65,34,33,31,2,1.03,93.94,31,3,91.54,Trop Facile,Trop Facile,Trop Facile / Trop Facile
4661,512,2020,Droit,7,8,QROC,0.8989,0.09,0.58,39,36,35,1,1.08,97.22,35,4,89.89,Trop Facile,Trop Facile,Trop Facile / Trop Facile
512,513,2015,Droit,8,1,QCM,0.5483,0.33,0.35,41,28,22,6,1.46,78.57,22,19,54.83,Difficile,Difficile,Difficile / Difficile
1342,513,2016,Droit,8,1,QCM,0.9903,0.08,1.0,46,46,46,0,1.0,100.0,46,0,99.03,Trop Facile,Trop Facile,Trop Facile / Trop Facile
2172,513,2017,Droit,8,1,QCM,0.1381,0.66,0.29,51,40,7,33,1.27,17.5,7,44,13.81,Trop Facile,Trop Difficile,Trop Facile / Trop Difficile
3002,513,2018,Droit,8,1,QCM,0.8497,0.14,0.76,44,38,37,1,1.16,97.37,37,7,84.97,Trop Facile,Facile,Trop Facile / Facile
3832,513,2019,Droit,8,1,QCM,0.0355,0.59,0.27,36,16,1,15,2.25,6.25,1,35,3.55,Trop Facile,Trop Difficile,Trop Facile / Trop Difficile
4662,513,2020,Droit,8,1,QCM,0.9315,0.07,0.96,37,37,34,3,1.0,91.89,34,3,93.15,Trop Facile,Trop Facile,Trop Facile / Trop Facile
513,514,2015,Droit,8,2,QO,0.905,0.07,0.78,97,91,88,3,1.07,96.7,88,9,90.5,Trop Facile,Trop Facile,Trop Facile / Trop Facile
1343,514,2016,Droit,8,2,QO,0.9481,0.1,0.54,89,85,84,1,1.05,98.82,84,5,94.81,Trop Facile,Trop Facile,Trop Facile / Trop Facile
2173,514,2017,Droit,8,2,QO,0.9229,0.06,0.97,89,85,82,3,1.05,96.47,82,7,92.29,Trop Facile,Trop Facile,Trop Facile / Trop Facile
3003,514,2018,Droit,8,2,QO,0.9898,0.03,0.51,86,86,85,1,1.0,98.84,85,1,98.98,Trop Facile,Trop Facile,Trop Facile / Trop Facile
3833,514,2019,Droit,8,2,QO,0.9122,0.1,0.81,83,78,76,2,1.06,97.44,76,7,91.22,Trop Facile,Trop Facile,Trop Facile / Trop Facile
4663,514,2020,Droit,8,2,QO,0.8708,0.07,0.84,86,86,75,11,1.0,87.21,75,11,87.08,Trop Facile,Trop Facile,Trop Facile / Trop Facile
514,515,2015,Droit,8,3,QCM,0.0662,0.03,0.2,64,52,4,48,1.23,7.69,4,60,6.62,Facile,Trop Difficile,Facile / Trop Difficile
1344,515,2016,Droit,8,3,QCM,0.9085,0.1,0.99,57,53,52,1,1.08,98.11,52,5,90.85,Trop Facile,Trop Facile,Trop Facile / Trop Facile
2174,515,2017,Droit,8,3,QCM,0.8994,0.02,0.9,63,58,57,1,1.09,98.28,57,6,89.94,Trop Facile,Trop Facile,Trop Facile / Trop Facile
3004,515,2018,Droit,8,3,QCM,0.0283,0.01,0.27,75,19,2,17,3.95,10.53,2,73,2.83,Trop Facile,Trop Difficile,Trop Facile / Trop Difficile
3834,515,2019,Droit,8,3,QCM,0.9381,0.08,0.9,73,70,68,2,1.04,97.14,68,5,93.81,Trop Facile,Trop Facile,Trop Facile / Trop Facile
4664,515,2020,Droit,8,3,QCM,0.763,0.2,0.75,87,86,66,20,1.01,76.74,66,21,76.3,Trop Facile,Facile,Trop Facile / Facile
515,516,2015,Droit,8,4,QCU,0.772,0.09,0.86,64,62,49,13,1.03,79.03,49,15,77.2,Facile,Facile,Facile / Facile
1345,516,2016,Droit,8,4,QCU,0.2745,0.36,0.35,65,38,18,20,1.71,47.37,18,47,27.45,Trop Facile,Difficile,Trop Facile / Difficile
2175,516,2017,Droit,8,4,QCU,0.9205,0.02,0.93,60,57,55,2,1.05,96.49,55,5,92.05,Trop Facile,Trop Facile,Trop Facile / Trop Facile
3005,516,2018,Droit,8,4,QCU,0.9521,0.01,0.96,69,67,66,1,1.03,98.51,66,3,95.21,Trop Facile,Trop Facile,Trop Facile / Trop Facile
3835,516,2019,Droit,8,4,QCU,0.9804,0.07,0.91,64,63,63,0,1.02,100.0,63,1,98.04,Trop Facile,Trop Facile,Trop Facile / Trop Facile
4665,516,2020,Droit,8,4,QCU,0.6193,0.1,0.65,64,44,40,4,1.45,90.91,40,24,61.93,Trop Facile,Adapte,Trop Facile / Adapte
516,517,2015,Droit,9,1,QCM,0.7987,0.08,0.77,33,27,26,1,1.22,96.3,26,7,79.87,Facile,Facile,Facile / Facile
1346,517,2016,Droit,9,1,QCM,0.9143,0.01,0.81,32,31,29,2,1.03,93.55,29,3,91.43,Trop Facile,Trop Facile,Trop Facile / Trop Facile
2176,517,2017,Droit,9,1,QCM,0.2334,0.06,0.29,29,20,7,13,1.45,35.0,7,22,23.34,Trop Facile,Trop Difficile,Trop Facile / Trop Difficile
3006,517,2018,Droit,9,1,QCM,0.9356,0.08,0.81,28,26,26,0,1.08,100.0,26,2,93.56,Trop Facile,Trop Facile,Trop Facile / Trop Facile
3836,517,2019,Droit,9,1,QCM,0.3561,0.08,0.35,34,19,12,7,1.79,63.16,12,22,35.61,Trop Facile,Difficile,Trop Facile / Difficile
4666,517,2020,Droit,9,1,QCM,0.986,0.09,0.98,40,39,39,0,1.03,100.0,39,1,98.6,Trop Facile,Trop Facile,Trop Facile / Trop Facile
517,518,2015,Droit,9,2,QCM,0.4247,0.44,0.31,18,11,8,3,1.64,72.73,8,10,42.47,Difficile,Difficile,Difficile / Difficile
1347,518,2016,Droit,9,2,QCM,0.8076,0.16,0.78,20,19,16,3,1.05,84.21,16,4,80.76,Trop Facile,Facile,Trop Facile / Facile
2177,518,2017,Droit,9,2,QCM,0.6749,0.05,0.6,19,18,13,5,1.06,72.22,13,6,67.49,Trop Facile,Adapte,Trop Facile / Adapte
3007,518,2018,Droit,9,2,QCM,0.7057,0.13,0.5,19,18,13,5,1.06,72.22,13,6,70.57,Adapte,Adapte,Adapte / Adapte
3837,518,2019,Droit,9,2,QCM,0.7467,0.03,0.52,18,14,13,1,1.29,92.86,13,5,74.67,Adapte,Adapte,Adapte / Adapte
4667,518,2020,Droit,9,2,QCM,0.6156,0.08,0.69,22,20,14,6,1.1,70.0,14,8,61.56,Adapte,Adapte,Adapte / Adapte
518,519,2015,Droit,9,3,QROC,0.6942,0.37,0.27,84,72,58,14,1.17,80.56,58,26,69.42,Trop Difficile,Adapte,Trop Difficile / Adapte
1348,519,2016,Droit,9,3,QROC,0.6936,0.42,0.28,68,61,47,14,1.11,77.05,47,21,69.36,Adapte,Adapte,Adapte / Adapte
2178,519,2017,Droit,9,3,QROC,0.7206,0.48,0.27,71,59,51,8,1.2,86.44,51,20,72.06,Adapte,Adapte,Adapte / Adapte
3008,519,2018,Droit,9,3,QROC,0.6206,0.26,0.3,62,52,38,14,1.19,73.08,38,24,62.06,Adapte,Adapte,Adapte / Adapte
3838,519,2019,Droit,9,3,QROC,0.7436,0.34,0.33,66,57,49,8,1.16,85.96,49,17,74.36,Adapte,Adapte,Adapte / Adapte
4668,519,2020,Droit,9,3,QROC,0.6811,0.46,0.31,66,58,45,13,1.14,77.59,45,21,68.11,Adapte,Adapte,Adapte / Adapte
519,520,2015,Droit,9,4,QCU,0.7781,0.02,0.88,35,28,27,1,1.25,96.43,27,8,77.81,Trop Difficile,Facile,Trop Difficile / Facile
1349,520,2016,Droit,9,4,QCU,0.9346,0.04,0.91,38,37,36,1,1.03,97.3,36,2,93.46,Trop Facile,Trop Facile,Trop Facile / Trop Facile
2179,520,2017,Droit,9,4,QCU,0.6497,0.12,0.59,41,34,27,7,1.21,79.41,27,14,64.97,Trop Facile,Adapte,Trop Facile / Adapte
3009,520,2018,Droit,9,4,QCU,0.723,0.08,0.61,48,47,35,12,1.02,74.47,35,13,72.3,Adapte,Adapte,Adapte / Adapte
3839,520,2019,Droit,9,4,QCU,0.6206,0.08,0.55,58,47,36,11,1.23,76.6,36,22,62.06,Adapte,Adapte,Adapte / Adapte
4669,520,2020,Droit,9,4,QCU,0.665,0.22,0.4,59,40,39,1,1.48,97.5,39,20,66.5,Adapte,Adapte,Adapte / Adapte
520,521,2015,Droit,9,5,QCU,0.0527,0.67,0.23,75,30,4,26,2.5,13.33,4,71,5.27,Trop Difficile,Trop Difficile,Trop Difficile / Trop Difficile
1350,521,2016,Droit,9,5,QCU,0.8834,0.03,0.97,83,75,73,2,1.11,97.33,73,10,88.34,Trop Facile,Trop Facile,Trop Facile / Trop Facile
2180,521,2017,Droit,9,5,QCU,0.7129,0.26,0.56,79,60,56,4,1.32,93.33,56,23,71.29,Trop Facile,Adapte,Trop Facile / Adapte
3010,521,2018,Droit,9,5,QCU,0.6988,0.09,0.69,87,84,61,23,1.04,72.62,61,26,69.88,Adapte,Adapte,Adapte / Adapte
3840,521,2019,Droit,9,5,QCU,0.6012,0.14,0.44,80,74,48,26,1.08,64.86,48,32,60.12,Adapte,Adapte,Adapte / Adapte
4670,521,2020,Droit,9,5,QCU,0.7441,0.29,0.45,83,80,62,18,1.04,77.5,62,21,74.41,Adapte,Adapte,Adapte / Adapte
521,522,2015,Droit,9,6,QCU,0.435,0.07,0.31,57,29,25,4,1.97,86.21,25,32,43.5,Difficile,Difficile,Difficile / Difficile
1351,522,2016,Droit,9,6,QCU,0.972,0.06,0.99,46,45,45,0,1.02,100.0,45,1,97.2,Trop Facile,Trop Facile,Trop Facile / Trop Facile
2181,522,2017,Droit,9,6,QCU,0.9949,0.06,0.94,51,51,51,0,1.0,100.0,51,0,99.49,Trop Facile,Trop Facile,Trop Facile / Trop Facile
3011,522,2018,Droit,9,6,QCU,0.9657,0.03,0.9,57,57,55,2,1.0,96.49,55,2,96.57,Trop Facile,Trop Facile,Trop Facile / Trop Facile
3841,522,2019,Droit,9,6,QCU,0.9513,0.01,0.98,46,45,44,1,1.02,97.78,44,2,95.13,Trop Facile,Trop Facile,Trop Facile / Trop Facile
4671,522,2020,Droit,9,6,QCU,0.9939,0.06,0.97,41,41,41,0,1.0,100.0,41,0,99.39,Trop Facile,Trop Facile,Trop Facile / Trop Facile
522,523,2015,Droit,9,7,QCM,0.703,0.18,0.5,78,57,55,2,1.37,96.49,55,23,70.3,Trop Difficile,Adapte,Trop Difficile / Adapte
1352,523,2016,Droit,9,7,QCM,0.6344,0.16,0.5,91,79,58,21,1.15,73.42,58,33,63.44,Adapte,Adapte,Adapte / Adapte
2182,523,2017,Droit,9,7,QCM,0.6039,0.03,0.44,94,70,57,13,1.34,81.43,57,37,60.39,Adapte,Adapte,Adapte / Adapte
3012,523,2018,Droit,9,7,QCM,0.6875,0.12,0.63,98,68,67,1,1.44,98.53,67,31,68.75,Adapte,Adapte,Adapte / Adapte
3842,523,2019,Droit,9,7,QCM,0.688,0.19,0.41,106,76,73,3,1.39,96.05,73,33,68.8,Adapte,Adapte,Adapte / Adapte
4672,523,2020,Droit,9,7,QCM,0.683,0.17,0.69,90,77,61,16,1.17,79.22,61,29,68.3,Adapte,Adapte,Adapte / Adapte
523,524,2015,Droit,10,1,QCU,0.7906,0.15,0.8,40,37,32,5,1.08,86.49,32,8,79.06,Facile,Facile,Facile / Facile
1353,524,2016,Droit,10,1,QCU,0.2095,0.54,0.21,44,31,9,22,1.42,29.03,9,35,20.95,Trop Facile,Trop Difficile,Trop Facile / Trop Difficile
2183,524,2017,Droit,10,1,QCU,0.8996,0.08,0.96,43,40,39,1,1.07,97.5,39,4,89.96,Trop Facile,Trop Facile,Trop Facile / Trop Facile
3013,524,2018,Droit,10,1,QCU,0.7913,0.19,0.84,37,31,29,2,1.19,93.55,29,8,79.13,Trop Facile,Facile,Trop Facile / Facile
3843,524,2019,Droit,10,1,QCU,0.9724,0.04,0.95,42,41,41,0,1.02,100.0,41,1,97.24,Trop Facile,Trop Facile,Trop Facile / Trop Facile
4673,524,2020,Droit,10,1,QCU,0.9653,0.07,1.0,38,37,37,0,1.03,100.0,37,1,96.53,Trop Facile,Trop Facile,Trop Facile / Trop Facile
524,525,2015,Droit,10,2,QCM,0.6846,0.18,0.47,21,16,14,2,1.31,87.5,14,7,68.46,Difficile,Adapte,Difficile / Adapte
1354,525,2016,Droit,10,2,QCM,0.7354,0.05,0.41,17,16,13,3,1.06,81.25,13,4,73.54,Adapte,Adapte,Adapte / Adapte
2184,525,2017,Droit,10,2,QCM,0.6213,0.25,0.63,15,14,9,5,1.07,64.29,9,6,62.13,Adapte,Adapte,Adapte / Adapte
3014,525,2018,Droit,10,2,QCM,0.643,0.3,0.54,13,9,8,1,1.44,88.89,8,5,64.3,Adapte,Adapte,Adapte / Adapte
3844,525,2019,Droit,10,2,QCM,0.6455,0.05,0.64,13,12,8,4,1.08,66.67,8,5,64.55,Adapte,Adapte,Adapte / Adapte
4674,525,2020,Droit,10,2,QCM,0.6204,0.23,0.49,16,15,10,5,1.07,66.67,10,6,62.04,Adapte,Adapte,Adapte / Adapte
525,526,2015,Droit,10,3,QCU,0.3271,0.06,0.35,84,71,27,44,1.18,38.03,27,57,32.71,Difficile,Difficile,Difficile / Difficile
1355,526,2016,Droit,10,3,QCU,0.9363,0.04,0.98,83,82,78,4,1.01,95.12,78,5,93.63,Trop Facile,Trop Facile,Trop Facile / Trop Facile
2185,526,2017,Droit,10,3,QCU,0.9433,0.06,0.93,97,95,92,3,1.02,96.84,92,5,94.33,Trop Facile,Trop Facile,Trop Facile / Trop Facile
3015,526,2018,Droit,10,3,QCU,0.8897,0.09,0.94,111,106,99,7,1.05,93.4,99,12,88.97,Trop Facile,Trop Facile,Trop Facile / Trop Facile
3845,526,2019,Droit,10,3,QCU,0.0225,0.12,0.24,105,57,2,55,1.84,3.51,2,103,2.25,Trop Facile,Trop Difficile,Trop Facile / Trop Difficile
4675,526,2020,Droit,10,3,QCU,0.9032,0.08,1.0,121,116,109,7,1.04,93.97,109,12,90.32,Trop Facile,Trop Facile,Trop Facile / Trop Facile
526,527,2015,Droit,10,4,QROC,0.6893,0.42,0.28,23,17,16,1,1.35,94.12,16,7,68.93,Adapte,Adapte,Adapte / Adapte
1356,527,2016,Droit,10,4,QROC,0.6523,0.37,0.28,25,24,16,8,1.04,66.67,16,9,65.23,Adapte,Adapte,Adapte / Adapte
2186,527,2017,Droit,10,4,QROC,0.6054,0.49,0.33,25,18,15,3,1.39,83.33,15,10,60.54,Adapte,Adapte,Adapte / Adapte
3016,527,2018,Droit,10,4,QROC,0.6944,0.28,0.27,22,15,15,0,1.47,100.0,15,7,69.44,Adapte,Adapte,Adapte / Adapte
3846,527,2019,Droit,10,4,QROC,0.6068,0.29,0.39,23,17,14,3,1.35,82.35,14,9,60.68,Adapte,Adapte,Adapte / Adapte
4676,527,2020,Droit,10,4,QROC,0.6318,0.21,0.38,24,21,15,6,1.14,71.43,15,9,63.18,Adapte,Adapte,Adapte / Adapte
527,528,2015,Droit,10,5,QCM,0.4564,0.19,0.36,31,26,14,12,1.19,53.85,14,17,45.64,Difficile,Difficile,Difficile / Difficile
1357,528,2016,Droit,10,5,QCM,0.0281,0.42,0.23,29,16,1,15,1.81,6.25,1,28,2.81,Trop Facile,Trop Difficile,Trop Facile / Trop Difficile
2187,528,2017,Droit,10,5,QCM,0.9735,0.03,0.95,24,24,23,1,1.0,95.83,23,1,97.35,Trop Facile,Trop Facile,Trop Facile / Trop Facile
3017,528,2018,Droit,10,5,QCM,0.981,0.01,0.95,24,24,24,0,1.0,100.0,24,0,98.1,Trop Facile,Trop Facile,Trop Facile / Trop Facile
3847,528,2019,Droit,10,5,QCM,0.0374,0.48,0.21,28,11,1,10,2.55,9.09,1,27,3.74,Trop Facile,Trop Difficile,Trop Facile / Trop Difficile
4677,528,2020,Droit,10,5,QCM,0.6803,0.16,0.68,23,20,16,4,1.15,80.0,16,7,68.03,Trop Facile,Adapte,Trop Facile / Adapte
528,529,2015,Droit,11,1,QCM,0.8414,0.01,0.76,19,16,16,0,1.19,100.0,16,3,84.14,Facile,Facile,Facile / Facile
1358,529,2016,Droit,11,1,QCM,0.9377,0.05,0.84,20,19,19,0,1.05,100.0,19,1,93.77,Trop Facile,Trop Facile,Trop Facile / Trop Facile
2188,529,2017,Droit,11,1,QCM,0.9644,0.03,0.88,21,20,20,0,1.05,100.0,20,1,96.44,Trop Facile,Trop Facile,Trop Facile / Trop Facile
3018,529,2018,Droit,11,1,QCM,0.9163,0.03,0.97,23,22,21,1,1.05,95.45,21,2,91.63,Trop Facile,Trop Facile,Trop Facile / Trop Facile
3848,529,2019,Droit,11,1,QCM,0.9895,0.09,0.94,21,21,21,0,1.0,100.0,21,0,98.95,Trop Facile,Trop Facile,Trop Facile / Trop Facile
4678,529,2020,Droit,11,1,QCM,0.9974,0.08,0.96,19,19,19,0,1.0,100.0,19,0,99.74,Trop Facile,Trop Facile,Trop Facile / Trop Facile
529,530,2015,Droit,12,1,QCU,0.9407,0.04,0.92,42,41,40,1,1.02,97.56,40,2,94.07,Trop Facile,Trop Facile,Trop Facile / Trop Facile
1359,530,2016,Droit,12,1,QCU,0.9647,0.04,0.97,37,36,36,0,1.03,100.0,36,1,96.47,Trop Facile,Trop Facile,Trop Facile / Trop Facile
2189,530,2017,Droit,12,1,QCU,0.9179,0.06,0.92,37,36,34,2,1.03,94.44,34,3,91.79,Trop Facile,Trop Facile,Trop Facile / Trop Facile
3019,530,2018,Droit,12,1,QCU,0.9033,0.05,1.0,38,37,34,3,1.03,91.89,34,4,90.33,Trop Facile,Trop Facile,Trop Facile / Trop Facile
3849,530,2019,Droit,12,1,QCU,0.8943,0.05,0.96,42,41,38,3,1.02,92.68,38,4,89.43,Trop Facile,Trop Facile,Trop Facile / Trop Facile
4679,530,2020,Droit,12,1,QCU,0.9361,0.04,0.98,44,43,41,2,1.02,95.35,41,3,93.61,Trop Facile,Trop Facile,Trop Facile / Trop Facile
530,531,2015,Droit,12,2,QCU,0.6874,0.07,0.57,14,13,10,3,1.08,76.92,10,4,68.74,Adapte,Adapte,Adapte / Adapte
1360,531,2016,Droit,12,2,QCU,0.6217,0.26,0.53,15,10,9,1,1.5,90.0,9,6,62.17,Adapte,Adapte,Adapte / Adapte
2190,531,2017,Droit,12,2,QCU,0.6084,0.04,0.48,14,13,9,4,1.08,69.23,9,5,60.84,Adapte,Adapte,Adapte / Adapte
3020,531,2018,Droit,12,2,QCU,0.602,0.04,0.57,12,9,7,2,1.33,77.78,7,5,60.2,Adapte,Adapte,Adapte / Adapte
3850,531,2019,Droit,12,2,QCU,0.7031,0.21,0.55,10,10,7,3,1.0,70.0,7,3,70.31,Adapte,Adapte,Adapte / Adapte
4680,531,2020,Droit,12,2,QCU,0.6362,0.16,0.45,9,8,6,2,1.12,75.0,6,3,63.62,Adapte,Adapte,Adapte / Adapte
531,532,2015,Droit,12,3,QCM,0.8004,0.01,0.71,72,67,58,9,1.07,86.57,58,14,80.04,Adapte,Facile,Adapte / Facile
1361,532,2016,Droit,12,3,QCM,0.9355,0.09,0.97,78,76,73,3,1.03,96.05,73,5,93.55,Trop Facile,Trop Facile,Trop Facile / Trop Facile
2191,532,2017,Droit,12,3,QCM,0.7489,0.18,0.45,80,64,60,4,1.25,93.75,60,20,74.89,Trop Facile,Adapte,Trop Facile / Adapte
3021,532,2018,Droit,12,3,QCM,0.7498,0.06,0.47,70,61,52,9,1.15,85.25,52,18,74.98,Adapte,Adapte,Adapte / Adapte
3851,532,2019,Droit,12,3,QCM,0.6865,0.29,0.58,57,42,39,3,1.36,92.86,39,18,68.65,Adapte,Adapte,Adapte / Adapte
4681,532,2020,Droit,12,3,QCM,0.6612,0.09,0.48,49,40,32,8,1.23,80.0,32,17,66.12,Adapte,Adapte,Adapte / Adapte
532,533,2015,Droit,12,4,QCU,0.3795,0.09,0.31,43,29,16,13,1.48,55.17,16,27,37.95,Difficile,Difficile,Difficile / Difficile
1362,533,2016,Droit,12,4,QCU,0.0906,0.75,0.29,51,32,5,27,1.59,15.62,5,46,9.06,Trop Facile,Trop Difficile,Trop Facile / Trop Difficile
2192,533,2017,Droit,12,4,QCU,0.7618,0.03,0.84,54,51,41,10,1.06,80.39,41,13,76.18,Trop Facile,Facile,Trop Facile / Facile
3022,533,2018,Droit,12,4,QCU,0.9364,0.05,0.92,56,55,52,3,1.02,94.55,52,4,93.64,Trop Facile,Trop Facile,Trop Facile / Trop Facile
3852,533,2019,Droit,12,4,QCU,0.6021,0.27,0.62,63,44,38,6,1.43,86.36,38,25,60.21,Trop Facile,Adapte,Trop Facile / Adapte
4682,533,2020,Droit,12,4,QCU,0.6759,0.11,0.69,67,48,45,3,1.4,93.75,45,22,67.59,Adapte,Adapte,Adapte / Adapte
533,534,2015,Droit,12,5,QCM,0.7961,0.12,0.79,96,84,76,8,1.14,90.48,76,20,79.61,Trop Difficile,Facile,Trop Difficile / Facile
1363,534,2016,Droit,12,5,QCM,0.9466,0.09,0.89,99,94,94,0,1.05,100.0,94,5,94.66,Trop Facile,Trop Facile,Trop Facile / Trop Facile
2193,534,2017,Droit,12,5,QCM,0.8767,0.06,0.92,104,95,91,4,1.09,95.79,91,13,87.67,Trop Facile,Trop Facile,Trop Facile / Trop Facile
3023,534,2018,Droit,12,5,QCM,0.9893,0.07,0.82,92,92,91,1,1.0,98.91,91,1,98.93,Trop Facile,Trop Facile,Trop Facile / Trop Facile
3853,534,2019,Droit,12,5,QCM,0.885,0.05,0.98,105,101,93,8,1.04,92.08,93,12,88.5,Trop Facile,Trop Facile,Trop Facile / Trop Facile
4683,534,2020,Droit,12,5,QCM,0.8919,0.08,0.95,113,105,101,4,1.08,96.19,101,12,89.19,Trop Facile,Trop Facile,Trop Facile / Trop Facile
534,535,2015,Droit,13,1,QCU,0.8463,0.08,0.77,91,84,77,7,1.08,91.67,77,14,84.63,Facile,Facile,Facile / Facile
1364,535,2016,Droit,13,1,QCU,0.9206,0.01,0.94,91,88,84,4,1.03,95.45,84,7,92.06,Trop Facile,Trop Facile,Trop Facile / Trop Facile
2194,535,2017,Droit,13,1,QCU,0.0899,0.23,0.25,90,70,8,62,1.29,11.43,8,82,8.99,Trop Facile,Trop Difficile,Trop Facile / Trop Difficile
3024,535,2018,Droit,13,1,QCU,0.1204,0.72,0.21,72,43,9,34,1.67,20.93,9,63,12.04,Trop Facile,Trop Difficile,Trop Facile / Trop Difficile
3854,535,2019,Droit,13,1,QCU,0.8304,0.04,0.88,69,69,57,12,1.0,82.61,57,12,83.04,Trop Facile,Facile,Trop Facile / Facile
4684,535,2020,Droit,13,1,QCU,0.8859,0.05,0.93,78,70,69,1,1.11,98.57,69,9,88.59,Trop Facile,Trop Facile,Trop Facile / Trop Facile
535,536,2015,Droit,14,1,QCM,0.092,0.53,0.23,72,24,7,17,3.0,29.17,7,65,9.2,Trop Difficile,Trop Difficile,Trop Difficile / Trop Difficile
1365,536,2016,Droit,14,1,QCM,0.6564,0.25,0.51,78,66,51,15,1.18,77.27,51,27,65.64,Trop Facile,Adapte,Trop Facile / Adapte
2195,536,2017,Droit,14,1,QCM,0.637,0.27,0.42,86,65,55,10,1.32,84.62,55,31,63.7,Adapte,Adapte,Adapte / Adapte
3025,536,2018,Droit,14,1,QCM,0.6932,0.12,0.54,83,60,58,2,1.38,96.67,58,25,69.32,Adapte,Adapte,Adapte / Adapte
3855,536,2019,Droit,14,1,QCM,0.6983,0.16,0.51,83,72,58,14,1.15,80.56,58,25,69.83,Adapte,Adapte,Adapte / Adapte
4685,536,2020,Droit,14,1,QCM,0.6018,0.13,0.64,90,71,54,17,1.27,76.06,54,36,60.18,Adapte,Adapte,Adapte / Adapte
536,537,2015,Droit,14,2,QCM,0.3843,0.47,0.39,53,29,20,9,1.83,68.97,20,33,38.43,Difficile,Difficile,Difficile / Difficile
1366,537,2016,Droit,14,2,QCM,0.9926,0.04,0.81,45,45,45,0,1.0,100.0,45,0,99.26,Trop Facile,Trop Facile,Trop Facile / Trop Facile
2196,537,2017,Droit,14,2,QCM,0.2668,0.17,0.4,50,19,13,6,2.63,68.42,13,37,26.68,Trop Facile,Difficile,Trop Facile / Difficile
3026,537,2018,Droit,14,2,QCM,0.016,0.71,0.2,53,23,1,22,2.3,4.35,1,52,1.6,Trop Facile,Trop Difficile,Trop Facile / Trop Difficile
3856,537,2019,Droit,14,2,QCM,0.8919,0.08,0.81,49,45,44,1,1.09,97.78,44,5,89.19,Trop Facile,Trop Facile,Trop Facile / Trop Facile
4686,537,2020,Droit,14,2,QCM,0.5512,0.38,0.39,53,31,29,2,1.71,93.55,29,24,55.12,Trop Facile,Difficile,Trop Facile / Difficile
537,538,2015,Droit,14,3,QCM,0.1462,0.73,0.23,33,19,5,14,1.74,26.32,5,28,14.62,Trop Difficile,Trop Difficile,Trop Difficile / Trop Difficile
1367,538,2016,Droit,14,3,QCM,0.9277,0.03,0.95,38,36,35,1,1.06,97.22,35,3,92.77,Trop Facile,Trop Facile,Trop Facile / Trop Facile
2197,538,2017,Droit,14,3,QCM,0.8903,0.06,0.93,35,32,31,1,1.09,96.88,31,4,89.03,Trop Facile,Trop Facile,Trop Facile / Trop Facile
3027,538,2018,Droit,14,3,QCM,0.9122,0.07,0.81,33,31,30,1,1.06,96.77,30,3,91.22,Trop Facile,Trop Facile,Trop Facile / Trop Facile
3857,538,2019,Droit,14,3,QCM,0.884,0.09,1.0,31,29,27,2,1.07,93.1,27,4,88.4,Trop Facile,Trop Facile,Trop Facile / Trop Facile
4687,538,2020,Droit,14,3,QCM,0.9821,0.06,0.89,35,34,34,0,1.03,100.0,34,1,98.21,Trop Facile,Trop Facile,Trop Facile / Trop Facile
538,539,2015,Droit,14,4,QCU,0.7956,0.09,0.79,5,5,4,1,1.0,80.0,4,1,79.56,Facile,Facile,Facile / Facile
1368,539,2016,Droit,14,4,QCU,0.9655,0.05,0.93,5,5,5,0,1.0,100.0,5,0,96.55,Trop Facile,Trop Facile,Trop Facile / Trop Facile
2198,539,2017,Droit,14,4,QCU,0.8687,0.0,0.96,5,4,4,0,1.25,100.0,4,1,86.87,Trop Facile,Trop Facile,Trop Facile / Trop Facile
3028,539,2018,Droit,14,4,QCU,0.9007,0.05,0.96,5,5,5,0,1.0,100.0,5,0,90.07,Trop Facile,Trop Facile,Trop Facile / Trop Facile
3858,539,2019,Droit,14,4,QCU,0.9396,0.04,0.91,6,6,6,0,1.0,100.0,6,0,93.96,Trop Facile,Trop Facile,Trop Facile / Trop Facile
4688,539,2020,Droit,14,4,QCU,0.9414,0.01,0.98,5,5,5,0,1.0,100.0,5,0,94.14,Trop Facile,Trop Facile,Trop Facile / Trop Facile
539,540,2015,Droit,14,5,QCM,0.81,0.15,0.78,49,40,40,0,1.23,100.0,40,9,81.0,Facile,Facile,Facile / Facile
1369,540,2016,Droit,14,5,QCM,0.8601,0.05,0.99,58,53,50,3,1.09,94.34,50,8,86.01,Trop Facile,Trop Facile,Trop Facile / Trop Facile
2199,540,2017,Droit,14,5,QCM,0.8681,0.08,0.8,46,43,40,3,1.07,93.02,40,6,86.81,Trop Facile,Trop Facile,Trop Facile / Trop Facile
3029,540,2018,Droit,14,5,QCM,0.89,0.01,0.84,54,51,48,3,1.06,94.12,48,6,89.0,Trop Facile,Trop Facile,Trop Facile / Trop Facile
3859,540,2019,Droit,14,5,QCM,0.9232,0.05,0.85,50,47,46,1,1.06,97.87,46,4,92.32,Trop Facile,Trop Facile,Trop Facile / Trop Facile
4689,540,2020,Droit,14,5,QCM,0.9973,0.09,1.0,51,51,51,0,1.0,100.0,51,0,99.73,Trop Facile,Trop Facile,Trop Facile / Trop Facile
540,541,2015,Droit,14,6,QCU,0.6447,0.16,0.59,74,48,48,0,1.54,100.0,48,26,64.47,Trop Facile,Adapte,Trop Facile / Adapte
1370,541,2016,Droit,14,6,QCU,0.6567,0.13,0.45,71,47,47,0,1.51,100.0,47,24,65.67,Adapte,Adapte,Adapte / Adapte
2200,541,2017,Droit,14,6,QCU,0.7245,0.07,0.48,64,52,46,6,1.23,88.46,46,18,72.45,Adapte,Adapte,Adapte / Adapte
3030,541,2018,Droit,14,6,QCU,0.7264,0.29,0.53,71,54,52,2,1.31,96.3,52,19,72.64,Adapte,Adapte,Adapte / Adapte
3860,541,2019,Droit,14,6,QCU,0.6114,0.13,0.55,69,60,42,18,1.15,70.0,42,27,61.14,Adapte,Adapte,Adapte / Adapte
4690,541,2020,Droit,14,6,QCU,0.6079,0.24,0.67,72,63,44,19,1.14,69.84,44,28,60.79,Adapte,Adapte,Adapte / Adapte
541,542,2015,Droit,14,7,QCU,0.9074,0.0,0.94,55,50,50,0,1.1,100.0,50,5,90.74,Trop Facile,Trop Facile,Trop Facile / Trop Facile
1371,542,2016,Droit,14,7,QCU,0.8665,0.06,0.9,56,56,49,7,1.0,87.5,49,7,86.65,Trop Facile,Trop Facile,Trop Facile / Trop Facile
2201,542,2017,Droit,14,7,QCU,0.9799,0.02,0.95,46,45,45,0,1.02,100.0,45,1,97.99,Trop Facile,Trop Facile,Trop Facile / Trop Facile
3031,542,2018,Droit,14,7,QCU,0.1055,0.15,0.27,42,15,4,11,2.8,26.67,4,38,10.55,Trop Facile,Trop Difficile,Trop Facile / Trop Difficile
3861,542,2019,Droit,14,7,QCU,0.9018,0.08,0.9,47,44,42,2,1.07,95.45,42,5,90.18,Trop Facile,Trop Facile,Trop Facile / Trop Facile
4691,542,2020,Droit,14,7,QCU,0.966,0.04,0.96,55,53,53,0,1.04,100.0,53,2,96.6,Trop Facile,Trop Facile,Trop Facile / Trop Facile
542,543,2015,Droit,14,8,QCM,0.8206,0.12,0.79,63,54,52,2,1.17,96.3,52,11,82.06,Facile,Facile,Facile / Facile
1372,543,2016,Droit,14,8,QCM,0.9579,0.04,0.8,67,66,64,2,1.02,96.97,64,3,95.79,Trop Facile,Trop Facile,Trop Facile / Trop Facile
2202,543,2017,Droit,14,8,QCM,0.9739,0.04,0.83,54,54,53,1,1.0,98.15,53,1,97.39,Trop Facile,Trop Facile,Trop Facile / Trop Facile
3032,543,2018,Droit,14,8,QCM,0.7789,0.1,0.77,61,49,48,1,1.24,97.96,48,13,77.89,Trop Facile,Facile,Trop Facile / Facile
3862,543,2019,Droit,14,8,QCM,0.879,0.1,0.87,69,62,61,1,1.11,98.39,61,8,87.9,Trop Facile,Trop Facile,Trop Facile / Trop Facile
4692,543,2020,Droit,14,8,QCM,0.916,0.07,0.88,62,57,57,0,1.09,100.0,57,5,91.6,Trop Facile,Trop Facile,Trop Facile / Trop Facile
543,544,2015,Droit,14,9,QCU,0.176,0.13,0.27,20,20,4,16,1.0,20.0,4,16,17.6,Trop Difficile,Trop Difficile,Trop Difficile / Trop Difficile
1373,544,2016,Droit,14,9,QCU,0.6609,0.16,0.51,24,19,16,3,1.26,84.21,16,8,66.09,Trop Facile,Adapte,Trop Facile / Adapte
2203,544,2017,Droit,14,9,QCU,0.6055,0.09,0.7,29,27,18,9,1.07,66.67,18,11,60.55,Adapte,Adapte,Adapte / Adapte
3033,544,2018,Droit,14,9,QCU,0.7065,0.03,0.42,30,22,21,1,1.36,95.45,21,9,70.65,Adapte,Adapte,Adapte / Adapte
3863,544,2019,Droit,14,9,QCU,0.7168,0.12,0.46,24,21,17,4,1.14,80.95,17,7,71.68,Adapte,Adapte,Adapte / Adapte
4693,544,2020,Droit,14,9,QCU,0.7195,0.26,0.49,27,20,19,1,1.35,95.0,19,8,71.95,Adapte,Adapte,Adapte / Adapte
544,545,2015,Droit,14,10,QO,0.6639,0.6,0.22,92,80,61,19,1.15,76.25,61,31,66.39,Facile,Adapte,Facile / Adapte
1374,545,2016,Droit,14,10,QO,0.6003,0.45,0.28,84,61,50,11,1.38,81.97,50,34,60.03,Adapte,Adapte,Adapte / Adapte
2204,545,2017,Droit,14,10,QO,0.6876,0.25,0.25,83,81,57,24,1.02,70.37,57,26,68.76,Adapte,Adapte,Adapte / Adapte
3034,545,2018,Droit,14,10,QO,0.6025,0.71,0.15,70,69,42,27,1.01,60.87,42,28,60.25,Adapte,Adapte,Adapte / Adapte
3864,545,2019,Droit,14,10,QO,0.6057,0.28,0.23,61,39,37,2,1.56,94.87,37,24,60.57,Adapte,Adapte,Adapte / Adapte
4694,545,2020,Droit,14,10,QO,0.74,0.57,0.19,65,58,48,10,1.12,82.76,48,17,74.0,Adapte,Adapte,Adapte / Adapte
545,546,2015,Droit,14,11,QCM,0.7971,0.18,0.71,26,22,21,1,1.18,95.45,21,5,79.71,Facile,Facile,Facile / Facile
1375,546,2016,Droit,14,11,QCM,0.2193,0.18,0.22,25,14,5,9,1.79,35.71,5,20,21.93,Trop Facile,Trop Difficile,Trop Facile / Trop Difficile
2205,546,2017,Droit,14,11,QCM,0.8929,0.01,0.85,29,26,26,0,1.12,100.0,26,3,89.29,Trop Facile,Trop Facile,Trop Facile / Trop Facile
3035,546,2018,Droit,14,11,QCM,0.862,0.01,0.84,23,21,20,1,1.1,95.24,20,3,86.2,Trop Facile,Trop Facile,Trop Facile / Trop Facile
3865,546,2019,Droit,14,11,QCM,0.0365,0.47,0.29,20,14,1,13,1.43,7.14,1,19,3.65,Trop Facile,Trop Difficile,Trop Facile / Trop Difficile
4695,546,2020,Droit,14,11,QCM,0.9087,0.09,0.98,16,15,15,0,1.07,100.0,15,1,90.87,Trop Facile,Trop Facile,Trop Facile / Trop Facile
546,547,2015,Droit,14,12,QCM,0.6836,0.15,0.47,84,66,57,9,1.27,86.36,57,27,68.36,Adapte,Adapte,Adapte / Adapte
1376,547,2016,Droit,14,12,QCM,0.6879,0.05,0.62,86,64,59,5,1.34,92.19,59,27,68.79,Adapte,Adapte,Adapte / Adapte
2206,547,2017,Droit,14,12,QCM,0.7223,0.2,0.44,86,71,62,9,1.21,87.32,62,24,72.23,Adapte,Adapte,Adapte / Adapte
3036,547,2018,Droit,14,12,QCM,0.7055,0.07,0.48,71,62,50,12,1.15,80.65,50,21,70.55,Adapte,Adapte,Adapte / Adapte
3866,547,2019,Droit,14,12,QCM,0.6792,0.1,0.47,72,49,49,0,1.47,100.0,49,23,67.92,Adapte,Adapte,Adapte / Adapte
4696,547,2020,Droit,14,12,QCM,0.6053,0.02,0.43,61,38,37,1,1.61,97.37,37,24,60.53,Adapte,Adapte,Adapte / Adapte
547,548,2015,Droit,15,1,QCM,0.2665,0.24,0.32,89,67,24,43,1.33,35.82,24,65,26.65,Difficile,Difficile,Difficile / Difficile
1377,548,2016,Droit,15,1,QCM,0.9765,0.07,0.94,101,101,99,2,1.0,98.02,99,2,97.65,Trop Facile,Trop Facile,Trop Facile / Trop Facile
2207,548,2017,Droit,15,1,QCM,0.8894,0.08,0.95,110,99,98,1,1.11,98.99,98,12,88.94,Trop Facile,Trop Facile,Trop Facile / Trop Facile
3037,548,2018,Droit,15,1,QCM,0.7603,0.18,0.78,100,85,76,9,1.18,89.41,76,24,76.03,Trop Facile,Facile,Trop Facile / Facile
3867,548,2019,Droit,15,1,QCM,0.0949,0.13,0.26,97,95,9,86,1.02,9.47,9,88,9.49,Trop Facile,Trop Difficile,Trop Facile / Trop Difficile
4697,548,2020,Droit,15,1,QCM,0.3124,0.13,0.33,114,107,36,71,1.07,33.64,36,78,31.24,Trop Facile,Difficile,Trop Facile / Difficile
548,549,2015,Droit,15,2,QCM,0.2622,0.26,0.34,35,14,9,5,2.5,64.29,9,26,26.22,Difficile,Difficile,Difficile / Difficile
1378,549,2016,Droit,15,2,QCM,0.7968,0.08,0.76,35,28,28,0,1.25,100.0,28,7,79.68,Trop Facile,Facile,Trop Facile / Facile
2208,549,2017,Droit,15,2,QCM,0.1514,0.59,0.24,28,20,4,16,1.4,20.0,4,24,15.14,Trop Facile,Trop Difficile,Trop Facile / Trop Difficile
3038,549,2018,Droit,15,2,QCM,0.8839,0.09,0.95,34,33,30,3,1.03,90.91,30,4,88.39,Trop Facile,Trop Facile,Trop Facile / Trop Facile
3868,549,2019,Droit,15,2,QCM,0.6992,0.01,0.5,38,36,27,9,1.06,75.0,27,11,69.92,Trop Facile,Adapte,Trop Facile / Adapte
4698,549,2020,Droit,15,2,QCM,0.6701,0.15,0.61,44,38,29,9,1.16,76.32,29,15,67.01,Adapte,Adapte,Adapte / Adapte
549,550,2015,Droit,15,3,QCU,0.0626,0.59,0.23,9,6,1,5,1.5,16.67,1,8,6.26,Difficile,Trop Difficile,Difficile / Trop Difficile
1379,550,2016,Droit,15,3,QCU,0.2812,0.35,0.35,11,7,3,4,1.57,42.86,3,8,28.12,Trop Facile,Difficile,Trop Facile / Difficile
2209,550,2017,Droit,15,3,QCU,0.9149,0.01,0.92,11,11,10,1,1.0,90.91,10,1,91.49,Trop Facile,Trop Facile,Trop Facile / Trop Facile
3039,550,2018,Droit,15,3,QCU,0.2108,0.04,0.25,10,7,2,5,1.43,28.57,2,8,21.08,Trop Facile,Trop Difficile,Trop Facile / Trop Difficile
3869,550,2019,Droit,15,3,QCU,0.9588,0.07,0.98,8,8,8,0,1.0,100.0,8,0,95.88,Trop Facile,Trop Facile,Trop Facile / Trop Facile
4699,550,2020,Droit,15,3,QCU,0.9032,0.06,1.0,8,8,7,1,1.0,87.5,7,1,90.32,Trop Facile,Trop Facile,Trop Facile / Trop Facile
550,551,2015,Droit,15,4,QCU,0.8143,0.17,0.8,100,83,81,2,1.2,97.59,81,19,81.43,Facile,Facile,Facile / Facile
1380,551,2016,Droit,15,4,QCU,0.9587,0.09,0.98,119,115,114,1,1.03,99.13,114,5,95.87,Trop Facile,Trop Facile,Trop Facile / Trop Facile
2210,551,2017,Droit,15,4,QCU,0.9634,0.06,0.94,108,107,104,3,1.01,97.2,104,4,96.34,Trop Facile,Trop Facile,Trop Facile / Trop Facile
3040,551,2018,Droit,15,4,QCU,0.8747,0.01,0.92,115,112,101,11,1.03,90.18,101,14,87.47,Trop Facile,Trop Facile,Trop Facile / Trop Facile
3870,551,2019,Droit,15,4,QCU,0.8892,0.07,0.99,94,86,84,2,1.09,97.67,84,10,88.92,Trop Facile,Trop Facile,Trop Facile / Trop Facile
4700,551,2020,Droit,15,4,QCU,0.9579,0.02,0.97,106,106,102,4,1.0,96.23,102,4,95.79,Trop Facile,Trop Facile,Trop Facile / Trop Facile
551,552,2015,Droit,15,5,QROC,0.9786,0.07,0.93,99,98,97,1,1.01,98.98,97,2,97.86,Trop Facile,Trop Facile,Trop Facile / Trop Facile
1381,552,2016,Droit,15,5,QROC,0.9625,0.09,0.64,111,107,107,0,1.04,100.0,107,4,96.25,Trop Facile,Trop Facile,Trop Facile / Trop Facile
2211,552,2017,Droit,15,5,QROC,0.9213,0.08,0.88,133,130,123,7,1.02,94.62,123,10,92.13,Trop Facile,Trop Facile,Trop Facile / Trop Facile
3041,552,2018,Droit,15,5,QROC,0.8784,0.03,0.67,121,117,106,11,1.03,90.6,106,15,87.84,Trop Facile,Trop Facile,Trop Facile / Trop Facile
3871,552,2019,Droit,15,5,QROC,0.8967,0.09,0.9,129,126,116,10,1.02,92.06,116,13,89.67,Trop Facile,Trop Facile,Trop Facile / Trop Facile
4701,552,2020,Droit,15,5,QROC,0.6107,0.3,0.32,141,104,86,18,1.36,82.69,86,55,61.07,Trop Facile,Adapte,Trop Facile / Adapte
552,553,2015,Droit,15,6,QCU,0.1501,0.21,0.25,77,36,12,24,2.14,33.33,12,65,15.01,Trop Difficile,Trop Difficile,Trop Difficile / Trop Difficile
1382,553,2016,Droit,15,6,QCU,0.1716,0.53,0.2,62,39,11,28,1.59,28.21,11,51,17.16,Trop Facile,Trop Difficile,Trop Facile / Trop Difficile
2212,553,2017,Droit,15,6,QCU,0.4155,0.27,0.33,57,39,24,15,1.46,61.54,24,33,41.55,Trop Facile,Difficile,Trop Facile / Difficile
3042,553,2018,Droit,15,6,QCU,0.8673,0.03,0.97,67,59,58,1,1.14,98.31,58,9,86.73,Trop Facile,Trop Facile,Trop Facile / Trop Facile
3872,553,2019,Droit,15,6,QCU,0.927,0.05,0.93,55,55,51,4,1.0,92.73,51,4,92.7,Trop Facile,Trop Facile,Trop Facile / Trop Facile
4702,553,2020,Droit,15,6,QCU,0.8085,0.1,0.86,60,54,49,5,1.11,90.74,49,11,80.85,Trop Facile,Facile,Trop Facile / Facile
553,554,2015,Droit,15,7,QCM,0.2051,0.48,0.26,64,41,13,28,1.56,31.71,13,51,20.51,Difficile,Trop Difficile,Difficile / Trop Difficile
1383,554,2016,Droit,15,7,QCM,0.2003,0.5,0.27,56,14,11,3,4.0,78.57,11,45,20.03,Trop Facile,Trop Difficile,Trop Facile / Trop Difficile
2213,554,2017,Droit,15,7,QCM,0.9481,0.07,0.87,61,61,58,3,1.0,95.08,58,3,94.81,Trop Facile,Trop Facile,Trop Facile / Trop Facile
3043,554,2018,Droit,15,7,QCM,0.3848,0.08,0.38,62,28,24,4,2.21,85.71,24,38,38.48,Trop Facile,Difficile,Trop Facile / Difficile
3873,554,2019,Droit,15,7,QCM,0.7756,0.05,0.74,59,58,46,12,1.02,79.31,46,13,77.56,Trop Facile,Facile,Trop Facile / Facile
4703,554,2020,Droit,15,7,QCM,0.987,0.01,0.86,65,64,64,0,1.02,100.0,64,1,98.7,Trop Facile,Trop Facile,Trop Facile / Trop Facile
554,555,2015,Droit,15,8,QCU,0.1444,0.33,0.3,40,32,6,26,1.25,18.75,6,34,14.44,Trop Difficile,Trop Difficile,Trop Difficile / Trop Difficile
1384,555,2016,Droit,15,8,QCU,0.8795,0.05,0.95,35,33,31,2,1.06,93.94,31,4,87.95,Trop Facile,Trop Facile,Trop Facile / Trop Facile
2214,555,2017,Droit,15,8,QCU,0.9687,0.02,0.92,31,30,30,0,1.03,100.0,30,1,96.87,Trop Facile,Trop Facile,Trop Facile / Trop Facile
3044,555,2018,Droit,15,8,QCU,0.9445,0.07,0.95,26,26,25,1,1.0,96.15,25,1,94.45,Trop Facile,Trop Facile,Trop Facile / Trop Facile
3874,555,2019,Droit,15,8,QCU,0.6738,0.12,0.57,28,21,19,2,1.33,90.48,19,9,67.38,Trop Facile,Adapte,Trop Facile / Adapte
4704,555,2020,Droit,15,8,QCU,0.7162,0.29,0.51,22,21,16,5,1.05,76.19,16,6,71.62,Adapte,Adapte,Adapte / Adapte
555,556,2015,Droit,15,9,QCU,0.3654,0.0,0.32,45,21,16,5,2.14,76.19,16,29,36.54,Difficile,Difficile,Difficile / Difficile
1385,556,2016,Droit,15,9,QCU,0.12,0.52,0.23,47,38,6,32,1.24,15.79,6,41,12.0,Trop Facile,Trop Difficile,Trop Facile / Trop Difficile
2215,556,2017,Droit,15,9,QCU,0.9273,0.02,0.91,55,55,51,4,1.0,92.73,51,4,92.73,Trop Facile,Trop Facile,Trop Facile / Trop Facile
3045,556,2018,Droit,15,9,QCU,0.4244,0.21,0.37,47,32,20,12,1.47,62.5,20,27,42.44,Trop Facile,Difficile,Trop Facile / Difficile
3875,556,2019,Droit,15,9,QCU,0.9623,0.07,0.95,39,38,38,0,1.03,100.0,38,1,96.23,Trop Facile,Trop Facile,Trop Facile / Trop Facile
4705,556,2020,Droit,15,9,QCU,0.9267,0.04,0.94,47,45,44,1,1.04,97.78,44,3,92.67,Trop Facile,Trop Facile,Trop Facile / Trop Facile
556,557,2015,Droit,15,10,QO,0.1528,0.91,0.07,60,41,9,32,1.46,21.95,9,51,15.28,Trop Difficile,Trop Difficile,Trop Difficile / Trop Difficile
1386,557,2016,Droit,15,10,QO,0.9637,0.08,0.8,51,49,49,0,1.04,100.0,49,2,96.37,Trop Facile,Trop Facile,Trop Facile / Trop Facile
2216,557,2017,Droit,15,10,QO,0.7419,0.39,0.21,52,41,39,2,1.27,95.12,39,13,74.19,Trop Facile,Adapte,Trop Facile / Adapte
3046,557,2018,Droit,15,10,QO,0.6375,0.42,0.18,58,51,37,14,1.14,72.55,37,21,63.75,Adapte,Adapte,Adapte / Adapte
3876,557,2019,Droit,15,10,QO,0.6431,0.38,0.29,66,54,42,12,1.22,77.78,42,24,64.31,Adapte,Adapte,Adapte / Adapte
4706,557,2020,Droit,15,10,QO,0.7352,0.38,0.15,68,64,50,14,1.06,78.12,50,18,73.52,Adapte,Adapte,Adapte / Adapte
557,558,2015,Droit,15,11,QCM,0.5643,0.35,0.38,27,21,15,6,1.29,71.43,15,12,56.43,Difficile,Difficile,Difficile / Difficile
1387,558,2016,Droit,15,11,QCM,0.9877,0.05,0.9,26,26,26,0,1.0,100.0,26,0,98.77,Trop Facile,Trop Facile,Trop Facile / Trop Facile
2217,558,2017,Droit,15,11,QCM,0.9702,0.04,0.92,29,29,28,1,1.0,96.55,28,1,97.02,Trop Facile,Trop Facile,Trop Facile / Trop Facile
3047,558,2018,Droit,15,11,QCM,0.9373,0.05,0.91,33,33,31,2,1.0,93.94,31,2,93.73,Trop Facile,Trop Facile,Trop Facile / Trop Facile
3877,558,2019,Droit,15,11,QCM,0.6114,0.3,0.47,34,25,21,4,1.36,84.0,21,13,61.14,Trop Facile,Adapte,Trop Facile / Adapte
4707,558,2020,Droit,15,11,QCM,0.6725,0.13,0.42,30,20,20,0,1.5,100.0,20,10,67.25,Adapte,Adapte,Adapte / Adapte
558,559,2015,Droit,16,1,QROC,0.5701,0.62,0.24,66,63,38,25,1.05,60.32,38,28,57.01,Trop Difficile,Difficile,Trop Difficile / Difficile
1388,559,2016,Droit,16,1,QROC,0.9013,0.03,0.9,61,57,55,2,1.07,96.49,55,6,90.13,Trop Facile,Trop Facile,Trop Facile / Trop Facile
2218,559,2017,Droit,16,1,QROC,0.9305,0.01,0.57,54,53,50,3,1.02,94.34,50,4,93.05,Trop Facile,Trop Facile,Trop Facile / Trop Facile
3048,559,2018,Droit,16,1,QROC,0.9601,0.06,1.0,47,46,45,1,1.02,97.83,45,2,96.01,Trop Facile,Trop Facile,Trop Facile / Trop Facile
3878,559,2019,Droit,16,1,QROC,0.7002,0.24,0.31,52,39,36,3,1.33,92.31,36,16,70.02,Trop Facile,Adapte,Trop Facile / Adapte
4708,559,2020,Droit,16,1,QROC,0.6216,0.37,0.26,56,43,35,8,1.3,81.4,35,21,62.16,Adapte,Adapte,Adapte / Adapte
559,560,2015,Droit,16,2,QCU,0.9698,0.02,0.93,49,49,48,1,1.0,97.96,48,1,96.98,Trop Facile,Trop Facile,Trop Facile / Trop Facile
1389,560,2016,Droit,16,2,QCU,0.8442,0.15,0.86,46,44,39,5,1.05,88.64,39,7,84.42,Trop Facile,Facile,Trop Facile / Facile
2219,560,2017,Droit,16,2,QCU,0.8845,0.05,0.96,40,39,35,4,1.03,89.74,35,5,88.45,Trop Facile,Trop Facile,Trop Facile / Trop Facile
3049,560,2018,Droit,16,2,QCU,0.118,0.45,0.22,47,34,6,28,1.38,17.65,6,41,11.8,Trop Facile,Trop Difficile,Trop Facile / Trop Difficile
3879,560,2019,Droit,16,2,QCU,0.98,0.09,0.99,52,52,51,1,1.0,98.08,51,1,98.0,Trop Facile,Trop Facile,Trop Facile / Trop Facile
4709,560,2020,Droit,16,2,QCU,0.9567,0.05,0.98,42,41,40,1,1.02,97.56,40,2,95.67,Trop Facile,Trop Facile,Trop Facile / Trop Facile
560,561,2015,Droit,16,3,QCM,0.009,0.23,0.3,96,36,1,35,2.67,2.78,1,95,0.9,Trop Difficile,Trop Difficile,Trop Difficile / Trop Difficile
1390,561,2016,Droit,16,3,QCM,0.908,0.01,0.96,80,79,73,6,1.01,92.41,73,7,90.8,Trop Facile,Trop Facile,Trop Facile / Trop Facile
2220,561,2017,Droit,16,3,QCM,0.9158,0.03,0.88,92,85,84,1,1.08,98.82,84,8,91.58,Trop Facile,Trop Facile,Trop Facile / Trop Facile
3050,561,2018,Droit,16,3,QCM,0.9013,0.09,0.93,84,80,76,4,1.05,95.0,76,8,90.13,Trop Facile,Trop Facile,Trop Facile / Trop Facile
3880,561,2019,Droit,16,3,QCM,0.6417,0.2,0.64,94,62,60,2,1.52,96.77,60,34,64.17,Trop Facile,Adapte,Trop Facile / Adapte
4710,561,2020,Droit,16,3,QCM,0.6979,0.22,0.42,93,77,65,12,1.21,84.42,65,28,69.79,Adapte,Adapte,Adapte / Adapte
561,562,2015,Droit,16,4,QROC,0.1061,0.79,0.13,94,82,10,72,1.15,12.2,10,84,10.61,Trop Difficile,Trop Difficile,Trop Difficile / Trop Difficile
1391,562,2016,Droit,16,4,QROC,0.9542,0.09,0.94,112,111,107,4,1.01,96.4,107,5,95.42,Trop Facile,Trop Facile,Trop Facile / Trop Facile
2221,562,2017,Droit,16,4,QROC,0.8624,0.04,0.94,114,103,98,5,1.11,95.15,98,16,86.24,Trop Facile,Trop Facile,Trop Facile / Trop Facile
3051,562,2018,Droit,16,4,QROC,0.9793,0.01,0.51,117,117,115,2,1.0,98.29,115,2,97.93,Trop Facile,Trop Facile,Trop Facile / Trop Facile
3881,562,2019,Droit,16,4,QROC,0.9998,0.03,0.89,124,124,124,0,1.0,100.0,124,0,99.98,Trop Facile,Trop Facile,Trop Facile / Trop Facile
4711,562,2020,Droit,16,4,QROC,0.9301,0.01,0.56,135,127,126,1,1.06,99.21,126,9,93.01,Trop Facile,Trop Facile,Trop Facile / Trop Facile
562,563,2015,Droit,16,5,QCM,0.9422,0.09,0.97,42,42,40,2,1.0,95.24,40,2,94.22,Trop Facile,Trop Facile,Trop Facile / Trop Facile
1392,563,2016,Droit,16,5,QCM,0.5619,0.43,0.31,48,43,27,16,1.12,62.79,27,21,56.19,Trop Facile,Difficile,Trop Facile / Difficile
2222,563,2017,Droit,16,5,QCM,0.23,0.58,0.27,39,12,9,3,3.25,75.0,9,30,23.0,Trop Facile,Trop Difficile,Trop Facile / Trop Difficile
3052,563,2018,Droit,16,5,QCM,0.9286,0.02,0.89,45,44,42,2,1.02,95.45,42,3,92.86,Trop Facile,Trop Facile,Trop Facile / Trop Facile
3882,563,2019,Droit,16,5,QCM,0.6131,0.2,0.46,36,28,22,6,1.29,78.57,22,14,61.31,Trop Facile,Adapte,Trop Facile / Adapte
4712,563,2020,Droit,16,5,QCM,0.6475,0.3,0.41,36,34,23,11,1.06,67.65,23,13,64.75,Adapte,Adapte,Adapte / Adapte
563,564,2015,Droit,17,1,QCM,0.7952,0.15,0.8,53,53,42,11,1.0,79.25,42,11,79.52,Adapte,Facile,Adapte / Facile
1393,564,2016,Droit,17,1,QCM,0.9651,0.06,0.87,62,61,60,1,1.02,98.36,60,2,96.51,Trop Facile,Trop Facile,Trop Facile / Trop Facile
2223,564,2017,Droit,17,1,QCM,0.9417,0.02,0.97,64,64,60,4,1.0,93.75,60,4,94.17,Trop Facile,Trop Facile,Trop Facile / Trop Facile
3053,564,2018,Droit,17,1,QCM,0.9123,0.06,0.81,73,68,67,1,1.07,98.53,67,6,91.23,Trop Facile,Trop Facile,Trop Facile / Trop Facile
3883,564,2019,Droit,17,1,QCM,0.8808,0.04,0.91,80,74,70,4,1.08,94.59,70,10,88.08,Trop Facile,Trop Facile,Trop Facile / Trop Facile
4713,564,2020,Droit,17,1,QCM,0.8639,0.08,0.82,80,76,69,7,1.05,90.79,69,11,86.39,Trop Facile,Trop Facile,Trop Facile / Trop Facile
564,565,2015,Droit,17,2,QCM,0.887,0.04,0.98,44,44,39,5,1.0,88.64,39,5,88.7,Trop Facile,Trop Facile,Trop Facile / Trop Facile
1394,565,2016,Droit,17,2,QCM,0.9922,0.05,0.86,38,38,38,0,1.0,100.0,38,0,99.22,Trop Facile,Trop Facile,Trop Facile / Trop Facile
2224,565,2017,Droit,17,2,QCM,0.6219,0.11,0.55,44,44,27,17,1.0,61.36,27,17,62.19,Trop Facile,Adapte,Trop Facile / Adapte
3054,565,2018,Droit,17,2,QCM,0.6363,0.04,0.68,42,35,27,8,1.2,77.14,27,15,63.63,Adapte,Adapte,Adapte / Adapte
3884,565,2019,Droit,17,2,QCM,0.6401,0.03,0.59,35,31,22,9,1.13,70.97,22,13,64.01,Adapte,Adapte,Adapte / Adapte
4714,565,2020,Droit,17,2,QCM,0.7461,0.0,0.54,28,26,21,5,1.08,80.77,21,7,74.61,Adapte,Adapte,Adapte / Adapte
565,566,2015,Droit,17,3,QROC,0.6925,0.37,0.32,16,14,11,3,1.14,78.57,11,5,69.25,Adapte,Adapte,Adapte / Adapte
1395,566,2016,Droit,17,3,QROC,0.6273,0.34,0.31,13,13,8,5,1.0,61.54,8,5,62.73,Adapte,Adapte,Adapte / Adapte
2225,566,2017,Droit,17,3,QROC,0.6549,0.26,0.26,10,9,7,2,1.11,77.78,7,3,65.49,Adapte,Adapte,Adapte / Adapte
3055,566,2018,Droit,17,3,QROC,0.691,0.44,0.34,12,12,8,4,1.0,66.67,8,4,69.1,Adapte,Adapte,Adapte / Adapte
3885,566,2019,Droit,17,3,QROC,0.6638,0.46,0.31,11,10,7,3,1.1,70.0,7,4,66.38,Adapte,Adapte,Adapte / Adapte
4715,566,2020,Droit,17,3,QROC,0.6554,0.21,0.36,13,12,9,3,1.08,75.0,9,4,65.54,Adapte,Adapte,Adapte / Adapte
566,567,2015,Droit,17,4,QCM,0.8328,0.09,0.7,31,28,26,2,1.11,92.86,26,5,83.28,Facile,Facile,Facile / Facile
1396,567,2016,Droit,17,4,QCM,0.9808,0.1,0.8,33,33,32,1,1.0,96.97,32,1,98.08,Trop Facile,Trop Facile,Trop Facile / Trop Facile
2226,567,2017,Droit,17,4,QCM,0.232,0.24,0.28,29,28,7,21,1.04,25.0,7,22,23.2,Trop Facile,Trop Difficile,Trop Facile / Trop Difficile
3056,567,2018,Droit,17,4,QCM,0.8164,0.08,0.77,35,35,29,6,1.0,82.86,29,6,81.64,Trop Facile,Facile,Trop Facile / Facile
3886,567,2019,Droit,17,4,QCM,0.8854,0.0,0.81,35,33,31,2,1.06,93.94,31,4,88.54,Trop Facile,Trop Facile,Trop Facile / Trop Facile
4716,567,2020,Droit,17,4,QCM,0.972,0.05,0.8,28,28,27,1,1.0,96.43,27,1,97.2,Trop Facile,Trop Facile,Trop Facile / Trop Facile
567,568,2015,Droit,17,5,QO,0.3919,0.83,0.12,39,21,15,6,1.86,71.43,15,24,39.19,Difficile,Difficile,Difficile / Difficile
1397,568,2016,Droit,17,5,QO,0.79,0.09,0.53,42,33,33,0,1.27,100.0,33,9,79.0,Trop Facile,Facile,Trop Facile / Facile
2227,568,2017,Droit,17,5,QO,0.9244,0.01,0.89,42,42,39,3,1.0,92.86,39,3,92.44,Trop Facile,Trop Facile,Trop Facile / Trop Facile
3057,568,2018,Droit,17,5,QO,0.8641,0.01,0.67,36,36,31,5,1.0,86.11,31,5,86.41,Trop Facile,Trop Facile,Trop Facile / Trop Facile
3887,568,2019,Droit,17,5,QO,0.8488,0.15,0.68,35,31,30,1,1.13,96.77,30,5,84.88,Trop Facile,Facile,Trop Facile / Facile
4717,568,2020,Droit,17,5,QO,0.88,0.06,0.85,35,31,31,0,1.13,100.0,31,4,88.0,Trop Facile,Trop Facile,Trop Facile / Trop Facile
568,569,2015,Droit,17,6,QCU,0.8317,0.12,0.83,81,74,67,7,1.09,90.54,67,14,83.17,Trop Difficile,Facile,Trop Difficile / Facile
1398,569,2016,Droit,17,6,QCU,0.9158,0.03,1.0,91,87,83,4,1.05,95.4,83,8,91.58,Trop Facile,Trop Facile,Trop Facile / Trop Facile
2228,569,2017,Droit,17,6,QCU,0.8607,0.02,0.99,104,93,90,3,1.12,96.77,90,14,86.07,Trop Facile,Trop Facile,Trop Facile / Trop Facile
3058,569,2018,Droit,17,6,QCU,0.989,0.04,1.0,88,88,87,1,1.0,98.86,87,1,98.9,Trop Facile,Trop Facile,Trop Facile / Trop Facile
3888,569,2019,Droit,17,6,QCU,0.9575,0.08,0.95,101,97,97,0,1.04,100.0,97,4,95.75,Trop Facile,Trop Facile,Trop Facile / Trop Facile
4718,569,2020,Droit,17,6,QCU,0.6483,0.02,0.51,113,102,73,29,1.11,71.57,73,40,64.83,Trop Facile,Adapte,Trop Facile / Adapte
569,570,2015,Droit,17,7,QO,0.0033,0.99,0.08,40,33,0,33,1.21,0.0,0,40,0.33,Difficile,Trop Difficile,Difficile / Trop Difficile
1399,570,2016,Droit,17,7,QO,0.6856,0.73,0.29,35,33,24,9,1.06,72.73,24,11,68.56,Trop Facile,Adapte,Trop Facile / Adapte
2229,570,2017,Droit,17,7,QO,0.7114,0.73,0.28,34,31,24,7,1.1,77.42,24,10,71.14,Adapte,Adapte,Adapte / Adapte
3059,570,2018,Droit,17,7,QO,0.6024,0.72,0.18,28,19,17,2,1.47,89.47,17,11,60.24,Adapte,Adapte,Adapte / Adapte
3889,570,2019,Droit,17,7,QO,0.7483,0.39,0.27,32,29,24,5,1.1,82.76,24,8,74.83,Adapte,Adapte,Adapte / Adapte
4719,570,2020,Droit,17,7,QO,0.6953,0.73,0.17,32,30,22,8,1.07,73.33,22,10,69.53,Adapte,Adapte,Adapte / Adapte
570,571,2015,Droit,18,1,QO,0.4223,0.86,0.1,22,20,9,11,1.1,45.0,9,13,42.23,Difficile,Difficile,Difficile / Difficile
1400,571,2016,Droit,18,1,QO,0.8836,0.02,0.58,23,23,20,3,1.0,86.96,20,3,88.36,Trop Facile,Trop Facile,Trop Facile / Trop Facile
2230,571,2017,Droit,18,1,QO,0.9746,0.08,0.55,25,25,24,1,1.0,96.0,24,1,97.46,Trop Facile,Trop Facile,Trop Facile / Trop Facile
3060,571,2018,Droit,18,1,QO,0.9298,0.05,0.86,26,24,24,0,1.08,100.0,24,2,92.98,Trop Facile,Trop Facile,Trop Facile / Trop Facile
3890,571,2019,Droit,18,1,QO,0.9364,0.1,0.5,23,22,22,0,1.05,100.0,22,1,93.64,Trop Facile,Trop Facile,Trop Facile / Trop Facile
4720,571,2020,Droit,18,1,QO,0.9507,0.08,0.5,28,27,27,0,1.04,100.0,27,1,95.07,Trop Facile,Trop Facile,Trop Facile / Trop Facile
571,572,2015,Droit,18,2,QCU,0.8273,0.01,0.79,99,82,82,0,1.21,100.0,82,17,82.73,Facile,Facile,Facile / Facile
1401,572,2016,Droit,18,2,QCU,0.0824,0.15,0.27,93,35,8,27,2.66,22.86,8,85,8.24,Trop Facile,Trop Difficile,Trop Facile / Trop Difficile
2231,572,2017,Droit,18,2,QCU,0.8628,0.01,0.95,103,96,89,7,1.07,92.71,89,14,86.28,Trop Facile,Trop Facile,Trop Facile / Trop Facile
3061,572,2018,Droit,18,2,QCU,0.9209,0.08,0.96,89,87,82,5,1.02,94.25,82,7,92.09,Trop Facile,Trop Facile,Trop Facile / Trop Facile
3891,572,2019,Droit,18,2,QCU,0.8749,0.09,0.95,89,83,78,5,1.07,93.98,78,11,87.49,Trop Facile,Trop Facile,Trop Facile / Trop Facile
4721,572,2020,Droit,18,2,QCU,0.8735,0.01,0.96,89,83,78,5,1.07,93.98,78,11,87.35,Trop Facile,Trop Facile,Trop Facile / Trop Facile
572,573,2015,Droit,18,3,QCU,0.9952,0.04,0.9,70,70,70,0,1.0,100.0,70,0,99.52,Trop Difficile,Trop Facile,Trop Difficile / Trop Facile
1402,573,2016,Droit,18,3,QCU,0.8024,0.12,0.77,67,58,54,4,1.16,93.1,54,13,80.24,Trop Facile,Facile,Trop Facile / Facile
2232,573,2017,Droit,18,3,QCU,0.9743,0.06,0.99,67,65,65,0,1.03,100.0,65,2,97.43,Trop Facile,Trop Facile,Trop Facile / Trop Facile
3062,573,2018,Droit,18,3,QCU,0.3601,0.16,0.32,73,68,26,42,1.07,38.24,26,47,36.01,Trop Facile,Difficile,Trop Facile / Difficile
3892,573,2019,Droit,18,3,QCU,0.7614,0.07,0.78,74,71,56,15,1.04,78.87,56,18,76.14,Trop Facile,Facile,Trop Facile / Facile
4722,573,2020,Droit,18,3,QCU,0.7972,0.19,0.84,88,86,70,16,1.02,81.4,70,18,79.72,Trop Facile,Facile,Trop Facile / Facile
573,574,2015,Droit,18,4,QCM,0.4148,0.34,0.36,46,40,19,21,1.15,47.5,19,27,41.48,Facile,Difficile,Facile / Difficile
1403,574,2016,Droit,18,4,QCM,0.3563,0.42,0.34,37,26,13,13,1.42,50.0,13,24,35.63,Trop Facile,Difficile,Trop Facile / Difficile
2233,574,2017,Droit,18,4,QCM,0.9003,0.1,0.89,34,33,31,2,1.03,93.94,31,3,90.03,Trop Facile,Trop Facile,Trop Facile / Trop Facile
3063,574,2018,Droit,18,4,QCM,0.9777,0.03,0.91,39,39,38,1,1.0,97.44,38,1,97.77,Trop Facile,Trop Facile,Trop Facile / Trop Facile
3893,574,2019,Droit,18,4,QCM,0.8154,0.19,0.75,45,41,37,4,1.1,90.24,37,8,81.54,Trop Facile,Facile,Trop Facile / Facile
4723,574,2020,Droit,18,4,QCM,0.8659,0.02,0.94,44,42,38,4,1.05,90.48,38,6,86.59,Trop Facile,Trop Facile,Trop Facile / Trop Facile
574,575,2015,Droit,18,5,QCM,0.6338,0.15,0.7,75,64,48,16,1.17,75.0,48,27,63.38,Adapte,Adapte,Adapte / Adapte
1404,575,2016,Droit,18,5,QCM,0.6438,0.05,0.62,72,58,46,12,1.24,79.31,46,26,64.38,Adapte,Adapte,Adapte / Adapte
2234,575,2017,Droit,18,5,QCM,0.6723,0.07,0.53,80,68,54,14,1.18,79.41,54,26,67.23,Adapte,Adapte,Adapte / Adapte
3064,575,2018,Droit,18,5,QCM,0.6465,0.26,0.53,75,68,48,20,1.1,70.59,48,27,64.65,Adapte,Adapte,Adapte / Adapte
3894,575,2019,Droit,18,5,QCM,0.6384,0.06,0.61,81,58,52,6,1.4,89.66,52,29,63.84,Adapte,Adapte,Adapte / Adapte
4724,575,2020,Droit,18,5,QCM,0.7228,0.17,0.43,74,60,53,7,1.23,88.33,53,21,72.28,Adapte,Adapte,Adapte / Adapte
575,576,2015,Droit,18,6,QROC,0.6564,0.21,0.28,80,67,53,14,1.19,79.1,53,27,65.64,Adapte,Adapte,Adapte / Adapte
1405,576,2016,Droit,18,6,QROC,0.6233,0.5,0.38,68,66,42,24,1.03,63.64,42,26,62.33,Adapte,Adapte,Adapte / Adapte
2235,576,2017,Droit,18,6,QROC,0.7206,0.23,0.29,82,75,59,16,1.09,78.67,59,23,72.06,Adapte,Adapte,Adapte / Adapte
3065,576,2018,Droit,18,6,QROC,0.7483,0.21,0.38,72,67,54,13,1.07,80.6,54,18,74.83,Adapte,Adapte,Adapte / Adapte
3895,576,2019,Droit,18,6,QROC,0.7269,0.42,0.31,84,76,61,15,1.11,80.26,61,23,72.69,Adapte,Adapte,Adapte / Adapte
4725,576,2020,Droit,18,6,QROC,0.6653,0.29,0.36,80,61,53,8,1.31,86.89,53,27,66.53,Adapte,Adapte,Adapte / Adapte
576,577,2015,Droit,18,7,QCU,0.887,0.06,0.92,46,44,41,3,1.05,93.18,41,5,88.7,Trop Facile,Trop Facile,Trop Facile / Trop Facile
1406,577,2016,Droit,18,7,QCU,0.9367,0.1,0.99,49,47,46,1,1.04,97.87,46,3,93.67,Trop Facile,Trop Facile,Trop Facile / Trop Facile
2236,577,2017,Droit,18,7,QCU,0.9338,0.1,0.91,41,39,38,1,1.05,97.44,38,3,93.38,Trop Facile,Trop Facile,Trop Facile / Trop Facile
3066,577,2018,Droit,18,7,QCU,0.8914,0.05,0.99,41,38,37,1,1.08,97.37,37,4,89.14,Trop Facile,Trop Facile,Trop Facile / Trop Facile
3896,577,2019,Droit,18,7,QCU,0.9202,0.08,0.96,49,48,45,3,1.02,93.75,45,4,92.02,Trop Facile,Trop Facile,Trop Facile / Trop Facile
4726,577,2020,Droit,18,7,QCU,0.0135,0.32,0.24,57,42,1,41,1.36,2.38,1,56,1.35,Trop Facile,Trop Difficile,Trop Facile / Trop Difficile
577,578,2015,Droit,18,8,QCU,0.6873,0.0,0.45,68,62,47,15,1.1,75.81,47,21,68.73,Adapte,Adapte,Adapte / Adapte
1407,578,2016,Droit,18,8,QCU,0.6966,0.04,0.63,58,43,40,3,1.35,93.02,40,18,69.66,Adapte,Adapte,Adapte / Adapte
2237,578,2017,Droit,18,8,QCU,0.6849,0.05,0.53,69,67,47,20,1.03,70.15,47,22,68.49,Adapte,Adapte,Adapte / Adapte
3067,578,2018,Droit,18,8,QCU,0.7197,0.11,0.61,74,67,53,14,1.1,79.1,53,21,71.97,Adapte,Adapte,Adapte / Adapte
3897,578,2019,Droit,18,8,QCU,0.6322,0.23,0.65,64,49,40,9,1.31,81.63,40,24,63.22,Adapte,Adapte,Adapte / Adapte
4727,578,2020,Droit,18,8,QCU,0.7308,0.29,0.6,76,74,56,18,1.03,75.68,56,20,73.08,Adapte,Adapte,Adapte / Adapte
578,579,2015,Droit,18,9,QCU,0.5355,0.35,0.39,49,30,26,4,1.63,86.67,26,23,53.55,Difficile,Difficile,Difficile / Difficile
1408,579,2016,Droit,18,9,QCU,0.6797,0.19,0.47,48,47,33,14,1.02,70.21,33,15,67.97,Trop Facile,Adapte,Trop Facile / Adapte
2238,579,2017,Droit,18,9,QCU,0.6678,0.08,0.59,47,34,31,3,1.38,91.18,31,16,66.78,Adapte,Adapte,Adapte / Adapte
3068,579,2018,Droit,18,9,QCU,0.7254,0.16,0.44,56,52,41,11,1.08,78.85,41,15,72.54,Adapte,Adapte,Adapte / Adapte
3898,579,2019,Droit,18,9,QCU,0.7182,0.05,0.57,64,54,46,8,1.19,85.19,46,18,71.82,Adapte,Adapte,Adapte / Adapte
4728,579,2020,Droit,18,9,QCU,0.6151,0.11,0.54,75,51,46,5,1.47,90.2,46,29,61.51,Adapte,Adapte,Adapte / Adapte
579,580,2015,Droit,18,10,QCM,0.6274,0.16,0.66,6,6,4,2,1.0,66.67,4,2,62.74,Trop Difficile,Adapte,Trop Difficile / Adapte
1409,580,2016,Droit,18,10,QCM,0.6245,0.28,0.47,5,4,3,1,1.25,75.0,3,2,62.45,Adapte,Adapte,Adapte / Adapte
2239,580,2017,Droit,18,10,QCM,0.6743,0.28,0.53,4,4,3,1,1.0,75.0,3,1,67.43,Adapte,Adapte,Adapte / Adapte
3069,580,2018,Droit,18,10,QCM,0.6499,0.19,0.64,5,3,3,0,1.67,100.0,3,2,64.99,Adapte,Adapte,Adapte / Adapte
3899,580,2019,Droit,18,10,QCM,0.6528,0.23,0.5,4,4,3,1,1.0,75.0,3,1,65.28,Adapte,Adapte,Adapte / Adapte
4729,580,2020,Droit,18,10,QCM,0.7293,0.29,0.61,5,5,4,1,1.0,80.0,4,1,72.93,Adapte,Adapte,Adapte / Adapte
580,581,2015,Droit,18,11,QCU,0.4417,0.29,0.31,46,28,20,8,1.64,71.43,20,26,44.17,Facile,Difficile,Facile / Difficile
1410,581,2016,Droit,18,11,QCU,0.6482,0.25,0.41,44,34,29,5,1.29,85.29,29,15,64.82,Trop Facile,Adapte,Trop Facile / Adapte
2240,581,2017,Droit,18,11,QCU,0.7296,0.01,0.63,42,35,31,4,1.2,88.57,31,11,72.96,Adapte,Adapte,Adapte / Adapte
3070,581,2018,Droit,18,11,QCU,0.7169,0.23,0.7,39,30,28,2,1.3,93.33,28,11,71.69,Adapte,Adapte,Adapte / Adapte
3900,581,2019,Droit,18,11,QCU,0.6375,0.13,0.53,41,30,26,4,1.37,86.67,26,15,63.75,Adapte,Adapte,Adapte / Adapte
4730,581,2020,Droit,18,11,QCU,0.601,0.26,0.55,46,37,28,9,1.24,75.68,28,18,60.1,Adapte,Adapte,Adapte / Adapte
581,582,2015,Droit,18,12,QCU,0.5636,0.25,0.33,95,83,54,29,1.14,65.06,54,41,56.36,Facile,Difficile,Facile / Difficile
1411,582,2016,Droit,18,12,QCU,0.7803,0.15,0.8,88,73,69,4,1.21,94.52,69,19,78.03,Trop Facile,Facile,Trop Facile / Facile
2241,582,2017,Droit,18,12,QCU,0.882,0.03,0.96,102,91,90,1,1.12,98.9,90,12,88.2,Trop Facile,Trop Facile,Trop Facile / Trop Facile
3071,582,2018,Droit,18,12,QCU,0.9687,0.01,0.94,101,98,98,0,1.03,100.0,98,3,96.87,Trop Facile,Trop Facile,Trop Facile / Trop Facile
3901,582,2019,Droit,18,12,QCU,0.8603,0.04,0.98,85,80,73,7,1.06,91.25,73,12,86.03,Trop Facile,Trop Facile,Trop Facile / Trop Facile
4731,582,2020,Droit,18,12,QCU,0.9863,0.09,0.99,93,92,92,0,1.01,100.0,92,1,98.63,Trop Facile,Trop Facile,Trop Facile / Trop Facile
582,583,2015,Droit,18,13,QO,0.8311,0.06,0.36,21,20,17,3,1.05,85.0,17,4,83.11,Trop Difficile,Facile,Trop Difficile / Facile
1412,583,2016,Droit,18,13,QO,0.2064,0.9,0.1,21,12,4,8,1.75,33.33,4,17,20.64,Trop Facile,Trop Difficile,Trop Facile / Trop Difficile
2242,583,2017,Droit,18,13,QO,0.9452,0.1,0.87,22,21,21,0,1.05,100.0,21,1,94.52,Trop Facile,Trop Facile,Trop Facile / Trop Facile
3072,583,2018,Droit,18,13,QO,0.9985,0.05,0.81,18,18,18,0,1.0,100.0,18,0,99.85,Trop Facile,Trop Facile,Trop Facile / Trop Facile
3902,583,2019,Droit,18,13,QO,0.8428,0.17,0.68,22,21,19,2,1.05,90.48,19,3,84.28,Trop Facile,Facile,Trop Facile / Facile
4732,583,2020,Droit,18,13,QO,0.8635,0.01,0.8,24,23,21,2,1.04,91.3,21,3,86.35,Trop Facile,Trop Facile,Trop Facile / Trop Facile
583,584,2015,Droit,18,14,QROC,0.7651,0.17,0.73,49,49,37,12,1.0,75.51,37,12,76.51,Adapte,Facile,Adapte / Facile
1413,584,2016,Droit,18,14,QROC,0.9473,0.1,0.83,41,39,39,0,1.05,100.0,39,2,94.73,Trop Facile,Trop Facile,Trop Facile / Trop Facile
2243,584,2017,Droit,18,14,QROC,0.3681,0.57,0.18,45,30,17,13,1.5,56.67,17,28,36.81,Trop Facile,Difficile,Trop Facile / Difficile
3073,584,2018,Droit,18,14,QROC,0.877,0.02,0.62,51,46,45,1,1.11,97.83,45,6,87.7,Trop Facile,Trop Facile,Trop Facile / Trop Facile
3903,584,2019,Droit,18,14,QROC,0.9784,0.02,0.74,55,54,54,0,1.02,100.0,54,1,97.84,Trop Facile,Trop Facile,Trop Facile / Trop Facile
4733,584,2020,Droit,18,14,QROC,0.0564,0.98,0.12,55,53,3,50,1.04,5.66,3,52,5.64,Trop Facile,Trop Difficile,Trop Facile / Trop Difficile
584,585,2015,Droit,19,1,QCU,0.0672,0.16,0.29,65,43,4,39,1.51,9.3,4,61,6.72,Difficile,Trop Difficile,Difficile / Trop Difficile
1414,585,2016,Droit,19,1,QCU,0.8067,0.1,0.83,72,67,58,9,1.07,86.57,58,14,80.67,Trop Facile,Facile,Trop Facile / Facile
2244,585,2017,Droit,19,1,QCU,0.7342,0.23,0.6,75,65,55,10,1.15,84.62,55,20,73.42,Trop Facile,Adapte,Trop Facile / Adapte
3074,585,2018,Droit,19,1,QCU,0.6974,0.02,0.5,83,72,58,14,1.15,80.56,58,25,69.74,Adapte,Adapte,Adapte / Adapte
3904,585,2019,Droit,19,1,QCU,0.7349,0.24,0.54,79,74,58,16,1.07,78.38,58,21,73.49,Adapte,Adapte,Adapte / Adapte
4734,585,2020,Droit,19,1,QCU,0.6683,0.09,0.4,75,69,50,19,1.09,72.46,50,25,66.83,Adapte,Adapte,Adapte / Adapte
585,586,2015,Droit,19,2,QCM,0.8036,0.16,0.74,95,85,76,9,1.12,89.41,76,19,80.36,Facile,Facile,Facile / Facile
1415,586,2016,Droit,19,2,QCM,0.9608,0.05,0.95,111,110,107,3,1.01,97.27,107,4,96.08,Trop Facile,Trop Facile,Trop Facile / Trop Facile
2245,586,2017,Droit,19,2,QCM,0.901,0.04,0.81,127,125,114,11,1.02,91.2,114,13,90.1,Trop Facile,Trop Facile,Trop Facile / Trop Facile
3075,586,2018,Droit,19,2,QCM,0.9768,0.03,0.85,135,134,132,2,1.01,98.51,132,3,97.68,Trop Facile,Trop Facile,Trop Facile / Trop Facile
3905,586,2019,Droit,19,2,QCM,0.792,0.11,0.75,153,137,121,16,1.12,88.32,121,32,79.2,Trop Facile,Facile,Trop Facile / Facile
4735,586,2020,Droit,19,2,QCM,0.9658,0.07,0.85,171,169,165,4,1.01,97.63,165,6,96.58,Trop Facile,Trop Facile,Trop Facile / Trop Facile
586,587,2015,Droit,19,3,QCU,0.5789,0.1,0.34,38,31,22,9,1.23,70.97,22,16,57.89,Difficile,Difficile,Difficile / Difficile
1416,587,2016,Droit,19,3,QCU,0.7949,0.08,0.81,34,27,27,0,1.26,100.0,27,7,79.49,Trop Facile,Facile,Trop Facile / Facile
2246,587,2017,Droit,19,3,QCU,0.558,0.32,0.35,27,20,15,5,1.35,75.0,15,12,55.8,Trop Facile,Difficile,Trop Facile / Difficile
3076,587,2018,Droit,19,3,QCU,0.9889,0.1,0.92,25,25,25,0,1.0,100.0,25,0,98.89,Trop Facile,Trop Facile,Trop Facile / Trop Facile
3906,587,2019,Droit,19,3,QCU,0.7108,0.18,0.61,27,24,19,5,1.12,79.17,19,8,71.08,Trop Facile,Adapte,Trop Facile / Adapte
4736,587,2020,Droit,19,3,QCU,0.7113,0.11,0.44,24,19,17,2,1.26,89.47,17,7,71.13,Adapte,Adapte,Adapte / Adapte
587,588,2015,Droit,19,4,QROC,0.888,0.04,0.87,32,29,28,1,1.1,96.55,28,4,88.8,Trop Facile,Trop Facile,Trop Facile / Trop Facile
1417,588,2016,Droit,19,4,QROC,0.9216,0.1,0.95,28,27,26,1,1.04,96.3,26,2,92.16,Trop Facile,Trop Facile,Trop Facile / Trop Facile
2247,588,2017,Droit,19,4,QROC,0.8831,0.1,0.59,33,33,29,4,1.0,87.88,29,4,88.31,Trop Facile,Trop Facile,Trop Facile / Trop Facile
3077,588,2018,Droit,19,4,QROC,0.8638,0.1,0.91,38,37,33,4,1.03,89.19,33,5,86.38,Trop Facile,Trop Facile,Trop Facile / Trop Facile
3907,588,2019,Droit,19,4,QROC,0.927,0.06,0.54,38,38,35,3,1.0,92.11,35,3,92.7,Trop Facile,Trop Facile,Trop Facile / Trop Facile
4737,588,2020,Droit,19,4,QROC,0.477,0.54,0.21,38,37,18,19,1.03,48.65,18,20,47.7,Trop Facile,Difficile,Trop Facile / Difficile
588,589,2015,Droit,19,5,QCM,0.3108,0.01,0.34,66,61,21,40,1.08,34.43,21,45,31.08,Difficile,Difficile,Difficile / Difficile
1418,589,2016,Droit,19,5,QCM,0.8648,0.08,0.88,58,57,50,7,1.02,87.72,50,8,86.48,Trop Facile,Trop Facile,Trop Facile / Trop Facile
2248,589,2017,Droit,19,5,QCM,0.7817,0.16,0.74,63,59,49,10,1.07,83.05,49,14,78.17,Trop Facile,Facile,Trop Facile / Facile
3078,589,2018,Droit,19,5,QCM,0.9457,0.02,1.0,63,61,60,1,1.03,98.36,60,3,94.57,Trop Facile,Trop Facile,Trop Facile / Trop Facile
3908,589,2019,Droit,19,5,QCM,0.9731,0.04,0.81,51,50,50,0,1.02,100.0,50,1,97.31,Trop Facile,Trop Facile,Trop Facile / Trop Facile
4738,589,2020,Droit,19,5,QCM,0.9831,0.1,0.9,61,60,60,0,1.02,100.0,60,1,98.31,Trop Facile,Trop Facile,Trop Facile / Trop Facile
589,590,2015,Droit,19,6,QCU,0.1126,0.53,0.21,94,51,11,40,1.84,21.57,11,83,11.26,Facile,Trop Difficile,Facile / Trop Difficile
1419,590,2016,Droit,19,6,QCU,0.8788,0.04,1.0,95,85,83,2,1.12,97.65,83,12,87.88,Trop Facile,Trop Facile,Trop Facile / Trop Facile
2249,590,2017,Droit,19,6,QCU,0.8923,0.04,0.98,114,110,102,8,1.04,92.73,102,12,89.23,Trop Facile,Trop Facile,Trop Facile / Trop Facile
3079,590,2018,Droit,19,6,QCU,0.8652,0.08,1.0,118,107,102,5,1.1,95.33,102,16,86.52,Trop Facile,Trop Facile,Trop Facile / Trop Facile
3909,590,2019,Droit,19,6,QCU,0.9535,0.03,0.99,106,106,101,5,1.0,95.28,101,5,95.35,Trop Facile,Trop Facile,Trop Facile / Trop Facile
4739,590,2020,Droit,19,6,QCU,0.9813,0.04,0.95,106,104,104,0,1.02,100.0,104,2,98.13,Trop Facile,Trop Facile,Trop Facile / Trop Facile
590,591,2015,Droit,19,7,QCU,0.7222,0.19,0.69,53,38,38,0,1.39,100.0,38,15,72.22,Trop Facile,Adapte,Trop Facile / Adapte
1420,591,2016,Droit,19,7,QCU,0.7026,0.02,0.63,59,55,41,14,1.07,74.55,41,18,70.26,Adapte,Adapte,Adapte / Adapte
2250,591,2017,Droit,19,7,QCU,0.6072,0.05,0.61,67,50,41,9,1.34,82.0,41,26,60.72,Adapte,Adapte,Adapte / Adapte
3080,591,2018,Droit,19,7,QCU,0.6349,0.09,0.68,74,56,47,9,1.32,83.93,47,27,63.49,Adapte,Adapte,Adapte / Adapte
3910,591,2019,Droit,19,7,QCU,0.6912,0.21,0.65,75,64,52,12,1.17,81.25,52,23,69.12,Adapte,Adapte,Adapte / Adapte
4740,591,2020,Droit,19,7,QCU,0.7038,0.01,0.61,69,62,49,13,1.11,79.03,49,20,70.38,Adapte,Adapte,Adapte / Adapte
591,592,2015,Droit,20,1,QCU,0.198,0.01,0.27,20,12,4,8,1.67,33.33,4,16,19.8,Trop Difficile,Trop Difficile,Trop Difficile / Trop Difficile
1421,592,2016,Droit,20,1,QCU,0.8847,0.06,0.91,21,20,19,1,1.05,95.0,19,2,88.47,Trop Facile,Trop Facile,Trop Facile / Trop Facile
2251,592,2017,Droit,20,1,QCU,0.9684,0.09,0.93,17,16,16,0,1.06,100.0,16,1,96.84,Trop Facile,Trop Facile,Trop Facile / Trop Facile
3081,592,2018,Droit,20,1,QCU,0.8256,0.2,0.78,17,14,14,0,1.21,100.0,14,3,82.56,Trop Facile,Facile,Trop Facile / Facile
3911,592,2019,Droit,20,1,QCU,0.909,0.02,0.99,16,15,15,0,1.07,100.0,15,1,90.9,Trop Facile,Trop Facile,Trop Facile / Trop Facile
4741,592,2020,Droit,20,1,QCU,0.8119,0.18,0.86,18,18,15,3,1.0,83.33,15,3,81.19,Trop Facile,Facile,Trop Facile / Facile
592,593,2015,Droit,20,2,QCU,0.0307,0.45,0.29,48,16,1,15,3.0,6.25,1,47,3.07,Difficile,Trop Difficile,Difficile / Trop Difficile
1422,593,2016,Droit,20,2,QCU,0.912,0.06,0.9,42,42,38,4,1.0,90.48,38,4,91.2,Trop Facile,Trop Facile,Trop Facile / Trop Facile
2252,593,2017,Droit,20,2,QCU,0.4709,0.33,0.35,50,42,24,18,1.19,57.14,24,26,47.09,Trop Facile,Difficile,Trop Facile / Difficile
3082,593,2018,Droit,20,2,QCU,0.23,0.69,0.21,43,35,10,25,1.23,28.57,10,33,23.0,Trop Facile,Trop Difficile,Trop Facile / Trop Difficile
3912,593,2019,Droit,20,2,QCU,0.9993,0.07,0.93,35,35,35,0,1.0,100.0,35,0,99.93,Trop Facile,Trop Facile,Trop Facile / Trop Facile
4742,593,2020,Droit,20,2,QCU,0.9192,0.08,0.92,31,31,28,3,1.0,90.32,28,3,91.92,Trop Facile,Trop Facile,Trop Facile / Trop Facile
593,594,2015,Droit,21,1,QCU,0.8091,0.17,0.78,87,86,70,16,1.01,81.4,70,17,80.91,Facile,Facile,Facile / Facile
1423,594,2016,Droit,21,1,QCU,0.5414,0.04,0.3,90,73,49,24,1.23,67.12,49,41,54.14,Trop Facile,Difficile,Trop Facile / Difficile
2253,594,2017,Droit,21,1,QCU,0.2036,0.51,0.26,75,48,15,33,1.56,31.25,15,60,20.36,Trop Facile,Trop Difficile,Trop Facile / Trop Difficile
3083,594,2018,Droit,21,1,QCU,0.9527,0.04,0.94,69,68,66,2,1.01,97.06,66,3,95.27,Trop Facile,Trop Facile,Trop Facile / Trop Facile
3913,594,2019,Droit,21,1,QCU,0.9292,0.02,0.96,82,80,76,4,1.02,95.0,76,6,92.92,Trop Facile,Trop Facile,Trop Facile / Trop Facile
4743,594,2020,Droit,21,1,QCU,0.024,0.65,0.28,72,28,2,26,2.57,7.14,2,70,2.4,Trop Facile,Trop Difficile,Trop Facile / Trop Difficile
594,595,2015,Sociologie,1,1,QCM,0.0574,0.18,0.23,52,24,3,21,2.17,12.5,3,49,5.74,Trop Difficile,Trop Difficile,Trop Difficile / Trop Difficile
1424,595,2016,Sociologie,1,1,QCM,0.9754,0.09,0.8,48,48,47,1,1.0,97.92,47,1,97.54,Trop Facile,Trop Facile,Trop Facile / Trop Facile
2254,595,2017,Sociologie,1,1,QCM,0.9537,0.06,0.96,57,55,54,1,1.04,98.18,54,3,95.37,Trop Facile,Trop Facile,Trop Facile / Trop Facile
3084,595,2018,Sociologie,1,1,QCM,0.9245,0.08,0.85,47,44,43,1,1.07,97.73,43,4,92.45,Trop Facile,Trop Facile,Trop Facile / Trop Facile
3914,595,2019,Sociologie,1,1,QCM,0.8889,0.03,0.99,50,45,44,1,1.11,97.78,44,6,88.89,Trop Facile,Trop Facile,Trop Facile / Trop Facile
4744,595,2020,Sociologie,1,1,QCM,0.9142,0.08,0.91,57,52,52,0,1.1,100.0,52,5,91.42,Trop Facile,Trop Facile,Trop Facile / Trop Facile
595,596,2015,Sociologie,1,2,QCM,0.3063,0.17,0.35,20,6,6,0,3.33,100.0,6,14,30.63,Difficile,Difficile,Difficile / Difficile
1425,596,2016,Sociologie,1,2,QCM,0.9372,0.03,0.83,21,21,20,1,1.0,95.24,20,1,93.72,Trop Facile,Trop Facile,Trop Facile / Trop Facile
2255,596,2017,Sociologie,1,2,QCM,0.8962,0.02,0.96,23,22,21,1,1.05,95.45,21,2,89.62,Trop Facile,Trop Facile,Trop Facile / Trop Facile
3085,596,2018,Sociologie,1,2,QCM,0.8962,0.06,0.94,18,18,16,2,1.0,88.89,16,2,89.62,Trop Facile,Trop Facile,Trop Facile / Trop Facile
3915,596,2019,Sociologie,1,2,QCM,0.9828,0.02,0.98,15,15,15,0,1.0,100.0,15,0,98.28,Trop Facile,Trop Facile,Trop Facile / Trop Facile
4745,596,2020,Sociologie,1,2,QCM,0.0436,0.28,0.29,14,7,1,6,2.0,14.29,1,13,4.36,Trop Facile,Trop Difficile,Trop Facile / Trop Difficile
596,597,2015,Sociologie,1,3,QCU,0.0338,0.0,0.28,20,12,1,11,1.67,8.33,1,19,3.38,Trop Difficile,Trop Difficile,Trop Difficile / Trop Difficile
1426,597,2016,Sociologie,1,3,QCU,0.9748,0.01,0.94,24,24,23,1,1.0,95.83,23,1,97.48,Trop Facile,Trop Facile,Trop Facile / Trop Facile
2256,597,2017,Sociologie,1,3,QCU,0.8693,0.08,0.91,27,26,23,3,1.04,88.46,23,4,86.93,Trop Facile,Trop Facile,Trop Facile / Trop Facile
3086,597,2018,Sociologie,1,3,QCU,0.9777,0.03,0.92,25,25,24,1,1.0,96.0,24,1,97.77,Trop Facile,Trop Facile,Trop Facile / Trop Facile
3916,597,2019,Sociologie,1,3,QCU,0.8453,0.1,0.76,28,25,24,1,1.12,96.0,24,4,84.53,Trop Facile,Facile,Trop Facile / Facile
4746,597,2020,Sociologie,1,3,QCU,0.6738,0.0,0.47,33,23,22,1,1.43,95.65,22,11,67.38,Trop Facile,Adapte,Trop Facile / Adapte
597,598,2015,Sociologie,1,4,QCU,0.3923,0.33,0.35,62,56,24,32,1.11,42.86,24,38,39.23,Difficile,Difficile,Difficile / Difficile
1427,598,2016,Sociologie,1,4,QCU,0.9207,0.07,0.9,74,69,68,1,1.07,98.55,68,6,92.07,Trop Facile,Trop Facile,Trop Facile / Trop Facile
2257,598,2017,Sociologie,1,4,QCU,0.9964,0.03,0.97,79,79,79,0,1.0,100.0,79,0,99.64,Trop Facile,Trop Facile,Trop Facile / Trop Facile
3087,598,2018,Sociologie,1,4,QCU,0.6769,0.22,0.49,78,76,53,23,1.03,69.74,53,25,67.69,Trop Facile,Adapte,Trop Facile / Adapte
3917,598,2019,Sociologie,1,4,QCU,0.6016,0.29,0.65,67,60,40,20,1.12,66.67,40,27,60.16,Adapte,Adapte,Adapte / Adapte
4747,598,2020,Sociologie,1,4,QCU,0.6582,0.26,0.67,78,55,51,4,1.42,92.73,51,27,65.82,Adapte,Adapte,Adapte / Adapte
598,599,2015,Sociologie,1,5,QCM,0.8144,0.14,0.75,33,32,27,5,1.03,84.38,27,6,81.44,Facile,Facile,Facile / Facile
1428,599,2016,Sociologie,1,5,QCM,0.9291,0.01,0.83,37,36,34,2,1.03,94.44,34,3,92.91,Trop Facile,Trop Facile,Trop Facile / Trop Facile
2258,599,2017,Sociologie,1,5,QCM,0.9432,0.02,0.82,35,35,33,2,1.0,94.29,33,2,94.32,Trop Facile,Trop Facile,Trop Facile / Trop Facile
3088,599,2018,Sociologie,1,5,QCM,0.9311,0.06,0.98,29,28,27,1,1.04,96.43,27,2,93.11,Trop Facile,Trop Facile,Trop Facile / Trop Facile
3918,599,2019,Sociologie,1,5,QCM,0.4991,0.13,0.31,29,15,14,1,1.93,93.33,14,15,49.91,Trop Facile,Difficile,Trop Facile / Difficile
4748,599,2020,Sociologie,1,5,QCM,0.7342,0.08,0.59,35,31,26,5,1.13,83.87,26,9,73.42,Trop Facile,Adapte,Trop Facile / Adapte
599,600,2015,Sociologie,1,6,QCU,0.8439,0.03,0.9,51,46,43,3,1.11,93.48,43,8,84.39,Adapte,Facile,Adapte / Facile
1429,600,2016,Sociologie,1,6,QCU,0.8639,0.09,0.97,53,53,46,7,1.0,86.79,46,7,86.39,Trop Facile,Trop Facile,Trop Facile / Trop Facile
2259,600,2017,Sociologie,1,6,QCU,0.951,0.05,0.95,44,44,42,2,1.0,95.45,42,2,95.1,Trop Facile,Trop Facile,Trop Facile / Trop Facile
3089,600,2018,Sociologie,1,6,QCU,0.0152,0.32,0.21,48,39,1,38,1.23,2.56,1,47,1.52,Trop Facile,Trop Difficile,Trop Facile / Trop Difficile
3919,600,2019,Sociologie,1,6,QCU,0.8752,0.09,0.94,43,42,38,4,1.02,90.48,38,5,87.52,Trop Facile,Trop Facile,Trop Facile / Trop Facile
4749,600,2020,Sociologie,1,6,QCU,0.8824,0.01,1.0,38,34,34,0,1.12,100.0,34,4,88.24,Trop Facile,Trop Facile,Trop Facile / Trop Facile
600,601,2015,Sociologie,1,7,QCM,0.5625,0.27,0.38,45,31,25,6,1.45,80.65,25,20,56.25,Difficile,Difficile,Difficile / Difficile
1430,601,2016,Sociologie,1,7,QCM,0.0711,0.63,0.21,39,36,3,33,1.08,8.33,3,36,7.11,Trop Facile,Trop Difficile,Trop Facile / Trop Difficile
2260,601,2017,Sociologie,1,7,QCM,0.9454,0.02,0.9,33,32,31,1,1.03,96.88,31,2,94.54,Trop Facile,Trop Facile,Trop Facile / Trop Facile
3090,601,2018,Sociologie,1,7,QCM,0.9205,0.09,0.88,27,26,25,1,1.04,96.15,25,2,92.05,Trop Facile,Trop Facile,Trop Facile / Trop Facile
3920,601,2019,Sociologie,1,7,QCM,0.9372,0.05,0.91,29,27,27,0,1.07,100.0,27,2,93.72,Trop Facile,Trop Facile,Trop Facile / Trop Facile
4750,601,2020,Sociologie,1,7,QCM,0.8736,0.1,0.96,29,25,25,0,1.16,100.0,25,4,87.36,Trop Facile,Trop Facile,Trop Facile / Trop Facile
601,602,2015,Sociologie,1,8,QROC,0.7045,0.37,0.26,93,81,66,15,1.15,81.48,66,27,70.45,Trop Difficile,Adapte,Trop Difficile / Adapte
1431,602,2016,Sociologie,1,8,QROC,0.6344,0.2,0.29,85,78,54,24,1.09,69.23,54,31,63.44,Adapte,Adapte,Adapte / Adapte
2261,602,2017,Sociologie,1,8,QROC,0.6353,0.48,0.33,84,54,53,1,1.56,98.15,53,31,63.53,Adapte,Adapte,Adapte / Adapte
3091,602,2018,Sociologie,1,8,QROC,0.7044,0.25,0.34,99,86,70,16,1.15,81.4,70,29,70.44,Adapte,Adapte,Adapte / Adapte
3921,602,2019,Sociologie,1,8,QROC,0.634,0.39,0.37,83,78,53,25,1.06,67.95,53,30,63.4,Adapte,Adapte,Adapte / Adapte
4751,602,2020,Sociologie,1,8,QROC,0.623,0.33,0.34,100,87,62,25,1.15,71.26,62,38,62.3,Adapte,Adapte,Adapte / Adapte
602,603,2015,Sociologie,1,9,QCM,0.7057,0.16,0.51,33,25,23,2,1.32,92.0,23,10,70.57,Facile,Adapte,Facile / Adapte
1432,603,2016,Sociologie,1,9,QCM,0.7311,0.29,0.53,37,34,27,7,1.09,79.41,27,10,73.11,Adapte,Adapte,Adapte / Adapte
2262,603,2017,Sociologie,1,9,QCM,0.6937,0.06,0.5,32,31,22,9,1.03,70.97,22,10,69.37,Adapte,Adapte,Adapte / Adapte
3092,603,2018,Sociologie,1,9,QCM,0.7226,0.22,0.52,36,36,26,10,1.0,72.22,26,10,72.26,Adapte,Adapte,Adapte / Adapte
3922,603,2019,Sociologie,1,9,QCM,0.747,0.19,0.62,31,27,23,4,1.15,85.19,23,8,74.7,Adapte,Adapte,Adapte / Adapte
4752,603,2020,Sociologie,1,9,QCM,0.6643,0.2,0.4,30,26,20,6,1.15,76.92,20,10,66.43,Adapte,Adapte,Adapte / Adapte
603,604,2015,Sociologie,2,1,QCM,0.8075,0.09,0.73,33,27,27,0,1.22,100.0,27,6,80.75,Trop Difficile,Facile,Trop Difficile / Facile
1433,604,2016,Sociologie,2,1,QCM,0.8494,0.01,0.76,33,32,28,4,1.03,87.5,28,5,84.94,Trop Facile,Facile,Trop Facile / Facile
2263,604,2017,Sociologie,2,1,QCM,0.9982,0.03,0.83,37,37,37,0,1.0,100.0,37,0,99.82,Trop Facile,Trop Facile,Trop Facile / Trop Facile
3093,604,2018,Sociologie,2,1,QCM,0.9414,0.06,0.81,42,40,40,0,1.05,100.0,40,2,94.14,Trop Facile,Trop Facile,Trop Facile / Trop Facile
3923,604,2019,Sociologie,2,1,QCM,0.8788,0.02,0.85,48,46,42,4,1.04,91.3,42,6,87.88,Trop Facile,Trop Facile,Trop Facile / Trop Facile
4753,604,2020,Sociologie,2,1,QCM,0.946,0.02,0.95,57,54,54,0,1.06,100.0,54,3,94.6,Trop Facile,Trop Facile,Trop Facile / Trop Facile
604,605,2015,Sociologie,2,2,QROC,0.6292,0.48,0.28,46,33,29,4,1.39,87.88,29,17,62.92,Adapte,Adapte,Adapte / Adapte
1434,605,2016,Sociologie,2,2,QROC,0.6143,0.36,0.35,38,26,23,3,1.46,88.46,23,15,61.43,Adapte,Adapte,Adapte / Adapte
2264,605,2017,Sociologie,2,2,QROC,0.6684,0.36,0.32,45,32,30,2,1.41,93.75,30,15,66.84,Adapte,Adapte,Adapte / Adapte
3094,605,2018,Sociologie,2,2,QROC,0.6433,0.34,0.32,48,35,31,4,1.37,88.57,31,17,64.33,Adapte,Adapte,Adapte / Adapte
3924,605,2019,Sociologie,2,2,QROC,0.6851,0.29,0.35,47,40,32,8,1.18,80.0,32,15,68.51,Adapte,Adapte,Adapte / Adapte
4754,605,2020,Sociologie,2,2,QROC,0.7472,0.3,0.39,43,38,32,6,1.13,84.21,32,11,74.72,Adapte,Adapte,Adapte / Adapte
605,606,2015,Sociologie,2,3,QCU,0.0059,0.03,0.29,70,26,0,26,2.69,0.0,0,70,0.59,Trop Difficile,Trop Difficile,Trop Difficile / Trop Difficile
1435,606,2016,Sociologie,2,3,QCU,0.8705,0.0,0.92,72,66,63,3,1.09,95.45,63,9,87.05,Trop Facile,Trop Facile,Trop Facile / Trop Facile
2265,606,2017,Sociologie,2,3,QCU,0.0612,0.3,0.28,75,72,5,67,1.04,6.94,5,70,6.12,Trop Facile,Trop Difficile,Trop Facile / Trop Difficile
3095,606,2018,Sociologie,2,3,QCU,0.8666,0.08,0.98,89,79,77,2,1.13,97.47,77,12,86.66,Trop Facile,Trop Facile,Trop Facile / Trop Facile
3925,606,2019,Sociologie,2,3,QCU,0.955,0.01,0.98,92,89,88,1,1.03,98.88,88,4,95.5,Trop Facile,Trop Facile,Trop Facile / Trop Facile
4755,606,2020,Sociologie,2,3,QCU,0.726,0.09,0.48,80,78,58,20,1.03,74.36,58,22,72.6,Trop Facile,Adapte,Trop Facile / Adapte
606,607,2015,Sociologie,2,4,QO,0.1762,0.99,0.07,100,51,18,33,1.96,35.29,18,82,17.62,Trop Difficile,Trop Difficile,Trop Difficile / Trop Difficile
1436,607,2016,Sociologie,2,4,QO,0.9498,0.0,0.92,120,119,114,5,1.01,95.8,114,6,94.98,Trop Facile,Trop Facile,Trop Facile / Trop Facile
2266,607,2017,Sociologie,2,4,QO,0.9574,0.06,0.5,111,110,106,4,1.01,96.36,106,5,95.74,Trop Facile,Trop Facile,Trop Facile / Trop Facile
3096,607,2018,Sociologie,2,4,QO,0.9715,0.08,0.58,95,93,92,1,1.02,98.92,92,3,97.15,Trop Facile,Trop Facile,Trop Facile / Trop Facile
3926,607,2019,Sociologie,2,4,QO,0.7036,0.52,0.29,105,103,74,29,1.02,71.84,74,31,70.36,Trop Facile,Adapte,Trop Facile / Adapte
4756,607,2020,Sociologie,2,4,QO,0.6548,0.64,0.3,118,92,77,15,1.28,83.7,77,41,65.48,Adapte,Adapte,Adapte / Adapte
607,608,2015,Sociologie,2,5,QCM,0.3378,0.3,0.32,58,36,20,16,1.61,55.56,20,38,33.78,Trop Facile,Difficile,Trop Facile / Difficile
1437,608,2016,Sociologie,2,5,QCM,0.2026,0.55,0.28,46,40,9,31,1.15,22.5,9,37,20.26,Trop Facile,Trop Difficile,Trop Facile / Trop Difficile
2267,608,2017,Sociologie,2,5,QCM,0.8328,0.12,0.73,52,44,43,1,1.18,97.73,43,9,83.28,Trop Facile,Facile,Trop Facile / Facile
3097,608,2018,Sociologie,2,5,QCM,0.9729,0.04,0.99,59,59,57,2,1.0,96.61,57,2,97.29,Trop Facile,Trop Facile,Trop Facile / Trop Facile
3927,608,2019,Sociologie,2,5,QCM,0.9321,0.05,0.92,64,63,60,3,1.02,95.24,60,4,93.21,Trop Facile,Trop Facile,Trop Facile / Trop Facile
4757,608,2020,Sociologie,2,5,QCM,0.2399,0.69,0.21,68,43,16,27,1.58,37.21,16,52,23.99,Trop Facile,Trop Difficile,Trop Facile / Trop Difficile
608,609,2015,Sociologie,2,6,QCU,0.785,0.04,0.82,72,66,57,9,1.09,86.36,57,15,78.5,Facile,Facile,Facile / Facile
1438,609,2016,Sociologie,2,6,QCU,0.8356,0.08,0.77,86,81,72,9,1.06,88.89,72,14,83.56,Trop Facile,Facile,Trop Facile / Facile
2268,609,2017,Sociologie,2,6,QCU,0.9324,0.05,0.91,88,84,82,2,1.05,97.62,82,6,93.24,Trop Facile,Trop Facile,Trop Facile / Trop Facile
3098,609,2018,Sociologie,2,6,QCU,0.8698,0.06,0.92,78,73,68,5,1.07,93.15,68,10,86.98,Trop Facile,Trop Facile,Trop Facile / Trop Facile
3928,609,2019,Sociologie,2,6,QCU,0.0788,0.5,0.22,72,36,6,30,2.0,16.67,6,66,7.88,Trop Facile,Trop Difficile,Trop Facile / Trop Difficile
4758,609,2020,Sociologie,2,6,QCU,0.9431,0.04,0.94,69,67,65,2,1.03,97.01,65,4,94.31,Trop Facile,Trop Facile,Trop Facile / Trop Facile
609,610,2015,Sociologie,2,7,QCM,0.3914,0.31,0.4,71,71,28,43,1.0,39.44,28,43,39.14,Difficile,Difficile,Difficile / Difficile
1439,610,2016,Sociologie,2,7,QCM,0.982,0.08,0.81,73,73,72,1,1.0,98.63,72,1,98.2,Trop Facile,Trop Facile,Trop Facile / Trop Facile
2269,610,2017,Sociologie,2,7,QCM,0.8928,0.03,0.88,80,77,71,6,1.04,92.21,71,9,89.28,Trop Facile,Trop Facile,Trop Facile / Trop Facile
3099,610,2018,Sociologie,2,7,QCM,0.7264,0.19,0.57,96,81,70,11,1.19,86.42,70,26,72.64,Trop Facile,Adapte,Trop Facile / Adapte
3929,610,2019,Sociologie,2,7,QCM,0.6924,0.08,0.66,78,66,54,12,1.18,81.82,54,24,69.24,Adapte,Adapte,Adapte / Adapte
4759,610,2020,Sociologie,2,7,QCM,0.7459,0.28,0.51,79,68,59,9,1.16,86.76,59,20,74.59,Adapte,Adapte,Adapte / Adapte
610,611,2015,Sociologie,2,8,QO,0.0055,0.98,0.02,51,33,0,33,1.55,0.0,0,51,0.55,Difficile,Trop Difficile,Difficile / Trop Difficile
1440,611,2016,Sociologie,2,8,QO,0.994,0.01,0.7,57,57,57,0,1.0,100.0,57,0,99.4,Trop Facile,Trop Facile,Trop Facile / Trop Facile
2270,611,2017,Sociologie,2,8,QO,0.9917,0.07,0.82,63,62,62,0,1.02,100.0,62,1,99.17,Trop Facile,Trop Facile,Trop Facile / Trop Facile
3100,611,2018,Sociologie,2,8,QO,0.9174,0.02,0.51,55,51,50,1,1.08,98.04,50,5,91.74,Trop Facile,Trop Facile,Trop Facile / Trop Facile
3930,611,2019,Sociologie,2,8,QO,0.9335,0.02,0.73,66,65,62,3,1.02,95.38,62,4,93.35,Trop Facile,Trop Facile,Trop Facile / Trop Facile
4760,611,2020,Sociologie,2,8,QO,0.9333,0.02,0.98,66,64,62,2,1.03,96.88,62,4,93.33,Trop Facile,Trop Facile,Trop Facile / Trop Facile
611,612,2015,Sociologie,3,1,QCM,0.949,0.09,0.98,57,56,54,2,1.02,96.43,54,3,94.9,Trop Facile,Trop Facile,Trop Facile / Trop Facile
1441,612,2016,Sociologie,3,1,QCM,0.866,0.1,0.93,66,64,57,7,1.03,89.06,57,9,86.6,Trop Facile,Trop Facile,Trop Facile / Trop Facile
2271,612,2017,Sociologie,3,1,QCM,0.8751,0.01,0.96,74,70,65,5,1.06,92.86,65,9,87.51,Trop Facile,Trop Facile,Trop Facile / Trop Facile
3101,612,2018,Sociologie,3,1,QCM,0.9599,0.06,0.98,75,72,72,0,1.04,100.0,72,3,95.99,Trop Facile,Trop Facile,Trop Facile / Trop Facile
3931,612,2019,Sociologie,3,1,QCM,0.9202,0.04,0.96,84,79,77,2,1.06,97.47,77,7,92.02,Trop Facile,Trop Facile,Trop Facile / Trop Facile
4761,612,2020,Sociologie,3,1,QCM,0.9018,0.03,0.87,81,74,73,1,1.09,98.65,73,8,90.18,Trop Facile,Trop Facile,Trop Facile / Trop Facile
612,613,2015,Sociologie,3,2,QROC,0.9962,0.03,1.0,18,18,18,0,1.0,100.0,18,0,99.62,Trop Difficile,Trop Facile,Trop Difficile / Trop Facile
1442,613,2016,Sociologie,3,2,QROC,0.9716,0.07,0.51,21,20,20,0,1.05,100.0,20,1,97.16,Trop Facile,Trop Facile,Trop Facile / Trop Facile
2272,613,2017,Sociologie,3,2,QROC,0.7124,0.46,0.26,20,17,14,3,1.18,82.35,14,6,71.24,Trop Facile,Adapte,Trop Facile / Adapte
3102,613,2018,Sociologie,3,2,QROC,0.7018,0.49,0.29,24,22,17,5,1.09,77.27,17,7,70.18,Adapte,Adapte,Adapte / Adapte
3932,613,2019,Sociologie,3,2,QROC,0.7118,0.27,0.38,22,17,16,1,1.29,94.12,16,6,71.18,Adapte,Adapte,Adapte / Adapte
4762,613,2020,Sociologie,3,2,QROC,0.697,0.36,0.27,20,20,14,6,1.0,70.0,14,6,69.7,Adapte,Adapte,Adapte / Adapte
613,614,2015,Sociologie,3,3,QCU,0.4438,0.23,0.33,36,25,16,9,1.44,64.0,16,20,44.38,Difficile,Difficile,Difficile / Difficile
1443,614,2016,Sociologie,3,3,QCU,0.8987,0.04,0.97,37,36,33,3,1.03,91.67,33,4,89.87,Trop Facile,Trop Facile,Trop Facile / Trop Facile
2273,614,2017,Sociologie,3,3,QCU,0.0426,0.66,0.28,43,26,2,24,1.65,7.69,2,41,4.26,Trop Facile,Trop Difficile,Trop Facile / Trop Difficile
3103,614,2018,Sociologie,3,3,QCU,0.7959,0.07,0.84,36,30,29,1,1.2,96.67,29,7,79.59,Trop Facile,Facile,Trop Facile / Facile
3933,614,2019,Sociologie,3,3,QCU,0.9796,0.07,0.91,31,30,30,0,1.03,100.0,30,1,97.96,Trop Facile,Trop Facile,Trop Facile / Trop Facile
4763,614,2020,Sociologie,3,3,QCU,0.9324,0.01,0.91,36,34,34,0,1.06,100.0,34,2,93.24,Trop Facile,Trop Facile,Trop Facile / Trop Facile
614,615,2015,Sociologie,3,4,QO,0.4612,0.84,0.09,36,27,17,10,1.33,62.96,17,19,46.12,Difficile,Difficile,Difficile / Difficile
1444,615,2016,Sociologie,3,4,QO,0.9416,0.06,0.72,38,37,36,1,1.03,97.3,36,2,94.16,Trop Facile,Trop Facile,Trop Facile / Trop Facile
2274,615,2017,Sociologie,3,4,QO,0.6118,0.6,0.24,40,31,24,7,1.29,77.42,24,16,61.18,Trop Facile,Adapte,Trop Facile / Adapte
3104,615,2018,Sociologie,3,4,QO,0.7239,0.46,0.22,43,41,31,10,1.05,75.61,31,12,72.39,Adapte,Adapte,Adapte / Adapte
3934,615,2019,Sociologie,3,4,QO,0.7207,0.59,0.21,48,48,35,13,1.0,72.92,35,13,72.07,Adapte,Adapte,Adapte / Adapte
4764,615,2020,Sociologie,3,4,QO,0.7126,0.34,0.3,41,31,29,2,1.32,93.55,29,12,71.26,Adapte,Adapte,Adapte / Adapte
615,616,2015,Sociologie,3,5,QCU,0.8392,0.1,0.77,88,82,74,8,1.07,90.24,74,14,83.92,Trop Facile,Facile,Trop Facile / Facile
1445,616,2016,Sociologie,3,5,QCU,0.6892,0.16,0.56,98,83,68,15,1.18,81.93,68,30,68.92,Trop Facile,Adapte,Trop Facile / Adapte
2275,616,2017,Sociologie,3,5,QCU,0.7138,0.24,0.57,103,101,74,27,1.02,73.27,74,29,71.38,Adapte,Adapte,Adapte / Adapte
3105,616,2018,Sociologie,3,5,QCU,0.6088,0.06,0.5,82,71,50,21,1.15,70.42,50,32,60.88,Adapte,Adapte,Adapte / Adapte
3935,616,2019,Sociologie,3,5,QCU,0.628,0.02,0.49,85,75,53,22,1.13,70.67,53,32,62.8,Adapte,Adapte,Adapte / Adapte
4765,616,2020,Sociologie,3,5,QCU,0.7115,0.29,0.68,94,67,67,0,1.4,100.0,67,27,71.15,Adapte,Adapte,Adapte / Adapte
616,617,2015,Sociologie,4,1,QCM,0.56,0.12,0.33,41,34,23,11,1.21,67.65,23,18,56.0,Difficile,Difficile,Difficile / Difficile
1446,617,2016,Sociologie,4,1,QCM,0.906,0.06,0.98,35,33,32,1,1.06,96.97,32,3,90.6,Trop Facile,Trop Facile,Trop Facile / Trop Facile
2276,617,2017,Sociologie,4,1,QCM,0.2217,0.67,0.26,30,13,7,6,2.31,53.85,7,23,22.17,Trop Facile,Trop Difficile,Trop Facile / Trop Difficile
3106,617,2018,Sociologie,4,1,QCM,0.2373,0.05,0.29,34,15,8,7,2.27,53.33,8,26,23.73,Trop Facile,Trop Difficile,Trop Facile / Trop Difficile
3936,617,2019,Sociologie,4,1,QCM,0.9517,0.06,0.9,41,39,39,0,1.05,100.0,39,2,95.17,Trop Facile,Trop Facile,Trop Facile / Trop Facile
4766,617,2020,Sociologie,4,1,QCM,0.9703,0.02,0.94,38,38,37,1,1.0,97.37,37,1,97.03,Trop Facile,Trop Facile,Trop Facile / Trop Facile
617,618,2015,Sociologie,4,2,QO,0.8261,0.04,0.4,22,20,18,2,1.1,90.0,18,4,82.61,Facile,Facile,Facile / Facile
1447,618,2016,Sociologie,4,2,QO,0.8911,0.08,0.78,19,18,17,1,1.06,94.44,17,2,89.11,Trop Facile,Trop Facile,Trop Facile / Trop Facile
2277,618,2017,Sociologie,4,2,QO,0.9138,0.04,0.96,23,21,21,0,1.1,100.0,21,2,91.38,Trop Facile,Trop Facile,Trop Facile / Trop Facile
3107,618,2018,Sociologie,4,2,QO,0.8621,0.09,0.54,18,17,16,1,1.06,94.12,16,2,86.21,Trop Facile,Trop Facile,Trop Facile / Trop Facile
3937,618,2019,Sociologie,4,2,QO,0.963,0.01,0.84,15,15,14,1,1.0,93.33,14,1,96.3,Trop Facile,Trop Facile,Trop Facile / Trop Facile
4767,618,2020,Sociologie,4,2,QO,0.9997,0.09,1.0,12,12,12,0,1.0,100.0,12,0,99.97,Trop Facile,Trop Facile,Trop Facile / Trop Facile
618,619,2015,Sociologie,4,3,QCU,0.2012,0.63,0.3,66,22,13,9,3.0,59.09,13,53,20.12,Facile,Trop Difficile,Facile / Trop Difficile
1448,619,2016,Sociologie,4,3,QCU,0.8976,0.05,0.9,53,50,48,2,1.06,96.0,48,5,89.76,Trop Facile,Trop Facile,Trop Facile / Trop Facile
2278,619,2017,Sociologie,4,3,QCU,0.9273,0.02,0.97,58,55,54,1,1.05,98.18,54,4,92.73,Trop Facile,Trop Facile,Trop Facile / Trop Facile
3108,619,2018,Sociologie,4,3,QCU,0.9498,0.01,0.97,58,55,55,0,1.05,100.0,55,3,94.98,Trop Facile,Trop Facile,Trop Facile / Trop Facile
3938,619,2019,Sociologie,4,3,QCU,0.2283,0.72,0.29,70,34,16,18,2.06,47.06,16,54,22.83,Trop Facile,Trop Difficile,Trop Facile / Trop Difficile
4768,619,2020,Sociologie,4,3,QCU,0.9984,0.03,0.97,82,82,82,0,1.0,100.0,82,0,99.84,Trop Facile,Trop Facile,Trop Facile / Trop Facile
619,620,2015,Sociologie,4,4,QCU,0.146,0.68,0.22,72,51,11,40,1.41,21.57,11,61,14.6,Difficile,Trop Difficile,Difficile / Trop Difficile
1449,620,2016,Sociologie,4,4,QCU,0.925,0.01,0.91,64,60,59,1,1.07,98.33,59,5,92.5,Trop Facile,Trop Facile,Trop Facile / Trop Facile
2279,620,2017,Sociologie,4,4,QCU,0.9166,0.04,1.0,57,53,52,1,1.08,98.11,52,5,91.66,Trop Facile,Trop Facile,Trop Facile / Trop Facile
3109,620,2018,Sociologie,4,4,QCU,0.4545,0.14,0.36,65,62,30,32,1.05,48.39,30,35,45.45,Trop Facile,Difficile,Trop Facile / Difficile
3939,620,2019,Sociologie,4,4,QCU,0.9777,0.01,0.99,69,67,67,0,1.03,100.0,67,2,97.77,Trop Facile,Trop Facile,Trop Facile / Trop Facile
4769,620,2020,Sociologie,4,4,QCU,0.3164,0.07,0.33,68,55,22,33,1.24,40.0,22,46,31.64,Trop Facile,Difficile,Trop Facile / Difficile
620,621,2015,Sociologie,4,5,QROC,0.8411,0.1,0.52,61,59,51,8,1.03,86.44,51,10,84.11,Facile,Facile,Facile / Facile
1450,621,2016,Sociologie,4,5,QROC,0.891,0.03,0.98,59,56,53,3,1.05,94.64,53,6,89.1,Trop Facile,Trop Facile,Trop Facile / Trop Facile
2280,621,2017,Sociologie,4,5,QROC,0.9573,0.04,0.51,61,60,58,2,1.02,96.67,58,3,95.73,Trop Facile,Trop Facile,Trop Facile / Trop Facile
3110,621,2018,Sociologie,4,5,QROC,0.9531,0.08,0.61,65,64,62,2,1.02,96.88,62,3,95.31,Trop Facile,Trop Facile,Trop Facile / Trop Facile
3940,621,2019,Sociologie,4,5,QROC,0.8714,0.03,0.96,69,67,60,7,1.03,89.55,60,9,87.14,Trop Facile,Trop Facile,Trop Facile / Trop Facile
4770,621,2020,Sociologie,4,5,QROC,0.9163,0.05,0.9,70,67,64,3,1.04,95.52,64,6,91.63,Trop Facile,Trop Facile,Trop Facile / Trop Facile
621,622,2015,Sociologie,4,6,QCM,0.8215,0.11,0.78,99,85,81,4,1.16,95.29,81,18,82.15,Facile,Facile,Facile / Facile
1451,622,2016,Sociologie,4,6,QCM,0.8967,0.03,0.95,101,95,91,4,1.06,95.79,91,10,89.67,Trop Facile,Trop Facile,Trop Facile / Trop Facile
2281,622,2017,Sociologie,4,6,QCM,0.1309,0.32,0.3,92,87,12,75,1.06,13.79,12,80,13.09,Trop Facile,Trop Difficile,Trop Facile / Trop Difficile
3111,622,2018,Sociologie,4,6,QCM,0.8733,0.0,0.88,87,80,76,4,1.09,95.0,76,11,87.33,Trop Facile,Trop Facile,Trop Facile / Trop Facile
3941,622,2019,Sociologie,4,6,QCM,0.9431,0.05,0.99,104,102,98,4,1.02,96.08,98,6,94.31,Trop Facile,Trop Facile,Trop Facile / Trop Facile
4771,622,2020,Sociologie,4,6,QCM,0.8982,0.08,0.94,98,90,88,2,1.09,97.78,88,10,89.82,Trop Facile,Trop Facile,Trop Facile / Trop Facile
622,623,2015,Sociologie,4,7,QCU,0.2515,0.4,0.4,33,32,8,24,1.03,25.0,8,25,25.15,Difficile,Difficile,Difficile / Difficile
1452,623,2016,Sociologie,4,7,QCU,0.9791,0.08,0.94,35,35,34,1,1.0,97.14,34,1,97.91,Trop Facile,Trop Facile,Trop Facile / Trop Facile
2282,623,2017,Sociologie,4,7,QCU,0.8883,0.09,0.96,41,40,36,4,1.02,90.0,36,5,88.83,Trop Facile,Trop Facile,Trop Facile / Trop Facile
3112,623,2018,Sociologie,4,7,QCU,0.8902,0.02,0.95,46,42,41,1,1.1,97.62,41,5,89.02,Trop Facile,Trop Facile,Trop Facile / Trop Facile
3942,623,2019,Sociologie,4,7,QCU,0.9094,0.09,0.99,46,42,42,0,1.1,100.0,42,4,90.94,Trop Facile,Trop Facile,Trop Facile / Trop Facile
4772,623,2020,Sociologie,4,7,QCU,0.9424,0.06,0.91,40,39,38,1,1.03,97.44,38,2,94.24,Trop Facile,Trop Facile,Trop Facile / Trop Facile
623,624,2015,Sociologie,4,8,QCU,0.6044,0.0,0.64,20,15,12,3,1.33,80.0,12,8,60.44,Difficile,Adapte,Difficile / Adapte
1453,624,2016,Sociologie,4,8,QCU,0.6296,0.12,0.66,17,12,11,1,1.42,91.67,11,6,62.96,Adapte,Adapte,Adapte / Adapte
2283,624,2017,Sociologie,4,8,QCU,0.7112,0.05,0.6,20,17,14,3,1.18,82.35,14,6,71.12,Adapte,Adapte,Adapte / Adapte
3113,624,2018,Sociologie,4,8,QCU,0.6511,0.0,0.53,19,18,12,6,1.06,66.67,12,7,65.11,Adapte,Adapte,Adapte / Adapte
3943,624,2019,Sociologie,4,8,QCU,0.6374,0.12,0.69,23,23,15,8,1.0,65.22,15,8,63.74,Adapte,Adapte,Adapte / Adapte
4773,624,2020,Sociologie,4,8,QCU,0.6803,0.0,0.57,19,15,13,2,1.27,86.67,13,6,68.03,Adapte,Adapte,Adapte / Adapte
624,625,2015,Sociologie,4,9,QCU,0.8658,0.07,0.96,19,16,16,0,1.19,100.0,16,3,86.58,Difficile,Trop Facile,Difficile / Trop Facile
1454,625,2016,Sociologie,4,9,QCU,0.631,0.15,0.44,22,17,14,3,1.29,82.35,14,8,63.1,Trop Facile,Adapte,Trop Facile / Adapte
2284,625,2017,Sociologie,4,9,QCU,0.6969,0.17,0.44,25,24,17,7,1.04,70.83,17,8,69.69,Adapte,Adapte,Adapte / Adapte
3114,625,2018,Sociologie,4,9,QCU,0.735,0.06,0.54,20,15,15,0,1.33,100.0,15,5,73.5,Adapte,Adapte,Adapte / Adapte
3944,625,2019,Sociologie,4,9,QCU,0.6364,0.14,0.53,23,19,15,4,1.21,78.95,15,8,63.64,Adapte,Adapte,Adapte / Adapte
4774,625,2020,Sociologie,4,9,QCU,0.708,0.0,0.53,21,19,15,4,1.11,78.95,15,6,70.8,Adapte,Adapte,Adapte / Adapte
625,626,2015,Sociologie,4,10,QCM,0.2747,0.02,0.37,50,24,14,10,2.08,58.33,14,36,27.47,Difficile,Difficile,Difficile / Difficile
1455,626,2016,Sociologie,4,10,QCM,0.9102,0.07,1.0,46,45,42,3,1.02,93.33,42,4,91.02,Trop Facile,Trop Facile,Trop Facile / Trop Facile
2285,626,2017,Sociologie,4,10,QCM,0.8101,0.07,0.75,54,45,44,1,1.2,97.78,44,10,81.01,Trop Facile,Facile,Trop Facile / Facile
3115,626,2018,Sociologie,4,10,QCM,0.9017,0.01,0.99,55,52,50,2,1.06,96.15,50,5,90.17,Trop Facile,Trop Facile,Trop Facile / Trop Facile
3945,626,2019,Sociologie,4,10,QCM,0.9055,0.04,0.96,63,58,57,1,1.09,98.28,57,6,90.55,Trop Facile,Trop Facile,Trop Facile / Trop Facile
4775,626,2020,Sociologie,4,10,QCM,0.9046,0.09,0.8,52,52,47,5,1.0,90.38,47,5,90.46,Trop Facile,Trop Facile,Trop Facile / Trop Facile
626,627,2015,Sociologie,4,11,QO,0.2191,0.92,0.06,52,49,11,38,1.06,22.45,11,41,21.91,Trop Difficile,Trop Difficile,Trop Difficile / Trop Difficile
1456,627,2016,Sociologie,4,11,QO,0.944,0.07,0.52,52,52,49,3,1.0,94.23,49,3,94.4,Trop Facile,Trop Facile,Trop Facile / Trop Facile
2286,627,2017,Sociologie,4,11,QO,0.906,0.04,0.64,46,44,42,2,1.05,95.45,42,4,90.6,Trop Facile,Trop Facile,Trop Facile / Trop Facile
3116,627,2018,Sociologie,4,11,QO,0.9452,0.1,0.9,51,51,48,3,1.0,94.12,48,3,94.52,Trop Facile,Trop Facile,Trop Facile / Trop Facile
3946,627,2019,Sociologie,4,11,QO,0.9702,0.09,0.59,42,42,41,1,1.0,97.62,41,1,97.02,Trop Facile,Trop Facile,Trop Facile / Trop Facile
4776,627,2020,Sociologie,4,11,QO,0.8701,0.09,0.8,38,36,33,3,1.06,91.67,33,5,87.01,Trop Facile,Trop Facile,Trop Facile / Trop Facile
627,628,2015,Sociologie,5,1,QCM,0.5648,0.43,0.35,89,69,50,19,1.29,72.46,50,39,56.48,Facile,Difficile,Facile / Difficile
1457,628,2016,Sociologie,5,1,QCM,0.9417,0.03,0.86,86,86,81,5,1.0,94.19,81,5,94.17,Trop Facile,Trop Facile,Trop Facile / Trop Facile
2287,628,2017,Sociologie,5,1,QCM,0.8879,0.02,0.86,80,78,71,7,1.03,91.03,71,9,88.79,Trop Facile,Trop Facile,Trop Facile / Trop Facile
3117,628,2018,Sociologie,5,1,QCM,0.9547,0.1,0.89,70,67,67,0,1.04,100.0,67,3,95.47,Trop Facile,Trop Facile,Trop Facile / Trop Facile
3947,628,2019,Sociologie,5,1,QCM,0.8862,0.02,0.83,75,73,66,7,1.03,90.41,66,9,88.62,Trop Facile,Trop Facile,Trop Facile / Trop Facile
4777,628,2020,Sociologie,5,1,QCM,0.8771,0.04,0.84,61,55,54,1,1.11,98.18,54,7,87.71,Trop Facile,Trop Facile,Trop Facile / Trop Facile
628,629,2015,Sociologie,5,2,QCM,0.7856,0.0,0.8,11,11,9,2,1.0,81.82,9,2,78.56,Facile,Facile,Facile / Facile
1458,629,2016,Sociologie,5,2,QCM,0.9287,0.06,0.81,10,9,9,0,1.11,100.0,9,1,92.87,Trop Facile,Trop Facile,Trop Facile / Trop Facile
2288,629,2017,Sociologie,5,2,QCM,0.9108,0.04,0.93,8,8,7,1,1.0,87.5,7,1,91.08,Trop Facile,Trop Facile,Trop Facile / Trop Facile
3118,629,2018,Sociologie,5,2,QCM,0.873,0.09,0.91,6,6,5,1,1.0,83.33,5,1,87.3,Trop Facile,Trop Facile,Trop Facile / Trop Facile
3948,629,2019,Sociologie,5,2,QCM,0.8723,0.03,0.98,6,5,5,0,1.2,100.0,5,1,87.23,Trop Facile,Trop Facile,Trop Facile / Trop Facile
4778,629,2020,Sociologie,5,2,QCM,0.976,0.02,0.81,7,7,7,0,1.0,100.0,7,0,97.6,Trop Facile,Trop Facile,Trop Facile / Trop Facile
629,630,2015,Sociologie,5,3,QCU,0.8668,0.07,0.99,76,72,66,6,1.06,91.67,66,10,86.68,Trop Facile,Trop Facile,Trop Facile / Trop Facile
1459,630,2016,Sociologie,5,3,QCU,0.8262,0.01,0.9,85,76,70,6,1.12,92.11,70,15,82.62,Trop Facile,Facile,Trop Facile / Facile
2289,630,2017,Sociologie,5,3,QCU,0.8304,0.19,0.82,69,57,57,0,1.21,100.0,57,12,83.04,Trop Facile,Facile,Trop Facile / Facile
3119,630,2018,Sociologie,5,3,QCU,0.0592,0.24,0.27,69,30,4,26,2.3,13.33,4,65,5.92,Trop Facile,Trop Difficile,Trop Facile / Trop Difficile
3949,630,2019,Sociologie,5,3,QCU,0.9774,0.02,0.95,56,56,55,1,1.0,98.21,55,1,97.74,Trop Facile,Trop Facile,Trop Facile / Trop Facile
4779,630,2020,Sociologie,5,3,QCU,0.9218,0.01,0.95,59,54,54,0,1.09,100.0,54,5,92.18,Trop Facile,Trop Facile,Trop Facile / Trop Facile
630,631,2015,Sociologie,5,4,QCM,0.2648,0.44,0.32,35,29,9,20,1.21,31.03,9,26,26.48,Difficile,Difficile,Difficile / Difficile
1460,631,2016,Sociologie,5,4,QCM,0.9967,0.09,0.96,32,32,32,0,1.0,100.0,32,0,99.67,Trop Facile,Trop Facile,Trop Facile / Trop Facile
2290,631,2017,Sociologie,5,4,QCM,0.6879,0.1,0.47,30,24,21,3,1.25,87.5,21,9,68.79,Trop Facile,Adapte,Trop Facile / Adapte
3120,631,2018,Sociologie,5,4,QCM,0.7155,0.14,0.59,35,30,25,5,1.17,83.33,25,10,71.55,Adapte,Adapte,Adapte / Adapte
3950,631,2019,Sociologie,5,4,QCM,0.7332,0.3,0.46,37,28,27,1,1.32,96.43,27,10,73.32,Adapte,Adapte,Adapte / Adapte
4780,631,2020,Sociologie,5,4,QCM,0.6585,0.18,0.48,42,31,28,3,1.35,90.32,28,14,65.85,Adapte,Adapte,Adapte / Adapte
631,632,2015,Sociologie,6,1,QCM,0.7648,0.06,0.77,35,35,27,8,1.0,77.14,27,8,76.48,Facile,Facile,Facile / Facile
1461,632,2016,Sociologie,6,1,QCM,0.7882,0.08,0.76,33,32,26,6,1.03,81.25,26,7,78.82,Trop Facile,Facile,Trop Facile / Facile
2291,632,2017,Sociologie,6,1,QCM,0.5153,0.15,0.36,33,18,17,1,1.83,94.44,17,16,51.53,Trop Facile,Difficile,Trop Facile / Difficile
3121,632,2018,Sociologie,6,1,QCM,0.991,0.05,0.89,35,35,35,0,1.0,100.0,35,0,99.1,Trop Facile,Trop Facile,Trop Facile / Trop Facile
3951,632,2019,Sociologie,6,1,QCM,0.9566,0.09,0.89,37,36,35,1,1.03,97.22,35,2,95.66,Trop Facile,Trop Facile,Trop Facile / Trop Facile
4781,632,2020,Sociologie,6,1,QCM,0.4125,0.17,0.37,31,25,13,12,1.24,52.0,13,18,41.25,Trop Facile,Difficile,Trop Facile / Difficile
632,633,2015,Sociologie,6,2,QCM,0.0881,0.11,0.26,92,33,8,25,2.79,24.24,8,84,8.81,Trop Difficile,Trop Difficile,Trop Difficile / Trop Difficile
1462,633,2016,Sociologie,6,2,QCM,0.9964,0.04,0.91,107,107,107,0,1.0,100.0,107,0,99.64,Trop Facile,Trop Facile,Trop Facile / Trop Facile
2292,633,2017,Sociologie,6,2,QCM,0.9879,0.07,0.99,115,114,114,0,1.01,100.0,114,1,98.79,Trop Facile,Trop Facile,Trop Facile / Trop Facile
3122,633,2018,Sociologie,6,2,QCM,0.9515,0.06,0.91,130,124,124,0,1.05,100.0,124,6,95.15,Trop Facile,Trop Facile,Trop Facile / Trop Facile
3952,633,2019,Sociologie,6,2,QCM,0.2614,0.42,0.33,124,95,32,63,1.31,33.68,32,92,26.14,Trop Facile,Difficile,Trop Facile / Difficile
4782,633,2020,Sociologie,6,2,QCM,0.1579,0.46,0.21,146,130,23,107,1.12,17.69,23,123,15.79,Trop Facile,Trop Difficile,Trop Facile / Trop Difficile
633,634,2015,Sociologie,6,3,QCU,0.5454,0.25,0.33,78,51,43,8,1.53,84.31,43,35,54.54,Difficile,Difficile,Difficile / Difficile
1463,634,2016,Sociologie,6,3,QCU,0.8966,0.03,0.91,69,63,62,1,1.1,98.41,62,7,89.66,Trop Facile,Trop Facile,Trop Facile / Trop Facile
2293,634,2017,Sociologie,6,3,QCU,0.9908,0.08,0.91,58,58,57,1,1.0,98.28,57,1,99.08,Trop Facile,Trop Facile,Trop Facile / Trop Facile
3123,634,2018,Sociologie,6,3,QCU,0.9155,0.08,0.98,63,58,58,0,1.09,100.0,58,5,91.55,Trop Facile,Trop Facile,Trop Facile / Trop Facile
3953,634,2019,Sociologie,6,3,QCU,0.9217,0.09,0.91,51,49,47,2,1.04,95.92,47,4,92.17,Trop Facile,Trop Facile,Trop Facile / Trop Facile
4783,634,2020,Sociologie,6,3,QCU,0.8811,0.02,0.94,56,51,49,2,1.1,96.08,49,7,88.11,Trop Facile,Trop Facile,Trop Facile / Trop Facile
634,635,2015,Sociologie,6,4,QCU,0.5173,0.1,0.38,79,60,41,19,1.32,68.33,41,38,51.73,Difficile,Difficile,Difficile / Difficile
1464,635,2016,Sociologie,6,4,QCU,0.9777,0.01,0.91,63,62,62,0,1.02,100.0,62,1,97.77,Trop Facile,Trop Facile,Trop Facile / Trop Facile
2294,635,2017,Sociologie,6,4,QCU,0.8832,0.09,0.91,71,70,63,7,1.01,90.0,63,8,88.32,Trop Facile,Trop Facile,Trop Facile / Trop Facile
3124,635,2018,Sociologie,6,4,QCU,0.9872,0.08,0.96,68,68,67,1,1.0,98.53,67,1,98.72,Trop Facile,Trop Facile,Trop Facile / Trop Facile
3954,635,2019,Sociologie,6,4,QCU,0.9131,0.04,0.95,70,69,64,5,1.01,92.75,64,6,91.31,Trop Facile,Trop Facile,Trop Facile / Trop Facile
4784,635,2020,Sociologie,6,4,QCU,0.8644,0.08,0.94,61,59,53,6,1.03,89.83,53,8,86.44,Trop Facile,Trop Facile,Trop Facile / Trop Facile
635,636,2015,Sociologie,6,5,QCM,0.3775,0.49,0.36,67,40,25,15,1.68,62.5,25,42,37.75,Difficile,Difficile,Difficile / Difficile
1465,636,2016,Sociologie,6,5,QCM,0.8728,0.07,0.8,65,63,57,6,1.03,90.48,57,8,87.28,Trop Facile,Trop Facile,Trop Facile / Trop Facile
2295,636,2017,Sociologie,6,5,QCM,0.9225,0.04,0.92,67,65,62,3,1.03,95.38,62,5,92.25,Trop Facile,Trop Facile,Trop Facile / Trop Facile
3125,636,2018,Sociologie,6,5,QCM,0.6272,0.15,0.53,59,55,37,18,1.07,67.27,37,22,62.72,Trop Facile,Adapte,Trop Facile / Adapte
3955,636,2019,Sociologie,6,5,QCM,0.6907,0.03,0.44,59,59,41,18,1.0,69.49,41,18,69.07,Adapte,Adapte,Adapte / Adapte
4785,636,2020,Sociologie,6,5,QCM,0.7471,0.13,0.48,48,38,36,2,1.26,94.74,36,12,74.71,Adapte,Adapte,Adapte / Adapte
636,637,2015,Sociologie,6,6,QROC,0.9001,0.06,0.58,84,77,76,1,1.09,98.7,76,8,90.01,Difficile,Trop Facile,Difficile / Trop Facile
1466,637,2016,Sociologie,6,6,QROC,0.9056,0.07,0.67,69,68,62,6,1.01,91.18,62,7,90.56,Trop Facile,Trop Facile,Trop Facile / Trop Facile
2296,637,2017,Sociologie,6,6,QROC,0.187,0.78,0.06,79,67,15,52,1.18,22.39,15,64,18.7,Trop Facile,Trop Difficile,Trop Facile / Trop Difficile
3126,637,2018,Sociologie,6,6,QROC,0.9799,0.01,0.97,65,64,64,0,1.02,100.0,64,1,97.99,Trop Facile,Trop Facile,Trop Facile / Trop Facile
3956,637,2019,Sociologie,6,6,QROC,0.2972,0.63,0.22,76,66,23,43,1.15,34.85,23,53,29.72,Trop Facile,Difficile,Trop Facile / Difficile
4786,637,2020,Sociologie,6,6,QROC,0.8916,0.02,0.62,89,86,79,7,1.03,91.86,79,10,89.16,Trop Facile,Trop Facile,Trop Facile / Trop Facile
637,638,2015,Sociologie,6,7,QCM,0.0387,0.09,0.22,18,10,1,9,1.8,10.0,1,17,3.87,Difficile,Trop Difficile,Difficile / Trop Difficile
1467,638,2016,Sociologie,6,7,QCM,0.9577,0.03,0.85,16,16,15,1,1.0,93.75,15,1,95.77,Trop Facile,Trop Facile,Trop Facile / Trop Facile
2297,638,2017,Sociologie,6,7,QCM,0.9878,0.07,0.95,14,14,14,0,1.0,100.0,14,0,98.78,Trop Facile,Trop Facile,Trop Facile / Trop Facile
3127,638,2018,Sociologie,6,7,QCM,0.8942,0.04,0.82,17,15,15,0,1.13,100.0,15,2,89.42,Trop Facile,Trop Facile,Trop Facile / Trop Facile
3957,638,2019,Sociologie,6,7,QCM,0.8916,0.05,0.88,19,18,17,1,1.06,94.44,17,2,89.16,Trop Facile,Trop Facile,Trop Facile / Trop Facile
4787,638,2020,Sociologie,6,7,QCM,0.9087,0.01,0.88,17,16,15,1,1.06,93.75,15,2,90.87,Trop Facile,Trop Facile,Trop Facile / Trop Facile
638,639,2015,Sociologie,6,8,QCU,0.9279,0.09,1.0,56,54,52,2,1.04,96.3,52,4,92.79,Trop Facile,Trop Facile,Trop Facile / Trop Facile
1468,639,2016,Sociologie,6,8,QCU,0.9649,0.07,0.94,63,61,61,0,1.03,100.0,61,2,96.49,Trop Facile,Trop Facile,Trop Facile / Trop Facile
2298,639,2017,Sociologie,6,8,QCU,0.876,0.09,0.91,60,56,53,3,1.07,94.64,53,7,87.6,Trop Facile,Trop Facile,Trop Facile / Trop Facile
3128,639,2018,Sociologie,6,8,QCU,0.9148,0.04,0.97,64,63,59,4,1.02,93.65,59,5,91.48,Trop Facile,Trop Facile,Trop Facile / Trop Facile
3958,639,2019,Sociologie,6,8,QCU,0.8628,0.02,0.97,74,66,64,2,1.12,96.97,64,10,86.28,Trop Facile,Trop Facile,Trop Facile / Trop Facile
4788,639,2020,Sociologie,6,8,QCU,0.9518,0.05,0.9,65,65,62,3,1.0,95.38,62,3,95.18,Trop Facile,Trop Facile,Trop Facile / Trop Facile
639,640,2015,Sociologie,6,9,QCM,0.8496,0.13,0.75,54,53,46,7,1.02,86.79,46,8,84.96,Facile,Facile,Facile / Facile
1469,640,2016,Sociologie,6,9,QCM,0.8987,0.08,1.0,59,54,53,1,1.09,98.15,53,6,89.87,Trop Facile,Trop Facile,Trop Facile / Trop Facile
2299,640,2017,Sociologie,6,9,QCM,0.9616,0.1,0.99,66,65,63,2,1.02,96.92,63,3,96.16,Trop Facile,Trop Facile,Trop Facile / Trop Facile
3129,640,2018,Sociologie,6,9,QCM,0.4678,0.27,0.33,69,45,32,13,1.53,71.11,32,37,46.78,Trop Facile,Difficile,Trop Facile / Difficile
3959,640,2019,Sociologie,6,9,QCM,0.7153,0.27,0.53,73,55,52,3,1.33,94.55,52,21,71.53,Trop Facile,Adapte,Trop Facile / Adapte
4789,640,2020,Sociologie,6,9,QCM,0.6631,0.05,0.46,65,47,43,4,1.38,91.49,43,22,66.31,Adapte,Adapte,Adapte / Adapte
640,641,2015,Sociologie,6,10,QCM,0.8641,0.06,0.81,24,22,21,1,1.09,95.45,21,3,86.41,Trop Facile,Trop Facile,Trop Facile / Trop Facile
1470,641,2016,Sociologie,6,10,QCM,0.892,0.03,0.81,19,19,17,2,1.0,89.47,17,2,89.2,Trop Facile,Trop Facile,Trop Facile / Trop Facile
2300,641,2017,Sociologie,6,10,QCM,0.9101,0.01,0.82,21,20,19,1,1.05,95.0,19,2,91.01,Trop Facile,Trop Facile,Trop Facile / Trop Facile
3130,641,2018,Sociologie,6,10,QCM,0.9294,0.09,0.97,24,24,22,2,1.0,91.67,22,2,92.94,Trop Facile,Trop Facile,Trop Facile / Trop Facile
3960,641,2019,Sociologie,6,10,QCM,0.9889,0.05,0.98,19,19,19,0,1.0,100.0,19,0,98.89,Trop Facile,Trop Facile,Trop Facile / Trop Facile
4790,641,2020,Sociologie,6,10,QCM,0.7951,0.19,0.7,16,13,13,0,1.23,100.0,13,3,79.51,Trop Facile,Facile,Trop Facile / Facile
641,642,2015,Sociologie,6,11,QCU,0.8755,0.01,0.93,7,7,6,1,1.0,85.71,6,1,87.55,Trop Facile,Trop Facile,Trop Facile / Trop Facile
1471,642,2016,Sociologie,6,11,QCU,0.886,0.01,0.96,6,6,5,1,1.0,83.33,5,1,88.6,Trop Facile,Trop Facile,Trop Facile / Trop Facile
2301,642,2017,Sociologie,6,11,QCU,0.4009,0.35,0.36,5,4,2,2,1.25,50.0,2,3,40.09,Trop Facile,Difficile,Trop Facile / Difficile
3131,642,2018,Sociologie,6,11,QCU,0.8469,0.13,0.8,5,5,4,1,1.0,80.0,4,1,84.69,Trop Facile,Facile,Trop Facile / Facile
3961,642,2019,Sociologie,6,11,QCU,0.9233,0.07,0.92,5,5,5,0,1.0,100.0,5,0,92.33,Trop Facile,Trop Facile,Trop Facile / Trop Facile
4791,642,2020,Sociologie,6,11,QCU,0.4469,0.01,0.33,4,3,2,1,1.33,66.67,2,2,44.69,Trop Facile,Difficile,Trop Facile / Difficile
642,643,2015,Sociologie,6,12,QCU,0.464,0.03,0.36,37,23,17,6,1.61,73.91,17,20,46.4,Facile,Difficile,Facile / Difficile
1472,643,2016,Sociologie,6,12,QCU,0.0926,0.3,0.28,34,33,3,30,1.03,9.09,3,31,9.26,Trop Facile,Trop Difficile,Trop Facile / Trop Difficile
2302,643,2017,Sociologie,6,12,QCU,0.0009,0.18,0.27,29,19,0,19,1.53,0.0,0,29,0.09,Trop Facile,Trop Difficile,Trop Facile / Trop Difficile
3132,643,2018,Sociologie,6,12,QCU,0.8797,0.06,0.97,35,34,31,3,1.03,91.18,31,4,87.97,Trop Facile,Trop Facile,Trop Facile / Trop Facile
3962,643,2019,Sociologie,6,12,QCU,0.9699,0.08,0.95,35,34,34,0,1.03,100.0,34,1,96.99,Trop Facile,Trop Facile,Trop Facile / Trop Facile
4792,643,2020,Sociologie,6,12,QCU,0.8639,0.06,0.93,30,27,26,1,1.11,96.3,26,4,86.39,Trop Facile,Trop Facile,Trop Facile / Trop Facile
643,644,2015,Sociologie,6,13,QCM,0.6569,0.25,0.53,8,6,5,1,1.33,83.33,5,3,65.69,Adapte,Adapte,Adapte / Adapte
1473,644,2016,Sociologie,6,13,QCM,0.6716,0.27,0.61,7,6,5,1,1.17,83.33,5,2,67.16,Adapte,Adapte,Adapte / Adapte
2303,644,2017,Sociologie,6,13,QCM,0.7292,0.13,0.65,8,8,6,2,1.0,75.0,6,2,72.92,Adapte,Adapte,Adapte / Adapte
3133,644,2018,Sociologie,6,13,QCM,0.7225,0.23,0.48,10,8,7,1,1.25,87.5,7,3,72.25,Adapte,Adapte,Adapte / Adapte
3963,644,2019,Sociologie,6,13,QCM,0.6375,0.11,0.57,11,8,7,1,1.38,87.5,7,4,63.75,Adapte,Adapte,Adapte / Adapte
4793,644,2020,Sociologie,6,13,QCM,0.724,0.01,0.7,10,8,7,1,1.25,87.5,7,3,72.4,Adapte,Adapte,Adapte / Adapte
644,645,2015,Sociologie,7,1,QROC,0.8175,0.08,0.72,10,9,8,1,1.11,88.89,8,2,81.75,Facile,Facile,Facile / Facile
1474,645,2016,Sociologie,7,1,QROC,0.9672,0.05,0.64,9,9,9,0,1.0,100.0,9,0,96.72,Trop Facile,Trop Facile,Trop Facile / Trop Facile
2304,645,2017,Sociologie,7,1,QROC,0.895,0.07,0.95,7,6,6,0,1.17,100.0,6,1,89.5,Trop Facile,Trop Facile,Trop Facile / Trop Facile
3134,645,2018,Sociologie,7,1,QROC,0.1448,0.97,0.01,7,6,1,5,1.17,16.67,1,6,14.48,Trop Facile,Trop Difficile,Trop Facile / Trop Difficile
3964,645,2019,Sociologie,7,1,QROC,0.9275,0.1,0.84,7,7,6,1,1.0,85.71,6,1,92.75,Trop Facile,Trop Facile,Trop Facile / Trop Facile
4794,645,2020,Sociologie,7,1,QROC,0.841,0.09,0.54,6,5,5,0,1.2,100.0,5,1,84.1,Trop Facile,Facile,Trop Facile / Facile
645,646,2015,Sociologie,8,1,QCU,0.777,0.08,0.76,97,95,75,20,1.02,78.95,75,22,77.7,Difficile,Facile,Difficile / Facile
1475,646,2016,Sociologie,8,1,QCU,0.8174,0.13,0.89,105,95,86,9,1.11,90.53,86,19,81.74,Trop Facile,Facile,Trop Facile / Facile
2305,646,2017,Sociologie,8,1,QCU,0.917,0.03,0.94,111,103,102,1,1.08,99.03,102,9,91.7,Trop Facile,Trop Facile,Trop Facile / Trop Facile
3135,646,2018,Sociologie,8,1,QCU,0.0094,0.69,0.22,102,93,1,92,1.1,1.08,1,101,0.94,Trop Facile,Trop Difficile,Trop Facile / Trop Difficile
3965,646,2019,Sociologie,8,1,QCU,0.893,0.03,0.98,92,86,82,4,1.07,95.35,82,10,89.3,Trop Facile,Trop Facile,Trop Facile / Trop Facile
4795,646,2020,Sociologie,8,1,QCU,0.8985,0.06,1.0,93,88,84,4,1.06,95.45,84,9,89.85,Trop Facile,Trop Facile,Trop Facile / Trop Facile
646,647,2015,Sociologie,8,2,QCU,0.6223,0.04,0.52,9,8,6,2,1.12,75.0,6,3,62.23,Trop Facile,Adapte,Trop Facile / Adapte
1476,647,2016,Sociologie,8,2,QCU,0.7399,0.04,0.68,8,7,6,1,1.14,85.71,6,2,73.99,Adapte,Adapte,Adapte / Adapte
2306,647,2017,Sociologie,8,2,QCU,0.6311,0.04,0.69,8,5,5,0,1.6,100.0,5,3,63.11,Adapte,Adapte,Adapte / Adapte
3136,647,2018,Sociologie,8,2,QCU,0.7006,0.04,0.43,9,6,6,0,1.5,100.0,6,3,70.06,Adapte,Adapte,Adapte / Adapte
3966,647,2019,Sociologie,8,2,QCU,0.6761,0.21,0.63,7,5,5,0,1.4,100.0,5,2,67.61,Adapte,Adapte,Adapte / Adapte
4796,647,2020,Sociologie,8,2,QCU,0.6796,0.19,0.41,6,4,4,0,1.5,100.0,4,2,67.96,Adapte,Adapte,Adapte / Adapte
647,648,2015,Sociologie,8,3,QCM,0.7671,0.08,0.77,60,58,46,12,1.03,79.31,46,14,76.71,Facile,Facile,Facile / Facile
1477,648,2016,Sociologie,8,3,QCM,0.9695,0.08,0.81,55,55,53,2,1.0,96.36,53,2,96.95,Trop Facile,Trop Facile,Trop Facile / Trop Facile
2307,648,2017,Sociologie,8,3,QCM,0.0844,0.16,0.26,51,22,4,18,2.32,18.18,4,47,8.44,Trop Facile,Trop Difficile,Trop Facile / Trop Difficile
3137,648,2018,Sociologie,8,3,QCM,0.9359,0.05,0.82,56,56,52,4,1.0,92.86,52,4,93.59,Trop Facile,Trop Facile,Trop Facile / Trop Facile
3967,648,2019,Sociologie,8,3,QCM,0.9423,0.08,0.84,50,50,47,3,1.0,94.0,47,3,94.23,Trop Facile,Trop Facile,Trop Facile / Trop Facile
4797,648,2020,Sociologie,8,3,QCM,0.9694,0.04,0.91,44,44,43,1,1.0,97.73,43,1,96.94,Trop Facile,Trop Facile,Trop Facile / Trop Facile
648,649,2015,Sociologie,8,4,QCU,0.0319,0.71,0.22,6,4,0,4,1.5,0.0,0,6,3.19,Difficile,Trop Difficile,Difficile / Trop Difficile
1478,649,2016,Sociologie,8,4,QCU,0.7729,0.12,0.87,6,6,5,1,1.0,83.33,5,1,77.29,Trop Facile,Facile,Trop Facile / Facile
2308,649,2017,Sociologie,8,4,QCU,0.9226,0.04,0.95,6,6,6,0,1.0,100.0,6,0,92.26,Trop Facile,Trop Facile,Trop Facile / Trop Facile
3138,649,2018,Sociologie,8,4,QCU,0.202,0.74,0.22,5,4,1,3,1.25,25.0,1,4,20.2,Trop Facile,Trop Difficile,Trop Facile / Trop Difficile
3968,649,2019,Sociologie,8,4,QCU,0.9262,0.05,0.91,5,5,5,0,1.0,100.0,5,0,92.62,Trop Facile,Trop Facile,Trop Facile / Trop Facile
4798,649,2020,Sociologie,8,4,QCU,0.1404,0.33,0.26,5,2,1,1,2.5,50.0,1,4,14.04,Trop Facile,Trop Difficile,Trop Facile / Trop Difficile
649,650,2015,Sociologie,8,5,QCU,0.8135,0.19,0.77,52,48,42,6,1.08,87.5,42,10,81.35,Facile,Facile,Facile / Facile
1479,650,2016,Sociologie,8,5,QCU,0.8966,0.06,0.97,60,58,54,4,1.03,93.1,54,6,89.66,Trop Facile,Trop Facile,Trop Facile / Trop Facile
2309,650,2017,Sociologie,8,5,QCU,0.8374,0.04,0.79,55,52,46,6,1.06,88.46,46,9,83.74,Trop Facile,Facile,Trop Facile / Facile
3139,650,2018,Sociologie,8,5,QCU,0.8332,0.11,0.89,66,61,55,6,1.08,90.16,55,11,83.32,Trop Facile,Facile,Trop Facile / Facile
3969,650,2019,Sociologie,8,5,QCU,0.9461,0.09,0.93,62,62,59,3,1.0,95.16,59,3,94.61,Trop Facile,Trop Facile,Trop Facile / Trop Facile
4799,650,2020,Sociologie,8,5,QCU,0.1711,0.19,0.21,53,24,9,15,2.21,37.5,9,44,17.11,Trop Facile,Trop Difficile,Trop Facile / Trop Difficile
650,651,2015,Sociologie,9,1,QCM,0.1395,0.72,0.28,52,34,7,27,1.53,20.59,7,45,13.95,Difficile,Trop Difficile,Difficile / Trop Difficile
1480,651,2016,Sociologie,9,1,QCM,0.8817,0.02,0.82,44,41,39,2,1.07,95.12,39,5,88.17,Trop Facile,Trop Facile,Trop Facile / Trop Facile
2310,651,2017,Sociologie,9,1,QCM,0.8094,0.16,0.74,52,45,42,3,1.16,93.33,42,10,80.94,Trop Facile,Facile,Trop Facile / Facile
3140,651,2018,Sociologie,9,1,QCM,0.9215,0.06,0.89,57,57,53,4,1.0,92.98,53,4,92.15,Trop Facile,Trop Facile,Trop Facile / Trop Facile
3970,651,2019,Sociologie,9,1,QCM,0.8245,0.2,0.77,58,51,48,3,1.14,94.12,48,10,82.45,Trop Facile,Facile,Trop Facile / Facile
4800,651,2020,Sociologie,9,1,QCM,0.991,0.01,0.96,64,63,63,0,1.02,100.0,63,1,99.1,Trop Facile,Trop Facile,Trop Facile / Trop Facile
651,652,2015,Sociologie,9,2,QCM,0.4308,0.4,0.3,78,62,34,28,1.26,54.84,34,44,43.08,Trop Facile,Difficile,Trop Facile / Difficile
1481,652,2016,Sociologie,9,2,QCM,0.6905,0.04,0.49,85,73,59,14,1.16,80.82,59,26,69.05,Trop Facile,Adapte,Trop Facile / Adapte
2311,652,2017,Sociologie,9,2,QCM,0.6094,0.11,0.68,85,81,52,29,1.05,64.2,52,33,60.94,Adapte,Adapte,Adapte / Adapte
3141,652,2018,Sociologie,9,2,QCM,0.6919,0.28,0.64,87,78,60,18,1.12,76.92,60,27,69.19,Adapte,Adapte,Adapte / Adapte
3971,652,2019,Sociologie,9,2,QCM,0.7476,0.15,0.66,83,70,62,8,1.19,88.57,62,21,74.76,Adapte,Adapte,Adapte / Adapte
4801,652,2020,Sociologie,9,2,QCM,0.6101,0.23,0.6,91,75,56,19,1.21,74.67,56,35,61.01,Adapte,Adapte,Adapte / Adapte
652,653,2015,Sociologie,9,3,QCU,0.7609,0.11,0.89,78,67,59,8,1.16,88.06,59,19,76.09,Facile,Facile,Facile / Facile
1482,653,2016,Sociologie,9,3,QCU,0.9671,0.01,0.99,79,77,76,1,1.03,98.7,76,3,96.71,Trop Facile,Trop Facile,Trop Facile / Trop Facile
2312,653,2017,Sociologie,9,3,QCU,0.9902,0.06,0.94,81,81,80,1,1.0,98.77,80,1,99.02,Trop Facile,Trop Facile,Trop Facile / Trop Facile
3142,653,2018,Sociologie,9,3,QCU,0.9686,0.06,0.94,74,73,72,1,1.01,98.63,72,2,96.86,Trop Facile,Trop Facile,Trop Facile / Trop Facile
3972,653,2019,Sociologie,9,3,QCU,0.6903,0.01,0.51,69,54,48,6,1.28,88.89,48,21,69.03,Trop Facile,Adapte,Trop Facile / Adapte
4802,653,2020,Sociologie,9,3,QCU,0.7316,0.29,0.41,65,53,48,5,1.23,90.57,48,17,73.16,Adapte,Adapte,Adapte / Adapte
653,654,2015,Sociologie,9,4,QROC,0.5522,0.71,0.21,64,38,35,3,1.68,92.11,35,29,55.22,Facile,Difficile,Facile / Difficile
1483,654,2016,Sociologie,9,4,QROC,0.3661,0.74,0.19,68,34,25,9,2.0,73.53,25,43,36.61,Trop Facile,Difficile,Trop Facile / Difficile
2313,654,2017,Sociologie,9,4,QROC,0.1937,0.98,0.13,54,25,10,15,2.16,40.0,10,44,19.37,Trop Facile,Trop Difficile,Trop Facile / Trop Difficile
3143,654,2018,Sociologie,9,4,QROC,0.8824,0.1,0.74,64,64,56,8,1.0,87.5,56,8,88.24,Trop Facile,Trop Facile,Trop Facile / Trop Facile
3973,654,2019,Sociologie,9,4,QROC,0.9573,0.01,0.58,58,56,56,0,1.04,100.0,56,2,95.73,Trop Facile,Trop Facile,Trop Facile / Trop Facile
4803,654,2020,Sociologie,9,4,QROC,0.6206,0.36,0.36,60,56,37,19,1.07,66.07,37,23,62.06,Trop Facile,Adapte,Trop Facile / Adapte
654,655,2015,Sociologie,9,5,QCM,0.7223,0.18,0.46,65,55,47,8,1.18,85.45,47,18,72.23,Adapte,Adapte,Adapte / Adapte
1484,655,2016,Sociologie,9,5,QCM,0.6467,0.25,0.44,58,51,38,13,1.14,74.51,38,20,64.67,Adapte,Adapte,Adapte / Adapte
2314,655,2017,Sociologie,9,5,QCM,0.6603,0.26,0.68,51,48,34,14,1.06,70.83,34,17,66.03,Adapte,Adapte,Adapte / Adapte
3144,655,2018,Sociologie,9,5,QCM,0.6214,0.01,0.6,50,39,31,8,1.28,79.49,31,19,62.14,Adapte,Adapte,Adapte / Adapte
3974,655,2019,Sociologie,9,5,QCM,0.7254,0.15,0.5,58,43,42,1,1.35,97.67,42,16,72.54,Adapte,Adapte,Adapte / Adapte
4804,655,2020,Sociologie,9,5,QCM,0.685,0.16,0.49,46,45,32,13,1.02,71.11,32,14,68.5,Adapte,Adapte,Adapte / Adapte
655,656,2015,Sociologie,9,6,QCU,0.6939,0.01,0.66,30,29,21,8,1.03,72.41,21,9,69.39,Trop Facile,Adapte,Trop Facile / Adapte
1485,656,2016,Sociologie,9,6,QCU,0.7358,0.06,0.49,26,25,19,6,1.04,76.0,19,7,73.58,Adapte,Adapte,Adapte / Adapte
2315,656,2017,Sociologie,9,6,QCU,0.6373,0.21,0.5,29,28,18,10,1.04,64.29,18,11,63.73,Adapte,Adapte,Adapte / Adapte
3145,656,2018,Sociologie,9,6,QCU,0.7319,0.22,0.46,29,26,21,5,1.12,80.77,21,8,73.19,Adapte,Adapte,Adapte / Adapte
3975,656,2019,Sociologie,9,6,QCU,0.714,0.13,0.58,25,25,18,7,1.0,72.0,18,7,71.4,Adapte,Adapte,Adapte / Adapte
4805,656,2020,Sociologie,9,6,QCU,0.6652,0.16,0.6,27,25,18,7,1.08,72.0,18,9,66.52,Adapte,Adapte,Adapte / Adapte
656,657,2015,Sociologie,9,7,QROC,0.3614,0.53,0.23,37,17,13,4,2.18,76.47,13,24,36.14,Difficile,Difficile,Difficile / Difficile
1486,657,2016,Sociologie,9,7,QROC,0.4758,0.51,0.25,35,31,17,14,1.13,54.84,17,18,47.58,Trop Facile,Difficile,Trop Facile / Difficile
2316,657,2017,Sociologie,9,7,QROC,0.8613,0.01,0.6,31,30,27,3,1.03,90.0,27,4,86.13,Trop Facile,Trop Facile,Trop Facile / Trop Facile
3146,657,2018,Sociologie,9,7,QROC,0.8712,0.09,0.84,31,27,27,0,1.15,100.0,27,4,87.12,Trop Facile,Trop Facile,Trop Facile / Trop Facile
3976,657,2019,Sociologie,9,7,QROC,0.1804,0.93,0.03,36,28,6,22,1.29,21.43,6,30,18.04,Trop Facile,Trop Difficile,Trop Facile / Trop Difficile
4806,657,2020,Sociologie,9,7,QROC,0.882,0.01,0.82,35,33,31,2,1.06,93.94,31,4,88.2,Trop Facile,Trop Facile,Trop Facile / Trop Facile
657,658,2015,Sociologie,10,1,QROC,0.7609,0.09,0.45,79,76,60,16,1.04,78.95,60,19,76.09,Facile,Facile,Facile / Facile
1487,658,2016,Sociologie,10,1,QROC,0.8253,0.12,0.46,80,67,66,1,1.19,98.51,66,14,82.53,Trop Facile,Facile,Trop Facile / Facile
2317,658,2017,Sociologie,10,1,QROC,0.9278,0.0,0.51,96,94,89,5,1.02,94.68,89,7,92.78,Trop Facile,Trop Facile,Trop Facile / Trop Facile
3147,658,2018,Sociologie,10,1,QROC,0.9302,0.04,0.99,114,108,106,2,1.06,98.15,106,8,93.02,Trop Facile,Trop Facile,Trop Facile / Trop Facile
3977,658,2019,Sociologie,10,1,QROC,0.9306,0.01,0.8,109,103,101,2,1.06,98.06,101,8,93.06,Trop Facile,Trop Facile,Trop Facile / Trop Facile
4807,658,2020,Sociologie,10,1,QROC,0.6377,0.47,0.39,119,97,76,21,1.23,78.35,76,43,63.77,Trop Facile,Adapte,Trop Facile / Adapte
658,659,2015,Sociologie,10,2,QCU,0.3014,0.22,0.33,74,37,22,15,2.0,59.46,22,52,30.14,Difficile,Difficile,Difficile / Difficile
1488,659,2016,Sociologie,10,2,QCU,0.962,0.07,0.97,61,60,59,1,1.02,98.33,59,2,96.2,Trop Facile,Trop Facile,Trop Facile / Trop Facile
2318,659,2017,Sociologie,10,2,QCU,0.8064,0.07,0.87,50,44,40,4,1.14,90.91,40,10,80.64,Trop Facile,Facile,Trop Facile / Facile
3148,659,2018,Sociologie,10,2,QCU,0.3997,0.22,0.4,52,31,21,10,1.68,67.74,21,31,39.97,Trop Facile,Difficile,Trop Facile / Difficile
3978,659,2019,Sociologie,10,2,QCU,0.9297,0.09,0.94,54,53,50,3,1.02,94.34,50,4,92.97,Trop Facile,Trop Facile,Trop Facile / Trop Facile
4808,659,2020,Sociologie,10,2,QCU,0.9853,0.07,0.98,59,58,58,0,1.02,100.0,58,1,98.53,Trop Facile,Trop Facile,Trop Facile / Trop Facile
659,660,2015,Sociologie,10,3,QCU,0.5387,0.36,0.39,58,44,31,13,1.32,70.45,31,27,53.87,Difficile,Difficile,Difficile / Difficile
1489,660,2016,Sociologie,10,3,QCU,0.835,0.01,0.86,67,66,56,10,1.02,84.85,56,11,83.5,Trop Facile,Facile,Trop Facile / Facile
2319,660,2017,Sociologie,10,3,QCU,0.9825,0.07,0.95,60,59,59,0,1.02,100.0,59,1,98.25,Trop Facile,Trop Facile,Trop Facile / Trop Facile
3149,660,2018,Sociologie,10,3,QCU,0.0051,0.31,0.21,62,52,0,52,1.19,0.0,0,62,0.51,Trop Facile,Trop Difficile,Trop Facile / Trop Difficile
3979,660,2019,Sociologie,10,3,QCU,0.6501,0.1,0.49,64,49,42,7,1.31,85.71,42,22,65.01,Trop Facile,Adapte,Trop Facile / Adapte
4809,660,2020,Sociologie,10,3,QCU,0.7213,0.29,0.58,66,59,48,11,1.12,81.36,48,18,72.13,Adapte,Adapte,Adapte / Adapte
660,661,2015,Sociologie,10,4,QCU,0.2607,0.38,0.37,47,41,12,29,1.15,29.27,12,35,26.07,Difficile,Difficile,Difficile / Difficile
1490,661,2016,Sociologie,10,4,QCU,0.814,0.06,0.77,41,34,33,1,1.21,97.06,33,8,81.4,Trop Facile,Facile,Trop Facile / Facile
2320,661,2017,Sociologie,10,4,QCU,0.911,0.05,0.97,48,46,44,2,1.04,95.65,44,4,91.1,Trop Facile,Trop Facile,Trop Facile / Trop Facile
3150,661,2018,Sociologie,10,4,QCU,0.9963,0.08,1.0,51,51,51,0,1.0,100.0,51,0,99.63,Trop Facile,Trop Facile,Trop Facile / Trop Facile
3980,661,2019,Sociologie,10,4,QCU,0.7756,0.19,0.89,46,38,36,2,1.21,94.74,36,10,77.56,Trop Facile,Facile,Trop Facile / Facile
4810,661,2020,Sociologie,10,4,QCU,0.17,0.45,0.25,39,26,7,19,1.5,26.92,7,32,17.0,Trop Facile,Trop Difficile,Trop Facile / Trop Difficile
661,662,2015,Sociologie,10,5,QCU,0.8897,0.09,0.95,77,75,69,6,1.03,92.0,69,8,88.97,Trop Facile,Trop Facile,Trop Facile / Trop Facile
1491,662,2016,Sociologie,10,5,QCU,0.9708,0.06,0.92,86,84,83,1,1.02,98.81,83,3,97.08,Trop Facile,Trop Facile,Trop Facile / Trop Facile
2321,662,2017,Sociologie,10,5,QCU,0.9513,0.04,0.92,83,83,79,4,1.0,95.18,79,4,95.13,Trop Facile,Trop Facile,Trop Facile / Trop Facile
3151,662,2018,Sociologie,10,5,QCU,0.7045,0.09,0.49,86,78,61,17,1.1,78.21,61,25,70.45,Trop Facile,Adapte,Trop Facile / Adapte
3981,662,2019,Sociologie,10,5,QCU,0.6521,0.29,0.54,89,83,58,25,1.07,69.88,58,31,65.21,Adapte,Adapte,Adapte / Adapte
4811,662,2020,Sociologie,10,5,QCU,0.6098,0.03,0.64,82,63,50,13,1.3,79.37,50,32,60.98,Adapte,Adapte,Adapte / Adapte
662,663,2015,Sociologie,10,6,QCU,0.4358,0.19,0.32,14,13,6,7,1.08,46.15,6,8,43.58,Trop Facile,Difficile,Trop Facile / Difficile
1492,663,2016,Sociologie,10,6,QCU,0.8661,0.07,0.94,14,13,12,1,1.08,92.31,12,2,86.61,Trop Facile,Trop Facile,Trop Facile / Trop Facile
2322,663,2017,Sociologie,10,6,QCU,0.9073,0.08,0.93,11,11,10,1,1.0,90.91,10,1,90.73,Trop Facile,Trop Facile,Trop Facile / Trop Facile
3152,663,2018,Sociologie,10,6,QCU,0.8444,0.17,0.86,11,11,9,2,1.0,81.82,9,2,84.44,Trop Facile,Facile,Trop Facile / Facile
3982,663,2019,Sociologie,10,6,QCU,0.918,0.09,0.91,11,11,10,1,1.0,90.91,10,1,91.8,Trop Facile,Trop Facile,Trop Facile / Trop Facile
4812,663,2020,Sociologie,10,6,QCU,0.9263,0.06,0.92,13,12,12,0,1.08,100.0,12,1,92.63,Trop Facile,Trop Facile,Trop Facile / Trop Facile
663,664,2015,Sociologie,10,7,QCU,0.9498,0.03,0.93,71,70,67,3,1.01,95.71,67,4,94.98,Trop Facile,Trop Facile,Trop Facile / Trop Facile
1493,664,2016,Sociologie,10,7,QCU,0.9264,0.06,0.92,77,74,71,3,1.04,95.95,71,6,92.64,Trop Facile,Trop Facile,Trop Facile / Trop Facile
2323,664,2017,Sociologie,10,7,QCU,0.9007,0.08,0.99,72,67,65,2,1.07,97.01,65,7,90.07,Trop Facile,Trop Facile,Trop Facile / Trop Facile
3153,664,2018,Sociologie,10,7,QCU,0.8934,0.08,0.97,82,76,73,3,1.08,96.05,73,9,89.34,Trop Facile,Trop Facile,Trop Facile / Trop Facile
3983,664,2019,Sociologie,10,7,QCU,0.0881,0.04,0.26,91,45,8,37,2.02,17.78,8,83,8.81,Trop Facile,Trop Difficile,Trop Facile / Trop Difficile
4813,664,2020,Sociologie,10,7,QCU,0.9834,0.0,0.93,88,88,87,1,1.0,98.86,87,1,98.34,Trop Facile,Trop Facile,Trop Facile / Trop Facile
664,665,2015,Sociologie,10,8,QCU,0.0622,0.58,0.27,45,23,3,20,1.96,13.04,3,42,6.22,Trop Difficile,Trop Difficile,Trop Difficile / Trop Difficile
1494,665,2016,Sociologie,10,8,QCU,0.8781,0.08,0.99,54,52,47,5,1.04,90.38,47,7,87.81,Trop Facile,Trop Facile,Trop Facile / Trop Facile
2324,665,2017,Sociologie,10,8,QCU,0.9498,0.05,0.91,59,57,56,1,1.04,98.25,56,3,94.98,Trop Facile,Trop Facile,Trop Facile / Trop Facile
3154,665,2018,Sociologie,10,8,QCU,0.8497,0.02,0.75,52,46,44,2,1.13,95.65,44,8,84.97,Trop Facile,Facile,Trop Facile / Facile
3984,665,2019,Sociologie,10,8,QCU,0.3569,0.27,0.35,62,24,22,2,2.58,91.67,22,40,35.69,Trop Facile,Difficile,Trop Facile / Difficile
4814,665,2020,Sociologie,10,8,QCU,0.8762,0.03,0.92,65,65,57,8,1.0,87.69,57,8,87.62,Trop Facile,Trop Facile,Trop Facile / Trop Facile
665,666,2015,Sociologie,11,1,QCU,0.8627,0.03,0.9,75,72,65,7,1.04,90.28,65,10,86.27,Trop Facile,Trop Facile,Trop Facile / Trop Facile
1495,666,2016,Sociologie,11,1,QCU,0.9273,0.1,0.99,77,74,71,3,1.04,95.95,71,6,92.73,Trop Facile,Trop Facile,Trop Facile / Trop Facile
2325,666,2017,Sociologie,11,1,QCU,0.8608,0.04,0.97,64,62,55,7,1.03,88.71,55,9,86.08,Trop Facile,Trop Facile,Trop Facile / Trop Facile
3155,666,2018,Sociologie,11,1,QCU,0.8951,0.1,0.93,75,73,67,6,1.03,91.78,67,8,89.51,Trop Facile,Trop Facile,Trop Facile / Trop Facile
3985,666,2019,Sociologie,11,1,QCU,0.8799,0.05,0.92,64,63,56,7,1.02,88.89,56,8,87.99,Trop Facile,Trop Facile,Trop Facile / Trop Facile
4815,666,2020,Sociologie,11,1,QCU,0.9977,0.1,0.98,56,56,56,0,1.0,100.0,56,0,99.77,Trop Facile,Trop Facile,Trop Facile / Trop Facile
666,667,2015,Sociologie,11,2,QCU,0.2997,0.21,0.3,60,49,18,31,1.22,36.73,18,42,29.97,Facile,Difficile,Facile / Difficile
1496,667,2016,Sociologie,11,2,QCU,0.888,0.05,0.95,54,49,48,1,1.1,97.96,48,6,88.8,Trop Facile,Trop Facile,Trop Facile / Trop Facile
2326,667,2017,Sociologie,11,2,QCU,0.8619,0.04,0.99,44,41,38,3,1.07,92.68,38,6,86.19,Trop Facile,Trop Facile,Trop Facile / Trop Facile
3156,667,2018,Sociologie,11,2,QCU,0.9332,0.03,0.9,43,43,40,3,1.0,93.02,40,3,93.32,Trop Facile,Trop Facile,Trop Facile / Trop Facile
3986,667,2019,Sociologie,11,2,QCU,0.8139,0.19,0.77,48,41,39,2,1.17,95.12,39,9,81.39,Trop Facile,Facile,Trop Facile / Facile
4816,667,2020,Sociologie,11,2,QCU,0.8832,0.02,0.93,55,54,49,5,1.02,90.74,49,6,88.32,Trop Facile,Trop Facile,Trop Facile / Trop Facile
667,668,2015,Sociologie,11,3,QCU,0.7748,0.01,0.89,61,59,47,12,1.03,79.66,47,14,77.48,Facile,Facile,Facile / Facile
1497,668,2016,Sociologie,11,3,QCU,0.8812,0.05,1.0,49,46,43,3,1.07,93.48,43,6,88.12,Trop Facile,Trop Facile,Trop Facile / Trop Facile
2327,668,2017,Sociologie,11,3,QCU,0.9632,0.1,0.9,57,56,55,1,1.02,98.21,55,2,96.32,Trop Facile,Trop Facile,Trop Facile / Trop Facile
3157,668,2018,Sociologie,11,3,QCU,0.9041,0.06,1.0,67,63,61,2,1.06,96.83,61,6,90.41,Trop Facile,Trop Facile,Trop Facile / Trop Facile
3987,668,2019,Sociologie,11,3,QCU,0.9542,0.01,0.95,67,65,64,1,1.03,98.46,64,3,95.42,Trop Facile,Trop Facile,Trop Facile / Trop Facile
4817,668,2020,Sociologie,11,3,QCU,0.7874,0.14,0.88,66,55,52,3,1.2,94.55,52,14,78.74,Trop Facile,Facile,Trop Facile / Facile
668,669,2015,Sociologie,11,4,QCU,0.8648,0.01,0.91,25,24,22,2,1.04,91.67,22,3,86.48,Trop Facile,Trop Facile,Trop Facile / Trop Facile
1498,669,2016,Sociologie,11,4,QCU,0.622,0.01,0.44,30,27,19,8,1.11,70.37,19,11,62.2,Trop Facile,Adapte,Trop Facile / Adapte
2328,669,2017,Sociologie,11,4,QCU,0.6799,0.23,0.54,26,25,18,7,1.04,72.0,18,8,67.99,Adapte,Adapte,Adapte / Adapte
3158,669,2018,Sociologie,11,4,QCU,0.7184,0.13,0.7,21,16,15,1,1.31,93.75,15,6,71.84,Adapte,Adapte,Adapte / Adapte
3988,669,2019,Sociologie,11,4,QCU,0.7008,0.21,0.55,23,17,16,1,1.35,94.12,16,7,70.08,Adapte,Adapte,Adapte / Adapte
4818,669,2020,Sociologie,11,4,QCU,0.6299,0.27,0.6,19,19,12,7,1.0,63.16,12,7,62.99,Adapte,Adapte,Adapte / Adapte
669,670,2015,Sociologie,12,1,QCU,0.0822,0.05,0.28,53,27,4,23,1.96,14.81,4,49,8.22,Trop Difficile,Trop Difficile,Trop Difficile / Trop Difficile
1499,670,2016,Sociologie,12,1,QCU,0.1692,0.67,0.28,62,61,10,51,1.02,16.39,10,52,16.92,Trop Facile,Trop Difficile,Trop Facile / Trop Difficile
2329,670,2017,Sociologie,12,1,QCU,0.9408,0.04,0.92,54,52,51,1,1.04,98.08,51,3,94.08,Trop Facile,Trop Facile,Trop Facile / Trop Facile
3159,670,2018,Sociologie,12,1,QCU,0.9909,0.04,0.91,52,52,52,0,1.0,100.0,52,0,99.09,Trop Facile,Trop Facile,Trop Facile / Trop Facile
3989,670,2019,Sociologie,12,1,QCU,0.9742,0.08,0.96,47,47,46,1,1.0,97.87,46,1,97.42,Trop Facile,Trop Facile,Trop Facile / Trop Facile
4819,670,2020,Sociologie,12,1,QCU,0.981,0.01,0.96,47,47,46,1,1.0,97.87,46,1,98.1,Trop Facile,Trop Facile,Trop Facile / Trop Facile
670,671,2015,Sociologie,12,2,QO,0.3994,0.84,0.13,15,12,6,6,1.25,50.0,6,9,39.94,Difficile,Difficile,Difficile / Difficile
1500,671,2016,Sociologie,12,2,QO,0.9259,0.04,0.7,18,18,17,1,1.0,94.44,17,1,92.59,Trop Facile,Trop Facile,Trop Facile / Trop Facile
2330,671,2017,Sociologie,12,2,QO,0.8667,0.01,0.56,20,19,17,2,1.05,89.47,17,3,86.67,Trop Facile,Trop Facile,Trop Facile / Trop Facile
3160,671,2018,Sociologie,12,2,QO,0.7415,0.67,0.19,23,22,17,5,1.05,77.27,17,6,74.15,Trop Facile,Adapte,Trop Facile / Adapte
3990,671,2019,Sociologie,12,2,QO,0.6378,0.4,0.27,26,19,17,2,1.37,89.47,17,9,63.78,Adapte,Adapte,Adapte / Adapte
4820,671,2020,Sociologie,12,2,QO,0.7284,0.7,0.22,26,21,19,2,1.24,90.48,19,7,72.84,Adapte,Adapte,Adapte / Adapte
671,672,2015,Sociologie,12,3,QROC,0.6382,0.32,0.34,98,96,63,33,1.02,65.62,63,35,63.82,Trop Difficile,Adapte,Trop Difficile / Adapte
1501,672,2016,Sociologie,12,3,QROC,0.6806,0.44,0.38,80,74,54,20,1.08,72.97,54,26,68.06,Adapte,Adapte,Adapte / Adapte
2331,672,2017,Sociologie,12,3,QROC,0.6313,0.29,0.36,95,74,60,14,1.28,81.08,60,35,63.13,Adapte,Adapte,Adapte / Adapte
3161,672,2018,Sociologie,12,3,QROC,0.63,0.33,0.28,112,72,71,1,1.56,98.61,71,41,63.0,Adapte,Adapte,Adapte / Adapte
3991,672,2019,Sociologie,12,3,QROC,0.6726,0.39,0.4,98,72,66,6,1.36,91.67,66,32,67.26,Adapte,Adapte,Adapte / Adapte
4821,672,2020,Sociologie,12,3,QROC,0.6461,0.38,0.28,92,78,59,19,1.18,75.64,59,33,64.61,Adapte,Adapte,Adapte / Adapte
672,673,2015,Sociologie,12,4,QCM,0.8176,0.12,0.78,95,87,78,9,1.09,89.66,78,17,81.76,Facile,Facile,Facile / Facile
1502,673,2016,Sociologie,12,4,QCM,0.3891,0.46,0.36,97,60,38,22,1.62,63.33,38,59,38.91,Trop Facile,Difficile,Trop Facile / Difficile
2332,673,2017,Sociologie,12,4,QCM,0.1627,0.0,0.24,100,49,16,33,2.04,32.65,16,84,16.27,Trop Facile,Trop Difficile,Trop Facile / Trop Difficile
3162,673,2018,Sociologie,12,4,QCM,0.674,0.04,0.56,94,80,63,17,1.18,78.75,63,31,67.4,Trop Facile,Adapte,Trop Facile / Adapte
3992,673,2019,Sociologie,12,4,QCM,0.6352,0.24,0.43,98,64,62,2,1.53,96.88,62,36,63.52,Adapte,Adapte,Adapte / Adapte
4822,673,2020,Sociologie,12,4,QCM,0.7314,0.03,0.42,88,68,64,4,1.29,94.12,64,24,73.14,Adapte,Adapte,Adapte / Adapte
673,674,2015,Sociologie,12,5,QCM,0.2627,0.48,0.31,44,28,12,16,1.57,42.86,12,32,26.27,Difficile,Difficile,Difficile / Difficile
1503,674,2016,Sociologie,12,5,QCM,0.8483,0.01,0.73,43,37,36,1,1.16,97.3,36,7,84.83,Trop Facile,Facile,Trop Facile / Facile
2333,674,2017,Sociologie,12,5,QCM,0.9552,0.06,0.86,44,43,42,1,1.02,97.67,42,2,95.52,Trop Facile,Trop Facile,Trop Facile / Trop Facile
3163,674,2018,Sociologie,12,5,QCM,0.9568,0.09,0.94,43,43,41,2,1.0,95.35,41,2,95.68,Trop Facile,Trop Facile,Trop Facile / Trop Facile
3993,674,2019,Sociologie,12,5,QCM,0.9417,0.06,0.93,52,49,49,0,1.06,100.0,49,3,94.17,Trop Facile,Trop Facile,Trop Facile / Trop Facile
4823,674,2020,Sociologie,12,5,QCM,0.9609,0.05,0.88,50,50,48,2,1.0,96.0,48,2,96.09,Trop Facile,Trop Facile,Trop Facile / Trop Facile
674,675,2015,Sociologie,12,6,QCU,0.3926,0.3,0.34,47,40,18,22,1.18,45.0,18,29,39.26,Difficile,Difficile,Difficile / Difficile
1504,675,2016,Sociologie,12,6,QCU,0.8262,0.15,0.8,51,46,42,4,1.11,91.3,42,9,82.62,Trop Facile,Facile,Trop Facile / Facile
2334,675,2017,Sociologie,12,6,QCU,0.8868,0.07,0.97,49,48,43,5,1.02,89.58,43,6,88.68,Trop Facile,Trop Facile,Trop Facile / Trop Facile
3164,675,2018,Sociologie,12,6,QCU,0.9318,0.04,0.99,42,42,39,3,1.0,92.86,39,3,93.18,Trop Facile,Trop Facile,Trop Facile / Trop Facile
3994,675,2019,Sociologie,12,6,QCU,0.9791,0.09,0.97,41,41,40,1,1.0,97.56,40,1,97.91,Trop Facile,Trop Facile,Trop Facile / Trop Facile
4824,675,2020,Sociologie,12,6,QCU,0.8632,0.04,1.0,35,31,30,1,1.13,96.77,30,5,86.32,Trop Facile,Trop Facile,Trop Facile / Trop Facile
675,676,2015,Sociologie,12,7,QCM,0.0762,0.44,0.24,49,29,4,25,1.69,13.79,4,45,7.62,Trop Difficile,Trop Difficile,Trop Difficile / Trop Difficile
1505,676,2016,Sociologie,12,7,QCM,0.9736,0.01,0.83,55,54,54,0,1.02,100.0,54,1,97.36,Trop Facile,Trop Facile,Trop Facile / Trop Facile
2335,676,2017,Sociologie,12,7,QCM,0.7916,0.07,0.78,53,46,42,4,1.15,91.3,42,11,79.16,Trop Facile,Facile,Trop Facile / Facile
3165,676,2018,Sociologie,12,7,QCM,0.9184,0.02,0.87,49,49,45,4,1.0,91.84,45,4,91.84,Trop Facile,Trop Facile,Trop Facile / Trop Facile
3995,676,2019,Sociologie,12,7,QCM,0.9813,0.02,0.85,40,40,39,1,1.0,97.5,39,1,98.13,Trop Facile,Trop Facile,Trop Facile / Trop Facile
4825,676,2020,Sociologie,12,7,QCM,0.6733,0.1,0.42,36,29,24,5,1.24,82.76,24,12,67.33,Trop Facile,Adapte,Trop Facile / Adapte
676,677,2015,Sociologie,12,8,QROC,0.0718,0.86,0.1,50,28,4,24,1.79,14.29,4,46,7.18,Trop Difficile,Trop Difficile,Trop Difficile / Trop Difficile
1506,677,2016,Sociologie,12,8,QROC,0.9782,0.07,0.63,54,53,53,0,1.02,100.0,53,1,97.82,Trop Facile,Trop Facile,Trop Facile / Trop Facile
2336,677,2017,Sociologie,12,8,QROC,0.0633,0.98,0.14,54,48,3,45,1.12,6.25,3,51,6.33,Trop Facile,Trop Difficile,Trop Facile / Trop Difficile
3166,677,2018,Sociologie,12,8,QROC,0.9683,0.03,0.71,48,46,46,0,1.04,100.0,46,2,96.83,Trop Facile,Trop Facile,Trop Facile / Trop Facile
3996,677,2019,Sociologie,12,8,QROC,0.9447,0.0,0.58,53,52,50,2,1.02,96.15,50,3,94.47,Trop Facile,Trop Facile,Trop Facile / Trop Facile
4826,677,2020,Sociologie,12,8,QROC,0.9203,0.07,0.99,49,47,45,2,1.04,95.74,45,4,92.03,Trop Facile,Trop Facile,Trop Facile / Trop Facile
677,678,2015,Sociologie,12,9,QROC,0.8997,0.02,0.52,72,66,65,1,1.09,98.48,65,7,89.97,Difficile,Trop Facile,Difficile / Trop Facile
1507,678,2016,Sociologie,12,9,QROC,0.9045,0.09,0.62,76,72,69,3,1.06,95.83,69,7,90.45,Trop Facile,Trop Facile,Trop Facile / Trop Facile
2337,678,2017,Sociologie,12,9,QROC,0.943,0.02,0.56,80,77,75,2,1.04,97.4,75,5,94.3,Trop Facile,Trop Facile,Trop Facile / Trop Facile
3167,678,2018,Sociologie,12,9,QROC,0.889,0.03,0.8,67,64,60,4,1.05,93.75,60,7,88.9,Trop Facile,Trop Facile,Trop Facile / Trop Facile
3997,678,2019,Sociologie,12,9,QROC,0.9283,0.06,0.75,71,67,66,1,1.06,98.51,66,5,92.83,Trop Facile,Trop Facile,Trop Facile / Trop Facile
4827,678,2020,Sociologie,12,9,QROC,0.021,0.83,0.15,64,39,1,38,1.64,2.56,1,63,2.1,Trop Facile,Trop Difficile,Trop Facile / Trop Difficile
678,679,2015,Sociologie,12,10,QCU,0.2659,0.04,0.35,29,26,8,18,1.12,30.77,8,21,26.59,Difficile,Difficile,Difficile / Difficile
1508,679,2016,Sociologie,12,10,QCU,0.8048,0.12,0.78,35,33,28,5,1.06,84.85,28,7,80.48,Trop Facile,Facile,Trop Facile / Facile
2338,679,2017,Sociologie,12,10,QCU,0.8896,0.1,0.94,39,38,35,3,1.03,92.11,35,4,88.96,Trop Facile,Trop Facile,Trop Facile / Trop Facile
3168,679,2018,Sociologie,12,10,QCU,0.6795,0.24,0.64,34,30,23,7,1.13,76.67,23,11,67.95,Trop Facile,Adapte,Trop Facile / Adapte
3998,679,2019,Sociologie,12,10,QCU,0.6123,0.23,0.43,31,24,19,5,1.29,79.17,19,12,61.23,Adapte,Adapte,Adapte / Adapte
4828,679,2020,Sociologie,12,10,QCU,0.7173,0.27,0.67,30,24,22,2,1.25,91.67,22,8,71.73,Adapte,Adapte,Adapte / Adapte
679,680,2015,Sociologie,12,11,QCU,0.8034,0.07,0.86,6,6,5,1,1.0,83.33,5,1,80.34,Facile,Facile,Facile / Facile
1509,680,2016,Sociologie,12,11,QCU,0.7966,0.15,0.81,6,5,5,0,1.2,100.0,5,1,79.66,Trop Facile,Facile,Trop Facile / Facile
2339,680,2017,Sociologie,12,11,QCU,0.9277,0.05,0.99,6,6,6,0,1.0,100.0,6,0,92.77,Trop Facile,Trop Facile,Trop Facile / Trop Facile
3169,680,2018,Sociologie,12,11,QCU,0.9645,0.05,0.92,6,6,6,0,1.0,100.0,6,0,96.45,Trop Facile,Trop Facile,Trop Facile / Trop Facile
3999,680,2019,Sociologie,12,11,QCU,0.9571,0.01,0.96,7,7,7,0,1.0,100.0,7,0,95.71,Trop Facile,Trop Facile,Trop Facile / Trop Facile
4829,680,2020,Sociologie,12,11,QCU,0.9304,0.03,0.91,8,7,7,0,1.14,100.0,7,1,93.04,Trop Facile,Trop Facile,Trop Facile / Trop Facile
680,681,2015,Sociologie,12,12,QCU,0.2123,0.35,0.23,16,16,3,13,1.0,18.75,3,13,21.23,Difficile,Trop Difficile,Difficile / Trop Difficile
1510,681,2016,Sociologie,12,12,QCU,0.1126,0.38,0.26,14,14,2,12,1.0,14.29,2,12,11.26,Trop Facile,Trop Difficile,Trop Facile / Trop Difficile
2340,681,2017,Sociologie,12,12,QCU,0.7655,0.17,0.76,16,14,12,2,1.14,85.71,12,4,76.55,Trop Facile,Facile,Trop Facile / Facile
3170,681,2018,Sociologie,12,12,QCU,0.9059,0.09,0.91,16,15,14,1,1.07,93.33,14,2,90.59,Trop Facile,Trop Facile,Trop Facile / Trop Facile
4000,681,2019,Sociologie,12,12,QCU,0.3751,0.22,0.39,14,5,5,0,2.8,100.0,5,9,37.51,Trop Facile,Difficile,Trop Facile / Difficile
4830,681,2020,Sociologie,12,12,QCU,0.8671,0.1,0.99,14,13,12,1,1.08,92.31,12,2,86.71,Trop Facile,Trop Facile,Trop Facile / Trop Facile
681,682,2015,Sociologie,13,1,QROC,0.8026,0.05,0.74,61,54,49,5,1.13,90.74,49,12,80.26,Facile,Facile,Facile / Facile
1511,682,2016,Sociologie,13,1,QROC,0.2134,0.77,0.13,56,55,12,43,1.02,21.82,12,44,21.34,Trop Facile,Trop Difficile,Trop Facile / Trop Difficile
2341,682,2017,Sociologie,13,1,QROC,0.8871,0.07,0.91,47,45,42,3,1.04,93.33,42,5,88.71,Trop Facile,Trop Facile,Trop Facile / Trop Facile
3171,682,2018,Sociologie,13,1,QROC,0.6011,0.32,0.31,55,53,33,20,1.04,62.26,33,22,60.11,Trop Facile,Adapte,Trop Facile / Adapte
4001,682,2019,Sociologie,13,1,QROC,0.7077,0.29,0.35,44,32,31,1,1.38,96.88,31,13,70.77,Adapte,Adapte,Adapte / Adapte
4831,682,2020,Sociologie,13,1,QROC,0.6459,0.38,0.38,38,36,25,11,1.06,69.44,25,13,64.59,Adapte,Adapte,Adapte / Adapte
682,683,2015,Sociologie,13,2,QCU,0.5192,0.02,0.31,81,46,42,4,1.76,91.3,42,39,51.92,Difficile,Difficile,Difficile / Difficile
1512,683,2016,Sociologie,13,2,QCU,0.9505,0.09,0.94,97,95,92,3,1.02,96.84,92,5,95.05,Trop Facile,Trop Facile,Trop Facile / Trop Facile
2342,683,2017,Sociologie,13,2,QCU,0.1453,0.73,0.28,89,79,13,66,1.13,16.46,13,76,14.53,Trop Facile,Trop Difficile,Trop Facile / Trop Difficile
3172,683,2018,Sociologie,13,2,QCU,0.9936,0.09,0.93,88,87,87,0,1.01,100.0,87,1,99.36,Trop Facile,Trop Facile,Trop Facile / Trop Facile
4002,683,2019,Sociologie,13,2,QCU,0.8364,0.01,0.84,89,86,74,12,1.03,86.05,74,15,83.64,Trop Facile,Facile,Trop Facile / Facile
4832,683,2020,Sociologie,13,2,QCU,0.9665,0.01,0.94,78,77,75,2,1.01,97.4,75,3,96.65,Trop Facile,Trop Facile,Trop Facile / Trop Facile
683,684,2015,Sociologie,13,3,QCU,0.3417,0.36,0.33,24,11,8,3,2.18,72.73,8,16,34.17,Difficile,Difficile,Difficile / Difficile
1513,684,2016,Sociologie,13,3,QCU,0.6335,0.02,0.4,24,17,15,2,1.41,88.24,15,9,63.35,Trop Facile,Adapte,Trop Facile / Adapte
2343,684,2017,Sociologie,13,3,QCU,0.7127,0.08,0.6,22,21,16,5,1.05,76.19,16,6,71.27,Adapte,Adapte,Adapte / Adapte
3173,684,2018,Sociologie,13,3,QCU,0.6021,0.02,0.68,23,20,14,6,1.15,70.0,14,9,60.21,Adapte,Adapte,Adapte / Adapte
4003,684,2019,Sociologie,13,3,QCU,0.7079,0.24,0.51,21,20,15,5,1.05,75.0,15,6,70.79,Adapte,Adapte,Adapte / Adapte
4833,684,2020,Sociologie,13,3,QCU,0.6892,0.1,0.46,22,16,15,1,1.38,93.75,15,7,68.92,Adapte,Adapte,Adapte / Adapte
684,685,2015,Sociologie,13,4,QCU,0.8294,0.1,0.88,63,53,52,1,1.19,98.11,52,11,82.94,Facile,Facile,Facile / Facile
1514,685,2016,Sociologie,13,4,QCU,0.7077,0.18,0.51,75,65,53,12,1.15,81.54,53,22,70.77,Trop Facile,Adapte,Trop Facile / Adapte
2344,685,2017,Sociologie,13,4,QCU,0.6637,0.26,0.41,71,59,47,12,1.2,79.66,47,24,66.37,Adapte,Adapte,Adapte / Adapte
3174,685,2018,Sociologie,13,4,QCU,0.6224,0.02,0.49,58,43,36,7,1.35,83.72,36,22,62.24,Adapte,Adapte,Adapte / Adapte
4004,685,2019,Sociologie,13,4,QCU,0.6596,0.1,0.48,58,39,38,1,1.49,97.44,38,20,65.96,Adapte,Adapte,Adapte / Adapte
4834,685,2020,Sociologie,13,4,QCU,0.653,0.2,0.55,52,50,34,16,1.04,68.0,34,18,65.3,Adapte,Adapte,Adapte / Adapte
685,686,2015,Sociologie,13,5,QO,0.6966,0.42,0.22,95,79,66,13,1.2,83.54,66,29,69.66,Difficile,Adapte,Difficile / Adapte
1515,686,2016,Sociologie,13,5,QO,0.7058,0.39,0.29,79,61,56,5,1.3,91.8,56,23,70.58,Adapte,Adapte,Adapte / Adapte
2345,686,2017,Sociologie,13,5,QO,0.6888,0.44,0.29,70,66,48,18,1.06,72.73,48,22,68.88,Adapte,Adapte,Adapte / Adapte
3175,686,2018,Sociologie,13,5,QO,0.7309,0.21,0.19,82,61,60,1,1.34,98.36,60,22,73.09,Adapte,Adapte,Adapte / Adapte
4005,686,2019,Sociologie,13,5,QO,0.6428,0.52,0.27,97,95,62,33,1.02,65.26,62,35,64.28,Adapte,Adapte,Adapte / Adapte
4835,686,2020,Sociologie,13,5,QO,0.6911,0.47,0.24,90,85,62,23,1.06,72.94,62,28,69.11,Adapte,Adapte,Adapte / Adapte
686,687,2015,Sociologie,13,6,QCU,0.3988,0.22,0.38,16,11,6,5,1.45,54.55,6,10,39.88,Difficile,Difficile,Difficile / Difficile
1516,687,2016,Sociologie,13,6,QCU,0.8978,0.02,0.97,19,18,17,1,1.06,94.44,17,2,89.78,Trop Facile,Trop Facile,Trop Facile / Trop Facile
2346,687,2017,Sociologie,13,6,QCU,0.8831,0.04,0.91,21,20,19,1,1.05,95.0,19,2,88.31,Trop Facile,Trop Facile,Trop Facile / Trop Facile
3176,687,2018,Sociologie,13,6,QCU,0.9097,0.02,0.99,22,22,20,2,1.0,90.91,20,2,90.97,Trop Facile,Trop Facile,Trop Facile / Trop Facile
4006,687,2019,Sociologie,13,6,QCU,0.9609,0.1,0.94,21,21,20,1,1.0,95.24,20,1,96.09,Trop Facile,Trop Facile,Trop Facile / Trop Facile
4836,687,2020,Sociologie,13,6,QCU,0.2147,0.71,0.28,23,12,5,7,1.92,41.67,5,18,21.47,Trop Facile,Trop Difficile,Trop Facile / Trop Difficile
687,688,2015,Sociologie,13,7,QROC,0.5147,0.6,0.2,83,78,43,35,1.06,55.13,43,40,51.47,Difficile,Difficile,Difficile / Difficile
1517,688,2016,Sociologie,13,7,QROC,0.8723,0.07,0.7,70,64,61,3,1.09,95.31,61,9,87.23,Trop Facile,Trop Facile,Trop Facile / Trop Facile
2347,688,2017,Sociologie,13,7,QROC,0.7603,0.18,0.7,78,63,59,4,1.24,93.65,59,19,76.03,Trop Facile,Facile,Trop Facile / Facile
3177,688,2018,Sociologie,13,7,QROC,0.9119,0.09,0.85,81,74,74,0,1.09,100.0,74,7,91.19,Trop Facile,Trop Facile,Trop Facile / Trop Facile
4007,688,2019,Sociologie,13,7,QROC,0.8819,0.1,0.98,76,73,67,6,1.04,91.78,67,9,88.19,Trop Facile,Trop Facile,Trop Facile / Trop Facile
4837,688,2020,Sociologie,13,7,QROC,0.1077,0.99,0.02,88,73,9,64,1.21,12.33,9,79,10.77,Trop Facile,Trop Difficile,Trop Facile / Trop Difficile
688,689,2015,Sociologie,14,1,QCU,0.6948,0.23,0.6,38,35,26,9,1.09,74.29,26,12,69.48,Trop Facile,Adapte,Trop Facile / Adapte
1518,689,2016,Sociologie,14,1,QCU,0.6497,0.17,0.58,31,28,20,8,1.11,71.43,20,11,64.97,Adapte,Adapte,Adapte / Adapte
2348,689,2017,Sociologie,14,1,QCU,0.6586,0.15,0.67,32,32,21,11,1.0,65.62,21,11,65.86,Adapte,Adapte,Adapte / Adapte
3178,689,2018,Sociologie,14,1,QCU,0.6372,0.1,0.47,32,23,20,3,1.39,86.96,20,12,63.72,Adapte,Adapte,Adapte / Adapte
4008,689,2019,Sociologie,14,1,QCU,0.7349,0.26,0.4,28,26,21,5,1.08,80.77,21,7,73.49,Adapte,Adapte,Adapte / Adapte
4838,689,2020,Sociologie,14,1,QCU,0.6539,0.19,0.54,32,26,21,5,1.23,80.77,21,11,65.39,Adapte,Adapte,Adapte / Adapte
689,690,2015,Sociologie,14,2,QCU,0.9245,0.01,0.9,16,16,15,1,1.0,93.75,15,1,92.45,Trop Facile,Trop Facile,Trop Facile / Trop Facile
1519,690,2016,Sociologie,14,2,QCU,0.8917,0.04,0.94,18,18,16,2,1.0,88.89,16,2,89.17,Trop Facile,Trop Facile,Trop Facile / Trop Facile
2349,690,2017,Sociologie,14,2,QCU,0.1792,0.16,0.3,20,8,4,4,2.5,50.0,4,16,17.92,Trop Facile,Trop Difficile,Trop Facile / Trop Difficile
3179,690,2018,Sociologie,14,2,QCU,0.8837,0.07,0.94,23,20,20,0,1.15,100.0,20,3,88.37,Trop Facile,Trop Facile,Trop Facile / Trop Facile
4009,690,2019,Sociologie,14,2,QCU,0.967,0.02,0.95,19,19,18,1,1.0,94.74,18,1,96.7,Trop Facile,Trop Facile,Trop Facile / Trop Facile
4839,690,2020,Sociologie,14,2,QCU,0.9126,0.04,0.94,21,19,19,0,1.11,100.0,19,2,91.26,Trop Facile,Trop Facile,Trop Facile / Trop Facile
690,691,2015,Sociologie,14,3,QROC,0.8781,0.08,0.63,90,80,79,1,1.12,98.75,79,11,87.81,Difficile,Trop Facile,Difficile / Trop Facile
1520,691,2016,Sociologie,14,3,QROC,0.9628,0.05,0.65,88,86,85,1,1.02,98.84,85,3,96.28,Trop Facile,Trop Facile,Trop Facile / Trop Facile
2350,691,2017,Sociologie,14,3,QROC,0.8801,0.03,0.95,97,86,85,1,1.13,98.84,85,12,88.01,Trop Facile,Trop Facile,Trop Facile / Trop Facile
3180,691,2018,Sociologie,14,3,QROC,0.3345,0.71,0.19,110,53,37,16,2.08,69.81,37,73,33.45,Trop Facile,Difficile,Trop Facile / Difficile
4010,691,2019,Sociologie,14,3,QROC,0.7406,0.5,0.3,90,84,67,17,1.07,79.76,67,23,74.06,Trop Facile,Adapte,Trop Facile / Adapte
4840,691,2020,Sociologie,14,3,QROC,0.6526,0.21,0.29,82,66,54,12,1.24,81.82,54,28,65.26,Adapte,Adapte,Adapte / Adapte
691,692,2015,Sociologie,14,4,QCM,0.9831,0.06,0.81,15,15,15,0,1.0,100.0,15,0,98.31,Trop Facile,Trop Facile,Trop Facile / Trop Facile
1521,692,2016,Sociologie,14,4,QCM,0.9894,0.07,0.99,12,12,12,0,1.0,100.0,12,0,98.94,Trop Facile,Trop Facile,Trop Facile / Trop Facile
2351,692,2017,Sociologie,14,4,QCM,0.904,0.02,0.98,11,11,10,1,1.0,90.91,10,1,90.4,Trop Facile,Trop Facile,Trop Facile / Trop Facile
3181,692,2018,Sociologie,14,4,QCM,0.3172,0.04,0.34,11,6,3,3,1.83,50.0,3,8,31.72,Trop Facile,Difficile,Trop Facile / Difficile
4011,692,2019,Sociologie,14,4,QCM,0.7802,0.03,0.71,10,8,8,0,1.25,100.0,8,2,78.02,Trop Facile,Facile,Trop Facile / Facile
4841,692,2020,Sociologie,14,4,QCM,0.9583,0.02,0.96,12,12,11,1,1.0,91.67,11,1,95.83,Trop Facile,Trop Facile,Trop Facile / Trop Facile
692,693,2015,Sociologie,14,5,QCU,0.1299,0.65,0.28,58,33,8,25,1.76,24.24,8,50,12.99,Difficile,Trop Difficile,Difficile / Trop Difficile
1522,693,2016,Sociologie,14,5,QCU,0.2198,0.56,0.3,65,54,14,40,1.2,25.93,14,51,21.98,Trop Facile,Trop Difficile,Trop Facile / Trop Difficile
2352,693,2017,Sociologie,14,5,QCU,0.4128,0.37,0.31,63,27,26,1,2.33,96.3,26,37,41.28,Trop Facile,Difficile,Trop Facile / Difficile
3182,693,2018,Sociologie,14,5,QCU,0.5679,0.19,0.39,67,59,38,21,1.14,64.41,38,29,56.79,Trop Facile,Difficile,Trop Facile / Difficile
4012,693,2019,Sociologie,14,5,QCU,0.9532,0.07,0.98,60,59,57,2,1.02,96.61,57,3,95.32,Trop Facile,Trop Facile,Trop Facile / Trop Facile
4842,693,2020,Sociologie,14,5,QCU,0.9417,0.0,0.98,50,50,47,3,1.0,94.0,47,3,94.17,Trop Facile,Trop Facile,Trop Facile / Trop Facile
693,694,2015,Sociologie,14,6,QCU,0.9459,0.05,0.93,63,60,60,0,1.05,100.0,60,3,94.59,Trop Facile,Trop Facile,Trop Facile / Trop Facile
1523,694,2016,Sociologie,14,6,QCU,0.8711,0.01,0.93,51,46,44,2,1.11,95.65,44,7,87.11,Trop Facile,Trop Facile,Trop Facile / Trop Facile
2353,694,2017,Sociologie,14,6,QCU,0.1301,0.42,0.28,59,48,8,40,1.23,16.67,8,51,13.01,Trop Facile,Trop Difficile,Trop Facile / Trop Difficile
3183,694,2018,Sociologie,14,6,QCU,0.9258,0.04,0.94,61,60,56,4,1.02,93.33,56,5,92.58,Trop Facile,Trop Facile,Trop Facile / Trop Facile
4013,694,2019,Sociologie,14,6,QCU,0.7699,0.16,0.8,67,58,52,6,1.16,89.66,52,15,76.99,Trop Facile,Facile,Trop Facile / Facile
4843,694,2020,Sociologie,14,6,QCU,0.871,0.01,0.97,78,73,68,5,1.07,93.15,68,10,87.1,Trop Facile,Trop Facile,Trop Facile / Trop Facile
694,695,2015,Sociologie,14,7,QCM,0.9843,0.08,0.99,38,38,37,1,1.0,97.37,37,1,98.43,Trop Facile,Trop Facile,Trop Facile / Trop Facile
1524,695,2016,Sociologie,14,7,QCM,0.4095,0.45,0.36,31,22,13,9,1.41,59.09,13,18,40.95,Trop Facile,Difficile,Trop Facile / Difficile
2354,695,2017,Sociologie,14,7,QCM,0.9395,0.08,0.91,37,36,35,1,1.03,97.22,35,2,93.95,Trop Facile,Trop Facile,Trop Facile / Trop Facile
3184,695,2018,Sociologie,14,7,QCM,0.1753,0.48,0.29,32,13,6,7,2.46,46.15,6,26,17.53,Trop Facile,Trop Difficile,Trop Facile / Trop Difficile
4014,695,2019,Sociologie,14,7,QCM,0.3441,0.15,0.31,33,23,11,12,1.43,47.83,11,22,34.41,Trop Facile,Difficile,Trop Facile / Difficile
4844,695,2020,Sociologie,14,7,QCM,0.9325,0.03,0.8,32,31,30,1,1.03,96.77,30,2,93.25,Trop Facile,Trop Facile,Trop Facile / Trop Facile
695,696,2015,Sociologie,14,8,QCM,0.4172,0.06,0.33,25,19,10,9,1.32,52.63,10,15,41.72,Difficile,Difficile,Difficile / Difficile
1525,696,2016,Sociologie,14,8,QCM,0.9699,0.0,0.87,23,22,22,0,1.05,100.0,22,1,96.99,Trop Facile,Trop Facile,Trop Facile / Trop Facile
2355,696,2017,Sociologie,14,8,QCM,0.6142,0.23,0.61,18,13,11,2,1.38,84.62,11,7,61.42,Trop Facile,Adapte,Trop Facile / Adapte
3185,696,2018,Sociologie,14,8,QCM,0.6948,0.01,0.54,18,13,13,0,1.38,100.0,13,5,69.48,Adapte,Adapte,Adapte / Adapte
4015,696,2019,Sociologie,14,8,QCM,0.6449,0.02,0.43,20,16,13,3,1.25,81.25,13,7,64.49,Adapte,Adapte,Adapte / Adapte
4845,696,2020,Sociologie,14,8,QCM,0.6837,0.22,0.64,20,18,14,4,1.11,77.78,14,6,68.37,Adapte,Adapte,Adapte / Adapte
696,697,2015,Sociologie,14,9,QCU,0.2219,0.19,0.22,43,16,10,6,2.69,62.5,10,33,22.19,Trop Difficile,Trop Difficile,Trop Difficile / Trop Difficile
1526,697,2016,Sociologie,14,9,QCU,0.6816,0.12,0.67,47,46,32,14,1.02,69.57,32,15,68.16,Trop Facile,Adapte,Trop Facile / Adapte
2356,697,2017,Sociologie,14,9,QCU,0.6886,0.29,0.66,45,35,31,4,1.29,88.57,31,14,68.86,Adapte,Adapte,Adapte / Adapte
3186,697,2018,Sociologie,14,9,QCU,0.6093,0.14,0.5,51,35,31,4,1.46,88.57,31,20,60.93,Adapte,Adapte,Adapte / Adapte
4016,697,2019,Sociologie,14,9,QCU,0.6662,0.03,0.62,54,37,36,1,1.46,97.3,36,18,66.62,Adapte,Adapte,Adapte / Adapte
4846,697,2020,Sociologie,14,9,QCU,0.6037,0.19,0.69,56,50,34,16,1.12,68.0,34,22,60.37,Adapte,Adapte,Adapte / Adapte
697,698,2015,Sociologie,14,10,QCM,0.7385,0.03,0.67,42,41,31,10,1.02,75.61,31,11,73.85,Difficile,Adapte,Difficile / Adapte
1527,698,2016,Sociologie,14,10,QCM,0.6851,0.11,0.44,37,30,25,5,1.23,83.33,25,12,68.51,Adapte,Adapte,Adapte / Adapte
2357,698,2017,Sociologie,14,10,QCM,0.7046,0.27,0.56,40,30,28,2,1.33,93.33,28,12,70.46,Adapte,Adapte,Adapte / Adapte
3187,698,2018,Sociologie,14,10,QCM,0.7455,0.26,0.45,32,27,24,3,1.19,88.89,24,8,74.55,Adapte,Adapte,Adapte / Adapte
4017,698,2019,Sociologie,14,10,QCM,0.6978,0.02,0.67,28,26,20,6,1.08,76.92,20,8,69.78,Adapte,Adapte,Adapte / Adapte
4847,698,2020,Sociologie,14,10,QCM,0.694,0.24,0.56,22,19,15,4,1.16,78.95,15,7,69.4,Adapte,Adapte,Adapte / Adapte
698,699,2015,Sociologie,14,11,QROC,0.1847,0.93,0.14,9,4,2,2,2.25,50.0,2,7,18.47,Difficile,Trop Difficile,Difficile / Trop Difficile
1528,699,2016,Sociologie,14,11,QROC,0.7867,0.11,0.73,10,8,8,0,1.25,100.0,8,2,78.67,Trop Facile,Facile,Trop Facile / Facile
2358,699,2017,Sociologie,14,11,QROC,0.8639,0.07,0.91,10,9,9,0,1.11,100.0,9,1,86.39,Trop Facile,Trop Facile,Trop Facile / Trop Facile
3188,699,2018,Sociologie,14,11,QROC,0.9198,0.06,0.63,12,12,11,1,1.0,91.67,11,1,91.98,Trop Facile,Trop Facile,Trop Facile / Trop Facile
4018,699,2019,Sociologie,14,11,QROC,0.9227,0.0,0.58,12,12,11,1,1.0,91.67,11,1,92.27,Trop Facile,Trop Facile,Trop Facile / Trop Facile
4848,699,2020,Sociologie,14,11,QROC,0.8749,0.01,0.96,11,11,10,1,1.0,90.91,10,1,87.49,Trop Facile,Trop Facile,Trop Facile / Trop Facile
699,700,2015,Sociologie,14,12,QCM,0.7081,0.05,0.62,22,19,16,3,1.16,84.21,16,6,70.81,Adapte,Adapte,Adapte / Adapte
1529,700,2016,Sociologie,14,12,QCM,0.7434,0.21,0.61,22,21,16,5,1.05,76.19,16,6,74.34,Adapte,Adapte,Adapte / Adapte
2359,700,2017,Sociologie,14,12,QCM,0.6774,0.12,0.49,24,19,16,3,1.26,84.21,16,8,67.74,Adapte,Adapte,Adapte / Adapte
3189,700,2018,Sociologie,14,12,QCM,0.7494,0.05,0.41,28,25,21,4,1.12,84.0,21,7,74.94,Adapte,Adapte,Adapte / Adapte
4019,700,2019,Sociologie,14,12,QCM,0.7256,0.02,0.48,23,21,17,4,1.1,80.95,17,6,72.56,Adapte,Adapte,Adapte / Adapte
4849,700,2020,Sociologie,14,12,QCM,0.6917,0.19,0.46,26,22,18,4,1.18,81.82,18,8,69.17,Adapte,Adapte,Adapte / Adapte
700,701,2015,Sociologie,15,1,QROC,0.4781,0.59,0.24,32,19,15,4,1.68,78.95,15,17,47.81,Difficile,Difficile,Difficile / Difficile
1530,701,2016,Sociologie,15,1,QROC,0.9558,0.05,0.72,26,26,25,1,1.0,96.15,25,1,95.58,Trop Facile,Trop Facile,Trop Facile / Trop Facile
2360,701,2017,Sociologie,15,1,QROC,0.9129,0.08,0.96,25,23,23,0,1.09,100.0,23,2,91.29,Trop Facile,Trop Facile,Trop Facile / Trop Facile
3190,701,2018,Sociologie,15,1,QROC,0.9698,0.06,0.95,29,28,28,0,1.04,100.0,28,1,96.98,Trop Facile,Trop Facile,Trop Facile / Trop Facile
4020,701,2019,Sociologie,15,1,QROC,0.9026,0.05,0.84,26,23,23,0,1.13,100.0,23,3,90.26,Trop Facile,Trop Facile,Trop Facile / Trop Facile
4850,701,2020,Sociologie,15,1,QROC,0.9553,0.06,0.83,21,20,20,0,1.05,100.0,20,1,95.53,Trop Facile,Trop Facile,Trop Facile / Trop Facile
701,702,2015,Sociologie,15,2,QCM,0.9516,0.07,0.9,32,31,30,1,1.03,96.77,30,2,95.16,Adapte,Trop Facile,Adapte / Trop Facile
1531,702,2016,Sociologie,15,2,QCM,0.6593,0.01,0.64,35,31,23,8,1.13,74.19,23,12,65.93,Trop Facile,Adapte,Trop Facile / Adapte
2361,702,2017,Sociologie,15,2,QCM,0.6849,0.27,0.55,42,31,29,2,1.35,93.55,29,13,68.49,Adapte,Adapte,Adapte / Adapte
3191,702,2018,Sociologie,15,2,QCM,0.7342,0.24,0.44,37,28,27,1,1.32,96.43,27,10,73.42,Adapte,Adapte,Adapte / Adapte
4021,702,2019,Sociologie,15,2,QCM,0.663,0.12,0.51,39,26,26,0,1.5,100.0,26,13,66.3,Adapte,Adapte,Adapte / Adapte
4851,702,2020,Sociologie,15,2,QCM,0.6902,0.13,0.61,44,42,30,12,1.05,71.43,30,14,69.02,Adapte,Adapte,Adapte / Adapte
702,703,2015,Sociologie,15,3,QROC,0.2277,0.86,0.11,17,7,4,3,2.43,57.14,4,13,22.77,Trop Difficile,Trop Difficile,Trop Difficile / Trop Difficile
1532,703,2016,Sociologie,15,3,QROC,0.9314,0.07,0.88,18,17,17,0,1.06,100.0,17,1,93.14,Trop Facile,Trop Facile,Trop Facile / Trop Facile
2362,703,2017,Sociologie,15,3,QROC,0.8709,0.1,0.52,20,19,17,2,1.05,89.47,17,3,87.09,Trop Facile,Trop Facile,Trop Facile / Trop Facile
3192,703,2018,Sociologie,15,3,QROC,0.8391,0.2,0.51,24,23,20,3,1.04,86.96,20,4,83.91,Trop Facile,Facile,Trop Facile / Facile
4022,703,2019,Sociologie,15,3,QROC,0.2701,0.52,0.24,20,19,5,14,1.05,26.32,5,15,27.01,Trop Facile,Difficile,Trop Facile / Difficile
4852,703,2020,Sociologie,15,3,QROC,0.8477,0.08,0.45,17,16,14,2,1.06,87.5,14,3,84.77,Trop Facile,Facile,Trop Facile / Facile
703,704,2015,Sociologie,16,1,QCM,0.5661,0.03,0.38,72,65,41,24,1.11,63.08,41,31,56.61,Adapte,Difficile,Adapte / Difficile
1533,704,2016,Sociologie,16,1,QCM,0.794,0.19,0.71,68,65,54,11,1.05,83.08,54,14,79.4,Trop Facile,Facile,Trop Facile / Facile
2363,704,2017,Sociologie,16,1,QCM,0.9059,0.03,0.8,76,74,69,5,1.03,93.24,69,7,90.59,Trop Facile,Trop Facile,Trop Facile / Trop Facile
3193,704,2018,Sociologie,16,1,QCM,0.9904,0.06,1.0,77,76,76,0,1.01,100.0,76,1,99.04,Trop Facile,Trop Facile,Trop Facile / Trop Facile
4023,704,2019,Sociologie,16,1,QCM,0.0556,0.22,0.26,92,60,5,55,1.53,8.33,5,87,5.56,Trop Facile,Trop Difficile,Trop Facile / Trop Difficile
4853,704,2020,Sociologie,16,1,QCM,0.891,0.09,0.99,79,77,70,7,1.03,90.91,70,9,89.1,Trop Facile,Trop Facile,Trop Facile / Trop Facile
704,705,2015,Sociologie,16,2,QCM,0.5529,0.28,0.32,11,6,6,0,1.83,100.0,6,5,55.29,Difficile,Difficile,Difficile / Difficile
1534,705,2016,Sociologie,16,2,QCM,0.9341,0.03,0.96,13,12,12,0,1.08,100.0,12,1,93.41,Trop Facile,Trop Facile,Trop Facile / Trop Facile
2364,705,2017,Sociologie,16,2,QCM,0.8639,0.01,0.91,15,13,13,0,1.15,100.0,13,2,86.39,Trop Facile,Trop Facile,Trop Facile / Trop Facile
3194,705,2018,Sociologie,16,2,QCM,0.6021,0.14,0.52,15,12,9,3,1.25,75.0,9,6,60.21,Trop Facile,Adapte,Trop Facile / Adapte
4024,705,2019,Sociologie,16,2,QCM,0.6864,0.16,0.7,13,11,9,2,1.18,81.82,9,4,68.64,Adapte,Adapte,Adapte / Adapte
4854,705,2020,Sociologie,16,2,QCM,0.6755,0.04,0.69,14,11,9,2,1.27,81.82,9,5,67.55,Adapte,Adapte,Adapte / Adapte
705,706,2015,Sociologie,16,3,QCU,0.9677,0.02,0.96,92,90,89,1,1.02,98.89,89,3,96.77,Trop Facile,Trop Facile,Trop Facile / Trop Facile
1535,706,2016,Sociologie,16,3,QCU,0.9886,0.04,0.93,99,98,98,0,1.01,100.0,98,1,98.86,Trop Facile,Trop Facile,Trop Facile / Trop Facile
2365,706,2017,Sociologie,16,3,QCU,0.8837,0.0,0.92,85,79,75,4,1.08,94.94,75,10,88.37,Trop Facile,Trop Facile,Trop Facile / Trop Facile
3195,706,2018,Sociologie,16,3,QCU,0.6363,0.04,0.52,97,88,62,26,1.1,70.45,62,35,63.63,Trop Facile,Adapte,Trop Facile / Adapte
4025,706,2019,Sociologie,16,3,QCU,0.6719,0.1,0.57,109,75,73,2,1.45,97.33,73,36,67.19,Adapte,Adapte,Adapte / Adapte
4855,706,2020,Sociologie,16,3,QCU,0.6259,0.05,0.61,100,94,63,31,1.06,67.02,63,37,62.59,Adapte,Adapte,Adapte / Adapte
706,707,2015,Sociologie,17,1,QCU,0.8126,0.18,0.82,96,81,78,3,1.19,96.3,78,18,81.26,Facile,Facile,Facile / Facile
1536,707,2016,Sociologie,17,1,QCU,0.865,0.08,0.92,99,86,86,0,1.15,100.0,86,13,86.5,Trop Facile,Trop Facile,Trop Facile / Trop Facile
2366,707,2017,Sociologie,17,1,QCU,0.8738,0.02,0.9,114,106,100,6,1.08,94.34,100,14,87.38,Trop Facile,Trop Facile,Trop Facile / Trop Facile
3196,707,2018,Sociologie,17,1,QCU,0.3893,0.22,0.38,123,92,48,44,1.34,52.17,48,75,38.93,Trop Facile,Difficile,Trop Facile / Difficile
4026,707,2019,Sociologie,17,1,QCU,0.9478,0.03,0.92,138,131,131,0,1.05,100.0,131,7,94.78,Trop Facile,Trop Facile,Trop Facile / Trop Facile
4856,707,2020,Sociologie,17,1,QCU,0.9442,0.07,0.95,128,123,121,2,1.04,98.37,121,7,94.42,Trop Facile,Trop Facile,Trop Facile / Trop Facile
707,708,2015,Sociologie,18,1,QCM,0.7343,0.08,0.64,17,13,12,1,1.31,92.31,12,5,73.43,Adapte,Adapte,Adapte / Adapte
1537,708,2016,Sociologie,18,1,QCM,0.6447,0.1,0.49,15,12,10,2,1.25,83.33,10,5,64.47,Adapte,Adapte,Adapte / Adapte
2367,708,2017,Sociologie,18,1,QCM,0.6102,0.14,0.42,18,16,11,5,1.12,68.75,11,7,61.02,Adapte,Adapte,Adapte / Adapte
3197,708,2018,Sociologie,18,1,QCM,0.6244,0.16,0.68,14,14,9,5,1.0,64.29,9,5,62.44,Adapte,Adapte,Adapte / Adapte
4027,708,2019,Sociologie,18,1,QCM,0.7366,0.16,0.55,15,12,11,1,1.25,91.67,11,4,73.66,Adapte,Adapte,Adapte / Adapte
4857,708,2020,Sociologie,18,1,QCM,0.6246,0.11,0.59,17,13,11,2,1.31,84.62,11,6,62.46,Adapte,Adapte,Adapte / Adapte
708,709,2015,Sociologie,18,2,QCU,0.659,0.29,0.51,79,75,52,23,1.05,69.33,52,27,65.9,Facile,Adapte,Facile / Adapte
1538,709,2016,Sociologie,18,2,QCU,0.6849,0.02,0.41,70,68,48,20,1.03,70.59,48,22,68.49,Adapte,Adapte,Adapte / Adapte
2368,709,2017,Sociologie,18,2,QCU,0.6682,0.17,0.48,82,75,55,20,1.09,73.33,55,27,66.82,Adapte,Adapte,Adapte / Adapte
3198,709,2018,Sociologie,18,2,QCU,0.7132,0.18,0.48,73,66,52,14,1.11,78.79,52,21,71.32,Adapte,Adapte,Adapte / Adapte
4028,709,2019,Sociologie,18,2,QCU,0.7421,0.1,0.7,58,50,43,7,1.16,86.0,43,15,74.21,Adapte,Adapte,Adapte / Adapte
4858,709,2020,Sociologie,18,2,QCU,0.6818,0.3,0.5,56,53,38,15,1.06,71.7,38,18,68.18,Adapte,Adapte,Adapte / Adapte
709,710,2015,Mathématique,1,1,QCM,0.0667,0.18,0.22,56,53,4,49,1.06,7.55,4,52,6.67,Trop Difficile,Trop Difficile,Trop Difficile / Trop Difficile
1539,710,2016,Mathématique,1,1,QCM,0.8076,0.12,0.77,56,55,45,10,1.02,81.82,45,11,80.76,Trop Facile,Facile,Trop Facile / Facile
2369,710,2017,Mathématique,1,1,QCM,0.7844,0.08,0.76,55,46,43,3,1.2,93.48,43,12,78.44,Trop Facile,Facile,Trop Facile / Facile
3199,710,2018,Mathématique,1,1,QCM,0.9961,0.09,0.87,53,53,53,0,1.0,100.0,53,0,99.61,Trop Facile,Trop Facile,Trop Facile / Trop Facile
4029,710,2019,Mathématique,1,1,QCM,0.9049,0.02,0.84,51,49,46,3,1.04,93.88,46,5,90.49,Trop Facile,Trop Facile,Trop Facile / Trop Facile
4859,710,2020,Mathématique,1,1,QCM,0.617,0.16,0.63,47,33,29,4,1.42,87.88,29,18,61.7,Trop Facile,Adapte,Trop Facile / Adapte
710,711,2015,Mathématique,1,2,QCM,0.7881,0.18,0.75,91,81,72,9,1.12,88.89,72,19,78.81,Difficile,Facile,Difficile / Facile
1540,711,2016,Mathématique,1,2,QCM,0.8699,0.01,0.94,73,72,64,8,1.01,88.89,64,9,86.99,Trop Facile,Trop Facile,Trop Facile / Trop Facile
2370,711,2017,Mathématique,1,2,QCM,0.9911,0.07,0.86,70,70,69,1,1.0,98.57,69,1,99.11,Trop Facile,Trop Facile,Trop Facile / Trop Facile
3200,711,2018,Mathématique,1,2,QCM,0.9409,0.0,0.94,66,63,62,1,1.05,98.41,62,4,94.09,Trop Facile,Trop Facile,Trop Facile / Trop Facile
4030,711,2019,Mathématique,1,2,QCM,0.785,0.07,0.74,78,75,61,14,1.04,81.33,61,17,78.5,Trop Facile,Facile,Trop Facile / Facile
4860,711,2020,Mathématique,1,2,QCM,0.9751,0.09,0.93,72,70,70,0,1.03,100.0,70,2,97.51,Trop Facile,Trop Facile,Trop Facile / Trop Facile
711,712,2015,Mathématique,1,3,QROC,0.75,0.45,0.33,23,22,17,5,1.05,77.27,17,6,75.0,Adapte,Adapte,Adapte / Adapte
1541,712,2016,Mathématique,1,3,QROC,0.6228,0.35,0.33,25,23,16,7,1.09,69.57,16,9,62.28,Adapte,Adapte,Adapte / Adapte
2371,712,2017,Mathématique,1,3,QROC,0.6763,0.23,0.27,30,24,20,4,1.25,83.33,20,10,67.63,Adapte,Adapte,Adapte / Adapte
3201,712,2018,Mathématique,1,3,QROC,0.6687,0.33,0.4,36,33,24,9,1.09,72.73,24,12,66.87,Adapte,Adapte,Adapte / Adapte
4031,712,2019,Mathématique,1,3,QROC,0.6177,0.5,0.31,43,43,27,16,1.0,62.79,27,16,61.77,Adapte,Adapte,Adapte / Adapte
4861,712,2020,Mathématique,1,3,QROC,0.6764,0.37,0.35,36,33,24,9,1.09,72.73,24,12,67.64,Adapte,Adapte,Adapte / Adapte
712,713,2015,Mathématique,1,4,QCM,0.733,0.28,0.54,94,87,69,18,1.08,79.31,69,25,73.3,Trop Difficile,Adapte,Trop Difficile / Adapte
1542,713,2016,Mathématique,1,4,QCM,0.6001,0.15,0.52,98,66,59,7,1.48,89.39,59,39,60.01,Adapte,Adapte,Adapte / Adapte
2372,713,2017,Mathématique,1,4,QCM,0.6357,0.16,0.69,111,99,71,28,1.12,71.72,71,40,63.57,Adapte,Adapte,Adapte / Adapte
3202,713,2018,Mathématique,1,4,QCM,0.6941,0.29,0.41,129,114,90,24,1.13,78.95,90,39,69.41,Adapte,Adapte,Adapte / Adapte
4032,713,2019,Mathématique,1,4,QCM,0.6309,0.08,0.43,122,109,77,32,1.12,70.64,77,45,63.09,Adapte,Adapte,Adapte / Adapte
4862,713,2020,Mathématique,1,4,QCM,0.6977,0.27,0.49,113,92,79,13,1.23,85.87,79,34,69.77,Adapte,Adapte,Adapte / Adapte
713,714,2015,Mathématique,1,5,QCU,0.0348,0.69,0.25,14,12,0,12,1.17,0.0,0,14,3.48,Trop Difficile,Trop Difficile,Trop Difficile / Trop Difficile
1543,714,2016,Mathématique,1,5,QCU,0.9425,0.02,0.95,11,10,10,0,1.1,100.0,10,1,94.25,Trop Facile,Trop Facile,Trop Facile / Trop Facile
2373,714,2017,Mathématique,1,5,QCU,0.9243,0.06,0.91,11,10,10,0,1.1,100.0,10,1,92.43,Trop Facile,Trop Facile,Trop Facile / Trop Facile
3203,714,2018,Mathématique,1,5,QCU,0.8703,0.05,0.97,12,11,10,1,1.09,90.91,10,2,87.03,Trop Facile,Trop Facile,Trop Facile / Trop Facile
4033,714,2019,Mathématique,1,5,QCU,0.9191,0.04,0.97,11,11,10,1,1.0,90.91,10,1,91.91,Trop Facile,Trop Facile,Trop Facile / Trop Facile
4863,714,2020,Mathématique,1,5,QCU,0.993,0.06,0.98,10,10,10,0,1.0,100.0,10,0,99.3,Trop Facile,Trop Facile,Trop Facile / Trop Facile
714,715,2015,Mathématique,1,6,QCU,0.4724,0.19,0.4,53,34,25,9,1.56,73.53,25,28,47.24,Difficile,Difficile,Difficile / Difficile
1544,715,2016,Mathématique,1,6,QCU,0.9007,0.06,0.99,44,44,40,4,1.0,90.91,40,4,90.07,Trop Facile,Trop Facile,Trop Facile / Trop Facile
2374,715,2017,Mathématique,1,6,QCU,0.8887,0.09,0.92,44,41,39,2,1.07,95.12,39,5,88.87,Trop Facile,Trop Facile,Trop Facile / Trop Facile
3204,715,2018,Mathématique,1,6,QCU,0.9627,0.08,0.95,35,34,34,0,1.03,100.0,34,1,96.27,Trop Facile,Trop Facile,Trop Facile / Trop Facile
4034,715,2019,Mathématique,1,6,QCU,0.7131,0.27,0.42,40,32,29,3,1.25,90.62,29,11,71.31,Trop Facile,Adapte,Trop Facile / Adapte
4864,715,2020,Mathématique,1,6,QCU,0.7407,0.2,0.45,36,35,27,8,1.03,77.14,27,9,74.07,Adapte,Adapte,Adapte / Adapte
715,716,2015,Mathématique,1,7,QCM,0.3693,0.01,0.39,31,30,11,19,1.03,36.67,11,20,36.93,Trop Difficile,Difficile,Trop Difficile / Difficile
1545,716,2016,Mathématique,1,7,QCM,0.2212,0.39,0.28,31,25,7,18,1.24,28.0,7,24,22.12,Trop Facile,Trop Difficile,Trop Facile / Trop Difficile
2375,716,2017,Mathématique,1,7,QCM,0.8837,0.07,0.99,27,27,24,3,1.0,88.89,24,3,88.37,Trop Facile,Trop Facile,Trop Facile / Trop Facile
3205,716,2018,Mathématique,1,7,QCM,0.8642,0.07,0.95,27,23,23,0,1.17,100.0,23,4,86.42,Trop Facile,Trop Facile,Trop Facile / Trop Facile
4035,716,2019,Mathématique,1,7,QCM,0.8004,0.16,0.71,22,21,18,3,1.05,85.71,18,4,80.04,Trop Facile,Facile,Trop Facile / Facile
4865,716,2020,Mathématique,1,7,QCM,0.8813,0.04,0.95,26,25,23,2,1.04,92.0,23,3,88.13,Trop Facile,Trop Facile,Trop Facile / Trop Facile
716,717,2015,Mathématique,1,8,QCU,0.8362,0.19,0.75,57,50,48,2,1.14,96.0,48,9,83.62,Facile,Facile,Facile / Facile
1546,717,2016,Mathématique,1,8,QCU,0.9847,0.01,0.93,58,57,57,0,1.02,100.0,57,1,98.47,Trop Facile,Trop Facile,Trop Facile / Trop Facile
2376,717,2017,Mathématique,1,8,QCU,0.9495,0.02,0.9,63,63,60,3,1.0,95.24,60,3,94.95,Trop Facile,Trop Facile,Trop Facile / Trop Facile
3206,717,2018,Mathématique,1,8,QCU,0.793,0.15,0.76,67,63,53,10,1.06,84.13,53,14,79.3,Trop Facile,Facile,Trop Facile / Facile
4036,717,2019,Mathématique,1,8,QCU,0.9629,0.0,1.0,64,63,62,1,1.02,98.41,62,2,96.29,Trop Facile,Trop Facile,Trop Facile / Trop Facile
4866,717,2020,Mathématique,1,8,QCU,0.0708,0.55,0.26,71,31,5,26,2.29,16.13,5,66,7.08,Trop Facile,Trop Difficile,Trop Facile / Trop Difficile
717,718,2015,Mathématique,1,9,QCU,0.6775,0.17,0.56,46,43,31,12,1.07,72.09,31,15,67.75,Adapte,Adapte,Adapte / Adapte
1547,718,2016,Mathématique,1,9,QCU,0.6173,0.05,0.56,43,35,27,8,1.23,77.14,27,16,61.73,Adapte,Adapte,Adapte / Adapte
2377,718,2017,Mathématique,1,9,QCU,0.6093,0.24,0.42,41,30,25,5,1.37,83.33,25,16,60.93,Adapte,Adapte,Adapte / Adapte
3207,718,2018,Mathématique,1,9,QCU,0.6615,0.27,0.64,37,26,24,2,1.42,92.31,24,13,66.15,Adapte,Adapte,Adapte / Adapte
4037,718,2019,Mathématique,1,9,QCU,0.6655,0.28,0.57,37,33,25,8,1.12,75.76,25,12,66.55,Adapte,Adapte,Adapte / Adapte
4867,718,2020,Mathématique,1,9,QCU,0.6435,0.26,0.66,44,35,28,7,1.26,80.0,28,16,64.35,Adapte,Adapte,Adapte / Adapte
718,719,2015,Mathématique,1,10,QCU,0.3035,0.19,0.35,27,22,8,14,1.23,36.36,8,19,30.35,Difficile,Difficile,Difficile / Difficile
1548,719,2016,Mathématique,1,10,QCU,0.968,0.04,0.93,22,22,21,1,1.0,95.45,21,1,96.8,Trop Facile,Trop Facile,Trop Facile / Trop Facile
2378,719,2017,Mathématique,1,10,QCU,0.0464,0.22,0.29,22,13,1,12,1.69,7.69,1,21,4.64,Trop Facile,Trop Difficile,Trop Facile / Trop Difficile
3208,719,2018,Mathématique,1,10,QCU,0.6502,0.25,0.69,23,18,15,3,1.28,83.33,15,8,65.02,Trop Facile,Adapte,Trop Facile / Adapte
4038,719,2019,Mathématique,1,10,QCU,0.6117,0.29,0.48,22,18,13,5,1.22,72.22,13,9,61.17,Adapte,Adapte,Adapte / Adapte
4868,719,2020,Mathématique,1,10,QCU,0.61,0.19,0.49,26,16,16,0,1.62,100.0,16,10,61.0,Adapte,Adapte,Adapte / Adapte
719,720,2015,Mathématique,2,1,QCM,0.0389,0.46,0.28,40,34,2,32,1.18,5.88,2,38,3.89,Trop Facile,Trop Difficile,Trop Facile / Trop Difficile
1549,720,2016,Mathématique,2,1,QCM,0.9547,0.09,0.83,44,43,42,1,1.02,97.67,42,2,95.47,Trop Facile,Trop Facile,Trop Facile / Trop Facile
2379,720,2017,Mathématique,2,1,QCM,0.9453,0.0,0.96,43,41,41,0,1.05,100.0,41,2,94.53,Trop Facile,Trop Facile,Trop Facile / Trop Facile
3209,720,2018,Mathématique,2,1,QCM,0.7023,0.27,0.51,49,41,34,7,1.2,82.93,34,15,70.23,Trop Facile,Adapte,Trop Facile / Adapte
4039,720,2019,Mathématique,2,1,QCM,0.7094,0.12,0.64,44,43,31,12,1.02,72.09,31,13,70.94,Adapte,Adapte,Adapte / Adapte
4869,720,2020,Mathématique,2,1,QCM,0.6092,0.05,0.56,42,41,26,15,1.02,63.41,26,16,60.92,Adapte,Adapte,Adapte / Adapte
720,721,2015,Mathématique,2,2,QCM,0.8445,0.04,0.77,82,71,69,2,1.15,97.18,69,13,84.45,Facile,Facile,Facile / Facile
1550,721,2016,Mathématique,2,2,QCM,0.8364,0.16,0.74,70,61,59,2,1.15,96.72,59,11,83.64,Trop Facile,Facile,Trop Facile / Facile
2380,721,2017,Mathématique,2,2,QCM,0.727,0.2,0.58,68,67,49,18,1.01,73.13,49,19,72.7,Trop Facile,Adapte,Trop Facile / Adapte
3210,721,2018,Mathématique,2,2,QCM,0.63,0.06,0.5,55,45,35,10,1.22,77.78,35,20,63.0,Adapte,Adapte,Adapte / Adapte
4040,721,2019,Mathématique,2,2,QCM,0.6511,0.15,0.46,66,49,43,6,1.35,87.76,43,23,65.11,Adapte,Adapte,Adapte / Adapte
4870,721,2020,Mathématique,2,2,QCM,0.6142,0.28,0.42,55,35,34,1,1.57,97.14,34,21,61.42,Adapte,Adapte,Adapte / Adapte
721,722,2015,Mathématique,2,3,QCU,0.1929,0.63,0.26,73,45,14,31,1.62,31.11,14,59,19.29,Facile,Trop Difficile,Facile / Trop Difficile
1551,722,2016,Mathématique,2,3,QCU,0.8827,0.06,0.98,72,71,64,7,1.01,90.14,64,8,88.27,Trop Facile,Trop Facile,Trop Facile / Trop Facile
2381,722,2017,Mathématique,2,3,QCU,0.0397,0.13,0.28,61,24,2,22,2.54,8.33,2,59,3.97,Trop Facile,Trop Difficile,Trop Facile / Trop Difficile
3211,722,2018,Mathématique,2,3,QCU,0.9962,0.08,0.91,54,54,54,0,1.0,100.0,54,0,99.62,Trop Facile,Trop Facile,Trop Facile / Trop Facile
4041,722,2019,Mathématique,2,3,QCU,0.9739,0.0,0.93,46,45,45,0,1.02,100.0,45,1,97.39,Trop Facile,Trop Facile,Trop Facile / Trop Facile
4871,722,2020,Mathématique,2,3,QCU,0.9302,0.09,0.97,42,41,39,2,1.02,95.12,39,3,93.02,Trop Facile,Trop Facile,Trop Facile / Trop Facile
722,723,2015,Mathématique,3,1,QCU,0.8345,0.05,0.77,22,19,18,1,1.16,94.74,18,4,83.45,Facile,Facile,Facile / Facile
1552,723,2016,Mathématique,3,1,QCU,0.9161,0.02,0.93,23,22,21,1,1.05,95.45,21,2,91.61,Trop Facile,Trop Facile,Trop Facile / Trop Facile
2382,723,2017,Mathématique,3,1,QCU,0.8937,0.08,1.0,21,20,19,1,1.05,95.0,19,2,89.37,Trop Facile,Trop Facile,Trop Facile / Trop Facile
3212,723,2018,Mathématique,3,1,QCU,0.6423,0.23,0.69,23,18,15,3,1.28,83.33,15,8,64.23,Trop Facile,Adapte,Trop Facile / Adapte
4042,723,2019,Mathématique,3,1,QCU,0.6494,0.06,0.52,22,18,14,4,1.22,77.78,14,8,64.94,Adapte,Adapte,Adapte / Adapte
4872,723,2020,Mathématique,3,1,QCU,0.6902,0.06,0.62,22,20,15,5,1.1,75.0,15,7,69.02,Adapte,Adapte,Adapte / Adapte
723,724,2015,Mathématique,3,2,QCM,0.9996,0.02,0.99,31,31,31,0,1.0,100.0,31,0,99.96,Trop Facile,Trop Facile,Trop Facile / Trop Facile
1553,724,2016,Mathématique,3,2,QCM,0.8694,0.09,0.97,32,31,28,3,1.03,90.32,28,4,86.94,Trop Facile,Trop Facile,Trop Facile / Trop Facile
2383,724,2017,Mathématique,3,2,QCM,0.9731,0.09,0.86,30,30,29,1,1.0,96.67,29,1,97.31,Trop Facile,Trop Facile,Trop Facile / Trop Facile
3213,724,2018,Mathématique,3,2,QCM,0.8811,0.03,0.84,31,31,27,4,1.0,87.1,27,4,88.11,Trop Facile,Trop Facile,Trop Facile / Trop Facile
4043,724,2019,Mathématique,3,2,QCM,0.973,0.1,0.88,28,27,27,0,1.04,100.0,27,1,97.3,Trop Facile,Trop Facile,Trop Facile / Trop Facile
4873,724,2020,Mathématique,3,2,QCM,0.9968,0.08,0.94,22,22,22,0,1.0,100.0,22,0,99.68,Trop Facile,Trop Facile,Trop Facile / Trop Facile
724,725,2015,Mathématique,3,3,QCU,0.9879,0.03,0.96,50,50,49,1,1.0,98.0,49,1,98.79,Trop Facile,Trop Facile,Trop Facile / Trop Facile
1554,725,2016,Mathématique,3,3,QCU,0.9181,0.05,0.94,41,39,38,1,1.05,97.44,38,3,91.81,Trop Facile,Trop Facile,Trop Facile / Trop Facile
2384,725,2017,Mathématique,3,3,QCU,0.906,0.09,0.91,41,38,37,1,1.08,97.37,37,4,90.6,Trop Facile,Trop Facile,Trop Facile / Trop Facile
3214,725,2018,Mathématique,3,3,QCU,0.9165,0.05,0.94,46,46,42,4,1.0,91.3,42,4,91.65,Trop Facile,Trop Facile,Trop Facile / Trop Facile
4044,725,2019,Mathématique,3,3,QCU,0.9306,0.09,0.96,45,42,42,0,1.07,100.0,42,3,93.06,Trop Facile,Trop Facile,Trop Facile / Trop Facile
4874,725,2020,Mathématique,3,3,QCU,0.9779,0.04,0.95,48,47,47,0,1.02,100.0,47,1,97.79,Trop Facile,Trop Facile,Trop Facile / Trop Facile
725,726,2015,Mathématique,3,4,QCU,0.8112,0.11,0.78,79,66,64,2,1.2,96.97,64,15,81.12,Facile,Facile,Facile / Facile
1555,726,2016,Mathématique,3,4,QCU,0.8921,0.05,0.92,73,73,65,8,1.0,89.04,65,8,89.21,Trop Facile,Trop Facile,Trop Facile / Trop Facile
2385,726,2017,Mathématique,3,4,QCU,0.9401,0.08,0.93,64,62,60,2,1.03,96.77,60,4,94.01,Trop Facile,Trop Facile,Trop Facile / Trop Facile
3215,726,2018,Mathématique,3,4,QCU,0.92,0.06,0.93,76,72,70,2,1.06,97.22,70,6,92.0,Trop Facile,Trop Facile,Trop Facile / Trop Facile
4045,726,2019,Mathématique,3,4,QCU,0.9752,0.02,0.94,82,81,80,1,1.01,98.77,80,2,97.52,Trop Facile,Trop Facile,Trop Facile / Trop Facile
4875,726,2020,Mathématique,3,4,QCU,0.9623,0.09,0.99,66,65,64,1,1.02,98.46,64,2,96.23,Trop Facile,Trop Facile,Trop Facile / Trop Facile
726,727,2015,Mathématique,3,5,QCM,0.5121,0.26,0.33,14,9,7,2,1.56,77.78,7,7,51.21,Difficile,Difficile,Difficile / Difficile
1556,727,2016,Mathématique,3,5,QCM,0.9453,0.05,0.9,16,15,15,0,1.07,100.0,15,1,94.53,Trop Facile,Trop Facile,Trop Facile / Trop Facile
2386,727,2017,Mathématique,3,5,QCM,0.8943,0.03,0.84,18,16,16,0,1.12,100.0,16,2,89.43,Trop Facile,Trop Facile,Trop Facile / Trop Facile
3216,727,2018,Mathématique,3,5,QCM,0.9136,0.05,0.87,18,16,16,0,1.12,100.0,16,2,91.36,Trop Facile,Trop Facile,Trop Facile / Trop Facile
4046,727,2019,Mathématique,3,5,QCM,0.9898,0.08,0.95,14,14,14,0,1.0,100.0,14,0,98.98,Trop Facile,Trop Facile,Trop Facile / Trop Facile
4876,727,2020,Mathématique,3,5,QCM,0.6253,0.1,0.68,17,12,11,1,1.42,91.67,11,6,62.53,Trop Facile,Adapte,Trop Facile / Adapte
727,728,2015,Mathématique,3,6,QCM,0.2044,0.56,0.2,77,39,16,23,1.97,41.03,16,61,20.44,Trop Difficile,Trop Difficile,Trop Difficile / Trop Difficile
1557,728,2016,Mathématique,3,6,QCM,0.9281,0.06,0.98,91,85,84,1,1.07,98.82,84,7,92.81,Trop Facile,Trop Facile,Trop Facile / Trop Facile
2387,728,2017,Mathématique,3,6,QCM,0.4625,0.41,0.4,90,89,42,47,1.01,47.19,42,48,46.25,Trop Facile,Difficile,Trop Facile / Difficile
3217,728,2018,Mathématique,3,6,QCM,0.9108,0.06,0.94,90,87,82,5,1.03,94.25,82,8,91.08,Trop Facile,Trop Facile,Trop Facile / Trop Facile
4047,728,2019,Mathématique,3,6,QCM,0.9645,0.02,0.89,81,78,78,0,1.04,100.0,78,3,96.45,Trop Facile,Trop Facile,Trop Facile / Trop Facile
4877,728,2020,Mathématique,3,6,QCM,0.9438,0.03,0.83,94,92,89,3,1.02,96.74,89,5,94.38,Trop Facile,Trop Facile,Trop Facile / Trop Facile
728,729,2015,Mathématique,3,7,QCM,0.8753,0.02,0.92,75,74,66,8,1.01,89.19,66,9,87.53,Trop Facile,Trop Facile,Trop Facile / Trop Facile
1558,729,2016,Mathématique,3,7,QCM,0.984,0.07,0.99,66,65,65,0,1.02,100.0,65,1,98.4,Trop Facile,Trop Facile,Trop Facile / Trop Facile
2388,729,2017,Mathématique,3,7,QCM,0.9762,0.06,0.9,63,63,62,1,1.0,98.41,62,1,97.62,Trop Facile,Trop Facile,Trop Facile / Trop Facile
3218,729,2018,Mathématique,3,7,QCM,0.2601,0.17,0.37,56,27,15,12,2.07,55.56,15,41,26.01,Trop Facile,Difficile,Trop Facile / Difficile
4048,729,2019,Mathématique,3,7,QCM,0.885,0.01,0.9,64,57,57,0,1.12,100.0,57,7,88.5,Trop Facile,Trop Facile,Trop Facile / Trop Facile
4878,729,2020,Mathématique,3,7,QCM,0.924,0.07,0.85,54,51,50,1,1.06,98.04,50,4,92.4,Trop Facile,Trop Facile,Trop Facile / Trop Facile
729,730,2015,Mathématique,3,8,QCM,0.1906,0.5,0.22,77,73,15,58,1.05,20.55,15,62,19.06,Trop Facile,Trop Difficile,Trop Facile / Trop Difficile
1559,730,2016,Mathématique,3,8,QCM,0.8643,0.08,0.84,92,90,80,10,1.02,88.89,80,12,86.43,Trop Facile,Trop Facile,Trop Facile / Trop Facile
2389,730,2017,Mathématique,3,8,QCM,0.0754,0.6,0.23,106,55,8,47,1.93,14.55,8,98,7.54,Trop Facile,Trop Difficile,Trop Facile / Trop Difficile
3219,730,2018,Mathématique,3,8,QCM,0.9408,0.1,0.92,112,112,105,7,1.0,93.75,105,7,94.08,Trop Facile,Trop Facile,Trop Facile / Trop Facile
4049,730,2019,Mathématique,3,8,QCM,0.1701,0.32,0.29,111,41,19,22,2.71,46.34,19,92,17.01,Trop Facile,Trop Difficile,Trop Facile / Trop Difficile
4879,730,2020,Mathématique,3,8,QCM,0.8798,0.01,0.89,124,122,109,13,1.02,89.34,109,15,87.98,Trop Facile,Trop Facile,Trop Facile / Trop Facile
730,731,2015,Mathématique,3,9,QCM,0.0188,0.48,0.22,7,5,0,5,1.4,0.0,0,7,1.88,Trop Difficile,Trop Difficile,Trop Difficile / Trop Difficile
1560,731,2016,Mathématique,3,9,QCM,0.8901,0.09,0.86,7,7,6,1,1.0,85.71,6,1,89.01,Trop Facile,Trop Facile,Trop Facile / Trop Facile
2390,731,2017,Mathématique,3,9,QCM,0.9987,0.01,0.93,7,7,7,0,1.0,100.0,7,0,99.87,Trop Facile,Trop Facile,Trop Facile / Trop Facile
3220,731,2018,Mathématique,3,9,QCM,0.9974,0.04,0.81,6,6,6,0,1.0,100.0,6,0,99.74,Trop Facile,Trop Facile,Trop Facile / Trop Facile
4050,731,2019,Mathématique,3,9,QCM,0.141,0.73,0.29,6,4,1,3,1.5,25.0,1,5,14.1,Trop Facile,Trop Difficile,Trop Facile / Trop Difficile
4880,731,2020,Mathématique,3,9,QCM,0.9293,0.0,0.92,5,5,5,0,1.0,100.0,5,0,92.93,Trop Facile,Trop Facile,Trop Facile / Trop Facile
731,732,2015,Mathématique,3,10,QCU,0.9967,0.09,0.9,42,42,42,0,1.0,100.0,42,0,99.67,Trop Facile,Trop Facile,Trop Facile / Trop Facile
1561,732,2016,Mathématique,3,10,QCU,0.9803,0.07,0.97,45,45,44,1,1.0,97.78,44,1,98.03,Trop Facile,Trop Facile,Trop Facile / Trop Facile
2391,732,2017,Mathématique,3,10,QCU,0.4348,0.3,0.35,46,35,20,15,1.31,57.14,20,26,43.48,Trop Facile,Difficile,Trop Facile / Difficile
3221,732,2018,Mathématique,3,10,QCU,0.9362,0.09,0.95,52,51,49,2,1.02,96.08,49,3,93.62,Trop Facile,Trop Facile,Trop Facile / Trop Facile
4051,732,2019,Mathématique,3,10,QCU,0.8618,0.07,0.94,54,54,47,7,1.0,87.04,47,7,86.18,Trop Facile,Trop Facile,Trop Facile / Trop Facile
4881,732,2020,Mathématique,3,10,QCU,0.8895,0.02,0.99,44,40,39,1,1.1,97.5,39,5,88.95,Trop Facile,Trop Facile,Trop Facile / Trop Facile
732,733,2015,Mathématique,3,11,QCU,0.2248,0.15,0.23,24,12,5,7,2.0,41.67,5,19,22.48,Trop Facile,Trop Difficile,Trop Facile / Trop Difficile
1562,733,2016,Mathématique,3,11,QCU,0.1389,0.3,0.26,22,10,3,7,2.2,30.0,3,19,13.89,Trop Facile,Trop Difficile,Trop Facile / Trop Difficile
2392,733,2017,Mathématique,3,11,QCU,0.7846,0.18,0.83,25,22,20,2,1.14,90.91,20,5,78.46,Trop Facile,Facile,Trop Facile / Facile
3222,733,2018,Mathématique,3,11,QCU,0.8667,0.01,0.93,25,23,22,1,1.09,95.65,22,3,86.67,Trop Facile,Trop Facile,Trop Facile / Trop Facile
4052,733,2019,Mathématique,3,11,QCU,0.8336,0.16,0.82,20,18,17,1,1.11,94.44,17,3,83.36,Trop Facile,Facile,Trop Facile / Facile
4882,733,2020,Mathématique,3,11,QCU,0.9633,0.03,0.94,20,19,19,0,1.05,100.0,19,1,96.33,Trop Facile,Trop Facile,Trop Facile / Trop Facile
733,734,2015,Mathématique,3,12,QCU,0.2975,0.29,0.38,58,56,17,39,1.04,30.36,17,41,29.75,Trop Facile,Difficile,Trop Facile / Difficile
1563,734,2016,Mathématique,3,12,QCU,0.9299,0.09,0.99,51,48,47,1,1.06,97.92,47,4,92.99,Trop Facile,Trop Facile,Trop Facile / Trop Facile
2393,734,2017,Mathématique,3,12,QCU,0.9804,0.06,0.91,47,46,46,0,1.02,100.0,46,1,98.04,Trop Facile,Trop Facile,Trop Facile / Trop Facile
3223,734,2018,Mathématique,3,12,QCU,0.8937,0.08,0.99,42,40,38,2,1.05,95.0,38,4,89.37,Trop Facile,Trop Facile,Trop Facile / Trop Facile
4053,734,2019,Mathématique,3,12,QCU,0.9306,0.08,0.91,44,44,41,3,1.0,93.18,41,3,93.06,Trop Facile,Trop Facile,Trop Facile / Trop Facile
4883,734,2020,Mathématique,3,12,QCU,0.8357,0.03,0.88,42,39,35,4,1.08,89.74,35,7,83.57,Trop Facile,Facile,Trop Facile / Facile
734,735,2015,Mathématique,3,13,QCM,0.9922,0.1,0.87,46,46,46,0,1.0,100.0,46,0,99.22,Trop Facile,Trop Facile,Trop Facile / Trop Facile
1564,735,2016,Mathématique,3,13,QCM,0.8342,0.02,0.76,48,48,40,8,1.0,83.33,40,8,83.42,Trop Facile,Facile,Trop Facile / Facile
2394,735,2017,Mathématique,3,13,QCM,0.8942,0.04,0.91,57,52,51,1,1.1,98.08,51,6,89.42,Trop Facile,Trop Facile,Trop Facile / Trop Facile
3224,735,2018,Mathématique,3,13,QCM,0.9758,0.1,0.91,52,51,51,0,1.02,100.0,51,1,97.58,Trop Facile,Trop Facile,Trop Facile / Trop Facile
4054,735,2019,Mathématique,3,13,QCM,0.9417,0.1,0.8,62,61,58,3,1.02,95.08,58,4,94.17,Trop Facile,Trop Facile,Trop Facile / Trop Facile
4884,735,2020,Mathématique,3,13,QCM,0.9608,0.1,0.81,52,52,50,2,1.0,96.15,50,2,96.08,Trop Facile,Trop Facile,Trop Facile / Trop Facile
735,736,2015,Mathématique,4,1,QCU,0.0311,0.46,0.24,91,55,3,52,1.65,5.45,3,88,3.11,Trop Difficile,Trop Difficile,Trop Difficile / Trop Difficile
1565,736,2016,Mathématique,4,1,QCU,0.8134,0.1,0.86,108,107,88,19,1.01,82.24,88,20,81.34,Trop Facile,Facile,Trop Facile / Facile
2395,736,2017,Mathématique,4,1,QCU,0.8885,0.09,0.98,124,112,110,2,1.11,98.21,110,14,88.85,Trop Facile,Trop Facile,Trop Facile / Trop Facile
3225,736,2018,Mathématique,4,1,QCU,0.966,0.09,0.94,124,121,120,1,1.02,99.17,120,4,96.6,Trop Facile,Trop Facile,Trop Facile / Trop Facile
4055,736,2019,Mathématique,4,1,QCU,0.8834,0.06,0.92,99,96,87,9,1.03,90.62,87,12,88.34,Trop Facile,Trop Facile,Trop Facile / Trop Facile
4885,736,2020,Mathématique,4,1,QCU,0.9984,0.09,1.0,109,109,109,0,1.0,100.0,109,0,99.84,Trop Facile,Trop Facile,Trop Facile / Trop Facile
736,737,2015,Mathématique,4,2,QCM,0.2637,0.18,0.32,82,80,22,58,1.02,27.5,22,60,26.37,Difficile,Difficile,Difficile / Difficile
1566,737,2016,Mathématique,4,2,QCM,0.5602,0.47,0.34,96,74,54,20,1.3,72.97,54,42,56.02,Trop Facile,Difficile,Trop Facile / Difficile
2396,737,2017,Mathématique,4,2,QCM,0.7212,0.24,0.41,103,102,74,28,1.01,72.55,74,29,72.12,Trop Facile,Adapte,Trop Facile / Adapte
3226,737,2018,Mathématique,4,2,QCM,0.6549,0.1,0.52,114,91,75,16,1.25,82.42,75,39,65.49,Adapte,Adapte,Adapte / Adapte
4056,737,2019,Mathématique,4,2,QCM,0.6198,0.0,0.56,116,99,72,27,1.17,72.73,72,44,61.98,Adapte,Adapte,Adapte / Adapte
4886,737,2020,Mathématique,4,2,QCM,0.7027,0.2,0.57,104,94,73,21,1.11,77.66,73,31,70.27,Adapte,Adapte,Adapte / Adapte
737,738,2015,Mathématique,4,3,QCU,0.9445,0.03,0.99,73,72,69,3,1.01,95.83,69,4,94.45,Trop Facile,Trop Facile,Trop Facile / Trop Facile
1567,738,2016,Mathématique,4,3,QCU,0.8667,0.09,0.94,80,70,69,1,1.14,98.57,69,11,86.67,Trop Facile,Trop Facile,Trop Facile / Trop Facile
2397,738,2017,Mathématique,4,3,QCU,0.974,0.07,0.95,83,82,81,1,1.01,98.78,81,2,97.4,Trop Facile,Trop Facile,Trop Facile / Trop Facile
3227,738,2018,Mathématique,4,3,QCU,0.9782,0.09,0.98,100,100,98,2,1.0,98.0,98,2,97.82,Trop Facile,Trop Facile,Trop Facile / Trop Facile
4057,738,2019,Mathématique,4,3,QCU,0.9604,0.02,0.93,88,86,85,1,1.02,98.84,85,3,96.04,Trop Facile,Trop Facile,Trop Facile / Trop Facile
4887,738,2020,Mathématique,4,3,QCU,0.9708,0.03,0.97,85,85,83,2,1.0,97.65,83,2,97.08,Trop Facile,Trop Facile,Trop Facile / Trop Facile
738,739,2015,Mathématique,4,4,QCM,0.8952,0.08,0.99,35,34,31,3,1.03,91.18,31,4,89.52,Trop Facile,Trop Facile,Trop Facile / Trop Facile
1568,739,2016,Mathématique,4,4,QCM,0.9881,0.02,0.86,32,32,32,0,1.0,100.0,32,0,98.81,Trop Facile,Trop Facile,Trop Facile / Trop Facile
2398,739,2017,Mathématique,4,4,QCM,0.9749,0.01,0.81,29,29,28,1,1.0,96.55,28,1,97.49,Trop Facile,Trop Facile,Trop Facile / Trop Facile
3228,739,2018,Mathématique,4,4,QCM,0.711,0.15,0.69,31,24,22,2,1.29,91.67,22,9,71.1,Trop Facile,Adapte,Trop Facile / Adapte
4058,739,2019,Mathématique,4,4,QCM,0.6729,0.12,0.42,25,21,17,4,1.19,80.95,17,8,67.29,Adapte,Adapte,Adapte / Adapte
4888,739,2020,Mathématique,4,4,QCM,0.6127,0.09,0.62,23,19,14,5,1.21,73.68,14,9,61.27,Adapte,Adapte,Adapte / Adapte
739,740,2015,Mathématique,5,1,QCM,0.8174,0.09,0.79,99,86,81,5,1.15,94.19,81,18,81.74,Facile,Facile,Facile / Facile
1569,740,2016,Mathématique,5,1,QCM,0.9565,0.03,0.96,92,91,88,3,1.01,96.7,88,4,95.65,Trop Facile,Trop Facile,Trop Facile / Trop Facile
2399,740,2017,Mathématique,5,1,QCM,0.9037,0.03,0.9,81,73,73,0,1.11,100.0,73,8,90.37,Trop Facile,Trop Facile,Trop Facile / Trop Facile
3229,740,2018,Mathématique,5,1,QCM,0.9818,0.1,0.93,81,81,80,1,1.0,98.77,80,1,98.18,Trop Facile,Trop Facile,Trop Facile / Trop Facile
4059,740,2019,Mathématique,5,1,QCM,0.9444,0.07,0.95,83,79,78,1,1.05,98.73,78,5,94.44,Trop Facile,Trop Facile,Trop Facile / Trop Facile
4889,740,2020,Mathématique,5,1,QCM,0.0161,0.28,0.29,96,73,2,71,1.32,2.74,2,94,1.61,Trop Facile,Trop Difficile,Trop Facile / Trop Difficile
740,741,2015,Mathématique,5,2,QCU,0.7689,0.17,0.82,46,43,35,8,1.07,81.4,35,11,76.89,Facile,Facile,Facile / Facile
1570,741,2016,Mathématique,5,2,QCU,0.6891,0.0,0.64,40,35,28,7,1.14,80.0,28,12,68.91,Trop Facile,Adapte,Trop Facile / Adapte
2400,741,2017,Mathématique,5,2,QCU,0.6501,0.03,0.46,39,30,25,5,1.3,83.33,25,14,65.01,Adapte,Adapte,Adapte / Adapte
3230,741,2018,Mathématique,5,2,QCU,0.6674,0.29,0.46,42,40,28,12,1.05,70.0,28,14,66.74,Adapte,Adapte,Adapte / Adapte
4060,741,2019,Mathématique,5,2,QCU,0.7212,0.14,0.45,38,35,27,8,1.09,77.14,27,11,72.12,Adapte,Adapte,Adapte / Adapte
4890,741,2020,Mathématique,5,2,QCU,0.6737,0.13,0.6,46,40,31,9,1.15,77.5,31,15,67.37,Adapte,Adapte,Adapte / Adapte
741,742,2015,Mathématique,5,3,QO,0.3857,0.81,0.06,74,71,29,42,1.04,40.85,29,45,38.57,Difficile,Difficile,Difficile / Difficile
1571,742,2016,Mathématique,5,3,QO,0.8985,0.02,0.57,80,77,72,5,1.04,93.51,72,8,89.85,Trop Facile,Trop Facile,Trop Facile / Trop Facile
2401,742,2017,Mathématique,5,3,QO,0.7404,0.7,0.24,64,57,47,10,1.12,82.46,47,17,74.04,Trop Facile,Adapte,Trop Facile / Adapte
3231,742,2018,Mathématique,5,3,QO,0.7213,0.23,0.25,68,67,49,18,1.01,73.13,49,19,72.13,Adapte,Adapte,Adapte / Adapte
4061,742,2019,Mathématique,5,3,QO,0.7104,0.3,0.18,78,73,55,18,1.07,75.34,55,23,71.04,Adapte,Adapte,Adapte / Adapte
4891,742,2020,Mathématique,5,3,QO,0.7472,0.44,0.21,63,55,47,8,1.15,85.45,47,16,74.72,Adapte,Adapte,Adapte / Adapte
742,743,2015,Mathématique,5,4,QCU,0.1783,0.3,0.21,93,84,17,67,1.11,20.24,17,76,17.83,Trop Facile,Trop Difficile,Trop Facile / Trop Difficile
1572,743,2016,Mathématique,5,4,QCU,0.9847,0.0,0.91,77,76,76,0,1.01,100.0,76,1,98.47,Trop Facile,Trop Facile,Trop Facile / Trop Facile
2402,743,2017,Mathématique,5,4,QCU,0.8653,0.08,0.91,83,77,72,5,1.08,93.51,72,11,86.53,Trop Facile,Trop Facile,Trop Facile / Trop Facile
3232,743,2018,Mathématique,5,4,QCU,0.9586,0.04,0.94,100,97,96,1,1.03,98.97,96,4,95.86,Trop Facile,Trop Facile,Trop Facile / Trop Facile
4062,743,2019,Mathématique,5,4,QCU,0.9268,0.0,0.92,98,96,91,5,1.02,94.79,91,7,92.68,Trop Facile,Trop Facile,Trop Facile / Trop Facile
4892,743,2020,Mathématique,5,4,QCU,0.9659,0.1,0.99,98,97,95,2,1.01,97.94,95,3,96.59,Trop Facile,Trop Facile,Trop Facile / Trop Facile
743,744,2015,Mathématique,5,5,QCU,0.0806,0.13,0.29,30,16,2,14,1.88,12.5,2,28,8.06,Trop Difficile,Trop Difficile,Trop Difficile / Trop Difficile
1573,744,2016,Mathématique,5,5,QCU,0.8683,0.05,0.91,33,31,29,2,1.06,93.55,29,4,86.83,Trop Facile,Trop Facile,Trop Facile / Trop Facile
2403,744,2017,Mathématique,5,5,QCU,0.4096,0.25,0.33,28,21,11,10,1.33,52.38,11,17,40.96,Trop Facile,Difficile,Trop Facile / Difficile
3233,744,2018,Mathématique,5,5,QCU,0.899,0.06,0.98,25,24,22,2,1.04,91.67,22,3,89.9,Trop Facile,Trop Facile,Trop Facile / Trop Facile
4063,744,2019,Mathématique,5,5,QCU,0.9124,0.07,0.98,25,24,23,1,1.04,95.83,23,2,91.24,Trop Facile,Trop Facile,Trop Facile / Trop Facile
4893,744,2020,Mathématique,5,5,QCU,0.8863,0.03,0.99,21,20,19,1,1.05,95.0,19,2,88.63,Trop Facile,Trop Facile,Trop Facile / Trop Facile
744,745,2015,Mathématique,6,1,QCU,0.218,0.05,0.2,33,15,7,8,2.2,46.67,7,26,21.8,Trop Difficile,Trop Difficile,Trop Difficile / Trop Difficile
1574,745,2016,Mathématique,6,1,QCU,0.665,0.17,0.44,26,20,17,3,1.3,85.0,17,9,66.5,Trop Facile,Adapte,Trop Facile / Adapte
2404,745,2017,Mathématique,6,1,QCU,0.7368,0.2,0.58,22,18,16,2,1.22,88.89,16,6,73.68,Adapte,Adapte,Adapte / Adapte
3234,745,2018,Mathématique,6,1,QCU,0.6747,0.21,0.62,20,16,13,3,1.25,81.25,13,7,67.47,Adapte,Adapte,Adapte / Adapte
4064,745,2019,Mathématique,6,1,QCU,0.7341,0.01,0.49,17,14,12,2,1.21,85.71,12,5,73.41,Adapte,Adapte,Adapte / Adapte
4894,745,2020,Mathématique,6,1,QCU,0.6028,0.29,0.63,16,11,10,1,1.45,90.91,10,6,60.28,Adapte,Adapte,Adapte / Adapte
745,746,2015,Mathématique,6,2,QO,0.7963,0.17,0.57,23,20,18,2,1.15,90.0,18,5,79.63,Facile,Facile,Facile / Facile
1575,746,2016,Mathématique,6,2,QO,0.9546,0.01,0.76,28,28,27,1,1.0,96.43,27,1,95.46,Trop Facile,Trop Facile,Trop Facile / Trop Facile
2405,746,2017,Mathématique,6,2,QO,0.9841,0.09,0.79,27,27,27,0,1.0,100.0,27,0,98.41,Trop Facile,Trop Facile,Trop Facile / Trop Facile
3235,746,2018,Mathématique,6,2,QO,0.9562,0.05,0.84,25,24,24,0,1.04,100.0,24,1,95.62,Trop Facile,Trop Facile,Trop Facile / Trop Facile
4065,746,2019,Mathématique,6,2,QO,0.5172,0.8,0.14,28,18,14,4,1.56,77.78,14,14,51.72,Trop Facile,Difficile,Trop Facile / Difficile
4895,746,2020,Mathématique,6,2,QO,0.6221,0.48,0.24,29,27,18,9,1.07,66.67,18,11,62.21,Trop Facile,Adapte,Trop Facile / Adapte
746,747,2015,Mathématique,6,3,QROC,0.9317,0.04,1.0,86,82,80,2,1.05,97.56,80,6,93.17,Trop Difficile,Trop Facile,Trop Difficile / Trop Facile
1576,747,2016,Mathématique,6,3,QROC,0.8916,0.04,0.59,70,70,62,8,1.0,88.57,62,8,89.16,Trop Facile,Trop Facile,Trop Facile / Trop Facile
2406,747,2017,Mathématique,6,3,QROC,0.3367,0.72,0.22,73,44,25,19,1.66,56.82,25,48,33.67,Trop Facile,Difficile,Trop Facile / Difficile
3236,747,2018,Mathématique,6,3,QROC,0.8864,0.04,0.52,86,84,76,8,1.02,90.48,76,10,88.64,Trop Facile,Trop Facile,Trop Facile / Trop Facile
4066,747,2019,Mathématique,6,3,QROC,0.3428,0.57,0.22,79,72,27,45,1.1,37.5,27,52,34.28,Trop Facile,Difficile,Trop Facile / Difficile
4896,747,2020,Mathématique,6,3,QROC,0.6465,0.39,0.25,82,60,53,7,1.37,88.33,53,29,64.65,Trop Facile,Adapte,Trop Facile / Adapte
747,748,2015,Mathématique,6,4,QROC,0.0322,0.93,0.1,5,3,0,3,1.67,0.0,0,5,3.22,Adapte,Trop Difficile,Adapte / Trop Difficile
1577,748,2016,Mathématique,6,4,QROC,0.9588,0.03,0.89,4,4,4,0,1.0,100.0,4,0,95.88,Trop Facile,Trop Facile,Trop Facile / Trop Facile
2407,748,2017,Mathématique,6,4,QROC,0.8443,0.1,0.6,5,4,4,0,1.25,100.0,4,1,84.43,Trop Facile,Facile,Trop Facile / Facile
3237,748,2018,Mathématique,6,4,QROC,0.8762,0.02,0.54,4,4,4,0,1.0,100.0,4,0,87.62,Trop Facile,Trop Facile,Trop Facile / Trop Facile
4067,748,2019,Mathématique,6,4,QROC,0.066,0.75,0.05,4,2,0,2,2.0,0.0,0,4,6.6,Trop Facile,Trop Difficile,Trop Facile / Trop Difficile
4897,748,2020,Mathématique,6,4,QROC,0.9313,0.04,0.94,3,3,3,0,1.0,100.0,3,0,93.13,Trop Facile,Trop Facile,Trop Facile / Trop Facile
748,749,2015,Mathématique,6,5,QCU,0.4808,0.19,0.39,87,70,42,28,1.24,60.0,42,45,48.08,Difficile,Difficile,Difficile / Difficile
1578,749,2016,Mathématique,6,5,QCU,0.3171,0.24,0.37,95,66,30,36,1.44,45.45,30,65,31.71,Trop Facile,Difficile,Trop Facile / Difficile
2408,749,2017,Mathématique,6,5,QCU,0.3224,0.19,0.33,104,55,34,21,1.89,61.82,34,70,32.24,Trop Facile,Difficile,Trop Facile / Difficile
3238,749,2018,Mathématique,6,5,QCU,0.8873,0.0,0.96,105,99,93,6,1.06,93.94,93,12,88.73,Trop Facile,Trop Facile,Trop Facile / Trop Facile
4068,749,2019,Mathématique,6,5,QCU,0.9107,0.05,0.97,121,115,110,5,1.05,95.65,110,11,91.07,Trop Facile,Trop Facile,Trop Facile / Trop Facile
4898,749,2020,Mathématique,6,5,QCU,0.961,0.08,0.99,145,143,139,4,1.01,97.2,139,6,96.1,Trop Facile,Trop Facile,Trop Facile / Trop Facile
749,750,2015,Mathématique,6,6,QCM,0.7755,0.05,0.72,52,51,40,11,1.02,78.43,40,12,77.55,Trop Facile,Facile,Trop Facile / Facile
1579,750,2016,Mathématique,6,6,QCM,0.8937,0.06,0.9,58,52,52,0,1.12,100.0,52,6,89.37,Trop Facile,Trop Facile,Trop Facile / Trop Facile
2409,750,2017,Mathématique,6,6,QCM,0.8656,0.02,0.9,51,48,44,4,1.06,91.67,44,7,86.56,Trop Facile,Trop Facile,Trop Facile / Trop Facile
3239,750,2018,Mathématique,6,6,QCM,0.6015,0.23,0.44,44,31,26,5,1.42,83.87,26,18,60.15,Trop Facile,Adapte,Trop Facile / Adapte
4069,750,2019,Mathématique,6,6,QCM,0.6306,0.24,0.44,39,33,25,8,1.18,75.76,25,14,63.06,Adapte,Adapte,Adapte / Adapte
4899,750,2020,Mathématique,6,6,QCM,0.6389,0.18,0.44,46,32,29,3,1.44,90.62,29,17,63.89,Adapte,Adapte,Adapte / Adapte
750,751,2015,Mathématique,6,7,QCU,0.0084,0.0,0.26,7,3,0,3,2.33,0.0,0,7,0.84,Trop Difficile,Trop Difficile,Trop Difficile / Trop Difficile
1580,751,2016,Mathématique,6,7,QCU,0.8141,0.08,0.9,7,7,6,1,1.0,85.71,6,1,81.41,Trop Facile,Facile,Trop Facile / Facile
2410,751,2017,Mathématique,6,7,QCU,0.9265,0.09,0.98,7,6,6,0,1.17,100.0,6,1,92.65,Trop Facile,Trop Facile,Trop Facile / Trop Facile
3240,751,2018,Mathématique,6,7,QCU,0.8744,0.09,0.91,6,5,5,0,1.2,100.0,5,1,87.44,Trop Facile,Trop Facile,Trop Facile / Trop Facile
4070,751,2019,Mathématique,6,7,QCU,0.9988,0.09,0.97,5,5,5,0,1.0,100.0,5,0,99.88,Trop Facile,Trop Facile,Trop Facile / Trop Facile
4900,751,2020,Mathématique,6,7,QCU,0.98,0.01,0.93,6,6,6,0,1.0,100.0,6,0,98.0,Trop Facile,Trop Facile,Trop Facile / Trop Facile
751,752,2015,Mathématique,6,8,QCU,0.4412,0.17,0.37,95,77,42,35,1.23,54.55,42,53,44.12,Difficile,Difficile,Difficile / Difficile
1581,752,2016,Mathématique,6,8,QCU,0.9969,0.08,0.98,76,76,76,0,1.0,100.0,76,0,99.69,Trop Facile,Trop Facile,Trop Facile / Trop Facile
2411,752,2017,Mathématique,6,8,QCU,0.0921,0.53,0.29,80,47,7,40,1.7,14.89,7,73,9.21,Trop Facile,Trop Difficile,Trop Facile / Trop Difficile
3241,752,2018,Mathématique,6,8,QCU,0.9714,0.09,0.93,77,77,75,2,1.0,97.4,75,2,97.14,Trop Facile,Trop Facile,Trop Facile / Trop Facile
4071,752,2019,Mathématique,6,8,QCU,0.9549,0.05,0.98,77,76,74,2,1.01,97.37,74,3,95.49,Trop Facile,Trop Facile,Trop Facile / Trop Facile
4901,752,2020,Mathématique,6,8,QCU,0.4504,0.23,0.4,76,55,34,21,1.38,61.82,34,42,45.04,Trop Facile,Difficile,Trop Facile / Difficile
752,753,2015,Mathématique,6,9,QCU,0.9656,0.03,0.91,64,63,62,1,1.02,98.41,62,2,96.56,Trop Facile,Trop Facile,Trop Facile / Trop Facile
1582,753,2016,Mathématique,6,9,QCU,0.9985,0.04,0.99,72,72,72,0,1.0,100.0,72,0,99.85,Trop Facile,Trop Facile,Trop Facile / Trop Facile
2412,753,2017,Mathématique,6,9,QCU,0.9162,0.08,0.95,61,61,56,5,1.0,91.8,56,5,91.62,Trop Facile,Trop Facile,Trop Facile / Trop Facile
3242,753,2018,Mathématique,6,9,QCU,0.937,0.08,0.94,60,56,56,0,1.07,100.0,56,4,93.7,Trop Facile,Trop Facile,Trop Facile / Trop Facile
4072,753,2019,Mathématique,6,9,QCU,0.9503,0.1,0.94,60,57,57,0,1.05,100.0,57,3,95.03,Trop Facile,Trop Facile,Trop Facile / Trop Facile
4902,753,2020,Mathématique,6,9,QCU,0.9084,0.09,0.99,48,45,44,1,1.07,97.78,44,4,90.84,Trop Facile,Trop Facile,Trop Facile / Trop Facile
753,754,2015,Mathématique,6,10,QCU,0.9126,0.0,0.99,22,21,20,1,1.05,95.24,20,2,91.26,Trop Facile,Trop Facile,Trop Facile / Trop Facile
1583,754,2016,Mathématique,6,10,QCU,0.9268,0.06,1.0,23,21,21,0,1.1,100.0,21,2,92.68,Trop Facile,Trop Facile,Trop Facile / Trop Facile
2413,754,2017,Mathématique,6,10,QCU,0.699,0.08,0.61,25,17,17,0,1.47,100.0,17,8,69.9,Trop Facile,Adapte,Trop Facile / Adapte
3243,754,2018,Mathématique,6,10,QCU,0.6953,0.11,0.64,26,18,18,0,1.44,100.0,18,8,69.53,Adapte,Adapte,Adapte / Adapte
4073,754,2019,Mathématique,6,10,QCU,0.6692,0.17,0.42,27,26,18,8,1.04,69.23,18,9,66.92,Adapte,Adapte,Adapte / Adapte
4903,754,2020,Mathématique,6,10,QCU,0.6494,0.05,0.69,24,17,16,1,1.41,94.12,16,8,64.94,Adapte,Adapte,Adapte / Adapte
754,755,2015,Mathématique,6,11,QCM,0.8106,0.17,0.74,68,59,55,4,1.15,93.22,55,13,81.06,Trop Facile,Facile,Trop Facile / Facile
1584,755,2016,Mathématique,6,11,QCM,0.7179,0.22,0.58,67,56,48,8,1.2,85.71,48,19,71.79,Trop Facile,Adapte,Trop Facile / Adapte
2414,755,2017,Mathématique,6,11,QCM,0.6972,0.03,0.6,64,57,45,12,1.12,78.95,45,19,69.72,Adapte,Adapte,Adapte / Adapte
3244,755,2018,Mathématique,6,11,QCM,0.6805,0.1,0.47,72,69,49,20,1.04,71.01,49,23,68.05,Adapte,Adapte,Adapte / Adapte
4074,755,2019,Mathématique,6,11,QCM,0.6731,0.05,0.69,61,48,41,7,1.27,85.42,41,20,67.31,Adapte,Adapte,Adapte / Adapte
4904,755,2020,Mathématique,6,11,QCM,0.6679,0.17,0.46,53,41,35,6,1.29,85.37,35,18,66.79,Adapte,Adapte,Adapte / Adapte
755,756,2015,Mathématique,6,12,QCU,0.4679,0.19,0.38,46,35,22,13,1.31,62.86,22,24,46.79,Difficile,Difficile,Difficile / Difficile
1585,756,2016,Mathématique,6,12,QCU,0.8645,0.08,0.96,45,40,39,1,1.12,97.5,39,6,86.45,Trop Facile,Trop Facile,Trop Facile / Trop Facile
2415,756,2017,Mathématique,6,12,QCU,0.9095,0.07,0.9,46,45,42,3,1.02,93.33,42,4,90.95,Trop Facile,Trop Facile,Trop Facile / Trop Facile
3245,756,2018,Mathématique,6,12,QCU,0.8655,0.07,0.91,53,52,46,6,1.02,88.46,46,7,86.55,Trop Facile,Trop Facile,Trop Facile / Trop Facile
4075,756,2019,Mathématique,6,12,QCU,0.7379,0.3,0.5,57,44,42,2,1.3,95.45,42,15,73.79,Trop Facile,Adapte,Trop Facile / Adapte
4905,756,2020,Mathématique,6,12,QCU,0.6698,0.09,0.65,47,34,31,3,1.38,91.18,31,16,66.98,Adapte,Adapte,Adapte / Adapte
756,757,2015,Mathématique,7,1,QROC,0.1933,0.86,0.13,53,48,10,38,1.1,20.83,10,43,19.33,Facile,Trop Difficile,Facile / Trop Difficile
1586,757,2016,Mathématique,7,1,QROC,0.7779,0.09,0.56,51,49,40,9,1.04,81.63,40,11,77.79,Trop Facile,Facile,Trop Facile / Facile
2416,757,2017,Mathématique,7,1,QROC,0.9771,0.08,0.82,44,44,43,1,1.0,97.73,43,1,97.71,Trop Facile,Trop Facile,Trop Facile / Trop Facile
3246,757,2018,Mathématique,7,1,QROC,0.9609,0.08,0.52,46,46,44,2,1.0,95.65,44,2,96.09,Trop Facile,Trop Facile,Trop Facile / Trop Facile
4076,757,2019,Mathématique,7,1,QROC,0.9474,0.08,0.69,37,36,35,1,1.03,97.22,35,2,94.74,Trop Facile,Trop Facile,Trop Facile / Trop Facile
4906,757,2020,Mathématique,7,1,QROC,0.9955,0.01,0.99,31,31,31,0,1.0,100.0,31,0,99.55,Trop Facile,Trop Facile,Trop Facile / Trop Facile
757,758,2015,Mathématique,7,2,QCM,0.2277,0.46,0.28,19,16,4,12,1.19,25.0,4,15,22.77,Trop Difficile,Trop Difficile,Trop Difficile / Trop Difficile
1587,758,2016,Mathématique,7,2,QCM,0.7816,0.12,0.73,21,20,16,4,1.05,80.0,16,5,78.16,Trop Facile,Facile,Trop Facile / Facile
2417,758,2017,Mathématique,7,2,QCM,0.9498,0.09,0.9,17,16,16,0,1.06,100.0,16,1,94.98,Trop Facile,Trop Facile,Trop Facile / Trop Facile
3247,758,2018,Mathématique,7,2,QCM,0.9987,0.06,0.94,20,20,20,0,1.0,100.0,20,0,99.87,Trop Facile,Trop Facile,Trop Facile / Trop Facile
4077,758,2019,Mathématique,7,2,QCM,0.9332,0.04,0.86,20,19,19,0,1.05,100.0,19,1,93.32,Trop Facile,Trop Facile,Trop Facile / Trop Facile
4907,758,2020,Mathématique,7,2,QCM,0.0871,0.66,0.22,16,10,1,9,1.6,10.0,1,15,8.71,Trop Facile,Trop Difficile,Trop Facile / Trop Difficile
758,759,2015,Mathématique,7,3,QCM,0.1435,0.59,0.2,41,18,6,12,2.28,33.33,6,35,14.35,Trop Difficile,Trop Difficile,Trop Difficile / Trop Difficile
1588,759,2016,Mathématique,7,3,QCM,0.8879,0.09,0.81,41,40,36,4,1.02,90.0,36,5,88.79,Trop Facile,Trop Facile,Trop Facile / Trop Facile
2418,759,2017,Mathématique,7,3,QCM,0.896,0.08,0.98,40,36,36,0,1.11,100.0,36,4,89.6,Trop Facile,Trop Facile,Trop Facile / Trop Facile
3248,759,2018,Mathématique,7,3,QCM,0.8093,0.03,0.75,34,32,28,4,1.06,87.5,28,6,80.93,Trop Facile,Facile,Trop Facile / Facile
4078,759,2019,Mathématique,7,3,QCM,0.8654,0.04,0.84,28,26,24,2,1.08,92.31,24,4,86.54,Trop Facile,Trop Facile,Trop Facile / Trop Facile
4908,759,2020,Mathématique,7,3,QCM,0.8774,0.04,0.91,33,33,29,4,1.0,87.88,29,4,87.74,Trop Facile,Trop Facile,Trop Facile / Trop Facile
759,760,2015,Mathématique,8,1,QCM,0.3837,0.36,0.4,92,52,35,17,1.77,67.31,35,57,38.37,Facile,Difficile,Facile / Difficile
1589,760,2016,Mathématique,8,1,QCM,0.9593,0.02,0.9,107,106,103,3,1.01,97.17,103,4,95.93,Trop Facile,Trop Facile,Trop Facile / Trop Facile
2419,760,2017,Mathématique,8,1,QCM,0.8612,0.1,0.92,115,110,99,11,1.05,90.0,99,16,86.12,Trop Facile,Trop Facile,Trop Facile / Trop Facile
3249,760,2018,Mathématique,8,1,QCM,0.6052,0.16,0.55,115,88,70,18,1.31,79.55,70,45,60.52,Trop Facile,Adapte,Trop Facile / Adapte
4079,760,2019,Mathématique,8,1,QCM,0.7178,0.18,0.44,102,100,73,27,1.02,73.0,73,29,71.78,Adapte,Adapte,Adapte / Adapte
4909,760,2020,Mathématique,8,1,QCM,0.7051,0.24,0.7,117,103,82,21,1.14,79.61,82,35,70.51,Adapte,Adapte,Adapte / Adapte
760,761,2015,Mathématique,8,2,QCM,0.2071,0.73,0.2,85,25,18,7,3.4,72.0,18,67,20.71,Trop Difficile,Trop Difficile,Trop Difficile / Trop Difficile
1590,761,2016,Mathématique,8,2,QCM,0.9919,0.09,0.99,84,83,83,0,1.01,100.0,83,1,99.19,Trop Facile,Trop Facile,Trop Facile / Trop Facile
2420,761,2017,Mathématique,8,2,QCM,0.1205,0.64,0.21,79,42,10,32,1.88,23.81,10,69,12.05,Trop Facile,Trop Difficile,Trop Facile / Trop Difficile
3250,761,2018,Mathématique,8,2,QCM,0.3146,0.45,0.38,85,59,27,32,1.44,45.76,27,58,31.46,Trop Facile,Difficile,Trop Facile / Difficile
4080,761,2019,Mathématique,8,2,QCM,0.9389,0.05,0.98,76,72,71,1,1.06,98.61,71,5,93.89,Trop Facile,Trop Facile,Trop Facile / Trop Facile
4910,761,2020,Mathématique,8,2,QCM,0.7993,0.09,0.77,88,87,70,17,1.01,80.46,70,18,79.93,Trop Facile,Facile,Trop Facile / Facile
761,762,2015,Mathématique,8,3,QROC,0.6802,0.34,0.35,22,20,15,5,1.1,75.0,15,7,68.02,Difficile,Adapte,Difficile / Adapte
1591,762,2016,Mathématique,8,3,QROC,0.6712,0.37,0.39,21,16,14,2,1.31,87.5,14,7,67.12,Adapte,Adapte,Adapte / Adapte
2421,762,2017,Mathématique,8,3,QROC,0.7038,0.38,0.29,23,22,16,6,1.05,72.73,16,7,70.38,Adapte,Adapte,Adapte / Adapte
3251,762,2018,Mathématique,8,3,QROC,0.6714,0.42,0.33,20,18,13,5,1.11,72.22,13,7,67.14,Adapte,Adapte,Adapte / Adapte
4081,762,2019,Mathématique,8,3,QROC,0.6767,0.37,0.38,20,17,14,3,1.18,82.35,14,6,67.67,Adapte,Adapte,Adapte / Adapte
4911,762,2020,Mathématique,8,3,QROC,0.6954,0.3,0.4,18,15,13,2,1.2,86.67,13,5,69.54,Adapte,Adapte,Adapte / Adapte
762,763,2015,Mathématique,8,4,QCU,0.9394,0.04,0.95,29,27,27,0,1.07,100.0,27,2,93.94,Trop Facile,Trop Facile,Trop Facile / Trop Facile
1592,763,2016,Mathématique,8,4,QCU,0.5232,0.01,0.39,33,25,17,8,1.32,68.0,17,16,52.32,Trop Facile,Difficile,Trop Facile / Difficile
2422,763,2017,Mathématique,8,4,QCU,0.7365,0.09,0.67,28,25,21,4,1.12,84.0,21,7,73.65,Trop Facile,Adapte,Trop Facile / Adapte
3252,763,2018,Mathématique,8,4,QCU,0.7178,0.12,0.5,33,31,24,7,1.06,77.42,24,9,71.78,Adapte,Adapte,Adapte / Adapte
4082,763,2019,Mathématique,8,4,QCU,0.6597,0.1,0.47,38,26,25,1,1.46,96.15,25,13,65.97,Adapte,Adapte,Adapte / Adapte
4912,763,2020,Mathématique,8,4,QCU,0.6697,0.19,0.53,40,40,27,13,1.0,67.5,27,13,66.97,Adapte,Adapte,Adapte / Adapte
763,764,2015,Mathématique,8,5,QCU,0.7997,0.15,0.86,7,7,6,1,1.0,85.71,6,1,79.97,Facile,Facile,Facile / Facile
1593,764,2016,Mathématique,8,5,QCU,0.9686,0.1,0.93,8,8,8,0,1.0,100.0,8,0,96.86,Trop Facile,Trop Facile,Trop Facile / Trop Facile
2423,764,2017,Mathématique,8,5,QCU,0.2342,0.17,0.29,6,5,1,4,1.2,20.0,1,5,23.42,Trop Facile,Trop Difficile,Trop Facile / Trop Difficile
3253,764,2018,Mathématique,8,5,QCU,0.0215,0.27,0.27,7,3,0,3,2.33,0.0,0,7,2.15,Trop Facile,Trop Difficile,Trop Facile / Trop Difficile
4083,764,2019,Mathématique,8,5,QCU,0.7732,0.03,0.87,7,5,5,0,1.4,100.0,5,2,77.32,Trop Facile,Facile,Trop Facile / Facile
4913,764,2020,Mathématique,8,5,QCU,0.5793,0.37,0.38,7,6,4,2,1.17,66.67,4,3,57.93,Trop Facile,Difficile,Trop Facile / Difficile
764,765,2015,Mathématique,8,6,QO,0.8728,0.05,0.95,19,17,17,0,1.12,100.0,17,2,87.28,Trop Facile,Trop Facile,Trop Facile / Trop Facile
1594,765,2016,Mathématique,8,6,QO,0.6892,0.59,0.17,18,13,12,1,1.38,92.31,12,6,68.92,Trop Facile,Adapte,Trop Facile / Adapte
2424,765,2017,Mathématique,8,6,QO,0.6165,0.33,0.2,20,19,12,7,1.05,63.16,12,8,61.65,Adapte,Adapte,Adapte / Adapte
3254,765,2018,Mathématique,8,6,QO,0.6875,0.34,0.19,21,17,14,3,1.24,82.35,14,7,68.75,Adapte,Adapte,Adapte / Adapte
4084,765,2019,Mathématique,8,6,QO,0.6774,0.22,0.23,24,17,16,1,1.41,94.12,16,8,67.74,Adapte,Adapte,Adapte / Adapte
4914,765,2020,Mathématique,8,6,QO,0.7014,0.3,0.26,25,19,18,1,1.32,94.74,18,7,70.14,Adapte,Adapte,Adapte / Adapte
765,766,2015,Mathématique,8,7,QCM,0.682,0.11,0.65,57,46,39,7,1.24,84.78,39,18,68.2,Adapte,Adapte,Adapte / Adapte
1595,766,2016,Mathématique,8,7,QCM,0.7435,0.21,0.62,64,60,48,12,1.07,80.0,48,16,74.35,Adapte,Adapte,Adapte / Adapte
2425,766,2017,Mathématique,8,7,QCM,0.6791,0.16,0.51,64,59,43,16,1.08,72.88,43,21,67.91,Adapte,Adapte,Adapte / Adapte
3255,766,2018,Mathématique,8,7,QCM,0.691,0.22,0.64,53,42,37,5,1.26,88.1,37,16,69.1,Adapte,Adapte,Adapte / Adapte
4085,766,2019,Mathématique,8,7,QCM,0.6368,0.18,0.5,54,44,34,10,1.23,77.27,34,20,63.68,Adapte,Adapte,Adapte / Adapte
4915,766,2020,Mathématique,8,7,QCM,0.6023,0.15,0.56,54,37,33,4,1.46,89.19,33,21,60.23,Adapte,Adapte,Adapte / Adapte
766,767,2015,Mathématique,8,8,QO,0.1746,0.98,0.01,86,74,15,59,1.16,20.27,15,71,17.46,Trop Difficile,Trop Difficile,Trop Difficile / Trop Difficile
1596,767,2016,Mathématique,8,8,QO,0.2294,0.94,0.07,73,61,17,44,1.2,27.87,17,56,22.94,Trop Facile,Trop Difficile,Trop Facile / Trop Difficile
2426,767,2017,Mathématique,8,8,QO,0.9658,0.05,0.54,63,63,61,2,1.0,96.83,61,2,96.58,Trop Facile,Trop Facile,Trop Facile / Trop Facile
3256,767,2018,Mathématique,8,8,QO,0.4863,0.85,0.01,66,54,32,22,1.22,59.26,32,34,48.63,Trop Facile,Difficile,Trop Facile / Difficile
4086,767,2019,Mathématique,8,8,QO,0.1724,0.98,0.03,76,39,13,26,1.95,33.33,13,63,17.24,Trop Facile,Trop Difficile,Trop Facile / Trop Difficile
4916,767,2020,Mathématique,8,8,QO,0.9944,0.1,0.61,65,65,65,0,1.0,100.0,65,0,99.44,Trop Facile,Trop Facile,Trop Facile / Trop Facile
767,768,2015,Mathématique,9,1,QCU,0.0877,0.2,0.23,87,59,8,51,1.47,13.56,8,79,8.77,Trop Difficile,Trop Difficile,Trop Difficile / Trop Difficile
1597,768,2016,Mathématique,9,1,QCU,0.9239,0.1,0.94,90,84,83,1,1.07,98.81,83,7,92.39,Trop Facile,Trop Facile,Trop Facile / Trop Facile
2427,768,2017,Mathématique,9,1,QCU,0.9293,0.02,0.99,84,83,78,5,1.01,93.98,78,6,92.93,Trop Facile,Trop Facile,Trop Facile / Trop Facile
3257,768,2018,Mathématique,9,1,QCU,0.3804,0.39,0.31,96,92,37,55,1.04,40.22,37,59,38.04,Trop Facile,Difficile,Trop Facile / Difficile
4087,768,2019,Mathématique,9,1,QCU,0.9802,0.08,0.93,96,94,94,0,1.02,100.0,94,2,98.02,Trop Facile,Trop Facile,Trop Facile / Trop Facile
4917,768,2020,Mathématique,9,1,QCU,0.9615,0.04,0.97,87,85,84,1,1.02,98.82,84,3,96.15,Trop Facile,Trop Facile,Trop Facile / Trop Facile
768,769,2015,Mathématique,9,2,QCM,0.7426,0.23,0.57,33,31,25,6,1.06,80.65,25,8,74.26,Adapte,Adapte,Adapte / Adapte
1598,769,2016,Mathématique,9,2,QCM,0.7255,0.24,0.61,35,30,25,5,1.17,83.33,25,10,72.55,Adapte,Adapte,Adapte / Adapte
2428,769,2017,Mathématique,9,2,QCM,0.7321,0.02,0.42,38,33,28,5,1.15,84.85,28,10,73.21,Adapte,Adapte,Adapte / Adapte
3258,769,2018,Mathématique,9,2,QCM,0.6289,0.02,0.46,36,28,23,5,1.29,82.14,23,13,62.89,Adapte,Adapte,Adapte / Adapte
4088,769,2019,Mathématique,9,2,QCM,0.7344,0.03,0.49,32,31,24,7,1.03,77.42,24,8,73.44,Adapte,Adapte,Adapte / Adapte
4918,769,2020,Mathématique,9,2,QCM,0.6693,0.01,0.41,28,27,19,8,1.04,70.37,19,9,66.93,Adapte,Adapte,Adapte / Adapte
769,770,2015,Mathématique,9,3,QCM,0.7341,0.26,0.4,88,82,65,17,1.07,79.27,65,23,73.41,Difficile,Adapte,Difficile / Adapte
1599,770,2016,Mathématique,9,3,QCM,0.6863,0.04,0.51,95,95,65,30,1.0,68.42,65,30,68.63,Adapte,Adapte,Adapte / Adapte
2429,770,2017,Mathématique,9,3,QCM,0.7257,0.13,0.6,102,78,74,4,1.31,94.87,74,28,72.57,Adapte,Adapte,Adapte / Adapte
3259,770,2018,Mathématique,9,3,QCM,0.6933,0.18,0.41,121,108,84,24,1.12,77.78,84,37,69.33,Adapte,Adapte,Adapte / Adapte
4089,770,2019,Mathématique,9,3,QCM,0.6365,0.03,0.42,118,116,75,41,1.02,64.66,75,43,63.65,Adapte,Adapte,Adapte / Adapte
4919,770,2020,Mathématique,9,3,QCM,0.7319,0.05,0.59,130,98,95,3,1.33,96.94,95,35,73.19,Adapte,Adapte,Adapte / Adapte
770,771,2015,Mathématique,9,4,QCM,0.79,0.03,0.7,46,44,36,8,1.05,81.82,36,10,79.0,Difficile,Facile,Difficile / Facile
1600,771,2016,Mathématique,9,4,QCM,0.8759,0.08,0.9,43,38,38,0,1.13,100.0,38,5,87.59,Trop Facile,Trop Facile,Trop Facile / Trop Facile
2430,771,2017,Mathématique,9,4,QCM,0.9061,0.01,0.83,38,37,34,3,1.03,91.89,34,4,90.61,Trop Facile,Trop Facile,Trop Facile / Trop Facile
3260,771,2018,Mathématique,9,4,QCM,0.9469,0.01,0.88,38,37,36,1,1.03,97.3,36,2,94.69,Trop Facile,Trop Facile,Trop Facile / Trop Facile
4090,771,2019,Mathématique,9,4,QCM,0.9968,0.05,0.8,45,45,45,0,1.0,100.0,45,0,99.68,Trop Facile,Trop Facile,Trop Facile / Trop Facile
4920,771,2020,Mathématique,9,4,QCM,0.8959,0.06,0.8,53,51,47,4,1.04,92.16,47,6,89.59,Trop Facile,Trop Facile,Trop Facile / Trop Facile
771,772,2015,Mathématique,9,5,QCU,0.8313,0.09,0.84,99,96,82,14,1.03,85.42,82,17,83.13,Facile,Facile,Facile / Facile
1601,772,2016,Mathématique,9,5,QCU,0.2387,0.44,0.23,103,102,25,77,1.01,24.51,25,78,23.87,Trop Facile,Trop Difficile,Trop Facile / Trop Difficile
2431,772,2017,Mathématique,9,5,QCU,0.9532,0.0,0.92,118,113,112,1,1.04,99.12,112,6,95.32,Trop Facile,Trop Facile,Trop Facile / Trop Facile
3261,772,2018,Mathématique,9,5,QCU,0.8646,0.02,0.91,101,93,87,6,1.09,93.55,87,14,86.46,Trop Facile,Trop Facile,Trop Facile / Trop Facile
4091,772,2019,Mathématique,9,5,QCU,0.1096,0.4,0.3,91,59,10,49,1.54,16.95,10,81,10.96,Trop Facile,Trop Difficile,Trop Facile / Trop Difficile
4921,772,2020,Mathématique,9,5,QCU,0.5801,0.15,0.38,96,72,56,16,1.33,77.78,56,40,58.01,Trop Facile,Difficile,Trop Facile / Difficile
772,773,2015,Mathématique,9,6,QCU,0.4665,0.33,0.34,45,43,21,22,1.05,48.84,21,24,46.65,Difficile,Difficile,Difficile / Difficile
1602,773,2016,Mathématique,9,6,QCU,0.2603,0.27,0.31,44,30,11,19,1.47,36.67,11,33,26.03,Trop Facile,Difficile,Trop Facile / Difficile
2432,773,2017,Mathématique,9,6,QCU,0.9762,0.06,0.97,35,34,34,0,1.03,100.0,34,1,97.62,Trop Facile,Trop Facile,Trop Facile / Trop Facile
3262,773,2018,Mathématique,9,6,QCU,0.9408,0.01,0.97,37,35,35,0,1.06,100.0,35,2,94.08,Trop Facile,Trop Facile,Trop Facile / Trop Facile
4092,773,2019,Mathématique,9,6,QCU,0.9872,0.09,0.93,42,41,41,0,1.02,100.0,41,1,98.72,Trop Facile,Trop Facile,Trop Facile / Trop Facile
4922,773,2020,Mathématique,9,6,QCU,0.9781,0.09,1.0,36,35,35,0,1.03,100.0,35,1,97.81,Trop Facile,Trop Facile,Trop Facile / Trop Facile
773,774,2015,Mathématique,10,1,QCU,0.1938,0.27,0.24,40,16,8,8,2.5,50.0,8,32,19.38,Difficile,Trop Difficile,Difficile / Trop Difficile
1603,774,2016,Mathématique,10,1,QCU,0.3859,0.29,0.35,41,26,16,10,1.58,61.54,16,25,38.59,Trop Facile,Difficile,Trop Facile / Difficile
2433,774,2017,Mathématique,10,1,QCU,0.9117,0.01,0.98,35,33,32,1,1.06,96.97,32,3,91.17,Trop Facile,Trop Facile,Trop Facile / Trop Facile
3263,774,2018,Mathématique,10,1,QCU,0.9461,0.08,0.92,30,29,28,1,1.03,96.55,28,2,94.61,Trop Facile,Trop Facile,Trop Facile / Trop Facile
4093,774,2019,Mathématique,10,1,QCU,0.7727,0.11,0.87,26,25,20,5,1.04,80.0,20,6,77.27,Trop Facile,Facile,Trop Facile / Facile
4923,774,2020,Mathématique,10,1,QCU,0.7491,0.04,0.47,29,24,22,2,1.21,91.67,22,7,74.91,Trop Facile,Adapte,Trop Facile / Adapte
774,775,2015,Mathématique,10,2,QCU,0.3115,0.27,0.36,12,5,4,1,2.4,80.0,4,8,31.15,Difficile,Difficile,Difficile / Difficile
1604,775,2016,Mathématique,10,2,QCU,0.8793,0.01,0.9,11,10,10,0,1.1,100.0,10,1,87.93,Trop Facile,Trop Facile,Trop Facile / Trop Facile
2434,775,2017,Mathématique,10,2,QCU,0.9665,0.08,0.94,9,9,9,0,1.0,100.0,9,0,96.65,Trop Facile,Trop Facile,Trop Facile / Trop Facile
3264,775,2018,Mathématique,10,2,QCU,0.9598,0.06,0.96,9,9,9,0,1.0,100.0,9,0,95.98,Trop Facile,Trop Facile,Trop Facile / Trop Facile
4094,775,2019,Mathématique,10,2,QCU,0.8423,0.14,0.87,10,10,8,2,1.0,80.0,8,2,84.23,Trop Facile,Facile,Trop Facile / Facile
4924,775,2020,Mathématique,10,2,QCU,0.1852,0.12,0.21,11,10,2,8,1.1,20.0,2,9,18.52,Trop Facile,Trop Difficile,Trop Facile / Trop Difficile
775,776,2015,Mathématique,10,3,QO,0.2298,0.93,0.01,29,23,7,16,1.26,30.43,7,22,22.98,Trop Difficile,Trop Difficile,Trop Difficile / Trop Difficile
1605,776,2016,Mathématique,10,3,QO,0.8325,0.17,0.61,35,32,29,3,1.09,90.62,29,6,83.25,Trop Facile,Facile,Trop Facile / Facile
2435,776,2017,Mathématique,10,3,QO,0.6394,0.72,0.2,36,30,23,7,1.2,76.67,23,13,63.94,Trop Facile,Adapte,Trop Facile / Adapte
3265,776,2018,Mathématique,10,3,QO,0.6267,0.7,0.16,30,20,19,1,1.5,95.0,19,11,62.67,Adapte,Adapte,Adapte / Adapte
4095,776,2019,Mathématique,10,3,QO,0.7331,0.36,0.21,35,34,26,8,1.03,76.47,26,9,73.31,Adapte,Adapte,Adapte / Adapte
4925,776,2020,Mathématique,10,3,QO,0.7035,0.57,0.18,38,37,27,10,1.03,72.97,27,11,70.35,Adapte,Adapte,Adapte / Adapte
776,777,2015,Mathématique,10,4,QCU,0.714,0.18,0.48,13,10,9,1,1.3,90.0,9,4,71.4,Difficile,Adapte,Difficile / Adapte
1606,777,2016,Mathématique,10,4,QCU,0.6658,0.16,0.4,16,11,11,0,1.45,100.0,11,5,66.58,Adapte,Adapte,Adapte / Adapte
2436,777,2017,Mathématique,10,4,QCU,0.6674,0.28,0.5,16,15,11,4,1.07,73.33,11,5,66.74,Adapte,Adapte,Adapte / Adapte
3266,777,2018,Mathématique,10,4,QCU,0.602,0.08,0.5,13,9,8,1,1.44,88.89,8,5,60.2,Adapte,Adapte,Adapte / Adapte
4096,777,2019,Mathématique,10,4,QCU,0.7395,0.0,0.47,10,8,7,1,1.25,87.5,7,3,73.95,Adapte,Adapte,Adapte / Adapte
4926,777,2020,Mathématique,10,4,QCU,0.6706,0.3,0.57,11,10,7,3,1.1,70.0,7,4,67.06,Adapte,Adapte,Adapte / Adapte
777,778,2015,Mathématique,10,5,QCM,0.3018,0.38,0.38,64,23,19,4,2.78,82.61,19,45,30.18,Difficile,Difficile,Difficile / Difficile
1607,778,2016,Mathématique,10,5,QCM,0.8057,0.02,0.7,77,62,62,0,1.24,100.0,62,15,80.57,Trop Facile,Facile,Trop Facile / Facile
2437,778,2017,Mathématique,10,5,QCM,0.9978,0.03,0.81,84,84,84,0,1.0,100.0,84,0,99.78,Trop Facile,Trop Facile,Trop Facile / Trop Facile
3267,778,2018,Mathématique,10,5,QCM,0.0487,0.57,0.21,73,48,4,44,1.52,8.33,4,69,4.87,Trop Facile,Trop Difficile,Trop Facile / Trop Difficile
4097,778,2019,Mathématique,10,5,QCM,0.9591,0.01,0.92,76,76,73,3,1.0,96.05,73,3,95.91,Trop Facile,Trop Facile,Trop Facile / Trop Facile
4927,778,2020,Mathématique,10,5,QCM,0.7621,0.08,0.71,71,67,54,13,1.06,80.6,54,17,76.21,Trop Facile,Facile,Trop Facile / Facile
778,779,2015,Mathématique,10,6,QCM,0.0397,0.12,0.25,36,14,1,13,2.57,7.14,1,35,3.97,Trop Difficile,Trop Difficile,Trop Difficile / Trop Difficile
1608,779,2016,Mathématique,10,6,QCM,0.2662,0.43,0.32,38,12,10,2,3.17,83.33,10,28,26.62,Trop Facile,Difficile,Trop Facile / Difficile
2438,779,2017,Mathématique,10,6,QCM,0.9932,0.02,0.93,30,30,30,0,1.0,100.0,30,0,99.32,Trop Facile,Trop Facile,Trop Facile / Trop Facile
3268,779,2018,Mathématique,10,6,QCM,0.9981,0.05,0.91,28,28,28,0,1.0,100.0,28,0,99.81,Trop Facile,Trop Facile,Trop Facile / Trop Facile
4098,779,2019,Mathématique,10,6,QCM,0.9133,0.1,0.95,22,20,20,0,1.1,100.0,20,2,91.33,Trop Facile,Trop Facile,Trop Facile / Trop Facile
4928,779,2020,Mathématique,10,6,QCM,0.9638,0.03,0.9,18,18,17,1,1.0,94.44,17,1,96.38,Trop Facile,Trop Facile,Trop Facile / Trop Facile
779,780,2015,Mathématique,10,7,QCU,0.8469,0.02,0.81,68,62,58,4,1.1,93.55,58,10,84.69,Facile,Facile,Facile / Facile
1609,780,2016,Mathématique,10,7,QCU,0.9088,0.09,0.98,66,64,60,4,1.03,93.75,60,6,90.88,Trop Facile,Trop Facile,Trop Facile / Trop Facile
2439,780,2017,Mathématique,10,7,QCU,0.9203,0.09,0.9,53,50,49,1,1.06,98.0,49,4,92.03,Trop Facile,Trop Facile,Trop Facile / Trop Facile
3269,780,2018,Mathématique,10,7,QCU,0.9709,0.1,0.92,52,51,50,1,1.02,98.04,50,2,97.09,Trop Facile,Trop Facile,Trop Facile / Trop Facile
4099,780,2019,Mathématique,10,7,QCU,0.8701,0.06,0.97,47,47,41,6,1.0,87.23,41,6,87.01,Trop Facile,Trop Facile,Trop Facile / Trop Facile
4929,780,2020,Mathématique,10,7,QCU,0.912,0.03,0.91,41,39,37,2,1.05,94.87,37,4,91.2,Trop Facile,Trop Facile,Trop Facile / Trop Facile
780,781,2015,Mathématique,10,8,QCM,0.6709,0.06,0.68,9,9,6,3,1.0,66.67,6,3,67.09,Trop Difficile,Adapte,Trop Difficile / Adapte
1610,781,2016,Mathématique,10,8,QCM,0.6398,0.29,0.7,9,8,6,2,1.12,75.0,6,3,63.98,Adapte,Adapte,Adapte / Adapte
2440,781,2017,Mathématique,10,8,QCM,0.7484,0.0,0.48,10,10,7,3,1.0,70.0,7,3,74.84,Adapte,Adapte,Adapte / Adapte
3270,781,2018,Mathématique,10,8,QCM,0.6678,0.3,0.66,10,8,7,1,1.25,87.5,7,3,66.78,Adapte,Adapte,Adapte / Adapte
4100,781,2019,Mathématique,10,8,QCM,0.6254,0.13,0.49,8,5,5,0,1.6,100.0,5,3,62.54,Adapte,Adapte,Adapte / Adapte
4930,781,2020,Mathématique,10,8,QCM,0.6738,0.14,0.64,10,8,7,1,1.25,87.5,7,3,67.38,Adapte,Adapte,Adapte / Adapte
781,782,2015,Mathématique,10,9,QO,0.0999,0.9,0.02,30,17,3,14,1.76,17.65,3,27,9.99,Difficile,Trop Difficile,Difficile / Trop Difficile
1611,782,2016,Mathématique,10,9,QO,0.9848,0.03,0.81,28,28,28,0,1.0,100.0,28,0,98.48,Trop Facile,Trop Facile,Trop Facile / Trop Facile
2441,782,2017,Mathématique,10,9,QO,0.0472,0.94,0.02,24,18,1,17,1.33,5.56,1,23,4.72,Trop Facile,Trop Difficile,Trop Facile / Trop Difficile
3271,782,2018,Mathématique,10,9,QO,0.7678,0.16,0.58,28,23,21,2,1.22,91.3,21,7,76.78,Trop Facile,Facile,Trop Facile / Facile
4101,782,2019,Mathématique,10,9,QO,0.9617,0.02,0.94,24,24,23,1,1.0,95.83,23,1,96.17,Trop Facile,Trop Facile,Trop Facile / Trop Facile
4931,782,2020,Mathématique,10,9,QO,0.7963,0.03,0.43,27,23,22,1,1.17,95.65,22,5,79.63,Trop Facile,Facile,Trop Facile / Facile
782,783,2015,Mathématique,10,10,QCU,0.8836,0.0,0.96,67,64,59,5,1.05,92.19,59,8,88.36,Facile,Trop Facile,Facile / Trop Facile
1612,783,2016,Mathématique,10,10,QCU,0.8018,0.17,0.86,60,48,48,0,1.25,100.0,48,12,80.18,Trop Facile,Facile,Trop Facile / Facile
2442,783,2017,Mathématique,10,10,QCU,0.945,0.06,1.0,57,54,54,0,1.06,100.0,54,3,94.5,Trop Facile,Trop Facile,Trop Facile / Trop Facile
3272,783,2018,Mathématique,10,10,QCU,0.6283,0.1,0.6,63,48,40,8,1.31,83.33,40,23,62.83,Trop Facile,Adapte,Trop Facile / Adapte
4102,783,2019,Mathématique,10,10,QCU,0.6615,0.02,0.56,52,39,34,5,1.33,87.18,34,18,66.15,Adapte,Adapte,Adapte / Adapte
4932,783,2020,Mathématique,10,10,QCU,0.6469,0.03,0.61,43,41,28,13,1.05,68.29,28,15,64.69,Adapte,Adapte,Adapte / Adapte
783,784,2015,Mathématique,11,1,QCM,0.0334,0.29,0.28,44,11,1,10,4.0,9.09,1,43,3.34,Trop Difficile,Trop Difficile,Trop Difficile / Trop Difficile
1613,784,2016,Mathématique,11,1,QCM,0.9658,0.01,0.81,48,47,46,1,1.02,97.87,46,2,96.58,Trop Facile,Trop Facile,Trop Facile / Trop Facile
2443,784,2017,Mathématique,11,1,QCM,0.9765,0.02,0.94,51,51,50,1,1.0,98.04,50,1,97.65,Trop Facile,Trop Facile,Trop Facile / Trop Facile
3273,784,2018,Mathématique,11,1,QCM,0.8879,0.09,0.97,54,52,48,4,1.04,92.31,48,6,88.79,Trop Facile,Trop Facile,Trop Facile / Trop Facile
4103,784,2019,Mathématique,11,1,QCM,0.1754,0.42,0.3,57,22,10,12,2.59,45.45,10,47,17.54,Trop Facile,Trop Difficile,Trop Facile / Trop Difficile
4933,784,2020,Mathématique,11,1,QCM,0.8811,0.0,0.81,52,52,46,6,1.0,88.46,46,6,88.11,Trop Facile,Trop Facile,Trop Facile / Trop Facile
784,785,2015,Mathématique,11,2,QCU,0.819,0.2,0.79,87,73,71,2,1.19,97.26,71,16,81.9,Facile,Facile,Facile / Facile
1614,785,2016,Mathématique,11,2,QCU,0.0055,0.7,0.29,83,80,0,80,1.04,0.0,0,83,0.55,Trop Facile,Trop Difficile,Trop Facile / Trop Difficile
2444,785,2017,Mathématique,11,2,QCU,0.8871,0.06,0.96,86,79,76,3,1.09,96.2,76,10,88.71,Trop Facile,Trop Facile,Trop Facile / Trop Facile
3274,785,2018,Mathématique,11,2,QCU,0.9386,0.01,0.94,95,91,89,2,1.04,97.8,89,6,93.86,Trop Facile,Trop Facile,Trop Facile / Trop Facile
4104,785,2019,Mathématique,11,2,QCU,0.9416,0.05,0.95,104,102,98,4,1.02,96.08,98,6,94.16,Trop Facile,Trop Facile,Trop Facile / Trop Facile
4934,785,2020,Mathématique,11,2,QCU,0.9976,0.03,0.91,112,112,112,0,1.0,100.0,112,0,99.76,Trop Facile,Trop Facile,Trop Facile / Trop Facile
785,786,2015,Mathématique,11,3,QCM,0.6797,0.19,0.45,8,8,5,3,1.0,62.5,5,3,67.97,Adapte,Adapte,Adapte / Adapte
1615,786,2016,Mathématique,11,3,QCM,0.7306,0.28,0.56,8,8,6,2,1.0,75.0,6,2,73.06,Adapte,Adapte,Adapte / Adapte
2445,786,2017,Mathématique,11,3,QCM,0.6003,0.28,0.56,6,5,4,1,1.2,80.0,4,2,60.03,Adapte,Adapte,Adapte / Adapte
3275,786,2018,Mathématique,11,3,QCM,0.7203,0.25,0.7,7,7,5,2,1.0,71.43,5,2,72.03,Adapte,Adapte,Adapte / Adapte
4105,786,2019,Mathématique,11,3,QCM,0.6041,0.05,0.66,6,6,4,2,1.0,66.67,4,2,60.41,Adapte,Adapte,Adapte / Adapte
4935,786,2020,Mathématique,11,3,QCM,0.6824,0.07,0.45,5,4,3,1,1.25,75.0,3,2,68.24,Adapte,Adapte,Adapte / Adapte
786,787,2015,Mathématique,12,1,QCM,0.8951,0.05,0.89,12,11,11,0,1.09,100.0,11,1,89.51,Trop Difficile,Trop Facile,Trop Difficile / Trop Facile
1616,787,2016,Mathématique,12,1,QCM,0.9037,0.01,0.92,10,9,9,0,1.11,100.0,9,1,90.37,Trop Facile,Trop Facile,Trop Facile / Trop Facile
2446,787,2017,Mathématique,12,1,QCM,0.8753,0.04,0.87,9,9,8,1,1.0,88.89,8,1,87.53,Trop Facile,Trop Facile,Trop Facile / Trop Facile
3276,787,2018,Mathématique,12,1,QCM,0.4685,0.02,0.37,8,6,4,2,1.33,66.67,4,4,46.85,Trop Facile,Difficile,Trop Facile / Difficile
4106,787,2019,Mathématique,12,1,QCM,0.9647,0.06,0.94,8,8,8,0,1.0,100.0,8,0,96.47,Trop Facile,Trop Facile,Trop Facile / Trop Facile
4936,787,2020,Mathématique,12,1,QCM,0.8847,0.1,0.95,7,7,6,1,1.0,85.71,6,1,88.47,Trop Facile,Trop Facile,Trop Facile / Trop Facile
787,788,2015,Mathématique,12,2,QCU,0.9886,0.01,0.95,70,69,69,0,1.01,100.0,69,1,98.86,Difficile,Trop Facile,Difficile / Trop Facile
1617,788,2016,Mathématique,12,2,QCU,0.9255,0.09,0.96,69,65,64,1,1.06,98.46,64,5,92.55,Trop Facile,Trop Facile,Trop Facile / Trop Facile
2447,788,2017,Mathématique,12,2,QCU,0.6411,0.27,0.52,55,39,35,4,1.41,89.74,35,20,64.11,Trop Facile,Adapte,Trop Facile / Adapte
3277,788,2018,Mathématique,12,2,QCU,0.6319,0.14,0.43,46,29,29,0,1.59,100.0,29,17,63.19,Adapte,Adapte,Adapte / Adapte
4107,788,2019,Mathématique,12,2,QCU,0.6785,0.14,0.63,44,38,30,8,1.16,78.95,30,14,67.85,Adapte,Adapte,Adapte / Adapte
4937,788,2020,Mathématique,12,2,QCU,0.6685,0.18,0.64,39,28,26,2,1.39,92.86,26,13,66.85,Adapte,Adapte,Adapte / Adapte
788,789,2015,Mathématique,12,3,QCM,0.5126,0.33,0.31,28,23,14,9,1.22,60.87,14,14,51.26,Difficile,Difficile,Difficile / Difficile
1618,789,2016,Mathématique,12,3,QCM,0.8656,0.05,0.9,25,25,22,3,1.0,88.0,22,3,86.56,Trop Facile,Trop Facile,Trop Facile / Trop Facile
2448,789,2017,Mathématique,12,3,QCM,0.9317,0.07,0.92,25,24,23,1,1.04,95.83,23,2,93.17,Trop Facile,Trop Facile,Trop Facile / Trop Facile
3278,789,2018,Mathématique,12,3,QCM,0.9723,0.0,0.89,23,23,22,1,1.0,95.65,22,1,97.23,Trop Facile,Trop Facile,Trop Facile / Trop Facile
4108,789,2019,Mathématique,12,3,QCM,0.9193,0.0,0.89,25,24,23,1,1.04,95.83,23,2,91.93,Trop Facile,Trop Facile,Trop Facile / Trop Facile
4938,789,2020,Mathématique,12,3,QCM,0.8277,0.1,0.74,24,21,20,1,1.14,95.24,20,4,82.77,Trop Facile,Facile,Trop Facile / Facile
789,790,2015,Mathématique,12,4,QROC,0.1959,0.82,0.12,66,61,13,48,1.08,21.31,13,53,19.59,Difficile,Trop Difficile,Difficile / Trop Difficile
1619,790,2016,Mathématique,12,4,QROC,0.6349,0.26,0.37,76,71,48,23,1.07,67.61,48,28,63.49,Trop Facile,Adapte,Trop Facile / Adapte
2449,790,2017,Mathématique,12,4,QROC,0.6567,0.47,0.37,76,55,50,5,1.38,90.91,50,26,65.67,Adapte,Adapte,Adapte / Adapte
3279,790,2018,Mathématique,12,4,QROC,0.6928,0.42,0.26,66,66,46,20,1.0,69.7,46,20,69.28,Adapte,Adapte,Adapte / Adapte
4109,790,2019,Mathématique,12,4,QROC,0.6449,0.34,0.32,71,60,46,14,1.18,76.67,46,25,64.49,Adapte,Adapte,Adapte / Adapte
4939,790,2020,Mathématique,12,4,QROC,0.6218,0.3,0.35,64,59,40,19,1.08,67.8,40,24,62.18,Adapte,Adapte,Adapte / Adapte
790,791,2015,Mathématique,12,5,QCU,0.6786,0.17,0.63,96,77,65,12,1.25,84.42,65,31,67.86,Adapte,Adapte,Adapte / Adapte
1620,791,2016,Mathématique,12,5,QCU,0.7384,0.13,0.58,105,79,78,1,1.33,98.73,78,27,73.84,Adapte,Adapte,Adapte / Adapte
2450,791,2017,Mathématique,12,5,QCU,0.6473,0.26,0.53,104,67,67,0,1.55,100.0,67,37,64.73,Adapte,Adapte,Adapte / Adapte
3280,791,2018,Mathématique,12,5,QCU,0.7488,0.13,0.41,102,102,76,26,1.0,74.51,76,26,74.88,Adapte,Adapte,Adapte / Adapte
4110,791,2019,Mathématique,12,5,QCU,0.6823,0.05,0.52,117,81,80,1,1.44,98.77,80,37,68.23,Adapte,Adapte,Adapte / Adapte
4940,791,2020,Mathématique,12,5,QCU,0.7432,0.18,0.58,106,95,79,16,1.12,83.16,79,27,74.32,Adapte,Adapte,Adapte / Adapte
791,792,2015,Mathématique,12,6,QCU,0.5189,0.2,0.39,29,29,15,14,1.0,51.72,15,14,51.89,Facile,Difficile,Facile / Difficile
1621,792,2016,Mathématique,12,6,QCU,0.5874,0.1,0.32,31,30,18,12,1.03,60.0,18,13,58.74,Trop Facile,Difficile,Trop Facile / Difficile
2451,792,2017,Mathématique,12,6,QCU,0.0158,0.2,0.21,36,23,1,22,1.57,4.35,1,35,1.58,Trop Facile,Trop Difficile,Trop Facile / Trop Difficile
3281,792,2018,Mathématique,12,6,QCU,0.691,0.01,0.4,40,34,28,6,1.18,82.35,28,12,69.1,Trop Facile,Adapte,Trop Facile / Adapte
4111,792,2019,Mathématique,12,6,QCU,0.7112,0.2,0.5,42,34,30,4,1.24,88.24,30,12,71.12,Adapte,Adapte,Adapte / Adapte
4941,792,2020,Mathématique,12,6,QCU,0.6678,0.05,0.67,44,36,29,7,1.22,80.56,29,15,66.78,Adapte,Adapte,Adapte / Adapte
792,793,2015,Mathématique,12,7,QCU,0.0948,0.57,0.23,100,82,9,73,1.22,10.98,9,91,9.48,Trop Difficile,Trop Difficile,Trop Difficile / Trop Difficile
1622,793,2016,Mathématique,12,7,QCU,0.6389,0.06,0.69,111,105,71,34,1.06,67.62,71,40,63.89,Trop Facile,Adapte,Trop Facile / Adapte
2452,793,2017,Mathématique,12,7,QCU,0.6105,0.14,0.56,127,81,78,3,1.57,96.3,78,49,61.05,Adapte,Adapte,Adapte / Adapte
3282,793,2018,Mathématique,12,7,QCU,0.6289,0.3,0.59,127,103,80,23,1.23,77.67,80,47,62.89,Adapte,Adapte,Adapte / Adapte
4112,793,2019,Mathématique,12,7,QCU,0.712,0.11,0.49,113,94,80,14,1.2,85.11,80,33,71.2,Adapte,Adapte,Adapte / Adapte
4942,793,2020,Mathématique,12,7,QCU,0.655,0.12,0.66,119,80,78,2,1.49,97.5,78,41,65.5,Adapte,Adapte,Adapte / Adapte
793,794,2015,Mathématique,12,8,QCM,0.3219,0.37,0.38,55,36,18,18,1.53,50.0,18,37,32.19,Facile,Difficile,Facile / Difficile
1623,794,2016,Mathématique,12,8,QCM,0.8704,0.03,0.89,62,56,54,2,1.11,96.43,54,8,87.04,Trop Facile,Trop Facile,Trop Facile / Trop Facile
2453,794,2017,Mathématique,12,8,QCM,0.9156,0.02,0.92,60,60,55,5,1.0,91.67,55,5,91.56,Trop Facile,Trop Facile,Trop Facile / Trop Facile
3283,794,2018,Mathématique,12,8,QCM,0.5233,0.48,0.38,69,41,36,5,1.68,87.8,36,33,52.33,Trop Facile,Difficile,Trop Facile / Difficile
4113,794,2019,Mathématique,12,8,QCM,0.9998,0.09,0.91,63,63,63,0,1.0,100.0,63,0,99.98,Trop Facile,Trop Facile,Trop Facile / Trop Facile
4943,794,2020,Mathématique,12,8,QCM,0.9946,0.09,0.81,58,58,58,0,1.0,100.0,58,0,99.46,Trop Facile,Trop Facile,Trop Facile / Trop Facile
794,795,2015,Mathématique,13,1,QCM,0.7925,0.15,0.73,53,44,42,2,1.2,95.45,42,11,79.25,Trop Difficile,Facile,Trop Difficile / Facile
1624,795,2016,Mathématique,13,1,QCM,0.2285,0.41,0.22,60,53,14,39,1.13,26.42,14,46,22.85,Trop Facile,Trop Difficile,Trop Facile / Trop Difficile
2454,795,2017,Mathématique,13,1,QCM,0.2192,0.29,0.24,49,28,11,17,1.75,39.29,11,38,21.92,Trop Facile,Trop Difficile,Trop Facile / Trop Difficile
3284,795,2018,Mathématique,13,1,QCM,0.9563,0.06,0.97,53,51,51,0,1.04,100.0,51,2,95.63,Trop Facile,Trop Facile,Trop Facile / Trop Facile
4114,795,2019,Mathématique,13,1,QCM,0.9245,0.08,0.84,45,44,42,2,1.02,95.45,42,3,92.45,Trop Facile,Trop Facile,Trop Facile / Trop Facile
4944,795,2020,Mathématique,13,1,QCM,0.7443,0.23,0.58,39,35,29,6,1.11,82.86,29,10,74.43,Trop Facile,Adapte,Trop Facile / Adapte
795,796,2015,Mathématique,13,2,QCU,0.4538,0.34,0.37,36,34,16,18,1.06,47.06,16,20,45.38,Trop Facile,Difficile,Trop Facile / Difficile
1625,796,2016,Mathématique,13,2,QCU,0.9631,0.06,0.98,36,35,35,0,1.03,100.0,35,1,96.31,Trop Facile,Trop Facile,Trop Facile / Trop Facile
2455,796,2017,Mathématique,13,2,QCU,0.942,0.06,0.95,43,42,41,1,1.02,97.62,41,2,94.2,Trop Facile,Trop Facile,Trop Facile / Trop Facile
3285,796,2018,Mathématique,13,2,QCU,0.3666,0.2,0.4,49,42,18,24,1.17,42.86,18,31,36.66,Trop Facile,Difficile,Trop Facile / Difficile
4115,796,2019,Mathématique,13,2,QCU,0.4126,0.18,0.37,39,32,16,16,1.22,50.0,16,23,41.26,Trop Facile,Difficile,Trop Facile / Difficile
4945,796,2020,Mathématique,13,2,QCU,0.9986,0.07,0.94,38,38,38,0,1.0,100.0,38,0,99.86,Trop Facile,Trop Facile,Trop Facile / Trop Facile
796,797,2015,Mathématique,13,3,QCM,0.9885,0.07,0.83,26,26,26,0,1.0,100.0,26,0,98.85,Trop Facile,Trop Facile,Trop Facile / Trop Facile
1626,797,2016,Mathématique,13,3,QCM,0.9462,0.04,0.87,21,21,20,1,1.0,95.24,20,1,94.62,Trop Facile,Trop Facile,Trop Facile / Trop Facile
2456,797,2017,Mathématique,13,3,QCM,0.9874,0.06,0.94,20,20,20,0,1.0,100.0,20,0,98.74,Trop Facile,Trop Facile,Trop Facile / Trop Facile
3286,797,2018,Mathématique,13,3,QCM,0.989,0.03,0.91,21,21,21,0,1.0,100.0,21,0,98.9,Trop Facile,Trop Facile,Trop Facile / Trop Facile
4116,797,2019,Mathématique,13,3,QCM,0.4574,0.09,0.4,23,14,11,3,1.64,78.57,11,12,45.74,Trop Facile,Difficile,Trop Facile / Difficile
4946,797,2020,Mathématique,13,3,QCM,0.6539,0.27,0.48,21,21,14,7,1.0,66.67,14,7,65.39,Trop Facile,Adapte,Trop Facile / Adapte
797,798,2015,Mathématique,13,4,QCM,0.1229,0.49,0.22,75,35,9,26,2.14,25.71,9,66,12.29,Trop Facile,Trop Difficile,Trop Facile / Trop Difficile
1627,798,2016,Mathématique,13,4,QCM,0.033,0.05,0.23,80,67,3,64,1.19,4.48,3,77,3.3,Trop Facile,Trop Difficile,Trop Facile / Trop Difficile
2457,798,2017,Mathématique,13,4,QCM,0.9922,0.07,0.9,65,64,64,0,1.02,100.0,64,1,99.22,Trop Facile,Trop Facile,Trop Facile / Trop Facile
3287,798,2018,Mathématique,13,4,QCM,0.7889,0.06,0.7,54,50,43,7,1.08,86.0,43,11,78.89,Trop Facile,Facile,Trop Facile / Facile
4117,798,2019,Mathématique,13,4,QCM,0.9263,0.09,0.9,58,57,54,3,1.02,94.74,54,4,92.63,Trop Facile,Trop Facile,Trop Facile / Trop Facile
4947,798,2020,Mathématique,13,4,QCM,0.6964,0.22,0.62,50,45,35,10,1.11,77.78,35,15,69.64,Trop Facile,Adapte,Trop Facile / Adapte
798,799,2015,Mathématique,13,5,QCM,0.6351,0.24,0.41,84,56,53,3,1.5,94.64,53,31,63.51,Adapte,Adapte,Adapte / Adapte
1628,799,2016,Mathématique,13,5,QCM,0.6271,0.26,0.5,92,84,58,26,1.1,69.05,58,34,62.71,Adapte,Adapte,Adapte / Adapte
2458,799,2017,Mathématique,13,5,QCM,0.6074,0.05,0.6,104,67,63,4,1.55,94.03,63,41,60.74,Adapte,Adapte,Adapte / Adapte
3288,799,2018,Mathématique,13,5,QCM,0.6364,0.25,0.54,124,100,79,21,1.24,79.0,79,45,63.64,Adapte,Adapte,Adapte / Adapte
4118,799,2019,Mathématique,13,5,QCM,0.6906,0.08,0.59,126,123,87,36,1.02,70.73,87,39,69.06,Adapte,Adapte,Adapte / Adapte
4948,799,2020,Mathématique,13,5,QCM,0.6625,0.14,0.59,132,98,87,11,1.35,88.78,87,45,66.25,Adapte,Adapte,Adapte / Adapte
799,800,2015,Mathématique,13,6,QCM,0.0524,0.09,0.27,23,16,1,15,1.44,6.25,1,22,5.24,Facile,Trop Difficile,Facile / Trop Difficile
1629,800,2016,Mathématique,13,6,QCM,0.9146,0.1,0.88,24,23,22,1,1.04,95.65,22,2,91.46,Trop Facile,Trop Facile,Trop Facile / Trop Facile
2459,800,2017,Mathématique,13,6,QCM,0.9117,0.07,0.89,26,24,24,0,1.08,100.0,24,2,91.17,Trop Facile,Trop Facile,Trop Facile / Trop Facile
3289,800,2018,Mathématique,13,6,QCM,0.9047,0.06,0.81,31,29,28,1,1.07,96.55,28,3,90.47,Trop Facile,Trop Facile,Trop Facile / Trop Facile
4119,800,2019,Mathématique,13,6,QCM,0.9872,0.09,0.95,34,34,34,0,1.0,100.0,34,0,98.72,Trop Facile,Trop Facile,Trop Facile / Trop Facile
4949,800,2020,Mathématique,13,6,QCM,0.6821,0.24,0.53,32,26,22,4,1.23,84.62,22,10,68.21,Trop Facile,Adapte,Trop Facile / Adapte
800,801,2015,Mathématique,13,7,QCM,0.7774,0.0,0.76,79,78,61,17,1.01,78.21,61,18,77.74,Facile,Facile,Facile / Facile
1630,801,2016,Mathématique,13,7,QCM,0.6662,0.17,0.47,91,71,61,10,1.28,85.92,61,30,66.62,Trop Facile,Adapte,Trop Facile / Adapte
2460,801,2017,Mathématique,13,7,QCM,0.6673,0.23,0.59,95,75,63,12,1.27,84.0,63,32,66.73,Adapte,Adapte,Adapte / Adapte
3290,801,2018,Mathématique,13,7,QCM,0.6797,0.2,0.63,91,65,62,3,1.4,95.38,62,29,67.97,Adapte,Adapte,Adapte / Adapte
4120,801,2019,Mathématique,13,7,QCM,0.624,0.03,0.4,97,76,61,15,1.28,80.26,61,36,62.4,Adapte,Adapte,Adapte / Adapte
4950,801,2020,Mathématique,13,7,QCM,0.7238,0.04,0.48,103,91,75,16,1.13,82.42,75,28,72.38,Adapte,Adapte,Adapte / Adapte
801,802,2015,Mathématique,13,8,QROC,0.9681,0.05,0.66,59,59,57,2,1.0,96.61,57,2,96.81,Facile,Trop Facile,Facile / Trop Facile
1631,802,2016,Mathématique,13,8,QROC,0.9002,0.08,0.59,63,59,57,2,1.07,96.61,57,6,90.02,Trop Facile,Trop Facile,Trop Facile / Trop Facile
2461,802,2017,Mathématique,13,8,QROC,0.3283,0.55,0.19,53,43,17,26,1.23,39.53,17,36,32.83,Trop Facile,Difficile,Trop Facile / Difficile
3291,802,2018,Mathématique,13,8,QROC,0.6225,0.44,0.27,62,42,39,3,1.48,92.86,39,23,62.25,Trop Facile,Adapte,Trop Facile / Adapte
4121,802,2019,Mathématique,13,8,QROC,0.7029,0.22,0.34,66,47,46,1,1.4,97.87,46,20,70.29,Adapte,Adapte,Adapte / Adapte
4951,802,2020,Mathématique,13,8,QROC,0.6115,0.38,0.25,58,40,35,5,1.45,87.5,35,23,61.15,Adapte,Adapte,Adapte / Adapte
802,803,2015,Mathématique,13,9,QCM,0.6338,0.15,0.42,70,65,44,21,1.08,67.69,44,26,63.38,Facile,Adapte,Facile / Adapte
1632,803,2016,Mathématique,13,9,QCM,0.6544,0.04,0.54,79,52,52,0,1.52,100.0,52,27,65.44,Adapte,Adapte,Adapte / Adapte
2462,803,2017,Mathématique,13,9,QCM,0.7069,0.06,0.46,75,62,53,9,1.21,85.48,53,22,70.69,Adapte,Adapte,Adapte / Adapte
3292,803,2018,Mathématique,13,9,QCM,0.6269,0.09,0.62,85,54,53,1,1.57,98.15,53,32,62.69,Adapte,Adapte,Adapte / Adapte
4122,803,2019,Mathématique,13,9,QCM,0.6824,0.28,0.67,97,93,66,27,1.04,70.97,66,31,68.24,Adapte,Adapte,Adapte / Adapte
4952,803,2020,Mathématique,13,9,QCM,0.6938,0.24,0.6,105,92,73,19,1.14,79.35,73,32,69.38,Adapte,Adapte,Adapte / Adapte
803,804,2015,Mathématique,13,10,QCU,0.0661,0.63,0.28,95,39,6,33,2.44,15.38,6,89,6.61,Adapte,Trop Difficile,Adapte / Trop Difficile
1633,804,2016,Mathématique,13,10,QCU,0.894,0.04,0.93,95,90,85,5,1.06,94.44,85,10,89.4,Trop Facile,Trop Facile,Trop Facile / Trop Facile
2463,804,2017,Mathématique,13,10,QCU,0.6475,0.11,0.4,97,85,63,22,1.14,74.12,63,34,64.75,Trop Facile,Adapte,Trop Facile / Adapte
3293,804,2018,Mathématique,13,10,QCU,0.6639,0.26,0.44,99,99,66,33,1.0,66.67,66,33,66.39,Adapte,Adapte,Adapte / Adapte
4123,804,2019,Mathématique,13,10,QCU,0.6401,0.08,0.42,90,63,58,5,1.43,92.06,58,32,64.01,Adapte,Adapte,Adapte / Adapte
4953,804,2020,Mathématique,13,10,QCU,0.626,0.2,0.59,97,72,61,11,1.35,84.72,61,36,62.6,Adapte,Adapte,Adapte / Adapte
804,805,2015,Mathématique,13,11,QCU,0.0011,0.16,0.27,49,30,0,30,1.63,0.0,0,49,0.11,Trop Difficile,Trop Difficile,Trop Difficile / Trop Difficile
1634,805,2016,Mathématique,13,11,QCU,0.9975,0.07,0.9,58,58,58,0,1.0,100.0,58,0,99.75,Trop Facile,Trop Facile,Trop Facile / Trop Facile
2464,805,2017,Mathématique,13,11,QCU,0.9755,0.09,0.94,50,50,49,1,1.0,98.0,49,1,97.55,Trop Facile,Trop Facile,Trop Facile / Trop Facile
3294,805,2018,Mathématique,13,11,QCU,0.167,0.1,0.28,46,41,8,33,1.12,19.51,8,38,16.7,Trop Facile,Trop Difficile,Trop Facile / Trop Difficile
4124,805,2019,Mathématique,13,11,QCU,0.9375,0.04,0.9,40,39,38,1,1.03,97.44,38,2,93.75,Trop Facile,Trop Facile,Trop Facile / Trop Facile
4954,805,2020,Mathématique,13,11,QCU,0.6782,0.14,0.48,42,36,28,8,1.17,77.78,28,14,67.82,Trop Facile,Adapte,Trop Facile / Adapte
805,806,2015,Mathématique,13,12,QCM,0.3965,0.36,0.35,67,38,27,11,1.76,71.05,27,40,39.65,Adapte,Difficile,Adapte / Difficile
1635,806,2016,Mathématique,13,12,QCM,0.6535,0.21,0.63,68,66,44,22,1.03,66.67,44,24,65.35,Trop Facile,Adapte,Trop Facile / Adapte
2465,806,2017,Mathématique,13,12,QCM,0.638,0.11,0.48,73,54,47,7,1.35,87.04,47,26,63.8,Adapte,Adapte,Adapte / Adapte
3295,806,2018,Mathématique,13,12,QCM,0.7401,0.27,0.66,84,75,62,13,1.12,82.67,62,22,74.01,Adapte,Adapte,Adapte / Adapte
4125,806,2019,Mathématique,13,12,QCM,0.6466,0.05,0.59,96,80,62,18,1.2,77.5,62,34,64.66,Adapte,Adapte,Adapte / Adapte
4955,806,2020,Mathématique,13,12,QCM,0.6785,0.08,0.6,115,113,78,35,1.02,69.03,78,37,67.85,Adapte,Adapte,Adapte / Adapte
806,807,2015,Mathématique,14,1,QCM,0.975,0.06,0.83,32,31,31,0,1.03,100.0,31,1,97.5,Trop Facile,Trop Facile,Trop Facile / Trop Facile
1636,807,2016,Mathématique,14,1,QCM,0.8988,0.0,0.95,26,26,23,3,1.0,88.46,23,3,89.88,Trop Facile,Trop Facile,Trop Facile / Trop Facile
2466,807,2017,Mathématique,14,1,QCM,0.9134,0.07,0.88,24,23,22,1,1.04,95.65,22,2,91.34,Trop Facile,Trop Facile,Trop Facile / Trop Facile
3296,807,2018,Mathématique,14,1,QCM,0.8933,0.05,0.89,22,21,20,1,1.05,95.24,20,2,89.33,Trop Facile,Trop Facile,Trop Facile / Trop Facile
4126,807,2019,Mathématique,14,1,QCM,0.3107,0.4,0.31,20,16,6,10,1.25,37.5,6,14,31.07,Trop Facile,Difficile,Trop Facile / Difficile
4956,807,2020,Mathématique,14,1,QCM,0.9645,0.0,0.99,23,23,22,1,1.0,95.65,22,1,96.45,Trop Facile,Trop Facile,Trop Facile / Trop Facile
807,808,2015,Mathématique,14,2,QO,0.3939,0.76,0.15,66,34,26,8,1.94,76.47,26,40,39.39,Difficile,Difficile,Difficile / Difficile
1637,808,2016,Mathématique,14,2,QO,0.9022,0.05,0.73,54,50,49,1,1.08,98.0,49,5,90.22,Trop Facile,Trop Facile,Trop Facile / Trop Facile
2467,808,2017,Mathématique,14,2,QO,0.9968,0.01,0.55,48,48,48,0,1.0,100.0,48,0,99.68,Trop Facile,Trop Facile,Trop Facile / Trop Facile
3297,808,2018,Mathématique,14,2,QO,0.9603,0.06,0.85,40,38,38,0,1.05,100.0,38,2,96.03,Trop Facile,Trop Facile,Trop Facile / Trop Facile
4127,808,2019,Mathématique,14,2,QO,0.8693,0.1,0.63,34,33,30,3,1.03,90.91,30,4,86.93,Trop Facile,Trop Facile,Trop Facile / Trop Facile
4957,808,2020,Mathématique,14,2,QO,0.9281,0.09,0.71,39,38,36,2,1.03,94.74,36,3,92.81,Trop Facile,Trop Facile,Trop Facile / Trop Facile
808,809,2015,Mathématique,14,3,QCM,0.9547,0.01,0.82,76,74,73,1,1.03,98.65,73,3,95.47,Trop Facile,Trop Facile,Trop Facile / Trop Facile
1638,809,2016,Mathématique,14,3,QCM,0.9736,0.04,0.85,72,72,70,2,1.0,97.22,70,2,97.36,Trop Facile,Trop Facile,Trop Facile / Trop Facile
2468,809,2017,Mathématique,14,3,QCM,0.8041,0.11,0.73,71,68,57,11,1.04,83.82,57,14,80.41,Trop Facile,Facile,Trop Facile / Facile
3298,809,2018,Mathématique,14,3,QCM,0.9388,0.05,0.85,74,73,69,4,1.01,94.52,69,5,93.88,Trop Facile,Trop Facile,Trop Facile / Trop Facile
4128,809,2019,Mathématique,14,3,QCM,0.9727,0.08,0.92,85,83,83,0,1.02,100.0,83,2,97.27,Trop Facile,Trop Facile,Trop Facile / Trop Facile
4958,809,2020,Mathématique,14,3,QCM,0.9718,0.09,0.87,72,71,70,1,1.01,98.59,70,2,97.18,Trop Facile,Trop Facile,Trop Facile / Trop Facile
809,810,2015,Mathématique,14,4,QCU,0.333,0.09,0.32,25,9,8,1,2.78,88.89,8,17,33.3,Trop Facile,Difficile,Trop Facile / Difficile
1639,810,2016,Mathématique,14,4,QCU,0.9586,0.02,0.9,21,21,20,1,1.0,95.24,20,1,95.86,Trop Facile,Trop Facile,Trop Facile / Trop Facile
2469,810,2017,Mathématique,14,4,QCU,0.98,0.06,0.93,24,24,24,0,1.0,100.0,24,0,98.0,Trop Facile,Trop Facile,Trop Facile / Trop Facile
3299,810,2018,Mathématique,14,4,QCU,0.9379,0.05,0.92,20,19,19,0,1.05,100.0,19,1,93.79,Trop Facile,Trop Facile,Trop Facile / Trop Facile
4129,810,2019,Mathématique,14,4,QCU,0.5862,0.32,0.37,21,20,12,8,1.05,60.0,12,9,58.62,Trop Facile,Difficile,Trop Facile / Difficile
4959,810,2020,Mathématique,14,4,QCU,0.911,0.03,0.93,25,23,23,0,1.09,100.0,23,2,91.1,Trop Facile,Trop Facile,Trop Facile / Trop Facile
810,811,2015,Mathématique,14,5,QCM,0.6272,0.06,0.59,43,33,27,6,1.3,81.82,27,16,62.72,Facile,Adapte,Facile / Adapte
1640,811,2016,Mathématique,14,5,QCM,0.6464,0.12,0.51,40,34,26,8,1.18,76.47,26,14,64.64,Adapte,Adapte,Adapte / Adapte
2470,811,2017,Mathématique,14,5,QCM,0.6828,0.26,0.44,34,32,23,9,1.06,71.88,23,11,68.28,Adapte,Adapte,Adapte / Adapte
3300,811,2018,Mathématique,14,5,QCM,0.6836,0.22,0.7,35,28,24,4,1.25,85.71,24,11,68.36,Adapte,Adapte,Adapte / Adapte
4130,811,2019,Mathématique,14,5,QCM,0.6521,0.02,0.65,31,30,20,10,1.03,66.67,20,11,65.21,Adapte,Adapte,Adapte / Adapte
4960,811,2020,Mathématique,14,5,QCM,0.6658,0.07,0.55,32,23,21,2,1.39,91.3,21,11,66.58,Adapte,Adapte,Adapte / Adapte
811,812,2015,Mathématique,14,6,QCU,0.1135,0.57,0.21,100,59,11,48,1.69,18.64,11,89,11.35,Difficile,Trop Difficile,Difficile / Trop Difficile
1641,812,2016,Mathématique,14,6,QCU,0.8983,0.02,0.99,119,118,107,11,1.01,90.68,107,12,89.83,Trop Facile,Trop Facile,Trop Facile / Trop Facile
2471,812,2017,Mathématique,14,6,QCU,0.9075,0.04,0.95,112,105,102,3,1.07,97.14,102,10,90.75,Trop Facile,Trop Facile,Trop Facile / Trop Facile
3301,812,2018,Mathématique,14,6,QCU,0.9452,0.08,0.99,94,92,89,3,1.02,96.74,89,5,94.52,Trop Facile,Trop Facile,Trop Facile / Trop Facile
4131,812,2019,Mathématique,14,6,QCU,0.9845,0.09,0.93,90,90,89,1,1.0,98.89,89,1,98.45,Trop Facile,Trop Facile,Trop Facile / Trop Facile
4961,812,2020,Mathématique,14,6,QCU,0.7968,0.11,0.85,104,97,83,14,1.07,85.57,83,21,79.68,Trop Facile,Facile,Trop Facile / Facile
812,813,2015,Mathématique,14,7,QCU,0.0007,0.22,0.26,52,38,0,38,1.37,0.0,0,52,0.07,Trop Difficile,Trop Difficile,Trop Difficile / Trop Difficile
1642,813,2016,Mathématique,14,7,QCU,0.0578,0.13,0.22,44,35,3,32,1.26,8.57,3,41,5.78,Trop Facile,Trop Difficile,Trop Facile / Trop Difficile
2472,813,2017,Mathématique,14,7,QCU,0.8775,0.08,0.96,51,48,45,3,1.06,93.75,45,6,87.75,Trop Facile,Trop Facile,Trop Facile / Trop Facile
3302,813,2018,Mathématique,14,7,QCU,0.99,0.05,0.96,57,57,56,1,1.0,98.25,56,1,99.0,Trop Facile,Trop Facile,Trop Facile / Trop Facile
4132,813,2019,Mathématique,14,7,QCU,0.9012,0.03,0.91,51,50,46,4,1.02,92.0,46,5,90.12,Trop Facile,Trop Facile,Trop Facile / Trop Facile
4962,813,2020,Mathématique,14,7,QCU,0.3416,0.39,0.38,43,28,15,13,1.54,53.57,15,28,34.16,Trop Facile,Difficile,Trop Facile / Difficile
813,814,2015,Mathématique,14,8,QCU,0.8669,0.07,0.98,13,12,11,1,1.08,91.67,11,2,86.69,Facile,Trop Facile,Facile / Trop Facile
1643,814,2016,Mathématique,14,8,QCU,0.4983,0.34,0.37,13,9,6,3,1.44,66.67,6,7,49.83,Trop Facile,Difficile,Trop Facile / Difficile
2473,814,2017,Mathématique,14,8,QCU,0.9185,0.03,1.0,11,10,10,0,1.1,100.0,10,1,91.85,Trop Facile,Trop Facile,Trop Facile / Trop Facile
3303,814,2018,Mathématique,14,8,QCU,0.4399,0.3,0.35,9,6,4,2,1.5,66.67,4,5,43.99,Trop Facile,Difficile,Trop Facile / Difficile
4133,814,2019,Mathématique,14,8,QCU,0.8775,0.06,0.95,10,9,9,0,1.11,100.0,9,1,87.75,Trop Facile,Trop Facile,Trop Facile / Trop Facile
4963,814,2020,Mathématique,14,8,QCU,0.6079,0.02,0.42,11,10,7,3,1.1,70.0,7,4,60.79,Trop Facile,Adapte,Trop Facile / Adapte
814,815,2015,Mathématique,14,9,QCU,0.1558,0.15,0.23,30,30,5,25,1.0,16.67,5,25,15.58,Trop Difficile,Trop Difficile,Trop Difficile / Trop Difficile
1644,815,2016,Mathématique,14,9,QCU,0.1018,0.04,0.29,31,11,3,8,2.82,27.27,3,28,10.18,Trop Facile,Trop Difficile,Trop Facile / Trop Difficile
2474,815,2017,Mathématique,14,9,QCU,0.7755,0.15,0.84,37,37,29,8,1.0,78.38,29,8,77.55,Trop Facile,Facile,Trop Facile / Facile
3304,815,2018,Mathématique,14,9,QCU,0.9388,0.02,0.98,34,32,32,0,1.06,100.0,32,2,93.88,Trop Facile,Trop Facile,Trop Facile / Trop Facile
4134,815,2019,Mathématique,14,9,QCU,0.9462,0.02,1.0,27,27,26,1,1.0,96.3,26,1,94.62,Trop Facile,Trop Facile,Trop Facile / Trop Facile
4964,815,2020,Mathématique,14,9,QCU,0.8981,0.03,0.9,28,25,25,0,1.12,100.0,25,3,89.81,Trop Facile,Trop Facile,Trop Facile / Trop Facile
815,816,2015,Mathématique,14,10,QCU,0.6194,0.04,0.53,88,58,55,3,1.52,94.83,55,33,61.94,Difficile,Adapte,Difficile / Adapte
1645,816,2016,Mathématique,14,10,QCU,0.623,0.16,0.43,92,65,57,8,1.42,87.69,57,35,62.3,Adapte,Adapte,Adapte / Adapte
2475,816,2017,Mathématique,14,10,QCU,0.6283,0.15,0.5,87,59,55,4,1.47,93.22,55,32,62.83,Adapte,Adapte,Adapte / Adapte
3305,816,2018,Mathématique,14,10,QCU,0.6536,0.15,0.46,77,77,50,27,1.0,64.94,50,27,65.36,Adapte,Adapte,Adapte / Adapte
4135,816,2019,Mathématique,14,10,QCU,0.6636,0.29,0.6,89,75,59,16,1.19,78.67,59,30,66.36,Adapte,Adapte,Adapte / Adapte
4965,816,2020,Mathématique,14,10,QCU,0.7381,0.17,0.41,90,83,66,17,1.08,79.52,66,24,73.81,Adapte,Adapte,Adapte / Adapte
816,817,2015,Mathématique,15,1,QO,0.0477,0.96,0.09,47,35,2,33,1.34,5.71,2,45,4.77,Trop Difficile,Trop Difficile,Trop Difficile / Trop Difficile
1646,817,2016,Mathématique,15,1,QO,0.6423,0.39,0.24,56,50,36,14,1.12,72.0,36,20,64.23,Trop Facile,Adapte,Trop Facile / Adapte
2476,817,2017,Mathématique,15,1,QO,0.6418,0.29,0.25,65,65,42,23,1.0,64.62,42,23,64.18,Adapte,Adapte,Adapte / Adapte
3306,817,2018,Mathématique,15,1,QO,0.7026,0.4,0.26,57,52,40,12,1.1,76.92,40,17,70.26,Adapte,Adapte,Adapte / Adapte
4136,817,2019,Mathématique,15,1,QO,0.722,0.26,0.15,66,57,48,9,1.16,84.21,48,18,72.2,Adapte,Adapte,Adapte / Adapte
4966,817,2020,Mathématique,15,1,QO,0.6772,0.44,0.26,62,58,42,16,1.07,72.41,42,20,67.72,Adapte,Adapte,Adapte / Adapte
817,818,2015,Mathématique,15,2,QCU,0.7015,0.16,0.46,62,47,43,4,1.32,91.49,43,19,70.15,Difficile,Adapte,Difficile / Adapte
1647,818,2016,Mathématique,15,2,QCU,0.7255,0.2,0.53,56,45,41,4,1.24,91.11,41,15,72.55,Adapte,Adapte,Adapte / Adapte
2477,818,2017,Mathématique,15,2,QCU,0.7323,0.24,0.41,47,36,34,2,1.31,94.44,34,13,73.23,Adapte,Adapte,Adapte / Adapte
3307,818,2018,Mathématique,15,2,QCU,0.7117,0.16,0.47,51,37,36,1,1.38,97.3,36,15,71.17,Adapte,Adapte,Adapte / Adapte
4137,818,2019,Mathématique,15,2,QCU,0.7015,0.09,0.69,58,46,41,5,1.26,89.13,41,17,70.15,Adapte,Adapte,Adapte / Adapte
4967,818,2020,Mathématique,15,2,QCU,0.749,0.03,0.62,69,58,52,6,1.19,89.66,52,17,74.9,Adapte,Adapte,Adapte / Adapte
818,819,2015,Mathématique,15,3,QCM,0.3938,0.06,0.39,8,7,3,4,1.14,42.86,3,5,39.38,Difficile,Difficile,Difficile / Difficile
1648,819,2016,Mathématique,15,3,QCM,0.9066,0.01,0.86,10,10,9,1,1.0,90.0,9,1,90.66,Trop Facile,Trop Facile,Trop Facile / Trop Facile
2478,819,2017,Mathématique,15,3,QCM,0.7008,0.1,0.66,8,8,6,2,1.0,75.0,6,2,70.08,Trop Facile,Adapte,Trop Facile / Adapte
3308,819,2018,Mathématique,15,3,QCM,0.6824,0.14,0.52,8,5,5,0,1.6,100.0,5,3,68.24,Adapte,Adapte,Adapte / Adapte
4138,819,2019,Mathématique,15,3,QCM,0.6191,0.18,0.55,6,6,4,2,1.0,66.67,4,2,61.91,Adapte,Adapte,Adapte / Adapte
4968,819,2020,Mathématique,15,3,QCM,0.6338,0.04,0.56,6,4,4,0,1.5,100.0,4,2,63.38,Adapte,Adapte,Adapte / Adapte
819,820,2015,Mathématique,15,4,QCU,0.9335,0.04,0.92,24,23,22,1,1.04,95.65,22,2,93.35,Trop Facile,Trop Facile,Trop Facile / Trop Facile
1649,820,2016,Mathématique,15,4,QCU,0.9177,0.07,0.98,22,21,20,1,1.05,95.24,20,2,91.77,Trop Facile,Trop Facile,Trop Facile / Trop Facile
2479,820,2017,Mathématique,15,4,QCU,0.9914,0.05,0.94,25,25,25,0,1.0,100.0,25,0,99.14,Trop Facile,Trop Facile,Trop Facile / Trop Facile
3309,820,2018,Mathématique,15,4,QCU,0.9389,0.0,0.98,23,22,22,0,1.05,100.0,22,1,93.89,Trop Facile,Trop Facile,Trop Facile / Trop Facile
4139,820,2019,Mathématique,15,4,QCU,0.9011,0.01,0.94,21,20,19,1,1.05,95.0,19,2,90.11,Trop Facile,Trop Facile,Trop Facile / Trop Facile
4969,820,2020,Mathématique,15,4,QCU,0.8869,0.08,0.93,21,19,19,0,1.11,100.0,19,2,88.69,Trop Facile,Trop Facile,Trop Facile / Trop Facile
820,821,2015,Mathématique,15,5,QCU,0.6274,0.02,0.66,69,49,43,6,1.41,87.76,43,26,62.74,Trop Difficile,Adapte,Trop Difficile / Adapte
1650,821,2016,Mathématique,15,5,QCU,0.6773,0.25,0.57,63,59,43,16,1.07,72.88,43,20,67.73,Adapte,Adapte,Adapte / Adapte
2480,821,2017,Mathématique,15,5,QCU,0.6954,0.07,0.44,76,56,53,3,1.36,94.64,53,23,69.54,Adapte,Adapte,Adapte / Adapte
3310,821,2018,Mathématique,15,5,QCU,0.7104,0.04,0.61,72,58,51,7,1.24,87.93,51,21,71.04,Adapte,Adapte,Adapte / Adapte
4140,821,2019,Mathématique,15,5,QCU,0.6451,0.28,0.44,79,73,51,22,1.08,69.86,51,28,64.51,Adapte,Adapte,Adapte / Adapte
4970,821,2020,Mathématique,15,5,QCU,0.6413,0.17,0.65,71,59,46,13,1.2,77.97,46,25,64.13,Adapte,Adapte,Adapte / Adapte
821,822,2015,Mathématique,15,6,QCU,0.5365,0.05,0.37,33,29,18,11,1.14,62.07,18,15,53.65,Difficile,Difficile,Difficile / Difficile
1651,822,2016,Mathématique,15,6,QCU,0.2943,0.39,0.33,28,20,8,12,1.4,40.0,8,20,29.43,Trop Facile,Difficile,Trop Facile / Difficile
2481,822,2017,Mathématique,15,6,QCU,0.9356,0.1,0.98,24,23,22,1,1.04,95.65,22,2,93.56,Trop Facile,Trop Facile,Trop Facile / Trop Facile
3311,822,2018,Mathématique,15,6,QCU,0.8729,0.05,0.95,19,18,17,1,1.06,94.44,17,2,87.29,Trop Facile,Trop Facile,Trop Facile / Trop Facile
4141,822,2019,Mathématique,15,6,QCU,0.9082,0.01,0.98,16,15,15,0,1.07,100.0,15,1,90.82,Trop Facile,Trop Facile,Trop Facile / Trop Facile
4971,822,2020,Mathématique,15,6,QCU,0.1978,0.54,0.24,13,6,3,3,2.17,50.0,3,10,19.78,Trop Facile,Trop Difficile,Trop Facile / Trop Difficile
822,823,2015,Mathématique,15,7,QCM,0.9474,0.04,0.84,44,42,42,0,1.05,100.0,42,2,94.74,Trop Facile,Trop Facile,Trop Facile / Trop Facile
1652,823,2016,Mathématique,15,7,QCM,0.9062,0.05,0.83,35,35,32,3,1.0,91.43,32,3,90.62,Trop Facile,Trop Facile,Trop Facile / Trop Facile
2482,823,2017,Mathématique,15,7,QCM,0.8859,0.07,0.92,29,27,26,1,1.07,96.3,26,3,88.59,Trop Facile,Trop Facile,Trop Facile / Trop Facile
3312,823,2018,Mathématique,15,7,QCM,0.9446,0.04,0.86,35,35,33,2,1.0,94.29,33,2,94.46,Trop Facile,Trop Facile,Trop Facile / Trop Facile
4142,823,2019,Mathématique,15,7,QCM,0.6245,0.29,0.6,39,30,24,6,1.3,80.0,24,15,62.45,Trop Facile,Adapte,Trop Facile / Adapte
4972,823,2020,Mathématique,15,7,QCM,0.7296,0.11,0.41,47,45,34,11,1.04,75.56,34,13,72.96,Adapte,Adapte,Adapte / Adapte
823,824,2015,Mathématique,15,8,QCM,0.1169,0.14,0.21,69,33,8,25,2.09,24.24,8,61,11.69,Trop Difficile,Trop Difficile,Trop Difficile / Trop Difficile
1653,824,2016,Mathématique,15,8,QCM,0.9269,0.07,0.95,60,56,56,0,1.07,100.0,56,4,92.69,Trop Facile,Trop Facile,Trop Facile / Trop Facile
2483,824,2017,Mathématique,15,8,QCM,0.9829,0.05,0.94,67,66,66,0,1.02,100.0,66,1,98.29,Trop Facile,Trop Facile,Trop Facile / Trop Facile
3313,824,2018,Mathématique,15,8,QCM,0.9617,0.09,0.96,55,54,53,1,1.02,98.15,53,2,96.17,Trop Facile,Trop Facile,Trop Facile / Trop Facile
4143,824,2019,Mathématique,15,8,QCM,0.6757,0.12,0.66,64,62,43,19,1.03,69.35,43,21,67.57,Trop Facile,Adapte,Trop Facile / Adapte
4973,824,2020,Mathématique,15,8,QCM,0.708,0.1,0.4,56,44,40,4,1.27,90.91,40,16,70.8,Adapte,Adapte,Adapte / Adapte
824,825,2015,Mathématique,16,1,QCM,0.7603,0.14,0.75,5,4,4,0,1.25,100.0,4,1,76.03,Trop Difficile,Facile,Trop Difficile / Facile
1654,825,2016,Mathématique,16,1,QCM,0.2347,0.38,0.22,4,2,1,1,2.0,50.0,1,3,23.47,Trop Facile,Trop Difficile,Trop Facile / Trop Difficile
2484,825,2017,Mathématique,16,1,QCM,0.8735,0.01,0.84,4,3,3,0,1.33,100.0,3,1,87.35,Trop Facile,Trop Facile,Trop Facile / Trop Facile
3314,825,2018,Mathématique,16,1,QCM,0.9377,0.04,0.91,3,3,3,0,1.0,100.0,3,0,93.77,Trop Facile,Trop Facile,Trop Facile / Trop Facile
4144,825,2019,Mathématique,16,1,QCM,0.9897,0.04,0.82,3,3,3,0,1.0,100.0,3,0,98.97,Trop Facile,Trop Facile,Trop Facile / Trop Facile
4974,825,2020,Mathématique,16,1,QCM,0.984,0.02,0.99,3,3,3,0,1.0,100.0,3,0,98.4,Trop Facile,Trop Facile,Trop Facile / Trop Facile
825,826,2015,Mathématique,16,2,QCM,0.1527,0.32,0.28,53,37,8,29,1.43,21.62,8,45,15.27,Trop Difficile,Trop Difficile,Trop Difficile / Trop Difficile
1655,826,2016,Mathématique,16,2,QCM,0.9453,0.09,0.92,47,46,44,2,1.02,95.65,44,3,94.53,Trop Facile,Trop Facile,Trop Facile / Trop Facile
2485,826,2017,Mathématique,16,2,QCM,0.9706,0.03,0.83,39,38,38,0,1.03,100.0,38,1,97.06,Trop Facile,Trop Facile,Trop Facile / Trop Facile
3315,826,2018,Mathématique,16,2,QCM,0.9222,0.0,0.93,32,30,30,0,1.07,100.0,30,2,92.22,Trop Facile,Trop Facile,Trop Facile / Trop Facile
4145,826,2019,Mathématique,16,2,QCM,0.9353,0.01,0.94,36,34,34,0,1.06,100.0,34,2,93.53,Trop Facile,Trop Facile,Trop Facile / Trop Facile
4975,826,2020,Mathématique,16,2,QCM,0.9462,0.08,0.98,42,41,40,1,1.02,97.56,40,2,94.62,Trop Facile,Trop Facile,Trop Facile / Trop Facile
826,827,2015,Mathématique,16,3,QCU,0.194,0.28,0.26,58,42,11,31,1.38,26.19,11,47,19.4,Trop Difficile,Trop Difficile,Trop Difficile / Trop Difficile
1656,827,2016,Mathématique,16,3,QCU,0.9807,0.0,0.97,65,65,64,1,1.0,98.46,64,1,98.07,Trop Facile,Trop Facile,Trop Facile / Trop Facile
2486,827,2017,Mathématique,16,3,QCU,0.9338,0.04,0.94,58,57,54,3,1.02,94.74,54,4,93.38,Trop Facile,Trop Facile,Trop Facile / Trop Facile
3316,827,2018,Mathématique,16,3,QCU,0.8047,0.11,0.86,67,57,54,3,1.18,94.74,54,13,80.47,Trop Facile,Facile,Trop Facile / Facile
4146,827,2019,Mathématique,16,3,QCU,0.9596,0.09,0.98,63,62,60,2,1.02,96.77,60,3,95.96,Trop Facile,Trop Facile,Trop Facile / Trop Facile
4976,827,2020,Mathématique,16,3,QCU,0.9385,0.08,0.98,68,64,64,0,1.06,100.0,64,4,93.85,Trop Facile,Trop Facile,Trop Facile / Trop Facile
827,828,2015,Mathématique,17,1,QCM,0.7019,0.19,0.56,74,57,52,5,1.3,91.23,52,22,70.19,Adapte,Adapte,Adapte / Adapte
1657,828,2016,Mathématique,17,1,QCM,0.6707,0.0,0.54,89,81,60,21,1.1,74.07,60,29,67.07,Adapte,Adapte,Adapte / Adapte
2487,828,2017,Mathématique,17,1,QCM,0.7473,0.22,0.62,85,71,64,7,1.2,90.14,64,21,74.73,Adapte,Adapte,Adapte / Adapte
3317,828,2018,Mathématique,17,1,QCM,0.6723,0.05,0.46,89,76,60,16,1.17,78.95,60,29,67.23,Adapte,Adapte,Adapte / Adapte
4147,828,2019,Mathématique,17,1,QCM,0.741,0.05,0.58,83,77,62,15,1.08,80.52,62,21,74.1,Adapte,Adapte,Adapte / Adapte
4977,828,2020,Mathématique,17,1,QCM,0.6716,0.02,0.54,76,51,51,0,1.49,100.0,51,25,67.16,Adapte,Adapte,Adapte / Adapte
828,829,2015,Mathématique,17,2,QCU,0.2796,0.34,0.33,51,18,14,4,2.83,77.78,14,37,27.96,Difficile,Difficile,Difficile / Difficile
1658,829,2016,Mathématique,17,2,QCU,0.9853,0.02,1.0,41,40,40,0,1.02,100.0,40,1,98.53,Trop Facile,Trop Facile,Trop Facile / Trop Facile
2488,829,2017,Mathématique,17,2,QCU,0.9566,0.02,0.9,44,43,42,1,1.02,97.67,42,2,95.66,Trop Facile,Trop Facile,Trop Facile / Trop Facile
3318,829,2018,Mathématique,17,2,QCU,0.9941,0.01,0.95,44,44,44,0,1.0,100.0,44,0,99.41,Trop Facile,Trop Facile,Trop Facile / Trop Facile
4148,829,2019,Mathématique,17,2,QCU,0.1343,0.61,0.3,51,22,7,15,2.32,31.82,7,44,13.43,Trop Facile,Trop Difficile,Trop Facile / Trop Difficile
4978,829,2020,Mathématique,17,2,QCU,0.1398,0.3,0.24,54,47,8,39,1.15,17.02,8,46,13.98,Trop Facile,Trop Difficile,Trop Facile / Trop Difficile
829,830,2015,Mathématique,17,3,QCU,0.2997,0.08,0.32,53,43,16,27,1.23,37.21,16,37,29.97,Trop Facile,Difficile,Trop Facile / Difficile
1659,830,2016,Mathématique,17,3,QCU,0.7441,0.28,0.48,43,36,32,4,1.19,88.89,32,11,74.41,Trop Facile,Adapte,Trop Facile / Adapte
2489,830,2017,Mathématique,17,3,QCU,0.6784,0.14,0.6,44,36,30,6,1.22,83.33,30,14,67.84,Adapte,Adapte,Adapte / Adapte
3319,830,2018,Mathématique,17,3,QCU,0.7197,0.29,0.43,40,32,29,3,1.25,90.62,29,11,71.97,Adapte,Adapte,Adapte / Adapte
4149,830,2019,Mathématique,17,3,QCU,0.7314,0.07,0.55,37,32,27,5,1.16,84.38,27,10,73.14,Adapte,Adapte,Adapte / Adapte
4979,830,2020,Mathématique,17,3,QCU,0.7111,0.02,0.42,42,41,30,11,1.02,73.17,30,12,71.11,Adapte,Adapte,Adapte / Adapte
