,Year,Departement,Module_ID,Module,Chapter_ID,Chapter,Quiz_perChapter,Quizz_ID,Rank_onChapter,Quizz_Type,Slip,Guess,Success_Prct,Success_Attempts,Failure_Attempts,Number_Attempts,UniQ_Learner,Sucessful_Learners,Unsucessful_Learners,Avg_Attempts,Percent_Learners_Success,Predict_Difficulty,Correct_Difficulty,Score,Difficulty_String,Difficulty
0,2015,Droit,1,Histoire du Droit,1,La Grèce,3,1,1,QCU,0.13,0.89,74.22,71,24,95,73,71,2,1.3,97.26,Facile,Facile,0,Meme Difficulte que la Prediction,Adapte
1066,2016,Droit,1,Histoire du Droit,1,La Grèce,3,1,1,QCU,0.18,0.99,74.22,71,25,96,79,71,8,1.22,89.87,Facile,Facile,0,Meme Difficulte que la Prediction,Adapte
2132,2017,Droit,1,Histoire du Droit,1,La Grèce,3,1,1,QCM,0.08,0.85,74.22,82,28,110,93,82,11,1.18,88.17,Facile,Facile,0,Meme Difficulte que la Prediction,Adapte
3198,2018,Droit,1,Histoire du Droit,1,La Grèce,3,1,1,QCM,0.19,0.77,74.22,91,31,122,112,91,21,1.09,81.25,Facile,Facile,0,Meme Difficulte que la Prediction,Adapte
4264,2019,Droit,1,Histoire du Droit,1,La Grèce,3,1,1,QCM,0.04,0.71,74.22,88,31,119,111,88,23,1.07,79.28,Facile,Facile,0,Meme Difficulte que la Prediction,Adapte
5330,2020,Droit,1,Histoire du Droit,1,La Grèce,3,1,1,QCM,0.07,0.8,74.22,95,33,128,113,95,18,1.13,84.07,Facile,Facile,0,Meme Difficulte que la Prediction,Adapte
1,2015,Droit,1,Histoire du Droit,1,La Grèce,3,2,2,QCU,0.01,0.97,69.11,25,11,36,26,25,1,1.38,96.15,Facile,Facile,0,Meme Difficulte que la Prediction,Adapte
1067,2016,Droit,1,Histoire du Droit,1,La Grèce,3,2,2,QCU,0.18,0.85,69.11,28,13,41,38,28,10,1.08,73.68,Facile,Facile,0,Meme Difficulte que la Prediction,Adapte
2133,2017,Droit,1,Histoire du Droit,1,La Grèce,3,2,2,QCU,0.03,0.83,69.11,28,13,41,29,28,1,1.41,96.55,Facile,Facile,0,Meme Difficulte que la Prediction,Adapte
3199,2018,Droit,1,Histoire du Droit,1,La Grèce,3,2,2,QCM,0.12,0.76,69.11,32,15,47,46,32,14,1.02,69.57,Facile,Facile,0,Meme Difficulte que la Prediction,Adapte
4265,2019,Droit,1,Histoire du Droit,1,La Grèce,3,2,2,QCM,0.09,0.92,69.11,30,13,43,42,30,12,1.02,71.43,Facile,Facile,0,Meme Difficulte que la Prediction,Adapte
5331,2020,Droit,1,Histoire du Droit,1,La Grèce,3,2,2,QCU,0.12,0.89,69.11,28,12,40,40,28,12,1.0,70.0,Facile,Facile,0,Meme Difficulte que la Prediction,Adapte
2,2015,Droit,1,Histoire du Droit,1,La Grèce,3,3,3,QCU,0.47,0.24,18.62,14,63,77,49,14,35,1.57,28.57,Difficile,Difficile,0,Meme Difficulte que la Prediction,Pas Adapte
1068,2016,Droit,1,Histoire du Droit,1,La Grèce,3,3,3,QCU,0.65,0.38,32.98,27,55,82,40,27,13,2.05,67.5,Facile,Difficile,-2,Beaucoup plus Difficile que la Prediction,Pas Adapte
2134,2017,Droit,1,Histoire du Droit,1,La Grèce,3,3,3,QCU,0.03,0.9,80.18,63,15,78,76,63,13,1.03,82.89,Facile,Facile,0,Meme Difficulte que la Prediction,Pas Adapte
3200,2018,Droit,1,Histoire du Droit,1,La Grèce,3,3,3,QCU,0.15,0.9,70.34,60,25,85,66,60,6,1.29,90.91,Facile,Facile,0,Meme Difficulte que la Prediction,Adapte
4266,2019,Droit,1,Histoire du Droit,1,La Grèce,3,3,3,QCU,0.05,0.87,70.34,68,29,97,77,68,9,1.26,88.31,Facile,Facile,0,Meme Difficulte que la Prediction,Adapte
5332,2020,Droit,1,Histoire du Droit,1,La Grèce,3,3,3,QCU,0.17,0.88,70.34,58,25,83,59,58,1,1.41,98.31,Facile,Facile,0,Meme Difficulte que la Prediction,Adapte
3,2015,Droit,1,Histoire du Droit,2,L'Italie,13,4,1,QROC,0.99,0.14,14.71,8,45,53,24,8,16,2.21,33.33,Moyen,Difficile,-1,Plus Difficile que la Prediction,Pas Adapte
1069,2016,Droit,1,Histoire du Droit,2,L'Italie,13,4,1,QROC,0.0,0.42,79.51,47,12,59,56,47,9,1.05,83.93,Moyen,Facile,1,Plus Facile que la Prediction,Pas Adapte
2135,2017,Droit,1,Histoire du Droit,2,L'Italie,13,4,1,QO,0.86,0.13,17.37,10,47,57,46,10,36,1.24,21.74,Moyen,Difficile,-1,Plus Difficile que la Prediction,Pas Adapte
3201,2018,Droit,1,Histoire du Droit,2,L'Italie,13,4,1,QO,0.06,0.53,93.05,47,4,51,50,47,3,1.02,94.0,Facile,Facile,0,Meme Difficulte que la Prediction,Pas Adapte
4267,2019,Droit,1,Histoire du Droit,2,L'Italie,13,4,1,QO,0.93,0.01,1.49,1,54,55,42,1,41,1.31,2.38,Difficile,Difficile,0,Meme Difficulte que la Prediction,Pas Adapte
5333,2020,Droit,1,Histoire du Droit,2,L'Italie,13,4,1,QO,0.97,0.13,21.78,12,41,53,49,12,37,1.08,24.49,Moyen,Difficile,-1,Plus Difficile que la Prediction,Pas Adapte
4,2015,Droit,1,Histoire du Droit,2,L'Italie,13,5,2,QCM,0.56,0.16,25.92,19,53,72,44,19,25,1.64,43.18,Difficile,Difficile,0,Meme Difficulte que la Prediction,Pas Adapte
1070,2016,Droit,1,Histoire du Droit,2,L'Italie,13,5,2,QCM,0.77,0.19,19.81,15,61,76,44,15,29,1.73,34.09,Moyen,Difficile,-1,Plus Difficile que la Prediction,Pas Adapte
2136,2017,Droit,1,Histoire du Droit,2,L'Italie,13,5,2,QCM,0.0,0.98,67.74,57,27,84,80,57,23,1.05,71.25,Facile,Facile,0,Meme Difficulte que la Prediction,Adapte
3202,2018,Droit,1,Histoire du Droit,2,L'Italie,13,5,2,QCM,0.08,0.74,67.74,56,26,82,72,56,16,1.14,77.78,Facile,Facile,0,Meme Difficulte que la Prediction,Adapte
4268,2019,Droit,1,Histoire du Droit,2,L'Italie,13,5,2,QCM,0.05,0.91,67.74,56,27,83,77,56,21,1.08,72.73,Facile,Facile,0,Meme Difficulte que la Prediction,Adapte
5334,2020,Droit,1,Histoire du Droit,2,L'Italie,13,5,2,QCM,0.1,0.87,67.74,60,28,88,72,60,12,1.22,83.33,Facile,Facile,0,Meme Difficulte que la Prediction,Adapte
5,2015,Droit,1,Histoire du Droit,2,L'Italie,13,6,3,QROC,0.17,0.88,69.92,66,28,94,82,66,16,1.15,80.49,Facile,Facile,0,Meme Difficulte que la Prediction,Adapte
1071,2016,Droit,1,Histoire du Droit,2,L'Italie,13,6,3,QCM,0.04,0.74,69.92,66,29,95,85,66,19,1.12,77.65,Facile,Facile,0,Meme Difficulte que la Prediction,Adapte
2137,2017,Droit,1,Histoire du Droit,2,L'Italie,13,6,3,QCU,0.13,0.93,69.92,64,28,92,82,64,18,1.12,78.05,Facile,Facile,0,Meme Difficulte que la Prediction,Adapte
3203,2018,Droit,1,Histoire du Droit,2,L'Italie,13,6,3,QCM,0.09,0.71,69.92,68,29,97,76,68,8,1.28,89.47,Facile,Facile,0,Meme Difficulte que la Prediction,Adapte
4269,2019,Droit,1,Histoire du Droit,2,L'Italie,13,6,3,QCM,0.13,0.79,69.92,62,27,89,67,62,5,1.33,92.54,Facile,Facile,0,Meme Difficulte que la Prediction,Adapte
5335,2020,Droit,1,Histoire du Droit,2,L'Italie,13,6,3,QCM,0.02,0.98,69.92,65,28,93,80,65,15,1.16,81.25,Facile,Facile,0,Meme Difficulte que la Prediction,Adapte
6,2015,Droit,1,Histoire du Droit,2,L'Italie,13,7,4,QCU,0.27,0.41,62.72,56,34,90,74,56,18,1.22,75.68,Difficile,Moyen,1,Plus Facile que la Prediction,Adapte
1072,2016,Droit,1,Histoire du Droit,2,L'Italie,13,7,4,QCU,0.38,0.47,62.72,56,34,90,61,56,5,1.48,91.8,Moyen,Moyen,0,Meme Difficulte que la Prediction,Adapte
2138,2017,Droit,1,Histoire du Droit,2,L'Italie,13,7,4,QCU,0.38,0.55,62.72,55,33,88,75,55,20,1.17,73.33,Moyen,Moyen,0,Meme Difficulte que la Prediction,Adapte
3204,2018,Droit,1,Histoire du Droit,2,L'Italie,13,7,4,QCU,0.24,0.48,62.72,58,35,93,79,58,21,1.18,73.42,Moyen,Moyen,0,Meme Difficulte que la Prediction,Adapte
4270,2019,Droit,1,Histoire du Droit,2,L'Italie,13,7,4,QROC,0.31,0.39,62.72,57,34,91,83,57,26,1.1,68.67,Moyen,Moyen,0,Meme Difficulte que la Prediction,Adapte
5336,2020,Droit,1,Histoire du Droit,2,L'Italie,13,7,4,QROC,0.4,0.29,62.72,51,31,82,67,51,16,1.22,76.12,Moyen,Moyen,0,Meme Difficulte que la Prediction,Adapte
7,2015,Droit,1,Histoire du Droit,2,L'Italie,13,8,5,QCU,0.35,0.65,48.32,37,40,77,53,37,16,1.45,69.81,Moyen,Moyen,0,Meme Difficulte que la Prediction,Pas Adapte
1073,2016,Droit,1,Histoire du Droit,2,L'Italie,13,8,5,QCM,0.23,0.52,45.45,35,43,78,72,35,37,1.08,48.61,Moyen,Moyen,0,Meme Difficulte que la Prediction,Pas Adapte
2139,2017,Droit,1,Histoire du Droit,2,L'Italie,13,8,5,QCM,0.14,0.94,81.83,68,15,83,80,68,12,1.04,85.0,Difficile,Facile,2,Beaucoup plus Facile que la Prediction,Pas Adapte
3205,2018,Droit,1,Histoire du Droit,2,L'Italie,13,8,5,QCM,0.24,0.59,57.71,49,36,85,80,49,31,1.06,61.25,Moyen,Moyen,0,Meme Difficulte que la Prediction,Pas Adapte
4271,2019,Droit,1,Histoire du Droit,2,L'Italie,13,8,5,QCM,0.65,0.18,25.05,20,61,81,46,20,26,1.76,43.48,Difficile,Difficile,0,Meme Difficulte que la Prediction,Pas Adapte
5337,2020,Droit,1,Histoire du Droit,2,L'Italie,13,8,5,QCM,0.13,0.78,78.18,68,19,87,81,68,13,1.07,83.95,Difficile,Facile,2,Beaucoup plus Facile que la Prediction,Pas Adapte
8,2015,Droit,1,Histoire du Droit,2,L'Italie,13,9,6,QCU,0.31,0.5,53.7,11,10,21,16,11,5,1.31,68.75,Moyen,Moyen,0,Meme Difficulte que la Prediction,Pas Adapte
1074,2016,Droit,1,Histoire du Droit,2,L'Italie,13,9,6,QCU,0.5,0.28,20.49,5,17,22,9,5,4,2.44,55.56,Difficile,Difficile,0,Meme Difficulte que la Prediction,Pas Adapte
2140,2017,Droit,1,Histoire du Droit,2,L'Italie,13,9,6,QCU,0.32,0.43,50.4,11,11,22,18,11,7,1.22,61.11,Moyen,Moyen,0,Meme Difficulte que la Prediction,Pas Adapte
3206,2018,Droit,1,Histoire du Droit,2,L'Italie,13,9,6,QCU,0.31,0.41,52.67,11,10,21,16,11,5,1.31,68.75,Moyen,Moyen,0,Meme Difficulte que la Prediction,Pas Adapte
4272,2019,Droit,1,Histoire du Droit,2,L'Italie,13,9,6,QCU,0.35,0.49,64.8,13,7,20,15,13,2,1.33,86.67,Moyen,Moyen,0,Meme Difficulte que la Prediction,Adapte
5338,2020,Droit,1,Histoire du Droit,2,L'Italie,13,9,6,QCU,0.34,0.55,64.8,12,6,18,14,12,2,1.29,85.71,Moyen,Moyen,0,Meme Difficulte que la Prediction,Adapte
9,2015,Droit,1,Histoire du Droit,2,L'Italie,13,10,7,QCM,0.24,0.52,46.97,30,33,63,42,30,12,1.5,71.43,Moyen,Moyen,0,Meme Difficulte que la Prediction,Pas Adapte
1075,2016,Droit,1,Histoire du Droit,2,L'Italie,13,10,7,QCM,0.42,0.36,42.72,23,32,55,27,23,4,2.04,85.19,Moyen,Moyen,0,Meme Difficulte que la Prediction,Pas Adapte
2141,2017,Droit,1,Histoire du Droit,2,L'Italie,13,10,7,QCM,0.14,0.83,91.74,57,5,62,61,57,4,1.02,93.44,Difficile,Facile,2,Beaucoup plus Facile que la Prediction,Pas Adapte
3207,2018,Droit,1,Histoire du Droit,2,L'Italie,13,10,7,QCM,0.52,0.19,7.28,4,51,55,28,4,24,1.96,14.29,Difficile,Difficile,0,Meme Difficulte que la Prediction,Pas Adapte
4273,2019,Droit,1,Histoire du Droit,2,L'Italie,13,10,7,QCM,0.73,0.2,34.25,20,39,59,52,20,32,1.13,38.46,Difficile,Difficile,0,Meme Difficulte que la Prediction,Pas Adapte
5339,2020,Droit,1,Histoire du Droit,2,L'Italie,13,10,7,QCM,0.01,0.89,99.2,61,0,61,61,61,0,1.0,100.0,Moyen,Facile,1,Plus Facile que la Prediction,Pas Adapte
10,2015,Droit,1,Histoire du Droit,2,L'Italie,13,11,8,QCM,0.75,0.16,17.43,15,73,88,57,15,42,1.54,26.32,Difficile,Difficile,0,Meme Difficulte que la Prediction,Pas Adapte
1076,2016,Droit,1,Histoire du Droit,2,L'Italie,13,11,8,QCM,0.01,0.91,69.26,56,25,81,79,56,23,1.03,70.89,Facile,Facile,0,Meme Difficulte que la Prediction,Adapte
2142,2017,Droit,1,Histoire du Droit,2,L'Italie,13,11,8,QCM,0.18,0.81,69.26,57,26,83,79,57,22,1.05,72.15,Facile,Facile,0,Meme Difficulte que la Prediction,Adapte
3208,2018,Droit,1,Histoire du Droit,2,L'Italie,13,11,8,QCM,0.15,0.9,69.26,49,22,71,67,49,18,1.06,73.13,Facile,Facile,0,Meme Difficulte que la Prediction,Adapte
4274,2019,Droit,1,Histoire du Droit,2,L'Italie,13,11,8,QCM,0.19,0.94,69.26,47,21,68,66,47,19,1.03,71.21,Facile,Facile,0,Meme Difficulte que la Prediction,Adapte
5340,2020,Droit,1,Histoire du Droit,2,L'Italie,13,11,8,QCM,0.07,0.72,69.26,41,18,59,45,41,4,1.31,91.11,Facile,Facile,0,Meme Difficulte que la Prediction,Adapte
11,2015,Droit,1,Histoire du Droit,2,L'Italie,13,12,9,QCU,0.34,0.68,44.91,9,12,21,17,9,8,1.24,52.94,Moyen,Moyen,0,Meme Difficulte que la Prediction,Pas Adapte
1077,2016,Droit,1,Histoire du Droit,2,L'Italie,13,12,9,QCU,0.58,0.22,13.47,3,21,24,15,3,12,1.6,20.0,Difficile,Difficile,0,Meme Difficulte que la Prediction,Pas Adapte
2143,2017,Droit,1,Histoire du Droit,2,L'Italie,13,12,9,QCM,0.25,0.37,54.65,12,10,22,20,12,8,1.1,60.0,Moyen,Moyen,0,Meme Difficulte que la Prediction,Pas Adapte
3209,2018,Droit,1,Histoire du Droit,2,L'Italie,13,12,9,QCM,0.79,0.21,13.62,3,22,25,9,3,6,2.78,33.33,Difficile,Difficile,0,Meme Difficulte que la Prediction,Pas Adapte
4275,2019,Droit,1,Histoire du Droit,2,L'Italie,13,12,9,QCU,0.29,0.75,62.56,15,9,24,22,15,7,1.09,68.18,Moyen,Moyen,0,Meme Difficulte que la Prediction,Adapte
5341,2020,Droit,1,Histoire du Droit,2,L'Italie,13,12,9,QCU,0.38,0.49,62.56,13,7,20,18,13,5,1.11,72.22,Moyen,Moyen,0,Meme Difficulte que la Prediction,Adapte
12,2015,Droit,1,Histoire du Droit,2,L'Italie,13,13,10,QCU,0.05,0.92,76.91,75,23,98,94,75,19,1.04,79.79,Facile,Facile,0,Meme Difficulte que la Prediction,Pas Adapte
1078,2016,Droit,1,Histoire du Droit,2,L'Italie,13,13,10,QROC,0.51,0.4,45.25,44,54,98,58,44,14,1.69,75.86,Difficile,Moyen,1,Plus Facile que la Prediction,Pas Adapte
2144,2017,Droit,1,Histoire du Droit,2,L'Italie,13,13,10,QROC,0.67,0.03,16.57,15,77,92,56,15,41,1.64,26.79,Facile,Difficile,-2,Beaucoup plus Difficile que la Prediction,Pas Adapte
3210,2018,Droit,1,Histoire du Droit,2,L'Italie,13,13,10,QCU,0.17,0.77,90.0,85,9,94,92,85,7,1.02,92.39,Facile,Facile,0,Meme Difficulte que la Prediction,Pas Adapte
4276,2019,Droit,1,Histoire du Droit,2,L'Italie,13,13,10,QCU,0.3,0.44,43.47,40,53,93,46,40,6,2.02,86.96,Moyen,Moyen,0,Meme Difficulte que la Prediction,Pas Adapte
5342,2020,Droit,1,Histoire du Droit,2,L'Italie,13,13,10,QCU,0.19,0.99,93.91,76,5,81,77,76,1,1.05,98.7,Facile,Facile,0,Meme Difficulte que la Prediction,Pas Adapte
13,2015,Droit,1,Histoire du Droit,2,L'Italie,13,14,11,QCM,0.66,0.23,21.29,17,64,81,71,17,54,1.14,23.94,Moyen,Difficile,-1,Plus Difficile que la Prediction,Pas Adapte
1079,2016,Droit,1,Histoire du Droit,2,L'Italie,13,14,11,QCM,0.77,0.18,18.56,17,72,89,76,17,59,1.17,22.37,Difficile,Difficile,0,Meme Difficulte que la Prediction,Pas Adapte
2145,2017,Droit,1,Histoire du Droit,2,L'Italie,13,14,11,QCM,0.14,0.77,95.82,80,3,83,81,80,1,1.02,98.77,Facile,Facile,0,Meme Difficulte que la Prediction,Pas Adapte
3211,2018,Droit,1,Histoire du Droit,2,L'Italie,13,14,11,QCM,0.65,0.24,31.98,25,52,77,47,25,22,1.64,53.19,Difficile,Difficile,0,Meme Difficulte que la Prediction,Pas Adapte
4277,2019,Droit,1,Histoire du Droit,2,L'Italie,13,14,11,QCM,0.19,0.9,89.93,67,7,74,71,67,4,1.04,94.37,Facile,Facile,0,Meme Difficulte que la Prediction,Pas Adapte
5343,2020,Droit,1,Histoire du Droit,2,L'Italie,13,14,11,QCM,0.52,0.27,9.91,7,65,72,40,7,33,1.8,17.5,Moyen,Difficile,-1,Plus Difficile que la Prediction,Pas Adapte
14,2015,Droit,1,Histoire du Droit,2,L'Italie,13,15,12,QROC,0.79,0.19,9.23,7,65,72,48,7,41,1.5,14.58,Facile,Difficile,-2,Beaucoup plus Difficile que la Prediction,Pas Adapte
1080,2016,Droit,1,Histoire du Droit,2,L'Italie,13,15,12,QROC,0.47,0.4,42.28,29,39,68,49,29,20,1.39,59.18,Moyen,Moyen,0,Meme Difficulte que la Prediction,Pas Adapte
2146,2017,Droit,1,Histoire du Droit,2,L'Italie,13,15,12,QROC,0.07,0.59,67.96,51,24,75,58,51,7,1.29,87.93,Facile,Facile,0,Meme Difficulte que la Prediction,Adapte
3212,2018,Droit,1,Histoire du Droit,2,L'Italie,13,15,12,QROC,0.1,0.74,67.96,58,27,85,67,58,9,1.27,86.57,Facile,Facile,0,Meme Difficulte que la Prediction,Adapte
4278,2019,Droit,1,Histoire du Droit,2,L'Italie,13,15,12,QROC,0.15,0.82,67.96,59,28,87,67,59,8,1.3,88.06,Facile,Facile,0,Meme Difficulte que la Prediction,Adapte
5344,2020,Droit,1,Histoire du Droit,2,L'Italie,13,15,12,QROC,0.06,0.41,67.96,65,30,95,90,65,25,1.06,72.22,Facile,Facile,0,Meme Difficulte que la Prediction,Adapte
15,2015,Droit,1,Histoire du Droit,2,L'Italie,13,16,13,QCM,0.57,0.25,32.6,20,40,60,27,20,7,2.22,74.07,Difficile,Difficile,0,Meme Difficulte que la Prediction,Pas Adapte
1081,2016,Droit,1,Histoire du Droit,2,L'Italie,13,16,13,QO,0.99,0.01,29.4,18,44,62,50,18,32,1.24,36.0,Difficile,Difficile,0,Meme Difficulte que la Prediction,Pas Adapte
2147,2017,Droit,1,Histoire du Droit,2,L'Italie,13,16,13,QO,0.14,0.55,88.62,57,7,64,61,57,4,1.05,93.44,Facile,Facile,0,Meme Difficulte que la Prediction,Pas Adapte
3213,2018,Droit,1,Histoire du Droit,2,L'Italie,13,16,13,QO,0.06,0.94,87.42,52,7,59,57,52,5,1.04,91.23,Moyen,Facile,1,Plus Facile que la Prediction,Pas Adapte
4279,2019,Droit,1,Histoire du Droit,2,L'Italie,13,16,13,QCM,0.06,0.92,70.52,38,16,54,51,38,13,1.06,74.51,Difficile,Facile,2,Beaucoup plus Facile que la Prediction,Adapte
5345,2020,Droit,1,Histoire du Droit,2,L'Italie,13,16,13,QROC,0.17,0.95,70.52,43,18,61,60,43,17,1.02,71.67,Facile,Facile,0,Meme Difficulte que la Prediction,Adapte
16,2015,Droit,1,Introduction Historique au Droit,1,L'Ancien Regime,1,17,1,QCU,0.16,0.86,95.22,84,4,88,84,84,0,1.05,100.0,Facile,Facile,0,Meme Difficulte que la Prediction,Pas Adapte
1082,2016,Droit,1,Introduction Historique au Droit,1,L'Ancien Regime,1,17,1,QCU,0.37,0.72,39.65,34,52,86,68,34,34,1.26,50.0,Moyen,Moyen,0,Meme Difficulte que la Prediction,Pas Adapte
2148,2017,Droit,1,Introduction Historique au Droit,1,L'Ancien Regime,1,17,1,QCU,0.72,0.27,1.86,1,77,78,40,1,39,1.95,2.5,Difficile,Difficile,0,Meme Difficulte que la Prediction,Pas Adapte
3214,2018,Droit,1,Introduction Historique au Droit,1,L'Ancien Regime,1,17,1,QCU,0.56,0.27,2.61,2,71,73,39,2,37,1.87,5.13,Difficile,Difficile,0,Meme Difficulte que la Prediction,Pas Adapte
4280,2019,Droit,1,Introduction Historique au Droit,1,L'Ancien Regime,1,17,1,QCU,0.33,0.62,52.05,43,40,83,57,43,14,1.46,75.44,Facile,Moyen,-1,Plus Difficile que la Prediction,Pas Adapte
5346,2020,Droit,1,Introduction Historique au Droit,1,L'Ancien Regime,1,17,1,QCU,0.16,0.92,79.2,69,18,87,86,69,17,1.01,80.23,Moyen,Facile,1,Plus Facile que la Prediction,Pas Adapte
17,2015,Droit,1,Introduction Historique au Droit,2,La Contestation du Regime Feodal,2,18,1,QCM,0.74,0.16,7.22,5,58,63,29,5,24,2.17,17.24,Difficile,Difficile,0,Meme Difficulte que la Prediction,Pas Adapte
1083,2016,Droit,1,Introduction Historique au Droit,2,La Contestation du Regime Feodal,2,18,1,QCM,0.52,0.27,22.32,15,50,65,49,15,34,1.33,30.61,Facile,Difficile,-2,Beaucoup plus Difficile que la Prediction,Pas Adapte
2149,2017,Droit,1,Introduction Historique au Droit,2,La Contestation du Regime Feodal,2,18,1,QCM,0.76,0.2,0.36,0,70,70,32,0,32,2.19,0.0,Difficile,Difficile,0,Meme Difficulte que la Prediction,Pas Adapte
3215,2018,Droit,1,Introduction Historique au Droit,2,La Contestation du Regime Feodal,2,18,1,QCU,0.2,0.99,95.88,62,3,65,63,62,1,1.03,98.41,Facile,Facile,0,Meme Difficulte que la Prediction,Pas Adapte
4281,2019,Droit,1,Introduction Historique au Droit,2,La Contestation du Regime Feodal,2,18,1,QCU,0.05,0.95,78.38,56,15,71,63,56,7,1.13,88.89,Facile,Facile,0,Meme Difficulte que la Prediction,Pas Adapte
5347,2020,Droit,1,Introduction Historique au Droit,2,La Contestation du Regime Feodal,2,18,1,QCU,0.46,0.24,17.53,13,59,72,29,13,16,2.48,44.83,Difficile,Difficile,0,Meme Difficulte que la Prediction,Pas Adapte
18,2015,Droit,1,Introduction Historique au Droit,2,La Contestation du Regime Feodal,2,19,2,QROC,0.89,0.13,26.41,9,25,34,25,9,16,1.36,36.0,Difficile,Difficile,0,Meme Difficulte que la Prediction,Pas Adapte
1084,2016,Droit,1,Introduction Historique au Droit,2,La Contestation du Regime Feodal,2,19,2,QROC,0.76,0.2,1.01,0,37,37,21,0,21,1.76,0.0,Difficile,Difficile,0,Meme Difficulte que la Prediction,Pas Adapte
2150,2017,Droit,1,Introduction Historique au Droit,2,La Contestation du Regime Feodal,2,19,2,QROC,0.41,0.35,56.93,22,17,39,25,22,3,1.56,88.0,Difficile,Moyen,1,Plus Facile que la Prediction,Pas Adapte
3216,2018,Droit,1,Introduction Historique au Droit,2,La Contestation du Regime Feodal,2,19,2,QO,0.07,0.69,95.15,38,2,40,40,38,2,1.0,95.0,Difficile,Facile,2,Beaucoup plus Facile que la Prediction,Pas Adapte
4282,2019,Droit,1,Introduction Historique au Droit,2,La Contestation du Regime Feodal,2,19,2,QO,0.24,0.21,46.34,18,21,39,34,18,16,1.15,52.94,Facile,Moyen,-1,Plus Difficile que la Prediction,Pas Adapte
5348,2020,Droit,1,Introduction Historique au Droit,2,La Contestation du Regime Feodal,2,19,2,QO,0.88,0.12,10.67,4,35,39,24,4,20,1.62,16.67,Facile,Difficile,-2,Beaucoup plus Difficile que la Prediction,Pas Adapte
19,2015,Droit,1,Introduction Historique au Droit,3,La Crise de l'Ancien Regime,7,20,1,QO,0.77,0.1,34.15,13,26,39,39,13,26,1.0,33.33,Facile,Difficile,-2,Beaucoup plus Difficile que la Prediction,Pas Adapte
1085,2016,Droit,1,Introduction Historique au Droit,3,La Crise de l'Ancien Regime,7,20,1,QROC,0.27,0.39,51.69,18,17,35,29,18,11,1.21,62.07,Moyen,Moyen,0,Meme Difficulte que la Prediction,Pas Adapte
2151,2017,Droit,1,Introduction Historique au Droit,3,La Crise de l'Ancien Regime,7,20,1,QROC,0.27,0.33,63.14,19,11,30,19,19,0,1.58,100.0,Moyen,Moyen,0,Meme Difficulte que la Prediction,Adapte
3217,2018,Droit,1,Introduction Historique au Droit,3,La Crise de l'Ancien Regime,7,20,1,QROC,0.32,0.35,63.14,18,10,28,22,18,4,1.27,81.82,Moyen,Moyen,0,Meme Difficulte que la Prediction,Adapte
4283,2019,Droit,1,Introduction Historique au Droit,3,La Crise de l'Ancien Regime,7,20,1,QROC,0.25,0.36,63.14,15,9,24,22,15,7,1.09,68.18,Moyen,Moyen,0,Meme Difficulte que la Prediction,Adapte
5349,2020,Droit,1,Introduction Historique au Droit,3,La Crise de l'Ancien Regime,7,20,1,QROC,0.25,0.26,63.14,18,10,28,19,18,1,1.47,94.74,Moyen,Moyen,0,Meme Difficulte que la Prediction,Adapte
20,2015,Droit,1,Introduction Historique au Droit,3,La Crise de l'Ancien Regime,7,21,2,QCM,0.04,0.93,94.05,29,2,31,30,29,1,1.03,96.67,Difficile,Facile,2,Beaucoup plus Facile que la Prediction,Pas Adapte
1086,2016,Droit,1,Introduction Historique au Droit,3,La Crise de l'Ancien Regime,7,21,2,QCM,0.34,0.32,37.09,10,17,27,27,10,17,1.0,37.04,Moyen,Moyen,0,Meme Difficulte que la Prediction,Pas Adapte
2152,2017,Droit,1,Introduction Historique au Droit,3,La Crise de l'Ancien Regime,7,21,2,QCM,0.01,0.98,79.71,25,6,31,27,25,2,1.15,92.59,Facile,Facile,0,Meme Difficulte que la Prediction,Pas Adapte
3218,2018,Droit,1,Introduction Historique au Droit,3,La Crise de l'Ancien Regime,7,21,2,QCM,0.27,0.57,39.0,11,16,27,13,11,2,2.08,84.62,Moyen,Moyen,0,Meme Difficulte que la Prediction,Pas Adapte
4284,2019,Droit,1,Introduction Historique au Droit,3,La Crise de l'Ancien Regime,7,21,2,QCM,0.36,0.4,55.96,13,10,23,16,13,3,1.44,81.25,Moyen,Moyen,0,Meme Difficulte que la Prediction,Pas Adapte
5350,2020,Droit,1,Introduction Historique au Droit,3,La Crise de l'Ancien Regime,7,21,2,QCM,0.01,0.88,72.73,16,6,22,20,16,4,1.1,80.0,Facile,Facile,0,Meme Difficulte que la Prediction,Adapte
21,2015,Droit,1,Introduction Historique au Droit,3,La Crise de l'Ancien Regime,7,22,3,QCM,0.16,0.98,94.54,72,4,76,76,72,4,1.0,94.74,Difficile,Facile,2,Beaucoup plus Facile que la Prediction,Pas Adapte
1087,2016,Droit,1,Introduction Historique au Droit,3,La Crise de l'Ancien Regime,7,22,3,QROC,0.88,0.22,3.96,3,79,82,37,3,34,2.22,8.11,Difficile,Difficile,0,Meme Difficulte que la Prediction,Pas Adapte
2153,2017,Droit,1,Introduction Historique au Droit,3,La Crise de l'Ancien Regime,7,22,3,QROC,0.4,0.29,42.38,35,47,82,41,35,6,2.0,85.37,Moyen,Moyen,0,Meme Difficulte que la Prediction,Pas Adapte
3219,2018,Droit,1,Introduction Historique au Droit,3,La Crise de l'Ancien Regime,7,22,3,QROC,0.2,0.45,72.76,68,26,94,84,68,16,1.12,80.95,Facile,Facile,0,Meme Difficulte que la Prediction,Adapte
4285,2019,Droit,1,Introduction Historique au Droit,3,La Crise de l'Ancien Regime,7,22,3,QROC,0.12,0.91,72.76,77,29,106,81,77,4,1.31,95.06,Facile,Facile,0,Meme Difficulte que la Prediction,Adapte
5351,2020,Droit,1,Introduction Historique au Droit,3,La Crise de l'Ancien Regime,7,22,3,QROC,0.06,0.85,72.76,81,30,111,91,81,10,1.22,89.01,Facile,Facile,0,Meme Difficulte que la Prediction,Adapte
22,2015,Droit,1,Introduction Historique au Droit,3,La Crise de l'Ancien Regime,7,23,4,QCM,0.67,0.18,34.15,4,8,12,5,4,1,2.4,80.0,Moyen,Difficile,-1,Plus Difficile que la Prediction,Pas Adapte
1088,2016,Droit,1,Introduction Historique au Droit,3,La Crise de l'Ancien Regime,7,23,4,QCM,0.1,0.75,66.24,7,4,11,10,7,3,1.1,70.0,Facile,Facile,0,Meme Difficulte que la Prediction,Adapte
2154,2017,Droit,1,Introduction Historique au Droit,3,La Crise de l'Ancien Regime,7,23,4,QCM,0.09,0.84,66.24,7,4,11,10,7,3,1.1,70.0,Facile,Facile,0,Meme Difficulte que la Prediction,Adapte
3220,2018,Droit,1,Introduction Historique au Droit,3,La Crise de l'Ancien Regime,7,23,4,QCU,0.12,0.79,66.24,6,3,9,8,6,2,1.12,75.0,Facile,Facile,0,Meme Difficulte que la Prediction,Adapte
4286,2019,Droit,1,Introduction Historique au Droit,3,La Crise de l'Ancien Regime,7,23,4,QCU,0.15,0.78,66.24,5,3,8,5,5,0,1.6,100.0,Facile,Facile,0,Meme Difficulte que la Prediction,Adapte
5352,2020,Droit,1,Introduction Historique au Droit,3,La Crise de l'Ancien Regime,7,23,4,QCU,0.07,0.96,66.24,5,2,7,5,5,0,1.4,100.0,Facile,Facile,0,Meme Difficulte que la Prediction,Adapte
23,2015,Droit,1,Introduction Historique au Droit,3,La Crise de l'Ancien Regime,7,24,5,QROC,0.42,0.28,43.96,17,21,38,36,17,19,1.06,47.22,Facile,Moyen,-1,Plus Difficile que la Prediction,Pas Adapte
1089,2016,Droit,1,Introduction Historique au Droit,3,La Crise de l'Ancien Regime,7,24,5,QROC,0.53,0.33,57.81,23,17,40,30,23,7,1.33,76.67,Difficile,Moyen,1,Plus Facile que la Prediction,Pas Adapte
2155,2017,Droit,1,Introduction Historique au Droit,3,La Crise de l'Ancien Regime,7,24,5,QROC,0.78,0.14,12.49,6,39,45,23,6,17,1.96,26.09,Moyen,Difficile,-1,Plus Difficile que la Prediction,Pas Adapte
3221,2018,Droit,1,Introduction Historique au Droit,3,La Crise de l'Ancien Regime,7,24,5,QROC,0.11,0.95,70.34,34,15,49,36,34,2,1.36,94.44,Moyen,Facile,1,Plus Facile que la Prediction,Adapte
4287,2019,Droit,1,Introduction Historique au Droit,3,La Crise de l'Ancien Regime,7,24,5,QROC,0.14,0.47,70.34,35,15,50,40,35,5,1.25,87.5,Facile,Facile,0,Meme Difficulte que la Prediction,Adapte
5353,2020,Droit,1,Introduction Historique au Droit,3,La Crise de l'Ancien Regime,7,24,5,QROC,0.08,0.85,70.34,30,12,42,36,30,6,1.17,83.33,Facile,Facile,0,Meme Difficulte que la Prediction,Adapte
24,2015,Droit,1,Introduction Historique au Droit,3,La Crise de l'Ancien Regime,7,25,6,QCU,0.47,0.21,14.21,8,51,59,47,8,39,1.26,17.02,Difficile,Difficile,0,Meme Difficulte que la Prediction,Pas Adapte
1090,2016,Droit,1,Introduction Historique au Droit,3,La Crise de l'Ancien Regime,7,25,6,QCU,0.52,0.32,11.69,6,46,52,26,6,20,2.0,23.08,Difficile,Difficile,0,Meme Difficulte que la Prediction,Pas Adapte
2156,2017,Droit,1,Introduction Historique au Droit,3,La Crise de l'Ancien Regime,7,25,6,QCU,0.15,0.83,81.6,43,10,53,52,43,9,1.02,82.69,Moyen,Facile,1,Plus Facile que la Prediction,Pas Adapte
3222,2018,Droit,1,Introduction Historique au Droit,3,La Crise de l'Ancien Regime,7,25,6,QCU,0.51,0.28,15.81,9,49,58,39,9,30,1.49,23.08,Difficile,Difficile,0,Meme Difficulte que la Prediction,Pas Adapte
4288,2019,Droit,1,Introduction Historique au Droit,3,La Crise de l'Ancien Regime,7,25,6,QCU,0.22,0.67,37.99,19,32,51,47,19,28,1.09,40.43,Difficile,Moyen,1,Plus Facile que la Prediction,Pas Adapte
5354,2020,Droit,1,Introduction Historique au Droit,3,La Crise de l'Ancien Regime,7,25,6,QCU,0.21,0.43,49.05,26,28,54,43,26,17,1.26,60.47,Facile,Moyen,-1,Plus Difficile que la Prediction,Pas Adapte
25,2015,Droit,1,Introduction Historique au Droit,3,La Crise de l'Ancien Regime,7,26,7,QCM,0.78,0.28,25.9,9,24,33,22,9,13,1.5,40.91,Difficile,Difficile,0,Meme Difficulte que la Prediction,Pas Adapte
1091,2016,Droit,1,Introduction Historique au Droit,3,La Crise de l'Ancien Regime,7,26,7,QCM,0.04,0.71,67.03,23,11,34,25,23,2,1.36,92.0,Facile,Facile,0,Meme Difficulte que la Prediction,Adapte
2157,2017,Droit,1,Introduction Historique au Droit,3,La Crise de l'Ancien Regime,7,26,7,QCM,0.05,0.93,67.03,21,11,32,21,21,0,1.52,100.0,Facile,Facile,0,Meme Difficulte que la Prediction,Adapte
3223,2018,Droit,1,Introduction Historique au Droit,3,La Crise de l'Ancien Regime,7,26,7,QCM,0.06,0.83,67.03,23,12,35,25,23,2,1.4,92.0,Facile,Facile,0,Meme Difficulte que la Prediction,Adapte
4289,2019,Droit,1,Introduction Historique au Droit,3,La Crise de l'Ancien Regime,7,26,7,QCM,0.1,0.87,67.03,20,10,30,23,20,3,1.3,86.96,Facile,Facile,0,Meme Difficulte que la Prediction,Adapte
5355,2020,Droit,1,Introduction Historique au Droit,3,La Crise de l'Ancien Regime,7,26,7,QCU,0.06,0.8,67.03,23,11,34,33,23,10,1.03,69.7,Facile,Facile,0,Meme Difficulte que la Prediction,Adapte
26,2015,Droit,1,Introduction Historique au Droit,4,"La Revolution Francaise, l'Affirmation du Liberalisme",13,27,1,QCM,0.17,0.95,80.21,29,7,36,33,29,4,1.09,87.88,Facile,Facile,0,Meme Difficulte que la Prediction,Pas Adapte
1092,2016,Droit,1,Introduction Historique au Droit,4,"La Revolution Francaise, l'Affirmation du Liberalisme",13,27,1,QCM,0.03,0.99,94.55,34,2,36,35,34,1,1.03,97.14,Facile,Facile,0,Meme Difficulte que la Prediction,Pas Adapte
2158,2017,Droit,1,Introduction Historique au Droit,4,"La Revolution Francaise, l'Affirmation du Liberalisme",13,27,1,QROC,0.68,0.24,6.9,2,30,32,23,2,21,1.39,8.7,Moyen,Difficile,-1,Plus Difficile que la Prediction,Pas Adapte
3224,2018,Droit,1,Introduction Historique au Droit,4,"La Revolution Francaise, l'Affirmation du Liberalisme",13,27,1,QROC,0.22,0.25,50.2,17,17,34,24,17,7,1.42,70.83,Facile,Moyen,-1,Plus Difficile que la Prediction,Pas Adapte
4290,2019,Droit,1,Introduction Historique au Droit,4,"La Revolution Francaise, l'Affirmation du Liberalisme",13,27,1,QROC,0.21,0.38,61.84,22,13,35,28,22,6,1.25,78.57,Moyen,Moyen,0,Meme Difficulte que la Prediction,Adapte
5356,2020,Droit,1,Introduction Historique au Droit,4,"La Revolution Francaise, l'Affirmation du Liberalisme",13,27,1,QROC,0.53,0.33,61.84,25,15,40,29,25,4,1.38,86.21,Moyen,Moyen,0,Meme Difficulte que la Prediction,Adapte
27,2015,Droit,1,Introduction Historique au Droit,4,"La Revolution Francaise, l'Affirmation du Liberalisme",13,28,2,QROC,0.11,0.5,80.43,23,6,29,25,23,2,1.16,92.0,Difficile,Facile,2,Beaucoup plus Facile que la Prediction,Pas Adapte
1093,2016,Droit,1,Introduction Historique au Droit,4,"La Revolution Francaise, l'Affirmation du Liberalisme",13,28,2,QROC,0.17,0.78,82.39,21,5,26,21,21,0,1.24,100.0,Facile,Facile,0,Meme Difficulte que la Prediction,Pas Adapte
2159,2017,Droit,1,Introduction Historique au Droit,4,"La Revolution Francaise, l'Affirmation du Liberalisme",13,28,2,QO,0.44,0.22,56.51,14,10,24,23,14,9,1.04,60.87,Moyen,Moyen,0,Meme Difficulte que la Prediction,Pas Adapte
3225,2018,Droit,1,Introduction Historique au Droit,4,"La Revolution Francaise, l'Affirmation du Liberalisme",13,28,2,QO,0.79,0.08,29.82,7,18,25,20,7,13,1.25,35.0,Difficile,Difficile,0,Meme Difficulte que la Prediction,Pas Adapte
4291,2019,Droit,1,Introduction Historique au Droit,4,"La Revolution Francaise, l'Affirmation du Liberalisme",13,28,2,QROC,0.97,0.05,28.13,8,21,29,28,8,20,1.04,28.57,Difficile,Difficile,0,Meme Difficulte que la Prediction,Pas Adapte
5357,2020,Droit,1,Introduction Historique au Droit,4,"La Revolution Francaise, l'Affirmation du Liberalisme",13,28,2,QROC,0.11,0.8,80.58,23,5,28,26,23,3,1.08,88.46,Difficile,Facile,2,Beaucoup plus Facile que la Prediction,Pas Adapte
28,2015,Droit,1,Introduction Historique au Droit,4,"La Revolution Francaise, l'Affirmation du Liberalisme",13,29,3,QCU,0.59,0.37,12.12,2,15,17,14,2,12,1.21,14.29,Facile,Difficile,-2,Beaucoup plus Difficile que la Prediction,Pas Adapte
1094,2016,Droit,1,Introduction Historique au Droit,4,"La Revolution Francaise, l'Affirmation du Liberalisme",13,29,3,QCU,0.08,0.78,81.97,15,3,18,15,15,0,1.2,100.0,Facile,Facile,0,Meme Difficulte que la Prediction,Pas Adapte
2160,2017,Droit,1,Introduction Historique au Droit,4,"La Revolution Francaise, l'Affirmation du Liberalisme",13,29,3,QCU,0.43,0.36,4.34,1,14,15,13,1,12,1.15,7.69,Moyen,Difficile,-1,Plus Difficile que la Prediction,Pas Adapte
3226,2018,Droit,1,Introduction Historique au Droit,4,"La Revolution Francaise, l'Affirmation du Liberalisme",13,29,3,QCU,0.02,0.83,76.74,11,3,14,12,11,1,1.17,91.67,Facile,Facile,0,Meme Difficulte que la Prediction,Pas Adapte
4292,2019,Droit,1,Introduction Historique au Droit,4,"La Revolution Francaise, l'Affirmation du Liberalisme",13,29,3,QCU,0.14,0.84,65.68,9,5,14,13,9,4,1.08,69.23,Difficile,Facile,2,Beaucoup plus Facile que la Prediction,Adapte
5358,2020,Droit,1,Introduction Historique au Droit,4,"La Revolution Francaise, l'Affirmation du Liberalisme",13,29,3,QCU,0.19,0.76,65.68,8,4,12,11,8,3,1.09,72.73,Facile,Facile,0,Meme Difficulte que la Prediction,Adapte
29,2015,Droit,1,Introduction Historique au Droit,4,"La Revolution Francaise, l'Affirmation du Liberalisme",13,30,4,QCU,0.06,0.97,79.57,44,11,55,48,44,4,1.15,91.67,Facile,Facile,0,Meme Difficulte que la Prediction,Pas Adapte
1095,2016,Droit,1,Introduction Historique au Droit,4,"La Revolution Francaise, l'Affirmation du Liberalisme",13,30,4,QCU,0.07,0.92,84.61,43,8,51,43,43,0,1.19,100.0,Moyen,Facile,1,Plus Facile que la Prediction,Pas Adapte
2161,2017,Droit,1,Introduction Historique au Droit,4,"La Revolution Francaise, l'Affirmation du Liberalisme",13,30,4,QCU,0.65,0.26,17.06,8,36,44,34,8,26,1.29,23.53,Facile,Difficile,-2,Beaucoup plus Difficile que la Prediction,Pas Adapte
3227,2018,Droit,1,Introduction Historique au Droit,4,"La Revolution Francaise, l'Affirmation du Liberalisme",13,30,4,QCM,0.35,0.43,40.13,20,30,50,38,20,18,1.32,52.63,Moyen,Moyen,0,Meme Difficulte que la Prediction,Pas Adapte
4293,2019,Droit,1,Introduction Historique au Droit,4,"La Revolution Francaise, l'Affirmation du Liberalisme",13,30,4,QCM,0.56,0.15,11.71,6,49,55,50,6,44,1.1,12.0,Difficile,Difficile,0,Meme Difficulte que la Prediction,Pas Adapte
5359,2020,Droit,1,Introduction Historique au Droit,4,"La Revolution Francaise, l'Affirmation du Liberalisme",13,30,4,QCM,0.66,0.24,29.89,19,43,62,50,19,31,1.24,38.0,Difficile,Difficile,0,Meme Difficulte que la Prediction,Pas Adapte
30,2015,Droit,1,Introduction Historique au Droit,4,"La Revolution Francaise, l'Affirmation du Liberalisme",13,31,5,QCU,0.15,0.9,88.45,55,7,62,62,55,7,1.0,88.71,Facile,Facile,0,Meme Difficulte que la Prediction,Pas Adapte
1096,2016,Droit,1,Introduction Historique au Droit,4,"La Revolution Francaise, l'Affirmation du Liberalisme",13,31,5,QCU,0.06,0.86,79.59,53,13,66,60,53,7,1.1,88.33,Facile,Facile,0,Meme Difficulte que la Prediction,Pas Adapte
2162,2017,Droit,1,Introduction Historique au Droit,4,"La Revolution Francaise, l'Affirmation du Liberalisme",13,31,5,QCM,0.21,0.34,55.71,35,28,63,52,35,17,1.21,67.31,Difficile,Moyen,1,Plus Facile que la Prediction,Pas Adapte
3228,2018,Droit,1,Introduction Historique au Droit,4,"La Revolution Francaise, l'Affirmation du Liberalisme",13,31,5,QCU,0.16,1.0,96.15,68,3,71,71,68,3,1.0,95.77,Facile,Facile,0,Meme Difficulte que la Prediction,Pas Adapte
4294,2019,Droit,1,Introduction Historique au Droit,4,"La Revolution Francaise, l'Affirmation du Liberalisme",13,31,5,QCU,0.03,0.86,93.94,75,5,80,76,75,1,1.05,98.68,Moyen,Facile,1,Plus Facile que la Prediction,Pas Adapte
5360,2020,Droit,1,Introduction Historique au Droit,4,"La Revolution Francaise, l'Affirmation du Liberalisme",13,31,5,QCU,0.04,0.99,97.45,66,2,68,68,66,2,1.0,97.06,Moyen,Facile,1,Plus Facile que la Prediction,Pas Adapte
31,2015,Droit,1,Introduction Historique au Droit,4,"La Revolution Francaise, l'Affirmation du Liberalisme",13,32,6,QCM,0.05,0.95,77.13,47,14,61,60,47,13,1.02,78.33,Facile,Facile,0,Meme Difficulte que la Prediction,Pas Adapte
1097,2016,Droit,1,Introduction Historique au Droit,4,"La Revolution Francaise, l'Affirmation du Liberalisme",13,32,6,QCM,0.43,0.61,53.4,35,31,66,45,35,10,1.47,77.78,Moyen,Moyen,0,Meme Difficulte que la Prediction,Pas Adapte
2163,2017,Droit,1,Introduction Historique au Droit,4,"La Revolution Francaise, l'Affirmation du Liberalisme",13,32,6,QCM,0.09,0.97,66.43,38,19,57,57,38,19,1.0,66.67,Facile,Facile,0,Meme Difficulte que la Prediction,Adapte
3229,2018,Droit,1,Introduction Historique au Droit,4,"La Revolution Francaise, l'Affirmation du Liberalisme",13,32,6,QCU,0.08,0.77,66.43,33,16,49,49,33,16,1.0,67.35,Facile,Facile,0,Meme Difficulte que la Prediction,Adapte
4295,2019,Droit,1,Introduction Historique au Droit,4,"La Revolution Francaise, l'Affirmation du Liberalisme",13,32,6,QCU,0.05,0.88,66.43,31,15,46,35,31,4,1.31,88.57,Facile,Facile,0,Meme Difficulte que la Prediction,Adapte
5361,2020,Droit,1,Introduction Historique au Droit,4,"La Revolution Francaise, l'Affirmation du Liberalisme",13,32,6,QCM,0.01,0.82,66.43,29,14,43,36,29,7,1.19,80.56,Facile,Facile,0,Meme Difficulte que la Prediction,Adapte
32,2015,Droit,1,Introduction Historique au Droit,4,"La Revolution Francaise, l'Affirmation du Liberalisme",13,33,7,QROC,0.7,0.21,19.4,16,66,82,67,16,51,1.22,23.88,Moyen,Difficile,-1,Plus Difficile que la Prediction,Pas Adapte
1098,2016,Droit,1,Introduction Historique au Droit,4,"La Revolution Francaise, l'Affirmation du Liberalisme",13,33,7,QCM,0.1,0.89,99.05,81,1,82,82,81,1,1.0,98.78,Facile,Facile,0,Meme Difficulte que la Prediction,Pas Adapte
2164,2017,Droit,1,Introduction Historique au Droit,4,"La Revolution Francaise, l'Affirmation du Liberalisme",13,33,7,QCM,0.5,0.27,5.24,4,68,72,42,4,38,1.71,9.52,Difficile,Difficile,0,Meme Difficulte que la Prediction,Pas Adapte
3230,2018,Droit,1,Introduction Historique au Droit,4,"La Revolution Francaise, l'Affirmation du Liberalisme",13,33,7,QCM,0.73,0.29,15.75,13,69,82,38,13,25,2.16,34.21,Difficile,Difficile,0,Meme Difficulte que la Prediction,Pas Adapte
4296,2019,Droit,1,Introduction Historique au Droit,4,"La Revolution Francaise, l'Affirmation du Liberalisme",13,33,7,QCU,0.22,0.75,56.58,40,31,71,68,40,28,1.04,58.82,Difficile,Moyen,1,Plus Facile que la Prediction,Pas Adapte
5362,2020,Droit,1,Introduction Historique au Droit,4,"La Revolution Francaise, l'Affirmation du Liberalisme",13,33,7,QCU,0.03,0.91,71.87,47,19,66,57,47,10,1.16,82.46,Moyen,Facile,1,Plus Facile que la Prediction,Adapte
33,2015,Droit,1,Introduction Historique au Droit,4,"La Revolution Francaise, l'Affirmation du Liberalisme",13,34,8,QCM,0.51,0.21,1.37,0,20,20,18,0,18,1.11,0.0,Difficile,Difficile,0,Meme Difficulte que la Prediction,Pas Adapte
1099,2016,Droit,1,Introduction Historique au Droit,4,"La Revolution Francaise, l'Affirmation du Liberalisme",13,34,8,QCM,0.31,0.36,40.88,9,14,23,18,9,9,1.28,50.0,Moyen,Moyen,0,Meme Difficulte que la Prediction,Pas Adapte
2165,2017,Droit,1,Introduction Historique au Droit,4,"La Revolution Francaise, l'Affirmation du Liberalisme",13,34,8,QCU,0.08,0.96,88.88,19,2,21,20,19,1,1.05,95.0,Facile,Facile,0,Meme Difficulte que la Prediction,Pas Adapte
3231,2018,Droit,1,Introduction Historique au Droit,4,"La Revolution Francaise, l'Affirmation du Liberalisme",13,34,8,QCU,0.2,0.64,61.72,15,9,24,19,15,4,1.26,78.95,Moyen,Moyen,0,Meme Difficulte que la Prediction,Adapte
4297,2019,Droit,1,Introduction Historique au Droit,4,"La Revolution Francaise, l'Affirmation du Liberalisme",13,34,8,QCU,0.38,0.73,61.72,15,10,25,16,15,1,1.56,93.75,Moyen,Moyen,0,Meme Difficulte que la Prediction,Adapte
5363,2020,Droit,1,Introduction Historique au Droit,4,"La Revolution Francaise, l'Affirmation du Liberalisme",13,34,8,QCU,0.39,0.67,61.72,17,11,28,20,17,3,1.4,85.0,Moyen,Moyen,0,Meme Difficulte que la Prediction,Adapte
34,2015,Droit,1,Introduction Historique au Droit,4,"La Revolution Francaise, l'Affirmation du Liberalisme",13,35,9,QROC,0.72,0.23,21.65,15,54,69,42,15,27,1.64,35.71,Difficile,Difficile,0,Meme Difficulte que la Prediction,Pas Adapte
1100,2016,Droit,1,Introduction Historique au Droit,4,"La Revolution Francaise, l'Affirmation du Liberalisme",13,35,9,QROC,0.58,0.37,44.77,29,35,64,40,29,11,1.6,72.5,Moyen,Moyen,0,Meme Difficulte que la Prediction,Pas Adapte
2166,2017,Droit,1,Introduction Historique au Droit,4,"La Revolution Francaise, l'Affirmation du Liberalisme",13,35,9,QROC,0.11,0.43,71.63,49,20,69,50,49,1,1.38,98.0,Moyen,Facile,1,Plus Facile que la Prediction,Adapte
3232,2018,Droit,1,Introduction Historique au Droit,4,"La Revolution Francaise, l'Affirmation du Liberalisme",13,35,9,QROC,0.09,0.99,71.63,50,20,70,60,50,10,1.17,83.33,Facile,Facile,0,Meme Difficulte que la Prediction,Adapte
4298,2019,Droit,1,Introduction Historique au Droit,4,"La Revolution Francaise, l'Affirmation du Liberalisme",13,35,9,QROC,0.03,0.87,71.63,52,21,73,54,52,2,1.35,96.3,Facile,Facile,0,Meme Difficulte que la Prediction,Adapte
5364,2020,Droit,1,Introduction Historique au Droit,4,"La Revolution Francaise, l'Affirmation du Liberalisme",13,35,9,QROC,0.02,0.85,71.63,49,19,68,62,49,13,1.1,79.03,Facile,Facile,0,Meme Difficulte que la Prediction,Adapte
35,2015,Droit,1,Introduction Historique au Droit,4,"La Revolution Francaise, l'Affirmation du Liberalisme",13,36,10,QO,1.0,0.11,12.06,6,42,48,45,6,39,1.07,13.33,Difficile,Difficile,0,Meme Difficulte que la Prediction,Pas Adapte
1101,2016,Droit,1,Introduction Historique au Droit,4,"La Revolution Francaise, l'Affirmation du Liberalisme",13,36,10,QO,0.1,0.73,83.82,45,9,54,50,45,5,1.08,90.0,Difficile,Facile,2,Beaucoup plus Facile que la Prediction,Pas Adapte
2167,2017,Droit,1,Introduction Historique au Droit,4,"La Revolution Francaise, l'Affirmation du Liberalisme",13,36,10,QO,0.92,0.09,33.45,20,40,60,58,20,38,1.03,34.48,Moyen,Difficile,-1,Plus Difficile que la Prediction,Pas Adapte
3233,2018,Droit,1,Introduction Historique au Droit,4,"La Revolution Francaise, l'Affirmation du Liberalisme",13,36,10,QO,0.91,0.09,20.9,14,51,65,35,14,21,1.86,40.0,Difficile,Difficile,0,Meme Difficulte que la Prediction,Pas Adapte
4299,2019,Droit,1,Introduction Historique au Droit,4,"La Revolution Francaise, l'Affirmation du Liberalisme",13,36,10,QO,0.03,0.78,82.69,45,10,55,55,45,10,1.0,81.82,Facile,Facile,0,Meme Difficulte que la Prediction,Pas Adapte
5365,2020,Droit,1,Introduction Historique au Droit,4,"La Revolution Francaise, l'Affirmation du Liberalisme",13,36,10,QCM,0.66,0.27,14.89,8,46,54,50,8,42,1.08,16.0,Moyen,Difficile,-1,Plus Difficile que la Prediction,Pas Adapte
36,2015,Droit,1,Introduction Historique au Droit,4,"La Revolution Francaise, l'Affirmation du Liberalisme",13,37,11,QCM,0.27,0.48,40.45,13,20,33,28,13,15,1.18,46.43,Moyen,Moyen,0,Meme Difficulte que la Prediction,Pas Adapte
1102,2016,Droit,1,Introduction Historique au Droit,4,"La Revolution Francaise, l'Affirmation du Liberalisme",13,37,11,QCM,0.07,0.82,89.22,29,4,33,30,29,1,1.1,96.67,Moyen,Facile,1,Plus Facile que la Prediction,Pas Adapte
2168,2017,Droit,1,Introduction Historique au Droit,4,"La Revolution Francaise, l'Affirmation du Liberalisme",13,37,11,QCU,0.05,0.85,92.15,29,3,32,31,29,2,1.03,93.55,Facile,Facile,0,Meme Difficulte que la Prediction,Pas Adapte
3234,2018,Droit,1,Introduction Historique au Droit,4,"La Revolution Francaise, l'Affirmation du Liberalisme",13,37,11,QCU,0.04,0.77,65.13,23,12,35,33,23,10,1.06,69.7,Facile,Facile,0,Meme Difficulte que la Prediction,Adapte
4300,2019,Droit,1,Introduction Historique au Droit,4,"La Revolution Francaise, l'Affirmation du Liberalisme",13,37,11,QCU,0.02,0.99,65.13,23,13,36,31,23,8,1.16,74.19,Facile,Facile,0,Meme Difficulte que la Prediction,Adapte
5366,2020,Droit,1,Introduction Historique au Droit,4,"La Revolution Francaise, l'Affirmation du Liberalisme",13,37,11,QCU,0.14,0.96,65.13,27,14,41,30,27,3,1.37,90.0,Facile,Facile,0,Meme Difficulte que la Prediction,Adapte
37,2015,Droit,1,Introduction Historique au Droit,4,"La Revolution Francaise, l'Affirmation du Liberalisme",13,38,12,QCM,0.74,0.23,3.61,2,48,50,44,2,42,1.14,4.55,Difficile,Difficile,0,Meme Difficulte que la Prediction,Pas Adapte
1103,2016,Droit,1,Introduction Historique au Droit,4,"La Revolution Francaise, l'Affirmation du Liberalisme",13,38,12,QCM,0.37,0.32,52.02,28,26,54,50,28,22,1.08,56.0,Moyen,Moyen,0,Meme Difficulte que la Prediction,Pas Adapte
2169,2017,Droit,1,Introduction Historique au Droit,4,"La Revolution Francaise, l'Affirmation du Liberalisme",13,38,12,QROC,0.16,0.75,68.53,32,15,47,34,32,2,1.38,94.12,Facile,Facile,0,Meme Difficulte que la Prediction,Adapte
3235,2018,Droit,1,Introduction Historique au Droit,4,"La Revolution Francaise, l'Affirmation du Liberalisme",13,38,12,QCU,0.19,1.0,68.53,29,14,43,31,29,2,1.39,93.55,Facile,Facile,0,Meme Difficulte que la Prediction,Adapte
4301,2019,Droit,1,Introduction Historique au Droit,4,"La Revolution Francaise, l'Affirmation du Liberalisme",13,38,12,QCU,0.13,0.78,68.53,34,15,49,43,34,9,1.14,79.07,Facile,Facile,0,Meme Difficulte que la Prediction,Adapte
5367,2020,Droit,1,Introduction Historique au Droit,4,"La Revolution Francaise, l'Affirmation du Liberalisme",13,38,12,QROC,0.09,0.57,68.53,34,16,50,42,34,8,1.19,80.95,Facile,Facile,0,Meme Difficulte que la Prediction,Adapte
38,2015,Droit,1,Introduction Historique au Droit,4,"La Revolution Francaise, l'Affirmation du Liberalisme",13,39,13,QCM,0.56,0.26,17.7,6,28,34,13,6,7,2.62,46.15,Facile,Difficile,-2,Beaucoup plus Difficile que la Prediction,Pas Adapte
1104,2016,Droit,1,Introduction Historique au Droit,4,"La Revolution Francaise, l'Affirmation du Liberalisme",13,39,13,QCM,0.68,0.29,26.45,8,24,32,10,8,2,3.2,80.0,Difficile,Difficile,0,Meme Difficulte que la Prediction,Pas Adapte
2170,2017,Droit,1,Introduction Historique au Droit,4,"La Revolution Francaise, l'Affirmation du Liberalisme",13,39,13,QCM,0.75,0.28,30.58,9,22,31,21,9,12,1.48,42.86,Difficile,Difficile,0,Meme Difficulte que la Prediction,Pas Adapte
3236,2018,Droit,1,Introduction Historique au Droit,4,"La Revolution Francaise, l'Affirmation du Liberalisme",13,39,13,QCU,0.05,0.87,79.79,25,6,31,27,25,2,1.15,92.59,Moyen,Facile,1,Plus Facile que la Prediction,Pas Adapte
4302,2019,Droit,1,Introduction Historique au Droit,4,"La Revolution Francaise, l'Affirmation du Liberalisme",13,39,13,QCU,0.06,0.99,93.31,34,2,36,35,34,1,1.03,97.14,Facile,Facile,0,Meme Difficulte que la Prediction,Pas Adapte
5368,2020,Droit,1,Introduction Historique au Droit,4,"La Revolution Francaise, l'Affirmation du Liberalisme",13,39,13,QCU,0.14,0.9,76.45,30,9,39,32,30,2,1.22,93.75,Facile,Facile,0,Meme Difficulte que la Prediction,Pas Adapte
39,2015,Droit,1,Introduction Historique au Droit,5,L'Amenagement du Liberalisme,7,40,1,QCM,0.69,0.29,8.07,8,92,100,55,8,47,1.82,14.55,Difficile,Difficile,0,Meme Difficulte que la Prediction,Pas Adapte
1105,2016,Droit,1,Introduction Historique au Droit,5,L'Amenagement du Liberalisme,7,40,1,QCM,0.09,0.87,73.72,82,29,111,91,82,9,1.22,90.11,Facile,Facile,0,Meme Difficulte que la Prediction,Adapte
2171,2017,Droit,1,Introduction Historique au Droit,5,L'Amenagement du Liberalisme,7,40,1,QCM,0.06,0.86,73.72,91,32,123,120,91,29,1.02,75.83,Facile,Facile,0,Meme Difficulte que la Prediction,Adapte
3237,2018,Droit,1,Introduction Historique au Droit,5,L'Amenagement du Liberalisme,7,40,1,QCM,0.17,0.8,73.72,96,34,130,110,96,14,1.18,87.27,Facile,Facile,0,Meme Difficulte que la Prediction,Adapte
4303,2019,Droit,1,Introduction Historique au Droit,5,L'Amenagement du Liberalisme,7,40,1,QCM,0.11,0.86,73.72,86,30,116,101,86,15,1.15,85.15,Facile,Facile,0,Meme Difficulte que la Prediction,Adapte
5369,2020,Droit,1,Introduction Historique au Droit,5,L'Amenagement du Liberalisme,7,40,1,QCM,0.13,0.88,73.72,82,29,111,104,82,22,1.07,78.85,Facile,Facile,0,Meme Difficulte que la Prediction,Adapte
40,2015,Droit,1,Introduction Historique au Droit,5,L'Amenagement du Liberalisme,7,41,2,QCM,0.12,0.99,65.65,64,34,98,72,64,8,1.36,88.89,Facile,Facile,0,Meme Difficulte que la Prediction,Adapte
1106,2016,Droit,1,Introduction Historique au Droit,5,L'Amenagement du Liberalisme,7,41,2,QCM,0.03,0.98,65.65,66,35,101,82,66,16,1.23,80.49,Facile,Facile,0,Meme Difficulte que la Prediction,Adapte
2172,2017,Droit,1,Introduction Historique au Droit,5,L'Amenagement du Liberalisme,7,41,2,QCM,0.12,0.7,65.65,75,39,114,106,75,31,1.08,70.75,Facile,Facile,0,Meme Difficulte que la Prediction,Adapte
3238,2018,Droit,1,Introduction Historique au Droit,5,L'Amenagement du Liberalisme,7,41,2,QCM,0.18,0.89,65.65,79,42,121,82,79,3,1.48,96.34,Facile,Facile,0,Meme Difficulte que la Prediction,Adapte
4304,2019,Droit,1,Introduction Historique au Droit,5,L'Amenagement du Liberalisme,7,41,2,QCM,0.09,0.79,65.65,86,45,131,102,86,16,1.28,84.31,Facile,Facile,0,Meme Difficulte que la Prediction,Adapte
5370,2020,Droit,1,Introduction Historique au Droit,5,L'Amenagement du Liberalisme,7,41,2,QCM,0.06,0.96,65.65,92,48,140,124,92,32,1.13,74.19,Facile,Facile,0,Meme Difficulte que la Prediction,Adapte
41,2015,Droit,1,Introduction Historique au Droit,5,L'Amenagement du Liberalisme,7,42,3,QCU,0.24,0.43,36.87,15,25,40,37,15,22,1.08,40.54,Difficile,Moyen,1,Plus Facile que la Prediction,Pas Adapte
1107,2016,Droit,1,Introduction Historique au Droit,5,L'Amenagement du Liberalisme,7,42,3,QCU,0.66,0.26,15.78,6,29,35,21,6,15,1.67,28.57,Moyen,Difficile,-1,Plus Difficile que la Prediction,Pas Adapte
2173,2017,Droit,1,Introduction Historique au Droit,5,L'Amenagement du Liberalisme,7,42,3,QCU,0.02,0.97,81.85,26,6,32,28,26,2,1.14,92.86,Difficile,Facile,2,Beaucoup plus Facile que la Prediction,Pas Adapte
3239,2018,Droit,1,Introduction Historique au Droit,5,L'Amenagement du Liberalisme,7,42,3,QCU,0.33,0.52,37.68,12,21,33,20,12,8,1.65,60.0,Difficile,Moyen,1,Plus Facile que la Prediction,Pas Adapte
4305,2019,Droit,1,Introduction Historique au Droit,5,L'Amenagement du Liberalisme,7,42,3,QCM,0.03,0.81,74.16,26,9,35,32,26,6,1.09,81.25,Facile,Facile,0,Meme Difficulte que la Prediction,Adapte
5371,2020,Droit,1,Introduction Historique au Droit,5,L'Amenagement du Liberalisme,7,42,3,QCM,0.09,0.87,74.16,26,9,35,28,26,2,1.25,92.86,Facile,Facile,0,Meme Difficulte que la Prediction,Adapte
42,2015,Droit,1,Introduction Historique au Droit,5,L'Amenagement du Liberalisme,7,43,4,QCM,0.21,0.44,61.38,43,27,70,64,43,21,1.09,67.19,Moyen,Moyen,0,Meme Difficulte que la Prediction,Adapte
1108,2016,Droit,1,Introduction Historique au Droit,5,L'Amenagement du Liberalisme,7,43,4,QCM,0.28,0.65,61.38,43,27,70,63,43,20,1.11,68.25,Moyen,Moyen,0,Meme Difficulte que la Prediction,Adapte
2174,2017,Droit,1,Introduction Historique au Droit,5,L'Amenagement du Liberalisme,7,43,4,QCM,0.24,0.6,61.38,49,31,80,50,49,1,1.6,98.0,Moyen,Moyen,0,Meme Difficulte que la Prediction,Adapte
3240,2018,Droit,1,Introduction Historique au Droit,5,L'Amenagement du Liberalisme,7,43,4,QCM,0.34,0.32,61.38,45,29,74,48,45,3,1.54,93.75,Moyen,Moyen,0,Meme Difficulte que la Prediction,Adapte
4306,2019,Droit,1,Introduction Historique au Droit,5,L'Amenagement du Liberalisme,7,43,4,QCU,0.31,0.54,61.38,51,32,83,66,51,15,1.26,77.27,Moyen,Moyen,0,Meme Difficulte que la Prediction,Adapte
5372,2020,Droit,1,Introduction Historique au Droit,5,L'Amenagement du Liberalisme,7,43,4,QCU,0.3,0.43,61.38,55,35,90,62,55,7,1.45,88.71,Moyen,Moyen,0,Meme Difficulte que la Prediction,Adapte
43,2015,Droit,1,Introduction Historique au Droit,5,L'Amenagement du Liberalisme,7,44,5,QROC,0.17,0.87,71.28,71,28,99,77,71,6,1.29,92.21,Facile,Facile,0,Meme Difficulte que la Prediction,Adapte
1109,2016,Droit,1,Introduction Historique au Droit,5,L'Amenagement du Liberalisme,7,44,5,QROC,0.0,0.41,71.28,68,28,96,71,68,3,1.35,95.77,Facile,Facile,0,Meme Difficulte que la Prediction,Adapte
2175,2017,Droit,1,Introduction Historique au Droit,5,L'Amenagement du Liberalisme,7,44,5,QROC,0.14,0.49,71.28,63,26,89,87,63,24,1.02,72.41,Facile,Facile,0,Meme Difficulte que la Prediction,Adapte
3241,2018,Droit,1,Introduction Historique au Droit,5,L'Amenagement du Liberalisme,7,44,5,QROC,0.13,0.64,71.28,62,25,87,82,62,20,1.06,75.61,Facile,Facile,0,Meme Difficulte que la Prediction,Adapte
4307,2019,Droit,1,Introduction Historique au Droit,5,L'Amenagement du Liberalisme,7,44,5,QO,0.05,0.67,71.28,68,28,96,75,68,7,1.28,90.67,Facile,Facile,0,Meme Difficulte que la Prediction,Adapte
5373,2020,Droit,1,Introduction Historique au Droit,5,L'Amenagement du Liberalisme,7,44,5,QO,0.08,0.64,71.28,68,27,95,85,68,17,1.12,80.0,Facile,Facile,0,Meme Difficulte que la Prediction,Adapte
44,2015,Droit,1,Introduction Historique au Droit,5,L'Amenagement du Liberalisme,7,45,6,QCM,0.31,0.46,54.07,14,12,26,20,14,6,1.3,70.0,Moyen,Moyen,0,Meme Difficulte que la Prediction,Pas Adapte
1110,2016,Droit,1,Introduction Historique au Droit,5,L'Amenagement du Liberalisme,7,45,6,QCM,0.22,0.48,37.17,8,14,22,13,8,5,1.69,61.54,Moyen,Moyen,0,Meme Difficulte que la Prediction,Pas Adapte
2176,2017,Droit,1,Introduction Historique au Droit,5,L'Amenagement du Liberalisme,7,45,6,QCM,0.67,0.19,3.21,1,18,19,9,1,8,2.11,11.11,Facile,Difficile,-2,Beaucoup plus Difficile que la Prediction,Pas Adapte
3242,2018,Droit,1,Introduction Historique au Droit,5,L'Amenagement du Liberalisme,7,45,6,QCU,0.21,0.68,37.96,7,11,18,11,7,4,1.64,63.64,Moyen,Moyen,0,Meme Difficulte que la Prediction,Pas Adapte
4308,2019,Droit,1,Introduction Historique au Droit,5,L'Amenagement du Liberalisme,7,45,6,QCU,0.51,0.31,28.33,6,15,21,12,6,6,1.75,50.0,Difficile,Difficile,0,Meme Difficulte que la Prediction,Pas Adapte
5374,2020,Droit,1,Introduction Historique au Droit,5,L'Amenagement du Liberalisme,7,45,6,QCU,0.19,0.75,84.6,18,3,21,20,18,2,1.05,90.0,Difficile,Facile,2,Beaucoup plus Facile que la Prediction,Pas Adapte
45,2015,Droit,1,Introduction Historique au Droit,5,L'Amenagement du Liberalisme,7,46,7,QCU,0.08,0.94,85.68,12,2,14,13,12,1,1.08,92.31,Facile,Facile,0,Meme Difficulte que la Prediction,Pas Adapte
1111,2016,Droit,1,Introduction Historique au Droit,5,L'Amenagement du Liberalisme,7,46,7,QCU,0.6,0.35,16.19,2,13,15,14,2,12,1.07,14.29,Moyen,Difficile,-1,Plus Difficile que la Prediction,Pas Adapte
2177,2017,Droit,1,Introduction Historique au Droit,5,L'Amenagement du Liberalisme,7,46,7,QCU,0.05,0.99,70.98,11,4,15,13,11,2,1.15,84.62,Difficile,Facile,2,Beaucoup plus Facile que la Prediction,Adapte
3243,2018,Droit,1,Introduction Historique au Droit,5,L'Amenagement du Liberalisme,7,46,7,QCU,0.07,0.83,70.98,10,4,14,14,10,4,1.0,71.43,Facile,Facile,0,Meme Difficulte que la Prediction,Adapte
4309,2019,Droit,1,Introduction Historique au Droit,5,L'Amenagement du Liberalisme,7,46,7,QCU,0.06,0.85,70.98,10,4,14,13,10,3,1.08,76.92,Facile,Facile,0,Meme Difficulte que la Prediction,Adapte
5375,2020,Droit,1,Introduction Historique au Droit,5,L'Amenagement du Liberalisme,7,46,7,QCU,0.08,0.82,70.98,9,3,12,9,9,0,1.33,100.0,Facile,Facile,0,Meme Difficulte que la Prediction,Adapte
46,2015,Droit,1,Relations Internationales,1,Introduction,4,47,1,QCU,0.33,0.54,55.2,8,6,14,10,8,2,1.4,80.0,Moyen,Moyen,0,Meme Difficulte que la Prediction,Pas Adapte
1112,2016,Droit,1,Relations Internationales,1,Introduction,4,47,1,QCU,0.3,0.43,62.84,10,6,16,10,10,0,1.6,100.0,Moyen,Moyen,0,Meme Difficulte que la Prediction,Adapte
2178,2017,Droit,1,Relations Internationales,1,Introduction,4,47,1,QCU,0.38,0.65,62.84,10,6,16,15,10,5,1.07,66.67,Moyen,Moyen,0,Meme Difficulte que la Prediction,Adapte
3244,2018,Droit,1,Relations Internationales,1,Introduction,4,47,1,QCU,0.25,0.69,62.84,9,6,15,10,9,1,1.5,90.0,Moyen,Moyen,0,Meme Difficulte que la Prediction,Adapte
4310,2019,Droit,1,Relations Internationales,1,Introduction,4,47,1,QCU,0.21,0.63,62.84,11,6,17,17,11,6,1.0,64.71,Moyen,Moyen,0,Meme Difficulte que la Prediction,Adapte
5376,2020,Droit,1,Relations Internationales,1,Introduction,4,47,1,QCU,0.29,0.52,62.84,9,5,14,12,9,3,1.17,75.0,Moyen,Moyen,0,Meme Difficulte que la Prediction,Adapte
47,2015,Droit,1,Relations Internationales,1,Introduction,4,48,2,QCU,0.26,0.65,57.03,43,33,76,64,43,21,1.19,67.19,Moyen,Moyen,0,Meme Difficulte que la Prediction,Pas Adapte
1113,2016,Droit,1,Relations Internationales,1,Introduction,4,48,2,QCU,0.08,0.99,97.42,78,2,80,79,78,1,1.01,98.73,Facile,Facile,0,Meme Difficulte que la Prediction,Pas Adapte
2179,2017,Droit,1,Relations Internationales,1,Introduction,4,48,2,QCU,0.46,0.36,26.79,20,55,75,37,20,17,2.03,54.05,Difficile,Difficile,0,Meme Difficulte que la Prediction,Pas Adapte
3245,2018,Droit,1,Relations Internationales,1,Introduction,4,48,2,QCU,0.17,0.8,72.68,59,22,81,76,59,17,1.07,77.63,Facile,Facile,0,Meme Difficulte que la Prediction,Adapte
4311,2019,Droit,1,Relations Internationales,1,Introduction,4,48,2,QCU,0.07,0.98,72.68,63,23,86,74,63,11,1.16,85.14,Facile,Facile,0,Meme Difficulte que la Prediction,Adapte
5377,2020,Droit,1,Relations Internationales,1,Introduction,4,48,2,QCU,0.15,0.89,72.68,65,24,89,78,65,13,1.14,83.33,Facile,Facile,0,Meme Difficulte que la Prediction,Adapte
48,2015,Droit,1,Relations Internationales,1,Introduction,4,49,3,QROC,0.38,0.36,35.97,26,45,71,37,26,11,1.92,70.27,Moyen,Moyen,0,Meme Difficulte que la Prediction,Pas Adapte
1114,2016,Droit,1,Relations Internationales,1,Introduction,4,49,3,QROC,0.86,0.2,28.17,21,55,76,68,21,47,1.12,30.88,Difficile,Difficile,0,Meme Difficulte que la Prediction,Pas Adapte
2180,2017,Droit,1,Relations Internationales,1,Introduction,4,49,3,QROC,0.04,0.93,68.72,58,27,85,71,58,13,1.2,81.69,Facile,Facile,0,Meme Difficulte que la Prediction,Adapte
3246,2018,Droit,1,Relations Internationales,1,Introduction,4,49,3,QROC,0.06,0.77,68.72,67,31,98,96,67,29,1.02,69.79,Facile,Facile,0,Meme Difficulte que la Prediction,Adapte
4312,2019,Droit,1,Relations Internationales,1,Introduction,4,49,3,QROC,0.15,0.77,68.72,70,32,102,76,70,6,1.34,92.11,Facile,Facile,0,Meme Difficulte que la Prediction,Adapte
5378,2020,Droit,1,Relations Internationales,1,Introduction,4,49,3,QO,0.05,0.35,68.72,79,36,115,106,79,27,1.08,74.53,Facile,Facile,0,Meme Difficulte que la Prediction,Adapte
49,2015,Droit,1,Relations Internationales,1,Introduction,4,50,4,QCM,0.07,0.86,84.65,68,12,80,73,68,5,1.1,93.15,Moyen,Facile,1,Plus Facile que la Prediction,Pas Adapte
1115,2016,Droit,1,Relations Internationales,1,Introduction,4,50,4,QCM,0.45,0.42,57.65,43,31,74,68,43,25,1.09,63.24,Difficile,Moyen,1,Plus Facile que la Prediction,Pas Adapte
2181,2017,Droit,1,Relations Internationales,1,Introduction,4,50,4,QCM,0.54,0.25,5.8,5,78,83,40,5,35,2.08,12.5,Difficile,Difficile,0,Meme Difficulte que la Prediction,Pas Adapte
3247,2018,Droit,1,Relations Internationales,1,Introduction,4,50,4,QCM,0.35,0.66,53.14,49,44,93,80,49,31,1.16,61.25,Moyen,Moyen,0,Meme Difficulte que la Prediction,Pas Adapte
4313,2019,Droit,1,Relations Internationales,1,Introduction,4,50,4,QCM,0.18,0.82,97.26,87,2,89,89,87,2,1.0,97.75,Difficile,Facile,2,Beaucoup plus Facile que la Prediction,Pas Adapte
5379,2020,Droit,1,Relations Internationales,1,Introduction,4,50,4,QCU,0.02,0.91,72.83,58,22,80,64,58,6,1.25,90.62,Moyen,Facile,1,Plus Facile que la Prediction,Adapte
50,2015,Droit,1,Relations Internationales,2,Les Acteurs des Relations Internationales,11,51,1,QCU,0.54,0.26,13.35,5,33,38,13,5,8,2.92,38.46,Difficile,Difficile,0,Meme Difficulte que la Prediction,Pas Adapte
1116,2016,Droit,1,Relations Internationales,2,Les Acteurs des Relations Internationales,11,51,1,QCU,0.02,0.81,65.91,26,14,40,35,26,9,1.14,74.29,Facile,Facile,0,Meme Difficulte que la Prediction,Adapte
2182,2017,Droit,1,Relations Internationales,2,Les Acteurs des Relations Internationales,11,51,1,QCU,0.15,0.94,65.91,29,15,44,31,29,2,1.42,93.55,Facile,Facile,0,Meme Difficulte que la Prediction,Adapte
3248,2018,Droit,1,Relations Internationales,2,Les Acteurs des Relations Internationales,11,51,1,QCU,0.13,0.89,65.91,26,13,39,34,26,8,1.15,76.47,Facile,Facile,0,Meme Difficulte que la Prediction,Adapte
4314,2019,Droit,1,Relations Internationales,2,Les Acteurs des Relations Internationales,11,51,1,QCU,0.17,0.92,65.91,22,12,34,24,22,2,1.42,91.67,Facile,Facile,0,Meme Difficulte que la Prediction,Adapte
5380,2020,Droit,1,Relations Internationales,2,Les Acteurs des Relations Internationales,11,51,1,QCU,0.03,0.9,65.91,20,11,31,21,20,1,1.48,95.24,Facile,Facile,0,Meme Difficulte que la Prediction,Adapte
51,2015,Droit,1,Relations Internationales,2,Les Acteurs des Relations Internationales,11,52,2,QCU,0.48,0.27,17.54,5,25,30,11,5,6,2.73,45.45,Facile,Difficile,-2,Beaucoup plus Difficile que la Prediction,Pas Adapte
1117,2016,Droit,1,Relations Internationales,2,Les Acteurs des Relations Internationales,11,52,2,QCM,0.7,0.24,23.62,7,24,31,13,7,6,2.38,53.85,Difficile,Difficile,0,Meme Difficulte que la Prediction,Pas Adapte
2183,2017,Droit,1,Relations Internationales,2,Les Acteurs des Relations Internationales,11,52,2,QCM,0.32,0.49,42.89,14,19,33,30,14,16,1.1,46.67,Facile,Moyen,-1,Plus Difficile que la Prediction,Pas Adapte
3249,2018,Droit,1,Relations Internationales,2,Les Acteurs des Relations Internationales,11,52,2,QCU,0.24,0.53,40.93,14,19,33,25,14,11,1.32,56.0,Moyen,Moyen,0,Meme Difficulte que la Prediction,Pas Adapte
4315,2019,Droit,1,Relations Internationales,2,Les Acteurs des Relations Internationales,11,52,2,QCM,0.36,0.65,53.11,19,17,36,35,19,16,1.03,54.29,Facile,Moyen,-1,Plus Difficile que la Prediction,Pas Adapte
5381,2020,Droit,1,Relations Internationales,2,Les Acteurs des Relations Internationales,11,52,2,QCM,0.52,0.28,12.53,4,28,32,16,4,12,2.0,25.0,Difficile,Difficile,0,Meme Difficulte que la Prediction,Pas Adapte
52,2015,Droit,1,Relations Internationales,2,Les Acteurs des Relations Internationales,11,53,3,QCU,0.64,0.23,20.54,7,25,32,15,7,8,2.13,46.67,Facile,Difficile,-2,Beaucoup plus Difficile que la Prediction,Pas Adapte
1118,2016,Droit,1,Relations Internationales,2,Les Acteurs des Relations Internationales,11,53,3,QCU,0.43,0.25,7.8,2,26,28,28,2,26,1.0,7.14,Difficile,Difficile,0,Meme Difficulte que la Prediction,Pas Adapte
2184,2017,Droit,1,Relations Internationales,2,Les Acteurs des Relations Internationales,11,53,3,QCU,0.21,0.44,38.14,11,17,28,21,11,10,1.33,52.38,Moyen,Moyen,0,Meme Difficulte que la Prediction,Pas Adapte
3250,2018,Droit,1,Relations Internationales,2,Les Acteurs des Relations Internationales,11,53,3,QCU,0.07,0.86,73.34,21,7,28,26,21,5,1.08,80.77,Facile,Facile,0,Meme Difficulte que la Prediction,Adapte
4316,2019,Droit,1,Relations Internationales,2,Les Acteurs des Relations Internationales,11,53,3,QCU,0.09,0.89,73.34,21,7,28,23,21,2,1.22,91.3,Facile,Facile,0,Meme Difficulte que la Prediction,Adapte
5382,2020,Droit,1,Relations Internationales,2,Les Acteurs des Relations Internationales,11,53,3,QCM,0.15,0.92,73.34,21,7,28,25,21,4,1.12,84.0,Facile,Facile,0,Meme Difficulte que la Prediction,Adapte
53,2015,Droit,1,Relations Internationales,2,Les Acteurs des Relations Internationales,11,54,4,QCU,0.03,0.8,90.3,26,3,29,27,26,1,1.07,96.3,Facile,Facile,0,Meme Difficulte que la Prediction,Pas Adapte
1119,2016,Droit,1,Relations Internationales,2,Les Acteurs des Relations Internationales,11,54,4,QCU,0.4,0.35,17.06,5,26,31,29,5,24,1.07,17.24,Moyen,Difficile,-1,Plus Difficile que la Prediction,Pas Adapte
2185,2017,Droit,1,Relations Internationales,2,Les Acteurs des Relations Internationales,11,54,4,QCU,0.27,0.49,35.82,12,21,33,29,12,17,1.14,41.38,Facile,Moyen,-1,Plus Difficile que la Prediction,Pas Adapte
3251,2018,Droit,1,Relations Internationales,2,Les Acteurs des Relations Internationales,11,54,4,QCU,0.7,0.35,25.7,8,25,33,30,8,22,1.1,26.67,Moyen,Difficile,-1,Plus Difficile que la Prediction,Pas Adapte
4317,2019,Droit,1,Relations Internationales,2,Les Acteurs des Relations Internationales,11,54,4,QCU,0.29,0.45,62.41,24,14,38,24,24,0,1.58,100.0,Moyen,Moyen,0,Meme Difficulte que la Prediction,Adapte
5383,2020,Droit,1,Relations Internationales,2,Les Acteurs des Relations Internationales,11,54,4,QCU,0.23,0.44,62.41,23,14,37,35,23,12,1.06,65.71,Moyen,Moyen,0,Meme Difficulte que la Prediction,Adapte
54,2015,Droit,1,Relations Internationales,2,Les Acteurs des Relations Internationales,11,55,5,QCM,0.48,0.5,45.86,37,43,80,48,37,11,1.67,77.08,Difficile,Moyen,1,Plus Facile que la Prediction,Pas Adapte
1120,2016,Droit,1,Relations Internationales,2,Les Acteurs des Relations Internationales,11,55,5,QCM,0.01,0.73,77.46,64,18,82,65,64,1,1.26,98.46,Facile,Facile,0,Meme Difficulte que la Prediction,Pas Adapte
2186,2017,Droit,1,Relations Internationales,2,Les Acteurs des Relations Internationales,11,55,5,QCM,0.71,0.17,22.02,20,69,89,28,20,8,3.18,71.43,Difficile,Difficile,0,Meme Difficulte que la Prediction,Pas Adapte
3252,2018,Droit,1,Relations Internationales,2,Les Acteurs des Relations Internationales,11,55,5,QCM,0.43,0.51,59.63,61,41,102,71,61,10,1.44,85.92,Moyen,Moyen,0,Meme Difficulte que la Prediction,Pas Adapte
4318,2019,Droit,1,Relations Internationales,2,Les Acteurs des Relations Internationales,11,55,5,QCM,0.31,0.4,46.07,42,49,91,80,42,38,1.14,52.5,Difficile,Moyen,1,Plus Facile que la Prediction,Pas Adapte
5384,2020,Droit,1,Relations Internationales,2,Les Acteurs des Relations Internationales,11,55,5,QCM,0.79,0.21,3.15,3,101,104,33,3,30,3.15,9.09,Difficile,Difficile,0,Meme Difficulte que la Prediction,Pas Adapte
55,2015,Droit,1,Relations Internationales,2,Les Acteurs des Relations Internationales,11,56,6,QROC,0.09,0.63,96.0,43,2,45,43,43,0,1.05,100.0,Difficile,Facile,2,Beaucoup plus Facile que la Prediction,Pas Adapte
1121,2016,Droit,1,Relations Internationales,2,Les Acteurs des Relations Internationales,11,56,6,QROC,0.81,0.08,4.96,2,40,42,17,2,15,2.47,11.76,Difficile,Difficile,0,Meme Difficulte que la Prediction,Pas Adapte
2187,2017,Droit,1,Relations Internationales,2,Les Acteurs des Relations Internationales,11,56,6,QROC,0.96,0.18,0.3,0,47,47,30,0,30,1.57,0.0,Difficile,Difficile,0,Meme Difficulte que la Prediction,Pas Adapte
3253,2018,Droit,1,Relations Internationales,2,Les Acteurs des Relations Internationales,11,56,6,QROC,0.28,0.26,55.04,24,20,44,35,24,11,1.26,68.57,Difficile,Moyen,1,Plus Facile que la Prediction,Pas Adapte
4319,2019,Droit,1,Relations Internationales,2,Les Acteurs des Relations Internationales,11,56,6,QO,0.9,0.1,3.79,2,43,45,35,2,33,1.29,5.71,Difficile,Difficile,0,Meme Difficulte que la Prediction,Pas Adapte
5385,2020,Droit,1,Relations Internationales,2,Les Acteurs des Relations Internationales,11,56,6,QO,0.04,0.58,67.93,35,17,52,42,35,7,1.24,83.33,Facile,Facile,0,Meme Difficulte que la Prediction,Adapte
56,2015,Droit,1,Relations Internationales,2,Les Acteurs des Relations Internationales,11,57,7,QCU,0.35,0.66,53.97,10,9,19,17,10,7,1.12,58.82,Facile,Moyen,-1,Plus Difficile que la Prediction,Pas Adapte
1122,2016,Droit,1,Relations Internationales,2,Les Acteurs des Relations Internationales,11,57,7,QCU,0.72,0.36,20.59,4,14,18,7,4,3,2.57,57.14,Difficile,Difficile,0,Meme Difficulte que la Prediction,Pas Adapte
2188,2017,Droit,1,Relations Internationales,2,Les Acteurs des Relations Internationales,11,57,7,QCU,0.19,0.93,79.28,16,4,20,19,16,3,1.05,84.21,Moyen,Facile,1,Plus Facile que la Prediction,Pas Adapte
3254,2018,Droit,1,Relations Internationales,2,Les Acteurs des Relations Internationales,11,57,7,QCU,0.09,0.88,73.07,17,6,23,22,17,5,1.05,77.27,Facile,Facile,0,Meme Difficulte que la Prediction,Adapte
4320,2019,Droit,1,Relations Internationales,2,Les Acteurs des Relations Internationales,11,57,7,QCU,0.01,0.75,73.07,19,7,26,21,19,2,1.24,90.48,Facile,Facile,0,Meme Difficulte que la Prediction,Adapte
5386,2020,Droit,1,Relations Internationales,2,Les Acteurs des Relations Internationales,11,57,7,QCU,0.15,0.93,73.07,18,6,24,19,18,1,1.26,94.74,Facile,Facile,0,Meme Difficulte que la Prediction,Adapte
57,2015,Droit,1,Relations Internationales,2,Les Acteurs des Relations Internationales,11,58,8,QCM,0.17,0.98,89.23,46,5,51,48,46,2,1.06,95.83,Difficile,Facile,2,Beaucoup plus Facile que la Prediction,Pas Adapte
1123,2016,Droit,1,Relations Internationales,2,Les Acteurs des Relations Internationales,11,58,8,QCM,0.42,0.62,62.5,29,17,46,41,29,12,1.12,70.73,Moyen,Moyen,0,Meme Difficulte que la Prediction,Adapte
2189,2017,Droit,1,Relations Internationales,2,Les Acteurs des Relations Internationales,11,58,8,QCM,0.28,0.62,62.5,31,18,49,34,31,3,1.44,91.18,Moyen,Moyen,0,Meme Difficulte que la Prediction,Adapte
3255,2018,Droit,1,Relations Internationales,2,Les Acteurs des Relations Internationales,11,58,8,QCM,0.4,0.31,62.5,33,20,53,50,33,17,1.06,66.0,Moyen,Moyen,0,Meme Difficulte que la Prediction,Adapte
4321,2019,Droit,1,Relations Internationales,2,Les Acteurs des Relations Internationales,11,58,8,QCM,0.46,0.56,62.5,33,19,52,50,33,17,1.04,66.0,Moyen,Moyen,0,Meme Difficulte que la Prediction,Adapte
5387,2020,Droit,1,Relations Internationales,2,Les Acteurs des Relations Internationales,11,58,8,QCM,0.37,0.59,62.5,34,20,54,38,34,4,1.42,89.47,Moyen,Moyen,0,Meme Difficulte que la Prediction,Adapte
58,2015,Droit,1,Relations Internationales,2,Les Acteurs des Relations Internationales,11,59,9,QCM,0.44,0.53,62.29,39,23,62,51,39,12,1.22,76.47,Moyen,Moyen,0,Meme Difficulte que la Prediction,Adapte
1124,2016,Droit,1,Relations Internationales,2,Les Acteurs des Relations Internationales,11,59,9,QCM,0.23,0.62,62.29,34,21,55,53,34,19,1.04,64.15,Moyen,Moyen,0,Meme Difficulte que la Prediction,Adapte
2190,2017,Droit,1,Relations Internationales,2,Les Acteurs des Relations Internationales,11,59,9,QCU,0.39,0.55,62.29,35,21,56,44,35,9,1.27,79.55,Moyen,Moyen,0,Meme Difficulte que la Prediction,Adapte
3256,2018,Droit,1,Relations Internationales,2,Les Acteurs des Relations Internationales,11,59,9,QCU,0.26,0.6,62.29,33,20,53,47,33,14,1.13,70.21,Moyen,Moyen,0,Meme Difficulte que la Prediction,Adapte
4322,2019,Droit,1,Relations Internationales,2,Les Acteurs des Relations Internationales,11,59,9,QCU,0.34,0.47,62.29,30,18,48,37,30,7,1.3,81.08,Moyen,Moyen,0,Meme Difficulte que la Prediction,Adapte
5388,2020,Droit,1,Relations Internationales,2,Les Acteurs des Relations Internationales,11,59,9,QCU,0.22,0.53,62.29,34,21,55,39,34,5,1.41,87.18,Moyen,Moyen,0,Meme Difficulte que la Prediction,Adapte
59,2015,Droit,1,Relations Internationales,2,Les Acteurs des Relations Internationales,11,60,10,QCM,0.34,0.47,59.31,52,35,87,70,52,18,1.24,74.29,Moyen,Moyen,0,Meme Difficulte que la Prediction,Pas Adapte
1125,2016,Droit,1,Relations Internationales,2,Les Acteurs des Relations Internationales,11,60,10,QCM,0.76,0.27,1.96,2,87,89,34,2,32,2.62,5.88,Difficile,Difficile,0,Meme Difficulte que la Prediction,Pas Adapte
2191,2017,Droit,1,Relations Internationales,2,Les Acteurs des Relations Internationales,11,60,10,QCM,0.67,0.17,13.82,12,77,89,63,12,51,1.41,19.05,Difficile,Difficile,0,Meme Difficulte que la Prediction,Pas Adapte
3257,2018,Droit,1,Relations Internationales,2,Les Acteurs des Relations Internationales,11,60,10,QCM,0.72,0.26,6.59,6,79,85,34,6,28,2.5,17.65,Moyen,Difficile,-1,Plus Difficile que la Prediction,Pas Adapte
4323,2019,Droit,1,Relations Internationales,2,Les Acteurs des Relations Internationales,11,60,10,QCM,0.23,0.34,54.12,53,44,97,58,53,5,1.67,91.38,Moyen,Moyen,0,Meme Difficulte que la Prediction,Pas Adapte
5389,2020,Droit,1,Relations Internationales,2,Les Acteurs des Relations Internationales,11,60,10,QCM,0.29,0.32,50.05,51,50,101,70,51,19,1.44,72.86,Facile,Moyen,-1,Plus Difficile que la Prediction,Pas Adapte
60,2015,Droit,1,Relations Internationales,2,Les Acteurs des Relations Internationales,11,61,11,QCM,0.04,0.97,88.58,35,4,39,39,35,4,1.0,89.74,Difficile,Facile,2,Beaucoup plus Facile que la Prediction,Pas Adapte
1126,2016,Droit,1,Relations Internationales,2,Les Acteurs des Relations Internationales,11,61,11,QCM,0.18,0.99,77.31,26,7,33,29,26,3,1.14,89.66,Facile,Facile,0,Meme Difficulte que la Prediction,Pas Adapte
2192,2017,Droit,1,Relations Internationales,2,Les Acteurs des Relations Internationales,11,61,11,QCM,0.19,0.91,84.6,26,5,31,27,26,1,1.15,96.3,Moyen,Facile,1,Plus Facile que la Prediction,Pas Adapte
3258,2018,Droit,1,Relations Internationales,2,Les Acteurs des Relations Internationales,11,61,11,QCM,0.04,0.87,93.58,27,2,29,27,27,0,1.07,100.0,Facile,Facile,0,Meme Difficulte que la Prediction,Pas Adapte
4324,2019,Droit,1,Relations Internationales,2,Les Acteurs des Relations Internationales,11,61,11,QCM,0.45,0.31,53.01,14,13,27,15,14,1,1.8,93.33,Moyen,Moyen,0,Meme Difficulte que la Prediction,Pas Adapte
5390,2020,Droit,1,Relations Internationales,2,Les Acteurs des Relations Internationales,11,61,11,QCM,0.22,0.38,64.17,15,8,23,16,15,1,1.44,93.75,Moyen,Moyen,0,Meme Difficulte que la Prediction,Adapte
61,2015,Droit,1,Relations Internationales,3,Les Grands Principes regissant les Relations Internationales,10,62,1,QCU,0.44,0.4,1.65,2,93,95,42,2,40,2.26,4.76,Difficile,Difficile,0,Meme Difficulte que la Prediction,Pas Adapte
1127,2016,Droit,1,Relations Internationales,3,Les Grands Principes regissant les Relations Internationales,10,62,1,QCU,0.24,0.71,36.71,36,63,99,95,36,59,1.04,37.89,Moyen,Moyen,0,Meme Difficulte que la Prediction,Pas Adapte
2193,2017,Droit,1,Relations Internationales,3,Les Grands Principes regissant les Relations Internationales,10,62,1,QCM,0.59,0.18,6.58,6,85,91,28,6,22,3.25,21.43,Difficile,Difficile,0,Meme Difficulte que la Prediction,Pas Adapte
3259,2018,Droit,1,Relations Internationales,3,Les Grands Principes regissant les Relations Internationales,10,62,1,QCM,0.31,0.66,55.05,53,44,97,68,53,15,1.43,77.94,Difficile,Moyen,1,Plus Facile que la Prediction,Pas Adapte
4325,2019,Droit,1,Relations Internationales,3,Les Grands Principes regissant les Relations Internationales,10,62,1,QCM,0.06,0.89,67.94,59,28,87,74,59,15,1.18,79.73,Facile,Facile,0,Meme Difficulte que la Prediction,Adapte
5391,2020,Droit,1,Relations Internationales,3,Les Grands Principes regissant les Relations Internationales,10,62,1,QCM,0.16,0.72,67.94,64,30,94,68,64,4,1.38,94.12,Facile,Facile,0,Meme Difficulte que la Prediction,Adapte
62,2015,Droit,1,Relations Internationales,3,Les Grands Principes regissant les Relations Internationales,10,63,2,QCU,0.74,0.24,32.1,23,50,73,48,23,25,1.52,47.92,Difficile,Difficile,0,Meme Difficulte que la Prediction,Pas Adapte
1128,2016,Droit,1,Relations Internationales,3,Les Grands Principes regissant les Relations Internationales,10,63,2,QCU,0.29,0.71,50.17,39,39,78,42,39,3,1.86,92.86,Moyen,Moyen,0,Meme Difficulte que la Prediction,Pas Adapte
2194,2017,Droit,1,Relations Internationales,3,Les Grands Principes regissant les Relations Internationales,10,63,2,QO,0.67,0.29,59.86,40,27,67,59,40,19,1.14,67.8,Moyen,Moyen,0,Meme Difficulte que la Prediction,Pas Adapte
3260,2018,Droit,1,Relations Internationales,3,Les Grands Principes regissant les Relations Internationales,10,63,2,QO,0.07,0.81,94.45,57,3,60,59,57,2,1.02,96.61,Moyen,Facile,1,Plus Facile que la Prediction,Pas Adapte
4326,2019,Droit,1,Relations Internationales,3,Les Grands Principes regissant les Relations Internationales,10,63,2,QROC,0.56,0.38,49.18,31,32,63,48,31,17,1.31,64.58,Difficile,Moyen,1,Plus Facile que la Prediction,Pas Adapte
5392,2020,Droit,1,Relations Internationales,3,Les Grands Principes regissant les Relations Internationales,10,63,2,QROC,0.91,0.12,18.9,12,53,65,36,12,24,1.81,33.33,Difficile,Difficile,0,Meme Difficulte que la Prediction,Pas Adapte
63,2015,Droit,1,Relations Internationales,3,Les Grands Principes regissant les Relations Internationales,10,64,3,QCM,0.35,0.37,37.58,12,21,33,21,12,9,1.57,57.14,Moyen,Moyen,0,Meme Difficulte que la Prediction,Pas Adapte
1129,2016,Droit,1,Relations Internationales,3,Les Grands Principes regissant les Relations Internationales,10,64,3,QCM,0.18,0.79,68.34,23,11,34,24,23,1,1.42,95.83,Facile,Facile,0,Meme Difficulte que la Prediction,Adapte
2195,2017,Droit,1,Relations Internationales,3,Les Grands Principes regissant les Relations Internationales,10,64,3,QROC,0.18,0.64,68.34,26,12,38,35,26,9,1.09,74.29,Facile,Facile,0,Meme Difficulte que la Prediction,Adapte
3261,2018,Droit,1,Relations Internationales,3,Les Grands Principes regissant les Relations Internationales,10,64,3,QO,0.12,0.6,68.34,27,13,40,37,27,10,1.08,72.97,Facile,Facile,0,Meme Difficulte que la Prediction,Adapte
4327,2019,Droit,1,Relations Internationales,3,Les Grands Principes regissant les Relations Internationales,10,64,3,QO,0.08,0.99,68.34,31,14,45,32,31,1,1.41,96.88,Facile,Facile,0,Meme Difficulte que la Prediction,Adapte
5393,2020,Droit,1,Relations Internationales,3,Les Grands Principes regissant les Relations Internationales,10,64,3,QO,0.16,0.54,68.34,31,15,46,32,31,1,1.44,96.88,Facile,Facile,0,Meme Difficulte que la Prediction,Adapte
64,2015,Droit,1,Relations Internationales,3,Les Grands Principes regissant les Relations Internationales,10,65,4,QCU,0.4,0.42,55.18,44,35,79,74,44,30,1.07,59.46,Moyen,Moyen,0,Meme Difficulte que la Prediction,Pas Adapte
1130,2016,Droit,1,Relations Internationales,3,Les Grands Principes regissant les Relations Internationales,10,65,4,QCU,0.57,0.25,13.97,10,61,71,61,10,51,1.16,16.39,Difficile,Difficile,0,Meme Difficulte que la Prediction,Pas Adapte
2196,2017,Droit,1,Relations Internationales,3,Les Grands Principes regissant les Relations Internationales,10,65,4,QCU,0.52,0.35,7.24,5,58,63,54,5,49,1.17,9.26,Difficile,Difficile,0,Meme Difficulte que la Prediction,Pas Adapte
3262,2018,Droit,1,Relations Internationales,3,Les Grands Principes regissant les Relations Internationales,10,65,4,QCU,0.2,0.96,87.23,47,7,54,50,47,3,1.08,94.0,Facile,Facile,0,Meme Difficulte que la Prediction,Pas Adapte
4328,2019,Droit,1,Relations Internationales,3,Les Grands Principes regissant les Relations Internationales,10,65,4,QCU,0.06,0.9,84.2,47,9,56,53,47,6,1.06,88.68,Difficile,Facile,2,Beaucoup plus Facile que la Prediction,Pas Adapte
5394,2020,Droit,1,Relations Internationales,3,Les Grands Principes regissant les Relations Internationales,10,65,4,QCM,0.25,0.47,55.44,28,23,51,40,28,12,1.27,70.0,Difficile,Moyen,1,Plus Facile que la Prediction,Pas Adapte
65,2015,Droit,1,Relations Internationales,3,Les Grands Principes regissant les Relations Internationales,10,66,5,QO,0.04,0.41,92.04,25,2,27,26,25,1,1.04,96.15,Facile,Facile,0,Meme Difficulte que la Prediction,Pas Adapte
1131,2016,Droit,1,Relations Internationales,3,Les Grands Principes regissant les Relations Internationales,10,66,5,QO,0.06,0.95,73.29,23,8,31,28,23,5,1.11,82.14,Facile,Facile,0,Meme Difficulte que la Prediction,Adapte
2197,2017,Droit,1,Relations Internationales,3,Les Grands Principes regissant les Relations Internationales,10,66,5,QO,0.14,0.56,73.29,21,7,28,27,21,6,1.04,77.78,Facile,Facile,0,Meme Difficulte que la Prediction,Adapte
3263,2018,Droit,1,Relations Internationales,3,Les Grands Principes regissant les Relations Internationales,10,66,5,QO,0.15,0.79,73.29,20,7,27,25,20,5,1.08,80.0,Facile,Facile,0,Meme Difficulte que la Prediction,Adapte
4329,2019,Droit,1,Relations Internationales,3,Les Grands Principes regissant les Relations Internationales,10,66,5,QO,0.19,0.51,73.29,20,7,27,22,20,2,1.23,90.91,Facile,Facile,0,Meme Difficulte que la Prediction,Adapte
5395,2020,Droit,1,Relations Internationales,3,Les Grands Principes regissant les Relations Internationales,10,66,5,QO,0.18,0.57,73.29,19,7,26,19,19,0,1.37,100.0,Facile,Facile,0,Meme Difficulte que la Prediction,Adapte
66,2015,Droit,1,Relations Internationales,3,Les Grands Principes regissant les Relations Internationales,10,67,6,QROC,0.74,0.16,24.97,15,46,61,58,15,43,1.05,25.86,Facile,Difficile,-2,Beaucoup plus Difficile que la Prediction,Pas Adapte
1132,2016,Droit,1,Relations Internationales,3,Les Grands Principes regissant les Relations Internationales,10,67,6,QO,0.72,0.17,63.25,42,24,66,44,42,2,1.5,95.45,Moyen,Moyen,0,Meme Difficulte que la Prediction,Adapte
2198,2017,Droit,1,Relations Internationales,3,Les Grands Principes regissant les Relations Internationales,10,67,6,QO,0.23,0.21,63.25,38,22,60,54,38,16,1.11,70.37,Moyen,Moyen,0,Meme Difficulte que la Prediction,Adapte
3264,2018,Droit,1,Relations Internationales,3,Les Grands Principes regissant les Relations Internationales,10,67,6,QO,0.59,0.24,63.25,34,19,53,42,34,8,1.26,80.95,Moyen,Moyen,0,Meme Difficulte que la Prediction,Adapte
4330,2019,Droit,1,Relations Internationales,3,Les Grands Principes regissant les Relations Internationales,10,67,6,QO,0.39,0.17,63.25,38,22,60,42,38,4,1.43,90.48,Moyen,Moyen,0,Meme Difficulte que la Prediction,Adapte
5396,2020,Droit,1,Relations Internationales,3,Les Grands Principes regissant les Relations Internationales,10,67,6,QO,0.64,0.24,63.25,33,19,52,49,33,16,1.06,67.35,Moyen,Moyen,0,Meme Difficulte que la Prediction,Adapte
67,2015,Droit,1,Relations Internationales,3,Les Grands Principes regissant les Relations Internationales,10,68,7,QCU,0.11,0.76,79.84,33,8,41,34,33,1,1.21,97.06,Facile,Facile,0,Meme Difficulte que la Prediction,Pas Adapte
1133,2016,Droit,1,Relations Internationales,3,Les Grands Principes regissant les Relations Internationales,10,68,7,QCU,0.18,0.96,77.78,33,9,42,36,33,3,1.17,91.67,Facile,Facile,0,Meme Difficulte que la Prediction,Pas Adapte
2199,2017,Droit,1,Relations Internationales,3,Les Grands Principes regissant les Relations Internationales,10,68,7,QCU,0.05,0.81,85.98,38,6,44,44,38,6,1.0,86.36,Difficile,Facile,2,Beaucoup plus Facile que la Prediction,Pas Adapte
3265,2018,Droit,1,Relations Internationales,3,Les Grands Principes regissant les Relations Internationales,10,68,7,QCU,0.63,0.3,22.17,8,30,38,32,8,24,1.19,25.0,Difficile,Difficile,0,Meme Difficulte que la Prediction,Pas Adapte
4331,2019,Droit,1,Relations Internationales,3,Les Grands Principes regissant les Relations Internationales,10,68,7,QCU,0.36,0.65,38.3,16,26,42,28,16,12,1.5,57.14,Moyen,Moyen,0,Meme Difficulte que la Prediction,Pas Adapte
5397,2020,Droit,1,Relations Internationales,3,Les Grands Principes regissant les Relations Internationales,10,68,7,QCU,0.16,0.93,85.14,41,7,48,43,41,2,1.12,95.35,Moyen,Facile,1,Plus Facile que la Prediction,Pas Adapte
68,2015,Droit,1,Relations Internationales,3,Les Grands Principes regissant les Relations Internationales,10,69,8,QCM,0.64,0.29,15.18,13,71,84,65,13,52,1.29,20.0,Difficile,Difficile,0,Meme Difficulte que la Prediction,Pas Adapte
1134,2016,Droit,1,Relations Internationales,3,Les Grands Principes regissant les Relations Internationales,10,69,8,QCM,0.24,0.7,42.12,36,50,86,79,36,43,1.09,45.57,Difficile,Moyen,1,Plus Facile que la Prediction,Pas Adapte
2200,2017,Droit,1,Relations Internationales,3,Les Grands Principes regissant les Relations Internationales,10,69,8,QCM,0.57,0.25,34.04,27,53,80,75,27,48,1.07,36.0,Moyen,Difficile,-1,Plus Difficile que la Prediction,Pas Adapte
3266,2018,Droit,1,Relations Internationales,3,Les Grands Principes regissant les Relations Internationales,10,69,8,QCM,0.05,0.74,85.99,58,10,68,59,58,1,1.15,98.31,Facile,Facile,0,Meme Difficulte que la Prediction,Pas Adapte
4332,2019,Droit,1,Relations Internationales,3,Les Grands Principes regissant les Relations Internationales,10,69,8,QCM,0.31,0.36,54.11,34,28,62,53,34,19,1.17,64.15,Moyen,Moyen,0,Meme Difficulte que la Prediction,Pas Adapte
5398,2020,Droit,1,Relations Internationales,3,Les Grands Principes regissant les Relations Internationales,10,69,8,QCM,0.04,0.8,67.18,40,19,59,57,40,17,1.04,70.18,Facile,Facile,0,Meme Difficulte que la Prediction,Adapte
69,2015,Droit,1,Relations Internationales,3,Les Grands Principes regissant les Relations Internationales,10,70,9,QCU,0.18,0.8,66.03,7,3,10,8,7,1,1.25,87.5,Facile,Facile,0,Meme Difficulte que la Prediction,Adapte
1135,2016,Droit,1,Relations Internationales,3,Les Grands Principes regissant les Relations Internationales,10,70,9,QCU,0.18,0.75,66.03,7,4,11,10,7,3,1.1,70.0,Facile,Facile,0,Meme Difficulte que la Prediction,Adapte
2201,2017,Droit,1,Relations Internationales,3,Les Grands Principes regissant les Relations Internationales,10,70,9,QCU,0.01,0.79,66.03,7,3,10,8,7,1,1.25,87.5,Facile,Facile,0,Meme Difficulte que la Prediction,Adapte
3267,2018,Droit,1,Relations Internationales,3,Les Grands Principes regissant les Relations Internationales,10,70,9,QCU,0.1,0.88,66.03,7,3,10,8,7,1,1.25,87.5,Facile,Facile,0,Meme Difficulte que la Prediction,Adapte
4333,2019,Droit,1,Relations Internationales,3,Les Grands Principes regissant les Relations Internationales,10,70,9,QCU,0.17,0.95,66.03,7,3,10,8,7,1,1.25,87.5,Facile,Facile,0,Meme Difficulte que la Prediction,Adapte
5399,2020,Droit,1,Relations Internationales,3,Les Grands Principes regissant les Relations Internationales,10,70,9,QCU,0.1,0.95,66.03,6,3,9,8,6,2,1.12,75.0,Facile,Facile,0,Meme Difficulte que la Prediction,Adapte
70,2015,Droit,1,Relations Internationales,3,Les Grands Principes regissant les Relations Internationales,10,71,10,QCU,0.1,0.93,68.35,36,17,53,46,36,10,1.15,78.26,Facile,Facile,0,Meme Difficulte que la Prediction,Adapte
1136,2016,Droit,1,Relations Internationales,3,Les Grands Principes regissant les Relations Internationales,10,71,10,QCU,0.1,0.85,68.35,33,15,48,35,33,2,1.37,94.29,Facile,Facile,0,Meme Difficulte que la Prediction,Adapte
2202,2017,Droit,1,Relations Internationales,3,Les Grands Principes regissant les Relations Internationales,10,71,10,QCU,0.12,0.78,68.35,31,14,45,35,31,4,1.29,88.57,Facile,Facile,0,Meme Difficulte que la Prediction,Adapte
3268,2018,Droit,1,Relations Internationales,3,Les Grands Principes regissant les Relations Internationales,10,71,10,QCU,0.2,0.95,68.35,27,13,40,38,27,11,1.05,71.05,Facile,Facile,0,Meme Difficulte que la Prediction,Adapte
4334,2019,Droit,1,Relations Internationales,3,Les Grands Principes regissant les Relations Internationales,10,71,10,QCU,0.19,0.91,68.35,29,13,42,32,29,3,1.31,90.62,Facile,Facile,0,Meme Difficulte que la Prediction,Adapte
5400,2020,Droit,1,Relations Internationales,3,Les Grands Principes regissant les Relations Internationales,10,71,10,QCU,0.08,0.96,68.35,29,14,43,35,29,6,1.23,82.86,Facile,Facile,0,Meme Difficulte que la Prediction,Adapte
71,2015,Droit,1,Proces et Institution Juridictionnelles,1,Introduction,7,72,1,QROC,0.05,0.57,74.28,48,16,64,56,48,8,1.14,85.71,Facile,Facile,0,Meme Difficulte que la Prediction,Adapte
1137,2016,Droit,1,Proces et Institution Juridictionnelles,1,Introduction,7,72,1,QROC,0.07,0.62,74.28,51,18,69,56,51,5,1.23,91.07,Facile,Facile,0,Meme Difficulte que la Prediction,Adapte
2203,2017,Droit,1,Proces et Institution Juridictionnelles,1,Introduction,7,72,1,QROC,0.12,0.46,74.28,49,17,66,54,49,5,1.22,90.74,Facile,Facile,0,Meme Difficulte que la Prediction,Adapte
3269,2018,Droit,1,Proces et Institution Juridictionnelles,1,Introduction,7,72,1,QROC,0.14,0.51,74.28,53,18,71,70,53,17,1.01,75.71,Facile,Facile,0,Meme Difficulte que la Prediction,Adapte
4335,2019,Droit,1,Proces et Institution Juridictionnelles,1,Introduction,7,72,1,QROC,0.15,0.47,74.28,58,20,78,67,58,9,1.16,86.57,Facile,Facile,0,Meme Difficulte que la Prediction,Adapte
5401,2020,Droit,1,Proces et Institution Juridictionnelles,1,Introduction,7,72,1,QROC,0.1,0.41,74.28,53,19,72,65,53,12,1.11,81.54,Facile,Facile,0,Meme Difficulte que la Prediction,Adapte
72,2015,Droit,1,Proces et Institution Juridictionnelles,1,Introduction,7,73,2,QCU,0.14,0.91,70.51,64,27,91,65,64,1,1.4,98.46,Facile,Facile,0,Meme Difficulte que la Prediction,Adapte
1138,2016,Droit,1,Proces et Institution Juridictionnelles,1,Introduction,7,73,2,QCU,0.05,0.88,70.51,58,24,82,71,58,13,1.15,81.69,Facile,Facile,0,Meme Difficulte que la Prediction,Adapte
2204,2017,Droit,1,Proces et Institution Juridictionnelles,1,Introduction,7,73,2,QCU,0.18,0.87,70.51,59,24,83,74,59,15,1.12,79.73,Facile,Facile,0,Meme Difficulte que la Prediction,Adapte
3270,2018,Droit,1,Proces et Institution Juridictionnelles,1,Introduction,7,73,2,QCU,0.11,0.85,70.51,63,27,90,82,63,19,1.1,76.83,Facile,Facile,0,Meme Difficulte que la Prediction,Adapte
4336,2019,Droit,1,Proces et Institution Juridictionnelles,1,Introduction,7,73,2,QCU,0.04,0.78,70.51,61,25,86,69,61,8,1.25,88.41,Facile,Facile,0,Meme Difficulte que la Prediction,Adapte
5402,2020,Droit,1,Proces et Institution Juridictionnelles,1,Introduction,7,73,2,QROC,0.09,0.53,70.51,59,24,83,82,59,23,1.01,71.95,Facile,Facile,0,Meme Difficulte que la Prediction,Adapte
73,2015,Droit,1,Proces et Institution Juridictionnelles,1,Introduction,7,74,3,QCU,0.35,0.62,56.58,32,24,56,33,32,1,1.7,96.97,Moyen,Moyen,0,Meme Difficulte que la Prediction,Pas Adapte
1139,2016,Droit,1,Proces et Institution Juridictionnelles,1,Introduction,7,74,3,QCU,0.32,0.41,49.38,24,25,49,34,24,10,1.44,70.59,Difficile,Moyen,1,Plus Facile que la Prediction,Pas Adapte
2205,2017,Droit,1,Proces et Institution Juridictionnelles,1,Introduction,7,74,3,QCU,0.73,0.27,26.78,13,35,48,36,13,23,1.33,36.11,Difficile,Difficile,0,Meme Difficulte que la Prediction,Pas Adapte
3271,2018,Droit,1,Proces et Institution Juridictionnelles,1,Introduction,7,74,3,QO,0.79,0.01,17.44,7,34,41,39,7,32,1.05,17.95,Difficile,Difficile,0,Meme Difficulte que la Prediction,Pas Adapte
4337,2019,Droit,1,Proces et Institution Juridictionnelles,1,Introduction,7,74,3,QO,0.52,0.2,43.27,20,26,46,25,20,5,1.84,80.0,Moyen,Moyen,0,Meme Difficulte que la Prediction,Pas Adapte
5403,2020,Droit,1,Proces et Institution Juridictionnelles,1,Introduction,7,74,3,QO,0.13,0.36,67.85,28,14,42,31,28,3,1.35,90.32,Difficile,Facile,2,Beaucoup plus Facile que la Prediction,Adapte
74,2015,Droit,1,Proces et Institution Juridictionnelles,1,Introduction,7,75,4,QCM,0.3,0.3,46.44,25,29,54,52,25,27,1.04,48.08,Difficile,Moyen,1,Plus Facile que la Prediction,Pas Adapte
1140,2016,Droit,1,Proces et Institution Juridictionnelles,1,Introduction,7,75,4,QROC,0.58,0.31,42.44,26,36,62,26,26,0,2.38,100.0,Difficile,Moyen,1,Plus Facile que la Prediction,Pas Adapte
2206,2017,Droit,1,Proces et Institution Juridictionnelles,1,Introduction,7,75,4,QROC,0.18,0.86,99.08,57,1,58,57,57,0,1.02,100.0,Difficile,Facile,2,Beaucoup plus Facile que la Prediction,Pas Adapte
3272,2018,Droit,1,Proces et Institution Juridictionnelles,1,Introduction,7,75,4,QROC,0.26,0.35,41.14,25,35,60,59,25,34,1.02,42.37,Moyen,Moyen,0,Meme Difficulte que la Prediction,Pas Adapte
4338,2019,Droit,1,Proces et Institution Juridictionnelles,1,Introduction,7,75,4,QROC,0.23,0.39,63.71,39,23,62,55,39,16,1.13,70.91,Moyen,Moyen,0,Meme Difficulte que la Prediction,Adapte
5404,2020,Droit,1,Proces et Institution Juridictionnelles,1,Introduction,7,75,4,QROC,0.55,0.28,63.71,43,24,67,45,43,2,1.49,95.56,Moyen,Moyen,0,Meme Difficulte que la Prediction,Adapte
75,2015,Droit,1,Proces et Institution Juridictionnelles,1,Introduction,7,76,5,QCM,0.03,0.77,66.53,33,16,49,40,33,7,1.23,82.5,Moyen,Facile,1,Plus Facile que la Prediction,Adapte
1141,2016,Droit,1,Proces et Institution Juridictionnelles,1,Introduction,7,76,5,QCM,0.11,0.79,66.53,30,15,45,39,30,9,1.15,76.92,Facile,Facile,0,Meme Difficulte que la Prediction,Adapte
2207,2017,Droit,1,Proces et Institution Juridictionnelles,1,Introduction,7,76,5,QCM,0.11,0.8,66.53,34,17,51,51,34,17,1.0,66.67,Facile,Facile,0,Meme Difficulte que la Prediction,Adapte
3273,2018,Droit,1,Proces et Institution Juridictionnelles,1,Introduction,7,76,5,QCU,0.07,0.86,66.53,30,15,45,44,30,14,1.02,68.18,Facile,Facile,0,Meme Difficulte que la Prediction,Adapte
4339,2019,Droit,1,Proces et Institution Juridictionnelles,1,Introduction,7,76,5,QCU,0.1,0.79,66.53,29,15,44,36,29,7,1.22,80.56,Facile,Facile,0,Meme Difficulte que la Prediction,Adapte
5405,2020,Droit,1,Proces et Institution Juridictionnelles,1,Introduction,7,76,5,QCU,0.12,0.81,66.53,32,16,48,39,32,7,1.23,82.05,Facile,Facile,0,Meme Difficulte que la Prediction,Adapte
76,2015,Droit,1,Proces et Institution Juridictionnelles,1,Introduction,7,77,6,QROC,0.15,0.9,66.95,56,27,83,67,56,11,1.24,83.58,Facile,Facile,0,Meme Difficulte que la Prediction,Adapte
1142,2016,Droit,1,Proces et Institution Juridictionnelles,1,Introduction,7,77,6,QROC,0.06,0.87,66.95,54,27,81,74,54,20,1.09,72.97,Facile,Facile,0,Meme Difficulte que la Prediction,Adapte
2208,2017,Droit,1,Proces et Institution Juridictionnelles,1,Introduction,7,77,6,QROC,0.16,0.59,66.95,50,25,75,59,50,9,1.27,84.75,Facile,Facile,0,Meme Difficulte que la Prediction,Adapte
3274,2018,Droit,1,Proces et Institution Juridictionnelles,1,Introduction,7,77,6,QROC,0.18,0.81,66.95,55,27,82,72,55,17,1.14,76.39,Facile,Facile,0,Meme Difficulte que la Prediction,Adapte
4340,2019,Droit,1,Proces et Institution Juridictionnelles,1,Introduction,7,77,6,QROC,0.19,0.59,66.95,54,26,80,56,54,2,1.43,96.43,Facile,Facile,0,Meme Difficulte que la Prediction,Adapte
5406,2020,Droit,1,Proces et Institution Juridictionnelles,1,Introduction,7,77,6,QROC,0.07,0.99,66.95,54,26,80,66,54,12,1.21,81.82,Facile,Facile,0,Meme Difficulte que la Prediction,Adapte
77,2015,Droit,1,Proces et Institution Juridictionnelles,1,Introduction,7,78,7,QCU,0.04,0.89,79.72,36,9,45,42,36,6,1.07,85.71,Facile,Facile,0,Meme Difficulte que la Prediction,Pas Adapte
1143,2016,Droit,1,Proces et Institution Juridictionnelles,1,Introduction,7,78,7,QCM,0.4,0.44,60.73,26,16,42,33,26,7,1.27,78.79,Facile,Moyen,-1,Plus Difficile que la Prediction,Adapte
2209,2017,Droit,1,Proces et Institution Juridictionnelles,1,Introduction,7,78,7,QCM,0.26,0.32,60.73,24,16,40,32,24,8,1.25,75.0,Moyen,Moyen,0,Meme Difficulte que la Prediction,Adapte
3275,2018,Droit,1,Proces et Institution Juridictionnelles,1,Introduction,7,78,7,QCM,0.41,0.39,60.73,24,16,40,30,24,6,1.33,80.0,Moyen,Moyen,0,Meme Difficulte que la Prediction,Adapte
4341,2019,Droit,1,Proces et Institution Juridictionnelles,1,Introduction,7,78,7,QCM,0.25,0.51,60.73,24,16,40,30,24,6,1.33,80.0,Moyen,Moyen,0,Meme Difficulte que la Prediction,Adapte
5407,2020,Droit,1,Proces et Institution Juridictionnelles,1,Introduction,7,78,7,QCM,0.36,0.69,60.73,21,13,34,25,21,4,1.36,84.0,Moyen,Moyen,0,Meme Difficulte que la Prediction,Adapte
78,2015,Droit,1,Proces et Institution Juridictionnelles,2,La Trame de la Scene Judiciaire,4,79,1,QCU,0.63,0.28,21.22,1,4,5,2,1,1,2.5,50.0,Difficile,Difficile,0,Meme Difficulte que la Prediction,Pas Adapte
1144,2016,Droit,1,Proces et Institution Juridictionnelles,2,La Trame de la Scene Judiciaire,4,79,1,QCU,0.61,0.32,21.08,1,3,4,2,1,1,2.0,50.0,Facile,Difficile,-2,Beaucoup plus Difficile que la Prediction,Pas Adapte
2210,2017,Droit,1,Proces et Institution Juridictionnelles,2,La Trame de la Scene Judiciaire,4,79,1,QCU,0.65,0.25,18.66,1,4,5,4,1,3,1.25,25.0,Difficile,Difficile,0,Meme Difficulte que la Prediction,Pas Adapte
3276,2018,Droit,1,Proces et Institution Juridictionnelles,2,La Trame de la Scene Judiciaire,4,79,1,QCU,0.05,0.84,81.71,4,1,5,5,4,1,1.0,80.0,Facile,Facile,0,Meme Difficulte que la Prediction,Pas Adapte
4342,2019,Droit,1,Proces et Institution Juridictionnelles,2,La Trame de la Scene Judiciaire,4,79,1,QCU,0.16,0.94,66.11,3,2,5,5,3,2,1.0,60.0,Facile,Facile,0,Meme Difficulte que la Prediction,Adapte
5408,2020,Droit,1,Proces et Institution Juridictionnelles,2,La Trame de la Scene Judiciaire,4,79,1,QCM,0.13,0.94,66.11,3,1,4,3,3,0,1.33,100.0,Facile,Facile,0,Meme Difficulte que la Prediction,Adapte
79,2015,Droit,1,Proces et Institution Juridictionnelles,2,La Trame de la Scene Judiciaire,4,80,2,QROC,0.61,0.16,14.25,11,66,77,45,11,34,1.71,24.44,Facile,Difficile,-2,Beaucoup plus Difficile que la Prediction,Pas Adapte
1145,2016,Droit,1,Proces et Institution Juridictionnelles,2,La Trame de la Scene Judiciaire,4,80,2,QROC,0.08,0.73,71.39,54,21,75,56,54,2,1.34,96.43,Moyen,Facile,1,Plus Facile que la Prediction,Adapte
2211,2017,Droit,1,Proces et Institution Juridictionnelles,2,La Trame de la Scene Judiciaire,4,80,2,QO,0.16,0.63,71.39,55,22,77,71,55,16,1.08,77.46,Facile,Facile,0,Meme Difficulte que la Prediction,Adapte
3277,2018,Droit,1,Proces et Institution Juridictionnelles,2,La Trame de la Scene Judiciaire,4,80,2,QO,0.15,0.71,71.39,54,21,75,66,54,12,1.14,81.82,Facile,Facile,0,Meme Difficulte que la Prediction,Adapte
4343,2019,Droit,1,Proces et Institution Juridictionnelles,2,La Trame de la Scene Judiciaire,4,80,2,QO,0.03,0.7,71.39,61,24,85,65,61,4,1.31,93.85,Facile,Facile,0,Meme Difficulte que la Prediction,Adapte
5409,2020,Droit,1,Proces et Institution Juridictionnelles,2,La Trame de la Scene Judiciaire,4,80,2,QO,0.05,0.74,71.39,58,23,81,59,58,1,1.37,98.31,Facile,Facile,0,Meme Difficulte que la Prediction,Adapte
80,2015,Droit,1,Proces et Institution Juridictionnelles,2,La Trame de la Scene Judiciaire,4,81,3,QROC,0.7,0.05,15.79,5,26,31,19,5,14,1.63,26.32,Facile,Difficile,-2,Beaucoup plus Difficile que la Prediction,Pas Adapte
1146,2016,Droit,1,Proces et Institution Juridictionnelles,2,La Trame de la Scene Judiciaire,4,81,3,QROC,0.27,0.26,55.62,19,16,35,32,19,13,1.09,59.38,Difficile,Moyen,1,Plus Facile que la Prediction,Pas Adapte
2212,2017,Droit,1,Proces et Institution Juridictionnelles,2,La Trame de la Scene Judiciaire,4,81,3,QROC,0.64,0.21,31.37,12,26,38,26,12,14,1.46,46.15,Difficile,Difficile,0,Meme Difficulte que la Prediction,Pas Adapte
3278,2018,Droit,1,Proces et Institution Juridictionnelles,2,La Trame de la Scene Judiciaire,4,81,3,QROC,0.66,0.25,30.31,11,25,36,34,11,23,1.06,32.35,Facile,Difficile,-2,Beaucoup plus Difficile que la Prediction,Pas Adapte
4344,2019,Droit,1,Proces et Institution Juridictionnelles,2,La Trame de la Scene Judiciaire,4,81,3,QROC,0.39,0.27,57.51,24,17,41,25,24,1,1.64,96.0,Moyen,Moyen,0,Meme Difficulte que la Prediction,Pas Adapte
5410,2020,Droit,1,Proces et Institution Juridictionnelles,2,La Trame de la Scene Judiciaire,4,81,3,QROC,0.67,0.17,6.83,3,36,39,20,3,17,1.95,15.0,Moyen,Difficile,-1,Plus Difficile que la Prediction,Pas Adapte
81,2015,Droit,1,Proces et Institution Juridictionnelles,2,La Trame de la Scene Judiciaire,4,82,4,QO,0.07,0.49,86.79,62,10,72,71,62,9,1.01,87.32,Facile,Facile,0,Meme Difficulte que la Prediction,Pas Adapte
1147,2016,Droit,1,Proces et Institution Juridictionnelles,2,La Trame de la Scene Judiciaire,4,82,4,QO,0.95,0.15,22.81,14,49,63,33,14,19,1.91,42.42,Difficile,Difficile,0,Meme Difficulte que la Prediction,Pas Adapte
2213,2017,Droit,1,Proces et Institution Juridictionnelles,2,La Trame de la Scene Judiciaire,4,82,4,QO,0.7,0.24,63.31,42,24,66,54,42,12,1.22,77.78,Moyen,Moyen,0,Meme Difficulte que la Prediction,Adapte
3279,2018,Droit,1,Proces et Institution Juridictionnelles,2,La Trame de la Scene Judiciaire,4,82,4,QCM,0.33,0.33,63.31,37,21,58,58,37,21,1.0,63.79,Moyen,Moyen,0,Meme Difficulte que la Prediction,Adapte
4345,2019,Droit,1,Proces et Institution Juridictionnelles,2,La Trame de la Scene Judiciaire,4,82,4,QROC,0.34,0.3,63.31,39,22,61,49,39,10,1.24,79.59,Moyen,Moyen,0,Meme Difficulte que la Prediction,Adapte
5411,2020,Droit,1,Proces et Institution Juridictionnelles,2,La Trame de la Scene Judiciaire,4,82,4,QROC,0.34,0.31,63.31,34,20,54,51,34,17,1.06,66.67,Moyen,Moyen,0,Meme Difficulte que la Prediction,Adapte
82,2015,Droit,1,Proces et Institution Juridictionnelles,3,Le Theatre de la Scene Judiciaire,13,83,1,QROC,0.91,0.05,24.6,10,32,42,20,10,10,2.1,50.0,Facile,Difficile,-2,Beaucoup plus Difficile que la Prediction,Pas Adapte
1148,2016,Droit,1,Proces et Institution Juridictionnelles,3,Le Theatre de la Scene Judiciaire,13,83,1,QROC,0.88,0.03,13.33,5,36,41,37,5,32,1.11,13.51,Facile,Difficile,-2,Beaucoup plus Difficile que la Prediction,Pas Adapte
2214,2017,Droit,1,Proces et Institution Juridictionnelles,3,Le Theatre de la Scene Judiciaire,13,83,1,QROC,0.12,0.85,86.53,35,5,40,36,35,1,1.11,97.22,Facile,Facile,0,Meme Difficulte que la Prediction,Pas Adapte
3280,2018,Droit,1,Proces et Institution Juridictionnelles,3,Le Theatre de la Scene Judiciaire,13,83,1,QROC,1.0,0.2,33.11,15,31,46,30,15,15,1.53,50.0,Difficile,Difficile,0,Meme Difficulte que la Prediction,Pas Adapte
4346,2019,Droit,1,Proces et Institution Juridictionnelles,3,Le Theatre de la Scene Judiciaire,13,83,1,QROC,0.8,0.14,32.88,15,31,46,32,15,17,1.44,46.88,Difficile,Difficile,0,Meme Difficulte que la Prediction,Pas Adapte
5412,2020,Droit,1,Proces et Institution Juridictionnelles,3,Le Theatre de la Scene Judiciaire,13,83,1,QO,0.88,0.15,26.51,11,29,40,27,11,16,1.48,40.74,Difficile,Difficile,0,Meme Difficulte que la Prediction,Pas Adapte
83,2015,Droit,1,Proces et Institution Juridictionnelles,3,Le Theatre de la Scene Judiciaire,13,84,2,QCM,0.42,0.57,41.39,35,50,85,38,35,3,2.24,92.11,Difficile,Moyen,1,Plus Facile que la Prediction,Pas Adapte
1149,2016,Droit,1,Proces et Institution Juridictionnelles,3,Le Theatre de la Scene Judiciaire,13,84,2,QROC,0.59,0.3,55.79,42,34,76,63,42,21,1.21,66.67,Difficile,Moyen,1,Plus Facile que la Prediction,Pas Adapte
2215,2017,Droit,1,Proces et Institution Juridictionnelles,3,Le Theatre de la Scene Judiciaire,13,84,2,QROC,0.18,0.62,67.8,52,25,77,55,52,3,1.4,94.55,Moyen,Facile,1,Plus Facile que la Prediction,Adapte
3281,2018,Droit,1,Proces et Institution Juridictionnelles,3,Le Theatre de la Scene Judiciaire,13,84,2,QROC,0.12,0.72,67.8,49,24,73,50,49,1,1.46,98.0,Facile,Facile,0,Meme Difficulte que la Prediction,Adapte
4347,2019,Droit,1,Proces et Institution Juridictionnelles,3,Le Theatre de la Scene Judiciaire,13,84,2,QROC,0.15,0.45,67.8,54,25,79,73,54,19,1.08,73.97,Facile,Facile,0,Meme Difficulte que la Prediction,Adapte
5413,2020,Droit,1,Proces et Institution Juridictionnelles,3,Le Theatre de la Scene Judiciaire,13,84,2,QROC,0.15,0.53,67.8,45,22,67,54,45,9,1.24,83.33,Facile,Facile,0,Meme Difficulte que la Prediction,Adapte
84,2015,Droit,1,Proces et Institution Juridictionnelles,3,Le Theatre de la Scene Judiciaire,13,85,3,QCU,0.01,0.92,66.98,52,25,77,76,52,24,1.01,68.42,Facile,Facile,0,Meme Difficulte que la Prediction,Adapte
1150,2016,Droit,1,Proces et Institution Juridictionnelles,3,Le Theatre de la Scene Judiciaire,13,85,3,QCU,0.14,0.86,66.98,50,24,74,61,50,11,1.21,81.97,Facile,Facile,0,Meme Difficulte que la Prediction,Adapte
2216,2017,Droit,1,Proces et Institution Juridictionnelles,3,Le Theatre de la Scene Judiciaire,13,85,3,QCU,0.07,0.75,66.98,48,23,71,60,48,12,1.18,80.0,Facile,Facile,0,Meme Difficulte que la Prediction,Adapte
3282,2018,Droit,1,Proces et Institution Juridictionnelles,3,Le Theatre de la Scene Judiciaire,13,85,3,QCU,0.16,0.98,66.98,46,23,69,66,46,20,1.05,69.7,Facile,Facile,0,Meme Difficulte que la Prediction,Adapte
4348,2019,Droit,1,Proces et Institution Juridictionnelles,3,Le Theatre de la Scene Judiciaire,13,85,3,QCU,0.02,0.8,66.98,50,25,75,67,50,17,1.12,74.63,Facile,Facile,0,Meme Difficulte que la Prediction,Adapte
5414,2020,Droit,1,Proces et Institution Juridictionnelles,3,Le Theatre de la Scene Judiciaire,13,85,3,QCU,0.07,0.99,66.98,54,26,80,65,54,11,1.23,83.08,Facile,Facile,0,Meme Difficulte que la Prediction,Adapte
85,2015,Droit,1,Proces et Institution Juridictionnelles,3,Le Theatre de la Scene Judiciaire,13,86,4,QCU,0.3,0.48,39.64,18,28,46,35,18,17,1.31,51.43,Moyen,Moyen,0,Meme Difficulte que la Prediction,Pas Adapte
1151,2016,Droit,1,Proces et Institution Juridictionnelles,3,Le Theatre de la Scene Judiciaire,13,86,4,QCU,0.03,0.79,91.82,39,4,43,41,39,2,1.05,95.12,Facile,Facile,0,Meme Difficulte que la Prediction,Pas Adapte
2217,2017,Droit,1,Proces et Institution Juridictionnelles,3,Le Theatre de la Scene Judiciaire,13,86,4,QCU,0.17,0.77,71.38,30,12,42,33,30,3,1.27,90.91,Moyen,Facile,1,Plus Facile que la Prediction,Adapte
3283,2018,Droit,1,Proces et Institution Juridictionnelles,3,Le Theatre de la Scene Judiciaire,13,86,4,QCU,0.02,0.89,71.38,34,14,48,41,34,7,1.17,82.93,Facile,Facile,0,Meme Difficulte que la Prediction,Adapte
4349,2019,Droit,1,Proces et Institution Juridictionnelles,3,Le Theatre de la Scene Judiciaire,13,86,4,QO,0.01,0.78,71.38,34,14,48,37,34,3,1.3,91.89,Facile,Facile,0,Meme Difficulte que la Prediction,Adapte
5415,2020,Droit,1,Proces et Institution Juridictionnelles,3,Le Theatre de la Scene Judiciaire,13,86,4,QO,0.12,0.37,71.38,38,15,53,48,38,10,1.1,79.17,Facile,Facile,0,Meme Difficulte que la Prediction,Adapte
86,2015,Droit,1,Proces et Institution Juridictionnelles,3,Le Theatre de la Scene Judiciaire,13,87,5,QCM,0.44,0.51,64.4,50,27,77,65,50,15,1.18,76.92,Difficile,Moyen,1,Plus Facile que la Prediction,Adapte
1152,2016,Droit,1,Proces et Institution Juridictionnelles,3,Le Theatre de la Scene Judiciaire,13,87,5,QCU,0.32,0.61,64.4,54,30,84,68,54,14,1.24,79.41,Moyen,Moyen,0,Meme Difficulte que la Prediction,Adapte
2218,2017,Droit,1,Proces et Institution Juridictionnelles,3,Le Theatre de la Scene Judiciaire,13,87,5,QCU,0.36,0.53,64.4,55,31,86,74,55,19,1.16,74.32,Moyen,Moyen,0,Meme Difficulte que la Prediction,Adapte
3284,2018,Droit,1,Proces et Institution Juridictionnelles,3,Le Theatre de la Scene Judiciaire,13,87,5,QCM,0.3,0.48,64.4,62,35,97,79,62,17,1.23,78.48,Moyen,Moyen,0,Meme Difficulte que la Prediction,Adapte
4350,2019,Droit,1,Proces et Institution Juridictionnelles,3,Le Theatre de la Scene Judiciaire,13,87,5,QCM,0.41,0.41,64.4,57,32,89,67,57,10,1.33,85.07,Moyen,Moyen,0,Meme Difficulte que la Prediction,Adapte
5416,2020,Droit,1,Proces et Institution Juridictionnelles,3,Le Theatre de la Scene Judiciaire,13,87,5,QCM,0.39,0.65,64.4,64,36,100,71,64,7,1.41,90.14,Moyen,Moyen,0,Meme Difficulte que la Prediction,Adapte
87,2015,Droit,1,Proces et Institution Juridictionnelles,3,Le Theatre de la Scene Judiciaire,13,88,6,QCM,0.74,0.25,6.93,4,54,58,19,4,15,3.05,21.05,Difficile,Difficile,0,Meme Difficulte que la Prediction,Pas Adapte
1153,2016,Droit,1,Proces et Institution Juridictionnelles,3,Le Theatre de la Scene Judiciaire,13,88,6,QCM,0.19,0.78,77.03,39,12,51,44,39,5,1.16,88.64,Facile,Facile,0,Meme Difficulte que la Prediction,Pas Adapte
2219,2017,Droit,1,Proces et Institution Juridictionnelles,3,Le Theatre de la Scene Judiciaire,13,88,6,QCM,0.3,0.6,37.45,22,37,59,32,22,10,1.84,68.75,Moyen,Moyen,0,Meme Difficulte que la Prediction,Pas Adapte
3285,2018,Droit,1,Proces et Institution Juridictionnelles,3,Le Theatre de la Scene Judiciaire,13,88,6,QCM,0.1,0.76,99.89,55,0,55,55,55,0,1.0,100.0,Moyen,Facile,1,Plus Facile que la Prediction,Pas Adapte
4351,2019,Droit,1,Proces et Institution Juridictionnelles,3,Le Theatre de la Scene Judiciaire,13,88,6,QCM,0.33,0.45,55.54,33,27,60,33,33,0,1.82,100.0,Moyen,Moyen,0,Meme Difficulte que la Prediction,Pas Adapte
5417,2020,Droit,1,Proces et Institution Juridictionnelles,3,Le Theatre de la Scene Judiciaire,13,88,6,QCM,0.35,0.55,36.55,21,36,57,50,21,29,1.14,42.0,Moyen,Moyen,0,Meme Difficulte que la Prediction,Pas Adapte
88,2015,Droit,1,Proces et Institution Juridictionnelles,3,Le Theatre de la Scene Judiciaire,13,89,7,QCM,0.56,0.26,8.71,2,16,18,6,2,4,3.0,33.33,Difficile,Difficile,0,Meme Difficulte que la Prediction,Pas Adapte
1154,2016,Droit,1,Proces et Institution Juridictionnelles,3,Le Theatre de la Scene Judiciaire,13,89,7,QCM,0.07,0.94,84.24,17,3,20,19,17,2,1.05,89.47,Moyen,Facile,1,Plus Facile que la Prediction,Pas Adapte
2220,2017,Droit,1,Proces et Institution Juridictionnelles,3,Le Theatre de la Scene Judiciaire,13,89,7,QCM,0.06,0.75,66.68,13,7,20,13,13,0,1.54,100.0,Facile,Facile,0,Meme Difficulte que la Prediction,Adapte
3286,2018,Droit,1,Proces et Institution Juridictionnelles,3,Le Theatre de la Scene Judiciaire,13,89,7,QCM,0.11,0.86,66.68,14,7,21,19,14,5,1.11,73.68,Facile,Facile,0,Meme Difficulte que la Prediction,Adapte
4352,2019,Droit,1,Proces et Institution Juridictionnelles,3,Le Theatre de la Scene Judiciaire,13,89,7,QCM,0.06,0.94,66.68,15,8,23,19,15,4,1.21,78.95,Facile,Facile,0,Meme Difficulte que la Prediction,Adapte
5418,2020,Droit,1,Proces et Institution Juridictionnelles,3,Le Theatre de la Scene Judiciaire,13,89,7,QCM,0.07,0.8,66.68,16,8,24,18,16,2,1.33,88.89,Facile,Facile,0,Meme Difficulte que la Prediction,Adapte
89,2015,Droit,1,Proces et Institution Juridictionnelles,3,Le Theatre de la Scene Judiciaire,13,90,8,QCU,0.11,0.95,69.85,26,11,37,30,26,4,1.23,86.67,Facile,Facile,0,Meme Difficulte que la Prediction,Adapte
1155,2016,Droit,1,Proces et Institution Juridictionnelles,3,Le Theatre de la Scene Judiciaire,13,90,8,QCU,0.17,0.88,69.85,22,9,31,27,22,5,1.15,81.48,Facile,Facile,0,Meme Difficulte que la Prediction,Adapte
2221,2017,Droit,1,Proces et Institution Juridictionnelles,3,Le Theatre de la Scene Judiciaire,13,90,8,QCU,0.05,0.83,69.85,20,9,29,25,20,5,1.16,80.0,Facile,Facile,0,Meme Difficulte que la Prediction,Adapte
3287,2018,Droit,1,Proces et Institution Juridictionnelles,3,Le Theatre de la Scene Judiciaire,13,90,8,QCM,0.06,0.9,69.85,19,8,27,23,19,4,1.17,82.61,Facile,Facile,0,Meme Difficulte que la Prediction,Adapte
4353,2019,Droit,1,Proces et Institution Juridictionnelles,3,Le Theatre de la Scene Judiciaire,13,90,8,QCM,0.06,0.81,69.85,16,7,23,21,16,5,1.1,76.19,Facile,Facile,0,Meme Difficulte que la Prediction,Adapte
5419,2020,Droit,1,Proces et Institution Juridictionnelles,3,Le Theatre de la Scene Judiciaire,13,90,8,QCM,0.16,0.77,69.85,15,7,22,17,15,2,1.29,88.24,Facile,Facile,0,Meme Difficulte que la Prediction,Adapte
90,2015,Droit,1,Proces et Institution Juridictionnelles,3,Le Theatre de la Scene Judiciaire,13,91,9,QROC,0.97,0.15,27.33,3,7,10,4,3,1,2.5,75.0,Moyen,Difficile,-1,Plus Difficile que la Prediction,Pas Adapte
1156,2016,Droit,1,Proces et Institution Juridictionnelles,3,Le Theatre de la Scene Judiciaire,13,91,9,QROC,0.37,0.36,56.31,5,3,8,7,5,2,1.14,71.43,Moyen,Moyen,0,Meme Difficulte que la Prediction,Pas Adapte
2222,2017,Droit,1,Proces et Institution Juridictionnelles,3,Le Theatre de la Scene Judiciaire,13,91,9,QROC,0.94,0.02,32.25,3,6,9,6,3,3,1.5,50.0,Facile,Difficile,-2,Beaucoup plus Difficile que la Prediction,Pas Adapte
3288,2018,Droit,1,Proces et Institution Juridictionnelles,3,Le Theatre de la Scene Judiciaire,13,91,9,QROC,0.09,0.75,83.64,8,1,9,9,8,1,1.0,88.89,Facile,Facile,0,Meme Difficulte que la Prediction,Pas Adapte
4354,2019,Droit,1,Proces et Institution Juridictionnelles,3,Le Theatre de la Scene Judiciaire,13,91,9,QROC,0.48,0.39,61.34,6,4,10,7,6,1,1.43,85.71,Facile,Moyen,-1,Plus Difficile que la Prediction,Adapte
5420,2020,Droit,1,Proces et Institution Juridictionnelles,3,Le Theatre de la Scene Judiciaire,13,91,9,QROC,0.31,0.37,61.34,7,5,12,10,7,3,1.2,70.0,Moyen,Moyen,0,Meme Difficulte que la Prediction,Adapte
91,2015,Droit,1,Proces et Institution Juridictionnelles,3,Le Theatre de la Scene Judiciaire,13,92,10,QCM,0.12,0.93,85.32,25,4,29,25,25,0,1.16,100.0,Facile,Facile,0,Meme Difficulte que la Prediction,Pas Adapte
1157,2016,Droit,1,Proces et Institution Juridictionnelles,3,Le Theatre de la Scene Judiciaire,13,92,10,QCM,0.58,0.25,26.05,7,19,26,11,7,4,2.36,63.64,Facile,Difficile,-2,Beaucoup plus Difficile que la Prediction,Pas Adapte
2223,2017,Droit,1,Proces et Institution Juridictionnelles,3,Le Theatre de la Scene Judiciaire,13,92,10,QCM,0.57,0.18,15.0,3,20,23,18,3,15,1.28,16.67,Difficile,Difficile,0,Meme Difficulte que la Prediction,Pas Adapte
3289,2018,Droit,1,Proces et Institution Juridictionnelles,3,Le Theatre de la Scene Judiciaire,13,92,10,QCM,0.71,0.18,30.95,7,17,24,14,7,7,1.71,50.0,Moyen,Difficile,-1,Plus Difficile que la Prediction,Pas Adapte
4355,2019,Droit,1,Proces et Institution Juridictionnelles,3,Le Theatre de la Scene Judiciaire,13,92,10,QCM,0.76,0.21,29.69,7,17,24,18,7,11,1.33,38.89,Facile,Difficile,-2,Beaucoup plus Difficile que la Prediction,Pas Adapte
5421,2020,Droit,1,Proces et Institution Juridictionnelles,3,Le Theatre de la Scene Judiciaire,13,92,10,QCM,0.37,0.51,57.08,13,9,22,20,13,7,1.1,65.0,Facile,Moyen,-1,Plus Difficile que la Prediction,Pas Adapte
92,2015,Droit,1,Proces et Institution Juridictionnelles,3,Le Theatre de la Scene Judiciaire,13,93,11,QCU,0.46,0.28,2.3,1,37,38,19,1,18,2.0,5.26,Difficile,Difficile,0,Meme Difficulte que la Prediction,Pas Adapte
1158,2016,Droit,1,Proces et Institution Juridictionnelles,3,Le Theatre de la Scene Judiciaire,13,93,11,QCU,0.57,0.22,14.05,6,35,41,26,6,20,1.58,23.08,Difficile,Difficile,0,Meme Difficulte que la Prediction,Pas Adapte
2224,2017,Droit,1,Proces et Institution Juridictionnelles,3,Le Theatre de la Scene Judiciaire,13,93,11,QCU,0.16,0.89,79.02,36,10,46,45,36,9,1.02,80.0,Facile,Facile,0,Meme Difficulte que la Prediction,Pas Adapte
3290,2018,Droit,1,Proces et Institution Juridictionnelles,3,Le Theatre de la Scene Judiciaire,13,93,11,QCU,0.14,0.75,90.25,39,4,43,40,39,1,1.07,97.5,Facile,Facile,0,Meme Difficulte que la Prediction,Pas Adapte
4356,2019,Droit,1,Proces et Institution Juridictionnelles,3,Le Theatre de la Scene Judiciaire,13,93,11,QCU,0.26,0.4,36.75,15,25,40,27,15,12,1.48,55.56,Moyen,Moyen,0,Meme Difficulte que la Prediction,Pas Adapte
5422,2020,Droit,1,Proces et Institution Juridictionnelles,3,Le Theatre de la Scene Judiciaire,13,93,11,QCU,0.19,0.96,95.49,41,2,43,42,41,1,1.02,97.62,Facile,Facile,0,Meme Difficulte que la Prediction,Pas Adapte
93,2015,Droit,1,Proces et Institution Juridictionnelles,3,Le Theatre de la Scene Judiciaire,13,94,12,QCU,0.66,0.33,15.94,4,20,24,11,4,7,2.18,36.36,Moyen,Difficile,-1,Plus Difficile que la Prediction,Pas Adapte
1159,2016,Droit,1,Proces et Institution Juridictionnelles,3,Le Theatre de la Scene Judiciaire,13,94,12,QCU,0.64,0.24,25.42,7,20,27,22,7,15,1.23,31.82,Moyen,Difficile,-1,Plus Difficile que la Prediction,Pas Adapte
2225,2017,Droit,1,Proces et Institution Juridictionnelles,3,Le Theatre de la Scene Judiciaire,13,94,12,QCU,0.66,0.35,29.19,8,19,27,23,8,15,1.17,34.78,Difficile,Difficile,0,Meme Difficulte que la Prediction,Pas Adapte
3291,2018,Droit,1,Proces et Institution Juridictionnelles,3,Le Theatre de la Scene Judiciaire,13,94,12,QCU,0.14,0.93,98.69,28,0,28,28,28,0,1.0,100.0,Moyen,Facile,1,Plus Facile que la Prediction,Pas Adapte
4357,2019,Droit,1,Proces et Institution Juridictionnelles,3,Le Theatre de la Scene Judiciaire,13,94,12,QCU,0.17,0.78,91.31,28,3,31,29,28,1,1.07,96.55,Moyen,Facile,1,Plus Facile que la Prediction,Pas Adapte
5423,2020,Droit,1,Proces et Institution Juridictionnelles,3,Le Theatre de la Scene Judiciaire,13,94,12,QCU,0.35,0.56,39.33,11,18,29,19,11,8,1.53,57.89,Moyen,Moyen,0,Meme Difficulte que la Prediction,Pas Adapte
94,2015,Droit,1,Proces et Institution Juridictionnelles,3,Le Theatre de la Scene Judiciaire,13,95,13,QCU,0.03,0.92,76.75,68,21,89,77,68,9,1.16,88.31,Facile,Facile,0,Meme Difficulte que la Prediction,Pas Adapte
1160,2016,Droit,1,Proces et Institution Juridictionnelles,3,Le Theatre de la Scene Judiciaire,13,95,13,QCU,0.3,0.63,63.94,58,32,90,61,58,3,1.48,95.08,Moyen,Moyen,0,Meme Difficulte que la Prediction,Adapte
2226,2017,Droit,1,Proces et Institution Juridictionnelles,3,Le Theatre de la Scene Judiciaire,13,95,13,QCU,0.31,0.45,63.94,52,29,81,69,52,17,1.17,75.36,Moyen,Moyen,0,Meme Difficulte que la Prediction,Adapte
3292,2018,Droit,1,Proces et Institution Juridictionnelles,3,Le Theatre de la Scene Judiciaire,13,95,13,QCU,0.21,0.49,63.94,58,33,91,85,58,27,1.07,68.24,Moyen,Moyen,0,Meme Difficulte que la Prediction,Adapte
4358,2019,Droit,1,Proces et Institution Juridictionnelles,3,Le Theatre de la Scene Judiciaire,13,95,13,QCU,0.28,0.58,63.94,65,37,102,81,65,16,1.26,80.25,Moyen,Moyen,0,Meme Difficulte que la Prediction,Adapte
5424,2020,Droit,1,Proces et Institution Juridictionnelles,3,Le Theatre de la Scene Judiciaire,13,95,13,QCU,0.29,0.44,63.94,69,39,108,79,69,10,1.37,87.34,Moyen,Moyen,0,Meme Difficulte que la Prediction,Adapte
95,2015,Droit,1,Constitution de la Cinquieme Republique,1,"La Cinquieme Republique, une Conception du Pouvoir",9,96,1,QCM,0.48,0.61,42.47,23,32,55,35,23,12,1.57,65.71,Moyen,Moyen,0,Meme Difficulte que la Prediction,Pas Adapte
1161,2016,Droit,1,Constitution de la Cinquieme Republique,1,"La Cinquieme Republique, une Conception du Pouvoir",9,96,1,QCU,0.47,0.2,34.61,20,39,59,36,20,16,1.64,55.56,Difficile,Difficile,0,Meme Difficulte que la Prediction,Pas Adapte
2227,2017,Droit,1,Constitution de la Cinquieme Republique,1,"La Cinquieme Republique, une Conception du Pouvoir",9,96,1,QCU,0.35,0.59,61.58,33,20,53,50,33,17,1.06,66.0,Difficile,Moyen,1,Plus Facile que la Prediction,Adapte
3293,2018,Droit,1,Constitution de la Cinquieme Republique,1,"La Cinquieme Republique, une Conception du Pouvoir",9,96,1,QCU,0.37,0.58,61.58,37,23,60,58,37,21,1.03,63.79,Moyen,Moyen,0,Meme Difficulte que la Prediction,Adapte
4359,2019,Droit,1,Constitution de la Cinquieme Republique,1,"La Cinquieme Republique, une Conception du Pouvoir",9,96,1,QCU,0.33,0.57,61.58,39,24,63,52,39,13,1.21,75.0,Moyen,Moyen,0,Meme Difficulte que la Prediction,Adapte
5425,2020,Droit,1,Constitution de la Cinquieme Republique,1,"La Cinquieme Republique, une Conception du Pouvoir",9,96,1,QCM,0.33,0.61,61.58,36,23,59,39,36,3,1.51,92.31,Moyen,Moyen,0,Meme Difficulte que la Prediction,Adapte
96,2015,Droit,1,Constitution de la Cinquieme Republique,1,"La Cinquieme Republique, une Conception du Pouvoir",9,97,2,QCU,0.34,0.49,46.67,46,52,98,56,46,10,1.75,82.14,Moyen,Moyen,0,Meme Difficulte que la Prediction,Pas Adapte
1162,2016,Droit,1,Constitution de la Cinquieme Republique,1,"La Cinquieme Republique, une Conception du Pouvoir",9,97,2,QCU,0.35,0.59,46.71,52,59,111,56,52,4,1.98,92.86,Difficile,Moyen,1,Plus Facile que la Prediction,Pas Adapte
2228,2017,Droit,1,Constitution de la Cinquieme Republique,1,"La Cinquieme Republique, une Conception du Pouvoir",9,97,2,QCU,0.37,0.67,55.4,63,50,113,74,63,11,1.53,85.14,Difficile,Moyen,1,Plus Facile que la Prediction,Pas Adapte
3294,2018,Droit,1,Constitution de la Cinquieme Republique,1,"La Cinquieme Republique, une Conception du Pouvoir",9,97,2,QCU,0.51,0.37,12.72,15,106,121,92,15,77,1.32,16.3,Difficile,Difficile,0,Meme Difficulte que la Prediction,Pas Adapte
4360,2019,Droit,1,Constitution de la Cinquieme Republique,1,"La Cinquieme Republique, une Conception du Pouvoir",9,97,2,QCU,0.35,0.44,59.83,76,51,127,79,76,3,1.61,96.2,Moyen,Moyen,0,Meme Difficulte que la Prediction,Pas Adapte
5426,2020,Droit,1,Constitution de la Cinquieme Republique,1,"La Cinquieme Republique, une Conception du Pouvoir",9,97,2,QROC,0.22,0.29,37.28,50,83,133,75,50,25,1.77,66.67,Moyen,Moyen,0,Meme Difficulte que la Prediction,Pas Adapte
97,2015,Droit,1,Constitution de la Cinquieme Republique,1,"La Cinquieme Republique, une Conception du Pouvoir",9,98,3,QCU,0.72,0.29,21.42,11,41,52,26,11,15,2.0,42.31,Difficile,Difficile,0,Meme Difficulte que la Prediction,Pas Adapte
1163,2016,Droit,1,Constitution de la Cinquieme Republique,1,"La Cinquieme Republique, une Conception du Pouvoir",9,98,3,QCU,0.45,0.37,26.03,12,36,48,20,12,8,2.4,60.0,Facile,Difficile,-2,Beaucoup plus Difficile que la Prediction,Pas Adapte
2229,2017,Droit,1,Constitution de la Cinquieme Republique,1,"La Cinquieme Republique, une Conception du Pouvoir",9,98,3,QCU,0.05,0.78,99.44,43,0,43,43,43,0,1.0,100.0,Difficile,Facile,2,Beaucoup plus Facile que la Prediction,Pas Adapte
3295,2018,Droit,1,Constitution de la Cinquieme Republique,1,"La Cinquieme Republique, une Conception du Pouvoir",9,98,3,QCU,0.45,0.31,17.83,7,35,42,38,7,31,1.11,18.42,Difficile,Difficile,0,Meme Difficulte que la Prediction,Pas Adapte
4361,2019,Droit,1,Constitution de la Cinquieme Republique,1,"La Cinquieme Republique, une Conception du Pouvoir",9,98,3,QCU,0.29,0.49,46.65,19,22,41,31,19,12,1.32,61.29,Facile,Moyen,-1,Plus Difficile que la Prediction,Pas Adapte
5427,2020,Droit,1,Constitution de la Cinquieme Republique,1,"La Cinquieme Republique, une Conception du Pouvoir",9,98,3,QCU,0.35,0.53,46.34,19,23,42,28,19,9,1.5,67.86,Moyen,Moyen,0,Meme Difficulte que la Prediction,Pas Adapte
98,2015,Droit,1,Constitution de la Cinquieme Republique,1,"La Cinquieme Republique, une Conception du Pouvoir",9,99,4,QCM,0.54,0.16,20.35,19,75,94,81,19,62,1.16,23.46,Moyen,Difficile,-1,Plus Difficile que la Prediction,Pas Adapte
1164,2016,Droit,1,Constitution de la Cinquieme Republique,1,"La Cinquieme Republique, une Conception du Pouvoir",9,99,4,QO,0.16,0.37,96.63,80,3,83,81,80,1,1.02,98.77,Facile,Facile,0,Meme Difficulte que la Prediction,Pas Adapte
2230,2017,Droit,1,Constitution de la Cinquieme Republique,1,"La Cinquieme Republique, une Conception du Pouvoir",9,99,4,QO,0.01,0.67,86.1,76,12,88,82,76,6,1.07,92.68,Facile,Facile,0,Meme Difficulte que la Prediction,Pas Adapte
3296,2018,Droit,1,Constitution de la Cinquieme Republique,1,"La Cinquieme Republique, une Conception du Pouvoir",9,99,4,QO,0.0,0.89,98.75,94,1,95,94,94,0,1.01,100.0,Difficile,Facile,2,Beaucoup plus Facile que la Prediction,Pas Adapte
4362,2019,Droit,1,Constitution de la Cinquieme Republique,1,"La Cinquieme Republique, une Conception du Pouvoir",9,99,4,QO,0.95,0.11,12.17,12,83,95,52,12,40,1.83,23.08,Difficile,Difficile,0,Meme Difficulte que la Prediction,Pas Adapte
5428,2020,Droit,1,Constitution de la Cinquieme Republique,1,"La Cinquieme Republique, une Conception du Pouvoir",9,99,4,QCM,0.74,0.21,5.53,5,82,87,41,5,36,2.12,12.2,Difficile,Difficile,0,Meme Difficulte que la Prediction,Pas Adapte
99,2015,Droit,1,Constitution de la Cinquieme Republique,1,"La Cinquieme Republique, une Conception du Pouvoir",9,100,5,QCM,0.66,0.24,29.34,19,47,66,39,19,20,1.69,48.72,Difficile,Difficile,0,Meme Difficulte que la Prediction,Pas Adapte
1165,2016,Droit,1,Constitution de la Cinquieme Republique,1,"La Cinquieme Republique, une Conception du Pouvoir",9,100,5,QCM,0.03,0.79,94.53,64,4,68,65,64,1,1.05,98.46,Facile,Facile,0,Meme Difficulte que la Prediction,Pas Adapte
2231,2017,Droit,1,Constitution de la Cinquieme Republique,1,"La Cinquieme Republique, une Conception du Pouvoir",9,100,5,QCM,0.34,0.41,38.46,26,42,68,42,26,16,1.62,61.9,Moyen,Moyen,0,Meme Difficulte que la Prediction,Pas Adapte
3297,2018,Droit,1,Constitution de la Cinquieme Republique,1,"La Cinquieme Republique, une Conception du Pouvoir",9,100,5,QCM,0.38,0.3,47.27,32,35,67,50,32,18,1.34,64.0,Moyen,Moyen,0,Meme Difficulte que la Prediction,Pas Adapte
4363,2019,Droit,1,Constitution de la Cinquieme Republique,1,"La Cinquieme Republique, une Conception du Pouvoir",9,100,5,QCM,0.42,0.36,44.69,29,35,64,40,29,11,1.6,72.5,Facile,Moyen,-1,Plus Difficile que la Prediction,Pas Adapte
5429,2020,Droit,1,Constitution de la Cinquieme Republique,1,"La Cinquieme Republique, une Conception du Pouvoir",9,100,5,QCM,0.61,0.27,13.98,9,52,61,48,9,39,1.27,18.75,Difficile,Difficile,0,Meme Difficulte que la Prediction,Pas Adapte
100,2015,Droit,1,Constitution de la Cinquieme Republique,1,"La Cinquieme Republique, une Conception du Pouvoir",9,101,6,QCU,0.03,1.0,79.77,53,13,66,63,53,10,1.05,84.13,Facile,Facile,0,Meme Difficulte que la Prediction,Pas Adapte
1166,2016,Droit,1,Constitution de la Cinquieme Republique,1,"La Cinquieme Republique, une Conception du Pouvoir",9,101,6,QCU,0.51,0.38,16.35,11,56,67,42,11,31,1.6,26.19,Moyen,Difficile,-1,Plus Difficile que la Prediction,Pas Adapte
2232,2017,Droit,1,Constitution de la Cinquieme Republique,1,"La Cinquieme Republique, une Conception du Pouvoir",9,101,6,QCU,0.31,0.59,56.3,36,28,64,55,36,19,1.16,65.45,Moyen,Moyen,0,Meme Difficulte que la Prediction,Pas Adapte
3298,2018,Droit,1,Constitution de la Cinquieme Republique,1,"La Cinquieme Republique, une Conception du Pouvoir",9,101,6,QCU,0.15,0.84,83.43,62,12,74,64,62,2,1.16,96.88,Facile,Facile,0,Meme Difficulte que la Prediction,Pas Adapte
4364,2019,Droit,1,Constitution de la Cinquieme Republique,1,"La Cinquieme Republique, une Conception du Pouvoir",9,101,6,QCU,0.2,0.82,72.73,57,21,78,62,57,5,1.26,91.94,Facile,Facile,0,Meme Difficulte que la Prediction,Adapte
5430,2020,Droit,1,Constitution de la Cinquieme Republique,1,"La Cinquieme Republique, une Conception du Pouvoir",9,101,6,QCU,0.09,0.79,72.73,61,23,84,64,61,3,1.31,95.31,Facile,Facile,0,Meme Difficulte que la Prediction,Adapte
101,2015,Droit,1,Constitution de la Cinquieme Republique,1,"La Cinquieme Republique, une Conception du Pouvoir",9,102,7,QROC,0.79,0.2,26.12,9,24,33,15,9,6,2.2,60.0,Facile,Difficile,-2,Beaucoup plus Difficile que la Prediction,Pas Adapte
1167,2016,Droit,1,Constitution de la Cinquieme Republique,1,"La Cinquieme Republique, une Conception du Pouvoir",9,102,7,QROC,0.32,0.34,48.52,17,19,36,31,17,14,1.16,54.84,Difficile,Moyen,1,Plus Facile que la Prediction,Pas Adapte
2233,2017,Droit,1,Constitution de la Cinquieme Republique,1,"La Cinquieme Republique, une Conception du Pouvoir",9,102,7,QROC,0.37,0.38,54.42,17,15,32,29,17,12,1.1,58.62,Moyen,Moyen,0,Meme Difficulte que la Prediction,Pas Adapte
3299,2018,Droit,1,Constitution de la Cinquieme Republique,1,"La Cinquieme Republique, une Conception du Pouvoir",9,102,7,QROC,0.51,0.38,38.31,13,22,35,14,13,1,2.5,92.86,Moyen,Moyen,0,Meme Difficulte que la Prediction,Pas Adapte
4365,2019,Droit,1,Constitution de la Cinquieme Republique,1,"La Cinquieme Republique, une Conception du Pouvoir",9,102,7,QO,0.07,0.58,92.92,37,3,40,37,37,0,1.08,100.0,Facile,Facile,0,Meme Difficulte que la Prediction,Pas Adapte
5431,2020,Droit,1,Constitution de la Cinquieme Republique,1,"La Cinquieme Republique, une Conception du Pouvoir",9,102,7,QO,0.19,0.39,77.59,26,8,34,32,26,6,1.06,81.25,Facile,Facile,0,Meme Difficulte que la Prediction,Pas Adapte
102,2015,Droit,1,Constitution de la Cinquieme Republique,1,"La Cinquieme Republique, une Conception du Pouvoir",9,103,8,QCU,0.71,0.33,34.31,5,9,14,9,5,4,1.56,55.56,Difficile,Difficile,0,Meme Difficulte que la Prediction,Pas Adapte
1168,2016,Droit,1,Constitution de la Cinquieme Republique,1,"La Cinquieme Republique, une Conception du Pouvoir",9,103,8,QCU,0.11,0.97,79.17,13,3,16,13,13,0,1.23,100.0,Facile,Facile,0,Meme Difficulte que la Prediction,Pas Adapte
2234,2017,Droit,1,Constitution de la Cinquieme Republique,1,"La Cinquieme Republique, une Conception du Pouvoir",9,103,8,QCU,0.33,0.43,40.58,6,9,15,6,6,0,2.5,100.0,Moyen,Moyen,0,Meme Difficulte que la Prediction,Pas Adapte
3300,2018,Droit,1,Constitution de la Cinquieme Republique,1,"La Cinquieme Republique, une Conception du Pouvoir",9,103,8,QCU,0.06,0.99,91.52,14,1,15,15,14,1,1.0,93.33,Difficile,Facile,2,Beaucoup plus Facile que la Prediction,Pas Adapte
4366,2019,Droit,1,Constitution de la Cinquieme Republique,1,"La Cinquieme Republique, une Conception du Pouvoir",9,103,8,QCU,0.18,0.85,72.29,9,4,13,13,9,4,1.0,69.23,Facile,Facile,0,Meme Difficulte que la Prediction,Adapte
5432,2020,Droit,1,Constitution de la Cinquieme Republique,1,"La Cinquieme Republique, une Conception du Pouvoir",9,103,8,QCU,0.16,0.9,72.29,9,4,13,11,9,2,1.18,81.82,Facile,Facile,0,Meme Difficulte que la Prediction,Adapte
103,2015,Droit,1,Constitution de la Cinquieme Republique,1,"La Cinquieme Republique, une Conception du Pouvoir",9,104,9,QCM,0.21,0.31,37.38,16,28,44,30,16,14,1.47,53.33,Moyen,Moyen,0,Meme Difficulte que la Prediction,Pas Adapte
1169,2016,Droit,1,Constitution de la Cinquieme Republique,1,"La Cinquieme Republique, une Conception du Pouvoir",9,104,9,QCM,0.14,0.77,74.06,33,11,44,38,33,5,1.16,86.84,Difficile,Facile,2,Beaucoup plus Facile que la Prediction,Adapte
2235,2017,Droit,1,Constitution de la Cinquieme Republique,1,"La Cinquieme Republique, une Conception du Pouvoir",9,104,9,QCU,0.07,0.82,74.06,28,10,38,31,28,3,1.23,90.32,Facile,Facile,0,Meme Difficulte que la Prediction,Adapte
3301,2018,Droit,1,Constitution de la Cinquieme Republique,1,"La Cinquieme Republique, une Conception du Pouvoir",9,104,9,QCU,0.06,0.79,74.06,31,11,42,34,31,3,1.24,91.18,Facile,Facile,0,Meme Difficulte que la Prediction,Adapte
4367,2019,Droit,1,Constitution de la Cinquieme Republique,1,"La Cinquieme Republique, une Conception du Pouvoir",9,104,9,QCU,0.13,0.75,74.06,30,11,41,38,30,8,1.08,78.95,Facile,Facile,0,Meme Difficulte que la Prediction,Adapte
5433,2020,Droit,1,Constitution de la Cinquieme Republique,1,"La Cinquieme Republique, une Conception du Pouvoir",9,104,9,QCU,0.03,0.97,74.06,34,12,46,41,34,7,1.12,82.93,Facile,Facile,0,Meme Difficulte que la Prediction,Adapte
104,2015,Droit,1,Constitution de la Cinquieme Republique,2,Le Pouvoir Gouvernant,7,105,1,QCU,0.26,0.67,41.27,15,21,36,28,15,13,1.29,53.57,Difficile,Moyen,1,Plus Facile que la Prediction,Pas Adapte
1170,2016,Droit,1,Constitution de la Cinquieme Republique,2,Le Pouvoir Gouvernant,7,105,1,QCU,0.63,0.22,2.8,1,36,37,24,1,23,1.54,4.17,Difficile,Difficile,0,Meme Difficulte que la Prediction,Pas Adapte
2236,2017,Droit,1,Constitution de la Cinquieme Republique,2,Le Pouvoir Gouvernant,7,105,1,QCM,0.04,0.89,73.91,27,10,37,28,27,1,1.32,96.43,Facile,Facile,0,Meme Difficulte que la Prediction,Adapte
3302,2018,Droit,1,Constitution de la Cinquieme Republique,2,Le Pouvoir Gouvernant,7,105,1,QCM,0.19,0.79,73.91,31,11,42,37,31,6,1.14,83.78,Facile,Facile,0,Meme Difficulte que la Prediction,Adapte
4368,2019,Droit,1,Constitution de la Cinquieme Republique,2,Le Pouvoir Gouvernant,7,105,1,QCM,0.18,0.86,73.91,35,13,48,41,35,6,1.17,85.37,Facile,Facile,0,Meme Difficulte que la Prediction,Adapte
5434,2020,Droit,1,Constitution de la Cinquieme Republique,2,Le Pouvoir Gouvernant,7,105,1,QCM,0.17,0.94,73.91,31,11,42,33,31,2,1.27,93.94,Facile,Facile,0,Meme Difficulte que la Prediction,Adapte
105,2015,Droit,1,Constitution de la Cinquieme Republique,2,Le Pouvoir Gouvernant,7,106,2,QO,0.61,0.17,42.03,40,54,94,67,40,27,1.4,59.7,Difficile,Moyen,1,Plus Facile que la Prediction,Pas Adapte
1171,2016,Droit,1,Constitution de la Cinquieme Republique,2,Le Pouvoir Gouvernant,7,106,2,QO,0.62,0.2,50.78,47,46,93,48,47,1,1.94,97.92,Facile,Moyen,-1,Plus Difficile que la Prediction,Pas Adapte
2237,2017,Droit,1,Constitution de la Cinquieme Republique,2,Le Pouvoir Gouvernant,7,106,2,QCM,0.7,0.26,15.31,15,85,100,93,15,78,1.08,16.13,Difficile,Difficile,0,Meme Difficulte que la Prediction,Pas Adapte
3303,2018,Droit,1,Constitution de la Cinquieme Republique,2,Le Pouvoir Gouvernant,7,106,2,QCM,0.15,0.83,67.71,62,30,92,84,62,22,1.1,73.81,Difficile,Facile,2,Beaucoup plus Facile que la Prediction,Adapte
4369,2019,Droit,1,Constitution de la Cinquieme Republique,2,Le Pouvoir Gouvernant,7,106,2,QCU,0.03,0.81,67.71,56,27,83,63,56,7,1.32,88.89,Facile,Facile,0,Meme Difficulte que la Prediction,Adapte
5435,2020,Droit,1,Constitution de la Cinquieme Republique,2,Le Pouvoir Gouvernant,7,106,2,QCU,0.07,0.98,67.71,63,30,93,74,63,11,1.26,85.14,Facile,Facile,0,Meme Difficulte que la Prediction,Adapte
106,2015,Droit,1,Constitution de la Cinquieme Republique,2,Le Pouvoir Gouvernant,7,107,3,QCM,0.28,0.34,39.45,11,16,27,12,11,1,2.25,91.67,Moyen,Moyen,0,Meme Difficulte que la Prediction,Pas Adapte
1172,2016,Droit,1,Constitution de la Cinquieme Republique,2,Le Pouvoir Gouvernant,7,107,3,QCU,0.62,0.33,3.97,1,25,26,17,1,16,1.53,5.88,Difficile,Difficile,0,Meme Difficulte que la Prediction,Pas Adapte
2238,2017,Droit,1,Constitution de la Cinquieme Republique,2,Le Pouvoir Gouvernant,7,107,3,QCU,0.01,0.85,89.0,27,3,30,28,27,1,1.07,96.43,Moyen,Facile,1,Plus Facile que la Prediction,Pas Adapte
3304,2018,Droit,1,Constitution de la Cinquieme Republique,2,Le Pouvoir Gouvernant,7,107,3,QCM,0.62,0.18,21.2,7,25,32,22,7,15,1.45,31.82,Moyen,Difficile,-1,Plus Difficile que la Prediction,Pas Adapte
4370,2019,Droit,1,Constitution de la Cinquieme Republique,2,Le Pouvoir Gouvernant,7,107,3,QCU,0.55,0.37,9.08,3,27,30,14,3,11,2.14,21.43,Facile,Difficile,-2,Beaucoup plus Difficile que la Prediction,Pas Adapte
5436,2020,Droit,1,Constitution de la Cinquieme Republique,2,Le Pouvoir Gouvernant,7,107,3,QCU,0.05,0.78,74.89,23,8,31,25,23,2,1.24,92.0,Difficile,Facile,2,Beaucoup plus Facile que la Prediction,Adapte
107,2015,Droit,1,Constitution de la Cinquieme Republique,2,Le Pouvoir Gouvernant,7,108,4,QCU,0.38,0.6,38.58,5,9,14,13,5,8,1.08,38.46,Moyen,Moyen,0,Meme Difficulte que la Prediction,Pas Adapte
1173,2016,Droit,1,Constitution de la Cinquieme Republique,2,Le Pouvoir Gouvernant,7,108,4,QCU,0.14,0.78,99.91,12,0,12,12,12,0,1.0,100.0,Facile,Facile,0,Meme Difficulte que la Prediction,Pas Adapte
2239,2017,Droit,1,Constitution de la Cinquieme Republique,2,Le Pouvoir Gouvernant,7,108,4,QCU,0.36,0.53,44.08,6,8,14,7,6,1,2.0,85.71,Difficile,Moyen,1,Plus Facile que la Prediction,Pas Adapte
3305,2018,Droit,1,Constitution de la Cinquieme Republique,2,Le Pouvoir Gouvernant,7,108,4,QCU,0.35,0.71,57.93,8,6,14,11,8,3,1.27,72.73,Moyen,Moyen,0,Meme Difficulte que la Prediction,Pas Adapte
4371,2019,Droit,1,Constitution de la Cinquieme Republique,2,Le Pouvoir Gouvernant,7,108,4,QCU,0.1,0.89,98.82,14,0,14,14,14,0,1.0,100.0,Facile,Facile,0,Meme Difficulte que la Prediction,Pas Adapte
5437,2020,Droit,1,Constitution de la Cinquieme Republique,2,Le Pouvoir Gouvernant,7,108,4,QCU,0.31,0.69,53.02,7,6,13,7,7,0,1.86,100.0,Moyen,Moyen,0,Meme Difficulte que la Prediction,Pas Adapte
108,2015,Droit,1,Constitution de la Cinquieme Republique,2,Le Pouvoir Gouvernant,7,109,5,QROC,0.88,0.0,0.47,0,36,36,31,0,31,1.16,0.0,Facile,Difficile,-2,Beaucoup plus Difficile que la Prediction,Pas Adapte
1174,2016,Droit,1,Constitution de la Cinquieme Republique,2,Le Pouvoir Gouvernant,7,109,5,QROC,0.4,0.3,46.73,19,22,41,33,19,14,1.24,57.58,Difficile,Moyen,1,Plus Facile que la Prediction,Pas Adapte
2240,2017,Droit,1,Constitution de la Cinquieme Republique,2,Le Pouvoir Gouvernant,7,109,5,QO,0.22,0.29,40.04,16,23,39,21,16,5,1.86,76.19,Moyen,Moyen,0,Meme Difficulte que la Prediction,Pas Adapte
3306,2018,Droit,1,Constitution de la Cinquieme Republique,2,Le Pouvoir Gouvernant,7,109,5,QO,0.9,0.0,2.99,1,32,33,27,1,26,1.22,3.7,Difficile,Difficile,0,Meme Difficulte que la Prediction,Pas Adapte
4372,2019,Droit,1,Constitution de la Cinquieme Republique,2,Le Pouvoir Gouvernant,7,109,5,QO,0.84,0.08,27.6,9,24,33,26,9,17,1.27,34.62,Difficile,Difficile,0,Meme Difficulte que la Prediction,Pas Adapte
5438,2020,Droit,1,Constitution de la Cinquieme Republique,2,Le Pouvoir Gouvernant,7,109,5,QO,0.14,0.39,96.72,32,1,33,32,32,0,1.03,100.0,Facile,Facile,0,Meme Difficulte que la Prediction,Pas Adapte
109,2015,Droit,1,Constitution de la Cinquieme Republique,2,Le Pouvoir Gouvernant,7,110,6,QCU,0.26,0.69,60.98,13,9,22,15,13,2,1.47,86.67,Moyen,Moyen,0,Meme Difficulte que la Prediction,Adapte
1175,2016,Droit,1,Constitution de la Cinquieme Republique,2,Le Pouvoir Gouvernant,7,110,6,QCM,0.47,0.39,60.98,14,9,23,14,14,0,1.64,100.0,Moyen,Moyen,0,Meme Difficulte que la Prediction,Adapte
2241,2017,Droit,1,Constitution de la Cinquieme Republique,2,Le Pouvoir Gouvernant,7,110,6,QCM,0.48,0.3,60.98,14,9,23,18,14,4,1.28,77.78,Moyen,Moyen,0,Meme Difficulte que la Prediction,Adapte
3307,2018,Droit,1,Constitution de la Cinquieme Republique,2,Le Pouvoir Gouvernant,7,110,6,QCM,0.25,0.43,60.98,15,9,24,18,15,3,1.33,83.33,Moyen,Moyen,0,Meme Difficulte que la Prediction,Adapte
4373,2019,Droit,1,Constitution de la Cinquieme Republique,2,Le Pouvoir Gouvernant,7,110,6,QCM,0.39,0.67,60.98,12,8,20,15,12,3,1.33,80.0,Moyen,Moyen,0,Meme Difficulte que la Prediction,Adapte
5439,2020,Droit,1,Constitution de la Cinquieme Republique,2,Le Pouvoir Gouvernant,7,110,6,QCM,0.48,0.45,60.98,12,7,19,19,12,7,1.0,63.16,Moyen,Moyen,0,Meme Difficulte que la Prediction,Adapte
110,2015,Droit,1,Constitution de la Cinquieme Republique,2,Le Pouvoir Gouvernant,7,111,7,QCU,0.27,0.65,53.88,32,27,59,58,32,26,1.02,55.17,Difficile,Moyen,1,Plus Facile que la Prediction,Pas Adapte
1176,2016,Droit,1,Constitution de la Cinquieme Republique,2,Le Pouvoir Gouvernant,7,111,7,QCU,0.52,0.23,19.62,11,47,58,52,11,41,1.12,21.15,Difficile,Difficile,0,Meme Difficulte que la Prediction,Pas Adapte
2242,2017,Droit,1,Constitution de la Cinquieme Republique,2,Le Pouvoir Gouvernant,7,111,7,QCU,0.31,0.67,64.15,32,18,50,42,32,10,1.19,76.19,Moyen,Moyen,0,Meme Difficulte que la Prediction,Adapte
3308,2018,Droit,1,Constitution de la Cinquieme Republique,2,Le Pouvoir Gouvernant,7,111,7,QO,0.62,0.3,64.15,31,17,48,41,31,10,1.17,75.61,Moyen,Moyen,0,Meme Difficulte que la Prediction,Adapte
4374,2019,Droit,1,Constitution de la Cinquieme Republique,2,Le Pouvoir Gouvernant,7,111,7,QO,0.6,0.19,64.15,28,16,44,29,28,1,1.52,96.55,Moyen,Moyen,0,Meme Difficulte que la Prediction,Adapte
5440,2020,Droit,1,Constitution de la Cinquieme Republique,2,Le Pouvoir Gouvernant,7,111,7,QO,0.42,0.18,64.15,25,14,39,37,25,12,1.05,67.57,Moyen,Moyen,0,Meme Difficulte que la Prediction,Adapte
111,2015,Droit,1,Constitution de la Cinquieme Republique,3,Le Pouvoir Legislatif,7,112,1,QCM,0.07,0.93,76.28,69,22,91,72,69,3,1.26,95.83,Facile,Facile,0,Meme Difficulte que la Prediction,Pas Adapte
1177,2016,Droit,1,Constitution de la Cinquieme Republique,3,Le Pouvoir Legislatif,7,112,1,QCM,0.24,0.34,39.91,42,63,105,85,42,43,1.24,49.41,Moyen,Moyen,0,Meme Difficulte que la Prediction,Pas Adapte
2243,2017,Droit,1,Constitution de la Cinquieme Republique,3,Le Pouvoir Legislatif,7,112,1,QCM,0.16,0.73,67.95,73,34,107,94,73,21,1.14,77.66,Facile,Facile,0,Meme Difficulte que la Prediction,Adapte
3309,2018,Droit,1,Constitution de la Cinquieme Republique,3,Le Pouvoir Legislatif,7,112,1,QCU,0.02,0.89,67.95,69,33,102,73,69,4,1.4,94.52,Facile,Facile,0,Meme Difficulte que la Prediction,Adapte
4375,2019,Droit,1,Constitution de la Cinquieme Republique,3,Le Pouvoir Legislatif,7,112,1,QCU,0.12,0.92,67.95,61,29,90,61,61,0,1.48,100.0,Facile,Facile,0,Meme Difficulte que la Prediction,Adapte
5441,2020,Droit,1,Constitution de la Cinquieme Republique,3,Le Pouvoir Legislatif,7,112,1,QCU,0.11,0.8,67.95,59,28,87,81,59,22,1.07,72.84,Facile,Facile,0,Meme Difficulte que la Prediction,Adapte
112,2015,Droit,1,Constitution de la Cinquieme Republique,3,Le Pouvoir Legislatif,7,113,2,QCU,0.75,0.38,25.73,4,10,14,7,4,3,2.0,57.14,Difficile,Difficile,0,Meme Difficulte que la Prediction,Pas Adapte
1178,2016,Droit,1,Constitution de la Cinquieme Republique,3,Le Pouvoir Legislatif,7,113,2,QCU,0.21,0.57,51.47,8,7,15,8,8,0,1.88,100.0,Moyen,Moyen,0,Meme Difficulte que la Prediction,Pas Adapte
2244,2017,Droit,1,Constitution de la Cinquieme Republique,3,Le Pouvoir Legislatif,7,113,2,QCU,0.06,0.84,74.3,12,4,16,14,12,2,1.14,85.71,Facile,Facile,0,Meme Difficulte que la Prediction,Adapte
3310,2018,Droit,1,Constitution de la Cinquieme Republique,3,Le Pouvoir Legislatif,7,113,2,QCU,0.04,0.98,74.3,12,4,16,14,12,2,1.14,85.71,Facile,Facile,0,Meme Difficulte que la Prediction,Adapte
4376,2019,Droit,1,Constitution de la Cinquieme Republique,3,Le Pouvoir Legislatif,7,113,2,QCM,0.04,0.93,74.3,12,4,16,16,12,4,1.0,75.0,Facile,Facile,0,Meme Difficulte que la Prediction,Adapte
5442,2020,Droit,1,Constitution de la Cinquieme Republique,3,Le Pouvoir Legislatif,7,113,2,QCM,0.02,1.0,74.3,13,4,17,13,13,0,1.31,100.0,Facile,Facile,0,Meme Difficulte que la Prediction,Adapte
113,2015,Droit,1,Constitution de la Cinquieme Republique,3,Le Pouvoir Legislatif,7,114,3,QROC,0.71,0.13,28.75,2,5,7,5,2,3,1.4,40.0,Facile,Difficile,-2,Beaucoup plus Difficile que la Prediction,Pas Adapte
1179,2016,Droit,1,Constitution de la Cinquieme Republique,3,Le Pouvoir Legislatif,7,114,3,QROC,0.61,0.14,22.82,2,5,7,6,2,4,1.17,33.33,Difficile,Difficile,0,Meme Difficulte que la Prediction,Pas Adapte
2245,2017,Droit,1,Constitution de la Cinquieme Republique,3,Le Pouvoir Legislatif,7,114,3,QROC,0.06,0.81,98.12,6,0,6,6,6,0,1.0,100.0,Facile,Facile,0,Meme Difficulte que la Prediction,Pas Adapte
3311,2018,Droit,1,Constitution de la Cinquieme Republique,3,Le Pouvoir Legislatif,7,114,3,QROC,0.07,0.79,65.86,5,2,7,6,5,1,1.17,83.33,Difficile,Facile,2,Beaucoup plus Facile que la Prediction,Adapte
4377,2019,Droit,1,Constitution de la Cinquieme Republique,3,Le Pouvoir Legislatif,7,114,3,QCM,0.06,0.99,65.86,5,3,8,6,5,1,1.33,83.33,Facile,Facile,0,Meme Difficulte que la Prediction,Adapte
5443,2020,Droit,1,Constitution de la Cinquieme Republique,3,Le Pouvoir Legislatif,7,114,3,QCM,0.15,0.9,65.86,5,2,7,5,5,0,1.4,100.0,Facile,Facile,0,Meme Difficulte que la Prediction,Adapte
114,2015,Droit,1,Constitution de la Cinquieme Republique,3,Le Pouvoir Legislatif,7,115,4,QCM,0.05,0.79,96.74,75,3,78,77,75,2,1.01,97.4,Facile,Facile,0,Meme Difficulte que la Prediction,Pas Adapte
1180,2016,Droit,1,Constitution de la Cinquieme Republique,3,Le Pouvoir Legislatif,7,115,4,QCM,0.12,0.99,90.85,73,7,80,76,73,3,1.05,96.05,Difficile,Facile,2,Beaucoup plus Facile que la Prediction,Pas Adapte
2246,2017,Droit,1,Constitution de la Cinquieme Republique,3,Le Pouvoir Legislatif,7,115,4,QCM,0.17,0.72,66.38,53,27,80,67,53,14,1.19,79.1,Difficile,Facile,2,Beaucoup plus Facile que la Prediction,Adapte
3312,2018,Droit,1,Constitution de la Cinquieme Republique,3,Le Pouvoir Legislatif,7,115,4,QCM,0.06,0.89,66.38,61,31,92,84,61,23,1.1,72.62,Facile,Facile,0,Meme Difficulte que la Prediction,Adapte
4378,2019,Droit,1,Constitution de la Cinquieme Republique,3,Le Pouvoir Legislatif,7,115,4,QCU,0.13,0.86,66.38,70,36,106,87,70,17,1.22,80.46,Facile,Facile,0,Meme Difficulte que la Prediction,Adapte
5444,2020,Droit,1,Constitution de la Cinquieme Republique,3,Le Pouvoir Legislatif,7,115,4,QCU,0.16,0.78,66.38,62,32,94,77,62,15,1.22,80.52,Facile,Facile,0,Meme Difficulte que la Prediction,Adapte
115,2015,Droit,1,Constitution de la Cinquieme Republique,3,Le Pouvoir Legislatif,7,116,5,QCM,0.13,0.93,82.37,7,1,8,8,7,1,1.0,87.5,Difficile,Facile,2,Beaucoup plus Facile que la Prediction,Pas Adapte
1181,2016,Droit,1,Constitution de la Cinquieme Republique,3,Le Pouvoir Legislatif,7,116,5,QCM,0.17,0.71,93.78,7,0,7,7,7,0,1.0,100.0,Facile,Facile,0,Meme Difficulte que la Prediction,Pas Adapte
2247,2017,Droit,1,Constitution de la Cinquieme Republique,3,Le Pouvoir Legislatif,7,116,5,QCM,0.12,0.98,95.93,7,0,7,7,7,0,1.0,100.0,Facile,Facile,0,Meme Difficulte que la Prediction,Pas Adapte
3313,2018,Droit,1,Constitution de la Cinquieme Republique,3,Le Pouvoir Legislatif,7,116,5,QCM,0.7,0.16,9.89,1,6,7,6,1,5,1.17,16.67,Difficile,Difficile,0,Meme Difficulte que la Prediction,Pas Adapte
4379,2019,Droit,1,Constitution de la Cinquieme Republique,3,Le Pouvoir Legislatif,7,116,5,QCM,0.14,0.87,81.65,6,1,7,7,6,1,1.0,85.71,Facile,Facile,0,Meme Difficulte que la Prediction,Pas Adapte
5445,2020,Droit,1,Constitution de la Cinquieme Republique,3,Le Pouvoir Legislatif,7,116,5,QCM,0.07,0.88,65.69,5,3,8,6,5,1,1.33,83.33,Facile,Facile,0,Meme Difficulte que la Prediction,Adapte
116,2015,Droit,1,Constitution de la Cinquieme Republique,3,Le Pouvoir Legislatif,7,117,6,QCU,0.11,0.92,74.32,27,9,36,30,27,3,1.2,90.0,Facile,Facile,0,Meme Difficulte que la Prediction,Adapte
1182,2016,Droit,1,Constitution de la Cinquieme Republique,3,Le Pouvoir Legislatif,7,117,6,QCU,0.09,0.92,74.32,28,10,38,33,28,5,1.15,84.85,Facile,Facile,0,Meme Difficulte que la Prediction,Adapte
2248,2017,Droit,1,Constitution de la Cinquieme Republique,3,Le Pouvoir Legislatif,7,117,6,QCU,0.14,0.79,74.32,27,10,37,30,27,3,1.23,90.0,Facile,Facile,0,Meme Difficulte que la Prediction,Adapte
3314,2018,Droit,1,Constitution de la Cinquieme Republique,3,Le Pouvoir Legislatif,7,117,6,QCU,0.11,0.94,74.32,29,10,39,38,29,9,1.03,76.32,Facile,Facile,0,Meme Difficulte que la Prediction,Adapte
4380,2019,Droit,1,Constitution de la Cinquieme Republique,3,Le Pouvoir Legislatif,7,117,6,QCU,0.04,0.9,74.32,28,10,38,36,28,8,1.06,77.78,Facile,Facile,0,Meme Difficulte que la Prediction,Adapte
5446,2020,Droit,1,Constitution de la Cinquieme Republique,3,Le Pouvoir Legislatif,7,117,6,QCU,0.06,0.76,74.32,32,11,43,41,32,9,1.05,78.05,Facile,Facile,0,Meme Difficulte que la Prediction,Adapte
117,2015,Droit,1,Constitution de la Cinquieme Republique,3,Le Pouvoir Legislatif,7,118,7,QCU,0.45,0.36,19.21,6,23,29,18,6,12,1.61,33.33,Facile,Difficile,-2,Beaucoup plus Difficile que la Prediction,Pas Adapte
1183,2016,Droit,1,Constitution de la Cinquieme Republique,3,Le Pouvoir Legislatif,7,118,7,QCU,0.17,0.88,75.56,21,7,28,21,21,0,1.33,100.0,Moyen,Facile,1,Plus Facile que la Prediction,Pas Adapte
2249,2017,Droit,1,Constitution de la Cinquieme Republique,3,Le Pouvoir Legislatif,7,118,7,QCU,0.4,0.55,60.62,16,11,27,19,16,3,1.42,84.21,Moyen,Moyen,0,Meme Difficulte que la Prediction,Adapte
3315,2018,Droit,1,Constitution de la Cinquieme Republique,3,Le Pouvoir Legislatif,7,118,7,QCM,0.31,0.59,60.62,16,10,26,20,16,4,1.3,80.0,Moyen,Moyen,0,Meme Difficulte que la Prediction,Adapte
4381,2019,Droit,1,Constitution de la Cinquieme Republique,3,Le Pouvoir Legislatif,7,118,7,QO,0.66,0.28,60.62,17,11,28,21,17,4,1.33,80.95,Moyen,Moyen,0,Meme Difficulte que la Prediction,Adapte
5447,2020,Droit,1,Constitution de la Cinquieme Republique,3,Le Pouvoir Legislatif,7,118,7,QO,0.32,0.21,60.62,19,12,31,28,19,9,1.11,67.86,Moyen,Moyen,0,Meme Difficulte que la Prediction,Adapte
118,2015,Droit,1,Constitution de la Cinquieme Republique,4,Le Controle de Constitutionnalite,9,119,1,QCU,0.08,0.88,86.9,57,9,66,64,57,7,1.03,89.06,Facile,Facile,0,Meme Difficulte que la Prediction,Pas Adapte
1184,2016,Droit,1,Constitution de la Cinquieme Republique,4,Le Controle de Constitutionnalite,9,119,1,QCU,0.59,0.22,17.42,12,54,66,44,12,32,1.5,27.27,Difficile,Difficile,0,Meme Difficulte que la Prediction,Pas Adapte
2250,2017,Droit,1,Constitution de la Cinquieme Republique,4,Le Controle de Constitutionnalite,9,119,1,QCU,0.53,0.31,8.59,6,59,65,52,6,46,1.25,11.54,Difficile,Difficile,0,Meme Difficulte que la Prediction,Pas Adapte
3316,2018,Droit,1,Constitution de la Cinquieme Republique,4,Le Controle de Constitutionnalite,9,119,1,QCM,0.07,0.74,74.58,47,16,63,51,47,4,1.24,92.16,Moyen,Facile,1,Plus Facile que la Prediction,Adapte
4382,2019,Droit,1,Constitution de la Cinquieme Republique,4,Le Controle de Constitutionnalite,9,119,1,QCM,0.11,0.74,74.58,53,18,71,69,53,16,1.03,76.81,Facile,Facile,0,Meme Difficulte que la Prediction,Adapte
5448,2020,Droit,1,Constitution de la Cinquieme Republique,4,Le Controle de Constitutionnalite,9,119,1,QCM,0.13,0.72,74.58,53,18,71,58,53,5,1.22,91.38,Facile,Facile,0,Meme Difficulte que la Prediction,Adapte
119,2015,Droit,1,Constitution de la Cinquieme Republique,4,Le Controle de Constitutionnalite,9,120,2,QCM,0.54,0.26,15.62,4,23,27,15,4,11,1.8,26.67,Difficile,Difficile,0,Meme Difficulte que la Prediction,Pas Adapte
1185,2016,Droit,1,Constitution de la Cinquieme Republique,4,Le Controle de Constitutionnalite,9,120,2,QCM,0.03,0.86,73.12,22,8,30,27,22,5,1.11,81.48,Facile,Facile,0,Meme Difficulte que la Prediction,Adapte
2251,2017,Droit,1,Constitution de la Cinquieme Republique,4,Le Controle de Constitutionnalite,9,120,2,QCM,0.18,0.72,73.12,19,7,26,23,19,4,1.13,82.61,Facile,Facile,0,Meme Difficulte que la Prediction,Adapte
3317,2018,Droit,1,Constitution de la Cinquieme Republique,4,Le Controle de Constitutionnalite,9,120,2,QCM,0.04,0.85,73.12,20,7,27,23,20,3,1.17,86.96,Facile,Facile,0,Meme Difficulte que la Prediction,Adapte
4383,2019,Droit,1,Constitution de la Cinquieme Republique,4,Le Controle de Constitutionnalite,9,120,2,QCM,0.07,0.92,73.12,17,6,23,22,17,5,1.05,77.27,Facile,Facile,0,Meme Difficulte que la Prediction,Adapte
5449,2020,Droit,1,Constitution de la Cinquieme Republique,4,Le Controle de Constitutionnalite,9,120,2,QCU,0.03,0.95,73.12,18,6,24,20,18,2,1.2,90.0,Facile,Facile,0,Meme Difficulte que la Prediction,Adapte
120,2015,Droit,1,Constitution de la Cinquieme Republique,4,Le Controle de Constitutionnalite,9,121,3,QCM,0.56,0.19,32.76,17,35,52,48,17,31,1.08,35.42,Moyen,Difficile,-1,Plus Difficile que la Prediction,Pas Adapte
1186,2016,Droit,1,Constitution de la Cinquieme Republique,4,Le Controle de Constitutionnalite,9,121,3,QCU,0.37,0.62,52.9,24,21,45,40,24,16,1.12,60.0,Facile,Moyen,-1,Plus Difficile que la Prediction,Pas Adapte
2252,2017,Droit,1,Constitution de la Cinquieme Republique,4,Le Controle de Constitutionnalite,9,121,3,QCU,0.28,0.56,35.62,16,30,46,44,16,28,1.05,36.36,Moyen,Moyen,0,Meme Difficulte que la Prediction,Pas Adapte
3318,2018,Droit,1,Constitution de la Cinquieme Republique,4,Le Controle de Constitutionnalite,9,121,3,QCU,0.45,0.21,11.08,6,44,50,22,6,16,2.27,27.27,Difficile,Difficile,0,Meme Difficulte que la Prediction,Pas Adapte
4384,2019,Droit,1,Constitution de la Cinquieme Republique,4,Le Controle de Constitutionnalite,9,121,3,QCU,0.11,0.91,91.8,41,4,45,42,41,1,1.07,97.62,Difficile,Facile,2,Beaucoup plus Facile que la Prediction,Pas Adapte
5450,2020,Droit,1,Constitution de la Cinquieme Republique,4,Le Controle de Constitutionnalite,9,121,3,QROC,0.69,0.19,28.23,11,29,40,22,11,11,1.82,50.0,Difficile,Difficile,0,Meme Difficulte que la Prediction,Pas Adapte
121,2015,Droit,1,Constitution de la Cinquieme Republique,4,Le Controle de Constitutionnalite,9,122,4,QCM,0.23,0.64,55.3,7,6,13,12,7,5,1.08,58.33,Facile,Moyen,-1,Plus Difficile que la Prediction,Pas Adapte
1187,2016,Droit,1,Constitution de la Cinquieme Republique,4,Le Controle de Constitutionnalite,9,122,4,QCM,0.29,0.46,39.18,6,9,15,8,6,2,1.88,75.0,Facile,Moyen,-1,Plus Difficile que la Prediction,Pas Adapte
2253,2017,Droit,1,Constitution de la Cinquieme Republique,4,Le Controle de Constitutionnalite,9,122,4,QCM,0.14,0.97,92.07,15,1,16,15,15,0,1.07,100.0,Facile,Facile,0,Meme Difficulte que la Prediction,Pas Adapte
3319,2018,Droit,1,Constitution de la Cinquieme Republique,4,Le Controle de Constitutionnalite,9,122,4,QCM,0.76,0.26,20.98,4,13,17,7,4,3,2.43,57.14,Difficile,Difficile,0,Meme Difficulte que la Prediction,Pas Adapte
4385,2019,Droit,1,Constitution de la Cinquieme Republique,4,Le Controle de Constitutionnalite,9,122,4,QCM,0.61,0.25,3.86,1,18,19,18,1,17,1.06,5.56,Facile,Difficile,-2,Beaucoup plus Difficile que la Prediction,Pas Adapte
5451,2020,Droit,1,Constitution de la Cinquieme Republique,4,Le Controle de Constitutionnalite,9,122,4,QCM,0.27,0.38,35.92,8,14,22,13,8,5,1.69,61.54,Moyen,Moyen,0,Meme Difficulte que la Prediction,Pas Adapte
122,2015,Droit,1,Constitution de la Cinquieme Republique,4,Le Controle de Constitutionnalite,9,123,5,QCM,0.56,0.25,29.27,18,42,60,37,18,19,1.62,48.65,Difficile,Difficile,0,Meme Difficulte que la Prediction,Pas Adapte
1188,2016,Droit,1,Constitution de la Cinquieme Republique,4,Le Controle de Constitutionnalite,9,123,5,QCU,0.15,0.93,98.9,68,1,69,69,68,1,1.0,98.55,Facile,Facile,0,Meme Difficulte que la Prediction,Pas Adapte
2254,2017,Droit,1,Constitution de la Cinquieme Republique,4,Le Controle de Constitutionnalite,9,123,5,QCU,0.1,0.84,86.99,67,10,77,71,67,4,1.08,94.37,Moyen,Facile,1,Plus Facile que la Prediction,Pas Adapte
3320,2018,Droit,1,Constitution de la Cinquieme Republique,4,Le Controle de Constitutionnalite,9,123,5,QCU,0.52,0.28,8.43,5,60,65,38,5,33,1.71,13.16,Facile,Difficile,-2,Beaucoup plus Difficile que la Prediction,Pas Adapte
4386,2019,Droit,1,Constitution de la Cinquieme Republique,4,Le Controle de Constitutionnalite,9,123,5,QROC,0.09,0.56,69.62,49,22,71,60,49,11,1.18,81.67,Facile,Facile,0,Meme Difficulte que la Prediction,Adapte
5452,2020,Droit,1,Constitution de la Cinquieme Republique,4,Le Controle de Constitutionnalite,9,123,5,QO,0.16,0.42,69.62,45,20,65,56,45,11,1.16,80.36,Facile,Facile,0,Meme Difficulte que la Prediction,Adapte
123,2015,Droit,1,Constitution de la Cinquieme Republique,4,Le Controle de Constitutionnalite,9,124,6,QCM,0.61,0.22,19.96,4,16,20,20,4,16,1.0,20.0,Facile,Difficile,-2,Beaucoup plus Difficile que la Prediction,Pas Adapte
1189,2016,Droit,1,Constitution de la Cinquieme Republique,4,Le Controle de Constitutionnalite,9,124,6,QCM,0.36,0.31,50.14,10,10,20,14,10,4,1.43,71.43,Moyen,Moyen,0,Meme Difficulte que la Prediction,Pas Adapte
2255,2017,Droit,1,Constitution de la Cinquieme Republique,4,Le Controle de Constitutionnalite,9,124,6,QCM,0.03,0.74,67.17,15,7,22,20,15,5,1.1,75.0,Facile,Facile,0,Meme Difficulte que la Prediction,Adapte
3321,2018,Droit,1,Constitution de la Cinquieme Republique,4,Le Controle de Constitutionnalite,9,124,6,QCM,0.05,0.83,67.17,14,7,21,16,14,2,1.31,87.5,Facile,Facile,0,Meme Difficulte que la Prediction,Adapte
4387,2019,Droit,1,Constitution de la Cinquieme Republique,4,Le Controle de Constitutionnalite,9,124,6,QCM,0.09,0.89,67.17,15,8,23,19,15,4,1.21,78.95,Facile,Facile,0,Meme Difficulte que la Prediction,Adapte
5453,2020,Droit,1,Constitution de la Cinquieme Republique,4,Le Controle de Constitutionnalite,9,124,6,QCM,0.14,0.83,67.17,16,8,24,18,16,2,1.33,88.89,Facile,Facile,0,Meme Difficulte que la Prediction,Adapte
124,2015,Droit,1,Constitution de la Cinquieme Republique,4,Le Controle de Constitutionnalite,9,125,7,QCU,0.01,0.76,78.78,43,12,55,43,43,0,1.28,100.0,Facile,Facile,0,Meme Difficulte que la Prediction,Pas Adapte
1190,2016,Droit,1,Constitution de la Cinquieme Republique,4,Le Controle de Constitutionnalite,9,125,7,QCU,0.22,0.53,56.31,26,21,47,37,26,11,1.27,70.27,Moyen,Moyen,0,Meme Difficulte que la Prediction,Pas Adapte
2256,2017,Droit,1,Constitution de la Cinquieme Republique,4,Le Controle de Constitutionnalite,9,125,7,QCU,0.29,0.5,57.75,31,22,53,34,31,3,1.56,91.18,Moyen,Moyen,0,Meme Difficulte que la Prediction,Pas Adapte
3322,2018,Droit,1,Constitution de la Cinquieme Republique,4,Le Controle de Constitutionnalite,9,125,7,QCM,0.36,0.31,55.09,28,22,50,40,28,12,1.25,70.0,Moyen,Moyen,0,Meme Difficulte que la Prediction,Pas Adapte
4388,2019,Droit,1,Constitution de la Cinquieme Republique,4,Le Controle de Constitutionnalite,9,125,7,QCU,0.42,0.29,0.95,0,50,50,34,0,34,1.47,0.0,Difficile,Difficile,0,Meme Difficulte que la Prediction,Pas Adapte
5454,2020,Droit,1,Constitution de la Cinquieme Republique,4,Le Controle de Constitutionnalite,9,125,7,QCU,0.11,0.79,67.14,34,16,50,46,34,12,1.09,73.91,Facile,Facile,0,Meme Difficulte que la Prediction,Adapte
125,2015,Droit,1,Constitution de la Cinquieme Republique,4,Le Controle de Constitutionnalite,9,126,8,QCM,0.53,0.26,16.12,13,65,78,34,13,21,2.29,38.24,Difficile,Difficile,0,Meme Difficulte que la Prediction,Pas Adapte
1191,2016,Droit,1,Constitution de la Cinquieme Republique,4,Le Controle de Constitutionnalite,9,126,8,QROC,0.94,0.13,9.92,9,77,86,71,9,62,1.21,12.68,Difficile,Difficile,0,Meme Difficulte que la Prediction,Pas Adapte
2257,2017,Droit,1,Constitution de la Cinquieme Republique,4,Le Controle de Constitutionnalite,9,126,8,QROC,0.19,0.54,91.36,84,8,92,91,84,7,1.01,92.31,Facile,Facile,0,Meme Difficulte que la Prediction,Pas Adapte
3323,2018,Droit,1,Constitution de la Cinquieme Republique,4,Le Controle de Constitutionnalite,9,126,8,QCM,0.74,0.16,16.06,16,84,100,81,16,65,1.23,19.75,Difficile,Difficile,0,Meme Difficulte que la Prediction,Pas Adapte
4389,2019,Droit,1,Constitution de la Cinquieme Republique,4,Le Controle de Constitutionnalite,9,126,8,QCM,0.77,0.19,27.99,27,70,97,29,27,2,3.34,93.1,Difficile,Difficile,0,Meme Difficulte que la Prediction,Pas Adapte
5455,2020,Droit,1,Constitution de la Cinquieme Republique,4,Le Controle de Constitutionnalite,9,126,8,QCM,0.04,0.79,89.06,99,12,111,109,99,10,1.02,90.83,Difficile,Facile,2,Beaucoup plus Facile que la Prediction,Pas Adapte
126,2015,Droit,1,Constitution de la Cinquieme Republique,4,Le Controle de Constitutionnalite,9,127,9,QCU,0.28,0.57,43.22,35,45,80,65,35,30,1.23,53.85,Facile,Moyen,-1,Plus Difficile que la Prediction,Pas Adapte
1192,2016,Droit,1,Constitution de la Cinquieme Republique,4,Le Controle de Constitutionnalite,9,127,9,QROC,0.7,0.16,26.56,19,54,73,38,19,19,1.92,50.0,Difficile,Difficile,0,Meme Difficulte que la Prediction,Pas Adapte
2258,2017,Droit,1,Constitution de la Cinquieme Republique,4,Le Controle de Constitutionnalite,9,127,9,QROC,0.25,0.32,51.63,35,33,68,43,35,8,1.58,81.4,Moyen,Moyen,0,Meme Difficulte que la Prediction,Pas Adapte
3324,2018,Droit,1,Constitution de la Cinquieme Republique,4,Le Controle de Constitutionnalite,9,127,9,QROC,0.02,0.81,69.15,48,21,69,58,48,10,1.19,82.76,Facile,Facile,0,Meme Difficulte que la Prediction,Adapte
4390,2019,Droit,1,Constitution de la Cinquieme Republique,4,Le Controle de Constitutionnalite,9,127,9,QROC,0.01,0.41,69.15,48,21,69,65,48,17,1.06,73.85,Facile,Facile,0,Meme Difficulte que la Prediction,Adapte
5456,2020,Droit,1,Constitution de la Cinquieme Republique,4,Le Controle de Constitutionnalite,9,127,9,QROC,0.08,0.97,69.15,42,19,61,56,42,14,1.09,75.0,Facile,Facile,0,Meme Difficulte que la Prediction,Adapte
127,2015,Economie,1,L'Economie et son Domaine,1,L'Objet de la Science Economique,6,128,1,QCM,0.55,0.2,28.62,21,51,72,23,21,2,3.13,91.3,Difficile,Difficile,0,Meme Difficulte que la Prediction,Pas Adapte
1193,2016,Economie,1,L'Economie et son Domaine,1,L'Objet de la Science Economique,6,128,1,QCM,0.14,0.9,88.66,71,9,80,79,71,8,1.01,89.87,Facile,Facile,0,Meme Difficulte que la Prediction,Pas Adapte
2259,2017,Economie,1,L'Economie et son Domaine,1,L'Objet de la Science Economique,6,128,1,QCM,0.46,0.68,35.09,31,57,88,83,31,52,1.06,37.35,Facile,Moyen,-1,Plus Difficile que la Prediction,Pas Adapte
3325,2018,Economie,1,L'Economie et son Domaine,1,L'Objet de la Science Economique,6,128,1,QCM,0.13,0.84,73.25,67,25,92,77,67,10,1.19,87.01,Facile,Facile,0,Meme Difficulte que la Prediction,Adapte
4391,2019,Economie,1,L'Economie et son Domaine,1,L'Objet de la Science Economique,6,128,1,QCM,0.15,0.79,73.25,69,25,94,79,69,10,1.19,87.34,Facile,Facile,0,Meme Difficulte que la Prediction,Adapte
5457,2020,Economie,1,L'Economie et son Domaine,1,L'Objet de la Science Economique,6,128,1,QCU,0.01,0.91,73.25,68,25,93,84,68,16,1.11,80.95,Facile,Facile,0,Meme Difficulte que la Prediction,Adapte
128,2015,Economie,1,L'Economie et son Domaine,1,L'Objet de la Science Economique,6,129,2,QROC,0.78,0.11,5.44,4,77,81,81,4,77,1.0,4.94,Difficile,Difficile,0,Meme Difficulte que la Prediction,Pas Adapte
1194,2016,Economie,1,L'Economie et son Domaine,1,L'Objet de la Science Economique,6,129,2,QROC,0.47,0.35,56.76,40,31,71,70,40,30,1.01,57.14,Moyen,Moyen,0,Meme Difficulte que la Prediction,Pas Adapte
2260,2017,Economie,1,L'Economie et son Domaine,1,L'Objet de la Science Economique,6,129,2,QROC,0.05,0.89,80.77,65,16,81,67,65,2,1.21,97.01,Moyen,Facile,1,Plus Facile que la Prediction,Pas Adapte
3326,2018,Economie,1,L'Economie et son Domaine,1,L'Objet de la Science Economique,6,129,2,QROC,0.24,0.25,55.59,50,40,90,88,50,38,1.02,56.82,Difficile,Moyen,1,Plus Facile que la Prediction,Pas Adapte
4392,2019,Economie,1,L'Economie et son Domaine,1,L'Objet de la Science Economique,6,129,2,QROC,0.36,0.4,45.87,35,41,76,72,35,37,1.06,48.61,Moyen,Moyen,0,Meme Difficulte que la Prediction,Pas Adapte
5458,2020,Economie,1,L'Economie et son Domaine,1,L'Objet de la Science Economique,6,129,2,QROC,0.67,0.05,25.2,21,62,83,38,21,17,2.18,55.26,Facile,Difficile,-2,Beaucoup plus Difficile que la Prediction,Pas Adapte
129,2015,Economie,1,L'Economie et son Domaine,1,L'Objet de la Science Economique,6,130,3,QROC,0.21,0.36,62.38,13,8,21,16,13,3,1.31,81.25,Facile,Moyen,-1,Plus Difficile que la Prediction,Adapte
1195,2016,Economie,1,L'Economie et son Domaine,1,L'Objet de la Science Economique,6,130,3,QROC,0.5,0.31,62.38,15,9,24,16,15,1,1.5,93.75,Moyen,Moyen,0,Meme Difficulte que la Prediction,Adapte
2261,2017,Economie,1,L'Economie et son Domaine,1,L'Objet de la Science Economique,6,130,3,QROC,0.39,0.3,62.38,13,8,21,14,13,1,1.5,92.86,Moyen,Moyen,0,Meme Difficulte que la Prediction,Adapte
3327,2018,Economie,1,L'Economie et son Domaine,1,L'Objet de la Science Economique,6,130,3,QROC,0.23,0.36,62.38,14,8,22,15,14,1,1.47,93.33,Moyen,Moyen,0,Meme Difficulte que la Prediction,Adapte
4393,2019,Economie,1,L'Economie et son Domaine,1,L'Objet de la Science Economique,6,130,3,QO,0.53,0.2,62.38,15,9,24,20,15,5,1.2,75.0,Moyen,Moyen,0,Meme Difficulte que la Prediction,Adapte
5459,2020,Economie,1,L'Economie et son Domaine,1,L'Objet de la Science Economique,6,130,3,QO,0.59,0.23,62.38,17,10,27,19,17,2,1.42,89.47,Moyen,Moyen,0,Meme Difficulte que la Prediction,Adapte
130,2015,Economie,1,L'Economie et son Domaine,1,L'Objet de la Science Economique,6,131,4,QCM,0.68,0.17,17.95,16,72,88,24,16,8,3.67,66.67,Difficile,Difficile,0,Meme Difficulte que la Prediction,Pas Adapte
1196,2016,Economie,1,L'Economie et son Domaine,1,L'Objet de la Science Economique,6,131,4,QCU,0.02,0.79,66.21,59,30,89,72,59,13,1.24,81.94,Facile,Facile,0,Meme Difficulte que la Prediction,Adapte
2262,2017,Economie,1,L'Economie et son Domaine,1,L'Objet de la Science Economique,6,131,4,QCM,0.1,0.82,66.21,66,33,99,81,66,15,1.22,81.48,Facile,Facile,0,Meme Difficulte que la Prediction,Adapte
3328,2018,Economie,1,L'Economie et son Domaine,1,L'Objet de la Science Economique,6,131,4,QCM,0.07,0.76,66.21,58,30,88,60,58,2,1.47,96.67,Facile,Facile,0,Meme Difficulte que la Prediction,Adapte
4394,2019,Economie,1,L'Economie et son Domaine,1,L'Objet de la Science Economique,6,131,4,QCM,0.17,0.94,66.21,58,29,87,83,58,25,1.05,69.88,Facile,Facile,0,Meme Difficulte que la Prediction,Adapte
5460,2020,Economie,1,L'Economie et son Domaine,1,L'Objet de la Science Economique,6,131,4,QCM,0.12,0.84,66.21,58,29,87,67,58,9,1.3,86.57,Facile,Facile,0,Meme Difficulte que la Prediction,Adapte
131,2015,Economie,1,L'Economie et son Domaine,1,L'Objet de la Science Economique,6,132,5,QCU,0.6,0.32,18.52,18,80,98,38,18,20,2.58,47.37,Facile,Difficile,-2,Beaucoup plus Difficile que la Prediction,Pas Adapte
1197,2016,Economie,1,L'Economie et son Domaine,1,L'Objet de la Science Economique,6,132,5,QCU,0.16,0.81,77.6,69,20,89,80,69,11,1.11,86.25,Facile,Facile,0,Meme Difficulte que la Prediction,Pas Adapte
2263,2017,Economie,1,L'Economie et son Domaine,1,L'Objet de la Science Economique,6,132,5,QCU,0.62,0.25,26.72,21,58,79,62,21,41,1.27,33.87,Moyen,Difficile,-1,Plus Difficile que la Prediction,Pas Adapte
3329,2018,Economie,1,L'Economie et son Domaine,1,L'Objet de la Science Economique,6,132,5,QCU,0.26,0.73,35.76,28,51,79,35,28,7,2.26,80.0,Moyen,Moyen,0,Meme Difficulte que la Prediction,Pas Adapte
4395,2019,Economie,1,L'Economie et son Domaine,1,L'Objet de la Science Economique,6,132,5,QCU,0.05,0.97,79.49,66,17,83,82,66,16,1.01,80.49,Facile,Facile,0,Meme Difficulte que la Prediction,Pas Adapte
5461,2020,Economie,1,L'Economie et son Domaine,1,L'Objet de la Science Economique,6,132,5,QCU,0.26,0.45,44.64,36,45,81,71,36,35,1.14,50.7,Moyen,Moyen,0,Meme Difficulte que la Prediction,Pas Adapte
132,2015,Economie,1,L'Economie et son Domaine,1,L'Objet de la Science Economique,6,133,6,QCU,0.07,0.76,92.32,54,5,59,57,54,3,1.04,94.74,Facile,Facile,0,Meme Difficulte que la Prediction,Pas Adapte
1198,2016,Economie,1,L'Economie et son Domaine,1,L'Objet de la Science Economique,6,133,6,QCU,0.1,0.97,77.86,51,14,65,51,51,0,1.27,100.0,Facile,Facile,0,Meme Difficulte que la Prediction,Pas Adapte
2264,2017,Economie,1,L'Economie et son Domaine,1,L'Objet de la Science Economique,6,133,6,QCU,0.21,0.52,41.09,26,38,64,28,26,2,2.29,92.86,Moyen,Moyen,0,Meme Difficulte que la Prediction,Pas Adapte
3330,2018,Economie,1,L'Economie et son Domaine,1,L'Objet de la Science Economique,6,133,6,QCU,0.4,0.4,8.85,6,60,66,41,6,35,1.61,14.63,Facile,Difficile,-2,Beaucoup plus Difficile que la Prediction,Pas Adapte
4396,2019,Economie,1,L'Economie et son Domaine,1,L'Objet de la Science Economique,6,133,6,QCU,0.04,0.77,87.53,58,8,66,61,58,3,1.08,95.08,Difficile,Facile,2,Beaucoup plus Facile que la Prediction,Pas Adapte
5462,2020,Economie,1,L'Economie et son Domaine,1,L'Objet de la Science Economique,6,133,6,QCU,0.35,0.69,42.73,29,39,68,61,29,32,1.11,47.54,Moyen,Moyen,0,Meme Difficulte que la Prediction,Pas Adapte
133,2015,Economie,1,L'Economie et son Domaine,2,Les Grands Courants de la Pensee Economique,11,134,1,QCU,0.23,0.5,59.59,47,32,79,57,47,10,1.39,82.46,Facile,Moyen,-1,Plus Difficile que la Prediction,Pas Adapte
1199,2016,Economie,1,L'Economie et son Domaine,2,Les Grands Courants de la Pensee Economique,11,134,1,QO,0.17,0.6,94.05,76,5,81,77,76,1,1.05,98.7,Facile,Facile,0,Meme Difficulte que la Prediction,Pas Adapte
2265,2017,Economie,1,L'Economie et son Domaine,2,Les Grands Courants de la Pensee Economique,11,134,1,QO,0.19,0.93,77.35,60,17,77,62,60,2,1.24,96.77,Facile,Facile,0,Meme Difficulte que la Prediction,Pas Adapte
3331,2018,Economie,1,L'Economie et son Domaine,2,Les Grands Courants de la Pensee Economique,11,134,1,QROC,0.33,0.28,37.72,27,44,71,41,27,14,1.73,65.85,Moyen,Moyen,0,Meme Difficulte que la Prediction,Pas Adapte
4397,2019,Economie,1,L'Economie et son Domaine,2,Les Grands Courants de la Pensee Economique,11,134,1,QROC,0.14,0.57,69.15,45,20,65,61,45,16,1.07,73.77,Facile,Facile,0,Meme Difficulte que la Prediction,Adapte
5463,2020,Economie,1,L'Economie et son Domaine,2,Les Grands Courants de la Pensee Economique,11,134,1,QROC,0.0,0.66,69.15,46,20,66,60,46,14,1.1,76.67,Facile,Facile,0,Meme Difficulte que la Prediction,Adapte
134,2015,Economie,1,L'Economie et son Domaine,2,Les Grands Courants de la Pensee Economique,11,135,2,QCM,0.31,0.45,47.03,8,9,17,13,8,5,1.31,61.54,Difficile,Moyen,1,Plus Facile que la Prediction,Pas Adapte
1200,2016,Economie,1,L'Economie et son Domaine,2,Les Grands Courants de la Pensee Economique,11,135,2,QCM,0.25,0.49,39.52,7,11,18,9,7,2,2.0,77.78,Facile,Moyen,-1,Plus Difficile que la Prediction,Pas Adapte
2266,2017,Economie,1,L'Economie et son Domaine,2,Les Grands Courants de la Pensee Economique,11,135,2,QCM,0.07,0.91,93.72,20,1,21,20,20,0,1.05,100.0,Facile,Facile,0,Meme Difficulte que la Prediction,Pas Adapte
3332,2018,Economie,1,L'Economie et son Domaine,2,Les Grands Courants de la Pensee Economique,11,135,2,QCM,0.24,0.38,43.92,10,12,22,19,10,9,1.16,52.63,Moyen,Moyen,0,Meme Difficulte que la Prediction,Pas Adapte
4398,2019,Economie,1,L'Economie et son Domaine,2,Les Grands Courants de la Pensee Economique,11,135,2,QCU,0.02,0.9,69.75,15,6,21,17,15,2,1.24,88.24,Facile,Facile,0,Meme Difficulte que la Prediction,Adapte
5464,2020,Economie,1,L'Economie et son Domaine,2,Les Grands Courants de la Pensee Economique,11,135,2,QCU,0.06,0.89,69.75,15,7,22,19,15,4,1.16,78.95,Facile,Facile,0,Meme Difficulte que la Prediction,Adapte
135,2015,Economie,1,L'Economie et son Domaine,2,Les Grands Courants de la Pensee Economique,11,136,3,QCU,0.38,0.63,40.65,23,34,57,42,23,19,1.36,54.76,Moyen,Moyen,0,Meme Difficulte que la Prediction,Pas Adapte
1201,2016,Economie,1,L'Economie et son Domaine,2,Les Grands Courants de la Pensee Economique,11,136,3,QCU,0.28,0.68,43.2,22,30,52,30,22,8,1.73,73.33,Moyen,Moyen,0,Meme Difficulte que la Prediction,Pas Adapte
2267,2017,Economie,1,L'Economie et son Domaine,2,Les Grands Courants de la Pensee Economique,11,136,3,QCU,0.09,0.92,71.87,36,14,50,50,36,14,1.0,72.0,Facile,Facile,0,Meme Difficulte que la Prediction,Adapte
3333,2018,Economie,1,L'Economie et son Domaine,2,Les Grands Courants de la Pensee Economique,11,136,3,QCU,0.07,0.79,71.87,35,14,49,39,35,4,1.26,89.74,Facile,Facile,0,Meme Difficulte que la Prediction,Adapte
4399,2019,Economie,1,L'Economie et son Domaine,2,Les Grands Courants de la Pensee Economique,11,136,3,QCU,0.03,0.97,71.87,33,13,46,35,33,2,1.31,94.29,Facile,Facile,0,Meme Difficulte que la Prediction,Adapte
5465,2020,Economie,1,L'Economie et son Domaine,2,Les Grands Courants de la Pensee Economique,11,136,3,QCU,0.09,0.83,71.87,35,14,49,44,35,9,1.11,79.55,Facile,Facile,0,Meme Difficulte que la Prediction,Adapte
136,2015,Economie,1,L'Economie et son Domaine,2,Les Grands Courants de la Pensee Economique,11,137,4,QCU,0.07,0.96,94.56,27,2,29,29,27,2,1.0,93.1,Facile,Facile,0,Meme Difficulte que la Prediction,Pas Adapte
1202,2016,Economie,1,L'Economie et son Domaine,2,Les Grands Courants de la Pensee Economique,11,137,4,QCU,0.28,0.42,50.13,14,14,28,16,14,2,1.75,87.5,Moyen,Moyen,0,Meme Difficulte que la Prediction,Pas Adapte
2268,2017,Economie,1,L'Economie et son Domaine,2,Les Grands Courants de la Pensee Economique,11,137,4,QCU,0.49,0.26,1.7,1,30,31,13,1,12,2.38,7.69,Difficile,Difficile,0,Meme Difficulte que la Prediction,Pas Adapte
3334,2018,Economie,1,L'Economie et son Domaine,2,Les Grands Courants de la Pensee Economique,11,137,4,QCU,0.74,0.21,4.4,2,33,35,22,2,20,1.59,9.09,Difficile,Difficile,0,Meme Difficulte que la Prediction,Pas Adapte
4400,2019,Economie,1,L'Economie et son Domaine,2,Les Grands Courants de la Pensee Economique,11,137,4,QCU,0.01,0.88,99.96,38,0,38,38,38,0,1.0,100.0,Difficile,Facile,2,Beaucoup plus Facile que la Prediction,Pas Adapte
5466,2020,Economie,1,L'Economie et son Domaine,2,Les Grands Courants de la Pensee Economique,11,137,4,QCU,0.51,0.3,14.3,5,33,38,13,5,8,2.92,38.46,Difficile,Difficile,0,Meme Difficulte que la Prediction,Pas Adapte
137,2015,Economie,1,L'Economie et son Domaine,2,Les Grands Courants de la Pensee Economique,11,138,5,QCU,0.01,0.78,71.68,70,27,97,93,70,23,1.04,75.27,Facile,Facile,0,Meme Difficulte que la Prediction,Adapte
1203,2016,Economie,1,L'Economie et son Domaine,2,Les Grands Courants de la Pensee Economique,11,138,5,QCU,0.19,0.99,71.68,69,27,96,91,69,22,1.05,75.82,Facile,Facile,0,Meme Difficulte que la Prediction,Adapte
2269,2017,Economie,1,L'Economie et son Domaine,2,Les Grands Courants de la Pensee Economique,11,138,5,QCU,0.03,0.79,71.68,61,24,85,79,61,18,1.08,77.22,Facile,Facile,0,Meme Difficulte que la Prediction,Adapte
3335,2018,Economie,1,L'Economie et son Domaine,2,Les Grands Courants de la Pensee Economique,11,138,5,QCU,0.15,0.82,71.68,59,24,83,80,59,21,1.04,73.75,Facile,Facile,0,Meme Difficulte que la Prediction,Adapte
4401,2019,Economie,1,L'Economie et son Domaine,2,Les Grands Courants de la Pensee Economique,11,138,5,QCU,0.04,0.86,71.68,64,25,89,81,64,17,1.1,79.01,Facile,Facile,0,Meme Difficulte que la Prediction,Adapte
5467,2020,Economie,1,L'Economie et son Domaine,2,Les Grands Courants de la Pensee Economique,11,138,5,QCU,0.08,0.93,71.68,71,28,99,74,71,3,1.34,95.95,Facile,Facile,0,Meme Difficulte que la Prediction,Adapte
138,2015,Economie,1,L'Economie et son Domaine,2,Les Grands Courants de la Pensee Economique,11,139,6,QROC,0.35,0.28,55.61,14,12,26,19,14,5,1.37,73.68,Moyen,Moyen,0,Meme Difficulte que la Prediction,Pas Adapte
1204,2016,Economie,1,L'Economie et son Domaine,2,Les Grands Courants de la Pensee Economique,11,139,6,QROC,0.15,0.76,77.46,19,6,25,20,19,1,1.25,95.0,Facile,Facile,0,Meme Difficulte que la Prediction,Pas Adapte
2270,2017,Economie,1,L'Economie et son Domaine,2,Les Grands Courants de la Pensee Economique,11,139,6,QROC,0.15,0.44,96.97,23,1,24,23,23,0,1.04,100.0,Facile,Facile,0,Meme Difficulte que la Prediction,Pas Adapte
3336,2018,Economie,1,L'Economie et son Domaine,2,Les Grands Courants de la Pensee Economique,11,139,6,QO,0.17,0.72,92.68,19,2,21,20,19,1,1.05,95.0,Facile,Facile,0,Meme Difficulte que la Prediction,Pas Adapte
4402,2019,Economie,1,L'Economie et son Domaine,2,Les Grands Courants de la Pensee Economique,11,139,6,QO,0.05,0.52,79.03,16,4,20,18,16,2,1.11,88.89,Facile,Facile,0,Meme Difficulte que la Prediction,Pas Adapte
5468,2020,Economie,1,L'Economie et son Domaine,2,Les Grands Courants de la Pensee Economique,11,139,6,QO,0.34,0.28,44.09,10,13,23,20,10,10,1.15,50.0,Moyen,Moyen,0,Meme Difficulte que la Prediction,Pas Adapte
139,2015,Economie,1,L'Economie et son Domaine,2,Les Grands Courants de la Pensee Economique,11,140,7,QCU,0.24,0.65,55.29,52,42,94,77,52,25,1.22,67.53,Difficile,Moyen,1,Plus Facile que la Prediction,Pas Adapte
1205,2016,Economie,1,L'Economie et son Domaine,2,Les Grands Courants de la Pensee Economique,11,140,7,QCU,0.1,0.81,98.27,100,2,102,101,100,1,1.01,99.01,Moyen,Facile,1,Plus Facile que la Prediction,Pas Adapte
2271,2017,Economie,1,L'Economie et son Domaine,2,Les Grands Courants de la Pensee Economique,11,140,7,QCU,0.02,0.81,65.27,57,30,87,76,57,19,1.14,75.0,Facile,Facile,0,Meme Difficulte que la Prediction,Adapte
3337,2018,Economie,1,L'Economie et son Domaine,2,Les Grands Courants de la Pensee Economique,11,140,7,QCU,0.09,0.8,65.27,55,30,85,76,55,21,1.12,72.37,Facile,Facile,0,Meme Difficulte que la Prediction,Adapte
4403,2019,Economie,1,L'Economie et son Domaine,2,Les Grands Courants de la Pensee Economique,11,140,7,QCU,0.0,0.78,65.27,63,33,96,64,63,1,1.5,98.44,Facile,Facile,0,Meme Difficulte que la Prediction,Adapte
5469,2020,Economie,1,L'Economie et son Domaine,2,Les Grands Courants de la Pensee Economique,11,140,7,QCU,0.02,0.84,65.27,67,35,102,85,67,18,1.2,78.82,Facile,Facile,0,Meme Difficulte que la Prediction,Adapte
140,2015,Economie,1,L'Economie et son Domaine,2,Les Grands Courants de la Pensee Economique,11,141,8,QCU,0.58,0.33,1.36,0,25,25,24,0,24,1.04,0.0,Difficile,Difficile,0,Meme Difficulte que la Prediction,Pas Adapte
1206,2016,Economie,1,L'Economie et son Domaine,2,Les Grands Courants de la Pensee Economique,11,141,8,QCU,0.74,0.22,22.18,6,23,29,17,6,11,1.71,35.29,Moyen,Difficile,-1,Plus Difficile que la Prediction,Pas Adapte
2272,2017,Economie,1,L'Economie et son Domaine,2,Les Grands Courants de la Pensee Economique,11,141,8,QCU,0.53,0.21,11.25,3,28,31,29,3,26,1.07,10.34,Difficile,Difficile,0,Meme Difficulte que la Prediction,Pas Adapte
3338,2018,Economie,1,L'Economie et son Domaine,2,Les Grands Courants de la Pensee Economique,11,141,8,QCU,0.07,0.92,90.86,26,3,29,28,26,2,1.04,92.86,Moyen,Facile,1,Plus Facile que la Prediction,Pas Adapte
4404,2019,Economie,1,L'Economie et son Domaine,2,Les Grands Courants de la Pensee Economique,11,141,8,QCU,0.49,0.33,9.61,3,24,27,24,3,21,1.12,12.5,Difficile,Difficile,0,Meme Difficulte que la Prediction,Pas Adapte
5470,2020,Economie,1,L'Economie et son Domaine,2,Les Grands Courants de la Pensee Economique,11,141,8,QCU,0.17,0.75,66.62,17,8,25,18,17,1,1.39,94.44,Moyen,Facile,1,Plus Facile que la Prediction,Adapte
141,2015,Economie,1,L'Economie et son Domaine,2,Les Grands Courants de la Pensee Economique,11,142,9,QCM,0.78,0.23,2.16,1,31,32,24,1,23,1.33,4.17,Difficile,Difficile,0,Meme Difficulte que la Prediction,Pas Adapte
1207,2016,Economie,1,L'Economie et son Domaine,2,Les Grands Courants de la Pensee Economique,11,142,9,QCM,0.26,0.36,40.16,12,19,31,17,12,5,1.82,70.59,Moyen,Moyen,0,Meme Difficulte que la Prediction,Pas Adapte
2273,2017,Economie,1,L'Economie et son Domaine,2,Les Grands Courants de la Pensee Economique,11,142,9,QCM,0.78,0.29,22.53,7,25,32,8,7,1,4.0,87.5,Difficile,Difficile,0,Meme Difficulte que la Prediction,Pas Adapte
3339,2018,Economie,1,L'Economie et son Domaine,2,Les Grands Courants de la Pensee Economique,11,142,9,QCM,0.14,0.77,69.77,21,9,30,30,21,9,1.0,70.0,Moyen,Facile,1,Plus Facile que la Prediction,Adapte
4405,2019,Economie,1,L'Economie et son Domaine,2,Les Grands Courants de la Pensee Economique,11,142,9,QCM,0.17,0.91,69.77,20,8,28,28,20,8,1.0,71.43,Facile,Facile,0,Meme Difficulte que la Prediction,Adapte
5471,2020,Economie,1,L'Economie et son Domaine,2,Les Grands Courants de la Pensee Economique,11,142,9,QCM,0.17,0.94,69.77,22,10,32,32,22,10,1.0,68.75,Facile,Facile,0,Meme Difficulte que la Prediction,Adapte
142,2015,Economie,1,L'Economie et son Domaine,2,Les Grands Courants de la Pensee Economique,11,143,10,QROC,0.14,0.58,80.47,52,13,65,58,52,6,1.12,89.66,Difficile,Facile,2,Beaucoup plus Facile que la Prediction,Pas Adapte
1208,2016,Economie,1,L'Economie et son Domaine,2,Les Grands Courants de la Pensee Economique,11,143,10,QCU,0.36,0.45,37.7,26,43,69,30,26,4,2.3,86.67,Difficile,Moyen,1,Plus Facile que la Prediction,Pas Adapte
2274,2017,Economie,1,L'Economie et son Domaine,2,Les Grands Courants de la Pensee Economique,11,143,10,QCM,0.11,0.76,98.71,67,1,68,68,67,1,1.0,98.53,Facile,Facile,0,Meme Difficulte que la Prediction,Pas Adapte
3340,2018,Economie,1,L'Economie et son Domaine,2,Les Grands Courants de la Pensee Economique,11,143,10,QCM,0.18,0.79,91.81,71,6,77,71,71,0,1.08,100.0,Facile,Facile,0,Meme Difficulte que la Prediction,Pas Adapte
4406,2019,Economie,1,L'Economie et son Domaine,2,Les Grands Courants de la Pensee Economique,11,143,10,QCM,0.66,0.23,3.28,3,86,89,45,3,42,1.98,6.67,Facile,Difficile,-2,Beaucoup plus Difficile que la Prediction,Pas Adapte
5472,2020,Economie,1,L'Economie et son Domaine,2,Les Grands Courants de la Pensee Economique,11,143,10,QCM,0.02,0.76,67.91,56,26,82,75,56,19,1.09,74.67,Facile,Facile,0,Meme Difficulte que la Prediction,Adapte
143,2015,Economie,1,L'Economie et son Domaine,2,Les Grands Courants de la Pensee Economique,11,144,11,QCU,0.61,0.32,2.02,1,49,50,35,1,34,1.43,2.86,Facile,Difficile,-2,Beaucoup plus Difficile que la Prediction,Pas Adapte
1209,2016,Economie,1,L'Economie et son Domaine,2,Les Grands Courants de la Pensee Economique,11,144,11,QCM,0.0,0.73,74.05,37,13,50,48,37,11,1.04,77.08,Moyen,Facile,1,Plus Facile que la Prediction,Adapte
2275,2017,Economie,1,L'Economie et son Domaine,2,Les Grands Courants de la Pensee Economique,11,144,11,QCM,0.07,0.99,74.05,41,14,55,47,41,6,1.17,87.23,Facile,Facile,0,Meme Difficulte que la Prediction,Adapte
3341,2018,Economie,1,L'Economie et son Domaine,2,Les Grands Courants de la Pensee Economique,11,144,11,QCM,0.06,0.84,74.05,37,13,50,43,37,6,1.16,86.05,Facile,Facile,0,Meme Difficulte que la Prediction,Adapte
4407,2019,Economie,1,L'Economie et son Domaine,2,Les Grands Courants de la Pensee Economique,11,144,11,QCU,0.08,0.84,74.05,36,12,48,46,36,10,1.04,78.26,Facile,Facile,0,Meme Difficulte que la Prediction,Adapte
5473,2020,Economie,1,L'Economie et son Domaine,2,Les Grands Courants de la Pensee Economique,11,144,11,QCU,0.18,0.77,74.05,35,12,47,39,35,4,1.21,89.74,Facile,Facile,0,Meme Difficulte que la Prediction,Adapte
144,2015,Economie,1,L'Economie et son Domaine,3,Modele d'Organisation de la Societe et Systeme Economique,7,145,1,QCM,0.56,0.17,22.2,18,64,82,61,18,43,1.34,29.51,Difficile,Difficile,0,Meme Difficulte que la Prediction,Pas Adapte
1210,2016,Economie,1,L'Economie et son Domaine,3,Modele d'Organisation de la Societe et Systeme Economique,7,145,1,QCM,0.07,0.88,88.03,75,10,85,77,75,2,1.1,97.4,Facile,Facile,0,Meme Difficulte que la Prediction,Pas Adapte
2276,2017,Economie,1,L'Economie et son Domaine,3,Modele d'Organisation de la Societe et Systeme Economique,7,145,1,QCM,0.23,0.42,47.44,39,44,83,50,39,11,1.66,78.0,Moyen,Moyen,0,Meme Difficulte que la Prediction,Pas Adapte
3342,2018,Economie,1,L'Economie et son Domaine,3,Modele d'Organisation de la Societe et Systeme Economique,7,145,1,QCU,0.15,0.76,89.28,68,8,76,74,68,6,1.03,91.89,Facile,Facile,0,Meme Difficulte que la Prediction,Pas Adapte
4408,2019,Economie,1,L'Economie et son Domaine,3,Modele d'Organisation de la Societe et Systeme Economique,7,145,1,QCU,0.02,0.83,94.05,64,4,68,68,64,4,1.0,94.12,Facile,Facile,0,Meme Difficulte que la Prediction,Pas Adapte
5474,2020,Economie,1,L'Economie et son Domaine,3,Modele d'Organisation de la Societe et Systeme Economique,7,145,1,QCM,0.48,0.45,54.97,41,34,75,74,41,33,1.01,55.41,Facile,Moyen,-1,Plus Difficile que la Prediction,Pas Adapte
145,2015,Economie,1,L'Economie et son Domaine,3,Modele d'Organisation de la Societe et Systeme Economique,7,146,2,QCU,0.39,0.52,57.61,5,4,9,6,5,1,1.5,83.33,Facile,Moyen,-1,Plus Difficile que la Prediction,Pas Adapte
1211,2016,Economie,1,L'Economie et son Domaine,3,Modele d'Organisation de la Societe et Systeme Economique,7,146,2,QCU,0.46,0.34,8.21,1,8,9,4,1,3,2.25,25.0,Difficile,Difficile,0,Meme Difficulte que la Prediction,Pas Adapte
2277,2017,Economie,1,L'Economie et son Domaine,3,Modele d'Organisation de la Societe et Systeme Economique,7,146,2,QCU,0.7,0.34,11.82,1,9,10,4,1,3,2.5,25.0,Difficile,Difficile,0,Meme Difficulte que la Prediction,Pas Adapte
3343,2018,Economie,1,L'Economie et son Domaine,3,Modele d'Organisation de la Societe et Systeme Economique,7,146,2,QCU,0.29,0.55,59.84,7,5,12,11,7,4,1.09,63.64,Facile,Moyen,-1,Plus Difficile que la Prediction,Pas Adapte
4409,2019,Economie,1,L'Economie et son Domaine,3,Modele d'Organisation de la Societe et Systeme Economique,7,146,2,QCU,0.51,0.32,7.64,1,10,11,6,1,5,1.83,16.67,Difficile,Difficile,0,Meme Difficulte que la Prediction,Pas Adapte
5475,2020,Economie,1,L'Economie et son Domaine,3,Modele d'Organisation de la Societe et Systeme Economique,7,146,2,QCU,0.03,0.81,89.7,12,1,13,13,12,1,1.0,92.31,Facile,Facile,0,Meme Difficulte que la Prediction,Pas Adapte
146,2015,Economie,1,L'Economie et son Domaine,3,Modele d'Organisation de la Societe et Systeme Economique,7,147,3,QCM,0.15,0.95,92.24,57,5,62,62,57,5,1.0,91.94,Moyen,Facile,1,Plus Facile que la Prediction,Pas Adapte
1212,2016,Economie,1,L'Economie et son Domaine,3,Modele d'Organisation de la Societe et Systeme Economique,7,147,3,QCM,0.27,0.41,51.47,30,29,59,49,30,19,1.2,61.22,Moyen,Moyen,0,Meme Difficulte que la Prediction,Pas Adapte
2278,2017,Economie,1,L'Economie et son Domaine,3,Modele d'Organisation de la Societe et Systeme Economique,7,147,3,QCM,0.24,0.41,37.73,22,37,59,50,22,28,1.18,44.0,Moyen,Moyen,0,Meme Difficulte que la Prediction,Pas Adapte
3344,2018,Economie,1,L'Economie et son Domaine,3,Modele d'Organisation de la Societe et Systeme Economique,7,147,3,QCM,0.01,0.97,66.32,40,21,61,54,40,14,1.13,74.07,Facile,Facile,0,Meme Difficulte que la Prediction,Adapte
4410,2019,Economie,1,L'Economie et son Domaine,3,Modele d'Organisation de la Societe et Systeme Economique,7,147,3,QCM,0.11,0.93,66.32,39,20,59,52,39,13,1.13,75.0,Facile,Facile,0,Meme Difficulte que la Prediction,Adapte
5476,2020,Economie,1,L'Economie et son Domaine,3,Modele d'Organisation de la Societe et Systeme Economique,7,147,3,QCM,0.14,0.81,66.32,38,19,57,52,38,14,1.1,73.08,Facile,Facile,0,Meme Difficulte que la Prediction,Adapte
147,2015,Economie,1,L'Economie et son Domaine,3,Modele d'Organisation de la Societe et Systeme Economique,7,148,4,QCM,0.68,0.18,19.84,11,42,53,39,11,28,1.36,28.21,Difficile,Difficile,0,Meme Difficulte que la Prediction,Pas Adapte
1213,2016,Economie,1,L'Economie et son Domaine,3,Modele d'Organisation de la Societe et Systeme Economique,7,148,4,QCM,0.25,0.47,65.0,38,21,59,48,38,10,1.23,79.17,Moyen,Moyen,0,Meme Difficulte que la Prediction,Adapte
2279,2017,Economie,1,L'Economie et son Domaine,3,Modele d'Organisation de la Societe et Systeme Economique,7,148,4,QCM,0.23,0.66,65.0,36,20,56,37,36,1,1.51,97.3,Moyen,Moyen,0,Meme Difficulte que la Prediction,Adapte
3345,2018,Economie,1,L'Economie et son Domaine,3,Modele d'Organisation de la Societe et Systeme Economique,7,148,4,QCM,0.29,0.55,65.0,35,19,54,43,35,8,1.26,81.4,Moyen,Moyen,0,Meme Difficulte que la Prediction,Adapte
4411,2019,Economie,1,L'Economie et son Domaine,3,Modele d'Organisation de la Societe et Systeme Economique,7,148,4,QCM,0.4,0.69,65.0,33,18,51,38,33,5,1.34,86.84,Moyen,Moyen,0,Meme Difficulte que la Prediction,Adapte
5477,2020,Economie,1,L'Economie et son Domaine,3,Modele d'Organisation de la Societe et Systeme Economique,7,148,4,QCM,0.45,0.49,65.0,38,21,59,40,38,2,1.48,95.0,Moyen,Moyen,0,Meme Difficulte que la Prediction,Adapte
148,2015,Economie,1,L'Economie et son Domaine,3,Modele d'Organisation de la Societe et Systeme Economique,7,149,5,QCU,0.02,0.98,71.62,34,14,48,41,34,7,1.17,82.93,Facile,Facile,0,Meme Difficulte que la Prediction,Adapte
1214,2016,Economie,1,L'Economie et son Domaine,3,Modele d'Organisation de la Societe et Systeme Economique,7,149,5,QCU,0.08,0.8,71.62,39,15,54,50,39,11,1.08,78.0,Facile,Facile,0,Meme Difficulte que la Prediction,Adapte
2280,2017,Economie,1,L'Economie et son Domaine,3,Modele d'Organisation de la Societe et Systeme Economique,7,149,5,QCM,0.16,0.8,71.62,42,17,59,51,42,9,1.16,82.35,Facile,Facile,0,Meme Difficulte que la Prediction,Adapte
3346,2018,Economie,1,L'Economie et son Domaine,3,Modele d'Organisation de la Societe et Systeme Economique,7,149,5,QCM,0.14,0.96,71.62,39,16,55,47,39,8,1.17,82.98,Facile,Facile,0,Meme Difficulte que la Prediction,Adapte
4412,2019,Economie,1,L'Economie et son Domaine,3,Modele d'Organisation de la Societe et Systeme Economique,7,149,5,QCM,0.14,0.92,71.62,37,15,52,50,37,13,1.04,74.0,Facile,Facile,0,Meme Difficulte que la Prediction,Adapte
5478,2020,Economie,1,L'Economie et son Domaine,3,Modele d'Organisation de la Societe et Systeme Economique,7,149,5,QO,0.13,0.92,71.62,34,14,48,45,34,11,1.07,75.56,Facile,Facile,0,Meme Difficulte que la Prediction,Adapte
149,2015,Economie,1,L'Economie et son Domaine,3,Modele d'Organisation de la Societe et Systeme Economique,7,150,6,QCU,0.14,0.8,90.75,46,5,51,47,46,1,1.09,97.87,Facile,Facile,0,Meme Difficulte que la Prediction,Pas Adapte
1215,2016,Economie,1,L'Economie et son Domaine,3,Modele d'Organisation de la Societe et Systeme Economique,7,150,6,QCU,0.2,0.94,81.79,42,9,51,44,42,2,1.16,95.45,Facile,Facile,0,Meme Difficulte que la Prediction,Pas Adapte
2281,2017,Economie,1,L'Economie et son Domaine,3,Modele d'Organisation de la Societe et Systeme Economique,7,150,6,QCU,0.12,0.98,66.4,37,19,56,47,37,10,1.19,78.72,Difficile,Facile,2,Beaucoup plus Facile que la Prediction,Adapte
3347,2018,Economie,1,L'Economie et son Domaine,3,Modele d'Organisation de la Societe et Systeme Economique,7,150,6,QCU,0.07,0.8,66.4,41,21,62,46,41,5,1.35,89.13,Facile,Facile,0,Meme Difficulte que la Prediction,Adapte
4413,2019,Economie,1,L'Economie et son Domaine,3,Modele d'Organisation de la Societe et Systeme Economique,7,150,6,QCU,0.05,0.88,66.4,43,22,65,65,43,22,1.0,66.15,Facile,Facile,0,Meme Difficulte que la Prediction,Adapte
5479,2020,Economie,1,L'Economie et son Domaine,3,Modele d'Organisation de la Societe et Systeme Economique,7,150,6,QCU,0.11,0.83,66.4,44,22,66,48,44,4,1.38,91.67,Facile,Facile,0,Meme Difficulte que la Prediction,Adapte
150,2015,Economie,1,L'Economie et son Domaine,3,Modele d'Organisation de la Societe et Systeme Economique,7,151,7,QCU,0.41,0.29,22.85,16,52,68,30,16,14,2.27,53.33,Difficile,Difficile,0,Meme Difficulte que la Prediction,Pas Adapte
1216,2016,Economie,1,L'Economie et son Domaine,3,Modele d'Organisation de la Societe et Systeme Economique,7,151,7,QCU,0.34,0.62,40.95,28,41,69,47,28,19,1.47,59.57,Moyen,Moyen,0,Meme Difficulte que la Prediction,Pas Adapte
2282,2017,Economie,1,L'Economie et son Domaine,3,Modele d'Organisation de la Societe et Systeme Economique,7,151,7,QCU,0.1,0.78,93.44,66,5,71,66,66,0,1.08,100.0,Facile,Facile,0,Meme Difficulte que la Prediction,Pas Adapte
3348,2018,Economie,1,L'Economie et son Domaine,3,Modele d'Organisation de la Societe et Systeme Economique,7,151,7,QCU,0.7,0.2,19.41,14,58,72,57,14,43,1.26,24.56,Difficile,Difficile,0,Meme Difficulte que la Prediction,Pas Adapte
4414,2019,Economie,1,L'Economie et son Domaine,3,Modele d'Organisation de la Societe et Systeme Economique,7,151,7,QCU,0.64,0.28,17.05,13,66,79,79,13,66,1.0,16.46,Difficile,Difficile,0,Meme Difficulte que la Prediction,Pas Adapte
5480,2020,Economie,1,L'Economie et son Domaine,3,Modele d'Organisation de la Societe et Systeme Economique,7,151,7,QCU,0.12,0.9,88.66,73,9,82,73,73,0,1.12,100.0,Facile,Facile,0,Meme Difficulte que la Prediction,Pas Adapte
151,2015,Economie,1,La Representation de l'Activite Economique: Le Circuit Economique,1,Les Agents Economiques et leurs Operations,3,152,1,QCM,0.03,0.71,68.61,55,25,80,66,55,11,1.21,83.33,Moyen,Facile,1,Plus Facile que la Prediction,Adapte
1217,2016,Economie,1,La Representation de l'Activite Economique: Le Circuit Economique,1,Les Agents Economiques et leurs Operations,3,152,1,QCM,0.04,0.9,68.61,54,24,78,77,54,23,1.01,70.13,Facile,Facile,0,Meme Difficulte que la Prediction,Adapte
2283,2017,Economie,1,La Representation de l'Activite Economique: Le Circuit Economique,1,Les Agents Economiques et leurs Operations,3,152,1,QCM,0.17,0.97,68.61,45,21,66,50,45,5,1.32,90.0,Facile,Facile,0,Meme Difficulte que la Prediction,Adapte
3349,2018,Economie,1,La Representation de l'Activite Economique: Le Circuit Economique,1,Les Agents Economiques et leurs Operations,3,152,1,QCM,0.19,0.71,68.61,49,22,71,67,49,18,1.06,73.13,Facile,Facile,0,Meme Difficulte que la Prediction,Adapte
4415,2019,Economie,1,La Representation de l'Activite Economique: Le Circuit Economique,1,Les Agents Economiques et leurs Operations,3,152,1,QCM,0.06,0.85,68.61,47,22,69,53,47,6,1.3,88.68,Facile,Facile,0,Meme Difficulte que la Prediction,Adapte
5481,2020,Economie,1,La Representation de l'Activite Economique: Le Circuit Economique,1,Les Agents Economiques et leurs Operations,3,152,1,QCM,0.01,0.84,68.61,47,22,69,49,47,2,1.41,95.92,Facile,Facile,0,Meme Difficulte que la Prediction,Adapte
152,2015,Economie,1,La Representation de l'Activite Economique: Le Circuit Economique,1,Les Agents Economiques et leurs Operations,3,153,2,QCM,0.1,0.72,68.27,17,8,25,23,17,6,1.09,73.91,Facile,Facile,0,Meme Difficulte que la Prediction,Adapte
1218,2016,Economie,1,La Representation de l'Activite Economique: Le Circuit Economique,1,Les Agents Economiques et leurs Operations,3,153,2,QCM,0.07,0.74,68.27,15,7,22,20,15,5,1.1,75.0,Facile,Facile,0,Meme Difficulte que la Prediction,Adapte
2284,2017,Economie,1,La Representation de l'Activite Economique: Le Circuit Economique,1,Les Agents Economiques et leurs Operations,3,153,2,QCM,0.19,0.88,68.27,13,6,19,17,13,4,1.12,76.47,Facile,Facile,0,Meme Difficulte que la Prediction,Adapte
3350,2018,Economie,1,La Representation de l'Activite Economique: Le Circuit Economique,1,Les Agents Economiques et leurs Operations,3,153,2,QCM,0.2,0.76,68.27,12,6,18,13,12,1,1.38,92.31,Facile,Facile,0,Meme Difficulte que la Prediction,Adapte
4416,2019,Economie,1,La Representation de l'Activite Economique: Le Circuit Economique,1,Les Agents Economiques et leurs Operations,3,153,2,QCM,0.03,0.88,68.27,12,6,18,15,12,3,1.2,80.0,Facile,Facile,0,Meme Difficulte que la Prediction,Adapte
5482,2020,Economie,1,La Representation de l'Activite Economique: Le Circuit Economique,1,Les Agents Economiques et leurs Operations,3,153,2,QCU,0.16,0.9,68.27,13,6,19,17,13,4,1.12,76.47,Facile,Facile,0,Meme Difficulte que la Prediction,Adapte
153,2015,Economie,1,La Representation de l'Activite Economique: Le Circuit Economique,1,Les Agents Economiques et leurs Operations,3,154,3,QCU,0.51,0.33,21.41,10,39,49,48,10,38,1.02,20.83,Difficile,Difficile,0,Meme Difficulte que la Prediction,Pas Adapte
1219,2016,Economie,1,La Representation de l'Activite Economique: Le Circuit Economique,1,Les Agents Economiques et leurs Operations,3,154,3,QCU,0.32,0.61,52.6,27,24,51,31,27,4,1.65,87.1,Moyen,Moyen,0,Meme Difficulte que la Prediction,Pas Adapte
2285,2017,Economie,1,La Representation de l'Activite Economique: Le Circuit Economique,1,Les Agents Economiques et leurs Operations,3,154,3,QCU,0.63,0.26,31.42,15,34,49,18,15,3,2.72,83.33,Moyen,Difficile,-1,Plus Difficile que la Prediction,Pas Adapte
3351,2018,Economie,1,La Representation de l'Activite Economique: Le Circuit Economique,1,Les Agents Economiques et leurs Operations,3,154,3,QCU,0.1,0.92,67.82,34,16,50,35,34,1,1.43,97.14,Difficile,Facile,2,Beaucoup plus Facile que la Prediction,Adapte
4417,2019,Economie,1,La Representation de l'Activite Economique: Le Circuit Economique,1,Les Agents Economiques et leurs Operations,3,154,3,QCU,0.03,0.94,67.82,28,14,42,33,28,5,1.27,84.85,Facile,Facile,0,Meme Difficulte que la Prediction,Adapte
5483,2020,Economie,1,La Representation de l'Activite Economique: Le Circuit Economique,1,Les Agents Economiques et leurs Operations,3,154,3,QCM,0.11,1.0,67.82,28,13,41,38,28,10,1.08,73.68,Facile,Facile,0,Meme Difficulte que la Prediction,Adapte
154,2015,Economie,1,La Representation de l'Activite Economique: Le Circuit Economique,2,Le Circuit Economique dans le Cadre National,12,155,1,QO,0.19,0.5,77.51,54,16,70,62,54,8,1.13,87.1,Facile,Facile,0,Meme Difficulte que la Prediction,Pas Adapte
1220,2016,Economie,1,La Representation de l'Activite Economique: Le Circuit Economique,2,Le Circuit Economique dans le Cadre National,12,155,1,QROC,0.61,0.22,32.49,22,47,69,45,22,23,1.53,48.89,Facile,Difficile,-2,Beaucoup plus Difficile que la Prediction,Pas Adapte
2286,2017,Economie,1,La Representation de l'Activite Economique: Le Circuit Economique,2,Le Circuit Economique dans le Cadre National,12,155,1,QROC,0.1,0.96,92.6,61,5,66,63,61,2,1.05,96.83,Facile,Facile,0,Meme Difficulte que la Prediction,Pas Adapte
3352,2018,Economie,1,La Representation de l'Activite Economique: Le Circuit Economique,2,Le Circuit Economique dans le Cadre National,12,155,1,QO,0.82,0.04,19.65,11,47,58,37,11,26,1.57,29.73,Moyen,Difficile,-1,Plus Difficile que la Prediction,Pas Adapte
4418,2019,Economie,1,La Representation de l'Activite Economique: Le Circuit Economique,2,Le Circuit Economique dans le Cadre National,12,155,1,QCU,0.28,0.52,38.69,23,36,59,31,23,8,1.9,74.19,Moyen,Moyen,0,Meme Difficulte que la Prediction,Pas Adapte
5484,2020,Economie,1,La Representation de l'Activite Economique: Le Circuit Economique,2,Le Circuit Economique dans le Cadre National,12,155,1,QCU,0.68,0.35,34.5,19,35,54,42,19,23,1.29,45.24,Difficile,Difficile,0,Meme Difficulte que la Prediction,Pas Adapte
155,2015,Economie,1,La Representation de l'Activite Economique: Le Circuit Economique,2,Le Circuit Economique dans le Cadre National,12,156,2,QCU,0.72,0.25,29.59,14,34,48,26,14,12,1.85,53.85,Difficile,Difficile,0,Meme Difficulte que la Prediction,Pas Adapte
1221,2016,Economie,1,La Representation de l'Activite Economique: Le Circuit Economique,2,Le Circuit Economique dans le Cadre National,12,156,2,QCU,0.24,0.72,61.43,28,17,45,33,28,5,1.36,84.85,Moyen,Moyen,0,Meme Difficulte que la Prediction,Adapte
2287,2017,Economie,1,La Representation de l'Activite Economique: Le Circuit Economique,2,Le Circuit Economique dans le Cadre National,12,156,2,QCU,0.2,0.62,61.43,30,19,49,31,30,1,1.58,96.77,Moyen,Moyen,0,Meme Difficulte que la Prediction,Adapte
3353,2018,Economie,1,La Representation de l'Activite Economique: Le Circuit Economique,2,Le Circuit Economique dans le Cadre National,12,156,2,QCU,0.28,0.66,61.43,31,19,50,37,31,6,1.35,83.78,Moyen,Moyen,0,Meme Difficulte que la Prediction,Adapte
4419,2019,Economie,1,La Representation de l'Activite Economique: Le Circuit Economique,2,Le Circuit Economique dans le Cadre National,12,156,2,QCU,0.31,0.44,61.43,29,18,47,44,29,15,1.07,65.91,Moyen,Moyen,0,Meme Difficulte que la Prediction,Adapte
5485,2020,Economie,1,La Representation de l'Activite Economique: Le Circuit Economique,2,Le Circuit Economique dans le Cadre National,12,156,2,QCU,0.29,0.72,61.43,25,15,40,35,25,10,1.14,71.43,Moyen,Moyen,0,Meme Difficulte que la Prediction,Adapte
156,2015,Economie,1,La Representation de l'Activite Economique: Le Circuit Economique,2,Le Circuit Economique dans le Cadre National,12,157,3,QROC,0.85,0.07,23.83,16,51,67,34,16,18,1.97,47.06,Difficile,Difficile,0,Meme Difficulte que la Prediction,Pas Adapte
1222,2016,Economie,1,La Representation de l'Activite Economique: Le Circuit Economique,2,Le Circuit Economique dans le Cadre National,12,157,3,QO,0.09,0.9,67.22,44,22,66,53,44,9,1.25,83.02,Facile,Facile,0,Meme Difficulte que la Prediction,Adapte
2288,2017,Economie,1,La Representation de l'Activite Economique: Le Circuit Economique,2,Le Circuit Economique dans le Cadre National,12,157,3,QO,0.05,0.56,67.22,46,23,69,69,46,23,1.0,66.67,Facile,Facile,0,Meme Difficulte que la Prediction,Adapte
3354,2018,Economie,1,La Representation de l'Activite Economique: Le Circuit Economique,2,Le Circuit Economique dans le Cadre National,12,157,3,QO,0.19,0.31,67.22,52,26,78,53,52,1,1.47,98.11,Facile,Facile,0,Meme Difficulte que la Prediction,Adapte
4420,2019,Economie,1,La Representation de l'Activite Economique: Le Circuit Economique,2,Le Circuit Economique dans le Cadre National,12,157,3,QO,0.16,0.72,67.22,54,26,80,58,54,4,1.38,93.1,Facile,Facile,0,Meme Difficulte que la Prediction,Adapte
5486,2020,Economie,1,La Representation de l'Activite Economique: Le Circuit Economique,2,Le Circuit Economique dans le Cadre National,12,157,3,QO,0.16,0.61,67.22,60,30,90,83,60,23,1.08,72.29,Facile,Facile,0,Meme Difficulte que la Prediction,Adapte
157,2015,Economie,1,La Representation de l'Activite Economique: Le Circuit Economique,2,Le Circuit Economique dans le Cadre National,12,158,4,QCU,0.73,0.21,22.61,19,65,84,80,19,61,1.05,23.75,Difficile,Difficile,0,Meme Difficulte que la Prediction,Pas Adapte
1223,2016,Economie,1,La Representation de l'Activite Economique: Le Circuit Economique,2,Le Circuit Economique dans le Cadre National,12,158,4,QCU,0.6,0.3,10.0,7,65,72,37,7,30,1.95,18.92,Difficile,Difficile,0,Meme Difficulte que la Prediction,Pas Adapte
2289,2017,Economie,1,La Representation de l'Activite Economique: Le Circuit Economique,2,Le Circuit Economique dans le Cadre National,12,158,4,QCU,0.07,0.76,87.42,63,9,72,68,63,5,1.06,92.65,Facile,Facile,0,Meme Difficulte que la Prediction,Pas Adapte
3355,2018,Economie,1,La Representation de l'Activite Economique: Le Circuit Economique,2,Le Circuit Economique dans le Cadre National,12,158,4,QCU,0.51,0.33,0.34,0,77,77,28,0,28,2.75,0.0,Facile,Difficile,-2,Beaucoup plus Difficile que la Prediction,Pas Adapte
4421,2019,Economie,1,La Representation de l'Activite Economique: Le Circuit Economique,2,Le Circuit Economique dans le Cadre National,12,158,4,QCU,0.17,0.94,92.71,78,6,84,78,78,0,1.08,100.0,Difficile,Facile,2,Beaucoup plus Facile que la Prediction,Pas Adapte
5487,2020,Economie,1,La Representation de l'Activite Economique: Le Circuit Economique,2,Le Circuit Economique dans le Cadre National,12,158,4,QCU,0.38,0.61,48.04,39,42,81,73,39,34,1.11,53.42,Difficile,Moyen,1,Plus Facile que la Prediction,Pas Adapte
158,2015,Economie,1,La Representation de l'Activite Economique: Le Circuit Economique,2,Le Circuit Economique dans le Cadre National,12,159,5,QCU,0.44,0.33,2.08,1,56,57,47,1,46,1.21,2.13,Difficile,Difficile,0,Meme Difficulte que la Prediction,Pas Adapte
1224,2016,Economie,1,La Representation de l'Activite Economique: Le Circuit Economique,2,Le Circuit Economique dans le Cadre National,12,159,5,QCM,0.63,0.3,9.64,6,52,58,28,6,22,2.07,21.43,Difficile,Difficile,0,Meme Difficulte que la Prediction,Pas Adapte
2290,2017,Economie,1,La Representation de l'Activite Economique: Le Circuit Economique,2,Le Circuit Economique dans le Cadre National,12,159,5,QCM,0.01,0.97,77.8,45,13,58,52,45,7,1.12,86.54,Facile,Facile,0,Meme Difficulte que la Prediction,Pas Adapte
3356,2018,Economie,1,La Representation de l'Activite Economique: Le Circuit Economique,2,Le Circuit Economique dans le Cadre National,12,159,5,QCM,0.4,0.4,60.94,34,21,55,37,34,3,1.49,91.89,Difficile,Moyen,1,Plus Facile que la Prediction,Adapte
4422,2019,Economie,1,La Representation de l'Activite Economique: Le Circuit Economique,2,Le Circuit Economique dans le Cadre National,12,159,5,QCM,0.2,0.64,60.94,36,23,59,42,36,6,1.4,85.71,Moyen,Moyen,0,Meme Difficulte que la Prediction,Adapte
5488,2020,Economie,1,La Representation de l'Activite Economique: Le Circuit Economique,2,Le Circuit Economique dans le Cadre National,12,159,5,QCM,0.25,0.48,60.94,31,20,51,44,31,13,1.16,70.45,Moyen,Moyen,0,Meme Difficulte que la Prediction,Adapte
159,2015,Economie,1,La Representation de l'Activite Economique: Le Circuit Economique,2,Le Circuit Economique dans le Cadre National,12,160,6,QROC,0.08,0.42,96.05,18,1,19,19,18,1,1.0,94.74,Facile,Facile,0,Meme Difficulte que la Prediction,Pas Adapte
1225,2016,Economie,1,La Representation de l'Activite Economique: Le Circuit Economique,2,Le Circuit Economique dans le Cadre National,12,160,6,QROC,0.14,0.69,69.63,15,6,21,18,15,3,1.17,83.33,Moyen,Facile,1,Plus Facile que la Prediction,Adapte
2291,2017,Economie,1,La Representation de l'Activite Economique: Le Circuit Economique,2,Le Circuit Economique dans le Cadre National,12,160,6,QROC,0.15,0.67,69.63,16,7,23,18,16,2,1.28,88.89,Facile,Facile,0,Meme Difficulte que la Prediction,Adapte
3357,2018,Economie,1,La Representation de l'Activite Economique: Le Circuit Economique,2,Le Circuit Economique dans le Cadre National,12,160,6,QROC,0.08,0.8,69.63,17,8,25,22,17,5,1.14,77.27,Facile,Facile,0,Meme Difficulte que la Prediction,Adapte
4423,2019,Economie,1,La Representation de l'Activite Economique: Le Circuit Economique,2,Le Circuit Economique dans le Cadre National,12,160,6,QROC,0.15,0.54,69.63,18,8,26,25,18,7,1.04,72.0,Facile,Facile,0,Meme Difficulte que la Prediction,Adapte
5489,2020,Economie,1,La Representation de l'Activite Economique: Le Circuit Economique,2,Le Circuit Economique dans le Cadre National,12,160,6,QO,0.02,0.81,69.63,16,7,23,17,16,1,1.35,94.12,Facile,Facile,0,Meme Difficulte que la Prediction,Adapte
160,2015,Economie,1,La Representation de l'Activite Economique: Le Circuit Economique,2,Le Circuit Economique dans le Cadre National,12,161,7,QCU,0.2,0.84,99.56,52,0,52,52,52,0,1.0,100.0,Facile,Facile,0,Meme Difficulte que la Prediction,Pas Adapte
1226,2016,Economie,1,La Representation de l'Activite Economique: Le Circuit Economique,2,Le Circuit Economique dans le Cadre National,12,161,7,QCU,0.28,0.58,61.36,36,23,59,57,36,21,1.04,63.16,Difficile,Moyen,1,Plus Facile que la Prediction,Adapte
2292,2017,Economie,1,La Representation de l'Activite Economique: Le Circuit Economique,2,Le Circuit Economique dans le Cadre National,12,161,7,QCU,0.29,0.49,61.36,37,24,61,40,37,3,1.52,92.5,Moyen,Moyen,0,Meme Difficulte que la Prediction,Adapte
3358,2018,Economie,1,La Representation de l'Activite Economique: Le Circuit Economique,2,Le Circuit Economique dans le Cadre National,12,161,7,QCU,0.36,0.45,61.36,38,24,62,59,38,21,1.05,64.41,Moyen,Moyen,0,Meme Difficulte que la Prediction,Adapte
4424,2019,Economie,1,La Representation de l'Activite Economique: Le Circuit Economique,2,Le Circuit Economique dans le Cadre National,12,161,7,QCM,0.39,0.52,61.36,35,22,57,55,35,20,1.04,63.64,Moyen,Moyen,0,Meme Difficulte que la Prediction,Adapte
5490,2020,Economie,1,La Representation de l'Activite Economique: Le Circuit Economique,2,Le Circuit Economique dans le Cadre National,12,161,7,QCM,0.35,0.41,61.36,31,20,51,45,31,14,1.13,68.89,Moyen,Moyen,0,Meme Difficulte que la Prediction,Adapte
161,2015,Economie,1,La Representation de l'Activite Economique: Le Circuit Economique,2,Le Circuit Economique dans le Cadre National,12,162,8,QCM,0.72,0.22,0.36,0,59,59,21,0,21,2.81,0.0,Difficile,Difficile,0,Meme Difficulte que la Prediction,Pas Adapte
1227,2016,Economie,1,La Representation de l'Activite Economique: Le Circuit Economique,2,Le Circuit Economique dans le Cadre National,12,162,8,QCM,0.13,0.76,80.8,53,12,65,58,53,5,1.12,91.38,Moyen,Facile,1,Plus Facile que la Prediction,Pas Adapte
2293,2017,Economie,1,La Representation de l'Activite Economique: Le Circuit Economique,2,Le Circuit Economique dans le Cadre National,12,162,8,QCM,0.64,0.23,13.49,8,48,56,36,8,28,1.56,22.22,Difficile,Difficile,0,Meme Difficulte que la Prediction,Pas Adapte
3359,2018,Economie,1,La Representation de l'Activite Economique: Le Circuit Economique,2,Le Circuit Economique dans le Cadre National,12,162,8,QCM,0.63,0.25,27.4,16,41,57,40,16,24,1.43,40.0,Facile,Difficile,-2,Beaucoup plus Difficile que la Prediction,Pas Adapte
4425,2019,Economie,1,La Representation de l'Activite Economique: Le Circuit Economique,2,Le Circuit Economique dans le Cadre National,12,162,8,QCM,0.28,0.68,59.81,35,23,58,56,35,21,1.04,62.5,Moyen,Moyen,0,Meme Difficulte que la Prediction,Pas Adapte
5491,2020,Economie,1,La Representation de l'Activite Economique: Le Circuit Economique,2,Le Circuit Economique dans le Cadre National,12,162,8,QCM,0.74,0.26,31.09,20,45,65,51,20,31,1.27,39.22,Facile,Difficile,-2,Beaucoup plus Difficile que la Prediction,Pas Adapte
162,2015,Economie,1,La Representation de l'Activite Economique: Le Circuit Economique,2,Le Circuit Economique dans le Cadre National,12,163,9,QCU,0.66,0.25,23.91,10,33,43,31,10,21,1.39,32.26,Difficile,Difficile,0,Meme Difficulte que la Prediction,Pas Adapte
1228,2016,Economie,1,La Representation de l'Activite Economique: Le Circuit Economique,2,Le Circuit Economique dans le Cadre National,12,163,9,QCU,0.01,0.95,98.2,36,1,37,37,36,1,1.0,97.3,Facile,Facile,0,Meme Difficulte que la Prediction,Pas Adapte
2294,2017,Economie,1,La Representation de l'Activite Economique: Le Circuit Economique,2,Le Circuit Economique dans le Cadre National,12,163,9,QCU,0.45,0.35,9.32,3,34,37,29,3,26,1.28,10.34,Difficile,Difficile,0,Meme Difficulte que la Prediction,Pas Adapte
3360,2018,Economie,1,La Representation de l'Activite Economique: Le Circuit Economique,2,Le Circuit Economique dans le Cadre National,12,163,9,QCU,0.03,0.78,82.77,31,6,37,31,31,0,1.19,100.0,Facile,Facile,0,Meme Difficulte que la Prediction,Pas Adapte
4426,2019,Economie,1,La Representation de l'Activite Economique: Le Circuit Economique,2,Le Circuit Economique dans le Cadre National,12,163,9,QCU,0.03,0.82,73.38,29,10,39,31,29,2,1.26,93.55,Difficile,Facile,2,Beaucoup plus Facile que la Prediction,Adapte
5492,2020,Economie,1,La Representation de l'Activite Economique: Le Circuit Economique,2,Le Circuit Economique dans le Cadre National,12,163,9,QCU,0.12,0.98,73.38,29,10,39,35,29,6,1.11,82.86,Facile,Facile,0,Meme Difficulte que la Prediction,Adapte
163,2015,Economie,1,La Representation de l'Activite Economique: Le Circuit Economique,2,Le Circuit Economique dans le Cadre National,12,164,10,QCU,0.46,0.25,33.65,10,19,29,25,10,15,1.16,40.0,Difficile,Difficile,0,Meme Difficulte que la Prediction,Pas Adapte
1229,2016,Economie,1,La Representation de l'Activite Economique: Le Circuit Economique,2,Le Circuit Economique dans le Cadre National,12,164,10,QCU,0.7,0.35,9.6,3,24,27,18,3,15,1.5,16.67,Difficile,Difficile,0,Meme Difficulte que la Prediction,Pas Adapte
2295,2017,Economie,1,La Representation de l'Activite Economique: Le Circuit Economique,2,Le Circuit Economique dans le Cadre National,12,164,10,QCU,0.48,0.38,7.17,2,24,26,14,2,12,1.86,14.29,Difficile,Difficile,0,Meme Difficulte que la Prediction,Pas Adapte
3361,2018,Economie,1,La Representation de l'Activite Economique: Le Circuit Economique,2,Le Circuit Economique dans le Cadre National,12,164,10,QCU,0.65,0.2,22.34,6,22,28,19,6,13,1.47,31.58,Difficile,Difficile,0,Meme Difficulte que la Prediction,Pas Adapte
4427,2019,Economie,1,La Representation de l'Activite Economique: Le Circuit Economique,2,Le Circuit Economique dans le Cadre National,12,164,10,QCU,0.68,0.3,10.65,3,22,25,25,3,22,1.0,12.0,Difficile,Difficile,0,Meme Difficulte que la Prediction,Pas Adapte
5493,2020,Economie,1,La Representation de l'Activite Economique: Le Circuit Economique,2,Le Circuit Economique dans le Cadre National,12,164,10,QCU,0.59,0.3,27.4,8,21,29,13,8,5,2.23,61.54,Difficile,Difficile,0,Meme Difficulte que la Prediction,Pas Adapte
164,2015,Economie,1,La Representation de l'Activite Economique: Le Circuit Economique,2,Le Circuit Economique dans le Cadre National,12,165,11,QCM,0.32,0.37,54.39,24,21,45,30,24,6,1.5,80.0,Difficile,Moyen,1,Plus Facile que la Prediction,Pas Adapte
1230,2016,Economie,1,La Representation de l'Activite Economique: Le Circuit Economique,2,Le Circuit Economique dans le Cadre National,12,165,11,QCM,0.1,0.87,72.22,36,14,50,38,36,2,1.32,94.74,Moyen,Facile,1,Plus Facile que la Prediction,Adapte
2296,2017,Economie,1,La Representation de l'Activite Economique: Le Circuit Economique,2,Le Circuit Economique dans le Cadre National,12,165,11,QCM,0.18,0.9,72.22,34,13,47,43,34,9,1.09,79.07,Facile,Facile,0,Meme Difficulte que la Prediction,Adapte
3362,2018,Economie,1,La Representation de l'Activite Economique: Le Circuit Economique,2,Le Circuit Economique dans le Cadre National,12,165,11,QCU,0.11,0.88,72.22,31,12,43,35,31,4,1.23,88.57,Facile,Facile,0,Meme Difficulte que la Prediction,Adapte
4428,2019,Economie,1,La Representation de l'Activite Economique: Le Circuit Economique,2,Le Circuit Economique dans le Cadre National,12,165,11,QROC,0.17,0.94,72.22,30,12,42,38,30,8,1.11,78.95,Facile,Facile,0,Meme Difficulte que la Prediction,Adapte
5494,2020,Economie,1,La Representation de l'Activite Economique: Le Circuit Economique,2,Le Circuit Economique dans le Cadre National,12,165,11,QROC,0.18,0.9,72.22,35,13,48,35,35,0,1.37,100.0,Facile,Facile,0,Meme Difficulte que la Prediction,Adapte
165,2015,Economie,1,La Representation de l'Activite Economique: Le Circuit Economique,2,Le Circuit Economique dans le Cadre National,12,166,12,QCM,0.6,0.3,1.0,1,62,63,59,1,58,1.07,1.69,Facile,Difficile,-2,Beaucoup plus Difficile que la Prediction,Pas Adapte
1231,2016,Economie,1,La Representation de l'Activite Economique: Le Circuit Economique,2,Le Circuit Economique dans le Cadre National,12,166,12,QCM,0.78,0.28,10.78,7,54,61,59,7,52,1.03,11.86,Facile,Difficile,-2,Beaucoup plus Difficile que la Prediction,Pas Adapte
2297,2017,Economie,1,La Representation de l'Activite Economique: Le Circuit Economique,2,Le Circuit Economique dans le Cadre National,12,166,12,QCM,0.16,0.87,74.88,43,14,57,46,43,3,1.24,93.48,Facile,Facile,0,Meme Difficulte que la Prediction,Adapte
3363,2018,Economie,1,La Representation de l'Activite Economique: Le Circuit Economique,2,Le Circuit Economique dans le Cadre National,12,166,12,QCM,0.16,0.88,74.88,37,12,49,40,37,3,1.23,92.5,Facile,Facile,0,Meme Difficulte que la Prediction,Adapte
4429,2019,Economie,1,La Representation de l'Activite Economique: Le Circuit Economique,2,Le Circuit Economique dans le Cadre National,12,166,12,QCU,0.02,0.9,74.88,37,12,49,40,37,3,1.23,92.5,Facile,Facile,0,Meme Difficulte que la Prediction,Adapte
5495,2020,Economie,1,La Representation de l'Activite Economique: Le Circuit Economique,2,Le Circuit Economique dans le Cadre National,12,166,12,QCU,0.08,0.81,74.88,34,11,45,36,34,2,1.25,94.44,Facile,Facile,0,Meme Difficulte que la Prediction,Adapte
166,2015,Economie,1,La Representation de l'Activite Economique: Le Circuit Economique,3,Les Interdependances Economiques entre les Nations,14,167,1,QCU,0.67,0.32,17.67,8,38,46,38,8,30,1.21,21.05,Facile,Difficile,-2,Beaucoup plus Difficile que la Prediction,Pas Adapte
1232,2016,Economie,1,La Representation de l'Activite Economique: Le Circuit Economique,3,Les Interdependances Economiques entre les Nations,14,167,1,QCU,0.61,0.23,31.17,15,32,47,37,15,22,1.27,40.54,Difficile,Difficile,0,Meme Difficulte que la Prediction,Pas Adapte
2298,2017,Economie,1,La Representation de l'Activite Economique: Le Circuit Economique,3,Les Interdependances Economiques entre les Nations,14,167,1,QCU,0.03,0.76,85.2,39,7,46,41,39,2,1.12,95.12,Facile,Facile,0,Meme Difficulte que la Prediction,Pas Adapte
3364,2018,Economie,1,La Representation de l'Activite Economique: Le Circuit Economique,3,Les Interdependances Economiques entre les Nations,14,167,1,QCU,0.31,0.63,54.62,22,19,41,40,22,18,1.02,55.0,Moyen,Moyen,0,Meme Difficulte que la Prediction,Pas Adapte
4430,2019,Economie,1,La Representation de l'Activite Economique: Le Circuit Economique,3,Les Interdependances Economiques entre les Nations,14,167,1,QCU,0.25,0.69,52.6,21,19,40,26,21,5,1.54,80.77,Facile,Moyen,-1,Plus Difficile que la Prediction,Pas Adapte
5496,2020,Economie,1,La Representation de l'Activite Economique: Le Circuit Economique,3,Les Interdependances Economiques entre les Nations,14,167,1,QCU,0.2,0.81,99.73,40,0,40,40,40,0,1.0,100.0,Facile,Facile,0,Meme Difficulte que la Prediction,Pas Adapte
167,2015,Economie,1,La Representation de l'Activite Economique: Le Circuit Economique,3,Les Interdependances Economiques entre les Nations,14,168,2,QCM,0.45,0.68,51.19,24,22,46,27,24,3,1.7,88.89,Moyen,Moyen,0,Meme Difficulte que la Prediction,Pas Adapte
1233,2016,Economie,1,La Representation de l'Activite Economique: Le Circuit Economique,3,Les Interdependances Economiques entre les Nations,14,168,2,QCM,0.64,0.3,17.75,9,44,53,16,9,7,3.31,56.25,Difficile,Difficile,0,Meme Difficulte que la Prediction,Pas Adapte
2299,2017,Economie,1,La Representation de l'Activite Economique: Le Circuit Economique,3,Les Interdependances Economiques entre les Nations,14,168,2,QROC,0.18,0.52,74.89,34,11,45,37,34,3,1.22,91.89,Difficile,Facile,2,Beaucoup plus Facile que la Prediction,Adapte
3365,2018,Economie,1,La Representation de l'Activite Economique: Le Circuit Economique,3,Les Interdependances Economiques entre les Nations,14,168,2,QROC,0.03,0.8,74.89,29,10,39,32,29,3,1.22,90.62,Facile,Facile,0,Meme Difficulte que la Prediction,Adapte
4431,2019,Economie,1,La Representation de l'Activite Economique: Le Circuit Economique,3,Les Interdependances Economiques entre les Nations,14,168,2,QROC,0.17,0.67,74.89,30,10,40,36,30,6,1.11,83.33,Facile,Facile,0,Meme Difficulte que la Prediction,Adapte
5497,2020,Economie,1,La Representation de l'Activite Economique: Le Circuit Economique,3,Les Interdependances Economiques entre les Nations,14,168,2,QROC,0.13,0.76,74.89,27,9,36,29,27,2,1.24,93.1,Facile,Facile,0,Meme Difficulte que la Prediction,Adapte
168,2015,Economie,1,La Representation de l'Activite Economique: Le Circuit Economique,3,Les Interdependances Economiques entre les Nations,14,169,3,QCU,0.02,0.81,81.52,24,5,29,29,24,5,1.0,82.76,Facile,Facile,0,Meme Difficulte que la Prediction,Pas Adapte
1234,2016,Economie,1,La Representation de l'Activite Economique: Le Circuit Economique,3,Les Interdependances Economiques entre les Nations,14,169,3,QCU,0.15,0.79,72.65,23,8,31,29,23,6,1.07,79.31,Facile,Facile,0,Meme Difficulte que la Prediction,Adapte
2300,2017,Economie,1,La Representation de l'Activite Economique: Le Circuit Economique,3,Les Interdependances Economiques entre les Nations,14,169,3,QCU,0.01,0.88,72.65,21,8,29,23,21,2,1.26,91.3,Facile,Facile,0,Meme Difficulte que la Prediction,Adapte
3366,2018,Economie,1,La Representation de l'Activite Economique: Le Circuit Economique,3,Les Interdependances Economiques entre les Nations,14,169,3,QCU,0.1,0.81,72.65,23,9,32,27,23,4,1.19,85.19,Facile,Facile,0,Meme Difficulte que la Prediction,Adapte
4432,2019,Economie,1,La Representation de l'Activite Economique: Le Circuit Economique,3,Les Interdependances Economiques entre les Nations,14,169,3,QCU,0.1,0.84,72.65,25,10,35,33,25,8,1.06,75.76,Facile,Facile,0,Meme Difficulte que la Prediction,Adapte
5498,2020,Economie,1,La Representation de l'Activite Economique: Le Circuit Economique,3,Les Interdependances Economiques entre les Nations,14,169,3,QCU,0.12,0.89,72.65,25,10,35,29,25,4,1.21,86.21,Facile,Facile,0,Meme Difficulte que la Prediction,Adapte
169,2015,Economie,1,La Representation de l'Activite Economique: Le Circuit Economique,3,Les Interdependances Economiques entre les Nations,14,170,4,QCM,0.51,0.17,15.63,7,38,45,24,7,17,1.88,29.17,Moyen,Difficile,-1,Plus Difficile que la Prediction,Pas Adapte
1235,2016,Economie,1,La Representation de l'Activite Economique: Le Circuit Economique,3,Les Interdependances Economiques entre les Nations,14,170,4,QCM,0.53,0.17,4.28,2,49,51,28,2,26,1.82,7.14,Moyen,Difficile,-1,Plus Difficile que la Prediction,Pas Adapte
2301,2017,Economie,1,La Representation de l'Activite Economique: Le Circuit Economique,3,Les Interdependances Economiques entre les Nations,14,170,4,QCM,0.63,0.23,1.76,1,52,53,27,1,26,1.96,3.7,Moyen,Difficile,-1,Plus Difficile que la Prediction,Pas Adapte
3367,2018,Economie,1,La Representation de l'Activite Economique: Le Circuit Economique,3,Les Interdependances Economiques entre les Nations,14,170,4,QCM,0.1,0.74,88.29,46,6,52,51,46,5,1.02,90.2,Facile,Facile,0,Meme Difficulte que la Prediction,Pas Adapte
4433,2019,Economie,1,La Representation de l'Activite Economique: Le Circuit Economique,3,Les Interdependances Economiques entre les Nations,14,170,4,QCM,0.46,0.45,64.5,34,18,52,51,34,17,1.02,66.67,Moyen,Moyen,0,Meme Difficulte que la Prediction,Adapte
5499,2020,Economie,1,La Representation de l'Activite Economique: Le Circuit Economique,3,Les Interdependances Economiques entre les Nations,14,170,4,QCM,0.48,0.69,64.5,35,20,55,43,35,8,1.28,81.4,Moyen,Moyen,0,Meme Difficulte que la Prediction,Adapte
170,2015,Economie,1,La Representation de l'Activite Economique: Le Circuit Economique,3,Les Interdependances Economiques entre les Nations,14,171,5,QCM,0.18,0.7,90.78,56,6,62,61,56,5,1.02,91.8,Facile,Facile,0,Meme Difficulte que la Prediction,Pas Adapte
1236,2016,Economie,1,La Representation de l'Activite Economique: Le Circuit Economique,3,Les Interdependances Economiques entre les Nations,14,171,5,QCM,0.65,0.24,7.54,5,58,63,16,5,11,3.94,31.25,Difficile,Difficile,0,Meme Difficulte que la Prediction,Pas Adapte
2302,2017,Economie,1,La Representation de l'Activite Economique: Le Circuit Economique,3,Les Interdependances Economiques entre les Nations,14,171,5,QCM,0.48,0.67,64.49,42,23,65,64,42,22,1.02,65.62,Difficile,Moyen,1,Plus Facile que la Prediction,Adapte
3368,2018,Economie,1,La Representation de l'Activite Economique: Le Circuit Economique,3,Les Interdependances Economiques entre les Nations,14,171,5,QCM,0.28,0.58,64.49,43,23,66,59,43,16,1.12,72.88,Moyen,Moyen,0,Meme Difficulte que la Prediction,Adapte
4434,2019,Economie,1,La Representation de l'Activite Economique: Le Circuit Economique,3,Les Interdependances Economiques entre les Nations,14,171,5,QCM,0.27,0.46,64.49,45,25,70,46,45,1,1.52,97.83,Moyen,Moyen,0,Meme Difficulte que la Prediction,Adapte
5500,2020,Economie,1,La Representation de l'Activite Economique: Le Circuit Economique,3,Les Interdependances Economiques entre les Nations,14,171,5,QCM,0.27,0.62,64.49,43,24,67,54,43,11,1.24,79.63,Moyen,Moyen,0,Meme Difficulte que la Prediction,Adapte
171,2015,Economie,1,La Representation de l'Activite Economique: Le Circuit Economique,3,Les Interdependances Economiques entre les Nations,14,172,6,QCU,0.01,0.81,99.97,72,0,72,72,72,0,1.0,100.0,Facile,Facile,0,Meme Difficulte que la Prediction,Pas Adapte
1237,2016,Economie,1,La Representation de l'Activite Economique: Le Circuit Economique,3,Les Interdependances Economiques entre les Nations,14,172,6,QCU,0.01,0.77,70.84,59,24,83,79,59,20,1.05,74.68,Facile,Facile,0,Meme Difficulte que la Prediction,Adapte
2303,2017,Economie,1,La Representation de l'Activite Economique: Le Circuit Economique,3,Les Interdependances Economiques entre les Nations,14,172,6,QCU,0.06,0.88,70.84,64,26,90,69,64,5,1.3,92.75,Facile,Facile,0,Meme Difficulte que la Prediction,Adapte
3369,2018,Economie,1,La Representation de l'Activite Economique: Le Circuit Economique,3,Les Interdependances Economiques entre les Nations,14,172,6,QCU,0.13,0.78,70.84,64,26,90,65,64,1,1.38,98.46,Facile,Facile,0,Meme Difficulte que la Prediction,Adapte
4435,2019,Economie,1,La Representation de l'Activite Economique: Le Circuit Economique,3,Les Interdependances Economiques entre les Nations,14,172,6,QCU,0.18,0.78,70.84,64,27,91,81,64,17,1.12,79.01,Facile,Facile,0,Meme Difficulte que la Prediction,Adapte
5501,2020,Economie,1,La Representation de l'Activite Economique: Le Circuit Economique,3,Les Interdependances Economiques entre les Nations,14,172,6,QCU,0.14,0.84,70.84,72,30,102,95,72,23,1.07,75.79,Facile,Facile,0,Meme Difficulte que la Prediction,Adapte
172,2015,Economie,1,La Representation de l'Activite Economique: Le Circuit Economique,3,Les Interdependances Economiques entre les Nations,14,173,7,QCM,0.03,0.72,87.16,44,6,50,49,44,5,1.02,89.8,Facile,Facile,0,Meme Difficulte que la Prediction,Pas Adapte
1238,2016,Economie,1,La Representation de l'Activite Economique: Le Circuit Economique,3,Les Interdependances Economiques entre les Nations,14,173,7,QCM,0.45,0.35,44.38,19,24,43,36,19,17,1.19,52.78,Moyen,Moyen,0,Meme Difficulte que la Prediction,Pas Adapte
2304,2017,Economie,1,La Representation de l'Activite Economique: Le Circuit Economique,3,Les Interdependances Economiques entre les Nations,14,173,7,QCM,0.59,0.21,20.27,10,38,48,17,10,7,2.82,58.82,Facile,Difficile,-2,Beaucoup plus Difficile que la Prediction,Pas Adapte
3370,2018,Economie,1,La Representation de l'Activite Economique: Le Circuit Economique,3,Les Interdependances Economiques entre les Nations,14,173,7,QCM,0.2,0.83,83.08,41,8,49,49,41,8,1.0,83.67,Moyen,Facile,1,Plus Facile que la Prediction,Pas Adapte
4436,2019,Economie,1,La Representation de l'Activite Economique: Le Circuit Economique,3,Les Interdependances Economiques entre les Nations,14,173,7,QCM,0.63,0.25,32.12,18,38,56,39,18,21,1.44,46.15,Facile,Difficile,-2,Beaucoup plus Difficile que la Prediction,Pas Adapte
5502,2020,Economie,1,La Representation de l'Activite Economique: Le Circuit Economique,3,Les Interdependances Economiques entre les Nations,14,173,7,QCM,0.21,0.4,51.73,32,29,61,34,32,2,1.79,94.12,Moyen,Moyen,0,Meme Difficulte que la Prediction,Pas Adapte
173,2015,Economie,1,La Representation de l'Activite Economique: Le Circuit Economique,3,Les Interdependances Economiques entre les Nations,14,174,8,QCU,0.04,0.89,86.42,38,6,44,40,38,2,1.1,95.0,Facile,Facile,0,Meme Difficulte que la Prediction,Pas Adapte
1239,2016,Economie,1,La Representation de l'Activite Economique: Le Circuit Economique,3,Les Interdependances Economiques entre les Nations,14,174,8,QCM,0.04,0.89,98.76,38,0,38,38,38,0,1.0,100.0,Facile,Facile,0,Meme Difficulte que la Prediction,Pas Adapte
2305,2017,Economie,1,La Representation de l'Activite Economique: Le Circuit Economique,3,Les Interdependances Economiques entre les Nations,14,174,8,QCM,0.39,0.43,43.25,15,19,34,23,15,8,1.48,65.22,Facile,Moyen,-1,Plus Difficile que la Prediction,Pas Adapte
3371,2018,Economie,1,La Representation de l'Activite Economique: Le Circuit Economique,3,Les Interdependances Economiques entre les Nations,14,174,8,QCM,0.03,0.78,96.22,38,1,39,39,38,1,1.0,97.44,Facile,Facile,0,Meme Difficulte que la Prediction,Pas Adapte
4437,2019,Economie,1,La Representation de l'Activite Economique: Le Circuit Economique,3,Les Interdependances Economiques entre les Nations,14,174,8,QCM,0.55,0.27,28.59,11,28,39,25,11,14,1.56,44.0,Difficile,Difficile,0,Meme Difficulte que la Prediction,Pas Adapte
5503,2020,Economie,1,La Representation de l'Activite Economique: Le Circuit Economique,3,Les Interdependances Economiques entre les Nations,14,174,8,QCM,0.15,0.87,95.61,33,1,34,33,33,0,1.03,100.0,Facile,Facile,0,Meme Difficulte que la Prediction,Pas Adapte
174,2015,Economie,1,La Representation de l'Activite Economique: Le Circuit Economique,3,Les Interdependances Economiques entre les Nations,14,175,9,QCU,0.59,0.21,24.57,9,27,36,24,9,15,1.5,37.5,Difficile,Difficile,0,Meme Difficulte que la Prediction,Pas Adapte
1240,2016,Economie,1,La Representation de l'Activite Economique: Le Circuit Economique,3,Les Interdependances Economiques entre les Nations,14,175,9,QCU,0.45,0.31,34.91,13,24,37,14,13,1,2.64,92.86,Difficile,Difficile,0,Meme Difficulte que la Prediction,Pas Adapte
2306,2017,Economie,1,La Representation de l'Activite Economique: Le Circuit Economique,3,Les Interdependances Economiques entre les Nations,14,175,9,QCU,0.46,0.4,3.12,1,37,38,27,1,26,1.41,3.7,Moyen,Difficile,-1,Plus Difficile que la Prediction,Pas Adapte
3372,2018,Economie,1,La Representation de l'Activite Economique: Le Circuit Economique,3,Les Interdependances Economiques entre les Nations,14,175,9,QCU,0.36,0.48,35.07,14,27,41,20,14,6,2.05,70.0,Moyen,Moyen,0,Meme Difficulte que la Prediction,Pas Adapte
4438,2019,Economie,1,La Representation de l'Activite Economique: Le Circuit Economique,3,Les Interdependances Economiques entre les Nations,14,175,9,QCU,0.46,0.32,32.1,14,29,43,41,14,27,1.05,34.15,Facile,Difficile,-2,Beaucoup plus Difficile que la Prediction,Pas Adapte
5504,2020,Economie,1,La Representation de l'Activite Economique: Le Circuit Economique,3,Les Interdependances Economiques entre les Nations,14,175,9,QCU,0.16,0.82,89.64,43,5,48,46,43,3,1.04,93.48,Difficile,Facile,2,Beaucoup plus Facile que la Prediction,Pas Adapte
175,2015,Economie,1,La Representation de l'Activite Economique: Le Circuit Economique,3,Les Interdependances Economiques entre les Nations,14,176,10,QCU,0.27,0.71,44.84,16,20,36,27,16,11,1.33,59.26,Facile,Moyen,-1,Plus Difficile que la Prediction,Pas Adapte
1241,2016,Economie,1,La Representation de l'Activite Economique: Le Circuit Economique,3,Les Interdependances Economiques entre les Nations,14,176,10,QCU,0.34,0.51,56.23,23,18,41,24,23,1,1.71,95.83,Difficile,Moyen,1,Plus Facile que la Prediction,Pas Adapte
2307,2017,Economie,1,La Representation de l'Activite Economique: Le Circuit Economique,3,Les Interdependances Economiques entre les Nations,14,176,10,QROC,0.65,0.1,14.51,7,40,47,29,7,22,1.62,24.14,Difficile,Difficile,0,Meme Difficulte que la Prediction,Pas Adapte
3373,2018,Economie,1,La Representation de l'Activite Economique: Le Circuit Economique,3,Les Interdependances Economiques entre les Nations,14,176,10,QROC,0.7,0.05,33.41,18,35,53,31,18,13,1.71,58.06,Facile,Difficile,-2,Beaucoup plus Difficile que la Prediction,Pas Adapte
4439,2019,Economie,1,La Representation de l'Activite Economique: Le Circuit Economique,3,Les Interdependances Economiques entre les Nations,14,176,10,QROC,0.01,0.65,97.19,45,1,46,46,45,1,1.0,97.83,Difficile,Facile,2,Beaucoup plus Facile que la Prediction,Pas Adapte
5505,2020,Economie,1,La Representation de l'Activite Economique: Le Circuit Economique,3,Les Interdependances Economiques entre les Nations,14,176,10,QROC,0.12,0.7,98.27,40,1,41,41,40,1,1.0,97.56,Facile,Facile,0,Meme Difficulte que la Prediction,Pas Adapte
176,2015,Economie,1,La Representation de l'Activite Economique: Le Circuit Economique,3,Les Interdependances Economiques entre les Nations,14,177,11,QCM,0.28,0.59,49.74,44,45,89,61,44,17,1.46,72.13,Moyen,Moyen,0,Meme Difficulte que la Prediction,Pas Adapte
1242,2016,Economie,1,La Representation de l'Activite Economique: Le Circuit Economique,3,Les Interdependances Economiques entre les Nations,14,177,11,QCU,0.17,0.98,76.62,61,19,80,73,61,12,1.1,83.56,Facile,Facile,0,Meme Difficulte que la Prediction,Pas Adapte
2308,2017,Economie,1,La Representation de l'Activite Economique: Le Circuit Economique,3,Les Interdependances Economiques entre les Nations,14,177,11,QCU,0.3,0.74,64.88,59,32,91,76,59,17,1.2,77.63,Moyen,Moyen,0,Meme Difficulte que la Prediction,Adapte
3374,2018,Economie,1,La Representation de l'Activite Economique: Le Circuit Economique,3,Les Interdependances Economiques entre les Nations,14,177,11,QCU,0.35,0.59,64.88,55,29,84,72,55,17,1.17,76.39,Moyen,Moyen,0,Meme Difficulte que la Prediction,Adapte
4440,2019,Economie,1,La Representation de l'Activite Economique: Le Circuit Economique,3,Les Interdependances Economiques entre les Nations,14,177,11,QCU,0.22,0.6,64.88,54,29,83,80,54,26,1.04,67.5,Moyen,Moyen,0,Meme Difficulte que la Prediction,Adapte
5506,2020,Economie,1,La Representation de l'Activite Economique: Le Circuit Economique,3,Les Interdependances Economiques entre les Nations,14,177,11,QCU,0.28,0.5,64.88,47,26,73,51,47,4,1.43,92.16,Moyen,Moyen,0,Meme Difficulte que la Prediction,Adapte
177,2015,Economie,1,La Representation de l'Activite Economique: Le Circuit Economique,3,Les Interdependances Economiques entre les Nations,14,178,12,QCM,0.52,0.3,7.02,5,63,68,48,5,43,1.42,10.42,Difficile,Difficile,0,Meme Difficulte que la Prediction,Pas Adapte
1243,2016,Economie,1,La Representation de l'Activite Economique: Le Circuit Economique,3,Les Interdependances Economiques entre les Nations,14,178,12,QCM,0.6,0.19,34.83,21,38,59,47,21,26,1.26,44.68,Difficile,Difficile,0,Meme Difficulte que la Prediction,Pas Adapte
2309,2017,Economie,1,La Representation de l'Activite Economique: Le Circuit Economique,3,Les Interdependances Economiques entre les Nations,14,178,12,QCM,0.54,0.22,28.49,18,46,64,43,18,25,1.49,41.86,Moyen,Difficile,-1,Plus Difficile que la Prediction,Pas Adapte
3375,2018,Economie,1,La Representation de l'Activite Economique: Le Circuit Economique,3,Les Interdependances Economiques entre les Nations,14,178,12,QCM,0.07,0.97,73.72,46,17,63,62,46,16,1.02,74.19,Facile,Facile,0,Meme Difficulte que la Prediction,Adapte
4441,2019,Economie,1,La Representation de l'Activite Economique: Le Circuit Economique,3,Les Interdependances Economiques entre les Nations,14,178,12,QCM,0.07,0.86,73.72,52,19,71,54,52,2,1.31,96.3,Facile,Facile,0,Meme Difficulte que la Prediction,Adapte
5507,2020,Economie,1,La Representation de l'Activite Economique: Le Circuit Economique,3,Les Interdependances Economiques entre les Nations,14,178,12,QCM,0.07,0.7,73.72,60,22,82,74,60,14,1.11,81.08,Facile,Facile,0,Meme Difficulte que la Prediction,Adapte
178,2015,Economie,1,La Representation de l'Activite Economique: Le Circuit Economique,3,Les Interdependances Economiques entre les Nations,14,179,13,QCM,0.58,0.3,9.85,9,82,91,60,9,51,1.52,15.0,Difficile,Difficile,0,Meme Difficulte que la Prediction,Pas Adapte
1244,2016,Economie,1,La Representation de l'Activite Economique: Le Circuit Economique,3,Les Interdependances Economiques entre les Nations,14,179,13,QCM,0.05,0.74,96.41,95,4,99,97,95,2,1.02,97.94,Facile,Facile,0,Meme Difficulte que la Prediction,Pas Adapte
2310,2017,Economie,1,La Representation de l'Activite Economique: Le Circuit Economique,3,Les Interdependances Economiques entre les Nations,14,179,13,QCM,0.26,0.35,53.85,50,42,92,91,50,41,1.01,54.95,Moyen,Moyen,0,Meme Difficulte que la Prediction,Pas Adapte
3376,2018,Economie,1,La Representation de l'Activite Economique: Le Circuit Economique,3,Les Interdependances Economiques entre les Nations,14,179,13,QCM,0.75,0.25,5.42,5,85,90,47,5,42,1.91,10.64,Difficile,Difficile,0,Meme Difficulte que la Prediction,Pas Adapte
4442,2019,Economie,1,La Representation de l'Activite Economique: Le Circuit Economique,3,Les Interdependances Economiques entre les Nations,14,179,13,QCM,0.02,0.73,82.75,79,17,96,94,79,15,1.02,84.04,Facile,Facile,0,Meme Difficulte que la Prediction,Pas Adapte
5508,2020,Economie,1,La Representation de l'Activite Economique: Le Circuit Economique,3,Les Interdependances Economiques entre les Nations,14,179,13,QCM,0.14,0.85,84.11,75,14,89,87,75,12,1.02,86.21,Difficile,Facile,2,Beaucoup plus Facile que la Prediction,Pas Adapte
179,2015,Economie,1,La Representation de l'Activite Economique: Le Circuit Economique,3,Les Interdependances Economiques entre les Nations,14,180,14,QROC,0.38,0.3,58.57,34,24,58,50,34,16,1.16,68.0,Moyen,Moyen,0,Meme Difficulte que la Prediction,Pas Adapte
1245,2016,Economie,1,La Representation de l'Activite Economique: Le Circuit Economique,3,Les Interdependances Economiques entre les Nations,14,180,14,QROC,0.03,0.61,86.9,51,8,59,57,51,6,1.04,89.47,Facile,Facile,0,Meme Difficulte que la Prediction,Pas Adapte
2311,2017,Economie,1,La Representation de l'Activite Economique: Le Circuit Economique,3,Les Interdependances Economiques entre les Nations,14,180,14,QROC,0.9,0.13,34.57,23,44,67,46,23,23,1.46,50.0,Facile,Difficile,-2,Beaucoup plus Difficile que la Prediction,Pas Adapte
3377,2018,Economie,1,La Representation de l'Activite Economique: Le Circuit Economique,3,Les Interdependances Economiques entre les Nations,14,180,14,QO,0.28,0.24,40.37,27,40,67,57,27,30,1.18,47.37,Difficile,Moyen,1,Plus Facile que la Prediction,Pas Adapte
4443,2019,Economie,1,La Representation de l'Activite Economique: Le Circuit Economique,3,Les Interdependances Economiques entre les Nations,14,180,14,QROC,0.91,0.06,18.51,14,62,76,36,14,22,2.11,38.89,Facile,Difficile,-2,Beaucoup plus Difficile que la Prediction,Pas Adapte
5509,2020,Economie,1,La Representation de l'Activite Economique: Le Circuit Economique,3,Les Interdependances Economiques entre les Nations,14,180,14,QROC,0.03,0.52,83.24,67,13,80,70,67,3,1.14,95.71,Facile,Facile,0,Meme Difficulte que la Prediction,Pas Adapte
180,2015,Economie,1,La Production,1,La Notion de Production,9,181,1,QROC,0.09,0.45,78.47,67,19,86,81,67,14,1.06,82.72,Facile,Facile,0,Meme Difficulte que la Prediction,Pas Adapte
1246,2016,Economie,1,La Production,1,La Notion de Production,9,181,1,QROC,0.87,0.05,27.66,21,56,77,37,21,16,2.08,56.76,Difficile,Difficile,0,Meme Difficulte que la Prediction,Pas Adapte
2312,2017,Economie,1,La Production,1,La Notion de Production,9,181,1,QROC,0.51,0.37,53.48,47,40,87,61,47,14,1.43,77.05,Moyen,Moyen,0,Meme Difficulte que la Prediction,Pas Adapte
3378,2018,Economie,1,La Production,1,La Notion de Production,9,181,1,QROC,0.95,0.06,32.73,28,59,87,39,28,11,2.23,71.79,Difficile,Difficile,0,Meme Difficulte que la Prediction,Pas Adapte
4444,2019,Economie,1,La Production,1,La Notion de Production,9,181,1,QO,0.15,0.74,94.0,88,6,94,93,88,5,1.01,94.62,Facile,Facile,0,Meme Difficulte que la Prediction,Pas Adapte
5510,2020,Economie,1,La Production,1,La Notion de Production,9,181,1,QROC,0.06,0.99,88.75,75,10,85,76,75,1,1.12,98.68,Difficile,Facile,2,Beaucoup plus Facile que la Prediction,Pas Adapte
181,2015,Economie,1,La Production,1,La Notion de Production,9,182,2,QCU,0.24,0.57,48.61,6,7,13,12,6,6,1.08,50.0,Moyen,Moyen,0,Meme Difficulte que la Prediction,Pas Adapte
1247,2016,Economie,1,La Production,1,La Notion de Production,9,182,2,QCU,0.25,0.63,44.2,7,8,15,12,7,5,1.25,58.33,Moyen,Moyen,0,Meme Difficulte que la Prediction,Pas Adapte
2313,2017,Economie,1,La Production,1,La Notion de Production,9,182,2,QCU,0.51,0.38,24.57,4,12,16,6,4,2,2.67,66.67,Difficile,Difficile,0,Meme Difficulte que la Prediction,Pas Adapte
3379,2018,Economie,1,La Production,1,La Notion de Production,9,182,2,QCU,0.31,0.41,51.23,8,8,16,15,8,7,1.07,53.33,Difficile,Moyen,1,Plus Facile que la Prediction,Pas Adapte
4445,2019,Economie,1,La Production,1,La Notion de Production,9,182,2,QCU,0.59,0.39,22.17,3,12,15,13,3,10,1.15,23.08,Difficile,Difficile,0,Meme Difficulte que la Prediction,Pas Adapte
5511,2020,Economie,1,La Production,1,La Notion de Production,9,182,2,QCU,0.18,0.75,96.78,15,0,15,15,15,0,1.0,100.0,Facile,Facile,0,Meme Difficulte que la Prediction,Pas Adapte
182,2015,Economie,1,La Production,1,La Notion de Production,9,183,3,QCU,0.26,0.62,51.76,20,19,39,25,20,5,1.56,80.0,Facile,Moyen,-1,Plus Difficile que la Prediction,Pas Adapte
1248,2016,Economie,1,La Production,1,La Notion de Production,9,183,3,QCU,0.12,0.97,77.14,29,8,37,34,29,5,1.09,85.29,Facile,Facile,0,Meme Difficulte que la Prediction,Pas Adapte
2314,2017,Economie,1,La Production,1,La Notion de Production,9,183,3,QCU,0.19,0.89,83.99,34,6,40,39,34,5,1.03,87.18,Difficile,Facile,2,Beaucoup plus Facile que la Prediction,Pas Adapte
3380,2018,Economie,1,La Production,1,La Notion de Production,9,183,3,QCM,0.09,0.9,94.1,34,2,36,34,34,0,1.06,100.0,Difficile,Facile,2,Beaucoup plus Facile que la Prediction,Pas Adapte
4446,2019,Economie,1,La Production,1,La Notion de Production,9,183,3,QCU,0.09,0.81,91.36,31,3,34,32,31,1,1.06,96.88,Facile,Facile,0,Meme Difficulte que la Prediction,Pas Adapte
5512,2020,Economie,1,La Production,1,La Notion de Production,9,183,3,QCU,0.62,0.21,26.08,8,23,31,18,8,10,1.72,44.44,Moyen,Difficile,-1,Plus Difficile que la Prediction,Pas Adapte
183,2015,Economie,1,La Production,1,La Notion de Production,9,184,4,QROC,0.36,0.31,58.24,19,14,33,26,19,7,1.27,73.08,Difficile,Moyen,1,Plus Facile que la Prediction,Pas Adapte
1249,2016,Economie,1,La Production,1,La Notion de Production,9,184,4,QO,0.05,0.7,88.85,28,3,31,29,28,1,1.07,96.55,Facile,Facile,0,Meme Difficulte que la Prediction,Pas Adapte
2315,2017,Economie,1,La Production,1,La Notion de Production,9,184,4,QCM,0.66,0.29,28.15,7,19,26,17,7,10,1.53,41.18,Difficile,Difficile,0,Meme Difficulte que la Prediction,Pas Adapte
3381,2018,Economie,1,La Production,1,La Notion de Production,9,184,4,QCM,0.0,0.91,91.17,21,2,23,21,21,0,1.1,100.0,Facile,Facile,0,Meme Difficulte que la Prediction,Pas Adapte
4447,2019,Economie,1,La Production,1,La Notion de Production,9,184,4,QCM,0.77,0.24,10.02,3,22,25,11,3,8,2.27,27.27,Difficile,Difficile,0,Meme Difficulte que la Prediction,Pas Adapte
5513,2020,Economie,1,La Production,1,La Notion de Production,9,184,4,QCU,0.26,0.61,56.42,13,10,23,18,13,5,1.28,72.22,Difficile,Moyen,1,Plus Facile que la Prediction,Pas Adapte
184,2015,Economie,1,La Production,1,La Notion de Production,9,185,5,QCM,0.08,0.87,91.94,6,0,6,6,6,0,1.0,100.0,Facile,Facile,0,Meme Difficulte que la Prediction,Pas Adapte
1250,2016,Economie,1,La Production,1,La Notion de Production,9,185,5,QCM,0.01,0.73,80.86,5,1,6,6,5,1,1.0,83.33,Facile,Facile,0,Meme Difficulte que la Prediction,Pas Adapte
2316,2017,Economie,1,La Production,1,La Notion de Production,9,185,5,QCM,0.79,0.27,11.41,1,5,6,6,1,5,1.0,16.67,Moyen,Difficile,-1,Plus Difficile que la Prediction,Pas Adapte
3382,2018,Economie,1,La Production,1,La Notion de Production,9,185,5,QROC,0.7,0.11,4.22,0,7,7,3,0,3,2.33,0.0,Difficile,Difficile,0,Meme Difficulte que la Prediction,Pas Adapte
4448,2019,Economie,1,La Production,1,La Notion de Production,9,185,5,QROC,0.83,0.19,32.78,2,5,7,6,2,4,1.17,33.33,Difficile,Difficile,0,Meme Difficulte que la Prediction,Pas Adapte
5514,2020,Economie,1,La Production,1,La Notion de Production,9,185,5,QROC,0.29,0.32,38.06,3,4,7,5,3,2,1.4,60.0,Moyen,Moyen,0,Meme Difficulte que la Prediction,Pas Adapte
185,2015,Economie,1,La Production,1,La Notion de Production,9,186,6,QCM,0.09,0.92,96.85,47,2,49,48,47,1,1.02,97.92,Difficile,Facile,2,Beaucoup plus Facile que la Prediction,Pas Adapte
1251,2016,Economie,1,La Production,1,La Notion de Production,9,186,6,QCM,0.35,0.68,41.83,21,30,51,44,21,23,1.16,47.73,Moyen,Moyen,0,Meme Difficulte que la Prediction,Pas Adapte
2317,2017,Economie,1,La Production,1,La Notion de Production,9,186,6,QCM,0.29,0.39,56.59,29,23,52,47,29,18,1.11,61.7,Difficile,Moyen,1,Plus Facile que la Prediction,Pas Adapte
3383,2018,Economie,1,La Production,1,La Notion de Production,9,186,6,QROC,0.13,0.87,81.62,36,8,44,42,36,6,1.05,85.71,Facile,Facile,0,Meme Difficulte que la Prediction,Pas Adapte
4449,2019,Economie,1,La Production,1,La Notion de Production,9,186,6,QROC,0.18,0.45,97.59,36,1,37,36,36,0,1.03,100.0,Facile,Facile,0,Meme Difficulte que la Prediction,Pas Adapte
5515,2020,Economie,1,La Production,1,La Notion de Production,9,186,6,QROC,0.04,0.78,91.97,34,3,37,34,34,0,1.09,100.0,Difficile,Facile,2,Beaucoup plus Facile que la Prediction,Pas Adapte
186,2015,Economie,1,La Production,1,La Notion de Production,9,187,7,QCU,0.63,0.32,2.06,2,94,96,58,2,56,1.66,3.45,Difficile,Difficile,0,Meme Difficulte que la Prediction,Pas Adapte
1252,2016,Economie,1,La Production,1,La Notion de Production,9,187,7,QCU,0.69,0.29,27.46,27,72,99,72,27,45,1.38,37.5,Difficile,Difficile,0,Meme Difficulte que la Prediction,Pas Adapte
2318,2017,Economie,1,La Production,1,La Notion de Production,9,187,7,QCU,0.12,0.95,99.32,109,1,110,109,109,0,1.01,100.0,Facile,Facile,0,Meme Difficulte que la Prediction,Pas Adapte
3384,2018,Economie,1,La Production,1,La Notion de Production,9,187,7,QCM,0.67,0.26,10.13,11,99,110,34,11,23,3.24,32.35,Difficile,Difficile,0,Meme Difficulte que la Prediction,Pas Adapte
4450,2019,Economie,1,La Production,1,La Notion de Production,9,187,7,QCM,0.38,0.42,35.72,44,80,124,47,44,3,2.64,93.62,Moyen,Moyen,0,Meme Difficulte que la Prediction,Pas Adapte
5516,2020,Economie,1,La Production,1,La Notion de Production,9,187,7,QCM,0.07,0.91,86.8,119,18,137,132,119,13,1.04,90.15,Moyen,Facile,1,Plus Facile que la Prediction,Pas Adapte
187,2015,Economie,1,La Production,1,La Notion de Production,9,188,8,QCU,0.29,0.68,43.36,10,12,22,18,10,8,1.22,55.56,Moyen,Moyen,0,Meme Difficulte que la Prediction,Pas Adapte
1253,2016,Economie,1,La Production,1,La Notion de Production,9,188,8,QROC,0.23,0.27,43.14,9,11,20,19,9,10,1.05,47.37,Moyen,Moyen,0,Meme Difficulte que la Prediction,Pas Adapte
2319,2017,Economie,1,La Production,1,La Notion de Production,9,188,8,QROC,0.84,0.15,27.46,6,15,21,15,6,9,1.4,40.0,Facile,Difficile,-2,Beaucoup plus Difficile que la Prediction,Pas Adapte
3385,2018,Economie,1,La Production,1,La Notion de Production,9,188,8,QROC,0.37,0.31,40.58,9,13,22,10,9,1,2.2,90.0,Difficile,Moyen,1,Plus Facile que la Prediction,Pas Adapte
4451,2019,Economie,1,La Production,1,La Notion de Production,9,188,8,QROC,0.26,0.25,50.78,12,12,24,14,12,2,1.71,85.71,Moyen,Moyen,0,Meme Difficulte que la Prediction,Pas Adapte
5517,2020,Economie,1,La Production,1,La Notion de Production,9,188,8,QROC,0.92,0.12,12.54,3,24,27,15,3,12,1.8,20.0,Difficile,Difficile,0,Meme Difficulte que la Prediction,Pas Adapte
188,2015,Economie,1,La Production,1,La Notion de Production,9,189,9,QCM,0.63,0.28,25.5,24,70,94,40,24,16,2.35,60.0,Difficile,Difficile,0,Meme Difficulte que la Prediction,Pas Adapte
1254,2016,Economie,1,La Production,1,La Notion de Production,9,189,9,QCM,0.41,0.61,59.29,49,34,83,52,49,3,1.6,94.23,Moyen,Moyen,0,Meme Difficulte que la Prediction,Pas Adapte
2320,2017,Economie,1,La Production,1,La Notion de Production,9,189,9,QCM,0.07,0.74,71.76,65,26,91,81,65,16,1.12,80.25,Facile,Facile,0,Meme Difficulte que la Prediction,Adapte
3386,2018,Economie,1,La Production,1,La Notion de Production,9,189,9,QCM,0.16,0.76,71.76,60,24,84,81,60,21,1.04,74.07,Facile,Facile,0,Meme Difficulte que la Prediction,Adapte
4452,2019,Economie,1,La Production,1,La Notion de Production,9,189,9,QCM,0.12,0.93,71.76,58,23,81,79,58,21,1.03,73.42,Facile,Facile,0,Meme Difficulte que la Prediction,Adapte
5518,2020,Economie,1,La Production,1,La Notion de Production,9,189,9,QROC,0.1,1.0,71.76,62,25,87,83,62,21,1.05,74.7,Facile,Facile,0,Meme Difficulte que la Prediction,Adapte
189,2015,Economie,1,La Production,2,L'Importance de la Production Marchande et de la Production Non-Marchande,5,190,1,QCU,0.26,0.67,50.7,10,10,20,10,10,0,2.0,100.0,Facile,Moyen,-1,Plus Difficile que la Prediction,Pas Adapte
1255,2016,Economie,1,La Production,2,L'Importance de la Production Marchande et de la Production Non-Marchande,5,190,1,QCU,0.42,0.24,16.55,4,18,22,13,4,9,1.69,30.77,Difficile,Difficile,0,Meme Difficulte que la Prediction,Pas Adapte
2321,2017,Economie,1,La Production,2,L'Importance de la Production Marchande et de la Production Non-Marchande,5,190,1,QCU,0.3,0.66,46.09,11,13,24,13,11,2,1.85,84.62,Facile,Moyen,-1,Plus Difficile que la Prediction,Pas Adapte
3387,2018,Economie,1,La Production,2,L'Importance de la Production Marchande et de la Production Non-Marchande,5,190,1,QCU,0.57,0.31,15.8,3,18,21,16,3,13,1.31,18.75,Facile,Difficile,-2,Beaucoup plus Difficile que la Prediction,Pas Adapte
4453,2019,Economie,1,La Production,2,L'Importance de la Production Marchande et de la Production Non-Marchande,5,190,1,QCU,0.12,0.93,91.02,16,2,18,17,16,1,1.06,94.12,Facile,Facile,0,Meme Difficulte que la Prediction,Pas Adapte
5519,2020,Economie,1,La Production,2,L'Importance de la Production Marchande et de la Production Non-Marchande,5,190,1,QCU,0.22,0.47,46.15,9,10,19,9,9,0,2.11,100.0,Moyen,Moyen,0,Meme Difficulte que la Prediction,Pas Adapte
190,2015,Economie,1,La Production,2,L'Importance de la Production Marchande et de la Production Non-Marchande,5,191,2,QCM,0.4,0.59,56.67,50,39,89,51,50,1,1.75,98.04,Moyen,Moyen,0,Meme Difficulte que la Prediction,Pas Adapte
1256,2016,Economie,1,La Production,2,L'Importance de la Production Marchande et de la Production Non-Marchande,5,191,2,QCM,0.19,0.73,76.5,68,21,89,70,68,2,1.27,97.14,Facile,Facile,0,Meme Difficulte que la Prediction,Pas Adapte
2322,2017,Economie,1,La Production,2,L'Importance de la Production Marchande et de la Production Non-Marchande,5,191,2,QCM,0.08,0.77,79.64,75,19,94,87,75,12,1.08,86.21,Facile,Facile,0,Meme Difficulte que la Prediction,Pas Adapte
3388,2018,Economie,1,La Production,2,L'Importance de la Production Marchande et de la Production Non-Marchande,5,191,2,QCM,0.47,0.54,44.45,46,57,103,47,46,1,2.19,97.87,Moyen,Moyen,0,Meme Difficulte que la Prediction,Pas Adapte
4454,2019,Economie,1,La Production,2,L'Importance de la Production Marchande et de la Production Non-Marchande,5,191,2,QCM,0.55,0.16,15.35,18,96,114,107,18,89,1.07,16.82,Moyen,Difficile,-1,Plus Difficile que la Prediction,Pas Adapte
5520,2020,Economie,1,La Production,2,L'Importance de la Production Marchande et de la Production Non-Marchande,5,191,2,QCM,0.42,0.37,44.7,50,61,111,98,50,48,1.13,51.02,Moyen,Moyen,0,Meme Difficulte que la Prediction,Pas Adapte
191,2015,Economie,1,La Production,2,L'Importance de la Production Marchande et de la Production Non-Marchande,5,192,3,QCU,0.33,0.58,53.04,44,39,83,62,44,18,1.34,70.97,Moyen,Moyen,0,Meme Difficulte que la Prediction,Pas Adapte
1257,2016,Economie,1,La Production,2,L'Importance de la Production Marchande et de la Production Non-Marchande,5,192,3,QCU,0.53,0.37,0.01,0,86,86,74,0,74,1.16,0.0,Difficile,Difficile,0,Meme Difficulte que la Prediction,Pas Adapte
2323,2017,Economie,1,La Production,2,L'Importance de la Production Marchande et de la Production Non-Marchande,5,192,3,QCU,0.63,0.23,6.71,5,68,73,53,5,48,1.38,9.43,Facile,Difficile,-2,Beaucoup plus Difficile que la Prediction,Pas Adapte
3389,2018,Economie,1,La Production,2,L'Importance de la Production Marchande et de la Production Non-Marchande,5,192,3,QCU,0.3,0.52,47.43,38,43,81,59,38,21,1.37,64.41,Facile,Moyen,-1,Plus Difficile que la Prediction,Pas Adapte
4455,2019,Economie,1,La Production,2,L'Importance de la Production Marchande et de la Production Non-Marchande,5,192,3,QCU,0.73,0.26,31.74,26,56,82,34,26,8,2.41,76.47,Facile,Difficile,-2,Beaucoup plus Difficile que la Prediction,Pas Adapte
5521,2020,Economie,1,La Production,2,L'Importance de la Production Marchande et de la Production Non-Marchande,5,192,3,QCU,0.19,0.85,99.24,82,1,83,82,82,0,1.01,100.0,Facile,Facile,0,Meme Difficulte que la Prediction,Pas Adapte
192,2015,Economie,1,La Production,2,L'Importance de la Production Marchande et de la Production Non-Marchande,5,193,4,QCM,0.26,0.43,41.1,33,48,81,48,33,15,1.69,68.75,Moyen,Moyen,0,Meme Difficulte que la Prediction,Pas Adapte
1258,2016,Economie,1,La Production,2,L'Importance de la Production Marchande et de la Production Non-Marchande,5,193,4,QCM,0.38,0.44,58.27,49,35,84,70,49,21,1.2,70.0,Difficile,Moyen,1,Plus Facile que la Prediction,Pas Adapte
2324,2017,Economie,1,La Production,2,L'Importance de la Production Marchande et de la Production Non-Marchande,5,193,4,QCM,0.08,0.79,67.15,52,25,77,63,52,11,1.22,82.54,Facile,Facile,0,Meme Difficulte que la Prediction,Adapte
3390,2018,Economie,1,La Production,2,L'Importance de la Production Marchande et de la Production Non-Marchande,5,193,4,QCM,0.06,0.73,67.15,58,28,86,77,58,19,1.12,75.32,Facile,Facile,0,Meme Difficulte que la Prediction,Adapte
4456,2019,Economie,1,La Production,2,L'Importance de la Production Marchande et de la Production Non-Marchande,5,193,4,QCM,0.03,0.76,67.15,58,28,86,82,58,24,1.05,70.73,Facile,Facile,0,Meme Difficulte que la Prediction,Adapte
5522,2020,Economie,1,La Production,2,L'Importance de la Production Marchande et de la Production Non-Marchande,5,193,4,QCM,0.05,0.93,67.15,54,26,80,77,54,23,1.04,70.13,Facile,Facile,0,Meme Difficulte que la Prediction,Adapte
193,2015,Economie,1,La Production,2,L'Importance de la Production Marchande et de la Production Non-Marchande,5,194,5,QROC,0.67,0.23,22.33,18,61,79,45,18,27,1.76,40.0,Difficile,Difficile,0,Meme Difficulte que la Prediction,Pas Adapte
1259,2016,Economie,1,La Production,2,L'Importance de la Production Marchande et de la Production Non-Marchande,5,194,5,QROC,0.65,0.03,33.55,23,45,68,28,23,5,2.43,82.14,Difficile,Difficile,0,Meme Difficulte que la Prediction,Pas Adapte
2325,2017,Economie,1,La Production,2,L'Importance de la Production Marchande et de la Production Non-Marchande,5,194,5,QROC,0.53,0.32,53.42,35,31,66,58,35,23,1.14,60.34,Facile,Moyen,-1,Plus Difficile que la Prediction,Pas Adapte
3391,2018,Economie,1,La Production,2,L'Importance de la Production Marchande et de la Production Non-Marchande,5,194,5,QROC,0.61,0.08,13.04,8,52,60,32,8,24,1.88,25.0,Moyen,Difficile,-1,Plus Difficile que la Prediction,Pas Adapte
4457,2019,Economie,1,La Production,2,L'Importance de la Production Marchande et de la Production Non-Marchande,5,194,5,QROC,0.73,0.08,30.7,16,36,52,36,16,20,1.44,44.44,Difficile,Difficile,0,Meme Difficulte que la Prediction,Pas Adapte
5523,2020,Economie,1,La Production,2,L'Importance de la Production Marchande et de la Production Non-Marchande,5,194,5,QROC,0.71,0.17,26.46,15,43,58,40,15,25,1.45,37.5,Difficile,Difficile,0,Meme Difficulte que la Prediction,Pas Adapte
194,2015,Economie,1,La Production,3,Valeur Ajouee et Mesure de la Richesse,6,195,1,QROC,0.3,0.3,41.25,38,55,93,43,38,5,2.16,88.37,Moyen,Moyen,0,Meme Difficulte que la Prediction,Pas Adapte
1260,2016,Economie,1,La Production,3,Valeur Ajouee et Mesure de la Richesse,6,195,1,QROC,0.17,0.9,67.14,70,34,104,84,70,14,1.24,83.33,Difficile,Facile,2,Beaucoup plus Facile que la Prediction,Adapte
2326,2017,Economie,1,La Production,3,Valeur Ajouee et Mesure de la Richesse,6,195,1,QROC,0.13,0.8,67.14,80,39,119,111,80,31,1.07,72.07,Facile,Facile,0,Meme Difficulte que la Prediction,Adapte
3392,2018,Economie,1,La Production,3,Valeur Ajouee et Mesure de la Richesse,6,195,1,QROC,0.15,0.7,67.14,82,40,122,92,82,10,1.33,89.13,Facile,Facile,0,Meme Difficulte que la Prediction,Adapte
4458,2019,Economie,1,La Production,3,Valeur Ajouee et Mesure de la Richesse,6,195,1,QROC,0.17,0.58,67.14,80,39,119,93,80,13,1.28,86.02,Facile,Facile,0,Meme Difficulte que la Prediction,Adapte
5524,2020,Economie,1,La Production,3,Valeur Ajouee et Mesure de la Richesse,6,195,1,QROC,0.0,0.45,67.14,89,43,132,100,89,11,1.32,89.0,Facile,Facile,0,Meme Difficulte que la Prediction,Adapte
195,2015,Economie,1,La Production,3,Valeur Ajouee et Mesure de la Richesse,6,196,2,QCU,0.05,0.76,65.65,7,3,10,10,7,3,1.0,70.0,Difficile,Facile,2,Beaucoup plus Facile que la Prediction,Adapte
1261,2016,Economie,1,La Production,3,Valeur Ajouee et Mesure de la Richesse,6,196,2,QCU,0.05,0.96,65.65,8,4,12,8,8,0,1.5,100.0,Facile,Facile,0,Meme Difficulte que la Prediction,Adapte
2327,2017,Economie,1,La Production,3,Valeur Ajouee et Mesure de la Richesse,6,196,2,QCU,0.03,0.99,65.65,7,3,10,9,7,2,1.11,77.78,Facile,Facile,0,Meme Difficulte que la Prediction,Adapte
3393,2018,Economie,1,La Production,3,Valeur Ajouee et Mesure de la Richesse,6,196,2,QCU,0.01,0.88,65.65,7,3,10,10,7,3,1.0,70.0,Facile,Facile,0,Meme Difficulte que la Prediction,Adapte
4459,2019,Economie,1,La Production,3,Valeur Ajouee et Mesure de la Richesse,6,196,2,QCM,0.01,0.97,65.65,7,4,11,11,7,4,1.0,63.64,Facile,Facile,0,Meme Difficulte que la Prediction,Adapte
5525,2020,Economie,1,La Production,3,Valeur Ajouee et Mesure de la Richesse,6,196,2,QCM,0.09,0.7,65.65,6,3,9,6,6,0,1.5,100.0,Facile,Facile,0,Meme Difficulte que la Prediction,Adapte
196,2015,Economie,1,La Production,3,Valeur Ajouee et Mesure de la Richesse,6,197,3,QCM,0.75,0.18,12.08,10,70,80,54,10,44,1.48,18.52,Facile,Difficile,-2,Beaucoup plus Difficile que la Prediction,Pas Adapte
1262,2016,Economie,1,La Production,3,Valeur Ajouee et Mesure de la Richesse,6,197,3,QROC,0.79,0.04,20.71,18,70,88,66,18,48,1.33,27.27,Difficile,Difficile,0,Meme Difficulte que la Prediction,Pas Adapte
2328,2017,Economie,1,La Production,3,Valeur Ajouee et Mesure de la Richesse,6,197,3,QO,0.13,0.39,86.68,66,10,76,76,66,10,1.0,86.84,Facile,Facile,0,Meme Difficulte que la Prediction,Pas Adapte
3394,2018,Economie,1,La Production,3,Valeur Ajouee et Mesure de la Richesse,6,197,3,QO,0.02,0.84,80.8,69,16,85,79,69,10,1.08,87.34,Facile,Facile,0,Meme Difficulte que la Prediction,Pas Adapte
4460,2019,Economie,1,La Production,3,Valeur Ajouee et Mesure de la Richesse,6,197,3,QO,0.05,0.87,90.49,76,8,84,77,76,1,1.09,98.7,Moyen,Facile,1,Plus Facile que la Prediction,Pas Adapte
5526,2020,Economie,1,La Production,3,Valeur Ajouee et Mesure de la Richesse,6,197,3,QO,0.87,0.13,0.33,0,75,75,38,0,38,1.97,0.0,Moyen,Difficile,-1,Plus Difficile que la Prediction,Pas Adapte
197,2015,Economie,1,La Production,3,Valeur Ajouee et Mesure de la Richesse,6,198,4,QROC,0.96,0.25,32.92,25,51,76,36,25,11,2.11,69.44,Difficile,Difficile,0,Meme Difficulte que la Prediction,Pas Adapte
1263,2016,Economie,1,La Production,3,Valeur Ajouee et Mesure de la Richesse,6,198,4,QCU,0.46,0.27,34.67,30,57,87,55,30,25,1.58,54.55,Difficile,Difficile,0,Meme Difficulte que la Prediction,Pas Adapte
2329,2017,Economie,1,La Production,3,Valeur Ajouee et Mesure de la Richesse,6,198,4,QCU,0.04,0.93,66.71,59,29,88,61,59,2,1.44,96.72,Facile,Facile,0,Meme Difficulte que la Prediction,Adapte
3395,2018,Economie,1,La Production,3,Valeur Ajouee et Mesure de la Richesse,6,198,4,QCU,0.16,0.77,66.71,51,25,76,76,51,25,1.0,67.11,Facile,Facile,0,Meme Difficulte que la Prediction,Adapte
4461,2019,Economie,1,La Production,3,Valeur Ajouee et Mesure de la Richesse,6,198,4,QCU,0.03,0.93,66.71,53,26,79,63,53,10,1.25,84.13,Facile,Facile,0,Meme Difficulte que la Prediction,Adapte
5527,2020,Economie,1,La Production,3,Valeur Ajouee et Mesure de la Richesse,6,198,4,QCU,0.12,0.85,66.71,54,27,81,57,54,3,1.42,94.74,Facile,Facile,0,Meme Difficulte que la Prediction,Adapte
198,2015,Economie,1,La Production,3,Valeur Ajouee et Mesure de la Richesse,6,199,5,QCU,0.25,0.45,59.19,22,16,38,27,22,5,1.41,81.48,Moyen,Moyen,0,Meme Difficulte que la Prediction,Pas Adapte
1264,2016,Economie,1,La Production,3,Valeur Ajouee et Mesure de la Richesse,6,199,5,QCU,0.42,0.2,26.84,12,32,44,41,12,29,1.07,29.27,Moyen,Difficile,-1,Plus Difficile que la Prediction,Pas Adapte
2330,2017,Economie,1,La Production,3,Valeur Ajouee et Mesure de la Richesse,6,199,5,QCU,0.4,0.38,12.82,6,38,44,15,6,9,2.93,40.0,Moyen,Difficile,-1,Plus Difficile que la Prediction,Pas Adapte
3396,2018,Economie,1,La Production,3,Valeur Ajouee et Mesure de la Richesse,6,199,5,QCU,0.06,0.75,81.59,40,9,49,42,40,2,1.17,95.24,Facile,Facile,0,Meme Difficulte que la Prediction,Pas Adapte
4462,2019,Economie,1,La Production,3,Valeur Ajouee et Mesure de la Richesse,6,199,5,QCU,0.03,0.75,91.02,49,5,54,53,49,4,1.02,92.45,Facile,Facile,0,Meme Difficulte que la Prediction,Pas Adapte
5528,2020,Economie,1,La Production,3,Valeur Ajouee et Mesure de la Richesse,6,199,5,QCU,0.22,0.4,38.52,22,36,58,42,22,20,1.38,52.38,Moyen,Moyen,0,Meme Difficulte que la Prediction,Pas Adapte
199,2015,Economie,1,La Production,3,Valeur Ajouee et Mesure de la Richesse,6,200,6,QCU,0.18,0.88,75.17,31,10,41,34,31,3,1.21,91.18,Facile,Facile,0,Meme Difficulte que la Prediction,Pas Adapte
1265,2016,Economie,1,La Production,3,Valeur Ajouee et Mesure de la Richesse,6,200,6,QCU,0.68,0.28,34.7,14,25,39,33,14,19,1.18,42.42,Difficile,Difficile,0,Meme Difficulte que la Prediction,Pas Adapte
2331,2017,Economie,1,La Production,3,Valeur Ajouee et Mesure de la Richesse,6,200,6,QCU,0.65,0.33,19.99,7,29,36,20,7,13,1.8,35.0,Difficile,Difficile,0,Meme Difficulte que la Prediction,Pas Adapte
3397,2018,Economie,1,La Production,3,Valeur Ajouee et Mesure de la Richesse,6,200,6,QCM,0.09,0.74,84.99,33,6,39,39,33,6,1.0,84.62,Facile,Facile,0,Meme Difficulte que la Prediction,Pas Adapte
4463,2019,Economie,1,La Production,3,Valeur Ajouee et Mesure de la Richesse,6,200,6,QCM,0.06,0.87,91.33,30,3,33,32,30,2,1.03,93.75,Difficile,Facile,2,Beaucoup plus Facile que la Prediction,Pas Adapte
5529,2020,Economie,1,La Production,3,Valeur Ajouee et Mesure de la Richesse,6,200,6,QCM,0.15,0.81,75.7,22,7,29,27,22,5,1.07,81.48,Facile,Facile,0,Meme Difficulte que la Prediction,Pas Adapte
200,2015,Economie,1,La Production,4,Les Limites de la Mesure de la Production,9,201,1,QCU,0.72,0.32,31.54,30,64,94,74,30,44,1.27,40.54,Moyen,Difficile,-1,Plus Difficile que la Prediction,Pas Adapte
1266,2016,Economie,1,La Production,4,Les Limites de la Mesure de la Production,9,201,1,QO,0.73,0.22,56.24,52,40,92,88,52,36,1.05,59.09,Moyen,Moyen,0,Meme Difficulte que la Prediction,Pas Adapte
2332,2017,Economie,1,La Production,4,Les Limites de la Mesure de la Production,9,201,1,QROC,0.94,0.02,34.73,34,64,98,88,34,54,1.11,38.64,Facile,Difficile,-2,Beaucoup plus Difficile que la Prediction,Pas Adapte
3398,2018,Economie,1,La Production,4,Les Limites de la Mesure de la Production,9,201,1,QROC,0.17,0.59,66.84,72,36,108,91,72,19,1.19,79.12,Moyen,Facile,1,Plus Facile que la Prediction,Adapte
4464,2019,Economie,1,La Production,4,Les Limites de la Mesure de la Production,9,201,1,QROC,0.12,0.82,66.84,66,33,99,76,66,10,1.3,86.84,Facile,Facile,0,Meme Difficulte que la Prediction,Adapte
5530,2020,Economie,1,La Production,4,Les Limites de la Mesure de la Production,9,201,1,QO,0.14,0.65,66.84,67,33,100,96,67,29,1.04,69.79,Facile,Facile,0,Meme Difficulte que la Prediction,Adapte
201,2015,Economie,1,La Production,4,Les Limites de la Mesure de la Production,9,202,2,QROC,0.5,0.32,50.86,25,25,50,32,25,7,1.56,78.12,Moyen,Moyen,0,Meme Difficulte que la Prediction,Pas Adapte
1267,2016,Economie,1,La Production,4,Les Limites de la Mesure de la Production,9,202,2,QROC,0.16,0.85,66.65,29,14,43,40,29,11,1.07,72.5,Moyen,Facile,1,Plus Facile que la Prediction,Adapte
2333,2017,Economie,1,La Production,4,Les Limites de la Mesure de la Production,9,202,2,QROC,0.12,0.54,66.65,27,14,41,37,27,10,1.11,72.97,Facile,Facile,0,Meme Difficulte que la Prediction,Adapte
3399,2018,Economie,1,La Production,4,Les Limites de la Mesure de la Production,9,202,2,QROC,0.05,0.55,66.65,27,14,41,31,27,4,1.32,87.1,Facile,Facile,0,Meme Difficulte que la Prediction,Adapte
4465,2019,Economie,1,La Production,4,Les Limites de la Mesure de la Production,9,202,2,QROC,0.03,0.65,66.65,27,14,41,28,27,1,1.46,96.43,Facile,Facile,0,Meme Difficulte que la Prediction,Adapte
5531,2020,Economie,1,La Production,4,Les Limites de la Mesure de la Production,9,202,2,QO,0.19,0.33,66.65,29,14,43,31,29,2,1.39,93.55,Facile,Facile,0,Meme Difficulte que la Prediction,Adapte
202,2015,Economie,1,La Production,4,Les Limites de la Mesure de la Production,9,203,3,QCM,0.57,0.27,33.9,14,27,41,18,14,4,2.28,77.78,Facile,Difficile,-2,Beaucoup plus Difficile que la Prediction,Pas Adapte
1268,2016,Economie,1,La Production,4,Les Limites de la Mesure de la Production,9,203,3,QCM,0.51,0.27,15.83,7,37,44,12,7,5,3.67,58.33,Difficile,Difficile,0,Meme Difficulte que la Prediction,Pas Adapte
2334,2017,Economie,1,La Production,4,Les Limites de la Mesure de la Production,9,203,3,QCM,0.74,0.23,14.39,6,37,43,12,6,6,3.58,50.0,Difficile,Difficile,0,Meme Difficulte que la Prediction,Pas Adapte
3400,2018,Economie,1,La Production,4,Les Limites de la Mesure de la Production,9,203,3,QCM,0.07,0.81,73.83,30,10,40,31,30,1,1.29,96.77,Facile,Facile,0,Meme Difficulte que la Prediction,Adapte
4466,2019,Economie,1,La Production,4,Les Limites de la Mesure de la Production,9,203,3,QCM,0.14,0.78,73.83,27,9,36,33,27,6,1.09,81.82,Facile,Facile,0,Meme Difficulte que la Prediction,Adapte
5532,2020,Economie,1,La Production,4,Les Limites de la Mesure de la Production,9,203,3,QCM,0.18,0.87,73.83,24,8,32,27,24,3,1.19,88.89,Facile,Facile,0,Meme Difficulte que la Prediction,Adapte
203,2015,Economie,1,La Production,4,Les Limites de la Mesure de la Production,9,204,4,QCU,0.62,0.39,18.54,14,62,76,60,14,46,1.27,23.33,Difficile,Difficile,0,Meme Difficulte que la Prediction,Pas Adapte
1269,2016,Economie,1,La Production,4,Les Limites de la Mesure de la Production,9,204,4,QCU,0.39,0.7,47.18,41,46,87,77,41,36,1.13,53.25,Moyen,Moyen,0,Meme Difficulte que la Prediction,Pas Adapte
2335,2017,Economie,1,La Production,4,Les Limites de la Mesure de la Production,9,204,4,QCM,0.15,0.89,67.46,53,26,79,63,53,10,1.25,84.13,Facile,Facile,0,Meme Difficulte que la Prediction,Adapte
3401,2018,Economie,1,La Production,4,Les Limites de la Mesure de la Production,9,204,4,QCM,0.18,0.95,67.46,52,25,77,53,52,1,1.45,98.11,Facile,Facile,0,Meme Difficulte que la Prediction,Adapte
4467,2019,Economie,1,La Production,4,Les Limites de la Mesure de la Production,9,204,4,QCM,0.01,0.89,67.46,53,26,79,61,53,8,1.3,86.89,Facile,Facile,0,Meme Difficulte que la Prediction,Adapte
5533,2020,Economie,1,La Production,4,Les Limites de la Mesure de la Production,9,204,4,QCU,0.16,0.76,67.46,59,28,87,69,59,10,1.26,85.51,Facile,Facile,0,Meme Difficulte que la Prediction,Adapte
204,2015,Economie,1,La Production,4,Les Limites de la Mesure de la Production,9,205,5,QCM,0.4,0.42,37.37,32,53,85,54,32,22,1.57,59.26,Moyen,Moyen,0,Meme Difficulte que la Prediction,Pas Adapte
1270,2016,Economie,1,La Production,4,Les Limites de la Mesure de la Production,9,205,5,QCM,0.12,0.98,98.66,73,1,74,73,73,0,1.01,100.0,Moyen,Facile,1,Plus Facile que la Prediction,Pas Adapte
2336,2017,Economie,1,La Production,4,Les Limites de la Mesure de la Production,9,205,5,QCM,0.55,0.3,29.75,21,48,69,30,21,9,2.3,70.0,Difficile,Difficile,0,Meme Difficulte que la Prediction,Pas Adapte
3402,2018,Economie,1,La Production,4,Les Limites de la Mesure de la Production,9,205,5,QCM,0.68,0.26,4.66,3,65,68,19,3,16,3.58,15.79,Moyen,Difficile,-1,Plus Difficile que la Prediction,Pas Adapte
4468,2019,Economie,1,La Production,4,Les Limites de la Mesure de la Production,9,205,5,QCM,0.53,0.3,26.07,16,46,62,41,16,25,1.51,39.02,Difficile,Difficile,0,Meme Difficulte que la Prediction,Pas Adapte
5534,2020,Economie,1,La Production,4,Les Limites de la Mesure de la Production,9,205,5,QROC,0.7,0.24,5.11,3,54,57,39,3,36,1.46,7.69,Difficile,Difficile,0,Meme Difficulte que la Prediction,Pas Adapte
205,2015,Economie,1,La Production,4,Les Limites de la Mesure de la Production,9,206,6,QCM,0.0,0.71,89.52,6,1,7,7,6,1,1.0,85.71,Facile,Facile,0,Meme Difficulte que la Prediction,Pas Adapte
1271,2016,Economie,1,La Production,4,Les Limites de la Mesure de la Production,9,206,6,QCM,0.74,0.17,20.88,2,6,8,5,2,3,1.6,40.0,Difficile,Difficile,0,Meme Difficulte que la Prediction,Pas Adapte
2337,2017,Economie,1,La Production,4,Les Limites de la Mesure de la Production,9,206,6,QCM,0.39,0.6,62.06,6,3,9,7,6,1,1.29,85.71,Difficile,Moyen,1,Plus Facile que la Prediction,Adapte
3403,2018,Economie,1,La Production,4,Les Limites de la Mesure de la Production,9,206,6,QCM,0.27,0.5,62.06,5,3,8,7,5,2,1.14,71.43,Moyen,Moyen,0,Meme Difficulte que la Prediction,Adapte
4469,2019,Economie,1,La Production,4,Les Limites de la Mesure de la Production,9,206,6,QCM,0.42,0.31,62.06,5,3,8,6,5,1,1.33,83.33,Moyen,Moyen,0,Meme Difficulte que la Prediction,Adapte
5535,2020,Economie,1,La Production,4,Les Limites de la Mesure de la Production,9,206,6,QROC,0.21,0.29,62.06,5,3,8,7,5,2,1.14,71.43,Moyen,Moyen,0,Meme Difficulte que la Prediction,Adapte
206,2015,Economie,1,La Production,4,Les Limites de la Mesure de la Production,9,207,7,QCM,0.62,0.25,6.27,3,38,41,17,3,14,2.41,17.65,Difficile,Difficile,0,Meme Difficulte que la Prediction,Pas Adapte
1272,2016,Economie,1,La Production,4,Les Limites de la Mesure de la Production,9,207,7,QCM,0.37,0.57,52.18,23,22,45,34,23,11,1.32,67.65,Moyen,Moyen,0,Meme Difficulte que la Prediction,Pas Adapte
2338,2017,Economie,1,La Production,4,Les Limites de la Mesure de la Production,9,207,7,QCU,0.71,0.36,5.44,2,43,45,18,2,16,2.5,11.11,Difficile,Difficile,0,Meme Difficulte que la Prediction,Pas Adapte
3404,2018,Economie,1,La Production,4,Les Limites de la Mesure de la Production,9,207,7,QCU,0.6,0.29,22.02,10,35,45,18,10,8,2.5,55.56,Moyen,Difficile,-1,Plus Difficile que la Prediction,Pas Adapte
4470,2019,Economie,1,La Production,4,Les Limites de la Mesure de la Production,9,207,7,QCU,0.56,0.35,30.0,12,28,40,23,12,11,1.74,52.17,Difficile,Difficile,0,Meme Difficulte que la Prediction,Pas Adapte
5536,2020,Economie,1,La Production,4,Les Limites de la Mesure de la Production,9,207,7,QCU,0.33,0.41,36.44,14,24,38,20,14,6,1.9,70.0,Moyen,Moyen,0,Meme Difficulte que la Prediction,Pas Adapte
207,2015,Economie,1,La Production,4,Les Limites de la Mesure de la Production,9,208,8,QCU,0.19,0.88,66.4,48,24,72,51,48,3,1.41,94.12,Facile,Facile,0,Meme Difficulte que la Prediction,Adapte
1273,2016,Economie,1,La Production,4,Les Limites de la Mesure de la Production,9,208,8,QCU,0.16,1.0,66.4,49,25,74,50,49,1,1.48,98.0,Facile,Facile,0,Meme Difficulte que la Prediction,Adapte
2339,2017,Economie,1,La Production,4,Les Limites de la Mesure de la Production,9,208,8,QCU,0.07,0.91,66.4,48,24,72,55,48,7,1.31,87.27,Facile,Facile,0,Meme Difficulte que la Prediction,Adapte
3405,2018,Economie,1,La Production,4,Les Limites de la Mesure de la Production,9,208,8,QCU,0.17,0.84,66.4,41,20,61,50,41,9,1.22,82.0,Facile,Facile,0,Meme Difficulte que la Prediction,Adapte
4471,2019,Economie,1,La Production,4,Les Limites de la Mesure de la Production,9,208,8,QCU,0.14,0.75,66.4,39,19,58,56,39,17,1.04,69.64,Facile,Facile,0,Meme Difficulte que la Prediction,Adapte
5537,2020,Economie,1,La Production,4,Les Limites de la Mesure de la Production,9,208,8,QCU,0.01,0.99,66.4,41,20,61,60,41,19,1.02,68.33,Facile,Facile,0,Meme Difficulte que la Prediction,Adapte
208,2015,Economie,1,La Production,4,Les Limites de la Mesure de la Production,9,209,9,QCM,0.54,0.3,27.54,18,49,67,66,18,48,1.02,27.27,Difficile,Difficile,0,Meme Difficulte que la Prediction,Pas Adapte
1274,2016,Economie,1,La Production,4,Les Limites de la Mesure de la Production,9,209,9,QCM,0.44,0.5,58.5,44,32,76,61,44,17,1.25,72.13,Moyen,Moyen,0,Meme Difficulte que la Prediction,Pas Adapte
2340,2017,Economie,1,La Production,4,Les Limites de la Mesure de la Production,9,209,9,QCM,0.48,0.52,37.06,31,53,84,82,31,51,1.02,37.8,Moyen,Moyen,0,Meme Difficulte que la Prediction,Pas Adapte
3406,2018,Economie,1,La Production,4,Les Limites de la Mesure de la Production,9,209,9,QCM,0.59,0.28,14.99,14,79,93,42,14,28,2.21,33.33,Difficile,Difficile,0,Meme Difficulte que la Prediction,Pas Adapte
4472,2019,Economie,1,La Production,4,Les Limites de la Mesure de la Production,9,209,9,QCM,0.72,0.19,1.93,2,92,94,72,2,70,1.31,2.78,Difficile,Difficile,0,Meme Difficulte que la Prediction,Pas Adapte
5538,2020,Economie,1,La Production,4,Les Limites de la Mesure de la Production,9,209,9,QCM,0.16,0.95,68.82,68,31,99,85,68,17,1.16,80.0,Facile,Facile,0,Meme Difficulte que la Prediction,Adapte
209,2015,Economie,1,Le Travail,1,Les Aspects Quantitatifs et Qualitatifs du Travail,11,210,1,QCM,0.07,0.94,97.96,49,1,50,49,49,0,1.02,100.0,Facile,Facile,0,Meme Difficulte que la Prediction,Pas Adapte
1275,2016,Economie,1,Le Travail,1,Les Aspects Quantitatifs et Qualitatifs du Travail,11,210,1,QCM,0.6,0.19,10.16,5,47,52,42,5,37,1.24,11.9,Difficile,Difficile,0,Meme Difficulte que la Prediction,Pas Adapte
2341,2017,Economie,1,Le Travail,1,Les Aspects Quantitatifs et Qualitatifs du Travail,11,210,1,QCU,0.6,0.38,34.44,20,39,59,53,20,33,1.11,37.74,Difficile,Difficile,0,Meme Difficulte que la Prediction,Pas Adapte
3407,2018,Economie,1,Le Travail,1,Les Aspects Quantitatifs et Qualitatifs du Travail,11,210,1,QCU,0.63,0.31,24.49,16,48,64,56,16,40,1.14,28.57,Difficile,Difficile,0,Meme Difficulte que la Prediction,Pas Adapte
4473,2019,Economie,1,Le Travail,1,Les Aspects Quantitatifs et Qualitatifs du Travail,11,210,1,QCU,0.34,0.71,57.05,39,30,69,56,39,17,1.23,69.64,Difficile,Moyen,1,Plus Facile que la Prediction,Pas Adapte
5539,2020,Economie,1,Le Travail,1,Les Aspects Quantitatifs et Qualitatifs du Travail,11,210,1,QCU,0.62,0.28,7.34,4,55,59,49,4,45,1.2,8.16,Difficile,Difficile,0,Meme Difficulte que la Prediction,Pas Adapte
210,2015,Economie,1,Le Travail,1,Les Aspects Quantitatifs et Qualitatifs du Travail,11,211,2,QCM,0.22,0.65,45.52,25,31,56,30,25,5,1.87,83.33,Facile,Moyen,-1,Plus Difficile que la Prediction,Pas Adapte
1276,2016,Economie,1,Le Travail,1,Les Aspects Quantitatifs et Qualitatifs du Travail,11,211,2,QCM,0.1,0.79,70.07,34,14,48,41,34,7,1.17,82.93,Facile,Facile,0,Meme Difficulte que la Prediction,Adapte
2342,2017,Economie,1,Le Travail,1,Les Aspects Quantitatifs et Qualitatifs du Travail,11,211,2,QCM,0.08,0.75,70.07,30,13,43,30,30,0,1.43,100.0,Facile,Facile,0,Meme Difficulte que la Prediction,Adapte
3408,2018,Economie,1,Le Travail,1,Les Aspects Quantitatifs et Qualitatifs du Travail,11,211,2,QCU,0.12,0.98,70.07,29,12,41,29,29,0,1.41,100.0,Facile,Facile,0,Meme Difficulte que la Prediction,Adapte
4474,2019,Economie,1,Le Travail,1,Les Aspects Quantitatifs et Qualitatifs du Travail,11,211,2,QCU,0.19,0.99,70.07,33,14,47,39,33,6,1.21,84.62,Facile,Facile,0,Meme Difficulte que la Prediction,Adapte
5540,2020,Economie,1,Le Travail,1,Les Aspects Quantitatifs et Qualitatifs du Travail,11,211,2,QCU,0.07,0.9,70.07,28,12,40,38,28,10,1.05,73.68,Facile,Facile,0,Meme Difficulte que la Prediction,Adapte
211,2015,Economie,1,Le Travail,1,Les Aspects Quantitatifs et Qualitatifs du Travail,11,212,3,QCM,0.06,0.88,88.16,9,1,10,9,9,0,1.11,100.0,Difficile,Facile,2,Beaucoup plus Facile que la Prediction,Pas Adapte
1277,2016,Economie,1,Le Travail,1,Les Aspects Quantitatifs et Qualitatifs du Travail,11,212,3,QCM,0.13,0.77,97.77,9,0,9,9,9,0,1.0,100.0,Difficile,Facile,2,Beaucoup plus Facile que la Prediction,Pas Adapte
2343,2017,Economie,1,Le Travail,1,Les Aspects Quantitatifs et Qualitatifs du Travail,11,212,3,QCM,0.43,0.6,36.46,3,6,9,7,3,4,1.29,42.86,Facile,Moyen,-1,Plus Difficile que la Prediction,Pas Adapte
3409,2018,Economie,1,Le Travail,1,Les Aspects Quantitatifs et Qualitatifs du Travail,11,212,3,QCM,0.51,0.29,25.25,2,7,9,3,2,1,3.0,66.67,Difficile,Difficile,0,Meme Difficulte que la Prediction,Pas Adapte
4475,2019,Economie,1,Le Travail,1,Les Aspects Quantitatifs et Qualitatifs du Travail,11,212,3,QCM,0.73,0.25,23.59,2,7,9,5,2,3,1.8,40.0,Moyen,Difficile,-1,Plus Difficile que la Prediction,Pas Adapte
5541,2020,Economie,1,Le Travail,1,Les Aspects Quantitatifs et Qualitatifs du Travail,11,212,3,QCM,0.18,0.88,71.46,7,3,10,10,7,3,1.0,70.0,Difficile,Facile,2,Beaucoup plus Facile que la Prediction,Adapte
212,2015,Economie,1,Le Travail,1,Les Aspects Quantitatifs et Qualitatifs du Travail,11,213,4,QCU,0.18,0.88,84.57,50,9,59,55,50,5,1.07,90.91,Moyen,Facile,1,Plus Facile que la Prediction,Pas Adapte
1278,2016,Economie,1,Le Travail,1,Les Aspects Quantitatifs et Qualitatifs du Travail,11,213,4,QCU,0.47,0.26,23.72,13,41,54,49,13,36,1.1,26.53,Moyen,Difficile,-1,Plus Difficile que la Prediction,Pas Adapte
2344,2017,Economie,1,Le Travail,1,Les Aspects Quantitatifs et Qualitatifs du Travail,11,213,4,QCU,0.39,0.49,39.09,23,36,59,39,23,16,1.51,58.97,Facile,Moyen,-1,Plus Difficile que la Prediction,Pas Adapte
3410,2018,Economie,1,Le Travail,1,Les Aspects Quantitatifs et Qualitatifs du Travail,11,213,4,QCU,0.16,0.98,79.69,49,13,62,59,49,10,1.05,83.05,Difficile,Facile,2,Beaucoup plus Facile que la Prediction,Pas Adapte
4476,2019,Economie,1,Le Travail,1,Les Aspects Quantitatifs et Qualitatifs du Travail,11,213,4,QCU,0.59,0.29,4.46,3,66,69,31,3,28,2.23,9.68,Moyen,Difficile,-1,Plus Difficile que la Prediction,Pas Adapte
5542,2020,Economie,1,Le Travail,1,Les Aspects Quantitatifs et Qualitatifs du Travail,11,213,4,QCU,0.72,0.23,27.98,18,46,64,56,18,38,1.14,32.14,Moyen,Difficile,-1,Plus Difficile que la Prediction,Pas Adapte
213,2015,Economie,1,Le Travail,1,Les Aspects Quantitatifs et Qualitatifs du Travail,11,214,5,QCU,0.28,0.42,40.15,33,48,81,50,33,17,1.62,66.0,Facile,Moyen,-1,Plus Difficile que la Prediction,Pas Adapte
1279,2016,Economie,1,Le Travail,1,Les Aspects Quantitatifs et Qualitatifs du Travail,11,214,5,QCU,0.63,0.34,5.2,4,80,84,61,4,57,1.38,6.56,Difficile,Difficile,0,Meme Difficulte que la Prediction,Pas Adapte
2345,2017,Economie,1,Le Travail,1,Les Aspects Quantitatifs et Qualitatifs du Travail,11,214,5,QCU,0.66,0.24,27.12,25,69,94,75,25,50,1.25,33.33,Difficile,Difficile,0,Meme Difficulte que la Prediction,Pas Adapte
3411,2018,Economie,1,Le Travail,1,Les Aspects Quantitatifs et Qualitatifs du Travail,11,214,5,QCU,0.73,0.34,18.93,16,67,83,64,16,48,1.3,25.0,Moyen,Difficile,-1,Plus Difficile que la Prediction,Pas Adapte
4477,2019,Economie,1,Le Travail,1,Les Aspects Quantitatifs et Qualitatifs du Travail,11,214,5,QCM,0.45,0.35,56.76,47,36,83,73,47,26,1.14,64.38,Moyen,Moyen,0,Meme Difficulte que la Prediction,Pas Adapte
5543,2020,Economie,1,Le Travail,1,Les Aspects Quantitatifs et Qualitatifs du Travail,11,214,5,QCM,0.52,0.24,19.84,15,59,74,46,15,31,1.61,32.61,Facile,Difficile,-2,Beaucoup plus Difficile que la Prediction,Pas Adapte
214,2015,Economie,1,Le Travail,1,Les Aspects Quantitatifs et Qualitatifs du Travail,11,215,6,QCM,0.69,0.27,12.78,10,68,78,32,10,22,2.44,31.25,Difficile,Difficile,0,Meme Difficulte que la Prediction,Pas Adapte
1280,2016,Economie,1,Le Travail,1,Les Aspects Quantitatifs et Qualitatifs du Travail,11,215,6,QCU,0.59,0.35,11.01,10,78,88,72,10,62,1.22,13.89,Difficile,Difficile,0,Meme Difficulte que la Prediction,Pas Adapte
2346,2017,Economie,1,Le Travail,1,Les Aspects Quantitatifs et Qualitatifs du Travail,11,215,6,QCU,0.65,0.22,8.59,9,91,100,98,9,89,1.02,9.18,Moyen,Difficile,-1,Plus Difficile que la Prediction,Pas Adapte
3412,2018,Economie,1,Le Travail,1,Les Aspects Quantitatifs et Qualitatifs du Travail,11,215,6,QCU,0.7,0.37,30.43,29,66,95,58,29,29,1.64,50.0,Difficile,Difficile,0,Meme Difficulte que la Prediction,Pas Adapte
4478,2019,Economie,1,Le Travail,1,Les Aspects Quantitatifs et Qualitatifs du Travail,11,215,6,QCU,0.43,0.26,2.78,3,90,93,32,3,29,2.91,9.38,Facile,Difficile,-2,Beaucoup plus Difficile que la Prediction,Pas Adapte
5544,2020,Economie,1,Le Travail,1,Les Aspects Quantitatifs et Qualitatifs du Travail,11,215,6,QCU,0.12,0.79,91.06,80,8,88,86,80,6,1.02,93.02,Moyen,Facile,1,Plus Facile que la Prediction,Pas Adapte
215,2015,Economie,1,Le Travail,1,Les Aspects Quantitatifs et Qualitatifs du Travail,11,216,7,QROC,0.79,0.15,6.26,5,72,77,50,5,45,1.54,10.0,Difficile,Difficile,0,Meme Difficulte que la Prediction,Pas Adapte
1281,2016,Economie,1,Le Travail,1,Les Aspects Quantitatifs et Qualitatifs du Travail,11,216,7,QROC,0.36,0.31,63.24,56,33,89,62,56,6,1.44,90.32,Moyen,Moyen,0,Meme Difficulte que la Prediction,Adapte
2347,2017,Economie,1,Le Travail,1,Les Aspects Quantitatifs et Qualitatifs du Travail,11,216,7,QROC,0.37,0.3,63.24,53,31,84,75,53,22,1.12,70.67,Moyen,Moyen,0,Meme Difficulte que la Prediction,Adapte
3413,2018,Economie,1,Le Travail,1,Les Aspects Quantitatifs et Qualitatifs du Travail,11,216,7,QROC,0.28,0.35,63.24,49,28,77,49,49,0,1.57,100.0,Moyen,Moyen,0,Meme Difficulte que la Prediction,Adapte
4479,2019,Economie,1,Le Travail,1,Les Aspects Quantitatifs et Qualitatifs du Travail,11,216,7,QROC,0.2,0.33,63.24,48,28,76,49,48,1,1.55,97.96,Moyen,Moyen,0,Meme Difficulte que la Prediction,Adapte
5545,2020,Economie,1,Le Travail,1,Les Aspects Quantitatifs et Qualitatifs du Travail,11,216,7,QROC,0.3,0.26,63.24,47,27,74,57,47,10,1.3,82.46,Moyen,Moyen,0,Meme Difficulte que la Prediction,Adapte
216,2015,Economie,1,Le Travail,1,Les Aspects Quantitatifs et Qualitatifs du Travail,11,217,8,QROC,0.92,0.19,5.6,1,18,19,9,1,8,2.11,11.11,Difficile,Difficile,0,Meme Difficulte que la Prediction,Pas Adapte
1282,2016,Economie,1,Le Travail,1,Les Aspects Quantitatifs et Qualitatifs du Travail,11,217,8,QROC,0.75,0.12,13.77,2,16,18,11,2,9,1.64,18.18,Difficile,Difficile,0,Meme Difficulte que la Prediction,Pas Adapte
2348,2017,Economie,1,Le Travail,1,Les Aspects Quantitatifs et Qualitatifs du Travail,11,217,8,QO,0.12,0.35,81.85,14,3,17,16,14,2,1.06,87.5,Facile,Facile,0,Meme Difficulte que la Prediction,Pas Adapte
3414,2018,Economie,1,Le Travail,1,Les Aspects Quantitatifs et Qualitatifs du Travail,11,217,8,QO,0.12,0.7,77.84,12,3,15,12,12,0,1.25,100.0,Facile,Facile,0,Meme Difficulte que la Prediction,Pas Adapte
4480,2019,Economie,1,Le Travail,1,Les Aspects Quantitatifs et Qualitatifs du Travail,11,217,8,QO,0.84,0.1,17.0,2,11,13,12,2,10,1.08,16.67,Facile,Difficile,-2,Beaucoup plus Difficile que la Prediction,Pas Adapte
5546,2020,Economie,1,Le Travail,1,Les Aspects Quantitatifs et Qualitatifs du Travail,11,217,8,QROC,0.35,0.38,61.15,9,6,15,15,9,6,1.0,60.0,Moyen,Moyen,0,Meme Difficulte que la Prediction,Adapte
217,2015,Economie,1,Le Travail,1,Les Aspects Quantitatifs et Qualitatifs du Travail,11,218,9,QCM,0.48,0.65,61.76,53,33,86,67,53,14,1.28,79.1,Moyen,Moyen,0,Meme Difficulte que la Prediction,Adapte
1283,2016,Economie,1,Le Travail,1,Les Aspects Quantitatifs et Qualitatifs du Travail,11,218,9,QCM,0.25,0.35,61.76,57,36,93,72,57,15,1.29,79.17,Moyen,Moyen,0,Meme Difficulte que la Prediction,Adapte
2349,2017,Economie,1,Le Travail,1,Les Aspects Quantitatifs et Qualitatifs du Travail,11,218,9,QCM,0.26,0.63,61.76,51,31,82,80,51,29,1.02,63.75,Moyen,Moyen,0,Meme Difficulte que la Prediction,Adapte
3415,2018,Economie,1,Le Travail,1,Les Aspects Quantitatifs et Qualitatifs du Travail,11,218,9,QCM,0.24,0.55,61.76,49,30,79,57,49,8,1.39,85.96,Moyen,Moyen,0,Meme Difficulte que la Prediction,Adapte
4481,2019,Economie,1,Le Travail,1,Les Aspects Quantitatifs et Qualitatifs du Travail,11,218,9,QROC,0.39,0.33,61.76,43,26,69,49,43,6,1.41,87.76,Moyen,Moyen,0,Meme Difficulte que la Prediction,Adapte
5547,2020,Economie,1,Le Travail,1,Les Aspects Quantitatifs et Qualitatifs du Travail,11,218,9,QROC,0.36,0.29,61.76,48,29,77,58,48,10,1.33,82.76,Moyen,Moyen,0,Meme Difficulte que la Prediction,Adapte
218,2015,Economie,1,Le Travail,1,Les Aspects Quantitatifs et Qualitatifs du Travail,11,219,10,QCM,0.01,0.75,70.65,11,5,16,12,11,1,1.33,91.67,Facile,Facile,0,Meme Difficulte que la Prediction,Adapte
1284,2016,Economie,1,Le Travail,1,Les Aspects Quantitatifs et Qualitatifs du Travail,11,219,10,QCM,0.12,0.83,70.65,13,5,18,14,13,1,1.29,92.86,Facile,Facile,0,Meme Difficulte que la Prediction,Adapte
2350,2017,Economie,1,Le Travail,1,Les Aspects Quantitatifs et Qualitatifs du Travail,11,219,10,QROC,0.05,0.55,70.65,12,5,17,13,12,1,1.31,92.31,Facile,Facile,0,Meme Difficulte que la Prediction,Adapte
3416,2018,Economie,1,Le Travail,1,Les Aspects Quantitatifs et Qualitatifs du Travail,11,219,10,QROC,0.12,0.62,70.65,10,4,14,10,10,0,1.4,100.0,Facile,Facile,0,Meme Difficulte que la Prediction,Adapte
4482,2019,Economie,1,Le Travail,1,Les Aspects Quantitatifs et Qualitatifs du Travail,11,219,10,QCU,0.13,0.99,70.65,11,4,15,13,11,2,1.15,84.62,Facile,Facile,0,Meme Difficulte que la Prediction,Adapte
5548,2020,Economie,1,Le Travail,1,Les Aspects Quantitatifs et Qualitatifs du Travail,11,219,10,QCU,0.18,0.91,70.65,10,4,14,12,10,2,1.17,83.33,Facile,Facile,0,Meme Difficulte que la Prediction,Adapte
219,2015,Economie,1,Le Travail,1,Les Aspects Quantitatifs et Qualitatifs du Travail,11,220,11,QCU,0.05,0.96,70.29,20,9,29,24,20,4,1.21,83.33,Difficile,Facile,2,Beaucoup plus Facile que la Prediction,Adapte
1285,2016,Economie,1,Le Travail,1,Les Aspects Quantitatifs et Qualitatifs du Travail,11,220,11,QCU,0.02,0.92,70.29,20,9,29,22,20,2,1.32,90.91,Facile,Facile,0,Meme Difficulte que la Prediction,Adapte
2351,2017,Economie,1,Le Travail,1,Les Aspects Quantitatifs et Qualitatifs du Travail,11,220,11,QCM,0.19,0.75,70.29,18,8,26,20,18,2,1.3,90.0,Facile,Facile,0,Meme Difficulte que la Prediction,Adapte
3417,2018,Economie,1,Le Travail,1,Les Aspects Quantitatifs et Qualitatifs du Travail,11,220,11,QCM,0.1,0.77,70.29,15,7,22,17,15,2,1.29,88.24,Facile,Facile,0,Meme Difficulte que la Prediction,Adapte
4483,2019,Economie,1,Le Travail,1,Les Aspects Quantitatifs et Qualitatifs du Travail,11,220,11,QCM,0.05,0.77,70.29,15,7,22,16,15,1,1.38,93.75,Facile,Facile,0,Meme Difficulte que la Prediction,Adapte
5549,2020,Economie,1,Le Travail,1,Les Aspects Quantitatifs et Qualitatifs du Travail,11,220,11,QCM,0.13,0.77,70.29,18,7,25,23,18,5,1.09,78.26,Facile,Facile,0,Meme Difficulte que la Prediction,Adapte
220,2015,Economie,1,Le Travail,2,La Productivite du Travail et la Notion de Capital Humain,7,221,1,QCU,0.39,0.62,48.41,47,50,97,56,47,9,1.73,83.93,Moyen,Moyen,0,Meme Difficulte que la Prediction,Pas Adapte
1286,2016,Economie,1,Le Travail,2,La Productivite du Travail et la Notion de Capital Humain,7,221,1,QCU,0.04,0.79,72.68,60,22,82,68,60,8,1.21,88.24,Difficile,Facile,2,Beaucoup plus Facile que la Prediction,Adapte
2352,2017,Economie,1,Le Travail,2,La Productivite du Travail et la Notion de Capital Humain,7,221,1,QCU,0.09,0.79,72.68,68,25,93,85,68,17,1.09,80.0,Facile,Facile,0,Meme Difficulte que la Prediction,Adapte
3418,2018,Economie,1,Le Travail,2,La Productivite du Travail et la Notion de Capital Humain,7,221,1,QCU,0.2,0.79,72.68,78,29,107,107,78,29,1.0,72.9,Facile,Facile,0,Meme Difficulte que la Prediction,Adapte
4484,2019,Economie,1,Le Travail,2,La Productivite du Travail et la Notion de Capital Humain,7,221,1,QCU,0.01,0.87,72.68,81,30,111,103,81,22,1.08,78.64,Facile,Facile,0,Meme Difficulte que la Prediction,Adapte
5550,2020,Economie,1,Le Travail,2,La Productivite du Travail et la Notion de Capital Humain,7,221,1,QCU,0.01,0.85,72.68,76,29,105,78,76,2,1.35,97.44,Facile,Facile,0,Meme Difficulte que la Prediction,Adapte
221,2015,Economie,1,Le Travail,2,La Productivite du Travail et la Notion de Capital Humain,7,222,2,QCM,0.11,0.78,86.73,7,1,8,7,7,0,1.14,100.0,Difficile,Facile,2,Beaucoup plus Facile que la Prediction,Pas Adapte
1287,2016,Economie,1,Le Travail,2,La Productivite du Travail et la Notion de Capital Humain,7,222,2,QCM,0.02,0.71,75.98,7,2,9,9,7,2,1.0,77.78,Moyen,Facile,1,Plus Facile que la Prediction,Pas Adapte
2353,2017,Economie,1,Le Travail,2,La Productivite du Travail et la Notion de Capital Humain,7,222,2,QROC,0.62,0.17,17.82,1,7,8,6,1,5,1.33,16.67,Difficile,Difficile,0,Meme Difficulte que la Prediction,Pas Adapte
3419,2018,Economie,1,Le Travail,2,La Productivite du Travail et la Notion de Capital Humain,7,222,2,QROC,0.3,0.29,57.18,5,3,8,7,5,2,1.14,71.43,Moyen,Moyen,0,Meme Difficulte que la Prediction,Pas Adapte
4485,2019,Economie,1,Le Travail,2,La Productivite du Travail et la Notion de Capital Humain,7,222,2,QROC,0.07,0.49,82.69,7,2,9,8,7,1,1.12,87.5,Difficile,Facile,2,Beaucoup plus Facile que la Prediction,Pas Adapte
5551,2020,Economie,1,Le Travail,2,La Productivite du Travail et la Notion de Capital Humain,7,222,2,QO,0.61,0.18,64.84,6,4,10,9,6,3,1.11,66.67,Moyen,Moyen,0,Meme Difficulte que la Prediction,Adapte
222,2015,Economie,1,Le Travail,2,La Productivite du Travail et la Notion de Capital Humain,7,223,3,QCM,0.25,0.55,51.87,3,2,5,4,3,1,1.25,75.0,Moyen,Moyen,0,Meme Difficulte que la Prediction,Pas Adapte
1288,2016,Economie,1,Le Travail,2,La Productivite du Travail et la Notion de Capital Humain,7,223,3,QCM,0.45,0.7,42.48,3,3,6,4,3,1,1.5,75.0,Facile,Moyen,-1,Plus Difficile que la Prediction,Pas Adapte
2354,2017,Economie,1,Le Travail,2,La Productivite du Travail et la Notion de Capital Humain,7,223,3,QCU,0.26,0.54,45.56,3,4,7,6,3,3,1.17,50.0,Facile,Moyen,-1,Plus Difficile que la Prediction,Pas Adapte
3420,2018,Economie,1,Le Travail,2,La Productivite du Travail et la Notion de Capital Humain,7,223,3,QCU,0.54,0.4,8.74,1,7,8,3,1,2,2.67,33.33,Difficile,Difficile,0,Meme Difficulte que la Prediction,Pas Adapte
4486,2019,Economie,1,Le Travail,2,La Productivite du Travail et la Notion de Capital Humain,7,223,3,QCU,0.45,0.35,8.79,1,7,8,4,1,3,2.0,25.0,Difficile,Difficile,0,Meme Difficulte que la Prediction,Pas Adapte
5552,2020,Economie,1,Le Travail,2,La Productivite du Travail et la Notion de Capital Humain,7,223,3,QCU,0.72,0.39,12.61,1,6,7,4,1,3,1.75,25.0,Difficile,Difficile,0,Meme Difficulte que la Prediction,Pas Adapte
223,2015,Economie,1,Le Travail,2,La Productivite du Travail et la Notion de Capital Humain,7,224,4,QCU,0.11,0.8,89.31,27,3,30,27,27,0,1.11,100.0,Facile,Facile,0,Meme Difficulte que la Prediction,Pas Adapte
1289,2016,Economie,1,Le Travail,2,La Productivite du Travail et la Notion de Capital Humain,7,224,4,QCU,0.03,0.77,69.67,22,10,32,24,22,2,1.33,91.67,Difficile,Facile,2,Beaucoup plus Facile que la Prediction,Adapte
2355,2017,Economie,1,Le Travail,2,La Productivite du Travail et la Notion de Capital Humain,7,224,4,QCU,0.08,0.77,69.67,23,10,33,30,23,7,1.1,76.67,Facile,Facile,0,Meme Difficulte que la Prediction,Adapte
3421,2018,Economie,1,Le Travail,2,La Productivite du Travail et la Notion de Capital Humain,7,224,4,QCU,0.08,0.95,69.67,24,11,35,33,24,9,1.06,72.73,Facile,Facile,0,Meme Difficulte que la Prediction,Adapte
4487,2019,Economie,1,Le Travail,2,La Productivite du Travail et la Notion de Capital Humain,7,224,4,QCU,0.13,0.79,69.67,22,9,31,23,22,1,1.35,95.65,Facile,Facile,0,Meme Difficulte que la Prediction,Adapte
5553,2020,Economie,1,Le Travail,2,La Productivite du Travail et la Notion de Capital Humain,7,224,4,QROC,0.11,0.62,69.67,21,9,30,21,21,0,1.43,100.0,Facile,Facile,0,Meme Difficulte que la Prediction,Adapte
224,2015,Economie,1,Le Travail,2,La Productivite du Travail et la Notion de Capital Humain,7,225,5,QCU,0.56,0.26,26.71,13,37,50,45,13,32,1.11,28.89,Difficile,Difficile,0,Meme Difficulte que la Prediction,Pas Adapte
1290,2016,Economie,1,Le Travail,2,La Productivite du Travail et la Notion de Capital Humain,7,225,5,QROC,0.08,0.45,84.68,38,7,45,39,38,1,1.15,97.44,Moyen,Facile,1,Plus Facile que la Prediction,Pas Adapte
2356,2017,Economie,1,Le Travail,2,La Productivite du Travail et la Notion de Capital Humain,7,225,5,QROC,0.95,0.04,15.24,7,36,43,18,7,11,2.39,38.89,Difficile,Difficile,0,Meme Difficulte que la Prediction,Pas Adapte
3422,2018,Economie,1,Le Travail,2,La Productivite du Travail et la Notion de Capital Humain,7,225,5,QO,0.01,0.97,74.43,31,11,42,32,31,1,1.31,96.88,Difficile,Facile,2,Beaucoup plus Facile que la Prediction,Adapte
4488,2019,Economie,1,Le Travail,2,La Productivite du Travail et la Notion de Capital Humain,7,225,5,QO,0.09,0.59,74.43,32,11,43,33,32,1,1.3,96.97,Facile,Facile,0,Meme Difficulte que la Prediction,Adapte
5554,2020,Economie,1,Le Travail,2,La Productivite du Travail et la Notion de Capital Humain,7,225,5,QO,0.14,0.38,74.43,34,12,46,42,34,8,1.1,80.95,Facile,Facile,0,Meme Difficulte que la Prediction,Adapte
225,2015,Economie,1,Le Travail,2,La Productivite du Travail et la Notion de Capital Humain,7,226,6,QCU,0.03,0.79,65.87,55,28,83,69,55,14,1.2,79.71,Facile,Facile,0,Meme Difficulte que la Prediction,Adapte
1291,2016,Economie,1,Le Travail,2,La Productivite du Travail et la Notion de Capital Humain,7,226,6,QCU,0.06,0.84,65.87,49,25,74,73,49,24,1.01,67.12,Facile,Facile,0,Meme Difficulte que la Prediction,Adapte
2357,2017,Economie,1,Le Travail,2,La Productivite du Travail et la Notion de Capital Humain,7,226,6,QCU,0.13,0.82,65.87,44,23,67,45,44,1,1.49,97.78,Facile,Facile,0,Meme Difficulte que la Prediction,Adapte
3423,2018,Economie,1,Le Travail,2,La Productivite du Travail et la Notion de Capital Humain,7,226,6,QCU,0.15,0.77,65.87,38,19,57,49,38,11,1.16,77.55,Facile,Facile,0,Meme Difficulte que la Prediction,Adapte
4489,2019,Economie,1,Le Travail,2,La Productivite du Travail et la Notion de Capital Humain,7,226,6,QCU,0.05,0.86,65.87,34,18,52,50,34,16,1.04,68.0,Facile,Facile,0,Meme Difficulte que la Prediction,Adapte
5555,2020,Economie,1,Le Travail,2,La Productivite du Travail et la Notion de Capital Humain,7,226,6,QCU,0.16,0.92,65.87,29,15,44,34,29,5,1.29,85.29,Facile,Facile,0,Meme Difficulte que la Prediction,Adapte
226,2015,Economie,1,Le Travail,2,La Productivite du Travail et la Notion de Capital Humain,7,227,7,QCM,0.51,0.21,5.49,1,14,15,4,1,3,3.75,25.0,Facile,Difficile,-2,Beaucoup plus Difficile que la Prediction,Pas Adapte
1292,2016,Economie,1,Le Travail,2,La Productivite du Travail et la Notion de Capital Humain,7,227,7,QCU,0.33,0.45,61.85,10,6,16,12,10,2,1.33,83.33,Facile,Moyen,-1,Plus Difficile que la Prediction,Adapte
2358,2017,Economie,1,Le Travail,2,La Productivite du Travail et la Notion de Capital Humain,7,227,7,QCU,0.31,0.48,61.85,11,6,17,14,11,3,1.21,78.57,Moyen,Moyen,0,Meme Difficulte que la Prediction,Adapte
3424,2018,Economie,1,Le Travail,2,La Productivite du Travail et la Notion de Capital Humain,7,227,7,QCU,0.37,0.4,61.85,12,7,19,17,12,5,1.12,70.59,Moyen,Moyen,0,Meme Difficulte que la Prediction,Adapte
4490,2019,Economie,1,Le Travail,2,La Productivite du Travail et la Notion de Capital Humain,7,227,7,QCU,0.36,0.66,61.85,11,7,18,11,11,0,1.64,100.0,Moyen,Moyen,0,Meme Difficulte que la Prediction,Adapte
5556,2020,Economie,1,Le Travail,2,La Productivite du Travail et la Notion de Capital Humain,7,227,7,QCU,0.39,0.68,61.85,12,8,20,14,12,2,1.43,85.71,Moyen,Moyen,0,Meme Difficulte que la Prediction,Adapte
227,2015,Economie,1,Le Capital et le Progres Technique,1,Le Capital et l'Investissement,3,228,1,QCU,0.23,0.54,43.48,40,51,91,53,40,13,1.72,75.47,Moyen,Moyen,0,Meme Difficulte que la Prediction,Pas Adapte
1293,2016,Economie,1,Le Capital et le Progres Technique,1,Le Capital et l'Investissement,3,228,1,QCU,0.29,0.48,58.55,49,34,83,64,49,15,1.3,76.56,Difficile,Moyen,1,Plus Facile que la Prediction,Pas Adapte
2359,2017,Economie,1,Le Capital et le Progres Technique,1,Le Capital et l'Investissement,3,228,1,QCU,0.01,0.89,80.8,77,18,95,85,77,8,1.12,90.59,Facile,Facile,0,Meme Difficulte que la Prediction,Pas Adapte
3425,2018,Economie,1,Le Capital et le Progres Technique,1,Le Capital et l'Investissement,3,228,1,QCU,0.14,0.85,83.54,81,16,97,89,81,8,1.09,91.01,Facile,Facile,0,Meme Difficulte que la Prediction,Pas Adapte
4491,2019,Economie,1,Le Capital et le Progres Technique,1,Le Capital et l'Investissement,3,228,1,QCM,0.48,0.43,59.98,64,42,106,92,64,28,1.15,69.57,Moyen,Moyen,0,Meme Difficulte que la Prediction,Pas Adapte
5557,2020,Economie,1,Le Capital et le Progres Technique,1,Le Capital et l'Investissement,3,228,1,QCM,0.25,0.67,59.68,56,38,94,77,56,21,1.22,72.73,Moyen,Moyen,0,Meme Difficulte que la Prediction,Pas Adapte
228,2015,Economie,1,Le Capital et le Progres Technique,1,Le Capital et l'Investissement,3,229,2,QCM,0.73,0.23,21.72,13,46,59,22,13,9,2.68,59.09,Difficile,Difficile,0,Meme Difficulte que la Prediction,Pas Adapte
1294,2016,Economie,1,Le Capital et le Progres Technique,1,Le Capital et l'Investissement,3,229,2,QCM,0.18,0.79,95.05,48,2,50,49,48,1,1.02,97.96,Facile,Facile,0,Meme Difficulte que la Prediction,Pas Adapte
2360,2017,Economie,1,Le Capital et le Progres Technique,1,Le Capital et l'Investissement,3,229,2,QCM,0.67,0.24,10.23,5,44,49,31,5,26,1.58,16.13,Difficile,Difficile,0,Meme Difficulte que la Prediction,Pas Adapte
3426,2018,Economie,1,Le Capital et le Progres Technique,1,Le Capital et l'Investissement,3,229,2,QCM,0.28,0.32,37.1,17,28,45,21,17,4,2.14,80.95,Moyen,Moyen,0,Meme Difficulte que la Prediction,Pas Adapte
4492,2019,Economie,1,Le Capital et le Progres Technique,1,Le Capital et l'Investissement,3,229,2,QCM,0.68,0.21,21.62,8,31,39,10,8,2,3.9,80.0,Difficile,Difficile,0,Meme Difficulte que la Prediction,Pas Adapte
5558,2020,Economie,1,Le Capital et le Progres Technique,1,Le Capital et l'Investissement,3,229,2,QCM,0.61,0.28,24.24,11,33,44,37,11,26,1.19,29.73,Difficile,Difficile,0,Meme Difficulte que la Prediction,Pas Adapte
229,2015,Economie,1,Le Capital et le Progres Technique,1,Le Capital et l'Investissement,3,230,3,QCM,0.49,0.44,47.75,6,7,13,9,6,3,1.44,66.67,Moyen,Moyen,0,Meme Difficulte que la Prediction,Pas Adapte
1295,2016,Economie,1,Le Capital et le Progres Technique,1,Le Capital et l'Investissement,3,230,3,QCM,0.33,0.6,41.31,5,7,12,9,5,4,1.33,55.56,Moyen,Moyen,0,Meme Difficulte que la Prediction,Pas Adapte
2361,2017,Economie,1,Le Capital et le Progres Technique,1,Le Capital et l'Investissement,3,230,3,QCM,0.3,0.65,46.73,6,6,12,9,6,3,1.33,66.67,Moyen,Moyen,0,Meme Difficulte que la Prediction,Pas Adapte
3427,2018,Economie,1,Le Capital et le Progres Technique,1,Le Capital et l'Investissement,3,230,3,QCM,0.59,0.18,10.65,1,12,13,9,1,8,1.44,11.11,Difficile,Difficile,0,Meme Difficulte que la Prediction,Pas Adapte
4493,2019,Economie,1,Le Capital et le Progres Technique,1,Le Capital et l'Investissement,3,230,3,QCM,0.19,0.88,91.69,10,1,11,10,10,0,1.1,100.0,Facile,Facile,0,Meme Difficulte que la Prediction,Pas Adapte
5559,2020,Economie,1,Le Capital et le Progres Technique,1,Le Capital et l'Investissement,3,230,3,QCM,0.01,0.79,81.94,11,2,13,13,11,2,1.0,84.62,Moyen,Facile,1,Plus Facile que la Prediction,Pas Adapte
230,2015,Economie,1,Le Capital et le Progres Technique,2,Le Capital: Aspect Physiques et Financiers,5,231,1,QCM,0.76,0.29,21.71,7,26,33,21,7,14,1.57,33.33,Difficile,Difficile,0,Meme Difficulte que la Prediction,Pas Adapte
1296,2016,Economie,1,Le Capital et le Progres Technique,2,Le Capital: Aspect Physiques et Financiers,5,231,1,QCU,0.17,0.75,84.93,25,5,30,28,25,3,1.07,89.29,Moyen,Facile,1,Plus Facile que la Prediction,Pas Adapte
2362,2017,Economie,1,Le Capital et le Progres Technique,2,Le Capital: Aspect Physiques et Financiers,5,231,1,QCU,0.32,0.45,58.89,18,12,30,23,18,5,1.3,78.26,Moyen,Moyen,0,Meme Difficulte que la Prediction,Pas Adapte
3428,2018,Economie,1,Le Capital et le Progres Technique,2,Le Capital: Aspect Physiques et Financiers,5,231,1,QCM,0.22,0.45,46.57,14,17,31,25,14,11,1.24,56.0,Moyen,Moyen,0,Meme Difficulte que la Prediction,Pas Adapte
4494,2019,Economie,1,Le Capital et le Progres Technique,2,Le Capital: Aspect Physiques et Financiers,5,231,1,QCU,0.47,0.26,27.3,8,20,28,27,8,19,1.04,29.63,Difficile,Difficile,0,Meme Difficulte que la Prediction,Pas Adapte
5560,2020,Economie,1,Le Capital et le Progres Technique,2,Le Capital: Aspect Physiques et Financiers,5,231,1,QCU,0.32,0.54,43.55,11,15,26,22,11,11,1.18,50.0,Facile,Moyen,-1,Plus Difficile que la Prediction,Pas Adapte
231,2015,Economie,1,Le Capital et le Progres Technique,2,Le Capital: Aspect Physiques et Financiers,5,232,2,QCU,0.61,0.31,12.03,6,42,48,31,6,25,1.55,19.35,Difficile,Difficile,0,Meme Difficulte que la Prediction,Pas Adapte
1297,2016,Economie,1,Le Capital et le Progres Technique,2,Le Capital: Aspect Physiques et Financiers,5,232,2,QCM,0.54,0.17,18.0,8,36,44,12,8,4,3.67,66.67,Difficile,Difficile,0,Meme Difficulte que la Prediction,Pas Adapte
2363,2017,Economie,1,Le Capital et le Progres Technique,2,Le Capital: Aspect Physiques et Financiers,5,232,2,QROC,0.02,0.94,70.05,27,11,38,32,27,5,1.19,84.38,Facile,Facile,0,Meme Difficulte que la Prediction,Adapte
3429,2018,Economie,1,Le Capital et le Progres Technique,2,Le Capital: Aspect Physiques et Financiers,5,232,2,QROC,0.09,0.63,70.05,24,10,34,31,24,7,1.1,77.42,Facile,Facile,0,Meme Difficulte que la Prediction,Adapte
4495,2019,Economie,1,Le Capital et le Progres Technique,2,Le Capital: Aspect Physiques et Financiers,5,232,2,QROC,0.09,0.76,70.05,27,11,38,37,27,10,1.03,72.97,Facile,Facile,0,Meme Difficulte que la Prediction,Adapte
5561,2020,Economie,1,Le Capital et le Progres Technique,2,Le Capital: Aspect Physiques et Financiers,5,232,2,QROC,0.17,0.74,70.05,24,10,34,32,24,8,1.06,75.0,Facile,Facile,0,Meme Difficulte que la Prediction,Adapte
232,2015,Economie,1,Le Capital et le Progres Technique,2,Le Capital: Aspect Physiques et Financiers,5,233,3,QCU,0.16,0.75,91.58,84,8,92,92,84,8,1.0,91.3,Difficile,Facile,2,Beaucoup plus Facile que la Prediction,Pas Adapte
1298,2016,Economie,1,Le Capital et le Progres Technique,2,Le Capital: Aspect Physiques et Financiers,5,233,3,QCU,0.05,0.84,79.4,65,17,82,70,65,5,1.17,92.86,Facile,Facile,0,Meme Difficulte que la Prediction,Pas Adapte
2364,2017,Economie,1,Le Capital et le Progres Technique,2,Le Capital: Aspect Physiques et Financiers,5,233,3,QROC,0.16,0.7,79.04,57,15,72,65,57,8,1.11,87.69,Moyen,Facile,1,Plus Facile que la Prediction,Pas Adapte
3430,2018,Economie,1,Le Capital et le Progres Technique,2,Le Capital: Aspect Physiques et Financiers,5,233,3,QROC,0.12,0.85,68.11,48,23,71,60,48,12,1.18,80.0,Facile,Facile,0,Meme Difficulte que la Prediction,Adapte
4496,2019,Economie,1,Le Capital et le Progres Technique,2,Le Capital: Aspect Physiques et Financiers,5,233,3,QROC,0.06,0.92,68.11,42,19,61,46,42,4,1.33,91.3,Facile,Facile,0,Meme Difficulte que la Prediction,Adapte
5562,2020,Economie,1,Le Capital et le Progres Technique,2,Le Capital: Aspect Physiques et Financiers,5,233,3,QROC,0.08,1.0,68.11,40,18,58,49,40,9,1.18,81.63,Facile,Facile,0,Meme Difficulte que la Prediction,Adapte
233,2015,Economie,1,Le Capital et le Progres Technique,2,Le Capital: Aspect Physiques et Financiers,5,234,4,QCU,0.51,0.38,2.18,1,41,42,37,1,36,1.14,2.7,Difficile,Difficile,0,Meme Difficulte que la Prediction,Pas Adapte
1299,2016,Economie,1,Le Capital et le Progres Technique,2,Le Capital: Aspect Physiques et Financiers,5,234,4,QCU,0.41,0.37,24.0,9,30,39,29,9,20,1.34,31.03,Facile,Difficile,-2,Beaucoup plus Difficile que la Prediction,Pas Adapte
2365,2017,Economie,1,Le Capital et le Progres Technique,2,Le Capital: Aspect Physiques et Financiers,5,234,4,QCU,0.07,0.91,79.09,31,8,39,34,31,3,1.15,91.18,Facile,Facile,0,Meme Difficulte que la Prediction,Pas Adapte
3431,2018,Economie,1,Le Capital et le Progres Technique,2,Le Capital: Aspect Physiques et Financiers,5,234,4,QCU,0.52,0.27,31.85,13,29,42,14,13,1,3.0,92.86,Difficile,Difficile,0,Meme Difficulte que la Prediction,Pas Adapte
4497,2019,Economie,1,Le Capital et le Progres Technique,2,Le Capital: Aspect Physiques et Financiers,5,234,4,QCU,0.4,0.45,48.49,20,22,42,22,20,2,1.91,90.91,Difficile,Moyen,1,Plus Facile que la Prediction,Pas Adapte
5563,2020,Economie,1,Le Capital et le Progres Technique,2,Le Capital: Aspect Physiques et Financiers,5,234,4,QCU,0.54,0.39,3.25,2,46,48,27,2,25,1.78,7.41,Difficile,Difficile,0,Meme Difficulte que la Prediction,Pas Adapte
234,2015,Economie,1,Le Capital et le Progres Technique,2,Le Capital: Aspect Physiques et Financiers,5,235,5,QCM,0.33,0.52,36.23,5,9,14,5,5,0,2.8,100.0,Difficile,Moyen,1,Plus Facile que la Prediction,Pas Adapte
1300,2016,Economie,1,Le Capital et le Progres Technique,2,Le Capital: Aspect Physiques et Financiers,5,235,5,QCM,0.06,0.94,94.27,14,1,15,14,14,0,1.07,100.0,Difficile,Facile,2,Beaucoup plus Facile que la Prediction,Pas Adapte
2366,2017,Economie,1,Le Capital et le Progres Technique,2,Le Capital: Aspect Physiques et Financiers,5,235,5,QCU,0.47,0.2,4.14,1,13,14,9,1,8,1.56,11.11,Difficile,Difficile,0,Meme Difficulte que la Prediction,Pas Adapte
3432,2018,Economie,1,Le Capital et le Progres Technique,2,Le Capital: Aspect Physiques et Financiers,5,235,5,QCU,0.15,0.77,83.72,10,2,12,11,10,1,1.09,90.91,Facile,Facile,0,Meme Difficulte que la Prediction,Pas Adapte
4498,2019,Economie,1,Le Capital et le Progres Technique,2,Le Capital: Aspect Physiques et Financiers,5,235,5,QCU,0.06,0.9,81.34,10,2,12,11,10,1,1.09,90.91,Moyen,Facile,1,Plus Facile que la Prediction,Pas Adapte
5564,2020,Economie,1,Le Capital et le Progres Technique,2,Le Capital: Aspect Physiques et Financiers,5,235,5,QCU,0.6,0.34,7.66,1,12,13,6,1,5,2.17,16.67,Difficile,Difficile,0,Meme Difficulte que la Prediction,Pas Adapte
235,2015,Economie,1,Le Capital et le Progres Technique,3,Les Differents Types d'Investissement et le Poids de l'Investissement Immateriel,9,236,1,QO,0.7,0.22,62.3,44,27,71,53,44,9,1.34,83.02,Facile,Moyen,-1,Plus Difficile que la Prediction,Adapte
1301,2016,Economie,1,Le Capital et le Progres Technique,3,Les Differents Types d'Investissement et le Poids de l'Investissement Immateriel,9,236,1,QO,0.53,0.16,62.3,38,23,61,39,38,1,1.56,97.44,Moyen,Moyen,0,Meme Difficulte que la Prediction,Adapte
2367,2017,Economie,1,Le Capital et le Progres Technique,3,Les Differents Types d'Investissement et le Poids de l'Investissement Immateriel,9,236,1,QO,0.44,0.2,62.3,38,23,61,56,38,18,1.09,67.86,Moyen,Moyen,0,Meme Difficulte que la Prediction,Adapte
3433,2018,Economie,1,Le Capital et le Progres Technique,3,Les Differents Types d'Investissement et le Poids de l'Investissement Immateriel,9,236,1,QO,0.43,0.19,62.3,34,20,54,46,34,12,1.17,73.91,Moyen,Moyen,0,Meme Difficulte que la Prediction,Adapte
4499,2019,Economie,1,Le Capital et le Progres Technique,3,Les Differents Types d'Investissement et le Poids de l'Investissement Immateriel,9,236,1,QO,0.52,0.29,62.3,37,22,59,56,37,19,1.05,66.07,Moyen,Moyen,0,Meme Difficulte que la Prediction,Adapte
5565,2020,Economie,1,Le Capital et le Progres Technique,3,Les Differents Types d'Investissement et le Poids de l'Investissement Immateriel,9,236,1,QCM,0.26,0.69,62.3,42,25,67,67,42,25,1.0,62.69,Moyen,Moyen,0,Meme Difficulte que la Prediction,Adapte
236,2015,Economie,1,Le Capital et le Progres Technique,3,Les Differents Types d'Investissement et le Poids de l'Investissement Immateriel,9,237,2,QCM,0.51,0.29,32.31,4,9,13,5,4,1,2.6,80.0,Moyen,Difficile,-1,Plus Difficile que la Prediction,Pas Adapte
1302,2016,Economie,1,Le Capital et le Progres Technique,3,Les Differents Types d'Investissement et le Poids de l'Investissement Immateriel,9,237,2,QCM,0.14,0.97,87.76,10,1,11,11,10,1,1.0,90.91,Facile,Facile,0,Meme Difficulte que la Prediction,Pas Adapte
2368,2017,Economie,1,Le Capital et le Progres Technique,3,Les Differents Types d'Investissement et le Poids de l'Investissement Immateriel,9,237,2,QCM,0.16,0.97,96.95,10,0,10,10,10,0,1.0,100.0,Facile,Facile,0,Meme Difficulte que la Prediction,Pas Adapte
3434,2018,Economie,1,Le Capital et le Progres Technique,3,Les Differents Types d'Investissement et le Poids de l'Investissement Immateriel,9,237,2,QCM,0.66,0.24,15.9,1,7,8,7,1,6,1.14,14.29,Difficile,Difficile,0,Meme Difficulte que la Prediction,Pas Adapte
4500,2019,Economie,1,Le Capital et le Progres Technique,3,Les Differents Types d'Investissement et le Poids de l'Investissement Immateriel,9,237,2,QCM,0.71,0.25,13.33,1,6,7,2,1,1,3.5,50.0,Difficile,Difficile,0,Meme Difficulte que la Prediction,Pas Adapte
5566,2020,Economie,1,Le Capital et le Progres Technique,3,Les Differents Types d'Investissement et le Poids de l'Investissement Immateriel,9,237,2,QCM,0.4,0.46,37.16,3,5,8,5,3,2,1.6,60.0,Moyen,Moyen,0,Meme Difficulte que la Prediction,Pas Adapte
237,2015,Economie,1,Le Capital et le Progres Technique,3,Les Differents Types d'Investissement et le Poids de l'Investissement Immateriel,9,238,3,QCU,0.11,0.93,69.25,53,24,77,65,53,12,1.18,81.54,Facile,Facile,0,Meme Difficulte que la Prediction,Adapte
1303,2016,Economie,1,Le Capital et le Progres Technique,3,Les Differents Types d'Investissement et le Poids de l'Investissement Immateriel,9,238,3,QCU,0.1,0.92,69.25,55,24,79,64,55,9,1.23,85.94,Facile,Facile,0,Meme Difficulte que la Prediction,Adapte
2369,2017,Economie,1,Le Capital et le Progres Technique,3,Les Differents Types d'Investissement et le Poids de l'Investissement Immateriel,9,238,3,QCU,0.05,0.78,69.25,50,22,72,63,50,13,1.14,79.37,Facile,Facile,0,Meme Difficulte que la Prediction,Adapte
3435,2018,Economie,1,Le Capital et le Progres Technique,3,Les Differents Types d'Investissement et le Poids de l'Investissement Immateriel,9,238,3,QCU,0.17,0.88,69.25,52,23,75,64,52,12,1.17,81.25,Facile,Facile,0,Meme Difficulte que la Prediction,Adapte
4501,2019,Economie,1,Le Capital et le Progres Technique,3,Les Differents Types d'Investissement et le Poids de l'Investissement Immateriel,9,238,3,QCM,0.15,0.98,69.25,46,20,66,58,46,12,1.14,79.31,Facile,Facile,0,Meme Difficulte que la Prediction,Adapte
5567,2020,Economie,1,Le Capital et le Progres Technique,3,Les Differents Types d'Investissement et le Poids de l'Investissement Immateriel,9,238,3,QCM,0.11,0.82,69.25,52,23,75,70,52,18,1.07,74.29,Facile,Facile,0,Meme Difficulte que la Prediction,Adapte
238,2015,Economie,1,Le Capital et le Progres Technique,3,Les Differents Types d'Investissement et le Poids de l'Investissement Immateriel,9,239,4,QCU,0.26,0.72,49.48,33,34,67,66,33,33,1.02,50.0,Difficile,Moyen,1,Plus Facile que la Prediction,Pas Adapte
1304,2016,Economie,1,Le Capital et le Progres Technique,3,Les Differents Types d'Investissement et le Poids de l'Investissement Immateriel,9,239,4,QO,0.87,0.02,32.49,24,51,75,48,24,24,1.56,50.0,Difficile,Difficile,0,Meme Difficulte que la Prediction,Pas Adapte
2370,2017,Economie,1,Le Capital et le Progres Technique,3,Les Differents Types d'Investissement et le Poids de l'Investissement Immateriel,9,239,4,QO,0.79,0.06,17.6,11,54,65,50,11,39,1.3,22.0,Difficile,Difficile,0,Meme Difficulte que la Prediction,Pas Adapte
3436,2018,Economie,1,Le Capital et le Progres Technique,3,Les Differents Types d'Investissement et le Poids de l'Investissement Immateriel,9,239,4,QO,0.65,0.3,51.87,38,36,74,52,38,14,1.42,73.08,Difficile,Moyen,1,Plus Facile que la Prediction,Pas Adapte
4502,2019,Economie,1,Le Capital et le Progres Technique,3,Les Differents Types d'Investissement et le Poids de l'Investissement Immateriel,9,239,4,QO,0.81,0.06,3.11,2,74,76,42,2,40,1.81,4.76,Difficile,Difficile,0,Meme Difficulte que la Prediction,Pas Adapte
5568,2020,Economie,1,Le Capital et le Progres Technique,3,Les Differents Types d'Investissement et le Poids de l'Investissement Immateriel,9,239,4,QO,0.4,0.3,60.63,40,26,66,52,40,12,1.27,76.92,Moyen,Moyen,0,Meme Difficulte que la Prediction,Adapte
239,2015,Economie,1,Le Capital et le Progres Technique,3,Les Differents Types d'Investissement et le Poids de l'Investissement Immateriel,9,240,5,QCU,0.71,0.25,14.85,13,75,88,33,13,20,2.67,39.39,Moyen,Difficile,-1,Plus Difficile que la Prediction,Pas Adapte
1305,2016,Economie,1,Le Capital et le Progres Technique,3,Les Differents Types d'Investissement et le Poids de l'Investissement Immateriel,9,240,5,QCU,0.21,0.64,47.25,36,41,77,66,36,30,1.17,54.55,Difficile,Moyen,1,Plus Facile que la Prediction,Pas Adapte
2371,2017,Economie,1,Le Capital et le Progres Technique,3,Les Differents Types d'Investissement et le Poids de l'Investissement Immateriel,9,240,5,QCU,0.14,0.92,95.31,82,4,86,85,82,3,1.01,96.47,Difficile,Facile,2,Beaucoup plus Facile que la Prediction,Pas Adapte
3437,2018,Economie,1,Le Capital et le Progres Technique,3,Les Differents Types d'Investissement et le Poids de l'Investissement Immateriel,9,240,5,QCU,0.17,0.96,88.71,65,8,73,67,65,2,1.09,97.01,Facile,Facile,0,Meme Difficulte que la Prediction,Pas Adapte
4503,2019,Economie,1,Le Capital et le Progres Technique,3,Les Differents Types d'Investissement et le Poids de l'Investissement Immateriel,9,240,5,QCU,0.65,0.24,20.52,15,59,74,44,15,29,1.68,34.09,Difficile,Difficile,0,Meme Difficulte que la Prediction,Pas Adapte
5569,2020,Economie,1,Le Capital et le Progres Technique,3,Les Differents Types d'Investissement et le Poids de l'Investissement Immateriel,9,240,5,QCU,0.14,0.88,80.66,65,16,81,73,65,8,1.11,89.04,Facile,Facile,0,Meme Difficulte que la Prediction,Pas Adapte
240,2015,Economie,1,Le Capital et le Progres Technique,3,Les Differents Types d'Investissement et le Poids de l'Investissement Immateriel,9,241,6,QCU,0.17,0.8,74.52,20,7,27,21,20,1,1.29,95.24,Facile,Facile,0,Meme Difficulte que la Prediction,Adapte
1306,2016,Economie,1,Le Capital et le Progres Technique,3,Les Differents Types d'Investissement et le Poids de l'Investissement Immateriel,9,241,6,QCU,0.16,0.9,74.52,20,7,27,21,20,1,1.29,95.24,Facile,Facile,0,Meme Difficulte que la Prediction,Adapte
2372,2017,Economie,1,Le Capital et le Progres Technique,3,Les Differents Types d'Investissement et le Poids de l'Investissement Immateriel,9,241,6,QCU,0.18,0.87,74.52,19,7,26,21,19,2,1.24,90.48,Facile,Facile,0,Meme Difficulte que la Prediction,Adapte
3438,2018,Economie,1,Le Capital et le Progres Technique,3,Les Differents Types d'Investissement et le Poids de l'Investissement Immateriel,9,241,6,QCU,0.15,0.88,74.52,19,7,26,20,19,1,1.3,95.0,Facile,Facile,0,Meme Difficulte que la Prediction,Adapte
4504,2019,Economie,1,Le Capital et le Progres Technique,3,Les Differents Types d'Investissement et le Poids de l'Investissement Immateriel,9,241,6,QCU,0.18,0.9,74.52,18,6,24,19,18,1,1.26,94.74,Facile,Facile,0,Meme Difficulte que la Prediction,Adapte
5570,2020,Economie,1,Le Capital et le Progres Technique,3,Les Differents Types d'Investissement et le Poids de l'Investissement Immateriel,9,241,6,QCU,0.19,0.96,74.52,16,6,22,20,16,4,1.1,80.0,Facile,Facile,0,Meme Difficulte que la Prediction,Adapte
241,2015,Economie,1,Le Capital et le Progres Technique,3,Les Differents Types d'Investissement et le Poids de l'Investissement Immateriel,9,242,7,QCU,0.35,0.53,38.07,24,38,62,36,24,12,1.72,66.67,Moyen,Moyen,0,Meme Difficulte que la Prediction,Pas Adapte
1307,2016,Economie,1,Le Capital et le Progres Technique,3,Les Differents Types d'Investissement et le Poids de l'Investissement Immateriel,9,242,7,QCU,0.65,0.28,27.77,20,51,71,25,20,5,2.84,80.0,Difficile,Difficile,0,Meme Difficulte que la Prediction,Pas Adapte
2373,2017,Economie,1,Le Capital et le Progres Technique,3,Les Differents Types d'Investissement et le Poids de l'Investissement Immateriel,9,242,7,QCU,0.17,0.97,79.4,52,14,66,63,52,11,1.05,82.54,Facile,Facile,0,Meme Difficulte que la Prediction,Pas Adapte
3439,2018,Economie,1,Le Capital et le Progres Technique,3,Les Differents Types d'Investissement et le Poids de l'Investissement Immateriel,9,242,7,QCU,0.36,0.56,56.35,34,27,61,34,34,0,1.79,100.0,Moyen,Moyen,0,Meme Difficulte que la Prediction,Pas Adapte
4505,2019,Economie,1,Le Capital et le Progres Technique,3,Les Differents Types d'Investissement et le Poids de l'Investissement Immateriel,9,242,7,QCU,0.56,0.31,29.26,20,49,69,63,20,43,1.1,31.75,Facile,Difficile,-2,Beaucoup plus Difficile que la Prediction,Pas Adapte
5571,2020,Economie,1,Le Capital et le Progres Technique,3,Les Differents Types d'Investissement et le Poids de l'Investissement Immateriel,9,242,7,QCU,0.75,0.25,7.61,5,63,68,39,5,34,1.74,12.82,Difficile,Difficile,0,Meme Difficulte que la Prediction,Pas Adapte
242,2015,Economie,1,Le Capital et le Progres Technique,3,Les Differents Types d'Investissement et le Poids de l'Investissement Immateriel,9,243,8,QCM,0.03,0.99,88.51,19,3,22,21,19,2,1.05,90.48,Moyen,Facile,1,Plus Facile que la Prediction,Pas Adapte
1308,2016,Economie,1,Le Capital et le Progres Technique,3,Les Differents Types d'Investissement et le Poids de l'Investissement Immateriel,9,243,8,QCM,0.31,0.46,38.48,10,15,25,16,10,6,1.56,62.5,Facile,Moyen,-1,Plus Difficile que la Prediction,Pas Adapte
2374,2017,Economie,1,Le Capital et le Progres Technique,3,Les Differents Types d'Investissement et le Poids de l'Investissement Immateriel,9,243,8,QCM,0.28,0.47,37.55,9,15,24,22,9,13,1.09,40.91,Moyen,Moyen,0,Meme Difficulte que la Prediction,Pas Adapte
3440,2018,Economie,1,Le Capital et le Progres Technique,3,Les Differents Types d'Investissement et le Poids de l'Investissement Immateriel,9,243,8,QCM,0.75,0.23,16.7,4,21,25,17,4,13,1.47,23.53,Moyen,Difficile,-1,Plus Difficile que la Prediction,Pas Adapte
4506,2019,Economie,1,Le Capital et le Progres Technique,3,Les Differents Types d'Investissement et le Poids de l'Investissement Immateriel,9,243,8,QCU,0.28,0.43,61.45,17,10,27,25,17,8,1.08,68.0,Moyen,Moyen,0,Meme Difficulte que la Prediction,Adapte
5572,2020,Economie,1,Le Capital et le Progres Technique,3,Les Differents Types d'Investissement et le Poids de l'Investissement Immateriel,9,243,8,QCU,0.28,0.59,61.45,14,9,23,18,14,4,1.28,77.78,Moyen,Moyen,0,Meme Difficulte que la Prediction,Adapte
243,2015,Economie,1,Le Capital et le Progres Technique,3,Les Differents Types d'Investissement et le Poids de l'Investissement Immateriel,9,244,9,QCU,0.34,0.59,36.41,8,14,22,13,8,5,1.69,61.54,Difficile,Moyen,1,Plus Facile que la Prediction,Pas Adapte
1309,2016,Economie,1,Le Capital et le Progres Technique,3,Les Differents Types d'Investissement et le Poids de l'Investissement Immateriel,9,244,9,QCU,0.53,0.31,15.24,3,16,19,17,3,14,1.12,17.65,Difficile,Difficile,0,Meme Difficulte que la Prediction,Pas Adapte
2375,2017,Economie,1,Le Capital et le Progres Technique,3,Les Differents Types d'Investissement et le Poids de l'Investissement Immateriel,9,244,9,QCU,0.28,0.52,37.94,7,11,18,14,7,7,1.29,50.0,Moyen,Moyen,0,Meme Difficulte que la Prediction,Pas Adapte
3441,2018,Economie,1,Le Capital et le Progres Technique,3,Les Differents Types d'Investissement et le Poids de l'Investissement Immateriel,9,244,9,QCM,0.5,0.33,55.35,12,9,21,18,12,6,1.17,66.67,Moyen,Moyen,0,Meme Difficulte que la Prediction,Pas Adapte
4507,2019,Economie,1,Le Capital et le Progres Technique,3,Les Differents Types d'Investissement et le Poids de l'Investissement Immateriel,9,244,9,QCM,0.65,0.26,19.3,3,15,18,8,3,5,2.25,37.5,Difficile,Difficile,0,Meme Difficulte que la Prediction,Pas Adapte
5573,2020,Economie,1,Le Capital et le Progres Technique,3,Les Differents Types d'Investissement et le Poids de l'Investissement Immateriel,9,244,9,QCM,0.53,0.28,16.06,3,16,19,15,3,12,1.27,20.0,Difficile,Difficile,0,Meme Difficulte que la Prediction,Pas Adapte
244,2015,Economie,1,Le Capital et le Progres Technique,4,Le Progres Technique - Nature et Role,6,245,1,QCM,0.57,0.2,25.35,24,70,94,43,24,19,2.19,55.81,Facile,Difficile,-2,Beaucoup plus Difficile que la Prediction,Pas Adapte
1310,2016,Economie,1,Le Capital et le Progres Technique,4,Le Progres Technique - Nature et Role,6,245,1,QCM,0.75,0.24,24.4,22,69,91,34,22,12,2.68,64.71,Difficile,Difficile,0,Meme Difficulte que la Prediction,Pas Adapte
2376,2017,Economie,1,Le Capital et le Progres Technique,4,Le Progres Technique - Nature et Role,6,245,1,QCM,0.38,0.5,61.07,54,34,88,81,54,27,1.09,66.67,Moyen,Moyen,0,Meme Difficulte que la Prediction,Adapte
3442,2018,Economie,1,Le Capital et le Progres Technique,4,Le Progres Technique - Nature et Role,6,245,1,QCM,0.34,0.69,61.07,51,32,83,55,51,4,1.51,92.73,Moyen,Moyen,0,Meme Difficulte que la Prediction,Adapte
4508,2019,Economie,1,Le Capital et le Progres Technique,4,Le Progres Technique - Nature et Role,6,245,1,QCM,0.36,0.47,61.07,51,32,83,80,51,29,1.04,63.75,Moyen,Moyen,0,Meme Difficulte que la Prediction,Adapte
5574,2020,Economie,1,Le Capital et le Progres Technique,4,Le Progres Technique - Nature et Role,6,245,1,QCM,0.28,0.65,61.07,56,36,92,81,56,25,1.14,69.14,Moyen,Moyen,0,Meme Difficulte que la Prediction,Adapte
245,2015,Economie,1,Le Capital et le Progres Technique,4,Le Progres Technique - Nature et Role,6,246,2,QCU,0.45,0.33,14.1,3,21,24,18,3,15,1.33,16.67,Difficile,Difficile,0,Meme Difficulte que la Prediction,Pas Adapte
1311,2016,Economie,1,Le Capital et le Progres Technique,4,Le Progres Technique - Nature et Role,6,246,2,QCU,0.05,0.9,77.55,21,6,27,25,21,4,1.08,84.0,Facile,Facile,0,Meme Difficulte que la Prediction,Pas Adapte
2377,2017,Economie,1,Le Capital et le Progres Technique,4,Le Progres Technique - Nature et Role,6,246,2,QCU,0.65,0.25,19.15,5,21,26,17,5,12,1.53,29.41,Difficile,Difficile,0,Meme Difficulte que la Prediction,Pas Adapte
3443,2018,Economie,1,Le Capital et le Progres Technique,4,Le Progres Technique - Nature et Role,6,246,2,QCU,0.42,0.21,32.18,9,18,27,10,9,1,2.7,90.0,Difficile,Difficile,0,Meme Difficulte que la Prediction,Pas Adapte
4509,2019,Economie,1,Le Capital et le Progres Technique,4,Le Progres Technique - Nature et Role,6,246,2,QCU,0.35,0.61,52.19,14,12,26,24,14,10,1.08,58.33,Moyen,Moyen,0,Meme Difficulte que la Prediction,Pas Adapte
5575,2020,Economie,1,Le Capital et le Progres Technique,4,Le Progres Technique - Nature et Role,6,246,2,QCU,0.52,0.28,11.31,3,27,30,20,3,17,1.5,15.0,Facile,Difficile,-2,Beaucoup plus Difficile que la Prediction,Pas Adapte
246,2015,Economie,1,Le Capital et le Progres Technique,4,Le Progres Technique - Nature et Role,6,247,3,QCM,0.76,0.2,10.79,8,68,76,56,8,48,1.36,14.29,Difficile,Difficile,0,Meme Difficulte que la Prediction,Pas Adapte
1312,2016,Economie,1,Le Capital et le Progres Technique,4,Le Progres Technique - Nature et Role,6,247,3,QCM,0.65,0.23,5.79,4,65,69,27,4,23,2.56,14.81,Difficile,Difficile,0,Meme Difficulte que la Prediction,Pas Adapte
2378,2017,Economie,1,Le Capital et le Progres Technique,4,Le Progres Technique - Nature et Role,6,247,3,QCM,0.19,0.86,67.18,48,23,71,61,48,13,1.16,78.69,Facile,Facile,0,Meme Difficulte que la Prediction,Adapte
3444,2018,Economie,1,Le Capital et le Progres Technique,4,Le Progres Technique - Nature et Role,6,247,3,QCM,0.17,0.76,67.18,47,23,70,55,47,8,1.27,85.45,Facile,Facile,0,Meme Difficulte que la Prediction,Adapte
4510,2019,Economie,1,Le Capital et le Progres Technique,4,Le Progres Technique - Nature et Role,6,247,3,QCM,0.13,0.94,67.18,50,25,75,59,50,9,1.27,84.75,Facile,Facile,0,Meme Difficulte que la Prediction,Adapte
5576,2020,Economie,1,Le Capital et le Progres Technique,4,Le Progres Technique - Nature et Role,6,247,3,QCM,0.12,0.85,67.18,45,22,67,51,45,6,1.31,88.24,Facile,Facile,0,Meme Difficulte que la Prediction,Adapte
247,2015,Economie,1,Le Capital et le Progres Technique,4,Le Progres Technique - Nature et Role,6,248,4,QCU,0.03,0.89,97.49,72,2,74,72,72,0,1.03,100.0,Difficile,Facile,2,Beaucoup plus Facile que la Prediction,Pas Adapte
1313,2016,Economie,1,Le Capital et le Progres Technique,4,Le Progres Technique - Nature et Role,6,248,4,QCU,0.12,0.84,98.32,71,1,72,72,71,1,1.0,98.61,Facile,Facile,0,Meme Difficulte que la Prediction,Pas Adapte
2379,2017,Economie,1,Le Capital et le Progres Technique,4,Le Progres Technique - Nature et Role,6,248,4,QCU,0.73,0.32,17.3,12,58,70,65,12,53,1.08,18.46,Facile,Difficile,-2,Beaucoup plus Difficile que la Prediction,Pas Adapte
3445,2018,Economie,1,Le Capital et le Progres Technique,4,Le Progres Technique - Nature et Role,6,248,4,QCU,0.21,0.43,36.5,22,39,61,58,22,36,1.05,37.93,Moyen,Moyen,0,Meme Difficulte que la Prediction,Pas Adapte
4511,2019,Economie,1,Le Capital et le Progres Technique,4,Le Progres Technique - Nature et Role,6,248,4,QCU,0.62,0.23,4.07,2,53,55,21,2,19,2.62,9.52,Facile,Difficile,-2,Beaucoup plus Difficile que la Prediction,Pas Adapte
5577,2020,Economie,1,Le Capital et le Progres Technique,4,Le Progres Technique - Nature et Role,6,248,4,QCU,0.28,0.65,61.13,29,18,47,42,29,13,1.12,69.05,Moyen,Moyen,0,Meme Difficulte que la Prediction,Adapte
248,2015,Economie,1,Le Capital et le Progres Technique,4,Le Progres Technique - Nature et Role,6,249,5,QCU,0.08,0.9,91.21,15,1,16,15,15,0,1.07,100.0,Facile,Facile,0,Meme Difficulte que la Prediction,Pas Adapte
1314,2016,Economie,1,Le Capital et le Progres Technique,4,Le Progres Technique - Nature et Role,6,249,5,QCU,0.12,0.83,85.69,14,2,16,15,14,1,1.07,93.33,Facile,Facile,0,Meme Difficulte que la Prediction,Pas Adapte
2380,2017,Economie,1,Le Capital et le Progres Technique,4,Le Progres Technique - Nature et Role,6,249,5,QCU,0.34,0.53,57.89,10,8,18,10,10,0,1.8,100.0,Facile,Moyen,-1,Plus Difficile que la Prediction,Pas Adapte
3446,2018,Economie,1,Le Capital et le Progres Technique,4,Le Progres Technique - Nature et Role,6,249,5,QCU,0.01,0.86,74.43,12,4,16,15,12,3,1.07,80.0,Facile,Facile,0,Meme Difficulte que la Prediction,Adapte
4512,2019,Economie,1,Le Capital et le Progres Technique,4,Le Progres Technique - Nature et Role,6,249,5,QCU,0.14,0.96,74.43,11,4,15,15,11,4,1.0,73.33,Facile,Facile,0,Meme Difficulte que la Prediction,Adapte
5578,2020,Economie,1,Le Capital et le Progres Technique,4,Le Progres Technique - Nature et Role,6,249,5,QCU,0.02,0.9,74.43,13,4,17,13,13,0,1.31,100.0,Facile,Facile,0,Meme Difficulte que la Prediction,Adapte
249,2015,Economie,1,Le Capital et le Progres Technique,4,Le Progres Technique - Nature et Role,6,250,6,QROC,0.63,0.19,16.84,17,81,98,76,17,59,1.29,22.37,Facile,Difficile,-2,Beaucoup plus Difficile que la Prediction,Pas Adapte
1315,2016,Economie,1,Le Capital et le Progres Technique,4,Le Progres Technique - Nature et Role,6,250,6,QROC,0.08,0.64,78.43,71,20,91,81,71,10,1.12,87.65,Moyen,Facile,1,Plus Facile que la Prediction,Pas Adapte
2381,2017,Economie,1,Le Capital et le Progres Technique,4,Le Progres Technique - Nature et Role,6,250,6,QROC,0.6,0.37,39.16,38,59,97,48,38,10,2.02,79.17,Moyen,Moyen,0,Meme Difficulte que la Prediction,Pas Adapte
3447,2018,Economie,1,Le Capital et le Progres Technique,4,Le Progres Technique - Nature et Role,6,250,6,QO,0.97,0.12,28.01,27,70,97,78,27,51,1.24,34.62,Difficile,Difficile,0,Meme Difficulte que la Prediction,Pas Adapte
4513,2019,Economie,1,Le Capital et le Progres Technique,4,Le Progres Technique - Nature et Role,6,250,6,QO,0.13,0.85,71.46,66,27,93,74,66,8,1.26,89.19,Difficile,Facile,2,Beaucoup plus Facile que la Prediction,Adapte
5579,2020,Economie,1,Le Capital et le Progres Technique,4,Le Progres Technique - Nature et Role,6,250,6,QO,0.02,0.68,71.46,62,25,87,85,62,23,1.02,72.94,Facile,Facile,0,Meme Difficulte que la Prediction,Adapte
250,2015,Information-Communication,1,Introduction a l'Etude du Langage,1,La Nature du Langage,8,251,1,QCU,0.6,0.24,0.39,0,64,64,43,0,43,1.49,0.0,Difficile,Difficile,0,Meme Difficulte que la Prediction,Pas Adapte
1316,2016,Information-Communication,1,Introduction a l'Etude du Langage,1,La Nature du Langage,8,251,1,QCU,0.38,0.5,55.28,32,26,58,43,32,11,1.35,74.42,Difficile,Moyen,1,Plus Facile que la Prediction,Pas Adapte
2382,2017,Information-Communication,1,Introduction a l'Etude du Langage,1,La Nature du Langage,8,251,1,QCU,0.06,0.78,90.2,56,6,62,60,56,4,1.03,93.33,Facile,Facile,0,Meme Difficulte que la Prediction,Pas Adapte
3448,2018,Information-Communication,1,Introduction a l'Etude du Langage,1,La Nature du Langage,8,251,1,QCU,0.43,0.34,2.15,1,52,53,33,1,32,1.61,3.03,Difficile,Difficile,0,Meme Difficulte que la Prediction,Pas Adapte
4514,2019,Information-Communication,1,Introduction a l'Etude du Langage,1,La Nature du Langage,8,251,1,QCM,0.7,0.22,31.61,17,36,53,24,17,7,2.21,70.83,Facile,Difficile,-2,Beaucoup plus Difficile que la Prediction,Pas Adapte
5580,2020,Information-Communication,1,Introduction a l'Etude du Langage,1,La Nature du Langage,8,251,1,QCM,0.13,0.98,70.85,41,17,58,48,41,7,1.21,85.42,Facile,Facile,0,Meme Difficulte que la Prediction,Adapte
251,2015,Information-Communication,1,Introduction a l'Etude du Langage,1,La Nature du Langage,8,252,2,QCU,0.18,0.87,81.04,53,13,66,54,53,1,1.22,98.15,Facile,Facile,0,Meme Difficulte que la Prediction,Pas Adapte
1317,2016,Information-Communication,1,Introduction a l'Etude du Langage,1,La Nature du Langage,8,252,2,QCU,0.65,0.27,7.46,5,58,63,28,5,23,2.25,17.86,Difficile,Difficile,0,Meme Difficulte que la Prediction,Pas Adapte
2383,2017,Information-Communication,1,Introduction a l'Etude du Langage,1,La Nature du Langage,8,252,2,QCU,0.37,0.53,55.56,32,25,57,36,32,4,1.58,88.89,Difficile,Moyen,1,Plus Facile que la Prediction,Pas Adapte
3449,2018,Information-Communication,1,Introduction a l'Etude du Langage,1,La Nature du Langage,8,252,2,QCU,0.53,0.23,20.65,13,50,63,31,13,18,2.03,41.94,Difficile,Difficile,0,Meme Difficulte que la Prediction,Pas Adapte
4515,2019,Information-Communication,1,Introduction a l'Etude du Langage,1,La Nature du Langage,8,252,2,QCU,0.61,0.35,24.3,14,44,58,44,14,30,1.32,31.82,Moyen,Difficile,-1,Plus Difficile que la Prediction,Pas Adapte
5581,2020,Information-Communication,1,Introduction a l'Etude du Langage,1,La Nature du Langage,8,252,2,QCU,0.24,0.55,60.91,30,20,50,41,30,11,1.22,73.17,Difficile,Moyen,1,Plus Facile que la Prediction,Adapte
252,2015,Information-Communication,1,Introduction a l'Etude du Langage,1,La Nature du Langage,8,253,3,QO,0.51,0.2,56.15,51,40,91,83,51,32,1.1,61.45,Facile,Moyen,-1,Plus Difficile que la Prediction,Pas Adapte
1318,2016,Information-Communication,1,Introduction a l'Etude du Langage,1,La Nature du Langage,8,253,3,QO,0.27,0.27,64.68,59,32,91,76,59,17,1.2,77.63,Moyen,Moyen,0,Meme Difficulte que la Prediction,Adapte
2384,2017,Information-Communication,1,Introduction a l'Etude du Langage,1,La Nature du Langage,8,253,3,QO,0.63,0.18,64.68,54,29,83,80,54,26,1.04,67.5,Moyen,Moyen,0,Meme Difficulte que la Prediction,Adapte
3450,2018,Information-Communication,1,Introduction a l'Etude du Langage,1,La Nature du Langage,8,253,3,QO,0.31,0.23,64.68,58,31,89,79,58,21,1.13,73.42,Moyen,Moyen,0,Meme Difficulte que la Prediction,Adapte
4516,2019,Information-Communication,1,Introduction a l'Etude du Langage,1,La Nature du Langage,8,253,3,QO,0.47,0.22,64.68,52,29,81,77,52,25,1.05,67.53,Moyen,Moyen,0,Meme Difficulte que la Prediction,Adapte
5582,2020,Information-Communication,1,Introduction a l'Etude du Langage,1,La Nature du Langage,8,253,3,QO,0.75,0.26,64.68,55,30,85,72,55,17,1.18,76.39,Moyen,Moyen,0,Meme Difficulte que la Prediction,Adapte
253,2015,Information-Communication,1,Introduction a l'Etude du Langage,1,La Nature du Langage,8,254,4,QCM,0.32,0.34,59.75,31,21,52,39,31,8,1.33,79.49,Moyen,Moyen,0,Meme Difficulte que la Prediction,Pas Adapte
1319,2016,Information-Communication,1,Introduction a l'Etude du Langage,1,La Nature du Langage,8,254,4,QCM,0.05,0.82,94.19,57,3,60,57,57,0,1.05,100.0,Difficile,Facile,2,Beaucoup plus Facile que la Prediction,Pas Adapte
2385,2017,Information-Communication,1,Introduction a l'Etude du Langage,1,La Nature du Langage,8,254,4,QCU,0.24,0.47,44.8,30,36,66,44,30,14,1.5,68.18,Moyen,Moyen,0,Meme Difficulte que la Prediction,Pas Adapte
3451,2018,Information-Communication,1,Introduction a l'Etude du Langage,1,La Nature du Langage,8,254,4,QCU,0.52,0.39,11.49,9,65,74,56,9,47,1.32,16.07,Difficile,Difficile,0,Meme Difficulte que la Prediction,Pas Adapte
4517,2019,Information-Communication,1,Introduction a l'Etude du Langage,1,La Nature du Langage,8,254,4,QCU,0.23,0.54,42.48,30,41,71,38,30,8,1.87,78.95,Difficile,Moyen,1,Plus Facile que la Prediction,Pas Adapte
5583,2020,Information-Communication,1,Introduction a l'Etude du Langage,1,La Nature du Langage,8,254,4,QCU,0.01,0.78,81.08,59,14,73,64,59,5,1.14,92.19,Moyen,Facile,1,Plus Facile que la Prediction,Pas Adapte
254,2015,Information-Communication,1,Introduction a l'Etude du Langage,1,La Nature du Langage,8,255,5,QROC,0.01,0.8,92.87,84,6,90,85,84,1,1.06,98.82,Facile,Facile,0,Meme Difficulte que la Prediction,Pas Adapte
1320,2016,Information-Communication,1,Introduction a l'Etude du Langage,1,La Nature du Langage,8,255,5,QROC,0.38,0.36,35.68,36,64,100,70,36,34,1.43,51.43,Moyen,Moyen,0,Meme Difficulte que la Prediction,Pas Adapte
2386,2017,Information-Communication,1,Introduction a l'Etude du Langage,1,La Nature du Langage,8,255,5,QROC,0.75,0.16,17.59,15,71,86,60,15,45,1.43,25.0,Moyen,Difficile,-1,Plus Difficile que la Prediction,Pas Adapte
3452,2018,Information-Communication,1,Introduction a l'Etude du Langage,1,La Nature du Langage,8,255,5,QROC,0.07,0.75,91.46,86,8,94,94,86,8,1.0,91.49,Difficile,Facile,2,Beaucoup plus Facile que la Prediction,Pas Adapte
4518,2019,Information-Communication,1,Introduction a l'Etude du Langage,1,La Nature du Langage,8,255,5,QCU,0.74,0.26,18.53,16,68,84,37,16,21,2.27,43.24,Difficile,Difficile,0,Meme Difficulte que la Prediction,Pas Adapte
5584,2020,Information-Communication,1,Introduction a l'Etude du Langage,1,La Nature du Langage,8,255,5,QCU,0.18,0.89,91.27,67,6,73,72,67,5,1.01,93.06,Facile,Facile,0,Meme Difficulte que la Prediction,Pas Adapte
255,2015,Information-Communication,1,Introduction a l'Etude du Langage,1,La Nature du Langage,8,256,6,QCM,0.78,0.16,22.81,14,49,63,57,14,43,1.11,24.56,Difficile,Difficile,0,Meme Difficulte que la Prediction,Pas Adapte
1321,2016,Information-Communication,1,Introduction a l'Etude du Langage,1,La Nature du Langage,8,256,6,QCM,0.76,0.3,3.84,3,63,66,41,3,38,1.61,7.32,Facile,Difficile,-2,Beaucoup plus Difficile que la Prediction,Pas Adapte
2387,2017,Information-Communication,1,Introduction a l'Etude du Langage,1,La Nature du Langage,8,256,6,QCM,0.78,0.16,8.87,5,54,59,19,5,14,3.11,26.32,Difficile,Difficile,0,Meme Difficulte que la Prediction,Pas Adapte
3453,2018,Information-Communication,1,Introduction a l'Etude du Langage,1,La Nature du Langage,8,256,6,QCM,0.43,0.64,54.84,37,30,67,42,37,5,1.6,88.1,Moyen,Moyen,0,Meme Difficulte que la Prediction,Pas Adapte
4519,2019,Information-Communication,1,Introduction a l'Etude du Langage,1,La Nature du Langage,8,256,6,QCM,0.0,0.8,66.09,49,25,74,70,49,21,1.06,70.0,Moyen,Facile,1,Plus Facile que la Prediction,Adapte
5585,2020,Information-Communication,1,Introduction a l'Etude du Langage,1,La Nature du Langage,8,256,6,QROC,0.08,0.73,66.09,52,27,79,75,52,23,1.05,69.33,Facile,Facile,0,Meme Difficulte que la Prediction,Adapte
256,2015,Information-Communication,1,Introduction a l'Etude du Langage,1,La Nature du Langage,8,257,7,QCU,0.44,0.25,10.04,3,28,31,16,3,13,1.94,18.75,Difficile,Difficile,0,Meme Difficulte que la Prediction,Pas Adapte
1322,2016,Information-Communication,1,Introduction a l'Etude du Langage,1,La Nature du Langage,8,257,7,QCU,0.4,0.64,54.06,14,12,26,23,14,9,1.13,60.87,Moyen,Moyen,0,Meme Difficulte que la Prediction,Pas Adapte
2388,2017,Information-Communication,1,Introduction a l'Etude du Langage,1,La Nature du Langage,8,257,7,QCU,0.49,0.22,9.44,2,23,25,9,2,7,2.78,22.22,Difficile,Difficile,0,Meme Difficulte que la Prediction,Pas Adapte
3454,2018,Information-Communication,1,Introduction a l'Etude du Langage,1,La Nature du Langage,8,257,7,QCU,0.67,0.39,9.98,2,19,21,12,2,10,1.75,16.67,Facile,Difficile,-2,Beaucoup plus Difficile que la Prediction,Pas Adapte
4520,2019,Information-Communication,1,Introduction a l'Etude du Langage,1,La Nature du Langage,8,257,7,QCU,0.2,0.88,91.07,22,2,24,23,22,1,1.04,95.65,Difficile,Facile,2,Beaucoup plus Facile que la Prediction,Pas Adapte
5586,2020,Information-Communication,1,Introduction a l'Etude du Langage,1,La Nature du Langage,8,257,7,QCU,0.74,0.3,0.0,0,20,20,16,0,16,1.25,0.0,Facile,Difficile,-2,Beaucoup plus Difficile que la Prediction,Pas Adapte
257,2015,Information-Communication,1,Introduction a l'Etude du Langage,1,La Nature du Langage,8,258,8,QROC,0.13,0.75,66.31,64,32,96,76,64,12,1.26,84.21,Facile,Facile,0,Meme Difficulte que la Prediction,Adapte
1323,2016,Information-Communication,1,Introduction a l'Etude du Langage,1,La Nature du Langage,8,258,8,QROC,0.03,0.43,66.31,59,30,89,74,59,15,1.2,79.73,Facile,Facile,0,Meme Difficulte que la Prediction,Adapte
2389,2017,Information-Communication,1,Introduction a l'Etude du Langage,1,La Nature du Langage,8,258,8,QO,0.1,0.31,66.31,52,27,79,66,52,14,1.2,78.79,Facile,Facile,0,Meme Difficulte que la Prediction,Adapte
3455,2018,Information-Communication,1,Introduction a l'Etude du Langage,1,La Nature du Langage,8,258,8,QO,0.05,0.48,66.31,58,29,87,67,58,9,1.3,86.57,Facile,Facile,0,Meme Difficulte que la Prediction,Adapte
4521,2019,Information-Communication,1,Introduction a l'Etude du Langage,1,La Nature du Langage,8,258,8,QO,0.06,0.4,66.31,65,33,98,86,65,21,1.14,75.58,Facile,Facile,0,Meme Difficulte que la Prediction,Adapte
5587,2020,Information-Communication,1,Introduction a l'Etude du Langage,1,La Nature du Langage,8,258,8,QO,0.09,0.61,66.31,67,34,101,84,67,17,1.2,79.76,Facile,Facile,0,Meme Difficulte que la Prediction,Adapte
258,2015,Information-Communication,1,Introduction a l'Etude du Langage,2,La Semiotique,7,259,1,QCM,0.79,0.22,24.48,15,48,63,50,15,35,1.26,30.0,Difficile,Difficile,0,Meme Difficulte que la Prediction,Pas Adapte
1324,2016,Information-Communication,1,Introduction a l'Etude du Langage,2,La Semiotique,7,259,1,QCM,0.44,0.45,56.36,34,27,61,43,34,9,1.42,79.07,Difficile,Moyen,1,Plus Facile que la Prediction,Pas Adapte
2390,2017,Information-Communication,1,Introduction a l'Etude du Langage,2,La Semiotique,7,259,1,QCM,0.73,0.29,7.58,5,56,61,41,5,36,1.49,12.2,Moyen,Difficile,-1,Plus Difficile que la Prediction,Pas Adapte
3456,2018,Information-Communication,1,Introduction a l'Etude du Langage,2,La Semiotique,7,259,1,QCM,0.08,0.75,77.82,54,16,70,60,54,6,1.17,90.0,Difficile,Facile,2,Beaucoup plus Facile que la Prediction,Pas Adapte
4522,2019,Information-Communication,1,Introduction a l'Etude du Langage,2,La Semiotique,7,259,1,QCM,0.64,0.18,13.27,8,55,63,17,8,9,3.71,47.06,Moyen,Difficile,-1,Plus Difficile que la Prediction,Pas Adapte
5588,2020,Information-Communication,1,Introduction a l'Etude du Langage,2,La Semiotique,7,259,1,QCM,0.39,0.45,47.78,29,31,60,41,29,12,1.46,70.73,Facile,Moyen,-1,Plus Difficile que la Prediction,Pas Adapte
259,2015,Information-Communication,1,Introduction a l'Etude du Langage,2,La Semiotique,7,260,2,QCM,0.05,0.97,70.83,47,19,66,62,47,15,1.06,75.81,Moyen,Facile,1,Plus Facile que la Prediction,Adapte
1325,2016,Information-Communication,1,Introduction a l'Etude du Langage,2,La Semiotique,7,260,2,QCM,0.18,0.8,70.83,45,18,63,50,45,5,1.26,90.0,Facile,Facile,0,Meme Difficulte que la Prediction,Adapte
2391,2017,Information-Communication,1,Introduction a l'Etude du Langage,2,La Semiotique,7,260,2,QCU,0.19,0.76,70.83,40,16,56,43,40,3,1.3,93.02,Facile,Facile,0,Meme Difficulte que la Prediction,Adapte
3457,2018,Information-Communication,1,Introduction a l'Etude du Langage,2,La Semiotique,7,260,2,QCU,0.08,0.96,70.83,45,19,64,47,45,2,1.36,95.74,Facile,Facile,0,Meme Difficulte que la Prediction,Adapte
4523,2019,Information-Communication,1,Introduction a l'Etude du Langage,2,La Semiotique,7,260,2,QCU,0.04,0.98,70.83,47,19,66,52,47,5,1.27,90.38,Facile,Facile,0,Meme Difficulte que la Prediction,Adapte
5589,2020,Information-Communication,1,Introduction a l'Etude du Langage,2,La Semiotique,7,260,2,QCM,0.02,0.85,70.83,45,18,63,62,45,17,1.02,72.58,Facile,Facile,0,Meme Difficulte que la Prediction,Adapte
260,2015,Information-Communication,1,Introduction a l'Etude du Langage,2,La Semiotique,7,261,3,QCM,0.02,0.78,79.79,36,9,45,44,36,8,1.02,81.82,Difficile,Facile,2,Beaucoup plus Facile que la Prediction,Pas Adapte
1326,2016,Information-Communication,1,Introduction a l'Etude du Langage,2,La Semiotique,7,261,3,QCM,0.45,0.67,35.31,13,25,38,19,13,6,2.0,68.42,Moyen,Moyen,0,Meme Difficulte que la Prediction,Pas Adapte
2392,2017,Information-Communication,1,Introduction a l'Etude du Langage,2,La Semiotique,7,261,3,QCM,0.05,0.78,67.36,24,12,36,27,24,3,1.33,88.89,Facile,Facile,0,Meme Difficulte que la Prediction,Adapte
3458,2018,Information-Communication,1,Introduction a l'Etude du Langage,2,La Semiotique,7,261,3,QCM,0.02,1.0,67.36,26,13,39,27,26,1,1.44,96.3,Facile,Facile,0,Meme Difficulte que la Prediction,Adapte
4524,2019,Information-Communication,1,Introduction a l'Etude du Langage,2,La Semiotique,7,261,3,QCU,0.02,0.85,67.36,24,11,35,26,24,2,1.35,92.31,Facile,Facile,0,Meme Difficulte que la Prediction,Adapte
5590,2020,Information-Communication,1,Introduction a l'Etude du Langage,2,La Semiotique,7,261,3,QCM,0.18,0.77,67.36,24,12,36,28,24,4,1.29,85.71,Facile,Facile,0,Meme Difficulte que la Prediction,Adapte
261,2015,Information-Communication,1,Introduction a l'Etude du Langage,2,La Semiotique,7,262,4,QROC,0.86,0.22,13.97,2,10,12,6,2,4,2.0,33.33,Facile,Difficile,-2,Beaucoup plus Difficile que la Prediction,Pas Adapte
1327,2016,Information-Communication,1,Introduction a l'Etude du Langage,2,La Semiotique,7,262,4,QROC,0.66,0.19,17.47,2,12,14,11,2,9,1.27,18.18,Difficile,Difficile,0,Meme Difficulte que la Prediction,Pas Adapte
2393,2017,Information-Communication,1,Introduction a l'Etude du Langage,2,La Semiotique,7,262,4,QROC,0.07,0.4,92.65,14,1,15,14,14,0,1.07,100.0,Facile,Facile,0,Meme Difficulte que la Prediction,Pas Adapte
3459,2018,Information-Communication,1,Introduction a l'Etude du Langage,2,La Semiotique,7,262,4,QROC,0.05,0.59,98.45,14,0,14,14,14,0,1.0,100.0,Moyen,Facile,1,Plus Facile que la Prediction,Pas Adapte
4525,2019,Information-Communication,1,Introduction a l'Etude du Langage,2,La Semiotique,7,262,4,QROC,0.65,0.16,12.88,2,14,16,10,2,8,1.6,20.0,Difficile,Difficile,0,Meme Difficulte que la Prediction,Pas Adapte
5591,2020,Information-Communication,1,Introduction a l'Etude du Langage,2,La Semiotique,7,262,4,QROC,0.03,0.61,89.24,14,2,16,15,14,1,1.07,93.33,Facile,Facile,0,Meme Difficulte que la Prediction,Pas Adapte
262,2015,Information-Communication,1,Introduction a l'Etude du Langage,2,La Semiotique,7,263,5,QCM,0.02,0.8,88.62,42,5,47,46,42,4,1.02,91.3,Facile,Facile,0,Meme Difficulte que la Prediction,Pas Adapte
1328,2016,Information-Communication,1,Introduction a l'Etude du Langage,2,La Semiotique,7,263,5,QCM,0.16,0.8,87.99,44,6,50,47,44,3,1.06,93.62,Difficile,Facile,2,Beaucoup plus Facile que la Prediction,Pas Adapte
2394,2017,Information-Communication,1,Introduction a l'Etude du Langage,2,La Semiotique,7,263,5,QCM,0.06,0.72,68.79,39,18,57,46,39,7,1.24,84.78,Difficile,Facile,2,Beaucoup plus Facile que la Prediction,Adapte
3460,2018,Information-Communication,1,Introduction a l'Etude du Langage,2,La Semiotique,7,263,5,QCM,0.03,0.82,68.79,40,18,58,55,40,15,1.05,72.73,Facile,Facile,0,Meme Difficulte que la Prediction,Adapte
4526,2019,Information-Communication,1,Introduction a l'Etude du Langage,2,La Semiotique,7,263,5,QCU,0.01,0.94,68.79,34,16,50,39,34,5,1.28,87.18,Facile,Facile,0,Meme Difficulte que la Prediction,Adapte
5592,2020,Information-Communication,1,Introduction a l'Etude du Langage,2,La Semiotique,7,263,5,QCU,0.13,0.77,68.79,39,18,57,42,39,3,1.36,92.86,Facile,Facile,0,Meme Difficulte que la Prediction,Adapte
263,2015,Information-Communication,1,Introduction a l'Etude du Langage,2,La Semiotique,7,264,6,QROC,0.66,0.08,7.17,6,74,80,71,6,65,1.13,8.45,Difficile,Difficile,0,Meme Difficulte que la Prediction,Pas Adapte
1329,2016,Information-Communication,1,Introduction a l'Etude du Langage,2,La Semiotique,7,264,6,QCM,0.41,0.32,36.7,28,48,76,40,28,12,1.9,70.0,Facile,Moyen,-1,Plus Difficile que la Prediction,Pas Adapte
2395,2017,Information-Communication,1,Introduction a l'Etude du Langage,2,La Semiotique,7,264,6,QCU,0.58,0.37,20.95,15,55,70,52,15,37,1.35,28.85,Difficile,Difficile,0,Meme Difficulte que la Prediction,Pas Adapte
3461,2018,Information-Communication,1,Introduction a l'Etude du Langage,2,La Semiotique,7,264,6,QCU,0.16,0.87,88.35,62,8,70,68,62,6,1.03,91.18,Difficile,Facile,2,Beaucoup plus Facile que la Prediction,Pas Adapte
4527,2019,Information-Communication,1,Introduction a l'Etude du Langage,2,La Semiotique,7,264,6,QCU,0.58,0.26,16.43,12,62,74,46,12,34,1.61,26.09,Difficile,Difficile,0,Meme Difficulte que la Prediction,Pas Adapte
5593,2020,Information-Communication,1,Introduction a l'Etude du Langage,2,La Semiotique,7,264,6,QCU,0.49,0.2,4.54,3,74,77,44,3,41,1.75,6.82,Facile,Difficile,-2,Beaucoup plus Difficile que la Prediction,Pas Adapte
264,2015,Information-Communication,1,Introduction a l'Etude du Langage,2,La Semiotique,7,265,7,QO,0.5,0.29,57.95,44,32,76,46,44,2,1.65,95.65,Moyen,Moyen,0,Meme Difficulte que la Prediction,Pas Adapte
1330,2016,Information-Communication,1,Introduction a l'Etude du Langage,2,La Semiotique,7,265,7,QROC,0.16,0.8,97.96,73,2,75,74,73,1,1.01,98.65,Facile,Facile,0,Meme Difficulte que la Prediction,Pas Adapte
2396,2017,Information-Communication,1,Introduction a l'Etude du Langage,2,La Semiotique,7,265,7,QROC,0.56,0.3,35.19,23,43,66,64,23,41,1.03,35.94,Moyen,Moyen,0,Meme Difficulte que la Prediction,Pas Adapte
3462,2018,Information-Communication,1,Introduction a l'Etude du Langage,2,La Semiotique,7,265,7,QROC,0.76,0.19,30.14,18,41,59,32,18,14,1.84,56.25,Difficile,Difficile,0,Meme Difficulte que la Prediction,Pas Adapte
4528,2019,Information-Communication,1,Introduction a l'Etude du Langage,2,La Semiotique,7,265,7,QCM,0.76,0.16,0.42,0,66,66,26,0,26,2.54,0.0,Difficile,Difficile,0,Meme Difficulte que la Prediction,Pas Adapte
5594,2020,Information-Communication,1,Introduction a l'Etude du Langage,2,La Semiotique,7,265,7,QCM,0.09,0.91,89.99,52,6,58,55,52,3,1.05,94.55,Facile,Facile,0,Meme Difficulte que la Prediction,Pas Adapte
265,2015,Information-Communication,1,Introduction a l'Etude du Langage,3,La Morphologie,14,266,1,QROC,0.33,0.33,56.18,50,39,89,67,50,17,1.33,74.63,Facile,Moyen,-1,Plus Difficile que la Prediction,Pas Adapte
1331,2016,Information-Communication,1,Introduction a l'Etude du Langage,3,La Morphologie,14,266,1,QROC,0.98,0.1,27.89,22,57,79,37,22,15,2.14,59.46,Difficile,Difficile,0,Meme Difficulte que la Prediction,Pas Adapte
2397,2017,Information-Communication,1,Introduction a l'Etude du Langage,3,La Morphologie,14,266,1,QROC,0.98,0.01,24.74,21,63,84,79,21,58,1.06,26.58,Difficile,Difficile,0,Meme Difficulte que la Prediction,Pas Adapte
3463,2018,Information-Communication,1,Introduction a l'Etude du Langage,3,La Morphologie,14,266,1,QROC,0.37,0.4,52.81,40,35,75,72,40,32,1.04,55.56,Facile,Moyen,-1,Plus Difficile que la Prediction,Pas Adapte
4529,2019,Information-Communication,1,Introduction a l'Etude du Langage,3,La Morphologie,14,266,1,QROC,0.48,0.37,60.26,51,33,84,79,51,28,1.06,64.56,Moyen,Moyen,0,Meme Difficulte que la Prediction,Adapte
5595,2020,Information-Communication,1,Introduction a l'Etude du Langage,3,La Morphologie,14,266,1,QROC,0.47,0.31,60.26,54,35,89,77,54,23,1.16,70.13,Moyen,Moyen,0,Meme Difficulte que la Prediction,Adapte
266,2015,Information-Communication,1,Introduction a l'Etude du Langage,3,La Morphologie,14,267,2,QROC,0.11,0.97,79.95,42,10,52,52,42,10,1.0,80.77,Facile,Facile,0,Meme Difficulte que la Prediction,Pas Adapte
1332,2016,Information-Communication,1,Introduction a l'Etude du Langage,3,La Morphologie,14,267,2,QROC,0.98,0.17,15.72,9,50,59,34,9,25,1.74,26.47,Difficile,Difficile,0,Meme Difficulte que la Prediction,Pas Adapte
2398,2017,Information-Communication,1,Introduction a l'Etude du Langage,3,La Morphologie,14,267,2,QO,0.77,0.01,16.88,10,47,57,29,10,19,1.97,34.48,Facile,Difficile,-2,Beaucoup plus Difficile que la Prediction,Pas Adapte
3464,2018,Information-Communication,1,Introduction a l'Etude du Langage,3,La Morphologie,14,267,2,QO,0.06,0.94,71.1,39,16,55,50,39,11,1.1,78.0,Facile,Facile,0,Meme Difficulte que la Prediction,Adapte
4530,2019,Information-Communication,1,Introduction a l'Etude du Langage,3,La Morphologie,14,267,2,QO,0.08,0.41,71.1,36,15,51,43,36,7,1.19,83.72,Facile,Facile,0,Meme Difficulte que la Prediction,Adapte
5596,2020,Information-Communication,1,Introduction a l'Etude du Langage,3,La Morphologie,14,267,2,QO,0.07,0.91,71.1,38,16,54,45,38,7,1.2,84.44,Facile,Facile,0,Meme Difficulte que la Prediction,Adapte
267,2015,Information-Communication,1,Introduction a l'Etude du Langage,3,La Morphologie,14,268,3,QO,0.89,0.13,17.35,17,79,96,62,17,45,1.55,27.42,Difficile,Difficile,0,Meme Difficulte que la Prediction,Pas Adapte
1333,2016,Information-Communication,1,Introduction a l'Etude du Langage,3,La Morphologie,14,268,3,QO,0.92,0.06,3.11,3,79,82,45,3,42,1.82,6.67,Difficile,Difficile,0,Meme Difficulte que la Prediction,Pas Adapte
2399,2017,Information-Communication,1,Introduction a l'Etude du Langage,3,La Morphologie,14,268,3,QO,0.81,0.11,26.26,20,55,75,53,20,33,1.42,37.74,Difficile,Difficile,0,Meme Difficulte que la Prediction,Pas Adapte
3465,2018,Information-Communication,1,Introduction a l'Etude du Langage,3,La Morphologie,14,268,3,QO,0.5,0.19,48.92,39,41,80,79,39,40,1.01,49.37,Difficile,Moyen,1,Plus Facile que la Prediction,Pas Adapte
4531,2019,Information-Communication,1,Introduction a l'Etude du Langage,3,La Morphologie,14,268,3,QO,0.87,0.09,20.31,15,61,76,62,15,47,1.23,24.19,Difficile,Difficile,0,Meme Difficulte que la Prediction,Pas Adapte
5597,2020,Information-Communication,1,Introduction a l'Etude du Langage,3,La Morphologie,14,268,3,QO,0.53,0.24,38.89,29,45,74,68,29,39,1.09,42.65,Facile,Moyen,-1,Plus Difficile que la Prediction,Pas Adapte
268,2015,Information-Communication,1,Introduction a l'Etude du Langage,3,La Morphologie,14,269,4,QCU,0.11,0.91,84.85,54,10,64,63,54,9,1.02,85.71,Facile,Facile,0,Meme Difficulte que la Prediction,Pas Adapte
1334,2016,Information-Communication,1,Introduction a l'Etude du Langage,3,La Morphologie,14,269,4,QCU,0.19,0.84,88.2,55,7,62,59,55,4,1.05,93.22,Difficile,Facile,2,Beaucoup plus Facile que la Prediction,Pas Adapte
2400,2017,Information-Communication,1,Introduction a l'Etude du Langage,3,La Morphologie,14,269,4,QCM,0.46,0.59,58.49,31,22,53,52,31,21,1.02,59.62,Difficile,Moyen,1,Plus Facile que la Prediction,Pas Adapte
3466,2018,Information-Communication,1,Introduction a l'Etude du Langage,3,La Morphologie,14,269,4,QCM,0.0,0.9,81.18,44,10,54,51,44,7,1.06,86.27,Facile,Facile,0,Meme Difficulte que la Prediction,Pas Adapte
4532,2019,Information-Communication,1,Introduction a l'Etude du Langage,3,La Morphologie,14,269,4,QCM,0.34,0.51,39.16,22,34,56,45,22,23,1.24,48.89,Difficile,Moyen,1,Plus Facile que la Prediction,Pas Adapte
5598,2020,Information-Communication,1,Introduction a l'Etude du Langage,3,La Morphologie,14,269,4,QCM,0.02,0.95,76.96,47,14,61,54,47,7,1.13,87.04,Difficile,Facile,2,Beaucoup plus Facile que la Prediction,Pas Adapte
269,2015,Information-Communication,1,Introduction a l'Etude du Langage,3,La Morphologie,14,270,5,QROC,0.35,0.4,37.27,10,18,28,25,10,15,1.12,40.0,Moyen,Moyen,0,Meme Difficulte que la Prediction,Pas Adapte
1335,2016,Information-Communication,1,Introduction a l'Etude du Langage,3,La Morphologie,14,270,5,QROC,0.17,0.89,73.18,19,7,26,23,19,4,1.13,82.61,Facile,Facile,0,Meme Difficulte que la Prediction,Adapte
2401,2017,Information-Communication,1,Introduction a l'Etude du Langage,3,La Morphologie,14,270,5,QROC,0.13,0.77,73.18,16,6,22,20,16,4,1.1,80.0,Facile,Facile,0,Meme Difficulte que la Prediction,Adapte
3467,2018,Information-Communication,1,Introduction a l'Etude du Langage,3,La Morphologie,14,270,5,QROC,0.16,0.51,73.18,16,6,22,20,16,4,1.1,80.0,Facile,Facile,0,Meme Difficulte que la Prediction,Adapte
4533,2019,Information-Communication,1,Introduction a l'Etude du Langage,3,La Morphologie,14,270,5,QROC,0.13,0.92,73.18,15,6,21,15,15,0,1.4,100.0,Facile,Facile,0,Meme Difficulte que la Prediction,Adapte
5599,2020,Information-Communication,1,Introduction a l'Etude du Langage,3,La Morphologie,14,270,5,QO,0.18,0.73,73.18,16,6,22,19,16,3,1.16,84.21,Facile,Facile,0,Meme Difficulte que la Prediction,Adapte
270,2015,Information-Communication,1,Introduction a l'Etude du Langage,3,La Morphologie,14,271,6,QCU,0.72,0.21,9.72,5,46,51,21,5,16,2.43,23.81,Difficile,Difficile,0,Meme Difficulte que la Prediction,Pas Adapte
1336,2016,Information-Communication,1,Introduction a l'Etude du Langage,3,La Morphologie,14,271,6,QCU,0.06,0.86,78.82,35,9,44,40,35,5,1.1,87.5,Moyen,Facile,1,Plus Facile que la Prediction,Pas Adapte
2402,2017,Information-Communication,1,Introduction a l'Etude du Langage,3,La Morphologie,14,271,6,QCU,0.28,0.47,57.43,24,17,41,32,24,8,1.28,75.0,Moyen,Moyen,0,Meme Difficulte que la Prediction,Pas Adapte
3468,2018,Information-Communication,1,Introduction a l'Etude du Langage,3,La Morphologie,14,271,6,QCU,0.38,0.46,47.02,21,24,45,34,21,13,1.32,61.76,Moyen,Moyen,0,Meme Difficulte que la Prediction,Pas Adapte
4534,2019,Information-Communication,1,Introduction a l'Etude du Langage,3,La Morphologie,14,271,6,QCU,0.04,0.97,70.96,37,15,52,50,37,13,1.04,74.0,Facile,Facile,0,Meme Difficulte que la Prediction,Adapte
5600,2020,Information-Communication,1,Introduction a l'Etude du Langage,3,La Morphologie,14,271,6,QCU,0.1,0.76,70.96,40,16,56,51,40,11,1.1,78.43,Facile,Facile,0,Meme Difficulte que la Prediction,Adapte
271,2015,Information-Communication,1,Introduction a l'Etude du Langage,3,La Morphologie,14,272,7,QCM,0.29,0.41,45.47,20,24,44,32,20,12,1.38,62.5,Facile,Moyen,-1,Plus Difficile que la Prediction,Pas Adapte
1337,2016,Information-Communication,1,Introduction a l'Etude du Langage,3,La Morphologie,14,272,7,QCM,0.78,0.17,24.73,11,35,46,32,11,21,1.44,34.38,Difficile,Difficile,0,Meme Difficulte que la Prediction,Pas Adapte
2403,2017,Information-Communication,1,Introduction a l'Etude du Langage,3,La Morphologie,14,272,7,QCM,0.2,0.81,85.06,40,7,47,45,40,5,1.04,88.89,Facile,Facile,0,Meme Difficulte que la Prediction,Pas Adapte
3469,2018,Information-Communication,1,Introduction a l'Etude du Langage,3,La Morphologie,14,272,7,QCM,0.41,0.58,61.53,30,19,49,40,30,10,1.23,75.0,Facile,Moyen,-1,Plus Difficile que la Prediction,Adapte
4535,2019,Information-Communication,1,Introduction a l'Etude du Langage,3,La Morphologie,14,272,7,QCU,0.28,0.64,61.53,31,19,50,46,31,15,1.09,67.39,Moyen,Moyen,0,Meme Difficulte que la Prediction,Adapte
5601,2020,Information-Communication,1,Introduction a l'Etude du Langage,3,La Morphologie,14,272,7,QCU,0.3,0.59,61.53,30,18,48,47,30,17,1.02,63.83,Moyen,Moyen,0,Meme Difficulte que la Prediction,Adapte
272,2015,Information-Communication,1,Introduction a l'Etude du Langage,3,La Morphologie,14,273,8,QCU,0.37,0.53,62.17,35,22,57,43,35,8,1.33,81.4,Facile,Moyen,-1,Plus Difficile que la Prediction,Adapte
1338,2016,Information-Communication,1,Introduction a l'Etude du Langage,3,La Morphologie,14,273,8,QCU,0.22,0.6,62.17,38,23,61,56,38,18,1.09,67.86,Moyen,Moyen,0,Meme Difficulte que la Prediction,Adapte
2404,2017,Information-Communication,1,Introduction a l'Etude du Langage,3,La Morphologie,14,273,8,QCU,0.37,0.61,62.17,34,20,54,35,34,1,1.54,97.14,Moyen,Moyen,0,Meme Difficulte que la Prediction,Adapte
3470,2018,Information-Communication,1,Introduction a l'Etude du Langage,3,La Morphologie,14,273,8,QCU,0.27,0.7,62.17,31,19,50,39,31,8,1.28,79.49,Moyen,Moyen,0,Meme Difficulte que la Prediction,Adapte
4536,2019,Information-Communication,1,Introduction a l'Etude du Langage,3,La Morphologie,14,273,8,QCM,0.34,0.37,62.17,34,21,55,49,34,15,1.12,69.39,Moyen,Moyen,0,Meme Difficulte que la Prediction,Adapte
5602,2020,Information-Communication,1,Introduction a l'Etude du Langage,3,La Morphologie,14,273,8,QCM,0.38,0.62,62.17,30,18,48,42,30,12,1.14,71.43,Moyen,Moyen,0,Meme Difficulte que la Prediction,Adapte
273,2015,Information-Communication,1,Introduction a l'Etude du Langage,3,La Morphologie,14,274,9,QCM,0.76,0.24,29.33,7,18,25,20,7,13,1.25,35.0,Moyen,Difficile,-1,Plus Difficile que la Prediction,Pas Adapte
1339,2016,Information-Communication,1,Introduction a l'Etude du Langage,3,La Morphologie,14,274,9,QCM,0.15,0.84,69.11,18,8,26,22,18,4,1.18,81.82,Facile,Facile,0,Meme Difficulte que la Prediction,Adapte
2405,2017,Information-Communication,1,Introduction a l'Etude du Langage,3,La Morphologie,14,274,9,QROC,0.12,0.58,69.11,20,9,29,22,20,2,1.32,90.91,Facile,Facile,0,Meme Difficulte que la Prediction,Adapte
3471,2018,Information-Communication,1,Introduction a l'Etude du Langage,3,La Morphologie,14,274,9,QROC,0.19,0.65,69.11,20,9,29,21,20,1,1.38,95.24,Facile,Facile,0,Meme Difficulte que la Prediction,Adapte
4537,2019,Information-Communication,1,Introduction a l'Etude du Langage,3,La Morphologie,14,274,9,QROC,0.2,0.47,69.11,20,9,29,22,20,2,1.32,90.91,Facile,Facile,0,Meme Difficulte que la Prediction,Adapte
5603,2020,Information-Communication,1,Introduction a l'Etude du Langage,3,La Morphologie,14,274,9,QROC,0.04,0.46,69.11,19,8,27,23,19,4,1.17,82.61,Facile,Facile,0,Meme Difficulte que la Prediction,Adapte
274,2015,Information-Communication,1,Introduction a l'Etude du Langage,3,La Morphologie,14,275,10,QCU,0.26,0.42,62.14,39,24,63,46,39,7,1.37,84.78,Moyen,Moyen,0,Meme Difficulte que la Prediction,Adapte
1340,2016,Information-Communication,1,Introduction a l'Etude du Langage,3,La Morphologie,14,275,10,QCU,0.38,0.56,62.14,44,27,71,44,44,0,1.61,100.0,Moyen,Moyen,0,Meme Difficulte que la Prediction,Adapte
2406,2017,Information-Communication,1,Introduction a l'Etude du Langage,3,La Morphologie,14,275,10,QCU,0.34,0.66,62.14,49,30,79,78,49,29,1.01,62.82,Moyen,Moyen,0,Meme Difficulte que la Prediction,Adapte
3472,2018,Information-Communication,1,Introduction a l'Etude du Langage,3,La Morphologie,14,275,10,QCU,0.26,0.55,62.14,47,29,76,48,47,1,1.58,97.92,Moyen,Moyen,0,Meme Difficulte que la Prediction,Adapte
4538,2019,Information-Communication,1,Introduction a l'Etude du Langage,3,La Morphologie,14,275,10,QCU,0.34,0.73,62.14,52,31,83,66,52,14,1.26,78.79,Moyen,Moyen,0,Meme Difficulte que la Prediction,Adapte
5604,2020,Information-Communication,1,Introduction a l'Etude du Langage,3,La Morphologie,14,275,10,QCU,0.22,0.55,62.14,47,28,75,58,47,11,1.29,81.03,Moyen,Moyen,0,Meme Difficulte que la Prediction,Adapte
275,2015,Information-Communication,1,Introduction a l'Etude du Langage,3,La Morphologie,14,276,11,QCM,0.66,0.25,21.09,3,12,15,7,3,4,2.14,42.86,Difficile,Difficile,0,Meme Difficulte que la Prediction,Pas Adapte
1341,2016,Information-Communication,1,Introduction a l'Etude du Langage,3,La Morphologie,14,276,11,QCM,0.08,0.97,72.85,11,4,15,13,11,2,1.15,84.62,Facile,Facile,0,Meme Difficulte que la Prediction,Adapte
2407,2017,Information-Communication,1,Introduction a l'Etude du Langage,3,La Morphologie,14,276,11,QCM,0.02,0.72,72.85,10,4,14,13,10,3,1.08,76.92,Facile,Facile,0,Meme Difficulte que la Prediction,Adapte
3473,2018,Information-Communication,1,Introduction a l'Etude du Langage,3,La Morphologie,14,276,11,QCM,0.01,0.89,72.85,10,4,14,13,10,3,1.08,76.92,Facile,Facile,0,Meme Difficulte que la Prediction,Adapte
4539,2019,Information-Communication,1,Introduction a l'Etude du Langage,3,La Morphologie,14,276,11,QCM,0.03,0.97,72.85,9,4,13,12,9,3,1.08,75.0,Facile,Facile,0,Meme Difficulte que la Prediction,Adapte
5605,2020,Information-Communication,1,Introduction a l'Etude du Langage,3,La Morphologie,14,276,11,QCM,0.1,0.76,72.85,9,4,13,12,9,3,1.08,75.0,Facile,Facile,0,Meme Difficulte que la Prediction,Adapte
276,2015,Information-Communication,1,Introduction a l'Etude du Langage,3,La Morphologie,14,277,12,QCU,0.39,0.49,41.0,13,18,31,23,13,10,1.35,56.52,Moyen,Moyen,0,Meme Difficulte que la Prediction,Pas Adapte
1342,2016,Information-Communication,1,Introduction a l'Etude du Langage,3,La Morphologie,14,277,12,QCU,0.1,0.91,78.41,25,7,32,26,25,1,1.23,96.15,Facile,Facile,0,Meme Difficulte que la Prediction,Pas Adapte
2408,2017,Information-Communication,1,Introduction a l'Etude du Langage,3,La Morphologie,14,277,12,QCU,0.36,0.75,48.67,15,16,31,19,15,4,1.63,78.95,Difficile,Moyen,1,Plus Facile que la Prediction,Pas Adapte
3474,2018,Information-Communication,1,Introduction a l'Etude du Langage,3,La Morphologie,14,277,12,QCU,0.02,0.9,71.65,26,10,36,36,26,10,1.0,72.22,Moyen,Facile,1,Plus Facile que la Prediction,Adapte
4540,2019,Information-Communication,1,Introduction a l'Etude du Langage,3,La Morphologie,14,277,12,QCU,0.17,0.99,71.65,29,12,41,33,29,4,1.24,87.88,Facile,Facile,0,Meme Difficulte que la Prediction,Adapte
5606,2020,Information-Communication,1,Introduction a l'Etude du Langage,3,La Morphologie,14,277,12,QCU,0.16,0.82,71.65,27,11,38,38,27,11,1.0,71.05,Facile,Facile,0,Meme Difficulte que la Prediction,Adapte
277,2015,Information-Communication,1,Introduction a l'Etude du Langage,3,La Morphologie,14,278,13,QCU,0.2,0.78,68.63,40,18,58,48,40,8,1.21,83.33,Difficile,Facile,2,Beaucoup plus Facile que la Prediction,Adapte
1343,2016,Information-Communication,1,Introduction a l'Etude du Langage,3,La Morphologie,14,278,13,QCU,0.16,0.75,68.63,38,18,56,44,38,6,1.27,86.36,Facile,Facile,0,Meme Difficulte que la Prediction,Adapte
2409,2017,Information-Communication,1,Introduction a l'Etude du Langage,3,La Morphologie,14,278,13,QCU,0.17,0.84,68.63,40,19,59,50,40,10,1.18,80.0,Facile,Facile,0,Meme Difficulte que la Prediction,Adapte
3475,2018,Information-Communication,1,Introduction a l'Etude du Langage,3,La Morphologie,14,278,13,QCU,0.14,0.76,68.63,44,20,64,63,44,19,1.02,69.84,Facile,Facile,0,Meme Difficulte que la Prediction,Adapte
4541,2019,Information-Communication,1,Introduction a l'Etude du Langage,3,La Morphologie,14,278,13,QCU,0.15,0.77,68.63,45,20,65,61,45,16,1.07,73.77,Facile,Facile,0,Meme Difficulte que la Prediction,Adapte
5607,2020,Information-Communication,1,Introduction a l'Etude du Langage,3,La Morphologie,14,278,13,QCU,0.08,0.93,68.63,50,23,73,51,50,1,1.43,98.04,Facile,Facile,0,Meme Difficulte que la Prediction,Adapte
278,2015,Information-Communication,1,Introduction a l'Etude du Langage,3,La Morphologie,14,279,14,QROC,0.17,0.77,88.56,40,5,45,40,40,0,1.12,100.0,Facile,Facile,0,Meme Difficulte que la Prediction,Pas Adapte
1344,2016,Information-Communication,1,Introduction a l'Etude du Langage,3,La Morphologie,14,279,14,QROC,0.0,0.63,67.04,27,14,41,38,27,11,1.08,71.05,Facile,Facile,0,Meme Difficulte que la Prediction,Adapte
2410,2017,Information-Communication,1,Introduction a l'Etude du Langage,3,La Morphologie,14,279,14,QO,0.04,0.79,67.04,30,15,45,33,30,3,1.36,90.91,Facile,Facile,0,Meme Difficulte que la Prediction,Adapte
3476,2018,Information-Communication,1,Introduction a l'Etude du Langage,3,La Morphologie,14,279,14,QO,0.15,0.94,67.04,25,13,38,30,25,5,1.27,83.33,Facile,Facile,0,Meme Difficulte que la Prediction,Adapte
4542,2019,Information-Communication,1,Introduction a l'Etude du Langage,3,La Morphologie,14,279,14,QO,0.13,0.94,67.04,22,11,33,29,22,7,1.14,75.86,Facile,Facile,0,Meme Difficulte que la Prediction,Adapte
5608,2020,Information-Communication,1,Introduction a l'Etude du Langage,3,La Morphologie,14,279,14,QO,0.09,0.88,67.04,22,11,33,25,22,3,1.32,88.0,Facile,Facile,0,Meme Difficulte que la Prediction,Adapte
279,2015,Information-Communication,1,Introduction a l'Etude du Langage,4,La Phonetique,8,280,1,QCU,0.39,0.58,42.58,15,20,35,21,15,6,1.67,71.43,Moyen,Moyen,0,Meme Difficulte que la Prediction,Pas Adapte
1345,2016,Information-Communication,1,Introduction a l'Etude du Langage,4,La Phonetique,8,280,1,QCU,0.15,0.97,74.61,24,8,32,29,24,5,1.1,82.76,Difficile,Facile,2,Beaucoup plus Facile que la Prediction,Adapte
2411,2017,Information-Communication,1,Introduction a l'Etude du Langage,4,La Phonetique,8,280,1,QCU,0.06,0.97,74.61,25,9,34,30,25,5,1.13,83.33,Facile,Facile,0,Meme Difficulte que la Prediction,Adapte
3477,2018,Information-Communication,1,Introduction a l'Etude du Langage,4,La Phonetique,8,280,1,QCU,0.04,0.86,74.61,27,9,36,34,27,7,1.06,79.41,Facile,Facile,0,Meme Difficulte que la Prediction,Adapte
4543,2019,Information-Communication,1,Introduction a l'Etude du Langage,4,La Phonetique,8,280,1,QCM,0.03,0.96,74.61,28,9,37,36,28,8,1.03,77.78,Facile,Facile,0,Meme Difficulte que la Prediction,Adapte
5609,2020,Information-Communication,1,Introduction a l'Etude du Langage,4,La Phonetique,8,280,1,QCM,0.17,0.9,74.61,24,8,32,29,24,5,1.1,82.76,Facile,Facile,0,Meme Difficulte que la Prediction,Adapte
280,2015,Information-Communication,1,Introduction a l'Etude du Langage,4,La Phonetique,8,281,2,QCM,0.46,0.38,61.88,41,26,67,49,41,8,1.37,83.67,Moyen,Moyen,0,Meme Difficulte que la Prediction,Adapte
1346,2016,Information-Communication,1,Introduction a l'Etude du Langage,4,La Phonetique,8,281,2,QCM,0.46,0.62,61.88,38,23,61,51,38,13,1.2,74.51,Moyen,Moyen,0,Meme Difficulte que la Prediction,Adapte
2412,2017,Information-Communication,1,Introduction a l'Etude du Langage,4,La Phonetique,8,281,2,QCM,0.35,0.69,61.88,37,22,59,43,37,6,1.37,86.05,Moyen,Moyen,0,Meme Difficulte que la Prediction,Adapte
3478,2018,Information-Communication,1,Introduction a l'Etude du Langage,4,La Phonetique,8,281,2,QCM,0.43,0.49,61.88,35,21,56,53,35,18,1.06,66.04,Moyen,Moyen,0,Meme Difficulte que la Prediction,Adapte
4544,2019,Information-Communication,1,Introduction a l'Etude du Langage,4,La Phonetique,8,281,2,QCM,0.4,0.36,61.88,30,19,49,36,30,6,1.36,83.33,Moyen,Moyen,0,Meme Difficulte que la Prediction,Adapte
5610,2020,Information-Communication,1,Introduction a l'Etude du Langage,4,La Phonetique,8,281,2,QCM,0.47,0.34,61.88,30,18,48,41,30,11,1.17,73.17,Moyen,Moyen,0,Meme Difficulte que la Prediction,Adapte
281,2015,Information-Communication,1,Introduction a l'Etude du Langage,4,La Phonetique,8,282,3,QROC,0.05,0.78,98.58,9,0,9,9,9,0,1.0,100.0,Facile,Facile,0,Meme Difficulte que la Prediction,Pas Adapte
1347,2016,Information-Communication,1,Introduction a l'Etude du Langage,4,La Phonetique,8,282,3,QROC,0.45,0.26,40.34,4,5,9,5,4,1,1.8,80.0,Facile,Moyen,-1,Plus Difficile que la Prediction,Pas Adapte
2413,2017,Information-Communication,1,Introduction a l'Etude du Langage,4,La Phonetique,8,282,3,QROC,0.32,0.37,57.6,5,3,8,7,5,2,1.14,71.43,Facile,Moyen,-1,Plus Difficile que la Prediction,Pas Adapte
3479,2018,Information-Communication,1,Introduction a l'Etude du Langage,4,La Phonetique,8,282,3,QROC,0.8,0.14,1.7,0,9,9,4,0,4,2.25,0.0,Difficile,Difficile,0,Meme Difficulte que la Prediction,Pas Adapte
4545,2019,Information-Communication,1,Introduction a l'Etude du Langage,4,La Phonetique,8,282,3,QROC,0.69,0.14,19.63,2,7,9,6,2,4,1.5,33.33,Difficile,Difficile,0,Meme Difficulte que la Prediction,Pas Adapte
5611,2020,Information-Communication,1,Introduction a l'Etude du Langage,4,La Phonetique,8,282,3,QO,0.89,0.06,0.84,0,8,8,8,0,8,1.0,0.0,Difficile,Difficile,0,Meme Difficulte que la Prediction,Pas Adapte
282,2015,Information-Communication,1,Introduction a l'Etude du Langage,4,La Phonetique,8,283,4,QCM,0.32,0.66,55.72,48,38,86,64,48,16,1.34,75.0,Moyen,Moyen,0,Meme Difficulte que la Prediction,Pas Adapte
1348,2016,Information-Communication,1,Introduction a l'Etude du Langage,4,La Phonetique,8,283,4,QCM,0.15,0.99,85.62,71,12,83,75,71,4,1.11,94.67,Facile,Facile,0,Meme Difficulte que la Prediction,Pas Adapte
2414,2017,Information-Communication,1,Introduction a l'Etude du Langage,4,La Phonetique,8,283,4,QROC,0.86,0.18,20.87,15,56,71,33,15,18,2.15,45.45,Difficile,Difficile,0,Meme Difficulte que la Prediction,Pas Adapte
3480,2018,Information-Communication,1,Introduction a l'Etude du Langage,4,La Phonetique,8,283,4,QROC,0.18,0.92,70.97,53,21,74,54,53,1,1.37,98.15,Moyen,Facile,1,Plus Facile que la Prediction,Adapte
4546,2019,Information-Communication,1,Introduction a l'Etude du Langage,4,La Phonetique,8,283,4,QO,0.01,0.92,70.97,50,21,71,68,50,18,1.04,73.53,Facile,Facile,0,Meme Difficulte que la Prediction,Adapte
5612,2020,Information-Communication,1,Introduction a l'Etude du Langage,4,La Phonetique,8,283,4,QO,0.06,0.62,70.97,57,23,80,57,57,0,1.4,100.0,Facile,Facile,0,Meme Difficulte que la Prediction,Adapte
283,2015,Information-Communication,1,Introduction a l'Etude du Langage,4,La Phonetique,8,284,5,QCM,0.79,0.27,16.92,13,66,79,40,13,27,1.98,32.5,Difficile,Difficile,0,Meme Difficulte que la Prediction,Pas Adapte
1349,2016,Information-Communication,1,Introduction a l'Etude du Langage,4,La Phonetique,8,284,5,QCM,0.58,0.18,34.58,26,49,75,46,26,20,1.63,56.52,Moyen,Difficile,-1,Plus Difficile que la Prediction,Pas Adapte
2415,2017,Information-Communication,1,Introduction a l'Etude du Langage,4,La Phonetique,8,284,5,QCU,0.54,0.28,24.94,17,51,68,48,17,31,1.42,35.42,Difficile,Difficile,0,Meme Difficulte que la Prediction,Pas Adapte
3481,2018,Information-Communication,1,Introduction a l'Etude du Langage,4,La Phonetique,8,284,5,QCU,0.16,0.8,82.59,63,13,76,72,63,9,1.06,87.5,Moyen,Facile,1,Plus Facile que la Prediction,Pas Adapte
4547,2019,Information-Communication,1,Introduction a l'Etude du Langage,4,La Phonetique,8,284,5,QCU,0.53,0.29,27.0,21,57,78,76,21,55,1.03,27.63,Difficile,Difficile,0,Meme Difficulte que la Prediction,Pas Adapte
5613,2020,Information-Communication,1,Introduction a l'Etude du Langage,4,La Phonetique,8,284,5,QCU,0.52,0.37,9.6,7,65,72,69,7,62,1.04,10.14,Difficile,Difficile,0,Meme Difficulte que la Prediction,Pas Adapte
284,2015,Information-Communication,1,Introduction a l'Etude du Langage,4,La Phonetique,8,285,6,QCM,0.29,0.44,59.51,6,4,10,8,6,2,1.25,75.0,Difficile,Moyen,1,Plus Facile que la Prediction,Pas Adapte
1350,2016,Information-Communication,1,Introduction a l'Etude du Langage,4,La Phonetique,8,285,6,QCM,0.57,0.18,28.66,3,9,12,8,3,5,1.5,37.5,Difficile,Difficile,0,Meme Difficulte que la Prediction,Pas Adapte
2416,2017,Information-Communication,1,Introduction a l'Etude du Langage,4,La Phonetique,8,285,6,QCM,0.08,0.72,95.28,12,1,13,12,12,0,1.08,100.0,Facile,Facile,0,Meme Difficulte que la Prediction,Pas Adapte
3482,2018,Information-Communication,1,Introduction a l'Etude du Langage,4,La Phonetique,8,285,6,QCM,0.63,0.28,8.29,1,14,15,5,1,4,3.0,20.0,Difficile,Difficile,0,Meme Difficulte que la Prediction,Pas Adapte
4548,2019,Information-Communication,1,Introduction a l'Etude du Langage,4,La Phonetique,8,285,6,QCM,0.39,0.59,46.18,7,8,15,12,7,5,1.25,58.33,Moyen,Moyen,0,Meme Difficulte que la Prediction,Pas Adapte
5614,2020,Information-Communication,1,Introduction a l'Etude du Langage,4,La Phonetique,8,285,6,QCM,0.54,0.24,18.95,2,11,13,10,2,8,1.3,20.0,Difficile,Difficile,0,Meme Difficulte que la Prediction,Pas Adapte
285,2015,Information-Communication,1,Introduction a l'Etude du Langage,4,La Phonetique,8,286,7,QCM,0.58,0.18,27.54,9,23,32,11,9,2,2.91,81.82,Difficile,Difficile,0,Meme Difficulte que la Prediction,Pas Adapte
1351,2016,Information-Communication,1,Introduction a l'Etude du Langage,4,La Phonetique,8,286,7,QCM,0.42,0.69,39.15,13,21,34,15,13,2,2.27,86.67,Moyen,Moyen,0,Meme Difficulte que la Prediction,Pas Adapte
2417,2017,Information-Communication,1,Introduction a l'Etude du Langage,4,La Phonetique,8,286,7,QCM,0.17,0.99,66.09,24,13,37,36,24,12,1.03,66.67,Facile,Facile,0,Meme Difficulte que la Prediction,Adapte
3483,2018,Information-Communication,1,Introduction a l'Etude du Langage,4,La Phonetique,8,286,7,QCU,0.13,0.93,66.09,25,13,38,26,25,1,1.46,96.15,Facile,Facile,0,Meme Difficulte que la Prediction,Adapte
4549,2019,Information-Communication,1,Introduction a l'Etude du Langage,4,La Phonetique,8,286,7,QCU,0.13,0.86,66.09,22,12,34,28,22,6,1.21,78.57,Facile,Facile,0,Meme Difficulte que la Prediction,Adapte
5615,2020,Information-Communication,1,Introduction a l'Etude du Langage,4,La Phonetique,8,286,7,QCU,0.03,0.77,66.09,20,11,31,20,20,0,1.55,100.0,Facile,Facile,0,Meme Difficulte que la Prediction,Adapte
286,2015,Information-Communication,1,Introduction a l'Etude du Langage,4,La Phonetique,8,287,8,QCU,0.38,0.66,57.57,17,13,30,19,17,2,1.58,89.47,Moyen,Moyen,0,Meme Difficulte que la Prediction,Pas Adapte
1352,2016,Information-Communication,1,Introduction a l'Etude du Langage,4,La Phonetique,8,287,8,QCU,0.3,0.42,56.95,19,14,33,28,19,9,1.18,67.86,Moyen,Moyen,0,Meme Difficulte que la Prediction,Pas Adapte
2418,2017,Information-Communication,1,Introduction a l'Etude du Langage,4,La Phonetique,8,287,8,QCU,0.55,0.25,12.46,4,28,32,23,4,19,1.39,17.39,Difficile,Difficile,0,Meme Difficulte que la Prediction,Pas Adapte
3484,2018,Information-Communication,1,Introduction a l'Etude du Langage,4,La Phonetique,8,287,8,QCU,0.12,0.97,74.47,27,9,36,30,27,3,1.2,90.0,Difficile,Facile,2,Beaucoup plus Facile que la Prediction,Adapte
4550,2019,Information-Communication,1,Introduction a l'Etude du Langage,4,La Phonetique,8,287,8,QCU,0.06,0.95,74.47,28,10,38,30,28,2,1.27,93.33,Facile,Facile,0,Meme Difficulte que la Prediction,Adapte
5616,2020,Information-Communication,1,Introduction a l'Etude du Langage,4,La Phonetique,8,287,8,QCU,0.11,0.95,74.47,31,10,41,36,31,5,1.14,86.11,Facile,Facile,0,Meme Difficulte que la Prediction,Adapte
287,2015,Information-Communication,1,Introduction a l'Etude du Langage,5,La Phonologie,7,288,1,QCM,0.7,0.19,6.67,6,81,87,84,6,78,1.04,7.14,Facile,Difficile,-2,Beaucoup plus Difficile que la Prediction,Pas Adapte
1353,2016,Information-Communication,1,Introduction a l'Etude du Langage,5,La Phonologie,7,288,1,QCM,0.3,0.36,51.25,50,47,97,78,50,28,1.24,64.1,Facile,Moyen,-1,Plus Difficile que la Prediction,Pas Adapte
2419,2017,Information-Communication,1,Introduction a l'Etude du Langage,5,La Phonologie,7,288,1,QCM,0.68,0.17,8.61,9,91,100,37,9,28,2.7,24.32,Difficile,Difficile,0,Meme Difficulte que la Prediction,Pas Adapte
3485,2018,Information-Communication,1,Introduction a l'Etude du Langage,5,La Phonologie,7,288,1,QCM,0.6,0.22,8.7,10,101,111,107,10,97,1.04,9.35,Facile,Difficile,-2,Beaucoup plus Difficile que la Prediction,Pas Adapte
4551,2019,Information-Communication,1,Introduction a l'Etude du Langage,5,La Phonologie,7,288,1,QCM,0.68,0.16,26.9,27,72,99,27,27,0,3.67,100.0,Difficile,Difficile,0,Meme Difficulte que la Prediction,Pas Adapte
5617,2020,Information-Communication,1,Introduction a l'Etude du Langage,5,La Phonologie,7,288,1,QCM,0.63,0.24,19.77,20,82,102,61,20,41,1.67,32.79,Difficile,Difficile,0,Meme Difficulte que la Prediction,Pas Adapte
288,2015,Information-Communication,1,Introduction a l'Etude du Langage,5,La Phonologie,7,289,2,QCU,0.19,0.88,83.28,11,2,13,11,11,0,1.18,100.0,Facile,Facile,0,Meme Difficulte que la Prediction,Pas Adapte
1354,2016,Information-Communication,1,Introduction a l'Etude du Langage,5,La Phonologie,7,289,2,QROC,0.96,0.25,6.03,1,11,12,6,1,5,2.0,16.67,Facile,Difficile,-2,Beaucoup plus Difficile que la Prediction,Pas Adapte
2420,2017,Information-Communication,1,Introduction a l'Etude du Langage,5,La Phonologie,7,289,2,QROC,0.93,0.13,14.31,1,9,10,6,1,5,1.67,16.67,Difficile,Difficile,0,Meme Difficulte que la Prediction,Pas Adapte
3486,2018,Information-Communication,1,Introduction a l'Etude du Langage,5,La Phonologie,7,289,2,QROC,0.76,0.03,10.85,1,8,9,4,1,3,2.25,25.0,Difficile,Difficile,0,Meme Difficulte que la Prediction,Pas Adapte
4552,2019,Information-Communication,1,Introduction a l'Etude du Langage,5,La Phonologie,7,289,2,QROC,0.02,0.77,81.22,8,2,10,9,8,1,1.11,88.89,Moyen,Facile,1,Plus Facile que la Prediction,Pas Adapte
5618,2020,Information-Communication,1,Introduction a l'Etude du Langage,5,La Phonologie,7,289,2,QROC,0.51,0.27,48.73,4,4,8,8,4,4,1.0,50.0,Moyen,Moyen,0,Meme Difficulte que la Prediction,Pas Adapte
289,2015,Information-Communication,1,Introduction a l'Etude du Langage,5,La Phonologie,7,290,3,QCU,0.39,0.44,54.48,19,16,35,31,19,12,1.13,61.29,Moyen,Moyen,0,Meme Difficulte que la Prediction,Pas Adapte
1355,2016,Information-Communication,1,Introduction a l'Etude du Langage,5,La Phonologie,7,290,3,QCU,0.33,0.57,37.89,14,22,36,15,14,1,2.4,93.33,Difficile,Moyen,1,Plus Facile que la Prediction,Pas Adapte
2421,2017,Information-Communication,1,Introduction a l'Etude du Langage,5,La Phonologie,7,290,3,QCU,0.13,0.8,81.9,32,7,39,38,32,6,1.03,84.21,Moyen,Facile,1,Plus Facile que la Prediction,Pas Adapte
3487,2018,Information-Communication,1,Introduction a l'Etude du Langage,5,La Phonologie,7,290,3,QCU,0.04,0.85,90.14,39,4,43,40,39,1,1.07,97.5,Facile,Facile,0,Meme Difficulte que la Prediction,Pas Adapte
4553,2019,Information-Communication,1,Introduction a l'Etude du Langage,5,La Phonologie,7,290,3,QCU,0.35,0.73,56.92,24,18,42,27,24,3,1.56,88.89,Difficile,Moyen,1,Plus Facile que la Prediction,Pas Adapte
5619,2020,Information-Communication,1,Introduction a l'Etude du Langage,5,La Phonologie,7,290,3,QCU,0.53,0.25,34.43,15,29,44,21,15,6,2.1,71.43,Difficile,Difficile,0,Meme Difficulte que la Prediction,Pas Adapte
290,2015,Information-Communication,1,Introduction a l'Etude du Langage,5,La Phonologie,7,291,4,QCM,0.6,0.28,8.43,3,31,34,18,3,15,1.89,16.67,Facile,Difficile,-2,Beaucoup plus Difficile que la Prediction,Pas Adapte
1356,2016,Information-Communication,1,Introduction a l'Etude du Langage,5,La Phonologie,7,291,4,QCM,0.16,0.79,84.73,32,6,38,36,32,4,1.06,88.89,Facile,Facile,0,Meme Difficulte que la Prediction,Pas Adapte
2422,2017,Information-Communication,1,Introduction a l'Etude du Langage,5,La Phonologie,7,291,4,QCM,0.04,0.7,67.61,30,14,44,38,30,8,1.16,78.95,Facile,Facile,0,Meme Difficulte que la Prediction,Adapte
3488,2018,Information-Communication,1,Introduction a l'Etude du Langage,5,La Phonologie,7,291,4,QCM,0.09,0.77,67.61,28,14,42,31,28,3,1.35,90.32,Facile,Facile,0,Meme Difficulte que la Prediction,Adapte
4554,2019,Information-Communication,1,Introduction a l'Etude du Langage,5,La Phonologie,7,291,4,QCM,0.15,0.94,67.61,30,14,44,36,30,6,1.22,83.33,Facile,Facile,0,Meme Difficulte que la Prediction,Adapte
5620,2020,Information-Communication,1,Introduction a l'Etude du Langage,5,La Phonologie,7,291,4,QCM,0.11,0.9,67.61,34,17,51,36,34,2,1.42,94.44,Facile,Facile,0,Meme Difficulte que la Prediction,Adapte
291,2015,Information-Communication,1,Introduction a l'Etude du Langage,5,La Phonologie,7,292,5,QCU,0.42,0.36,29.31,16,38,54,24,16,8,2.25,66.67,Difficile,Difficile,0,Meme Difficulte que la Prediction,Pas Adapte
1357,2016,Information-Communication,1,Introduction a l'Etude du Langage,5,La Phonologie,7,292,5,QCU,0.72,0.21,23.54,12,38,50,21,12,9,2.38,57.14,Difficile,Difficile,0,Meme Difficulte que la Prediction,Pas Adapte
2423,2017,Information-Communication,1,Introduction a l'Etude du Langage,5,La Phonologie,7,292,5,QCU,0.75,0.38,25.31,12,37,49,34,12,22,1.44,35.29,Difficile,Difficile,0,Meme Difficulte que la Prediction,Pas Adapte
3489,2018,Information-Communication,1,Introduction a l'Etude du Langage,5,La Phonologie,7,292,5,QCU,0.24,0.67,48.86,21,22,43,40,21,19,1.07,52.5,Facile,Moyen,-1,Plus Difficile que la Prediction,Pas Adapte
4555,2019,Information-Communication,1,Introduction a l'Etude du Langage,5,La Phonologie,7,292,5,QCU,0.12,0.9,66.02,29,15,44,32,29,3,1.38,90.62,Facile,Facile,0,Meme Difficulte que la Prediction,Adapte
5621,2020,Information-Communication,1,Introduction a l'Etude du Langage,5,La Phonologie,7,292,5,QCU,0.15,0.95,66.02,34,17,51,39,34,5,1.31,87.18,Facile,Facile,0,Meme Difficulte que la Prediction,Adapte
292,2015,Information-Communication,1,Introduction a l'Etude du Langage,5,La Phonologie,7,293,6,QCU,0.6,0.31,32.71,29,61,90,68,29,39,1.32,42.65,Difficile,Difficile,0,Meme Difficulte que la Prediction,Pas Adapte
1358,2016,Information-Communication,1,Introduction a l'Etude du Langage,5,La Phonologie,7,293,6,QCU,0.62,0.25,19.65,17,70,87,29,17,12,3.0,58.62,Facile,Difficile,-2,Beaucoup plus Difficile que la Prediction,Pas Adapte
2424,2017,Information-Communication,1,Introduction a l'Etude du Langage,5,La Phonologie,7,293,6,QCU,0.72,0.29,33.94,26,50,76,71,26,45,1.07,36.62,Moyen,Difficile,-1,Plus Difficile que la Prediction,Pas Adapte
3490,2018,Information-Communication,1,Introduction a l'Etude du Langage,5,La Phonologie,7,293,6,QCU,0.41,0.38,31.8,25,54,79,29,25,4,2.72,86.21,Facile,Difficile,-2,Beaucoup plus Difficile que la Prediction,Pas Adapte
4556,2019,Information-Communication,1,Introduction a l'Etude du Langage,5,La Phonologie,7,293,6,QCM,0.65,0.3,26.25,20,57,77,56,20,36,1.38,35.71,Difficile,Difficile,0,Meme Difficulte que la Prediction,Pas Adapte
5622,2020,Information-Communication,1,Introduction a l'Etude du Langage,5,La Phonologie,7,293,6,QCM,0.07,0.88,81.94,66,14,80,67,66,1,1.19,98.51,Difficile,Facile,2,Beaucoup plus Facile que la Prediction,Pas Adapte
293,2015,Information-Communication,1,Introduction a l'Etude du Langage,5,La Phonologie,7,294,7,QROC,0.1,0.92,68.2,32,15,47,36,32,4,1.31,88.89,Facile,Facile,0,Meme Difficulte que la Prediction,Adapte
1359,2016,Information-Communication,1,Introduction a l'Etude du Langage,5,La Phonologie,7,294,7,QROC,0.15,0.72,68.2,29,14,43,29,29,0,1.48,100.0,Facile,Facile,0,Meme Difficulte que la Prediction,Adapte
2425,2017,Information-Communication,1,Introduction a l'Etude du Langage,5,La Phonologie,7,294,7,QO,0.02,0.58,68.2,27,12,39,37,27,10,1.05,72.97,Facile,Facile,0,Meme Difficulte que la Prediction,Adapte
3491,2018,Information-Communication,1,Introduction a l'Etude du Langage,5,La Phonologie,7,294,7,QO,0.01,0.5,68.2,27,13,40,40,27,13,1.0,67.5,Facile,Facile,0,Meme Difficulte que la Prediction,Adapte
4557,2019,Information-Communication,1,Introduction a l'Etude du Langage,5,La Phonologie,7,294,7,QO,0.14,0.3,68.2,25,12,37,30,25,5,1.23,83.33,Facile,Facile,0,Meme Difficulte que la Prediction,Adapte
5623,2020,Information-Communication,1,Introduction a l'Etude du Langage,5,La Phonologie,7,294,7,QCM,0.08,0.82,68.2,26,12,38,26,26,0,1.46,100.0,Facile,Facile,0,Meme Difficulte que la Prediction,Adapte
294,2015,Information-Communication,1,Introduction a l'Etude du Langage,6,La Syntaxe,7,295,1,QCU,0.48,0.29,17.56,15,73,88,63,15,48,1.4,23.81,Difficile,Difficile,0,Meme Difficulte que la Prediction,Pas Adapte
1360,2016,Information-Communication,1,Introduction a l'Etude du Langage,6,La Syntaxe,7,295,1,QCM,0.4,0.35,62.9,53,32,85,76,53,23,1.12,69.74,Facile,Moyen,-1,Plus Difficile que la Prediction,Adapte
2426,2017,Information-Communication,1,Introduction a l'Etude du Langage,6,La Syntaxe,7,295,1,QCM,0.46,0.51,62.9,57,33,90,63,57,6,1.43,90.48,Moyen,Moyen,0,Meme Difficulte que la Prediction,Adapte
3492,2018,Information-Communication,1,Introduction a l'Etude du Langage,6,La Syntaxe,7,295,1,QROC,0.24,0.28,62.9,48,29,77,64,48,16,1.2,75.0,Moyen,Moyen,0,Meme Difficulte que la Prediction,Adapte
4558,2019,Information-Communication,1,Introduction a l'Etude du Langage,6,La Syntaxe,7,295,1,QROC,0.2,0.27,62.9,44,26,70,48,44,4,1.46,91.67,Moyen,Moyen,0,Meme Difficulte que la Prediction,Adapte
5624,2020,Information-Communication,1,Introduction a l'Etude du Langage,6,La Syntaxe,7,295,1,QO,0.24,0.22,62.9,47,27,74,48,47,1,1.54,97.92,Moyen,Moyen,0,Meme Difficulte que la Prediction,Adapte
295,2015,Information-Communication,1,Introduction a l'Etude du Langage,6,La Syntaxe,7,296,2,QCU,0.01,0.94,70.55,67,28,95,75,67,8,1.27,89.33,Facile,Facile,0,Meme Difficulte que la Prediction,Adapte
1361,2016,Information-Communication,1,Introduction a l'Etude du Langage,6,La Syntaxe,7,296,2,QCU,0.16,0.86,70.55,75,32,107,78,75,3,1.37,96.15,Facile,Facile,0,Meme Difficulte que la Prediction,Adapte
2427,2017,Information-Communication,1,Introduction a l'Etude du Langage,6,La Syntaxe,7,296,2,QCU,0.14,0.88,70.55,71,29,100,92,71,21,1.09,77.17,Facile,Facile,0,Meme Difficulte que la Prediction,Adapte
3493,2018,Information-Communication,1,Introduction a l'Etude du Langage,6,La Syntaxe,7,296,2,QCU,0.17,0.8,70.55,78,33,111,106,78,28,1.05,73.58,Facile,Facile,0,Meme Difficulte que la Prediction,Adapte
4559,2019,Information-Communication,1,Introduction a l'Etude du Langage,6,La Syntaxe,7,296,2,QCU,0.11,0.92,70.55,71,30,101,87,71,16,1.16,81.61,Facile,Facile,0,Meme Difficulte que la Prediction,Adapte
5625,2020,Information-Communication,1,Introduction a l'Etude du Langage,6,La Syntaxe,7,296,2,QCU,0.18,0.82,70.55,63,26,89,89,63,26,1.0,70.79,Facile,Facile,0,Meme Difficulte que la Prediction,Adapte
296,2015,Information-Communication,1,Introduction a l'Etude du Langage,6,La Syntaxe,7,297,3,QCM,0.56,0.15,33.05,31,64,95,87,31,56,1.09,35.63,Moyen,Difficile,-1,Plus Difficile que la Prediction,Pas Adapte
1362,2016,Information-Communication,1,Introduction a l'Etude du Langage,6,La Syntaxe,7,297,3,QCM,0.38,0.44,58.59,53,38,91,56,53,3,1.62,94.64,Facile,Moyen,-1,Plus Difficile que la Prediction,Pas Adapte
2428,2017,Information-Communication,1,Introduction a l'Etude du Langage,6,La Syntaxe,7,297,3,QCM,0.31,0.69,57.02,58,44,102,64,58,6,1.59,90.62,Moyen,Moyen,0,Meme Difficulte que la Prediction,Pas Adapte
3494,2018,Information-Communication,1,Introduction a l'Etude du Langage,6,La Syntaxe,7,297,3,QCM,0.06,0.85,92.93,99,8,107,100,99,1,1.07,99.0,Facile,Facile,0,Meme Difficulte que la Prediction,Pas Adapte
4560,2019,Information-Communication,1,Introduction a l'Etude du Langage,6,La Syntaxe,7,297,3,QCM,0.45,0.33,55.62,68,55,123,113,68,45,1.09,60.18,Facile,Moyen,-1,Plus Difficile que la Prediction,Pas Adapte
5626,2020,Information-Communication,1,Introduction a l'Etude du Langage,6,La Syntaxe,7,297,3,QCM,0.6,0.17,0.55,1,139,140,124,1,123,1.13,0.81,Difficile,Difficile,0,Meme Difficulte que la Prediction,Pas Adapte
297,2015,Information-Communication,1,Introduction a l'Etude du Langage,6,La Syntaxe,7,298,4,QCM,0.62,0.27,13.75,8,47,55,26,8,18,2.12,30.77,Facile,Difficile,-2,Beaucoup plus Difficile que la Prediction,Pas Adapte
1363,2016,Information-Communication,1,Introduction a l'Etude du Langage,6,La Syntaxe,7,298,4,QCM,0.74,0.24,1.09,1,48,49,24,1,23,2.04,4.17,Moyen,Difficile,-1,Plus Difficile que la Prediction,Pas Adapte
2429,2017,Information-Communication,1,Introduction a l'Etude du Langage,6,La Syntaxe,7,298,4,QCM,0.66,0.27,6.39,3,48,51,44,3,41,1.16,6.82,Difficile,Difficile,0,Meme Difficulte que la Prediction,Pas Adapte
3495,2018,Information-Communication,1,Introduction a l'Etude du Langage,6,La Syntaxe,7,298,4,QCU,0.31,0.58,64.15,31,17,48,43,31,12,1.12,72.09,Moyen,Moyen,0,Meme Difficulte que la Prediction,Adapte
4561,2019,Information-Communication,1,Introduction a l'Etude du Langage,6,La Syntaxe,7,298,4,QCU,0.37,0.63,64.15,28,16,44,39,28,11,1.13,71.79,Moyen,Moyen,0,Meme Difficulte que la Prediction,Adapte
5627,2020,Information-Communication,1,Introduction a l'Etude du Langage,6,La Syntaxe,7,298,4,QCU,0.29,0.42,64.15,24,13,37,33,24,9,1.12,72.73,Moyen,Moyen,0,Meme Difficulte que la Prediction,Adapte
298,2015,Information-Communication,1,Introduction a l'Etude du Langage,6,La Syntaxe,7,299,5,QROC,0.08,0.74,85.63,46,8,54,52,46,6,1.04,88.46,Facile,Facile,0,Meme Difficulte que la Prediction,Pas Adapte
1364,2016,Information-Communication,1,Introduction a l'Etude du Langage,6,La Syntaxe,7,299,5,QO,0.11,0.38,69.4,42,19,61,54,42,12,1.13,77.78,Facile,Facile,0,Meme Difficulte que la Prediction,Adapte
2430,2017,Information-Communication,1,Introduction a l'Etude du Langage,6,La Syntaxe,7,299,5,QO,0.09,0.72,69.4,46,20,66,60,46,14,1.1,76.67,Facile,Facile,0,Meme Difficulte que la Prediction,Adapte
3496,2018,Information-Communication,1,Introduction a l'Etude du Langage,6,La Syntaxe,7,299,5,QROC,0.18,0.92,69.4,43,19,62,47,43,4,1.32,91.49,Facile,Facile,0,Meme Difficulte que la Prediction,Adapte
4562,2019,Information-Communication,1,Introduction a l'Etude du Langage,6,La Syntaxe,7,299,5,QROC,0.2,0.89,69.4,40,17,57,43,40,3,1.33,93.02,Facile,Facile,0,Meme Difficulte que la Prediction,Adapte
5628,2020,Information-Communication,1,Introduction a l'Etude du Langage,6,La Syntaxe,7,299,5,QROC,0.15,0.76,69.4,44,20,64,52,44,8,1.23,84.62,Facile,Facile,0,Meme Difficulte que la Prediction,Adapte
299,2015,Information-Communication,1,Introduction a l'Etude du Langage,6,La Syntaxe,7,300,6,QCU,0.34,0.43,47.52,41,45,86,85,41,44,1.01,48.24,Difficile,Moyen,1,Plus Facile que la Prediction,Pas Adapte
1365,2016,Information-Communication,1,Introduction a l'Etude du Langage,6,La Syntaxe,7,300,6,QCU,0.25,0.62,38.22,32,53,85,71,32,39,1.2,45.07,Moyen,Moyen,0,Meme Difficulte que la Prediction,Pas Adapte
2431,2017,Information-Communication,1,Introduction a l'Etude du Langage,6,La Syntaxe,7,300,6,QCU,0.05,0.85,84.35,83,15,98,88,83,5,1.11,94.32,Facile,Facile,0,Meme Difficulte que la Prediction,Pas Adapte
3497,2018,Information-Communication,1,Introduction a l'Etude du Langage,6,La Syntaxe,7,300,6,QCU,0.58,0.26,2.58,3,95,98,55,3,52,1.78,5.45,Moyen,Difficile,-1,Plus Difficile que la Prediction,Pas Adapte
4563,2019,Information-Communication,1,Introduction a l'Etude du Langage,6,La Syntaxe,7,300,6,QO,0.01,0.43,70.89,64,26,90,89,64,25,1.01,71.91,Facile,Facile,0,Meme Difficulte que la Prediction,Adapte
5629,2020,Information-Communication,1,Introduction a l'Etude du Langage,6,La Syntaxe,7,300,6,QO,0.02,0.36,70.89,62,26,88,84,62,22,1.05,73.81,Facile,Facile,0,Meme Difficulte que la Prediction,Adapte
300,2015,Information-Communication,1,Introduction a l'Etude du Langage,6,La Syntaxe,7,301,7,QCM,0.12,0.92,82.35,36,8,44,38,36,2,1.16,94.74,Facile,Facile,0,Meme Difficulte que la Prediction,Pas Adapte
1366,2016,Information-Communication,1,Introduction a l'Etude du Langage,6,La Syntaxe,7,301,7,QCM,0.52,0.18,19.42,9,36,45,19,9,10,2.37,47.37,Difficile,Difficile,0,Meme Difficulte que la Prediction,Pas Adapte
2432,2017,Information-Communication,1,Introduction a l'Etude du Langage,6,La Syntaxe,7,301,7,QCM,0.36,0.35,45.22,23,27,50,36,23,13,1.39,63.89,Moyen,Moyen,0,Meme Difficulte que la Prediction,Pas Adapte
3498,2018,Information-Communication,1,Introduction a l'Etude du Langage,6,La Syntaxe,7,301,7,QCM,0.66,0.29,17.79,8,39,47,28,8,20,1.68,28.57,Difficile,Difficile,0,Meme Difficulte que la Prediction,Pas Adapte
4564,2019,Information-Communication,1,Introduction a l'Etude du Langage,6,La Syntaxe,7,301,7,QCM,0.62,0.17,6.83,3,38,41,30,3,27,1.37,10.0,Moyen,Difficile,-1,Plus Difficile que la Prediction,Pas Adapte
5630,2020,Information-Communication,1,Introduction a l'Etude du Langage,6,La Syntaxe,7,301,7,QCM,0.41,0.68,53.05,25,22,47,38,25,13,1.24,65.79,Difficile,Moyen,1,Plus Facile que la Prediction,Pas Adapte
301,2015,Information-Communication,1,Introduction a l'Etude du Langage,7,Le Developpement du Langage,13,302,1,QCU,0.04,0.93,97.92,98,2,100,98,98,0,1.02,100.0,Facile,Facile,0,Meme Difficulte que la Prediction,Pas Adapte
1367,2016,Information-Communication,1,Introduction a l'Etude du Langage,7,Le Developpement du Langage,13,302,1,QCU,0.22,0.57,63.62,70,40,110,82,70,12,1.34,85.37,Moyen,Moyen,0,Meme Difficulte que la Prediction,Adapte
2433,2017,Information-Communication,1,Introduction a l'Etude du Langage,7,Le Developpement du Langage,13,302,1,QCU,0.28,0.46,63.62,75,43,118,117,75,42,1.01,64.1,Moyen,Moyen,0,Meme Difficulte que la Prediction,Adapte
3499,2018,Information-Communication,1,Introduction a l'Etude du Langage,7,Le Developpement du Langage,13,302,1,QCU,0.29,0.64,63.62,84,48,132,118,84,34,1.12,71.19,Moyen,Moyen,0,Meme Difficulte que la Prediction,Adapte
4565,2019,Information-Communication,1,Introduction a l'Etude du Langage,7,Le Developpement du Langage,13,302,1,QCU,0.31,0.4,63.62,76,43,119,106,76,30,1.12,71.7,Moyen,Moyen,0,Meme Difficulte que la Prediction,Adapte
5631,2020,Information-Communication,1,Introduction a l'Etude du Langage,7,Le Developpement du Langage,13,302,1,QCU,0.3,0.54,63.62,67,38,105,84,67,17,1.25,79.76,Moyen,Moyen,0,Meme Difficulte que la Prediction,Adapte
302,2015,Information-Communication,1,Introduction a l'Etude du Langage,7,Le Developpement du Langage,13,303,2,QCM,0.47,0.41,35.03,9,18,27,16,9,7,1.69,56.25,Moyen,Moyen,0,Meme Difficulte que la Prediction,Pas Adapte
1368,2016,Information-Communication,1,Introduction a l'Etude du Langage,7,Le Developpement du Langage,13,303,2,QCM,0.11,0.71,70.08,16,7,23,17,16,1,1.35,94.12,Moyen,Facile,1,Plus Facile que la Prediction,Adapte
2434,2017,Information-Communication,1,Introduction a l'Etude du Langage,7,Le Developpement du Langage,13,303,2,QCM,0.16,0.81,70.08,18,7,25,23,18,5,1.09,78.26,Facile,Facile,0,Meme Difficulte que la Prediction,Adapte
3500,2018,Information-Communication,1,Introduction a l'Etude du Langage,7,Le Developpement du Langage,13,303,2,QCM,0.13,0.96,70.08,15,7,22,17,15,2,1.29,88.24,Facile,Facile,0,Meme Difficulte que la Prediction,Adapte
4566,2019,Information-Communication,1,Introduction a l'Etude du Langage,7,Le Developpement du Langage,13,303,2,QCM,0.1,0.88,70.08,14,6,20,17,14,3,1.18,82.35,Facile,Facile,0,Meme Difficulte que la Prediction,Adapte
5632,2020,Information-Communication,1,Introduction a l'Etude du Langage,7,Le Developpement du Langage,13,303,2,QCM,0.11,0.96,70.08,15,6,21,18,15,3,1.17,83.33,Facile,Facile,0,Meme Difficulte que la Prediction,Adapte
303,2015,Information-Communication,1,Introduction a l'Etude du Langage,7,Le Developpement du Langage,13,304,3,QCU,0.05,0.84,68.18,52,24,76,57,52,5,1.33,91.23,Facile,Facile,0,Meme Difficulte que la Prediction,Adapte
1369,2016,Information-Communication,1,Introduction a l'Etude du Langage,7,Le Developpement du Langage,13,304,3,QCU,0.05,0.79,68.18,46,21,67,59,46,13,1.14,77.97,Facile,Facile,0,Meme Difficulte que la Prediction,Adapte
2435,2017,Information-Communication,1,Introduction a l'Etude du Langage,7,Le Developpement du Langage,13,304,3,QCU,0.13,0.96,68.18,51,24,75,72,51,21,1.04,70.83,Facile,Facile,0,Meme Difficulte que la Prediction,Adapte
3501,2018,Information-Communication,1,Introduction a l'Etude du Langage,7,Le Developpement du Langage,13,304,3,QCU,0.08,0.75,68.18,58,27,85,72,58,14,1.18,80.56,Facile,Facile,0,Meme Difficulte que la Prediction,Adapte
4567,2019,Information-Communication,1,Introduction a l'Etude du Langage,7,Le Developpement du Langage,13,304,3,QCU,0.06,0.81,68.18,66,31,97,66,66,0,1.47,100.0,Facile,Facile,0,Meme Difficulte que la Prediction,Adapte
5633,2020,Information-Communication,1,Introduction a l'Etude du Langage,7,Le Developpement du Langage,13,304,3,QCU,0.05,0.99,68.18,67,31,98,96,67,29,1.02,69.79,Facile,Facile,0,Meme Difficulte que la Prediction,Adapte
304,2015,Information-Communication,1,Introduction a l'Etude du Langage,7,Le Developpement du Langage,13,305,4,QCM,0.04,0.83,87.95,55,7,62,59,55,4,1.05,93.22,Difficile,Facile,2,Beaucoup plus Facile que la Prediction,Pas Adapte
1370,2016,Information-Communication,1,Introduction a l'Etude du Langage,7,Le Developpement du Langage,13,305,4,QCM,0.66,0.22,15.26,8,46,54,29,8,21,1.86,27.59,Difficile,Difficile,0,Meme Difficulte que la Prediction,Pas Adapte
2436,2017,Information-Communication,1,Introduction a l'Etude du Langage,7,Le Developpement du Langage,13,305,4,QCM,0.75,0.29,26.8,14,39,53,29,14,15,1.83,48.28,Difficile,Difficile,0,Meme Difficulte que la Prediction,Pas Adapte
3502,2018,Information-Communication,1,Introduction a l'Etude du Langage,7,Le Developpement du Langage,13,305,4,QCM,0.31,0.66,63.29,36,21,57,46,36,10,1.24,78.26,Moyen,Moyen,0,Meme Difficulte que la Prediction,Adapte
4568,2019,Information-Communication,1,Introduction a l'Etude du Langage,7,Le Developpement du Langage,13,305,4,QCM,0.48,0.47,63.29,35,21,56,38,35,3,1.47,92.11,Moyen,Moyen,0,Meme Difficulte que la Prediction,Adapte
5634,2020,Information-Communication,1,Introduction a l'Etude du Langage,7,Le Developpement du Langage,13,305,4,QROC,0.21,0.27,63.29,36,21,57,43,36,7,1.33,83.72,Moyen,Moyen,0,Meme Difficulte que la Prediction,Adapte
305,2015,Information-Communication,1,Introduction a l'Etude du Langage,7,Le Developpement du Langage,13,306,5,QCU,0.24,0.64,55.25,35,28,63,47,35,12,1.34,74.47,Difficile,Moyen,1,Plus Facile que la Prediction,Pas Adapte
1371,2016,Information-Communication,1,Introduction a l'Etude du Langage,7,Le Developpement du Langage,13,306,5,QROC,0.03,0.75,89.66,50,6,56,54,50,4,1.04,92.59,Facile,Facile,0,Meme Difficulte que la Prediction,Pas Adapte
2437,2017,Information-Communication,1,Introduction a l'Etude du Langage,7,Le Developpement du Langage,13,306,5,QROC,0.75,0.2,6.84,4,59,63,47,4,43,1.34,8.51,Moyen,Difficile,-1,Plus Difficile que la Prediction,Pas Adapte
3503,2018,Information-Communication,1,Introduction a l'Etude du Langage,7,Le Developpement du Langage,13,306,5,QROC,0.57,0.28,44.69,28,34,62,59,28,31,1.05,47.46,Difficile,Moyen,1,Plus Facile que la Prediction,Pas Adapte
4569,2019,Information-Communication,1,Introduction a l'Etude du Langage,7,Le Developpement du Langage,13,306,5,QROC,0.05,0.88,68.27,46,21,67,66,46,20,1.02,69.7,Facile,Facile,0,Meme Difficulte que la Prediction,Adapte
5635,2020,Information-Communication,1,Introduction a l'Etude du Langage,7,Le Developpement du Langage,13,306,5,QROC,0.05,0.5,68.27,46,21,67,47,46,1,1.43,97.87,Facile,Facile,0,Meme Difficulte que la Prediction,Adapte
306,2015,Information-Communication,1,Introduction a l'Etude du Langage,7,Le Developpement du Langage,13,307,6,QCU,0.31,0.48,57.31,5,3,8,6,5,1,1.33,83.33,Moyen,Moyen,0,Meme Difficulte que la Prediction,Pas Adapte
1372,2016,Information-Communication,1,Introduction a l'Etude du Langage,7,Le Developpement du Langage,13,307,6,QCU,0.22,0.41,42.37,3,5,8,6,3,3,1.33,50.0,Moyen,Moyen,0,Meme Difficulte que la Prediction,Pas Adapte
2438,2017,Information-Communication,1,Introduction a l'Etude du Langage,7,Le Developpement du Langage,13,307,6,QCM,0.16,0.82,75.9,5,2,7,7,5,2,1.0,71.43,Facile,Facile,0,Meme Difficulte que la Prediction,Pas Adapte
3504,2018,Information-Communication,1,Introduction a l'Etude du Langage,7,Le Developpement du Langage,13,307,6,QCM,0.76,0.2,17.05,1,6,7,6,1,5,1.17,16.67,Difficile,Difficile,0,Meme Difficulte que la Prediction,Pas Adapte
4570,2019,Information-Communication,1,Introduction a l'Etude du Langage,7,Le Developpement du Langage,13,307,6,QCM,0.09,0.97,76.83,6,2,8,8,6,2,1.0,75.0,Moyen,Facile,1,Plus Facile que la Prediction,Pas Adapte
5636,2020,Information-Communication,1,Introduction a l'Etude du Langage,7,Le Developpement du Langage,13,307,6,QCM,0.18,0.74,76.75,6,2,8,8,6,2,1.0,75.0,Difficile,Facile,2,Beaucoup plus Facile que la Prediction,Pas Adapte
307,2015,Information-Communication,1,Introduction a l'Etude du Langage,7,Le Developpement du Langage,13,308,7,QCU,0.56,0.25,15.85,3,16,19,16,3,13,1.19,18.75,Facile,Difficile,-2,Beaucoup plus Difficile que la Prediction,Pas Adapte
1373,2016,Information-Communication,1,Introduction a l'Etude du Langage,7,Le Developpement du Langage,13,308,7,QCU,0.08,1.0,71.88,12,4,16,14,12,2,1.14,85.71,Facile,Facile,0,Meme Difficulte que la Prediction,Adapte
2439,2017,Information-Communication,1,Introduction a l'Etude du Langage,7,Le Developpement du Langage,13,308,7,QCU,0.07,0.77,71.88,12,5,17,13,12,1,1.31,92.31,Facile,Facile,0,Meme Difficulte que la Prediction,Adapte
3505,2018,Information-Communication,1,Introduction a l'Etude du Langage,7,Le Developpement du Langage,13,308,7,QCU,0.1,0.93,71.88,11,4,15,14,11,3,1.07,78.57,Facile,Facile,0,Meme Difficulte que la Prediction,Adapte
4571,2019,Information-Communication,1,Introduction a l'Etude du Langage,7,Le Developpement du Langage,13,308,7,QCU,0.19,0.92,71.88,9,4,13,11,9,2,1.18,81.82,Facile,Facile,0,Meme Difficulte que la Prediction,Adapte
5637,2020,Information-Communication,1,Introduction a l'Etude du Langage,7,Le Developpement du Langage,13,308,7,QCU,0.06,0.84,71.88,9,4,13,13,9,4,1.0,69.23,Facile,Facile,0,Meme Difficulte que la Prediction,Adapte
308,2015,Information-Communication,1,Introduction a l'Etude du Langage,7,Le Developpement du Langage,13,309,8,QCM,0.01,0.75,73.4,48,17,65,53,48,5,1.23,90.57,Facile,Facile,0,Meme Difficulte que la Prediction,Adapte
1374,2016,Information-Communication,1,Introduction a l'Etude du Langage,7,Le Developpement du Langage,13,309,8,QCM,0.15,0.7,73.4,43,15,58,43,43,0,1.35,100.0,Facile,Facile,0,Meme Difficulte que la Prediction,Adapte
2440,2017,Information-Communication,1,Introduction a l'Etude du Langage,7,Le Developpement du Langage,13,309,8,QCM,0.19,0.73,73.4,47,17,64,59,47,12,1.08,79.66,Facile,Facile,0,Meme Difficulte que la Prediction,Adapte
3506,2018,Information-Communication,1,Introduction a l'Etude du Langage,7,Le Developpement du Langage,13,309,8,QO,0.04,0.62,73.4,46,17,63,58,46,12,1.09,79.31,Facile,Facile,0,Meme Difficulte que la Prediction,Adapte
4572,2019,Information-Communication,1,Introduction a l'Etude du Langage,7,Le Developpement du Langage,13,309,8,QO,0.04,0.31,73.4,40,14,54,48,40,8,1.12,83.33,Facile,Facile,0,Meme Difficulte que la Prediction,Adapte
5638,2020,Information-Communication,1,Introduction a l'Etude du Langage,7,Le Developpement du Langage,13,309,8,QROC,0.12,0.83,73.4,45,16,61,58,45,13,1.05,77.59,Facile,Facile,0,Meme Difficulte que la Prediction,Adapte
309,2015,Information-Communication,1,Introduction a l'Etude du Langage,7,Le Developpement du Langage,13,310,9,QCM,0.06,0.97,75.76,75,24,99,79,75,4,1.25,94.94,Facile,Facile,0,Meme Difficulte que la Prediction,Pas Adapte
1375,2016,Information-Communication,1,Introduction a l'Etude du Langage,7,Le Developpement du Langage,13,310,9,QCM,0.04,0.87,67.69,66,32,98,74,66,8,1.32,89.19,Facile,Facile,0,Meme Difficulte que la Prediction,Adapte
2441,2017,Information-Communication,1,Introduction a l'Etude du Langage,7,Le Developpement du Langage,13,310,9,QCM,0.18,0.78,67.69,76,37,113,76,76,0,1.49,100.0,Facile,Facile,0,Meme Difficulte que la Prediction,Adapte
3507,2018,Information-Communication,1,Introduction a l'Etude du Langage,7,Le Developpement du Langage,13,310,9,QCM,0.03,0.79,67.69,66,32,98,75,66,9,1.31,88.0,Facile,Facile,0,Meme Difficulte que la Prediction,Adapte
4573,2019,Information-Communication,1,Introduction a l'Etude du Langage,7,Le Developpement du Langage,13,310,9,QCM,0.01,0.8,67.69,72,35,107,98,72,26,1.09,73.47,Facile,Facile,0,Meme Difficulte que la Prediction,Adapte
5639,2020,Information-Communication,1,Introduction a l'Etude du Langage,7,Le Developpement du Langage,13,310,9,QCM,0.18,0.84,67.69,72,34,106,89,72,17,1.19,80.9,Facile,Facile,0,Meme Difficulte que la Prediction,Adapte
310,2015,Information-Communication,1,Introduction a l'Etude du Langage,7,Le Developpement du Langage,13,311,10,QCM,0.14,0.97,87.82,41,6,47,41,41,0,1.15,100.0,Facile,Facile,0,Meme Difficulte que la Prediction,Pas Adapte
1376,2016,Information-Communication,1,Introduction a l'Etude du Langage,7,Le Developpement du Langage,13,311,10,QCM,0.43,0.6,47.39,25,27,52,27,25,2,1.93,92.59,Moyen,Moyen,0,Meme Difficulte que la Prediction,Pas Adapte
2442,2017,Information-Communication,1,Introduction a l'Etude du Langage,7,Le Developpement du Langage,13,311,10,QCM,0.5,0.2,31.8,18,38,56,33,18,15,1.7,54.55,Moyen,Difficile,-1,Plus Difficile que la Prediction,Pas Adapte
3508,2018,Information-Communication,1,Introduction a l'Etude du Langage,7,Le Developpement du Langage,13,311,10,QCM,0.2,0.87,80.18,51,12,63,61,51,10,1.03,83.61,Difficile,Facile,2,Beaucoup plus Facile que la Prediction,Pas Adapte
4574,2019,Information-Communication,1,Introduction a l'Etude du Langage,7,Le Developpement du Langage,13,311,10,QCM,0.1,0.95,93.88,53,3,56,54,53,1,1.04,98.15,Facile,Facile,0,Meme Difficulte que la Prediction,Pas Adapte
5640,2020,Information-Communication,1,Introduction a l'Etude du Langage,7,Le Developpement du Langage,13,311,10,QCM,0.65,0.18,29.55,18,42,60,33,18,15,1.82,54.55,Difficile,Difficile,0,Meme Difficulte que la Prediction,Pas Adapte
311,2015,Information-Communication,1,Introduction a l'Etude du Langage,7,Le Developpement du Langage,13,312,11,QCU,0.33,0.71,61.85,59,36,95,80,59,21,1.19,73.75,Difficile,Moyen,1,Plus Facile que la Prediction,Adapte
1377,2016,Information-Communication,1,Introduction a l'Etude du Langage,7,Le Developpement du Langage,13,312,11,QCU,0.39,0.42,61.85,65,40,105,65,65,0,1.62,100.0,Moyen,Moyen,0,Meme Difficulte que la Prediction,Adapte
2443,2017,Information-Communication,1,Introduction a l'Etude du Langage,7,Le Developpement du Langage,13,312,11,QCU,0.36,0.44,61.85,66,40,106,80,66,14,1.32,82.5,Moyen,Moyen,0,Meme Difficulte que la Prediction,Adapte
3509,2018,Information-Communication,1,Introduction a l'Etude du Langage,7,Le Developpement du Langage,13,312,11,QCU,0.35,0.55,61.85,73,45,118,92,73,19,1.28,79.35,Moyen,Moyen,0,Meme Difficulte que la Prediction,Adapte
4575,2019,Information-Communication,1,Introduction a l'Etude du Langage,7,Le Developpement du Langage,13,312,11,QCU,0.28,0.67,61.85,68,42,110,87,68,19,1.26,78.16,Moyen,Moyen,0,Meme Difficulte que la Prediction,Adapte
5641,2020,Information-Communication,1,Introduction a l'Etude du Langage,7,Le Developpement du Langage,13,312,11,QCU,0.27,0.62,61.85,69,42,111,90,69,21,1.23,76.67,Moyen,Moyen,0,Meme Difficulte que la Prediction,Adapte
312,2015,Information-Communication,1,Introduction a l'Etude du Langage,7,Le Developpement du Langage,13,313,12,QCU,0.15,0.9,93.39,69,5,74,73,69,4,1.01,94.52,Facile,Facile,0,Meme Difficulte que la Prediction,Pas Adapte
1378,2016,Information-Communication,1,Introduction a l'Etude du Langage,7,Le Developpement du Langage,13,313,12,QCU,0.17,0.84,84.84,65,12,77,71,65,6,1.08,91.55,Difficile,Facile,2,Beaucoup plus Facile que la Prediction,Pas Adapte
2444,2017,Information-Communication,1,Introduction a l'Etude du Langage,7,Le Developpement du Langage,13,313,12,QCU,0.18,0.89,65.67,44,23,67,63,44,19,1.06,69.84,Facile,Facile,0,Meme Difficulte que la Prediction,Adapte
3510,2018,Information-Communication,1,Introduction a l'Etude du Langage,7,Le Developpement du Langage,13,313,12,QCU,0.05,0.94,65.67,40,21,61,52,40,12,1.17,76.92,Facile,Facile,0,Meme Difficulte que la Prediction,Adapte
4576,2019,Information-Communication,1,Introduction a l'Etude du Langage,7,Le Developpement du Langage,13,313,12,QCM,0.02,0.73,65.67,38,20,58,51,38,13,1.14,74.51,Facile,Facile,0,Meme Difficulte que la Prediction,Adapte
5642,2020,Information-Communication,1,Introduction a l'Etude du Langage,7,Le Developpement du Langage,13,313,12,QCM,0.05,0.76,65.67,33,17,50,34,33,1,1.47,97.06,Facile,Facile,0,Meme Difficulte que la Prediction,Adapte
313,2015,Information-Communication,1,Introduction a l'Etude du Langage,7,Le Developpement du Langage,13,314,13,QCM,0.18,0.91,76.03,53,17,70,55,53,2,1.27,96.36,Facile,Facile,0,Meme Difficulte que la Prediction,Pas Adapte
1379,2016,Information-Communication,1,Introduction a l'Etude du Langage,7,Le Developpement du Langage,13,314,13,QCM,0.2,0.87,93.72,67,5,72,68,67,1,1.06,98.53,Facile,Facile,0,Meme Difficulte que la Prediction,Pas Adapte
2445,2017,Information-Communication,1,Introduction a l'Etude du Langage,7,Le Developpement du Langage,13,314,13,QCM,0.57,0.2,30.66,19,43,62,50,19,31,1.24,38.0,Facile,Difficile,-2,Beaucoup plus Difficile que la Prediction,Pas Adapte
3511,2018,Information-Communication,1,Introduction a l'Etude du Langage,7,Le Developpement du Langage,13,314,13,QCM,0.76,0.22,18.86,12,53,65,24,12,12,2.71,50.0,Difficile,Difficile,0,Meme Difficulte que la Prediction,Pas Adapte
4577,2019,Information-Communication,1,Introduction a l'Etude du Langage,7,Le Developpement du Langage,13,314,13,QCM,0.03,0.94,71.58,42,16,58,42,42,0,1.38,100.0,Facile,Facile,0,Meme Difficulte que la Prediction,Adapte
5643,2020,Information-Communication,1,Introduction a l'Etude du Langage,7,Le Developpement du Langage,13,314,13,QROC,0.04,0.66,71.58,38,15,53,43,38,5,1.23,88.37,Facile,Facile,0,Meme Difficulte que la Prediction,Adapte
314,2015,Information-Communication,1,Introduction a l'Etude du Langage,8,L'Apprentissage de la Langue Seconde,4,315,1,QCU,0.04,1.0,67.28,22,10,32,23,22,1,1.39,95.65,Moyen,Facile,1,Plus Facile que la Prediction,Adapte
1380,2016,Information-Communication,1,Introduction a l'Etude du Langage,8,L'Apprentissage de la Langue Seconde,4,315,1,QCU,0.17,0.83,67.28,24,11,35,28,24,4,1.25,85.71,Facile,Facile,0,Meme Difficulte que la Prediction,Adapte
2446,2017,Information-Communication,1,Introduction a l'Etude du Langage,8,L'Apprentissage de la Langue Seconde,4,315,1,QCU,0.07,0.87,67.28,25,12,37,25,25,0,1.48,100.0,Facile,Facile,0,Meme Difficulte que la Prediction,Adapte
3512,2018,Information-Communication,1,Introduction a l'Etude du Langage,8,L'Apprentissage de la Langue Seconde,4,315,1,QCU,0.11,0.99,67.28,28,13,41,32,28,4,1.28,87.5,Facile,Facile,0,Meme Difficulte que la Prediction,Adapte
4578,2019,Information-Communication,1,Introduction a l'Etude du Langage,8,L'Apprentissage de la Langue Seconde,4,315,1,QCU,0.17,0.97,67.28,26,13,39,35,26,9,1.11,74.29,Facile,Facile,0,Meme Difficulte que la Prediction,Adapte
5644,2020,Information-Communication,1,Introduction a l'Etude du Langage,8,L'Apprentissage de la Langue Seconde,4,315,1,QCM,0.13,0.96,67.28,25,12,37,26,25,1,1.42,96.15,Facile,Facile,0,Meme Difficulte que la Prediction,Adapte
315,2015,Information-Communication,1,Introduction a l'Etude du Langage,8,L'Apprentissage de la Langue Seconde,4,316,2,QCM,0.09,0.78,85.2,41,7,48,44,41,3,1.09,93.18,Facile,Facile,0,Meme Difficulte que la Prediction,Pas Adapte
1381,2016,Information-Communication,1,Introduction a l'Etude du Langage,8,L'Apprentissage de la Langue Seconde,4,316,2,QCM,0.74,0.16,10.57,6,49,55,16,6,10,3.44,37.5,Facile,Difficile,-2,Beaucoup plus Difficile que la Prediction,Pas Adapte
2447,2017,Information-Communication,1,Introduction a l'Etude du Langage,8,L'Apprentissage de la Langue Seconde,4,316,2,QCU,0.06,0.92,81.31,49,11,60,59,49,10,1.02,83.05,Facile,Facile,0,Meme Difficulte que la Prediction,Pas Adapte
3513,2018,Information-Communication,1,Introduction a l'Etude du Langage,8,L'Apprentissage de la Langue Seconde,4,316,2,QCU,0.6,0.3,34.93,24,44,68,32,24,8,2.12,75.0,Difficile,Difficile,0,Meme Difficulte que la Prediction,Pas Adapte
4579,2019,Information-Communication,1,Introduction a l'Etude du Langage,8,L'Apprentissage de la Langue Seconde,4,316,2,QCU,0.59,0.2,22.42,16,54,70,29,16,13,2.41,55.17,Facile,Difficile,-2,Beaucoup plus Difficile que la Prediction,Pas Adapte
5645,2020,Information-Communication,1,Introduction a l'Etude du Langage,8,L'Apprentissage de la Langue Seconde,4,316,2,QCU,0.03,0.9,86.29,65,10,75,73,65,8,1.03,89.04,Facile,Facile,0,Meme Difficulte que la Prediction,Pas Adapte
316,2015,Information-Communication,1,Introduction a l'Etude du Langage,8,L'Apprentissage de la Langue Seconde,4,317,3,QCU,0.15,0.92,72.55,70,26,96,84,70,14,1.14,83.33,Facile,Facile,0,Meme Difficulte que la Prediction,Adapte
1382,2016,Information-Communication,1,Introduction a l'Etude du Langage,8,L'Apprentissage de la Langue Seconde,4,317,3,QCU,0.15,0.97,72.55,72,27,99,76,72,4,1.3,94.74,Facile,Facile,0,Meme Difficulte que la Prediction,Adapte
2448,2017,Information-Communication,1,Introduction a l'Etude du Langage,8,L'Apprentissage de la Langue Seconde,4,317,3,QCU,0.2,0.99,72.55,68,26,94,74,68,6,1.27,91.89,Facile,Facile,0,Meme Difficulte que la Prediction,Adapte
3514,2018,Information-Communication,1,Introduction a l'Etude du Langage,8,L'Apprentissage de la Langue Seconde,4,317,3,QCU,0.19,0.91,72.55,71,27,98,72,71,1,1.36,98.61,Facile,Facile,0,Meme Difficulte que la Prediction,Adapte
4580,2019,Information-Communication,1,Introduction a l'Etude du Langage,8,L'Apprentissage de la Langue Seconde,4,317,3,QCU,0.15,0.81,72.55,77,29,106,89,77,12,1.19,86.52,Facile,Facile,0,Meme Difficulte que la Prediction,Adapte
5646,2020,Information-Communication,1,Introduction a l'Etude du Langage,8,L'Apprentissage de la Langue Seconde,4,317,3,QCU,0.06,0.91,72.55,86,33,119,109,86,23,1.09,78.9,Facile,Facile,0,Meme Difficulte que la Prediction,Adapte
317,2015,Information-Communication,1,Introduction a l'Etude du Langage,8,L'Apprentissage de la Langue Seconde,4,318,4,QCU,0.28,0.46,37.72,29,48,77,32,29,3,2.41,90.62,Moyen,Moyen,0,Meme Difficulte que la Prediction,Pas Adapte
1383,2016,Information-Communication,1,Introduction a l'Etude du Langage,8,L'Apprentissage de la Langue Seconde,4,318,4,QCM,0.34,0.67,56.67,50,39,89,76,50,26,1.17,65.79,Moyen,Moyen,0,Meme Difficulte que la Prediction,Pas Adapte
2449,2017,Information-Communication,1,Introduction a l'Etude du Langage,8,L'Apprentissage de la Langue Seconde,4,318,4,QCM,0.03,0.99,68.03,52,24,76,65,52,13,1.17,80.0,Moyen,Facile,1,Plus Facile que la Prediction,Adapte
3515,2018,Information-Communication,1,Introduction a l'Etude du Langage,8,L'Apprentissage de la Langue Seconde,4,318,4,QCM,0.15,0.82,68.03,57,27,84,78,57,21,1.08,73.08,Facile,Facile,0,Meme Difficulte que la Prediction,Adapte
4581,2019,Information-Communication,1,Introduction a l'Etude du Langage,8,L'Apprentissage de la Langue Seconde,4,318,4,QCM,0.06,0.84,68.03,59,28,87,71,59,12,1.23,83.1,Facile,Facile,0,Meme Difficulte que la Prediction,Adapte
5647,2020,Information-Communication,1,Introduction a l'Etude du Langage,8,L'Apprentissage de la Langue Seconde,4,318,4,QCM,0.14,0.95,68.03,64,30,94,69,64,5,1.36,92.75,Facile,Facile,0,Meme Difficulte que la Prediction,Adapte
318,2015,Information-Communication,1,Introduction a l'Etude du Langage,9,La Sociolinguistique et la Dialectologie,7,319,1,QCM,0.68,0.17,1.92,2,94,96,61,2,59,1.57,3.28,Moyen,Difficile,-1,Plus Difficile que la Prediction,Pas Adapte
1384,2016,Information-Communication,1,Introduction a l'Etude du Langage,9,La Sociolinguistique et la Dialectologie,7,319,1,QCM,0.77,0.16,19.5,20,82,102,78,20,58,1.31,25.64,Difficile,Difficile,0,Meme Difficulte que la Prediction,Pas Adapte
2450,2017,Information-Communication,1,Introduction a l'Etude du Langage,9,La Sociolinguistique et la Dialectologie,7,319,1,QCM,0.09,0.92,66.38,68,34,102,78,68,10,1.31,87.18,Facile,Facile,0,Meme Difficulte que la Prediction,Adapte
3516,2018,Information-Communication,1,Introduction a l'Etude du Langage,9,La Sociolinguistique et la Dialectologie,7,319,1,QCM,0.13,0.98,66.38,58,30,88,82,58,24,1.07,70.73,Facile,Facile,0,Meme Difficulte que la Prediction,Adapte
4582,2019,Information-Communication,1,Introduction a l'Etude du Langage,9,La Sociolinguistique et la Dialectologie,7,319,1,QCM,0.07,0.84,66.38,62,32,94,64,62,2,1.47,96.88,Facile,Facile,0,Meme Difficulte que la Prediction,Adapte
5648,2020,Information-Communication,1,Introduction a l'Etude du Langage,9,La Sociolinguistique et la Dialectologie,7,319,1,QCU,0.17,0.81,66.38,63,32,95,81,63,18,1.17,77.78,Facile,Facile,0,Meme Difficulte que la Prediction,Adapte
319,2015,Information-Communication,1,Introduction a l'Etude du Langage,9,La Sociolinguistique et la Dialectologie,7,320,2,QCM,0.6,0.27,8.26,2,28,30,27,2,25,1.11,7.41,Difficile,Difficile,0,Meme Difficulte que la Prediction,Pas Adapte
1385,2016,Information-Communication,1,Introduction a l'Etude du Langage,9,La Sociolinguistique et la Dialectologie,7,320,2,QCM,0.42,0.37,64.78,18,10,28,24,18,6,1.17,75.0,Moyen,Moyen,0,Meme Difficulte que la Prediction,Adapte
2451,2017,Information-Communication,1,Introduction a l'Etude du Langage,9,La Sociolinguistique et la Dialectologie,7,320,2,QCU,0.21,0.56,64.78,21,11,32,22,21,1,1.45,95.45,Moyen,Moyen,0,Meme Difficulte que la Prediction,Adapte
3517,2018,Information-Communication,1,Introduction a l'Etude du Langage,9,La Sociolinguistique et la Dialectologie,7,320,2,QCU,0.27,0.62,64.78,19,10,29,21,19,2,1.38,90.48,Moyen,Moyen,0,Meme Difficulte que la Prediction,Adapte
4583,2019,Information-Communication,1,Introduction a l'Etude du Langage,9,La Sociolinguistique et la Dialectologie,7,320,2,QCU,0.25,0.72,64.78,21,12,33,28,21,7,1.18,75.0,Moyen,Moyen,0,Meme Difficulte que la Prediction,Adapte
5649,2020,Information-Communication,1,Introduction a l'Etude du Langage,9,La Sociolinguistique et la Dialectologie,7,320,2,QCM,0.43,0.41,64.78,24,13,37,24,24,0,1.54,100.0,Moyen,Moyen,0,Meme Difficulte que la Prediction,Adapte
320,2015,Information-Communication,1,Introduction a l'Etude du Langage,9,La Sociolinguistique et la Dialectologie,7,321,3,QCU,0.07,0.81,72.94,14,5,19,19,14,5,1.0,73.68,Moyen,Facile,1,Plus Facile que la Prediction,Adapte
1386,2016,Information-Communication,1,Introduction a l'Etude du Langage,9,La Sociolinguistique et la Dialectologie,7,321,3,QCU,0.15,0.88,72.94,15,5,20,16,15,1,1.25,93.75,Facile,Facile,0,Meme Difficulte que la Prediction,Adapte
2452,2017,Information-Communication,1,Introduction a l'Etude du Langage,9,La Sociolinguistique et la Dialectologie,7,321,3,QCU,0.06,0.99,72.94,15,5,20,15,15,0,1.33,100.0,Facile,Facile,0,Meme Difficulte que la Prediction,Adapte
3518,2018,Information-Communication,1,Introduction a l'Etude du Langage,9,La Sociolinguistique et la Dialectologie,7,321,3,QCU,0.12,0.9,72.94,17,6,23,22,17,5,1.05,77.27,Facile,Facile,0,Meme Difficulte que la Prediction,Adapte
4584,2019,Information-Communication,1,Introduction a l'Etude du Langage,9,La Sociolinguistique et la Dialectologie,7,321,3,QCU,0.05,0.99,72.94,18,6,24,24,18,6,1.0,75.0,Facile,Facile,0,Meme Difficulte que la Prediction,Adapte
5650,2020,Information-Communication,1,Introduction a l'Etude du Langage,9,La Sociolinguistique et la Dialectologie,7,321,3,QCM,0.08,0.93,72.94,15,5,20,19,15,4,1.05,78.95,Facile,Facile,0,Meme Difficulte que la Prediction,Adapte
321,2015,Information-Communication,1,Introduction a l'Etude du Langage,9,La Sociolinguistique et la Dialectologie,7,322,4,QCM,0.59,0.26,21.99,11,37,48,31,11,20,1.55,35.48,Moyen,Difficile,-1,Plus Difficile que la Prediction,Pas Adapte
1387,2016,Information-Communication,1,Introduction a l'Etude du Langage,9,La Sociolinguistique et la Dialectologie,7,322,4,QCM,0.79,0.23,23.95,12,39,51,26,12,14,1.96,46.15,Moyen,Difficile,-1,Plus Difficile que la Prediction,Pas Adapte
2453,2017,Information-Communication,1,Introduction a l'Etude du Langage,9,La Sociolinguistique et la Dialectologie,7,322,4,QROC,0.43,0.33,55.92,32,25,57,56,32,24,1.02,57.14,Moyen,Moyen,0,Meme Difficulte que la Prediction,Pas Adapte
3519,2018,Information-Communication,1,Introduction a l'Etude du Langage,9,La Sociolinguistique et la Dialectologie,7,322,4,QCM,0.28,0.52,61.92,35,22,57,52,35,17,1.1,67.31,Facile,Moyen,-1,Plus Difficile que la Prediction,Adapte
4585,2019,Information-Communication,1,Introduction a l'Etude du Langage,9,La Sociolinguistique et la Dialectologie,7,322,4,QCM,0.42,0.68,61.92,37,23,60,40,37,3,1.5,92.5,Moyen,Moyen,0,Meme Difficulte que la Prediction,Adapte
5651,2020,Information-Communication,1,Introduction a l'Etude du Langage,9,La Sociolinguistique et la Dialectologie,7,322,4,QCM,0.31,0.55,61.92,35,21,56,52,35,17,1.08,67.31,Moyen,Moyen,0,Meme Difficulte que la Prediction,Adapte
322,2015,Information-Communication,1,Introduction a l'Etude du Langage,9,La Sociolinguistique et la Dialectologie,7,323,5,QROC,0.62,0.16,19.78,2,9,11,9,2,7,1.22,22.22,Difficile,Difficile,0,Meme Difficulte que la Prediction,Pas Adapte
1388,2016,Information-Communication,1,Introduction a l'Etude du Langage,9,La Sociolinguistique et la Dialectologie,7,323,5,QROC,0.31,0.4,55.19,7,6,13,12,7,5,1.08,58.33,Difficile,Moyen,1,Plus Facile que la Prediction,Pas Adapte
2454,2017,Information-Communication,1,Introduction a l'Etude du Langage,9,La Sociolinguistique et la Dialectologie,7,323,5,QROC,0.67,0.17,3.55,0,13,13,12,0,12,1.08,0.0,Moyen,Difficile,-1,Plus Difficile que la Prediction,Pas Adapte
3520,2018,Information-Communication,1,Introduction a l'Etude du Langage,9,La Sociolinguistique et la Dialectologie,7,323,5,QROC,1.0,0.22,29.6,3,8,11,9,3,6,1.22,33.33,Difficile,Difficile,0,Meme Difficulte que la Prediction,Pas Adapte
4586,2019,Information-Communication,1,Introduction a l'Etude du Langage,9,La Sociolinguistique et la Dialectologie,7,323,5,QROC,0.88,0.22,5.2,1,12,13,11,1,10,1.18,9.09,Difficile,Difficile,0,Meme Difficulte que la Prediction,Pas Adapte
5652,2020,Information-Communication,1,Introduction a l'Etude du Langage,9,La Sociolinguistique et la Dialectologie,7,323,5,QROC,0.79,0.24,24.75,4,11,15,9,4,5,1.67,44.44,Difficile,Difficile,0,Meme Difficulte que la Prediction,Pas Adapte
323,2015,Information-Communication,1,Introduction a l'Etude du Langage,9,La Sociolinguistique et la Dialectologie,7,324,6,QCU,0.49,0.37,12.07,5,37,42,36,5,31,1.17,13.89,Difficile,Difficile,0,Meme Difficulte que la Prediction,Pas Adapte
1389,2016,Information-Communication,1,Introduction a l'Etude du Langage,9,La Sociolinguistique et la Dialectologie,7,324,6,QCU,0.53,0.28,23.41,9,31,40,25,9,16,1.6,36.0,Difficile,Difficile,0,Meme Difficulte que la Prediction,Pas Adapte
2455,2017,Information-Communication,1,Introduction a l'Etude du Langage,9,La Sociolinguistique et la Dialectologie,7,324,6,QCU,0.16,0.77,91.43,39,4,43,42,39,3,1.02,92.86,Difficile,Facile,2,Beaucoup plus Facile que la Prediction,Pas Adapte
3521,2018,Information-Communication,1,Introduction a l'Etude du Langage,9,La Sociolinguistique et la Dialectologie,7,324,6,QCU,0.12,0.8,79.21,38,10,48,40,38,2,1.2,95.0,Facile,Facile,0,Meme Difficulte que la Prediction,Pas Adapte
4587,2019,Information-Communication,1,Introduction a l'Etude du Langage,9,La Sociolinguistique et la Dialectologie,7,324,6,QCU,0.01,0.93,85.85,41,7,48,47,41,6,1.02,87.23,Facile,Facile,0,Meme Difficulte que la Prediction,Pas Adapte
5653,2020,Information-Communication,1,Introduction a l'Etude du Langage,9,La Sociolinguistique et la Dialectologie,7,324,6,QCU,0.15,0.87,79.61,37,10,47,42,37,5,1.12,88.1,Difficile,Facile,2,Beaucoup plus Facile que la Prediction,Pas Adapte
324,2015,Information-Communication,1,Introduction a l'Etude du Langage,9,La Sociolinguistique et la Dialectologie,7,325,7,QCU,0.17,0.91,66.3,16,8,24,22,16,6,1.09,72.73,Moyen,Facile,1,Plus Facile que la Prediction,Adapte
1390,2016,Information-Communication,1,Introduction a l'Etude du Langage,9,La Sociolinguistique et la Dialectologie,7,325,7,QCU,0.06,0.96,66.3,17,8,25,22,17,5,1.14,77.27,Facile,Facile,0,Meme Difficulte que la Prediction,Adapte
2456,2017,Information-Communication,1,Introduction a l'Etude du Langage,9,La Sociolinguistique et la Dialectologie,7,325,7,QCM,0.14,0.8,66.3,18,9,27,26,18,8,1.04,69.23,Facile,Facile,0,Meme Difficulte que la Prediction,Adapte
3522,2018,Information-Communication,1,Introduction a l'Etude du Langage,9,La Sociolinguistique et la Dialectologie,7,325,7,QCM,0.06,0.96,66.3,20,10,30,25,20,5,1.2,80.0,Facile,Facile,0,Meme Difficulte que la Prediction,Adapte
4588,2019,Information-Communication,1,Introduction a l'Etude du Langage,9,La Sociolinguistique et la Dialectologie,7,325,7,QCM,0.1,0.91,66.3,19,9,28,25,19,6,1.12,76.0,Facile,Facile,0,Meme Difficulte que la Prediction,Adapte
5654,2020,Information-Communication,1,Introduction a l'Etude du Langage,9,La Sociolinguistique et la Dialectologie,7,325,7,QCM,0.15,0.85,66.3,20,10,30,29,20,9,1.03,68.97,Facile,Facile,0,Meme Difficulte que la Prediction,Adapte
325,2015,Information-Communication,1,Introduction a l'Etude du Langage,10,L'Amenagement Linguistique,12,326,1,QCU,0.48,0.2,19.89,8,30,38,20,8,12,1.9,40.0,Difficile,Difficile,0,Meme Difficulte que la Prediction,Pas Adapte
1391,2016,Information-Communication,1,Introduction a l'Etude du Langage,10,L'Amenagement Linguistique,12,326,1,QCU,0.21,0.5,59.08,21,15,36,24,21,3,1.5,87.5,Difficile,Moyen,1,Plus Facile que la Prediction,Pas Adapte
2457,2017,Information-Communication,1,Introduction a l'Etude du Langage,10,L'Amenagement Linguistique,12,326,1,QCU,0.71,0.27,12.63,4,28,32,27,4,23,1.19,14.81,Difficile,Difficile,0,Meme Difficulte que la Prediction,Pas Adapte
3523,2018,Information-Communication,1,Introduction a l'Etude du Langage,10,L'Amenagement Linguistique,12,326,1,QCU,0.0,0.99,83.02,26,5,31,30,26,4,1.03,86.67,Facile,Facile,0,Meme Difficulte que la Prediction,Pas Adapte
4589,2019,Information-Communication,1,Introduction a l'Etude du Langage,10,L'Amenagement Linguistique,12,326,1,QCU,0.12,0.79,69.73,25,11,36,34,25,9,1.06,73.53,Facile,Facile,0,Meme Difficulte que la Prediction,Adapte
5655,2020,Information-Communication,1,Introduction a l'Etude du Langage,10,L'Amenagement Linguistique,12,326,1,QCU,0.12,0.82,69.73,25,11,36,31,25,6,1.16,80.65,Facile,Facile,0,Meme Difficulte que la Prediction,Adapte
326,2015,Information-Communication,1,Introduction a l'Etude du Langage,10,L'Amenagement Linguistique,12,327,2,QROC,0.19,0.97,69.13,68,31,99,88,68,20,1.12,77.27,Difficile,Facile,2,Beaucoup plus Facile que la Prediction,Adapte
1392,2016,Information-Communication,1,Introduction a l'Etude du Langage,10,L'Amenagement Linguistique,12,327,2,QROC,0.01,0.5,69.13,70,31,101,80,70,10,1.26,87.5,Facile,Facile,0,Meme Difficulte que la Prediction,Adapte
2458,2017,Information-Communication,1,Introduction a l'Etude du Langage,10,L'Amenagement Linguistique,12,327,2,QROC,0.1,0.62,69.13,60,27,87,71,60,11,1.23,84.51,Facile,Facile,0,Meme Difficulte que la Prediction,Adapte
3524,2018,Information-Communication,1,Introduction a l'Etude du Langage,10,L'Amenagement Linguistique,12,327,2,QROC,0.13,0.49,69.13,53,24,77,57,53,4,1.35,92.98,Facile,Facile,0,Meme Difficulte que la Prediction,Adapte
4590,2019,Information-Communication,1,Introduction a l'Etude du Langage,10,L'Amenagement Linguistique,12,327,2,QROC,0.1,0.85,69.13,46,20,66,56,46,10,1.18,82.14,Facile,Facile,0,Meme Difficulte que la Prediction,Adapte
5656,2020,Information-Communication,1,Introduction a l'Etude du Langage,10,L'Amenagement Linguistique,12,327,2,QROC,0.11,0.82,69.13,50,23,73,71,50,21,1.03,70.42,Facile,Facile,0,Meme Difficulte que la Prediction,Adapte
327,2015,Information-Communication,1,Introduction a l'Etude du Langage,10,L'Amenagement Linguistique,12,328,3,QCM,0.01,0.91,79.02,70,18,88,71,70,1,1.24,98.59,Difficile,Facile,2,Beaucoup plus Facile que la Prediction,Pas Adapte
1393,2016,Information-Communication,1,Introduction a l'Etude du Langage,10,L'Amenagement Linguistique,12,328,3,QCM,0.52,0.24,32.37,30,64,94,57,30,27,1.65,52.63,Difficile,Difficile,0,Meme Difficulte que la Prediction,Pas Adapte
2459,2017,Information-Communication,1,Introduction a l'Etude du Langage,10,L'Amenagement Linguistique,12,328,3,QCM,0.1,0.93,90.37,94,10,104,101,94,7,1.03,93.07,Facile,Facile,0,Meme Difficulte que la Prediction,Pas Adapte
3525,2018,Information-Communication,1,Introduction a l'Etude du Langage,10,L'Amenagement Linguistique,12,328,3,QCM,0.48,0.61,60.63,70,46,116,79,70,9,1.47,88.61,Difficile,Moyen,1,Plus Facile que la Prediction,Adapte
4591,2019,Information-Communication,1,Introduction a l'Etude du Langage,10,L'Amenagement Linguistique,12,328,3,QCM,0.28,0.48,60.63,67,44,111,95,67,28,1.17,70.53,Moyen,Moyen,0,Meme Difficulte que la Prediction,Adapte
5657,2020,Information-Communication,1,Introduction a l'Etude du Langage,10,L'Amenagement Linguistique,12,328,3,QO,0.52,0.27,60.63,70,45,115,79,70,9,1.46,88.61,Moyen,Moyen,0,Meme Difficulte que la Prediction,Adapte
328,2015,Information-Communication,1,Introduction a l'Etude du Langage,10,L'Amenagement Linguistique,12,329,4,QCU,0.2,0.88,87.71,85,12,97,90,85,5,1.08,94.44,Facile,Facile,0,Meme Difficulte que la Prediction,Pas Adapte
1394,2016,Information-Communication,1,Introduction a l'Etude du Langage,10,L'Amenagement Linguistique,12,329,4,QCU,0.09,0.79,85.59,91,15,106,96,91,5,1.1,94.79,Moyen,Facile,1,Plus Facile que la Prediction,Pas Adapte
2460,2017,Information-Communication,1,Introduction a l'Etude du Langage,10,L'Amenagement Linguistique,12,329,4,QCU,0.15,0.81,87.09,99,15,114,101,99,2,1.13,98.02,Moyen,Facile,1,Plus Facile que la Prediction,Pas Adapte
3526,2018,Information-Communication,1,Introduction a l'Etude du Langage,10,L'Amenagement Linguistique,12,329,4,QCU,0.05,0.98,91.04,90,9,99,95,90,5,1.04,94.74,Facile,Facile,0,Meme Difficulte que la Prediction,Pas Adapte
4592,2019,Information-Communication,1,Introduction a l'Etude du Langage,10,L'Amenagement Linguistique,12,329,4,QCU,0.36,0.43,54.76,58,48,106,98,58,40,1.08,59.18,Moyen,Moyen,0,Meme Difficulte que la Prediction,Pas Adapte
5658,2020,Information-Communication,1,Introduction a l'Etude du Langage,10,L'Amenagement Linguistique,12,329,4,QCU,0.18,0.81,81.88,95,21,116,97,95,2,1.2,97.94,Facile,Facile,0,Meme Difficulte que la Prediction,Pas Adapte
329,2015,Information-Communication,1,Introduction a l'Etude du Langage,10,L'Amenagement Linguistique,12,330,5,QCU,0.65,0.25,0.25,0,69,69,33,0,33,2.09,0.0,Difficile,Difficile,0,Meme Difficulte que la Prediction,Pas Adapte
1395,2016,Information-Communication,1,Introduction a l'Etude du Langage,10,L'Amenagement Linguistique,12,330,5,QCU,0.11,0.78,89.18,61,7,68,66,61,5,1.03,92.42,Facile,Facile,0,Meme Difficulte que la Prediction,Pas Adapte
2461,2017,Information-Communication,1,Introduction a l'Etude du Langage,10,L'Amenagement Linguistique,12,330,5,QCU,0.31,0.59,57.62,41,31,72,51,41,10,1.41,80.39,Facile,Moyen,-1,Plus Difficile que la Prediction,Pas Adapte
3527,2018,Information-Communication,1,Introduction a l'Etude du Langage,10,L'Amenagement Linguistique,12,330,5,QCU,0.57,0.36,1.99,1,66,67,35,1,34,1.91,2.86,Facile,Difficile,-2,Beaucoup plus Difficile que la Prediction,Pas Adapte
4593,2019,Information-Communication,1,Introduction a l'Etude du Langage,10,L'Amenagement Linguistique,12,330,5,QCU,0.54,0.23,17.04,10,48,58,30,10,20,1.93,33.33,Facile,Difficile,-2,Beaucoup plus Difficile que la Prediction,Pas Adapte
5659,2020,Information-Communication,1,Introduction a l'Etude du Langage,10,L'Amenagement Linguistique,12,330,5,QCU,0.26,0.64,42.76,27,37,64,31,27,4,2.06,87.1,Facile,Moyen,-1,Plus Difficile que la Prediction,Pas Adapte
330,2015,Information-Communication,1,Introduction a l'Etude du Langage,10,L'Amenagement Linguistique,12,331,6,QCM,0.35,0.33,36.97,6,10,16,12,6,6,1.33,50.0,Difficile,Moyen,1,Plus Facile que la Prediction,Pas Adapte
1396,2016,Information-Communication,1,Introduction a l'Etude du Langage,10,L'Amenagement Linguistique,12,331,6,QCM,0.61,0.22,19.28,3,15,18,16,3,13,1.12,18.75,Moyen,Difficile,-1,Plus Difficile que la Prediction,Pas Adapte
2462,2017,Information-Communication,1,Introduction a l'Etude du Langage,10,L'Amenagement Linguistique,12,331,6,QCM,0.0,0.9,96.85,16,1,17,16,16,0,1.06,100.0,Facile,Facile,0,Meme Difficulte que la Prediction,Pas Adapte
3528,2018,Information-Communication,1,Introduction a l'Etude du Langage,10,L'Amenagement Linguistique,12,331,6,QCM,0.36,0.62,52.66,7,7,14,13,7,6,1.08,53.85,Difficile,Moyen,1,Plus Facile que la Prediction,Pas Adapte
4594,2019,Information-Communication,1,Introduction a l'Etude du Langage,10,L'Amenagement Linguistique,12,331,6,QCM,0.75,0.23,10.47,2,13,15,14,2,12,1.07,14.29,Difficile,Difficile,0,Meme Difficulte que la Prediction,Pas Adapte
5660,2020,Information-Communication,1,Introduction a l'Etude du Langage,10,L'Amenagement Linguistique,12,331,6,QCM,0.19,0.85,93.44,13,1,14,13,13,0,1.08,100.0,Facile,Facile,0,Meme Difficulte que la Prediction,Pas Adapte
331,2015,Information-Communication,1,Introduction a l'Etude du Langage,10,L'Amenagement Linguistique,12,332,7,QCM,0.37,0.66,43.46,22,29,51,41,22,19,1.24,53.66,Facile,Moyen,-1,Plus Difficile que la Prediction,Pas Adapte
1397,2016,Information-Communication,1,Introduction a l'Etude du Langage,10,L'Amenagement Linguistique,12,332,7,QCM,0.53,0.25,11.07,6,49,55,31,6,25,1.77,19.35,Facile,Difficile,-2,Beaucoup plus Difficile que la Prediction,Pas Adapte
2463,2017,Information-Communication,1,Introduction a l'Etude du Langage,10,L'Amenagement Linguistique,12,332,7,QCM,0.08,0.84,97.08,50,1,51,51,50,1,1.0,98.04,Difficile,Facile,2,Beaucoup plus Facile que la Prediction,Pas Adapte
3529,2018,Information-Communication,1,Introduction a l'Etude du Langage,10,L'Amenagement Linguistique,12,332,7,QCM,0.24,0.4,52.23,25,22,47,36,25,11,1.31,69.44,Moyen,Moyen,0,Meme Difficulte que la Prediction,Pas Adapte
4595,2019,Information-Communication,1,Introduction a l'Etude du Langage,10,L'Amenagement Linguistique,12,332,7,QCM,0.19,0.86,70.57,34,14,48,38,34,4,1.26,89.47,Difficile,Facile,2,Beaucoup plus Facile que la Prediction,Adapte
5661,2020,Information-Communication,1,Introduction a l'Etude du Langage,10,L'Amenagement Linguistique,12,332,7,QCM,0.11,0.74,70.57,34,14,48,43,34,9,1.12,79.07,Facile,Facile,0,Meme Difficulte que la Prediction,Adapte
332,2015,Information-Communication,1,Introduction a l'Etude du Langage,10,L'Amenagement Linguistique,12,333,8,QCM,0.04,0.83,79.86,54,13,67,60,54,6,1.12,90.0,Moyen,Facile,1,Plus Facile que la Prediction,Pas Adapte
1398,2016,Information-Communication,1,Introduction a l'Etude du Langage,10,L'Amenagement Linguistique,12,333,8,QCM,0.5,0.39,39.07,30,47,77,47,30,17,1.64,63.83,Moyen,Moyen,0,Meme Difficulte que la Prediction,Pas Adapte
2464,2017,Information-Communication,1,Introduction a l'Etude du Langage,10,L'Amenagement Linguistique,12,333,8,QCM,0.79,0.2,30.96,24,52,76,45,24,21,1.69,53.33,Difficile,Difficile,0,Meme Difficulte que la Prediction,Pas Adapte
3530,2018,Information-Communication,1,Introduction a l'Etude du Langage,10,L'Amenagement Linguistique,12,333,8,QCM,0.3,0.65,59.39,45,31,76,70,45,25,1.09,64.29,Moyen,Moyen,0,Meme Difficulte que la Prediction,Pas Adapte
4596,2019,Information-Communication,1,Introduction a l'Etude du Langage,10,L'Amenagement Linguistique,12,333,8,QCM,0.14,0.81,68.56,48,22,70,58,48,10,1.21,82.76,Facile,Facile,0,Meme Difficulte que la Prediction,Adapte
5662,2020,Information-Communication,1,Introduction a l'Etude du Langage,10,L'Amenagement Linguistique,12,333,8,QCM,0.14,0.78,68.56,47,21,68,52,47,5,1.31,90.38,Facile,Facile,0,Meme Difficulte que la Prediction,Adapte
333,2015,Information-Communication,1,Introduction a l'Etude du Langage,10,L'Amenagement Linguistique,12,334,9,QO,0.06,0.45,82.92,54,11,65,62,54,8,1.05,87.1,Difficile,Facile,2,Beaucoup plus Facile que la Prediction,Pas Adapte
1399,2016,Information-Communication,1,Introduction a l'Etude du Langage,10,L'Amenagement Linguistique,12,334,9,QO,0.89,0.07,30.15,20,46,66,58,20,38,1.14,34.48,Difficile,Difficile,0,Meme Difficulte que la Prediction,Pas Adapte
2465,2017,Information-Communication,1,Introduction a l'Etude du Langage,10,L'Amenagement Linguistique,12,334,9,QROC,0.44,0.39,36.94,25,42,67,36,25,11,1.86,69.44,Facile,Moyen,-1,Plus Difficile que la Prediction,Pas Adapte
3531,2018,Information-Communication,1,Introduction a l'Etude du Langage,10,L'Amenagement Linguistique,12,334,9,QROC,0.9,0.2,33.53,22,44,66,60,22,38,1.1,36.67,Difficile,Difficile,0,Meme Difficulte que la Prediction,Pas Adapte
4597,2019,Information-Communication,1,Introduction a l'Etude du Langage,10,L'Amenagement Linguistique,12,334,9,QROC,0.44,0.36,47.07,30,33,63,55,30,25,1.15,54.55,Moyen,Moyen,0,Meme Difficulte que la Prediction,Pas Adapte
5663,2020,Information-Communication,1,Introduction a l'Etude du Langage,10,L'Amenagement Linguistique,12,334,9,QROC,0.73,0.15,2.87,2,53,55,33,2,31,1.67,6.06,Difficile,Difficile,0,Meme Difficulte que la Prediction,Pas Adapte
334,2015,Information-Communication,1,Introduction a l'Etude du Langage,10,L'Amenagement Linguistique,12,335,10,QCU,0.13,0.83,69.9,9,4,13,9,9,0,1.44,100.0,Difficile,Facile,2,Beaucoup plus Facile que la Prediction,Adapte
1400,2016,Information-Communication,1,Introduction a l'Etude du Langage,10,L'Amenagement Linguistique,12,335,10,QCU,0.07,0.81,69.9,10,5,15,12,10,2,1.25,83.33,Facile,Facile,0,Meme Difficulte que la Prediction,Adapte
2466,2017,Information-Communication,1,Introduction a l'Etude du Langage,10,L'Amenagement Linguistique,12,335,10,QROC,0.15,0.49,69.9,10,5,15,10,10,0,1.5,100.0,Facile,Facile,0,Meme Difficulte que la Prediction,Adapte
3532,2018,Information-Communication,1,Introduction a l'Etude du Langage,10,L'Amenagement Linguistique,12,335,10,QO,0.13,0.88,69.9,12,5,17,13,12,1,1.31,92.31,Facile,Facile,0,Meme Difficulte que la Prediction,Adapte
4598,2019,Information-Communication,1,Introduction a l'Etude du Langage,10,L'Amenagement Linguistique,12,335,10,QO,0.19,0.39,69.9,14,6,20,18,14,4,1.11,77.78,Facile,Facile,0,Meme Difficulte que la Prediction,Adapte
5664,2020,Information-Communication,1,Introduction a l'Etude du Langage,10,L'Amenagement Linguistique,12,335,10,QROC,0.15,0.6,69.9,15,7,22,21,15,6,1.05,71.43,Facile,Facile,0,Meme Difficulte que la Prediction,Adapte
335,2015,Information-Communication,1,Introduction a l'Etude du Langage,10,L'Amenagement Linguistique,12,336,11,QO,0.78,0.01,5.26,0,9,9,6,0,6,1.5,0.0,Difficile,Difficile,0,Meme Difficulte que la Prediction,Pas Adapte
1401,2016,Information-Communication,1,Introduction a l'Etude du Langage,10,L'Amenagement Linguistique,12,336,11,QROC,0.42,0.3,63.58,6,3,9,7,6,1,1.29,85.71,Moyen,Moyen,0,Meme Difficulte que la Prediction,Adapte
2467,2017,Information-Communication,1,Introduction a l'Etude du Langage,10,L'Amenagement Linguistique,12,336,11,QO,0.52,0.2,63.58,6,4,10,9,6,3,1.11,66.67,Moyen,Moyen,0,Meme Difficulte que la Prediction,Adapte
3533,2018,Information-Communication,1,Introduction a l'Etude du Langage,10,L'Amenagement Linguistique,12,336,11,QO,0.21,0.25,63.58,6,4,10,7,6,1,1.43,85.71,Moyen,Moyen,0,Meme Difficulte que la Prediction,Adapte
4599,2019,Information-Communication,1,Introduction a l'Etude du Langage,10,L'Amenagement Linguistique,12,336,11,QROC,0.43,0.25,63.58,5,3,8,8,5,3,1.0,62.5,Moyen,Moyen,0,Meme Difficulte que la Prediction,Adapte
5665,2020,Information-Communication,1,Introduction a l'Etude du Langage,10,L'Amenagement Linguistique,12,336,11,QO,0.57,0.18,63.58,5,3,8,7,5,2,1.14,71.43,Moyen,Moyen,0,Meme Difficulte que la Prediction,Adapte
336,2015,Information-Communication,1,Introduction a l'Etude du Langage,10,L'Amenagement Linguistique,12,337,12,QCU,0.33,0.56,41.61,27,37,64,48,27,21,1.33,56.25,Facile,Moyen,-1,Plus Difficile que la Prediction,Pas Adapte
1402,2016,Information-Communication,1,Introduction a l'Etude du Langage,10,L'Amenagement Linguistique,12,337,12,QCU,0.25,0.64,53.64,37,32,69,54,37,17,1.28,68.52,Moyen,Moyen,0,Meme Difficulte que la Prediction,Pas Adapte
2468,2017,Information-Communication,1,Introduction a l'Etude du Langage,10,L'Amenagement Linguistique,12,337,12,QCU,0.69,0.3,5.85,4,58,62,39,4,35,1.59,10.26,Difficile,Difficile,0,Meme Difficulte que la Prediction,Pas Adapte
3534,2018,Information-Communication,1,Introduction a l'Etude du Langage,10,L'Amenagement Linguistique,12,337,12,QCU,0.37,0.69,58.94,37,26,63,62,37,25,1.02,59.68,Facile,Moyen,-1,Plus Difficile que la Prediction,Pas Adapte
4600,2019,Information-Communication,1,Introduction a l'Etude du Langage,10,L'Amenagement Linguistique,12,337,12,QCU,0.09,0.96,87.93,52,7,59,59,52,7,1.0,88.14,Facile,Facile,0,Meme Difficulte que la Prediction,Pas Adapte
5666,2020,Information-Communication,1,Introduction a l'Etude du Langage,10,L'Amenagement Linguistique,12,337,12,QCU,0.02,0.78,76.18,48,15,63,56,48,8,1.12,85.71,Facile,Facile,0,Meme Difficulte que la Prediction,Pas Adapte
337,2015,Information-Communication,1,Grammaire Lexicale Fonctionnelle,1,Les Traits Syntaxiques,7,338,1,QCM,0.14,0.8,97.37,19,1,20,19,19,0,1.05,100.0,Difficile,Facile,2,Beaucoup plus Facile que la Prediction,Pas Adapte
1403,2016,Information-Communication,1,Grammaire Lexicale Fonctionnelle,1,Les Traits Syntaxiques,7,338,1,QCM,0.42,0.58,43.72,8,11,19,9,8,1,2.11,88.89,Moyen,Moyen,0,Meme Difficulte que la Prediction,Pas Adapte
2469,2017,Information-Communication,1,Grammaire Lexicale Fonctionnelle,1,Les Traits Syntaxiques,7,338,1,QCM,0.48,0.34,40.88,8,11,19,9,8,1,2.11,88.89,Moyen,Moyen,0,Meme Difficulte que la Prediction,Pas Adapte
3535,2018,Information-Communication,1,Grammaire Lexicale Fonctionnelle,1,Les Traits Syntaxiques,7,338,1,QCM,0.33,0.56,35.96,7,12,19,11,7,4,1.73,63.64,Moyen,Moyen,0,Meme Difficulte que la Prediction,Pas Adapte
4601,2019,Information-Communication,1,Grammaire Lexicale Fonctionnelle,1,Les Traits Syntaxiques,7,338,1,QCM,0.15,0.97,98.86,16,0,16,16,16,0,1.0,100.0,Difficile,Facile,2,Beaucoup plus Facile que la Prediction,Pas Adapte
5667,2020,Information-Communication,1,Grammaire Lexicale Fonctionnelle,1,Les Traits Syntaxiques,7,338,1,QCM,0.17,0.74,87.01,12,2,14,12,12,0,1.17,100.0,Moyen,Facile,1,Plus Facile que la Prediction,Pas Adapte
338,2015,Information-Communication,1,Grammaire Lexicale Fonctionnelle,1,Les Traits Syntaxiques,7,339,2,QCU,0.38,0.73,59.93,30,20,50,37,30,7,1.35,81.08,Facile,Moyen,-1,Plus Difficile que la Prediction,Pas Adapte
1404,2016,Information-Communication,1,Grammaire Lexicale Fonctionnelle,1,Les Traits Syntaxiques,7,339,2,QROC,0.84,0.14,32.31,14,30,44,28,14,14,1.57,50.0,Facile,Difficile,-2,Beaucoup plus Difficile que la Prediction,Pas Adapte
2470,2017,Information-Communication,1,Grammaire Lexicale Fonctionnelle,1,Les Traits Syntaxiques,7,339,2,QO,0.15,0.31,65.02,29,15,44,38,29,9,1.16,76.32,Moyen,Facile,1,Plus Facile que la Prediction,Adapte
3536,2018,Information-Communication,1,Grammaire Lexicale Fonctionnelle,1,Les Traits Syntaxiques,7,339,2,QO,0.15,0.57,65.02,25,13,38,26,25,1,1.46,96.15,Facile,Facile,0,Meme Difficulte que la Prediction,Adapte
4602,2019,Information-Communication,1,Grammaire Lexicale Fonctionnelle,1,Les Traits Syntaxiques,7,339,2,QO,0.15,0.33,65.02,23,12,35,27,23,4,1.3,85.19,Facile,Facile,0,Meme Difficulte que la Prediction,Adapte
5668,2020,Information-Communication,1,Grammaire Lexicale Fonctionnelle,1,Les Traits Syntaxiques,7,339,2,QO,0.09,0.49,65.02,21,12,33,23,21,2,1.43,91.3,Facile,Facile,0,Meme Difficulte que la Prediction,Adapte
339,2015,Information-Communication,1,Grammaire Lexicale Fonctionnelle,1,Les Traits Syntaxiques,7,340,3,QROC,0.47,0.29,48.7,38,41,79,45,38,7,1.76,84.44,Moyen,Moyen,0,Meme Difficulte que la Prediction,Pas Adapte
1405,2016,Information-Communication,1,Grammaire Lexicale Fonctionnelle,1,Les Traits Syntaxiques,7,340,3,QO,0.86,0.13,1.22,1,77,78,53,1,52,1.47,1.89,Moyen,Difficile,-1,Plus Difficile que la Prediction,Pas Adapte
2471,2017,Information-Communication,1,Grammaire Lexicale Fonctionnelle,1,Les Traits Syntaxiques,7,340,3,QO,0.49,0.24,61.18,52,33,85,60,52,8,1.42,86.67,Difficile,Moyen,1,Plus Facile que la Prediction,Adapte
3537,2018,Information-Communication,1,Grammaire Lexicale Fonctionnelle,1,Les Traits Syntaxiques,7,340,3,QO,0.64,0.25,61.18,44,28,72,53,44,9,1.36,83.02,Moyen,Moyen,0,Meme Difficulte que la Prediction,Adapte
4603,2019,Information-Communication,1,Grammaire Lexicale Fonctionnelle,1,Les Traits Syntaxiques,7,340,3,QROC,0.39,0.31,61.18,43,28,71,59,43,16,1.2,72.88,Moyen,Moyen,0,Meme Difficulte que la Prediction,Adapte
5669,2020,Information-Communication,1,Grammaire Lexicale Fonctionnelle,1,Les Traits Syntaxiques,7,340,3,QROC,0.49,0.27,61.18,42,26,68,67,42,25,1.01,62.69,Moyen,Moyen,0,Meme Difficulte que la Prediction,Adapte
340,2015,Information-Communication,1,Grammaire Lexicale Fonctionnelle,1,Les Traits Syntaxiques,7,341,4,QCU,0.42,0.22,14.71,5,30,35,32,5,27,1.09,15.62,Facile,Difficile,-2,Beaucoup plus Difficile que la Prediction,Pas Adapte
1406,2016,Information-Communication,1,Grammaire Lexicale Fonctionnelle,1,Les Traits Syntaxiques,7,341,4,QCU,0.49,0.22,31.1,9,21,30,15,9,6,2.0,60.0,Facile,Difficile,-2,Beaucoup plus Difficile que la Prediction,Pas Adapte
2472,2017,Information-Communication,1,Grammaire Lexicale Fonctionnelle,1,Les Traits Syntaxiques,7,341,4,QCU,0.36,0.6,63.98,22,12,34,25,22,3,1.36,88.0,Facile,Moyen,-1,Plus Difficile que la Prediction,Adapte
3538,2018,Information-Communication,1,Grammaire Lexicale Fonctionnelle,1,Les Traits Syntaxiques,7,341,4,QCU,0.31,0.73,63.98,23,13,36,32,23,9,1.12,71.88,Moyen,Moyen,0,Meme Difficulte que la Prediction,Adapte
4604,2019,Information-Communication,1,Grammaire Lexicale Fonctionnelle,1,Les Traits Syntaxiques,7,341,4,QCU,0.24,0.53,63.98,20,12,32,21,20,1,1.52,95.24,Moyen,Moyen,0,Meme Difficulte que la Prediction,Adapte
5670,2020,Information-Communication,1,Grammaire Lexicale Fonctionnelle,1,Les Traits Syntaxiques,7,341,4,QCU,0.36,0.66,63.98,18,10,28,20,18,2,1.4,90.0,Moyen,Moyen,0,Meme Difficulte que la Prediction,Adapte
341,2015,Information-Communication,1,Grammaire Lexicale Fonctionnelle,1,Les Traits Syntaxiques,7,342,5,QCU,0.12,1.0,86.31,28,5,33,31,28,3,1.06,90.32,Facile,Facile,0,Meme Difficulte que la Prediction,Pas Adapte
1407,2016,Information-Communication,1,Grammaire Lexicale Fonctionnelle,1,Les Traits Syntaxiques,7,342,5,QCU,0.24,0.56,40.04,15,23,38,16,15,1,2.38,93.75,Moyen,Moyen,0,Meme Difficulte que la Prediction,Pas Adapte
2473,2017,Information-Communication,1,Grammaire Lexicale Fonctionnelle,1,Les Traits Syntaxiques,7,342,5,QCU,0.07,0.78,91.31,31,3,34,34,31,3,1.0,91.18,Moyen,Facile,1,Plus Facile que la Prediction,Pas Adapte
3539,2018,Information-Communication,1,Grammaire Lexicale Fonctionnelle,1,Les Traits Syntaxiques,7,342,5,QCU,0.04,0.92,69.37,24,10,34,32,24,8,1.06,75.0,Moyen,Facile,1,Plus Facile que la Prediction,Adapte
4605,2019,Information-Communication,1,Grammaire Lexicale Fonctionnelle,1,Les Traits Syntaxiques,7,342,5,QCU,0.1,0.81,69.37,26,11,37,31,26,5,1.19,83.87,Facile,Facile,0,Meme Difficulte que la Prediction,Adapte
5671,2020,Information-Communication,1,Grammaire Lexicale Fonctionnelle,1,Les Traits Syntaxiques,7,342,5,QCU,0.1,0.99,69.37,22,9,31,23,22,1,1.35,95.65,Facile,Facile,0,Meme Difficulte que la Prediction,Adapte
342,2015,Information-Communication,1,Grammaire Lexicale Fonctionnelle,1,Les Traits Syntaxiques,7,343,6,QCM,0.57,0.19,1.66,0,13,13,6,0,6,2.17,0.0,Moyen,Difficile,-1,Plus Difficile que la Prediction,Pas Adapte
1408,2016,Information-Communication,1,Grammaire Lexicale Fonctionnelle,1,Les Traits Syntaxiques,7,343,6,QCM,0.06,0.74,95.37,14,1,15,15,14,1,1.0,93.33,Facile,Facile,0,Meme Difficulte que la Prediction,Pas Adapte
2474,2017,Information-Communication,1,Grammaire Lexicale Fonctionnelle,1,Les Traits Syntaxiques,7,343,6,QCM,0.57,0.19,11.74,2,13,15,11,2,9,1.36,18.18,Difficile,Difficile,0,Meme Difficulte que la Prediction,Pas Adapte
3540,2018,Information-Communication,1,Grammaire Lexicale Fonctionnelle,1,Les Traits Syntaxiques,7,343,6,QCM,0.47,0.68,54.52,9,8,17,9,9,0,1.89,100.0,Moyen,Moyen,0,Meme Difficulte que la Prediction,Pas Adapte
4606,2019,Information-Communication,1,Grammaire Lexicale Fonctionnelle,1,Les Traits Syntaxiques,7,343,6,QCM,0.44,0.32,52.53,9,8,17,12,9,3,1.42,75.0,Facile,Moyen,-1,Plus Difficile que la Prediction,Pas Adapte
5672,2020,Information-Communication,1,Grammaire Lexicale Fonctionnelle,1,Les Traits Syntaxiques,7,343,6,QCM,0.04,0.84,94.2,13,1,14,13,13,0,1.08,100.0,Difficile,Facile,2,Beaucoup plus Facile que la Prediction,Pas Adapte
343,2015,Information-Communication,1,Grammaire Lexicale Fonctionnelle,1,Les Traits Syntaxiques,7,344,7,QCM,0.58,0.29,29.92,15,35,50,36,15,21,1.39,41.67,Difficile,Difficile,0,Meme Difficulte que la Prediction,Pas Adapte
1409,2016,Information-Communication,1,Grammaire Lexicale Fonctionnelle,1,Les Traits Syntaxiques,7,344,7,QCM,0.77,0.19,6.0,3,52,55,33,3,30,1.67,9.09,Difficile,Difficile,0,Meme Difficulte que la Prediction,Pas Adapte
2475,2017,Information-Communication,1,Grammaire Lexicale Fonctionnelle,1,Les Traits Syntaxiques,7,344,7,QCM,0.18,0.78,93.11,48,4,52,50,48,2,1.04,96.0,Facile,Facile,0,Meme Difficulte que la Prediction,Pas Adapte
3541,2018,Information-Communication,1,Grammaire Lexicale Fonctionnelle,1,Les Traits Syntaxiques,7,344,7,QCU,0.73,0.32,25.33,12,35,47,30,12,18,1.57,40.0,Facile,Difficile,-2,Beaucoup plus Difficile que la Prediction,Pas Adapte
4607,2019,Information-Communication,1,Grammaire Lexicale Fonctionnelle,1,Les Traits Syntaxiques,7,344,7,QCU,0.74,0.3,12.42,6,42,48,28,6,22,1.71,21.43,Difficile,Difficile,0,Meme Difficulte que la Prediction,Pas Adapte
5673,2020,Information-Communication,1,Grammaire Lexicale Fonctionnelle,1,Les Traits Syntaxiques,7,344,7,QCU,0.49,0.28,28.68,15,36,51,20,15,5,2.55,75.0,Difficile,Difficile,0,Meme Difficulte que la Prediction,Pas Adapte
344,2015,Information-Communication,1,Grammaire Lexicale Fonctionnelle,2,Les Fonctions,6,345,1,QCU,0.7,0.34,11.19,10,75,85,40,10,30,2.12,25.0,Moyen,Difficile,-1,Plus Difficile que la Prediction,Pas Adapte
1410,2016,Information-Communication,1,Grammaire Lexicale Fonctionnelle,2,Les Fonctions,6,345,1,QCU,0.64,0.22,6.2,6,89,95,84,6,78,1.13,7.14,Difficile,Difficile,0,Meme Difficulte que la Prediction,Pas Adapte
2476,2017,Information-Communication,1,Grammaire Lexicale Fonctionnelle,2,Les Fonctions,6,345,1,QCU,0.21,0.7,42.47,45,60,105,46,45,1,2.28,97.83,Facile,Moyen,-1,Plus Difficile que la Prediction,Pas Adapte
3542,2018,Information-Communication,1,Grammaire Lexicale Fonctionnelle,2,Les Fonctions,6,345,1,QCU,0.66,0.22,17.07,17,81,98,64,17,47,1.53,26.56,Difficile,Difficile,0,Meme Difficulte que la Prediction,Pas Adapte
4608,2019,Information-Communication,1,Grammaire Lexicale Fonctionnelle,2,Les Fonctions,6,345,1,QCU,0.16,0.81,83.15,94,19,113,95,94,1,1.19,98.95,Moyen,Facile,1,Plus Facile que la Prediction,Pas Adapte
5674,2020,Information-Communication,1,Grammaire Lexicale Fonctionnelle,2,Les Fonctions,6,345,1,QCM,0.54,0.19,27.9,28,74,102,39,28,11,2.62,71.79,Difficile,Difficile,0,Meme Difficulte que la Prediction,Pas Adapte
345,2015,Information-Communication,1,Grammaire Lexicale Fonctionnelle,2,Les Fonctions,6,346,2,QCM,0.15,0.99,80.34,4,1,5,4,4,0,1.25,100.0,Facile,Facile,0,Meme Difficulte que la Prediction,Pas Adapte
1411,2016,Information-Communication,1,Grammaire Lexicale Fonctionnelle,2,Les Fonctions,6,346,2,QCM,0.68,0.17,31.12,2,3,5,2,2,0,2.5,100.0,Difficile,Difficile,0,Meme Difficulte que la Prediction,Pas Adapte
2477,2017,Information-Communication,1,Grammaire Lexicale Fonctionnelle,2,Les Fonctions,6,346,2,QCM,0.75,0.17,21.32,1,3,4,1,1,0,4.0,100.0,Difficile,Difficile,0,Meme Difficulte que la Prediction,Pas Adapte
3543,2018,Information-Communication,1,Grammaire Lexicale Fonctionnelle,2,Les Fonctions,6,346,2,QCM,0.04,0.95,85.08,4,1,5,4,4,0,1.25,100.0,Facile,Facile,0,Meme Difficulte que la Prediction,Pas Adapte
4609,2019,Information-Communication,1,Grammaire Lexicale Fonctionnelle,2,Les Fonctions,6,346,2,QCM,0.16,0.76,81.38,3,1,4,3,3,0,1.33,100.0,Moyen,Facile,1,Plus Facile que la Prediction,Pas Adapte
5675,2020,Information-Communication,1,Grammaire Lexicale Fonctionnelle,2,Les Fonctions,6,346,2,QCM,0.46,0.64,36.86,2,3,5,5,2,3,1.0,40.0,Moyen,Moyen,0,Meme Difficulte que la Prediction,Pas Adapte
346,2015,Information-Communication,1,Grammaire Lexicale Fonctionnelle,2,Les Fonctions,6,347,3,QROC,0.72,0.03,7.79,5,55,60,34,5,29,1.76,14.71,Difficile,Difficile,0,Meme Difficulte que la Prediction,Pas Adapte
1412,2016,Information-Communication,1,Grammaire Lexicale Fonctionnelle,2,Les Fonctions,6,347,3,QO,0.61,0.28,64.06,34,19,53,44,34,10,1.2,77.27,Moyen,Moyen,0,Meme Difficulte que la Prediction,Adapte
2478,2017,Information-Communication,1,Grammaire Lexicale Fonctionnelle,2,Les Fonctions,6,347,3,QCU,0.2,0.65,64.06,29,16,45,32,29,3,1.41,90.62,Moyen,Moyen,0,Meme Difficulte que la Prediction,Adapte
3544,2018,Information-Communication,1,Grammaire Lexicale Fonctionnelle,2,Les Fonctions,6,347,3,QCU,0.23,0.47,64.06,33,18,51,45,33,12,1.13,73.33,Moyen,Moyen,0,Meme Difficulte que la Prediction,Adapte
4610,2019,Information-Communication,1,Grammaire Lexicale Fonctionnelle,2,Les Fonctions,6,347,3,QCU,0.39,0.58,64.06,29,17,46,41,29,12,1.12,70.73,Moyen,Moyen,0,Meme Difficulte que la Prediction,Adapte
5676,2020,Information-Communication,1,Grammaire Lexicale Fonctionnelle,2,Les Fonctions,6,347,3,QCU,0.36,0.54,64.06,28,16,44,43,28,15,1.02,65.12,Moyen,Moyen,0,Meme Difficulte que la Prediction,Adapte
347,2015,Information-Communication,1,Grammaire Lexicale Fonctionnelle,2,Les Fonctions,6,348,4,QCM,0.49,0.46,60.16,13,9,22,17,13,4,1.29,76.47,Moyen,Moyen,0,Meme Difficulte que la Prediction,Adapte
1413,2016,Information-Communication,1,Grammaire Lexicale Fonctionnelle,2,Les Fonctions,6,348,4,QCM,0.41,0.56,60.16,13,8,21,21,13,8,1.0,61.9,Moyen,Moyen,0,Meme Difficulte que la Prediction,Adapte
2479,2017,Information-Communication,1,Grammaire Lexicale Fonctionnelle,2,Les Fonctions,6,348,4,QCM,0.43,0.6,60.16,11,8,19,14,11,3,1.36,78.57,Moyen,Moyen,0,Meme Difficulte que la Prediction,Adapte
3545,2018,Information-Communication,1,Grammaire Lexicale Fonctionnelle,2,Les Fonctions,6,348,4,QCM,0.26,0.58,60.16,13,9,22,18,13,5,1.22,72.22,Moyen,Moyen,0,Meme Difficulte que la Prediction,Adapte
4611,2019,Information-Communication,1,Grammaire Lexicale Fonctionnelle,2,Les Fonctions,6,348,4,QCU,0.22,0.47,60.16,12,8,20,14,12,2,1.43,85.71,Moyen,Moyen,0,Meme Difficulte que la Prediction,Adapte
5677,2020,Information-Communication,1,Grammaire Lexicale Fonctionnelle,2,Les Fonctions,6,348,4,QCU,0.34,0.75,60.16,13,9,22,20,13,7,1.1,65.0,Moyen,Moyen,0,Meme Difficulte que la Prediction,Adapte
348,2015,Information-Communication,1,Grammaire Lexicale Fonctionnelle,2,Les Fonctions,6,349,5,QCU,0.49,0.31,0.65,0,66,66,24,0,24,2.75,0.0,Difficile,Difficile,0,Meme Difficulte que la Prediction,Pas Adapte
1414,2016,Information-Communication,1,Grammaire Lexicale Fonctionnelle,2,Les Fonctions,6,349,5,QROC,0.45,0.32,53.27,40,36,76,42,40,2,1.81,95.24,Facile,Moyen,-1,Plus Difficile que la Prediction,Pas Adapte
2480,2017,Information-Communication,1,Grammaire Lexicale Fonctionnelle,2,Les Fonctions,6,349,5,QCM,0.19,0.79,86.15,73,12,85,76,73,3,1.12,96.05,Difficile,Facile,2,Beaucoup plus Facile que la Prediction,Pas Adapte
3546,2018,Information-Communication,1,Grammaire Lexicale Fonctionnelle,2,Les Fonctions,6,349,5,QCM,0.37,0.6,61.61,56,35,91,63,56,7,1.44,88.89,Facile,Moyen,-1,Plus Difficile que la Prediction,Adapte
4612,2019,Information-Communication,1,Grammaire Lexicale Fonctionnelle,2,Les Fonctions,6,349,5,QCM,0.39,0.48,61.61,57,35,92,61,57,4,1.51,93.44,Moyen,Moyen,0,Meme Difficulte que la Prediction,Adapte
5678,2020,Information-Communication,1,Grammaire Lexicale Fonctionnelle,2,Les Fonctions,6,349,5,QCM,0.45,0.59,61.61,63,40,103,71,63,8,1.45,88.73,Moyen,Moyen,0,Meme Difficulte que la Prediction,Adapte
349,2015,Information-Communication,1,Grammaire Lexicale Fonctionnelle,2,Les Fonctions,6,350,6,QCM,0.3,0.58,60.91,10,7,17,11,10,1,1.55,90.91,Moyen,Moyen,0,Meme Difficulte que la Prediction,Adapte
1415,2016,Information-Communication,1,Grammaire Lexicale Fonctionnelle,2,Les Fonctions,6,350,6,QCM,0.33,0.36,60.91,12,7,19,13,12,1,1.46,92.31,Moyen,Moyen,0,Meme Difficulte que la Prediction,Adapte
2481,2017,Information-Communication,1,Grammaire Lexicale Fonctionnelle,2,Les Fonctions,6,350,6,QCU,0.31,0.46,60.91,10,7,17,17,10,7,1.0,58.82,Moyen,Moyen,0,Meme Difficulte que la Prediction,Adapte
3547,2018,Information-Communication,1,Grammaire Lexicale Fonctionnelle,2,Les Fonctions,6,350,6,QCU,0.29,0.48,60.91,12,8,20,13,12,1,1.54,92.31,Moyen,Moyen,0,Meme Difficulte que la Prediction,Adapte
4613,2019,Information-Communication,1,Grammaire Lexicale Fonctionnelle,2,Les Fonctions,6,350,6,QCU,0.22,0.7,60.91,10,7,17,12,10,2,1.42,83.33,Moyen,Moyen,0,Meme Difficulte que la Prediction,Adapte
5679,2020,Information-Communication,1,Grammaire Lexicale Fonctionnelle,2,Les Fonctions,6,350,6,QO,0.55,0.19,60.91,9,5,14,10,9,1,1.4,90.0,Moyen,Moyen,0,Meme Difficulte que la Prediction,Adapte
350,2015,Information-Communication,1,Grammaire Lexicale Fonctionnelle,3,Ecrire une Grammaire Lexicale Fonctionnelle,10,351,1,QCU,0.08,0.8,88.08,39,5,44,39,39,0,1.13,100.0,Difficile,Facile,2,Beaucoup plus Facile que la Prediction,Pas Adapte
1416,2016,Information-Communication,1,Grammaire Lexicale Fonctionnelle,3,Ecrire une Grammaire Lexicale Fonctionnelle,10,351,1,QCU,0.06,0.94,68.68,30,14,44,36,30,6,1.22,83.33,Facile,Facile,0,Meme Difficulte que la Prediction,Adapte
2482,2017,Information-Communication,1,Grammaire Lexicale Fonctionnelle,3,Ecrire une Grammaire Lexicale Fonctionnelle,10,351,1,QCU,0.2,0.99,68.68,32,14,46,36,32,4,1.28,88.89,Facile,Facile,0,Meme Difficulte que la Prediction,Adapte
3548,2018,Information-Communication,1,Grammaire Lexicale Fonctionnelle,3,Ecrire une Grammaire Lexicale Fonctionnelle,10,351,1,QCM,0.06,0.98,68.68,29,13,42,30,29,1,1.4,96.67,Facile,Facile,0,Meme Difficulte que la Prediction,Adapte
4614,2019,Information-Communication,1,Grammaire Lexicale Fonctionnelle,3,Ecrire une Grammaire Lexicale Fonctionnelle,10,351,1,QCM,0.2,0.72,68.68,32,14,46,43,32,11,1.07,74.42,Facile,Facile,0,Meme Difficulte que la Prediction,Adapte
5680,2020,Information-Communication,1,Grammaire Lexicale Fonctionnelle,3,Ecrire une Grammaire Lexicale Fonctionnelle,10,351,1,QCM,0.08,0.84,68.68,27,12,39,32,27,5,1.22,84.38,Facile,Facile,0,Meme Difficulte que la Prediction,Adapte
351,2015,Information-Communication,1,Grammaire Lexicale Fonctionnelle,3,Ecrire une Grammaire Lexicale Fonctionnelle,10,352,2,QCU,0.27,0.72,62.19,60,37,97,83,60,23,1.17,72.29,Facile,Moyen,-1,Plus Difficile que la Prediction,Adapte
1417,2016,Information-Communication,1,Grammaire Lexicale Fonctionnelle,3,Ecrire une Grammaire Lexicale Fonctionnelle,10,352,2,QCU,0.37,0.62,62.19,57,34,91,80,57,23,1.14,71.25,Moyen,Moyen,0,Meme Difficulte que la Prediction,Adapte
2483,2017,Information-Communication,1,Grammaire Lexicale Fonctionnelle,3,Ecrire une Grammaire Lexicale Fonctionnelle,10,352,2,QCU,0.38,0.44,62.19,55,33,88,61,55,6,1.44,90.16,Moyen,Moyen,0,Meme Difficulte que la Prediction,Adapte
3549,2018,Information-Communication,1,Grammaire Lexicale Fonctionnelle,3,Ecrire une Grammaire Lexicale Fonctionnelle,10,352,2,QCM,0.41,0.52,62.19,63,38,101,72,63,9,1.4,87.5,Moyen,Moyen,0,Meme Difficulte que la Prediction,Adapte
4615,2019,Information-Communication,1,Grammaire Lexicale Fonctionnelle,3,Ecrire une Grammaire Lexicale Fonctionnelle,10,352,2,QROC,0.35,0.25,62.19,72,43,115,102,72,30,1.13,70.59,Moyen,Moyen,0,Meme Difficulte que la Prediction,Adapte
5681,2020,Information-Communication,1,Grammaire Lexicale Fonctionnelle,3,Ecrire une Grammaire Lexicale Fonctionnelle,10,352,2,QROC,0.38,0.31,62.19,76,46,122,121,76,45,1.01,62.81,Moyen,Moyen,0,Meme Difficulte que la Prediction,Adapte
352,2015,Information-Communication,1,Grammaire Lexicale Fonctionnelle,3,Ecrire une Grammaire Lexicale Fonctionnelle,10,353,3,QCU,0.19,0.77,82.52,39,8,47,42,39,3,1.12,92.86,Difficile,Facile,2,Beaucoup plus Facile que la Prediction,Pas Adapte
1418,2016,Information-Communication,1,Grammaire Lexicale Fonctionnelle,3,Ecrire une Grammaire Lexicale Fonctionnelle,10,353,3,QCM,0.67,0.19,30.48,16,35,51,40,16,24,1.27,40.0,Difficile,Difficile,0,Meme Difficulte que la Prediction,Pas Adapte
2484,2017,Information-Communication,1,Grammaire Lexicale Fonctionnelle,3,Ecrire une Grammaire Lexicale Fonctionnelle,10,353,3,QCM,0.02,0.84,97.57,50,1,51,51,50,1,1.0,98.04,Facile,Facile,0,Meme Difficulte que la Prediction,Pas Adapte
3550,2018,Information-Communication,1,Grammaire Lexicale Fonctionnelle,3,Ecrire une Grammaire Lexicale Fonctionnelle,10,353,3,QCM,0.79,0.18,5.18,2,44,46,31,2,29,1.48,6.45,Moyen,Difficile,-1,Plus Difficile que la Prediction,Pas Adapte
4616,2019,Information-Communication,1,Grammaire Lexicale Fonctionnelle,3,Ecrire une Grammaire Lexicale Fonctionnelle,10,353,3,QCM,0.02,0.87,95.69,50,2,52,52,50,2,1.0,96.15,Facile,Facile,0,Meme Difficulte que la Prediction,Pas Adapte
5682,2020,Information-Communication,1,Grammaire Lexicale Fonctionnelle,3,Ecrire une Grammaire Lexicale Fonctionnelle,10,353,3,QCM,0.39,0.5,49.73,24,25,49,37,24,13,1.32,64.86,Difficile,Moyen,1,Plus Facile que la Prediction,Pas Adapte
353,2015,Information-Communication,1,Grammaire Lexicale Fonctionnelle,3,Ecrire une Grammaire Lexicale Fonctionnelle,10,354,4,QCU,0.09,0.81,74.39,33,12,45,40,33,7,1.12,82.5,Facile,Facile,0,Meme Difficulte que la Prediction,Adapte
1419,2016,Information-Communication,1,Grammaire Lexicale Fonctionnelle,3,Ecrire une Grammaire Lexicale Fonctionnelle,10,354,4,QCU,0.12,0.92,74.39,32,11,43,38,32,6,1.13,84.21,Facile,Facile,0,Meme Difficulte que la Prediction,Adapte
2485,2017,Information-Communication,1,Grammaire Lexicale Fonctionnelle,3,Ecrire une Grammaire Lexicale Fonctionnelle,10,354,4,QCU,0.17,0.92,74.39,35,12,47,42,35,7,1.12,83.33,Facile,Facile,0,Meme Difficulte que la Prediction,Adapte
3551,2018,Information-Communication,1,Grammaire Lexicale Fonctionnelle,3,Ecrire une Grammaire Lexicale Fonctionnelle,10,354,4,QCU,0.19,0.75,74.39,33,11,44,43,33,10,1.02,76.74,Facile,Facile,0,Meme Difficulte que la Prediction,Adapte
4617,2019,Information-Communication,1,Grammaire Lexicale Fonctionnelle,3,Ecrire une Grammaire Lexicale Fonctionnelle,10,354,4,QCU,0.11,0.86,74.39,31,10,41,40,31,9,1.02,77.5,Facile,Facile,0,Meme Difficulte que la Prediction,Adapte
5683,2020,Information-Communication,1,Grammaire Lexicale Fonctionnelle,3,Ecrire une Grammaire Lexicale Fonctionnelle,10,354,4,QCU,0.14,0.82,74.39,29,10,39,30,29,1,1.3,96.67,Facile,Facile,0,Meme Difficulte que la Prediction,Adapte
354,2015,Information-Communication,1,Grammaire Lexicale Fonctionnelle,3,Ecrire une Grammaire Lexicale Fonctionnelle,10,355,5,QCU,0.33,0.75,42.86,28,38,66,32,28,4,2.06,87.5,Difficile,Moyen,1,Plus Facile que la Prediction,Pas Adapte
1420,2016,Information-Communication,1,Grammaire Lexicale Fonctionnelle,3,Ecrire une Grammaire Lexicale Fonctionnelle,10,355,5,QCU,0.02,0.89,76.06,47,15,62,59,47,12,1.05,79.66,Facile,Facile,0,Meme Difficulte que la Prediction,Pas Adapte
2486,2017,Information-Communication,1,Grammaire Lexicale Fonctionnelle,3,Ecrire une Grammaire Lexicale Fonctionnelle,10,355,5,QCU,0.28,0.47,37.44,23,38,61,36,23,13,1.69,63.89,Difficile,Moyen,1,Plus Facile que la Prediction,Pas Adapte
3552,2018,Information-Communication,1,Grammaire Lexicale Fonctionnelle,3,Ecrire une Grammaire Lexicale Fonctionnelle,10,355,5,QCU,0.4,0.56,58.85,33,23,56,51,33,18,1.1,64.71,Moyen,Moyen,0,Meme Difficulte que la Prediction,Pas Adapte
4618,2019,Information-Communication,1,Grammaire Lexicale Fonctionnelle,3,Ecrire une Grammaire Lexicale Fonctionnelle,10,355,5,QCU,0.72,0.32,33.38,20,39,59,48,20,28,1.23,41.67,Difficile,Difficile,0,Meme Difficulte que la Prediction,Pas Adapte
5684,2020,Information-Communication,1,Grammaire Lexicale Fonctionnelle,3,Ecrire une Grammaire Lexicale Fonctionnelle,10,355,5,QCU,0.13,0.84,85.48,44,8,52,47,44,3,1.11,93.62,Facile,Facile,0,Meme Difficulte que la Prediction,Pas Adapte
355,2015,Information-Communication,1,Grammaire Lexicale Fonctionnelle,3,Ecrire une Grammaire Lexicale Fonctionnelle,10,356,6,QCU,0.37,0.51,51.46,28,27,55,37,28,9,1.49,75.68,Moyen,Moyen,0,Meme Difficulte que la Prediction,Pas Adapte
1421,2016,Information-Communication,1,Grammaire Lexicale Fonctionnelle,3,Ecrire une Grammaire Lexicale Fonctionnelle,10,356,6,QCU,0.3,0.73,41.51,24,34,58,37,24,13,1.57,64.86,Difficile,Moyen,1,Plus Facile que la Prediction,Pas Adapte
2487,2017,Information-Communication,1,Grammaire Lexicale Fonctionnelle,3,Ecrire une Grammaire Lexicale Fonctionnelle,10,356,6,QCU,0.41,0.32,32.71,18,37,55,22,18,4,2.5,81.82,Difficile,Difficile,0,Meme Difficulte que la Prediction,Pas Adapte
3553,2018,Information-Communication,1,Grammaire Lexicale Fonctionnelle,3,Ecrire une Grammaire Lexicale Fonctionnelle,10,356,6,QCU,0.36,0.58,63.49,31,18,49,33,31,2,1.48,93.94,Moyen,Moyen,0,Meme Difficulte que la Prediction,Adapte
4619,2019,Information-Communication,1,Grammaire Lexicale Fonctionnelle,3,Ecrire une Grammaire Lexicale Fonctionnelle,10,356,6,QCU,0.22,0.71,63.49,34,19,53,52,34,18,1.02,65.38,Moyen,Moyen,0,Meme Difficulte que la Prediction,Adapte
5685,2020,Information-Communication,1,Grammaire Lexicale Fonctionnelle,3,Ecrire une Grammaire Lexicale Fonctionnelle,10,356,6,QCU,0.29,0.67,63.49,38,22,60,56,38,18,1.07,67.86,Moyen,Moyen,0,Meme Difficulte que la Prediction,Adapte
356,2015,Information-Communication,1,Grammaire Lexicale Fonctionnelle,3,Ecrire une Grammaire Lexicale Fonctionnelle,10,357,7,QCM,0.62,0.24,10.78,5,39,44,29,5,24,1.52,17.24,Moyen,Difficile,-1,Plus Difficile que la Prediction,Pas Adapte
1422,2016,Information-Communication,1,Grammaire Lexicale Fonctionnelle,3,Ecrire une Grammaire Lexicale Fonctionnelle,10,357,7,QCM,0.09,0.87,76.15,34,10,44,35,34,1,1.26,97.14,Facile,Facile,0,Meme Difficulte que la Prediction,Pas Adapte
2488,2017,Information-Communication,1,Grammaire Lexicale Fonctionnelle,3,Ecrire une Grammaire Lexicale Fonctionnelle,10,357,7,QCM,0.37,0.49,47.72,24,27,51,44,24,20,1.16,54.55,Moyen,Moyen,0,Meme Difficulte que la Prediction,Pas Adapte
3554,2018,Information-Communication,1,Grammaire Lexicale Fonctionnelle,3,Ecrire une Grammaire Lexicale Fonctionnelle,10,357,7,QCM,0.38,0.61,44.85,23,29,52,50,23,27,1.04,46.0,Facile,Moyen,-1,Plus Difficile que la Prediction,Pas Adapte
4620,2019,Information-Communication,1,Grammaire Lexicale Fonctionnelle,3,Ecrire une Grammaire Lexicale Fonctionnelle,10,357,7,QCM,0.4,0.36,37.68,18,29,47,25,18,7,1.88,72.0,Facile,Moyen,-1,Plus Difficile que la Prediction,Pas Adapte
5686,2020,Information-Communication,1,Grammaire Lexicale Fonctionnelle,3,Ecrire une Grammaire Lexicale Fonctionnelle,10,357,7,QCM,0.52,0.16,26.34,11,30,41,14,11,3,2.93,78.57,Difficile,Difficile,0,Meme Difficulte que la Prediction,Pas Adapte
357,2015,Information-Communication,1,Grammaire Lexicale Fonctionnelle,3,Ecrire une Grammaire Lexicale Fonctionnelle,10,358,8,QCU,0.44,0.21,4.5,3,59,62,40,3,37,1.55,7.5,Difficile,Difficile,0,Meme Difficulte que la Prediction,Pas Adapte
1423,2016,Information-Communication,1,Grammaire Lexicale Fonctionnelle,3,Ecrire une Grammaire Lexicale Fonctionnelle,10,358,8,QCU,0.39,0.7,62.71,38,22,60,40,38,2,1.5,95.0,Moyen,Moyen,0,Meme Difficulte que la Prediction,Adapte
2489,2017,Information-Communication,1,Grammaire Lexicale Fonctionnelle,3,Ecrire une Grammaire Lexicale Fonctionnelle,10,358,8,QCM,0.46,0.45,62.71,39,23,62,59,39,20,1.05,66.1,Moyen,Moyen,0,Meme Difficulte que la Prediction,Adapte
3555,2018,Information-Communication,1,Grammaire Lexicale Fonctionnelle,3,Ecrire une Grammaire Lexicale Fonctionnelle,10,358,8,QCM,0.35,0.67,62.71,42,25,67,66,42,24,1.02,63.64,Moyen,Moyen,0,Meme Difficulte que la Prediction,Adapte
4621,2019,Information-Communication,1,Grammaire Lexicale Fonctionnelle,3,Ecrire une Grammaire Lexicale Fonctionnelle,10,358,8,QCU,0.36,0.73,62.71,39,23,62,59,39,20,1.05,66.1,Moyen,Moyen,0,Meme Difficulte que la Prediction,Adapte
5687,2020,Information-Communication,1,Grammaire Lexicale Fonctionnelle,3,Ecrire une Grammaire Lexicale Fonctionnelle,10,358,8,QCU,0.27,0.45,62.71,33,20,53,42,33,9,1.26,78.57,Moyen,Moyen,0,Meme Difficulte que la Prediction,Adapte
358,2015,Information-Communication,1,Grammaire Lexicale Fonctionnelle,3,Ecrire une Grammaire Lexicale Fonctionnelle,10,359,9,QCM,0.68,0.3,21.34,9,32,41,39,9,30,1.05,23.08,Moyen,Difficile,-1,Plus Difficile que la Prediction,Pas Adapte
1424,2016,Information-Communication,1,Grammaire Lexicale Fonctionnelle,3,Ecrire une Grammaire Lexicale Fonctionnelle,10,359,9,QCM,0.5,0.38,43.78,21,26,47,40,21,19,1.18,52.5,Facile,Moyen,-1,Plus Difficile que la Prediction,Pas Adapte
2490,2017,Information-Communication,1,Grammaire Lexicale Fonctionnelle,3,Ecrire une Grammaire Lexicale Fonctionnelle,10,359,9,QCU,0.2,0.49,50.79,20,20,40,31,20,11,1.29,64.52,Moyen,Moyen,0,Meme Difficulte que la Prediction,Pas Adapte
3556,2018,Information-Communication,1,Grammaire Lexicale Fonctionnelle,3,Ecrire une Grammaire Lexicale Fonctionnelle,10,359,9,QCM,0.62,0.29,3.0,1,40,41,13,1,12,3.15,7.69,Moyen,Difficile,-1,Plus Difficile que la Prediction,Pas Adapte
4622,2019,Information-Communication,1,Grammaire Lexicale Fonctionnelle,3,Ecrire une Grammaire Lexicale Fonctionnelle,10,359,9,QCM,0.05,0.92,83.3,37,8,45,40,37,3,1.12,92.5,Facile,Facile,0,Meme Difficulte que la Prediction,Pas Adapte
5688,2020,Information-Communication,1,Grammaire Lexicale Fonctionnelle,3,Ecrire une Grammaire Lexicale Fonctionnelle,10,359,9,QCM,0.58,0.21,28.66,12,31,43,38,12,26,1.13,31.58,Difficile,Difficile,0,Meme Difficulte que la Prediction,Pas Adapte
359,2015,Information-Communication,1,Grammaire Lexicale Fonctionnelle,3,Ecrire une Grammaire Lexicale Fonctionnelle,10,360,10,QCU,0.72,0.25,25.49,21,63,84,32,21,11,2.62,65.62,Difficile,Difficile,0,Meme Difficulte que la Prediction,Pas Adapte
1425,2016,Information-Communication,1,Grammaire Lexicale Fonctionnelle,3,Ecrire une Grammaire Lexicale Fonctionnelle,10,360,10,QCU,0.52,0.33,19.78,19,78,97,49,19,30,1.98,38.78,Difficile,Difficile,0,Meme Difficulte que la Prediction,Pas Adapte
2491,2017,Information-Communication,1,Grammaire Lexicale Fonctionnelle,3,Ecrire une Grammaire Lexicale Fonctionnelle,10,360,10,QCU,0.34,0.63,35.79,31,55,86,64,31,33,1.34,48.44,Moyen,Moyen,0,Meme Difficulte que la Prediction,Pas Adapte
3557,2018,Information-Communication,1,Grammaire Lexicale Fonctionnelle,3,Ecrire une Grammaire Lexicale Fonctionnelle,10,360,10,QCU,0.12,0.83,94.52,69,4,73,70,69,1,1.04,98.57,Moyen,Facile,1,Plus Facile que la Prediction,Pas Adapte
4623,2019,Information-Communication,1,Grammaire Lexicale Fonctionnelle,3,Ecrire une Grammaire Lexicale Fonctionnelle,10,360,10,QCU,0.21,0.68,37.92,28,47,75,50,28,22,1.5,56.0,Facile,Moyen,-1,Plus Difficile que la Prediction,Pas Adapte
5689,2020,Information-Communication,1,Grammaire Lexicale Fonctionnelle,3,Ecrire une Grammaire Lexicale Fonctionnelle,10,360,10,QCU,0.62,0.25,24.27,19,61,80,39,19,20,2.05,48.72,Difficile,Difficile,0,Meme Difficulte que la Prediction,Pas Adapte
360,2015,Information-Communication,1,Grammaire Lexicale Fonctionnelle,4,Diversite des Fonctions Grammaticales,2,361,1,QO,0.05,0.91,69.44,64,28,92,90,64,26,1.02,71.11,Difficile,Facile,2,Beaucoup plus Facile que la Prediction,Adapte
1426,2016,Information-Communication,1,Grammaire Lexicale Fonctionnelle,4,Diversite des Fonctions Grammaticales,2,361,1,QO,0.11,0.43,69.44,56,24,80,74,56,18,1.08,75.68,Facile,Facile,0,Meme Difficulte que la Prediction,Adapte
2492,2017,Information-Communication,1,Grammaire Lexicale Fonctionnelle,4,Diversite des Fonctions Grammaticales,2,361,1,QROC,0.18,0.46,69.44,56,25,81,72,56,16,1.12,77.78,Facile,Facile,0,Meme Difficulte que la Prediction,Adapte
3558,2018,Information-Communication,1,Grammaire Lexicale Fonctionnelle,4,Diversite des Fonctions Grammaticales,2,361,1,QROC,0.18,0.84,69.44,48,21,69,52,48,4,1.33,92.31,Facile,Facile,0,Meme Difficulte que la Prediction,Adapte
4624,2019,Information-Communication,1,Grammaire Lexicale Fonctionnelle,4,Diversite des Fonctions Grammaticales,2,361,1,QROC,0.07,0.65,69.44,49,22,71,50,49,1,1.42,98.0,Facile,Facile,0,Meme Difficulte que la Prediction,Adapte
5690,2020,Information-Communication,1,Grammaire Lexicale Fonctionnelle,4,Diversite des Fonctions Grammaticales,2,361,1,QROC,0.15,0.8,69.44,47,20,67,59,47,12,1.14,79.66,Facile,Facile,0,Meme Difficulte que la Prediction,Adapte
361,2015,Information-Communication,1,Grammaire Lexicale Fonctionnelle,4,Diversite des Fonctions Grammaticales,2,362,2,QCU,0.42,0.3,3.45,2,67,69,60,2,58,1.15,3.33,Difficile,Difficile,0,Meme Difficulte que la Prediction,Pas Adapte
1427,2016,Information-Communication,1,Grammaire Lexicale Fonctionnelle,4,Diversite des Fonctions Grammaticales,2,362,2,QCU,0.14,0.81,69.75,43,19,62,44,43,1,1.41,97.73,Facile,Facile,0,Meme Difficulte que la Prediction,Adapte
2493,2017,Information-Communication,1,Grammaire Lexicale Fonctionnelle,4,Diversite des Fonctions Grammaticales,2,362,2,QROC,0.07,0.78,69.75,46,20,66,48,46,2,1.38,95.83,Facile,Facile,0,Meme Difficulte que la Prediction,Adapte
3559,2018,Information-Communication,1,Grammaire Lexicale Fonctionnelle,4,Diversite des Fonctions Grammaticales,2,362,2,QROC,0.06,0.47,69.75,43,19,62,48,43,5,1.29,89.58,Facile,Facile,0,Meme Difficulte que la Prediction,Adapte
4625,2019,Information-Communication,1,Grammaire Lexicale Fonctionnelle,4,Diversite des Fonctions Grammaticales,2,362,2,QROC,0.14,0.47,69.75,41,18,59,57,41,16,1.04,71.93,Facile,Facile,0,Meme Difficulte que la Prediction,Adapte
5691,2020,Information-Communication,1,Grammaire Lexicale Fonctionnelle,4,Diversite des Fonctions Grammaticales,2,362,2,QCM,0.2,0.91,69.75,43,19,62,54,43,11,1.15,79.63,Facile,Facile,0,Meme Difficulte que la Prediction,Adapte
362,2015,Information-Communication,1,Grammaire et Syntaxe,1,Les Subordonnees,14,363,1,QCU,0.37,0.62,56.29,15,12,27,27,15,12,1.0,55.56,Moyen,Moyen,0,Meme Difficulte que la Prediction,Pas Adapte
1428,2016,Information-Communication,1,Grammaire et Syntaxe,1,Les Subordonnees,14,363,1,QCU,0.02,0.83,78.58,21,6,27,24,21,3,1.12,87.5,Difficile,Facile,2,Beaucoup plus Facile que la Prediction,Pas Adapte
2494,2017,Information-Communication,1,Grammaire et Syntaxe,1,Les Subordonnees,14,363,1,QCM,0.25,0.68,56.19,16,13,29,21,16,5,1.38,76.19,Moyen,Moyen,0,Meme Difficulte que la Prediction,Pas Adapte
3560,2018,Information-Communication,1,Grammaire et Syntaxe,1,Les Subordonnees,14,363,1,QCM,0.07,0.84,68.26,17,8,25,17,17,0,1.47,100.0,Facile,Facile,0,Meme Difficulte que la Prediction,Adapte
4626,2019,Information-Communication,1,Grammaire et Syntaxe,1,Les Subordonnees,14,363,1,QCM,0.2,0.94,68.26,18,8,26,19,18,1,1.37,94.74,Facile,Facile,0,Meme Difficulte que la Prediction,Adapte
5692,2020,Information-Communication,1,Grammaire et Syntaxe,1,Les Subordonnees,14,363,1,QROC,0.0,0.6,68.26,20,9,29,20,20,0,1.45,100.0,Facile,Facile,0,Meme Difficulte que la Prediction,Adapte
363,2015,Information-Communication,1,Grammaire et Syntaxe,1,Les Subordonnees,14,364,2,QCU,0.11,0.81,97.41,94,2,96,94,94,0,1.02,100.0,Difficile,Facile,2,Beaucoup plus Facile que la Prediction,Pas Adapte
1429,2016,Information-Communication,1,Grammaire et Syntaxe,1,Les Subordonnees,14,364,2,QCU,0.09,0.97,71.04,59,24,83,81,59,22,1.02,72.84,Facile,Facile,0,Meme Difficulte que la Prediction,Adapte
2495,2017,Information-Communication,1,Grammaire et Syntaxe,1,Les Subordonnees,14,364,2,QCU,0.13,0.8,71.04,60,24,84,83,60,23,1.01,72.29,Facile,Facile,0,Meme Difficulte que la Prediction,Adapte
3561,2018,Information-Communication,1,Grammaire et Syntaxe,1,Les Subordonnees,14,364,2,QCU,0.18,0.84,71.04,60,25,85,62,60,2,1.37,96.77,Facile,Facile,0,Meme Difficulte que la Prediction,Adapte
4627,2019,Information-Communication,1,Grammaire et Syntaxe,1,Les Subordonnees,14,364,2,QO,0.12,0.33,71.04,65,26,91,73,65,8,1.25,89.04,Facile,Facile,0,Meme Difficulte que la Prediction,Adapte
5693,2020,Information-Communication,1,Grammaire et Syntaxe,1,Les Subordonnees,14,364,2,QO,0.09,0.32,71.04,61,25,86,70,61,9,1.23,87.14,Facile,Facile,0,Meme Difficulte que la Prediction,Adapte
364,2015,Information-Communication,1,Grammaire et Syntaxe,1,Les Subordonnees,14,365,3,QO,0.84,0.01,18.57,12,50,62,43,12,31,1.44,27.91,Difficile,Difficile,0,Meme Difficulte que la Prediction,Pas Adapte
1430,2016,Information-Communication,1,Grammaire et Syntaxe,1,Les Subordonnees,14,365,3,QO,0.76,0.1,30.58,19,42,61,32,19,13,1.91,59.38,Facile,Difficile,-2,Beaucoup plus Difficile que la Prediction,Pas Adapte
2496,2017,Information-Communication,1,Grammaire et Syntaxe,1,Les Subordonnees,14,365,3,QO,0.57,0.19,58.66,31,22,53,47,31,16,1.13,65.96,Moyen,Moyen,0,Meme Difficulte que la Prediction,Pas Adapte
3562,2018,Information-Communication,1,Grammaire et Syntaxe,1,Les Subordonnees,14,365,3,QO,0.86,0.04,21.68,11,40,51,27,11,16,1.89,40.74,Difficile,Difficile,0,Meme Difficulte que la Prediction,Pas Adapte
4628,2019,Information-Communication,1,Grammaire et Syntaxe,1,Les Subordonnees,14,365,3,QO,0.13,0.68,72.36,36,14,50,39,36,3,1.28,92.31,Moyen,Facile,1,Plus Facile que la Prediction,Adapte
5694,2020,Information-Communication,1,Grammaire et Syntaxe,1,Les Subordonnees,14,365,3,QO,0.11,0.97,72.36,38,15,53,47,38,9,1.13,80.85,Facile,Facile,0,Meme Difficulte que la Prediction,Adapte
365,2015,Information-Communication,1,Grammaire et Syntaxe,1,Les Subordonnees,14,366,4,QCM,0.72,0.24,3.64,2,54,56,44,2,42,1.27,4.55,Facile,Difficile,-2,Beaucoup plus Difficile que la Prediction,Pas Adapte
1431,2016,Information-Communication,1,Grammaire et Syntaxe,1,Les Subordonnees,14,366,4,QCU,0.46,0.27,25.39,15,46,61,49,15,34,1.24,30.61,Facile,Difficile,-2,Beaucoup plus Difficile que la Prediction,Pas Adapte
2497,2017,Information-Communication,1,Grammaire et Syntaxe,1,Les Subordonnees,14,366,4,QCM,0.53,0.28,23.65,14,46,60,48,14,34,1.25,29.17,Facile,Difficile,-2,Beaucoup plus Difficile que la Prediction,Pas Adapte
3563,2018,Information-Communication,1,Grammaire et Syntaxe,1,Les Subordonnees,14,366,4,QCM,0.14,0.87,74.27,48,17,65,51,48,3,1.27,94.12,Moyen,Facile,1,Plus Facile que la Prediction,Adapte
4629,2019,Information-Communication,1,Grammaire et Syntaxe,1,Les Subordonnees,14,366,4,QCM,0.08,0.72,74.27,43,15,58,56,43,13,1.04,76.79,Facile,Facile,0,Meme Difficulte que la Prediction,Adapte
5695,2020,Information-Communication,1,Grammaire et Syntaxe,1,Les Subordonnees,14,366,4,QCM,0.06,0.76,74.27,50,17,67,66,50,16,1.02,75.76,Facile,Facile,0,Meme Difficulte que la Prediction,Adapte
366,2015,Information-Communication,1,Grammaire et Syntaxe,1,Les Subordonnees,14,367,5,QO,0.05,0.77,88.08,85,11,96,89,85,4,1.08,95.51,Facile,Facile,0,Meme Difficulte que la Prediction,Pas Adapte
1432,2016,Information-Communication,1,Grammaire et Syntaxe,1,Les Subordonnees,14,367,5,QO,0.37,0.21,53.78,50,43,93,93,50,43,1.0,53.76,Moyen,Moyen,0,Meme Difficulte que la Prediction,Pas Adapte
2498,2017,Information-Communication,1,Grammaire et Syntaxe,1,Les Subordonnees,14,367,5,QO,0.04,0.3,79.24,64,17,81,79,64,15,1.03,81.01,Facile,Facile,0,Meme Difficulte que la Prediction,Pas Adapte
3564,2018,Information-Communication,1,Grammaire et Syntaxe,1,Les Subordonnees,14,367,5,QO,0.28,0.19,35.31,31,57,88,57,31,26,1.54,54.39,Difficile,Moyen,1,Plus Facile que la Prediction,Pas Adapte
4630,2019,Information-Communication,1,Grammaire et Syntaxe,1,Les Subordonnees,14,367,5,QO,0.92,0.11,30.38,26,59,85,82,26,56,1.04,31.71,Difficile,Difficile,0,Meme Difficulte que la Prediction,Pas Adapte
5696,2020,Information-Communication,1,Grammaire et Syntaxe,1,Les Subordonnees,14,367,5,QO,0.11,0.78,80.57,59,14,73,63,59,4,1.16,93.65,Facile,Facile,0,Meme Difficulte que la Prediction,Pas Adapte
367,2015,Information-Communication,1,Grammaire et Syntaxe,1,Les Subordonnees,14,368,6,QCM,0.71,0.21,2.76,1,37,38,22,1,21,1.73,4.55,Difficile,Difficile,0,Meme Difficulte que la Prediction,Pas Adapte
1433,2016,Information-Communication,1,Grammaire et Syntaxe,1,Les Subordonnees,14,368,6,QCM,0.52,0.2,17.17,7,32,39,38,7,31,1.03,18.42,Difficile,Difficile,0,Meme Difficulte que la Prediction,Pas Adapte
2499,2017,Information-Communication,1,Grammaire et Syntaxe,1,Les Subordonnees,14,368,6,QCU,0.02,0.97,87.7,36,5,41,40,36,4,1.02,90.0,Facile,Facile,0,Meme Difficulte que la Prediction,Pas Adapte
3565,2018,Information-Communication,1,Grammaire et Syntaxe,1,Les Subordonnees,14,368,6,QCM,0.13,0.72,69.12,32,14,46,38,32,6,1.21,84.21,Facile,Facile,0,Meme Difficulte que la Prediction,Adapte
4631,2019,Information-Communication,1,Grammaire et Syntaxe,1,Les Subordonnees,14,368,6,QCM,0.05,0.78,69.12,34,15,49,38,34,4,1.29,89.47,Facile,Facile,0,Meme Difficulte que la Prediction,Adapte
5697,2020,Information-Communication,1,Grammaire et Syntaxe,1,Les Subordonnees,14,368,6,QCU,0.13,0.92,69.12,35,15,50,48,35,13,1.04,72.92,Facile,Facile,0,Meme Difficulte que la Prediction,Adapte
368,2015,Information-Communication,1,Grammaire et Syntaxe,1,Les Subordonnees,14,369,7,QCU,0.2,0.88,95.55,16,1,17,16,16,0,1.06,100.0,Moyen,Facile,1,Plus Facile que la Prediction,Pas Adapte
1434,2016,Information-Communication,1,Grammaire et Syntaxe,1,Les Subordonnees,14,369,7,QCU,0.23,0.72,35.47,6,11,17,11,6,5,1.55,54.55,Moyen,Moyen,0,Meme Difficulte que la Prediction,Pas Adapte
2500,2017,Information-Communication,1,Grammaire et Syntaxe,1,Les Subordonnees,14,369,7,QCU,0.24,0.62,42.35,7,9,16,13,7,6,1.23,53.85,Difficile,Moyen,1,Plus Facile que la Prediction,Pas Adapte
3566,2018,Information-Communication,1,Grammaire et Syntaxe,1,Les Subordonnees,14,369,7,QCU,0.19,0.8,95.76,15,1,16,16,15,1,1.0,93.75,Moyen,Facile,1,Plus Facile que la Prediction,Pas Adapte
4632,2019,Information-Communication,1,Grammaire et Syntaxe,1,Les Subordonnees,14,369,7,QCU,0.57,0.27,31.28,4,10,14,7,4,3,2.0,57.14,Difficile,Difficile,0,Meme Difficulte que la Prediction,Pas Adapte
5698,2020,Information-Communication,1,Grammaire et Syntaxe,1,Les Subordonnees,14,369,7,QCU,0.71,0.29,23.84,3,11,14,8,3,5,1.75,37.5,Difficile,Difficile,0,Meme Difficulte que la Prediction,Pas Adapte
369,2015,Information-Communication,1,Grammaire et Syntaxe,1,Les Subordonnees,14,370,8,QCM,0.75,0.21,28.14,18,45,63,59,18,41,1.07,30.51,Difficile,Difficile,0,Meme Difficulte que la Prediction,Pas Adapte
1435,2016,Information-Communication,1,Grammaire et Syntaxe,1,Les Subordonnees,14,370,8,QCU,0.33,0.66,41.49,23,33,56,44,23,21,1.27,52.27,Facile,Moyen,-1,Plus Difficile que la Prediction,Pas Adapte
2501,2017,Information-Communication,1,Grammaire et Syntaxe,1,Les Subordonnees,14,370,8,QCU,0.24,0.41,57.91,28,21,49,29,28,1,1.69,96.55,Moyen,Moyen,0,Meme Difficulte que la Prediction,Pas Adapte
3567,2018,Information-Communication,1,Grammaire et Syntaxe,1,Les Subordonnees,14,370,8,QCU,0.15,0.96,80.9,42,10,52,50,42,8,1.04,84.0,Difficile,Facile,2,Beaucoup plus Facile que la Prediction,Pas Adapte
4633,2019,Information-Communication,1,Grammaire et Syntaxe,1,Les Subordonnees,14,370,8,QCU,0.55,0.21,28.54,17,43,60,21,17,4,2.86,80.95,Difficile,Difficile,0,Meme Difficulte que la Prediction,Pas Adapte
5699,2020,Information-Communication,1,Grammaire et Syntaxe,1,Les Subordonnees,14,370,8,QCU,0.1,0.86,72.89,42,16,58,57,42,15,1.02,73.68,Facile,Facile,0,Meme Difficulte que la Prediction,Adapte
370,2015,Information-Communication,1,Grammaire et Syntaxe,1,Les Subordonnees,14,371,9,QCM,0.57,0.27,18.02,8,36,44,38,8,30,1.16,21.05,Moyen,Difficile,-1,Plus Difficile que la Prediction,Pas Adapte
1436,2016,Information-Communication,1,Grammaire et Syntaxe,1,Les Subordonnees,14,371,9,QCM,0.21,0.52,47.43,24,26,50,37,24,13,1.35,64.86,Facile,Moyen,-1,Plus Difficile que la Prediction,Pas Adapte
2502,2017,Information-Communication,1,Grammaire et Syntaxe,1,Les Subordonnees,14,371,9,QCM,0.52,0.19,29.67,14,32,46,33,14,19,1.39,42.42,Difficile,Difficile,0,Meme Difficulte que la Prediction,Pas Adapte
3568,2018,Information-Communication,1,Grammaire et Syntaxe,1,Les Subordonnees,14,371,9,QCM,0.72,0.2,28.58,12,30,42,21,12,9,2.0,57.14,Facile,Difficile,-2,Beaucoup plus Difficile que la Prediction,Pas Adapte
4634,2019,Information-Communication,1,Grammaire et Syntaxe,1,Les Subordonnees,14,371,9,QCM,0.2,0.46,46.29,18,21,39,26,18,8,1.5,69.23,Difficile,Moyen,1,Plus Facile que la Prediction,Pas Adapte
5700,2020,Information-Communication,1,Grammaire et Syntaxe,1,Les Subordonnees,14,371,9,QCM,0.79,0.22,1.12,0,37,37,15,0,15,2.47,0.0,Difficile,Difficile,0,Meme Difficulte que la Prediction,Pas Adapte
371,2015,Information-Communication,1,Grammaire et Syntaxe,1,Les Subordonnees,14,372,10,QROC,0.85,0.04,30.87,18,39,57,56,18,38,1.02,32.14,Difficile,Difficile,0,Meme Difficulte que la Prediction,Pas Adapte
1437,2016,Information-Communication,1,Grammaire et Syntaxe,1,Les Subordonnees,14,372,10,QROC,0.18,0.4,69.11,44,19,63,61,44,17,1.03,72.13,Facile,Facile,0,Meme Difficulte que la Prediction,Adapte
2503,2017,Information-Communication,1,Grammaire et Syntaxe,1,Les Subordonnees,14,372,10,QROC,0.2,0.85,69.11,40,18,58,41,40,1,1.41,97.56,Facile,Facile,0,Meme Difficulte que la Prediction,Adapte
3569,2018,Information-Communication,1,Grammaire et Syntaxe,1,Les Subordonnees,14,372,10,QROC,0.16,0.67,69.11,36,16,52,51,36,15,1.02,70.59,Facile,Facile,0,Meme Difficulte que la Prediction,Adapte
4635,2019,Information-Communication,1,Grammaire et Syntaxe,1,Les Subordonnees,14,372,10,QROC,0.08,0.86,69.11,39,17,56,55,39,16,1.02,70.91,Facile,Facile,0,Meme Difficulte que la Prediction,Adapte
5701,2020,Information-Communication,1,Grammaire et Syntaxe,1,Les Subordonnees,14,372,10,QROC,0.19,0.46,69.11,43,19,62,62,43,19,1.0,69.35,Facile,Facile,0,Meme Difficulte que la Prediction,Adapte
372,2015,Information-Communication,1,Grammaire et Syntaxe,1,Les Subordonnees,14,373,11,QCM,0.06,0.77,81.81,28,6,34,32,28,4,1.06,87.5,Moyen,Facile,1,Plus Facile que la Prediction,Pas Adapte
1438,2016,Information-Communication,1,Grammaire et Syntaxe,1,Les Subordonnees,14,373,11,QCM,0.15,0.86,95.31,37,2,39,37,37,0,1.05,100.0,Difficile,Facile,2,Beaucoup plus Facile que la Prediction,Pas Adapte
2504,2017,Information-Communication,1,Grammaire et Syntaxe,1,Les Subordonnees,14,373,11,QCM,0.13,0.76,74.12,27,9,36,34,27,7,1.06,79.41,Facile,Facile,0,Meme Difficulte que la Prediction,Adapte
3570,2018,Information-Communication,1,Grammaire et Syntaxe,1,Les Subordonnees,14,373,11,QCM,0.09,0.87,74.12,30,11,41,35,30,5,1.17,85.71,Facile,Facile,0,Meme Difficulte que la Prediction,Adapte
4636,2019,Information-Communication,1,Grammaire et Syntaxe,1,Les Subordonnees,14,373,11,QCM,0.13,0.99,74.12,27,10,37,33,27,6,1.12,81.82,Facile,Facile,0,Meme Difficulte que la Prediction,Adapte
5702,2020,Information-Communication,1,Grammaire et Syntaxe,1,Les Subordonnees,14,373,11,QCM,0.04,0.74,74.12,30,11,41,35,30,5,1.17,85.71,Facile,Facile,0,Meme Difficulte que la Prediction,Adapte
373,2015,Information-Communication,1,Grammaire et Syntaxe,1,Les Subordonnees,14,374,12,QCU,0.75,0.29,2.19,0,6,6,4,0,4,1.5,0.0,Difficile,Difficile,0,Meme Difficulte que la Prediction,Pas Adapte
1439,2016,Information-Communication,1,Grammaire et Syntaxe,1,Les Subordonnees,14,374,12,QCU,0.59,0.38,25.46,2,4,6,4,2,2,1.5,50.0,Difficile,Difficile,0,Meme Difficulte que la Prediction,Pas Adapte
2505,2017,Information-Communication,1,Grammaire et Syntaxe,1,Les Subordonnees,14,374,12,QROC,0.07,0.88,76.68,4,1,5,5,4,1,1.0,80.0,Moyen,Facile,1,Plus Facile que la Prediction,Pas Adapte
3571,2018,Information-Communication,1,Grammaire et Syntaxe,1,Les Subordonnees,14,374,12,QROC,0.05,0.87,82.0,3,1,4,3,3,0,1.33,100.0,Facile,Facile,0,Meme Difficulte que la Prediction,Pas Adapte
4637,2019,Information-Communication,1,Grammaire et Syntaxe,1,Les Subordonnees,14,374,12,QROC,0.77,0.09,7.43,0,4,4,4,0,4,1.0,0.0,Difficile,Difficile,0,Meme Difficulte que la Prediction,Pas Adapte
5703,2020,Information-Communication,1,Grammaire et Syntaxe,1,Les Subordonnees,14,374,12,QROC,0.95,0.16,9.72,0,5,5,2,0,2,2.5,0.0,Facile,Difficile,-2,Beaucoup plus Difficile que la Prediction,Pas Adapte
374,2015,Information-Communication,1,Grammaire et Syntaxe,1,Les Subordonnees,14,375,13,QROC,0.01,0.65,83.95,57,11,68,66,57,9,1.03,86.36,Facile,Facile,0,Meme Difficulte que la Prediction,Pas Adapte
1440,2016,Information-Communication,1,Grammaire et Syntaxe,1,Les Subordonnees,14,375,13,QROC,0.22,0.28,55.17,38,31,69,66,38,28,1.05,57.58,Moyen,Moyen,0,Meme Difficulte que la Prediction,Pas Adapte
2506,2017,Information-Communication,1,Grammaire et Syntaxe,1,Les Subordonnees,14,375,13,QROC,0.03,0.51,84.45,53,10,63,57,53,4,1.11,92.98,Moyen,Facile,1,Plus Facile que la Prediction,Pas Adapte
3572,2018,Information-Communication,1,Grammaire et Syntaxe,1,Les Subordonnees,14,375,13,QO,0.83,0.01,1.66,1,55,56,41,1,40,1.37,2.44,Difficile,Difficile,0,Meme Difficulte que la Prediction,Pas Adapte
4638,2019,Information-Communication,1,Grammaire et Syntaxe,1,Les Subordonnees,14,375,13,QO,0.75,0.16,45.84,22,26,48,31,22,9,1.55,70.97,Moyen,Moyen,0,Meme Difficulte que la Prediction,Pas Adapte
5704,2020,Information-Communication,1,Grammaire et Syntaxe,1,Les Subordonnees,14,375,13,QO,0.03,0.98,91.49,43,4,47,47,43,4,1.0,91.49,Moyen,Facile,1,Plus Facile que la Prediction,Pas Adapte
375,2015,Information-Communication,1,Grammaire et Syntaxe,1,Les Subordonnees,14,376,14,QO,0.95,0.12,1.65,2,98,100,78,2,76,1.28,2.56,Difficile,Difficile,0,Meme Difficulte que la Prediction,Pas Adapte
1441,2016,Information-Communication,1,Grammaire et Syntaxe,1,Les Subordonnees,14,376,14,QO,0.03,0.3,89.73,88,10,98,93,88,5,1.05,94.62,Facile,Facile,0,Meme Difficulte que la Prediction,Pas Adapte
2507,2017,Information-Communication,1,Grammaire et Syntaxe,1,Les Subordonnees,14,376,14,QO,0.85,0.01,8.37,8,85,93,57,8,49,1.63,14.04,Moyen,Difficile,-1,Plus Difficile que la Prediction,Pas Adapte
3573,2018,Information-Communication,1,Grammaire et Syntaxe,1,Les Subordonnees,14,376,14,QO,0.69,0.19,38.31,39,64,103,58,39,19,1.78,67.24,Moyen,Moyen,0,Meme Difficulte que la Prediction,Pas Adapte
4639,2019,Information-Communication,1,Grammaire et Syntaxe,1,Les Subordonnees,14,376,14,QO,0.08,0.35,76.3,87,27,114,91,87,4,1.25,95.6,Facile,Facile,0,Meme Difficulte que la Prediction,Pas Adapte
5705,2020,Information-Communication,1,Grammaire et Syntaxe,1,Les Subordonnees,14,376,14,QO,0.0,0.91,81.11,79,19,98,81,79,2,1.21,97.53,Facile,Facile,0,Meme Difficulte que la Prediction,Pas Adapte
376,2015,Information-Communication,1,Grammaire et Syntaxe,2,La Coordination,6,377,1,QCU,0.18,0.94,81.09,43,10,53,49,43,6,1.08,87.76,Moyen,Facile,1,Plus Facile que la Prediction,Pas Adapte
1442,2016,Information-Communication,1,Grammaire et Syntaxe,2,La Coordination,6,377,1,QCU,0.06,0.86,82.52,43,9,52,44,43,1,1.18,97.73,Facile,Facile,0,Meme Difficulte que la Prediction,Pas Adapte
2508,2017,Information-Communication,1,Grammaire et Syntaxe,2,La Coordination,6,377,1,QCM,0.19,0.96,80.93,47,11,58,53,47,6,1.09,88.68,Facile,Facile,0,Meme Difficulte que la Prediction,Pas Adapte
3574,2018,Information-Communication,1,Grammaire et Syntaxe,2,La Coordination,6,377,1,QCM,0.42,0.54,58.63,29,21,50,32,29,3,1.56,90.62,Moyen,Moyen,0,Meme Difficulte que la Prediction,Pas Adapte
4640,2019,Information-Communication,1,Grammaire et Syntaxe,2,La Coordination,6,377,1,QCM,0.2,0.95,77.84,44,13,57,48,44,4,1.19,91.67,Facile,Facile,0,Meme Difficulte que la Prediction,Pas Adapte
5706,2020,Information-Communication,1,Grammaire et Syntaxe,2,La Coordination,6,377,1,QCM,0.1,0.76,83.21,40,8,48,46,40,6,1.04,86.96,Facile,Facile,0,Meme Difficulte que la Prediction,Pas Adapte
377,2015,Information-Communication,1,Grammaire et Syntaxe,2,La Coordination,6,378,2,QCU,0.05,0.85,74.4,49,17,66,60,49,11,1.1,81.67,Moyen,Facile,1,Plus Facile que la Prediction,Adapte
1443,2016,Information-Communication,1,Grammaire et Syntaxe,2,La Coordination,6,378,2,QCU,0.13,0.92,74.4,57,19,76,63,57,6,1.21,90.48,Facile,Facile,0,Meme Difficulte que la Prediction,Adapte
2509,2017,Information-Communication,1,Grammaire et Syntaxe,2,La Coordination,6,378,2,QCU,0.07,0.82,74.4,55,19,74,74,55,19,1.0,74.32,Facile,Facile,0,Meme Difficulte que la Prediction,Adapte
3575,2018,Information-Communication,1,Grammaire et Syntaxe,2,La Coordination,6,378,2,QCU,0.08,0.94,74.4,53,18,71,58,53,5,1.22,91.38,Facile,Facile,0,Meme Difficulte que la Prediction,Adapte
4641,2019,Information-Communication,1,Grammaire et Syntaxe,2,La Coordination,6,378,2,QCU,0.14,0.76,74.4,60,20,80,63,60,3,1.27,95.24,Facile,Facile,0,Meme Difficulte que la Prediction,Adapte
5707,2020,Information-Communication,1,Grammaire et Syntaxe,2,La Coordination,6,378,2,QCU,0.05,0.83,74.4,64,22,86,71,64,7,1.21,90.14,Facile,Facile,0,Meme Difficulte que la Prediction,Adapte
378,2015,Information-Communication,1,Grammaire et Syntaxe,2,La Coordination,6,379,3,QCU,0.1,0.98,76.28,31,10,41,35,31,4,1.17,88.57,Facile,Facile,0,Meme Difficulte que la Prediction,Pas Adapte
1444,2016,Information-Communication,1,Grammaire et Syntaxe,2,La Coordination,6,379,3,QCU,0.48,0.36,23.95,8,27,35,17,8,9,2.06,47.06,Difficile,Difficile,0,Meme Difficulte que la Prediction,Pas Adapte
2510,2017,Information-Communication,1,Grammaire et Syntaxe,2,La Coordination,6,379,3,QCM,0.57,0.23,24.68,8,25,33,16,8,8,2.06,50.0,Difficile,Difficile,0,Meme Difficulte que la Prediction,Pas Adapte
3576,2018,Information-Communication,1,Grammaire et Syntaxe,2,La Coordination,6,379,3,QCM,0.58,0.25,16.58,5,24,29,19,5,14,1.53,26.32,Moyen,Difficile,-1,Plus Difficile que la Prediction,Pas Adapte
4642,2019,Information-Communication,1,Grammaire et Syntaxe,2,La Coordination,6,379,3,QCM,0.17,0.74,77.88,22,6,28,27,22,5,1.04,81.48,Facile,Facile,0,Meme Difficulte que la Prediction,Pas Adapte
5708,2020,Information-Communication,1,Grammaire et Syntaxe,2,La Coordination,6,379,3,QCM,0.65,0.27,27.42,8,20,28,15,8,7,1.87,53.33,Difficile,Difficile,0,Meme Difficulte que la Prediction,Pas Adapte
379,2015,Information-Communication,1,Grammaire et Syntaxe,2,La Coordination,6,380,4,QCU,0.74,0.27,0.71,0,15,15,12,0,12,1.25,0.0,Difficile,Difficile,0,Meme Difficulte que la Prediction,Pas Adapte
1445,2016,Information-Communication,1,Grammaire et Syntaxe,2,La Coordination,6,380,4,QCM,0.29,0.43,53.22,7,7,14,13,7,6,1.08,53.85,Moyen,Moyen,0,Meme Difficulte que la Prediction,Pas Adapte
2511,2017,Information-Communication,1,Grammaire et Syntaxe,2,La Coordination,6,380,4,QCM,0.15,0.77,80.22,13,3,16,14,13,1,1.14,92.86,Difficile,Facile,2,Beaucoup plus Facile que la Prediction,Pas Adapte
3577,2018,Information-Communication,1,Grammaire et Syntaxe,2,La Coordination,6,380,4,QCM,0.53,0.2,6.2,1,16,17,5,1,4,3.4,20.0,Difficile,Difficile,0,Meme Difficulte que la Prediction,Pas Adapte
4643,2019,Information-Communication,1,Grammaire et Syntaxe,2,La Coordination,6,380,4,QCM,0.09,0.88,89.05,16,2,18,16,16,0,1.12,100.0,Difficile,Facile,2,Beaucoup plus Facile que la Prediction,Pas Adapte
5709,2020,Information-Communication,1,Grammaire et Syntaxe,2,La Coordination,6,380,4,QCM,0.03,0.97,84.07,13,3,16,15,13,2,1.07,86.67,Facile,Facile,0,Meme Difficulte que la Prediction,Pas Adapte
380,2015,Information-Communication,1,Grammaire et Syntaxe,2,La Coordination,6,381,5,QCU,0.03,0.84,89.5,64,7,71,69,64,5,1.03,92.75,Facile,Facile,0,Meme Difficulte que la Prediction,Pas Adapte
1446,2016,Information-Communication,1,Grammaire et Syntaxe,2,La Coordination,6,381,5,QCU,0.49,0.21,18.65,12,52,64,44,12,32,1.45,27.27,Difficile,Difficile,0,Meme Difficulte que la Prediction,Pas Adapte
2512,2017,Information-Communication,1,Grammaire et Syntaxe,2,La Coordination,6,381,5,QCU,0.25,0.61,35.19,21,39,60,30,21,9,2.0,70.0,Moyen,Moyen,0,Meme Difficulte que la Prediction,Pas Adapte
3578,2018,Information-Communication,1,Grammaire et Syntaxe,2,La Coordination,6,381,5,QCU,0.21,0.68,47.39,24,27,51,35,24,11,1.46,68.57,Moyen,Moyen,0,Meme Difficulte que la Prediction,Pas Adapte
4644,2019,Information-Communication,1,Grammaire et Syntaxe,2,La Coordination,6,381,5,QCU,0.07,0.78,80.54,36,9,45,40,36,4,1.12,90.0,Facile,Facile,0,Meme Difficulte que la Prediction,Pas Adapte
5710,2020,Information-Communication,1,Grammaire et Syntaxe,2,La Coordination,6,381,5,QCU,0.11,0.91,84.05,40,7,47,43,40,3,1.09,93.02,Moyen,Facile,1,Plus Facile que la Prediction,Pas Adapte
381,2015,Information-Communication,1,Grammaire et Syntaxe,2,La Coordination,6,382,6,QCM,0.04,0.98,68.89,42,19,61,54,42,12,1.13,77.78,Facile,Facile,0,Meme Difficulte que la Prediction,Adapte
1447,2016,Information-Communication,1,Grammaire et Syntaxe,2,La Coordination,6,382,6,QCM,0.08,0.73,68.89,46,21,67,54,46,8,1.24,85.19,Facile,Facile,0,Meme Difficulte que la Prediction,Adapte
2513,2017,Information-Communication,1,Grammaire et Syntaxe,2,La Coordination,6,382,6,QCM,0.13,0.86,68.89,51,23,74,65,51,14,1.14,78.46,Facile,Facile,0,Meme Difficulte que la Prediction,Adapte
3579,2018,Information-Communication,1,Grammaire et Syntaxe,2,La Coordination,6,382,6,QO,0.01,0.57,68.89,53,24,77,71,53,18,1.08,74.65,Facile,Facile,0,Meme Difficulte que la Prediction,Adapte
4645,2019,Information-Communication,1,Grammaire et Syntaxe,2,La Coordination,6,382,6,QO,0.09,0.55,68.89,58,26,84,76,58,18,1.11,76.32,Facile,Facile,0,Meme Difficulte que la Prediction,Adapte
5711,2020,Information-Communication,1,Grammaire et Syntaxe,2,La Coordination,6,382,6,QO,0.17,0.36,68.89,57,26,83,64,57,7,1.3,89.06,Facile,Facile,0,Meme Difficulte que la Prediction,Adapte
382,2015,Information-Communication,1,Grammaire et Syntaxe,3,Le Statut des Pronoms,9,383,1,QCM,0.14,0.89,97.17,55,2,57,55,55,0,1.04,100.0,Difficile,Facile,2,Beaucoup plus Facile que la Prediction,Pas Adapte
1448,2016,Information-Communication,1,Grammaire et Syntaxe,3,Le Statut des Pronoms,9,383,1,QROC,0.43,0.31,59.62,36,24,60,54,36,18,1.11,66.67,Moyen,Moyen,0,Meme Difficulte que la Prediction,Pas Adapte
2514,2017,Information-Communication,1,Grammaire et Syntaxe,3,Le Statut des Pronoms,9,383,1,QO,0.04,0.34,88.04,50,7,57,57,50,7,1.0,87.72,Facile,Facile,0,Meme Difficulte que la Prediction,Pas Adapte
3580,2018,Information-Communication,1,Grammaire et Syntaxe,3,Le Statut des Pronoms,9,383,1,QO,0.45,0.27,42.7,26,35,61,56,26,30,1.09,46.43,Facile,Moyen,-1,Plus Difficile que la Prediction,Pas Adapte
4646,2019,Information-Communication,1,Grammaire et Syntaxe,3,Le Statut des Pronoms,9,383,1,QO,0.26,0.23,45.11,30,37,67,49,30,19,1.37,61.22,Moyen,Moyen,0,Meme Difficulte que la Prediction,Pas Adapte
5712,2020,Information-Communication,1,Grammaire et Syntaxe,3,Le Statut des Pronoms,9,383,1,QO,0.43,0.26,45.64,28,34,62,61,28,33,1.02,45.9,Moyen,Moyen,0,Meme Difficulte que la Prediction,Pas Adapte
383,2015,Information-Communication,1,Grammaire et Syntaxe,3,Le Statut des Pronoms,9,384,2,QCU,0.13,0.99,69.21,12,5,17,15,12,3,1.13,80.0,Facile,Facile,0,Meme Difficulte que la Prediction,Adapte
1449,2016,Information-Communication,1,Grammaire et Syntaxe,3,Le Statut des Pronoms,9,384,2,QCU,0.19,0.86,69.21,10,5,15,11,10,1,1.36,90.91,Facile,Facile,0,Meme Difficulte que la Prediction,Adapte
2515,2017,Information-Communication,1,Grammaire et Syntaxe,3,Le Statut des Pronoms,9,384,2,QCU,0.01,0.99,69.21,10,5,15,14,10,4,1.07,71.43,Facile,Facile,0,Meme Difficulte que la Prediction,Adapte
3581,2018,Information-Communication,1,Grammaire et Syntaxe,3,Le Statut des Pronoms,9,384,2,QCU,0.07,0.88,69.21,12,5,17,14,12,2,1.21,85.71,Facile,Facile,0,Meme Difficulte que la Prediction,Adapte
4647,2019,Information-Communication,1,Grammaire et Syntaxe,3,Le Statut des Pronoms,9,384,2,QCU,0.17,0.78,69.21,10,4,14,11,10,1,1.27,90.91,Facile,Facile,0,Meme Difficulte que la Prediction,Adapte
5713,2020,Information-Communication,1,Grammaire et Syntaxe,3,Le Statut des Pronoms,9,384,2,QCM,0.13,0.93,69.21,10,5,15,14,10,4,1.07,71.43,Facile,Facile,0,Meme Difficulte que la Prediction,Adapte
384,2015,Information-Communication,1,Grammaire et Syntaxe,3,Le Statut des Pronoms,9,385,3,QCU,0.11,0.99,87.32,57,8,65,60,57,3,1.08,95.0,Difficile,Facile,2,Beaucoup plus Facile que la Prediction,Pas Adapte
1450,2016,Information-Communication,1,Grammaire et Syntaxe,3,Le Statut des Pronoms,9,385,3,QCU,0.36,0.7,47.11,26,30,56,32,26,6,1.75,81.25,Difficile,Moyen,1,Plus Facile que la Prediction,Pas Adapte
2516,2017,Information-Communication,1,Grammaire et Syntaxe,3,Le Statut des Pronoms,9,385,3,QCU,0.02,0.98,75.92,49,15,64,58,49,9,1.1,84.48,Difficile,Facile,2,Beaucoup plus Facile que la Prediction,Pas Adapte
3582,2018,Information-Communication,1,Grammaire et Syntaxe,3,Le Statut des Pronoms,9,385,3,QCU,0.12,0.96,92.53,56,4,60,59,56,3,1.02,94.92,Facile,Facile,0,Meme Difficulte que la Prediction,Pas Adapte
4648,2019,Information-Communication,1,Grammaire et Syntaxe,3,Le Statut des Pronoms,9,385,3,QCU,0.35,0.65,37.62,21,35,56,24,21,3,2.33,87.5,Moyen,Moyen,0,Meme Difficulte que la Prediction,Pas Adapte
5714,2020,Information-Communication,1,Grammaire et Syntaxe,3,Le Statut des Pronoms,9,385,3,QCU,0.71,0.38,0.28,0,50,50,38,0,38,1.32,0.0,Difficile,Difficile,0,Meme Difficulte que la Prediction,Pas Adapte
385,2015,Information-Communication,1,Grammaire et Syntaxe,3,Le Statut des Pronoms,9,386,4,QCU,0.61,0.24,32.81,19,39,58,23,19,4,2.52,82.61,Difficile,Difficile,0,Meme Difficulte que la Prediction,Pas Adapte
1451,2016,Information-Communication,1,Grammaire et Syntaxe,3,Le Statut des Pronoms,9,386,4,QCU,0.56,0.33,31.78,16,35,51,29,16,13,1.76,55.17,Difficile,Difficile,0,Meme Difficulte que la Prediction,Pas Adapte
2517,2017,Information-Communication,1,Grammaire et Syntaxe,3,Le Statut des Pronoms,9,386,4,QCU,0.01,0.89,68.16,34,16,50,42,34,8,1.19,80.95,Facile,Facile,0,Meme Difficulte que la Prediction,Adapte
3583,2018,Information-Communication,1,Grammaire et Syntaxe,3,Le Statut des Pronoms,9,386,4,QCU,0.17,0.92,68.16,32,15,47,40,32,8,1.18,80.0,Facile,Facile,0,Meme Difficulte que la Prediction,Adapte
4649,2019,Information-Communication,1,Grammaire et Syntaxe,3,Le Statut des Pronoms,9,386,4,QCU,0.07,0.9,68.16,32,15,47,40,32,8,1.18,80.0,Facile,Facile,0,Meme Difficulte que la Prediction,Adapte
5715,2020,Information-Communication,1,Grammaire et Syntaxe,3,Le Statut des Pronoms,9,386,4,QCU,0.18,0.78,68.16,28,13,41,33,28,5,1.24,84.85,Facile,Facile,0,Meme Difficulte que la Prediction,Adapte
386,2015,Information-Communication,1,Grammaire et Syntaxe,3,Le Statut des Pronoms,9,387,5,QCU,0.08,0.77,84.09,50,9,59,58,50,8,1.02,86.21,Facile,Facile,0,Meme Difficulte que la Prediction,Pas Adapte
1452,2016,Information-Communication,1,Grammaire et Syntaxe,3,Le Statut des Pronoms,9,387,5,QCU,0.08,0.81,84.91,51,9,60,59,51,8,1.02,86.44,Difficile,Facile,2,Beaucoup plus Facile que la Prediction,Pas Adapte
2518,2017,Information-Communication,1,Grammaire et Syntaxe,3,Le Statut des Pronoms,9,387,5,QCU,0.2,0.97,89.78,55,6,61,60,55,5,1.02,91.67,Facile,Facile,0,Meme Difficulte que la Prediction,Pas Adapte
3584,2018,Information-Communication,1,Grammaire et Syntaxe,3,Le Statut des Pronoms,9,387,5,QCU,0.22,0.46,38.57,22,36,58,28,22,6,2.07,78.57,Moyen,Moyen,0,Meme Difficulte que la Prediction,Pas Adapte
4650,2019,Information-Communication,1,Grammaire et Syntaxe,3,Le Statut des Pronoms,9,387,5,QCU,0.74,0.39,29.48,16,38,54,18,16,2,3.0,88.89,Difficile,Difficile,0,Meme Difficulte que la Prediction,Pas Adapte
5716,2020,Information-Communication,1,Grammaire et Syntaxe,3,Le Statut des Pronoms,9,387,5,QCU,0.08,0.83,67.85,40,19,59,52,40,12,1.13,76.92,Facile,Facile,0,Meme Difficulte que la Prediction,Adapte
387,2015,Information-Communication,1,Grammaire et Syntaxe,3,Le Statut des Pronoms,9,388,6,QROC,0.66,0.1,17.32,16,77,93,91,16,75,1.02,17.58,Difficile,Difficile,0,Meme Difficulte que la Prediction,Pas Adapte
1453,2016,Information-Communication,1,Grammaire et Syntaxe,3,Le Statut des Pronoms,9,388,6,QROC,0.04,0.74,96.34,99,4,103,100,99,1,1.03,99.0,Facile,Facile,0,Meme Difficulte que la Prediction,Pas Adapte
2519,2017,Information-Communication,1,Grammaire et Syntaxe,3,Le Statut des Pronoms,9,388,6,QROC,0.06,0.43,69.3,71,32,103,91,71,20,1.13,78.02,Facile,Facile,0,Meme Difficulte que la Prediction,Adapte
3585,2018,Information-Communication,1,Grammaire et Syntaxe,3,Le Statut des Pronoms,9,388,6,QO,0.14,0.87,69.3,62,27,89,84,62,22,1.06,73.81,Facile,Facile,0,Meme Difficulte que la Prediction,Adapte
4651,2019,Information-Communication,1,Grammaire et Syntaxe,3,Le Statut des Pronoms,9,388,6,QO,0.13,0.76,69.3,56,25,81,73,56,17,1.11,76.71,Facile,Facile,0,Meme Difficulte que la Prediction,Adapte
5717,2020,Information-Communication,1,Grammaire et Syntaxe,3,Le Statut des Pronoms,9,388,6,QO,0.15,0.52,69.3,60,27,87,73,60,13,1.19,82.19,Facile,Facile,0,Meme Difficulte que la Prediction,Adapte
388,2015,Information-Communication,1,Grammaire et Syntaxe,3,Le Statut des Pronoms,9,389,7,QROC,0.36,0.31,46.22,5,5,10,5,5,0,2.0,100.0,Facile,Moyen,-1,Plus Difficile que la Prediction,Pas Adapte
1454,2016,Information-Communication,1,Grammaire et Syntaxe,3,Le Statut des Pronoms,9,389,7,QROC,0.7,0.05,7.95,1,8,9,7,1,6,1.29,14.29,Difficile,Difficile,0,Meme Difficulte que la Prediction,Pas Adapte
2520,2017,Information-Communication,1,Grammaire et Syntaxe,3,Le Statut des Pronoms,9,389,7,QROC,0.93,0.09,2.82,0,10,10,5,0,5,2.0,0.0,Moyen,Difficile,-1,Plus Difficile que la Prediction,Pas Adapte
3586,2018,Information-Communication,1,Grammaire et Syntaxe,3,Le Statut des Pronoms,9,389,7,QROC,0.74,0.17,9.52,1,8,9,4,1,3,2.25,25.0,Difficile,Difficile,0,Meme Difficulte que la Prediction,Pas Adapte
4652,2019,Information-Communication,1,Grammaire et Syntaxe,3,Le Statut des Pronoms,9,389,7,QROC,0.6,0.4,50.86,5,5,10,5,5,0,2.0,100.0,Moyen,Moyen,0,Meme Difficulte que la Prediction,Pas Adapte
5718,2020,Information-Communication,1,Grammaire et Syntaxe,3,Le Statut des Pronoms,9,389,7,QROC,0.07,0.62,75.84,9,3,12,9,9,0,1.33,100.0,Moyen,Facile,1,Plus Facile que la Prediction,Pas Adapte
389,2015,Information-Communication,1,Grammaire et Syntaxe,3,Le Statut des Pronoms,9,390,8,QCM,0.03,0.73,73.79,24,8,32,32,24,8,1.0,75.0,Moyen,Facile,1,Plus Facile que la Prediction,Adapte
1455,2016,Information-Communication,1,Grammaire et Syntaxe,3,Le Statut des Pronoms,9,390,8,QCM,0.18,0.76,73.79,25,9,34,28,25,3,1.21,89.29,Facile,Facile,0,Meme Difficulte que la Prediction,Adapte
2521,2017,Information-Communication,1,Grammaire et Syntaxe,3,Le Statut des Pronoms,9,390,8,QCM,0.11,0.77,73.79,22,8,30,30,22,8,1.0,73.33,Facile,Facile,0,Meme Difficulte que la Prediction,Adapte
3587,2018,Information-Communication,1,Grammaire et Syntaxe,3,Le Statut des Pronoms,9,390,8,QCM,0.2,0.88,73.79,19,7,26,19,19,0,1.37,100.0,Facile,Facile,0,Meme Difficulte que la Prediction,Adapte
4653,2019,Information-Communication,1,Grammaire et Syntaxe,3,Le Statut des Pronoms,9,390,8,QCM,0.06,0.96,73.79,17,6,23,20,17,3,1.15,85.0,Facile,Facile,0,Meme Difficulte que la Prediction,Adapte
5719,2020,Information-Communication,1,Grammaire et Syntaxe,3,Le Statut des Pronoms,9,390,8,QCM,0.01,0.75,73.79,19,7,26,24,19,5,1.08,79.17,Facile,Facile,0,Meme Difficulte que la Prediction,Adapte
390,2015,Information-Communication,1,Grammaire et Syntaxe,3,Le Statut des Pronoms,9,391,9,QCU,0.25,0.49,50.24,22,21,43,24,22,2,1.79,91.67,Facile,Moyen,-1,Plus Difficile que la Prediction,Pas Adapte
1456,2016,Information-Communication,1,Grammaire et Syntaxe,3,Le Statut des Pronoms,9,391,9,QCU,0.08,0.94,96.6,36,1,37,36,36,0,1.03,100.0,Facile,Facile,0,Meme Difficulte que la Prediction,Pas Adapte
2522,2017,Information-Communication,1,Grammaire et Syntaxe,3,Le Statut des Pronoms,9,391,9,QCU,0.06,0.94,93.46,31,2,33,32,31,1,1.03,96.88,Difficile,Facile,2,Beaucoup plus Facile que la Prediction,Pas Adapte
3588,2018,Information-Communication,1,Grammaire et Syntaxe,3,Le Statut des Pronoms,9,391,9,QCU,0.14,0.82,95.95,36,2,38,36,36,0,1.06,100.0,Facile,Facile,0,Meme Difficulte que la Prediction,Pas Adapte
4654,2019,Information-Communication,1,Grammaire et Syntaxe,3,Le Statut des Pronoms,9,391,9,QCU,0.43,0.32,0.48,0,43,43,41,0,41,1.05,0.0,Moyen,Difficile,-1,Plus Difficile que la Prediction,Pas Adapte
5720,2020,Information-Communication,1,Grammaire et Syntaxe,3,Le Statut des Pronoms,9,391,9,QCU,0.29,0.72,44.68,19,23,42,23,19,4,1.83,82.61,Moyen,Moyen,0,Meme Difficulte que la Prediction,Pas Adapte
391,2015,Information-Communication,1,Neologie,1,Les Innovations Lexicales,8,392,1,QROC,0.98,0.06,12.52,9,65,74,56,9,47,1.32,16.07,Difficile,Difficile,0,Meme Difficulte que la Prediction,Pas Adapte
1457,2016,Information-Communication,1,Neologie,1,Les Innovations Lexicales,8,392,1,QROC,0.15,0.53,94.91,70,4,74,73,70,3,1.01,95.89,Facile,Facile,0,Meme Difficulte que la Prediction,Pas Adapte
2523,2017,Information-Communication,1,Neologie,1,Les Innovations Lexicales,8,392,1,QROC,0.65,0.22,8.2,6,68,74,36,6,30,2.06,16.67,Facile,Difficile,-2,Beaucoup plus Difficile que la Prediction,Pas Adapte
3589,2018,Information-Communication,1,Neologie,1,Les Innovations Lexicales,8,392,1,QROC,0.06,0.82,90.88,61,6,67,65,61,4,1.03,93.85,Facile,Facile,0,Meme Difficulte que la Prediction,Pas Adapte
4655,2019,Information-Communication,1,Neologie,1,Les Innovations Lexicales,8,392,1,QROC,0.26,0.38,57.82,44,32,76,65,44,21,1.17,67.69,Moyen,Moyen,0,Meme Difficulte que la Prediction,Pas Adapte
5721,2020,Information-Communication,1,Neologie,1,Les Innovations Lexicales,8,392,1,QROC,0.06,0.49,74.62,55,19,74,73,55,18,1.01,75.34,Facile,Facile,0,Meme Difficulte que la Prediction,Adapte
392,2015,Information-Communication,1,Neologie,1,Les Innovations Lexicales,8,393,2,QCU,0.26,0.57,42.27,15,20,35,25,15,10,1.4,60.0,Facile,Moyen,-1,Plus Difficile que la Prediction,Pas Adapte
1458,2016,Information-Communication,1,Neologie,1,Les Innovations Lexicales,8,393,2,QCU,0.67,0.38,13.27,5,35,40,24,5,19,1.67,20.83,Facile,Difficile,-2,Beaucoup plus Difficile que la Prediction,Pas Adapte
2524,2017,Information-Communication,1,Neologie,1,Les Innovations Lexicales,8,393,2,QCU,0.12,0.75,79.78,36,9,45,43,36,7,1.05,83.72,Moyen,Facile,1,Plus Facile que la Prediction,Pas Adapte
3590,2018,Information-Communication,1,Neologie,1,Les Innovations Lexicales,8,393,2,QCU,0.5,0.31,31.82,16,35,51,47,16,31,1.09,34.04,Difficile,Difficile,0,Meme Difficulte que la Prediction,Pas Adapte
4656,2019,Information-Communication,1,Neologie,1,Les Innovations Lexicales,8,393,2,QCU,0.26,0.61,44.36,20,24,44,37,20,17,1.19,54.05,Difficile,Moyen,1,Plus Facile que la Prediction,Pas Adapte
5722,2020,Information-Communication,1,Neologie,1,Les Innovations Lexicales,8,393,2,QCU,0.02,0.75,93.0,40,3,43,43,40,3,1.0,93.02,Moyen,Facile,1,Plus Facile que la Prediction,Pas Adapte
393,2015,Information-Communication,1,Neologie,1,Les Innovations Lexicales,8,394,3,QCU,0.37,0.42,56.35,55,43,98,74,55,19,1.32,74.32,Moyen,Moyen,0,Meme Difficulte que la Prediction,Pas Adapte
1459,2016,Information-Communication,1,Neologie,1,Les Innovations Lexicales,8,394,3,QCU,0.54,0.36,25.96,26,76,102,81,26,55,1.26,32.1,Difficile,Difficile,0,Meme Difficulte que la Prediction,Pas Adapte
2525,2017,Information-Communication,1,Neologie,1,Les Innovations Lexicales,8,394,3,QCM,0.15,0.89,85.81,79,13,92,83,79,4,1.11,95.18,Facile,Facile,0,Meme Difficulte que la Prediction,Pas Adapte
3591,2018,Information-Communication,1,Neologie,1,Les Innovations Lexicales,8,394,3,QCM,0.78,0.19,25.41,26,77,103,62,26,36,1.66,41.94,Difficile,Difficile,0,Meme Difficulte que la Prediction,Pas Adapte
4657,2019,Information-Communication,1,Neologie,1,Les Innovations Lexicales,8,394,3,QCM,0.4,0.41,42.92,45,59,104,47,45,2,2.21,95.74,Facile,Moyen,-1,Plus Difficile que la Prediction,Pas Adapte
5723,2020,Information-Communication,1,Neologie,1,Les Innovations Lexicales,8,394,3,QCU,0.21,0.69,55.07,64,53,117,76,64,12,1.54,84.21,Moyen,Moyen,0,Meme Difficulte que la Prediction,Pas Adapte
394,2015,Information-Communication,1,Neologie,1,Les Innovations Lexicales,8,395,4,QCM,0.24,0.37,49.27,44,46,90,45,44,1,2.0,97.78,Moyen,Moyen,0,Meme Difficulte que la Prediction,Pas Adapte
1460,2016,Information-Communication,1,Neologie,1,Les Innovations Lexicales,8,395,4,QCU,0.63,0.2,7.87,7,88,95,48,7,41,1.98,14.58,Moyen,Difficile,-1,Plus Difficile que la Prediction,Pas Adapte
2526,2017,Information-Communication,1,Neologie,1,Les Innovations Lexicales,8,395,4,QCU,0.08,0.8,65.89,69,35,104,101,69,32,1.03,68.32,Facile,Facile,0,Meme Difficulte que la Prediction,Adapte
3592,2018,Information-Communication,1,Neologie,1,Les Innovations Lexicales,8,395,4,QCM,0.09,0.95,65.89,70,36,106,98,70,28,1.08,71.43,Facile,Facile,0,Meme Difficulte que la Prediction,Adapte
4658,2019,Information-Communication,1,Neologie,1,Les Innovations Lexicales,8,395,4,QCM,0.05,0.85,65.89,67,35,102,78,67,11,1.31,85.9,Facile,Facile,0,Meme Difficulte que la Prediction,Adapte
5724,2020,Information-Communication,1,Neologie,1,Les Innovations Lexicales,8,395,4,QCM,0.18,0.81,65.89,67,35,102,74,67,7,1.38,90.54,Facile,Facile,0,Meme Difficulte que la Prediction,Adapte
395,2015,Information-Communication,1,Neologie,1,Les Innovations Lexicales,8,396,5,QCU,0.19,0.88,78.42,44,12,56,48,44,4,1.17,91.67,Facile,Facile,0,Meme Difficulte que la Prediction,Pas Adapte
1461,2016,Information-Communication,1,Neologie,1,Les Innovations Lexicales,8,396,5,QCU,0.52,0.21,23.28,14,44,58,32,14,18,1.81,43.75,Difficile,Difficile,0,Meme Difficulte que la Prediction,Pas Adapte
2527,2017,Information-Communication,1,Neologie,1,Les Innovations Lexicales,8,396,5,QCU,0.24,0.62,47.48,31,35,66,45,31,14,1.47,68.89,Difficile,Moyen,1,Plus Facile que la Prediction,Pas Adapte
3593,2018,Information-Communication,1,Neologie,1,Les Innovations Lexicales,8,396,5,QCU,0.28,0.66,36.84,21,37,58,30,21,9,1.93,70.0,Moyen,Moyen,0,Meme Difficulte que la Prediction,Pas Adapte
4659,2019,Information-Communication,1,Neologie,1,Les Innovations Lexicales,8,396,5,QCU,0.42,0.4,3.2,2,64,66,44,2,42,1.5,4.55,Difficile,Difficile,0,Meme Difficulte que la Prediction,Pas Adapte
5725,2020,Information-Communication,1,Neologie,1,Les Innovations Lexicales,8,396,5,QCU,0.26,0.55,50.23,38,38,76,57,38,19,1.33,66.67,Difficile,Moyen,1,Plus Facile que la Prediction,Pas Adapte
396,2015,Information-Communication,1,Neologie,1,Les Innovations Lexicales,8,397,6,QCU,0.69,0.22,19.69,2,9,11,10,2,8,1.1,20.0,Moyen,Difficile,-1,Plus Difficile que la Prediction,Pas Adapte
1462,2016,Information-Communication,1,Neologie,1,Les Innovations Lexicales,8,397,6,QCU,0.26,0.74,56.82,6,4,10,7,6,1,1.43,85.71,Difficile,Moyen,1,Plus Facile que la Prediction,Pas Adapte
2528,2017,Information-Communication,1,Neologie,1,Les Innovations Lexicales,8,397,6,QCU,0.34,0.42,40.64,4,5,9,6,4,2,1.5,66.67,Moyen,Moyen,0,Meme Difficulte que la Prediction,Pas Adapte
3594,2018,Information-Communication,1,Neologie,1,Les Innovations Lexicales,8,397,6,QCU,0.62,0.2,0.69,0,8,8,6,0,6,1.33,0.0,Difficile,Difficile,0,Meme Difficulte que la Prediction,Pas Adapte
4660,2019,Information-Communication,1,Neologie,1,Les Innovations Lexicales,8,397,6,QCU,0.24,0.47,45.35,3,4,7,4,3,1,1.75,75.0,Facile,Moyen,-1,Plus Difficile que la Prediction,Pas Adapte
5726,2020,Information-Communication,1,Neologie,1,Les Innovations Lexicales,8,397,6,QCU,0.5,0.26,23.62,2,6,8,4,2,2,2.0,50.0,Facile,Difficile,-2,Beaucoup plus Difficile que la Prediction,Pas Adapte
397,2015,Information-Communication,1,Neologie,1,Les Innovations Lexicales,8,398,7,QCU,0.65,0.33,19.16,11,49,60,31,11,20,1.94,35.48,Moyen,Difficile,-1,Plus Difficile que la Prediction,Pas Adapte
1463,2016,Information-Communication,1,Neologie,1,Les Innovations Lexicales,8,398,7,QCU,0.39,0.45,53.52,33,28,61,38,33,5,1.61,86.84,Difficile,Moyen,1,Plus Facile que la Prediction,Pas Adapte
2529,2017,Information-Communication,1,Neologie,1,Les Innovations Lexicales,8,398,7,QCU,0.73,0.36,9.89,6,54,60,59,6,53,1.02,10.17,Difficile,Difficile,0,Meme Difficulte que la Prediction,Pas Adapte
3595,2018,Information-Communication,1,Neologie,1,Les Innovations Lexicales,8,398,7,QROC,0.2,0.72,97.9,53,1,54,54,53,1,1.0,98.15,Difficile,Facile,2,Beaucoup plus Facile que la Prediction,Pas Adapte
4661,2019,Information-Communication,1,Neologie,1,Les Innovations Lexicales,8,398,7,QROC,0.67,0.14,19.15,10,42,52,40,10,30,1.3,25.0,Difficile,Difficile,0,Meme Difficulte que la Prediction,Pas Adapte
5727,2020,Information-Communication,1,Neologie,1,Les Innovations Lexicales,8,398,7,QCU,0.72,0.28,2.05,1,45,46,45,1,44,1.02,2.22,Facile,Difficile,-2,Beaucoup plus Difficile que la Prediction,Pas Adapte
398,2015,Information-Communication,1,Neologie,1,Les Innovations Lexicales,8,399,8,QCU,0.27,0.52,43.29,32,41,73,73,32,41,1.0,43.84,Moyen,Moyen,0,Meme Difficulte que la Prediction,Pas Adapte
1464,2016,Information-Communication,1,Neologie,1,Les Innovations Lexicales,8,399,8,QCU,0.47,0.38,23.11,15,48,63,28,15,13,2.25,53.57,Facile,Difficile,-2,Beaucoup plus Difficile que la Prediction,Pas Adapte
2530,2017,Information-Communication,1,Neologie,1,Les Innovations Lexicales,8,399,8,QCU,0.51,0.2,24.53,16,49,65,46,16,30,1.41,34.78,Difficile,Difficile,0,Meme Difficulte que la Prediction,Pas Adapte
3596,2018,Information-Communication,1,Neologie,1,Les Innovations Lexicales,8,399,8,QCU,0.36,0.75,62.82,35,20,55,39,35,4,1.41,89.74,Facile,Moyen,-1,Plus Difficile que la Prediction,Adapte
4662,2019,Information-Communication,1,Neologie,1,Les Innovations Lexicales,8,399,8,QCU,0.21,0.59,62.82,31,19,50,36,31,5,1.39,86.11,Moyen,Moyen,0,Meme Difficulte que la Prediction,Adapte
5728,2020,Information-Communication,1,Neologie,1,Les Innovations Lexicales,8,399,8,QCU,0.28,0.73,62.82,35,21,56,38,35,3,1.47,92.11,Moyen,Moyen,0,Meme Difficulte que la Prediction,Adapte
399,2015,Information-Communication,1,Neologie,2,La Motivation Neologique,9,400,1,QROC,0.88,0.02,32.03,13,28,41,21,13,8,1.95,61.9,Facile,Difficile,-2,Beaucoup plus Difficile que la Prediction,Pas Adapte
1465,2016,Information-Communication,1,Neologie,2,La Motivation Neologique,9,400,1,QROC,0.02,0.47,74.65,31,11,42,40,31,9,1.05,77.5,Facile,Facile,0,Meme Difficulte que la Prediction,Adapte
2531,2017,Information-Communication,1,Neologie,2,La Motivation Neologique,9,400,1,QO,0.05,0.99,74.65,35,12,47,40,35,5,1.18,87.5,Facile,Facile,0,Meme Difficulte que la Prediction,Adapte
3597,2018,Information-Communication,1,Neologie,2,La Motivation Neologique,9,400,1,QO,0.09,0.45,74.65,34,11,45,45,34,11,1.0,75.56,Facile,Facile,0,Meme Difficulte que la Prediction,Adapte
4663,2019,Information-Communication,1,Neologie,2,La Motivation Neologique,9,400,1,QO,0.03,0.85,74.65,31,10,41,35,31,4,1.17,88.57,Facile,Facile,0,Meme Difficulte que la Prediction,Adapte
5729,2020,Information-Communication,1,Neologie,2,La Motivation Neologique,9,400,1,QO,0.01,0.39,74.65,29,10,39,39,29,10,1.0,74.36,Facile,Facile,0,Meme Difficulte que la Prediction,Adapte
400,2015,Information-Communication,1,Neologie,2,La Motivation Neologique,9,401,2,QCM,0.44,0.31,59.36,44,30,74,61,44,17,1.21,72.13,Difficile,Moyen,1,Plus Facile que la Prediction,Pas Adapte
1466,2016,Information-Communication,1,Neologie,2,La Motivation Neologique,9,401,2,QCM,0.23,0.4,53.8,39,33,72,61,39,22,1.18,63.93,Moyen,Moyen,0,Meme Difficulte que la Prediction,Pas Adapte
2532,2017,Information-Communication,1,Neologie,2,La Motivation Neologique,9,401,2,QCM,0.07,0.96,67.15,48,24,72,68,48,20,1.06,70.59,Difficile,Facile,2,Beaucoup plus Facile que la Prediction,Adapte
3598,2018,Information-Communication,1,Neologie,2,La Motivation Neologique,9,401,2,QCU,0.14,0.8,67.15,48,23,71,71,48,23,1.0,67.61,Facile,Facile,0,Meme Difficulte que la Prediction,Adapte
4664,2019,Information-Communication,1,Neologie,2,La Motivation Neologique,9,401,2,QROC,0.01,0.62,67.15,54,27,81,64,54,10,1.27,84.38,Facile,Facile,0,Meme Difficulte que la Prediction,Adapte
5730,2020,Information-Communication,1,Neologie,2,La Motivation Neologique,9,401,2,QROC,0.03,0.59,67.15,54,26,80,65,54,11,1.23,83.08,Facile,Facile,0,Meme Difficulte que la Prediction,Adapte
401,2015,Information-Communication,1,Neologie,2,La Motivation Neologique,9,402,3,QCM,0.11,0.71,95.77,32,1,33,32,32,0,1.03,100.0,Facile,Facile,0,Meme Difficulte que la Prediction,Pas Adapte
1467,2016,Information-Communication,1,Neologie,2,La Motivation Neologique,9,402,3,QCM,0.4,0.68,51.72,19,18,37,25,19,6,1.48,76.0,Moyen,Moyen,0,Meme Difficulte que la Prediction,Pas Adapte
2533,2017,Information-Communication,1,Neologie,2,La Motivation Neologique,9,402,3,QCM,0.61,0.19,30.46,13,29,42,20,13,7,2.1,65.0,Difficile,Difficile,0,Meme Difficulte que la Prediction,Pas Adapte
3599,2018,Information-Communication,1,Neologie,2,La Motivation Neologique,9,402,3,QCM,0.71,0.18,14.08,6,36,42,27,6,21,1.56,22.22,Difficile,Difficile,0,Meme Difficulte que la Prediction,Pas Adapte
4665,2019,Information-Communication,1,Neologie,2,La Motivation Neologique,9,402,3,QCM,0.43,0.45,47.17,17,20,37,27,17,10,1.37,62.96,Moyen,Moyen,0,Meme Difficulte que la Prediction,Pas Adapte
5731,2020,Information-Communication,1,Neologie,2,La Motivation Neologique,9,402,3,QCM,0.73,0.27,4.12,2,37,39,27,2,25,1.44,7.41,Difficile,Difficile,0,Meme Difficulte que la Prediction,Pas Adapte
402,2015,Information-Communication,1,Neologie,2,La Motivation Neologique,9,403,4,QROC,0.64,0.19,7.22,7,88,95,79,7,72,1.2,8.86,Moyen,Difficile,-1,Plus Difficile que la Prediction,Pas Adapte
1468,2016,Information-Communication,1,Neologie,2,La Motivation Neologique,9,403,4,QROC,0.16,0.86,80.27,71,17,88,72,71,1,1.22,98.61,Facile,Facile,0,Meme Difficulte que la Prediction,Pas Adapte
2534,2017,Information-Communication,1,Neologie,2,La Motivation Neologique,9,403,4,QROC,0.72,0.01,7.4,7,82,89,88,7,81,1.01,7.95,Difficile,Difficile,0,Meme Difficulte que la Prediction,Pas Adapte
3600,2018,Information-Communication,1,Neologie,2,La Motivation Neologique,9,403,4,QROC,0.05,0.92,97.04,94,3,97,97,94,3,1.0,96.91,Facile,Facile,0,Meme Difficulte que la Prediction,Pas Adapte
4666,2019,Information-Communication,1,Neologie,2,La Motivation Neologique,9,403,4,QROC,0.09,0.7,81.46,84,19,103,103,84,19,1.0,81.55,Facile,Facile,0,Meme Difficulte que la Prediction,Pas Adapte
5732,2020,Information-Communication,1,Neologie,2,La Motivation Neologique,9,403,4,QROC,0.12,0.88,84.41,90,17,107,101,90,11,1.06,89.11,Facile,Facile,0,Meme Difficulte que la Prediction,Pas Adapte
403,2015,Information-Communication,1,Neologie,2,La Motivation Neologique,9,404,5,QCM,0.09,0.71,82.59,59,13,72,62,59,3,1.16,95.16,Facile,Facile,0,Meme Difficulte que la Prediction,Pas Adapte
1469,2016,Information-Communication,1,Neologie,2,La Motivation Neologique,9,404,5,QCM,0.62,0.18,29.59,25,58,83,66,25,41,1.26,37.88,Difficile,Difficile,0,Meme Difficulte que la Prediction,Pas Adapte
2535,2017,Information-Communication,1,Neologie,2,La Motivation Neologique,9,404,5,QCM,0.18,0.95,71.71,52,21,73,69,52,17,1.06,75.36,Facile,Facile,0,Meme Difficulte que la Prediction,Adapte
3601,2018,Information-Communication,1,Neologie,2,La Motivation Neologique,9,404,5,QCM,0.05,0.85,71.71,49,19,68,61,49,12,1.11,80.33,Facile,Facile,0,Meme Difficulte que la Prediction,Adapte
4667,2019,Information-Communication,1,Neologie,2,La Motivation Neologique,9,404,5,QCM,0.08,1.0,71.71,56,22,78,66,56,10,1.18,84.85,Facile,Facile,0,Meme Difficulte que la Prediction,Adapte
5733,2020,Information-Communication,1,Neologie,2,La Motivation Neologique,9,404,5,QCM,0.18,0.85,71.71,55,22,77,66,55,11,1.17,83.33,Facile,Facile,0,Meme Difficulte que la Prediction,Adapte
404,2015,Information-Communication,1,Neologie,2,La Motivation Neologique,9,405,6,QROC,0.59,0.39,44.52,39,49,88,76,39,37,1.16,51.32,Moyen,Moyen,0,Meme Difficulte que la Prediction,Pas Adapte
1470,2016,Information-Communication,1,Neologie,2,La Motivation Neologique,9,405,6,QROC,0.94,0.05,1.79,2,90,92,37,2,35,2.49,5.41,Difficile,Difficile,0,Meme Difficulte que la Prediction,Pas Adapte
2536,2017,Information-Communication,1,Neologie,2,La Motivation Neologique,9,405,6,QO,0.98,0.12,24.47,25,77,102,77,25,52,1.32,32.47,Difficile,Difficile,0,Meme Difficulte que la Prediction,Pas Adapte
3602,2018,Information-Communication,1,Neologie,2,La Motivation Neologique,9,405,6,QROC,0.17,0.86,68.49,64,29,93,90,64,26,1.03,71.11,Facile,Facile,0,Meme Difficulte que la Prediction,Adapte
4668,2019,Information-Communication,1,Neologie,2,La Motivation Neologique,9,405,6,QROC,0.09,0.76,68.49,59,27,86,78,59,19,1.1,75.64,Facile,Facile,0,Meme Difficulte que la Prediction,Adapte
5734,2020,Information-Communication,1,Neologie,2,La Motivation Neologique,9,405,6,QROC,0.18,0.8,68.49,55,25,80,62,55,7,1.29,88.71,Facile,Facile,0,Meme Difficulte que la Prediction,Adapte
405,2015,Information-Communication,1,Neologie,2,La Motivation Neologique,9,406,7,QCU,0.58,0.25,5.69,1,12,13,7,1,6,1.86,14.29,Difficile,Difficile,0,Meme Difficulte que la Prediction,Pas Adapte
1471,2016,Information-Communication,1,Neologie,2,La Motivation Neologique,9,406,7,QCU,0.34,0.69,59.84,8,5,13,12,8,4,1.08,66.67,Difficile,Moyen,1,Plus Facile que la Prediction,Pas Adapte
2537,2017,Information-Communication,1,Neologie,2,La Motivation Neologique,9,406,7,QCU,0.51,0.21,7.92,1,11,12,6,1,5,2.0,16.67,Difficile,Difficile,0,Meme Difficulte que la Prediction,Pas Adapte
3603,2018,Information-Communication,1,Neologie,2,La Motivation Neologique,9,406,7,QCU,0.54,0.37,20.32,3,11,14,8,3,5,1.75,37.5,Difficile,Difficile,0,Meme Difficulte que la Prediction,Pas Adapte
4669,2019,Information-Communication,1,Neologie,2,La Motivation Neologique,9,406,7,QCU,0.24,0.41,36.97,5,9,14,9,5,4,1.56,55.56,Moyen,Moyen,0,Meme Difficulte que la Prediction,Pas Adapte
5735,2020,Information-Communication,1,Neologie,2,La Motivation Neologique,9,406,7,QCU,0.49,0.28,18.79,3,11,14,6,3,3,2.33,50.0,Difficile,Difficile,0,Meme Difficulte que la Prediction,Pas Adapte
406,2015,Information-Communication,1,Neologie,2,La Motivation Neologique,9,407,8,QCM,0.61,0.23,18.07,3,15,18,12,3,9,1.5,25.0,Difficile,Difficile,0,Meme Difficulte que la Prediction,Pas Adapte
1472,2016,Information-Communication,1,Neologie,2,La Motivation Neologique,9,407,8,QCM,0.33,0.63,38.8,8,13,21,12,8,4,1.75,66.67,Moyen,Moyen,0,Meme Difficulte que la Prediction,Pas Adapte
2538,2017,Information-Communication,1,Neologie,2,La Motivation Neologique,9,407,8,QCM,0.59,0.18,16.25,3,17,20,6,3,3,3.33,50.0,Difficile,Difficile,0,Meme Difficulte que la Prediction,Pas Adapte
3604,2018,Information-Communication,1,Neologie,2,La Motivation Neologique,9,407,8,QCM,0.04,0.84,80.27,17,4,21,18,17,1,1.17,94.44,Facile,Facile,0,Meme Difficulte que la Prediction,Pas Adapte
4670,2019,Information-Communication,1,Neologie,2,La Motivation Neologique,9,407,8,QCM,0.25,0.38,49.51,9,9,18,11,9,2,1.64,81.82,Difficile,Moyen,1,Plus Facile que la Prediction,Pas Adapte
5736,2020,Information-Communication,1,Neologie,2,La Motivation Neologique,9,407,8,QCM,0.51,0.24,19.23,3,15,18,6,3,3,3.0,50.0,Difficile,Difficile,0,Meme Difficulte que la Prediction,Pas Adapte
407,2015,Information-Communication,1,Neologie,2,La Motivation Neologique,9,408,9,QCM,0.6,0.16,23.17,9,30,39,21,9,12,1.86,42.86,Difficile,Difficile,0,Meme Difficulte que la Prediction,Pas Adapte
1473,2016,Information-Communication,1,Neologie,2,La Motivation Neologique,9,408,9,QCM,0.12,0.72,85.05,35,6,41,37,35,2,1.11,94.59,Moyen,Facile,1,Plus Facile que la Prediction,Pas Adapte
2539,2017,Information-Communication,1,Neologie,2,La Motivation Neologique,9,408,9,QCM,0.75,0.26,26.85,10,26,36,25,10,15,1.44,40.0,Difficile,Difficile,0,Meme Difficulte que la Prediction,Pas Adapte
3605,2018,Information-Communication,1,Neologie,2,La Motivation Neologique,9,408,9,QCM,0.5,0.33,50.71,17,17,34,33,17,16,1.03,51.52,Moyen,Moyen,0,Meme Difficulte que la Prediction,Pas Adapte
4671,2019,Information-Communication,1,Neologie,2,La Motivation Neologique,9,408,9,QCM,0.05,0.9,90.59,35,4,39,38,35,3,1.03,92.11,Moyen,Facile,1,Plus Facile que la Prediction,Pas Adapte
5737,2020,Information-Communication,1,Neologie,2,La Motivation Neologique,9,408,9,QCM,0.65,0.28,1.03,0,39,39,28,0,28,1.39,0.0,Facile,Difficile,-2,Beaucoup plus Difficile que la Prediction,Pas Adapte
408,2015,Information-Communication,1,Neologie,3,La Creation Neologique,7,409,1,QCU,0.39,0.48,46.75,8,10,18,17,8,9,1.06,47.06,Difficile,Moyen,1,Plus Facile que la Prediction,Pas Adapte
1474,2016,Information-Communication,1,Neologie,3,La Creation Neologique,7,409,1,QCU,0.68,0.28,30.03,5,10,15,9,5,4,1.67,55.56,Difficile,Difficile,0,Meme Difficulte que la Prediction,Pas Adapte
2540,2017,Information-Communication,1,Neologie,3,La Creation Neologique,7,409,1,QCU,0.01,0.83,95.21,14,1,15,15,14,1,1.0,93.33,Facile,Facile,0,Meme Difficulte que la Prediction,Pas Adapte
3606,2018,Information-Communication,1,Neologie,3,La Creation Neologique,7,409,1,QCU,0.47,0.34,1.82,0,16,16,14,0,14,1.14,0.0,Difficile,Difficile,0,Meme Difficulte que la Prediction,Pas Adapte
4672,2019,Information-Communication,1,Neologie,3,La Creation Neologique,7,409,1,QROC,0.96,0.07,15.14,3,14,17,14,3,11,1.21,21.43,Difficile,Difficile,0,Meme Difficulte que la Prediction,Pas Adapte
5738,2020,Information-Communication,1,Neologie,3,La Creation Neologique,7,409,1,QROC,0.36,0.35,46.14,7,8,15,14,7,7,1.07,50.0,Facile,Moyen,-1,Plus Difficile que la Prediction,Pas Adapte
409,2015,Information-Communication,1,Neologie,3,La Creation Neologique,7,410,2,QROC,0.95,0.02,14.19,12,74,86,55,12,43,1.56,21.82,Moyen,Difficile,-1,Plus Difficile que la Prediction,Pas Adapte
1475,2016,Information-Communication,1,Neologie,3,La Creation Neologique,7,410,2,QROC,0.15,0.57,85.6,78,13,91,79,78,1,1.15,98.73,Difficile,Facile,2,Beaucoup plus Facile que la Prediction,Pas Adapte
2541,2017,Information-Communication,1,Neologie,3,La Creation Neologique,7,410,2,QROC,0.28,0.35,52.09,43,39,82,62,43,19,1.32,69.35,Moyen,Moyen,0,Meme Difficulte que la Prediction,Pas Adapte
3607,2018,Information-Communication,1,Neologie,3,La Creation Neologique,7,410,2,QROC,0.88,0.07,4.18,4,84,88,43,4,39,2.05,9.3,Difficile,Difficile,0,Meme Difficulte que la Prediction,Pas Adapte
4673,2019,Information-Communication,1,Neologie,3,La Creation Neologique,7,410,2,QROC,0.48,0.33,50.98,48,46,94,94,48,46,1.0,51.06,Moyen,Moyen,0,Meme Difficulte que la Prediction,Pas Adapte
5739,2020,Information-Communication,1,Neologie,3,La Creation Neologique,7,410,2,QROC,0.91,0.01,8.76,9,90,99,88,9,79,1.12,10.23,Moyen,Difficile,-1,Plus Difficile que la Prediction,Pas Adapte
410,2015,Information-Communication,1,Neologie,3,La Creation Neologique,7,411,3,QCM,0.09,0.87,98.82,11,0,11,11,11,0,1.0,100.0,Moyen,Facile,1,Plus Facile que la Prediction,Pas Adapte
1476,2016,Information-Communication,1,Neologie,3,La Creation Neologique,7,411,3,QCM,0.23,0.64,38.68,4,7,11,7,4,3,1.57,57.14,Moyen,Moyen,0,Meme Difficulte que la Prediction,Pas Adapte
2542,2017,Information-Communication,1,Neologie,3,La Creation Neologique,7,411,3,QCM,0.69,0.22,13.85,2,9,11,9,2,7,1.22,22.22,Facile,Difficile,-2,Beaucoup plus Difficile que la Prediction,Pas Adapte
3608,2018,Information-Communication,1,Neologie,3,La Creation Neologique,7,411,3,QCM,0.01,0.95,93.99,8,1,9,8,8,0,1.12,100.0,Difficile,Facile,2,Beaucoup plus Facile que la Prediction,Pas Adapte
4674,2019,Information-Communication,1,Neologie,3,La Creation Neologique,7,411,3,QCM,0.66,0.23,23.32,2,7,9,4,2,2,2.25,50.0,Moyen,Difficile,-1,Plus Difficile que la Prediction,Pas Adapte
5740,2020,Information-Communication,1,Neologie,3,La Creation Neologique,7,411,3,QCM,0.07,0.71,70.45,6,2,8,8,6,2,1.0,75.0,Difficile,Facile,2,Beaucoup plus Facile que la Prediction,Adapte
411,2015,Information-Communication,1,Neologie,3,La Creation Neologique,7,412,4,QO,0.89,0.13,20.88,15,56,71,64,15,49,1.11,23.44,Difficile,Difficile,0,Meme Difficulte que la Prediction,Pas Adapte
1477,2016,Information-Communication,1,Neologie,3,La Creation Neologique,7,412,4,QO,0.87,0.07,20.05,15,61,76,76,15,61,1.0,19.74,Difficile,Difficile,0,Meme Difficulte que la Prediction,Pas Adapte
2543,2017,Information-Communication,1,Neologie,3,La Creation Neologique,7,412,4,QO,0.19,0.93,81.86,56,13,69,61,56,5,1.13,91.8,Facile,Facile,0,Meme Difficulte que la Prediction,Pas Adapte
3609,2018,Information-Communication,1,Neologie,3,La Creation Neologique,7,412,4,QO,0.52,0.16,50.36,36,36,72,44,36,8,1.64,81.82,Moyen,Moyen,0,Meme Difficulte que la Prediction,Pas Adapte
4675,2019,Information-Communication,1,Neologie,3,La Creation Neologique,7,412,4,QO,0.83,0.07,7.1,5,65,70,52,5,47,1.35,9.62,Difficile,Difficile,0,Meme Difficulte que la Prediction,Pas Adapte
5741,2020,Information-Communication,1,Neologie,3,La Creation Neologique,7,412,4,QO,0.79,0.01,31.25,21,46,67,34,21,13,1.97,61.76,Difficile,Difficile,0,Meme Difficulte que la Prediction,Pas Adapte
412,2015,Information-Communication,1,Neologie,3,La Creation Neologique,7,413,5,QCM,0.04,0.9,98.22,93,2,95,93,93,0,1.02,100.0,Facile,Facile,0,Meme Difficulte que la Prediction,Pas Adapte
1478,2016,Information-Communication,1,Neologie,3,La Creation Neologique,7,413,5,QCM,0.25,0.58,53.46,56,49,105,81,56,25,1.3,69.14,Moyen,Moyen,0,Meme Difficulte que la Prediction,Pas Adapte
2544,2017,Information-Communication,1,Neologie,3,La Creation Neologique,7,413,5,QCM,0.62,0.25,20.47,20,76,96,30,20,10,3.2,66.67,Moyen,Difficile,-1,Plus Difficile que la Prediction,Pas Adapte
3610,2018,Information-Communication,1,Neologie,3,La Creation Neologique,7,413,5,QCM,0.5,0.27,20.86,18,68,86,79,18,61,1.09,22.78,Difficile,Difficile,0,Meme Difficulte que la Prediction,Pas Adapte
4676,2019,Information-Communication,1,Neologie,3,La Creation Neologique,7,413,5,QCM,0.6,0.21,8.08,6,73,79,75,6,69,1.05,8.0,Difficile,Difficile,0,Meme Difficulte que la Prediction,Pas Adapte
5742,2020,Information-Communication,1,Neologie,3,La Creation Neologique,7,413,5,QCM,0.25,0.7,50.21,34,33,67,57,34,23,1.18,59.65,Difficile,Moyen,1,Plus Facile que la Prediction,Pas Adapte
413,2015,Information-Communication,1,Neologie,3,La Creation Neologique,7,414,6,QCM,0.42,0.44,60.2,46,31,77,74,46,28,1.04,62.16,Moyen,Moyen,0,Meme Difficulte que la Prediction,Adapte
1479,2016,Information-Communication,1,Neologie,3,La Creation Neologique,7,414,6,QCM,0.29,0.38,60.2,49,32,81,50,49,1,1.62,98.0,Moyen,Moyen,0,Meme Difficulte que la Prediction,Adapte
2545,2017,Information-Communication,1,Neologie,3,La Creation Neologique,7,414,6,QCM,0.43,0.59,60.2,51,34,85,74,51,23,1.15,68.92,Moyen,Moyen,0,Meme Difficulte que la Prediction,Adapte
3611,2018,Information-Communication,1,Neologie,3,La Creation Neologique,7,414,6,QCU,0.37,0.51,60.2,50,33,83,80,50,30,1.04,62.5,Moyen,Moyen,0,Meme Difficulte que la Prediction,Adapte
4677,2019,Information-Communication,1,Neologie,3,La Creation Neologique,7,414,6,QCU,0.36,0.7,60.2,57,37,94,62,57,5,1.52,91.94,Moyen,Moyen,0,Meme Difficulte que la Prediction,Adapte
5743,2020,Information-Communication,1,Neologie,3,La Creation Neologique,7,414,6,QCU,0.34,0.42,60.2,54,36,90,72,54,18,1.25,75.0,Moyen,Moyen,0,Meme Difficulte que la Prediction,Adapte
414,2015,Information-Communication,1,Neologie,3,La Creation Neologique,7,415,7,QO,0.79,0.14,20.77,4,13,17,10,4,6,1.7,40.0,Difficile,Difficile,0,Meme Difficulte que la Prediction,Pas Adapte
1480,2016,Information-Communication,1,Neologie,3,La Creation Neologique,7,415,7,QO,0.2,0.83,80.35,14,4,18,16,14,2,1.12,87.5,Facile,Facile,0,Meme Difficulte que la Prediction,Pas Adapte
2546,2017,Information-Communication,1,Neologie,3,La Creation Neologique,7,415,7,QROC,0.95,0.19,14.4,3,17,20,12,3,9,1.67,25.0,Difficile,Difficile,0,Meme Difficulte que la Prediction,Pas Adapte
3612,2018,Information-Communication,1,Neologie,3,La Creation Neologique,7,415,7,QROC,0.51,0.29,62.83,13,8,21,17,13,4,1.24,76.47,Moyen,Moyen,0,Meme Difficulte que la Prediction,Adapte
4678,2019,Information-Communication,1,Neologie,3,La Creation Neologique,7,415,7,QROC,0.54,0.37,62.83,14,9,23,20,14,6,1.15,70.0,Moyen,Moyen,0,Meme Difficulte que la Prediction,Adapte
5744,2020,Information-Communication,1,Neologie,3,La Creation Neologique,7,415,7,QROC,0.52,0.3,62.83,13,8,21,19,13,6,1.11,68.42,Moyen,Moyen,0,Meme Difficulte que la Prediction,Adapte
415,2015,Information-Communication,1,Neologie,4,Les Accidents Lexicaux,13,416,1,QROC,0.18,0.48,73.59,15,5,20,18,15,3,1.11,83.33,Facile,Facile,0,Meme Difficulte que la Prediction,Adapte
1481,2016,Information-Communication,1,Neologie,4,Les Accidents Lexicaux,13,416,1,QO,0.12,0.73,73.59,17,6,23,22,17,5,1.05,77.27,Facile,Facile,0,Meme Difficulte que la Prediction,Adapte
2547,2017,Information-Communication,1,Neologie,4,Les Accidents Lexicaux,13,416,1,QCM,0.18,0.97,73.59,15,6,21,20,15,5,1.05,75.0,Facile,Facile,0,Meme Difficulte que la Prediction,Adapte
3613,2018,Information-Communication,1,Neologie,4,Les Accidents Lexicaux,13,416,1,QCM,0.13,0.77,73.59,16,6,22,21,16,5,1.05,76.19,Facile,Facile,0,Meme Difficulte que la Prediction,Adapte
4679,2019,Information-Communication,1,Neologie,4,Les Accidents Lexicaux,13,416,1,QCM,0.02,0.71,73.59,18,6,24,20,18,2,1.2,90.0,Facile,Facile,0,Meme Difficulte que la Prediction,Adapte
5745,2020,Information-Communication,1,Neologie,4,Les Accidents Lexicaux,13,416,1,QCM,0.13,0.98,73.59,21,7,28,21,21,0,1.33,100.0,Facile,Facile,0,Meme Difficulte que la Prediction,Adapte
416,2015,Information-Communication,1,Neologie,4,Les Accidents Lexicaux,13,417,2,QCU,0.35,0.75,38.45,37,60,97,74,37,37,1.31,50.0,Moyen,Moyen,0,Meme Difficulte que la Prediction,Pas Adapte
1482,2016,Information-Communication,1,Neologie,4,Les Accidents Lexicaux,13,417,2,QCU,0.37,0.45,49.7,46,47,93,91,46,45,1.02,50.55,Difficile,Moyen,1,Plus Facile que la Prediction,Pas Adapte
2548,2017,Information-Communication,1,Neologie,4,Les Accidents Lexicaux,13,417,2,QCU,0.05,0.79,71.16,65,26,91,79,65,14,1.15,82.28,Difficile,Facile,2,Beaucoup plus Facile que la Prediction,Adapte
3614,2018,Information-Communication,1,Neologie,4,Les Accidents Lexicaux,13,417,2,QCU,0.16,0.92,71.16,69,28,97,97,69,28,1.0,71.13,Facile,Facile,0,Meme Difficulte que la Prediction,Adapte
4680,2019,Information-Communication,1,Neologie,4,Les Accidents Lexicaux,13,417,2,QCU,0.12,0.79,71.16,68,27,95,88,68,20,1.08,77.27,Facile,Facile,0,Meme Difficulte que la Prediction,Adapte
5746,2020,Information-Communication,1,Neologie,4,Les Accidents Lexicaux,13,417,2,QCU,0.1,0.87,71.16,63,26,89,84,63,21,1.06,75.0,Facile,Facile,0,Meme Difficulte que la Prediction,Adapte
417,2015,Information-Communication,1,Neologie,4,Les Accidents Lexicaux,13,418,3,QROC,0.5,0.32,50.74,31,30,61,42,31,11,1.45,73.81,Difficile,Moyen,1,Plus Facile que la Prediction,Pas Adapte
1483,2016,Information-Communication,1,Neologie,4,Les Accidents Lexicaux,13,418,3,QROC,0.95,0.01,2.58,2,68,70,56,2,54,1.25,3.57,Facile,Difficile,-2,Beaucoup plus Difficile que la Prediction,Pas Adapte
2549,2017,Information-Communication,1,Neologie,4,Les Accidents Lexicaux,13,418,3,QCM,0.1,0.8,92.68,74,6,80,79,74,5,1.01,93.67,Difficile,Facile,2,Beaucoup plus Facile que la Prediction,Pas Adapte
3615,2018,Information-Communication,1,Neologie,4,Les Accidents Lexicaux,13,418,3,QCM,0.75,0.2,5.78,5,86,91,23,5,18,3.96,21.74,Difficile,Difficile,0,Meme Difficulte que la Prediction,Pas Adapte
4681,2019,Information-Communication,1,Neologie,4,Les Accidents Lexicaux,13,418,3,QCM,0.01,0.87,88.72,75,10,85,81,75,6,1.05,92.59,Facile,Facile,0,Meme Difficulte que la Prediction,Pas Adapte
5747,2020,Information-Communication,1,Neologie,4,Les Accidents Lexicaux,13,418,3,QCM,0.13,0.83,93.34,79,6,85,82,79,3,1.04,96.34,Facile,Facile,0,Meme Difficulte que la Prediction,Pas Adapte
418,2015,Information-Communication,1,Neologie,4,Les Accidents Lexicaux,13,419,4,QCU,0.6,0.24,2.89,3,94,97,33,3,30,2.94,9.09,Difficile,Difficile,0,Meme Difficulte que la Prediction,Pas Adapte
1484,2016,Information-Communication,1,Neologie,4,Les Accidents Lexicaux,13,419,4,QCU,0.63,0.35,10.5,10,89,99,83,10,73,1.19,12.05,Difficile,Difficile,0,Meme Difficulte que la Prediction,Pas Adapte
2550,2017,Information-Communication,1,Neologie,4,Les Accidents Lexicaux,13,419,4,QCU,0.66,0.35,33.06,34,70,104,93,34,59,1.12,36.56,Moyen,Difficile,-1,Plus Difficile que la Prediction,Pas Adapte
3616,2018,Information-Communication,1,Neologie,4,Les Accidents Lexicaux,13,419,4,QCU,0.37,0.59,42.14,50,68,118,84,50,34,1.4,59.52,Moyen,Moyen,0,Meme Difficulte que la Prediction,Pas Adapte
4682,2019,Information-Communication,1,Neologie,4,Les Accidents Lexicaux,13,419,4,QROC,0.36,0.32,45.53,56,68,124,62,56,6,2.0,90.32,Moyen,Moyen,0,Meme Difficulte que la Prediction,Pas Adapte
5748,2020,Information-Communication,1,Neologie,4,Les Accidents Lexicaux,13,419,4,QROC,0.09,0.58,71.44,83,33,116,114,83,31,1.02,72.81,Difficile,Facile,2,Beaucoup plus Facile que la Prediction,Adapte
419,2015,Information-Communication,1,Neologie,4,Les Accidents Lexicaux,13,420,5,QO,0.39,0.16,51.8,19,17,36,22,19,3,1.64,86.36,Difficile,Moyen,1,Plus Facile que la Prediction,Pas Adapte
1485,2016,Information-Communication,1,Neologie,4,Les Accidents Lexicaux,13,420,5,QO,0.96,0.1,6.15,2,32,34,25,2,23,1.36,8.0,Difficile,Difficile,0,Meme Difficulte que la Prediction,Pas Adapte
2551,2017,Information-Communication,1,Neologie,4,Les Accidents Lexicaux,13,420,5,QO,0.9,0.09,2.31,1,38,39,21,1,20,1.86,4.76,Facile,Difficile,-2,Beaucoup plus Difficile que la Prediction,Pas Adapte
3617,2018,Information-Communication,1,Neologie,4,Les Accidents Lexicaux,13,420,5,QO,0.5,0.19,53.06,21,18,39,32,21,11,1.22,65.62,Difficile,Moyen,1,Plus Facile que la Prediction,Pas Adapte
4683,2019,Information-Communication,1,Neologie,4,Les Accidents Lexicaux,13,420,5,QROC,0.9,0.11,21.91,8,28,36,21,8,13,1.71,38.1,Facile,Difficile,-2,Beaucoup plus Difficile que la Prediction,Pas Adapte
5749,2020,Information-Communication,1,Neologie,4,Les Accidents Lexicaux,13,420,5,QROC,0.97,0.0,25.79,10,28,38,24,10,14,1.58,41.67,Difficile,Difficile,0,Meme Difficulte que la Prediction,Pas Adapte
420,2015,Information-Communication,1,Neologie,4,Les Accidents Lexicaux,13,421,6,QCU,0.09,0.9,88.37,6,1,7,7,6,1,1.0,85.71,Difficile,Facile,2,Beaucoup plus Facile que la Prediction,Pas Adapte
1486,2016,Information-Communication,1,Neologie,4,Les Accidents Lexicaux,13,421,6,QCU,0.46,0.29,27.76,2,6,8,3,2,1,2.67,66.67,Difficile,Difficile,0,Meme Difficulte que la Prediction,Pas Adapte
2552,2017,Information-Communication,1,Neologie,4,Les Accidents Lexicaux,13,421,6,QCU,0.75,0.31,31.12,3,6,9,8,3,5,1.12,37.5,Facile,Difficile,-2,Beaucoup plus Difficile que la Prediction,Pas Adapte
3618,2018,Information-Communication,1,Neologie,4,Les Accidents Lexicaux,13,421,6,QCU,0.65,0.25,21.87,2,7,9,3,2,1,3.0,66.67,Difficile,Difficile,0,Meme Difficulte que la Prediction,Pas Adapte
4684,2019,Information-Communication,1,Neologie,4,Les Accidents Lexicaux,13,421,6,QCU,0.05,0.94,91.04,9,1,10,9,9,0,1.11,100.0,Moyen,Facile,1,Plus Facile que la Prediction,Pas Adapte
5750,2020,Information-Communication,1,Neologie,4,Les Accidents Lexicaux,13,421,6,QCU,0.58,0.33,19.94,2,6,8,3,2,1,2.67,66.67,Difficile,Difficile,0,Meme Difficulte que la Prediction,Pas Adapte
421,2015,Information-Communication,1,Neologie,4,Les Accidents Lexicaux,13,422,7,QROC,0.09,0.64,83.56,67,13,80,74,67,7,1.08,90.54,Facile,Facile,0,Meme Difficulte que la Prediction,Pas Adapte
1487,2016,Information-Communication,1,Neologie,4,Les Accidents Lexicaux,13,422,7,QROC,0.18,0.52,75.92,61,20,81,80,61,19,1.01,76.25,Difficile,Facile,2,Beaucoup plus Facile que la Prediction,Pas Adapte
2553,2017,Information-Communication,1,Neologie,4,Les Accidents Lexicaux,13,422,7,QROC,0.07,0.74,69.94,48,21,69,56,48,8,1.23,85.71,Facile,Facile,0,Meme Difficulte que la Prediction,Adapte
3619,2018,Information-Communication,1,Neologie,4,Les Accidents Lexicaux,13,422,7,QROC,0.14,0.8,69.94,50,22,72,66,50,16,1.09,75.76,Facile,Facile,0,Meme Difficulte que la Prediction,Adapte
4685,2019,Information-Communication,1,Neologie,4,Les Accidents Lexicaux,13,422,7,QROC,0.03,0.74,69.94,46,20,66,60,46,14,1.1,76.67,Facile,Facile,0,Meme Difficulte que la Prediction,Adapte
5751,2020,Information-Communication,1,Neologie,4,Les Accidents Lexicaux,13,422,7,QO,0.09,0.78,69.94,50,22,72,54,50,4,1.33,92.59,Facile,Facile,0,Meme Difficulte que la Prediction,Adapte
422,2015,Information-Communication,1,Neologie,4,Les Accidents Lexicaux,13,423,8,QO,0.41,0.19,64.19,12,6,18,14,12,2,1.29,85.71,Moyen,Moyen,0,Meme Difficulte que la Prediction,Adapte
1488,2016,Information-Communication,1,Neologie,4,Les Accidents Lexicaux,13,423,8,QO,0.73,0.17,64.19,13,8,21,21,13,8,1.0,61.9,Moyen,Moyen,0,Meme Difficulte que la Prediction,Adapte
2554,2017,Information-Communication,1,Neologie,4,Les Accidents Lexicaux,13,423,8,QO,0.33,0.21,64.19,13,8,21,14,13,1,1.5,92.86,Moyen,Moyen,0,Meme Difficulte que la Prediction,Adapte
3620,2018,Information-Communication,1,Neologie,4,Les Accidents Lexicaux,13,423,8,QO,0.65,0.28,64.19,15,8,23,18,15,3,1.28,83.33,Moyen,Moyen,0,Meme Difficulte que la Prediction,Adapte
4686,2019,Information-Communication,1,Neologie,4,Les Accidents Lexicaux,13,423,8,QO,0.59,0.29,64.19,15,8,23,21,15,6,1.1,71.43,Moyen,Moyen,0,Meme Difficulte que la Prediction,Adapte
5752,2020,Information-Communication,1,Neologie,4,Les Accidents Lexicaux,13,423,8,QO,0.71,0.16,64.19,13,8,21,17,13,4,1.24,76.47,Moyen,Moyen,0,Meme Difficulte que la Prediction,Adapte
423,2015,Information-Communication,1,Neologie,4,Les Accidents Lexicaux,13,424,9,QROC,0.86,0.1,27.8,19,49,68,56,19,37,1.21,33.93,Facile,Difficile,-2,Beaucoup plus Difficile que la Prediction,Pas Adapte
1489,2016,Information-Communication,1,Neologie,4,Les Accidents Lexicaux,13,424,9,QROC,0.83,0.21,21.91,14,49,63,49,14,35,1.29,28.57,Moyen,Difficile,-1,Plus Difficile que la Prediction,Pas Adapte
2555,2017,Information-Communication,1,Neologie,4,Les Accidents Lexicaux,13,424,9,QO,0.78,0.1,10.5,8,64,72,58,8,50,1.24,13.79,Facile,Difficile,-2,Beaucoup plus Difficile que la Prediction,Pas Adapte
3621,2018,Information-Communication,1,Neologie,4,Les Accidents Lexicaux,13,424,9,QO,0.03,0.93,97.69,73,2,75,74,73,1,1.01,98.65,Facile,Facile,0,Meme Difficulte que la Prediction,Pas Adapte
4687,2019,Information-Communication,1,Neologie,4,Les Accidents Lexicaux,13,424,9,QO,0.02,0.42,80.49,60,14,74,73,60,13,1.01,82.19,Difficile,Facile,2,Beaucoup plus Facile que la Prediction,Pas Adapte
5753,2020,Information-Communication,1,Neologie,4,Les Accidents Lexicaux,13,424,9,QO,0.91,0.06,33.86,27,53,80,65,27,38,1.23,41.54,Difficile,Difficile,0,Meme Difficulte que la Prediction,Pas Adapte
424,2015,Information-Communication,1,Neologie,4,Les Accidents Lexicaux,13,425,10,QCM,0.27,0.31,53.78,18,16,34,32,18,14,1.06,56.25,Moyen,Moyen,0,Meme Difficulte que la Prediction,Pas Adapte
1490,2016,Information-Communication,1,Neologie,4,Les Accidents Lexicaux,13,425,10,QCM,0.75,0.28,12.09,4,30,34,17,4,13,2.0,23.53,Difficile,Difficile,0,Meme Difficulte que la Prediction,Pas Adapte
2556,2017,Information-Communication,1,Neologie,4,Les Accidents Lexicaux,13,425,10,QCM,0.65,0.3,0.43,0,36,36,31,0,31,1.16,0.0,Difficile,Difficile,0,Meme Difficulte que la Prediction,Pas Adapte
3622,2018,Information-Communication,1,Neologie,4,Les Accidents Lexicaux,13,425,10,QCM,0.5,0.67,61.08,24,15,39,24,24,0,1.62,100.0,Moyen,Moyen,0,Meme Difficulte que la Prediction,Adapte
4688,2019,Information-Communication,1,Neologie,4,Les Accidents Lexicaux,13,425,10,QCM,0.39,0.45,61.08,23,15,38,29,23,6,1.31,79.31,Moyen,Moyen,0,Meme Difficulte que la Prediction,Adapte
5754,2020,Information-Communication,1,Neologie,4,Les Accidents Lexicaux,13,425,10,QCM,0.44,0.63,61.08,24,15,39,36,24,12,1.08,66.67,Moyen,Moyen,0,Meme Difficulte que la Prediction,Adapte
425,2015,Information-Communication,1,Neologie,4,Les Accidents Lexicaux,13,426,11,QCU,0.26,0.64,53.52,25,21,46,38,25,13,1.21,65.79,Difficile,Moyen,1,Plus Facile que la Prediction,Pas Adapte
1491,2016,Information-Communication,1,Neologie,4,Les Accidents Lexicaux,13,426,11,QCU,0.12,0.8,79.22,34,9,43,38,34,4,1.13,89.47,Moyen,Facile,1,Plus Facile que la Prediction,Pas Adapte
2557,2017,Information-Communication,1,Neologie,4,Les Accidents Lexicaux,13,426,11,QCU,0.62,0.38,4.58,2,43,45,34,2,32,1.32,5.88,Difficile,Difficile,0,Meme Difficulte que la Prediction,Pas Adapte
3623,2018,Information-Communication,1,Neologie,4,Les Accidents Lexicaux,13,426,11,QCM,0.07,0.99,65.37,26,14,40,31,26,5,1.29,83.87,Facile,Facile,0,Meme Difficulte que la Prediction,Adapte
4689,2019,Information-Communication,1,Neologie,4,Les Accidents Lexicaux,13,426,11,QCM,0.0,0.81,65.37,22,12,34,23,22,1,1.48,95.65,Facile,Facile,0,Meme Difficulte que la Prediction,Adapte
5755,2020,Information-Communication,1,Neologie,4,Les Accidents Lexicaux,13,426,11,QCM,0.12,0.89,65.37,20,10,30,28,20,8,1.07,71.43,Facile,Facile,0,Meme Difficulte que la Prediction,Adapte
426,2015,Information-Communication,1,Neologie,4,Les Accidents Lexicaux,13,427,12,QCU,0.38,0.48,38.28,14,22,36,23,14,9,1.57,60.87,Moyen,Moyen,0,Meme Difficulte que la Prediction,Pas Adapte
1492,2016,Information-Communication,1,Neologie,4,Les Accidents Lexicaux,13,427,12,QCU,0.56,0.23,10.35,4,37,41,21,4,17,1.95,19.05,Difficile,Difficile,0,Meme Difficulte que la Prediction,Pas Adapte
2558,2017,Information-Communication,1,Neologie,4,Les Accidents Lexicaux,13,427,12,QCU,0.06,0.85,94.56,42,2,44,43,42,1,1.02,97.67,Facile,Facile,0,Meme Difficulte que la Prediction,Pas Adapte
3624,2018,Information-Communication,1,Neologie,4,Les Accidents Lexicaux,13,427,12,QCU,0.37,0.72,39.19,16,24,40,26,16,10,1.54,61.54,Difficile,Moyen,1,Plus Facile que la Prediction,Pas Adapte
4690,2019,Information-Communication,1,Neologie,4,Les Accidents Lexicaux,13,427,12,QCU,0.13,0.82,65.22,29,15,44,41,29,12,1.07,70.73,Facile,Facile,0,Meme Difficulte que la Prediction,Adapte
5756,2020,Information-Communication,1,Neologie,4,Les Accidents Lexicaux,13,427,12,QCU,0.04,0.87,65.22,31,17,48,36,31,5,1.33,86.11,Facile,Facile,0,Meme Difficulte que la Prediction,Adapte
427,2015,Information-Communication,1,Neologie,4,Les Accidents Lexicaux,13,428,13,QCM,0.43,0.36,47.86,21,23,44,44,21,23,1.0,47.73,Moyen,Moyen,0,Meme Difficulte que la Prediction,Pas Adapte
1493,2016,Information-Communication,1,Neologie,4,Les Accidents Lexicaux,13,428,13,QCM,0.13,0.82,66.01,24,13,37,29,24,5,1.28,82.76,Difficile,Facile,2,Beaucoup plus Facile que la Prediction,Adapte
2559,2017,Information-Communication,1,Neologie,4,Les Accidents Lexicaux,13,428,13,QCM,0.12,0.74,66.01,22,11,33,23,22,1,1.43,95.65,Facile,Facile,0,Meme Difficulte que la Prediction,Adapte
3625,2018,Information-Communication,1,Neologie,4,Les Accidents Lexicaux,13,428,13,QCM,0.04,0.95,66.01,24,12,36,26,24,2,1.38,92.31,Facile,Facile,0,Meme Difficulte que la Prediction,Adapte
4691,2019,Information-Communication,1,Neologie,4,Les Accidents Lexicaux,13,428,13,QCM,0.03,0.81,66.01,25,13,38,29,25,4,1.31,86.21,Facile,Facile,0,Meme Difficulte que la Prediction,Adapte
5757,2020,Information-Communication,1,Neologie,4,Les Accidents Lexicaux,13,428,13,QCM,0.08,0.98,66.01,24,12,36,33,24,9,1.09,72.73,Facile,Facile,0,Meme Difficulte que la Prediction,Adapte
428,2015,Information-Communication,1,Construction Morphologique,1,Alterations,8,429,1,QCU,0.55,0.27,19.48,15,63,78,74,15,59,1.05,20.27,Moyen,Difficile,-1,Plus Difficile que la Prediction,Pas Adapte
1494,2016,Information-Communication,1,Construction Morphologique,1,Alterations,8,429,1,QCU,0.34,0.67,51.88,45,41,86,78,45,33,1.1,57.69,Difficile,Moyen,1,Plus Facile que la Prediction,Pas Adapte
2560,2017,Information-Communication,1,Construction Morphologique,1,Alterations,8,429,1,QCU,0.12,0.97,78.48,71,20,91,82,71,11,1.11,86.59,Moyen,Facile,1,Plus Facile que la Prediction,Pas Adapte
3626,2018,Information-Communication,1,Construction Morphologique,1,Alterations,8,429,1,QCU,0.64,0.35,31.79,33,70,103,95,33,62,1.08,34.74,Facile,Difficile,-2,Beaucoup plus Difficile que la Prediction,Pas Adapte
4692,2019,Information-Communication,1,Construction Morphologique,1,Alterations,8,429,1,QCU,0.51,0.22,15.86,17,92,109,65,17,48,1.68,26.15,Difficile,Difficile,0,Meme Difficulte que la Prediction,Pas Adapte
5758,2020,Information-Communication,1,Construction Morphologique,1,Alterations,8,429,1,QCU,0.57,0.3,31.15,33,74,107,68,33,35,1.57,48.53,Difficile,Difficile,0,Meme Difficulte que la Prediction,Pas Adapte
429,2015,Information-Communication,1,Construction Morphologique,1,Alterations,8,430,2,QCU,0.13,1.0,76.64,36,11,47,42,36,6,1.12,85.71,Facile,Facile,0,Meme Difficulte que la Prediction,Pas Adapte
1495,2016,Information-Communication,1,Construction Morphologique,1,Alterations,8,430,2,QCU,0.51,0.29,23.09,12,39,51,24,12,12,2.12,50.0,Difficile,Difficile,0,Meme Difficulte que la Prediction,Pas Adapte
2561,2017,Information-Communication,1,Construction Morphologique,1,Alterations,8,430,2,QCM,0.28,0.46,42.58,20,26,46,40,20,20,1.15,50.0,Moyen,Moyen,0,Meme Difficulte que la Prediction,Pas Adapte
3627,2018,Information-Communication,1,Construction Morphologique,1,Alterations,8,430,2,QCM,0.13,0.92,90.4,36,4,40,38,36,2,1.05,94.74,Difficile,Facile,2,Beaucoup plus Facile que la Prediction,Pas Adapte
4693,2019,Information-Communication,1,Construction Morphologique,1,Alterations,8,430,2,QCM,0.01,0.96,75.58,27,9,36,34,27,7,1.06,79.41,Facile,Facile,0,Meme Difficulte que la Prediction,Pas Adapte
5759,2020,Information-Communication,1,Construction Morphologique,1,Alterations,8,430,2,QCM,0.77,0.2,6.55,2,34,36,22,2,20,1.64,9.09,Facile,Difficile,-2,Beaucoup plus Difficile que la Prediction,Pas Adapte
430,2015,Information-Communication,1,Construction Morphologique,1,Alterations,8,431,3,QCM,0.29,0.58,49.24,38,39,77,47,38,9,1.64,80.85,Facile,Moyen,-1,Plus Difficile que la Prediction,Pas Adapte
1496,2016,Information-Communication,1,Construction Morphologique,1,Alterations,8,431,3,QCM,0.21,0.52,58.12,44,32,76,49,44,5,1.55,89.8,Moyen,Moyen,0,Meme Difficulte que la Prediction,Pas Adapte
2562,2017,Information-Communication,1,Construction Morphologique,1,Alterations,8,431,3,QCM,0.36,0.43,61.08,44,28,72,54,44,10,1.33,81.48,Difficile,Moyen,1,Plus Facile que la Prediction,Adapte
3628,2018,Information-Communication,1,Construction Morphologique,1,Alterations,8,431,3,QCM,0.46,0.41,61.08,48,31,79,70,48,22,1.13,68.57,Moyen,Moyen,0,Meme Difficulte que la Prediction,Adapte
4694,2019,Information-Communication,1,Construction Morphologique,1,Alterations,8,431,3,QCM,0.41,0.34,61.08,42,26,68,54,42,12,1.26,77.78,Moyen,Moyen,0,Meme Difficulte que la Prediction,Adapte
5760,2020,Information-Communication,1,Construction Morphologique,1,Alterations,8,431,3,QCM,0.35,0.58,61.08,37,23,60,38,37,1,1.58,97.37,Moyen,Moyen,0,Meme Difficulte que la Prediction,Adapte
431,2015,Information-Communication,1,Construction Morphologique,1,Alterations,8,432,4,QCM,0.02,0.75,85.05,65,11,76,68,65,3,1.12,95.59,Facile,Facile,0,Meme Difficulte que la Prediction,Pas Adapte
1497,2016,Information-Communication,1,Construction Morphologique,1,Alterations,8,432,4,QROC,0.19,0.7,70.13,46,20,66,56,46,10,1.18,82.14,Facile,Facile,0,Meme Difficulte que la Prediction,Adapte
2563,2017,Information-Communication,1,Construction Morphologique,1,Alterations,8,432,4,QROC,0.15,0.94,70.13,50,21,71,58,50,8,1.22,86.21,Facile,Facile,0,Meme Difficulte que la Prediction,Adapte
3629,2018,Information-Communication,1,Construction Morphologique,1,Alterations,8,432,4,QROC,0.02,0.5,70.13,48,21,69,58,48,10,1.19,82.76,Facile,Facile,0,Meme Difficulte que la Prediction,Adapte
4695,2019,Information-Communication,1,Construction Morphologique,1,Alterations,8,432,4,QROC,0.14,0.81,70.13,41,18,59,53,41,12,1.11,77.36,Facile,Facile,0,Meme Difficulte que la Prediction,Adapte
5761,2020,Information-Communication,1,Construction Morphologique,1,Alterations,8,432,4,QROC,0.13,0.85,70.13,46,20,66,61,46,15,1.08,75.41,Facile,Facile,0,Meme Difficulte que la Prediction,Adapte
432,2015,Information-Communication,1,Construction Morphologique,1,Alterations,8,433,5,QROC,0.47,0.36,42.57,17,23,40,36,17,19,1.11,47.22,Moyen,Moyen,0,Meme Difficulte que la Prediction,Pas Adapte
1498,2016,Information-Communication,1,Construction Morphologique,1,Alterations,8,433,5,QROC,0.88,0.16,12.7,4,30,34,14,4,10,2.43,28.57,Difficile,Difficile,0,Meme Difficulte que la Prediction,Pas Adapte
2564,2017,Information-Communication,1,Construction Morphologique,1,Alterations,8,433,5,QROC,0.12,0.94,93.68,30,2,32,31,30,1,1.03,96.77,Facile,Facile,0,Meme Difficulte que la Prediction,Pas Adapte
3630,2018,Information-Communication,1,Construction Morphologique,1,Alterations,8,433,5,QROC,0.75,0.18,27.73,9,22,31,26,9,17,1.19,34.62,Facile,Difficile,-2,Beaucoup plus Difficile que la Prediction,Pas Adapte
4696,2019,Information-Communication,1,Construction Morphologique,1,Alterations,8,433,5,QROC,0.53,0.32,36.78,12,21,33,17,12,5,1.94,70.59,Moyen,Moyen,0,Meme Difficulte que la Prediction,Pas Adapte
5762,2020,Information-Communication,1,Construction Morphologique,1,Alterations,8,433,5,QROC,0.09,0.9,90.33,26,3,29,29,26,3,1.0,89.66,Facile,Facile,0,Meme Difficulte que la Prediction,Pas Adapte
433,2015,Information-Communication,1,Construction Morphologique,1,Alterations,8,434,6,QCM,0.16,0.79,69.6,44,19,63,45,44,1,1.4,97.78,Difficile,Facile,2,Beaucoup plus Facile que la Prediction,Adapte
1499,2016,Information-Communication,1,Construction Morphologique,1,Alterations,8,434,6,QCM,0.02,0.73,69.6,42,18,60,49,42,7,1.22,85.71,Facile,Facile,0,Meme Difficulte que la Prediction,Adapte
2565,2017,Information-Communication,1,Construction Morphologique,1,Alterations,8,434,6,QCM,0.11,0.85,69.6,36,16,52,44,36,8,1.18,81.82,Facile,Facile,0,Meme Difficulte que la Prediction,Adapte
3631,2018,Information-Communication,1,Construction Morphologique,1,Alterations,8,434,6,QCM,0.03,0.79,69.6,34,15,49,36,34,2,1.36,94.44,Facile,Facile,0,Meme Difficulte que la Prediction,Adapte
4697,2019,Information-Communication,1,Construction Morphologique,1,Alterations,8,434,6,QCM,0.09,0.73,69.6,30,13,43,40,30,10,1.07,75.0,Facile,Facile,0,Meme Difficulte que la Prediction,Adapte
5763,2020,Information-Communication,1,Construction Morphologique,1,Alterations,8,434,6,QCM,0.03,0.99,69.6,26,11,37,26,26,0,1.42,100.0,Facile,Facile,0,Meme Difficulte que la Prediction,Adapte
434,2015,Information-Communication,1,Construction Morphologique,1,Alterations,8,435,7,QCM,0.45,0.69,36.52,12,20,32,27,12,15,1.19,44.44,Moyen,Moyen,0,Meme Difficulte que la Prediction,Pas Adapte
1500,2016,Information-Communication,1,Construction Morphologique,1,Alterations,8,435,7,QCM,0.39,0.45,38.2,11,17,28,27,11,16,1.04,40.74,Moyen,Moyen,0,Meme Difficulte que la Prediction,Pas Adapte
2566,2017,Information-Communication,1,Construction Morphologique,1,Alterations,8,435,7,QCM,0.53,0.22,22.87,5,19,24,22,5,17,1.09,22.73,Facile,Difficile,-2,Beaucoup plus Difficile que la Prediction,Pas Adapte
3632,2018,Information-Communication,1,Construction Morphologique,1,Alterations,8,435,7,QCM,0.76,0.19,18.21,4,19,23,6,4,2,3.83,66.67,Difficile,Difficile,0,Meme Difficulte que la Prediction,Pas Adapte
4698,2019,Information-Communication,1,Construction Morphologique,1,Alterations,8,435,7,QCM,0.08,0.85,79.29,16,4,20,18,16,2,1.11,88.89,Facile,Facile,0,Meme Difficulte que la Prediction,Pas Adapte
5764,2020,Information-Communication,1,Construction Morphologique,1,Alterations,8,435,7,QCM,0.69,0.2,23.79,5,16,21,19,5,14,1.11,26.32,Difficile,Difficile,0,Meme Difficulte que la Prediction,Pas Adapte
435,2015,Information-Communication,1,Construction Morphologique,1,Alterations,8,436,8,QCM,0.16,0.94,86.43,6,1,7,6,6,0,1.17,100.0,Facile,Facile,0,Meme Difficulte que la Prediction,Pas Adapte
1501,2016,Information-Communication,1,Construction Morphologique,1,Alterations,8,436,8,QCM,0.33,0.45,37.44,3,5,8,5,3,2,1.6,60.0,Moyen,Moyen,0,Meme Difficulte que la Prediction,Pas Adapte
2567,2017,Information-Communication,1,Construction Morphologique,1,Alterations,8,436,8,QCM,0.03,0.83,85.01,6,1,7,6,6,0,1.17,100.0,Facile,Facile,0,Meme Difficulte que la Prediction,Pas Adapte
3633,2018,Information-Communication,1,Construction Morphologique,1,Alterations,8,436,8,QCM,0.15,0.71,67.28,5,2,7,6,5,1,1.17,83.33,Facile,Facile,0,Meme Difficulte que la Prediction,Adapte
4699,2019,Information-Communication,1,Construction Morphologique,1,Alterations,8,436,8,QCM,0.06,0.78,67.28,5,3,8,5,5,0,1.6,100.0,Facile,Facile,0,Meme Difficulte que la Prediction,Adapte
5765,2020,Information-Communication,1,Construction Morphologique,1,Alterations,8,436,8,QCM,0.09,0.76,67.28,5,2,7,6,5,1,1.17,83.33,Facile,Facile,0,Meme Difficulte que la Prediction,Adapte
436,2015,Information-Communication,1,Construction Morphologique,2,Transferts,3,437,1,QCM,0.08,0.79,92.89,69,5,74,69,69,0,1.07,100.0,Facile,Facile,0,Meme Difficulte que la Prediction,Pas Adapte
1502,2016,Information-Communication,1,Construction Morphologique,2,Transferts,3,437,1,QROC,0.15,0.66,95.74,62,3,65,64,62,2,1.02,96.88,Facile,Facile,0,Meme Difficulte que la Prediction,Pas Adapte
2568,2017,Information-Communication,1,Construction Morphologique,2,Transferts,3,437,1,QROC,0.64,0.07,15.29,10,54,64,47,10,37,1.36,21.28,Difficile,Difficile,0,Meme Difficulte que la Prediction,Pas Adapte
3634,2018,Information-Communication,1,Construction Morphologique,2,Transferts,3,437,1,QROC,0.16,0.98,73.53,50,18,68,62,50,12,1.1,80.65,Facile,Facile,0,Meme Difficulte que la Prediction,Adapte
4700,2019,Information-Communication,1,Construction Morphologique,2,Transferts,3,437,1,QO,0.07,0.5,73.53,54,20,74,70,54,16,1.06,77.14,Facile,Facile,0,Meme Difficulte que la Prediction,Adapte
5766,2020,Information-Communication,1,Construction Morphologique,2,Transferts,3,437,1,QROC,0.06,0.61,73.53,46,17,63,54,46,8,1.17,85.19,Facile,Facile,0,Meme Difficulte que la Prediction,Adapte
437,2015,Information-Communication,1,Construction Morphologique,2,Transferts,3,438,2,QCM,0.04,0.9,94.6,28,2,30,28,28,0,1.07,100.0,Facile,Facile,0,Meme Difficulte que la Prediction,Pas Adapte
1503,2016,Information-Communication,1,Construction Morphologique,2,Transferts,3,438,2,QCM,0.18,0.71,77.13,26,8,34,29,26,3,1.17,89.66,Moyen,Facile,1,Plus Facile que la Prediction,Pas Adapte
2569,2017,Information-Communication,1,Construction Morphologique,2,Transferts,3,438,2,QCM,0.77,0.18,26.76,10,26,36,30,10,20,1.2,33.33,Difficile,Difficile,0,Meme Difficulte que la Prediction,Pas Adapte
3635,2018,Information-Communication,1,Construction Morphologique,2,Transferts,3,438,2,QCM,0.05,0.96,67.51,27,13,40,34,27,7,1.18,79.41,Facile,Facile,0,Meme Difficulte que la Prediction,Adapte
4701,2019,Information-Communication,1,Construction Morphologique,2,Transferts,3,438,2,QCM,0.14,0.97,67.51,24,11,35,35,24,11,1.0,68.57,Facile,Facile,0,Meme Difficulte que la Prediction,Adapte
5767,2020,Information-Communication,1,Construction Morphologique,2,Transferts,3,438,2,QCU,0.03,0.92,67.51,27,13,40,30,27,3,1.33,90.0,Facile,Facile,0,Meme Difficulte que la Prediction,Adapte
438,2015,Information-Communication,1,Construction Morphologique,2,Transferts,3,439,3,QCU,0.56,0.27,22.53,17,60,77,40,17,23,1.93,42.5,Difficile,Difficile,0,Meme Difficulte que la Prediction,Pas Adapte
1504,2016,Information-Communication,1,Construction Morphologique,2,Transferts,3,439,3,QCM,0.17,0.75,98.83,78,1,79,79,78,1,1.0,98.73,Facile,Facile,0,Meme Difficulte que la Prediction,Pas Adapte
2570,2017,Information-Communication,1,Construction Morphologique,2,Transferts,3,439,3,QCM,0.64,0.24,27.79,22,58,80,77,22,55,1.04,28.57,Moyen,Difficile,-1,Plus Difficile que la Prediction,Pas Adapte
3636,2018,Information-Communication,1,Construction Morphologique,2,Transferts,3,439,3,QCM,0.64,0.24,18.02,15,67,82,34,15,19,2.41,44.12,Moyen,Difficile,-1,Plus Difficile que la Prediction,Pas Adapte
4702,2019,Information-Communication,1,Construction Morphologique,2,Transferts,3,439,3,QCM,0.23,0.64,44.38,40,50,90,67,40,27,1.34,59.7,Difficile,Moyen,1,Plus Facile que la Prediction,Pas Adapte
5768,2020,Information-Communication,1,Construction Morphologique,2,Transferts,3,439,3,QCM,0.27,0.58,61.82,54,34,88,84,54,30,1.05,64.29,Moyen,Moyen,0,Meme Difficulte que la Prediction,Adapte
439,2015,Information-Communication,1,Construction Morphologique,3,Sens Predictible et Atteste,9,440,1,QCU,0.66,0.29,24.98,15,46,61,41,15,26,1.49,36.59,Difficile,Difficile,0,Meme Difficulte que la Prediction,Pas Adapte
1505,2016,Information-Communication,1,Construction Morphologique,3,Sens Predictible et Atteste,9,440,1,QCU,0.17,0.92,67.25,46,22,68,62,46,16,1.1,74.19,Moyen,Facile,1,Plus Facile que la Prediction,Adapte
2571,2017,Information-Communication,1,Construction Morphologique,3,Sens Predictible et Atteste,9,440,1,QCU,0.11,0.88,67.25,44,21,65,63,44,19,1.03,69.84,Facile,Facile,0,Meme Difficulte que la Prediction,Adapte
3637,2018,Information-Communication,1,Construction Morphologique,3,Sens Predictible et Atteste,9,440,1,QCU,0.02,0.78,67.25,38,18,56,55,38,17,1.02,69.09,Facile,Facile,0,Meme Difficulte que la Prediction,Adapte
4703,2019,Information-Communication,1,Construction Morphologique,3,Sens Predictible et Atteste,9,440,1,QCU,0.14,0.77,67.25,42,20,62,43,42,1,1.44,97.67,Facile,Facile,0,Meme Difficulte que la Prediction,Adapte
5769,2020,Information-Communication,1,Construction Morphologique,3,Sens Predictible et Atteste,9,440,1,QCM,0.18,0.98,67.25,43,21,64,59,43,16,1.08,72.88,Facile,Facile,0,Meme Difficulte que la Prediction,Adapte
440,2015,Information-Communication,1,Construction Morphologique,3,Sens Predictible et Atteste,9,441,2,QROC,0.68,0.01,15.62,1,8,9,5,1,4,1.8,20.0,Difficile,Difficile,0,Meme Difficulte que la Prediction,Pas Adapte
1506,2016,Information-Communication,1,Construction Morphologique,3,Sens Predictible et Atteste,9,441,2,QROC,0.4,0.29,51.31,4,4,8,7,4,3,1.14,57.14,Difficile,Moyen,1,Plus Facile que la Prediction,Pas Adapte
2572,2017,Information-Communication,1,Construction Morphologique,3,Sens Predictible et Atteste,9,441,2,QROC,0.95,0.21,4.05,0,9,9,6,0,6,1.5,0.0,Difficile,Difficile,0,Meme Difficulte que la Prediction,Pas Adapte
3638,2018,Information-Communication,1,Construction Morphologique,3,Sens Predictible et Atteste,9,441,2,QROC,0.04,0.98,78.74,6,2,8,7,6,1,1.14,85.71,Facile,Facile,0,Meme Difficulte que la Prediction,Pas Adapte
4704,2019,Information-Communication,1,Construction Morphologique,3,Sens Predictible et Atteste,9,441,2,QROC,0.9,0.0,13.3,1,7,8,6,1,5,1.33,16.67,Difficile,Difficile,0,Meme Difficulte que la Prediction,Pas Adapte
5770,2020,Information-Communication,1,Construction Morphologique,3,Sens Predictible et Atteste,9,441,2,QROC,0.77,0.12,8.56,1,8,9,6,1,5,1.5,16.67,Difficile,Difficile,0,Meme Difficulte que la Prediction,Pas Adapte
441,2015,Information-Communication,1,Construction Morphologique,3,Sens Predictible et Atteste,9,442,3,QCU,0.29,0.58,41.4,14,20,34,19,14,5,1.79,73.68,Moyen,Moyen,0,Meme Difficulte que la Prediction,Pas Adapte
1507,2016,Information-Communication,1,Construction Morphologique,3,Sens Predictible et Atteste,9,442,3,QCU,0.39,0.74,48.93,15,15,30,18,15,3,1.67,83.33,Facile,Moyen,-1,Plus Difficile que la Prediction,Pas Adapte
2573,2017,Information-Communication,1,Construction Morphologique,3,Sens Predictible et Atteste,9,442,3,QCU,0.33,0.52,45.5,12,15,27,14,12,2,1.93,85.71,Moyen,Moyen,0,Meme Difficulte que la Prediction,Pas Adapte
3639,2018,Information-Communication,1,Construction Morphologique,3,Sens Predictible et Atteste,9,442,3,QCU,0.34,0.49,46.91,15,16,31,18,15,3,1.72,83.33,Moyen,Moyen,0,Meme Difficulte que la Prediction,Pas Adapte
4705,2019,Information-Communication,1,Construction Morphologique,3,Sens Predictible et Atteste,9,442,3,QCU,0.21,0.74,59.84,16,11,27,23,16,7,1.17,69.57,Facile,Moyen,-1,Plus Difficile que la Prediction,Pas Adapte
5771,2020,Information-Communication,1,Construction Morphologique,3,Sens Predictible et Atteste,9,442,3,QCU,0.44,0.39,21.93,5,19,24,14,5,9,1.71,35.71,Difficile,Difficile,0,Meme Difficulte que la Prediction,Pas Adapte
442,2015,Information-Communication,1,Construction Morphologique,3,Sens Predictible et Atteste,9,443,4,QCM,0.28,0.65,53.54,18,15,33,28,18,10,1.18,64.29,Difficile,Moyen,1,Plus Facile que la Prediction,Pas Adapte
1508,2016,Information-Communication,1,Construction Morphologique,3,Sens Predictible et Atteste,9,443,4,QCM,0.31,0.67,36.45,11,20,31,24,11,13,1.29,45.83,Moyen,Moyen,0,Meme Difficulte que la Prediction,Pas Adapte
2574,2017,Information-Communication,1,Construction Morphologique,3,Sens Predictible et Atteste,9,443,4,QCU,0.55,0.2,18.74,5,22,27,23,5,18,1.17,21.74,Difficile,Difficile,0,Meme Difficulte que la Prediction,Pas Adapte
3640,2018,Information-Communication,1,Construction Morphologique,3,Sens Predictible et Atteste,9,443,4,QCU,0.06,0.81,92.42,27,2,29,28,27,1,1.04,96.43,Difficile,Facile,2,Beaucoup plus Facile que la Prediction,Pas Adapte
4706,2019,Information-Communication,1,Construction Morphologique,3,Sens Predictible et Atteste,9,443,4,QCU,0.53,0.22,33.55,10,20,30,29,10,19,1.03,34.48,Moyen,Difficile,-1,Plus Difficile que la Prediction,Pas Adapte
5772,2020,Information-Communication,1,Construction Morphologique,3,Sens Predictible et Atteste,9,443,4,QCU,0.27,0.75,48.64,15,16,31,30,15,15,1.03,50.0,Moyen,Moyen,0,Meme Difficulte que la Prediction,Pas Adapte
443,2015,Information-Communication,1,Construction Morphologique,3,Sens Predictible et Atteste,9,444,5,QCU,0.57,0.37,8.8,7,78,85,84,7,77,1.01,8.33,Moyen,Difficile,-1,Plus Difficile que la Prediction,Pas Adapte
1509,2016,Information-Communication,1,Construction Morphologique,3,Sens Predictible et Atteste,9,444,5,QCU,0.39,0.71,40.19,37,54,91,65,37,28,1.4,56.92,Difficile,Moyen,1,Plus Facile que la Prediction,Pas Adapte
2575,2017,Information-Communication,1,Construction Morphologique,3,Sens Predictible et Atteste,9,444,5,QCU,0.37,0.64,42.87,41,54,95,62,41,21,1.53,66.13,Moyen,Moyen,0,Meme Difficulte que la Prediction,Pas Adapte
3641,2018,Information-Communication,1,Construction Morphologique,3,Sens Predictible et Atteste,9,444,5,QCU,0.03,0.89,91.04,78,8,86,83,78,5,1.04,93.98,Facile,Facile,0,Meme Difficulte que la Prediction,Pas Adapte
4707,2019,Information-Communication,1,Construction Morphologique,3,Sens Predictible et Atteste,9,444,5,QCU,0.17,0.94,99.93,83,0,83,83,83,0,1.0,100.0,Facile,Facile,0,Meme Difficulte que la Prediction,Pas Adapte
5773,2020,Information-Communication,1,Construction Morphologique,3,Sens Predictible et Atteste,9,444,5,QCU,0.02,0.97,79.83,65,17,82,81,65,16,1.01,80.25,Difficile,Facile,2,Beaucoup plus Facile que la Prediction,Pas Adapte
444,2015,Information-Communication,1,Construction Morphologique,3,Sens Predictible et Atteste,9,445,6,QCU,0.65,0.22,18.01,1,7,8,6,1,5,1.33,16.67,Facile,Difficile,-2,Beaucoup plus Difficile que la Prediction,Pas Adapte
1510,2016,Information-Communication,1,Construction Morphologique,3,Sens Predictible et Atteste,9,445,6,QCU,0.4,0.4,10.33,1,8,9,5,1,4,1.8,20.0,Facile,Difficile,-2,Beaucoup plus Difficile que la Prediction,Pas Adapte
2576,2017,Information-Communication,1,Construction Morphologique,3,Sens Predictible et Atteste,9,445,6,QCU,0.14,0.79,80.9,8,2,10,10,8,2,1.0,80.0,Facile,Facile,0,Meme Difficulte que la Prediction,Pas Adapte
3642,2018,Information-Communication,1,Construction Morphologique,3,Sens Predictible et Atteste,9,445,6,QCM,0.14,0.85,65.46,7,3,10,9,7,2,1.11,77.78,Facile,Facile,0,Meme Difficulte que la Prediction,Adapte
4708,2019,Information-Communication,1,Construction Morphologique,3,Sens Predictible et Atteste,9,445,6,QCM,0.2,0.84,65.46,5,3,8,8,5,3,1.0,62.5,Facile,Facile,0,Meme Difficulte que la Prediction,Adapte
5774,2020,Information-Communication,1,Construction Morphologique,3,Sens Predictible et Atteste,9,445,6,QCM,0.11,0.97,65.46,5,2,7,6,5,1,1.17,83.33,Facile,Facile,0,Meme Difficulte que la Prediction,Adapte
445,2015,Information-Communication,1,Construction Morphologique,3,Sens Predictible et Atteste,9,446,7,QCU,0.46,0.38,10.0,1,8,9,4,1,3,2.25,25.0,Facile,Difficile,-2,Beaucoup plus Difficile que la Prediction,Pas Adapte
1511,2016,Information-Communication,1,Construction Morphologique,3,Sens Predictible et Atteste,9,446,7,QROC,0.64,0.17,21.33,2,6,8,5,2,3,1.6,40.0,Facile,Difficile,-2,Beaucoup plus Difficile que la Prediction,Pas Adapte
2577,2017,Information-Communication,1,Construction Morphologique,3,Sens Predictible et Atteste,9,446,7,QO,0.82,0.14,24.28,2,5,7,6,2,4,1.17,33.33,Difficile,Difficile,0,Meme Difficulte que la Prediction,Pas Adapte
3643,2018,Information-Communication,1,Construction Morphologique,3,Sens Predictible et Atteste,9,446,7,QCM,0.01,0.91,78.3,5,2,7,6,5,1,1.17,83.33,Facile,Facile,0,Meme Difficulte que la Prediction,Pas Adapte
4709,2019,Information-Communication,1,Construction Morphologique,3,Sens Predictible et Atteste,9,446,7,QCM,0.69,0.24,24.51,2,5,7,5,2,3,1.4,40.0,Difficile,Difficile,0,Meme Difficulte que la Prediction,Pas Adapte
5775,2020,Information-Communication,1,Construction Morphologique,3,Sens Predictible et Atteste,9,446,7,QROC,0.95,0.22,5.99,0,8,8,7,0,7,1.14,0.0,Difficile,Difficile,0,Meme Difficulte que la Prediction,Pas Adapte
446,2015,Information-Communication,1,Construction Morphologique,3,Sens Predictible et Atteste,9,447,8,QCM,0.01,0.74,96.81,9,0,9,9,9,0,1.0,100.0,Facile,Facile,0,Meme Difficulte que la Prediction,Pas Adapte
1512,2016,Information-Communication,1,Construction Morphologique,3,Sens Predictible et Atteste,9,447,8,QCM,0.15,0.98,92.46,7,1,8,7,7,0,1.14,100.0,Facile,Facile,0,Meme Difficulte que la Prediction,Pas Adapte
2578,2017,Information-Communication,1,Construction Morphologique,3,Sens Predictible et Atteste,9,447,8,QCM,0.53,0.15,9.41,1,7,8,4,1,3,2.0,25.0,Difficile,Difficile,0,Meme Difficulte que la Prediction,Pas Adapte
3644,2018,Information-Communication,1,Construction Morphologique,3,Sens Predictible et Atteste,9,447,8,QCU,0.44,0.38,29.07,2,6,8,7,2,5,1.14,28.57,Difficile,Difficile,0,Meme Difficulte que la Prediction,Pas Adapte
4710,2019,Information-Communication,1,Construction Morphologique,3,Sens Predictible et Atteste,9,447,8,QCU,0.2,0.63,57.24,4,3,7,5,4,1,1.4,80.0,Difficile,Moyen,1,Plus Facile que la Prediction,Pas Adapte
5776,2020,Information-Communication,1,Construction Morphologique,3,Sens Predictible et Atteste,9,447,8,QCU,0.28,0.71,50.91,4,4,8,7,4,3,1.14,57.14,Moyen,Moyen,0,Meme Difficulte que la Prediction,Pas Adapte
447,2015,Information-Communication,1,Construction Morphologique,3,Sens Predictible et Atteste,9,448,9,QCM,0.14,0.81,92.63,44,4,48,46,44,2,1.04,95.65,Moyen,Facile,1,Plus Facile que la Prediction,Pas Adapte
1513,2016,Information-Communication,1,Construction Morphologique,3,Sens Predictible et Atteste,9,448,9,QCM,0.33,0.65,54.96,23,18,41,31,23,8,1.32,74.19,Moyen,Moyen,0,Meme Difficulte que la Prediction,Pas Adapte
2579,2017,Information-Communication,1,Construction Morphologique,3,Sens Predictible et Atteste,9,448,9,QCU,0.18,1.0,77.88,34,10,44,34,34,0,1.29,100.0,Facile,Facile,0,Meme Difficulte que la Prediction,Pas Adapte
3645,2018,Information-Communication,1,Construction Morphologique,3,Sens Predictible et Atteste,9,448,9,QCU,0.25,0.6,45.16,21,25,46,32,21,11,1.44,65.62,Moyen,Moyen,0,Meme Difficulte que la Prediction,Pas Adapte
4711,2019,Information-Communication,1,Construction Morphologique,3,Sens Predictible et Atteste,9,448,9,QCU,0.36,0.66,54.71,27,23,50,36,27,9,1.39,75.0,Moyen,Moyen,0,Meme Difficulte que la Prediction,Pas Adapte
5777,2020,Information-Communication,1,Construction Morphologique,3,Sens Predictible et Atteste,9,448,9,QCU,0.62,0.39,0.09,0,42,42,33,0,33,1.27,0.0,Difficile,Difficile,0,Meme Difficulte que la Prediction,Pas Adapte
448,2015,Informatique,1,Generalites sur les Systeme Informatiques,1,Definitions et Vocabulaire de Base,3,449,1,QCU,0.62,0.25,29.23,22,52,74,54,22,32,1.37,40.74,Difficile,Difficile,0,Meme Difficulte que la Prediction,Pas Adapte
1514,2016,Informatique,1,Generalites sur les Systeme Informatiques,1,Definitions et Vocabulaire de Base,3,449,1,QCU,0.39,0.66,55.99,38,30,68,42,38,4,1.62,90.48,Difficile,Moyen,1,Plus Facile que la Prediction,Pas Adapte
2580,2017,Informatique,1,Generalites sur les Systeme Informatiques,1,Definitions et Vocabulaire de Base,3,449,1,QCU,0.32,0.56,60.22,44,29,73,69,44,25,1.06,63.77,Moyen,Moyen,0,Meme Difficulte que la Prediction,Adapte
3646,2018,Informatique,1,Generalites sur les Systeme Informatiques,1,Definitions et Vocabulaire de Base,3,449,1,QCU,0.28,0.4,60.22,45,30,75,69,45,24,1.09,65.22,Moyen,Moyen,0,Meme Difficulte que la Prediction,Adapte
4712,2019,Informatique,1,Generalites sur les Systeme Informatiques,1,Definitions et Vocabulaire de Base,3,449,1,QCU,0.25,0.68,60.22,51,33,84,83,51,32,1.01,61.45,Moyen,Moyen,0,Meme Difficulte que la Prediction,Adapte
5778,2020,Informatique,1,Generalites sur les Systeme Informatiques,1,Definitions et Vocabulaire de Base,3,449,1,QCM,0.37,0.45,60.22,55,36,91,91,55,36,1.0,60.44,Moyen,Moyen,0,Meme Difficulte que la Prediction,Adapte
449,2015,Informatique,1,Generalites sur les Systeme Informatiques,1,Definitions et Vocabulaire de Base,3,450,2,QCM,0.59,0.16,18.28,3,11,14,12,3,9,1.17,25.0,Moyen,Difficile,-1,Plus Difficile que la Prediction,Pas Adapte
1515,2016,Informatique,1,Generalites sur les Systeme Informatiques,1,Definitions et Vocabulaire de Base,3,450,2,QCM,0.07,1.0,88.6,14,2,16,16,14,2,1.0,87.5,Facile,Facile,0,Meme Difficulte que la Prediction,Pas Adapte
2581,2017,Informatique,1,Generalites sur les Systeme Informatiques,1,Definitions et Vocabulaire de Base,3,450,2,QCM,0.76,0.22,17.3,3,12,15,5,3,2,3.0,60.0,Difficile,Difficile,0,Meme Difficulte que la Prediction,Pas Adapte
3647,2018,Informatique,1,Generalites sur les Systeme Informatiques,1,Definitions et Vocabulaire de Base,3,450,2,QROC,0.15,0.49,86.77,11,2,13,13,11,2,1.0,84.62,Facile,Facile,0,Meme Difficulte que la Prediction,Pas Adapte
4713,2019,Informatique,1,Generalites sur les Systeme Informatiques,1,Definitions et Vocabulaire de Base,3,450,2,QO,0.18,0.86,76.98,8,3,11,9,8,1,1.22,88.89,Facile,Facile,0,Meme Difficulte que la Prediction,Pas Adapte
5779,2020,Informatique,1,Generalites sur les Systeme Informatiques,1,Definitions et Vocabulaire de Base,3,450,2,QO,0.7,0.19,58.51,6,4,10,7,6,1,1.43,85.71,Facile,Moyen,-1,Plus Difficile que la Prediction,Pas Adapte
450,2015,Informatique,1,Generalites sur les Systeme Informatiques,1,Definitions et Vocabulaire de Base,3,451,3,QCU,0.31,0.74,50.05,13,12,25,19,13,6,1.32,68.42,Moyen,Moyen,0,Meme Difficulte que la Prediction,Pas Adapte
1516,2016,Informatique,1,Generalites sur les Systeme Informatiques,1,Definitions et Vocabulaire de Base,3,451,3,QCU,0.36,0.72,53.18,15,13,28,23,15,8,1.22,65.22,Difficile,Moyen,1,Plus Facile que la Prediction,Pas Adapte
2582,2017,Informatique,1,Generalites sur les Systeme Informatiques,1,Definitions et Vocabulaire de Base,3,451,3,QCU,0.61,0.37,28.56,8,21,29,20,8,12,1.45,40.0,Difficile,Difficile,0,Meme Difficulte que la Prediction,Pas Adapte
3648,2018,Informatique,1,Generalites sur les Systeme Informatiques,1,Definitions et Vocabulaire de Base,3,451,3,QCU,0.05,0.95,70.78,21,8,29,28,21,7,1.04,75.0,Facile,Facile,0,Meme Difficulte que la Prediction,Adapte
4714,2019,Informatique,1,Generalites sur les Systeme Informatiques,1,Definitions et Vocabulaire de Base,3,451,3,QCU,0.12,0.98,70.78,20,8,28,21,20,1,1.33,95.24,Facile,Facile,0,Meme Difficulte que la Prediction,Adapte
5780,2020,Informatique,1,Generalites sur les Systeme Informatiques,1,Definitions et Vocabulaire de Base,3,451,3,QCU,0.16,0.95,70.78,23,9,32,31,23,8,1.03,74.19,Facile,Facile,0,Meme Difficulte que la Prediction,Adapte
451,2015,Informatique,1,Generalites sur les Systeme Informatiques,2,Structure de l'Ordinateur,11,452,1,QCM,0.03,0.86,82.36,33,7,40,37,33,4,1.08,89.19,Facile,Facile,0,Meme Difficulte que la Prediction,Pas Adapte
1517,2016,Informatique,1,Generalites sur les Systeme Informatiques,2,Structure de l'Ordinateur,11,452,1,QCM,0.13,0.78,66.15,30,15,45,44,30,14,1.02,68.18,Facile,Facile,0,Meme Difficulte que la Prediction,Adapte
2583,2017,Informatique,1,Generalites sur les Systeme Informatiques,2,Structure de l'Ordinateur,11,452,1,QCM,0.02,0.81,66.15,32,16,48,36,32,4,1.33,88.89,Facile,Facile,0,Meme Difficulte que la Prediction,Adapte
3649,2018,Informatique,1,Generalites sur les Systeme Informatiques,2,Structure de l'Ordinateur,11,452,1,QCM,0.19,0.7,66.15,34,17,51,39,34,5,1.31,87.18,Facile,Facile,0,Meme Difficulte que la Prediction,Adapte
4715,2019,Informatique,1,Generalites sur les Systeme Informatiques,2,Structure de l'Ordinateur,11,452,1,QCM,0.09,0.93,66.15,32,17,49,37,32,5,1.32,86.49,Facile,Facile,0,Meme Difficulte que la Prediction,Adapte
5781,2020,Informatique,1,Generalites sur les Systeme Informatiques,2,Structure de l'Ordinateur,11,452,1,QCM,0.1,0.72,66.15,36,18,54,40,36,4,1.35,90.0,Facile,Facile,0,Meme Difficulte que la Prediction,Adapte
452,2015,Informatique,1,Generalites sur les Systeme Informatiques,2,Structure de l'Ordinateur,11,453,2,QCU,0.59,0.27,33.22,20,41,61,59,20,39,1.03,33.9,Difficile,Difficile,0,Meme Difficulte que la Prediction,Pas Adapte
1518,2016,Informatique,1,Generalites sur les Systeme Informatiques,2,Structure de l'Ordinateur,11,453,2,QCU,0.0,0.85,71.8,46,18,64,48,46,2,1.33,95.83,Facile,Facile,0,Meme Difficulte que la Prediction,Adapte
2584,2017,Informatique,1,Generalites sur les Systeme Informatiques,2,Structure de l'Ordinateur,11,453,2,QCU,0.17,0.93,71.8,49,19,68,62,49,13,1.1,79.03,Facile,Facile,0,Meme Difficulte que la Prediction,Adapte
3650,2018,Informatique,1,Generalites sur les Systeme Informatiques,2,Structure de l'Ordinateur,11,453,2,QCM,0.15,0.81,71.8,52,20,72,56,52,4,1.29,92.86,Facile,Facile,0,Meme Difficulte que la Prediction,Adapte
4716,2019,Informatique,1,Generalites sur les Systeme Informatiques,2,Structure de l'Ordinateur,11,453,2,QCM,0.13,0.74,71.8,55,21,76,68,55,13,1.12,80.88,Facile,Facile,0,Meme Difficulte que la Prediction,Adapte
5782,2020,Informatique,1,Generalites sur les Systeme Informatiques,2,Structure de l'Ordinateur,11,453,2,QCM,0.03,0.84,71.8,48,19,67,50,48,2,1.34,96.0,Facile,Facile,0,Meme Difficulte que la Prediction,Adapte
453,2015,Informatique,1,Generalites sur les Systeme Informatiques,2,Structure de l'Ordinateur,11,454,3,QCM,0.06,0.87,73.64,55,20,75,58,55,3,1.29,94.83,Facile,Facile,0,Meme Difficulte que la Prediction,Adapte
1519,2016,Informatique,1,Generalites sur les Systeme Informatiques,2,Structure de l'Ordinateur,11,454,3,QCM,0.13,0.75,73.64,49,17,66,58,49,9,1.14,84.48,Facile,Facile,0,Meme Difficulte que la Prediction,Adapte
2585,2017,Informatique,1,Generalites sur les Systeme Informatiques,2,Structure de l'Ordinateur,11,454,3,QCM,0.16,0.73,73.64,45,16,61,51,45,6,1.2,88.24,Facile,Facile,0,Meme Difficulte que la Prediction,Adapte
3651,2018,Informatique,1,Generalites sur les Systeme Informatiques,2,Structure de l'Ordinateur,11,454,3,QCM,0.1,0.73,73.64,38,14,52,45,38,7,1.16,84.44,Facile,Facile,0,Meme Difficulte que la Prediction,Adapte
4717,2019,Informatique,1,Generalites sur les Systeme Informatiques,2,Structure de l'Ordinateur,11,454,3,QCM,0.09,0.98,73.64,32,12,44,39,32,7,1.13,82.05,Facile,Facile,0,Meme Difficulte que la Prediction,Adapte
5783,2020,Informatique,1,Generalites sur les Systeme Informatiques,2,Structure de l'Ordinateur,11,454,3,QCM,0.19,0.8,73.64,35,13,48,44,35,9,1.09,79.55,Facile,Facile,0,Meme Difficulte que la Prediction,Adapte
454,2015,Informatique,1,Generalites sur les Systeme Informatiques,2,Structure de l'Ordinateur,11,455,4,QCU,0.5,0.25,8.59,7,72,79,47,7,40,1.68,14.89,Moyen,Difficile,-1,Plus Difficile que la Prediction,Pas Adapte
1520,2016,Informatique,1,Generalites sur les Systeme Informatiques,2,Structure de l'Ordinateur,11,455,4,QCM,0.18,0.79,66.11,56,29,85,79,56,23,1.08,70.89,Facile,Facile,0,Meme Difficulte que la Prediction,Adapte
2586,2017,Informatique,1,Generalites sur les Systeme Informatiques,2,Structure de l'Ordinateur,11,455,4,QCM,0.16,0.95,66.11,60,30,90,87,60,27,1.03,68.97,Facile,Facile,0,Meme Difficulte que la Prediction,Adapte
3652,2018,Informatique,1,Generalites sur les Systeme Informatiques,2,Structure de l'Ordinateur,11,455,4,QCM,0.11,0.93,66.11,58,30,88,60,58,2,1.47,96.67,Facile,Facile,0,Meme Difficulte que la Prediction,Adapte
4718,2019,Informatique,1,Generalites sur les Systeme Informatiques,2,Structure de l'Ordinateur,11,455,4,QCM,0.08,0.95,66.11,59,30,89,88,59,29,1.01,67.05,Facile,Facile,0,Meme Difficulte que la Prediction,Adapte
5784,2020,Informatique,1,Generalites sur les Systeme Informatiques,2,Structure de l'Ordinateur,11,455,4,QCM,0.16,0.78,66.11,52,27,79,58,52,6,1.36,89.66,Facile,Facile,0,Meme Difficulte que la Prediction,Adapte
455,2015,Informatique,1,Generalites sur les Systeme Informatiques,2,Structure de l'Ordinateur,11,456,5,QCM,0.14,0.92,69.04,23,10,33,29,23,6,1.14,79.31,Moyen,Facile,1,Plus Facile que la Prediction,Adapte
1521,2016,Informatique,1,Generalites sur les Systeme Informatiques,2,Structure de l'Ordinateur,11,456,5,QCM,0.19,0.79,69.04,26,11,37,26,26,0,1.42,100.0,Facile,Facile,0,Meme Difficulte que la Prediction,Adapte
2587,2017,Informatique,1,Generalites sur les Systeme Informatiques,2,Structure de l'Ordinateur,11,456,5,QCM,0.15,0.97,69.04,23,10,33,25,23,2,1.32,92.0,Facile,Facile,0,Meme Difficulte que la Prediction,Adapte
3653,2018,Informatique,1,Generalites sur les Systeme Informatiques,2,Structure de l'Ordinateur,11,456,5,QCM,0.03,0.9,69.04,22,10,32,24,22,2,1.33,91.67,Facile,Facile,0,Meme Difficulte que la Prediction,Adapte
4719,2019,Informatique,1,Generalites sur les Systeme Informatiques,2,Structure de l'Ordinateur,11,456,5,QCM,0.04,0.92,69.04,23,10,33,26,23,3,1.27,88.46,Facile,Facile,0,Meme Difficulte que la Prediction,Adapte
5785,2020,Informatique,1,Generalites sur les Systeme Informatiques,2,Structure de l'Ordinateur,11,456,5,QCM,0.12,0.76,69.04,21,10,31,31,21,10,1.0,67.74,Facile,Facile,0,Meme Difficulte que la Prediction,Adapte
456,2015,Informatique,1,Generalites sur les Systeme Informatiques,2,Structure de l'Ordinateur,11,457,6,QROC,0.08,0.63,74.02,67,24,91,88,67,21,1.03,76.14,Difficile,Facile,2,Beaucoup plus Facile que la Prediction,Adapte
1522,2016,Informatique,1,Generalites sur les Systeme Informatiques,2,Structure de l'Ordinateur,11,457,6,QROC,0.03,0.9,74.02,67,24,91,86,67,19,1.06,77.91,Facile,Facile,0,Meme Difficulte que la Prediction,Adapte
2588,2017,Informatique,1,Generalites sur les Systeme Informatiques,2,Structure de l'Ordinateur,11,457,6,QROC,0.09,0.57,74.02,74,26,100,85,74,11,1.18,87.06,Facile,Facile,0,Meme Difficulte que la Prediction,Adapte
3654,2018,Informatique,1,Generalites sur les Systeme Informatiques,2,Structure de l'Ordinateur,11,457,6,QROC,0.03,0.45,74.02,67,24,91,89,67,22,1.02,75.28,Facile,Facile,0,Meme Difficulte que la Prediction,Adapte
4720,2019,Informatique,1,Generalites sur les Systeme Informatiques,2,Structure de l'Ordinateur,11,457,6,QO,0.17,0.66,74.02,68,24,92,79,68,11,1.16,86.08,Facile,Facile,0,Meme Difficulte que la Prediction,Adapte
5786,2020,Informatique,1,Generalites sur les Systeme Informatiques,2,Structure de l'Ordinateur,11,457,6,QO,0.06,0.79,74.02,68,24,92,68,68,0,1.35,100.0,Facile,Facile,0,Meme Difficulte que la Prediction,Adapte
457,2015,Informatique,1,Generalites sur les Systeme Informatiques,2,Structure de l'Ordinateur,11,458,7,QO,0.71,0.22,46.69,3,4,7,5,3,2,1.4,60.0,Difficile,Moyen,1,Plus Facile que la Prediction,Pas Adapte
1523,2016,Informatique,1,Generalites sur les Systeme Informatiques,2,Structure de l'Ordinateur,11,458,7,QO,0.42,0.22,49.23,3,3,6,4,3,1,1.5,75.0,Moyen,Moyen,0,Meme Difficulte que la Prediction,Pas Adapte
2589,2017,Informatique,1,Generalites sur les Systeme Informatiques,2,Structure de l'Ordinateur,11,458,7,QO,0.76,0.04,20.39,1,4,5,3,1,2,1.67,33.33,Difficile,Difficile,0,Meme Difficulte que la Prediction,Pas Adapte
3655,2018,Informatique,1,Generalites sur les Systeme Informatiques,2,Structure de l'Ordinateur,11,458,7,QO,0.04,0.53,68.36,3,1,4,4,3,1,1.0,75.0,Difficile,Facile,2,Beaucoup plus Facile que la Prediction,Adapte
4721,2019,Informatique,1,Generalites sur les Systeme Informatiques,2,Structure de l'Ordinateur,11,458,7,QO,0.13,0.33,68.36,2,1,3,2,2,0,1.5,100.0,Facile,Facile,0,Meme Difficulte que la Prediction,Adapte
5787,2020,Informatique,1,Generalites sur les Systeme Informatiques,2,Structure de l'Ordinateur,11,458,7,QO,0.15,0.78,68.36,2,1,3,3,2,1,1.0,66.67,Facile,Facile,0,Meme Difficulte que la Prediction,Adapte
458,2015,Informatique,1,Generalites sur les Systeme Informatiques,2,Structure de l'Ordinateur,11,459,8,QCU,0.06,0.93,92.57,14,1,15,15,14,1,1.0,93.33,Facile,Facile,0,Meme Difficulte que la Prediction,Pas Adapte
1524,2016,Informatique,1,Generalites sur les Systeme Informatiques,2,Structure de l'Ordinateur,11,459,8,QCM,0.24,0.4,56.99,9,6,15,9,9,0,1.67,100.0,Moyen,Moyen,0,Meme Difficulte que la Prediction,Pas Adapte
2590,2017,Informatique,1,Generalites sur les Systeme Informatiques,2,Structure de l'Ordinateur,11,459,8,QCM,0.17,0.89,80.55,12,3,15,13,12,1,1.15,92.31,Facile,Facile,0,Meme Difficulte que la Prediction,Pas Adapte
3656,2018,Informatique,1,Generalites sur les Systeme Informatiques,2,Structure de l'Ordinateur,11,459,8,QCM,0.25,0.56,56.01,8,7,15,11,8,3,1.36,72.73,Moyen,Moyen,0,Meme Difficulte que la Prediction,Pas Adapte
4722,2019,Informatique,1,Generalites sur les Systeme Informatiques,2,Structure de l'Ordinateur,11,459,8,QCM,0.7,0.29,11.55,2,14,16,13,2,11,1.23,15.38,Facile,Difficile,-2,Beaucoup plus Difficile que la Prediction,Pas Adapte
5788,2020,Informatique,1,Generalites sur les Systeme Informatiques,2,Structure de l'Ordinateur,11,459,8,QCM,0.27,0.42,35.68,5,9,14,7,5,2,2.0,71.43,Facile,Moyen,-1,Plus Difficile que la Prediction,Pas Adapte
459,2015,Informatique,1,Generalites sur les Systeme Informatiques,2,Structure de l'Ordinateur,11,460,9,QCU,0.72,0.37,9.06,2,19,21,16,2,14,1.31,12.5,Difficile,Difficile,0,Meme Difficulte que la Prediction,Pas Adapte
1525,2016,Informatique,1,Generalites sur les Systeme Informatiques,2,Structure de l'Ordinateur,11,460,9,QCU,0.26,0.65,40.69,9,13,22,19,9,10,1.16,47.37,Facile,Moyen,-1,Plus Difficile que la Prediction,Pas Adapte
2591,2017,Informatique,1,Generalites sur les Systeme Informatiques,2,Structure de l'Ordinateur,11,460,9,QCU,0.19,0.88,83.06,20,4,24,21,20,1,1.14,95.24,Difficile,Facile,2,Beaucoup plus Facile que la Prediction,Pas Adapte
3657,2018,Informatique,1,Generalites sur les Systeme Informatiques,2,Structure de l'Ordinateur,11,460,9,QCU,0.52,0.37,32.74,7,13,20,19,7,12,1.05,36.84,Facile,Difficile,-2,Beaucoup plus Difficile que la Prediction,Pas Adapte
4723,2019,Informatique,1,Generalites sur les Systeme Informatiques,2,Structure de l'Ordinateur,11,460,9,QCU,0.29,0.7,57.39,12,9,21,14,12,2,1.5,85.71,Moyen,Moyen,0,Meme Difficulte que la Prediction,Pas Adapte
5789,2020,Informatique,1,Generalites sur les Systeme Informatiques,2,Structure de l'Ordinateur,11,460,9,QCU,0.24,0.46,39.63,9,14,23,9,9,0,2.56,100.0,Facile,Moyen,-1,Plus Difficile que la Prediction,Pas Adapte
460,2015,Informatique,1,Generalites sur les Systeme Informatiques,2,Structure de l'Ordinateur,11,461,10,QCU,0.51,0.21,32.56,17,36,53,46,17,29,1.15,36.96,Moyen,Difficile,-1,Plus Difficile que la Prediction,Pas Adapte
1526,2016,Informatique,1,Generalites sur les Systeme Informatiques,2,Structure de l'Ordinateur,11,461,10,QCU,0.17,0.99,66.78,33,16,49,44,33,11,1.11,75.0,Facile,Facile,0,Meme Difficulte que la Prediction,Adapte
2592,2017,Informatique,1,Generalites sur les Systeme Informatiques,2,Structure de l'Ordinateur,11,461,10,QCU,0.19,0.79,66.78,35,17,52,38,35,3,1.37,92.11,Facile,Facile,0,Meme Difficulte que la Prediction,Adapte
3658,2018,Informatique,1,Generalites sur les Systeme Informatiques,2,Structure de l'Ordinateur,11,461,10,QCU,0.09,0.9,66.78,32,16,48,37,32,5,1.3,86.49,Facile,Facile,0,Meme Difficulte que la Prediction,Adapte
4724,2019,Informatique,1,Generalites sur les Systeme Informatiques,2,Structure de l'Ordinateur,11,461,10,QCU,0.2,0.92,66.78,31,16,47,42,31,11,1.12,73.81,Facile,Facile,0,Meme Difficulte que la Prediction,Adapte
5790,2020,Informatique,1,Generalites sur les Systeme Informatiques,2,Structure de l'Ordinateur,11,461,10,QCU,0.11,0.93,66.78,35,17,52,50,35,15,1.04,70.0,Facile,Facile,0,Meme Difficulte que la Prediction,Adapte
461,2015,Informatique,1,Generalites sur les Systeme Informatiques,2,Structure de l'Ordinateur,11,462,11,QCU,0.22,0.44,41.45,41,57,98,81,41,40,1.21,50.62,Difficile,Moyen,1,Plus Facile que la Prediction,Pas Adapte
1527,2016,Informatique,1,Generalites sur les Systeme Informatiques,2,Structure de l'Ordinateur,11,462,11,QCU,0.05,0.82,71.53,77,31,108,79,77,2,1.37,97.47,Difficile,Facile,2,Beaucoup plus Facile que la Prediction,Adapte
2593,2017,Informatique,1,Generalites sur les Systeme Informatiques,2,Structure de l'Ordinateur,11,462,11,QCM,0.08,0.92,71.53,81,32,113,100,81,19,1.13,81.0,Facile,Facile,0,Meme Difficulte que la Prediction,Adapte
3659,2018,Informatique,1,Generalites sur les Systeme Informatiques,2,Structure de l'Ordinateur,11,462,11,QCU,0.14,0.75,71.53,79,31,110,94,79,15,1.17,84.04,Facile,Facile,0,Meme Difficulte que la Prediction,Adapte
4725,2019,Informatique,1,Generalites sur les Systeme Informatiques,2,Structure de l'Ordinateur,11,462,11,QCU,0.08,0.99,71.53,88,35,123,105,88,17,1.17,83.81,Facile,Facile,0,Meme Difficulte que la Prediction,Adapte
5791,2020,Informatique,1,Generalites sur les Systeme Informatiques,2,Structure de l'Ordinateur,11,462,11,QCU,0.2,0.84,71.53,94,37,131,112,94,18,1.17,83.93,Facile,Facile,0,Meme Difficulte que la Prediction,Adapte
462,2015,Informatique,1,Generalites sur les Systeme Informatiques,3,Logiciels et Domaines d'Applicationd de l'Informatique,7,463,1,QCM,0.04,0.98,66.12,19,9,28,26,19,7,1.08,73.08,Difficile,Facile,2,Beaucoup plus Facile que la Prediction,Adapte
1528,2016,Informatique,1,Generalites sur les Systeme Informatiques,3,Logiciels et Domaines d'Applicationd de l'Informatique,7,463,1,QCM,0.12,0.97,66.12,16,8,24,20,16,4,1.2,80.0,Facile,Facile,0,Meme Difficulte que la Prediction,Adapte
2594,2017,Informatique,1,Generalites sur les Systeme Informatiques,3,Logiciels et Domaines d'Applicationd de l'Informatique,7,463,1,QCM,0.15,0.84,66.12,17,8,25,25,17,8,1.0,68.0,Facile,Facile,0,Meme Difficulte que la Prediction,Adapte
3660,2018,Informatique,1,Generalites sur les Systeme Informatiques,3,Logiciels et Domaines d'Applicationd de l'Informatique,7,463,1,QCM,0.12,0.96,66.12,15,8,23,20,15,5,1.15,75.0,Facile,Facile,0,Meme Difficulte que la Prediction,Adapte
4726,2019,Informatique,1,Generalites sur les Systeme Informatiques,3,Logiciels et Domaines d'Applicationd de l'Informatique,7,463,1,QCM,0.14,0.78,66.12,15,7,22,19,15,4,1.16,78.95,Facile,Facile,0,Meme Difficulte que la Prediction,Adapte
5792,2020,Informatique,1,Generalites sur les Systeme Informatiques,3,Logiciels et Domaines d'Applicationd de l'Informatique,7,463,1,QCM,0.11,0.92,66.12,15,8,23,16,15,1,1.44,93.75,Facile,Facile,0,Meme Difficulte que la Prediction,Adapte
463,2015,Informatique,1,Generalites sur les Systeme Informatiques,3,Logiciels et Domaines d'Applicationd de l'Informatique,7,464,2,QCM,0.07,0.76,75.28,66,22,88,87,66,21,1.01,75.86,Facile,Facile,0,Meme Difficulte que la Prediction,Pas Adapte
1529,2016,Informatique,1,Generalites sur les Systeme Informatiques,3,Logiciels et Domaines d'Applicationd de l'Informatique,7,464,2,QCM,0.02,0.77,89.54,79,9,88,82,79,3,1.07,96.34,Facile,Facile,0,Meme Difficulte que la Prediction,Pas Adapte
2595,2017,Informatique,1,Generalites sur les Systeme Informatiques,3,Logiciels et Domaines d'Applicationd de l'Informatique,7,464,2,QCM,0.11,0.79,71.85,55,21,76,69,55,14,1.1,79.71,Difficile,Facile,2,Beaucoup plus Facile que la Prediction,Adapte
3661,2018,Informatique,1,Generalites sur les Systeme Informatiques,3,Logiciels et Domaines d'Applicationd de l'Informatique,7,464,2,QCM,0.02,0.86,71.85,48,19,67,60,48,12,1.12,80.0,Facile,Facile,0,Meme Difficulte que la Prediction,Adapte
4727,2019,Informatique,1,Generalites sur les Systeme Informatiques,3,Logiciels et Domaines d'Applicationd de l'Informatique,7,464,2,QCM,0.01,0.98,71.85,50,19,69,69,50,19,1.0,72.46,Facile,Facile,0,Meme Difficulte que la Prediction,Adapte
5793,2020,Informatique,1,Generalites sur les Systeme Informatiques,3,Logiciels et Domaines d'Applicationd de l'Informatique,7,464,2,QCM,0.17,0.88,71.85,52,20,72,61,52,9,1.18,85.25,Facile,Facile,0,Meme Difficulte que la Prediction,Adapte
464,2015,Informatique,1,Generalites sur les Systeme Informatiques,3,Logiciels et Domaines d'Applicationd de l'Informatique,7,465,3,QCM,0.75,0.18,12.25,9,62,71,68,9,59,1.04,13.24,Difficile,Difficile,0,Meme Difficulte que la Prediction,Pas Adapte
1530,2016,Informatique,1,Generalites sur les Systeme Informatiques,3,Logiciels et Domaines d'Applicationd de l'Informatique,7,465,3,QCM,0.63,0.22,11.39,7,55,62,30,7,23,2.07,23.33,Facile,Difficile,-2,Beaucoup plus Difficile que la Prediction,Pas Adapte
2596,2017,Informatique,1,Generalites sur les Systeme Informatiques,3,Logiciels et Domaines d'Applicationd de l'Informatique,7,465,3,QCM,0.06,0.83,79.01,43,11,54,44,43,1,1.23,97.73,Facile,Facile,0,Meme Difficulte que la Prediction,Pas Adapte
3662,2018,Informatique,1,Generalites sur les Systeme Informatiques,3,Logiciels et Domaines d'Applicationd de l'Informatique,7,465,3,QCM,0.1,0.74,90.98,45,5,50,49,45,4,1.02,91.84,Facile,Facile,0,Meme Difficulte que la Prediction,Pas Adapte
4728,2019,Informatique,1,Generalites sur les Systeme Informatiques,3,Logiciels et Domaines d'Applicationd de l'Informatique,7,465,3,QCM,0.03,0.85,87.72,46,7,53,49,46,3,1.08,93.88,Facile,Facile,0,Meme Difficulte que la Prediction,Pas Adapte
5794,2020,Informatique,1,Generalites sur les Systeme Informatiques,3,Logiciels et Domaines d'Applicationd de l'Informatique,7,465,3,QCM,0.73,0.29,7.77,4,43,47,13,4,9,3.62,30.77,Moyen,Difficile,-1,Plus Difficile que la Prediction,Pas Adapte
465,2015,Informatique,1,Generalites sur les Systeme Informatiques,3,Logiciels et Domaines d'Applicationd de l'Informatique,7,466,4,QCU,0.53,0.39,5.81,4,62,66,25,4,21,2.64,16.0,Difficile,Difficile,0,Meme Difficulte que la Prediction,Pas Adapte
1531,2016,Informatique,1,Generalites sur les Systeme Informatiques,3,Logiciels et Domaines d'Applicationd de l'Informatique,7,466,4,QCU,0.49,0.4,23.67,14,45,59,56,14,42,1.05,25.0,Moyen,Difficile,-1,Plus Difficile que la Prediction,Pas Adapte
2597,2017,Informatique,1,Generalites sur les Systeme Informatiques,3,Logiciels et Domaines d'Applicationd de l'Informatique,7,466,4,QCU,0.45,0.33,4.93,3,65,68,29,3,26,2.34,10.34,Difficile,Difficile,0,Meme Difficulte que la Prediction,Pas Adapte
3663,2018,Informatique,1,Generalites sur les Systeme Informatiques,3,Logiciels et Domaines d'Applicationd de l'Informatique,7,466,4,QCU,0.62,0.36,27.17,19,50,69,63,19,44,1.1,30.16,Difficile,Difficile,0,Meme Difficulte que la Prediction,Pas Adapte
4729,2019,Informatique,1,Generalites sur les Systeme Informatiques,3,Logiciels et Domaines d'Applicationd de l'Informatique,7,466,4,QCU,0.63,0.22,9.7,7,66,73,27,7,20,2.7,25.93,Facile,Difficile,-2,Beaucoup plus Difficile que la Prediction,Pas Adapte
5795,2020,Informatique,1,Generalites sur les Systeme Informatiques,3,Logiciels et Domaines d'Applicationd de l'Informatique,7,466,4,QCU,0.48,0.28,13.5,9,61,70,28,9,19,2.5,32.14,Difficile,Difficile,0,Meme Difficulte que la Prediction,Pas Adapte
466,2015,Informatique,1,Generalites sur les Systeme Informatiques,3,Logiciels et Domaines d'Applicationd de l'Informatique,7,467,5,QCM,0.07,0.71,72.52,7,3,10,10,7,3,1.0,70.0,Difficile,Facile,2,Beaucoup plus Facile que la Prediction,Adapte
1532,2016,Informatique,1,Generalites sur les Systeme Informatiques,3,Logiciels et Domaines d'Applicationd de l'Informatique,7,467,5,QCM,0.19,0.97,72.52,8,3,11,10,8,2,1.1,80.0,Facile,Facile,0,Meme Difficulte que la Prediction,Adapte
2598,2017,Informatique,1,Generalites sur les Systeme Informatiques,3,Logiciels et Domaines d'Applicationd de l'Informatique,7,467,5,QCM,0.1,0.73,72.52,9,3,12,10,9,1,1.2,90.0,Facile,Facile,0,Meme Difficulte que la Prediction,Adapte
3664,2018,Informatique,1,Generalites sur les Systeme Informatiques,3,Logiciels et Domaines d'Applicationd de l'Informatique,7,467,5,QCM,0.1,0.99,72.52,9,4,13,11,9,2,1.18,81.82,Facile,Facile,0,Meme Difficulte que la Prediction,Adapte
4730,2019,Informatique,1,Generalites sur les Systeme Informatiques,3,Logiciels et Domaines d'Applicationd de l'Informatique,7,467,5,QCM,0.12,0.75,72.52,9,4,13,11,9,2,1.18,81.82,Facile,Facile,0,Meme Difficulte que la Prediction,Adapte
5796,2020,Informatique,1,Generalites sur les Systeme Informatiques,3,Logiciels et Domaines d'Applicationd de l'Informatique,7,467,5,QCM,0.11,0.89,72.52,9,3,12,10,9,1,1.2,90.0,Facile,Facile,0,Meme Difficulte que la Prediction,Adapte
467,2015,Informatique,1,Generalites sur les Systeme Informatiques,3,Logiciels et Domaines d'Applicationd de l'Informatique,7,468,6,QCM,0.23,0.33,61.75,43,27,70,51,43,8,1.37,84.31,Moyen,Moyen,0,Meme Difficulte que la Prediction,Adapte
1533,2016,Informatique,1,Generalites sur les Systeme Informatiques,3,Logiciels et Domaines d'Applicationd de l'Informatique,7,468,6,QCM,0.26,0.35,61.75,42,26,68,51,42,9,1.33,82.35,Moyen,Moyen,0,Meme Difficulte que la Prediction,Adapte
2599,2017,Informatique,1,Generalites sur les Systeme Informatiques,3,Logiciels et Domaines d'Applicationd de l'Informatique,7,468,6,QCM,0.31,0.39,61.75,43,27,70,63,43,20,1.11,68.25,Moyen,Moyen,0,Meme Difficulte que la Prediction,Adapte
3665,2018,Informatique,1,Generalites sur les Systeme Informatiques,3,Logiciels et Domaines d'Applicationd de l'Informatique,7,468,6,QCM,0.43,0.45,61.75,44,27,71,50,44,6,1.42,88.0,Moyen,Moyen,0,Meme Difficulte que la Prediction,Adapte
4731,2019,Informatique,1,Generalites sur les Systeme Informatiques,3,Logiciels et Domaines d'Applicationd de l'Informatique,7,468,6,QCM,0.26,0.42,61.75,51,31,82,72,51,21,1.14,70.83,Moyen,Moyen,0,Meme Difficulte que la Prediction,Adapte
5797,2020,Informatique,1,Generalites sur les Systeme Informatiques,3,Logiciels et Domaines d'Applicationd de l'Informatique,7,468,6,QCM,0.28,0.3,61.75,49,31,80,66,49,17,1.21,74.24,Moyen,Moyen,0,Meme Difficulte que la Prediction,Adapte
468,2015,Informatique,1,Generalites sur les Systeme Informatiques,3,Logiciels et Domaines d'Applicationd de l'Informatique,7,469,7,QCU,0.09,0.99,83.39,30,6,36,36,30,6,1.0,83.33,Difficile,Facile,2,Beaucoup plus Facile que la Prediction,Pas Adapte
1534,2016,Informatique,1,Generalites sur les Systeme Informatiques,3,Logiciels et Domaines d'Applicationd de l'Informatique,7,469,7,QCU,0.04,0.88,90.57,34,4,38,37,34,3,1.03,91.89,Facile,Facile,0,Meme Difficulte que la Prediction,Pas Adapte
2600,2017,Informatique,1,Generalites sur les Systeme Informatiques,3,Logiciels et Domaines d'Applicationd de l'Informatique,7,469,7,QCU,0.35,0.44,39.24,15,23,38,24,15,9,1.58,62.5,Moyen,Moyen,0,Meme Difficulte que la Prediction,Pas Adapte
3666,2018,Informatique,1,Generalites sur les Systeme Informatiques,3,Logiciels et Domaines d'Applicationd de l'Informatique,7,469,7,QCU,0.09,0.86,98.15,37,1,38,37,37,0,1.03,100.0,Facile,Facile,0,Meme Difficulte que la Prediction,Pas Adapte
4732,2019,Informatique,1,Generalites sur les Systeme Informatiques,3,Logiciels et Domaines d'Applicationd de l'Informatique,7,469,7,QCU,0.17,0.93,83.26,34,7,41,35,34,1,1.17,97.14,Facile,Facile,0,Meme Difficulte que la Prediction,Pas Adapte
5798,2020,Informatique,1,Generalites sur les Systeme Informatiques,3,Logiciels et Domaines d'Applicationd de l'Informatique,7,469,7,QCU,0.49,0.27,4.22,2,45,47,37,2,35,1.27,5.41,Difficile,Difficile,0,Meme Difficulte que la Prediction,Pas Adapte
469,2015,Informatique,1,Les Logiciels,1,Systeme d'Exploitation,10,470,1,QROC,0.69,0.13,10.85,3,29,32,13,3,10,2.46,23.08,Difficile,Difficile,0,Meme Difficulte que la Prediction,Pas Adapte
1535,2016,Informatique,1,Les Logiciels,1,Systeme d'Exploitation,10,470,1,QROC,0.2,0.33,62.05,17,11,28,21,17,4,1.33,80.95,Difficile,Moyen,1,Plus Facile que la Prediction,Adapte
2601,2017,Informatique,1,Les Logiciels,1,Systeme d'Exploitation,10,470,1,QROC,0.56,0.39,62.05,16,9,25,24,16,8,1.04,66.67,Moyen,Moyen,0,Meme Difficulte que la Prediction,Adapte
3667,2018,Informatique,1,Les Logiciels,1,Systeme d'Exploitation,10,470,1,QROC,0.25,0.39,62.05,14,8,22,16,14,2,1.38,87.5,Moyen,Moyen,0,Meme Difficulte que la Prediction,Adapte
4733,2019,Informatique,1,Les Logiciels,1,Systeme d'Exploitation,10,470,1,QROC,0.27,0.34,62.05,13,8,21,19,13,6,1.11,68.42,Moyen,Moyen,0,Meme Difficulte que la Prediction,Adapte
5799,2020,Informatique,1,Les Logiciels,1,Systeme d'Exploitation,10,470,1,QO,0.29,0.18,62.05,14,8,22,19,14,5,1.16,73.68,Moyen,Moyen,0,Meme Difficulte que la Prediction,Adapte
470,2015,Informatique,1,Les Logiciels,1,Systeme d'Exploitation,10,471,2,QCM,0.56,0.23,32.55,3,5,8,5,3,2,1.6,60.0,Difficile,Difficile,0,Meme Difficulte que la Prediction,Pas Adapte
1536,2016,Informatique,1,Les Logiciels,1,Systeme d'Exploitation,10,471,2,QCM,0.15,0.9,84.56,7,1,8,7,7,0,1.14,100.0,Moyen,Facile,1,Plus Facile que la Prediction,Pas Adapte
2602,2017,Informatique,1,Les Logiciels,1,Systeme d'Exploitation,10,471,2,QCM,0.06,0.94,69.7,6,2,8,7,6,1,1.14,85.71,Moyen,Facile,1,Plus Facile que la Prediction,Adapte
3668,2018,Informatique,1,Les Logiciels,1,Systeme d'Exploitation,10,471,2,QCM,0.18,0.86,69.7,6,3,9,7,6,1,1.29,85.71,Facile,Facile,0,Meme Difficulte que la Prediction,Adapte
4734,2019,Informatique,1,Les Logiciels,1,Systeme d'Exploitation,10,471,2,QCU,0.14,1.0,69.7,6,2,8,6,6,0,1.33,100.0,Facile,Facile,0,Meme Difficulte que la Prediction,Adapte
5800,2020,Informatique,1,Les Logiciels,1,Systeme d'Exploitation,10,471,2,QCU,0.02,0.91,69.7,6,2,8,6,6,0,1.33,100.0,Facile,Facile,0,Meme Difficulte que la Prediction,Adapte
471,2015,Informatique,1,Les Logiciels,1,Systeme d'Exploitation,10,472,3,QCU,0.67,0.32,34.87,33,63,96,92,33,59,1.04,35.87,Moyen,Difficile,-1,Plus Difficile que la Prediction,Pas Adapte
1537,2016,Informatique,1,Les Logiciels,1,Systeme d'Exploitation,10,472,3,QROC,0.09,0.91,99.7,95,0,95,95,95,0,1.0,100.0,Facile,Facile,0,Meme Difficulte que la Prediction,Pas Adapte
2603,2017,Informatique,1,Les Logiciels,1,Systeme d'Exploitation,10,472,3,QO,0.06,0.69,82.08,89,19,108,104,89,15,1.04,85.58,Facile,Facile,0,Meme Difficulte que la Prediction,Pas Adapte
3669,2018,Informatique,1,Les Logiciels,1,Systeme d'Exploitation,10,472,3,QO,0.94,0.05,28.88,29,72,101,93,29,64,1.09,31.18,Difficile,Difficile,0,Meme Difficulte que la Prediction,Pas Adapte
4735,2019,Informatique,1,Les Logiciels,1,Systeme d'Exploitation,10,472,3,QCM,0.61,0.28,11.63,11,86,97,87,11,76,1.11,12.64,Difficile,Difficile,0,Meme Difficulte que la Prediction,Pas Adapte
5801,2020,Informatique,1,Les Logiciels,1,Systeme d'Exploitation,10,472,3,QCM,0.66,0.26,7.01,6,79,85,25,6,19,3.4,24.0,Difficile,Difficile,0,Meme Difficulte que la Prediction,Pas Adapte
472,2015,Informatique,1,Les Logiciels,1,Systeme d'Exploitation,10,473,4,QCM,0.79,0.29,10.99,7,60,67,19,7,12,3.53,36.84,Moyen,Difficile,-1,Plus Difficile que la Prediction,Pas Adapte
1538,2016,Informatique,1,Les Logiciels,1,Systeme d'Exploitation,10,473,4,QCM,0.17,0.97,81.0,56,13,69,66,56,10,1.05,84.85,Facile,Facile,0,Meme Difficulte que la Prediction,Pas Adapte
2604,2017,Informatique,1,Les Logiciels,1,Systeme d'Exploitation,10,473,4,QCM,0.34,0.67,36.98,26,43,69,56,26,30,1.23,46.43,Moyen,Moyen,0,Meme Difficulte que la Prediction,Pas Adapte
3670,2018,Informatique,1,Les Logiciels,1,Systeme d'Exploitation,10,473,4,QCM,0.55,0.29,21.39,13,46,59,24,13,11,2.46,54.17,Difficile,Difficile,0,Meme Difficulte que la Prediction,Pas Adapte
4736,2019,Informatique,1,Les Logiciels,1,Systeme d'Exploitation,10,473,4,QCM,0.27,0.48,45.91,28,32,60,34,28,6,1.76,82.35,Moyen,Moyen,0,Meme Difficulte que la Prediction,Pas Adapte
5802,2020,Informatique,1,Les Logiciels,1,Systeme d'Exploitation,10,473,4,QCU,0.32,0.61,37.24,25,42,67,33,25,8,2.03,75.76,Facile,Moyen,-1,Plus Difficile que la Prediction,Pas Adapte
473,2015,Informatique,1,Les Logiciels,1,Systeme d'Exploitation,10,474,5,QCU,0.52,0.24,27.09,22,61,83,74,22,52,1.12,29.73,Difficile,Difficile,0,Meme Difficulte que la Prediction,Pas Adapte
1539,2016,Informatique,1,Les Logiciels,1,Systeme d'Exploitation,10,474,5,QCU,0.3,0.51,54.08,44,38,82,62,44,18,1.32,70.97,Moyen,Moyen,0,Meme Difficulte que la Prediction,Pas Adapte
2605,2017,Informatique,1,Les Logiciels,1,Systeme d'Exploitation,10,474,5,QCU,0.07,0.81,99.63,77,0,77,77,77,0,1.0,100.0,Moyen,Facile,1,Plus Facile que la Prediction,Pas Adapte
3671,2018,Informatique,1,Les Logiciels,1,Systeme d'Exploitation,10,474,5,QCU,0.61,0.27,23.37,18,58,76,45,18,27,1.69,40.0,Difficile,Difficile,0,Meme Difficulte que la Prediction,Pas Adapte
4737,2019,Informatique,1,Les Logiciels,1,Systeme d'Exploitation,10,474,5,QCU,0.64,0.27,21.07,15,55,70,42,15,27,1.67,35.71,Moyen,Difficile,-1,Plus Difficile que la Prediction,Pas Adapte
5803,2020,Informatique,1,Les Logiciels,1,Systeme d'Exploitation,10,474,5,QCU,0.37,0.72,35.34,28,51,79,39,28,11,2.03,71.79,Difficile,Moyen,1,Plus Facile que la Prediction,Pas Adapte
474,2015,Informatique,1,Les Logiciels,1,Systeme d'Exploitation,10,475,6,QCM,0.74,0.2,23.36,7,22,29,23,7,16,1.26,30.43,Difficile,Difficile,0,Meme Difficulte que la Prediction,Pas Adapte
1540,2016,Informatique,1,Les Logiciels,1,Systeme d'Exploitation,10,475,6,QCM,0.2,0.82,70.52,20,8,28,22,20,2,1.27,90.91,Facile,Facile,0,Meme Difficulte que la Prediction,Adapte
2606,2017,Informatique,1,Les Logiciels,1,Systeme d'Exploitation,10,475,6,QCM,0.01,0.99,70.52,18,7,25,22,18,4,1.14,81.82,Facile,Facile,0,Meme Difficulte que la Prediction,Adapte
3672,2018,Informatique,1,Les Logiciels,1,Systeme d'Exploitation,10,475,6,QCM,0.16,0.72,70.52,20,8,28,21,20,1,1.33,95.24,Facile,Facile,0,Meme Difficulte que la Prediction,Adapte
4738,2019,Informatique,1,Les Logiciels,1,Systeme d'Exploitation,10,475,6,QCM,0.01,0.93,70.52,18,7,25,20,18,2,1.25,90.0,Facile,Facile,0,Meme Difficulte que la Prediction,Adapte
5804,2020,Informatique,1,Les Logiciels,1,Systeme d'Exploitation,10,475,6,QCM,0.05,0.92,70.52,16,7,23,22,16,6,1.05,72.73,Facile,Facile,0,Meme Difficulte que la Prediction,Adapte
475,2015,Informatique,1,Les Logiciels,1,Systeme d'Exploitation,10,476,7,QCU,0.61,0.31,34.7,9,18,27,22,9,13,1.23,40.91,Difficile,Difficile,0,Meme Difficulte que la Prediction,Pas Adapte
1541,2016,Informatique,1,Les Logiciels,1,Systeme d'Exploitation,10,476,7,QCU,0.28,0.58,44.47,13,17,30,20,13,7,1.5,65.0,Moyen,Moyen,0,Meme Difficulte que la Prediction,Pas Adapte
2607,2017,Informatique,1,Les Logiciels,1,Systeme d'Exploitation,10,476,7,QCU,0.18,0.97,94.24,32,2,34,33,32,1,1.03,96.97,Difficile,Facile,2,Beaucoup plus Facile que la Prediction,Pas Adapte
3673,2018,Informatique,1,Les Logiciels,1,Systeme d'Exploitation,10,476,7,QCU,0.2,0.6,35.95,12,21,33,16,12,4,2.06,75.0,Difficile,Moyen,1,Plus Facile que la Prediction,Pas Adapte
4739,2019,Informatique,1,Les Logiciels,1,Systeme d'Exploitation,10,476,7,QCU,0.49,0.3,14.39,4,25,29,20,4,16,1.45,20.0,Difficile,Difficile,0,Meme Difficulte que la Prediction,Pas Adapte
5805,2020,Informatique,1,Les Logiciels,1,Systeme d'Exploitation,10,476,7,QCU,0.06,0.82,92.96,23,2,25,23,23,0,1.09,100.0,Facile,Facile,0,Meme Difficulte que la Prediction,Pas Adapte
476,2015,Informatique,1,Les Logiciels,1,Systeme d'Exploitation,10,477,8,QCU,0.04,0.76,76.12,71,22,93,88,71,17,1.06,80.68,Moyen,Facile,1,Plus Facile que la Prediction,Pas Adapte
1542,2016,Informatique,1,Les Logiciels,1,Systeme d'Exploitation,10,477,8,QROC,0.15,0.74,70.37,59,25,84,67,59,8,1.25,88.06,Facile,Facile,0,Meme Difficulte que la Prediction,Adapte
2608,2017,Informatique,1,Les Logiciels,1,Systeme d'Exploitation,10,477,8,QO,0.06,0.63,70.37,58,24,82,70,58,12,1.17,82.86,Facile,Facile,0,Meme Difficulte que la Prediction,Adapte
3674,2018,Informatique,1,Les Logiciels,1,Systeme d'Exploitation,10,477,8,QO,0.13,0.38,70.37,63,26,89,77,63,14,1.16,81.82,Facile,Facile,0,Meme Difficulte que la Prediction,Adapte
4740,2019,Informatique,1,Les Logiciels,1,Systeme d'Exploitation,10,477,8,QO,0.1,0.79,70.37,53,23,76,68,53,15,1.12,77.94,Facile,Facile,0,Meme Difficulte que la Prediction,Adapte
5806,2020,Informatique,1,Les Logiciels,1,Systeme d'Exploitation,10,477,8,QO,0.2,0.76,70.37,51,21,72,63,51,12,1.14,80.95,Facile,Facile,0,Meme Difficulte que la Prediction,Adapte
477,2015,Informatique,1,Les Logiciels,1,Systeme d'Exploitation,10,478,9,QCM,0.18,0.77,84.52,55,10,65,57,55,2,1.14,96.49,Moyen,Facile,1,Plus Facile que la Prediction,Pas Adapte
1543,2016,Informatique,1,Les Logiciels,1,Systeme d'Exploitation,10,478,9,QCM,0.32,0.49,43.04,31,42,73,52,31,21,1.4,59.62,Difficile,Moyen,1,Plus Facile que la Prediction,Pas Adapte
2609,2017,Informatique,1,Les Logiciels,1,Systeme d'Exploitation,10,478,9,QCM,0.64,0.28,24.2,15,47,62,23,15,8,2.7,65.22,Difficile,Difficile,0,Meme Difficulte que la Prediction,Pas Adapte
3675,2018,Informatique,1,Les Logiciels,1,Systeme d'Exploitation,10,478,9,QCM,0.79,0.25,1.13,1,60,61,35,1,34,1.74,2.86,Moyen,Difficile,-1,Plus Difficile que la Prediction,Pas Adapte
4741,2019,Informatique,1,Les Logiciels,1,Systeme d'Exploitation,10,478,9,QROC,0.35,0.32,60.89,40,25,65,49,40,9,1.33,81.63,Facile,Moyen,-1,Plus Difficile que la Prediction,Adapte
5807,2020,Informatique,1,Les Logiciels,1,Systeme d'Exploitation,10,478,9,QROC,0.23,0.35,60.89,45,29,74,47,45,2,1.57,95.74,Moyen,Moyen,0,Meme Difficulte que la Prediction,Adapte
478,2015,Informatique,1,Les Logiciels,1,Systeme d'Exploitation,10,479,10,QCU,0.05,0.88,94.16,51,3,54,52,51,1,1.04,98.08,Facile,Facile,0,Meme Difficulte que la Prediction,Pas Adapte
1544,2016,Informatique,1,Les Logiciels,1,Systeme d'Exploitation,10,479,10,QCU,0.33,0.69,42.18,26,35,61,53,26,27,1.15,49.06,Moyen,Moyen,0,Meme Difficulte que la Prediction,Pas Adapte
2610,2017,Informatique,1,Les Logiciels,1,Systeme d'Exploitation,10,479,10,QCU,0.06,0.95,97.46,52,1,53,52,52,0,1.02,100.0,Moyen,Facile,1,Plus Facile que la Prediction,Pas Adapte
3676,2018,Informatique,1,Les Logiciels,1,Systeme d'Exploitation,10,479,10,QCM,0.29,0.63,41.8,20,27,47,27,20,7,1.74,74.07,Facile,Moyen,-1,Plus Difficile que la Prediction,Pas Adapte
4742,2019,Informatique,1,Les Logiciels,1,Systeme d'Exploitation,10,479,10,QCM,0.53,0.23,10.06,5,41,46,12,5,7,3.83,41.67,Difficile,Difficile,0,Meme Difficulte que la Prediction,Pas Adapte
5808,2020,Informatique,1,Les Logiciels,1,Systeme d'Exploitation,10,479,10,QCM,0.08,0.88,92.92,45,3,48,46,45,1,1.04,97.83,Facile,Facile,0,Meme Difficulte que la Prediction,Pas Adapte
479,2015,Informatique,1,Les Logiciels,2,Traitement de Texte,8,480,1,QCM,0.36,0.36,61.71,57,35,92,59,57,2,1.56,96.61,Moyen,Moyen,0,Meme Difficulte que la Prediction,Adapte
1545,2016,Informatique,1,Les Logiciels,2,Traitement de Texte,8,480,1,QCM,0.22,0.46,61.71,65,40,105,97,65,32,1.08,67.01,Moyen,Moyen,0,Meme Difficulte que la Prediction,Adapte
2611,2017,Informatique,1,Les Logiciels,2,Traitement de Texte,8,480,1,QCM,0.45,0.69,61.71,61,38,99,96,61,35,1.03,63.54,Moyen,Moyen,0,Meme Difficulte que la Prediction,Adapte
3677,2018,Informatique,1,Les Logiciels,2,Traitement de Texte,8,480,1,QROC,0.38,0.29,61.71,60,38,98,88,60,28,1.11,68.18,Moyen,Moyen,0,Meme Difficulte que la Prediction,Adapte
4743,2019,Informatique,1,Les Logiciels,2,Traitement de Texte,8,480,1,QROC,0.42,0.26,61.71,56,34,90,57,56,1,1.58,98.25,Moyen,Moyen,0,Meme Difficulte que la Prediction,Adapte
5809,2020,Informatique,1,Les Logiciels,2,Traitement de Texte,8,480,1,QROC,0.57,0.39,61.71,62,39,101,97,62,35,1.04,63.92,Moyen,Moyen,0,Meme Difficulte que la Prediction,Adapte
480,2015,Informatique,1,Les Logiciels,2,Traitement de Texte,8,481,2,QCU,0.17,0.93,76.84,60,18,78,65,60,5,1.2,92.31,Facile,Facile,0,Meme Difficulte que la Prediction,Pas Adapte
1546,2016,Informatique,1,Les Logiciels,2,Traitement de Texte,8,481,2,QCU,0.53,0.27,26.13,22,64,86,72,22,50,1.19,30.56,Difficile,Difficile,0,Meme Difficulte que la Prediction,Pas Adapte
2612,2017,Informatique,1,Les Logiciels,2,Traitement de Texte,8,481,2,QCU,0.15,0.83,67.2,64,31,95,88,64,24,1.08,72.73,Facile,Facile,0,Meme Difficulte que la Prediction,Adapte
3678,2018,Informatique,1,Les Logiciels,2,Traitement de Texte,8,481,2,QCU,0.19,0.84,67.2,65,31,96,82,65,17,1.17,79.27,Facile,Facile,0,Meme Difficulte que la Prediction,Adapte
4744,2019,Informatique,1,Les Logiciels,2,Traitement de Texte,8,481,2,QCU,0.06,0.94,67.2,67,33,100,76,67,9,1.32,88.16,Facile,Facile,0,Meme Difficulte que la Prediction,Adapte
5810,2020,Informatique,1,Les Logiciels,2,Traitement de Texte,8,481,2,QCU,0.14,0.78,67.2,71,35,106,102,71,31,1.04,69.61,Facile,Facile,0,Meme Difficulte que la Prediction,Adapte
481,2015,Informatique,1,Les Logiciels,2,Traitement de Texte,8,482,3,QCU,0.74,0.21,15.75,9,49,58,28,9,19,2.07,32.14,Facile,Difficile,-2,Beaucoup plus Difficile que la Prediction,Pas Adapte
1547,2016,Informatique,1,Les Logiciels,2,Traitement de Texte,8,482,3,QCU,0.02,0.88,80.91,53,12,65,58,53,5,1.12,91.38,Moyen,Facile,1,Plus Facile que la Prediction,Pas Adapte
2613,2017,Informatique,1,Les Logiciels,2,Traitement de Texte,8,482,3,QCU,0.23,0.74,60.22,44,29,73,62,44,18,1.18,70.97,Moyen,Moyen,0,Meme Difficulte que la Prediction,Adapte
3679,2018,Informatique,1,Les Logiciels,2,Traitement de Texte,8,482,3,QCU,0.28,0.74,60.22,39,26,65,64,39,25,1.02,60.94,Moyen,Moyen,0,Meme Difficulte que la Prediction,Adapte
4745,2019,Informatique,1,Les Logiciels,2,Traitement de Texte,8,482,3,QCU,0.2,0.56,60.22,34,23,57,52,34,18,1.1,65.38,Moyen,Moyen,0,Meme Difficulte que la Prediction,Adapte
5811,2020,Informatique,1,Les Logiciels,2,Traitement de Texte,8,482,3,QCU,0.27,0.53,60.22,35,23,58,47,35,12,1.23,74.47,Moyen,Moyen,0,Meme Difficulte que la Prediction,Adapte
482,2015,Informatique,1,Les Logiciels,2,Traitement de Texte,8,483,4,QROC,0.9,0.21,19.09,2,10,12,12,2,10,1.0,16.67,Moyen,Difficile,-1,Plus Difficile que la Prediction,Pas Adapte
1548,2016,Informatique,1,Les Logiciels,2,Traitement de Texte,8,483,4,QROC,0.67,0.14,25.88,3,7,10,8,3,5,1.25,37.5,Difficile,Difficile,0,Meme Difficulte que la Prediction,Pas Adapte
2614,2017,Informatique,1,Les Logiciels,2,Traitement de Texte,8,483,4,QROC,0.98,0.02,19.92,2,8,10,6,2,4,1.67,33.33,Facile,Difficile,-2,Beaucoup plus Difficile que la Prediction,Pas Adapte
3680,2018,Informatique,1,Les Logiciels,2,Traitement de Texte,8,483,4,QROC,0.17,0.89,82.76,7,1,8,8,7,1,1.0,87.5,Facile,Facile,0,Meme Difficulte que la Prediction,Pas Adapte
4746,2019,Informatique,1,Les Logiciels,2,Traitement de Texte,8,483,4,QROC,0.53,0.31,43.23,4,5,9,6,4,2,1.5,66.67,Moyen,Moyen,0,Meme Difficulte que la Prediction,Pas Adapte
5812,2020,Informatique,1,Les Logiciels,2,Traitement de Texte,8,483,4,QROC,0.63,0.03,32.13,3,7,10,5,3,2,2.0,60.0,Difficile,Difficile,0,Meme Difficulte que la Prediction,Pas Adapte
483,2015,Informatique,1,Les Logiciels,2,Traitement de Texte,8,484,5,QCM,0.68,0.2,15.56,13,70,83,34,13,21,2.44,38.24,Difficile,Difficile,0,Meme Difficulte que la Prediction,Pas Adapte
1549,2016,Informatique,1,Les Logiciels,2,Traitement de Texte,8,484,5,QCM,0.45,0.58,46.75,43,48,91,52,43,9,1.75,82.69,Facile,Moyen,-1,Plus Difficile que la Prediction,Pas Adapte
2615,2017,Informatique,1,Les Logiciels,2,Traitement de Texte,8,484,5,QCM,0.64,0.25,7.86,8,88,96,38,8,30,2.53,21.05,Difficile,Difficile,0,Meme Difficulte que la Prediction,Pas Adapte
3681,2018,Informatique,1,Les Logiciels,2,Traitement de Texte,8,484,5,QCM,0.53,0.27,29.06,30,72,102,43,30,13,2.37,69.77,Difficile,Difficile,0,Meme Difficulte que la Prediction,Pas Adapte
4747,2019,Informatique,1,Les Logiciels,2,Traitement de Texte,8,484,5,QO,0.49,0.21,61.45,68,42,110,90,68,22,1.22,75.56,Moyen,Moyen,0,Meme Difficulte que la Prediction,Adapte
5813,2020,Informatique,1,Les Logiciels,2,Traitement de Texte,8,484,5,QO,0.21,0.17,61.45,62,39,101,97,62,35,1.04,63.92,Moyen,Moyen,0,Meme Difficulte que la Prediction,Adapte
484,2015,Informatique,1,Les Logiciels,2,Traitement de Texte,8,485,6,QCU,0.53,0.39,3.92,2,42,44,26,2,24,1.69,7.69,Difficile,Difficile,0,Meme Difficulte que la Prediction,Pas Adapte
1550,2016,Informatique,1,Les Logiciels,2,Traitement de Texte,8,485,6,QCU,0.23,0.69,42.82,17,22,39,17,17,0,2.29,100.0,Moyen,Moyen,0,Meme Difficulte que la Prediction,Pas Adapte
2616,2017,Informatique,1,Les Logiciels,2,Traitement de Texte,8,485,6,QCU,0.37,0.71,46.23,15,18,33,28,15,13,1.18,53.57,Facile,Moyen,-1,Plus Difficile que la Prediction,Pas Adapte
3682,2018,Informatique,1,Les Logiciels,2,Traitement de Texte,8,485,6,QO,0.04,0.55,92.65,34,3,37,34,34,0,1.09,100.0,Facile,Facile,0,Meme Difficulte que la Prediction,Pas Adapte
4748,2019,Informatique,1,Les Logiciels,2,Traitement de Texte,8,485,6,QO,0.96,0.01,3.74,1,33,34,22,1,21,1.55,4.55,Difficile,Difficile,0,Meme Difficulte que la Prediction,Pas Adapte
5814,2020,Informatique,1,Les Logiciels,2,Traitement de Texte,8,485,6,QROC,0.62,0.21,30.38,11,25,36,26,11,15,1.38,42.31,Difficile,Difficile,0,Meme Difficulte que la Prediction,Pas Adapte
485,2015,Informatique,1,Les Logiciels,2,Traitement de Texte,8,486,7,QCM,0.12,0.83,95.31,24,1,25,25,24,1,1.0,96.0,Moyen,Facile,1,Plus Facile que la Prediction,Pas Adapte
1551,2016,Informatique,1,Les Logiciels,2,Traitement de Texte,8,486,7,QCM,0.13,0.93,92.37,26,2,28,26,26,0,1.08,100.0,Facile,Facile,0,Meme Difficulte que la Prediction,Pas Adapte
2617,2017,Informatique,1,Les Logiciels,2,Traitement de Texte,8,486,7,QCU,0.52,0.35,3.94,1,23,24,9,1,8,2.67,11.11,Difficile,Difficile,0,Meme Difficulte que la Prediction,Pas Adapte
3683,2018,Informatique,1,Les Logiciels,2,Traitement de Texte,8,486,7,QCU,0.66,0.22,31.17,8,17,25,24,8,16,1.04,33.33,Moyen,Difficile,-1,Plus Difficile que la Prediction,Pas Adapte
4749,2019,Informatique,1,Les Logiciels,2,Traitement de Texte,8,486,7,QCU,0.07,0.89,79.4,23,6,29,26,23,3,1.12,88.46,Facile,Facile,0,Meme Difficulte que la Prediction,Pas Adapte
5815,2020,Informatique,1,Les Logiciels,2,Traitement de Texte,8,486,7,QCU,0.26,0.67,62.79,18,11,29,24,18,6,1.21,75.0,Facile,Moyen,-1,Plus Difficile que la Prediction,Adapte
486,2015,Informatique,1,Les Logiciels,2,Traitement de Texte,8,487,8,QCU,0.33,0.63,40.15,6,8,14,12,6,6,1.17,50.0,Difficile,Moyen,1,Plus Facile que la Prediction,Pas Adapte
1552,2016,Informatique,1,Les Logiciels,2,Traitement de Texte,8,487,8,QROC,0.15,0.65,86.49,13,2,15,15,13,2,1.0,86.67,Moyen,Facile,1,Plus Facile que la Prediction,Pas Adapte
2618,2017,Informatique,1,Les Logiciels,2,Traitement de Texte,8,487,8,QCM,0.71,0.22,0.73,0,13,13,10,0,10,1.3,0.0,Difficile,Difficile,0,Meme Difficulte que la Prediction,Pas Adapte
3684,2018,Informatique,1,Les Logiciels,2,Traitement de Texte,8,487,8,QCM,0.06,0.74,89.73,13,2,15,14,13,1,1.07,92.86,Facile,Facile,0,Meme Difficulte que la Prediction,Pas Adapte
4750,2019,Informatique,1,Les Logiciels,2,Traitement de Texte,8,487,8,QCM,0.08,0.96,91.81,12,1,13,13,12,1,1.0,92.31,Facile,Facile,0,Meme Difficulte que la Prediction,Pas Adapte
5816,2020,Informatique,1,Les Logiciels,2,Traitement de Texte,8,487,8,QCM,0.6,0.16,21.44,2,9,11,5,2,3,2.2,40.0,Difficile,Difficile,0,Meme Difficulte que la Prediction,Pas Adapte
487,2015,Informatique,1,Les Logiciels,3,Les Tableurs,5,488,1,QCM,0.12,0.93,87.36,75,11,86,79,75,4,1.09,94.94,Facile,Facile,0,Meme Difficulte que la Prediction,Pas Adapte
1553,2016,Informatique,1,Les Logiciels,3,Les Tableurs,5,488,1,QCM,0.67,0.28,16.69,13,63,76,22,13,9,3.45,59.09,Difficile,Difficile,0,Meme Difficulte que la Prediction,Pas Adapte
2619,2017,Informatique,1,Les Logiciels,3,Les Tableurs,5,488,1,QCM,0.1,0.75,71.31,58,23,81,63,58,5,1.29,92.06,Facile,Facile,0,Meme Difficulte que la Prediction,Adapte
3685,2018,Informatique,1,Les Logiciels,3,Les Tableurs,5,488,1,QCM,0.14,0.97,71.31,58,23,81,71,58,13,1.14,81.69,Facile,Facile,0,Meme Difficulte que la Prediction,Adapte
4751,2019,Informatique,1,Les Logiciels,3,Les Tableurs,5,488,1,QCU,0.01,0.84,71.31,61,24,85,84,61,23,1.01,72.62,Facile,Facile,0,Meme Difficulte que la Prediction,Adapte
5817,2020,Informatique,1,Les Logiciels,3,Les Tableurs,5,488,1,QCU,0.18,0.82,71.31,53,21,74,57,53,4,1.3,92.98,Facile,Facile,0,Meme Difficulte que la Prediction,Adapte
488,2015,Informatique,1,Les Logiciels,3,Les Tableurs,5,489,2,QCU,0.2,0.45,57.61,41,31,72,70,41,29,1.03,58.57,Difficile,Moyen,1,Plus Facile que la Prediction,Pas Adapte
1554,2016,Informatique,1,Les Logiciels,3,Les Tableurs,5,489,2,QCM,0.54,0.22,6.15,4,61,65,20,4,16,3.25,20.0,Difficile,Difficile,0,Meme Difficulte que la Prediction,Pas Adapte
2620,2017,Informatique,1,Les Logiciels,3,Les Tableurs,5,489,2,QCM,0.3,0.3,56.6,32,25,57,51,32,19,1.12,62.75,Moyen,Moyen,0,Meme Difficulte que la Prediction,Pas Adapte
3686,2018,Informatique,1,Les Logiciels,3,Les Tableurs,5,489,2,QCM,0.57,0.28,29.58,15,35,50,16,15,1,3.12,93.75,Difficile,Difficile,0,Meme Difficulte que la Prediction,Pas Adapte
4752,2019,Informatique,1,Les Logiciels,3,Les Tableurs,5,489,2,QCM,0.07,0.85,69.62,33,15,48,35,33,2,1.37,94.29,Facile,Facile,0,Meme Difficulte que la Prediction,Adapte
5818,2020,Informatique,1,Les Logiciels,3,Les Tableurs,5,489,2,QCM,0.15,0.78,69.62,38,16,54,42,38,4,1.29,90.48,Facile,Facile,0,Meme Difficulte que la Prediction,Adapte
489,2015,Informatique,1,Les Logiciels,3,Les Tableurs,5,490,3,QCM,0.46,0.64,37.35,29,48,77,54,29,25,1.43,53.7,Moyen,Moyen,0,Meme Difficulte que la Prediction,Pas Adapte
1555,2016,Informatique,1,Les Logiciels,3,Les Tableurs,5,490,3,QCM,0.5,0.44,48.86,34,35,69,67,34,33,1.03,50.75,Difficile,Moyen,1,Plus Facile que la Prediction,Pas Adapte
2621,2017,Informatique,1,Les Logiciels,3,Les Tableurs,5,490,3,QCM,0.53,0.2,8.83,6,65,71,45,6,39,1.58,13.33,Difficile,Difficile,0,Meme Difficulte que la Prediction,Pas Adapte
3687,2018,Informatique,1,Les Logiciels,3,Les Tableurs,5,490,3,QCM,0.44,0.54,40.78,27,39,66,33,27,6,2.0,81.82,Moyen,Moyen,0,Meme Difficulte que la Prediction,Pas Adapte
4753,2019,Informatique,1,Les Logiciels,3,Les Tableurs,5,490,3,QCM,0.57,0.24,21.34,16,59,75,66,16,50,1.14,24.24,Difficile,Difficile,0,Meme Difficulte que la Prediction,Pas Adapte
5819,2020,Informatique,1,Les Logiciels,3,Les Tableurs,5,490,3,QCM,0.06,0.96,88.33,59,8,67,59,59,0,1.14,100.0,Difficile,Facile,2,Beaucoup plus Facile que la Prediction,Pas Adapte
490,2015,Informatique,1,Les Logiciels,3,Les Tableurs,5,491,4,QCU,0.36,0.53,50.47,28,28,56,47,28,19,1.19,59.57,Facile,Moyen,-1,Plus Difficile que la Prediction,Pas Adapte
1556,2016,Informatique,1,Les Logiciels,3,Les Tableurs,5,491,4,QCU,0.6,0.38,5.84,3,51,54,39,3,36,1.38,7.69,Difficile,Difficile,0,Meme Difficulte que la Prediction,Pas Adapte
2622,2017,Informatique,1,Les Logiciels,3,Les Tableurs,5,491,4,QCU,0.52,0.38,24.34,15,47,62,27,15,12,2.3,55.56,Difficile,Difficile,0,Meme Difficulte que la Prediction,Pas Adapte
3688,2018,Informatique,1,Les Logiciels,3,Les Tableurs,5,491,4,QCU,0.36,0.43,47.88,28,31,59,40,28,12,1.48,70.0,Facile,Moyen,-1,Plus Difficile que la Prediction,Pas Adapte
4754,2019,Informatique,1,Les Logiciels,3,Les Tableurs,5,491,4,QCU,0.04,0.81,84.65,47,9,56,55,47,8,1.02,85.45,Facile,Facile,0,Meme Difficulte que la Prediction,Pas Adapte
5820,2020,Informatique,1,Les Logiciels,3,Les Tableurs,5,491,4,QCU,0.48,0.27,10.86,6,49,55,42,6,36,1.31,14.29,Moyen,Difficile,-1,Plus Difficile que la Prediction,Pas Adapte
491,2015,Informatique,1,Les Logiciels,3,Les Tableurs,5,492,5,QCM,0.15,0.74,86.36,74,12,86,78,74,4,1.1,94.87,Facile,Facile,0,Meme Difficulte que la Prediction,Pas Adapte
1557,2016,Informatique,1,Les Logiciels,3,Les Tableurs,5,492,5,QCM,0.52,0.22,7.08,6,78,84,38,6,32,2.21,15.79,Difficile,Difficile,0,Meme Difficulte que la Prediction,Pas Adapte
2623,2017,Informatique,1,Les Logiciels,3,Les Tableurs,5,492,5,QCM,0.55,0.29,26.17,23,64,87,29,23,6,3.0,79.31,Moyen,Difficile,-1,Plus Difficile que la Prediction,Pas Adapte
3689,2018,Informatique,1,Les Logiciels,3,Les Tableurs,5,492,5,QCM,0.15,0.99,78.84,63,17,80,70,63,7,1.14,90.0,Facile,Facile,0,Meme Difficulte que la Prediction,Pas Adapte
4755,2019,Informatique,1,Les Logiciels,3,Les Tableurs,5,492,5,QCM,0.77,0.19,17.55,14,63,77,29,14,15,2.66,48.28,Difficile,Difficile,0,Meme Difficulte que la Prediction,Pas Adapte
5821,2020,Informatique,1,Les Logiciels,3,Les Tableurs,5,492,5,QCM,0.06,1.0,99.65,87,0,87,87,87,0,1.0,100.0,Facile,Facile,0,Meme Difficulte que la Prediction,Pas Adapte
492,2015,Informatique,1,Algorithme et Programmation,1,Notion d'Algorithme,9,493,1,QCU,0.73,0.38,23.24,13,44,57,31,13,18,1.84,41.94,Moyen,Difficile,-1,Plus Difficile que la Prediction,Pas Adapte
1558,2016,Informatique,1,Algorithme et Programmation,1,Notion d'Algorithme,9,493,1,QCU,0.46,0.29,7.48,5,56,61,55,5,50,1.11,9.09,Difficile,Difficile,0,Meme Difficulte que la Prediction,Pas Adapte
2624,2017,Informatique,1,Algorithme et Programmation,1,Notion d'Algorithme,9,493,1,QCU,0.51,0.3,3.96,3,62,65,46,3,43,1.41,6.52,Facile,Difficile,-2,Beaucoup plus Difficile que la Prediction,Pas Adapte
3690,2018,Informatique,1,Algorithme et Programmation,1,Notion d'Algorithme,9,493,1,QCU,0.26,0.53,62.16,36,22,58,37,36,1,1.57,97.3,Facile,Moyen,-1,Plus Difficile que la Prediction,Adapte
4756,2019,Informatique,1,Algorithme et Programmation,1,Notion d'Algorithme,9,493,1,QCU,0.39,0.43,62.16,31,19,50,44,31,13,1.14,70.45,Moyen,Moyen,0,Meme Difficulte que la Prediction,Adapte
5822,2020,Informatique,1,Algorithme et Programmation,1,Notion d'Algorithme,9,493,1,QCU,0.33,0.45,62.16,31,19,50,38,31,7,1.32,81.58,Moyen,Moyen,0,Meme Difficulte que la Prediction,Adapte
493,2015,Informatique,1,Algorithme et Programmation,1,Notion d'Algorithme,9,494,2,QROC,0.61,0.01,15.74,4,22,26,18,4,14,1.44,22.22,Difficile,Difficile,0,Meme Difficulte que la Prediction,Pas Adapte
1559,2016,Informatique,1,Algorithme et Programmation,1,Notion d'Algorithme,9,494,2,QROC,0.85,0.0,12.69,3,20,23,19,3,16,1.21,15.79,Difficile,Difficile,0,Meme Difficulte que la Prediction,Pas Adapte
2625,2017,Informatique,1,Algorithme et Programmation,1,Notion d'Algorithme,9,494,2,QROC,0.52,0.39,48.32,11,12,23,12,11,1,1.92,91.67,Moyen,Moyen,0,Meme Difficulte que la Prediction,Pas Adapte
3691,2018,Informatique,1,Algorithme et Programmation,1,Notion d'Algorithme,9,494,2,QROC,0.3,0.29,40.57,10,15,25,23,10,13,1.09,43.48,Moyen,Moyen,0,Meme Difficulte que la Prediction,Pas Adapte
4757,2019,Informatique,1,Algorithme et Programmation,1,Notion d'Algorithme,9,494,2,QROC,0.79,0.09,20.23,5,21,26,16,5,11,1.62,31.25,Facile,Difficile,-2,Beaucoup plus Difficile que la Prediction,Pas Adapte
5823,2020,Informatique,1,Algorithme et Programmation,1,Notion d'Algorithme,9,494,2,QROC,0.08,0.51,66.92,19,9,28,21,19,2,1.33,90.48,Facile,Facile,0,Meme Difficulte que la Prediction,Adapte
494,2015,Informatique,1,Algorithme et Programmation,1,Notion d'Algorithme,9,495,3,QCU,0.08,0.85,70.38,6,2,8,8,6,2,1.0,75.0,Facile,Facile,0,Meme Difficulte que la Prediction,Adapte
1560,2016,Informatique,1,Algorithme et Programmation,1,Notion d'Algorithme,9,495,3,QCU,0.07,0.79,70.38,6,2,8,7,6,1,1.14,85.71,Facile,Facile,0,Meme Difficulte que la Prediction,Adapte
2626,2017,Informatique,1,Algorithme et Programmation,1,Notion d'Algorithme,9,495,3,QCM,0.14,0.72,70.38,6,2,8,7,6,1,1.14,85.71,Facile,Facile,0,Meme Difficulte que la Prediction,Adapte
3692,2018,Informatique,1,Algorithme et Programmation,1,Notion d'Algorithme,9,495,3,QCM,0.18,0.84,70.38,5,2,7,6,5,1,1.17,83.33,Facile,Facile,0,Meme Difficulte que la Prediction,Adapte
4758,2019,Informatique,1,Algorithme et Programmation,1,Notion d'Algorithme,9,495,3,QCM,0.2,0.76,70.38,5,2,7,5,5,0,1.4,100.0,Facile,Facile,0,Meme Difficulte que la Prediction,Adapte
5824,2020,Informatique,1,Algorithme et Programmation,1,Notion d'Algorithme,9,495,3,QCM,0.04,0.98,70.38,4,2,6,6,4,2,1.0,66.67,Facile,Facile,0,Meme Difficulte que la Prediction,Adapte
495,2015,Informatique,1,Algorithme et Programmation,1,Notion d'Algorithme,9,496,4,QCM,0.44,0.38,37.52,17,29,46,39,17,22,1.18,43.59,Moyen,Moyen,0,Meme Difficulte que la Prediction,Pas Adapte
1561,2016,Informatique,1,Algorithme et Programmation,1,Notion d'Algorithme,9,496,4,QROC,0.02,0.56,89.85,39,4,43,42,39,3,1.02,92.86,Difficile,Facile,2,Beaucoup plus Facile que la Prediction,Pas Adapte
2627,2017,Informatique,1,Algorithme et Programmation,1,Notion d'Algorithme,9,496,4,QROC,0.1,0.77,81.74,30,7,37,35,30,5,1.06,85.71,Moyen,Facile,1,Plus Facile que la Prediction,Pas Adapte
3693,2018,Informatique,1,Algorithme et Programmation,1,Notion d'Algorithme,9,496,4,QO,0.09,0.87,81.61,29,7,36,29,29,0,1.24,100.0,Facile,Facile,0,Meme Difficulte que la Prediction,Pas Adapte
4759,2019,Informatique,1,Algorithme et Programmation,1,Notion d'Algorithme,9,496,4,QO,0.18,0.68,96.0,35,1,36,36,35,1,1.0,97.22,Moyen,Facile,1,Plus Facile que la Prediction,Pas Adapte
5825,2020,Informatique,1,Algorithme et Programmation,1,Notion d'Algorithme,9,496,4,QO,0.66,0.2,45.72,16,19,35,26,16,10,1.35,61.54,Moyen,Moyen,0,Meme Difficulte que la Prediction,Pas Adapte
496,2015,Informatique,1,Algorithme et Programmation,1,Notion d'Algorithme,9,497,5,QROC,0.16,0.87,68.89,27,12,39,37,27,10,1.05,72.97,Facile,Facile,0,Meme Difficulte que la Prediction,Adapte
1562,2016,Informatique,1,Algorithme et Programmation,1,Notion d'Algorithme,9,497,5,QROC,0.05,0.56,68.89,31,14,45,39,31,8,1.15,79.49,Facile,Facile,0,Meme Difficulte que la Prediction,Adapte
2628,2017,Informatique,1,Algorithme et Programmation,1,Notion d'Algorithme,9,497,5,QROC,0.04,0.46,68.89,32,14,46,45,32,13,1.02,71.11,Facile,Facile,0,Meme Difficulte que la Prediction,Adapte
3694,2018,Informatique,1,Algorithme et Programmation,1,Notion d'Algorithme,9,497,5,QROC,0.19,0.66,68.89,34,16,50,43,34,9,1.16,79.07,Facile,Facile,0,Meme Difficulte que la Prediction,Adapte
4760,2019,Informatique,1,Algorithme et Programmation,1,Notion d'Algorithme,9,497,5,QROC,0.16,0.75,68.89,37,16,53,43,37,6,1.23,86.05,Facile,Facile,0,Meme Difficulte que la Prediction,Adapte
5826,2020,Informatique,1,Algorithme et Programmation,1,Notion d'Algorithme,9,497,5,QROC,0.15,0.58,68.89,37,17,54,37,37,0,1.46,100.0,Facile,Facile,0,Meme Difficulte que la Prediction,Adapte
497,2015,Informatique,1,Algorithme et Programmation,1,Notion d'Algorithme,9,498,6,QCM,0.31,0.61,61.7,7,5,12,10,7,3,1.2,70.0,Moyen,Moyen,0,Meme Difficulte que la Prediction,Adapte
1563,2016,Informatique,1,Algorithme et Programmation,1,Notion d'Algorithme,9,498,6,QCM,0.49,0.68,61.7,8,5,13,9,8,1,1.44,88.89,Moyen,Moyen,0,Meme Difficulte que la Prediction,Adapte
2629,2017,Informatique,1,Algorithme et Programmation,1,Notion d'Algorithme,9,498,6,QCM,0.23,0.31,61.7,9,5,14,10,9,1,1.4,90.0,Moyen,Moyen,0,Meme Difficulte que la Prediction,Adapte
3695,2018,Informatique,1,Algorithme et Programmation,1,Notion d'Algorithme,9,498,6,QCM,0.34,0.36,61.7,9,6,15,9,9,0,1.67,100.0,Moyen,Moyen,0,Meme Difficulte que la Prediction,Adapte
4761,2019,Informatique,1,Algorithme et Programmation,1,Notion d'Algorithme,9,498,6,QCM,0.42,0.62,61.7,9,6,15,15,9,6,1.0,60.0,Moyen,Moyen,0,Meme Difficulte que la Prediction,Adapte
5827,2020,Informatique,1,Algorithme et Programmation,1,Notion d'Algorithme,9,498,6,QCM,0.31,0.63,61.7,10,7,17,10,10,0,1.7,100.0,Moyen,Moyen,0,Meme Difficulte que la Prediction,Adapte
498,2015,Informatique,1,Algorithme et Programmation,1,Notion d'Algorithme,9,499,7,QCM,0.53,0.29,13.86,12,78,90,47,12,35,1.91,25.53,Difficile,Difficile,0,Meme Difficulte que la Prediction,Pas Adapte
1564,2016,Informatique,1,Algorithme et Programmation,1,Notion d'Algorithme,9,499,7,QCM,0.16,0.75,89.34,90,11,101,99,90,9,1.02,90.91,Facile,Facile,0,Meme Difficulte que la Prediction,Pas Adapte
2630,2017,Informatique,1,Algorithme et Programmation,1,Notion d'Algorithme,9,499,7,QCM,0.37,0.66,44.18,42,53,95,61,42,19,1.56,68.85,Moyen,Moyen,0,Meme Difficulte que la Prediction,Pas Adapte
3696,2018,Informatique,1,Algorithme et Programmation,1,Notion d'Algorithme,9,499,7,QCM,0.15,0.82,90.53,81,9,90,83,81,2,1.08,97.59,Facile,Facile,0,Meme Difficulte que la Prediction,Pas Adapte
4762,2019,Informatique,1,Algorithme et Programmation,1,Notion d'Algorithme,9,499,7,QCM,0.73,0.21,18.38,17,78,95,38,17,21,2.5,44.74,Difficile,Difficile,0,Meme Difficulte que la Prediction,Pas Adapte
5828,2020,Informatique,1,Algorithme et Programmation,1,Notion d'Algorithme,9,499,7,QCM,0.53,0.25,1.34,1,81,82,75,1,74,1.09,1.33,Difficile,Difficile,0,Meme Difficulte que la Prediction,Pas Adapte
499,2015,Informatique,1,Algorithme et Programmation,1,Notion d'Algorithme,9,500,8,QROC,0.7,0.24,32.35,5,11,16,13,5,8,1.23,38.46,Difficile,Difficile,0,Meme Difficulte que la Prediction,Pas Adapte
1565,2016,Informatique,1,Algorithme et Programmation,1,Notion d'Algorithme,9,500,8,QROC,0.25,0.3,36.01,6,10,16,14,6,8,1.14,42.86,Facile,Moyen,-1,Plus Difficile que la Prediction,Pas Adapte
2631,2017,Informatique,1,Algorithme et Programmation,1,Notion d'Algorithme,9,500,8,QO,0.78,0.0,20.36,3,13,16,8,3,5,2.0,37.5,Difficile,Difficile,0,Meme Difficulte que la Prediction,Pas Adapte
3697,2018,Informatique,1,Algorithme et Programmation,1,Notion d'Algorithme,9,500,8,QO,0.31,0.28,44.94,8,9,17,15,8,7,1.13,53.33,Moyen,Moyen,0,Meme Difficulte que la Prediction,Pas Adapte
4763,2019,Informatique,1,Algorithme et Programmation,1,Notion d'Algorithme,9,500,8,QCU,0.72,0.34,0.46,0,16,16,9,0,9,1.78,0.0,Difficile,Difficile,0,Meme Difficulte que la Prediction,Pas Adapte
5829,2020,Informatique,1,Algorithme et Programmation,1,Notion d'Algorithme,9,500,8,QCM,0.11,0.98,95.87,13,1,14,13,13,0,1.08,100.0,Facile,Facile,0,Meme Difficulte que la Prediction,Pas Adapte
500,2015,Informatique,1,Algorithme et Programmation,1,Notion d'Algorithme,9,501,9,QROC,0.71,0.21,15.71,8,40,48,23,8,15,2.09,34.78,Moyen,Difficile,-1,Plus Difficile que la Prediction,Pas Adapte
1566,2016,Informatique,1,Algorithme et Programmation,1,Notion d'Algorithme,9,501,9,QROC,0.13,0.77,83.13,45,9,54,53,45,8,1.02,84.91,Difficile,Facile,2,Beaucoup plus Facile que la Prediction,Pas Adapte
2632,2017,Informatique,1,Algorithme et Programmation,1,Notion d'Algorithme,9,501,9,QROC,0.86,0.01,31.12,16,34,50,36,16,20,1.39,44.44,Moyen,Difficile,-1,Plus Difficile que la Prediction,Pas Adapte
3698,2018,Informatique,1,Algorithme et Programmation,1,Notion d'Algorithme,9,501,9,QROC,0.97,0.15,17.76,9,42,51,21,9,12,2.43,42.86,Difficile,Difficile,0,Meme Difficulte que la Prediction,Pas Adapte
4764,2019,Informatique,1,Algorithme et Programmation,1,Notion d'Algorithme,9,501,9,QROC,0.73,0.2,12.33,5,39,44,29,5,24,1.52,17.24,Moyen,Difficile,-1,Plus Difficile que la Prediction,Pas Adapte
5830,2020,Informatique,1,Algorithme et Programmation,1,Notion d'Algorithme,9,501,9,QROC,0.38,0.37,40.87,20,28,48,36,20,16,1.33,55.56,Facile,Moyen,-1,Plus Difficile que la Prediction,Pas Adapte
501,2015,Informatique,1,Algorithme et Programmation,2,Instruction de Base,10,502,1,QCU,0.15,0.96,84.05,66,13,79,68,66,2,1.16,97.06,Facile,Facile,0,Meme Difficulte que la Prediction,Pas Adapte
1567,2016,Informatique,1,Algorithme et Programmation,2,Instruction de Base,10,502,1,QCU,0.09,0.78,82.49,68,14,82,81,68,13,1.01,83.95,Difficile,Facile,2,Beaucoup plus Facile que la Prediction,Pas Adapte
2633,2017,Informatique,1,Algorithme et Programmation,2,Instruction de Base,10,502,1,QCU,0.1,0.89,81.56,67,15,82,80,67,13,1.02,83.75,Facile,Facile,0,Meme Difficulte que la Prediction,Pas Adapte
3699,2018,Informatique,1,Algorithme et Programmation,2,Instruction de Base,10,502,1,QCM,0.09,0.89,75.12,65,22,87,78,65,13,1.12,83.33,Facile,Facile,0,Meme Difficulte que la Prediction,Pas Adapte
4765,2019,Informatique,1,Algorithme et Programmation,2,Instruction de Base,10,502,1,QCM,0.15,0.71,88.78,67,8,75,67,67,0,1.12,100.0,Difficile,Facile,2,Beaucoup plus Facile que la Prediction,Pas Adapte
5831,2020,Informatique,1,Algorithme et Programmation,2,Instruction de Base,10,502,1,QCM,0.29,0.44,40.99,29,42,71,45,29,16,1.58,64.44,Moyen,Moyen,0,Meme Difficulte que la Prediction,Pas Adapte
502,2015,Informatique,1,Algorithme et Programmation,2,Instruction de Base,10,503,2,QCM,0.22,0.44,36.9,19,33,52,39,19,20,1.33,48.72,Difficile,Moyen,1,Plus Facile que la Prediction,Pas Adapte
1568,2016,Informatique,1,Algorithme et Programmation,2,Instruction de Base,10,503,2,QCM,0.18,0.71,95.27,52,3,55,53,52,1,1.04,98.11,Difficile,Facile,2,Beaucoup plus Facile que la Prediction,Pas Adapte
2634,2017,Informatique,1,Algorithme et Programmation,2,Instruction de Base,10,503,2,QCM,0.06,0.9,94.09,49,3,52,52,49,3,1.0,94.23,Difficile,Facile,2,Beaucoup plus Facile que la Prediction,Pas Adapte
3700,2018,Informatique,1,Algorithme et Programmation,2,Instruction de Base,10,503,2,QCU,0.24,0.58,42.2,21,28,49,39,21,18,1.26,53.85,Facile,Moyen,-1,Plus Difficile que la Prediction,Pas Adapte
4766,2019,Informatique,1,Algorithme et Programmation,2,Instruction de Base,10,503,2,QCU,0.63,0.22,13.76,7,47,54,22,7,15,2.45,31.82,Difficile,Difficile,0,Meme Difficulte que la Prediction,Pas Adapte
5832,2020,Informatique,1,Algorithme et Programmation,2,Instruction de Base,10,503,2,QCU,0.05,0.93,74.13,37,13,50,49,37,12,1.02,75.51,Moyen,Facile,1,Plus Facile que la Prediction,Adapte
503,2015,Informatique,1,Algorithme et Programmation,2,Instruction de Base,10,504,3,QCM,0.1,0.91,67.51,34,16,50,39,34,5,1.28,87.18,Difficile,Facile,2,Beaucoup plus Facile que la Prediction,Adapte
1569,2016,Informatique,1,Algorithme et Programmation,2,Instruction de Base,10,504,3,QCM,0.04,0.76,67.51,28,14,42,32,28,4,1.31,87.5,Facile,Facile,0,Meme Difficulte que la Prediction,Adapte
2635,2017,Informatique,1,Algorithme et Programmation,2,Instruction de Base,10,504,3,QCM,0.13,0.93,67.51,28,14,42,41,28,13,1.02,68.29,Facile,Facile,0,Meme Difficulte que la Prediction,Adapte
3701,2018,Informatique,1,Algorithme et Programmation,2,Instruction de Base,10,504,3,QCM,0.03,0.84,67.51,31,15,46,38,31,7,1.21,81.58,Facile,Facile,0,Meme Difficulte que la Prediction,Adapte
4767,2019,Informatique,1,Algorithme et Programmation,2,Instruction de Base,10,504,3,QCM,0.11,0.88,67.51,30,14,44,43,30,13,1.02,69.77,Facile,Facile,0,Meme Difficulte que la Prediction,Adapte
5833,2020,Informatique,1,Algorithme et Programmation,2,Instruction de Base,10,504,3,QCM,0.08,0.84,67.51,32,16,48,33,32,1,1.45,96.97,Facile,Facile,0,Meme Difficulte que la Prediction,Adapte
504,2015,Informatique,1,Algorithme et Programmation,2,Instruction de Base,10,505,4,QROC,0.07,0.64,99.8,63,0,63,63,63,0,1.0,100.0,Difficile,Facile,2,Beaucoup plus Facile que la Prediction,Pas Adapte
1570,2016,Informatique,1,Algorithme et Programmation,2,Instruction de Base,10,505,4,QROC,0.12,0.61,75.56,54,18,72,70,54,16,1.03,77.14,Facile,Facile,0,Meme Difficulte que la Prediction,Pas Adapte
2636,2017,Informatique,1,Algorithme et Programmation,2,Instruction de Base,10,505,4,QROC,0.84,0.11,31.43,25,55,80,75,25,50,1.07,33.33,Difficile,Difficile,0,Meme Difficulte que la Prediction,Pas Adapte
3702,2018,Informatique,1,Algorithme et Programmation,2,Instruction de Base,10,505,4,QROC,0.75,0.16,34.25,28,55,83,43,28,15,1.93,65.12,Moyen,Difficile,-1,Plus Difficile que la Prediction,Pas Adapte
4768,2019,Informatique,1,Algorithme et Programmation,2,Instruction de Base,10,505,4,QO,0.78,0.12,31.72,23,49,72,39,23,16,1.85,58.97,Difficile,Difficile,0,Meme Difficulte que la Prediction,Pas Adapte
5834,2020,Informatique,1,Algorithme et Programmation,2,Instruction de Base,10,505,4,QO,0.06,0.75,94.47,73,4,77,77,73,4,1.0,94.81,Moyen,Facile,1,Plus Facile que la Prediction,Pas Adapte
505,2015,Informatique,1,Algorithme et Programmation,2,Instruction de Base,10,506,5,QCU,0.06,0.96,72.22,70,27,97,71,70,1,1.37,98.59,Difficile,Facile,2,Beaucoup plus Facile que la Prediction,Adapte
1571,2016,Informatique,1,Algorithme et Programmation,2,Instruction de Base,10,506,5,QCU,0.09,0.76,72.22,79,30,109,89,79,10,1.22,88.76,Facile,Facile,0,Meme Difficulte que la Prediction,Adapte
2637,2017,Informatique,1,Algorithme et Programmation,2,Instruction de Base,10,506,5,QCU,0.18,0.79,72.22,87,33,120,105,87,18,1.14,82.86,Facile,Facile,0,Meme Difficulte que la Prediction,Adapte
3703,2018,Informatique,1,Algorithme et Programmation,2,Instruction de Base,10,506,5,QCU,0.03,0.95,72.22,95,36,131,121,95,26,1.08,78.51,Facile,Facile,0,Meme Difficulte que la Prediction,Adapte
4769,2019,Informatique,1,Algorithme et Programmation,2,Instruction de Base,10,506,5,QCU,0.01,0.91,72.22,83,32,115,97,83,14,1.19,85.57,Facile,Facile,0,Meme Difficulte que la Prediction,Adapte
5835,2020,Informatique,1,Algorithme et Programmation,2,Instruction de Base,10,506,5,QCU,0.07,0.84,72.22,92,35,127,101,92,9,1.26,91.09,Facile,Facile,0,Meme Difficulte que la Prediction,Adapte
506,2015,Informatique,1,Algorithme et Programmation,2,Instruction de Base,10,507,6,QCM,0.52,0.21,24.1,1,4,5,5,1,4,1.0,20.0,Facile,Difficile,-2,Beaucoup plus Difficile que la Prediction,Pas Adapte
1572,2016,Informatique,1,Algorithme et Programmation,2,Instruction de Base,10,507,6,QCU,0.18,0.93,66.97,3,1,4,4,3,1,1.0,75.0,Moyen,Facile,1,Plus Facile que la Prediction,Adapte
2638,2017,Informatique,1,Algorithme et Programmation,2,Instruction de Base,10,507,6,QCU,0.15,0.9,66.97,2,1,3,2,2,0,1.5,100.0,Facile,Facile,0,Meme Difficulte que la Prediction,Adapte
3704,2018,Informatique,1,Algorithme et Programmation,2,Instruction de Base,10,507,6,QCU,0.09,0.95,66.97,2,1,3,2,2,0,1.5,100.0,Facile,Facile,0,Meme Difficulte que la Prediction,Adapte
4770,2019,Informatique,1,Algorithme et Programmation,2,Instruction de Base,10,507,6,QCU,0.15,0.97,66.97,2,1,3,2,2,0,1.5,100.0,Facile,Facile,0,Meme Difficulte que la Prediction,Adapte
5836,2020,Informatique,1,Algorithme et Programmation,2,Instruction de Base,10,507,6,QCU,0.1,0.98,66.97,2,1,3,3,2,1,1.0,66.67,Facile,Facile,0,Meme Difficulte que la Prediction,Adapte
507,2015,Informatique,1,Algorithme et Programmation,2,Instruction de Base,10,508,7,QCU,0.61,0.39,9.04,8,86,94,69,8,61,1.36,11.59,Facile,Difficile,-2,Beaucoup plus Difficile que la Prediction,Pas Adapte
1573,2016,Informatique,1,Algorithme et Programmation,2,Instruction de Base,10,508,7,QCU,0.47,0.26,28.12,24,63,87,46,24,22,1.89,52.17,Facile,Difficile,-2,Beaucoup plus Difficile que la Prediction,Pas Adapte
2639,2017,Informatique,1,Algorithme et Programmation,2,Instruction de Base,10,508,7,QCU,0.06,0.89,86.13,85,14,99,97,85,12,1.02,87.63,Moyen,Facile,1,Plus Facile que la Prediction,Pas Adapte
3705,2018,Informatique,1,Algorithme et Programmation,2,Instruction de Base,10,508,7,QCU,0.03,0.97,90.4,99,11,110,109,99,10,1.01,90.83,Facile,Facile,0,Meme Difficulte que la Prediction,Pas Adapte
4771,2019,Informatique,1,Algorithme et Programmation,2,Instruction de Base,10,508,7,QCU,0.53,0.28,16.63,17,86,103,83,17,66,1.24,20.48,Difficile,Difficile,0,Meme Difficulte que la Prediction,Pas Adapte
5837,2020,Informatique,1,Algorithme et Programmation,2,Instruction de Base,10,508,7,QCU,0.35,0.47,49.58,46,47,93,71,46,25,1.31,64.79,Moyen,Moyen,0,Meme Difficulte que la Prediction,Pas Adapte
508,2015,Informatique,1,Algorithme et Programmation,2,Instruction de Base,10,509,8,QCU,0.02,0.82,70.87,11,5,16,15,11,4,1.07,73.33,Difficile,Facile,2,Beaucoup plus Facile que la Prediction,Adapte
1574,2016,Informatique,1,Algorithme et Programmation,2,Instruction de Base,10,509,8,QCU,0.06,0.91,70.87,12,5,17,12,12,0,1.42,100.0,Facile,Facile,0,Meme Difficulte que la Prediction,Adapte
2640,2017,Informatique,1,Algorithme et Programmation,2,Instruction de Base,10,509,8,QCU,0.13,0.95,70.87,13,6,19,15,13,2,1.27,86.67,Facile,Facile,0,Meme Difficulte que la Prediction,Adapte
3706,2018,Informatique,1,Algorithme et Programmation,2,Instruction de Base,10,509,8,QCU,0.04,0.91,70.87,12,5,17,16,12,4,1.06,75.0,Facile,Facile,0,Meme Difficulte que la Prediction,Adapte
4772,2019,Informatique,1,Algorithme et Programmation,2,Instruction de Base,10,509,8,QCU,0.11,0.8,70.87,11,5,16,16,11,5,1.0,68.75,Facile,Facile,0,Meme Difficulte que la Prediction,Adapte
5838,2020,Informatique,1,Algorithme et Programmation,2,Instruction de Base,10,509,8,QCU,0.07,0.79,70.87,10,4,14,11,10,1,1.27,90.91,Facile,Facile,0,Meme Difficulte que la Prediction,Adapte
509,2015,Informatique,1,Algorithme et Programmation,2,Instruction de Base,10,510,9,QCU,0.19,0.92,96.46,65,2,67,67,65,2,1.0,97.01,Facile,Facile,0,Meme Difficulte que la Prediction,Pas Adapte
1575,2016,Informatique,1,Algorithme et Programmation,2,Instruction de Base,10,510,9,QCU,0.25,0.58,60.71,35,22,57,53,35,18,1.08,66.04,Facile,Moyen,-1,Plus Difficile que la Prediction,Adapte
2641,2017,Informatique,1,Algorithme et Programmation,2,Instruction de Base,10,510,9,QCU,0.39,0.41,60.71,34,22,56,53,34,19,1.06,64.15,Moyen,Moyen,0,Meme Difficulte que la Prediction,Adapte
3707,2018,Informatique,1,Algorithme et Programmation,2,Instruction de Base,10,510,9,QO,0.26,0.24,60.71,38,25,63,59,38,21,1.07,64.41,Moyen,Moyen,0,Meme Difficulte que la Prediction,Adapte
4773,2019,Informatique,1,Algorithme et Programmation,2,Instruction de Base,10,510,9,QCM,0.32,0.41,60.71,41,27,68,52,41,11,1.31,78.85,Moyen,Moyen,0,Meme Difficulte que la Prediction,Adapte
5839,2020,Informatique,1,Algorithme et Programmation,2,Instruction de Base,10,510,9,QCM,0.48,0.57,60.71,47,30,77,73,47,26,1.05,64.38,Moyen,Moyen,0,Meme Difficulte que la Prediction,Adapte
510,2015,Informatique,1,Algorithme et Programmation,2,Instruction de Base,10,511,10,QCU,0.39,0.45,38.71,27,42,69,59,27,32,1.17,45.76,Facile,Moyen,-1,Plus Difficile que la Prediction,Pas Adapte
1576,2016,Informatique,1,Algorithme et Programmation,2,Instruction de Base,10,511,10,QCU,0.46,0.29,3.26,2,59,61,51,2,49,1.2,3.92,Difficile,Difficile,0,Meme Difficulte que la Prediction,Pas Adapte
2642,2017,Informatique,1,Algorithme et Programmation,2,Instruction de Base,10,511,10,QCM,0.51,0.26,31.18,21,45,66,39,21,18,1.69,53.85,Difficile,Difficile,0,Meme Difficulte que la Prediction,Pas Adapte
3708,2018,Informatique,1,Algorithme et Programmation,2,Instruction de Base,10,511,10,QCM,0.38,0.3,44.39,28,36,64,63,28,35,1.02,44.44,Facile,Moyen,-1,Plus Difficile que la Prediction,Pas Adapte
4774,2019,Informatique,1,Algorithme et Programmation,2,Instruction de Base,10,511,10,QCM,0.46,0.5,61.64,41,26,67,66,41,25,1.02,62.12,Moyen,Moyen,0,Meme Difficulte que la Prediction,Adapte
5840,2020,Informatique,1,Algorithme et Programmation,2,Instruction de Base,10,511,10,QCM,0.21,0.54,61.64,43,26,69,53,43,10,1.3,81.13,Moyen,Moyen,0,Meme Difficulte que la Prediction,Adapte
511,2015,Informatique,1,Algorithme et Programmation,3,Les Langagues de Programmation,7,512,1,QCM,0.04,0.82,87.54,78,11,89,80,78,2,1.11,97.5,Facile,Facile,0,Meme Difficulte que la Prediction,Pas Adapte
1577,2016,Informatique,1,Algorithme et Programmation,3,Les Langagues de Programmation,7,512,1,QCM,0.12,0.72,76.85,70,21,91,71,70,1,1.28,98.59,Facile,Facile,0,Meme Difficulte que la Prediction,Pas Adapte
2643,2017,Informatique,1,Algorithme et Programmation,3,Les Langagues de Programmation,7,512,1,QCM,0.76,0.17,13.17,13,88,101,82,13,69,1.23,15.85,Difficile,Difficile,0,Meme Difficulte que la Prediction,Pas Adapte
3709,2018,Informatique,1,Algorithme et Programmation,3,Les Langagues de Programmation,7,512,1,QCM,0.43,0.57,56.28,52,41,93,72,52,20,1.29,72.22,Moyen,Moyen,0,Meme Difficulte que la Prediction,Pas Adapte
4775,2019,Informatique,1,Algorithme et Programmation,3,Les Langagues de Programmation,7,512,1,QCM,0.5,0.27,23.01,24,81,105,46,24,22,2.28,52.17,Difficile,Difficile,0,Meme Difficulte que la Prediction,Pas Adapte
5841,2020,Informatique,1,Algorithme et Programmation,3,Les Langagues de Programmation,7,512,1,QCM,0.54,0.24,29.81,30,71,101,77,30,47,1.31,38.96,Difficile,Difficile,0,Meme Difficulte que la Prediction,Pas Adapte
512,2015,Informatique,1,Algorithme et Programmation,3,Les Langagues de Programmation,7,513,2,QCM,0.8,0.21,22.97,17,59,76,36,17,19,2.11,47.22,Difficile,Difficile,0,Meme Difficulte que la Prediction,Pas Adapte
1578,2016,Informatique,1,Algorithme et Programmation,3,Les Langagues de Programmation,7,513,2,QO,0.01,0.33,68.65,48,22,70,61,48,13,1.15,78.69,Facile,Facile,0,Meme Difficulte que la Prediction,Adapte
2644,2017,Informatique,1,Algorithme et Programmation,3,Les Langagues de Programmation,7,513,2,QO,0.0,0.39,68.65,42,19,61,58,42,16,1.05,72.41,Facile,Facile,0,Meme Difficulte que la Prediction,Adapte
3710,2018,Informatique,1,Algorithme et Programmation,3,Les Langagues de Programmation,7,513,2,QO,0.17,0.36,68.65,42,19,61,50,42,8,1.22,84.0,Facile,Facile,0,Meme Difficulte que la Prediction,Adapte
4776,2019,Informatique,1,Algorithme et Programmation,3,Les Langagues de Programmation,7,513,2,QO,0.08,0.36,68.65,46,21,67,64,46,18,1.05,71.88,Facile,Facile,0,Meme Difficulte que la Prediction,Adapte
5842,2020,Informatique,1,Algorithme et Programmation,3,Les Langagues de Programmation,7,513,2,QO,0.14,0.9,68.65,46,21,67,47,46,1,1.43,97.87,Facile,Facile,0,Meme Difficulte que la Prediction,Adapte
513,2015,Informatique,1,Algorithme et Programmation,3,Les Langagues de Programmation,7,514,3,QROC,0.79,0.16,8.46,5,49,54,37,5,32,1.46,13.51,Difficile,Difficile,0,Meme Difficulte que la Prediction,Pas Adapte
1579,2016,Informatique,1,Algorithme et Programmation,3,Les Langagues de Programmation,7,514,3,QROC,0.08,0.86,95.33,48,2,50,49,48,1,1.02,97.96,Moyen,Facile,1,Plus Facile que la Prediction,Pas Adapte
2645,2017,Informatique,1,Algorithme et Programmation,3,Les Langagues de Programmation,7,514,3,QROC,0.9,0.22,8.13,5,52,57,26,5,21,2.19,19.23,Difficile,Difficile,0,Meme Difficulte que la Prediction,Pas Adapte
3711,2018,Informatique,1,Algorithme et Programmation,3,Les Langagues de Programmation,7,514,3,QROC,0.19,0.79,99.74,55,0,55,55,55,0,1.0,100.0,Facile,Facile,0,Meme Difficulte que la Prediction,Pas Adapte
4777,2019,Informatique,1,Algorithme et Programmation,3,Les Langagues de Programmation,7,514,3,QROC,0.41,0.28,43.91,25,32,57,39,25,14,1.46,64.1,Facile,Moyen,-1,Plus Difficile que la Prediction,Pas Adapte
5843,2020,Informatique,1,Algorithme et Programmation,3,Les Langagues de Programmation,7,514,3,QROC,0.68,0.1,11.99,8,55,63,42,8,34,1.5,19.05,Difficile,Difficile,0,Meme Difficulte que la Prediction,Pas Adapte
514,2015,Informatique,1,Algorithme et Programmation,3,Les Langagues de Programmation,7,515,4,QCM,0.07,0.84,95.22,30,2,32,30,30,0,1.07,100.0,Facile,Facile,0,Meme Difficulte que la Prediction,Pas Adapte
1580,2016,Informatique,1,Algorithme et Programmation,3,Les Langagues de Programmation,7,515,4,QCM,0.55,0.22,19.04,6,28,34,28,6,22,1.21,21.43,Difficile,Difficile,0,Meme Difficulte que la Prediction,Pas Adapte
2646,2017,Informatique,1,Algorithme et Programmation,3,Les Langagues de Programmation,7,515,4,QCM,0.74,0.25,34.48,10,20,30,29,10,19,1.03,34.48,Moyen,Difficile,-1,Plus Difficile que la Prediction,Pas Adapte
3712,2018,Informatique,1,Algorithme et Programmation,3,Les Langagues de Programmation,7,515,4,QCM,0.55,0.16,28.59,7,19,26,18,7,11,1.44,38.89,Difficile,Difficile,0,Meme Difficulte que la Prediction,Pas Adapte
4778,2019,Informatique,1,Algorithme et Programmation,3,Les Langagues de Programmation,7,515,4,QCM,0.42,0.62,36.57,11,18,29,26,11,15,1.12,42.31,Moyen,Moyen,0,Meme Difficulte que la Prediction,Pas Adapte
5844,2020,Informatique,1,Algorithme et Programmation,3,Les Langagues de Programmation,7,515,4,QCM,0.67,0.26,23.96,7,23,30,28,7,21,1.07,25.0,Difficile,Difficile,0,Meme Difficulte que la Prediction,Pas Adapte
515,2015,Informatique,1,Algorithme et Programmation,3,Les Langagues de Programmation,7,516,5,QROC,0.48,0.28,49.31,21,21,42,26,21,5,1.62,80.77,Facile,Moyen,-1,Plus Difficile que la Prediction,Pas Adapte
1581,2016,Informatique,1,Algorithme et Programmation,3,Les Langagues de Programmation,7,516,5,QCU,0.04,0.97,73.59,33,12,45,41,33,8,1.1,80.49,Facile,Facile,0,Meme Difficulte que la Prediction,Adapte
2647,2017,Informatique,1,Algorithme et Programmation,3,Les Langagues de Programmation,7,516,5,QO,0.05,0.79,73.59,28,10,38,29,28,1,1.31,96.55,Facile,Facile,0,Meme Difficulte que la Prediction,Adapte
3713,2018,Informatique,1,Algorithme et Programmation,3,Les Langagues de Programmation,7,516,5,QO,0.16,0.72,73.59,31,11,42,40,31,9,1.05,77.5,Facile,Facile,0,Meme Difficulte que la Prediction,Adapte
4779,2019,Informatique,1,Algorithme et Programmation,3,Les Langagues de Programmation,7,516,5,QCU,0.18,0.78,73.59,32,12,44,33,32,1,1.33,96.97,Facile,Facile,0,Meme Difficulte que la Prediction,Adapte
5845,2020,Informatique,1,Algorithme et Programmation,3,Les Langagues de Programmation,7,516,5,QCU,0.13,0.86,73.59,29,11,40,35,29,6,1.14,82.86,Facile,Facile,0,Meme Difficulte que la Prediction,Adapte
516,2015,Informatique,1,Algorithme et Programmation,3,Les Langagues de Programmation,7,517,6,QCU,0.15,0.96,88.17,55,7,62,61,55,6,1.02,90.16,Moyen,Facile,1,Plus Facile que la Prediction,Pas Adapte
1582,2016,Informatique,1,Algorithme et Programmation,3,Les Langagues de Programmation,7,517,6,QCU,0.19,0.96,95.69,58,3,61,59,58,1,1.03,98.31,Moyen,Facile,1,Plus Facile que la Prediction,Pas Adapte
2648,2017,Informatique,1,Algorithme et Programmation,3,Les Langagues de Programmation,7,517,6,QCU,0.19,0.92,82.48,47,10,57,51,47,4,1.12,92.16,Facile,Facile,0,Meme Difficulte que la Prediction,Pas Adapte
3714,2018,Informatique,1,Algorithme et Programmation,3,Les Langagues de Programmation,7,517,6,QCU,0.44,0.34,26.35,14,38,52,42,14,28,1.24,33.33,Facile,Difficile,-2,Beaucoup plus Difficile que la Prediction,Pas Adapte
4780,2019,Informatique,1,Algorithme et Programmation,3,Les Langagues de Programmation,7,517,6,QCU,0.39,0.48,55.78,26,20,46,34,26,8,1.35,76.47,Moyen,Moyen,0,Meme Difficulte que la Prediction,Pas Adapte
5846,2020,Informatique,1,Algorithme et Programmation,3,Les Langagues de Programmation,7,517,6,QCU,0.16,0.8,78.84,41,11,52,49,41,8,1.06,83.67,Facile,Facile,0,Meme Difficulte que la Prediction,Pas Adapte
517,2015,Informatique,1,Algorithme et Programmation,3,Les Langagues de Programmation,7,518,7,QCM,0.63,0.24,14.42,9,54,63,23,9,14,2.74,39.13,Facile,Difficile,-2,Beaucoup plus Difficile que la Prediction,Pas Adapte
1583,2016,Informatique,1,Algorithme et Programmation,3,Les Langagues de Programmation,7,518,7,QCM,0.27,0.61,47.59,31,35,66,36,31,5,1.83,86.11,Moyen,Moyen,0,Meme Difficulte que la Prediction,Pas Adapte
2649,2017,Informatique,1,Algorithme et Programmation,3,Les Langagues de Programmation,7,518,7,QROC,0.77,0.07,14.18,9,52,61,54,9,45,1.13,16.67,Moyen,Difficile,-1,Plus Difficile que la Prediction,Pas Adapte
3715,2018,Informatique,1,Algorithme et Programmation,3,Les Langagues de Programmation,7,518,7,QROC,0.1,0.54,71.2,43,18,61,57,43,14,1.07,75.44,Facile,Facile,0,Meme Difficulte que la Prediction,Adapte
4781,2019,Informatique,1,Algorithme et Programmation,3,Les Langagues de Programmation,7,518,7,QROC,0.04,0.52,71.2,44,18,62,58,44,14,1.07,75.86,Facile,Facile,0,Meme Difficulte que la Prediction,Adapte
5847,2020,Informatique,1,Algorithme et Programmation,3,Les Langagues de Programmation,7,518,7,QROC,0.04,0.55,71.2,38,16,54,38,38,0,1.42,100.0,Facile,Facile,0,Meme Difficulte que la Prediction,Adapte
518,2015,Informatique,1,Reseaux et Internet,1,Ntoion de Reseau Informatique,2,519,1,QO,0.99,0.06,31.53,11,23,34,30,11,19,1.13,36.67,Facile,Difficile,-2,Beaucoup plus Difficile que la Prediction,Pas Adapte
1584,2016,Informatique,1,Reseaux et Internet,1,Ntoion de Reseau Informatique,2,519,1,QCM,0.53,0.28,32.39,11,22,33,24,11,13,1.38,45.83,Moyen,Difficile,-1,Plus Difficile que la Prediction,Pas Adapte
2650,2017,Informatique,1,Reseaux et Internet,1,Ntoion de Reseau Informatique,2,519,1,QCM,0.02,0.74,79.79,24,6,30,25,24,1,1.2,96.0,Moyen,Facile,1,Plus Facile que la Prediction,Pas Adapte
3716,2018,Informatique,1,Reseaux et Internet,1,Ntoion de Reseau Informatique,2,519,1,QCM,0.78,0.19,21.18,7,24,31,10,7,3,3.1,70.0,Facile,Difficile,-2,Beaucoup plus Difficile que la Prediction,Pas Adapte
4782,2019,Informatique,1,Reseaux et Internet,1,Ntoion de Reseau Informatique,2,519,1,QCM,0.23,0.31,45.54,13,16,29,24,13,11,1.21,54.17,Difficile,Moyen,1,Plus Facile que la Prediction,Pas Adapte
5848,2020,Informatique,1,Reseaux et Internet,1,Ntoion de Reseau Informatique,2,519,1,QCM,0.1,1.0,81.44,23,5,28,23,23,0,1.22,100.0,Facile,Facile,0,Meme Difficulte que la Prediction,Pas Adapte
519,2015,Informatique,1,Reseaux et Internet,1,Ntoion de Reseau Informatique,2,520,2,QCU,0.75,0.2,19.97,5,21,26,15,5,10,1.73,33.33,Difficile,Difficile,0,Meme Difficulte que la Prediction,Pas Adapte
1585,2016,Informatique,1,Reseaux et Internet,1,Ntoion de Reseau Informatique,2,520,2,QCU,0.07,0.88,85.3,24,4,28,28,24,4,1.0,85.71,Facile,Facile,0,Meme Difficulte que la Prediction,Pas Adapte
2651,2017,Informatique,1,Reseaux et Internet,1,Ntoion de Reseau Informatique,2,520,2,QCU,0.41,0.4,29.82,8,19,27,27,8,19,1.0,29.63,Difficile,Difficile,0,Meme Difficulte que la Prediction,Pas Adapte
3717,2018,Informatique,1,Reseaux et Internet,1,Ntoion de Reseau Informatique,2,520,2,QCU,0.39,0.64,55.66,14,12,26,22,14,8,1.18,63.64,Moyen,Moyen,0,Meme Difficulte que la Prediction,Pas Adapte
4783,2019,Informatique,1,Reseaux et Internet,1,Ntoion de Reseau Informatique,2,520,2,QCU,0.02,0.8,73.6,17,6,23,20,17,3,1.15,85.0,Moyen,Facile,1,Plus Facile que la Prediction,Adapte
5849,2020,Informatique,1,Reseaux et Internet,1,Ntoion de Reseau Informatique,2,520,2,QCU,0.01,0.86,73.6,19,7,26,20,19,1,1.3,95.0,Facile,Facile,0,Meme Difficulte que la Prediction,Adapte
520,2015,Mathematique,1,L'Algebre Lineaire,1,Sommes de Sous Espaces,7,521,1,QCU,0.2,0.52,39.0,3,4,7,5,3,2,1.4,60.0,Facile,Moyen,-1,Plus Difficile que la Prediction,Pas Adapte
1586,2016,Mathematique,1,L'Algebre Lineaire,1,Sommes de Sous Espaces,7,521,1,QO,0.42,0.17,40.0,3,5,8,6,3,3,1.33,50.0,Difficile,Moyen,1,Plus Facile que la Prediction,Pas Adapte
2652,2017,Mathematique,1,L'Algebre Lineaire,1,Sommes de Sous Espaces,7,521,1,QO,0.46,0.24,62.0,6,3,9,9,6,3,1.0,66.67,Facile,Moyen,-1,Plus Difficile que la Prediction,Adapte
3718,2018,Mathematique,1,L'Algebre Lineaire,1,Sommes de Sous Espaces,7,521,1,QROC,0.49,0.26,62.0,6,3,9,8,6,2,1.12,75.0,Moyen,Moyen,0,Meme Difficulte que la Prediction,Adapte
4784,2019,Mathematique,1,L'Algebre Lineaire,1,Sommes de Sous Espaces,7,521,1,QROC,0.45,0.37,62.0,6,4,10,7,6,1,1.43,85.71,Moyen,Moyen,0,Meme Difficulte que la Prediction,Adapte
5850,2020,Mathematique,1,L'Algebre Lineaire,1,Sommes de Sous Espaces,7,521,1,QROC,0.42,0.37,62.0,6,3,9,7,6,1,1.29,85.71,Moyen,Moyen,0,Meme Difficulte que la Prediction,Adapte
521,2015,Mathematique,1,L'Algebre Lineaire,1,Sommes de Sous Espaces,7,522,2,QCU,0.65,0.25,14.0,9,53,62,57,9,48,1.09,15.79,Moyen,Difficile,-1,Plus Difficile que la Prediction,Pas Adapte
1587,2016,Mathematique,1,L'Algebre Lineaire,1,Sommes de Sous Espaces,7,522,2,QCU,0.69,0.29,23.0,16,52,68,28,16,12,2.43,57.14,Difficile,Difficile,0,Meme Difficulte que la Prediction,Pas Adapte
2653,2017,Mathematique,1,L'Algebre Lineaire,1,Sommes de Sous Espaces,7,522,2,QCU,0.57,0.31,35.0,20,38,58,49,20,29,1.18,40.82,Difficile,Difficile,0,Meme Difficulte que la Prediction,Pas Adapte
3719,2018,Mathematique,1,L'Algebre Lineaire,1,Sommes de Sous Espaces,7,522,2,QCU,0.26,0.44,47.0,30,34,64,47,30,17,1.36,63.83,Moyen,Moyen,0,Meme Difficulte que la Prediction,Pas Adapte
4785,2019,Mathematique,1,L'Algebre Lineaire,1,Sommes de Sous Espaces,7,522,2,QCU,0.5,0.31,26.0,16,46,62,40,16,24,1.55,40.0,Moyen,Difficile,-1,Plus Difficile que la Prediction,Pas Adapte
5851,2020,Mathematique,1,L'Algebre Lineaire,1,Sommes de Sous Espaces,7,522,2,QCU,0.62,0.29,17.0,10,46,56,26,10,16,2.15,38.46,Difficile,Difficile,0,Meme Difficulte que la Prediction,Pas Adapte
522,2015,Mathematique,1,L'Algebre Lineaire,1,Sommes de Sous Espaces,7,523,3,QCM,0.38,0.63,62.0,50,31,81,74,50,24,1.09,67.57,Facile,Moyen,-1,Plus Difficile que la Prediction,Adapte
1588,2016,Mathematique,1,L'Algebre Lineaire,1,Sommes de Sous Espaces,7,523,3,QCM,0.46,0.65,62.0,50,31,81,51,50,1,1.59,98.04,Moyen,Moyen,0,Meme Difficulte que la Prediction,Adapte
2654,2017,Mathematique,1,L'Algebre Lineaire,1,Sommes de Sous Espaces,7,523,3,QCM,0.22,0.46,62.0,50,30,80,77,50,27,1.04,64.94,Moyen,Moyen,0,Meme Difficulte que la Prediction,Adapte
3720,2018,Mathematique,1,L'Algebre Lineaire,1,Sommes de Sous Espaces,7,523,3,QCM,0.25,0.46,62.0,57,35,92,62,57,5,1.48,91.94,Moyen,Moyen,0,Meme Difficulte que la Prediction,Adapte
4786,2019,Mathematique,1,L'Algebre Lineaire,1,Sommes de Sous Espaces,7,523,3,QCM,0.47,0.63,62.0,65,40,105,88,65,23,1.19,73.86,Moyen,Moyen,0,Meme Difficulte que la Prediction,Adapte
5852,2020,Mathematique,1,L'Algebre Lineaire,1,Sommes de Sous Espaces,7,523,3,QCM,0.32,0.3,62.0,66,40,106,88,66,22,1.2,75.0,Moyen,Moyen,0,Meme Difficulte que la Prediction,Adapte
523,2015,Mathematique,1,L'Algebre Lineaire,1,Sommes de Sous Espaces,7,524,4,QO,0.05,0.38,69.0,4,2,6,5,4,1,1.2,80.0,Facile,Facile,0,Meme Difficulte que la Prediction,Adapte
1589,2016,Mathematique,1,L'Algebre Lineaire,1,Sommes de Sous Espaces,7,524,4,QO,0.03,0.87,69.0,3,2,5,4,3,1,1.25,75.0,Facile,Facile,0,Meme Difficulte que la Prediction,Adapte
2655,2017,Mathematique,1,L'Algebre Lineaire,1,Sommes de Sous Espaces,7,524,4,QO,0.1,0.68,69.0,3,2,5,3,3,0,1.67,100.0,Facile,Facile,0,Meme Difficulte que la Prediction,Adapte
3721,2018,Mathematique,1,L'Algebre Lineaire,1,Sommes de Sous Espaces,7,524,4,QO,0.11,0.57,69.0,3,2,5,5,3,2,1.0,60.0,Facile,Facile,0,Meme Difficulte que la Prediction,Adapte
4787,2019,Mathematique,1,L'Algebre Lineaire,1,Sommes de Sous Espaces,7,524,4,QO,0.17,0.89,69.0,4,2,6,4,4,0,1.5,100.0,Facile,Facile,0,Meme Difficulte que la Prediction,Adapte
5853,2020,Mathematique,1,L'Algebre Lineaire,1,Sommes de Sous Espaces,7,524,4,QO,0.2,0.63,69.0,5,2,7,6,5,1,1.17,83.33,Facile,Facile,0,Meme Difficulte que la Prediction,Adapte
524,2015,Mathematique,1,L'Algebre Lineaire,1,Sommes de Sous Espaces,7,525,5,QCM,0.35,0.33,54.0,11,10,21,18,11,7,1.17,61.11,Facile,Moyen,-1,Plus Difficile que la Prediction,Pas Adapte
1590,2016,Mathematique,1,L'Algebre Lineaire,1,Sommes de Sous Espaces,7,525,5,QCU,0.41,0.4,3.0,1,21,22,18,1,17,1.22,5.56,Difficile,Difficile,0,Meme Difficulte que la Prediction,Pas Adapte
2656,2017,Mathematique,1,L'Algebre Lineaire,1,Sommes de Sous Espaces,7,525,5,QCU,0.53,0.23,15.0,4,21,25,23,4,19,1.09,17.39,Difficile,Difficile,0,Meme Difficulte que la Prediction,Pas Adapte
3722,2018,Mathematique,1,L'Algebre Lineaire,1,Sommes de Sous Espaces,7,525,5,QCU,0.29,0.59,58.0,13,9,22,15,13,2,1.47,86.67,Moyen,Moyen,0,Meme Difficulte que la Prediction,Pas Adapte
4788,2019,Mathematique,1,L'Algebre Lineaire,1,Sommes de Sous Espaces,7,525,5,QCU,0.47,0.23,5.0,1,18,19,8,1,7,2.38,12.5,Difficile,Difficile,0,Meme Difficulte que la Prediction,Pas Adapte
5854,2020,Mathematique,1,L'Algebre Lineaire,1,Sommes de Sous Espaces,7,525,5,QCU,0.36,0.47,58.0,12,9,21,17,12,5,1.24,70.59,Moyen,Moyen,0,Meme Difficulte que la Prediction,Pas Adapte
525,2015,Mathematique,1,L'Algebre Lineaire,1,Sommes de Sous Espaces,7,526,6,QCU,0.48,0.33,11.0,5,41,46,30,5,25,1.53,16.67,Moyen,Difficile,-1,Plus Difficile que la Prediction,Pas Adapte
1591,2016,Mathematique,1,L'Algebre Lineaire,1,Sommes de Sous Espaces,7,526,6,QCU,0.31,0.54,57.0,23,18,41,30,23,7,1.37,76.67,Facile,Moyen,-1,Plus Difficile que la Prediction,Pas Adapte
2657,2017,Mathematique,1,L'Algebre Lineaire,1,Sommes de Sous Espaces,7,526,6,QCM,0.67,0.23,28.0,13,32,45,24,13,11,1.88,54.17,Moyen,Difficile,-1,Plus Difficile que la Prediction,Pas Adapte
3723,2018,Mathematique,1,L'Algebre Lineaire,1,Sommes de Sous Espaces,7,526,6,QCM,0.31,0.51,55.0,28,23,51,49,28,21,1.04,57.14,Difficile,Moyen,1,Plus Facile que la Prediction,Pas Adapte
4789,2019,Mathematique,1,L'Algebre Lineaire,1,Sommes de Sous Espaces,7,526,6,QCM,0.26,0.39,62.0,29,17,46,46,29,17,1.0,63.04,Moyen,Moyen,0,Meme Difficulte que la Prediction,Adapte
5855,2020,Mathematique,1,L'Algebre Lineaire,1,Sommes de Sous Espaces,7,526,6,QCM,0.34,0.54,62.0,27,16,43,31,27,4,1.39,87.1,Moyen,Moyen,0,Meme Difficulte que la Prediction,Adapte
526,2015,Mathematique,1,L'Algebre Lineaire,1,Sommes de Sous Espaces,7,527,7,QCU,0.61,0.33,33.0,7,14,21,8,7,1,2.62,87.5,Moyen,Difficile,-1,Plus Difficile que la Prediction,Pas Adapte
1592,2016,Mathematique,1,L'Algebre Lineaire,1,Sommes de Sous Espaces,7,527,7,QCU,0.21,0.45,61.0,11,7,18,15,11,4,1.2,73.33,Facile,Moyen,-1,Plus Difficile que la Prediction,Adapte
2658,2017,Mathematique,1,L'Algebre Lineaire,1,Sommes de Sous Espaces,7,527,7,QCU,0.28,0.56,61.0,12,8,20,17,12,5,1.18,70.59,Moyen,Moyen,0,Meme Difficulte que la Prediction,Adapte
3724,2018,Mathematique,1,L'Algebre Lineaire,1,Sommes de Sous Espaces,7,527,7,QCM,0.22,0.6,61.0,14,9,23,17,14,3,1.35,82.35,Moyen,Moyen,0,Meme Difficulte que la Prediction,Adapte
4790,2019,Mathematique,1,L'Algebre Lineaire,1,Sommes de Sous Espaces,7,527,7,QCM,0.5,0.44,61.0,15,9,24,15,15,0,1.6,100.0,Moyen,Moyen,0,Meme Difficulte que la Prediction,Adapte
5856,2020,Mathematique,1,L'Algebre Lineaire,1,Sommes de Sous Espaces,7,527,7,QCM,0.31,0.65,61.0,13,8,21,14,13,1,1.5,92.86,Moyen,Moyen,0,Meme Difficulte que la Prediction,Adapte
527,2015,Mathematique,1,L'Algebre Lineaire,2,Sous Espaces Supplementaires,3,528,1,QCM,0.31,0.53,55.0,8,6,14,9,8,1,1.56,88.89,Facile,Moyen,-1,Plus Difficile que la Prediction,Pas Adapte
1593,2016,Mathematique,1,L'Algebre Lineaire,2,Sous Espaces Supplementaires,3,528,1,QCM,0.18,0.75,69.0,10,4,14,13,10,3,1.08,76.92,Moyen,Facile,1,Plus Facile que la Prediction,Adapte
2659,2017,Mathematique,1,L'Algebre Lineaire,2,Sous Espaces Supplementaires,3,528,1,QCM,0.07,0.81,69.0,10,4,14,10,10,0,1.4,100.0,Facile,Facile,0,Meme Difficulte que la Prediction,Adapte
3725,2018,Mathematique,1,L'Algebre Lineaire,2,Sous Espaces Supplementaires,3,528,1,QROC,0.08,0.84,69.0,10,4,14,11,10,1,1.27,90.91,Facile,Facile,0,Meme Difficulte que la Prediction,Adapte
4791,2019,Mathematique,1,L'Algebre Lineaire,2,Sous Espaces Supplementaires,3,528,1,QROC,0.07,0.42,69.0,8,4,12,9,8,1,1.33,88.89,Facile,Facile,0,Meme Difficulte que la Prediction,Adapte
5857,2020,Mathematique,1,L'Algebre Lineaire,2,Sous Espaces Supplementaires,3,528,1,QROC,0.15,0.8,69.0,8,3,11,10,8,2,1.1,80.0,Facile,Facile,0,Meme Difficulte que la Prediction,Adapte
528,2015,Mathematique,1,L'Algebre Lineaire,2,Sous Espaces Supplementaires,3,529,2,QCM,0.8,0.28,20.0,1,5,6,6,1,5,1.0,16.67,Facile,Difficile,-2,Beaucoup plus Difficile que la Prediction,Pas Adapte
1594,2016,Mathematique,1,L'Algebre Lineaire,2,Sous Espaces Supplementaires,3,529,2,QCM,0.67,0.26,0.0,0,6,6,2,0,2,3.0,0.0,Difficile,Difficile,0,Meme Difficulte que la Prediction,Pas Adapte
2660,2017,Mathematique,1,L'Algebre Lineaire,2,Sous Espaces Supplementaires,3,529,2,QCM,0.22,0.53,46.0,3,4,7,5,3,2,1.4,60.0,Difficile,Moyen,1,Plus Facile que la Prediction,Pas Adapte
3726,2018,Mathematique,1,L'Algebre Lineaire,2,Sous Espaces Supplementaires,3,529,2,QCU,0.47,0.28,33.0,2,4,6,5,2,3,1.2,40.0,Difficile,Difficile,0,Meme Difficulte que la Prediction,Pas Adapte
4792,2019,Mathematique,1,L'Algebre Lineaire,2,Sous Espaces Supplementaires,3,529,2,QCU,0.16,0.94,69.0,5,2,7,7,5,2,1.0,71.43,Facile,Facile,0,Meme Difficulte que la Prediction,Adapte
5858,2020,Mathematique,1,L'Algebre Lineaire,2,Sous Espaces Supplementaires,3,529,2,QCU,0.06,0.98,69.0,6,2,8,8,6,2,1.0,75.0,Facile,Facile,0,Meme Difficulte que la Prediction,Adapte
529,2015,Mathematique,1,L'Algebre Lineaire,2,Sous Espaces Supplementaires,3,530,3,QCU,0.27,0.44,51.0,32,30,62,33,32,1,1.88,96.97,Moyen,Moyen,0,Meme Difficulte que la Prediction,Pas Adapte
1595,2016,Mathematique,1,L'Algebre Lineaire,2,Sous Espaces Supplementaires,3,530,3,QCU,0.52,0.23,29.0,17,41,58,26,17,9,2.23,65.38,Difficile,Difficile,0,Meme Difficulte que la Prediction,Pas Adapte
2661,2017,Mathematique,1,L'Algebre Lineaire,2,Sous Espaces Supplementaires,3,530,3,QCU,0.34,0.55,55.0,31,26,57,33,31,2,1.73,93.94,Moyen,Moyen,0,Meme Difficulte que la Prediction,Pas Adapte
3727,2018,Mathematique,1,L'Algebre Lineaire,2,Sous Espaces Supplementaires,3,530,3,QCU,0.69,0.37,5.0,3,49,52,52,3,49,1.0,5.77,Moyen,Difficile,-1,Plus Difficile que la Prediction,Pas Adapte
4793,2019,Mathematique,1,L'Algebre Lineaire,2,Sous Espaces Supplementaires,3,530,3,QCU,0.12,0.89,67.0,39,19,58,42,39,3,1.38,92.86,Difficile,Facile,2,Beaucoup plus Facile que la Prediction,Adapte
5859,2020,Mathematique,1,L'Algebre Lineaire,2,Sous Espaces Supplementaires,3,530,3,QCU,0.07,0.8,67.0,44,22,66,58,44,14,1.14,75.86,Facile,Facile,0,Meme Difficulte que la Prediction,Adapte
530,2015,Mathematique,1,L'Algebre Lineaire,3,Theoreme du Rang,7,531,1,QCU,0.24,0.64,63.0,23,13,36,33,23,10,1.09,69.7,Facile,Moyen,-1,Plus Difficile que la Prediction,Adapte
1596,2016,Mathematique,1,L'Algebre Lineaire,3,Theoreme du Rang,7,531,1,QCU,0.26,0.52,63.0,24,14,38,35,24,11,1.09,68.57,Moyen,Moyen,0,Meme Difficulte que la Prediction,Adapte
2662,2017,Mathematique,1,L'Algebre Lineaire,3,Theoreme du Rang,7,531,1,QCU,0.27,0.41,63.0,25,15,40,38,25,13,1.05,65.79,Moyen,Moyen,0,Meme Difficulte que la Prediction,Adapte
3728,2018,Mathematique,1,L'Algebre Lineaire,3,Theoreme du Rang,7,531,1,QCU,0.23,0.55,63.0,25,15,40,33,25,8,1.21,75.76,Moyen,Moyen,0,Meme Difficulte que la Prediction,Adapte
4794,2019,Mathematique,1,L'Algebre Lineaire,3,Theoreme du Rang,7,531,1,QCU,0.37,0.51,63.0,21,13,34,33,21,12,1.03,63.64,Moyen,Moyen,0,Meme Difficulte que la Prediction,Adapte
5860,2020,Mathematique,1,L'Algebre Lineaire,3,Theoreme du Rang,7,531,1,QCU,0.38,0.44,63.0,18,11,29,25,18,7,1.16,72.0,Moyen,Moyen,0,Meme Difficulte que la Prediction,Adapte
531,2015,Mathematique,1,L'Algebre Lineaire,3,Theoreme du Rang,7,532,2,QROC,0.35,0.37,51.0,46,45,91,68,46,22,1.34,67.65,Difficile,Moyen,1,Plus Facile que la Prediction,Pas Adapte
1597,2016,Mathematique,1,L'Algebre Lineaire,3,Theoreme du Rang,7,532,2,QROC,0.31,0.26,64.0,64,36,100,71,64,7,1.41,90.14,Difficile,Moyen,1,Plus Facile que la Prediction,Adapte
2663,2017,Mathematique,1,L'Algebre Lineaire,3,Theoreme du Rang,7,532,2,QO,0.65,0.28,64.0,56,32,88,57,56,1,1.54,98.25,Moyen,Moyen,0,Meme Difficulte que la Prediction,Adapte
3729,2018,Mathematique,1,L'Algebre Lineaire,3,Theoreme du Rang,7,532,2,QO,0.54,0.24,64.0,53,30,83,61,53,8,1.36,86.89,Moyen,Moyen,0,Meme Difficulte que la Prediction,Adapte
4795,2019,Mathematique,1,L'Algebre Lineaire,3,Theoreme du Rang,7,532,2,QO,0.34,0.3,64.0,47,27,74,65,47,18,1.14,72.31,Moyen,Moyen,0,Meme Difficulte que la Prediction,Adapte
5861,2020,Mathematique,1,L'Algebre Lineaire,3,Theoreme du Rang,7,532,2,QO,0.56,0.25,64.0,40,23,63,46,40,6,1.37,86.96,Moyen,Moyen,0,Meme Difficulte que la Prediction,Adapte
532,2015,Mathematique,1,L'Algebre Lineaire,3,Theoreme du Rang,7,533,3,QCU,0.39,0.63,52.0,25,23,48,32,25,7,1.5,78.12,Moyen,Moyen,0,Meme Difficulte que la Prediction,Pas Adapte
1598,2016,Mathematique,1,L'Algebre Lineaire,3,Theoreme du Rang,7,533,3,QCU,0.03,0.86,65.0,27,14,41,30,27,3,1.37,90.0,Moyen,Facile,1,Plus Facile que la Prediction,Adapte
2664,2017,Mathematique,1,L'Algebre Lineaire,3,Theoreme du Rang,7,533,3,QCU,0.19,0.93,65.0,25,13,38,30,25,5,1.27,83.33,Facile,Facile,0,Meme Difficulte que la Prediction,Adapte
3730,2018,Mathematique,1,L'Algebre Lineaire,3,Theoreme du Rang,7,533,3,QCU,0.04,0.83,65.0,25,13,38,30,25,5,1.27,83.33,Facile,Facile,0,Meme Difficulte que la Prediction,Adapte
4796,2019,Mathematique,1,L'Algebre Lineaire,3,Theoreme du Rang,7,533,3,QCU,0.06,0.87,65.0,21,11,32,23,21,2,1.39,91.3,Facile,Facile,0,Meme Difficulte que la Prediction,Adapte
5862,2020,Mathematique,1,L'Algebre Lineaire,3,Theoreme du Rang,7,533,3,QCM,0.16,0.74,65.0,20,10,30,26,20,6,1.15,76.92,Facile,Facile,0,Meme Difficulte que la Prediction,Adapte
533,2015,Mathematique,1,L'Algebre Lineaire,3,Theoreme du Rang,7,534,4,QCU,0.33,0.65,45.0,19,23,42,27,19,8,1.56,70.37,Difficile,Moyen,1,Plus Facile que la Prediction,Pas Adapte
1599,2016,Mathematique,1,L'Algebre Lineaire,3,Theoreme du Rang,7,534,4,QCU,0.37,0.56,40.0,16,24,40,18,16,2,2.22,88.89,Difficile,Moyen,1,Plus Facile que la Prediction,Pas Adapte
2665,2017,Mathematique,1,L'Algebre Lineaire,3,Theoreme du Rang,7,534,4,QCU,0.55,0.4,4.0,2,42,44,29,2,27,1.52,6.9,Facile,Difficile,-2,Beaucoup plus Difficile que la Prediction,Pas Adapte
3731,2018,Mathematique,1,L'Algebre Lineaire,3,Theoreme du Rang,7,534,4,QCU,0.61,0.35,6.0,2,35,37,35,2,33,1.06,5.71,Facile,Difficile,-2,Beaucoup plus Difficile que la Prediction,Pas Adapte
4797,2019,Mathematique,1,L'Algebre Lineaire,3,Theoreme du Rang,7,534,4,QCU,0.48,0.24,29.0,10,26,36,32,10,22,1.12,31.25,Difficile,Difficile,0,Meme Difficulte que la Prediction,Pas Adapte
5863,2020,Mathematique,1,L'Algebre Lineaire,3,Theoreme du Rang,7,534,4,QCU,0.41,0.35,19.0,8,32,40,35,8,27,1.14,22.86,Facile,Difficile,-2,Beaucoup plus Difficile que la Prediction,Pas Adapte
534,2015,Mathematique,1,L'Algebre Lineaire,3,Theoreme du Rang,7,535,5,QCU,0.63,0.36,27.0,3,8,11,7,3,4,1.57,42.86,Moyen,Difficile,-1,Plus Difficile que la Prediction,Pas Adapte
1600,2016,Mathematique,1,L'Algebre Lineaire,3,Theoreme du Rang,7,535,5,QCU,0.69,0.3,14.0,2,9,11,9,2,7,1.22,22.22,Difficile,Difficile,0,Meme Difficulte que la Prediction,Pas Adapte
2666,2017,Mathematique,1,L'Algebre Lineaire,3,Theoreme du Rang,7,535,5,QCU,0.56,0.34,3.0,0,11,11,5,0,5,2.2,0.0,Moyen,Difficile,-1,Plus Difficile que la Prediction,Pas Adapte
3732,2018,Mathematique,1,L'Algebre Lineaire,3,Theoreme du Rang,7,535,5,QROC,0.44,0.34,57.0,7,5,12,8,7,1,1.5,87.5,Difficile,Moyen,1,Plus Facile que la Prediction,Pas Adapte
4798,2019,Mathematique,1,L'Algebre Lineaire,3,Theoreme du Rang,7,535,5,QROC,0.55,0.37,44.0,6,8,14,7,6,1,2.0,85.71,Difficile,Moyen,1,Plus Facile que la Prediction,Pas Adapte
5864,2020,Mathematique,1,L'Algebre Lineaire,3,Theoreme du Rang,7,535,5,QROC,0.98,0.2,19.0,3,12,15,9,3,6,1.67,33.33,Difficile,Difficile,0,Meme Difficulte que la Prediction,Pas Adapte
535,2015,Mathematique,1,L'Algebre Lineaire,3,Theoreme du Rang,7,536,6,QCU,0.69,0.3,14.0,1,6,7,6,1,5,1.17,16.67,Difficile,Difficile,0,Meme Difficulte que la Prediction,Pas Adapte
1601,2016,Mathematique,1,L'Algebre Lineaire,3,Theoreme du Rang,7,536,6,QCU,0.21,0.59,44.0,3,4,7,6,3,3,1.17,50.0,Moyen,Moyen,0,Meme Difficulte que la Prediction,Pas Adapte
2667,2017,Mathematique,1,L'Algebre Lineaire,3,Theoreme du Rang,7,536,6,QCU,0.71,0.29,34.0,3,5,8,6,3,3,1.33,50.0,Difficile,Difficile,0,Meme Difficulte que la Prediction,Pas Adapte
3733,2018,Mathematique,1,L'Algebre Lineaire,3,Theoreme du Rang,7,536,6,QROC,0.61,0.15,5.0,0,8,8,7,0,7,1.14,0.0,Moyen,Difficile,-1,Plus Difficile que la Prediction,Pas Adapte
4799,2019,Mathematique,1,L'Algebre Lineaire,3,Theoreme du Rang,7,536,6,QROC,0.35,0.38,44.0,4,5,9,5,4,1,1.8,80.0,Moyen,Moyen,0,Meme Difficulte que la Prediction,Pas Adapte
5865,2020,Mathematique,1,L'Algebre Lineaire,3,Theoreme du Rang,7,536,6,QROC,0.79,0.24,8.0,1,7,8,6,1,5,1.33,16.67,Difficile,Difficile,0,Meme Difficulte que la Prediction,Pas Adapte
536,2015,Mathematique,1,L'Algebre Lineaire,3,Theoreme du Rang,7,537,7,QROC,0.87,0.01,12.0,12,87,99,86,12,74,1.15,13.95,Facile,Difficile,-2,Beaucoup plus Difficile que la Prediction,Pas Adapte
1602,2016,Mathematique,1,L'Algebre Lineaire,3,Theoreme du Rang,7,537,7,QROC,0.16,0.7,69.0,58,26,84,77,58,19,1.09,75.32,Facile,Facile,0,Meme Difficulte que la Prediction,Adapte
2668,2017,Mathematique,1,L'Algebre Lineaire,3,Theoreme du Rang,7,537,7,QROC,0.2,0.65,69.0,67,30,97,85,67,18,1.14,78.82,Facile,Facile,0,Meme Difficulte que la Prediction,Adapte
3734,2018,Mathematique,1,L'Algebre Lineaire,3,Theoreme du Rang,7,537,7,QROC,0.16,0.98,69.0,70,31,101,94,70,24,1.07,74.47,Facile,Facile,0,Meme Difficulte que la Prediction,Adapte
4800,2019,Mathematique,1,L'Algebre Lineaire,3,Theoreme du Rang,7,537,7,QROC,0.06,0.5,69.0,74,33,107,81,74,7,1.32,91.36,Facile,Facile,0,Meme Difficulte que la Prediction,Adapte
5866,2020,Mathematique,1,L'Algebre Lineaire,3,Theoreme du Rang,7,537,7,QROC,0.02,0.72,69.0,77,34,111,99,77,22,1.12,77.78,Facile,Facile,0,Meme Difficulte que la Prediction,Adapte
537,2015,Mathematique,1,L'Algebre Lineaire,4,Projecteurs et Symetries,6,538,1,QCU,0.55,0.26,7.0,1,7,8,3,1,2,2.67,33.33,Moyen,Difficile,-1,Plus Difficile que la Prediction,Pas Adapte
1603,2016,Mathematique,1,L'Algebre Lineaire,4,Projecteurs et Symetries,6,538,1,QCU,0.73,0.21,35.0,3,6,9,8,3,5,1.12,37.5,Facile,Difficile,-2,Beaucoup plus Difficile que la Prediction,Pas Adapte
2669,2017,Mathematique,1,L'Algebre Lineaire,4,Projecteurs et Symetries,6,538,1,QCU,0.14,0.76,65.0,6,3,9,8,6,2,1.12,75.0,Facile,Facile,0,Meme Difficulte que la Prediction,Adapte
3735,2018,Mathematique,1,L'Algebre Lineaire,4,Projecteurs et Symetries,6,538,1,QCM,0.12,0.83,65.0,6,4,10,9,6,3,1.11,66.67,Facile,Facile,0,Meme Difficulte que la Prediction,Adapte
4801,2019,Mathematique,1,L'Algebre Lineaire,4,Projecteurs et Symetries,6,538,1,QCM,0.09,0.8,65.0,7,4,11,10,7,3,1.1,70.0,Facile,Facile,0,Meme Difficulte que la Prediction,Adapte
5867,2020,Mathematique,1,L'Algebre Lineaire,4,Projecteurs et Symetries,6,538,1,QCU,0.14,0.76,65.0,8,5,13,8,8,0,1.62,100.0,Facile,Facile,0,Meme Difficulte que la Prediction,Adapte
538,2015,Mathematique,1,L'Algebre Lineaire,4,Projecteurs et Symetries,6,539,2,QROC,0.98,0.12,10.0,1,7,8,5,1,4,1.6,20.0,Difficile,Difficile,0,Meme Difficulte que la Prediction,Pas Adapte
1604,2016,Mathematique,1,L'Algebre Lineaire,4,Projecteurs et Symetries,6,539,2,QROC,0.69,0.22,5.0,0,9,9,9,0,9,1.0,0.0,Difficile,Difficile,0,Meme Difficulte que la Prediction,Pas Adapte
2670,2017,Mathematique,1,L'Algebre Lineaire,4,Projecteurs et Symetries,6,539,2,QROC,0.9,0.09,1.0,0,8,8,5,0,5,1.6,0.0,Difficile,Difficile,0,Meme Difficulte que la Prediction,Pas Adapte
3736,2018,Mathematique,1,L'Algebre Lineaire,4,Projecteurs et Symetries,6,539,2,QO,0.41,0.2,40.0,3,5,8,5,3,2,1.6,60.0,Facile,Moyen,-1,Plus Difficile que la Prediction,Pas Adapte
4802,2019,Mathematique,1,L'Algebre Lineaire,4,Projecteurs et Symetries,6,539,2,QO,0.27,0.23,62.0,4,3,7,4,4,0,1.75,100.0,Facile,Moyen,-1,Plus Difficile que la Prediction,Adapte
5868,2020,Mathematique,1,L'Algebre Lineaire,4,Projecteurs et Symetries,6,539,2,QO,0.53,0.17,62.0,4,2,6,5,4,1,1.2,80.0,Moyen,Moyen,0,Meme Difficulte que la Prediction,Adapte
539,2015,Mathematique,1,L'Algebre Lineaire,4,Projecteurs et Symetries,6,540,3,QROC,0.34,0.36,63.0,8,4,12,10,8,2,1.2,80.0,Facile,Moyen,-1,Plus Difficile que la Prediction,Adapte
1605,2016,Mathematique,1,L'Algebre Lineaire,4,Projecteurs et Symetries,6,540,3,QROC,0.56,0.34,63.0,9,5,14,13,9,4,1.08,69.23,Moyen,Moyen,0,Meme Difficulte que la Prediction,Adapte
2671,2017,Mathematique,1,L'Algebre Lineaire,4,Projecteurs et Symetries,6,540,3,QROC,0.44,0.29,63.0,9,5,14,13,9,4,1.08,69.23,Moyen,Moyen,0,Meme Difficulte que la Prediction,Adapte
3737,2018,Mathematique,1,L'Algebre Lineaire,4,Projecteurs et Symetries,6,540,3,QROC,0.35,0.26,63.0,10,6,16,13,10,3,1.23,76.92,Moyen,Moyen,0,Meme Difficulte que la Prediction,Adapte
4803,2019,Mathematique,1,L'Algebre Lineaire,4,Projecteurs et Symetries,6,540,3,QROC,0.59,0.37,63.0,10,6,16,13,10,3,1.23,76.92,Moyen,Moyen,0,Meme Difficulte que la Prediction,Adapte
5869,2020,Mathematique,1,L'Algebre Lineaire,4,Projecteurs et Symetries,6,540,3,QROC,0.57,0.33,63.0,10,6,16,10,10,0,1.6,100.0,Moyen,Moyen,0,Meme Difficulte que la Prediction,Adapte
540,2015,Mathematique,1,L'Algebre Lineaire,4,Projecteurs et Symetries,6,541,4,QCU,0.42,0.34,30.0,29,68,97,65,29,36,1.49,44.62,Facile,Difficile,-2,Beaucoup plus Difficile que la Prediction,Pas Adapte
1606,2016,Mathematique,1,L'Algebre Lineaire,4,Projecteurs et Symetries,6,541,4,QCU,0.63,0.27,30.0,31,73,104,50,31,19,2.08,62.0,Facile,Difficile,-2,Beaucoup plus Difficile que la Prediction,Pas Adapte
2672,2017,Mathematique,1,L'Algebre Lineaire,4,Projecteurs et Symetries,6,541,4,QROC,0.71,0.22,9.0,11,109,120,62,11,51,1.94,17.74,Moyen,Difficile,-1,Plus Difficile que la Prediction,Pas Adapte
3738,2018,Mathematique,1,L'Algebre Lineaire,4,Projecteurs et Symetries,6,541,4,QROC,0.67,0.0,31.0,40,88,128,106,40,66,1.21,37.74,Moyen,Difficile,-1,Plus Difficile que la Prediction,Pas Adapte
4804,2019,Mathematique,1,L'Algebre Lineaire,4,Projecteurs et Symetries,6,541,4,QO,0.9,0.14,8.0,11,126,137,81,11,70,1.69,13.58,Moyen,Difficile,-1,Plus Difficile que la Prediction,Pas Adapte
5870,2020,Mathematique,1,L'Algebre Lineaire,4,Projecteurs et Symetries,6,541,4,QO,0.29,0.29,47.0,62,70,132,98,62,36,1.35,63.27,Facile,Moyen,-1,Plus Difficile que la Prediction,Pas Adapte
541,2015,Mathematique,1,L'Algebre Lineaire,4,Projecteurs et Symetries,6,542,5,QCU,0.6,0.31,15.0,8,46,54,39,8,31,1.38,20.51,Moyen,Difficile,-1,Plus Difficile que la Prediction,Pas Adapte
1607,2016,Mathematique,1,L'Algebre Lineaire,4,Projecteurs et Symetries,6,542,5,QCU,0.34,0.55,49.0,28,29,57,34,28,6,1.68,82.35,Facile,Moyen,-1,Plus Difficile que la Prediction,Pas Adapte
2673,2017,Mathematique,1,L'Algebre Lineaire,4,Projecteurs et Symetries,6,542,5,QCU,0.73,0.35,31.0,20,46,66,41,20,21,1.61,48.78,Difficile,Difficile,0,Meme Difficulte que la Prediction,Pas Adapte
3739,2018,Mathematique,1,L'Algebre Lineaire,4,Projecteurs et Symetries,6,542,5,QCM,0.24,0.61,49.0,28,30,58,36,28,8,1.61,77.78,Facile,Moyen,-1,Plus Difficile que la Prediction,Pas Adapte
4805,2019,Mathematique,1,L'Algebre Lineaire,4,Projecteurs et Symetries,6,542,5,QCM,0.49,0.65,52.0,30,27,57,51,30,21,1.12,58.82,Facile,Moyen,-1,Plus Difficile que la Prediction,Pas Adapte
5871,2020,Mathematique,1,L'Algebre Lineaire,4,Projecteurs et Symetries,6,542,5,QCM,0.65,0.24,30.0,20,46,66,38,20,18,1.74,52.63,Facile,Difficile,-2,Beaucoup plus Difficile que la Prediction,Pas Adapte
542,2015,Mathematique,1,L'Algebre Lineaire,4,Projecteurs et Symetries,6,543,6,QCU,0.28,0.64,49.0,29,30,59,36,29,7,1.64,80.56,Difficile,Moyen,1,Plus Facile que la Prediction,Pas Adapte
1608,2016,Mathematique,1,L'Algebre Lineaire,4,Projecteurs et Symetries,6,543,6,QCU,0.24,0.72,37.0,23,39,62,33,23,10,1.88,69.7,Facile,Moyen,-1,Plus Difficile que la Prediction,Pas Adapte
2674,2017,Mathematique,1,L'Algebre Lineaire,4,Projecteurs et Symetries,6,543,6,QCU,0.27,0.59,41.0,25,36,61,27,25,2,2.26,92.59,Facile,Moyen,-1,Plus Difficile que la Prediction,Pas Adapte
3740,2018,Mathematique,1,L'Algebre Lineaire,4,Projecteurs et Symetries,6,543,6,QCU,0.53,0.26,33.0,21,44,65,42,21,21,1.55,50.0,Facile,Difficile,-2,Beaucoup plus Difficile que la Prediction,Pas Adapte
4806,2019,Mathematique,1,L'Algebre Lineaire,4,Projecteurs et Symetries,6,543,6,QCU,0.09,0.86,68.0,48,22,70,49,48,1,1.43,97.96,Facile,Facile,0,Meme Difficulte que la Prediction,Adapte
5872,2020,Mathematique,1,L'Algebre Lineaire,4,Projecteurs et Symetries,6,543,6,QO,0.06,0.32,68.0,44,21,65,55,44,11,1.18,80.0,Facile,Facile,0,Meme Difficulte que la Prediction,Adapte
543,2015,Mathematique,1,L'Algebre Lineaire,5,Determination et Construction d'Applications Lineaires,14,544,1,QCU,0.6,0.24,22.0,8,29,37,21,8,13,1.76,38.1,Difficile,Difficile,0,Meme Difficulte que la Prediction,Pas Adapte
1609,2016,Mathematique,1,L'Algebre Lineaire,5,Determination et Construction d'Applications Lineaires,14,544,1,QCU,0.43,0.33,7.0,2,32,34,21,2,19,1.62,9.52,Facile,Difficile,-2,Beaucoup plus Difficile que la Prediction,Pas Adapte
2675,2017,Mathematique,1,L'Algebre Lineaire,5,Determination et Construction d'Applications Lineaires,14,544,1,QCU,0.39,0.5,64.0,22,13,35,27,22,5,1.3,81.48,Facile,Moyen,-1,Plus Difficile que la Prediction,Adapte
3741,2018,Mathematique,1,L'Algebre Lineaire,5,Determination et Construction d'Applications Lineaires,14,544,1,QCU,0.27,0.44,64.0,20,12,32,20,20,0,1.6,100.0,Moyen,Moyen,0,Meme Difficulte que la Prediction,Adapte
4807,2019,Mathematique,1,L'Algebre Lineaire,5,Determination et Construction d'Applications Lineaires,14,544,1,QCU,0.34,0.69,64.0,24,13,37,25,24,1,1.48,96.0,Moyen,Moyen,0,Meme Difficulte que la Prediction,Adapte
5873,2020,Mathematique,1,L'Algebre Lineaire,5,Determination et Construction d'Applications Lineaires,14,544,1,QCU,0.36,0.52,64.0,26,14,40,37,26,11,1.08,70.27,Moyen,Moyen,0,Meme Difficulte que la Prediction,Adapte
544,2015,Mathematique,1,L'Algebre Lineaire,5,Determination et Construction d'Applications Lineaires,14,545,2,QO,0.48,0.22,43.0,17,23,40,34,17,17,1.18,50.0,Difficile,Moyen,1,Plus Facile que la Prediction,Pas Adapte
1610,2016,Mathematique,1,L'Algebre Lineaire,5,Determination et Construction d'Applications Lineaires,14,545,2,QO,0.87,0.06,15.0,6,34,40,35,6,29,1.14,17.14,Difficile,Difficile,0,Meme Difficulte que la Prediction,Pas Adapte
2676,2017,Mathematique,1,L'Algebre Lineaire,5,Determination et Construction d'Applications Lineaires,14,545,2,QO,0.77,0.04,6.0,3,42,45,44,3,41,1.02,6.82,Moyen,Difficile,-1,Plus Difficile que la Prediction,Pas Adapte
3742,2018,Mathematique,1,L'Algebre Lineaire,5,Determination et Construction d'Applications Lineaires,14,545,2,QO,0.44,0.29,38.0,17,27,44,29,17,12,1.52,58.62,Moyen,Moyen,0,Meme Difficulte que la Prediction,Pas Adapte
4808,2019,Mathematique,1,L'Algebre Lineaire,5,Determination et Construction d'Applications Lineaires,14,545,2,QO,0.05,0.79,66.0,30,16,46,30,30,0,1.53,100.0,Difficile,Facile,2,Beaucoup plus Facile que la Prediction,Adapte
5874,2020,Mathematique,1,L'Algebre Lineaire,5,Determination et Construction d'Applications Lineaires,14,545,2,QO,0.11,0.54,66.0,29,15,44,35,29,6,1.26,82.86,Facile,Facile,0,Meme Difficulte que la Prediction,Adapte
545,2015,Mathematique,1,L'Algebre Lineaire,5,Determination et Construction d'Applications Lineaires,14,546,3,QCU,0.61,0.33,21.0,2,8,10,5,2,3,2.0,40.0,Difficile,Difficile,0,Meme Difficulte que la Prediction,Pas Adapte
1611,2016,Mathematique,1,L'Algebre Lineaire,5,Determination et Construction d'Applications Lineaires,14,546,3,QCU,0.37,0.49,56.0,7,5,12,12,7,5,1.0,58.33,Facile,Moyen,-1,Plus Difficile que la Prediction,Pas Adapte
2677,2017,Mathematique,1,L'Algebre Lineaire,5,Determination et Construction d'Applications Lineaires,14,546,3,QCU,0.6,0.39,18.0,2,11,13,9,2,7,1.44,22.22,Moyen,Difficile,-1,Plus Difficile que la Prediction,Pas Adapte
3743,2018,Mathematique,1,L'Algebre Lineaire,5,Determination et Construction d'Applications Lineaires,14,546,3,QCU,0.35,0.56,47.0,7,8,15,12,7,5,1.25,58.33,Facile,Moyen,-1,Plus Difficile que la Prediction,Pas Adapte
4809,2019,Mathematique,1,L'Algebre Lineaire,5,Determination et Construction d'Applications Lineaires,14,546,3,QCU,0.42,0.3,6.0,1,13,14,5,1,4,2.8,20.0,Moyen,Difficile,-1,Plus Difficile que la Prediction,Pas Adapte
5875,2020,Mathematique,1,L'Algebre Lineaire,5,Determination et Construction d'Applications Lineaires,14,546,3,QCU,0.38,0.52,44.0,6,8,14,7,6,1,2.0,85.71,Moyen,Moyen,0,Meme Difficulte que la Prediction,Pas Adapte
546,2015,Mathematique,1,L'Algebre Lineaire,5,Determination et Construction d'Applications Lineaires,14,547,4,QCM,0.57,0.27,14.0,4,21,25,8,4,4,3.12,50.0,Facile,Difficile,-2,Beaucoup plus Difficile que la Prediction,Pas Adapte
1612,2016,Mathematique,1,L'Algebre Lineaire,5,Determination et Construction d'Applications Lineaires,14,547,4,QCM,0.69,0.23,1.0,0,22,22,8,0,8,2.75,0.0,Moyen,Difficile,-1,Plus Difficile que la Prediction,Pas Adapte
2678,2017,Mathematique,1,L'Algebre Lineaire,5,Determination et Construction d'Applications Lineaires,14,547,4,QCM,0.59,0.29,28.0,7,17,24,14,7,7,1.71,50.0,Facile,Difficile,-2,Beaucoup plus Difficile que la Prediction,Pas Adapte
3744,2018,Mathematique,1,L'Algebre Lineaire,5,Determination et Construction d'Applications Lineaires,14,547,4,QCM,0.25,0.44,60.0,17,11,28,23,17,6,1.22,73.91,Difficile,Moyen,1,Plus Facile que la Prediction,Adapte
4810,2019,Mathematique,1,L'Algebre Lineaire,5,Determination et Construction d'Applications Lineaires,14,547,4,QCM,0.31,0.69,60.0,19,13,32,23,19,4,1.39,82.61,Moyen,Moyen,0,Meme Difficulte que la Prediction,Adapte
5876,2020,Mathematique,1,L'Algebre Lineaire,5,Determination et Construction d'Applications Lineaires,14,547,4,QCU,0.37,0.44,60.0,22,14,36,30,22,8,1.2,73.33,Moyen,Moyen,0,Meme Difficulte que la Prediction,Adapte
547,2015,Mathematique,1,L'Algebre Lineaire,5,Determination et Construction d'Applications Lineaires,14,548,5,QCM,0.79,0.15,25.0,11,33,44,34,11,23,1.29,32.35,Difficile,Difficile,0,Meme Difficulte que la Prediction,Pas Adapte
1613,2016,Mathematique,1,L'Algebre Lineaire,5,Determination et Construction d'Applications Lineaires,14,548,5,QCM,0.65,0.24,34.0,16,30,46,17,16,1,2.71,94.12,Difficile,Difficile,0,Meme Difficulte que la Prediction,Pas Adapte
2679,2017,Mathematique,1,L'Algebre Lineaire,5,Determination et Construction d'Applications Lineaires,14,548,5,QCU,0.33,0.71,48.0,25,27,52,49,25,24,1.06,51.02,Facile,Moyen,-1,Plus Difficile que la Prediction,Pas Adapte
3745,2018,Mathematique,1,L'Algebre Lineaire,5,Determination et Construction d'Applications Lineaires,14,548,5,QCU,0.32,0.48,63.0,28,16,44,32,28,4,1.38,87.5,Moyen,Moyen,0,Meme Difficulte que la Prediction,Adapte
4811,2019,Mathematique,1,L'Algebre Lineaire,5,Determination et Construction d'Applications Lineaires,14,548,5,QCU,0.24,0.5,63.0,26,16,42,33,26,7,1.27,78.79,Moyen,Moyen,0,Meme Difficulte que la Prediction,Adapte
5877,2020,Mathematique,1,L'Algebre Lineaire,5,Determination et Construction d'Applications Lineaires,14,548,5,QROC,0.58,0.27,63.0,23,13,36,24,23,1,1.5,95.83,Moyen,Moyen,0,Meme Difficulte que la Prediction,Adapte
548,2015,Mathematique,1,L'Algebre Lineaire,5,Determination et Construction d'Applications Lineaires,14,549,6,QCM,0.61,0.19,6.0,4,60,64,58,4,54,1.1,6.9,Facile,Difficile,-2,Beaucoup plus Difficile que la Prediction,Pas Adapte
1614,2016,Mathematique,1,L'Algebre Lineaire,5,Determination et Construction d'Applications Lineaires,14,549,6,QCM,0.43,0.48,60.0,35,23,58,50,35,15,1.16,70.0,Difficile,Moyen,1,Plus Facile que la Prediction,Adapte
2680,2017,Mathematique,1,L'Algebre Lineaire,5,Determination et Construction d'Applications Lineaires,14,549,6,QCM,0.36,0.58,60.0,30,20,50,43,30,13,1.16,69.77,Moyen,Moyen,0,Meme Difficulte que la Prediction,Adapte
3746,2018,Mathematique,1,L'Algebre Lineaire,5,Determination et Construction d'Applications Lineaires,14,549,6,QCM,0.23,0.39,60.0,29,20,49,42,29,13,1.17,69.05,Moyen,Moyen,0,Meme Difficulte que la Prediction,Adapte
4812,2019,Mathematique,1,L'Algebre Lineaire,5,Determination et Construction d'Applications Lineaires,14,549,6,QCM,0.38,0.44,60.0,26,17,43,41,26,15,1.05,63.41,Moyen,Moyen,0,Meme Difficulte que la Prediction,Adapte
5878,2020,Mathematique,1,L'Algebre Lineaire,5,Determination et Construction d'Applications Lineaires,14,549,6,QCM,0.35,0.43,60.0,29,19,48,47,29,18,1.02,61.7,Moyen,Moyen,0,Meme Difficulte que la Prediction,Adapte
549,2015,Mathematique,1,L'Algebre Lineaire,5,Determination et Construction d'Applications Lineaires,14,550,7,QCU,0.24,0.43,50.0,3,3,6,5,3,2,1.2,60.0,Facile,Moyen,-1,Plus Difficile que la Prediction,Pas Adapte
1615,2016,Mathematique,1,L'Algebre Lineaire,5,Determination et Construction d'Applications Lineaires,14,550,7,QCU,0.0,0.91,68.0,3,2,5,4,3,1,1.25,75.0,Facile,Facile,0,Meme Difficulte que la Prediction,Adapte
2681,2017,Mathematique,1,L'Algebre Lineaire,5,Determination et Construction d'Applications Lineaires,14,550,7,QCU,0.06,0.93,68.0,4,2,6,5,4,1,1.2,80.0,Facile,Facile,0,Meme Difficulte que la Prediction,Adapte
3747,2018,Mathematique,1,L'Algebre Lineaire,5,Determination et Construction d'Applications Lineaires,14,550,7,QCU,0.02,0.9,68.0,3,2,5,4,3,1,1.25,75.0,Facile,Facile,0,Meme Difficulte que la Prediction,Adapte
4813,2019,Mathematique,1,L'Algebre Lineaire,5,Determination et Construction d'Applications Lineaires,14,550,7,QCU,0.14,0.99,68.0,3,1,4,4,3,1,1.0,75.0,Facile,Facile,0,Meme Difficulte que la Prediction,Adapte
5879,2020,Mathematique,1,L'Algebre Lineaire,5,Determination et Construction d'Applications Lineaires,14,550,7,QCU,0.01,0.78,68.0,3,2,5,5,3,2,1.0,60.0,Facile,Facile,0,Meme Difficulte que la Prediction,Adapte
550,2015,Mathematique,1,L'Algebre Lineaire,5,Determination et Construction d'Applications Lineaires,14,551,8,QROC,0.62,0.23,19.0,6,26,32,13,6,7,2.46,46.15,Difficile,Difficile,0,Meme Difficulte que la Prediction,Pas Adapte
1616,2016,Mathematique,1,L'Algebre Lineaire,5,Determination et Construction d'Applications Lineaires,14,551,8,QROC,0.73,0.25,4.0,1,35,36,27,1,26,1.33,3.7,Facile,Difficile,-2,Beaucoup plus Difficile que la Prediction,Pas Adapte
2682,2017,Mathematique,1,L'Algebre Lineaire,5,Determination et Construction d'Applications Lineaires,14,551,8,QROC,0.51,0.29,45.0,16,20,36,22,16,6,1.64,72.73,Facile,Moyen,-1,Plus Difficile que la Prediction,Pas Adapte
3748,2018,Mathematique,1,L'Algebre Lineaire,5,Determination et Construction d'Applications Lineaires,14,551,8,QROC,0.7,0.15,35.0,11,20,31,15,11,4,2.07,73.33,Moyen,Difficile,-1,Plus Difficile que la Prediction,Pas Adapte
4814,2019,Mathematique,1,L'Algebre Lineaire,5,Determination et Construction d'Applications Lineaires,14,551,8,QROC,0.93,0.19,33.0,10,21,31,18,10,8,1.72,55.56,Facile,Difficile,-2,Beaucoup plus Difficile que la Prediction,Pas Adapte
5880,2020,Mathematique,1,L'Algebre Lineaire,5,Determination et Construction d'Applications Lineaires,14,551,8,QROC,0.26,0.35,47.0,16,17,33,27,16,11,1.22,59.26,Moyen,Moyen,0,Meme Difficulte que la Prediction,Pas Adapte
551,2015,Mathematique,1,L'Algebre Lineaire,5,Determination et Construction d'Applications Lineaires,14,552,9,QCM,0.7,0.17,14.0,9,56,65,49,9,40,1.33,18.37,Difficile,Difficile,0,Meme Difficulte que la Prediction,Pas Adapte
1617,2016,Mathematique,1,L'Algebre Lineaire,5,Determination et Construction d'Applications Lineaires,14,552,9,QCM,0.48,0.42,36.0,20,36,56,46,20,26,1.22,43.48,Facile,Moyen,-1,Plus Difficile que la Prediction,Pas Adapte
2683,2017,Mathematique,1,L'Algebre Lineaire,5,Determination et Construction d'Applications Lineaires,14,552,9,QCM,0.45,0.35,42.0,24,34,58,56,24,32,1.04,42.86,Moyen,Moyen,0,Meme Difficulte que la Prediction,Pas Adapte
3749,2018,Mathematique,1,L'Algebre Lineaire,5,Determination et Construction d'Applications Lineaires,14,552,9,QCM,0.63,0.28,35.0,20,38,58,49,20,29,1.18,40.82,Difficile,Difficile,0,Meme Difficulte que la Prediction,Pas Adapte
4815,2019,Mathematique,1,L'Algebre Lineaire,5,Determination et Construction d'Applications Lineaires,14,552,9,QCM,0.72,0.18,34.0,19,37,56,31,19,12,1.81,61.29,Facile,Difficile,-2,Beaucoup plus Difficile que la Prediction,Pas Adapte
5881,2020,Mathematique,1,L'Algebre Lineaire,5,Determination et Construction d'Applications Lineaires,14,552,9,QCM,0.27,0.56,48.0,26,29,55,40,26,14,1.38,65.0,Facile,Moyen,-1,Plus Difficile que la Prediction,Pas Adapte
552,2015,Mathematique,1,L'Algebre Lineaire,5,Determination et Construction d'Applications Lineaires,14,553,10,QROC,0.25,0.36,36.0,22,40,62,40,22,18,1.55,55.0,Difficile,Moyen,1,Plus Facile que la Prediction,Pas Adapte
1618,2016,Mathematique,1,L'Algebre Lineaire,5,Determination et Construction d'Applications Lineaires,14,553,10,QROC,0.69,0.15,24.0,16,51,67,30,16,14,2.23,53.33,Moyen,Difficile,-1,Plus Difficile que la Prediction,Pas Adapte
2684,2017,Mathematique,1,L'Algebre Lineaire,5,Determination et Construction d'Applications Lineaires,14,553,10,QROC,0.7,0.11,26.0,18,53,71,42,18,24,1.69,42.86,Facile,Difficile,-2,Beaucoup plus Difficile que la Prediction,Pas Adapte
3750,2018,Mathematique,1,L'Algebre Lineaire,5,Determination et Construction d'Applications Lineaires,14,553,10,QROC,0.81,0.15,31.0,21,46,67,56,21,35,1.2,37.5,Facile,Difficile,-2,Beaucoup plus Difficile que la Prediction,Pas Adapte
4816,2019,Mathematique,1,L'Algebre Lineaire,5,Determination et Construction d'Applications Lineaires,14,553,10,QO,0.28,0.23,60.0,35,24,59,55,35,20,1.07,63.64,Facile,Moyen,-1,Plus Difficile que la Prediction,Adapte
5882,2020,Mathematique,1,L'Algebre Lineaire,5,Determination et Construction d'Applications Lineaires,14,553,10,QO,0.75,0.25,60.0,35,23,58,41,35,6,1.41,85.37,Moyen,Moyen,0,Meme Difficulte que la Prediction,Adapte
553,2015,Mathematique,1,L'Algebre Lineaire,5,Determination et Construction d'Applications Lineaires,14,554,11,QROC,0.48,0.28,49.0,17,18,35,17,17,0,2.06,100.0,Moyen,Moyen,0,Meme Difficulte que la Prediction,Pas Adapte
1619,2016,Mathematique,1,L'Algebre Lineaire,5,Determination et Construction d'Applications Lineaires,14,554,11,QROC,0.68,0.04,28.0,10,27,37,25,10,15,1.48,40.0,Moyen,Difficile,-1,Plus Difficile que la Prediction,Pas Adapte
2685,2017,Mathematique,1,L'Algebre Lineaire,5,Determination et Construction d'Applications Lineaires,14,554,11,QROC,0.45,0.33,45.0,14,18,32,22,14,8,1.45,63.64,Difficile,Moyen,1,Plus Facile que la Prediction,Pas Adapte
3751,2018,Mathematique,1,L'Algebre Lineaire,5,Determination et Construction d'Applications Lineaires,14,554,11,QROC,0.7,0.13,29.0,9,23,32,29,9,20,1.1,31.03,Difficile,Difficile,0,Meme Difficulte que la Prediction,Pas Adapte
4817,2019,Mathematique,1,L'Algebre Lineaire,5,Determination et Construction d'Applications Lineaires,14,554,11,QROC,0.17,0.47,67.0,19,9,28,25,19,6,1.12,76.0,Facile,Facile,0,Meme Difficulte que la Prediction,Adapte
5883,2020,Mathematique,1,L'Algebre Lineaire,5,Determination et Construction d'Applications Lineaires,14,554,11,QROC,0.1,0.42,67.0,17,8,25,20,17,3,1.25,85.0,Facile,Facile,0,Meme Difficulte que la Prediction,Adapte
554,2015,Mathematique,1,L'Algebre Lineaire,5,Determination et Construction d'Applications Lineaires,14,555,12,QROC,0.68,0.21,13.0,7,47,54,49,7,42,1.1,14.29,Difficile,Difficile,0,Meme Difficulte que la Prediction,Pas Adapte
1620,2016,Mathematique,1,L'Algebre Lineaire,5,Determination et Construction d'Applications Lineaires,14,555,12,QO,0.36,0.28,50.0,24,23,47,27,24,3,1.74,88.89,Moyen,Moyen,0,Meme Difficulte que la Prediction,Pas Adapte
2686,2017,Mathematique,1,L'Algebre Lineaire,5,Determination et Construction d'Applications Lineaires,14,555,12,QO,0.84,0.0,24.0,11,35,46,27,11,16,1.7,40.74,Difficile,Difficile,0,Meme Difficulte que la Prediction,Pas Adapte
3752,2018,Mathematique,1,L'Algebre Lineaire,5,Determination et Construction d'Applications Lineaires,14,555,12,QO,0.89,0.04,20.0,8,34,42,40,8,32,1.05,20.0,Moyen,Difficile,-1,Plus Difficile que la Prediction,Pas Adapte
4818,2019,Mathematique,1,L'Algebre Lineaire,5,Determination et Construction d'Applications Lineaires,14,555,12,QO,0.76,0.04,25.0,10,32,42,29,10,19,1.45,34.48,Facile,Difficile,-2,Beaucoup plus Difficile que la Prediction,Pas Adapte
5884,2020,Mathematique,1,L'Algebre Lineaire,5,Determination et Construction d'Applications Lineaires,14,555,12,QO,0.77,0.03,14.0,6,35,41,23,6,17,1.78,26.09,Moyen,Difficile,-1,Plus Difficile que la Prediction,Pas Adapte
555,2015,Mathematique,1,L'Algebre Lineaire,5,Determination et Construction d'Applications Lineaires,14,556,13,QROC,0.48,0.37,44.0,22,28,50,49,22,27,1.02,44.9,Moyen,Moyen,0,Meme Difficulte que la Prediction,Pas Adapte
1621,2016,Mathematique,1,L'Algebre Lineaire,5,Determination et Construction d'Applications Lineaires,14,556,13,QROC,0.57,0.38,58.0,32,24,56,37,32,5,1.51,86.49,Difficile,Moyen,1,Plus Facile que la Prediction,Pas Adapte
2687,2017,Mathematique,1,L'Algebre Lineaire,5,Determination et Construction d'Applications Lineaires,14,556,13,QROC,0.31,0.39,43.0,22,28,50,45,22,23,1.11,48.89,Moyen,Moyen,0,Meme Difficulte que la Prediction,Pas Adapte
3753,2018,Mathematique,1,L'Algebre Lineaire,5,Determination et Construction d'Applications Lineaires,14,556,13,QROC,0.6,0.05,1.0,0,48,48,34,0,34,1.41,0.0,Moyen,Difficile,-1,Plus Difficile que la Prediction,Pas Adapte
4819,2019,Mathematique,1,L'Algebre Lineaire,5,Determination et Construction d'Applications Lineaires,14,556,13,QROC,0.32,0.36,46.0,23,26,49,23,23,0,2.13,100.0,Facile,Moyen,-1,Plus Difficile que la Prediction,Pas Adapte
5885,2020,Mathematique,1,L'Algebre Lineaire,5,Determination et Construction d'Applications Lineaires,14,556,13,QO,0.95,0.02,33.0,15,29,44,35,15,20,1.26,42.86,Moyen,Difficile,-1,Plus Difficile que la Prediction,Pas Adapte
556,2015,Mathematique,1,L'Algebre Lineaire,5,Determination et Construction d'Applications Lineaires,14,557,14,QO,0.33,0.24,50.0,14,13,27,22,14,8,1.23,63.64,Difficile,Moyen,1,Plus Facile que la Prediction,Pas Adapte
1622,2016,Mathematique,1,L'Algebre Lineaire,5,Determination et Construction d'Applications Lineaires,14,557,14,QO,0.23,0.28,36.0,10,17,27,15,10,5,1.8,66.67,Facile,Moyen,-1,Plus Difficile que la Prediction,Pas Adapte
2688,2017,Mathematique,1,L'Algebre Lineaire,5,Determination et Construction d'Applications Lineaires,14,557,14,QO,0.1,0.55,66.0,18,9,27,25,18,7,1.08,72.0,Difficile,Facile,2,Beaucoup plus Facile que la Prediction,Adapte
3754,2018,Mathematique,1,L'Algebre Lineaire,5,Determination et Construction d'Applications Lineaires,14,557,14,QO,0.18,0.79,66.0,19,10,29,29,19,10,1.0,65.52,Facile,Facile,0,Meme Difficulte que la Prediction,Adapte
4820,2019,Mathematique,1,L'Algebre Lineaire,5,Determination et Construction d'Applications Lineaires,14,557,14,QO,0.07,0.39,66.0,18,9,27,21,18,3,1.29,85.71,Facile,Facile,0,Meme Difficulte que la Prediction,Adapte
5886,2020,Mathematique,1,L'Algebre Lineaire,5,Determination et Construction d'Applications Lineaires,14,557,14,QO,0.04,0.93,66.0,16,9,25,22,16,6,1.14,72.73,Facile,Facile,0,Meme Difficulte que la Prediction,Adapte
557,2015,Mathematique,1,L'Algebre Lineaire,6,"Calcul de Dimensions et Construction de Bases, utilisant de la Dualite",10,558,1,QCM,0.14,0.96,65.0,9,5,14,12,9,3,1.17,75.0,Difficile,Facile,2,Beaucoup plus Facile que la Prediction,Adapte
1623,2016,Mathematique,1,L'Algebre Lineaire,6,"Calcul de Dimensions et Construction de Bases, utilisant de la Dualite",10,558,1,QCM,0.1,0.75,65.0,8,4,12,10,8,2,1.2,80.0,Facile,Facile,0,Meme Difficulte que la Prediction,Adapte
2689,2017,Mathematique,1,L'Algebre Lineaire,6,"Calcul de Dimensions et Construction de Bases, utilisant de la Dualite",10,558,1,QCM,0.0,0.71,65.0,8,4,12,11,8,3,1.09,72.73,Facile,Facile,0,Meme Difficulte que la Prediction,Adapte
3755,2018,Mathematique,1,L'Algebre Lineaire,6,"Calcul de Dimensions et Construction de Bases, utilisant de la Dualite",10,558,1,QCM,0.04,0.88,65.0,8,5,13,12,8,4,1.08,66.67,Facile,Facile,0,Meme Difficulte que la Prediction,Adapte
4821,2019,Mathematique,1,L'Algebre Lineaire,6,"Calcul de Dimensions et Construction de Bases, utilisant de la Dualite",10,558,1,QCM,0.1,0.91,65.0,8,4,12,10,8,2,1.2,80.0,Facile,Facile,0,Meme Difficulte que la Prediction,Adapte
5887,2020,Mathematique,1,L'Algebre Lineaire,6,"Calcul de Dimensions et Construction de Bases, utilisant de la Dualite",10,558,1,QCU,0.17,0.79,65.0,7,4,11,9,7,2,1.22,77.78,Facile,Facile,0,Meme Difficulte que la Prediction,Adapte
558,2015,Mathematique,1,L'Algebre Lineaire,6,"Calcul de Dimensions et Construction de Bases, utilisant de la Dualite",10,559,2,QCM,0.4,0.65,43.0,32,42,74,65,32,33,1.14,49.23,Facile,Moyen,-1,Plus Difficile que la Prediction,Pas Adapte
1624,2016,Mathematique,1,L'Algebre Lineaire,6,"Calcul de Dimensions et Construction de Bases, utilisant de la Dualite",10,559,2,QCM,0.56,0.22,26.0,21,59,80,56,21,35,1.43,37.5,Difficile,Difficile,0,Meme Difficulte que la Prediction,Pas Adapte
2690,2017,Mathematique,1,L'Algebre Lineaire,6,"Calcul de Dimensions et Construction de Bases, utilisant de la Dualite",10,559,2,QCM,0.24,0.42,49.0,36,37,73,67,36,31,1.09,53.73,Difficile,Moyen,1,Plus Facile que la Prediction,Pas Adapte
3756,2018,Mathematique,1,L'Algebre Lineaire,6,"Calcul de Dimensions et Construction de Bases, utilisant de la Dualite",10,559,2,QCM,0.67,0.25,18.0,14,65,79,64,14,50,1.23,21.88,Moyen,Difficile,-1,Plus Difficile que la Prediction,Pas Adapte
4822,2019,Mathematique,1,L'Algebre Lineaire,6,"Calcul de Dimensions et Construction de Bases, utilisant de la Dualite",10,559,2,QCU,0.2,0.75,38.0,34,55,89,83,34,49,1.07,40.96,Facile,Moyen,-1,Plus Difficile que la Prediction,Pas Adapte
5888,2020,Mathematique,1,L'Algebre Lineaire,6,"Calcul de Dimensions et Construction de Bases, utilisant de la Dualite",10,559,2,QCU,0.25,0.63,47.0,42,48,90,83,42,41,1.08,50.6,Facile,Moyen,-1,Plus Difficile que la Prediction,Pas Adapte
559,2015,Mathematique,1,L'Algebre Lineaire,6,"Calcul de Dimensions et Construction de Bases, utilisant de la Dualite",10,560,3,QROC,0.98,0.13,6.0,1,23,24,14,1,13,1.71,7.14,Difficile,Difficile,0,Meme Difficulte que la Prediction,Pas Adapte
1625,2016,Mathematique,1,L'Algebre Lineaire,6,"Calcul de Dimensions et Construction de Bases, utilisant de la Dualite",10,560,3,QO,0.86,0.13,8.0,2,18,20,15,2,13,1.33,13.33,Facile,Difficile,-2,Beaucoup plus Difficile que la Prediction,Pas Adapte
2691,2017,Mathematique,1,L'Algebre Lineaire,6,"Calcul de Dimensions et Construction de Bases, utilisant de la Dualite",10,560,3,QO,0.05,0.79,65.0,14,8,22,16,14,2,1.38,87.5,Difficile,Facile,2,Beaucoup plus Facile que la Prediction,Adapte
3757,2018,Mathematique,1,L'Algebre Lineaire,6,"Calcul de Dimensions et Construction de Bases, utilisant de la Dualite",10,560,3,QO,0.01,0.64,65.0,14,7,21,21,14,7,1.0,66.67,Facile,Facile,0,Meme Difficulte que la Prediction,Adapte
4823,2019,Mathematique,1,L'Algebre Lineaire,6,"Calcul de Dimensions et Construction de Bases, utilisant de la Dualite",10,560,3,QO,0.18,0.87,65.0,12,7,19,16,12,4,1.19,75.0,Facile,Facile,0,Meme Difficulte que la Prediction,Adapte
5889,2020,Mathematique,1,L'Algebre Lineaire,6,"Calcul de Dimensions et Construction de Bases, utilisant de la Dualite",10,560,3,QO,0.03,0.72,65.0,10,6,16,14,10,4,1.14,71.43,Facile,Facile,0,Meme Difficulte que la Prediction,Adapte
560,2015,Mathematique,1,L'Algebre Lineaire,6,"Calcul de Dimensions et Construction de Bases, utilisant de la Dualite",10,561,4,QROC,0.87,0.04,32.0,20,42,62,25,20,5,2.48,80.0,Facile,Difficile,-2,Beaucoup plus Difficile que la Prediction,Pas Adapte
1626,2016,Mathematique,1,L'Algebre Lineaire,6,"Calcul de Dimensions et Construction de Bases, utilisant de la Dualite",10,561,4,QROC,0.91,0.11,20.0,12,49,61,34,12,22,1.79,35.29,Difficile,Difficile,0,Meme Difficulte que la Prediction,Pas Adapte
2692,2017,Mathematique,1,L'Algebre Lineaire,6,"Calcul de Dimensions et Construction de Bases, utilisant de la Dualite",10,561,4,QROC,0.68,0.03,25.0,14,41,55,33,14,19,1.67,42.42,Difficile,Difficile,0,Meme Difficulte que la Prediction,Pas Adapte
3758,2018,Mathematique,1,L'Algebre Lineaire,6,"Calcul de Dimensions et Construction de Bases, utilisant de la Dualite",10,561,4,QROC,0.55,0.37,44.0,26,33,59,37,26,11,1.59,70.27,Facile,Moyen,-1,Plus Difficile que la Prediction,Pas Adapte
4824,2019,Mathematique,1,L'Algebre Lineaire,6,"Calcul de Dimensions et Construction de Bases, utilisant de la Dualite",10,561,4,QROC,0.38,0.26,64.0,35,20,55,41,35,6,1.34,85.37,Facile,Moyen,-1,Plus Difficile que la Prediction,Adapte
5890,2020,Mathematique,1,L'Algebre Lineaire,6,"Calcul de Dimensions et Construction de Bases, utilisant de la Dualite",10,561,4,QROC,0.25,0.35,64.0,40,22,62,46,40,6,1.35,86.96,Moyen,Moyen,0,Meme Difficulte que la Prediction,Adapte
561,2015,Mathematique,1,L'Algebre Lineaire,6,"Calcul de Dimensions et Construction de Bases, utilisant de la Dualite",10,562,5,QCU,0.58,0.22,20.0,13,50,63,53,13,40,1.19,24.53,Moyen,Difficile,-1,Plus Difficile que la Prediction,Pas Adapte
1627,2016,Mathematique,1,L'Algebre Lineaire,6,"Calcul de Dimensions et Construction de Bases, utilisant de la Dualite",10,562,5,QCU,0.32,0.51,50.0,27,27,54,42,27,15,1.29,64.29,Facile,Moyen,-1,Plus Difficile que la Prediction,Pas Adapte
2693,2017,Mathematique,1,L'Algebre Lineaire,6,"Calcul de Dimensions et Construction de Bases, utilisant de la Dualite",10,562,5,QCU,0.35,0.43,51.0,30,29,59,44,30,14,1.34,68.18,Moyen,Moyen,0,Meme Difficulte que la Prediction,Pas Adapte
3759,2018,Mathematique,1,L'Algebre Lineaire,6,"Calcul de Dimensions et Construction de Bases, utilisant de la Dualite",10,562,5,QCU,0.02,0.98,65.0,38,20,58,49,38,11,1.18,77.55,Difficile,Facile,2,Beaucoup plus Facile que la Prediction,Adapte
4825,2019,Mathematique,1,L'Algebre Lineaire,6,"Calcul de Dimensions et Construction de Bases, utilisant de la Dualite",10,562,5,QCM,0.01,0.88,65.0,41,22,63,51,41,10,1.24,80.39,Facile,Facile,0,Meme Difficulte que la Prediction,Adapte
5891,2020,Mathematique,1,L'Algebre Lineaire,6,"Calcul de Dimensions et Construction de Bases, utilisant de la Dualite",10,562,5,QCM,0.07,0.85,65.0,41,22,63,57,41,16,1.11,71.93,Facile,Facile,0,Meme Difficulte que la Prediction,Adapte
562,2015,Mathematique,1,L'Algebre Lineaire,6,"Calcul de Dimensions et Construction de Bases, utilisant de la Dualite",10,563,6,QCM,0.41,0.69,59.0,32,23,55,43,32,11,1.28,74.42,Facile,Moyen,-1,Plus Difficile que la Prediction,Pas Adapte
1628,2016,Mathematique,1,L'Algebre Lineaire,6,"Calcul de Dimensions et Construction de Bases, utilisant de la Dualite",10,563,6,QCU,0.7,0.31,33.0,20,41,61,55,20,35,1.11,36.36,Difficile,Difficile,0,Meme Difficulte que la Prediction,Pas Adapte
2694,2017,Mathematique,1,L'Algebre Lineaire,6,"Calcul de Dimensions et Construction de Bases, utilisant de la Dualite",10,563,6,QCU,0.7,0.33,30.0,19,43,62,54,19,35,1.15,35.19,Moyen,Difficile,-1,Plus Difficile que la Prediction,Pas Adapte
3760,2018,Mathematique,1,L'Algebre Lineaire,6,"Calcul de Dimensions et Construction de Bases, utilisant de la Dualite",10,563,6,QROC,0.27,0.3,40.0,23,34,57,39,23,16,1.46,58.97,Moyen,Moyen,0,Meme Difficulte que la Prediction,Pas Adapte
4826,2019,Mathematique,1,L'Algebre Lineaire,6,"Calcul de Dimensions et Construction de Bases, utilisant de la Dualite",10,563,6,QROC,0.79,0.06,26.0,15,42,57,28,15,13,2.04,53.57,Difficile,Difficile,0,Meme Difficulte que la Prediction,Pas Adapte
5892,2020,Mathematique,1,L'Algebre Lineaire,6,"Calcul de Dimensions et Construction de Bases, utilisant de la Dualite",10,563,6,QROC,0.53,0.35,41.0,27,38,65,32,27,5,2.03,84.38,Facile,Moyen,-1,Plus Difficile que la Prediction,Pas Adapte
563,2015,Mathematique,1,L'Algebre Lineaire,6,"Calcul de Dimensions et Construction de Bases, utilisant de la Dualite",10,564,7,QCU,0.57,0.35,16.0,1,6,7,5,1,4,1.4,20.0,Moyen,Difficile,-1,Plus Difficile que la Prediction,Pas Adapte
1629,2016,Mathematique,1,L'Algebre Lineaire,6,"Calcul de Dimensions et Construction de Bases, utilisant de la Dualite",10,564,7,QCU,0.4,0.28,4.0,0,6,6,5,0,5,1.2,0.0,Difficile,Difficile,0,Meme Difficulte que la Prediction,Pas Adapte
2695,2017,Mathematique,1,L'Algebre Lineaire,6,"Calcul de Dimensions et Construction de Bases, utilisant de la Dualite",10,564,7,QCU,0.66,0.3,21.0,1,5,6,4,1,3,1.5,25.0,Moyen,Difficile,-1,Plus Difficile que la Prediction,Pas Adapte
3761,2018,Mathematique,1,L'Algebre Lineaire,6,"Calcul de Dimensions et Construction de Bases, utilisant de la Dualite",10,564,7,QCU,0.48,0.39,2.0,0,5,5,2,0,2,2.5,0.0,Difficile,Difficile,0,Meme Difficulte que la Prediction,Pas Adapte
4827,2019,Mathematique,1,L'Algebre Lineaire,6,"Calcul de Dimensions et Construction de Bases, utilisant de la Dualite",10,564,7,QCU,0.25,0.65,58.0,3,3,6,5,3,2,1.2,60.0,Moyen,Moyen,0,Meme Difficulte que la Prediction,Pas Adapte
5893,2020,Mathematique,1,L'Algebre Lineaire,6,"Calcul de Dimensions et Construction de Bases, utilisant de la Dualite",10,564,7,QO,0.21,0.18,39.0,3,4,7,4,3,1,1.75,75.0,Difficile,Moyen,1,Plus Facile que la Prediction,Pas Adapte
564,2015,Mathematique,1,L'Algebre Lineaire,6,"Calcul de Dimensions et Construction de Bases, utilisant de la Dualite",10,565,8,QCU,0.59,0.27,9.0,6,58,64,30,6,24,2.13,20.0,Facile,Difficile,-2,Beaucoup plus Difficile que la Prediction,Pas Adapte
1630,2016,Mathematique,1,L'Algebre Lineaire,6,"Calcul de Dimensions et Construction de Bases, utilisant de la Dualite",10,565,8,QCU,0.49,0.39,2.0,1,66,67,44,1,43,1.52,2.27,Moyen,Difficile,-1,Plus Difficile que la Prediction,Pas Adapte
2696,2017,Mathematique,1,L'Algebre Lineaire,6,"Calcul de Dimensions et Construction de Bases, utilisant de la Dualite",10,565,8,QCU,0.7,0.23,0.0,0,58,58,25,0,25,2.32,0.0,Difficile,Difficile,0,Meme Difficulte que la Prediction,Pas Adapte
3762,2018,Mathematique,1,L'Algebre Lineaire,6,"Calcul de Dimensions et Construction de Bases, utilisant de la Dualite",10,565,8,QCM,0.57,0.17,0.0,0,66,66,55,0,55,1.2,0.0,Facile,Difficile,-2,Beaucoup plus Difficile que la Prediction,Pas Adapte
4828,2019,Mathematique,1,L'Algebre Lineaire,6,"Calcul de Dimensions et Construction de Bases, utilisant de la Dualite",10,565,8,QCM,0.78,0.19,6.0,3,55,58,15,3,12,3.87,20.0,Difficile,Difficile,0,Meme Difficulte que la Prediction,Pas Adapte
5894,2020,Mathematique,1,L'Algebre Lineaire,6,"Calcul de Dimensions et Construction de Bases, utilisant de la Dualite",10,565,8,QCM,0.58,0.24,27.0,16,43,59,35,16,19,1.69,45.71,Moyen,Difficile,-1,Plus Difficile que la Prediction,Pas Adapte
565,2015,Mathematique,1,L'Algebre Lineaire,6,"Calcul de Dimensions et Construction de Bases, utilisant de la Dualite",10,566,9,QCU,0.63,0.32,6.0,4,59,63,45,4,41,1.4,8.89,Difficile,Difficile,0,Meme Difficulte que la Prediction,Pas Adapte
1631,2016,Mathematique,1,L'Algebre Lineaire,6,"Calcul de Dimensions et Construction de Bases, utilisant de la Dualite",10,566,9,QCU,0.52,0.26,30.0,22,50,72,28,22,6,2.57,78.57,Facile,Difficile,-2,Beaucoup plus Difficile que la Prediction,Pas Adapte
2697,2017,Mathematique,1,L'Algebre Lineaire,6,"Calcul de Dimensions et Construction de Bases, utilisant de la Dualite",10,566,9,QCU,0.42,0.22,30.0,22,51,73,58,22,36,1.26,37.93,Facile,Difficile,-2,Beaucoup plus Difficile que la Prediction,Pas Adapte
3763,2018,Mathematique,1,L'Algebre Lineaire,6,"Calcul de Dimensions et Construction de Bases, utilisant de la Dualite",10,566,9,QCU,0.35,0.48,48.0,39,43,82,59,39,20,1.39,66.1,Facile,Moyen,-1,Plus Difficile que la Prediction,Pas Adapte
4829,2019,Mathematique,1,L'Algebre Lineaire,6,"Calcul de Dimensions et Construction de Bases, utilisant de la Dualite",10,566,9,QCM,0.22,0.5,60.0,42,28,70,68,42,26,1.03,61.76,Difficile,Moyen,1,Plus Facile que la Prediction,Adapte
5895,2020,Mathematique,1,L'Algebre Lineaire,6,"Calcul de Dimensions et Construction de Bases, utilisant de la Dualite",10,566,9,QCU,0.29,0.54,60.0,45,30,75,47,45,2,1.6,95.74,Moyen,Moyen,0,Meme Difficulte que la Prediction,Adapte
566,2015,Mathematique,1,L'Algebre Lineaire,6,"Calcul de Dimensions et Construction de Bases, utilisant de la Dualite",10,567,10,QCU,0.22,0.64,57.0,42,32,74,62,42,20,1.19,67.74,Difficile,Moyen,1,Plus Facile que la Prediction,Pas Adapte
1632,2016,Mathematique,1,L'Algebre Lineaire,6,"Calcul de Dimensions et Construction de Bases, utilisant de la Dualite",10,567,10,QCU,0.29,0.51,50.0,32,33,65,40,32,8,1.62,80.0,Moyen,Moyen,0,Meme Difficulte que la Prediction,Pas Adapte
2698,2017,Mathematique,1,L'Algebre Lineaire,6,"Calcul de Dimensions et Construction de Bases, utilisant de la Dualite",10,567,10,QO,0.61,0.23,55.0,31,25,56,38,31,7,1.47,81.58,Difficile,Moyen,1,Plus Facile que la Prediction,Pas Adapte
3764,2018,Mathematique,1,L'Algebre Lineaire,6,"Calcul de Dimensions et Construction de Bases, utilisant de la Dualite",10,567,10,QCM,0.3,0.43,59.0,34,24,58,55,34,21,1.05,61.82,Difficile,Moyen,1,Plus Facile que la Prediction,Pas Adapte
4830,2019,Mathematique,1,L'Algebre Lineaire,6,"Calcul de Dimensions et Construction de Bases, utilisant de la Dualite",10,567,10,QCU,0.51,0.38,4.0,3,61,64,63,3,60,1.02,4.76,Difficile,Difficile,0,Meme Difficulte que la Prediction,Pas Adapte
5896,2020,Mathematique,1,L'Algebre Lineaire,6,"Calcul de Dimensions et Construction de Bases, utilisant de la Dualite",10,567,10,QCU,0.6,0.38,2.0,1,59,60,52,1,51,1.15,1.92,Difficile,Difficile,0,Meme Difficulte que la Prediction,Pas Adapte
567,2015,Mathematique,1,Le Calcul d'Integral,1,Les Divers Types d'Integrale,7,568,1,QROC,0.81,0.22,31.0,16,36,52,36,16,20,1.44,44.44,Difficile,Difficile,0,Meme Difficulte que la Prediction,Pas Adapte
1633,2016,Mathematique,1,Le Calcul d'Integral,1,Les Divers Types d'Integrale,7,568,1,QROC,0.27,0.36,60.0,29,19,48,38,29,9,1.26,76.32,Difficile,Moyen,1,Plus Facile que la Prediction,Adapte
2699,2017,Mathematique,1,Le Calcul d'Integral,1,Les Divers Types d'Integrale,7,568,1,QO,0.69,0.25,60.0,26,17,43,40,26,14,1.07,65.0,Moyen,Moyen,0,Meme Difficulte que la Prediction,Adapte
3765,2018,Mathematique,1,Le Calcul d'Integral,1,Les Divers Types d'Integrale,7,568,1,QO,0.57,0.28,60.0,26,17,43,40,26,14,1.07,65.0,Moyen,Moyen,0,Meme Difficulte que la Prediction,Adapte
4831,2019,Mathematique,1,Le Calcul d'Integral,1,Les Divers Types d'Integrale,7,568,1,QO,0.43,0.16,60.0,22,15,37,28,22,6,1.32,78.57,Moyen,Moyen,0,Meme Difficulte que la Prediction,Adapte
5897,2020,Mathematique,1,Le Calcul d'Integral,1,Les Divers Types d'Integrale,7,568,1,QO,0.31,0.25,60.0,19,12,31,20,19,1,1.55,95.0,Moyen,Moyen,0,Meme Difficulte que la Prediction,Adapte
568,2015,Mathematique,1,Le Calcul d'Integral,1,Les Divers Types d'Integrale,7,569,2,QCU,0.57,0.36,30.0,16,37,53,27,16,11,1.96,59.26,Difficile,Difficile,0,Meme Difficulte que la Prediction,Pas Adapte
1634,2016,Mathematique,1,Le Calcul d'Integral,1,Les Divers Types d'Integrale,7,569,2,QCU,0.63,0.33,35.0,18,32,50,20,18,2,2.5,90.0,Difficile,Difficile,0,Meme Difficulte que la Prediction,Pas Adapte
2700,2017,Mathematique,1,Le Calcul d'Integral,1,Les Divers Types d'Integrale,7,569,2,QCM,0.48,0.41,62.0,30,18,48,36,30,6,1.33,83.33,Facile,Moyen,-1,Plus Difficile que la Prediction,Adapte
3766,2018,Mathematique,1,Le Calcul d'Integral,1,Les Divers Types d'Integrale,7,569,2,QCM,0.49,0.63,62.0,28,17,45,33,28,5,1.36,84.85,Moyen,Moyen,0,Meme Difficulte que la Prediction,Adapte
4832,2019,Mathematique,1,Le Calcul d'Integral,1,Les Divers Types d'Integrale,7,569,2,QCM,0.37,0.47,62.0,31,19,50,31,31,0,1.61,100.0,Moyen,Moyen,0,Meme Difficulte que la Prediction,Adapte
5898,2020,Mathematique,1,Le Calcul d'Integral,1,Les Divers Types d'Integrale,7,569,2,QCM,0.36,0.49,62.0,28,17,45,37,28,9,1.22,75.68,Moyen,Moyen,0,Meme Difficulte que la Prediction,Adapte
569,2015,Mathematique,1,Le Calcul d'Integral,1,Les Divers Types d'Integrale,7,570,3,QCU,0.69,0.34,34.0,33,63,96,82,33,49,1.17,40.24,Facile,Difficile,-2,Beaucoup plus Difficile que la Prediction,Pas Adapte
1635,2016,Mathematique,1,Le Calcul d'Integral,1,Les Divers Types d'Integrale,7,570,3,QCM,0.77,0.17,26.0,25,73,98,92,25,67,1.07,27.17,Facile,Difficile,-2,Beaucoup plus Difficile que la Prediction,Pas Adapte
2701,2017,Mathematique,1,Le Calcul d'Integral,1,Les Divers Types d'Integrale,7,570,3,QCM,0.37,0.65,46.0,51,60,111,100,51,49,1.11,51.0,Difficile,Moyen,1,Plus Facile que la Prediction,Pas Adapte
3767,2018,Mathematique,1,Le Calcul d'Integral,1,Les Divers Types d'Integrale,7,570,3,QCM,0.27,0.37,59.0,68,47,115,99,68,31,1.16,68.69,Difficile,Moyen,1,Plus Facile que la Prediction,Pas Adapte
4833,2019,Mathematique,1,Le Calcul d'Integral,1,Les Divers Types d'Integrale,7,570,3,QCM,0.26,0.68,49.0,50,52,102,86,50,36,1.19,58.14,Facile,Moyen,-1,Plus Difficile que la Prediction,Pas Adapte
5899,2020,Mathematique,1,Le Calcul d'Integral,1,Les Divers Types d'Integrale,7,570,3,QCM,0.78,0.26,19.0,17,72,89,48,17,31,1.85,35.42,Moyen,Difficile,-1,Plus Difficile que la Prediction,Pas Adapte
570,2015,Mathematique,1,Le Calcul d'Integral,1,Les Divers Types d'Integrale,7,571,4,QROC,0.45,0.36,40.0,14,22,36,21,14,7,1.71,66.67,Facile,Moyen,-1,Plus Difficile que la Prediction,Pas Adapte
1636,2016,Mathematique,1,Le Calcul d'Integral,1,Les Divers Types d'Integrale,7,571,4,QROC,0.65,0.02,21.0,8,28,36,28,8,20,1.29,28.57,Difficile,Difficile,0,Meme Difficulte que la Prediction,Pas Adapte
2702,2017,Mathematique,1,Le Calcul d'Integral,1,Les Divers Types d'Integrale,7,571,4,QCM,0.61,0.27,28.0,11,27,38,24,11,13,1.58,45.83,Moyen,Difficile,-1,Plus Difficile que la Prediction,Pas Adapte
3768,2018,Mathematique,1,Le Calcul d'Integral,1,Les Divers Types d'Integrale,7,571,4,QCM,0.77,0.25,15.0,5,29,34,33,5,28,1.03,15.15,Facile,Difficile,-2,Beaucoup plus Difficile que la Prediction,Pas Adapte
4834,2019,Mathematique,1,Le Calcul d'Integral,1,Les Divers Types d'Integrale,7,571,4,QCU,0.23,0.66,59.0,19,13,32,29,19,10,1.1,65.52,Facile,Moyen,-1,Plus Difficile que la Prediction,Pas Adapte
5900,2020,Mathematique,1,Le Calcul d'Integral,1,Les Divers Types d'Integrale,7,571,4,QCU,0.09,0.77,67.0,23,12,35,27,23,4,1.3,85.19,Moyen,Facile,1,Plus Facile que la Prediction,Adapte
571,2015,Mathematique,1,Le Calcul d'Integral,1,Les Divers Types d'Integrale,7,572,5,QROC,0.9,0.14,20.0,16,62,78,62,16,46,1.26,25.81,Difficile,Difficile,0,Meme Difficulte que la Prediction,Pas Adapte
1637,2016,Mathematique,1,Le Calcul d'Integral,1,Les Divers Types d'Integrale,7,572,5,QROC,0.68,0.14,27.0,23,64,87,39,23,16,2.23,58.97,Difficile,Difficile,0,Meme Difficulte que la Prediction,Pas Adapte
2703,2017,Mathematique,1,Le Calcul d'Integral,1,Les Divers Types d'Integrale,7,572,5,QROC,0.57,0.27,59.0,55,38,93,57,55,2,1.63,96.49,Facile,Moyen,-1,Plus Difficile que la Prediction,Pas Adapte
3769,2018,Mathematique,1,Le Calcul d'Integral,1,Les Divers Types d'Integrale,7,572,5,QCU,0.15,0.95,69.0,72,32,104,86,72,14,1.21,83.72,Difficile,Facile,2,Beaucoup plus Facile que la Prediction,Adapte
4835,2019,Mathematique,1,Le Calcul d'Integral,1,Les Divers Types d'Integrale,7,572,5,QCU,0.18,1.0,69.0,83,37,120,86,83,3,1.4,96.51,Facile,Facile,0,Meme Difficulte que la Prediction,Adapte
5901,2020,Mathematique,1,Le Calcul d'Integral,1,Les Divers Types d'Integrale,7,572,5,QCU,0.09,0.98,69.0,88,39,127,112,88,24,1.13,78.57,Facile,Facile,0,Meme Difficulte que la Prediction,Adapte
572,2015,Mathematique,1,Le Calcul d'Integral,1,Les Divers Types d'Integrale,7,573,6,QCM,0.71,0.27,6.0,3,50,53,42,3,39,1.26,7.14,Moyen,Difficile,-1,Plus Difficile que la Prediction,Pas Adapte
1638,2016,Mathematique,1,Le Calcul d'Integral,1,Les Divers Types d'Integrale,7,573,6,QROC,0.98,0.22,25.0,13,40,53,32,13,19,1.66,40.62,Moyen,Difficile,-1,Plus Difficile que la Prediction,Pas Adapte
2704,2017,Mathematique,1,Le Calcul d'Integral,1,Les Divers Types d'Integrale,7,573,6,QROC,0.78,0.05,16.0,8,41,49,49,8,41,1.0,16.33,Difficile,Difficile,0,Meme Difficulte que la Prediction,Pas Adapte
3770,2018,Mathematique,1,Le Calcul d'Integral,1,Les Divers Types d'Integrale,7,573,6,QROC,0.83,0.24,23.0,10,34,44,38,10,28,1.16,26.32,Moyen,Difficile,-1,Plus Difficile que la Prediction,Pas Adapte
4836,2019,Mathematique,1,Le Calcul d'Integral,1,Les Divers Types d'Integrale,7,573,6,QCM,0.8,0.29,20.0,10,40,50,24,10,14,2.08,41.67,Facile,Difficile,-2,Beaucoup plus Difficile que la Prediction,Pas Adapte
5902,2020,Mathematique,1,Le Calcul d'Integral,1,Les Divers Types d'Integrale,7,573,6,QCM,0.72,0.28,1.0,0,50,50,48,0,48,1.04,0.0,Difficile,Difficile,0,Meme Difficulte que la Prediction,Pas Adapte
573,2015,Mathematique,1,Le Calcul d'Integral,1,Les Divers Types d'Integrale,7,574,7,QCU,0.42,0.3,12.0,10,71,81,51,10,41,1.59,19.61,Difficile,Difficile,0,Meme Difficulte que la Prediction,Pas Adapte
1639,2016,Mathematique,1,Le Calcul d'Integral,1,Les Divers Types d'Integrale,7,574,7,QCU,0.58,0.21,14.0,12,73,85,69,12,57,1.23,17.39,Facile,Difficile,-2,Beaucoup plus Difficile que la Prediction,Pas Adapte
2705,2017,Mathematique,1,Le Calcul d'Integral,1,Les Divers Types d'Integrale,7,574,7,QCU,0.43,0.38,35.0,32,60,92,37,32,5,2.49,86.49,Facile,Difficile,-2,Beaucoup plus Difficile que la Prediction,Pas Adapte
3771,2018,Mathematique,1,Le Calcul d'Integral,1,Les Divers Types d'Integrale,7,574,7,QCU,0.23,0.62,42.0,33,46,79,64,33,31,1.23,51.56,Difficile,Moyen,1,Plus Facile que la Prediction,Pas Adapte
4837,2019,Mathematique,1,Le Calcul d'Integral,1,Les Divers Types d'Integrale,7,574,7,QCU,0.34,0.52,49.0,36,37,73,43,36,7,1.7,83.72,Facile,Moyen,-1,Plus Difficile que la Prediction,Pas Adapte
5903,2020,Mathematique,1,Le Calcul d'Integral,1,Les Divers Types d'Integrale,7,574,7,QCM,0.51,0.22,17.0,12,59,71,27,12,15,2.63,44.44,Moyen,Difficile,-1,Plus Difficile que la Prediction,Pas Adapte
574,2015,Mathematique,1,Le Calcul d'Integral,2,Les Methodes Generales d'Integration,10,575,1,QCM,0.57,0.17,29.0,12,31,43,22,12,10,1.95,54.55,Difficile,Difficile,0,Meme Difficulte que la Prediction,Pas Adapte
1640,2016,Mathematique,1,Le Calcul d'Integral,2,Les Methodes Generales d'Integration,10,575,1,QCM,0.32,0.62,52.0,25,23,48,27,25,2,1.78,92.59,Facile,Moyen,-1,Plus Difficile que la Prediction,Pas Adapte
2706,2017,Mathematique,1,Le Calcul d'Integral,2,Les Methodes Generales d'Integration,10,575,1,QROC,0.37,0.3,41.0,20,28,48,27,20,7,1.78,74.07,Difficile,Moyen,1,Plus Facile que la Prediction,Pas Adapte
3772,2018,Mathematique,1,Le Calcul d'Integral,2,Les Methodes Generales d'Integration,10,575,1,QROC,0.44,0.26,63.0,30,18,48,33,30,3,1.45,90.91,Moyen,Moyen,0,Meme Difficulte que la Prediction,Adapte
4838,2019,Mathematique,1,Le Calcul d'Integral,2,Les Methodes Generales d'Integration,10,575,1,QROC,0.24,0.35,63.0,33,20,53,46,33,13,1.15,71.74,Moyen,Moyen,0,Meme Difficulte que la Prediction,Adapte
5904,2020,Mathematique,1,Le Calcul d'Integral,2,Les Methodes Generales d'Integration,10,575,1,QROC,0.58,0.27,63.0,38,22,60,39,38,1,1.54,97.44,Moyen,Moyen,0,Meme Difficulte que la Prediction,Adapte
575,2015,Mathematique,1,Le Calcul d'Integral,2,Les Methodes Generales d'Integration,10,576,2,QCU,0.45,0.23,35.0,7,13,20,10,7,3,2.0,70.0,Moyen,Difficile,-1,Plus Difficile que la Prediction,Pas Adapte
1641,2016,Mathematique,1,Le Calcul d'Integral,2,Les Methodes Generales d'Integration,10,576,2,QCU,0.35,0.52,63.0,14,9,23,20,14,6,1.15,70.0,Difficile,Moyen,1,Plus Facile que la Prediction,Adapte
2707,2017,Mathematique,1,Le Calcul d'Integral,2,Les Methodes Generales d'Integration,10,576,2,QCU,0.29,0.59,63.0,16,10,26,20,16,4,1.3,80.0,Moyen,Moyen,0,Meme Difficulte que la Prediction,Adapte
3773,2018,Mathematique,1,Le Calcul d'Integral,2,Les Methodes Generales d'Integration,10,576,2,QCM,0.21,0.5,63.0,18,11,29,21,18,3,1.38,85.71,Moyen,Moyen,0,Meme Difficulte que la Prediction,Adapte
4839,2019,Mathematique,1,Le Calcul d'Integral,2,Les Methodes Generales d'Integration,10,576,2,QCM,0.47,0.44,63.0,17,10,27,25,17,8,1.08,68.0,Moyen,Moyen,0,Meme Difficulte que la Prediction,Adapte
5905,2020,Mathematique,1,Le Calcul d'Integral,2,Les Methodes Generales d'Integration,10,576,2,QCM,0.26,0.65,63.0,14,9,23,18,14,4,1.28,77.78,Moyen,Moyen,0,Meme Difficulte que la Prediction,Adapte
576,2015,Mathematique,1,Le Calcul d'Integral,2,Les Methodes Generales d'Integration,10,577,3,QO,0.39,0.25,48.0,2,3,5,4,2,2,1.25,50.0,Moyen,Moyen,0,Meme Difficulte que la Prediction,Pas Adapte
1642,2016,Mathematique,1,Le Calcul d'Integral,2,Les Methodes Generales d'Integration,10,577,3,QO,0.83,0.02,12.0,1,4,5,3,1,2,1.67,33.33,Facile,Difficile,-2,Beaucoup plus Difficile que la Prediction,Pas Adapte
2708,2017,Mathematique,1,Le Calcul d'Integral,2,Les Methodes Generales d'Integration,10,577,3,QROC,0.67,0.14,19.0,1,4,5,4,1,3,1.25,25.0,Facile,Difficile,-2,Beaucoup plus Difficile que la Prediction,Pas Adapte
3774,2018,Mathematique,1,Le Calcul d'Integral,2,Les Methodes Generales d'Integration,10,577,3,QO,0.93,0.05,15.0,1,3,4,2,1,1,2.0,50.0,Facile,Difficile,-2,Beaucoup plus Difficile que la Prediction,Pas Adapte
4840,2019,Mathematique,1,Le Calcul d'Integral,2,Les Methodes Generales d'Integration,10,577,3,QO,0.94,0.14,8.0,0,3,3,2,0,2,1.5,0.0,Facile,Difficile,-2,Beaucoup plus Difficile que la Prediction,Pas Adapte
5906,2020,Mathematique,1,Le Calcul d'Integral,2,Les Methodes Generales d'Integration,10,577,3,QROC,0.41,0.26,63.0,2,1,3,3,2,1,1.0,66.67,Difficile,Moyen,1,Plus Facile que la Prediction,Adapte
577,2015,Mathematique,1,Le Calcul d'Integral,2,Les Methodes Generales d'Integration,10,578,4,QCU,0.25,0.74,47.0,34,38,72,66,34,32,1.09,51.52,Facile,Moyen,-1,Plus Difficile que la Prediction,Pas Adapte
1643,2016,Mathematique,1,Le Calcul d'Integral,2,Les Methodes Generales d'Integration,10,578,4,QCU,0.38,0.61,41.0,28,41,69,28,28,0,2.46,100.0,Moyen,Moyen,0,Meme Difficulte que la Prediction,Pas Adapte
2709,2017,Mathematique,1,Le Calcul d'Integral,2,Les Methodes Generales d'Integration,10,578,4,QCU,0.28,0.74,61.0,45,28,73,58,45,13,1.26,77.59,Facile,Moyen,-1,Plus Difficile que la Prediction,Adapte
3775,2018,Mathematique,1,Le Calcul d'Integral,2,Les Methodes Generales d'Integration,10,578,4,QCU,0.21,0.52,61.0,49,32,81,59,49,10,1.37,83.05,Moyen,Moyen,0,Meme Difficulte que la Prediction,Adapte
4841,2019,Mathematique,1,Le Calcul d'Integral,2,Les Methodes Generales d'Integration,10,578,4,QCU,0.31,0.57,61.0,52,34,86,73,52,21,1.18,71.23,Moyen,Moyen,0,Meme Difficulte que la Prediction,Adapte
5907,2020,Mathematique,1,Le Calcul d'Integral,2,Les Methodes Generales d'Integration,10,578,4,QCU,0.34,0.44,61.0,57,37,94,83,57,26,1.13,68.67,Moyen,Moyen,0,Meme Difficulte que la Prediction,Adapte
578,2015,Mathematique,1,Le Calcul d'Integral,2,Les Methodes Generales d'Integration,10,579,5,QCU,0.38,0.42,61.0,53,34,87,80,53,27,1.09,66.25,Facile,Moyen,-1,Plus Difficile que la Prediction,Adapte
1644,2016,Mathematique,1,Le Calcul d'Integral,2,Les Methodes Generales d'Integration,10,579,5,QCU,0.39,0.69,61.0,52,33,85,78,52,26,1.09,66.67,Moyen,Moyen,0,Meme Difficulte que la Prediction,Adapte
2710,2017,Mathematique,1,Le Calcul d'Integral,2,Les Methodes Generales d'Integration,10,579,5,QCU,0.28,0.66,61.0,46,29,75,48,46,2,1.56,95.83,Moyen,Moyen,0,Meme Difficulte que la Prediction,Adapte
3776,2018,Mathematique,1,Le Calcul d'Integral,2,Les Methodes Generales d'Integration,10,579,5,QCU,0.34,0.45,61.0,49,31,80,55,49,6,1.45,89.09,Moyen,Moyen,0,Meme Difficulte que la Prediction,Adapte
4842,2019,Mathematique,1,Le Calcul d'Integral,2,Les Methodes Generales d'Integration,10,579,5,QCM,0.41,0.34,61.0,52,34,86,67,52,15,1.28,77.61,Moyen,Moyen,0,Meme Difficulte que la Prediction,Adapte
5908,2020,Mathematique,1,Le Calcul d'Integral,2,Les Methodes Generales d'Integration,10,579,5,QCU,0.34,0.43,61.0,51,33,84,77,51,26,1.09,66.23,Moyen,Moyen,0,Meme Difficulte que la Prediction,Adapte
579,2015,Mathematique,1,Le Calcul d'Integral,2,Les Methodes Generales d'Integration,10,580,6,QCU,0.64,0.25,13.0,3,20,23,9,3,6,2.56,33.33,Facile,Difficile,-2,Beaucoup plus Difficile que la Prediction,Pas Adapte
1645,2016,Mathematique,1,Le Calcul d'Integral,2,Les Methodes Generales d'Integration,10,580,6,QCU,0.06,0.98,66.0,14,7,21,14,14,0,1.5,100.0,Facile,Facile,0,Meme Difficulte que la Prediction,Adapte
2711,2017,Mathematique,1,Le Calcul d'Integral,2,Les Methodes Generales d'Integration,10,580,6,QCU,0.16,0.94,66.0,13,6,19,16,13,3,1.19,81.25,Facile,Facile,0,Meme Difficulte que la Prediction,Adapte
3777,2018,Mathematique,1,Le Calcul d'Integral,2,Les Methodes Generales d'Integration,10,580,6,QCU,0.03,0.95,66.0,14,7,21,19,14,5,1.11,73.68,Facile,Facile,0,Meme Difficulte que la Prediction,Adapte
4843,2019,Mathematique,1,Le Calcul d'Integral,2,Les Methodes Generales d'Integration,10,580,6,QCU,0.12,0.9,66.0,14,7,21,19,14,5,1.11,73.68,Facile,Facile,0,Meme Difficulte que la Prediction,Adapte
5909,2020,Mathematique,1,Le Calcul d'Integral,2,Les Methodes Generales d'Integration,10,580,6,QCU,0.19,0.97,66.0,15,8,23,15,15,0,1.53,100.0,Facile,Facile,0,Meme Difficulte que la Prediction,Adapte
580,2015,Mathematique,1,Le Calcul d'Integral,2,Les Methodes Generales d'Integration,10,581,7,QCM,0.34,0.58,47.0,7,7,14,9,7,2,1.56,77.78,Moyen,Moyen,0,Meme Difficulte que la Prediction,Pas Adapte
1646,2016,Mathematique,1,Le Calcul d'Integral,2,Les Methodes Generales d'Integration,10,581,7,QCM,0.63,0.23,22.0,3,11,14,11,3,8,1.27,27.27,Facile,Difficile,-2,Beaucoup plus Difficile que la Prediction,Pas Adapte
2712,2017,Mathematique,1,Le Calcul d'Integral,2,Les Methodes Generales d'Integration,10,581,7,QCM,0.26,0.45,57.0,7,6,13,9,7,2,1.44,77.78,Moyen,Moyen,0,Meme Difficulte que la Prediction,Pas Adapte
3778,2018,Mathematique,1,Le Calcul d'Integral,2,Les Methodes Generales d'Integration,10,581,7,QCM,0.67,0.17,32.0,5,10,15,8,5,3,1.88,62.5,Difficile,Difficile,0,Meme Difficulte que la Prediction,Pas Adapte
4844,2019,Mathematique,1,Le Calcul d'Integral,2,Les Methodes Generales d'Integration,10,581,7,QCM,0.49,0.47,46.0,6,7,13,12,6,6,1.08,50.0,Facile,Moyen,-1,Plus Difficile que la Prediction,Pas Adapte
5910,2020,Mathematique,1,Le Calcul d'Integral,2,Les Methodes Generales d'Integration,10,581,7,QCM,0.77,0.19,18.0,3,11,14,10,3,7,1.4,30.0,Difficile,Difficile,0,Meme Difficulte que la Prediction,Pas Adapte
581,2015,Mathematique,1,Le Calcul d'Integral,2,Les Methodes Generales d'Integration,10,582,8,QCM,0.73,0.17,14.0,5,30,35,19,5,14,1.84,26.32,Facile,Difficile,-2,Beaucoup plus Difficile que la Prediction,Pas Adapte
1647,2016,Mathematique,1,Le Calcul d'Integral,2,Les Methodes Generales d'Integration,10,582,8,QCM,0.57,0.17,15.0,5,28,33,27,5,22,1.22,18.52,Facile,Difficile,-2,Beaucoup plus Difficile que la Prediction,Pas Adapte
2713,2017,Mathematique,1,Le Calcul d'Integral,2,Les Methodes Generales d'Integration,10,582,8,QCM,0.73,0.17,30.0,10,22,32,31,10,21,1.03,32.26,Moyen,Difficile,-1,Plus Difficile que la Prediction,Pas Adapte
3779,2018,Mathematique,1,Le Calcul d'Integral,2,Les Methodes Generales d'Integration,10,582,8,QCM,0.49,0.56,39.0,11,18,29,12,11,1,2.42,91.67,Moyen,Moyen,0,Meme Difficulte que la Prediction,Pas Adapte
4845,2019,Mathematique,1,Le Calcul d'Integral,2,Les Methodes Generales d'Integration,10,582,8,QCU,0.7,0.29,29.0,7,18,25,25,7,18,1.0,28.0,Facile,Difficile,-2,Beaucoup plus Difficile que la Prediction,Pas Adapte
5911,2020,Mathematique,1,Le Calcul d'Integral,2,Les Methodes Generales d'Integration,10,582,8,QCU,0.1,0.76,70.0,15,6,21,20,15,5,1.05,75.0,Facile,Facile,0,Meme Difficulte que la Prediction,Adapte
582,2015,Mathematique,1,Le Calcul d'Integral,2,Les Methodes Generales d'Integration,10,583,9,QCU,0.61,0.2,4.0,3,61,64,33,3,30,1.94,9.09,Moyen,Difficile,-1,Plus Difficile que la Prediction,Pas Adapte
1648,2016,Mathematique,1,Le Calcul d'Integral,2,Les Methodes Generales d'Integration,10,583,9,QCU,0.74,0.23,14.0,8,47,55,28,8,20,1.96,28.57,Facile,Difficile,-2,Beaucoup plus Difficile que la Prediction,Pas Adapte
2714,2017,Mathematique,1,Le Calcul d'Integral,2,Les Methodes Generales d'Integration,10,583,9,QCU,0.36,0.61,40.0,23,35,58,41,23,18,1.41,56.1,Moyen,Moyen,0,Meme Difficulte que la Prediction,Pas Adapte
3780,2018,Mathematique,1,Le Calcul d'Integral,2,Les Methodes Generales d'Integration,10,583,9,QCU,0.04,0.76,67.0,34,16,50,36,34,2,1.39,94.44,Difficile,Facile,2,Beaucoup plus Facile que la Prediction,Adapte
4846,2019,Mathematique,1,Le Calcul d'Integral,2,Les Methodes Generales d'Integration,10,583,9,QCU,0.0,1.0,67.0,33,16,49,46,33,13,1.07,71.74,Facile,Facile,0,Meme Difficulte que la Prediction,Adapte
5912,2020,Mathematique,1,Le Calcul d'Integral,2,Les Methodes Generales d'Integration,10,583,9,QCU,0.16,0.9,67.0,36,18,54,44,36,8,1.23,81.82,Facile,Facile,0,Meme Difficulte que la Prediction,Adapte
583,2015,Mathematique,1,Le Calcul d'Integral,2,Les Methodes Generales d'Integration,10,584,10,QCM,0.77,0.21,14.0,13,83,96,85,13,72,1.13,15.29,Moyen,Difficile,-1,Plus Difficile que la Prediction,Pas Adapte
1649,2016,Mathematique,1,Le Calcul d'Integral,2,Les Methodes Generales d'Integration,10,584,10,QCM,0.67,0.18,15.0,13,75,88,29,13,16,3.03,44.83,Facile,Difficile,-2,Beaucoup plus Difficile que la Prediction,Pas Adapte
2715,2017,Mathematique,1,Le Calcul d'Integral,2,Les Methodes Generales d'Integration,10,584,10,QCM,0.64,0.17,12.0,10,73,83,80,10,70,1.04,12.5,Facile,Difficile,-2,Beaucoup plus Difficile que la Prediction,Pas Adapte
3781,2018,Mathematique,1,Le Calcul d'Integral,2,Les Methodes Generales d'Integration,10,584,10,QCU,0.46,0.34,2.0,2,81,83,69,2,67,1.2,2.9,Moyen,Difficile,-1,Plus Difficile que la Prediction,Pas Adapte
4847,2019,Mathematique,1,Le Calcul d'Integral,2,Les Methodes Generales d'Integration,10,584,10,QCM,0.47,0.61,50.0,37,37,74,49,37,12,1.51,75.51,Moyen,Moyen,0,Meme Difficulte que la Prediction,Pas Adapte
5913,2020,Mathematique,1,Le Calcul d'Integral,2,Les Methodes Generales d'Integration,10,584,10,QCM,0.69,0.27,19.0,15,62,77,60,15,45,1.28,25.0,Facile,Difficile,-2,Beaucoup plus Difficile que la Prediction,Pas Adapte
584,2015,Mathematique,1,Le Calcul d'Integral,3,Integration des Fractions Rationnelles,5,585,1,QCU,0.16,0.91,66.0,21,11,32,28,21,7,1.14,75.0,Difficile,Facile,2,Beaucoup plus Facile que la Prediction,Adapte
1650,2016,Mathematique,1,Le Calcul d'Integral,3,Integration des Fractions Rationnelles,5,585,1,QCU,0.12,0.75,66.0,20,10,30,29,20,9,1.03,68.97,Facile,Facile,0,Meme Difficulte que la Prediction,Adapte
2716,2017,Mathematique,1,Le Calcul d'Integral,3,Integration des Fractions Rationnelles,5,585,1,QCU,0.11,0.82,66.0,21,11,32,24,21,3,1.33,87.5,Facile,Facile,0,Meme Difficulte que la Prediction,Adapte
3782,2018,Mathematique,1,Le Calcul d'Integral,3,Integration des Fractions Rationnelles,5,585,1,QCU,0.2,0.92,66.0,18,10,28,19,18,1,1.47,94.74,Facile,Facile,0,Meme Difficulte que la Prediction,Adapte
4848,2019,Mathematique,1,Le Calcul d'Integral,3,Integration des Fractions Rationnelles,5,585,1,QCU,0.09,0.79,66.0,18,10,28,22,18,4,1.27,81.82,Facile,Facile,0,Meme Difficulte que la Prediction,Adapte
5914,2020,Mathematique,1,Le Calcul d'Integral,3,Integration des Fractions Rationnelles,5,585,1,QCU,0.12,0.87,66.0,18,10,28,24,18,6,1.17,75.0,Facile,Facile,0,Meme Difficulte que la Prediction,Adapte
585,2015,Mathematique,1,Le Calcul d'Integral,3,Integration des Fractions Rationnelles,5,586,2,QCU,0.05,0.75,65.0,23,12,35,29,23,6,1.21,79.31,Moyen,Facile,1,Plus Facile que la Prediction,Adapte
1651,2016,Mathematique,1,Le Calcul d'Integral,3,Integration des Fractions Rationnelles,5,586,2,QCU,0.18,0.89,65.0,20,11,31,26,20,6,1.19,76.92,Facile,Facile,0,Meme Difficulte que la Prediction,Adapte
2717,2017,Mathematique,1,Le Calcul d'Integral,3,Integration des Fractions Rationnelles,5,586,2,QCU,0.06,0.91,65.0,19,10,29,26,19,7,1.12,73.08,Facile,Facile,0,Meme Difficulte que la Prediction,Adapte
3783,2018,Mathematique,1,Le Calcul d'Integral,3,Integration des Fractions Rationnelles,5,586,2,QCU,0.02,0.83,65.0,21,11,32,21,21,0,1.52,100.0,Facile,Facile,0,Meme Difficulte que la Prediction,Adapte
4849,2019,Mathematique,1,Le Calcul d'Integral,3,Integration des Fractions Rationnelles,5,586,2,QCU,0.0,0.93,65.0,18,10,28,18,18,0,1.56,100.0,Facile,Facile,0,Meme Difficulte que la Prediction,Adapte
5915,2020,Mathematique,1,Le Calcul d'Integral,3,Integration des Fractions Rationnelles,5,586,2,QCU,0.14,0.88,65.0,17,9,26,17,17,0,1.53,100.0,Facile,Facile,0,Meme Difficulte que la Prediction,Adapte
586,2015,Mathematique,1,Le Calcul d'Integral,3,Integration des Fractions Rationnelles,5,587,3,QO,0.69,0.17,48.0,38,41,79,64,38,26,1.23,59.38,Facile,Moyen,-1,Plus Difficile que la Prediction,Pas Adapte
1652,2016,Mathematique,1,Le Calcul d'Integral,3,Integration des Fractions Rationnelles,5,587,3,QO,0.24,0.21,59.0,44,31,75,59,44,15,1.27,74.58,Facile,Moyen,-1,Plus Difficile que la Prediction,Pas Adapte
2718,2017,Mathematique,1,Le Calcul d'Integral,3,Integration des Fractions Rationnelles,5,587,3,QO,0.57,0.27,43.0,28,38,66,49,28,21,1.35,57.14,Moyen,Moyen,0,Meme Difficulte que la Prediction,Pas Adapte
3784,2018,Mathematique,1,Le Calcul d'Integral,3,Integration des Fractions Rationnelles,5,587,3,QO,0.35,0.29,50.0,28,29,57,50,28,22,1.14,56.0,Facile,Moyen,-1,Plus Difficile que la Prediction,Pas Adapte
4850,2019,Mathematique,1,Le Calcul d'Integral,3,Integration des Fractions Rationnelles,5,587,3,QROC,0.21,0.33,43.0,23,30,53,24,23,1,2.21,95.83,Difficile,Moyen,1,Plus Facile que la Prediction,Pas Adapte
5916,2020,Mathematique,1,Le Calcul d'Integral,3,Integration des Fractions Rationnelles,5,587,3,QROC,0.95,0.03,2.0,1,55,56,46,1,45,1.22,2.17,Difficile,Difficile,0,Meme Difficulte que la Prediction,Pas Adapte
587,2015,Mathematique,1,Le Calcul d'Integral,3,Integration des Fractions Rationnelles,5,588,4,QCU,0.14,0.88,67.0,54,27,81,73,54,19,1.11,73.97,Moyen,Facile,1,Plus Facile que la Prediction,Adapte
1653,2016,Mathematique,1,Le Calcul d'Integral,3,Integration des Fractions Rationnelles,5,588,4,QCU,0.2,0.96,67.0,52,26,78,75,52,23,1.04,69.33,Facile,Facile,0,Meme Difficulte que la Prediction,Adapte
2719,2017,Mathematique,1,Le Calcul d'Integral,3,Integration des Fractions Rationnelles,5,588,4,QCU,0.01,0.84,67.0,60,29,89,79,60,19,1.13,75.95,Facile,Facile,0,Meme Difficulte que la Prediction,Adapte
3785,2018,Mathematique,1,Le Calcul d'Integral,3,Integration des Fractions Rationnelles,5,588,4,QCU,0.13,0.92,67.0,59,29,88,71,59,12,1.24,83.1,Facile,Facile,0,Meme Difficulte que la Prediction,Adapte
4851,2019,Mathematique,1,Le Calcul d'Integral,3,Integration des Fractions Rationnelles,5,588,4,QCU,0.18,0.84,67.0,66,33,99,95,66,29,1.04,69.47,Facile,Facile,0,Meme Difficulte que la Prediction,Adapte
5917,2020,Mathematique,1,Le Calcul d'Integral,3,Integration des Fractions Rationnelles,5,588,4,QCU,0.1,0.97,67.0,73,36,109,82,73,9,1.33,89.02,Facile,Facile,0,Meme Difficulte que la Prediction,Adapte
588,2015,Mathematique,1,Le Calcul d'Integral,3,Integration des Fractions Rationnelles,5,589,5,QCU,0.24,0.66,38.0,26,43,69,44,26,18,1.57,59.09,Facile,Moyen,-1,Plus Difficile que la Prediction,Pas Adapte
1654,2016,Mathematique,1,Le Calcul d'Integral,3,Integration des Fractions Rationnelles,5,589,5,QCU,0.63,0.3,0.0,0,65,65,44,0,44,1.48,0.0,Moyen,Difficile,-1,Plus Difficile que la Prediction,Pas Adapte
2720,2017,Mathematique,1,Le Calcul d'Integral,3,Integration des Fractions Rationnelles,5,589,5,QCU,0.22,0.54,60.0,43,29,72,60,43,17,1.2,71.67,Facile,Moyen,-1,Plus Difficile que la Prediction,Adapte
3786,2018,Mathematique,1,Le Calcul d'Integral,3,Integration des Fractions Rationnelles,5,589,5,QCU,0.29,0.7,60.0,38,25,63,42,38,4,1.5,90.48,Moyen,Moyen,0,Meme Difficulte que la Prediction,Adapte
4852,2019,Mathematique,1,Le Calcul d'Integral,3,Integration des Fractions Rationnelles,5,589,5,QCU,0.21,0.64,60.0,40,26,66,63,40,23,1.05,63.49,Moyen,Moyen,0,Meme Difficulte que la Prediction,Adapte
5918,2020,Mathematique,1,Le Calcul d'Integral,3,Integration des Fractions Rationnelles,5,589,5,QCU,0.26,0.62,60.0,46,30,76,71,46,25,1.07,64.79,Moyen,Moyen,0,Meme Difficulte que la Prediction,Adapte
589,2015,Mathematique,1,Le Calcul d'Integral,4,Fonction Trigonometriques,7,590,1,QCU,0.58,0.3,34.0,5,11,16,8,5,3,2.0,62.5,Moyen,Difficile,-1,Plus Difficile que la Prediction,Pas Adapte
1655,2016,Mathematique,1,Le Calcul d'Integral,4,Fonction Trigonometriques,7,590,1,QCU,0.37,0.74,38.0,6,10,16,8,6,2,2.0,75.0,Difficile,Moyen,1,Plus Facile que la Prediction,Pas Adapte
2721,2017,Mathematique,1,Le Calcul d'Integral,4,Fonction Trigonometriques,7,590,1,QCU,0.71,0.23,20.0,4,14,18,7,4,3,2.57,57.14,Facile,Difficile,-2,Beaucoup plus Difficile que la Prediction,Pas Adapte
3787,2018,Mathematique,1,Le Calcul d'Integral,4,Fonction Trigonometriques,7,590,1,QCU,0.47,0.38,24.0,4,11,15,8,4,4,1.88,50.0,Facile,Difficile,-2,Beaucoup plus Difficile que la Prediction,Pas Adapte
4853,2019,Mathematique,1,Le Calcul d'Integral,4,Fonction Trigonometriques,7,590,1,QCU,0.36,0.54,48.0,8,9,17,17,8,9,1.0,47.06,Facile,Moyen,-1,Plus Difficile que la Prediction,Pas Adapte
5919,2020,Mathematique,1,Le Calcul d'Integral,4,Fonction Trigonometriques,7,590,1,QCU,0.35,0.49,54.0,9,7,16,12,9,3,1.33,75.0,Difficile,Moyen,1,Plus Facile que la Prediction,Pas Adapte
590,2015,Mathematique,1,Le Calcul d'Integral,4,Fonction Trigonometriques,7,591,2,QCU,0.51,0.24,16.0,12,64,76,66,12,54,1.15,18.18,Facile,Difficile,-2,Beaucoup plus Difficile que la Prediction,Pas Adapte
1656,2016,Mathematique,1,Le Calcul d'Integral,4,Fonction Trigonometriques,7,591,2,QCU,0.69,0.34,1.0,1,72,73,61,1,60,1.2,1.64,Facile,Difficile,-2,Beaucoup plus Difficile que la Prediction,Pas Adapte
2722,2017,Mathematique,1,Le Calcul d'Integral,4,Fonction Trigonometriques,7,591,2,QCU,0.63,0.26,27.0,22,58,80,28,22,6,2.86,78.57,Moyen,Difficile,-1,Plus Difficile que la Prediction,Pas Adapte
3788,2018,Mathematique,1,Le Calcul d'Integral,4,Fonction Trigonometriques,7,591,2,QCU,0.69,0.4,19.0,17,75,92,60,17,43,1.53,28.33,Moyen,Difficile,-1,Plus Difficile que la Prediction,Pas Adapte
4854,2019,Mathematique,1,Le Calcul d'Integral,4,Fonction Trigonometriques,7,591,2,QCU,0.23,0.43,54.0,53,45,98,65,53,12,1.51,81.54,Facile,Moyen,-1,Plus Difficile que la Prediction,Pas Adapte
5920,2020,Mathematique,1,Le Calcul d'Integral,4,Fonction Trigonometriques,7,591,2,QCM,0.24,0.43,38.0,40,64,104,60,40,20,1.73,66.67,Difficile,Moyen,1,Plus Facile que la Prediction,Pas Adapte
591,2015,Mathematique,1,Le Calcul d'Integral,4,Fonction Trigonometriques,7,592,3,QCU,0.3,0.51,44.0,17,21,38,21,17,4,1.81,80.95,Difficile,Moyen,1,Plus Facile que la Prediction,Pas Adapte
1657,2016,Mathematique,1,Le Calcul d'Integral,4,Fonction Trigonometriques,7,592,3,QCU,0.34,0.46,43.0,15,20,35,18,15,3,1.94,83.33,Moyen,Moyen,0,Meme Difficulte que la Prediction,Pas Adapte
2723,2017,Mathematique,1,Le Calcul d'Integral,4,Fonction Trigonometriques,7,592,3,QCU,0.74,0.24,24.0,9,29,38,33,9,24,1.15,27.27,Difficile,Difficile,0,Meme Difficulte que la Prediction,Pas Adapte
3789,2018,Mathematique,1,Le Calcul d'Integral,4,Fonction Trigonometriques,7,592,3,QCU,0.36,0.45,50.0,19,19,38,32,19,13,1.19,59.38,Moyen,Moyen,0,Meme Difficulte que la Prediction,Pas Adapte
4855,2019,Mathematique,1,Le Calcul d'Integral,4,Fonction Trigonometriques,7,592,3,QCU,0.39,0.54,53.0,20,17,37,35,20,15,1.06,57.14,Difficile,Moyen,1,Plus Facile que la Prediction,Pas Adapte
5921,2020,Mathematique,1,Le Calcul d'Integral,4,Fonction Trigonometriques,7,592,3,QCU,0.39,0.71,50.0,16,17,33,18,16,2,1.83,88.89,Difficile,Moyen,1,Plus Facile que la Prediction,Pas Adapte
592,2015,Mathematique,1,Le Calcul d'Integral,4,Fonction Trigonometriques,7,593,4,QCM,0.03,0.88,66.0,6,3,9,9,6,3,1.0,66.67,Facile,Facile,0,Meme Difficulte que la Prediction,Adapte
1658,2016,Mathematique,1,Le Calcul d'Integral,4,Fonction Trigonometriques,7,593,4,QCM,0.04,0.94,66.0,6,3,9,7,6,1,1.29,85.71,Facile,Facile,0,Meme Difficulte que la Prediction,Adapte
2724,2017,Mathematique,1,Le Calcul d'Integral,4,Fonction Trigonometriques,7,593,4,QCM,0.1,0.9,66.0,7,3,10,7,7,0,1.43,100.0,Facile,Facile,0,Meme Difficulte que la Prediction,Adapte
3790,2018,Mathematique,1,Le Calcul d'Integral,4,Fonction Trigonometriques,7,593,4,QCM,0.15,0.87,66.0,7,3,10,9,7,2,1.11,77.78,Facile,Facile,0,Meme Difficulte que la Prediction,Adapte
4856,2019,Mathematique,1,Le Calcul d'Integral,4,Fonction Trigonometriques,7,593,4,QCM,0.18,0.87,66.0,5,3,8,8,5,3,1.0,62.5,Facile,Facile,0,Meme Difficulte que la Prediction,Adapte
5922,2020,Mathematique,1,Le Calcul d'Integral,4,Fonction Trigonometriques,7,593,4,QCM,0.13,0.96,66.0,6,3,9,9,6,3,1.0,66.67,Facile,Facile,0,Meme Difficulte que la Prediction,Adapte
593,2015,Mathematique,1,Le Calcul d'Integral,4,Fonction Trigonometriques,7,594,5,QROC,0.98,0.04,2.0,2,92,94,60,2,58,1.57,3.33,Difficile,Difficile,0,Meme Difficulte que la Prediction,Pas Adapte
1659,2016,Mathematique,1,Le Calcul d'Integral,4,Fonction Trigonometriques,7,594,5,QROC,0.82,0.14,19.0,16,70,86,52,16,36,1.65,30.77,Moyen,Difficile,-1,Plus Difficile que la Prediction,Pas Adapte
2725,2017,Mathematique,1,Le Calcul d'Integral,4,Fonction Trigonometriques,7,594,5,QROC,0.99,0.07,8.0,8,86,94,69,8,61,1.36,11.59,Facile,Difficile,-2,Beaucoup plus Difficile que la Prediction,Pas Adapte
3791,2018,Mathematique,1,Le Calcul d'Integral,4,Fonction Trigonometriques,7,594,5,QCM,0.76,0.19,7.0,6,74,80,71,6,65,1.13,8.45,Difficile,Difficile,0,Meme Difficulte que la Prediction,Pas Adapte
4857,2019,Mathematique,1,Le Calcul d'Integral,4,Fonction Trigonometriques,7,594,5,QCM,0.25,0.54,51.0,43,42,85,81,43,38,1.05,53.09,Moyen,Moyen,0,Meme Difficulte que la Prediction,Pas Adapte
5923,2020,Mathematique,1,Le Calcul d'Integral,4,Fonction Trigonometriques,7,594,5,QCM,0.57,0.21,5.0,5,88,93,56,5,51,1.66,8.93,Facile,Difficile,-2,Beaucoup plus Difficile que la Prediction,Pas Adapte
594,2015,Mathematique,1,Le Calcul d'Integral,4,Fonction Trigonometriques,7,595,6,QCM,0.66,0.28,31.0,19,43,62,40,19,21,1.55,47.5,Facile,Difficile,-2,Beaucoup plus Difficile que la Prediction,Pas Adapte
1660,2016,Mathematique,1,Le Calcul d'Integral,4,Fonction Trigonometriques,7,595,6,QCM,0.2,0.41,58.0,33,24,57,34,33,1,1.68,97.06,Moyen,Moyen,0,Meme Difficulte que la Prediction,Pas Adapte
2726,2017,Mathematique,1,Le Calcul d'Integral,4,Fonction Trigonometriques,7,595,6,QCM,0.28,0.58,61.0,30,20,50,45,30,15,1.11,66.67,Facile,Moyen,-1,Plus Difficile que la Prediction,Adapte
3792,2018,Mathematique,1,Le Calcul d'Integral,4,Fonction Trigonometriques,7,595,6,QCM,0.36,0.35,61.0,31,20,51,46,31,15,1.11,67.39,Moyen,Moyen,0,Meme Difficulte que la Prediction,Adapte
4858,2019,Mathematique,1,Le Calcul d'Integral,4,Fonction Trigonometriques,7,595,6,QCM,0.42,0.42,61.0,30,19,49,42,30,12,1.17,71.43,Moyen,Moyen,0,Meme Difficulte que la Prediction,Adapte
5924,2020,Mathematique,1,Le Calcul d'Integral,4,Fonction Trigonometriques,7,595,6,QCM,0.33,0.42,61.0,30,19,49,37,30,7,1.32,81.08,Moyen,Moyen,0,Meme Difficulte que la Prediction,Adapte
595,2015,Mathematique,1,Le Calcul d'Integral,4,Fonction Trigonometriques,7,596,7,QCU,0.34,0.7,40.0,2,4,6,5,2,3,1.2,40.0,Facile,Moyen,-1,Plus Difficile que la Prediction,Pas Adapte
1661,2016,Mathematique,1,Le Calcul d'Integral,4,Fonction Trigonometriques,7,596,7,QCU,0.44,0.39,14.0,1,6,7,6,1,5,1.17,16.67,Moyen,Difficile,-1,Plus Difficile que la Prediction,Pas Adapte
2727,2017,Mathematique,1,Le Calcul d'Integral,4,Fonction Trigonometriques,7,596,7,QROC,0.07,0.7,68.0,5,2,7,7,5,2,1.0,71.43,Difficile,Facile,2,Beaucoup plus Facile que la Prediction,Adapte
3793,2018,Mathematique,1,Le Calcul d'Integral,4,Fonction Trigonometriques,7,596,7,QO,0.09,0.59,68.0,5,3,8,5,5,0,1.6,100.0,Facile,Facile,0,Meme Difficulte que la Prediction,Adapte
4859,2019,Mathematique,1,Le Calcul d'Integral,4,Fonction Trigonometriques,7,596,7,QO,0.17,0.36,68.0,5,3,8,5,5,0,1.6,100.0,Facile,Facile,0,Meme Difficulte que la Prediction,Adapte
5925,2020,Mathematique,1,Le Calcul d'Integral,4,Fonction Trigonometriques,7,596,7,QO,0.14,0.72,68.0,5,2,7,6,5,1,1.17,83.33,Facile,Facile,0,Meme Difficulte que la Prediction,Adapte
596,2015,Mathematique,1,Le Calcul d'Integral,5,Integrales Abeliennes,7,597,1,QCM,0.28,0.32,62.0,30,19,49,40,30,10,1.23,75.0,Difficile,Moyen,1,Plus Facile que la Prediction,Adapte
1662,2016,Mathematique,1,Le Calcul d'Integral,5,Integrales Abeliennes,7,597,1,QCM,0.29,0.65,62.0,33,21,54,54,33,21,1.0,61.11,Moyen,Moyen,0,Meme Difficulte que la Prediction,Adapte
2728,2017,Mathematique,1,Le Calcul d'Integral,5,Integrales Abeliennes,7,597,1,QCM,0.38,0.32,62.0,36,22,58,48,36,12,1.21,75.0,Moyen,Moyen,0,Meme Difficulte que la Prediction,Adapte
3794,2018,Mathematique,1,Le Calcul d'Integral,5,Integrales Abeliennes,7,597,1,QCM,0.21,0.43,62.0,40,25,65,52,40,12,1.25,76.92,Moyen,Moyen,0,Meme Difficulte que la Prediction,Adapte
4860,2019,Mathematique,1,Le Calcul d'Integral,5,Integrales Abeliennes,7,597,1,QCM,0.23,0.34,62.0,36,22,58,45,36,9,1.29,80.0,Moyen,Moyen,0,Meme Difficulte que la Prediction,Adapte
5926,2020,Mathematique,1,Le Calcul d'Integral,5,Integrales Abeliennes,7,597,1,QCM,0.3,0.35,62.0,40,25,65,45,40,5,1.44,88.89,Moyen,Moyen,0,Meme Difficulte que la Prediction,Adapte
597,2015,Mathematique,1,Le Calcul d'Integral,5,Integrales Abeliennes,7,598,2,QCU,0.23,0.43,42.0,4,5,9,8,4,4,1.12,50.0,Difficile,Moyen,1,Plus Facile que la Prediction,Pas Adapte
1663,2016,Mathematique,1,Le Calcul d'Integral,5,Integrales Abeliennes,7,598,2,QCU,0.49,0.22,16.0,2,8,10,8,2,6,1.25,25.0,Moyen,Difficile,-1,Plus Difficile que la Prediction,Pas Adapte
2729,2017,Mathematique,1,Le Calcul d'Integral,5,Integrales Abeliennes,7,598,2,QCU,0.02,0.92,66.0,7,4,11,10,7,3,1.1,70.0,Moyen,Facile,1,Plus Facile que la Prediction,Adapte
3795,2018,Mathematique,1,Le Calcul d'Integral,5,Integrales Abeliennes,7,598,2,QCU,0.18,0.9,66.0,7,4,11,10,7,3,1.1,70.0,Facile,Facile,0,Meme Difficulte que la Prediction,Adapte
4861,2019,Mathematique,1,Le Calcul d'Integral,5,Integrales Abeliennes,7,598,2,QCU,0.03,0.85,66.0,9,4,13,10,9,1,1.3,90.0,Facile,Facile,0,Meme Difficulte que la Prediction,Adapte
5927,2020,Mathematique,1,Le Calcul d'Integral,5,Integrales Abeliennes,7,598,2,QCU,0.19,0.92,66.0,8,4,12,9,8,1,1.33,88.89,Facile,Facile,0,Meme Difficulte que la Prediction,Adapte
598,2015,Mathematique,1,Le Calcul d'Integral,5,Integrales Abeliennes,7,599,3,QCM,0.33,0.65,54.0,3,3,6,4,3,1,1.5,75.0,Difficile,Moyen,1,Plus Facile que la Prediction,Pas Adapte
1664,2016,Mathematique,1,Le Calcul d'Integral,5,Integrales Abeliennes,7,599,3,QCM,0.55,0.27,22.0,2,5,7,4,2,2,1.75,50.0,Difficile,Difficile,0,Meme Difficulte que la Prediction,Pas Adapte
2730,2017,Mathematique,1,Le Calcul d'Integral,5,Integrales Abeliennes,7,599,3,QCM,0.59,0.22,0.0,0,8,8,7,0,7,1.14,0.0,Difficile,Difficile,0,Meme Difficulte que la Prediction,Pas Adapte
3796,2018,Mathematique,1,Le Calcul d'Integral,5,Integrales Abeliennes,7,599,3,QCM,0.42,0.6,64.0,4,3,7,5,4,1,1.4,80.0,Moyen,Moyen,0,Meme Difficulte que la Prediction,Adapte
4862,2019,Mathematique,1,Le Calcul d'Integral,5,Integrales Abeliennes,7,599,3,QCM,0.45,0.52,64.0,5,3,8,8,5,3,1.0,62.5,Moyen,Moyen,0,Meme Difficulte que la Prediction,Adapte
5928,2020,Mathematique,1,Le Calcul d'Integral,5,Integrales Abeliennes,7,599,3,QCM,0.22,0.49,64.0,6,3,9,8,6,2,1.12,75.0,Moyen,Moyen,0,Meme Difficulte que la Prediction,Adapte
599,2015,Mathematique,1,Le Calcul d'Integral,5,Integrales Abeliennes,7,600,4,QROC,0.57,0.26,62.0,48,29,77,75,48,27,1.03,64.0,Difficile,Moyen,1,Plus Facile que la Prediction,Adapte
1665,2016,Mathematique,1,Le Calcul d'Integral,5,Integrales Abeliennes,7,600,4,QROC,0.36,0.39,62.0,43,27,70,69,43,26,1.01,62.32,Moyen,Moyen,0,Meme Difficulte que la Prediction,Adapte
2731,2017,Mathematique,1,Le Calcul d'Integral,5,Integrales Abeliennes,7,600,4,QROC,0.59,0.33,62.0,49,30,79,65,49,16,1.22,75.38,Moyen,Moyen,0,Meme Difficulte que la Prediction,Adapte
3797,2018,Mathematique,1,Le Calcul d'Integral,5,Integrales Abeliennes,7,600,4,QO,0.58,0.18,62.0,56,34,90,58,56,2,1.55,96.55,Moyen,Moyen,0,Meme Difficulte que la Prediction,Adapte
4863,2019,Mathematique,1,Le Calcul d'Integral,5,Integrales Abeliennes,7,600,4,QO,0.38,0.19,62.0,48,30,78,69,48,21,1.13,69.57,Moyen,Moyen,0,Meme Difficulte que la Prediction,Adapte
5929,2020,Mathematique,1,Le Calcul d'Integral,5,Integrales Abeliennes,7,600,4,QO,0.62,0.27,62.0,51,32,83,53,51,2,1.57,96.23,Moyen,Moyen,0,Meme Difficulte que la Prediction,Adapte
600,2015,Mathematique,1,Le Calcul d'Integral,5,Integrales Abeliennes,7,601,5,QCM,0.64,0.17,9.0,8,83,91,70,8,62,1.3,11.43,Facile,Difficile,-2,Beaucoup plus Difficile que la Prediction,Pas Adapte
1666,2016,Mathematique,1,Le Calcul d'Integral,5,Integrales Abeliennes,7,601,5,QCU,0.71,0.26,2.0,2,87,89,38,2,36,2.34,5.26,Facile,Difficile,-2,Beaucoup plus Difficile que la Prediction,Pas Adapte
2732,2017,Mathematique,1,Le Calcul d'Integral,5,Integrales Abeliennes,7,601,5,QCU,0.61,0.32,31.0,27,59,86,70,27,43,1.23,38.57,Difficile,Difficile,0,Meme Difficulte que la Prediction,Pas Adapte
3798,2018,Mathematique,1,Le Calcul d'Integral,5,Integrales Abeliennes,7,601,5,QCU,0.37,0.51,59.0,48,34,82,80,48,32,1.02,60.0,Difficile,Moyen,1,Plus Facile que la Prediction,Pas Adapte
4864,2019,Mathematique,1,Le Calcul d'Integral,5,Integrales Abeliennes,7,601,5,QCU,0.45,0.29,7.0,6,80,86,57,6,51,1.51,10.53,Difficile,Difficile,0,Meme Difficulte que la Prediction,Pas Adapte
5930,2020,Mathematique,1,Le Calcul d'Integral,5,Integrales Abeliennes,7,601,5,QCM,0.41,0.35,36.0,32,58,90,56,32,24,1.61,57.14,Moyen,Moyen,0,Meme Difficulte que la Prediction,Pas Adapte
601,2015,Mathematique,1,Le Calcul d'Integral,5,Integrales Abeliennes,7,602,6,QCM,0.28,0.31,60.0,17,12,29,27,17,10,1.07,62.96,Difficile,Moyen,1,Plus Facile que la Prediction,Adapte
1667,2016,Mathematique,1,Le Calcul d'Integral,5,Integrales Abeliennes,7,602,6,QCM,0.36,0.42,60.0,19,12,31,22,19,3,1.41,86.36,Moyen,Moyen,0,Meme Difficulte que la Prediction,Adapte
2733,2017,Mathematique,1,Le Calcul d'Integral,5,Integrales Abeliennes,7,602,6,QCM,0.38,0.68,60.0,16,11,27,21,16,5,1.29,76.19,Moyen,Moyen,0,Meme Difficulte que la Prediction,Adapte
3799,2018,Mathematique,1,Le Calcul d'Integral,5,Integrales Abeliennes,7,602,6,QCM,0.28,0.5,60.0,14,10,24,14,14,0,1.71,100.0,Moyen,Moyen,0,Meme Difficulte que la Prediction,Adapte
4865,2019,Mathematique,1,Le Calcul d'Integral,5,Integrales Abeliennes,7,602,6,QCM,0.38,0.51,60.0,12,8,20,12,12,0,1.67,100.0,Moyen,Moyen,0,Meme Difficulte que la Prediction,Adapte
5931,2020,Mathematique,1,Le Calcul d'Integral,5,Integrales Abeliennes,7,602,6,QCM,0.29,0.53,60.0,14,9,23,21,14,7,1.1,66.67,Moyen,Moyen,0,Meme Difficulte que la Prediction,Adapte
602,2015,Mathematique,1,Le Calcul d'Integral,5,Integrales Abeliennes,7,603,7,QCU,0.26,0.5,39.0,10,15,25,12,10,2,2.08,83.33,Facile,Moyen,-1,Plus Difficile que la Prediction,Pas Adapte
1668,2016,Mathematique,1,Le Calcul d'Integral,5,Integrales Abeliennes,7,603,7,QROC,0.74,0.11,12.0,3,23,26,26,3,23,1.0,11.54,Facile,Difficile,-2,Beaucoup plus Difficile que la Prediction,Pas Adapte
2734,2017,Mathematique,1,Le Calcul d'Integral,5,Integrales Abeliennes,7,603,7,QROC,0.7,0.03,18.0,4,21,25,11,4,7,2.27,36.36,Difficile,Difficile,0,Meme Difficulte que la Prediction,Pas Adapte
3800,2018,Mathematique,1,Le Calcul d'Integral,5,Integrales Abeliennes,7,603,7,QCU,0.69,0.32,18.0,4,17,21,15,4,11,1.4,26.67,Moyen,Difficile,-1,Plus Difficile que la Prediction,Pas Adapte
4866,2019,Mathematique,1,Le Calcul d'Integral,5,Integrales Abeliennes,7,603,7,QCU,0.74,0.27,3.0,1,23,24,19,1,18,1.26,5.26,Moyen,Difficile,-1,Plus Difficile que la Prediction,Pas Adapte
5932,2020,Mathematique,1,Le Calcul d'Integral,5,Integrales Abeliennes,7,603,7,QCU,0.3,0.74,61.0,16,11,27,21,16,5,1.29,76.19,Moyen,Moyen,0,Meme Difficulte que la Prediction,Adapte
603,2015,Mathematique,1,Le Calcul d'Integral,6,Quelques Exemples en Maple,5,604,1,QO,0.83,0.1,3.0,1,31,32,31,1,30,1.03,3.23,Difficile,Difficile,0,Meme Difficulte que la Prediction,Pas Adapte
1669,2016,Mathematique,1,Le Calcul d'Integral,6,Quelques Exemples en Maple,5,604,1,QO,0.33,0.27,50.0,14,15,29,23,14,9,1.26,60.87,Moyen,Moyen,0,Meme Difficulte que la Prediction,Pas Adapte
2735,2017,Mathematique,1,Le Calcul d'Integral,6,Quelques Exemples en Maple,5,604,1,QROC,0.41,0.39,51.0,13,12,25,24,13,11,1.04,54.17,Facile,Moyen,-1,Plus Difficile que la Prediction,Pas Adapte
3801,2018,Mathematique,1,Le Calcul d'Integral,6,Quelques Exemples en Maple,5,604,1,QROC,0.7,0.09,34.0,7,14,21,10,7,3,2.1,70.0,Difficile,Difficile,0,Meme Difficulte que la Prediction,Pas Adapte
4867,2019,Mathematique,1,Le Calcul d'Integral,6,Quelques Exemples en Maple,5,604,1,QROC,0.86,0.14,19.0,4,15,19,11,4,7,1.73,36.36,Difficile,Difficile,0,Meme Difficulte que la Prediction,Pas Adapte
5933,2020,Mathematique,1,Le Calcul d'Integral,6,Quelques Exemples en Maple,5,604,1,QCM,0.21,0.44,43.0,7,10,17,8,7,1,2.12,87.5,Difficile,Moyen,1,Plus Facile que la Prediction,Pas Adapte
604,2015,Mathematique,1,Le Calcul d'Integral,6,Quelques Exemples en Maple,5,605,2,QCM,0.43,0.44,61.0,27,17,44,39,27,12,1.13,69.23,Facile,Moyen,-1,Plus Difficile que la Prediction,Adapte
1670,2016,Mathematique,1,Le Calcul d'Integral,6,Quelques Exemples en Maple,5,605,2,QCM,0.23,0.6,61.0,29,18,47,40,29,11,1.18,72.5,Moyen,Moyen,0,Meme Difficulte que la Prediction,Adapte
2736,2017,Mathematique,1,Le Calcul d'Integral,6,Quelques Exemples en Maple,5,605,2,QCU,0.25,0.72,61.0,26,17,43,38,26,12,1.13,68.42,Moyen,Moyen,0,Meme Difficulte que la Prediction,Adapte
3802,2018,Mathematique,1,Le Calcul d'Integral,6,Quelques Exemples en Maple,5,605,2,QCU,0.39,0.56,61.0,27,17,44,38,27,11,1.16,71.05,Moyen,Moyen,0,Meme Difficulte que la Prediction,Adapte
4868,2019,Mathematique,1,Le Calcul d'Integral,6,Quelques Exemples en Maple,5,605,2,QCU,0.21,0.72,61.0,24,15,39,29,24,5,1.34,82.76,Moyen,Moyen,0,Meme Difficulte que la Prediction,Adapte
5934,2020,Mathematique,1,Le Calcul d'Integral,6,Quelques Exemples en Maple,5,605,2,QCU,0.33,0.52,61.0,26,16,42,26,26,0,1.62,100.0,Moyen,Moyen,0,Meme Difficulte que la Prediction,Adapte
605,2015,Mathematique,1,Le Calcul d'Integral,6,Quelques Exemples en Maple,5,606,3,QCU,0.73,0.22,7.0,7,90,97,37,7,30,2.62,18.92,Difficile,Difficile,0,Meme Difficulte que la Prediction,Pas Adapte
1671,2016,Mathematique,1,Le Calcul d'Integral,6,Quelques Exemples en Maple,5,606,3,QCU,0.25,0.73,38.0,34,56,90,47,34,13,1.91,72.34,Moyen,Moyen,0,Meme Difficulte que la Prediction,Pas Adapte
2737,2017,Mathematique,1,Le Calcul d'Integral,6,Quelques Exemples en Maple,5,606,3,QCM,0.26,0.42,56.0,57,44,101,80,57,23,1.26,71.25,Difficile,Moyen,1,Plus Facile que la Prediction,Pas Adapte
3803,2018,Mathematique,1,Le Calcul d'Integral,6,Quelques Exemples en Maple,5,606,3,QCM,0.53,0.26,13.0,11,77,88,31,11,20,2.84,35.48,Facile,Difficile,-2,Beaucoup plus Difficile que la Prediction,Pas Adapte
4869,2019,Mathematique,1,Le Calcul d'Integral,6,Quelques Exemples en Maple,5,606,3,QCM,0.5,0.38,36.0,33,58,91,71,33,38,1.28,46.48,Moyen,Moyen,0,Meme Difficulte que la Prediction,Pas Adapte
5935,2020,Mathematique,1,Le Calcul d'Integral,6,Quelques Exemples en Maple,5,606,3,QCM,0.35,0.43,44.0,46,59,105,62,46,16,1.69,74.19,Moyen,Moyen,0,Meme Difficulte que la Prediction,Pas Adapte
606,2015,Mathematique,1,Le Calcul d'Integral,6,Quelques Exemples en Maple,5,607,4,QCU,0.6,0.32,9.0,9,87,96,50,9,41,1.92,18.0,Facile,Difficile,-2,Beaucoup plus Difficile que la Prediction,Pas Adapte
1672,2016,Mathematique,1,Le Calcul d'Integral,6,Quelques Exemples en Maple,5,607,4,QCU,0.73,0.31,6.0,5,83,88,36,5,31,2.44,13.89,Facile,Difficile,-2,Beaucoup plus Difficile que la Prediction,Pas Adapte
2738,2017,Mathematique,1,Le Calcul d'Integral,6,Quelques Exemples en Maple,5,607,4,QCU,0.22,0.7,60.0,50,34,84,67,50,17,1.25,74.63,Moyen,Moyen,0,Meme Difficulte que la Prediction,Adapte
3804,2018,Mathematique,1,Le Calcul d'Integral,6,Quelques Exemples en Maple,5,607,4,QCU,0.29,0.72,60.0,58,39,97,74,58,16,1.31,78.38,Moyen,Moyen,0,Meme Difficulte que la Prediction,Adapte
4870,2019,Mathematique,1,Le Calcul d'Integral,6,Quelques Exemples en Maple,5,607,4,QCU,0.31,0.47,60.0,52,35,87,61,52,9,1.43,85.25,Moyen,Moyen,0,Meme Difficulte que la Prediction,Adapte
5936,2020,Mathematique,1,Le Calcul d'Integral,6,Quelques Exemples en Maple,5,607,4,QCU,0.33,0.41,60.0,46,30,76,53,46,7,1.43,86.79,Moyen,Moyen,0,Meme Difficulte que la Prediction,Adapte
607,2015,Mathematique,1,Le Calcul d'Integral,6,Quelques Exemples en Maple,5,608,5,QCM,0.63,0.16,35.0,29,55,84,39,29,10,2.15,74.36,Facile,Difficile,-2,Beaucoup plus Difficile que la Prediction,Pas Adapte
1673,2016,Mathematique,1,Le Calcul d'Integral,6,Quelques Exemples en Maple,5,608,5,QCM,0.51,0.28,11.0,8,66,74,29,8,21,2.55,27.59,Difficile,Difficile,0,Meme Difficulte que la Prediction,Pas Adapte
2739,2017,Mathematique,1,Le Calcul d'Integral,6,Quelques Exemples en Maple,5,608,5,QCM,0.34,0.69,42.0,34,47,81,49,34,15,1.65,69.39,Moyen,Moyen,0,Meme Difficulte que la Prediction,Pas Adapte
3805,2018,Mathematique,1,Le Calcul d'Integral,6,Quelques Exemples en Maple,5,608,5,QCM,0.68,0.17,25.0,23,69,92,34,23,11,2.71,67.65,Difficile,Difficile,0,Meme Difficulte que la Prediction,Pas Adapte
4871,2019,Mathematique,1,Le Calcul d'Integral,6,Quelques Exemples en Maple,5,608,5,QROC,0.9,0.12,7.0,6,80,86,60,6,54,1.43,10.0,Difficile,Difficile,0,Meme Difficulte que la Prediction,Pas Adapte
5937,2020,Mathematique,1,Le Calcul d'Integral,6,Quelques Exemples en Maple,5,608,5,QROC,0.48,0.31,41.0,36,51,87,86,36,50,1.01,41.86,Facile,Moyen,-1,Plus Difficile que la Prediction,Pas Adapte
608,2015,Mathematique,1,La Derivation,1,Derivee en un Point,9,609,1,QCU,0.53,0.25,28.0,5,14,19,12,5,7,1.58,41.67,Moyen,Difficile,-1,Plus Difficile que la Prediction,Pas Adapte
1674,2016,Mathematique,1,La Derivation,1,Derivee en un Point,9,609,1,QCU,0.66,0.28,1.0,0,22,22,22,0,22,1.0,0.0,Facile,Difficile,-2,Beaucoup plus Difficile que la Prediction,Pas Adapte
2740,2017,Mathematique,1,La Derivation,1,Derivee en un Point,9,609,1,QCU,0.26,0.7,62.0,14,8,22,19,14,5,1.16,73.68,Moyen,Moyen,0,Meme Difficulte que la Prediction,Adapte
3806,2018,Mathematique,1,La Derivation,1,Derivee en un Point,9,609,1,QCU,0.24,0.49,62.0,15,9,24,23,15,8,1.04,65.22,Moyen,Moyen,0,Meme Difficulte que la Prediction,Adapte
4872,2019,Mathematique,1,La Derivation,1,Derivee en un Point,9,609,1,QCU,0.36,0.48,62.0,15,9,24,18,15,3,1.33,83.33,Moyen,Moyen,0,Meme Difficulte que la Prediction,Adapte
5938,2020,Mathematique,1,La Derivation,1,Derivee en un Point,9,609,1,QCM,0.37,0.7,62.0,17,11,28,26,17,9,1.08,65.38,Moyen,Moyen,0,Meme Difficulte que la Prediction,Adapte
609,2015,Mathematique,1,La Derivation,1,Derivee en un Point,9,610,2,QCM,0.73,0.19,16.0,5,27,32,28,5,23,1.14,17.86,Moyen,Difficile,-1,Plus Difficile que la Prediction,Pas Adapte
1675,2016,Mathematique,1,La Derivation,1,Derivee en un Point,9,610,2,QCU,0.67,0.21,4.0,1,33,34,23,1,22,1.48,4.35,Moyen,Difficile,-1,Plus Difficile que la Prediction,Pas Adapte
2741,2017,Mathematique,1,La Derivation,1,Derivee en un Point,9,610,2,QCU,0.56,0.33,33.0,12,23,35,24,12,12,1.46,50.0,Facile,Difficile,-2,Beaucoup plus Difficile que la Prediction,Pas Adapte
3807,2018,Mathematique,1,La Derivation,1,Derivee en un Point,9,610,2,QCU,0.52,0.31,18.0,6,30,36,21,6,15,1.71,28.57,Facile,Difficile,-2,Beaucoup plus Difficile que la Prediction,Pas Adapte
4873,2019,Mathematique,1,La Derivation,1,Derivee en un Point,9,610,2,QCU,0.04,0.98,69.0,24,11,35,35,24,11,1.0,68.57,Facile,Facile,0,Meme Difficulte que la Prediction,Adapte
5939,2020,Mathematique,1,La Derivation,1,Derivee en un Point,9,610,2,QCU,0.09,0.83,69.0,21,9,30,21,21,0,1.43,100.0,Facile,Facile,0,Meme Difficulte que la Prediction,Adapte
610,2015,Mathematique,1,La Derivation,1,Derivee en un Point,9,611,3,QROC,0.79,0.2,4.0,3,78,81,47,3,44,1.72,6.38,Facile,Difficile,-2,Beaucoup plus Difficile que la Prediction,Pas Adapte
1676,2016,Mathematique,1,La Derivation,1,Derivee en un Point,9,611,3,QROC,0.68,0.08,31.0,23,50,73,71,23,48,1.03,32.39,Moyen,Difficile,-1,Plus Difficile que la Prediction,Pas Adapte
2742,2017,Mathematique,1,La Derivation,1,Derivee en un Point,9,611,3,QROC,0.77,0.07,2.0,1,66,67,29,1,28,2.31,3.45,Difficile,Difficile,0,Meme Difficulte que la Prediction,Pas Adapte
3808,2018,Mathematique,1,La Derivation,1,Derivee en un Point,9,611,3,QO,0.88,0.03,31.0,24,52,76,53,24,29,1.43,45.28,Difficile,Difficile,0,Meme Difficulte que la Prediction,Pas Adapte
4874,2019,Mathematique,1,La Derivation,1,Derivee en un Point,9,611,3,QO,0.9,0.0,7.0,5,60,65,42,5,37,1.55,11.9,Moyen,Difficile,-1,Plus Difficile que la Prediction,Pas Adapte
5940,2020,Mathematique,1,La Derivation,1,Derivee en un Point,9,611,3,QO,0.77,0.12,19.0,11,47,58,44,11,33,1.32,25.0,Moyen,Difficile,-1,Plus Difficile que la Prediction,Pas Adapte
611,2015,Mathematique,1,La Derivation,1,Derivee en un Point,9,612,4,QROC,0.95,0.12,2.0,0,17,17,12,0,12,1.42,0.0,Facile,Difficile,-2,Beaucoup plus Difficile que la Prediction,Pas Adapte
1677,2016,Mathematique,1,La Derivation,1,Derivee en un Point,9,612,4,QROC,0.79,0.01,22.0,3,12,15,6,3,3,2.5,50.0,Moyen,Difficile,-1,Plus Difficile que la Prediction,Pas Adapte
2743,2017,Mathematique,1,La Derivation,1,Derivee en un Point,9,612,4,QROC,0.44,0.27,41.0,7,9,16,12,7,5,1.33,58.33,Facile,Moyen,-1,Plus Difficile que la Prediction,Pas Adapte
3809,2018,Mathematique,1,La Derivation,1,Derivee en un Point,9,612,4,QROC,0.98,0.06,31.0,5,11,16,15,5,10,1.07,33.33,Difficile,Difficile,0,Meme Difficulte que la Prediction,Pas Adapte
4875,2019,Mathematique,1,La Derivation,1,Derivee en un Point,9,612,4,QCM,0.55,0.26,29.0,4,10,14,11,4,7,1.27,36.36,Difficile,Difficile,0,Meme Difficulte que la Prediction,Pas Adapte
5941,2020,Mathematique,1,La Derivation,1,Derivee en un Point,9,612,4,QCM,0.44,0.4,56.0,7,6,13,8,7,1,1.62,87.5,Moyen,Moyen,0,Meme Difficulte que la Prediction,Pas Adapte
612,2015,Mathematique,1,La Derivation,1,Derivee en un Point,9,613,5,QROC,0.79,0.1,11.0,9,73,82,46,9,37,1.78,19.57,Facile,Difficile,-2,Beaucoup plus Difficile que la Prediction,Pas Adapte
1678,2016,Mathematique,1,La Derivation,1,Derivee en un Point,9,613,5,QO,0.95,0.09,29.0,26,62,88,52,26,26,1.69,50.0,Facile,Difficile,-2,Beaucoup plus Difficile que la Prediction,Pas Adapte
2744,2017,Mathematique,1,La Derivation,1,Derivee en un Point,9,613,5,QO,0.82,0.09,7.0,6,85,91,86,6,80,1.06,6.98,Difficile,Difficile,0,Meme Difficulte que la Prediction,Pas Adapte
3810,2018,Mathematique,1,La Derivation,1,Derivee en un Point,9,613,5,QO,0.77,0.06,13.0,10,70,80,77,10,67,1.04,12.99,Facile,Difficile,-2,Beaucoup plus Difficile que la Prediction,Pas Adapte
4876,2019,Mathematique,1,La Derivation,1,Derivee en un Point,9,613,5,QO,0.96,0.06,23.0,18,59,77,44,18,26,1.75,40.91,Difficile,Difficile,0,Meme Difficulte que la Prediction,Pas Adapte
5942,2020,Mathematique,1,La Derivation,1,Derivee en un Point,9,613,5,QO,0.42,0.17,48.0,37,40,77,56,37,19,1.38,66.07,Moyen,Moyen,0,Meme Difficulte que la Prediction,Pas Adapte
613,2015,Mathematique,1,La Derivation,1,Derivee en un Point,9,614,6,QCM,0.48,0.58,38.0,23,37,60,47,23,24,1.28,48.94,Difficile,Moyen,1,Plus Facile que la Prediction,Pas Adapte
1679,2016,Mathematique,1,La Derivation,1,Derivee en un Point,9,614,6,QCM,0.59,0.2,8.0,4,50,54,38,4,34,1.42,10.53,Facile,Difficile,-2,Beaucoup plus Difficile que la Prediction,Pas Adapte
2745,2017,Mathematique,1,La Derivation,1,Derivee en un Point,9,614,6,QCM,0.76,0.21,4.0,2,44,46,19,2,17,2.42,10.53,Difficile,Difficile,0,Meme Difficulte que la Prediction,Pas Adapte
3811,2018,Mathematique,1,La Derivation,1,Derivee en un Point,9,614,6,QCM,0.15,0.78,67.0,33,16,49,34,33,1,1.44,97.06,Facile,Facile,0,Meme Difficulte que la Prediction,Adapte
4877,2019,Mathematique,1,La Derivation,1,Derivee en un Point,9,614,6,QCM,0.08,0.99,67.0,31,15,46,43,31,12,1.07,72.09,Facile,Facile,0,Meme Difficulte que la Prediction,Adapte
5943,2020,Mathematique,1,La Derivation,1,Derivee en un Point,9,614,6,QCM,0.17,0.9,67.0,28,14,42,29,28,1,1.45,96.55,Facile,Facile,0,Meme Difficulte que la Prediction,Adapte
614,2015,Mathematique,1,La Derivation,1,Derivee en un Point,9,615,7,QCU,0.35,0.45,59.0,57,40,97,74,57,17,1.31,77.03,Facile,Moyen,-1,Plus Difficile que la Prediction,Pas Adapte
1680,2016,Mathematique,1,La Derivation,1,Derivee en un Point,9,615,7,QCU,0.25,0.55,50.0,48,47,95,94,48,46,1.01,51.06,Difficile,Moyen,1,Plus Facile que la Prediction,Pas Adapte
2746,2017,Mathematique,1,La Derivation,1,Derivee en un Point,9,615,7,QCU,0.23,0.49,43.0,45,59,104,46,45,1,2.26,97.83,Moyen,Moyen,0,Meme Difficulte que la Prediction,Pas Adapte
3812,2018,Mathematique,1,La Derivation,1,Derivee en un Point,9,615,7,QO,0.8,0.15,14.0,13,82,95,82,13,69,1.16,15.85,Facile,Difficile,-2,Beaucoup plus Difficile que la Prediction,Pas Adapte
4878,2019,Mathematique,1,La Derivation,1,Derivee en un Point,9,615,7,QROC,0.34,0.36,37.0,37,63,100,63,37,26,1.59,58.73,Difficile,Moyen,1,Plus Facile que la Prediction,Pas Adapte
5944,2020,Mathematique,1,La Derivation,1,Derivee en un Point,9,615,7,QROC,0.72,0.2,34.0,29,57,86,67,29,38,1.28,43.28,Facile,Difficile,-2,Beaucoup plus Difficile que la Prediction,Pas Adapte
615,2015,Mathematique,1,La Derivation,1,Derivee en un Point,9,616,8,QCU,0.4,0.63,56.0,10,8,18,15,10,5,1.2,66.67,Difficile,Moyen,1,Plus Facile que la Prediction,Pas Adapte
1681,2016,Mathematique,1,La Derivation,1,Derivee en un Point,9,616,8,QCU,0.47,0.36,2.0,0,21,21,11,0,11,1.91,0.0,Moyen,Difficile,-1,Plus Difficile que la Prediction,Pas Adapte
2747,2017,Mathematique,1,La Derivation,1,Derivee en un Point,9,616,8,QCU,0.29,0.62,64.0,14,8,22,19,14,5,1.16,73.68,Facile,Moyen,-1,Plus Difficile que la Prediction,Adapte
3813,2018,Mathematique,1,La Derivation,1,Derivee en un Point,9,616,8,QCU,0.29,0.53,64.0,14,8,22,20,14,6,1.1,70.0,Moyen,Moyen,0,Meme Difficulte que la Prediction,Adapte
4879,2019,Mathematique,1,La Derivation,1,Derivee en un Point,9,616,8,QCU,0.4,0.72,64.0,13,7,20,16,13,3,1.25,81.25,Moyen,Moyen,0,Meme Difficulte que la Prediction,Adapte
5945,2020,Mathematique,1,La Derivation,1,Derivee en un Point,9,616,8,QCU,0.23,0.7,64.0,13,7,20,20,13,7,1.0,65.0,Moyen,Moyen,0,Meme Difficulte que la Prediction,Adapte
616,2015,Mathematique,1,La Derivation,1,Derivee en un Point,9,617,9,QCU,0.28,0.63,39.0,7,12,19,11,7,4,1.73,63.64,Facile,Moyen,-1,Plus Difficile que la Prediction,Pas Adapte
1682,2016,Mathematique,1,La Derivation,1,Derivee en un Point,9,617,9,QCU,0.68,0.21,23.0,5,16,21,8,5,3,2.62,62.5,Difficile,Difficile,0,Meme Difficulte que la Prediction,Pas Adapte
2748,2017,Mathematique,1,La Derivation,1,Derivee en un Point,9,617,9,QCU,0.38,0.49,38.0,7,11,18,10,7,3,1.8,70.0,Difficile,Moyen,1,Plus Facile que la Prediction,Pas Adapte
3814,2018,Mathematique,1,La Derivation,1,Derivee en un Point,9,617,9,QCU,0.32,0.47,55.0,8,7,15,11,8,3,1.36,72.73,Facile,Moyen,-1,Plus Difficile que la Prediction,Pas Adapte
4880,2019,Mathematique,1,La Derivation,1,Derivee en un Point,9,617,9,QCU,0.25,0.64,62.0,9,5,14,10,9,1,1.4,90.0,Facile,Moyen,-1,Plus Difficile que la Prediction,Adapte
5946,2020,Mathematique,1,La Derivation,1,Derivee en un Point,9,617,9,QCU,0.25,0.6,62.0,9,5,14,10,9,1,1.4,90.0,Moyen,Moyen,0,Meme Difficulte que la Prediction,Adapte
617,2015,Mathematique,1,La Derivation,2,Derivee Globale,10,618,1,QCM,0.1,0.82,66.0,30,16,46,40,30,10,1.15,75.0,Moyen,Facile,1,Plus Facile que la Prediction,Adapte
1683,2016,Mathematique,1,La Derivation,2,Derivee Globale,10,618,1,QCU,0.06,1.0,66.0,33,17,50,37,33,4,1.35,89.19,Facile,Facile,0,Meme Difficulte que la Prediction,Adapte
2749,2017,Mathematique,1,La Derivation,2,Derivee Globale,10,618,1,QCM,0.05,0.94,66.0,32,16,48,43,32,11,1.12,74.42,Facile,Facile,0,Meme Difficulte que la Prediction,Adapte
3815,2018,Mathematique,1,La Derivation,2,Derivee Globale,10,618,1,QCM,0.18,0.97,66.0,33,17,50,36,33,3,1.39,91.67,Facile,Facile,0,Meme Difficulte que la Prediction,Adapte
4881,2019,Mathematique,1,La Derivation,2,Derivee Globale,10,618,1,QCM,0.18,0.97,66.0,28,14,42,40,28,12,1.05,70.0,Facile,Facile,0,Meme Difficulte que la Prediction,Adapte
5947,2020,Mathematique,1,La Derivation,2,Derivee Globale,10,618,1,QCM,0.04,0.81,66.0,25,13,38,34,25,9,1.12,73.53,Facile,Facile,0,Meme Difficulte que la Prediction,Adapte
618,2015,Mathematique,1,La Derivation,2,Derivee Globale,10,619,2,QCU,0.29,0.55,63.0,16,10,26,18,16,2,1.44,88.89,Moyen,Moyen,0,Meme Difficulte que la Prediction,Adapte
1684,2016,Mathematique,1,La Derivation,2,Derivee Globale,10,619,2,QCU,0.21,0.6,63.0,18,10,28,27,18,9,1.04,66.67,Moyen,Moyen,0,Meme Difficulte que la Prediction,Adapte
2750,2017,Mathematique,1,La Derivation,2,Derivee Globale,10,619,2,QCU,0.34,0.68,63.0,20,11,31,26,20,6,1.19,76.92,Moyen,Moyen,0,Meme Difficulte que la Prediction,Adapte
3816,2018,Mathematique,1,La Derivation,2,Derivee Globale,10,619,2,QCU,0.29,0.42,63.0,21,12,33,31,21,10,1.06,67.74,Moyen,Moyen,0,Meme Difficulte que la Prediction,Adapte
4882,2019,Mathematique,1,La Derivation,2,Derivee Globale,10,619,2,QCM,0.35,0.33,63.0,18,10,28,21,18,3,1.33,85.71,Moyen,Moyen,0,Meme Difficulte que la Prediction,Adapte
5948,2020,Mathematique,1,La Derivation,2,Derivee Globale,10,619,2,QCM,0.49,0.34,63.0,18,11,29,26,18,8,1.12,69.23,Moyen,Moyen,0,Meme Difficulte que la Prediction,Adapte
619,2015,Mathematique,1,La Derivation,2,Derivee Globale,10,620,3,QCM,0.48,0.39,64.0,53,30,83,71,53,18,1.17,74.65,Moyen,Moyen,0,Meme Difficulte que la Prediction,Adapte
1685,2016,Mathematique,1,La Derivation,2,Derivee Globale,10,620,3,QCM,0.22,0.57,64.0,60,34,94,76,60,16,1.24,78.95,Moyen,Moyen,0,Meme Difficulte que la Prediction,Adapte
2751,2017,Mathematique,1,La Derivation,2,Derivee Globale,10,620,3,QCM,0.47,0.38,64.0,56,31,87,70,56,14,1.24,80.0,Moyen,Moyen,0,Meme Difficulte que la Prediction,Adapte
3817,2018,Mathematique,1,La Derivation,2,Derivee Globale,10,620,3,QCM,0.36,0.44,64.0,56,31,87,70,56,14,1.24,80.0,Moyen,Moyen,0,Meme Difficulte que la Prediction,Adapte
4883,2019,Mathematique,1,La Derivation,2,Derivee Globale,10,620,3,QCM,0.34,0.6,64.0,49,28,77,55,49,6,1.4,89.09,Moyen,Moyen,0,Meme Difficulte que la Prediction,Adapte
5949,2020,Mathematique,1,La Derivation,2,Derivee Globale,10,620,3,QCM,0.47,0.53,64.0,45,25,70,66,45,21,1.06,68.18,Moyen,Moyen,0,Meme Difficulte que la Prediction,Adapte
620,2015,Mathematique,1,La Derivation,2,Derivee Globale,10,621,4,QROC,0.96,0.11,28.0,8,21,29,15,8,7,1.93,53.33,Difficile,Difficile,0,Meme Difficulte que la Prediction,Pas Adapte
1686,2016,Mathematique,1,La Derivation,2,Derivee Globale,10,621,4,QROC,0.3,0.27,40.0,10,16,26,19,10,9,1.37,52.63,Facile,Moyen,-1,Plus Difficile que la Prediction,Pas Adapte
2752,2017,Mathematique,1,La Derivation,2,Derivee Globale,10,621,4,QROC,0.98,0.04,31.0,9,20,29,12,9,3,2.42,75.0,Difficile,Difficile,0,Meme Difficulte que la Prediction,Pas Adapte
3818,2018,Mathematique,1,La Derivation,2,Derivee Globale,10,621,4,QROC,0.92,0.17,26.0,8,21,29,22,8,14,1.32,36.36,Moyen,Difficile,-1,Plus Difficile que la Prediction,Pas Adapte
4884,2019,Mathematique,1,La Derivation,2,Derivee Globale,10,621,4,QROC,0.57,0.32,48.0,16,17,33,31,16,15,1.06,51.61,Difficile,Moyen,1,Plus Facile que la Prediction,Pas Adapte
5950,2020,Mathematique,1,La Derivation,2,Derivee Globale,10,621,4,QO,0.85,0.06,1.0,0,38,38,29,0,29,1.31,0.0,Facile,Difficile,-2,Beaucoup plus Difficile que la Prediction,Pas Adapte
621,2015,Mathematique,1,La Derivation,2,Derivee Globale,10,622,5,QROC,0.73,0.24,14.0,1,8,9,6,1,5,1.5,16.67,Moyen,Difficile,-1,Plus Difficile que la Prediction,Pas Adapte
1687,2016,Mathematique,1,La Derivation,2,Derivee Globale,10,622,5,QROC,0.74,0.17,1.0,0,9,9,4,0,4,2.25,0.0,Facile,Difficile,-2,Beaucoup plus Difficile que la Prediction,Pas Adapte
2753,2017,Mathematique,1,La Derivation,2,Derivee Globale,10,622,5,QROC,0.84,0.15,8.0,1,8,9,4,1,3,2.25,25.0,Facile,Difficile,-2,Beaucoup plus Difficile que la Prediction,Pas Adapte
3819,2018,Mathematique,1,La Derivation,2,Derivee Globale,10,622,5,QROC,0.68,0.19,1.0,0,10,10,5,0,5,2.0,0.0,Moyen,Difficile,-1,Plus Difficile que la Prediction,Pas Adapte
4885,2019,Mathematique,1,La Derivation,2,Derivee Globale,10,622,5,QROC,0.79,0.15,16.0,2,9,11,7,2,5,1.57,28.57,Moyen,Difficile,-1,Plus Difficile que la Prediction,Pas Adapte
5951,2020,Mathematique,1,La Derivation,2,Derivee Globale,10,622,5,QROC,0.45,0.37,45.0,6,7,13,10,6,4,1.3,60.0,Moyen,Moyen,0,Meme Difficulte que la Prediction,Pas Adapte
622,2015,Mathematique,1,La Derivation,2,Derivee Globale,10,623,6,QCU,0.44,0.36,20.0,8,33,41,39,8,31,1.05,20.51,Moyen,Difficile,-1,Plus Difficile que la Prediction,Pas Adapte
1688,2016,Mathematique,1,La Derivation,2,Derivee Globale,10,623,6,QCU,0.55,0.33,19.0,8,33,41,17,8,9,2.41,47.06,Facile,Difficile,-2,Beaucoup plus Difficile que la Prediction,Pas Adapte
2754,2017,Mathematique,1,La Derivation,2,Derivee Globale,10,623,6,QCU,0.0,0.78,67.0,27,14,41,39,27,12,1.05,69.23,Moyen,Facile,1,Plus Facile que la Prediction,Adapte
3820,2018,Mathematique,1,La Derivation,2,Derivee Globale,10,623,6,QO,0.15,0.5,67.0,26,13,39,27,26,1,1.44,96.3,Facile,Facile,0,Meme Difficulte que la Prediction,Adapte
4886,2019,Mathematique,1,La Derivation,2,Derivee Globale,10,623,6,QO,0.01,0.8,67.0,30,15,45,39,30,9,1.15,76.92,Facile,Facile,0,Meme Difficulte que la Prediction,Adapte
5952,2020,Mathematique,1,La Derivation,2,Derivee Globale,10,623,6,QCU,0.13,0.87,67.0,34,16,50,49,34,15,1.02,69.39,Facile,Facile,0,Meme Difficulte que la Prediction,Adapte
623,2015,Mathematique,1,La Derivation,2,Derivee Globale,10,624,7,QCM,0.57,0.25,3.0,1,42,43,40,1,39,1.07,2.5,Facile,Difficile,-2,Beaucoup plus Difficile que la Prediction,Pas Adapte
1689,2016,Mathematique,1,La Derivation,2,Derivee Globale,10,624,7,QCM,0.22,0.32,61.0,24,16,40,25,24,1,1.6,96.0,Difficile,Moyen,1,Plus Facile que la Prediction,Adapte
2755,2017,Mathematique,1,La Derivation,2,Derivee Globale,10,624,7,QROC,0.2,0.36,61.0,21,14,35,31,21,10,1.13,67.74,Moyen,Moyen,0,Meme Difficulte que la Prediction,Adapte
3821,2018,Mathematique,1,La Derivation,2,Derivee Globale,10,624,7,QROC,0.24,0.25,61.0,21,14,35,22,21,1,1.59,95.45,Moyen,Moyen,0,Meme Difficulte que la Prediction,Adapte
4887,2019,Mathematique,1,La Derivation,2,Derivee Globale,10,624,7,QROC,0.51,0.38,61.0,24,16,40,37,24,13,1.08,64.86,Moyen,Moyen,0,Meme Difficulte que la Prediction,Adapte
5953,2020,Mathematique,1,La Derivation,2,Derivee Globale,10,624,7,QROC,0.42,0.27,61.0,21,13,34,27,21,6,1.26,77.78,Moyen,Moyen,0,Meme Difficulte que la Prediction,Adapte
624,2015,Mathematique,1,La Derivation,2,Derivee Globale,10,625,8,QCU,0.5,0.37,14.0,9,57,66,47,9,38,1.4,19.15,Facile,Difficile,-2,Beaucoup plus Difficile que la Prediction,Pas Adapte
1690,2016,Mathematique,1,La Derivation,2,Derivee Globale,10,625,8,QROC,0.29,0.26,53.0,33,30,63,50,33,17,1.26,66.0,Difficile,Moyen,1,Plus Facile que la Prediction,Pas Adapte
2756,2017,Mathematique,1,La Derivation,2,Derivee Globale,10,625,8,QO,0.84,0.09,23.0,15,49,64,35,15,20,1.83,42.86,Difficile,Difficile,0,Meme Difficulte que la Prediction,Pas Adapte
3822,2018,Mathematique,1,La Derivation,2,Derivee Globale,10,625,8,QO,0.38,0.22,55.0,36,29,65,38,36,2,1.71,94.74,Moyen,Moyen,0,Meme Difficulte que la Prediction,Pas Adapte
4888,2019,Mathematique,1,La Derivation,2,Derivee Globale,10,625,8,QO,0.88,0.12,15.0,10,58,68,47,10,37,1.45,21.28,Facile,Difficile,-2,Beaucoup plus Difficile que la Prediction,Pas Adapte
5954,2020,Mathematique,1,La Derivation,2,Derivee Globale,10,625,8,QO,0.52,0.3,36.0,23,40,63,37,23,14,1.7,62.16,Moyen,Moyen,0,Meme Difficulte que la Prediction,Pas Adapte
625,2015,Mathematique,1,La Derivation,2,Derivee Globale,10,626,9,QCU,0.42,0.39,22.0,2,8,10,9,2,7,1.11,22.22,Facile,Difficile,-2,Beaucoup plus Difficile que la Prediction,Pas Adapte
1691,2016,Mathematique,1,La Derivation,2,Derivee Globale,10,626,9,QROC,0.82,0.04,21.0,3,9,12,6,3,3,2.0,50.0,Difficile,Difficile,0,Meme Difficulte que la Prediction,Pas Adapte
2757,2017,Mathematique,1,La Derivation,2,Derivee Globale,10,626,9,QROC,0.52,0.39,45.0,5,7,12,6,5,1,2.0,83.33,Difficile,Moyen,1,Plus Facile que la Prediction,Pas Adapte
3823,2018,Mathematique,1,La Derivation,2,Derivee Globale,10,626,9,QROC,0.83,0.1,7.0,1,11,12,7,1,6,1.71,14.29,Difficile,Difficile,0,Meme Difficulte que la Prediction,Pas Adapte
4889,2019,Mathematique,1,La Derivation,2,Derivee Globale,10,626,9,QO,0.34,0.2,61.0,7,4,11,11,7,4,1.0,63.64,Difficile,Moyen,1,Plus Facile que la Prediction,Adapte
5955,2020,Mathematique,1,La Derivation,2,Derivee Globale,10,626,9,QO,0.43,0.29,61.0,6,4,10,6,6,0,1.67,100.0,Moyen,Moyen,0,Meme Difficulte que la Prediction,Adapte
626,2015,Mathematique,1,La Derivation,2,Derivee Globale,10,627,10,QCU,0.34,0.6,62.0,43,27,70,52,43,9,1.35,82.69,Facile,Moyen,-1,Plus Difficile que la Prediction,Adapte
1692,2016,Mathematique,1,La Derivation,2,Derivee Globale,10,627,10,QCU,0.2,0.67,62.0,39,24,63,40,39,1,1.57,97.5,Moyen,Moyen,0,Meme Difficulte que la Prediction,Adapte
2758,2017,Mathematique,1,La Derivation,2,Derivee Globale,10,627,10,QCU,0.23,0.66,62.0,33,21,54,34,33,1,1.59,97.06,Moyen,Moyen,0,Meme Difficulte que la Prediction,Adapte
3824,2018,Mathematique,1,La Derivation,2,Derivee Globale,10,627,10,QCU,0.34,0.56,62.0,33,20,53,39,33,6,1.36,84.62,Moyen,Moyen,0,Meme Difficulte que la Prediction,Adapte
4890,2019,Mathematique,1,La Derivation,2,Derivee Globale,10,627,10,QCU,0.21,0.57,62.0,31,19,50,45,31,14,1.11,68.89,Moyen,Moyen,0,Meme Difficulte que la Prediction,Adapte
5956,2020,Mathematique,1,La Derivation,2,Derivee Globale,10,627,10,QCU,0.25,0.51,62.0,29,17,46,43,29,14,1.07,67.44,Moyen,Moyen,0,Meme Difficulte que la Prediction,Adapte
627,2015,Mathematique,1,La Derivation,3,Theroeme de Rolle et des Accroissements Finis,9,628,1,QO,0.9,0.06,15.0,10,59,69,54,10,44,1.28,18.52,Difficile,Difficile,0,Meme Difficulte que la Prediction,Pas Adapte
1693,2016,Mathematique,1,La Derivation,3,Theroeme de Rolle et des Accroissements Finis,9,628,1,QO,0.94,0.02,31.0,24,52,76,50,24,26,1.52,48.0,Difficile,Difficile,0,Meme Difficulte que la Prediction,Pas Adapte
2759,2017,Mathematique,1,La Derivation,3,Theroeme de Rolle et des Accroissements Finis,9,628,1,QO,0.85,0.1,9.0,7,67,74,57,7,50,1.3,12.28,Moyen,Difficile,-1,Plus Difficile que la Prediction,Pas Adapte
3825,2018,Mathematique,1,La Derivation,3,Theroeme de Rolle et des Accroissements Finis,9,628,1,QO,0.93,0.1,10.0,8,69,77,62,8,54,1.24,12.9,Difficile,Difficile,0,Meme Difficulte que la Prediction,Pas Adapte
4891,2019,Mathematique,1,La Derivation,3,Theroeme de Rolle et des Accroissements Finis,9,628,1,QO,0.88,0.07,15.0,12,71,83,51,12,39,1.63,23.53,Facile,Difficile,-2,Beaucoup plus Difficile que la Prediction,Pas Adapte
5957,2020,Mathematique,1,La Derivation,3,Theroeme de Rolle et des Accroissements Finis,9,628,1,QO,0.8,0.01,8.0,7,77,84,68,7,61,1.24,10.29,Difficile,Difficile,0,Meme Difficulte que la Prediction,Pas Adapte
628,2015,Mathematique,1,La Derivation,3,Theroeme de Rolle et des Accroissements Finis,9,629,2,QCU,0.41,0.38,20.0,14,55,69,67,14,53,1.03,20.9,Difficile,Difficile,0,Meme Difficulte que la Prediction,Pas Adapte
1694,2016,Mathematique,1,La Derivation,3,Theroeme de Rolle et des Accroissements Finis,9,629,2,QCU,0.4,0.5,49.0,31,32,63,55,31,24,1.15,56.36,Moyen,Moyen,0,Meme Difficulte que la Prediction,Pas Adapte
2760,2017,Mathematique,1,La Derivation,3,Theroeme de Rolle et des Accroissements Finis,9,629,2,QCU,0.7,0.29,23.0,14,49,63,29,14,15,2.17,48.28,Difficile,Difficile,0,Meme Difficulte que la Prediction,Pas Adapte
3826,2018,Mathematique,1,La Derivation,3,Theroeme de Rolle et des Accroissements Finis,9,629,2,QCU,0.45,0.21,35.0,19,36,55,30,19,11,1.83,63.33,Moyen,Difficile,-1,Plus Difficile que la Prediction,Pas Adapte
4892,2019,Mathematique,1,La Derivation,3,Theroeme de Rolle et des Accroissements Finis,9,629,2,QCU,0.5,0.23,27.0,14,38,52,27,14,13,1.93,51.85,Moyen,Difficile,-1,Plus Difficile que la Prediction,Pas Adapte
5958,2020,Mathematique,1,La Derivation,3,Theroeme de Rolle et des Accroissements Finis,9,629,2,QCU,0.4,0.41,43.0,19,26,45,31,19,12,1.45,61.29,Facile,Moyen,-1,Plus Difficile que la Prediction,Pas Adapte
629,2015,Mathematique,1,La Derivation,3,Theroeme de Rolle et des Accroissements Finis,9,630,3,QCM,0.26,0.36,49.0,14,14,28,19,14,5,1.47,73.68,Difficile,Moyen,1,Plus Facile que la Prediction,Pas Adapte
1695,2016,Mathematique,1,La Derivation,3,Theroeme de Rolle et des Accroissements Finis,9,630,3,QCU,0.36,0.74,36.0,10,17,27,26,10,16,1.04,38.46,Difficile,Moyen,1,Plus Facile que la Prediction,Pas Adapte
2761,2017,Mathematique,1,La Derivation,3,Theroeme de Rolle et des Accroissements Finis,9,630,3,QCU,0.26,0.53,49.0,14,15,29,27,14,13,1.07,51.85,Difficile,Moyen,1,Plus Facile que la Prediction,Pas Adapte
3827,2018,Mathematique,1,La Derivation,3,Theroeme de Rolle et des Accroissements Finis,9,630,3,QCU,0.68,0.35,11.0,3,22,25,16,3,13,1.56,18.75,Difficile,Difficile,0,Meme Difficulte que la Prediction,Pas Adapte
4893,2019,Mathematique,1,La Derivation,3,Theroeme de Rolle et des Accroissements Finis,9,630,3,QCU,0.28,0.6,38.0,10,16,26,16,10,6,1.62,62.5,Difficile,Moyen,1,Plus Facile que la Prediction,Pas Adapte
5959,2020,Mathematique,1,La Derivation,3,Theroeme de Rolle et des Accroissements Finis,9,630,3,QCU,0.71,0.26,25.0,7,21,28,14,7,7,2.0,50.0,Moyen,Difficile,-1,Plus Difficile que la Prediction,Pas Adapte
630,2015,Mathematique,1,La Derivation,3,Theroeme de Rolle et des Accroissements Finis,9,631,4,QCM,0.3,0.56,53.0,47,41,88,68,47,21,1.29,69.12,Moyen,Moyen,0,Meme Difficulte que la Prediction,Pas Adapte
1696,2016,Mathematique,1,La Derivation,3,Theroeme de Rolle et des Accroissements Finis,9,631,4,QCM,0.26,0.33,38.0,29,47,76,68,29,39,1.12,42.65,Moyen,Moyen,0,Meme Difficulte que la Prediction,Pas Adapte
2762,2017,Mathematique,1,La Derivation,3,Theroeme de Rolle et des Accroissements Finis,9,631,4,QCM,0.47,0.46,55.0,45,36,81,61,45,16,1.33,73.77,Moyen,Moyen,0,Meme Difficulte que la Prediction,Pas Adapte
3828,2018,Mathematique,1,La Derivation,3,Theroeme de Rolle et des Accroissements Finis,9,631,4,QCM,0.49,0.62,57.0,43,33,76,59,43,16,1.29,72.88,Difficile,Moyen,1,Plus Facile que la Prediction,Pas Adapte
4894,2019,Mathematique,1,La Derivation,3,Theroeme de Rolle et des Accroissements Finis,9,631,4,QCM,0.42,0.67,56.0,48,38,86,79,48,31,1.09,60.76,Facile,Moyen,-1,Plus Difficile que la Prediction,Pas Adapte
5960,2020,Mathematique,1,La Derivation,3,Theroeme de Rolle et des Accroissements Finis,9,631,4,QCM,0.72,0.15,5.0,4,85,89,54,4,50,1.65,7.41,Moyen,Difficile,-1,Plus Difficile que la Prediction,Pas Adapte
631,2015,Mathematique,1,La Derivation,3,Theroeme de Rolle et des Accroissements Finis,9,632,5,QCU,0.59,0.27,10.0,6,56,62,48,6,42,1.29,12.5,Moyen,Difficile,-1,Plus Difficile que la Prediction,Pas Adapte
1697,2016,Mathematique,1,La Derivation,3,Theroeme de Rolle et des Accroissements Finis,9,632,5,QCU,0.22,0.42,50.0,30,30,60,31,30,1,1.94,96.77,Moyen,Moyen,0,Meme Difficulte que la Prediction,Pas Adapte
2763,2017,Mathematique,1,La Derivation,3,Theroeme de Rolle et des Accroissements Finis,9,632,5,QROC,0.57,0.38,61.0,40,26,66,43,40,3,1.53,93.02,Facile,Moyen,-1,Plus Difficile que la Prediction,Adapte
3829,2018,Mathematique,1,La Derivation,3,Theroeme de Rolle et des Accroissements Finis,9,632,5,QROC,0.36,0.34,61.0,45,29,74,59,45,14,1.25,76.27,Moyen,Moyen,0,Meme Difficulte que la Prediction,Adapte
4895,2019,Mathematique,1,La Derivation,3,Theroeme de Rolle et des Accroissements Finis,9,632,5,QROC,0.41,0.4,61.0,41,26,67,45,41,4,1.49,91.11,Moyen,Moyen,0,Meme Difficulte que la Prediction,Adapte
5961,2020,Mathematique,1,La Derivation,3,Theroeme de Rolle et des Accroissements Finis,9,632,5,QROC,0.38,0.31,61.0,35,22,57,36,35,1,1.58,97.22,Moyen,Moyen,0,Meme Difficulte que la Prediction,Adapte
632,2015,Mathematique,1,La Derivation,3,Theroeme de Rolle et des Accroissements Finis,9,633,6,QCM,0.54,0.19,21.0,18,67,85,22,18,4,3.86,81.82,Moyen,Difficile,-1,Plus Difficile que la Prediction,Pas Adapte
1698,2016,Mathematique,1,La Derivation,3,Theroeme de Rolle et des Accroissements Finis,9,633,6,QCM,0.19,0.81,66.0,50,25,75,60,50,10,1.25,83.33,Facile,Facile,0,Meme Difficulte que la Prediction,Adapte
2764,2017,Mathematique,1,La Derivation,3,Theroeme de Rolle et des Accroissements Finis,9,633,6,QCM,0.03,0.84,66.0,51,26,77,52,51,1,1.48,98.08,Facile,Facile,0,Meme Difficulte que la Prediction,Adapte
3830,2018,Mathematique,1,La Derivation,3,Theroeme de Rolle et des Accroissements Finis,9,633,6,QCM,0.03,0.84,66.0,57,29,86,63,57,6,1.37,90.48,Facile,Facile,0,Meme Difficulte que la Prediction,Adapte
4896,2019,Mathematique,1,La Derivation,3,Theroeme de Rolle et des Accroissements Finis,9,633,6,QCM,0.17,0.88,66.0,63,33,96,96,63,33,1.0,65.62,Facile,Facile,0,Meme Difficulte que la Prediction,Adapte
5962,2020,Mathematique,1,La Derivation,3,Theroeme de Rolle et des Accroissements Finis,9,633,6,QCM,0.04,0.88,66.0,69,35,104,82,69,13,1.27,84.15,Facile,Facile,0,Meme Difficulte que la Prediction,Adapte
633,2015,Mathematique,1,La Derivation,3,Theroeme de Rolle et des Accroissements Finis,9,634,7,QCU,0.37,0.5,57.0,14,11,25,23,14,9,1.09,60.87,Facile,Moyen,-1,Plus Difficile que la Prediction,Pas Adapte
1699,2016,Mathematique,1,La Derivation,3,Theroeme de Rolle et des Accroissements Finis,9,634,7,QCU,0.51,0.36,29.0,8,18,26,18,8,10,1.44,44.44,Difficile,Difficile,0,Meme Difficulte que la Prediction,Pas Adapte
2765,2017,Mathematique,1,La Derivation,3,Theroeme de Rolle et des Accroissements Finis,9,634,7,QCU,0.73,0.25,25.0,6,19,25,22,6,16,1.14,27.27,Difficile,Difficile,0,Meme Difficulte que la Prediction,Pas Adapte
3831,2018,Mathematique,1,La Derivation,3,Theroeme de Rolle et des Accroissements Finis,9,634,7,QCU,0.31,0.66,48.0,12,14,26,15,12,3,1.73,80.0,Facile,Moyen,-1,Plus Difficile que la Prediction,Pas Adapte
4897,2019,Mathematique,1,La Derivation,3,Theroeme de Rolle et des Accroissements Finis,9,634,7,QCU,0.62,0.24,18.0,5,24,29,24,5,19,1.21,20.83,Difficile,Difficile,0,Meme Difficulte que la Prediction,Pas Adapte
5963,2020,Mathematique,1,La Derivation,3,Theroeme de Rolle et des Accroissements Finis,9,634,7,QCU,0.12,0.8,68.0,20,10,30,25,20,5,1.2,80.0,Difficile,Facile,2,Beaucoup plus Facile que la Prediction,Adapte
634,2015,Mathematique,1,La Derivation,3,Theroeme de Rolle et des Accroissements Finis,9,635,8,QCM,0.07,0.94,66.0,51,27,78,75,51,24,1.04,68.0,Moyen,Facile,1,Plus Facile que la Prediction,Adapte
1700,2016,Mathematique,1,La Derivation,3,Theroeme de Rolle et des Accroissements Finis,9,635,8,QCM,0.2,0.99,66.0,50,25,75,61,50,11,1.23,81.97,Facile,Facile,0,Meme Difficulte que la Prediction,Adapte
2766,2017,Mathematique,1,La Derivation,3,Theroeme de Rolle et des Accroissements Finis,9,635,8,QCM,0.07,0.78,66.0,55,28,83,56,55,1,1.48,98.21,Facile,Facile,0,Meme Difficulte que la Prediction,Adapte
3832,2018,Mathematique,1,La Derivation,3,Theroeme de Rolle et des Accroissements Finis,9,635,8,QCM,0.02,0.84,66.0,55,29,84,69,55,14,1.22,79.71,Facile,Facile,0,Meme Difficulte que la Prediction,Adapte
4898,2019,Mathematique,1,La Derivation,3,Theroeme de Rolle et des Accroissements Finis,9,635,8,QCM,0.13,0.82,66.0,50,26,76,64,50,14,1.19,78.12,Facile,Facile,0,Meme Difficulte que la Prediction,Adapte
5964,2020,Mathematique,1,La Derivation,3,Theroeme de Rolle et des Accroissements Finis,9,635,8,QCM,0.01,0.97,66.0,57,30,87,57,57,0,1.53,100.0,Facile,Facile,0,Meme Difficulte que la Prediction,Adapte
635,2015,Mathematique,1,La Derivation,3,Theroeme de Rolle et des Accroissements Finis,9,636,9,QCM,0.7,0.16,11.0,10,77,87,28,10,18,3.11,35.71,Facile,Difficile,-2,Beaucoup plus Difficile que la Prediction,Pas Adapte
1701,2016,Mathematique,1,La Derivation,3,Theroeme de Rolle et des Accroissements Finis,9,636,9,QCU,0.03,0.96,67.0,56,28,84,76,56,20,1.11,73.68,Facile,Facile,0,Meme Difficulte que la Prediction,Adapte
2767,2017,Mathematique,1,La Derivation,3,Theroeme de Rolle et des Accroissements Finis,9,636,9,QCU,0.04,0.84,67.0,52,25,77,55,52,3,1.4,94.55,Facile,Facile,0,Meme Difficulte que la Prediction,Adapte
3833,2018,Mathematique,1,La Derivation,3,Theroeme de Rolle et des Accroissements Finis,9,636,9,QCM,0.07,0.94,67.0,46,22,68,49,46,3,1.39,93.88,Facile,Facile,0,Meme Difficulte que la Prediction,Adapte
4899,2019,Mathematique,1,La Derivation,3,Theroeme de Rolle et des Accroissements Finis,9,636,9,QCM,0.16,0.87,67.0,46,23,69,59,46,13,1.17,77.97,Facile,Facile,0,Meme Difficulte que la Prediction,Adapte
5965,2020,Mathematique,1,La Derivation,3,Theroeme de Rolle et des Accroissements Finis,9,636,9,QCM,0.15,0.73,67.0,49,24,73,73,49,24,1.0,67.12,Facile,Facile,0,Meme Difficulte que la Prediction,Adapte
636,2015,Mathematique,1,La Derivation,4,La Fonction Exponentielle Complexe,7,637,1,QCU,0.27,0.55,52.0,52,48,100,95,52,43,1.05,54.74,Facile,Moyen,-1,Plus Difficile que la Prediction,Pas Adapte
1702,2016,Mathematique,1,La Derivation,4,La Fonction Exponentielle Complexe,7,637,1,QCU,0.54,0.24,25.0,24,74,98,61,24,37,1.61,39.34,Difficile,Difficile,0,Meme Difficulte que la Prediction,Pas Adapte
2768,2017,Mathematique,1,La Derivation,4,La Fonction Exponentielle Complexe,7,637,1,QCU,0.03,0.97,69.0,64,29,93,69,64,5,1.35,92.75,Facile,Facile,0,Meme Difficulte que la Prediction,Adapte
3834,2018,Mathematique,1,La Derivation,4,La Fonction Exponentielle Complexe,7,637,1,QCU,0.01,0.76,69.0,63,28,91,82,63,19,1.11,76.83,Facile,Facile,0,Meme Difficulte que la Prediction,Adapte
4900,2019,Mathematique,1,La Derivation,4,La Fonction Exponentielle Complexe,7,637,1,QCU,0.19,0.9,69.0,59,27,86,66,59,7,1.3,89.39,Facile,Facile,0,Meme Difficulte que la Prediction,Adapte
5966,2020,Mathematique,1,La Derivation,4,La Fonction Exponentielle Complexe,7,637,1,QROC,0.09,0.92,69.0,68,30,98,84,68,16,1.17,80.95,Facile,Facile,0,Meme Difficulte que la Prediction,Adapte
637,2015,Mathematique,1,La Derivation,4,La Fonction Exponentielle Complexe,7,638,2,QCU,0.69,0.25,10.0,6,51,57,49,6,43,1.16,12.24,Moyen,Difficile,-1,Plus Difficile que la Prediction,Pas Adapte
1703,2016,Mathematique,1,La Derivation,4,La Fonction Exponentielle Complexe,7,638,2,QCU,0.2,0.4,57.0,37,28,65,50,37,13,1.3,74.0,Facile,Moyen,-1,Plus Difficile que la Prediction,Pas Adapte
2769,2017,Mathematique,1,La Derivation,4,La Fonction Exponentielle Complexe,7,638,2,QCU,0.33,0.46,51.0,31,30,61,41,31,10,1.49,75.61,Moyen,Moyen,0,Meme Difficulte que la Prediction,Pas Adapte
3835,2018,Mathematique,1,La Derivation,4,La Fonction Exponentielle Complexe,7,638,2,QCU,0.26,0.7,60.0,34,22,56,52,34,18,1.08,65.38,Moyen,Moyen,0,Meme Difficulte que la Prediction,Adapte
4901,2019,Mathematique,1,La Derivation,4,La Fonction Exponentielle Complexe,7,638,2,QCM,0.43,0.31,60.0,35,24,59,50,35,15,1.18,70.0,Moyen,Moyen,0,Meme Difficulte que la Prediction,Adapte
5967,2020,Mathematique,1,La Derivation,4,La Fonction Exponentielle Complexe,7,638,2,QCM,0.32,0.56,60.0,37,25,62,38,37,1,1.63,97.37,Moyen,Moyen,0,Meme Difficulte que la Prediction,Adapte
638,2015,Mathematique,1,La Derivation,4,La Fonction Exponentielle Complexe,7,639,3,QCU,0.67,0.24,1.0,0,37,37,30,0,30,1.23,0.0,Facile,Difficile,-2,Beaucoup plus Difficile que la Prediction,Pas Adapte
1704,2016,Mathematique,1,La Derivation,4,La Fonction Exponentielle Complexe,7,639,3,QCU,0.72,0.33,10.0,4,34,38,33,4,29,1.15,12.12,Difficile,Difficile,0,Meme Difficulte que la Prediction,Pas Adapte
2770,2017,Mathematique,1,La Derivation,4,La Fonction Exponentielle Complexe,7,639,3,QCU,0.28,0.43,58.0,22,16,38,31,22,9,1.23,70.97,Moyen,Moyen,0,Meme Difficulte que la Prediction,Pas Adapte
3836,2018,Mathematique,1,La Derivation,4,La Fonction Exponentielle Complexe,7,639,3,QCU,0.26,0.71,46.0,15,17,32,16,15,1,2.0,93.75,Facile,Moyen,-1,Plus Difficile que la Prediction,Pas Adapte
4902,2019,Mathematique,1,La Derivation,4,La Fonction Exponentielle Complexe,7,639,3,QCU,0.3,0.72,40.0,14,22,36,33,14,19,1.09,42.42,Difficile,Moyen,1,Plus Facile que la Prediction,Pas Adapte
5968,2020,Mathematique,1,La Derivation,4,La Fonction Exponentielle Complexe,7,639,3,QCU,0.39,0.61,59.0,24,16,40,34,24,10,1.18,70.59,Facile,Moyen,-1,Plus Difficile que la Prediction,Pas Adapte
639,2015,Mathematique,1,La Derivation,4,La Fonction Exponentielle Complexe,7,640,4,QCM,0.42,0.3,56.0,18,14,32,19,18,1,1.68,94.74,Moyen,Moyen,0,Meme Difficulte que la Prediction,Pas Adapte
1705,2016,Mathematique,1,La Derivation,4,La Fonction Exponentielle Complexe,7,640,4,QCU,0.21,0.7,53.0,19,17,36,27,19,8,1.33,70.37,Moyen,Moyen,0,Meme Difficulte que la Prediction,Pas Adapte
2771,2017,Mathematique,1,La Derivation,4,La Fonction Exponentielle Complexe,7,640,4,QCU,0.72,0.39,14.0,4,28,32,30,4,26,1.07,13.33,Facile,Difficile,-2,Beaucoup plus Difficile que la Prediction,Pas Adapte
3837,2018,Mathematique,1,La Derivation,4,La Fonction Exponentielle Complexe,7,640,4,QCM,0.27,0.35,49.0,17,18,35,30,17,13,1.17,56.67,Moyen,Moyen,0,Meme Difficulte que la Prediction,Pas Adapte
4903,2019,Mathematique,1,La Derivation,4,La Fonction Exponentielle Complexe,7,640,4,QCM,0.02,0.88,67.0,23,11,34,31,23,8,1.1,74.19,Facile,Facile,0,Meme Difficulte que la Prediction,Adapte
5969,2020,Mathematique,1,La Derivation,4,La Fonction Exponentielle Complexe,7,640,4,QCM,0.07,0.89,67.0,21,11,32,28,21,7,1.14,75.0,Facile,Facile,0,Meme Difficulte que la Prediction,Adapte
640,2015,Mathematique,1,La Derivation,4,La Fonction Exponentielle Complexe,7,641,5,QCM,0.26,0.67,60.0,13,9,22,17,13,4,1.29,76.47,Difficile,Moyen,1,Plus Facile que la Prediction,Adapte
1706,2016,Mathematique,1,La Derivation,4,La Fonction Exponentielle Complexe,7,641,5,QCM,0.36,0.65,60.0,12,8,20,19,12,7,1.05,63.16,Moyen,Moyen,0,Meme Difficulte que la Prediction,Adapte
2772,2017,Mathematique,1,La Derivation,4,La Fonction Exponentielle Complexe,7,641,5,QCM,0.28,0.38,60.0,14,9,23,14,14,0,1.64,100.0,Moyen,Moyen,0,Meme Difficulte que la Prediction,Adapte
3838,2018,Mathematique,1,La Derivation,4,La Fonction Exponentielle Complexe,7,641,5,QCM,0.22,0.68,60.0,14,10,24,20,14,6,1.2,70.0,Moyen,Moyen,0,Meme Difficulte que la Prediction,Adapte
4904,2019,Mathematique,1,La Derivation,4,La Fonction Exponentielle Complexe,7,641,5,QCM,0.29,0.69,60.0,13,9,22,15,13,2,1.47,86.67,Moyen,Moyen,0,Meme Difficulte que la Prediction,Adapte
5970,2020,Mathematique,1,La Derivation,4,La Fonction Exponentielle Complexe,7,641,5,QCM,0.23,0.46,60.0,13,8,21,17,13,4,1.24,76.47,Moyen,Moyen,0,Meme Difficulte que la Prediction,Adapte
641,2015,Mathematique,1,La Derivation,4,La Fonction Exponentielle Complexe,7,642,6,QROC,0.94,0.11,21.0,4,15,19,12,4,8,1.58,33.33,Moyen,Difficile,-1,Plus Difficile que la Prediction,Pas Adapte
1707,2016,Mathematique,1,La Derivation,4,La Fonction Exponentielle Complexe,7,642,6,QROC,0.13,0.8,68.0,13,6,19,14,13,1,1.36,92.86,Difficile,Facile,2,Beaucoup plus Facile que la Prediction,Adapte
2773,2017,Mathematique,1,La Derivation,4,La Fonction Exponentielle Complexe,7,642,6,QROC,0.17,0.75,68.0,15,7,22,20,15,5,1.1,75.0,Facile,Facile,0,Meme Difficulte que la Prediction,Adapte
3839,2018,Mathematique,1,La Derivation,4,La Fonction Exponentielle Complexe,7,642,6,QROC,0.16,0.67,68.0,17,8,25,21,17,4,1.19,80.95,Facile,Facile,0,Meme Difficulte que la Prediction,Adapte
4905,2019,Mathematique,1,La Derivation,4,La Fonction Exponentielle Complexe,7,642,6,QROC,0.12,0.84,68.0,16,7,23,21,16,5,1.1,76.19,Facile,Facile,0,Meme Difficulte que la Prediction,Adapte
5971,2020,Mathematique,1,La Derivation,4,La Fonction Exponentielle Complexe,7,642,6,QROC,0.13,0.41,68.0,16,8,24,20,16,4,1.2,80.0,Facile,Facile,0,Meme Difficulte que la Prediction,Adapte
642,2015,Mathematique,1,La Derivation,4,La Fonction Exponentielle Complexe,7,643,7,QCM,0.04,0.72,69.0,10,4,14,13,10,3,1.08,76.92,Difficile,Facile,2,Beaucoup plus Facile que la Prediction,Adapte
1708,2016,Mathematique,1,La Derivation,4,La Fonction Exponentielle Complexe,7,643,7,QCM,0.06,0.95,69.0,11,5,16,12,11,1,1.33,91.67,Facile,Facile,0,Meme Difficulte que la Prediction,Adapte
2774,2017,Mathematique,1,La Derivation,4,La Fonction Exponentielle Complexe,7,643,7,QCM,0.19,0.73,69.0,11,5,16,15,11,4,1.07,73.33,Facile,Facile,0,Meme Difficulte que la Prediction,Adapte
3840,2018,Mathematique,1,La Derivation,4,La Fonction Exponentielle Complexe,7,643,7,QCU,0.08,0.82,69.0,10,4,14,13,10,3,1.08,76.92,Facile,Facile,0,Meme Difficulte que la Prediction,Adapte
4906,2019,Mathematique,1,La Derivation,4,La Fonction Exponentielle Complexe,7,643,7,QCU,0.12,0.78,69.0,8,4,12,12,8,4,1.0,66.67,Facile,Facile,0,Meme Difficulte que la Prediction,Adapte
5972,2020,Mathematique,1,La Derivation,4,La Fonction Exponentielle Complexe,7,643,7,QCU,0.1,0.84,69.0,7,3,10,8,7,1,1.25,87.5,Facile,Facile,0,Meme Difficulte que la Prediction,Adapte
643,2015,Mathematique,1,La Derivation,5,Derivees d'Ordres Superieurs,8,644,1,QROC,0.03,0.81,69.0,23,11,34,33,23,10,1.03,69.7,Facile,Facile,0,Meme Difficulte que la Prediction,Adapte
1709,2016,Mathematique,1,La Derivation,5,Derivees d'Ordres Superieurs,8,644,1,QROC,0.01,0.92,69.0,23,11,34,31,23,8,1.1,74.19,Facile,Facile,0,Meme Difficulte que la Prediction,Adapte
2775,2017,Mathematique,1,La Derivation,5,Derivees d'Ordres Superieurs,8,644,1,QROC,0.01,0.9,69.0,21,10,31,29,21,8,1.07,72.41,Facile,Facile,0,Meme Difficulte que la Prediction,Adapte
3841,2018,Mathematique,1,La Derivation,5,Derivees d'Ordres Superieurs,8,644,1,QCM,0.1,0.88,69.0,18,8,26,24,18,6,1.08,75.0,Facile,Facile,0,Meme Difficulte que la Prediction,Adapte
4907,2019,Mathematique,1,La Derivation,5,Derivees d'Ordres Superieurs,8,644,1,QO,0.0,0.55,69.0,21,9,30,29,21,8,1.03,72.41,Facile,Facile,0,Meme Difficulte que la Prediction,Adapte
5973,2020,Mathematique,1,La Derivation,5,Derivees d'Ordres Superieurs,8,644,1,QO,0.12,0.31,69.0,23,10,33,32,23,9,1.03,71.88,Facile,Facile,0,Meme Difficulte que la Prediction,Adapte
644,2015,Mathematique,1,La Derivation,5,Derivees d'Ordres Superieurs,8,645,2,QROC,0.85,0.13,6.0,6,89,95,83,6,77,1.14,7.23,Difficile,Difficile,0,Meme Difficulte que la Prediction,Pas Adapte
1710,2016,Mathematique,1,La Derivation,5,Derivees d'Ordres Superieurs,8,645,2,QROC,0.03,0.6,69.0,75,33,108,97,75,22,1.11,77.32,Facile,Facile,0,Meme Difficulte que la Prediction,Adapte
2776,2017,Mathematique,1,La Derivation,5,Derivees d'Ordres Superieurs,8,645,2,QO,0.11,0.35,69.0,82,37,119,87,82,5,1.37,94.25,Facile,Facile,0,Meme Difficulte que la Prediction,Adapte
3842,2018,Mathematique,1,La Derivation,5,Derivees d'Ordres Superieurs,8,645,2,QROC,0.0,0.98,69.0,84,38,122,114,84,30,1.07,73.68,Facile,Facile,0,Meme Difficulte que la Prediction,Adapte
4908,2019,Mathematique,1,La Derivation,5,Derivees d'Ordres Superieurs,8,645,2,QROC,0.12,0.41,69.0,96,43,139,133,96,37,1.05,72.18,Facile,Facile,0,Meme Difficulte que la Prediction,Adapte
5974,2020,Mathematique,1,La Derivation,5,Derivees d'Ordres Superieurs,8,645,2,QROC,0.02,0.9,69.0,84,38,122,85,84,1,1.44,98.82,Facile,Facile,0,Meme Difficulte que la Prediction,Adapte
645,2015,Mathematique,1,La Derivation,5,Derivees d'Ordres Superieurs,8,646,3,QROC,0.2,0.84,66.0,8,4,12,11,8,3,1.09,72.73,Facile,Facile,0,Meme Difficulte que la Prediction,Adapte
1711,2016,Mathematique,1,La Derivation,5,Derivees d'Ordres Superieurs,8,646,3,QROC,0.05,0.71,66.0,9,4,13,12,9,3,1.08,75.0,Facile,Facile,0,Meme Difficulte que la Prediction,Adapte
2777,2017,Mathematique,1,La Derivation,5,Derivees d'Ordres Superieurs,8,646,3,QROC,0.13,0.76,66.0,9,4,13,10,9,1,1.3,90.0,Facile,Facile,0,Meme Difficulte que la Prediction,Adapte
3843,2018,Mathematique,1,La Derivation,5,Derivees d'Ordres Superieurs,8,646,3,QROC,0.01,0.77,66.0,8,4,12,10,8,2,1.2,80.0,Facile,Facile,0,Meme Difficulte que la Prediction,Adapte
4909,2019,Mathematique,1,La Derivation,5,Derivees d'Ordres Superieurs,8,646,3,QO,0.2,0.74,66.0,9,4,13,10,9,1,1.3,90.0,Facile,Facile,0,Meme Difficulte que la Prediction,Adapte
5975,2020,Mathematique,1,La Derivation,5,Derivees d'Ordres Superieurs,8,646,3,QO,0.1,0.53,66.0,10,5,15,14,10,4,1.07,71.43,Facile,Facile,0,Meme Difficulte que la Prediction,Adapte
646,2015,Mathematique,1,La Derivation,5,Derivees d'Ordres Superieurs,8,647,4,QROC,0.34,0.31,41.0,7,9,16,12,7,5,1.33,58.33,Moyen,Moyen,0,Meme Difficulte que la Prediction,Pas Adapte
1712,2016,Mathematique,1,La Derivation,5,Derivees d'Ordres Superieurs,8,647,4,QO,0.85,0.0,12.0,2,16,18,13,2,11,1.38,15.38,Difficile,Difficile,0,Meme Difficulte que la Prediction,Pas Adapte
2778,2017,Mathematique,1,La Derivation,5,Derivees d'Ordres Superieurs,8,647,4,QO,0.21,0.23,50.0,9,9,18,9,9,0,2.0,100.0,Difficile,Moyen,1,Plus Facile que la Prediction,Pas Adapte
3844,2018,Mathematique,1,La Derivation,5,Derivees d'Ordres Superieurs,8,647,4,QO,0.93,0.0,23.0,5,15,20,10,5,5,2.0,50.0,Difficile,Difficile,0,Meme Difficulte que la Prediction,Pas Adapte
4910,2019,Mathematique,1,La Derivation,5,Derivees d'Ordres Superieurs,8,647,4,QO,0.37,0.2,51.0,9,9,18,11,9,2,1.64,81.82,Difficile,Moyen,1,Plus Facile que la Prediction,Pas Adapte
5976,2020,Mathematique,1,La Derivation,5,Derivees d'Ordres Superieurs,8,647,4,QO,0.84,0.07,29.0,4,11,15,8,4,4,1.88,50.0,Moyen,Difficile,-1,Plus Difficile que la Prediction,Pas Adapte
647,2015,Mathematique,1,La Derivation,5,Derivees d'Ordres Superieurs,8,648,5,QCU,0.09,0.99,69.0,56,25,81,69,56,13,1.17,81.16,Difficile,Facile,2,Beaucoup plus Facile que la Prediction,Adapte
1713,2016,Mathematique,1,La Derivation,5,Derivees d'Ordres Superieurs,8,648,5,QCU,0.17,0.98,69.0,57,25,82,61,57,4,1.34,93.44,Facile,Facile,0,Meme Difficulte que la Prediction,Adapte
2779,2017,Mathematique,1,La Derivation,5,Derivees d'Ordres Superieurs,8,648,5,QCU,0.08,0.79,69.0,48,22,70,55,48,7,1.27,87.27,Facile,Facile,0,Meme Difficulte que la Prediction,Adapte
3845,2018,Mathematique,1,La Derivation,5,Derivees d'Ordres Superieurs,8,648,5,QROC,0.02,0.57,69.0,50,22,72,54,50,4,1.33,92.59,Facile,Facile,0,Meme Difficulte que la Prediction,Adapte
4911,2019,Mathematique,1,La Derivation,5,Derivees d'Ordres Superieurs,8,648,5,QROC,0.02,0.83,69.0,50,23,73,63,50,13,1.16,79.37,Facile,Facile,0,Meme Difficulte que la Prediction,Adapte
5977,2020,Mathematique,1,La Derivation,5,Derivees d'Ordres Superieurs,8,648,5,QROC,0.17,0.87,69.0,48,22,70,53,48,5,1.32,90.57,Facile,Facile,0,Meme Difficulte que la Prediction,Adapte
648,2015,Mathematique,1,La Derivation,5,Derivees d'Ordres Superieurs,8,649,6,QO,0.89,0.13,8.0,1,8,9,8,1,7,1.12,12.5,Difficile,Difficile,0,Meme Difficulte que la Prediction,Pas Adapte
1714,2016,Mathematique,1,La Derivation,5,Derivees d'Ordres Superieurs,8,649,6,QROC,0.3,0.31,50.0,5,5,10,7,5,2,1.43,71.43,Moyen,Moyen,0,Meme Difficulte que la Prediction,Pas Adapte
2780,2017,Mathematique,1,La Derivation,5,Derivees d'Ordres Superieurs,8,649,6,QROC,0.22,0.38,58.0,5,3,8,7,5,2,1.14,71.43,Facile,Moyen,-1,Plus Difficile que la Prediction,Pas Adapte
3846,2018,Mathematique,1,La Derivation,5,Derivees d'Ordres Superieurs,8,649,6,QROC,0.98,0.23,30.0,2,5,7,6,2,4,1.17,33.33,Facile,Difficile,-2,Beaucoup plus Difficile que la Prediction,Pas Adapte
4912,2019,Mathematique,1,La Derivation,5,Derivees d'Ordres Superieurs,8,649,6,QROC,0.26,0.29,44.0,4,4,8,7,4,3,1.14,57.14,Facile,Moyen,-1,Plus Difficile que la Prediction,Pas Adapte
5978,2020,Mathematique,1,La Derivation,5,Derivees d'Ordres Superieurs,8,649,6,QROC,0.43,0.31,53.0,4,4,8,5,4,1,1.6,80.0,Difficile,Moyen,1,Plus Facile que la Prediction,Pas Adapte
649,2015,Mathematique,1,La Derivation,5,Derivees d'Ordres Superieurs,8,650,7,QCU,0.28,0.56,53.0,11,10,21,11,11,0,1.91,100.0,Difficile,Moyen,1,Plus Facile que la Prediction,Pas Adapte
1715,2016,Mathematique,1,La Derivation,5,Derivees d'Ordres Superieurs,8,650,7,QCM,0.53,0.19,29.0,7,16,23,13,7,6,1.77,53.85,Facile,Difficile,-2,Beaucoup plus Difficile que la Prediction,Pas Adapte
2781,2017,Mathematique,1,La Derivation,5,Derivees d'Ordres Superieurs,8,650,7,QCM,0.26,0.58,62.0,16,10,26,17,16,1,1.53,94.12,Facile,Moyen,-1,Plus Difficile que la Prediction,Adapte
3847,2018,Mathematique,1,La Derivation,5,Derivees d'Ordres Superieurs,8,650,7,QCM,0.37,0.38,62.0,14,9,23,23,14,9,1.0,60.87,Moyen,Moyen,0,Meme Difficulte que la Prediction,Adapte
4913,2019,Mathematique,1,La Derivation,5,Derivees d'Ordres Superieurs,8,650,7,QCM,0.36,0.64,62.0,16,9,25,24,16,8,1.04,66.67,Moyen,Moyen,0,Meme Difficulte que la Prediction,Adapte
5979,2020,Mathematique,1,La Derivation,5,Derivees d'Ordres Superieurs,8,650,7,QCM,0.25,0.37,62.0,16,9,25,20,16,4,1.25,80.0,Moyen,Moyen,0,Meme Difficulte que la Prediction,Adapte
650,2015,Mathematique,1,La Derivation,5,Derivees d'Ordres Superieurs,8,651,8,QCM,0.34,0.39,47.0,45,50,95,85,45,40,1.12,52.94,Moyen,Moyen,0,Meme Difficulte que la Prediction,Pas Adapte
1716,2016,Mathematique,1,La Derivation,5,Derivees d'Ordres Superieurs,8,651,8,QCM,0.44,0.64,38.0,37,60,97,73,37,36,1.33,50.68,Facile,Moyen,-1,Plus Difficile que la Prediction,Pas Adapte
2782,2017,Mathematique,1,La Derivation,5,Derivees d'Ordres Superieurs,8,651,8,QCM,0.37,0.65,55.0,59,49,108,105,59,46,1.03,56.19,Difficile,Moyen,1,Plus Facile que la Prediction,Pas Adapte
3848,2018,Mathematique,1,La Derivation,5,Derivees d'Ordres Superieurs,8,651,8,QCM,0.22,0.45,42.0,43,59,102,95,43,52,1.07,45.26,Difficile,Moyen,1,Plus Facile que la Prediction,Pas Adapte
4914,2019,Mathematique,1,La Derivation,5,Derivees d'Ordres Superieurs,8,651,8,QCM,0.63,0.25,7.0,6,82,88,84,6,78,1.05,7.14,Moyen,Difficile,-1,Plus Difficile que la Prediction,Pas Adapte
5980,2020,Mathematique,1,La Derivation,5,Derivees d'Ordres Superieurs,8,651,8,QCM,0.8,0.26,33.0,27,54,81,31,27,4,2.61,87.1,Difficile,Difficile,0,Meme Difficulte que la Prediction,Pas Adapte
651,2015,Mathematique,1,La Derivation,6,Classe Cn par Morceaux,11,652,1,QCM,0.68,0.23,29.0,9,22,31,23,9,14,1.35,39.13,Facile,Difficile,-2,Beaucoup plus Difficile que la Prediction,Pas Adapte
1717,2016,Mathematique,1,La Derivation,6,Classe Cn par Morceaux,11,652,1,QCM,0.33,0.55,39.0,12,18,30,20,12,8,1.5,60.0,Moyen,Moyen,0,Meme Difficulte que la Prediction,Pas Adapte
2783,2017,Mathematique,1,La Derivation,6,Classe Cn par Morceaux,11,652,1,QCM,0.52,0.17,17.0,6,28,34,16,6,10,2.12,37.5,Difficile,Difficile,0,Meme Difficulte que la Prediction,Pas Adapte
3849,2018,Mathematique,1,La Derivation,6,Classe Cn par Morceaux,11,652,1,QCM,0.75,0.29,24.0,8,25,33,14,8,6,2.36,57.14,Moyen,Difficile,-1,Plus Difficile que la Prediction,Pas Adapte
4915,2019,Mathematique,1,La Derivation,6,Classe Cn par Morceaux,11,652,1,QCM,0.46,0.38,37.0,11,19,30,27,11,16,1.11,40.74,Difficile,Moyen,1,Plus Facile que la Prediction,Pas Adapte
5981,2020,Mathematique,1,La Derivation,6,Classe Cn par Morceaux,11,652,1,QCM,0.67,0.28,2.0,1,25,26,7,1,6,3.71,14.29,Difficile,Difficile,0,Meme Difficulte que la Prediction,Pas Adapte
652,2015,Mathematique,1,La Derivation,6,Classe Cn par Morceaux,11,653,2,QCM,0.76,0.27,29.0,18,44,62,49,18,31,1.27,36.73,Moyen,Difficile,-1,Plus Difficile que la Prediction,Pas Adapte
1718,2016,Mathematique,1,La Derivation,6,Classe Cn par Morceaux,11,653,2,QCM,0.56,0.2,17.0,12,57,69,46,12,34,1.5,26.09,Difficile,Difficile,0,Meme Difficulte que la Prediction,Pas Adapte
2784,2017,Mathematique,1,La Derivation,6,Classe Cn par Morceaux,11,653,2,QCM,0.78,0.28,6.0,4,60,64,45,4,41,1.42,8.89,Moyen,Difficile,-1,Plus Difficile que la Prediction,Pas Adapte
3850,2018,Mathematique,1,La Derivation,6,Classe Cn par Morceaux,11,653,2,QCM,0.55,0.19,3.0,2,60,62,27,2,25,2.3,7.41,Moyen,Difficile,-1,Plus Difficile que la Prediction,Pas Adapte
4916,2019,Mathematique,1,La Derivation,6,Classe Cn par Morceaux,11,653,2,QCM,0.2,0.39,55.0,30,25,55,41,30,11,1.34,73.17,Moyen,Moyen,0,Meme Difficulte que la Prediction,Pas Adapte
5982,2020,Mathematique,1,La Derivation,6,Classe Cn par Morceaux,11,653,2,QCM,0.16,0.98,67.0,38,19,57,46,38,8,1.24,82.61,Facile,Facile,0,Meme Difficulte que la Prediction,Adapte
653,2015,Mathematique,1,La Derivation,6,Classe Cn par Morceaux,11,654,3,QCM,0.34,0.54,47.0,30,33,63,54,30,24,1.17,55.56,Facile,Moyen,-1,Plus Difficile que la Prediction,Pas Adapte
1719,2016,Mathematique,1,La Derivation,6,Classe Cn par Morceaux,11,654,3,QO,0.52,0.27,57.0,38,29,67,56,38,18,1.2,67.86,Facile,Moyen,-1,Plus Difficile que la Prediction,Pas Adapte
2785,2017,Mathematique,1,La Derivation,6,Classe Cn par Morceaux,11,654,3,QO,0.74,0.26,49.0,37,39,76,51,37,14,1.49,72.55,Difficile,Moyen,1,Plus Facile que la Prediction,Pas Adapte
3851,2018,Mathematique,1,La Derivation,6,Classe Cn par Morceaux,11,654,3,QO,0.81,0.11,33.0,22,45,67,50,22,28,1.34,44.0,Moyen,Difficile,-1,Plus Difficile que la Prediction,Pas Adapte
4917,2019,Mathematique,1,La Derivation,6,Classe Cn par Morceaux,11,654,3,QO,0.78,0.13,15.0,10,59,69,57,10,47,1.21,17.54,Moyen,Difficile,-1,Plus Difficile que la Prediction,Pas Adapte
5983,2020,Mathematique,1,La Derivation,6,Classe Cn par Morceaux,11,654,3,QO,0.57,0.18,51.0,39,38,77,75,39,36,1.03,52.0,Difficile,Moyen,1,Plus Facile que la Prediction,Pas Adapte
654,2015,Mathematique,1,La Derivation,6,Classe Cn par Morceaux,11,655,4,QCM,0.36,0.34,39.0,31,49,80,50,31,19,1.6,62.0,Moyen,Moyen,0,Meme Difficulte que la Prediction,Pas Adapte
1720,2016,Mathematique,1,La Derivation,6,Classe Cn par Morceaux,11,655,4,QCM,0.75,0.29,4.0,3,73,76,44,3,41,1.73,6.82,Moyen,Difficile,-1,Plus Difficile que la Prediction,Pas Adapte
2786,2017,Mathematique,1,La Derivation,6,Classe Cn par Morceaux,11,655,4,QCM,0.46,0.56,41.0,32,45,77,65,32,33,1.18,49.23,Difficile,Moyen,1,Plus Facile que la Prediction,Pas Adapte
3852,2018,Mathematique,1,La Derivation,6,Classe Cn par Morceaux,11,655,4,QCU,0.3,0.64,47.0,31,34,65,43,31,12,1.51,72.09,Facile,Moyen,-1,Plus Difficile que la Prediction,Pas Adapte
4918,2019,Mathematique,1,La Derivation,6,Classe Cn par Morceaux,11,655,4,QCU,0.25,0.41,41.0,27,40,67,63,27,36,1.06,42.86,Difficile,Moyen,1,Plus Facile que la Prediction,Pas Adapte
5984,2020,Mathematique,1,La Derivation,6,Classe Cn par Morceaux,11,655,4,QCU,0.48,0.36,24.0,18,58,76,72,18,54,1.06,25.0,Difficile,Difficile,0,Meme Difficulte que la Prediction,Pas Adapte
655,2015,Mathematique,1,La Derivation,6,Classe Cn par Morceaux,11,656,5,QCM,0.27,0.53,51.0,21,20,41,28,21,7,1.46,75.0,Facile,Moyen,-1,Plus Difficile que la Prediction,Pas Adapte
1721,2016,Mathematique,1,La Derivation,6,Classe Cn par Morceaux,11,656,5,QCM,0.47,0.68,50.0,22,22,44,42,22,20,1.05,52.38,Moyen,Moyen,0,Meme Difficulte que la Prediction,Pas Adapte
2787,2017,Mathematique,1,La Derivation,6,Classe Cn par Morceaux,11,656,5,QCM,0.76,0.26,29.0,14,34,48,24,14,10,2.0,58.33,Facile,Difficile,-2,Beaucoup plus Difficile que la Prediction,Pas Adapte
3853,2018,Mathematique,1,La Derivation,6,Classe Cn par Morceaux,11,656,5,QCM,0.48,0.37,57.0,30,23,53,38,30,8,1.39,78.95,Difficile,Moyen,1,Plus Facile que la Prediction,Pas Adapte
4919,2019,Mathematique,1,La Derivation,6,Classe Cn par Morceaux,11,656,5,QCM,0.58,0.2,1.0,1,60,61,36,1,35,1.69,2.78,Moyen,Difficile,-1,Plus Difficile que la Prediction,Pas Adapte
5985,2020,Mathematique,1,La Derivation,6,Classe Cn par Morceaux,11,656,5,QCM,0.16,0.77,68.0,41,20,61,45,41,4,1.36,91.11,Facile,Facile,0,Meme Difficulte que la Prediction,Adapte
656,2015,Mathematique,1,La Derivation,6,Classe Cn par Morceaux,11,657,6,QCU,0.16,0.91,66.0,38,19,57,44,38,6,1.3,86.36,Facile,Facile,0,Meme Difficulte que la Prediction,Adapte
1722,2016,Mathematique,1,La Derivation,6,Classe Cn par Morceaux,11,657,6,QCU,0.06,0.86,66.0,33,17,50,45,33,12,1.11,73.33,Facile,Facile,0,Meme Difficulte que la Prediction,Adapte
2788,2017,Mathematique,1,La Derivation,6,Classe Cn par Morceaux,11,657,6,QCU,0.14,0.77,66.0,38,19,57,38,38,0,1.5,100.0,Facile,Facile,0,Meme Difficulte que la Prediction,Adapte
3854,2018,Mathematique,1,La Derivation,6,Classe Cn par Morceaux,11,657,6,QCU,0.1,1.0,66.0,34,18,52,44,34,10,1.18,77.27,Facile,Facile,0,Meme Difficulte que la Prediction,Adapte
4920,2019,Mathematique,1,La Derivation,6,Classe Cn par Morceaux,11,657,6,QCU,0.2,0.82,66.0,32,16,48,45,32,13,1.07,71.11,Facile,Facile,0,Meme Difficulte que la Prediction,Adapte
5986,2020,Mathematique,1,La Derivation,6,Classe Cn par Morceaux,11,657,6,QCU,0.16,0.78,66.0,29,15,44,29,29,0,1.52,100.0,Facile,Facile,0,Meme Difficulte que la Prediction,Adapte
657,2015,Mathematique,1,La Derivation,6,Classe Cn par Morceaux,11,658,7,QCM,0.26,0.5,47.0,33,37,70,45,33,12,1.56,73.33,Facile,Moyen,-1,Plus Difficile que la Prediction,Pas Adapte
1723,2016,Mathematique,1,La Derivation,6,Classe Cn par Morceaux,11,658,7,QCM,0.78,0.16,21.0,17,62,79,20,17,3,3.95,85.0,Difficile,Difficile,0,Meme Difficulte que la Prediction,Pas Adapte
2789,2017,Mathematique,1,La Derivation,6,Classe Cn par Morceaux,11,658,7,QCM,0.2,0.55,62.0,56,35,91,78,56,22,1.17,71.79,Facile,Moyen,-1,Plus Difficile que la Prediction,Adapte
3855,2018,Mathematique,1,La Derivation,6,Classe Cn par Morceaux,11,658,7,QCM,0.41,0.59,62.0,51,31,82,58,51,7,1.41,87.93,Moyen,Moyen,0,Meme Difficulte que la Prediction,Adapte
4921,2019,Mathematique,1,La Derivation,6,Classe Cn par Morceaux,11,658,7,QCM,0.46,0.51,62.0,55,34,89,82,55,27,1.09,67.07,Moyen,Moyen,0,Meme Difficulte que la Prediction,Adapte
5987,2020,Mathematique,1,La Derivation,6,Classe Cn par Morceaux,11,658,7,QCM,0.26,0.37,62.0,62,38,100,89,62,27,1.12,69.66,Moyen,Moyen,0,Meme Difficulte que la Prediction,Adapte
658,2015,Mathematique,1,La Derivation,6,Classe Cn par Morceaux,11,659,8,QCU,0.37,0.64,45.0,35,42,77,63,35,28,1.22,55.56,Difficile,Moyen,1,Plus Facile que la Prediction,Pas Adapte
1724,2016,Mathematique,1,La Derivation,6,Classe Cn par Morceaux,11,659,8,QCU,0.37,0.62,41.0,30,44,74,40,30,10,1.85,75.0,Difficile,Moyen,1,Plus Facile que la Prediction,Pas Adapte
2790,2017,Mathematique,1,La Derivation,6,Classe Cn par Morceaux,11,659,8,QCU,0.24,0.65,62.0,43,27,70,64,43,21,1.09,67.19,Moyen,Moyen,0,Meme Difficulte que la Prediction,Adapte
3856,2018,Mathematique,1,La Derivation,6,Classe Cn par Morceaux,11,659,8,QCU,0.25,0.58,62.0,46,29,75,68,46,22,1.1,67.65,Moyen,Moyen,0,Meme Difficulte que la Prediction,Adapte
4922,2019,Mathematique,1,La Derivation,6,Classe Cn par Morceaux,11,659,8,QCU,0.24,0.54,62.0,45,27,72,65,45,20,1.11,69.23,Moyen,Moyen,0,Meme Difficulte que la Prediction,Adapte
5988,2020,Mathematique,1,La Derivation,6,Classe Cn par Morceaux,11,659,8,QCU,0.4,0.41,62.0,44,27,71,70,44,26,1.01,62.86,Moyen,Moyen,0,Meme Difficulte que la Prediction,Adapte
659,2015,Mathematique,1,La Derivation,6,Classe Cn par Morceaux,11,660,9,QCM,0.62,0.24,16.0,5,24,29,13,5,8,2.23,38.46,Moyen,Difficile,-1,Plus Difficile que la Prediction,Pas Adapte
1725,2016,Mathematique,1,La Derivation,6,Classe Cn par Morceaux,11,660,9,QCM,0.02,0.85,66.0,18,9,27,25,18,7,1.08,72.0,Difficile,Facile,2,Beaucoup plus Facile que la Prediction,Adapte
2791,2017,Mathematique,1,La Derivation,6,Classe Cn par Morceaux,11,660,9,QCM,0.1,0.83,66.0,15,8,23,23,15,8,1.0,65.22,Facile,Facile,0,Meme Difficulte que la Prediction,Adapte
3857,2018,Mathematique,1,La Derivation,6,Classe Cn par Morceaux,11,660,9,QCM,0.01,0.9,66.0,15,7,22,16,15,1,1.38,93.75,Facile,Facile,0,Meme Difficulte que la Prediction,Adapte
4923,2019,Mathematique,1,La Derivation,6,Classe Cn par Morceaux,11,660,9,QCM,0.05,0.82,66.0,15,8,23,23,15,8,1.0,65.22,Facile,Facile,0,Meme Difficulte que la Prediction,Adapte
5989,2020,Mathematique,1,La Derivation,6,Classe Cn par Morceaux,11,660,9,QCM,0.02,0.95,66.0,15,8,23,19,15,4,1.21,78.95,Facile,Facile,0,Meme Difficulte que la Prediction,Adapte
660,2015,Mathematique,1,La Derivation,6,Classe Cn par Morceaux,11,661,10,QCU,0.36,0.41,41.0,5,7,12,8,5,3,1.5,62.5,Facile,Moyen,-1,Plus Difficile que la Prediction,Pas Adapte
1726,2016,Mathematique,1,La Derivation,6,Classe Cn par Morceaux,11,661,10,QCU,0.32,0.59,60.0,7,5,12,9,7,2,1.33,77.78,Difficile,Moyen,1,Plus Facile que la Prediction,Adapte
2792,2017,Mathematique,1,La Derivation,6,Classe Cn par Morceaux,11,661,10,QCU,0.38,0.4,60.0,8,5,13,10,8,2,1.3,80.0,Moyen,Moyen,0,Meme Difficulte que la Prediction,Adapte
3858,2018,Mathematique,1,La Derivation,6,Classe Cn par Morceaux,11,661,10,QCU,0.23,0.7,60.0,7,4,11,8,7,1,1.38,87.5,Moyen,Moyen,0,Meme Difficulte que la Prediction,Adapte
4924,2019,Mathematique,1,La Derivation,6,Classe Cn par Morceaux,11,661,10,QCU,0.29,0.53,60.0,5,4,9,6,5,1,1.5,83.33,Moyen,Moyen,0,Meme Difficulte que la Prediction,Adapte
5990,2020,Mathematique,1,La Derivation,6,Classe Cn par Morceaux,11,661,10,QCU,0.23,0.54,60.0,5,4,9,7,5,2,1.29,71.43,Moyen,Moyen,0,Meme Difficulte que la Prediction,Adapte
661,2015,Mathematique,1,La Derivation,6,Classe Cn par Morceaux,11,662,11,QCU,0.45,0.25,16.0,15,77,92,34,15,19,2.71,44.12,Difficile,Difficile,0,Meme Difficulte que la Prediction,Pas Adapte
1727,2016,Mathematique,1,La Derivation,6,Classe Cn par Morceaux,11,662,11,QCU,0.68,0.37,33.0,32,65,97,41,32,9,2.37,78.05,Moyen,Difficile,-1,Plus Difficile que la Prediction,Pas Adapte
2793,2017,Mathematique,1,La Derivation,6,Classe Cn par Morceaux,11,662,11,QCU,0.37,0.57,48.0,50,54,104,94,50,44,1.11,53.19,Difficile,Moyen,1,Plus Facile que la Prediction,Pas Adapte
3859,2018,Mathematique,1,La Derivation,6,Classe Cn par Morceaux,11,662,11,QCU,0.4,0.21,35.0,42,77,119,70,42,28,1.7,60.0,Difficile,Difficile,0,Meme Difficulte que la Prediction,Pas Adapte
4925,2019,Mathematique,1,La Derivation,6,Classe Cn par Morceaux,11,662,11,QCM,0.66,0.17,9.0,11,114,125,72,11,61,1.74,15.28,Moyen,Difficile,-1,Plus Difficile que la Prediction,Pas Adapte
5991,2020,Mathematique,1,La Derivation,6,Classe Cn par Morceaux,11,662,11,QCM,0.36,0.6,57.0,67,51,118,114,67,47,1.04,58.77,Facile,Moyen,-1,Plus Difficile que la Prediction,Pas Adapte
662,2015,Mathematique,1,La Derivation,7,Fonctions Reciproques,4,663,1,QCM,0.59,0.17,28.0,5,13,18,9,5,4,2.0,55.56,Moyen,Difficile,-1,Plus Difficile que la Prediction,Pas Adapte
1728,2016,Mathematique,1,La Derivation,7,Fonctions Reciproques,4,663,1,QROC,0.96,0.1,1.0,0,20,20,14,0,14,1.43,0.0,Difficile,Difficile,0,Meme Difficulte que la Prediction,Pas Adapte
2794,2017,Mathematique,1,La Derivation,7,Fonctions Reciproques,4,663,1,QCM,0.67,0.28,10.0,2,21,23,16,2,14,1.44,12.5,Difficile,Difficile,0,Meme Difficulte que la Prediction,Pas Adapte
3860,2018,Mathematique,1,La Derivation,7,Fonctions Reciproques,4,663,1,QCM,0.76,0.18,28.0,7,17,24,8,7,1,3.0,87.5,Facile,Difficile,-2,Beaucoup plus Difficile que la Prediction,Pas Adapte
4926,2019,Mathematique,1,La Derivation,7,Fonctions Reciproques,4,663,1,QCM,0.57,0.24,32.0,9,18,27,24,9,15,1.12,37.5,Facile,Difficile,-2,Beaucoup plus Difficile que la Prediction,Pas Adapte
5992,2020,Mathematique,1,La Derivation,7,Fonctions Reciproques,4,663,1,QCM,0.72,0.22,8.0,2,25,27,12,2,10,2.25,16.67,Difficile,Difficile,0,Meme Difficulte que la Prediction,Pas Adapte
663,2015,Mathematique,1,La Derivation,7,Fonctions Reciproques,4,664,2,QCM,0.03,0.77,65.0,9,5,14,10,9,1,1.4,90.0,Difficile,Facile,2,Beaucoup plus Facile que la Prediction,Adapte
1729,2016,Mathematique,1,La Derivation,7,Fonctions Reciproques,4,664,2,QCM,0.14,0.75,65.0,10,6,16,11,10,1,1.45,90.91,Facile,Facile,0,Meme Difficulte que la Prediction,Adapte
2795,2017,Mathematique,1,La Derivation,7,Fonctions Reciproques,4,664,2,QCM,0.12,0.83,65.0,10,6,16,14,10,4,1.14,71.43,Facile,Facile,0,Meme Difficulte que la Prediction,Adapte
3861,2018,Mathematique,1,La Derivation,7,Fonctions Reciproques,4,664,2,QCM,0.01,0.76,65.0,10,5,15,13,10,3,1.15,76.92,Facile,Facile,0,Meme Difficulte que la Prediction,Adapte
4927,2019,Mathematique,1,La Derivation,7,Fonctions Reciproques,4,664,2,QCM,0.2,0.76,65.0,8,5,13,11,8,3,1.18,72.73,Facile,Facile,0,Meme Difficulte que la Prediction,Adapte
5993,2020,Mathematique,1,La Derivation,7,Fonctions Reciproques,4,664,2,QCM,0.13,0.71,65.0,8,5,13,11,8,3,1.18,72.73,Facile,Facile,0,Meme Difficulte que la Prediction,Adapte
664,2015,Mathematique,1,La Derivation,7,Fonctions Reciproques,4,665,3,QCU,0.22,0.54,51.0,48,47,95,55,48,7,1.73,87.27,Difficile,Moyen,1,Plus Facile que la Prediction,Pas Adapte
1730,2016,Mathematique,1,La Derivation,7,Fonctions Reciproques,4,665,3,QCU,0.28,0.49,50.0,46,47,93,67,46,21,1.39,68.66,Facile,Moyen,-1,Plus Difficile que la Prediction,Pas Adapte
2796,2017,Mathematique,1,La Derivation,7,Fonctions Reciproques,4,665,3,QCU,0.7,0.29,5.0,5,98,103,92,5,87,1.12,5.43,Facile,Difficile,-2,Beaucoup plus Difficile que la Prediction,Pas Adapte
3862,2018,Mathematique,1,La Derivation,7,Fonctions Reciproques,4,665,3,QCU,0.49,0.25,1.0,1,93,94,67,1,66,1.4,1.49,Facile,Difficile,-2,Beaucoup plus Difficile que la Prediction,Pas Adapte
4928,2019,Mathematique,1,La Derivation,7,Fonctions Reciproques,4,665,3,QCU,0.39,0.62,44.0,40,52,92,60,40,20,1.53,66.67,Facile,Moyen,-1,Plus Difficile que la Prediction,Pas Adapte
5994,2020,Mathematique,1,La Derivation,7,Fonctions Reciproques,4,665,3,QCU,0.49,0.35,26.0,25,71,96,56,25,31,1.71,44.64,Facile,Difficile,-2,Beaucoup plus Difficile que la Prediction,Pas Adapte
665,2015,Mathematique,1,La Derivation,7,Fonctions Reciproques,4,666,4,QROC,0.35,0.31,62.0,55,33,88,72,55,17,1.22,76.39,Difficile,Moyen,1,Plus Facile que la Prediction,Adapte
1731,2016,Mathematique,1,La Derivation,7,Fonctions Reciproques,4,666,4,QROC,0.53,0.28,62.0,53,33,86,82,53,29,1.05,64.63,Moyen,Moyen,0,Meme Difficulte que la Prediction,Adapte
2797,2017,Mathematique,1,La Derivation,7,Fonctions Reciproques,4,666,4,QROC,0.25,0.25,62.0,47,29,76,64,47,17,1.19,73.44,Moyen,Moyen,0,Meme Difficulte que la Prediction,Adapte
3863,2018,Mathematique,1,La Derivation,7,Fonctions Reciproques,4,666,4,QROC,0.52,0.32,62.0,53,32,85,82,53,29,1.04,64.63,Moyen,Moyen,0,Meme Difficulte que la Prediction,Adapte
4929,2019,Mathematique,1,La Derivation,7,Fonctions Reciproques,4,666,4,QROC,0.4,0.36,62.0,58,35,93,63,58,5,1.48,92.06,Moyen,Moyen,0,Meme Difficulte que la Prediction,Adapte
5995,2020,Mathematique,1,La Derivation,7,Fonctions Reciproques,4,666,4,QROC,0.31,0.39,62.0,58,35,93,70,58,12,1.33,82.86,Moyen,Moyen,0,Meme Difficulte que la Prediction,Adapte
666,2015,Mathematique,1,La Derivation,8,Quelques Techniques de Calcul,1,667,1,QROC,0.71,0.22,33.0,12,23,35,29,12,17,1.21,41.38,Facile,Difficile,-2,Beaucoup plus Difficile que la Prediction,Pas Adapte
1732,2016,Mathematique,1,La Derivation,8,Quelques Techniques de Calcul,1,667,1,QCM,0.56,0.22,11.0,4,30,34,12,4,8,2.83,33.33,Moyen,Difficile,-1,Plus Difficile que la Prediction,Pas Adapte
2798,2017,Mathematique,1,La Derivation,8,Quelques Techniques de Calcul,1,667,1,QCM,0.1,0.85,69.0,27,12,39,28,27,1,1.39,96.43,Facile,Facile,0,Meme Difficulte que la Prediction,Adapte
3864,2018,Mathematique,1,La Derivation,8,Quelques Techniques de Calcul,1,667,1,QCM,0.16,0.72,69.0,26,12,38,35,26,9,1.09,74.29,Facile,Facile,0,Meme Difficulte que la Prediction,Adapte
4930,2019,Mathematique,1,La Derivation,8,Quelques Techniques de Calcul,1,667,1,QCM,0.08,0.75,69.0,29,13,42,38,29,9,1.11,76.32,Facile,Facile,0,Meme Difficulte que la Prediction,Adapte
5996,2020,Mathematique,1,La Derivation,8,Quelques Techniques de Calcul,1,667,1,QCM,0.12,0.71,69.0,28,13,41,37,28,9,1.11,75.68,Facile,Facile,0,Meme Difficulte que la Prediction,Adapte
667,2015,Mathematique,1,Les Espaces Pre-Hilbertiens et Hilbertiens,1,Espaces Prehilbertiens Reel ou Complexes,6,668,1,QCU,0.16,0.94,70.0,63,27,90,72,63,9,1.25,87.5,Facile,Facile,0,Meme Difficulte que la Prediction,Adapte
1733,2016,Mathematique,1,Les Espaces Pre-Hilbertiens et Hilbertiens,1,Espaces Prehilbertiens Reel ou Complexes,6,668,1,QCU,0.05,0.86,70.0,72,31,103,85,72,13,1.21,84.71,Facile,Facile,0,Meme Difficulte que la Prediction,Adapte
2799,2017,Mathematique,1,Les Espaces Pre-Hilbertiens et Hilbertiens,1,Espaces Prehilbertiens Reel ou Complexes,6,668,1,QROC,0.14,0.9,70.0,73,31,104,78,73,5,1.33,93.59,Facile,Facile,0,Meme Difficulte que la Prediction,Adapte
3865,2018,Mathematique,1,Les Espaces Pre-Hilbertiens et Hilbertiens,1,Espaces Prehilbertiens Reel ou Complexes,6,668,1,QROC,0.14,0.49,70.0,77,33,110,98,77,21,1.12,78.57,Facile,Facile,0,Meme Difficulte que la Prediction,Adapte
4931,2019,Mathematique,1,Les Espaces Pre-Hilbertiens et Hilbertiens,1,Espaces Prehilbertiens Reel ou Complexes,6,668,1,QROC,0.19,0.55,70.0,74,32,106,93,74,19,1.14,79.57,Facile,Facile,0,Meme Difficulte que la Prediction,Adapte
5997,2020,Mathematique,1,Les Espaces Pre-Hilbertiens et Hilbertiens,1,Espaces Prehilbertiens Reel ou Complexes,6,668,1,QROC,0.12,0.5,70.0,67,29,96,68,67,1,1.41,98.53,Facile,Facile,0,Meme Difficulte que la Prediction,Adapte
668,2015,Mathematique,1,Les Espaces Pre-Hilbertiens et Hilbertiens,1,Espaces Prehilbertiens Reel ou Complexes,6,669,2,QCM,0.77,0.15,24.0,4,13,17,11,4,7,1.55,36.36,Facile,Difficile,-2,Beaucoup plus Difficile que la Prediction,Pas Adapte
1734,2016,Mathematique,1,Les Espaces Pre-Hilbertiens et Hilbertiens,1,Espaces Prehilbertiens Reel ou Complexes,6,669,2,QCM,0.17,0.87,68.0,13,6,19,19,13,6,1.0,68.42,Facile,Facile,0,Meme Difficulte que la Prediction,Adapte
2800,2017,Mathematique,1,Les Espaces Pre-Hilbertiens et Hilbertiens,1,Espaces Prehilbertiens Reel ou Complexes,6,669,2,QCU,0.06,0.95,68.0,14,7,21,15,14,1,1.4,93.33,Facile,Facile,0,Meme Difficulte que la Prediction,Adapte
3866,2018,Mathematique,1,Les Espaces Pre-Hilbertiens et Hilbertiens,1,Espaces Prehilbertiens Reel ou Complexes,6,669,2,QCU,0.01,0.98,68.0,16,7,23,18,16,2,1.28,88.89,Facile,Facile,0,Meme Difficulte que la Prediction,Adapte
4932,2019,Mathematique,1,Les Espaces Pre-Hilbertiens et Hilbertiens,1,Espaces Prehilbertiens Reel ou Complexes,6,669,2,QCU,0.08,0.81,68.0,16,7,23,18,16,2,1.28,88.89,Facile,Facile,0,Meme Difficulte que la Prediction,Adapte
5998,2020,Mathematique,1,Les Espaces Pre-Hilbertiens et Hilbertiens,1,Espaces Prehilbertiens Reel ou Complexes,6,669,2,QCU,0.14,0.81,68.0,17,8,25,24,17,7,1.04,70.83,Facile,Facile,0,Meme Difficulte que la Prediction,Adapte
669,2015,Mathematique,1,Les Espaces Pre-Hilbertiens et Hilbertiens,1,Espaces Prehilbertiens Reel ou Complexes,6,670,3,QROC,0.77,0.22,17.0,13,63,76,34,13,21,2.24,38.24,Moyen,Difficile,-1,Plus Difficile que la Prediction,Pas Adapte
1735,2016,Mathematique,1,Les Espaces Pre-Hilbertiens et Hilbertiens,1,Espaces Prehilbertiens Reel ou Complexes,6,670,3,QROC,0.26,0.39,62.0,47,29,76,71,47,24,1.07,66.2,Facile,Moyen,-1,Plus Difficile que la Prediction,Adapte
2801,2017,Mathematique,1,Les Espaces Pre-Hilbertiens et Hilbertiens,1,Espaces Prehilbertiens Reel ou Complexes,6,670,3,QROC,0.31,0.25,62.0,54,33,87,72,54,18,1.21,75.0,Moyen,Moyen,0,Meme Difficulte que la Prediction,Adapte
3867,2018,Mathematique,1,Les Espaces Pre-Hilbertiens et Hilbertiens,1,Espaces Prehilbertiens Reel ou Complexes,6,670,3,QROC,0.21,0.27,62.0,46,29,75,50,46,4,1.5,92.0,Moyen,Moyen,0,Meme Difficulte que la Prediction,Adapte
4933,2019,Mathematique,1,Les Espaces Pre-Hilbertiens et Hilbertiens,1,Espaces Prehilbertiens Reel ou Complexes,6,670,3,QO,0.42,0.22,62.0,49,30,79,57,49,8,1.39,85.96,Moyen,Moyen,0,Meme Difficulte que la Prediction,Adapte
5999,2020,Mathematique,1,Les Espaces Pre-Hilbertiens et Hilbertiens,1,Espaces Prehilbertiens Reel ou Complexes,6,670,3,QO,0.52,0.21,62.0,43,26,69,65,43,22,1.06,66.15,Moyen,Moyen,0,Meme Difficulte que la Prediction,Adapte
670,2015,Mathematique,1,Les Espaces Pre-Hilbertiens et Hilbertiens,1,Espaces Prehilbertiens Reel ou Complexes,6,671,4,QCM,0.58,0.22,27.0,12,31,43,25,12,13,1.72,48.0,Moyen,Difficile,-1,Plus Difficile que la Prediction,Pas Adapte
1736,2016,Mathematique,1,Les Espaces Pre-Hilbertiens et Hilbertiens,1,Espaces Prehilbertiens Reel ou Complexes,6,671,4,QCM,0.14,0.78,68.0,26,12,38,35,26,9,1.09,74.29,Difficile,Facile,2,Beaucoup plus Facile que la Prediction,Adapte
2802,2017,Mathematique,1,Les Espaces Pre-Hilbertiens et Hilbertiens,1,Espaces Prehilbertiens Reel ou Complexes,6,671,4,QCM,0.19,0.93,68.0,29,14,43,37,29,8,1.16,78.38,Facile,Facile,0,Meme Difficulte que la Prediction,Adapte
3868,2018,Mathematique,1,Les Espaces Pre-Hilbertiens et Hilbertiens,1,Espaces Prehilbertiens Reel ou Complexes,6,671,4,QCM,0.12,0.8,68.0,31,14,45,41,31,10,1.1,75.61,Facile,Facile,0,Meme Difficulte que la Prediction,Adapte
4934,2019,Mathematique,1,Les Espaces Pre-Hilbertiens et Hilbertiens,1,Espaces Prehilbertiens Reel ou Complexes,6,671,4,QCM,0.02,0.85,68.0,31,14,45,44,31,13,1.02,70.45,Facile,Facile,0,Meme Difficulte que la Prediction,Adapte
6000,2020,Mathematique,1,Les Espaces Pre-Hilbertiens et Hilbertiens,1,Espaces Prehilbertiens Reel ou Complexes,6,671,4,QCM,0.2,0.78,68.0,30,14,44,39,30,9,1.13,76.92,Facile,Facile,0,Meme Difficulte que la Prediction,Adapte
671,2015,Mathematique,1,Les Espaces Pre-Hilbertiens et Hilbertiens,1,Espaces Prehilbertiens Reel ou Complexes,6,672,5,QCU,0.35,0.6,54.0,5,4,9,8,5,3,1.12,62.5,Moyen,Moyen,0,Meme Difficulte que la Prediction,Pas Adapte
1737,2016,Mathematique,1,Les Espaces Pre-Hilbertiens et Hilbertiens,1,Espaces Prehilbertiens Reel ou Complexes,6,672,5,QCU,0.57,0.25,33.0,3,7,10,7,3,4,1.43,42.86,Moyen,Difficile,-1,Plus Difficile que la Prediction,Pas Adapte
2803,2017,Mathematique,1,Les Espaces Pre-Hilbertiens et Hilbertiens,1,Espaces Prehilbertiens Reel ou Complexes,6,672,5,QCU,0.51,0.3,21.0,3,9,12,12,3,9,1.0,25.0,Facile,Difficile,-2,Beaucoup plus Difficile que la Prediction,Pas Adapte
3869,2018,Mathematique,1,Les Espaces Pre-Hilbertiens et Hilbertiens,1,Espaces Prehilbertiens Reel ou Complexes,6,672,5,QCU,0.63,0.35,2.0,0,11,11,4,0,4,2.75,0.0,Difficile,Difficile,0,Meme Difficulte que la Prediction,Pas Adapte
4935,2019,Mathematique,1,Les Espaces Pre-Hilbertiens et Hilbertiens,1,Espaces Prehilbertiens Reel ou Complexes,6,672,5,QCU,0.73,0.35,30.0,4,9,13,9,4,5,1.44,44.44,Moyen,Difficile,-1,Plus Difficile que la Prediction,Pas Adapte
6001,2020,Mathematique,1,Les Espaces Pre-Hilbertiens et Hilbertiens,1,Espaces Prehilbertiens Reel ou Complexes,6,672,5,QCU,0.38,0.7,60.0,7,5,12,8,7,1,1.5,87.5,Facile,Moyen,-1,Plus Difficile que la Prediction,Adapte
672,2015,Mathematique,1,Les Espaces Pre-Hilbertiens et Hilbertiens,1,Espaces Prehilbertiens Reel ou Complexes,6,673,6,QCU,0.18,0.91,70.0,15,7,22,18,15,3,1.22,83.33,Moyen,Facile,1,Plus Facile que la Prediction,Adapte
1738,2016,Mathematique,1,Les Espaces Pre-Hilbertiens et Hilbertiens,1,Espaces Prehilbertiens Reel ou Complexes,6,673,6,QCU,0.02,0.98,70.0,17,7,24,19,17,2,1.26,89.47,Facile,Facile,0,Meme Difficulte que la Prediction,Adapte
2804,2017,Mathematique,1,Les Espaces Pre-Hilbertiens et Hilbertiens,1,Espaces Prehilbertiens Reel ou Complexes,6,673,6,QCU,0.13,0.83,70.0,15,6,21,17,15,2,1.24,88.24,Facile,Facile,0,Meme Difficulte que la Prediction,Adapte
3870,2018,Mathematique,1,Les Espaces Pre-Hilbertiens et Hilbertiens,1,Espaces Prehilbertiens Reel ou Complexes,6,673,6,QCU,0.09,0.9,70.0,13,5,18,14,13,1,1.29,92.86,Facile,Facile,0,Meme Difficulte que la Prediction,Adapte
4936,2019,Mathematique,1,Les Espaces Pre-Hilbertiens et Hilbertiens,1,Espaces Prehilbertiens Reel ou Complexes,6,673,6,QCU,0.02,0.89,70.0,10,5,15,13,10,3,1.15,76.92,Facile,Facile,0,Meme Difficulte que la Prediction,Adapte
6002,2020,Mathematique,1,Les Espaces Pre-Hilbertiens et Hilbertiens,1,Espaces Prehilbertiens Reel ou Complexes,6,673,6,QCU,0.19,0.93,70.0,10,5,15,13,10,3,1.15,76.92,Facile,Facile,0,Meme Difficulte que la Prediction,Adapte
673,2015,Mathematique,1,Les Espaces Pre-Hilbertiens et Hilbertiens,2,Espaces Euclidiens,10,674,1,QO,0.94,0.15,22.0,18,66,84,56,18,38,1.5,32.14,Facile,Difficile,-2,Beaucoup plus Difficile que la Prediction,Pas Adapte
1739,2016,Mathematique,1,Les Espaces Pre-Hilbertiens et Hilbertiens,2,Espaces Euclidiens,10,674,1,QO,0.85,0.04,1.0,1,95,96,70,1,69,1.37,1.43,Facile,Difficile,-2,Beaucoup plus Difficile que la Prediction,Pas Adapte
2805,2017,Mathematique,1,Les Espaces Pre-Hilbertiens et Hilbertiens,2,Espaces Euclidiens,10,674,1,QO,0.28,0.16,64.0,69,39,108,71,69,2,1.52,97.18,Moyen,Moyen,0,Meme Difficulte que la Prediction,Adapte
3871,2018,Mathematique,1,Les Espaces Pre-Hilbertiens et Hilbertiens,2,Espaces Euclidiens,10,674,1,QO,0.34,0.17,64.0,74,42,116,111,74,37,1.05,66.67,Moyen,Moyen,0,Meme Difficulte que la Prediction,Adapte
4937,2019,Mathematique,1,Les Espaces Pre-Hilbertiens et Hilbertiens,2,Espaces Euclidiens,10,674,1,QO,0.42,0.3,64.0,84,47,131,128,84,44,1.02,65.62,Moyen,Moyen,0,Meme Difficulte que la Prediction,Adapte
6003,2020,Mathematique,1,Les Espaces Pre-Hilbertiens et Hilbertiens,2,Espaces Euclidiens,10,674,1,QO,0.24,0.29,64.0,92,52,144,129,92,37,1.12,71.32,Moyen,Moyen,0,Meme Difficulte que la Prediction,Adapte
674,2015,Mathematique,1,Les Espaces Pre-Hilbertiens et Hilbertiens,2,Espaces Euclidiens,10,675,2,QCM,0.45,0.65,51.0,11,10,21,17,11,6,1.24,64.71,Difficile,Moyen,1,Plus Facile que la Prediction,Pas Adapte
1740,2016,Mathematique,1,Les Espaces Pre-Hilbertiens et Hilbertiens,2,Espaces Euclidiens,10,675,2,QCM,0.62,0.27,2.0,0,21,21,12,0,12,1.75,0.0,Difficile,Difficile,0,Meme Difficulte que la Prediction,Pas Adapte
2806,2017,Mathematique,1,Les Espaces Pre-Hilbertiens et Hilbertiens,2,Espaces Euclidiens,10,675,2,QCM,0.29,0.36,44.0,9,11,20,17,9,8,1.18,52.94,Facile,Moyen,-1,Plus Difficile que la Prediction,Pas Adapte
3872,2018,Mathematique,1,Les Espaces Pre-Hilbertiens et Hilbertiens,2,Espaces Euclidiens,10,675,2,QCM,0.68,0.25,27.0,6,16,22,6,6,0,3.67,100.0,Facile,Difficile,-2,Beaucoup plus Difficile que la Prediction,Pas Adapte
4938,2019,Mathematique,1,Les Espaces Pre-Hilbertiens et Hilbertiens,2,Espaces Euclidiens,10,675,2,QCM,0.62,0.2,1.0,0,20,20,7,0,7,2.86,0.0,Facile,Difficile,-2,Beaucoup plus Difficile que la Prediction,Pas Adapte
6004,2020,Mathematique,1,Les Espaces Pre-Hilbertiens et Hilbertiens,2,Espaces Euclidiens,10,675,2,QCM,0.61,0.27,35.0,6,11,17,17,6,11,1.0,35.29,Moyen,Difficile,-1,Plus Difficile que la Prediction,Pas Adapte
675,2015,Mathematique,1,Les Espaces Pre-Hilbertiens et Hilbertiens,2,Espaces Euclidiens,10,676,3,QCU,0.7,0.24,0.0,0,32,32,23,0,23,1.39,0.0,Difficile,Difficile,0,Meme Difficulte que la Prediction,Pas Adapte
1741,2016,Mathematique,1,Les Espaces Pre-Hilbertiens et Hilbertiens,2,Espaces Euclidiens,10,676,3,QCU,0.67,0.35,13.0,5,32,37,21,5,16,1.76,23.81,Moyen,Difficile,-1,Plus Difficile que la Prediction,Pas Adapte
2807,2017,Mathematique,1,Les Espaces Pre-Hilbertiens et Hilbertiens,2,Espaces Euclidiens,10,676,3,QCU,0.37,0.47,56.0,22,18,40,29,22,7,1.38,75.86,Difficile,Moyen,1,Plus Facile que la Prediction,Pas Adapte
3873,2018,Mathematique,1,Les Espaces Pre-Hilbertiens et Hilbertiens,2,Espaces Euclidiens,10,676,3,QCU,0.23,0.62,47.0,19,22,41,25,19,6,1.64,76.0,Facile,Moyen,-1,Plus Difficile que la Prediction,Pas Adapte
4939,2019,Mathematique,1,Les Espaces Pre-Hilbertiens et Hilbertiens,2,Espaces Euclidiens,10,676,3,QCM,0.45,0.34,59.0,27,18,45,30,27,3,1.5,90.0,Facile,Moyen,-1,Plus Difficile que la Prediction,Pas Adapte
6005,2020,Mathematique,1,Les Espaces Pre-Hilbertiens et Hilbertiens,2,Espaces Euclidiens,10,676,3,QCM,0.77,0.26,26.0,13,36,49,30,13,17,1.63,43.33,Difficile,Difficile,0,Meme Difficulte que la Prediction,Pas Adapte
676,2015,Mathematique,1,Les Espaces Pre-Hilbertiens et Hilbertiens,2,Espaces Euclidiens,10,677,4,QCU,0.42,0.24,6.0,3,46,49,26,3,23,1.88,11.54,Facile,Difficile,-2,Beaucoup plus Difficile que la Prediction,Pas Adapte
1742,2016,Mathematique,1,Les Espaces Pre-Hilbertiens et Hilbertiens,2,Espaces Euclidiens,10,677,4,QCU,0.7,0.27,16.0,8,39,47,22,8,14,2.14,36.36,Difficile,Difficile,0,Meme Difficulte que la Prediction,Pas Adapte
2808,2017,Mathematique,1,Les Espaces Pre-Hilbertiens et Hilbertiens,2,Espaces Euclidiens,10,677,4,QCU,0.31,0.43,55.0,30,24,54,44,30,14,1.23,68.18,Difficile,Moyen,1,Plus Facile que la Prediction,Pas Adapte
3874,2018,Mathematique,1,Les Espaces Pre-Hilbertiens et Hilbertiens,2,Espaces Euclidiens,10,677,4,QCU,0.49,0.31,5.0,3,55,58,54,3,51,1.07,5.56,Difficile,Difficile,0,Meme Difficulte que la Prediction,Pas Adapte
4940,2019,Mathematique,1,Les Espaces Pre-Hilbertiens et Hilbertiens,2,Espaces Euclidiens,10,677,4,QCU,0.23,0.74,41.0,27,38,65,49,27,22,1.33,55.1,Facile,Moyen,-1,Plus Difficile que la Prediction,Pas Adapte
6006,2020,Mathematique,1,Les Espaces Pre-Hilbertiens et Hilbertiens,2,Espaces Euclidiens,10,677,4,QO,0.49,0.29,51.0,31,29,60,51,31,20,1.18,60.78,Difficile,Moyen,1,Plus Facile que la Prediction,Pas Adapte
677,2015,Mathematique,1,Les Espaces Pre-Hilbertiens et Hilbertiens,2,Espaces Euclidiens,10,678,5,QCM,0.24,0.36,46.0,3,4,7,4,3,1,1.75,75.0,Facile,Moyen,-1,Plus Difficile que la Prediction,Pas Adapte
1743,2016,Mathematique,1,Les Espaces Pre-Hilbertiens et Hilbertiens,2,Espaces Euclidiens,10,678,5,QCM,0.73,0.26,14.0,1,6,7,5,1,4,1.4,20.0,Difficile,Difficile,0,Meme Difficulte que la Prediction,Pas Adapte
2809,2017,Mathematique,1,Les Espaces Pre-Hilbertiens et Hilbertiens,2,Espaces Euclidiens,10,678,5,QCM,0.53,0.21,8.0,1,7,8,2,1,1,4.0,50.0,Difficile,Difficile,0,Meme Difficulte que la Prediction,Pas Adapte
3875,2018,Mathematique,1,Les Espaces Pre-Hilbertiens et Hilbertiens,2,Espaces Euclidiens,10,678,5,QCM,0.33,0.53,56.0,4,4,8,8,4,4,1.0,50.0,Facile,Moyen,-1,Plus Difficile que la Prediction,Pas Adapte
4941,2019,Mathematique,1,Les Espaces Pre-Hilbertiens et Hilbertiens,2,Espaces Euclidiens,10,678,5,QCM,0.69,0.24,21.0,2,6,8,6,2,4,1.33,33.33,Facile,Difficile,-2,Beaucoup plus Difficile que la Prediction,Pas Adapte
6007,2020,Mathematique,1,Les Espaces Pre-Hilbertiens et Hilbertiens,2,Espaces Euclidiens,10,678,5,QCM,0.71,0.22,2.0,0,9,9,7,0,7,1.29,0.0,Moyen,Difficile,-1,Plus Difficile que la Prediction,Pas Adapte
678,2015,Mathematique,1,Les Espaces Pre-Hilbertiens et Hilbertiens,2,Espaces Euclidiens,10,679,6,QCM,0.48,0.53,37.0,20,35,55,53,20,33,1.04,37.74,Facile,Moyen,-1,Plus Difficile que la Prediction,Pas Adapte
1744,2016,Mathematique,1,Les Espaces Pre-Hilbertiens et Hilbertiens,2,Espaces Euclidiens,10,679,6,QCM,0.41,0.32,58.0,27,20,47,31,27,4,1.52,87.1,Facile,Moyen,-1,Plus Difficile que la Prediction,Pas Adapte
2810,2017,Mathematique,1,Les Espaces Pre-Hilbertiens et Hilbertiens,2,Espaces Euclidiens,10,679,6,QCM,0.61,0.18,14.0,7,44,51,28,7,21,1.82,25.0,Difficile,Difficile,0,Meme Difficulte que la Prediction,Pas Adapte
3876,2018,Mathematique,1,Les Espaces Pre-Hilbertiens et Hilbertiens,2,Espaces Euclidiens,10,679,6,QCM,0.49,0.36,60.0,26,18,44,26,26,0,1.69,100.0,Facile,Moyen,-1,Plus Difficile que la Prediction,Adapte
4942,2019,Mathematique,1,Les Espaces Pre-Hilbertiens et Hilbertiens,2,Espaces Euclidiens,10,679,6,QCM,0.44,0.68,60.0,30,20,50,37,30,7,1.35,81.08,Moyen,Moyen,0,Meme Difficulte que la Prediction,Adapte
6008,2020,Mathematique,1,Les Espaces Pre-Hilbertiens et Hilbertiens,2,Espaces Euclidiens,10,679,6,QCM,0.48,0.59,60.0,34,22,56,51,34,17,1.1,66.67,Moyen,Moyen,0,Meme Difficulte que la Prediction,Adapte
679,2015,Mathematique,1,Les Espaces Pre-Hilbertiens et Hilbertiens,2,Espaces Euclidiens,10,680,7,QCU,0.54,0.32,7.0,4,52,56,52,4,48,1.08,7.69,Moyen,Difficile,-1,Plus Difficile que la Prediction,Pas Adapte
1745,2016,Mathematique,1,Les Espaces Pre-Hilbertiens et Hilbertiens,2,Espaces Euclidiens,10,680,7,QCU,0.28,0.4,45.0,22,27,49,33,22,11,1.48,66.67,Facile,Moyen,-1,Plus Difficile que la Prediction,Pas Adapte
2811,2017,Mathematique,1,Les Espaces Pre-Hilbertiens et Hilbertiens,2,Espaces Euclidiens,10,680,7,QCU,0.24,0.59,50.0,28,27,55,50,28,22,1.1,56.0,Difficile,Moyen,1,Plus Facile que la Prediction,Pas Adapte
3877,2018,Mathematique,1,Les Espaces Pre-Hilbertiens et Hilbertiens,2,Espaces Euclidiens,10,680,7,QCU,0.34,0.67,36.0,23,40,63,37,23,14,1.7,62.16,Facile,Moyen,-1,Plus Difficile que la Prediction,Pas Adapte
4943,2019,Mathematique,1,Les Espaces Pre-Hilbertiens et Hilbertiens,2,Espaces Euclidiens,10,680,7,QCU,0.06,0.76,66.0,44,23,67,62,44,18,1.08,70.97,Facile,Facile,0,Meme Difficulte que la Prediction,Adapte
6009,2020,Mathematique,1,Les Espaces Pre-Hilbertiens et Hilbertiens,2,Espaces Euclidiens,10,680,7,QCU,0.03,0.78,66.0,42,22,64,46,42,4,1.39,91.3,Facile,Facile,0,Meme Difficulte que la Prediction,Adapte
680,2015,Mathematique,1,Les Espaces Pre-Hilbertiens et Hilbertiens,2,Espaces Euclidiens,10,681,8,QCU,0.34,0.46,48.0,34,37,71,37,34,3,1.92,91.89,Moyen,Moyen,0,Meme Difficulte que la Prediction,Pas Adapte
1746,2016,Mathematique,1,Les Espaces Pre-Hilbertiens et Hilbertiens,2,Espaces Euclidiens,10,681,8,QCU,0.19,0.89,68.0,44,20,64,61,44,17,1.05,72.13,Facile,Facile,0,Meme Difficulte que la Prediction,Adapte
2812,2017,Mathematique,1,Les Espaces Pre-Hilbertiens et Hilbertiens,2,Espaces Euclidiens,10,681,8,QCU,0.13,0.75,68.0,41,20,61,44,41,3,1.39,93.18,Facile,Facile,0,Meme Difficulte que la Prediction,Adapte
3878,2018,Mathematique,1,Les Espaces Pre-Hilbertiens et Hilbertiens,2,Espaces Euclidiens,10,681,8,QCU,0.12,0.85,68.0,41,19,60,46,41,5,1.3,89.13,Facile,Facile,0,Meme Difficulte que la Prediction,Adapte
4944,2019,Mathematique,1,Les Espaces Pre-Hilbertiens et Hilbertiens,2,Espaces Euclidiens,10,681,8,QCU,0.16,0.93,68.0,37,18,55,38,37,1,1.45,97.37,Facile,Facile,0,Meme Difficulte que la Prediction,Adapte
6010,2020,Mathematique,1,Les Espaces Pre-Hilbertiens et Hilbertiens,2,Espaces Euclidiens,10,681,8,QCU,0.14,0.98,68.0,33,15,48,44,33,11,1.09,75.0,Facile,Facile,0,Meme Difficulte que la Prediction,Adapte
681,2015,Mathematique,1,Les Espaces Pre-Hilbertiens et Hilbertiens,2,Espaces Euclidiens,10,682,9,QO,0.98,0.04,8.0,3,31,34,29,3,26,1.17,10.34,Facile,Difficile,-2,Beaucoup plus Difficile que la Prediction,Pas Adapte
1747,2016,Mathematique,1,Les Espaces Pre-Hilbertiens et Hilbertiens,2,Espaces Euclidiens,10,682,9,QO,0.7,0.25,60.0,23,16,39,35,23,12,1.11,65.71,Difficile,Moyen,1,Plus Facile que la Prediction,Adapte
2813,2017,Mathematique,1,Les Espaces Pre-Hilbertiens et Hilbertiens,2,Espaces Euclidiens,10,682,9,QO,0.47,0.19,60.0,26,17,43,30,26,4,1.43,86.67,Moyen,Moyen,0,Meme Difficulte que la Prediction,Adapte
3879,2018,Mathematique,1,Les Espaces Pre-Hilbertiens et Hilbertiens,2,Espaces Euclidiens,10,682,9,QO,0.66,0.24,60.0,26,17,43,30,26,4,1.43,86.67,Moyen,Moyen,0,Meme Difficulte que la Prediction,Adapte
4945,2019,Mathematique,1,Les Espaces Pre-Hilbertiens et Hilbertiens,2,Espaces Euclidiens,10,682,9,QO,0.33,0.17,60.0,26,18,44,40,26,14,1.1,65.0,Moyen,Moyen,0,Meme Difficulte que la Prediction,Adapte
6011,2020,Mathematique,1,Les Espaces Pre-Hilbertiens et Hilbertiens,2,Espaces Euclidiens,10,682,9,QROC,0.25,0.35,60.0,22,15,37,34,22,12,1.09,64.71,Moyen,Moyen,0,Meme Difficulte que la Prediction,Adapte
682,2015,Mathematique,1,Les Espaces Pre-Hilbertiens et Hilbertiens,2,Espaces Euclidiens,10,683,10,QROC,0.38,0.34,44.0,10,13,23,10,10,0,2.3,100.0,Difficile,Moyen,1,Plus Facile que la Prediction,Pas Adapte
1748,2016,Mathematique,1,Les Espaces Pre-Hilbertiens et Hilbertiens,2,Espaces Euclidiens,10,683,10,QROC,0.25,0.33,49.0,13,13,26,21,13,8,1.24,61.9,Facile,Moyen,-1,Plus Difficile que la Prediction,Pas Adapte
2814,2017,Mathematique,1,Les Espaces Pre-Hilbertiens et Hilbertiens,2,Espaces Euclidiens,10,683,10,QROC,0.78,0.21,20.0,5,19,24,10,5,5,2.4,50.0,Facile,Difficile,-2,Beaucoup plus Difficile que la Prediction,Pas Adapte
3880,2018,Mathematique,1,Les Espaces Pre-Hilbertiens et Hilbertiens,2,Espaces Euclidiens,10,683,10,QROC,0.87,0.07,30.0,7,15,22,18,7,11,1.22,38.89,Difficile,Difficile,0,Meme Difficulte que la Prediction,Pas Adapte
4946,2019,Mathematique,1,Les Espaces Pre-Hilbertiens et Hilbertiens,2,Espaces Euclidiens,10,683,10,QROC,0.95,0.16,27.0,6,15,21,19,6,13,1.11,31.58,Moyen,Difficile,-1,Plus Difficile que la Prediction,Pas Adapte
6012,2020,Mathematique,1,Les Espaces Pre-Hilbertiens et Hilbertiens,2,Espaces Euclidiens,10,683,10,QROC,0.47,0.3,49.0,10,11,21,16,10,6,1.31,62.5,Difficile,Moyen,1,Plus Facile que la Prediction,Pas Adapte
683,2015,Mathematique,1,Les Espaces Pre-Hilbertiens et Hilbertiens,3,Rappels et Complements sur le Groupe Orthogonal d'un Espace Euclidien,6,684,1,QO,0.97,0.07,22.0,3,11,14,10,3,7,1.4,30.0,Moyen,Difficile,-1,Plus Difficile que la Prediction,Pas Adapte
1749,2016,Mathematique,1,Les Espaces Pre-Hilbertiens et Hilbertiens,3,Rappels et Complements sur le Groupe Orthogonal d'un Espace Euclidien,6,684,1,QO,0.68,0.21,60.0,8,6,14,10,8,2,1.4,80.0,Facile,Moyen,-1,Plus Difficile que la Prediction,Adapte
2815,2017,Mathematique,1,Les Espaces Pre-Hilbertiens et Hilbertiens,3,Rappels et Complements sur le Groupe Orthogonal d'un Espace Euclidien,6,684,1,QO,0.46,0.16,60.0,10,6,16,16,10,6,1.0,62.5,Moyen,Moyen,0,Meme Difficulte que la Prediction,Adapte
3881,2018,Mathematique,1,Les Espaces Pre-Hilbertiens et Hilbertiens,3,Rappels et Complements sur le Groupe Orthogonal d'un Espace Euclidien,6,684,1,QO,0.23,0.27,60.0,8,6,14,14,8,6,1.0,57.14,Moyen,Moyen,0,Meme Difficulte que la Prediction,Adapte
4947,2019,Mathematique,1,Les Espaces Pre-Hilbertiens et Hilbertiens,3,Rappels et Complements sur le Groupe Orthogonal d'un Espace Euclidien,6,684,1,QO,0.52,0.24,60.0,8,5,13,8,8,0,1.62,100.0,Moyen,Moyen,0,Meme Difficulte que la Prediction,Adapte
6013,2020,Mathematique,1,Les Espaces Pre-Hilbertiens et Hilbertiens,3,Rappels et Complements sur le Groupe Orthogonal d'un Espace Euclidien,6,684,1,QO,0.33,0.16,60.0,7,5,12,10,7,3,1.2,70.0,Moyen,Moyen,0,Meme Difficulte que la Prediction,Adapte
684,2015,Mathematique,1,Les Espaces Pre-Hilbertiens et Hilbertiens,3,Rappels et Complements sur le Groupe Orthogonal d'un Espace Euclidien,6,685,2,QCU,0.2,0.63,60.0,55,37,92,62,55,7,1.48,88.71,Difficile,Moyen,1,Plus Facile que la Prediction,Adapte
1750,2016,Mathematique,1,Les Espaces Pre-Hilbertiens et Hilbertiens,3,Rappels et Complements sur le Groupe Orthogonal d'un Espace Euclidien,6,685,2,QCU,0.3,0.54,60.0,64,42,106,85,64,21,1.25,75.29,Moyen,Moyen,0,Meme Difficulte que la Prediction,Adapte
2816,2017,Mathematique,1,Les Espaces Pre-Hilbertiens et Hilbertiens,3,Rappels et Complements sur le Groupe Orthogonal d'un Espace Euclidien,6,685,2,QCU,0.28,0.6,60.0,61,40,101,95,61,34,1.06,64.21,Moyen,Moyen,0,Meme Difficulte que la Prediction,Adapte
3882,2018,Mathematique,1,Les Espaces Pre-Hilbertiens et Hilbertiens,3,Rappels et Complements sur le Groupe Orthogonal d'un Espace Euclidien,6,685,2,QROC,0.48,0.28,60.0,61,41,102,96,61,35,1.06,63.54,Moyen,Moyen,0,Meme Difficulte que la Prediction,Adapte
4948,2019,Mathematique,1,Les Espaces Pre-Hilbertiens et Hilbertiens,3,Rappels et Complements sur le Groupe Orthogonal d'un Espace Euclidien,6,685,2,QROC,0.54,0.34,60.0,53,36,89,70,53,17,1.27,75.71,Moyen,Moyen,0,Meme Difficulte que la Prediction,Adapte
6014,2020,Mathematique,1,Les Espaces Pre-Hilbertiens et Hilbertiens,3,Rappels et Complements sur le Groupe Orthogonal d'un Espace Euclidien,6,685,2,QROC,0.54,0.3,60.0,55,37,92,75,55,20,1.23,73.33,Moyen,Moyen,0,Meme Difficulte que la Prediction,Adapte
685,2015,Mathematique,1,Les Espaces Pre-Hilbertiens et Hilbertiens,3,Rappels et Complements sur le Groupe Orthogonal d'un Espace Euclidien,6,686,3,QCU,0.21,0.73,55.0,30,25,55,32,30,2,1.72,93.75,Moyen,Moyen,0,Meme Difficulte que la Prediction,Pas Adapte
1751,2016,Mathematique,1,Les Espaces Pre-Hilbertiens et Hilbertiens,3,Rappels et Complements sur le Groupe Orthogonal d'un Espace Euclidien,6,686,3,QCU,0.25,0.72,64.0,34,19,53,46,34,12,1.15,73.91,Moyen,Moyen,0,Meme Difficulte que la Prediction,Adapte
2817,2017,Mathematique,1,Les Espaces Pre-Hilbertiens et Hilbertiens,3,Rappels et Complements sur le Groupe Orthogonal d'un Espace Euclidien,6,686,3,QCU,0.29,0.53,64.0,38,22,60,52,38,14,1.15,73.08,Moyen,Moyen,0,Meme Difficulte que la Prediction,Adapte
3883,2018,Mathematique,1,Les Espaces Pre-Hilbertiens et Hilbertiens,3,Rappels et Complements sur le Groupe Orthogonal d'un Espace Euclidien,6,686,3,QCU,0.2,0.59,64.0,40,23,63,50,40,10,1.26,80.0,Moyen,Moyen,0,Meme Difficulte que la Prediction,Adapte
4949,2019,Mathematique,1,Les Espaces Pre-Hilbertiens et Hilbertiens,3,Rappels et Complements sur le Groupe Orthogonal d'un Espace Euclidien,6,686,3,QCU,0.34,0.69,64.0,43,24,67,64,43,21,1.05,67.19,Moyen,Moyen,0,Meme Difficulte que la Prediction,Adapte
6015,2020,Mathematique,1,Les Espaces Pre-Hilbertiens et Hilbertiens,3,Rappels et Complements sur le Groupe Orthogonal d'un Espace Euclidien,6,686,3,QCU,0.2,0.69,64.0,44,25,69,51,44,7,1.35,86.27,Moyen,Moyen,0,Meme Difficulte que la Prediction,Adapte
686,2015,Mathematique,1,Les Espaces Pre-Hilbertiens et Hilbertiens,3,Rappels et Complements sur le Groupe Orthogonal d'un Espace Euclidien,6,687,4,QCM,0.3,0.6,36.0,15,27,42,36,15,21,1.17,41.67,Difficile,Moyen,1,Plus Facile que la Prediction,Pas Adapte
1752,2016,Mathematique,1,Les Espaces Pre-Hilbertiens et Hilbertiens,3,Rappels et Complements sur le Groupe Orthogonal d'un Espace Euclidien,6,687,4,QCM,0.6,0.29,28.0,12,31,43,27,12,15,1.59,44.44,Facile,Difficile,-2,Beaucoup plus Difficile que la Prediction,Pas Adapte
2818,2017,Mathematique,1,Les Espaces Pre-Hilbertiens et Hilbertiens,3,Rappels et Complements sur le Groupe Orthogonal d'un Espace Euclidien,6,687,4,QCM,0.72,0.21,25.0,10,29,39,29,10,19,1.34,34.48,Difficile,Difficile,0,Meme Difficulte que la Prediction,Pas Adapte
3884,2018,Mathematique,1,Les Espaces Pre-Hilbertiens et Hilbertiens,3,Rappels et Complements sur le Groupe Orthogonal d'un Espace Euclidien,6,687,4,QCM,0.74,0.19,2.0,1,40,41,14,1,13,2.93,7.14,Facile,Difficile,-2,Beaucoup plus Difficile que la Prediction,Pas Adapte
4950,2019,Mathematique,1,Les Espaces Pre-Hilbertiens et Hilbertiens,3,Rappels et Complements sur le Groupe Orthogonal d'un Espace Euclidien,6,687,4,QCM,0.46,0.33,40.0,16,23,39,26,16,10,1.5,61.54,Moyen,Moyen,0,Meme Difficulte que la Prediction,Pas Adapte
6016,2020,Mathematique,1,Les Espaces Pre-Hilbertiens et Hilbertiens,3,Rappels et Complements sur le Groupe Orthogonal d'un Espace Euclidien,6,687,4,QCM,0.34,0.62,58.0,21,16,37,26,21,5,1.42,80.77,Difficile,Moyen,1,Plus Facile que la Prediction,Pas Adapte
687,2015,Mathematique,1,Les Espaces Pre-Hilbertiens et Hilbertiens,3,Rappels et Complements sur le Groupe Orthogonal d'un Espace Euclidien,6,688,5,QCU,0.31,0.44,59.0,21,14,35,23,21,2,1.52,91.3,Moyen,Moyen,0,Meme Difficulte que la Prediction,Pas Adapte
1753,2016,Mathematique,1,Les Espaces Pre-Hilbertiens et Hilbertiens,3,Rappels et Complements sur le Groupe Orthogonal d'un Espace Euclidien,6,688,5,QCU,0.67,0.31,0.0,0,38,38,19,0,19,2.0,0.0,Difficile,Difficile,0,Meme Difficulte que la Prediction,Pas Adapte
2819,2017,Mathematique,1,Les Espaces Pre-Hilbertiens et Hilbertiens,3,Rappels et Complements sur le Groupe Orthogonal d'un Espace Euclidien,6,688,5,QCU,0.34,0.68,61.0,21,14,35,33,21,12,1.06,63.64,Difficile,Moyen,1,Plus Facile que la Prediction,Adapte
3885,2018,Mathematique,1,Les Espaces Pre-Hilbertiens et Hilbertiens,3,Rappels et Complements sur le Groupe Orthogonal d'un Espace Euclidien,6,688,5,QCU,0.36,0.44,61.0,24,16,40,35,24,11,1.14,68.57,Moyen,Moyen,0,Meme Difficulte que la Prediction,Adapte
4951,2019,Mathematique,1,Les Espaces Pre-Hilbertiens et Hilbertiens,3,Rappels et Complements sur le Groupe Orthogonal d'un Espace Euclidien,6,688,5,QCU,0.33,0.49,61.0,24,15,39,25,24,1,1.56,96.0,Moyen,Moyen,0,Meme Difficulte que la Prediction,Adapte
6017,2020,Mathematique,1,Les Espaces Pre-Hilbertiens et Hilbertiens,3,Rappels et Complements sur le Groupe Orthogonal d'un Espace Euclidien,6,688,5,QCU,0.38,0.42,61.0,26,16,42,42,26,16,1.0,61.9,Moyen,Moyen,0,Meme Difficulte que la Prediction,Adapte
688,2015,Mathematique,1,Les Espaces Pre-Hilbertiens et Hilbertiens,3,Rappels et Complements sur le Groupe Orthogonal d'un Espace Euclidien,6,689,6,QCM,0.64,0.18,8.0,6,67,73,30,6,24,2.43,20.0,Moyen,Difficile,-1,Plus Difficile que la Prediction,Pas Adapte
1754,2016,Mathematique,1,Les Espaces Pre-Hilbertiens et Hilbertiens,3,Rappels et Complements sur le Groupe Orthogonal d'un Espace Euclidien,6,689,6,QCM,0.71,0.23,10.0,7,59,66,63,7,56,1.05,11.11,Facile,Difficile,-2,Beaucoup plus Difficile que la Prediction,Pas Adapte
2820,2017,Mathematique,1,Les Espaces Pre-Hilbertiens et Hilbertiens,3,Rappels et Complements sur le Groupe Orthogonal d'un Espace Euclidien,6,689,6,QCM,0.27,0.59,56.0,43,33,76,62,43,19,1.23,69.35,Facile,Moyen,-1,Plus Difficile que la Prediction,Pas Adapte
3886,2018,Mathematique,1,Les Espaces Pre-Hilbertiens et Hilbertiens,3,Rappels et Complements sur le Groupe Orthogonal d'un Espace Euclidien,6,689,6,QCM,0.37,0.4,45.0,35,42,77,56,35,21,1.38,62.5,Facile,Moyen,-1,Plus Difficile que la Prediction,Pas Adapte
4952,2019,Mathematique,1,Les Espaces Pre-Hilbertiens et Hilbertiens,3,Rappels et Complements sur le Groupe Orthogonal d'un Espace Euclidien,6,689,6,QCM,0.66,0.25,15.0,10,58,68,45,10,35,1.51,22.22,Difficile,Difficile,0,Meme Difficulte que la Prediction,Pas Adapte
6018,2020,Mathematique,1,Les Espaces Pre-Hilbertiens et Hilbertiens,3,Rappels et Complements sur le Groupe Orthogonal d'un Espace Euclidien,6,689,6,QCM,0.52,0.21,12.0,9,67,76,30,9,21,2.53,30.0,Moyen,Difficile,-1,Plus Difficile que la Prediction,Pas Adapte
689,2015,Mathematique,1,Les Espaces Pre-Hilbertiens et Hilbertiens,4,Complement sur les Endomorphismes Autoadjoints d'un Espace Euclidien et les Matrices Symetriques,1,690,1,QCM,0.13,0.89,67.0,44,21,65,56,44,12,1.16,78.57,Facile,Facile,0,Meme Difficulte que la Prediction,Adapte
1755,2016,Mathematique,1,Les Espaces Pre-Hilbertiens et Hilbertiens,4,Complement sur les Endomorphismes Autoadjoints d'un Espace Euclidien et les Matrices Symetriques,1,690,1,QCM,0.02,0.88,67.0,38,18,56,54,38,16,1.04,70.37,Facile,Facile,0,Meme Difficulte que la Prediction,Adapte
2821,2017,Mathematique,1,Les Espaces Pre-Hilbertiens et Hilbertiens,4,Complement sur les Endomorphismes Autoadjoints d'un Espace Euclidien et les Matrices Symetriques,1,690,1,QCU,0.06,0.9,67.0,39,19,58,42,39,3,1.38,92.86,Facile,Facile,0,Meme Difficulte que la Prediction,Adapte
3887,2018,Mathematique,1,Les Espaces Pre-Hilbertiens et Hilbertiens,4,Complement sur les Endomorphismes Autoadjoints d'un Espace Euclidien et les Matrices Symetriques,1,690,1,QCU,0.06,0.99,67.0,39,19,58,55,39,16,1.05,70.91,Facile,Facile,0,Meme Difficulte que la Prediction,Adapte
4953,2019,Mathematique,1,Les Espaces Pre-Hilbertiens et Hilbertiens,4,Complement sur les Endomorphismes Autoadjoints d'un Espace Euclidien et les Matrices Symetriques,1,690,1,QCU,0.15,0.88,67.0,38,18,56,39,38,1,1.44,97.44,Facile,Facile,0,Meme Difficulte que la Prediction,Adapte
6019,2020,Mathematique,1,Les Espaces Pre-Hilbertiens et Hilbertiens,4,Complement sur les Endomorphismes Autoadjoints d'un Espace Euclidien et les Matrices Symetriques,1,690,1,QCU,0.05,0.97,67.0,33,16,49,41,33,8,1.2,80.49,Facile,Facile,0,Meme Difficulte que la Prediction,Adapte
690,2015,Mathematique,1,La Geometrie Analytique,1,Sur l'Utilisation de Maple,2,691,1,QCM,0.73,0.21,21.0,4,16,20,13,4,9,1.54,30.77,Facile,Difficile,-2,Beaucoup plus Difficile que la Prediction,Pas Adapte
1756,2016,Mathematique,1,La Geometrie Analytique,1,Sur l'Utilisation de Maple,2,691,1,QCM,0.65,0.17,4.0,1,18,19,16,1,15,1.19,6.25,Difficile,Difficile,0,Meme Difficulte que la Prediction,Pas Adapte
2822,2017,Mathematique,1,La Geometrie Analytique,1,Sur l'Utilisation de Maple,2,691,1,QROC,0.42,0.26,64.0,12,6,18,18,12,6,1.0,66.67,Difficile,Moyen,1,Plus Facile que la Prediction,Adapte
3888,2018,Mathematique,1,La Geometrie Analytique,1,Sur l'Utilisation de Maple,2,691,1,QROC,0.45,0.28,64.0,12,7,19,18,12,6,1.06,66.67,Moyen,Moyen,0,Meme Difficulte que la Prediction,Adapte
4954,2019,Mathematique,1,La Geometrie Analytique,1,Sur l'Utilisation de Maple,2,691,1,QROC,0.49,0.36,64.0,13,8,21,17,13,4,1.24,76.47,Moyen,Moyen,0,Meme Difficulte que la Prediction,Adapte
6020,2020,Mathematique,1,La Geometrie Analytique,1,Sur l'Utilisation de Maple,2,691,1,QROC,0.39,0.4,64.0,15,8,23,21,15,6,1.1,71.43,Moyen,Moyen,0,Meme Difficulte que la Prediction,Adapte
691,2015,Mathematique,1,La Geometrie Analytique,1,Sur l'Utilisation de Maple,2,692,2,QCU,0.51,0.39,21.0,14,53,67,52,14,38,1.29,26.92,Moyen,Difficile,-1,Plus Difficile que la Prediction,Pas Adapte
1757,2016,Mathematique,1,La Geometrie Analytique,1,Sur l'Utilisation de Maple,2,692,2,QCU,0.31,0.46,41.0,27,38,65,58,27,31,1.12,46.55,Facile,Moyen,-1,Plus Difficile que la Prediction,Pas Adapte
2823,2017,Mathematique,1,La Geometrie Analytique,1,Sur l'Utilisation de Maple,2,692,2,QCU,0.68,0.39,30.0,21,48,69,48,21,27,1.44,43.75,Difficile,Difficile,0,Meme Difficulte que la Prediction,Pas Adapte
3889,2018,Mathematique,1,La Geometrie Analytique,1,Sur l'Utilisation de Maple,2,692,2,QCU,0.7,0.25,14.0,10,62,72,59,10,49,1.22,16.95,Moyen,Difficile,-1,Plus Difficile que la Prediction,Pas Adapte
4955,2019,Mathematique,1,La Geometrie Analytique,1,Sur l'Utilisation de Maple,2,692,2,QCU,0.5,0.3,19.0,16,67,83,30,16,14,2.77,53.33,Difficile,Difficile,0,Meme Difficulte que la Prediction,Pas Adapte
6021,2020,Mathematique,1,La Geometrie Analytique,1,Sur l'Utilisation de Maple,2,692,2,QROC,0.83,0.16,33.0,30,62,92,43,30,13,2.14,69.77,Difficile,Difficile,0,Meme Difficulte que la Prediction,Pas Adapte
692,2015,Mathematique,1,La Geometrie Analytique,2,Methodes Generales pour aborder un probleme de Geometrie Analytique,12,693,1,QCU,0.36,0.7,39.0,15,23,38,37,15,22,1.03,40.54,Moyen,Moyen,0,Meme Difficulte que la Prediction,Pas Adapte
1758,2016,Mathematique,1,La Geometrie Analytique,2,Methodes Generales pour aborder un probleme de Geometrie Analytique,12,693,1,QCU,0.38,0.75,59.0,22,16,38,33,22,11,1.15,66.67,Moyen,Moyen,0,Meme Difficulte que la Prediction,Pas Adapte
2824,2017,Mathematique,1,La Geometrie Analytique,2,Methodes Generales pour aborder un probleme de Geometrie Analytique,12,693,1,QCU,0.22,0.66,63.0,24,14,38,27,24,3,1.41,88.89,Facile,Moyen,-1,Plus Difficile que la Prediction,Adapte
3890,2018,Mathematique,1,La Geometrie Analytique,2,Methodes Generales pour aborder un probleme de Geometrie Analytique,12,693,1,QCU,0.29,0.41,63.0,23,14,37,26,23,3,1.42,88.46,Moyen,Moyen,0,Meme Difficulte que la Prediction,Adapte
4956,2019,Mathematique,1,La Geometrie Analytique,2,Methodes Generales pour aborder un probleme de Geometrie Analytique,12,693,1,QCU,0.28,0.5,63.0,20,11,31,20,20,0,1.55,100.0,Moyen,Moyen,0,Meme Difficulte que la Prediction,Adapte
6022,2020,Mathematique,1,La Geometrie Analytique,2,Methodes Generales pour aborder un probleme de Geometrie Analytique,12,693,1,QCU,0.39,0.68,63.0,18,10,28,24,18,6,1.17,75.0,Moyen,Moyen,0,Meme Difficulte que la Prediction,Adapte
693,2015,Mathematique,1,La Geometrie Analytique,2,Methodes Generales pour aborder un probleme de Geometrie Analytique,12,694,2,QROC,0.94,0.25,0.0,0,35,35,22,0,22,1.59,0.0,Facile,Difficile,-2,Beaucoup plus Difficile que la Prediction,Pas Adapte
1759,2016,Mathematique,1,La Geometrie Analytique,2,Methodes Generales pour aborder un probleme de Geometrie Analytique,12,694,2,QROC,0.91,0.1,23.0,9,31,40,38,9,29,1.05,23.68,Facile,Difficile,-2,Beaucoup plus Difficile que la Prediction,Pas Adapte
2825,2017,Mathematique,1,La Geometrie Analytique,2,Methodes Generales pour aborder un probleme de Geometrie Analytique,12,694,2,QROC,0.41,0.25,52.0,19,17,36,20,19,1,1.8,95.0,Facile,Moyen,-1,Plus Difficile que la Prediction,Pas Adapte
3891,2018,Mathematique,1,La Geometrie Analytique,2,Methodes Generales pour aborder un probleme de Geometrie Analytique,12,694,2,QROC,0.91,0.02,1.0,0,33,33,30,0,30,1.1,0.0,Difficile,Difficile,0,Meme Difficulte que la Prediction,Pas Adapte
4957,2019,Mathematique,1,La Geometrie Analytique,2,Methodes Generales pour aborder un probleme de Geometrie Analytique,12,694,2,QROC,0.4,0.31,55.0,21,17,38,32,21,11,1.19,65.62,Moyen,Moyen,0,Meme Difficulte que la Prediction,Pas Adapte
6023,2020,Mathematique,1,La Geometrie Analytique,2,Methodes Generales pour aborder un probleme de Geometrie Analytique,12,694,2,QROC,0.72,0.06,27.0,10,26,36,21,10,11,1.71,47.62,Facile,Difficile,-2,Beaucoup plus Difficile que la Prediction,Pas Adapte
694,2015,Mathematique,1,La Geometrie Analytique,2,Methodes Generales pour aborder un probleme de Geometrie Analytique,12,695,3,QROC,0.55,0.35,45.0,34,41,75,71,34,37,1.06,47.89,Difficile,Moyen,1,Plus Facile que la Prediction,Pas Adapte
1760,2016,Mathematique,1,La Geometrie Analytique,2,Methodes Generales pour aborder un probleme de Geometrie Analytique,12,695,3,QROC,0.81,0.13,4.0,3,70,73,48,3,45,1.52,6.25,Moyen,Difficile,-1,Plus Difficile que la Prediction,Pas Adapte
2826,2017,Mathematique,1,La Geometrie Analytique,2,Methodes Generales pour aborder un probleme de Geometrie Analytique,12,695,3,QROC,0.06,0.89,65.0,42,23,65,49,42,7,1.33,85.71,Facile,Facile,0,Meme Difficulte que la Prediction,Adapte
3892,2018,Mathematique,1,La Geometrie Analytique,2,Methodes Generales pour aborder un probleme de Geometrie Analytique,12,695,3,QROC,0.09,0.58,65.0,39,21,60,54,39,15,1.11,72.22,Facile,Facile,0,Meme Difficulte que la Prediction,Adapte
4958,2019,Mathematique,1,La Geometrie Analytique,2,Methodes Generales pour aborder un probleme de Geometrie Analytique,12,695,3,QO,0.18,0.79,65.0,34,19,53,48,34,14,1.1,70.83,Facile,Facile,0,Meme Difficulte que la Prediction,Adapte
6024,2020,Mathematique,1,La Geometrie Analytique,2,Methodes Generales pour aborder un probleme de Geometrie Analytique,12,695,3,QO,0.15,0.61,65.0,37,20,57,38,37,1,1.5,97.37,Facile,Facile,0,Meme Difficulte que la Prediction,Adapte
695,2015,Mathematique,1,La Geometrie Analytique,2,Methodes Generales pour aborder un probleme de Geometrie Analytique,12,696,4,QCU,0.11,0.94,67.0,45,22,67,57,45,12,1.18,78.95,Difficile,Facile,2,Beaucoup plus Facile que la Prediction,Adapte
1761,2016,Mathematique,1,La Geometrie Analytique,2,Methodes Generales pour aborder un probleme de Geometrie Analytique,12,696,4,QCU,0.2,0.78,67.0,45,22,67,47,45,2,1.43,95.74,Facile,Facile,0,Meme Difficulte que la Prediction,Adapte
2827,2017,Mathematique,1,La Geometrie Analytique,2,Methodes Generales pour aborder un probleme de Geometrie Analytique,12,696,4,QCU,0.01,0.75,67.0,47,23,70,53,47,6,1.32,88.68,Facile,Facile,0,Meme Difficulte que la Prediction,Adapte
3893,2018,Mathematique,1,La Geometrie Analytique,2,Methodes Generales pour aborder un probleme de Geometrie Analytique,12,696,4,QCU,0.14,0.97,67.0,52,26,78,65,52,13,1.2,80.0,Facile,Facile,0,Meme Difficulte que la Prediction,Adapte
4959,2019,Mathematique,1,La Geometrie Analytique,2,Methodes Generales pour aborder un probleme de Geometrie Analytique,12,696,4,QCU,0.15,0.88,67.0,57,28,85,77,57,20,1.1,74.03,Facile,Facile,0,Meme Difficulte que la Prediction,Adapte
6025,2020,Mathematique,1,La Geometrie Analytique,2,Methodes Generales pour aborder un probleme de Geometrie Analytique,12,696,4,QCU,0.01,0.79,67.0,63,31,94,66,63,3,1.42,95.45,Facile,Facile,0,Meme Difficulte que la Prediction,Adapte
696,2015,Mathematique,1,La Geometrie Analytique,2,Methodes Generales pour aborder un probleme de Geometrie Analytique,12,697,5,QCU,0.15,0.96,68.0,32,15,47,41,32,9,1.15,78.05,Difficile,Facile,2,Beaucoup plus Facile que la Prediction,Adapte
1762,2016,Mathematique,1,La Geometrie Analytique,2,Methodes Generales pour aborder un probleme de Geometrie Analytique,12,697,5,QCU,0.18,0.76,68.0,35,16,51,44,35,9,1.16,79.55,Facile,Facile,0,Meme Difficulte que la Prediction,Adapte
2828,2017,Mathematique,1,La Geometrie Analytique,2,Methodes Generales pour aborder un probleme de Geometrie Analytique,12,697,5,QCU,0.06,0.77,68.0,36,17,53,43,36,7,1.23,83.72,Facile,Facile,0,Meme Difficulte que la Prediction,Adapte
3894,2018,Mathematique,1,La Geometrie Analytique,2,Methodes Generales pour aborder un probleme de Geometrie Analytique,12,697,5,QCM,0.14,0.8,68.0,37,17,54,43,37,6,1.26,86.05,Facile,Facile,0,Meme Difficulte que la Prediction,Adapte
4960,2019,Mathematique,1,La Geometrie Analytique,2,Methodes Generales pour aborder un probleme de Geometrie Analytique,12,697,5,QCM,0.09,0.85,68.0,33,16,49,35,33,2,1.4,94.29,Facile,Facile,0,Meme Difficulte que la Prediction,Adapte
6026,2020,Mathematique,1,La Geometrie Analytique,2,Methodes Generales pour aborder un probleme de Geometrie Analytique,12,697,5,QCM,0.1,0.94,68.0,29,13,42,36,29,7,1.17,80.56,Facile,Facile,0,Meme Difficulte que la Prediction,Adapte
697,2015,Mathematique,1,La Geometrie Analytique,2,Methodes Generales pour aborder un probleme de Geometrie Analytique,12,698,6,QCU,0.3,0.65,58.0,19,13,32,22,19,3,1.45,86.36,Moyen,Moyen,0,Meme Difficulte que la Prediction,Pas Adapte
1763,2016,Mathematique,1,La Geometrie Analytique,2,Methodes Generales pour aborder un probleme de Geometrie Analytique,12,698,6,QCU,0.57,0.35,20.0,7,27,34,25,7,18,1.36,28.0,Difficile,Difficile,0,Meme Difficulte que la Prediction,Pas Adapte
2829,2017,Mathematique,1,La Geometrie Analytique,2,Methodes Generales pour aborder un probleme de Geometrie Analytique,12,698,6,QCU,0.53,0.23,8.0,3,31,34,14,3,11,2.43,21.43,Difficile,Difficile,0,Meme Difficulte que la Prediction,Pas Adapte
3895,2018,Mathematique,1,La Geometrie Analytique,2,Methodes Generales pour aborder un probleme de Geometrie Analytique,12,698,6,QCU,0.66,0.26,17.0,6,30,36,28,6,22,1.29,21.43,Moyen,Difficile,-1,Plus Difficile que la Prediction,Pas Adapte
4961,2019,Mathematique,1,La Geometrie Analytique,2,Methodes Generales pour aborder un probleme de Geometrie Analytique,12,698,6,QCU,0.32,0.42,38.0,12,20,32,26,12,14,1.23,46.15,Facile,Moyen,-1,Plus Difficile que la Prediction,Pas Adapte
6027,2020,Mathematique,1,La Geometrie Analytique,2,Methodes Generales pour aborder un probleme de Geometrie Analytique,12,698,6,QCM,0.7,0.22,7.0,2,31,33,30,2,28,1.1,6.67,Facile,Difficile,-2,Beaucoup plus Difficile que la Prediction,Pas Adapte
698,2015,Mathematique,1,La Geometrie Analytique,2,Methodes Generales pour aborder un probleme de Geometrie Analytique,12,699,7,QCM,0.08,0.73,65.0,48,26,74,61,48,13,1.21,78.69,Facile,Facile,0,Meme Difficulte que la Prediction,Adapte
1764,2016,Mathematique,1,La Geometrie Analytique,2,Methodes Generales pour aborder un probleme de Geometrie Analytique,12,699,7,QCM,0.14,0.99,65.0,46,25,71,50,46,4,1.42,92.0,Facile,Facile,0,Meme Difficulte que la Prediction,Adapte
2830,2017,Mathematique,1,La Geometrie Analytique,2,Methodes Generales pour aborder un probleme de Geometrie Analytique,12,699,7,QCM,0.04,0.79,65.0,39,21,60,57,39,18,1.05,68.42,Facile,Facile,0,Meme Difficulte que la Prediction,Adapte
3896,2018,Mathematique,1,La Geometrie Analytique,2,Methodes Generales pour aborder un probleme de Geometrie Analytique,12,699,7,QCM,0.14,0.92,65.0,34,19,53,48,34,14,1.1,70.83,Facile,Facile,0,Meme Difficulte que la Prediction,Adapte
4962,2019,Mathematique,1,La Geometrie Analytique,2,Methodes Generales pour aborder un probleme de Geometrie Analytique,12,699,7,QCM,0.16,0.91,65.0,34,19,53,52,34,18,1.02,65.38,Facile,Facile,0,Meme Difficulte que la Prediction,Adapte
6028,2020,Mathematique,1,La Geometrie Analytique,2,Methodes Generales pour aborder un probleme de Geometrie Analytique,12,699,7,QCM,0.13,0.91,65.0,38,20,58,54,38,16,1.07,70.37,Facile,Facile,0,Meme Difficulte que la Prediction,Adapte
699,2015,Mathematique,1,La Geometrie Analytique,2,Methodes Generales pour aborder un probleme de Geometrie Analytique,12,700,8,QCU,0.54,0.34,20.0,12,46,58,33,12,21,1.76,36.36,Difficile,Difficile,0,Meme Difficulte que la Prediction,Pas Adapte
1765,2016,Mathematique,1,La Geometrie Analytique,2,Methodes Generales pour aborder un probleme de Geometrie Analytique,12,700,8,QCU,0.62,0.23,25.0,12,38,50,39,12,27,1.28,30.77,Difficile,Difficile,0,Meme Difficulte que la Prediction,Pas Adapte
2831,2017,Mathematique,1,La Geometrie Analytique,2,Methodes Generales pour aborder un probleme de Geometrie Analytique,12,700,8,QCU,0.14,0.78,68.0,38,18,56,49,38,11,1.14,77.55,Moyen,Facile,1,Plus Facile que la Prediction,Adapte
3897,2018,Mathematique,1,La Geometrie Analytique,2,Methodes Generales pour aborder un probleme de Geometrie Analytique,12,700,8,QCU,0.19,0.79,68.0,33,15,48,47,33,14,1.02,70.21,Facile,Facile,0,Meme Difficulte que la Prediction,Adapte
4963,2019,Mathematique,1,La Geometrie Analytique,2,Methodes Generales pour aborder un probleme de Geometrie Analytique,12,700,8,QCU,0.0,0.77,68.0,37,18,55,52,37,15,1.06,71.15,Facile,Facile,0,Meme Difficulte que la Prediction,Adapte
6029,2020,Mathematique,1,La Geometrie Analytique,2,Methodes Generales pour aborder un probleme de Geometrie Analytique,12,700,8,QCU,0.05,0.95,68.0,37,17,54,46,37,9,1.17,80.43,Facile,Facile,0,Meme Difficulte que la Prediction,Adapte
700,2015,Mathematique,1,La Geometrie Analytique,2,Methodes Generales pour aborder un probleme de Geometrie Analytique,12,701,9,QCM,0.76,0.25,32.0,18,38,56,26,18,8,2.15,69.23,Difficile,Difficile,0,Meme Difficulte que la Prediction,Pas Adapte
1766,2016,Mathematique,1,La Geometrie Analytique,2,Methodes Generales pour aborder un probleme de Geometrie Analytique,12,701,9,QCM,0.71,0.22,22.0,12,43,55,18,12,6,3.06,66.67,Facile,Difficile,-2,Beaucoup plus Difficile que la Prediction,Pas Adapte
2832,2017,Mathematique,1,La Geometrie Analytique,2,Methodes Generales pour aborder un probleme de Geometrie Analytique,12,701,9,QCU,0.48,0.21,7.0,4,47,51,50,4,46,1.02,8.0,Difficile,Difficile,0,Meme Difficulte que la Prediction,Pas Adapte
3898,2018,Mathematique,1,La Geometrie Analytique,2,Methodes Generales pour aborder un probleme de Geometrie Analytique,12,701,9,QCU,0.54,0.27,11.0,5,39,44,15,5,10,2.93,33.33,Facile,Difficile,-2,Beaucoup plus Difficile que la Prediction,Pas Adapte
4964,2019,Mathematique,1,La Geometrie Analytique,2,Methodes Generales pour aborder un probleme de Geometrie Analytique,12,701,9,QCU,0.43,0.35,29.0,12,28,40,14,12,2,2.86,85.71,Moyen,Difficile,-1,Plus Difficile que la Prediction,Pas Adapte
6030,2020,Mathematique,1,La Geometrie Analytique,2,Methodes Generales pour aborder un probleme de Geometrie Analytique,12,701,9,QCU,0.45,0.24,28.0,12,30,42,16,12,4,2.62,75.0,Facile,Difficile,-2,Beaucoup plus Difficile que la Prediction,Pas Adapte
701,2015,Mathematique,1,La Geometrie Analytique,2,Methodes Generales pour aborder un probleme de Geometrie Analytique,12,702,10,QCU,0.21,0.69,43.0,30,40,70,33,30,3,2.12,90.91,Facile,Moyen,-1,Plus Difficile que la Prediction,Pas Adapte
1767,2016,Mathematique,1,La Geometrie Analytique,2,Methodes Generales pour aborder un probleme de Geometrie Analytique,12,702,10,QCU,0.46,0.24,9.0,7,72,79,71,7,64,1.11,9.86,Moyen,Difficile,-1,Plus Difficile que la Prediction,Pas Adapte
2833,2017,Mathematique,1,La Geometrie Analytique,2,Methodes Generales pour aborder un probleme de Geometrie Analytique,12,702,10,QCU,0.38,0.7,37.0,27,45,72,33,27,6,2.18,81.82,Difficile,Moyen,1,Plus Facile que la Prediction,Pas Adapte
3899,2018,Mathematique,1,La Geometrie Analytique,2,Methodes Generales pour aborder un probleme de Geometrie Analytique,12,702,10,QCU,0.42,0.23,10.0,6,56,62,46,6,40,1.35,13.04,Facile,Difficile,-2,Beaucoup plus Difficile que la Prediction,Pas Adapte
4965,2019,Mathematique,1,La Geometrie Analytique,2,Methodes Generales pour aborder un probleme de Geometrie Analytique,12,702,10,QCM,0.57,0.19,31.0,16,37,53,32,16,16,1.66,50.0,Difficile,Difficile,0,Meme Difficulte que la Prediction,Pas Adapte
6031,2020,Mathematique,1,La Geometrie Analytique,2,Methodes Generales pour aborder un probleme de Geometrie Analytique,12,702,10,QCM,0.73,0.3,18.0,9,40,49,44,9,35,1.11,20.45,Facile,Difficile,-2,Beaucoup plus Difficile que la Prediction,Pas Adapte
702,2015,Mathematique,1,La Geometrie Analytique,2,Methodes Generales pour aborder un probleme de Geometrie Analytique,12,703,11,QCM,0.39,0.56,49.0,39,40,79,64,39,25,1.23,60.94,Moyen,Moyen,0,Meme Difficulte que la Prediction,Pas Adapte
1768,2016,Mathematique,1,La Geometrie Analytique,2,Methodes Generales pour aborder un probleme de Geometrie Analytique,12,703,11,QCM,0.09,0.73,65.0,49,26,75,69,49,20,1.09,71.01,Difficile,Facile,2,Beaucoup plus Facile que la Prediction,Adapte
2834,2017,Mathematique,1,La Geometrie Analytique,2,Methodes Generales pour aborder un probleme de Geometrie Analytique,12,703,11,QCM,0.09,0.89,65.0,49,27,76,72,49,23,1.06,68.06,Facile,Facile,0,Meme Difficulte que la Prediction,Adapte
3900,2018,Mathematique,1,La Geometrie Analytique,2,Methodes Generales pour aborder un probleme de Geometrie Analytique,12,703,11,QCM,0.05,0.71,65.0,47,26,73,59,47,12,1.24,79.66,Facile,Facile,0,Meme Difficulte que la Prediction,Adapte
4966,2019,Mathematique,1,La Geometrie Analytique,2,Methodes Generales pour aborder un probleme de Geometrie Analytique,12,703,11,QCU,0.12,0.93,65.0,47,26,73,50,47,3,1.46,94.0,Facile,Facile,0,Meme Difficulte que la Prediction,Adapte
6032,2020,Mathematique,1,La Geometrie Analytique,2,Methodes Generales pour aborder un probleme de Geometrie Analytique,12,703,11,QCU,0.11,0.85,65.0,45,24,69,58,45,13,1.19,77.59,Facile,Facile,0,Meme Difficulte que la Prediction,Adapte
703,2015,Mathematique,1,La Geometrie Analytique,2,Methodes Generales pour aborder un probleme de Geometrie Analytique,12,704,12,QCU,0.05,0.98,67.0,31,15,46,35,31,4,1.31,88.57,Moyen,Facile,1,Plus Facile que la Prediction,Adapte
1769,2016,Mathematique,1,La Geometrie Analytique,2,Methodes Generales pour aborder un probleme de Geometrie Analytique,12,704,12,QCU,0.12,0.89,67.0,36,17,53,45,36,9,1.18,80.0,Facile,Facile,0,Meme Difficulte que la Prediction,Adapte
2835,2017,Mathematique,1,La Geometrie Analytique,2,Methodes Generales pour aborder un probleme de Geometrie Analytique,12,704,12,QCU,0.08,0.99,67.0,31,16,47,35,31,4,1.34,88.57,Facile,Facile,0,Meme Difficulte que la Prediction,Adapte
3901,2018,Mathematique,1,La Geometrie Analytique,2,Methodes Generales pour aborder un probleme de Geometrie Analytique,12,704,12,QCU,0.06,0.98,67.0,29,15,44,34,29,5,1.29,85.29,Facile,Facile,0,Meme Difficulte que la Prediction,Adapte
4967,2019,Mathematique,1,La Geometrie Analytique,2,Methodes Generales pour aborder un probleme de Geometrie Analytique,12,704,12,QCU,0.1,0.95,67.0,33,16,49,46,33,13,1.07,71.74,Facile,Facile,0,Meme Difficulte que la Prediction,Adapte
6033,2020,Mathematique,1,La Geometrie Analytique,2,Methodes Generales pour aborder un probleme de Geometrie Analytique,12,704,12,QCU,0.2,0.9,67.0,34,17,51,41,34,7,1.24,82.93,Facile,Facile,0,Meme Difficulte que la Prediction,Adapte
704,2015,Mathematique,1,La Geometrie Analytique,3,Geometrie Plane,1,705,1,QCU,0.72,0.38,18.0,17,78,95,69,17,52,1.38,24.64,Facile,Difficile,-2,Beaucoup plus Difficile que la Prediction,Pas Adapte
1770,2016,Mathematique,1,La Geometrie Analytique,3,Geometrie Plane,1,705,1,QCU,0.55,0.32,32.0,26,55,81,42,26,16,1.93,61.9,Difficile,Difficile,0,Meme Difficulte que la Prediction,Pas Adapte
2836,2017,Mathematique,1,La Geometrie Analytique,3,Geometrie Plane,1,705,1,QCU,0.52,0.3,1.0,1,86,87,85,1,84,1.02,1.18,Difficile,Difficile,0,Meme Difficulte que la Prediction,Pas Adapte
3902,2018,Mathematique,1,La Geometrie Analytique,3,Geometrie Plane,1,705,1,QCM,0.71,0.24,35.0,32,60,92,36,32,4,2.56,88.89,Moyen,Difficile,-1,Plus Difficile que la Prediction,Pas Adapte
4968,2019,Mathematique,1,La Geometrie Analytique,3,Geometrie Plane,1,705,1,QCM,0.22,0.67,38.0,36,59,95,87,36,51,1.09,41.38,Moyen,Moyen,0,Meme Difficulte que la Prediction,Pas Adapte
6034,2020,Mathematique,1,La Geometrie Analytique,3,Geometrie Plane,1,705,1,QCM,0.27,0.44,57.0,48,36,84,78,48,30,1.08,61.54,Difficile,Moyen,1,Plus Facile que la Prediction,Pas Adapte
705,2015,Philosophie,1,Introduction a la Philosophie,1,La Nature,7,706,1,QROC,0.45,0.38,52.93,14,13,27,22,14,8,1.23,63.64,Moyen,Moyen,0,Meme Difficulte que la Prediction,Pas Adapte
1771,2016,Philosophie,1,Introduction a la Philosophie,1,La Nature,7,706,1,QROC,0.33,0.38,62.99,15,9,24,21,15,6,1.14,71.43,Moyen,Moyen,0,Meme Difficulte que la Prediction,Adapte
2837,2017,Philosophie,1,Introduction a la Philosophie,1,La Nature,7,706,1,QROC,0.21,0.35,62.99,14,9,23,22,14,8,1.05,63.64,Moyen,Moyen,0,Meme Difficulte que la Prediction,Adapte
3903,2018,Philosophie,1,Introduction a la Philosophie,1,La Nature,7,706,1,QROC,0.58,0.27,62.99,16,9,25,24,16,8,1.04,66.67,Moyen,Moyen,0,Meme Difficulte que la Prediction,Adapte
4969,2019,Philosophie,1,Introduction a la Philosophie,1,La Nature,7,706,1,QROC,0.26,0.28,62.99,15,9,24,17,15,2,1.41,88.24,Moyen,Moyen,0,Meme Difficulte que la Prediction,Adapte
6035,2020,Philosophie,1,Introduction a la Philosophie,1,La Nature,7,706,1,QCU,0.24,0.44,62.99,14,8,22,14,14,0,1.57,100.0,Moyen,Moyen,0,Meme Difficulte que la Prediction,Adapte
706,2015,Philosophie,1,Introduction a la Philosophie,1,La Nature,7,707,2,QCM,0.49,0.67,46.25,45,52,97,59,45,14,1.64,76.27,Facile,Moyen,-1,Plus Difficile que la Prediction,Pas Adapte
1772,2016,Philosophie,1,Introduction a la Philosophie,1,La Nature,7,707,2,QCM,0.5,0.16,9.47,10,92,102,95,10,85,1.07,10.53,Moyen,Difficile,-1,Plus Difficile que la Prediction,Pas Adapte
2838,2017,Philosophie,1,Introduction a la Philosophie,1,La Nature,7,707,2,QCM,0.68,0.28,0.48,0,97,97,31,0,31,3.13,0.0,Difficile,Difficile,0,Meme Difficulte que la Prediction,Pas Adapte
3904,2018,Philosophie,1,Introduction a la Philosophie,1,La Nature,7,707,2,QCM,0.53,0.24,30.8,29,64,93,78,29,49,1.19,37.18,Difficile,Difficile,0,Meme Difficulte que la Prediction,Pas Adapte
4970,2019,Philosophie,1,Introduction a la Philosophie,1,La Nature,7,707,2,QCM,0.34,0.32,60.77,55,36,91,62,55,7,1.47,88.71,Moyen,Moyen,0,Meme Difficulte que la Prediction,Adapte
6036,2020,Philosophie,1,Introduction a la Philosophie,1,La Nature,7,707,2,QCM,0.38,0.58,60.77,60,38,98,76,60,16,1.29,78.95,Moyen,Moyen,0,Meme Difficulte que la Prediction,Adapte
707,2015,Philosophie,1,Introduction a la Philosophie,1,La Nature,7,708,3,QCM,0.39,0.4,56.79,53,41,94,64,53,11,1.47,82.81,Difficile,Moyen,1,Plus Facile que la Prediction,Pas Adapte
1773,2016,Philosophie,1,Introduction a la Philosophie,1,La Nature,7,708,3,QCU,0.14,0.88,93.17,95,7,102,102,95,7,1.0,93.14,Difficile,Facile,2,Beaucoup plus Facile que la Prediction,Pas Adapte
2839,2017,Philosophie,1,Introduction a la Philosophie,1,La Nature,7,708,3,QCU,0.65,0.38,11.11,11,85,96,48,11,37,2.0,22.92,Difficile,Difficile,0,Meme Difficulte que la Prediction,Pas Adapte
3905,2018,Philosophie,1,Introduction a la Philosophie,1,La Nature,7,708,3,QCU,0.39,0.43,35.3,30,55,85,41,30,11,2.07,73.17,Moyen,Moyen,0,Meme Difficulte que la Prediction,Pas Adapte
4971,2019,Philosophie,1,Introduction a la Philosophie,1,La Nature,7,708,3,QCM,0.72,0.22,16.18,13,65,78,62,13,49,1.26,20.97,Difficile,Difficile,0,Meme Difficulte que la Prediction,Pas Adapte
6037,2020,Philosophie,1,Introduction a la Philosophie,1,La Nature,7,708,3,QCM,0.4,0.3,53.71,36,31,67,38,36,2,1.76,94.74,Moyen,Moyen,0,Meme Difficulte que la Prediction,Pas Adapte
708,2015,Philosophie,1,Introduction a la Philosophie,1,La Nature,7,709,4,QCM,0.08,0.72,98.72,92,1,93,93,92,1,1.0,98.92,Difficile,Facile,2,Beaucoup plus Facile que la Prediction,Pas Adapte
1774,2016,Philosophie,1,Introduction a la Philosophie,1,La Nature,7,709,4,QCM,0.27,0.66,43.97,35,45,80,52,35,17,1.54,67.31,Moyen,Moyen,0,Meme Difficulte que la Prediction,Pas Adapte
2840,2017,Philosophie,1,Introduction a la Philosophie,1,La Nature,7,709,4,QCM,0.55,0.27,33.13,27,56,83,73,27,46,1.14,36.99,Difficile,Difficile,0,Meme Difficulte que la Prediction,Pas Adapte
3906,2018,Philosophie,1,Introduction a la Philosophie,1,La Nature,7,709,4,QCM,0.63,0.19,0.52,0,80,80,47,0,47,1.7,0.0,Facile,Difficile,-2,Beaucoup plus Difficile que la Prediction,Pas Adapte
4972,2019,Philosophie,1,Introduction a la Philosophie,1,La Nature,7,709,4,QO,0.14,0.68,79.34,69,18,87,75,69,6,1.16,92.0,Difficile,Facile,2,Beaucoup plus Facile que la Prediction,Pas Adapte
6038,2020,Philosophie,1,Introduction a la Philosophie,1,La Nature,7,709,4,QO,0.01,0.97,74.29,61,21,82,65,61,4,1.26,93.85,Facile,Facile,0,Meme Difficulte que la Prediction,Adapte
709,2015,Philosophie,1,Introduction a la Philosophie,1,La Nature,7,710,5,QCM,0.17,0.87,68.45,33,15,48,41,33,8,1.17,80.49,Facile,Facile,0,Meme Difficulte que la Prediction,Adapte
1775,2016,Philosophie,1,Introduction a la Philosophie,1,La Nature,7,710,5,QCM,0.15,0.93,68.45,29,13,42,33,29,4,1.27,87.88,Facile,Facile,0,Meme Difficulte que la Prediction,Adapte
2841,2017,Philosophie,1,Introduction a la Philosophie,1,La Nature,7,710,5,QCM,0.1,0.71,68.45,26,12,38,37,26,11,1.03,70.27,Facile,Facile,0,Meme Difficulte que la Prediction,Adapte
3907,2018,Philosophie,1,Introduction a la Philosophie,1,La Nature,7,710,5,QCM,0.1,0.84,68.45,24,11,35,26,24,2,1.35,92.31,Facile,Facile,0,Meme Difficulte que la Prediction,Adapte
4973,2019,Philosophie,1,Introduction a la Philosophie,1,La Nature,7,710,5,QCM,0.16,0.86,68.45,24,11,35,26,24,2,1.35,92.31,Facile,Facile,0,Meme Difficulte que la Prediction,Adapte
6039,2020,Philosophie,1,Introduction a la Philosophie,1,La Nature,7,710,5,QCM,0.2,0.71,68.45,23,11,34,23,23,0,1.48,100.0,Facile,Facile,0,Meme Difficulte que la Prediction,Adapte
710,2015,Philosophie,1,Introduction a la Philosophie,1,La Nature,7,711,6,QROC,0.06,0.49,74.29,44,15,59,47,44,3,1.26,93.62,Difficile,Facile,2,Beaucoup plus Facile que la Prediction,Adapte
1776,2016,Philosophie,1,Introduction a la Philosophie,1,La Nature,7,711,6,QROC,0.12,0.53,74.29,40,14,54,44,40,4,1.23,90.91,Facile,Facile,0,Meme Difficulte que la Prediction,Adapte
2842,2017,Philosophie,1,Introduction a la Philosophie,1,La Nature,7,711,6,QROC,0.14,0.81,74.29,46,16,62,47,46,1,1.32,97.87,Facile,Facile,0,Meme Difficulte que la Prediction,Adapte
3908,2018,Philosophie,1,Introduction a la Philosophie,1,La Nature,7,711,6,QROC,0.18,0.68,74.29,49,17,66,60,49,11,1.1,81.67,Facile,Facile,0,Meme Difficulte que la Prediction,Adapte
4974,2019,Philosophie,1,Introduction a la Philosophie,1,La Nature,7,711,6,QROC,0.17,0.56,74.29,54,19,73,58,54,4,1.26,93.1,Facile,Facile,0,Meme Difficulte que la Prediction,Adapte
6040,2020,Philosophie,1,Introduction a la Philosophie,1,La Nature,7,711,6,QROC,0.02,0.96,74.29,48,16,64,55,48,7,1.16,87.27,Facile,Facile,0,Meme Difficulte que la Prediction,Adapte
711,2015,Philosophie,1,Introduction a la Philosophie,1,La Nature,7,712,7,QCM,0.61,0.2,30.54,4,8,12,7,4,3,1.71,57.14,Difficile,Difficile,0,Meme Difficulte que la Prediction,Pas Adapte
1777,2016,Philosophie,1,Introduction a la Philosophie,1,La Nature,7,712,7,QCM,0.24,0.34,35.83,4,8,12,9,4,5,1.33,44.44,Difficile,Moyen,1,Plus Facile que la Prediction,Pas Adapte
2843,2017,Philosophie,1,Introduction a la Philosophie,1,La Nature,7,712,7,QROC,0.99,0.04,4.13,0,10,10,4,0,4,2.5,0.0,Facile,Difficile,-2,Beaucoup plus Difficile que la Prediction,Pas Adapte
3909,2018,Philosophie,1,Introduction a la Philosophie,1,La Nature,7,712,7,QROC,0.26,0.25,38.06,5,7,12,9,5,4,1.33,55.56,Moyen,Moyen,0,Meme Difficulte que la Prediction,Pas Adapte
4975,2019,Philosophie,1,Introduction a la Philosophie,1,La Nature,7,712,7,QROC,0.93,0.15,29.33,4,9,13,7,4,3,1.86,57.14,Facile,Difficile,-2,Beaucoup plus Difficile que la Prediction,Pas Adapte
6041,2020,Philosophie,1,Introduction a la Philosophie,1,La Nature,7,712,7,QO,0.1,0.8,67.86,9,5,14,10,9,1,1.4,90.0,Facile,Facile,0,Meme Difficulte que la Prediction,Adapte
712,2015,Philosophie,1,Introduction a la Philosophie,2,La Technique,13,713,1,QCM,0.72,0.29,3.24,0,10,10,9,0,9,1.11,0.0,Difficile,Difficile,0,Meme Difficulte que la Prediction,Pas Adapte
1778,2016,Philosophie,1,Introduction a la Philosophie,2,La Technique,13,713,1,QCM,0.23,0.5,47.95,5,6,11,7,5,2,1.57,71.43,Facile,Moyen,-1,Plus Difficile que la Prediction,Pas Adapte
2844,2017,Philosophie,1,Introduction a la Philosophie,2,La Technique,13,713,1,QCM,0.72,0.28,11.71,1,11,12,6,1,5,2.0,16.67,Difficile,Difficile,0,Meme Difficulte que la Prediction,Pas Adapte
3910,2018,Philosophie,1,Introduction a la Philosophie,2,La Technique,13,713,1,QCM,0.25,0.53,46.2,5,5,10,6,5,1,1.67,83.33,Difficile,Moyen,1,Plus Facile que la Prediction,Pas Adapte
4976,2019,Philosophie,1,Introduction a la Philosophie,2,La Technique,13,713,1,QCM,0.54,0.15,32.46,4,8,12,10,4,6,1.2,40.0,Difficile,Difficile,0,Meme Difficulte que la Prediction,Pas Adapte
6042,2020,Philosophie,1,Introduction a la Philosophie,2,La Technique,13,713,1,QCM,0.05,0.87,67.1,7,3,10,9,7,2,1.11,77.78,Facile,Facile,0,Meme Difficulte que la Prediction,Adapte
713,2015,Philosophie,1,Introduction a la Philosophie,2,La Technique,13,714,2,QCU,0.74,0.27,7.33,4,53,57,21,4,17,2.71,19.05,Difficile,Difficile,0,Meme Difficulte que la Prediction,Pas Adapte
1779,2016,Philosophie,1,Introduction a la Philosophie,2,La Technique,13,714,2,QCU,0.12,0.98,96.98,61,2,63,61,61,0,1.03,100.0,Facile,Facile,0,Meme Difficulte que la Prediction,Pas Adapte
2845,2017,Philosophie,1,Introduction a la Philosophie,2,La Technique,13,714,2,QCU,0.3,0.6,59.66,39,26,65,42,39,3,1.55,92.86,Difficile,Moyen,1,Plus Facile que la Prediction,Pas Adapte
3911,2018,Philosophie,1,Introduction a la Philosophie,2,La Technique,13,714,2,QCU,0.11,0.79,80.61,57,14,71,58,57,1,1.22,98.28,Facile,Facile,0,Meme Difficulte que la Prediction,Pas Adapte
4977,2019,Philosophie,1,Introduction a la Philosophie,2,La Technique,13,714,2,QCU,0.58,0.36,1.62,1,61,62,53,1,52,1.17,1.89,Difficile,Difficile,0,Meme Difficulte que la Prediction,Pas Adapte
6043,2020,Philosophie,1,Introduction a la Philosophie,2,La Technique,13,714,2,QCU,0.07,0.94,79.5,46,12,58,47,46,1,1.23,97.87,Facile,Facile,0,Meme Difficulte que la Prediction,Pas Adapte
714,2015,Philosophie,1,Introduction a la Philosophie,2,La Technique,13,715,3,QCM,0.12,0.95,74.35,48,17,65,57,48,9,1.14,84.21,Moyen,Facile,1,Plus Facile que la Prediction,Adapte
1780,2016,Philosophie,1,Introduction a la Philosophie,2,La Technique,13,715,3,QCM,0.14,0.82,74.35,44,15,59,56,44,12,1.05,78.57,Facile,Facile,0,Meme Difficulte que la Prediction,Adapte
2846,2017,Philosophie,1,Introduction a la Philosophie,2,La Technique,13,715,3,QCM,0.11,0.84,74.35,47,16,63,63,47,16,1.0,74.6,Facile,Facile,0,Meme Difficulte que la Prediction,Adapte
3912,2018,Philosophie,1,Introduction a la Philosophie,2,La Technique,13,715,3,QCM,0.07,0.87,74.35,45,16,61,61,45,16,1.0,73.77,Facile,Facile,0,Meme Difficulte que la Prediction,Adapte
4978,2019,Philosophie,1,Introduction a la Philosophie,2,La Technique,13,715,3,QCM,0.09,0.85,74.35,51,17,68,61,51,10,1.11,83.61,Facile,Facile,0,Meme Difficulte que la Prediction,Adapte
6044,2020,Philosophie,1,Introduction a la Philosophie,2,La Technique,13,715,3,QCM,0.04,0.91,74.35,45,15,60,47,45,2,1.28,95.74,Facile,Facile,0,Meme Difficulte que la Prediction,Adapte
715,2015,Philosophie,1,Introduction a la Philosophie,2,La Technique,13,716,4,QCU,0.0,0.95,80.51,6,1,7,6,6,0,1.17,100.0,Facile,Facile,0,Meme Difficulte que la Prediction,Pas Adapte
1781,2016,Philosophie,1,Introduction a la Philosophie,2,La Technique,13,716,4,QCU,0.05,0.99,90.77,5,1,6,6,5,1,1.0,83.33,Facile,Facile,0,Meme Difficulte que la Prediction,Pas Adapte
2847,2017,Philosophie,1,Introduction a la Philosophie,2,La Technique,13,716,4,QCU,0.49,0.22,32.05,2,3,5,3,2,1,1.67,66.67,Difficile,Difficile,0,Meme Difficulte que la Prediction,Pas Adapte
3913,2018,Philosophie,1,Introduction a la Philosophie,2,La Technique,13,716,4,QROC,0.83,0.19,29.57,1,3,4,3,1,2,1.33,33.33,Difficile,Difficile,0,Meme Difficulte que la Prediction,Pas Adapte
4979,2019,Philosophie,1,Introduction a la Philosophie,2,La Technique,13,716,4,QROC,0.74,0.05,33.92,2,3,5,4,2,2,1.25,50.0,Difficile,Difficile,0,Meme Difficulte que la Prediction,Pas Adapte
6045,2020,Philosophie,1,Introduction a la Philosophie,2,La Technique,13,716,4,QROC,0.06,0.99,95.68,5,0,5,5,5,0,1.0,100.0,Facile,Facile,0,Meme Difficulte que la Prediction,Pas Adapte
716,2015,Philosophie,1,Introduction a la Philosophie,2,La Technique,13,717,5,QCU,0.28,0.52,40.41,27,39,66,48,27,21,1.38,56.25,Moyen,Moyen,0,Meme Difficulte que la Prediction,Pas Adapte
1782,2016,Philosophie,1,Introduction a la Philosophie,2,La Technique,13,717,5,QCU,0.04,0.77,78.39,60,16,76,71,60,11,1.07,84.51,Difficile,Facile,2,Beaucoup plus Facile que la Prediction,Pas Adapte
2848,2017,Philosophie,1,Introduction a la Philosophie,2,La Technique,13,717,5,QCU,0.62,0.37,1.43,1,74,75,53,1,52,1.42,1.89,Facile,Difficile,-2,Beaucoup plus Difficile que la Prediction,Pas Adapte
3914,2018,Philosophie,1,Introduction a la Philosophie,2,La Technique,13,717,5,QCM,0.18,0.94,69.85,48,21,69,64,48,16,1.08,75.0,Facile,Facile,0,Meme Difficulte que la Prediction,Adapte
4980,2019,Philosophie,1,Introduction a la Philosophie,2,La Technique,13,717,5,QCM,0.05,0.8,69.85,54,23,77,65,54,11,1.18,83.08,Facile,Facile,0,Meme Difficulte que la Prediction,Adapte
6046,2020,Philosophie,1,Introduction a la Philosophie,2,La Technique,13,717,5,QCM,0.11,0.97,69.85,54,24,78,60,54,6,1.3,90.0,Facile,Facile,0,Meme Difficulte que la Prediction,Adapte
717,2015,Philosophie,1,Introduction a la Philosophie,2,La Technique,13,718,6,QCU,0.15,0.77,88.11,84,11,95,91,84,7,1.04,92.31,Facile,Facile,0,Meme Difficulte que la Prediction,Pas Adapte
1783,2016,Philosophie,1,Introduction a la Philosophie,2,La Technique,13,718,6,QCU,0.53,0.27,30.77,31,70,101,96,31,65,1.05,32.29,Facile,Difficile,-2,Beaucoup plus Difficile que la Prediction,Pas Adapte
2849,2017,Philosophie,1,Introduction a la Philosophie,2,La Technique,13,718,6,QCU,0.17,0.83,78.12,77,22,99,89,77,12,1.11,86.52,Facile,Facile,0,Meme Difficulte que la Prediction,Pas Adapte
3915,2018,Philosophie,1,Introduction a la Philosophie,2,La Technique,13,718,6,QCM,0.28,0.42,64.47,60,33,93,73,60,13,1.27,82.19,Facile,Moyen,-1,Plus Difficile que la Prediction,Adapte
4981,2019,Philosophie,1,Introduction a la Philosophie,2,La Technique,13,718,6,QCM,0.35,0.6,64.47,56,31,87,80,56,24,1.09,70.0,Moyen,Moyen,0,Meme Difficulte que la Prediction,Adapte
6047,2020,Philosophie,1,Introduction a la Philosophie,2,La Technique,13,718,6,QCM,0.35,0.52,64.47,49,27,76,65,49,16,1.17,75.38,Moyen,Moyen,0,Meme Difficulte que la Prediction,Adapte
718,2015,Philosophie,1,Introduction a la Philosophie,2,La Technique,13,719,7,QCM,0.09,0.75,99.07,13,0,13,13,13,0,1.0,100.0,Difficile,Facile,2,Beaucoup plus Facile que la Prediction,Pas Adapte
1784,2016,Philosophie,1,Introduction a la Philosophie,2,La Technique,13,719,7,QCM,0.75,0.24,14.76,2,12,14,11,2,9,1.27,18.18,Facile,Difficile,-2,Beaucoup plus Difficile que la Prediction,Pas Adapte
2850,2017,Philosophie,1,Introduction a la Philosophie,2,La Technique,13,719,7,QCM,0.33,0.32,61.08,8,5,13,9,8,1,1.44,88.89,Difficile,Moyen,1,Plus Facile que la Prediction,Adapte
3916,2018,Philosophie,1,Introduction a la Philosophie,2,La Technique,13,719,7,QCM,0.34,0.35,61.08,7,5,12,8,7,1,1.5,87.5,Moyen,Moyen,0,Meme Difficulte que la Prediction,Adapte
4982,2019,Philosophie,1,Introduction a la Philosophie,2,La Technique,13,719,7,QCM,0.32,0.39,61.08,7,5,12,10,7,3,1.2,70.0,Moyen,Moyen,0,Meme Difficulte que la Prediction,Adapte
6048,2020,Philosophie,1,Introduction a la Philosophie,2,La Technique,13,719,7,QCM,0.46,0.33,61.08,6,4,10,9,6,3,1.11,66.67,Moyen,Moyen,0,Meme Difficulte que la Prediction,Adapte
719,2015,Philosophie,1,Introduction a la Philosophie,2,La Technique,13,720,8,QCU,0.21,0.64,43.71,16,21,37,33,16,17,1.12,48.48,Moyen,Moyen,0,Meme Difficulte que la Prediction,Pas Adapte
1785,2016,Philosophie,1,Introduction a la Philosophie,2,La Technique,13,720,8,QCU,0.38,0.56,60.49,22,15,37,30,22,8,1.23,73.33,Moyen,Moyen,0,Meme Difficulte que la Prediction,Adapte
2851,2017,Philosophie,1,Introduction a la Philosophie,2,La Technique,13,720,8,QCU,0.31,0.55,60.49,21,13,34,27,21,6,1.26,77.78,Moyen,Moyen,0,Meme Difficulte que la Prediction,Adapte
3917,2018,Philosophie,1,Introduction a la Philosophie,2,La Technique,13,720,8,QCU,0.32,0.57,60.49,22,15,37,33,22,11,1.12,66.67,Moyen,Moyen,0,Meme Difficulte que la Prediction,Adapte
4983,2019,Philosophie,1,Introduction a la Philosophie,2,La Technique,13,720,8,QCU,0.29,0.65,60.49,21,13,34,27,21,6,1.26,77.78,Moyen,Moyen,0,Meme Difficulte que la Prediction,Adapte
6049,2020,Philosophie,1,Introduction a la Philosophie,2,La Technique,13,720,8,QCU,0.27,0.74,60.49,24,15,39,27,24,3,1.44,88.89,Moyen,Moyen,0,Meme Difficulte que la Prediction,Adapte
720,2015,Philosophie,1,Introduction a la Philosophie,2,La Technique,13,721,9,QO,0.08,0.6,73.32,59,22,81,60,59,1,1.35,98.33,Facile,Facile,0,Meme Difficulte que la Prediction,Adapte
1786,2016,Philosophie,1,Introduction a la Philosophie,2,La Technique,13,721,9,QO,0.11,0.34,73.32,51,19,70,65,51,14,1.08,78.46,Facile,Facile,0,Meme Difficulte que la Prediction,Adapte
2852,2017,Philosophie,1,Introduction a la Philosophie,2,La Technique,13,721,9,QO,0.1,0.32,73.32,48,18,66,58,48,10,1.14,82.76,Facile,Facile,0,Meme Difficulte que la Prediction,Adapte
3918,2018,Philosophie,1,Introduction a la Philosophie,2,La Technique,13,721,9,QO,0.08,0.96,73.32,50,18,68,67,50,17,1.01,74.63,Facile,Facile,0,Meme Difficulte que la Prediction,Adapte
4984,2019,Philosophie,1,Introduction a la Philosophie,2,La Technique,13,721,9,QO,0.08,0.32,73.32,56,20,76,68,56,12,1.12,82.35,Facile,Facile,0,Meme Difficulte que la Prediction,Adapte
6050,2020,Philosophie,1,Introduction a la Philosophie,2,La Technique,13,721,9,QO,0.18,0.8,73.32,53,19,72,63,53,10,1.14,84.13,Facile,Facile,0,Meme Difficulte que la Prediction,Adapte
721,2015,Philosophie,1,Introduction a la Philosophie,2,La Technique,13,722,10,QCU,0.13,0.82,91.02,47,5,52,48,47,1,1.08,97.92,Facile,Facile,0,Meme Difficulte que la Prediction,Pas Adapte
1787,2016,Philosophie,1,Introduction a la Philosophie,2,La Technique,13,722,10,QCU,0.06,0.97,87.83,40,6,46,43,40,3,1.07,93.02,Facile,Facile,0,Meme Difficulte que la Prediction,Pas Adapte
2853,2017,Philosophie,1,Introduction a la Philosophie,2,La Technique,13,722,10,QCU,0.54,0.35,0.48,0,39,39,25,0,25,1.56,0.0,Facile,Difficile,-2,Beaucoup plus Difficile que la Prediction,Pas Adapte
3919,2018,Philosophie,1,Introduction a la Philosophie,2,La Technique,13,722,10,QCU,0.39,0.46,41.9,16,23,39,21,16,5,1.86,76.19,Moyen,Moyen,0,Meme Difficulte que la Prediction,Pas Adapte
4985,2019,Philosophie,1,Introduction a la Philosophie,2,La Technique,13,722,10,QCM,0.32,0.66,44.9,16,19,35,27,16,11,1.3,59.26,Moyen,Moyen,0,Meme Difficulte que la Prediction,Pas Adapte
6051,2020,Philosophie,1,Introduction a la Philosophie,2,La Technique,13,722,10,QCM,0.06,0.72,80.16,30,7,37,37,30,7,1.0,81.08,Difficile,Facile,2,Beaucoup plus Facile que la Prediction,Pas Adapte
722,2015,Philosophie,1,Introduction a la Philosophie,2,La Technique,13,723,11,QCM,0.01,0.76,68.69,58,26,84,69,58,11,1.22,84.06,Facile,Facile,0,Meme Difficulte que la Prediction,Adapte
1788,2016,Philosophie,1,Introduction a la Philosophie,2,La Technique,13,723,11,QCM,0.02,0.75,68.69,54,24,78,74,54,20,1.05,72.97,Facile,Facile,0,Meme Difficulte que la Prediction,Adapte
2854,2017,Philosophie,1,Introduction a la Philosophie,2,La Technique,13,723,11,QCM,0.2,0.96,68.69,62,28,90,70,62,8,1.29,88.57,Facile,Facile,0,Meme Difficulte que la Prediction,Adapte
3920,2018,Philosophie,1,Introduction a la Philosophie,2,La Technique,13,723,11,QCM,0.03,0.91,68.69,66,30,96,84,66,18,1.14,78.57,Facile,Facile,0,Meme Difficulte que la Prediction,Adapte
4986,2019,Philosophie,1,Introduction a la Philosophie,2,La Technique,13,723,11,QCM,0.0,1.0,68.69,65,29,94,87,65,22,1.08,74.71,Facile,Facile,0,Meme Difficulte que la Prediction,Adapte
6052,2020,Philosophie,1,Introduction a la Philosophie,2,La Technique,13,723,11,QCM,0.12,0.73,68.69,60,28,88,86,60,26,1.02,69.77,Facile,Facile,0,Meme Difficulte que la Prediction,Adapte
723,2015,Philosophie,1,Introduction a la Philosophie,2,La Technique,13,724,12,QCU,0.07,0.77,85.55,18,3,21,19,18,1,1.11,94.74,Facile,Facile,0,Meme Difficulte que la Prediction,Pas Adapte
1789,2016,Philosophie,1,Introduction a la Philosophie,2,La Technique,13,724,12,QCM,0.33,0.42,42.71,10,13,23,14,10,4,1.64,71.43,Moyen,Moyen,0,Meme Difficulte que la Prediction,Pas Adapte
2855,2017,Philosophie,1,Introduction a la Philosophie,2,La Technique,13,724,12,QCM,0.61,0.21,25.7,6,16,22,9,6,3,2.44,66.67,Difficile,Difficile,0,Meme Difficulte que la Prediction,Pas Adapte
3921,2018,Philosophie,1,Introduction a la Philosophie,2,La Technique,13,724,12,QCM,0.26,0.4,58.01,12,9,21,20,12,8,1.05,60.0,Moyen,Moyen,0,Meme Difficulte que la Prediction,Pas Adapte
4987,2019,Philosophie,1,Introduction a la Philosophie,2,La Technique,13,724,12,QCM,0.11,0.8,70.33,13,6,19,19,13,6,1.0,68.42,Facile,Facile,0,Meme Difficulte que la Prediction,Adapte
6053,2020,Philosophie,1,Introduction a la Philosophie,2,La Technique,13,724,12,QCM,0.07,0.91,70.33,15,6,21,18,15,3,1.17,83.33,Facile,Facile,0,Meme Difficulte que la Prediction,Adapte
724,2015,Philosophie,1,Introduction a la Philosophie,2,La Technique,13,725,13,QCU,0.34,0.45,58.2,11,8,19,15,11,4,1.27,73.33,Moyen,Moyen,0,Meme Difficulte que la Prediction,Pas Adapte
1790,2016,Philosophie,1,Introduction a la Philosophie,2,La Technique,13,725,13,QCU,0.22,0.48,38.16,6,11,17,9,6,3,1.89,66.67,Facile,Moyen,-1,Plus Difficile que la Prediction,Pas Adapte
2856,2017,Philosophie,1,Introduction a la Philosophie,2,La Technique,13,725,13,QCU,0.28,0.4,38.69,7,10,17,14,7,7,1.21,50.0,Moyen,Moyen,0,Meme Difficulte que la Prediction,Pas Adapte
3922,2018,Philosophie,1,Introduction a la Philosophie,2,La Technique,13,725,13,QROC,0.13,0.83,93.76,13,1,14,14,13,1,1.0,92.86,Facile,Facile,0,Meme Difficulte que la Prediction,Pas Adapte
4988,2019,Philosophie,1,Introduction a la Philosophie,2,La Technique,13,725,13,QROC,0.67,0.23,8.01,1,11,12,8,1,7,1.5,12.5,Facile,Difficile,-2,Beaucoup plus Difficile que la Prediction,Pas Adapte
6054,2020,Philosophie,1,Introduction a la Philosophie,2,La Technique,13,725,13,QROC,0.82,0.14,15.24,2,12,14,12,2,10,1.17,16.67,Difficile,Difficile,0,Meme Difficulte que la Prediction,Pas Adapte
725,2015,Philosophie,1,Introduction a la Philosophie,3,L'Oeuvre d'Art,5,726,1,QO,0.03,0.46,66.95,42,20,62,48,42,6,1.29,87.5,Facile,Facile,0,Meme Difficulte que la Prediction,Adapte
1791,2016,Philosophie,1,Introduction a la Philosophie,3,L'Oeuvre d'Art,5,726,1,QCU,0.1,0.75,66.95,39,19,58,51,39,12,1.14,76.47,Facile,Facile,0,Meme Difficulte que la Prediction,Adapte
2857,2017,Philosophie,1,Introduction a la Philosophie,3,L'Oeuvre d'Art,5,726,1,QO,0.08,0.52,66.95,44,21,65,60,44,16,1.08,73.33,Facile,Facile,0,Meme Difficulte que la Prediction,Adapte
3923,2018,Philosophie,1,Introduction a la Philosophie,3,L'Oeuvre d'Art,5,726,1,QO,0.13,0.58,66.95,40,20,60,42,40,2,1.43,95.24,Facile,Facile,0,Meme Difficulte que la Prediction,Adapte
4989,2019,Philosophie,1,Introduction a la Philosophie,3,L'Oeuvre d'Art,5,726,1,QO,0.02,0.46,66.95,41,20,61,50,41,9,1.22,82.0,Facile,Facile,0,Meme Difficulte que la Prediction,Adapte
6055,2020,Philosophie,1,Introduction a la Philosophie,3,L'Oeuvre d'Art,5,726,1,QO,0.16,0.85,66.95,39,19,58,45,39,6,1.29,86.67,Facile,Facile,0,Meme Difficulte que la Prediction,Adapte
726,2015,Philosophie,1,Introduction a la Philosophie,3,L'Oeuvre d'Art,5,727,2,QCM,0.17,0.95,72.41,35,13,48,45,35,10,1.07,77.78,Facile,Facile,0,Meme Difficulte que la Prediction,Adapte
1792,2016,Philosophie,1,Introduction a la Philosophie,3,L'Oeuvre d'Art,5,727,2,QCM,0.14,0.92,72.41,33,13,46,38,33,5,1.21,86.84,Facile,Facile,0,Meme Difficulte que la Prediction,Adapte
2858,2017,Philosophie,1,Introduction a la Philosophie,3,L'Oeuvre d'Art,5,727,2,QCM,0.1,0.81,72.41,32,12,44,33,32,1,1.33,96.97,Facile,Facile,0,Meme Difficulte que la Prediction,Adapte
3924,2018,Philosophie,1,Introduction a la Philosophie,3,L'Oeuvre d'Art,5,727,2,QCM,0.2,0.82,72.41,28,10,38,36,28,8,1.06,77.78,Facile,Facile,0,Meme Difficulte que la Prediction,Adapte
4990,2019,Philosophie,1,Introduction a la Philosophie,3,L'Oeuvre d'Art,5,727,2,QCM,0.12,0.78,72.41,30,12,42,32,30,2,1.31,93.75,Facile,Facile,0,Meme Difficulte que la Prediction,Adapte
6056,2020,Philosophie,1,Introduction a la Philosophie,3,L'Oeuvre d'Art,5,727,2,QCM,0.06,0.88,72.41,35,13,48,37,35,2,1.3,94.59,Facile,Facile,0,Meme Difficulte que la Prediction,Adapte
727,2015,Philosophie,1,Introduction a la Philosophie,3,L'Oeuvre d'Art,5,728,3,QCU,0.48,0.28,28.81,22,54,76,46,22,24,1.65,47.83,Difficile,Difficile,0,Meme Difficulte que la Prediction,Pas Adapte
1793,2016,Philosophie,1,Introduction a la Philosophie,3,L'Oeuvre d'Art,5,728,3,QCU,0.11,0.8,94.41,77,5,82,78,77,1,1.05,98.72,Difficile,Facile,2,Beaucoup plus Facile que la Prediction,Pas Adapte
2859,2017,Philosophie,1,Introduction a la Philosophie,3,L'Oeuvre d'Art,5,728,3,QCU,0.08,0.93,97.33,86,2,88,86,86,0,1.02,100.0,Facile,Facile,0,Meme Difficulte que la Prediction,Pas Adapte
3925,2018,Philosophie,1,Introduction a la Philosophie,3,L'Oeuvre d'Art,5,728,3,QCU,0.72,0.29,14.3,13,81,94,80,13,67,1.18,16.25,Difficile,Difficile,0,Meme Difficulte que la Prediction,Pas Adapte
4991,2019,Philosophie,1,Introduction a la Philosophie,3,L'Oeuvre d'Art,5,728,3,QCU,0.37,0.68,56.6,50,39,89,69,50,19,1.29,72.46,Moyen,Moyen,0,Meme Difficulte que la Prediction,Pas Adapte
6057,2020,Philosophie,1,Introduction a la Philosophie,3,L'Oeuvre d'Art,5,728,3,QCM,0.36,0.31,55.25,45,37,82,72,45,27,1.14,62.5,Facile,Moyen,-1,Plus Difficile que la Prediction,Pas Adapte
728,2015,Philosophie,1,Introduction a la Philosophie,3,L'Oeuvre d'Art,5,729,4,QCU,0.23,0.59,39.07,3,4,7,7,3,4,1.0,42.86,Moyen,Moyen,0,Meme Difficulte que la Prediction,Pas Adapte
1794,2016,Philosophie,1,Introduction a la Philosophie,3,L'Oeuvre d'Art,5,729,4,QROC,0.09,0.58,65.23,5,3,8,8,5,3,1.0,62.5,Facile,Facile,0,Meme Difficulte que la Prediction,Adapte
2860,2017,Philosophie,1,Introduction a la Philosophie,3,L'Oeuvre d'Art,5,729,4,QROC,0.15,0.48,65.23,6,3,9,7,6,1,1.29,85.71,Facile,Facile,0,Meme Difficulte que la Prediction,Adapte
3926,2018,Philosophie,1,Introduction a la Philosophie,3,L'Oeuvre d'Art,5,729,4,QROC,0.05,0.95,65.23,7,3,10,8,7,1,1.25,87.5,Facile,Facile,0,Meme Difficulte que la Prediction,Adapte
4992,2019,Philosophie,1,Introduction a la Philosophie,3,L'Oeuvre d'Art,5,729,4,QO,0.14,0.99,65.23,6,3,9,9,6,3,1.0,66.67,Facile,Facile,0,Meme Difficulte que la Prediction,Adapte
6058,2020,Philosophie,1,Introduction a la Philosophie,3,L'Oeuvre d'Art,5,729,4,QO,0.19,0.45,65.23,5,3,8,5,5,0,1.6,100.0,Facile,Facile,0,Meme Difficulte que la Prediction,Adapte
729,2015,Philosophie,1,Introduction a la Philosophie,3,L'Oeuvre d'Art,5,730,5,QCM,0.51,0.28,11.68,6,42,48,26,6,20,1.85,23.08,Moyen,Difficile,-1,Plus Difficile que la Prediction,Pas Adapte
1795,2016,Philosophie,1,Introduction a la Philosophie,3,L'Oeuvre d'Art,5,730,5,QROC,0.2,0.26,52.73,29,26,55,38,29,9,1.45,76.32,Facile,Moyen,-1,Plus Difficile que la Prediction,Pas Adapte
2861,2017,Philosophie,1,Introduction a la Philosophie,3,L'Oeuvre d'Art,5,730,5,QROC,0.45,0.29,59.69,32,22,54,37,32,5,1.46,86.49,Facile,Moyen,-1,Plus Difficile que la Prediction,Pas Adapte
3927,2018,Philosophie,1,Introduction a la Philosophie,3,L'Oeuvre d'Art,5,730,5,QO,0.3,0.26,62.46,36,22,58,56,36,20,1.04,64.29,Difficile,Moyen,1,Plus Facile que la Prediction,Adapte
4993,2019,Philosophie,1,Introduction a la Philosophie,3,L'Oeuvre d'Art,5,730,5,QO,0.48,0.26,62.46,41,24,65,51,41,10,1.27,80.39,Moyen,Moyen,0,Meme Difficulte que la Prediction,Adapte
6059,2020,Philosophie,1,Introduction a la Philosophie,3,L'Oeuvre d'Art,5,730,5,QROC,0.58,0.3,62.46,39,23,62,58,39,19,1.07,67.24,Moyen,Moyen,0,Meme Difficulte que la Prediction,Adapte
730,2015,Philosophie,1,Introduction a la Philosophie,4,L'Histoire,11,731,1,QCM,0.73,0.28,32.53,9,20,29,26,9,17,1.12,34.62,Difficile,Difficile,0,Meme Difficulte que la Prediction,Pas Adapte
1796,2016,Philosophie,1,Introduction a la Philosophie,4,L'Histoire,11,731,1,QCM,0.11,0.88,76.44,21,7,28,23,21,2,1.22,91.3,Difficile,Facile,2,Beaucoup plus Facile que la Prediction,Pas Adapte
2862,2017,Philosophie,1,Introduction a la Philosophie,4,L'Histoire,11,731,1,QCM,0.53,0.17,11.18,3,23,26,17,3,14,1.53,17.65,Difficile,Difficile,0,Meme Difficulte que la Prediction,Pas Adapte
3928,2018,Philosophie,1,Introduction a la Philosophie,4,L'Histoire,11,731,1,QCM,0.78,0.21,26.02,7,21,28,14,7,7,2.0,50.0,Difficile,Difficile,0,Meme Difficulte que la Prediction,Pas Adapte
4994,2019,Philosophie,1,Introduction a la Philosophie,4,L'Histoire,11,731,1,QCM,0.05,0.84,71.59,21,9,30,24,21,3,1.25,87.5,Facile,Facile,0,Meme Difficulte que la Prediction,Adapte
6060,2020,Philosophie,1,Introduction a la Philosophie,4,L'Histoire,11,731,1,QCM,0.0,0.84,71.59,24,10,34,28,24,4,1.21,85.71,Facile,Facile,0,Meme Difficulte que la Prediction,Adapte
731,2015,Philosophie,1,Introduction a la Philosophie,4,L'Histoire,11,732,2,QROC,0.63,0.06,33.41,17,34,51,26,17,9,1.96,65.38,Difficile,Difficile,0,Meme Difficulte que la Prediction,Pas Adapte
1797,2016,Philosophie,1,Introduction a la Philosophie,4,L'Histoire,11,732,2,QROC,0.16,0.78,83.53,49,10,59,55,49,6,1.07,89.09,Facile,Facile,0,Meme Difficulte que la Prediction,Pas Adapte
2863,2017,Philosophie,1,Introduction a la Philosophie,4,L'Histoire,11,732,2,QROC,0.27,0.28,53.96,33,29,62,49,33,16,1.27,67.35,Moyen,Moyen,0,Meme Difficulte que la Prediction,Pas Adapte
3929,2018,Philosophie,1,Introduction a la Philosophie,4,L'Histoire,11,732,2,QO,0.74,0.2,35.34,22,41,63,32,22,10,1.97,68.75,Facile,Moyen,-1,Plus Difficile que la Prediction,Pas Adapte
4995,2019,Philosophie,1,Introduction a la Philosophie,4,L'Histoire,11,732,2,QROC,0.75,0.24,7.9,4,51,55,35,4,31,1.57,11.43,Facile,Difficile,-2,Beaucoup plus Difficile que la Prediction,Pas Adapte
6061,2020,Philosophie,1,Introduction a la Philosophie,4,L'Histoire,11,732,2,QROC,0.14,0.87,95.28,51,3,54,52,51,1,1.04,98.08,Facile,Facile,0,Meme Difficulte que la Prediction,Pas Adapte
732,2015,Philosophie,1,Introduction a la Philosophie,4,L'Histoire,11,733,3,QCM,0.61,0.21,34.18,32,63,95,76,32,44,1.25,42.11,Difficile,Difficile,0,Meme Difficulte que la Prediction,Pas Adapte
1798,2016,Philosophie,1,Introduction a la Philosophie,4,L'Histoire,11,733,3,QCM,0.26,0.69,37.95,41,67,108,72,41,31,1.5,56.94,Moyen,Moyen,0,Meme Difficulte que la Prediction,Pas Adapte
2864,2017,Philosophie,1,Introduction a la Philosophie,4,L'Histoire,11,733,3,QCU,0.24,0.42,54.85,65,53,118,93,65,28,1.27,69.89,Moyen,Moyen,0,Meme Difficulte que la Prediction,Pas Adapte
3930,2018,Philosophie,1,Introduction a la Philosophie,4,L'Histoire,11,733,3,QO,0.4,0.2,59.5,67,46,113,93,67,26,1.22,72.04,Moyen,Moyen,0,Meme Difficulte que la Prediction,Pas Adapte
4996,2019,Philosophie,1,Introduction a la Philosophie,4,L'Histoire,11,733,3,QROC,0.77,0.13,17.74,18,84,102,64,18,46,1.59,28.12,Difficile,Difficile,0,Meme Difficulte que la Prediction,Pas Adapte
6062,2020,Philosophie,1,Introduction a la Philosophie,4,L'Histoire,11,733,3,QROC,0.17,0.53,74.51,86,30,116,112,86,26,1.04,76.79,Moyen,Facile,1,Plus Facile que la Prediction,Adapte
733,2015,Philosophie,1,Introduction a la Philosophie,4,L'Histoire,11,734,4,QCU,0.48,0.39,33.82,20,40,60,25,20,5,2.4,80.0,Facile,Difficile,-2,Beaucoup plus Difficile que la Prediction,Pas Adapte
1799,2016,Philosophie,1,Introduction a la Philosophie,4,L'Histoire,11,734,4,QCU,0.26,0.63,47.93,25,27,52,45,25,20,1.16,55.56,Difficile,Moyen,1,Plus Facile que la Prediction,Pas Adapte
2865,2017,Philosophie,1,Introduction a la Philosophie,4,L'Histoire,11,734,4,QCU,0.18,0.81,99.83,56,0,56,56,56,0,1.0,100.0,Facile,Facile,0,Meme Difficulte que la Prediction,Pas Adapte
3931,2018,Philosophie,1,Introduction a la Philosophie,4,L'Histoire,11,734,4,QCM,0.31,0.52,37.36,23,39,62,35,23,12,1.77,65.71,Facile,Moyen,-1,Plus Difficile que la Prediction,Pas Adapte
4997,2019,Philosophie,1,Introduction a la Philosophie,4,L'Histoire,11,734,4,QCM,0.26,0.48,44.6,29,35,64,30,29,1,2.13,96.67,Moyen,Moyen,0,Meme Difficulte que la Prediction,Pas Adapte
6063,2020,Philosophie,1,Introduction a la Philosophie,4,L'Histoire,11,734,4,QCM,0.28,0.51,58.55,33,23,56,54,33,21,1.04,61.11,Moyen,Moyen,0,Meme Difficulte que la Prediction,Pas Adapte
734,2015,Philosophie,1,Introduction a la Philosophie,4,L'Histoire,11,735,5,QROC,0.52,0.29,54.16,31,26,57,32,31,1,1.78,96.88,Difficile,Moyen,1,Plus Facile que la Prediction,Pas Adapte
1800,2016,Philosophie,1,Introduction a la Philosophie,4,L'Histoire,11,735,5,QROC,0.84,0.19,5.58,3,46,49,24,3,21,2.04,12.5,Difficile,Difficile,0,Meme Difficulte que la Prediction,Pas Adapte
2866,2017,Philosophie,1,Introduction a la Philosophie,4,L'Histoire,11,735,5,QROC,0.03,0.57,73.65,41,15,56,44,41,3,1.27,93.18,Facile,Facile,0,Meme Difficulte que la Prediction,Adapte
3932,2018,Philosophie,1,Introduction a la Philosophie,4,L'Histoire,11,735,5,QROC,0.14,0.76,73.65,36,13,49,42,36,6,1.17,85.71,Facile,Facile,0,Meme Difficulte que la Prediction,Adapte
4998,2019,Philosophie,1,Introduction a la Philosophie,4,L'Histoire,11,735,5,QROC,0.11,0.42,73.65,41,15,56,54,41,13,1.04,75.93,Facile,Facile,0,Meme Difficulte que la Prediction,Adapte
6064,2020,Philosophie,1,Introduction a la Philosophie,4,L'Histoire,11,735,5,QROC,0.03,0.89,73.65,45,16,61,52,45,7,1.17,86.54,Facile,Facile,0,Meme Difficulte que la Prediction,Adapte
735,2015,Philosophie,1,Introduction a la Philosophie,4,L'Histoire,11,736,6,QCU,0.37,0.67,45.5,25,29,54,25,25,0,2.16,100.0,Facile,Moyen,-1,Plus Difficile que la Prediction,Pas Adapte
1801,2016,Philosophie,1,Introduction a la Philosophie,4,L'Histoire,11,736,6,QCU,0.65,0.36,1.67,1,50,51,48,1,47,1.06,2.08,Moyen,Difficile,-1,Plus Difficile que la Prediction,Pas Adapte
2867,2017,Philosophie,1,Introduction a la Philosophie,4,L'Histoire,11,736,6,QCU,0.1,0.8,94.43,49,3,52,52,49,3,1.0,94.23,Facile,Facile,0,Meme Difficulte que la Prediction,Pas Adapte
3933,2018,Philosophie,1,Introduction a la Philosophie,4,L'Histoire,11,736,6,QCU,0.29,0.63,42.95,19,26,45,41,19,22,1.1,46.34,Moyen,Moyen,0,Meme Difficulte que la Prediction,Pas Adapte
4999,2019,Philosophie,1,Introduction a la Philosophie,4,L'Histoire,11,736,6,QCM,0.31,0.36,37.06,16,27,43,17,16,1,2.53,94.12,Moyen,Moyen,0,Meme Difficulte que la Prediction,Pas Adapte
6065,2020,Philosophie,1,Introduction a la Philosophie,4,L'Histoire,11,736,6,QCM,0.64,0.27,18.38,7,32,39,11,7,4,3.55,63.64,Difficile,Difficile,0,Meme Difficulte que la Prediction,Pas Adapte
736,2015,Philosophie,1,Introduction a la Philosophie,4,L'Histoire,11,737,7,QROC,0.0,0.49,74.32,69,24,93,72,69,3,1.29,95.83,Facile,Facile,0,Meme Difficulte que la Prediction,Adapte
1802,2016,Philosophie,1,Introduction a la Philosophie,4,L'Histoire,11,737,7,QROC,0.1,0.63,74.32,68,24,92,92,68,24,1.0,73.91,Facile,Facile,0,Meme Difficulte que la Prediction,Adapte
2868,2017,Philosophie,1,Introduction a la Philosophie,4,L'Histoire,11,737,7,QROC,0.17,0.72,74.32,68,24,92,85,68,17,1.08,80.0,Facile,Facile,0,Meme Difficulte que la Prediction,Adapte
3934,2018,Philosophie,1,Introduction a la Philosophie,4,L'Histoire,11,737,7,QROC,0.13,0.81,74.32,79,27,106,81,79,2,1.31,97.53,Facile,Facile,0,Meme Difficulte que la Prediction,Adapte
5000,2019,Philosophie,1,Introduction a la Philosophie,4,L'Histoire,11,737,7,QROC,0.08,0.54,74.32,69,24,93,71,69,2,1.31,97.18,Facile,Facile,0,Meme Difficulte que la Prediction,Adapte
6066,2020,Philosophie,1,Introduction a la Philosophie,4,L'Histoire,11,737,7,QCM,0.1,0.73,74.32,65,22,87,86,65,21,1.01,75.58,Facile,Facile,0,Meme Difficulte que la Prediction,Adapte
737,2015,Philosophie,1,Introduction a la Philosophie,4,L'Histoire,11,738,8,QCU,0.7,0.34,6.62,2,29,31,16,2,14,1.94,12.5,Difficile,Difficile,0,Meme Difficulte que la Prediction,Pas Adapte
1803,2016,Philosophie,1,Introduction a la Philosophie,4,L'Histoire,11,738,8,QCM,0.41,0.62,35.57,10,18,28,20,10,10,1.4,50.0,Moyen,Moyen,0,Meme Difficulte que la Prediction,Pas Adapte
2869,2017,Philosophie,1,Introduction a la Philosophie,4,L'Histoire,11,738,8,QCM,0.02,0.93,79.53,25,7,32,30,25,5,1.07,83.33,Facile,Facile,0,Meme Difficulte que la Prediction,Pas Adapte
3935,2018,Philosophie,1,Introduction a la Philosophie,4,L'Histoire,11,738,8,QCM,0.11,0.95,87.43,26,4,30,27,26,1,1.11,96.3,Facile,Facile,0,Meme Difficulte que la Prediction,Pas Adapte
5001,2019,Philosophie,1,Introduction a la Philosophie,4,L'Histoire,11,738,8,QROC,0.58,0.27,63.26,18,11,29,23,18,5,1.26,78.26,Moyen,Moyen,0,Meme Difficulte que la Prediction,Adapte
6067,2020,Philosophie,1,Introduction a la Philosophie,4,L'Histoire,11,738,8,QROC,0.2,0.28,63.26,18,10,28,21,18,3,1.33,85.71,Moyen,Moyen,0,Meme Difficulte que la Prediction,Adapte
738,2015,Philosophie,1,Introduction a la Philosophie,4,L'Histoire,11,739,9,QCM,0.4,0.4,57.37,38,29,67,50,38,12,1.34,76.0,Moyen,Moyen,0,Meme Difficulte que la Prediction,Pas Adapte
1804,2016,Philosophie,1,Introduction a la Philosophie,4,L'Histoire,11,739,9,QO,0.48,0.18,64.98,40,21,61,51,40,11,1.2,78.43,Facile,Moyen,-1,Plus Difficile que la Prediction,Adapte
2870,2017,Philosophie,1,Introduction a la Philosophie,4,L'Histoire,11,739,9,QO,0.21,0.19,64.98,41,22,63,46,41,5,1.37,89.13,Moyen,Moyen,0,Meme Difficulte que la Prediction,Adapte
3936,2018,Philosophie,1,Introduction a la Philosophie,4,L'Histoire,11,739,9,QO,0.55,0.25,64.98,40,21,61,47,40,7,1.3,85.11,Moyen,Moyen,0,Meme Difficulte que la Prediction,Adapte
5002,2019,Philosophie,1,Introduction a la Philosophie,4,L'Histoire,11,739,9,QO,0.72,0.2,64.98,40,22,62,50,40,10,1.24,80.0,Moyen,Moyen,0,Meme Difficulte que la Prediction,Adapte
6068,2020,Philosophie,1,Introduction a la Philosophie,4,L'Histoire,11,739,9,QCM,0.24,0.6,64.98,34,19,53,34,34,0,1.56,100.0,Moyen,Moyen,0,Meme Difficulte que la Prediction,Adapte
739,2015,Philosophie,1,Introduction a la Philosophie,4,L'Histoire,11,740,10,QROC,0.93,0.16,23.55,11,37,48,32,11,21,1.5,34.38,Difficile,Difficile,0,Meme Difficulte que la Prediction,Pas Adapte
1805,2016,Philosophie,1,Introduction a la Philosophie,4,L'Histoire,11,740,10,QROC,0.64,0.14,17.07,8,39,47,23,8,15,2.04,34.78,Difficile,Difficile,0,Meme Difficulte que la Prediction,Pas Adapte
2871,2017,Philosophie,1,Introduction a la Philosophie,4,L'Histoire,11,740,10,QROC,0.12,0.74,84.52,40,7,47,45,40,5,1.04,88.89,Moyen,Facile,1,Plus Facile que la Prediction,Pas Adapte
3937,2018,Philosophie,1,Introduction a la Philosophie,4,L'Histoire,11,740,10,QROC,0.69,0.02,11.09,5,43,48,24,5,19,2.0,20.83,Difficile,Difficile,0,Meme Difficulte que la Prediction,Pas Adapte
5003,2019,Philosophie,1,Introduction a la Philosophie,4,L'Histoire,11,740,10,QCM,0.64,0.22,30.92,15,32,47,41,15,26,1.15,36.59,Difficile,Difficile,0,Meme Difficulte que la Prediction,Pas Adapte
6069,2020,Philosophie,1,Introduction a la Philosophie,4,L'Histoire,11,740,10,QCM,0.14,0.73,81.71,36,8,44,44,36,8,1.0,81.82,Moyen,Facile,1,Plus Facile que la Prediction,Pas Adapte
740,2015,Philosophie,1,Introduction a la Philosophie,4,L'Histoire,11,741,11,QCM,0.59,0.3,25.33,15,43,58,32,15,17,1.81,46.88,Moyen,Difficile,-1,Plus Difficile que la Prediction,Pas Adapte
1806,2016,Philosophie,1,Introduction a la Philosophie,4,L'Histoire,11,741,11,QCM,0.36,0.43,49.85,30,30,60,51,30,21,1.18,58.82,Moyen,Moyen,0,Meme Difficulte que la Prediction,Pas Adapte
2872,2017,Philosophie,1,Introduction a la Philosophie,4,L'Histoire,11,741,11,QCU,0.2,0.95,99.57,65,0,65,65,65,0,1.0,100.0,Moyen,Facile,1,Plus Facile que la Prediction,Pas Adapte
3938,2018,Philosophie,1,Introduction a la Philosophie,4,L'Histoire,11,741,11,QCU,0.05,0.92,90.07,62,7,69,64,62,2,1.08,96.88,Facile,Facile,0,Meme Difficulte que la Prediction,Pas Adapte
5004,2019,Philosophie,1,Introduction a la Philosophie,4,L'Histoire,11,741,11,QCU,0.04,0.83,74.24,47,16,63,59,47,12,1.07,79.66,Difficile,Facile,2,Beaucoup plus Facile que la Prediction,Adapte
6070,2020,Philosophie,1,Introduction a la Philosophie,4,L'Histoire,11,741,11,QCU,0.15,0.88,74.24,52,18,70,60,52,8,1.17,86.67,Facile,Facile,0,Meme Difficulte que la Prediction,Adapte
741,2015,Philosophie,1,Introduction a la Philosophie,5,Le Droit,2,742,1,QCU,0.55,0.22,24.64,9,29,38,14,9,5,2.71,64.29,Difficile,Difficile,0,Meme Difficulte que la Prediction,Pas Adapte
1807,2016,Philosophie,1,Introduction a la Philosophie,5,Le Droit,2,742,1,QCM,0.07,0.92,72.36,30,12,42,34,30,4,1.24,88.24,Facile,Facile,0,Meme Difficulte que la Prediction,Adapte
2873,2017,Philosophie,1,Introduction a la Philosophie,5,Le Droit,2,742,1,QCU,0.19,0.82,72.36,33,12,45,36,33,3,1.25,91.67,Facile,Facile,0,Meme Difficulte que la Prediction,Adapte
3939,2018,Philosophie,1,Introduction a la Philosophie,5,Le Droit,2,742,1,QCU,0.06,0.85,72.36,29,11,40,32,29,3,1.25,90.62,Facile,Facile,0,Meme Difficulte que la Prediction,Adapte
5005,2019,Philosophie,1,Introduction a la Philosophie,5,Le Droit,2,742,1,QCM,0.03,0.78,72.36,32,12,44,32,32,0,1.38,100.0,Facile,Facile,0,Meme Difficulte que la Prediction,Adapte
6071,2020,Philosophie,1,Introduction a la Philosophie,5,Le Droit,2,742,1,QCU,0.1,0.92,72.36,30,11,41,40,30,10,1.02,75.0,Facile,Facile,0,Meme Difficulte que la Prediction,Adapte
742,2015,Philosophie,1,Introduction a la Philosophie,5,Le Droit,2,743,2,QCM,0.36,0.67,54.32,49,42,91,57,49,8,1.6,85.96,Moyen,Moyen,0,Meme Difficulte que la Prediction,Pas Adapte
1808,2016,Philosophie,1,Introduction a la Philosophie,5,Le Droit,2,743,2,QCM,0.67,0.27,31.38,29,65,94,75,29,46,1.25,38.67,Difficile,Difficile,0,Meme Difficulte que la Prediction,Pas Adapte
2874,2017,Philosophie,1,Introduction a la Philosophie,5,Le Droit,2,743,2,QCU,0.06,0.76,74.69,69,23,92,71,69,2,1.3,97.18,Facile,Facile,0,Meme Difficulte que la Prediction,Adapte
3940,2018,Philosophie,1,Introduction a la Philosophie,5,Le Droit,2,743,2,QCU,0.07,0.78,74.69,78,26,104,92,78,14,1.13,84.78,Facile,Facile,0,Meme Difficulte que la Prediction,Adapte
5006,2019,Philosophie,1,Introduction a la Philosophie,5,Le Droit,2,743,2,QCM,0.11,0.83,74.69,81,28,109,107,81,26,1.02,75.7,Facile,Facile,0,Meme Difficulte que la Prediction,Adapte
6072,2020,Philosophie,1,Introduction a la Philosophie,5,Le Droit,2,743,2,QCM,0.2,0.75,74.69,84,29,113,103,84,19,1.1,81.55,Facile,Facile,0,Meme Difficulte que la Prediction,Adapte
743,2015,Philosophie,1,Introduction a la Philosophie,6,La Raison,7,744,1,QCM,0.51,0.22,25.82,2,5,7,4,2,2,1.75,50.0,Difficile,Difficile,0,Meme Difficulte que la Prediction,Pas Adapte
1809,2016,Philosophie,1,Introduction a la Philosophie,6,La Raison,7,744,1,QROC,0.09,0.41,88.72,6,1,7,7,6,1,1.0,85.71,Difficile,Facile,2,Beaucoup plus Facile que la Prediction,Pas Adapte
2875,2017,Philosophie,1,Introduction a la Philosophie,6,La Raison,7,744,1,QROC,0.57,0.31,39.67,3,5,8,4,3,1,2.0,75.0,Moyen,Moyen,0,Meme Difficulte que la Prediction,Pas Adapte
3941,2018,Philosophie,1,Introduction a la Philosophie,6,La Raison,7,744,1,QROC,0.3,0.39,35.73,3,5,8,4,3,1,2.0,75.0,Moyen,Moyen,0,Meme Difficulte que la Prediction,Pas Adapte
5007,2019,Philosophie,1,Introduction a la Philosophie,6,La Raison,7,744,1,QROC,0.36,0.3,60.68,4,3,7,5,4,1,1.4,80.0,Difficile,Moyen,1,Plus Facile que la Prediction,Adapte
6073,2020,Philosophie,1,Introduction a la Philosophie,6,La Raison,7,744,1,QROC,0.36,0.27,60.68,4,3,7,6,4,2,1.17,66.67,Moyen,Moyen,0,Meme Difficulte que la Prediction,Adapte
744,2015,Philosophie,1,Introduction a la Philosophie,6,La Raison,7,745,2,QROC,0.69,0.12,23.43,1,5,6,4,1,3,1.5,25.0,Moyen,Difficile,-1,Plus Difficile que la Prediction,Pas Adapte
1810,2016,Philosophie,1,Introduction a la Philosophie,6,La Raison,7,745,2,QROC,0.16,0.97,70.49,5,2,7,7,5,2,1.0,71.43,Difficile,Facile,2,Beaucoup plus Facile que la Prediction,Adapte
2876,2017,Philosophie,1,Introduction a la Philosophie,6,La Raison,7,745,2,QROC,0.17,0.86,70.49,5,2,7,7,5,2,1.0,71.43,Facile,Facile,0,Meme Difficulte que la Prediction,Adapte
3942,2018,Philosophie,1,Introduction a la Philosophie,6,La Raison,7,745,2,QROC,0.02,0.8,70.49,4,2,6,5,4,1,1.2,80.0,Facile,Facile,0,Meme Difficulte que la Prediction,Adapte
5008,2019,Philosophie,1,Introduction a la Philosophie,6,La Raison,7,745,2,QROC,0.03,0.85,70.49,5,2,7,7,5,2,1.0,71.43,Facile,Facile,0,Meme Difficulte que la Prediction,Adapte
6074,2020,Philosophie,1,Introduction a la Philosophie,6,La Raison,7,745,2,QCM,0.04,0.73,70.49,5,2,7,6,5,1,1.17,83.33,Facile,Facile,0,Meme Difficulte que la Prediction,Adapte
745,2015,Philosophie,1,Introduction a la Philosophie,6,La Raison,7,746,3,QCU,0.34,0.68,36.87,34,58,92,61,34,27,1.51,55.74,Moyen,Moyen,0,Meme Difficulte que la Prediction,Pas Adapte
1811,2016,Philosophie,1,Introduction a la Philosophie,6,La Raison,7,746,3,QCU,0.22,0.53,49.18,38,40,78,46,38,8,1.7,82.61,Moyen,Moyen,0,Meme Difficulte que la Prediction,Pas Adapte
2877,2017,Philosophie,1,Introduction a la Philosophie,6,La Raison,7,746,3,QCM,0.29,0.5,56.13,42,33,75,73,42,31,1.03,57.53,Facile,Moyen,-1,Plus Difficile que la Prediction,Pas Adapte
3943,2018,Philosophie,1,Introduction a la Philosophie,6,La Raison,7,746,3,QCM,0.06,0.75,73.9,49,17,66,63,49,14,1.05,77.78,Difficile,Facile,2,Beaucoup plus Facile que la Prediction,Adapte
5009,2019,Philosophie,1,Introduction a la Philosophie,6,La Raison,7,746,3,QCM,0.03,0.93,73.9,50,18,68,61,50,11,1.11,81.97,Facile,Facile,0,Meme Difficulte que la Prediction,Adapte
6075,2020,Philosophie,1,Introduction a la Philosophie,6,La Raison,7,746,3,QCU,0.1,0.85,73.9,55,19,74,56,55,1,1.32,98.21,Facile,Facile,0,Meme Difficulte que la Prediction,Adapte
746,2015,Philosophie,1,Introduction a la Philosophie,6,La Raison,7,747,4,QCU,0.36,0.46,54.18,14,11,25,18,14,4,1.39,77.78,Difficile,Moyen,1,Plus Facile que la Prediction,Pas Adapte
1812,2016,Philosophie,1,Introduction a la Philosophie,6,La Raison,7,747,4,QCU,0.43,0.33,29.09,7,18,25,20,7,13,1.25,35.0,Difficile,Difficile,0,Meme Difficulte que la Prediction,Pas Adapte
2878,2017,Philosophie,1,Introduction a la Philosophie,6,La Raison,7,747,4,QCU,0.74,0.37,18.7,4,17,21,8,4,4,2.62,50.0,Difficile,Difficile,0,Meme Difficulte que la Prediction,Pas Adapte
3944,2018,Philosophie,1,Introduction a la Philosophie,6,La Raison,7,747,4,QCU,0.46,0.37,11.15,3,20,23,16,3,13,1.44,18.75,Difficile,Difficile,0,Meme Difficulte que la Prediction,Pas Adapte
5010,2019,Philosophie,1,Introduction a la Philosophie,6,La Raison,7,747,4,QCU,0.21,0.56,48.54,10,11,21,18,10,8,1.17,55.56,Difficile,Moyen,1,Plus Facile que la Prediction,Pas Adapte
6076,2020,Philosophie,1,Introduction a la Philosophie,6,La Raison,7,747,4,QCU,0.28,0.45,61.07,14,9,23,14,14,0,1.64,100.0,Moyen,Moyen,0,Meme Difficulte que la Prediction,Adapte
747,2015,Philosophie,1,Introduction a la Philosophie,6,La Raison,7,748,5,QCM,0.27,0.35,44.13,19,23,42,28,19,9,1.5,67.86,Facile,Moyen,-1,Plus Difficile que la Prediction,Pas Adapte
1813,2016,Philosophie,1,Introduction a la Philosophie,6,La Raison,7,748,5,QCM,0.65,0.18,12.39,6,42,48,24,6,18,2.0,25.0,Difficile,Difficile,0,Meme Difficulte que la Prediction,Pas Adapte
2879,2017,Philosophie,1,Introduction a la Philosophie,6,La Raison,7,748,5,QCM,0.02,0.85,67.76,37,18,55,45,37,8,1.22,82.22,Facile,Facile,0,Meme Difficulte que la Prediction,Adapte
3945,2018,Philosophie,1,Introduction a la Philosophie,6,La Raison,7,748,5,QCU,0.16,0.89,67.76,35,17,52,46,35,11,1.13,76.09,Facile,Facile,0,Meme Difficulte que la Prediction,Adapte
5011,2019,Philosophie,1,Introduction a la Philosophie,6,La Raison,7,748,5,QCU,0.08,0.94,67.76,33,16,49,48,33,15,1.02,68.75,Facile,Facile,0,Meme Difficulte que la Prediction,Adapte
6077,2020,Philosophie,1,Introduction a la Philosophie,6,La Raison,7,748,5,QCU,0.11,0.94,67.76,35,17,52,42,35,7,1.24,83.33,Facile,Facile,0,Meme Difficulte que la Prediction,Adapte
748,2015,Philosophie,1,Introduction a la Philosophie,6,La Raison,7,749,6,QCU,0.32,0.68,48.49,33,36,69,40,33,7,1.73,82.5,Difficile,Moyen,1,Plus Facile que la Prediction,Pas Adapte
1814,2016,Philosophie,1,Introduction a la Philosophie,6,La Raison,7,749,6,QCU,0.3,0.66,46.66,34,39,73,35,34,1,2.09,97.14,Facile,Moyen,-1,Plus Difficile que la Prediction,Pas Adapte
2880,2017,Philosophie,1,Introduction a la Philosophie,6,La Raison,7,749,6,QCU,0.14,0.81,87.7,64,9,73,69,64,5,1.06,92.75,Facile,Facile,0,Meme Difficulte que la Prediction,Pas Adapte
3946,2018,Philosophie,1,Introduction a la Philosophie,6,La Raison,7,749,6,QCU,0.11,0.82,69.31,57,25,82,80,57,23,1.02,71.25,Facile,Facile,0,Meme Difficulte que la Prediction,Adapte
5012,2019,Philosophie,1,Introduction a la Philosophie,6,La Raison,7,749,6,QCU,0.17,0.81,69.31,53,24,77,70,53,17,1.1,75.71,Facile,Facile,0,Meme Difficulte que la Prediction,Adapte
6078,2020,Philosophie,1,Introduction a la Philosophie,6,La Raison,7,749,6,QCU,0.04,0.77,69.31,54,24,78,66,54,12,1.18,81.82,Facile,Facile,0,Meme Difficulte que la Prediction,Adapte
749,2015,Philosophie,1,Introduction a la Philosophie,6,La Raison,7,750,7,QCU,0.31,0.63,54.63,41,34,75,64,41,23,1.17,64.06,Difficile,Moyen,1,Plus Facile que la Prediction,Pas Adapte
1815,2016,Philosophie,1,Introduction a la Philosophie,6,La Raison,7,750,7,QCM,0.17,0.83,95.76,79,4,83,82,79,3,1.01,96.34,Facile,Facile,0,Meme Difficulte que la Prediction,Pas Adapte
2881,2017,Philosophie,1,Introduction a la Philosophie,6,La Raison,7,750,7,QCM,0.16,0.72,87.52,81,12,93,89,81,8,1.04,91.01,Moyen,Facile,1,Plus Facile que la Prediction,Pas Adapte
3947,2018,Philosophie,1,Introduction a la Philosophie,6,La Raison,7,750,7,QCM,0.07,0.94,84.86,82,15,97,87,82,5,1.11,94.25,Difficile,Facile,2,Beaucoup plus Facile que la Prediction,Pas Adapte
5013,2019,Philosophie,1,Introduction a la Philosophie,6,La Raison,7,750,7,QCM,0.21,0.35,39.2,39,61,100,72,39,33,1.39,54.17,Facile,Moyen,-1,Plus Difficile que la Prediction,Pas Adapte
6079,2020,Philosophie,1,Introduction a la Philosophie,6,La Raison,7,750,7,QCU,0.33,0.48,43.27,49,64,113,76,49,27,1.49,64.47,Facile,Moyen,-1,Plus Difficile que la Prediction,Pas Adapte
750,2015,Philosophie,1,Introduction a la Philosophie,7,La Verite,9,751,1,QCU,0.63,0.38,16.69,14,70,84,49,14,35,1.71,28.57,Difficile,Difficile,0,Meme Difficulte que la Prediction,Pas Adapte
1816,2016,Philosophie,1,Introduction a la Philosophie,7,La Verite,9,751,1,QCU,0.37,0.4,64.24,55,31,86,56,55,1,1.54,98.21,Moyen,Moyen,0,Meme Difficulte que la Prediction,Adapte
2882,2017,Philosophie,1,Introduction a la Philosophie,7,La Verite,9,751,1,QCU,0.25,0.5,64.24,49,27,76,57,49,8,1.33,85.96,Moyen,Moyen,0,Meme Difficulte que la Prediction,Adapte
3948,2018,Philosophie,1,Introduction a la Philosophie,7,La Verite,9,751,1,QCU,0.34,0.75,64.24,45,25,70,48,45,3,1.46,93.75,Moyen,Moyen,0,Meme Difficulte que la Prediction,Adapte
5014,2019,Philosophie,1,Introduction a la Philosophie,7,La Verite,9,751,1,QCU,0.23,0.48,64.24,48,26,74,68,48,20,1.09,70.59,Moyen,Moyen,0,Meme Difficulte que la Prediction,Adapte
6080,2020,Philosophie,1,Introduction a la Philosophie,7,La Verite,9,751,1,QCU,0.31,0.42,64.24,44,25,69,46,44,2,1.5,95.65,Moyen,Moyen,0,Meme Difficulte que la Prediction,Adapte
751,2015,Philosophie,1,Introduction a la Philosophie,7,La Verite,9,752,2,QROC,0.0,0.47,80.94,57,14,71,58,57,1,1.22,98.28,Facile,Facile,0,Meme Difficulte que la Prediction,Pas Adapte
1817,2016,Philosophie,1,Introduction a la Philosophie,7,La Verite,9,752,2,QCM,0.55,0.16,3.43,3,72,75,39,3,36,1.92,7.69,Difficile,Difficile,0,Meme Difficulte que la Prediction,Pas Adapte
2883,2017,Philosophie,1,Introduction a la Philosophie,7,La Verite,9,752,2,QCM,0.06,0.76,86.98,65,10,75,74,65,9,1.01,87.84,Moyen,Facile,1,Plus Facile que la Prediction,Pas Adapte
3949,2018,Philosophie,1,Introduction a la Philosophie,7,La Verite,9,752,2,QCM,0.1,0.85,90.22,68,7,75,74,68,6,1.01,91.89,Difficile,Facile,2,Beaucoup plus Facile que la Prediction,Pas Adapte
5015,2019,Philosophie,1,Introduction a la Philosophie,7,La Verite,9,752,2,QCM,0.33,0.56,59.62,42,29,71,69,42,27,1.03,60.87,Moyen,Moyen,0,Meme Difficulte que la Prediction,Pas Adapte
6081,2020,Philosophie,1,Introduction a la Philosophie,7,La Verite,9,752,2,QCM,0.04,0.83,92.18,57,5,62,62,57,5,1.0,91.94,Facile,Facile,0,Meme Difficulte que la Prediction,Pas Adapte
752,2015,Philosophie,1,Introduction a la Philosophie,7,La Verite,9,753,3,QCM,0.46,0.47,42.27,27,36,63,49,27,22,1.29,55.1,Moyen,Moyen,0,Meme Difficulte que la Prediction,Pas Adapte
1818,2016,Philosophie,1,Introduction a la Philosophie,7,La Verite,9,753,3,QCU,0.14,0.88,85.84,49,8,57,49,49,0,1.16,100.0,Moyen,Facile,1,Plus Facile que la Prediction,Pas Adapte
2884,2017,Philosophie,1,Introduction a la Philosophie,7,La Verite,9,753,3,QCU,0.37,0.52,57.05,35,27,62,48,35,13,1.29,72.92,Moyen,Moyen,0,Meme Difficulte que la Prediction,Pas Adapte
3950,2018,Philosophie,1,Introduction a la Philosophie,7,La Verite,9,753,3,QROC,0.99,0.03,14.96,9,48,57,50,9,41,1.14,18.0,Difficile,Difficile,0,Meme Difficulte que la Prediction,Pas Adapte
5016,2019,Philosophie,1,Introduction a la Philosophie,7,La Verite,9,753,3,QROC,0.18,0.72,89.94,59,7,66,63,59,4,1.05,93.65,Facile,Facile,0,Meme Difficulte que la Prediction,Pas Adapte
6082,2020,Philosophie,1,Introduction a la Philosophie,7,La Verite,9,753,3,QROC,0.08,0.56,98.64,61,1,62,61,61,0,1.02,100.0,Moyen,Facile,1,Plus Facile que la Prediction,Pas Adapte
753,2015,Philosophie,1,Introduction a la Philosophie,7,La Verite,9,754,4,QCU,0.09,0.88,99.64,52,0,52,52,52,0,1.0,100.0,Facile,Facile,0,Meme Difficulte que la Prediction,Pas Adapte
1819,2016,Philosophie,1,Introduction a la Philosophie,7,La Verite,9,754,4,QCM,0.45,0.52,49.87,28,29,57,57,28,29,1.0,49.12,Moyen,Moyen,0,Meme Difficulte que la Prediction,Pas Adapte
2885,2017,Philosophie,1,Introduction a la Philosophie,7,La Verite,9,754,4,QCM,0.46,0.43,63.65,40,23,63,42,40,2,1.5,95.24,Facile,Moyen,-1,Plus Difficile que la Prediction,Adapte
3951,2018,Philosophie,1,Introduction a la Philosophie,7,La Verite,9,754,4,QCM,0.45,0.47,63.65,36,21,57,44,36,8,1.3,81.82,Moyen,Moyen,0,Meme Difficulte que la Prediction,Adapte
5017,2019,Philosophie,1,Introduction a la Philosophie,7,La Verite,9,754,4,QCM,0.31,0.61,63.65,39,22,61,52,39,13,1.17,75.0,Moyen,Moyen,0,Meme Difficulte que la Prediction,Adapte
6083,2020,Philosophie,1,Introduction a la Philosophie,7,La Verite,9,754,4,QO,0.42,0.17,63.65,44,25,69,68,44,24,1.01,64.71,Moyen,Moyen,0,Meme Difficulte que la Prediction,Adapte
754,2015,Philosophie,1,Introduction a la Philosophie,7,La Verite,9,755,5,QO,0.92,0.08,7.94,8,91,99,94,8,86,1.05,8.51,Difficile,Difficile,0,Meme Difficulte que la Prediction,Pas Adapte
1820,2016,Philosophie,1,Introduction a la Philosophie,7,La Verite,9,755,5,QO,0.11,0.4,81.06,77,18,95,87,77,10,1.09,88.51,Facile,Facile,0,Meme Difficulte que la Prediction,Pas Adapte
2886,2017,Philosophie,1,Introduction a la Philosophie,7,La Verite,9,755,5,QO,0.25,0.21,44.07,47,60,107,58,47,11,1.84,81.03,Moyen,Moyen,0,Meme Difficulte que la Prediction,Pas Adapte
3952,2018,Philosophie,1,Introduction a la Philosophie,7,La Verite,9,755,5,QO,0.63,0.17,56.82,60,46,106,65,60,5,1.63,92.31,Moyen,Moyen,0,Meme Difficulte que la Prediction,Pas Adapte
5018,2019,Philosophie,1,Introduction a la Philosophie,7,La Verite,9,755,5,QO,0.25,0.27,62.22,61,37,98,78,61,17,1.26,78.21,Moyen,Moyen,0,Meme Difficulte que la Prediction,Adapte
6084,2020,Philosophie,1,Introduction a la Philosophie,7,La Verite,9,755,5,QO,0.7,0.17,62.22,52,31,83,72,52,20,1.15,72.22,Moyen,Moyen,0,Meme Difficulte que la Prediction,Adapte
755,2015,Philosophie,1,Introduction a la Philosophie,7,La Verite,9,756,6,QO,0.8,0.08,14.15,1,6,7,4,1,3,1.75,25.0,Moyen,Difficile,-1,Plus Difficile que la Prediction,Pas Adapte
1821,2016,Philosophie,1,Introduction a la Philosophie,7,La Verite,9,756,6,QO,0.16,0.44,77.11,5,1,6,6,5,1,1.0,83.33,Facile,Facile,0,Meme Difficulte que la Prediction,Pas Adapte
2887,2017,Philosophie,1,Introduction a la Philosophie,7,La Verite,9,756,6,QO,0.91,0.08,28.42,1,4,5,4,1,3,1.25,25.0,Difficile,Difficile,0,Meme Difficulte que la Prediction,Pas Adapte
3953,2018,Philosophie,1,Introduction a la Philosophie,7,La Verite,9,756,6,QO,0.49,0.2,61.48,2,2,4,4,2,2,1.0,50.0,Moyen,Moyen,0,Meme Difficulte que la Prediction,Adapte
5019,2019,Philosophie,1,Introduction a la Philosophie,7,La Verite,9,756,6,QO,0.62,0.15,61.48,3,2,5,4,3,1,1.25,75.0,Moyen,Moyen,0,Meme Difficulte que la Prediction,Adapte
6085,2020,Philosophie,1,Introduction a la Philosophie,7,La Verite,9,756,6,QROC,0.56,0.36,61.48,3,2,5,5,3,2,1.0,60.0,Moyen,Moyen,0,Meme Difficulte que la Prediction,Adapte
756,2015,Philosophie,1,Introduction a la Philosophie,7,La Verite,9,757,7,QCU,0.01,0.98,83.23,77,16,93,82,77,5,1.13,93.9,Moyen,Facile,1,Plus Facile que la Prediction,Pas Adapte
1822,2016,Philosophie,1,Introduction a la Philosophie,7,La Verite,9,757,7,QCU,0.45,0.21,14.04,13,79,92,41,13,28,2.24,31.71,Facile,Difficile,-2,Beaucoup plus Difficile que la Prediction,Pas Adapte
2888,2017,Philosophie,1,Introduction a la Philosophie,7,La Verite,9,757,7,QCU,0.63,0.31,24.34,22,70,92,44,22,22,2.09,50.0,Difficile,Difficile,0,Meme Difficulte que la Prediction,Pas Adapte
3954,2018,Philosophie,1,Introduction a la Philosophie,7,La Verite,9,757,7,QCM,0.06,0.9,74.01,64,23,87,67,64,3,1.3,95.52,Facile,Facile,0,Meme Difficulte que la Prediction,Adapte
5020,2019,Philosophie,1,Introduction a la Philosophie,7,La Verite,9,757,7,QCM,0.02,0.76,74.01,61,22,83,75,61,14,1.11,81.33,Facile,Facile,0,Meme Difficulte que la Prediction,Adapte
6086,2020,Philosophie,1,Introduction a la Philosophie,7,La Verite,9,757,7,QCM,0.16,0.92,74.01,63,22,85,84,63,21,1.01,75.0,Facile,Facile,0,Meme Difficulte que la Prediction,Adapte
757,2015,Philosophie,1,Introduction a la Philosophie,7,La Verite,9,758,8,QCU,0.39,0.43,36.79,11,20,31,18,11,7,1.72,61.11,Difficile,Moyen,1,Plus Facile que la Prediction,Pas Adapte
1823,2016,Philosophie,1,Introduction a la Philosophie,7,La Verite,9,758,8,QCU,0.02,0.94,65.17,20,11,31,20,20,0,1.55,100.0,Facile,Facile,0,Meme Difficulte que la Prediction,Adapte
2889,2017,Philosophie,1,Introduction a la Philosophie,7,La Verite,9,758,8,QCU,0.16,0.75,65.17,20,11,31,27,20,7,1.15,74.07,Facile,Facile,0,Meme Difficulte que la Prediction,Adapte
3955,2018,Philosophie,1,Introduction a la Philosophie,7,La Verite,9,758,8,QCU,0.14,0.99,65.17,21,11,32,23,21,2,1.39,91.3,Facile,Facile,0,Meme Difficulte que la Prediction,Adapte
5021,2019,Philosophie,1,Introduction a la Philosophie,7,La Verite,9,758,8,QCM,0.04,0.87,65.17,22,11,33,26,22,4,1.27,84.62,Facile,Facile,0,Meme Difficulte que la Prediction,Adapte
6087,2020,Philosophie,1,Introduction a la Philosophie,7,La Verite,9,758,8,QCM,0.17,0.94,65.17,25,13,38,29,25,4,1.31,86.21,Facile,Facile,0,Meme Difficulte que la Prediction,Adapte
758,2015,Philosophie,1,Introduction a la Philosophie,7,La Verite,9,759,9,QROC,0.31,0.26,49.87,21,22,43,42,21,21,1.02,50.0,Facile,Moyen,-1,Plus Difficile que la Prediction,Pas Adapte
1824,2016,Philosophie,1,Introduction a la Philosophie,7,La Verite,9,759,9,QROC,0.61,0.2,16.77,7,32,39,23,7,16,1.7,30.43,Difficile,Difficile,0,Meme Difficulte que la Prediction,Pas Adapte
2890,2017,Philosophie,1,Introduction a la Philosophie,7,La Verite,9,759,9,QROC,0.61,0.1,8.85,3,31,34,20,3,17,1.7,15.0,Moyen,Difficile,-1,Plus Difficile que la Prediction,Pas Adapte
3956,2018,Philosophie,1,Introduction a la Philosophie,7,La Verite,9,759,9,QROC,0.85,0.16,13.93,5,34,39,26,5,21,1.5,19.23,Difficile,Difficile,0,Meme Difficulte que la Prediction,Pas Adapte
5022,2019,Philosophie,1,Introduction a la Philosophie,7,La Verite,9,759,9,QROC,0.7,0.25,12.0,5,36,41,31,5,26,1.32,16.13,Facile,Difficile,-2,Beaucoup plus Difficile que la Prediction,Pas Adapte
6088,2020,Philosophie,1,Introduction a la Philosophie,7,La Verite,9,759,9,QCM,0.18,0.93,99.58,37,0,37,37,37,0,1.0,100.0,Facile,Facile,0,Meme Difficulte que la Prediction,Pas Adapte
759,2015,Philosophie,1,Introduction a la Philosophie,8,La Conscience,6,760,1,QCU,0.67,0.27,34.58,33,61,94,79,33,46,1.19,41.77,Moyen,Difficile,-1,Plus Difficile que la Prediction,Pas Adapte
1825,2016,Philosophie,1,Introduction a la Philosophie,8,La Conscience,6,760,1,QCU,0.13,0.77,83.84,85,16,101,93,85,8,1.09,91.4,Facile,Facile,0,Meme Difficulte que la Prediction,Pas Adapte
2891,2017,Philosophie,1,Introduction a la Philosophie,8,La Conscience,6,760,1,QCU,0.69,0.21,13.33,14,89,103,66,14,52,1.56,21.21,Facile,Difficile,-2,Beaucoup plus Difficile que la Prediction,Pas Adapte
3957,2018,Philosophie,1,Introduction a la Philosophie,8,La Conscience,6,760,1,QCU,0.31,0.74,44.08,43,55,98,91,43,48,1.08,47.25,Moyen,Moyen,0,Meme Difficulte que la Prediction,Pas Adapte
5023,2019,Philosophie,1,Introduction a la Philosophie,8,La Conscience,6,760,1,QCU,0.04,0.92,97.57,99,2,101,100,99,1,1.01,99.0,Moyen,Facile,1,Plus Facile que la Prediction,Pas Adapte
6089,2020,Philosophie,1,Introduction a la Philosophie,8,La Conscience,6,760,1,QCU,0.58,0.31,34.5,35,66,101,81,35,46,1.25,43.21,Difficile,Difficile,0,Meme Difficulte que la Prediction,Pas Adapte
760,2015,Philosophie,1,Introduction a la Philosophie,8,La Conscience,6,761,2,QCM,0.03,0.91,72.92,10,4,14,10,10,0,1.4,100.0,Moyen,Facile,1,Plus Facile que la Prediction,Adapte
1826,2016,Philosophie,1,Introduction a la Philosophie,8,La Conscience,6,761,2,QCM,0.07,0.7,72.92,12,4,16,14,12,2,1.14,85.71,Facile,Facile,0,Meme Difficulte que la Prediction,Adapte
2892,2017,Philosophie,1,Introduction a la Philosophie,8,La Conscience,6,761,2,QCM,0.04,0.97,72.92,13,5,18,14,13,1,1.29,92.86,Facile,Facile,0,Meme Difficulte que la Prediction,Adapte
3958,2018,Philosophie,1,Introduction a la Philosophie,8,La Conscience,6,761,2,QCM,0.04,0.81,72.92,15,6,21,15,15,0,1.4,100.0,Facile,Facile,0,Meme Difficulte que la Prediction,Adapte
5024,2019,Philosophie,1,Introduction a la Philosophie,8,La Conscience,6,761,2,QCM,0.02,0.72,72.92,16,6,22,20,16,4,1.1,80.0,Facile,Facile,0,Meme Difficulte que la Prediction,Adapte
6090,2020,Philosophie,1,Introduction a la Philosophie,8,La Conscience,6,761,2,QCM,0.0,0.99,72.92,15,6,21,15,15,0,1.4,100.0,Facile,Facile,0,Meme Difficulte que la Prediction,Adapte
761,2015,Philosophie,1,Introduction a la Philosophie,8,La Conscience,6,762,3,QCU,0.08,0.96,79.98,59,15,74,64,59,5,1.16,92.19,Difficile,Facile,2,Beaucoup plus Facile que la Prediction,Pas Adapte
1827,2016,Philosophie,1,Introduction a la Philosophie,8,La Conscience,6,762,3,QCU,0.19,0.84,66.29,51,26,77,52,51,1,1.48,98.08,Facile,Facile,0,Meme Difficulte que la Prediction,Adapte
2893,2017,Philosophie,1,Introduction a la Philosophie,8,La Conscience,6,762,3,QCU,0.2,0.98,66.29,59,30,89,85,59,26,1.05,69.41,Facile,Facile,0,Meme Difficulte que la Prediction,Adapte
3959,2018,Philosophie,1,Introduction a la Philosophie,8,La Conscience,6,762,3,QCU,0.17,0.77,66.29,56,28,84,75,56,19,1.12,74.67,Facile,Facile,0,Meme Difficulte que la Prediction,Adapte
5025,2019,Philosophie,1,Introduction a la Philosophie,8,La Conscience,6,762,3,QROC,0.06,0.81,66.29,54,28,82,80,54,26,1.02,67.5,Facile,Facile,0,Meme Difficulte que la Prediction,Adapte
6091,2020,Philosophie,1,Introduction a la Philosophie,8,La Conscience,6,762,3,QROC,0.07,0.58,66.29,48,24,72,63,48,15,1.14,76.19,Facile,Facile,0,Meme Difficulte que la Prediction,Adapte
762,2015,Philosophie,1,Introduction a la Philosophie,8,La Conscience,6,763,4,QCU,0.64,0.28,6.22,3,48,51,41,3,38,1.24,7.32,Facile,Difficile,-2,Beaucoup plus Difficile que la Prediction,Pas Adapte
1828,2016,Philosophie,1,Introduction a la Philosophie,8,La Conscience,6,763,4,QCU,0.21,0.57,47.53,26,29,55,36,26,10,1.53,72.22,Moyen,Moyen,0,Meme Difficulte que la Prediction,Pas Adapte
2894,2017,Philosophie,1,Introduction a la Philosophie,8,La Conscience,6,763,4,QCU,0.22,0.49,41.75,26,37,63,34,26,8,1.85,76.47,Moyen,Moyen,0,Meme Difficulte que la Prediction,Pas Adapte
3960,2018,Philosophie,1,Introduction a la Philosophie,8,La Conscience,6,763,4,QROC,0.16,0.48,75.98,51,16,67,58,51,7,1.16,87.93,Facile,Facile,0,Meme Difficulte que la Prediction,Pas Adapte
5026,2019,Philosophie,1,Introduction a la Philosophie,8,La Conscience,6,763,4,QROC,0.19,0.63,80.2,49,12,61,53,49,4,1.15,92.45,Moyen,Facile,1,Plus Facile que la Prediction,Pas Adapte
6092,2020,Philosophie,1,Introduction a la Philosophie,8,La Conscience,6,763,4,QO,0.89,0.07,25.32,15,43,58,53,15,38,1.09,28.3,Moyen,Difficile,-1,Plus Difficile que la Prediction,Pas Adapte
763,2015,Philosophie,1,Introduction a la Philosophie,8,La Conscience,6,764,5,QCU,0.13,0.97,98.77,40,0,40,40,40,0,1.0,100.0,Facile,Facile,0,Meme Difficulte que la Prediction,Pas Adapte
1829,2016,Philosophie,1,Introduction a la Philosophie,8,La Conscience,6,764,5,QCU,0.02,0.88,77.49,33,10,43,38,33,5,1.13,86.84,Facile,Facile,0,Meme Difficulte que la Prediction,Pas Adapte
2895,2017,Philosophie,1,Introduction a la Philosophie,8,La Conscience,6,764,5,QCM,0.15,0.87,71.07,31,12,43,33,31,2,1.3,93.94,Facile,Facile,0,Meme Difficulte que la Prediction,Adapte
3961,2018,Philosophie,1,Introduction a la Philosophie,8,La Conscience,6,764,5,QCU,0.12,0.76,71.07,34,14,48,46,34,12,1.04,73.91,Facile,Facile,0,Meme Difficulte que la Prediction,Adapte
5027,2019,Philosophie,1,Introduction a la Philosophie,8,La Conscience,6,764,5,QCU,0.09,0.95,71.07,29,12,41,32,29,3,1.28,90.62,Facile,Facile,0,Meme Difficulte que la Prediction,Adapte
6093,2020,Philosophie,1,Introduction a la Philosophie,8,La Conscience,6,764,5,QCU,0.11,0.75,71.07,32,13,45,42,32,10,1.07,76.19,Facile,Facile,0,Meme Difficulte que la Prediction,Adapte
764,2015,Philosophie,1,Introduction a la Philosophie,8,La Conscience,6,765,6,QCU,0.74,0.21,6.15,2,32,34,30,2,28,1.13,6.67,Difficile,Difficile,0,Meme Difficulte que la Prediction,Pas Adapte
1830,2016,Philosophie,1,Introduction a la Philosophie,8,La Conscience,6,765,6,QCU,0.7,0.35,24.11,7,23,30,20,7,13,1.5,35.0,Facile,Difficile,-2,Beaucoup plus Difficile que la Prediction,Pas Adapte
2896,2017,Philosophie,1,Introduction a la Philosophie,8,La Conscience,6,765,6,QCU,0.42,0.23,18.92,6,26,32,11,6,5,2.91,54.55,Difficile,Difficile,0,Meme Difficulte que la Prediction,Pas Adapte
3962,2018,Philosophie,1,Introduction a la Philosophie,8,La Conscience,6,765,6,QCU,0.71,0.32,3.23,1,30,31,23,1,22,1.35,4.35,Difficile,Difficile,0,Meme Difficulte que la Prediction,Pas Adapte
5028,2019,Philosophie,1,Introduction a la Philosophie,8,La Conscience,6,765,6,QCU,0.62,0.3,12.23,4,28,32,22,4,18,1.45,18.18,Difficile,Difficile,0,Meme Difficulte que la Prediction,Pas Adapte
6094,2020,Philosophie,1,Introduction a la Philosophie,8,La Conscience,6,765,6,QCU,0.05,0.79,68.36,20,9,29,26,20,6,1.12,76.92,Moyen,Facile,1,Plus Facile que la Prediction,Adapte
765,2015,Philosophie,1,Introduction a la Philosophie,9,La Liberte,8,766,1,QCU,0.53,0.22,33.15,29,59,88,67,29,38,1.31,43.28,Moyen,Difficile,-1,Plus Difficile que la Prediction,Pas Adapte
1831,2016,Philosophie,1,Introduction a la Philosophie,9,La Liberte,8,766,1,QCU,0.51,0.39,17.05,14,66,80,64,14,50,1.25,21.88,Difficile,Difficile,0,Meme Difficulte que la Prediction,Pas Adapte
2897,2017,Philosophie,1,Introduction a la Philosophie,9,La Liberte,8,766,1,QCU,0.38,0.52,36.63,25,43,68,26,25,1,2.62,96.15,Difficile,Moyen,1,Plus Facile que la Prediction,Pas Adapte
3963,2018,Philosophie,1,Introduction a la Philosophie,9,La Liberte,8,766,1,QCU,0.31,0.6,41.94,32,45,77,58,32,26,1.33,55.17,Moyen,Moyen,0,Meme Difficulte que la Prediction,Pas Adapte
5029,2019,Philosophie,1,Introduction a la Philosophie,9,La Liberte,8,766,1,QCU,0.1,0.88,73.52,57,20,77,63,57,6,1.22,90.48,Moyen,Facile,1,Plus Facile que la Prediction,Adapte
6095,2020,Philosophie,1,Introduction a la Philosophie,9,La Liberte,8,766,1,QROC,0.17,0.97,73.52,53,19,72,62,53,9,1.16,85.48,Facile,Facile,0,Meme Difficulte que la Prediction,Adapte
766,2015,Philosophie,1,Introduction a la Philosophie,9,La Liberte,8,767,2,QROC,0.06,0.62,80.9,11,3,14,11,11,0,1.27,100.0,Facile,Facile,0,Meme Difficulte que la Prediction,Pas Adapte
1832,2016,Philosophie,1,Introduction a la Philosophie,9,La Liberte,8,767,2,QROC,0.42,0.37,57.28,9,6,15,11,9,2,1.36,81.82,Moyen,Moyen,0,Meme Difficulte que la Prediction,Pas Adapte
2898,2017,Philosophie,1,Introduction a la Philosophie,9,La Liberte,8,767,2,QO,0.1,0.66,99.16,16,0,16,16,16,0,1.0,100.0,Difficile,Facile,2,Beaucoup plus Facile que la Prediction,Pas Adapte
3964,2018,Philosophie,1,Introduction a la Philosophie,9,La Liberte,8,767,2,QO,0.75,0.1,24.64,3,11,14,7,3,4,2.0,42.86,Difficile,Difficile,0,Meme Difficulte que la Prediction,Pas Adapte
5030,2019,Philosophie,1,Introduction a la Philosophie,9,La Liberte,8,767,2,QO,0.74,0.29,42.94,6,8,14,8,6,2,1.75,75.0,Difficile,Moyen,1,Plus Facile que la Prediction,Pas Adapte
6096,2020,Philosophie,1,Introduction a la Philosophie,9,La Liberte,8,767,2,QO,0.88,0.12,8.62,1,13,14,14,1,13,1.0,7.14,Difficile,Difficile,0,Meme Difficulte que la Prediction,Pas Adapte
767,2015,Philosophie,1,Introduction a la Philosophie,9,La Liberte,8,768,3,QCU,0.31,0.61,51.32,8,7,15,15,8,7,1.0,53.33,Moyen,Moyen,0,Meme Difficulte que la Prediction,Pas Adapte
1833,2016,Philosophie,1,Introduction a la Philosophie,9,La Liberte,8,768,3,QCU,0.35,0.46,64.32,9,5,14,12,9,3,1.17,75.0,Moyen,Moyen,0,Meme Difficulte que la Prediction,Adapte
2899,2017,Philosophie,1,Introduction a la Philosophie,9,La Liberte,8,768,3,QCU,0.23,0.48,64.32,10,6,16,14,10,4,1.14,71.43,Moyen,Moyen,0,Meme Difficulte que la Prediction,Adapte
3965,2018,Philosophie,1,Introduction a la Philosophie,9,La Liberte,8,768,3,QCU,0.23,0.54,64.32,12,6,18,15,12,3,1.2,80.0,Moyen,Moyen,0,Meme Difficulte que la Prediction,Adapte
5031,2019,Philosophie,1,Introduction a la Philosophie,9,La Liberte,8,768,3,QCU,0.28,0.43,64.32,11,6,17,15,11,4,1.13,73.33,Moyen,Moyen,0,Meme Difficulte que la Prediction,Adapte
6097,2020,Philosophie,1,Introduction a la Philosophie,9,La Liberte,8,768,3,QCU,0.34,0.68,64.32,12,7,19,16,12,4,1.19,75.0,Moyen,Moyen,0,Meme Difficulte que la Prediction,Adapte
768,2015,Philosophie,1,Introduction a la Philosophie,9,La Liberte,8,769,4,QCU,0.19,0.9,83.37,5,1,6,6,5,1,1.0,83.33,Facile,Facile,0,Meme Difficulte que la Prediction,Pas Adapte
1834,2016,Philosophie,1,Introduction a la Philosophie,9,La Liberte,8,769,4,QCU,0.05,0.95,80.68,4,1,5,4,4,0,1.25,100.0,Facile,Facile,0,Meme Difficulte que la Prediction,Pas Adapte
2900,2017,Philosophie,1,Introduction a la Philosophie,9,La Liberte,8,769,4,QCM,0.09,0.81,74.66,4,2,6,5,4,1,1.2,80.0,Facile,Facile,0,Meme Difficulte que la Prediction,Adapte
3966,2018,Philosophie,1,Introduction a la Philosophie,9,La Liberte,8,769,4,QO,0.15,0.93,74.66,4,2,6,5,4,1,1.2,80.0,Facile,Facile,0,Meme Difficulte que la Prediction,Adapte
5032,2019,Philosophie,1,Introduction a la Philosophie,9,La Liberte,8,769,4,QO,0.19,0.92,74.66,4,1,5,5,4,1,1.0,80.0,Facile,Facile,0,Meme Difficulte que la Prediction,Adapte
6098,2020,Philosophie,1,Introduction a la Philosophie,9,La Liberte,8,769,4,QO,0.16,0.53,74.66,3,1,4,4,3,1,1.0,75.0,Facile,Facile,0,Meme Difficulte que la Prediction,Adapte
769,2015,Philosophie,1,Introduction a la Philosophie,9,La Liberte,8,770,5,QCU,0.56,0.24,25.84,3,9,12,11,3,8,1.09,27.27,Difficile,Difficile,0,Meme Difficulte que la Prediction,Pas Adapte
1835,2016,Philosophie,1,Introduction a la Philosophie,9,La Liberte,8,770,5,QCU,0.5,0.37,20.18,2,10,12,11,2,9,1.09,18.18,Moyen,Difficile,-1,Plus Difficile que la Prediction,Pas Adapte
2901,2017,Philosophie,1,Introduction a la Philosophie,9,La Liberte,8,770,5,QCU,0.4,0.38,16.76,2,9,11,11,2,9,1.0,18.18,Difficile,Difficile,0,Meme Difficulte que la Prediction,Pas Adapte
3967,2018,Philosophie,1,Introduction a la Philosophie,9,La Liberte,8,770,5,QCU,0.54,0.28,10.45,1,9,10,4,1,3,2.5,25.0,Moyen,Difficile,-1,Plus Difficile que la Prediction,Pas Adapte
5033,2019,Philosophie,1,Introduction a la Philosophie,9,La Liberte,8,770,5,QCU,0.42,0.2,13.7,1,8,9,7,1,6,1.29,14.29,Moyen,Difficile,-1,Plus Difficile que la Prediction,Pas Adapte
6099,2020,Philosophie,1,Introduction a la Philosophie,9,La Liberte,8,770,5,QCU,0.43,0.31,18.57,2,8,10,9,2,7,1.11,22.22,Difficile,Difficile,0,Meme Difficulte que la Prediction,Pas Adapte
770,2015,Philosophie,1,Introduction a la Philosophie,9,La Liberte,8,771,6,QO,0.72,0.17,44.32,27,33,60,53,27,26,1.13,50.94,Moyen,Moyen,0,Meme Difficulte que la Prediction,Pas Adapte
1836,2016,Philosophie,1,Introduction a la Philosophie,9,La Liberte,8,771,6,QO,0.11,0.79,80.2,49,12,61,54,49,5,1.13,90.74,Facile,Facile,0,Meme Difficulte que la Prediction,Pas Adapte
2902,2017,Philosophie,1,Introduction a la Philosophie,9,La Liberte,8,771,6,QO,0.15,0.69,92.24,62,5,67,63,62,1,1.06,98.41,Facile,Facile,0,Meme Difficulte que la Prediction,Pas Adapte
3968,2018,Philosophie,1,Introduction a la Philosophie,9,La Liberte,8,771,6,QO,0.01,0.87,68.36,46,22,68,47,46,1,1.45,97.87,Facile,Facile,0,Meme Difficulte que la Prediction,Adapte
5034,2019,Philosophie,1,Introduction a la Philosophie,9,La Liberte,8,771,6,QCU,0.11,0.93,68.36,48,22,70,48,48,0,1.46,100.0,Facile,Facile,0,Meme Difficulte que la Prediction,Adapte
6100,2020,Philosophie,1,Introduction a la Philosophie,9,La Liberte,8,771,6,QCU,0.16,0.76,68.36,46,21,67,46,46,0,1.46,100.0,Facile,Facile,0,Meme Difficulte que la Prediction,Adapte
771,2015,Philosophie,1,Introduction a la Philosophie,9,La Liberte,8,772,7,QCU,0.2,0.54,41.65,37,53,90,58,37,21,1.55,63.79,Moyen,Moyen,0,Meme Difficulte que la Prediction,Pas Adapte
1837,2016,Philosophie,1,Introduction a la Philosophie,9,La Liberte,8,772,7,QCU,0.33,0.41,35.08,30,56,86,30,30,0,2.87,100.0,Moyen,Moyen,0,Meme Difficulte que la Prediction,Pas Adapte
2903,2017,Philosophie,1,Introduction a la Philosophie,9,La Liberte,8,772,7,QROC,0.69,0.09,21.6,21,75,96,56,21,35,1.71,37.5,Difficile,Difficile,0,Meme Difficulte que la Prediction,Pas Adapte
3969,2018,Philosophie,1,Introduction a la Philosophie,9,La Liberte,8,772,7,QROC,0.18,0.66,72.44,71,27,98,83,71,12,1.18,85.54,Facile,Facile,0,Meme Difficulte que la Prediction,Adapte
5035,2019,Philosophie,1,Introduction a la Philosophie,9,La Liberte,8,772,7,QROC,0.1,0.5,72.44,67,26,93,67,67,0,1.39,100.0,Facile,Facile,0,Meme Difficulte que la Prediction,Adapte
6101,2020,Philosophie,1,Introduction a la Philosophie,9,La Liberte,8,772,7,QO,0.04,0.61,72.44,69,26,95,83,69,14,1.14,83.13,Facile,Facile,0,Meme Difficulte que la Prediction,Adapte
772,2015,Philosophie,1,Introduction a la Philosophie,9,La Liberte,8,773,8,QO,0.91,0.12,12.97,2,13,15,14,2,12,1.07,14.29,Facile,Difficile,-2,Beaucoup plus Difficile que la Prediction,Pas Adapte
1838,2016,Philosophie,1,Introduction a la Philosophie,9,La Liberte,8,773,8,QROC,0.18,0.4,70.71,10,4,14,11,10,1,1.27,90.91,Difficile,Facile,2,Beaucoup plus Facile que la Prediction,Adapte
2904,2017,Philosophie,1,Introduction a la Philosophie,9,La Liberte,8,773,8,QROC,0.12,0.46,70.71,8,4,12,12,8,4,1.0,66.67,Facile,Facile,0,Meme Difficulte que la Prediction,Adapte
3970,2018,Philosophie,1,Introduction a la Philosophie,9,La Liberte,8,773,8,QROC,0.1,0.46,70.71,8,3,11,11,8,3,1.0,72.73,Facile,Facile,0,Meme Difficulte que la Prediction,Adapte
5036,2019,Philosophie,1,Introduction a la Philosophie,9,La Liberte,8,773,8,QROC,0.12,0.92,70.71,7,3,10,7,7,0,1.43,100.0,Facile,Facile,0,Meme Difficulte que la Prediction,Adapte
6102,2020,Philosophie,1,Introduction a la Philosophie,9,La Liberte,8,773,8,QROC,0.08,0.58,70.71,8,3,11,10,8,2,1.1,80.0,Facile,Facile,0,Meme Difficulte que la Prediction,Adapte
773,2015,Philosophie,1,La Notion de Logique,1,Les Lois Logiques,9,774,1,QROC,0.14,0.85,74.72,25,8,33,29,25,4,1.14,86.21,Facile,Facile,0,Meme Difficulte que la Prediction,Adapte
1839,2016,Philosophie,1,La Notion de Logique,1,Les Lois Logiques,9,774,1,QROC,0.03,0.66,74.72,25,9,34,29,25,4,1.17,86.21,Facile,Facile,0,Meme Difficulte que la Prediction,Adapte
2905,2017,Philosophie,1,La Notion de Logique,1,Les Lois Logiques,9,774,1,QROC,0.04,0.57,74.72,29,10,39,39,29,10,1.0,74.36,Facile,Facile,0,Meme Difficulte que la Prediction,Adapte
3971,2018,Philosophie,1,La Notion de Logique,1,Les Lois Logiques,9,774,1,QROC,0.05,0.86,74.72,27,9,36,32,27,5,1.12,84.38,Facile,Facile,0,Meme Difficulte que la Prediction,Adapte
5037,2019,Philosophie,1,La Notion de Logique,1,Les Lois Logiques,9,774,1,QROC,0.08,0.94,74.72,28,9,37,30,28,2,1.23,93.33,Facile,Facile,0,Meme Difficulte que la Prediction,Adapte
6103,2020,Philosophie,1,La Notion de Logique,1,Les Lois Logiques,9,774,1,QROC,0.08,0.87,74.72,29,10,39,33,29,4,1.18,87.88,Facile,Facile,0,Meme Difficulte que la Prediction,Adapte
774,2015,Philosophie,1,La Notion de Logique,1,Les Lois Logiques,9,775,2,QCU,0.36,0.47,51.86,34,31,65,41,34,7,1.59,82.93,Moyen,Moyen,0,Meme Difficulte que la Prediction,Pas Adapte
1840,2016,Philosophie,1,La Notion de Logique,1,Les Lois Logiques,9,775,2,QCU,0.26,0.42,44.61,33,41,74,67,33,34,1.1,49.25,Difficile,Moyen,1,Plus Facile que la Prediction,Pas Adapte
2906,2017,Philosophie,1,La Notion de Logique,1,Les Lois Logiques,9,775,2,QCU,0.63,0.33,29.33,23,54,77,55,23,32,1.4,41.82,Difficile,Difficile,0,Meme Difficulte que la Prediction,Pas Adapte
3972,2018,Philosophie,1,La Notion de Logique,1,Les Lois Logiques,9,775,2,QCU,0.55,0.25,22.32,19,66,85,46,19,27,1.85,41.3,Difficile,Difficile,0,Meme Difficulte que la Prediction,Pas Adapte
5038,2019,Philosophie,1,La Notion de Logique,1,Les Lois Logiques,9,775,2,QCU,0.19,0.8,79.24,66,17,83,76,66,10,1.09,86.84,Facile,Facile,0,Meme Difficulte que la Prediction,Pas Adapte
6104,2020,Philosophie,1,La Notion de Logique,1,Les Lois Logiques,9,775,2,QCU,0.18,0.81,88.59,67,9,76,74,67,7,1.03,90.54,Facile,Facile,0,Meme Difficulte que la Prediction,Pas Adapte
775,2015,Philosophie,1,La Notion de Logique,1,Les Lois Logiques,9,776,3,QCU,0.24,0.57,46.94,46,53,99,96,46,50,1.03,47.92,Facile,Moyen,-1,Plus Difficile que la Prediction,Pas Adapte
1841,2016,Philosophie,1,La Notion de Logique,1,Les Lois Logiques,9,776,3,QCU,0.66,0.39,3.28,3,103,106,101,3,98,1.05,2.97,Difficile,Difficile,0,Meme Difficulte que la Prediction,Pas Adapte
2907,2017,Philosophie,1,La Notion de Logique,1,Les Lois Logiques,9,776,3,QCU,0.7,0.39,32.14,33,69,102,87,33,54,1.17,37.93,Moyen,Difficile,-1,Plus Difficile que la Prediction,Pas Adapte
3973,2018,Philosophie,1,La Notion de Logique,1,Les Lois Logiques,9,776,3,QCM,0.59,0.24,1.92,2,106,108,47,2,45,2.3,4.26,Difficile,Difficile,0,Meme Difficulte que la Prediction,Pas Adapte
5039,2019,Philosophie,1,La Notion de Logique,1,Les Lois Logiques,9,776,3,QCM,0.36,0.43,60.1,61,41,102,81,61,20,1.26,75.31,Moyen,Moyen,0,Meme Difficulte que la Prediction,Adapte
6105,2020,Philosophie,1,La Notion de Logique,1,Les Lois Logiques,9,776,3,QCM,0.31,0.38,60.1,59,39,98,86,59,27,1.14,68.6,Moyen,Moyen,0,Meme Difficulte que la Prediction,Adapte
776,2015,Philosophie,1,La Notion de Logique,1,Les Lois Logiques,9,777,4,QROC,0.36,0.28,63.54,34,19,53,36,34,2,1.47,94.44,Facile,Moyen,-1,Plus Difficile que la Prediction,Adapte
1842,2016,Philosophie,1,La Notion de Logique,1,Les Lois Logiques,9,777,4,QROC,0.46,0.39,63.54,35,20,55,42,35,7,1.31,83.33,Moyen,Moyen,0,Meme Difficulte que la Prediction,Adapte
2908,2017,Philosophie,1,La Notion de Logique,1,Les Lois Logiques,9,777,4,QROC,0.23,0.33,63.54,36,20,56,56,36,20,1.0,64.29,Moyen,Moyen,0,Meme Difficulte que la Prediction,Adapte
3974,2018,Philosophie,1,La Notion de Logique,1,Les Lois Logiques,9,777,4,QROC,0.28,0.35,63.54,39,22,61,57,39,18,1.07,68.42,Moyen,Moyen,0,Meme Difficulte que la Prediction,Adapte
5040,2019,Philosophie,1,La Notion de Logique,1,Les Lois Logiques,9,777,4,QROC,0.5,0.38,63.54,34,20,54,49,34,15,1.1,69.39,Moyen,Moyen,0,Meme Difficulte que la Prediction,Adapte
6106,2020,Philosophie,1,La Notion de Logique,1,Les Lois Logiques,9,777,4,QROC,0.3,0.38,63.54,33,19,52,46,33,13,1.13,71.74,Moyen,Moyen,0,Meme Difficulte que la Prediction,Adapte
777,2015,Philosophie,1,La Notion de Logique,1,Les Lois Logiques,9,778,5,QCM,0.71,0.21,12.22,8,57,65,23,8,15,2.83,34.78,Difficile,Difficile,0,Meme Difficulte que la Prediction,Pas Adapte
1843,2016,Philosophie,1,La Notion de Logique,1,Les Lois Logiques,9,778,5,QCM,0.43,0.41,58.08,44,31,75,48,44,4,1.56,91.67,Moyen,Moyen,0,Meme Difficulte que la Prediction,Pas Adapte
2909,2017,Philosophie,1,La Notion de Logique,1,Les Lois Logiques,9,778,5,QCM,0.43,0.5,45.29,35,42,77,53,35,18,1.45,66.04,Facile,Moyen,-1,Plus Difficile que la Prediction,Pas Adapte
3975,2018,Philosophie,1,La Notion de Logique,1,Les Lois Logiques,9,778,5,QCM,0.67,0.17,4.81,4,78,82,53,4,49,1.55,7.55,Difficile,Difficile,0,Meme Difficulte que la Prediction,Pas Adapte
5041,2019,Philosophie,1,La Notion de Logique,1,Les Lois Logiques,9,778,5,QCU,0.41,0.36,6.98,5,69,74,50,5,45,1.48,10.0,Difficile,Difficile,0,Meme Difficulte que la Prediction,Pas Adapte
6107,2020,Philosophie,1,La Notion de Logique,1,Les Lois Logiques,9,778,5,QCM,0.48,0.46,58.48,43,30,73,61,43,18,1.2,70.49,Moyen,Moyen,0,Meme Difficulte que la Prediction,Pas Adapte
778,2015,Philosophie,1,La Notion de Logique,1,Les Lois Logiques,9,779,6,QCM,0.77,0.22,19.36,14,58,72,57,14,43,1.26,24.56,Difficile,Difficile,0,Meme Difficulte que la Prediction,Pas Adapte
1844,2016,Philosophie,1,La Notion de Logique,1,Les Lois Logiques,9,779,6,QCM,0.17,0.72,78.87,61,16,77,76,61,15,1.01,80.26,Facile,Facile,0,Meme Difficulte que la Prediction,Pas Adapte
2910,2017,Philosophie,1,La Notion de Logique,1,Les Lois Logiques,9,779,6,QCM,0.42,0.54,44.97,36,43,79,57,36,21,1.39,63.16,Moyen,Moyen,0,Meme Difficulte que la Prediction,Pas Adapte
3976,2018,Philosophie,1,La Notion de Logique,1,Les Lois Logiques,9,779,6,QCM,0.06,0.8,80.93,68,16,84,82,68,14,1.02,82.93,Facile,Facile,0,Meme Difficulte que la Prediction,Pas Adapte
5042,2019,Philosophie,1,La Notion de Logique,1,Les Lois Logiques,9,779,6,QCM,0.26,0.66,47.41,41,46,87,83,41,42,1.05,49.4,Moyen,Moyen,0,Meme Difficulte que la Prediction,Pas Adapte
6108,2020,Philosophie,1,La Notion de Logique,1,Les Lois Logiques,9,779,6,QCM,0.67,0.18,26.67,24,65,89,81,24,57,1.1,29.63,Difficile,Difficile,0,Meme Difficulte que la Prediction,Pas Adapte
779,2015,Philosophie,1,La Notion de Logique,1,Les Lois Logiques,9,780,7,QCU,0.63,0.27,3.08,3,87,90,89,3,86,1.01,3.37,Difficile,Difficile,0,Meme Difficulte que la Prediction,Pas Adapte
1845,2016,Philosophie,1,La Notion de Logique,1,Les Lois Logiques,9,780,7,QCU,0.39,0.6,46.85,48,55,103,100,48,52,1.03,48.0,Moyen,Moyen,0,Meme Difficulte que la Prediction,Pas Adapte
2911,2017,Philosophie,1,La Notion de Logique,1,Les Lois Logiques,9,780,7,QCU,0.67,0.34,30.47,31,72,103,99,31,68,1.04,31.31,Moyen,Difficile,-1,Plus Difficile que la Prediction,Pas Adapte
3977,2018,Philosophie,1,La Notion de Logique,1,Les Lois Logiques,9,780,7,QROC,0.45,0.35,44.32,43,53,96,61,43,18,1.57,70.49,Facile,Moyen,-1,Plus Difficile que la Prediction,Pas Adapte
5043,2019,Philosophie,1,La Notion de Logique,1,Les Lois Logiques,9,780,7,QROC,0.05,0.85,65.8,57,30,87,59,57,2,1.47,96.61,Difficile,Facile,2,Beaucoup plus Facile que la Prediction,Adapte
6109,2020,Philosophie,1,La Notion de Logique,1,Les Lois Logiques,9,780,7,QROC,0.08,0.8,65.8,57,29,86,76,57,19,1.13,75.0,Facile,Facile,0,Meme Difficulte que la Prediction,Adapte
780,2015,Philosophie,1,La Notion de Logique,1,Les Lois Logiques,9,781,8,QROC,0.51,0.31,52.51,15,14,29,20,15,5,1.45,75.0,Moyen,Moyen,0,Meme Difficulte que la Prediction,Pas Adapte
1846,2016,Philosophie,1,La Notion de Logique,1,Les Lois Logiques,9,781,8,QROC,0.45,0.27,57.0,15,12,27,22,15,7,1.23,68.18,Difficile,Moyen,1,Plus Facile que la Prediction,Pas Adapte
2912,2017,Philosophie,1,La Notion de Logique,1,Les Lois Logiques,9,781,8,QROC,0.25,0.36,35.51,8,15,23,18,8,10,1.28,44.44,Moyen,Moyen,0,Meme Difficulte que la Prediction,Pas Adapte
3978,2018,Philosophie,1,La Notion de Logique,1,Les Lois Logiques,9,781,8,QROC,0.63,0.2,10.5,3,21,24,22,3,19,1.09,13.64,Moyen,Difficile,-1,Plus Difficile que la Prediction,Pas Adapte
5044,2019,Philosophie,1,La Notion de Logique,1,Les Lois Logiques,9,781,8,QROC,0.73,0.06,0.22,0,22,22,9,0,9,2.44,0.0,Facile,Difficile,-2,Beaucoup plus Difficile que la Prediction,Pas Adapte
6110,2020,Philosophie,1,La Notion de Logique,1,Les Lois Logiques,9,781,8,QROC,0.91,0.17,18.43,4,20,24,18,4,14,1.33,22.22,Difficile,Difficile,0,Meme Difficulte que la Prediction,Pas Adapte
781,2015,Philosophie,1,La Notion de Logique,1,Les Lois Logiques,9,782,9,QCU,0.58,0.25,28.58,21,51,72,27,21,6,2.67,77.78,Facile,Difficile,-2,Beaucoup plus Difficile que la Prediction,Pas Adapte
1847,2016,Philosophie,1,La Notion de Logique,1,Les Lois Logiques,9,782,9,QCM,0.62,0.2,11.57,7,56,63,21,7,14,3.0,33.33,Difficile,Difficile,0,Meme Difficulte que la Prediction,Pas Adapte
2913,2017,Philosophie,1,La Notion de Logique,1,Les Lois Logiques,9,782,9,QCM,0.23,0.48,59.59,42,28,70,54,42,12,1.3,77.78,Moyen,Moyen,0,Meme Difficulte que la Prediction,Pas Adapte
3979,2018,Philosophie,1,La Notion de Logique,1,Les Lois Logiques,9,782,9,QCM,0.1,0.81,89.57,57,7,64,63,57,6,1.02,90.48,Facile,Facile,0,Meme Difficulte que la Prediction,Pas Adapte
5045,2019,Philosophie,1,La Notion de Logique,1,Les Lois Logiques,9,782,9,QCM,0.38,0.34,57.87,34,25,59,57,34,23,1.04,59.65,Difficile,Moyen,1,Plus Facile que la Prediction,Pas Adapte
6111,2020,Philosophie,1,La Notion de Logique,1,Les Lois Logiques,9,782,9,QCM,0.08,0.84,80.51,43,10,53,46,43,3,1.15,93.48,Difficile,Facile,2,Beaucoup plus Facile que la Prediction,Pas Adapte
782,2015,Philosophie,1,La Notion de Logique,2,Les Raisonnements Valides,6,783,1,QCM,0.72,0.27,28.53,26,66,92,68,26,42,1.35,38.24,Difficile,Difficile,0,Meme Difficulte que la Prediction,Pas Adapte
1848,2016,Philosophie,1,La Notion de Logique,2,Les Raisonnements Valides,6,783,1,QCM,0.44,0.56,36.79,35,60,95,36,35,1,2.64,97.22,Difficile,Moyen,1,Plus Facile que la Prediction,Pas Adapte
2914,2017,Philosophie,1,La Notion de Logique,2,Les Raisonnements Valides,6,783,1,QCM,0.66,0.27,11.34,10,80,90,44,10,34,2.05,22.73,Moyen,Difficile,-1,Plus Difficile que la Prediction,Pas Adapte
3980,2018,Philosophie,1,La Notion de Logique,2,Les Raisonnements Valides,6,783,1,QCM,0.05,0.76,96.27,84,3,87,85,84,1,1.02,98.82,Moyen,Facile,1,Plus Facile que la Prediction,Pas Adapte
5046,2019,Philosophie,1,La Notion de Logique,2,Les Raisonnements Valides,6,783,1,QCM,0.13,0.74,69.18,66,30,96,85,66,19,1.13,77.65,Facile,Facile,0,Meme Difficulte que la Prediction,Adapte
6112,2020,Philosophie,1,La Notion de Logique,2,Les Raisonnements Valides,6,783,1,QCM,0.04,0.85,69.18,66,29,95,91,66,25,1.04,72.53,Facile,Facile,0,Meme Difficulte que la Prediction,Adapte
783,2015,Philosophie,1,La Notion de Logique,2,Les Raisonnements Valides,6,784,2,QO,0.69,0.23,47.72,13,14,27,26,13,13,1.04,50.0,Difficile,Moyen,1,Plus Facile que la Prediction,Pas Adapte
1849,2016,Philosophie,1,La Notion de Logique,2,Les Raisonnements Valides,6,784,2,QO,0.91,0.09,19.76,6,25,31,22,6,16,1.41,27.27,Moyen,Difficile,-1,Plus Difficile que la Prediction,Pas Adapte
2915,2017,Philosophie,1,La Notion de Logique,2,Les Raisonnements Valides,6,784,2,QO,0.2,0.94,71.8,23,9,32,31,23,8,1.03,74.19,Moyen,Facile,1,Plus Facile que la Prediction,Adapte
3981,2018,Philosophie,1,La Notion de Logique,2,Les Raisonnements Valides,6,784,2,QO,0.14,0.46,71.8,22,8,30,25,22,3,1.2,88.0,Facile,Facile,0,Meme Difficulte que la Prediction,Adapte
5047,2019,Philosophie,1,La Notion de Logique,2,Les Raisonnements Valides,6,784,2,QO,0.08,0.43,71.8,19,7,26,23,19,4,1.13,82.61,Facile,Facile,0,Meme Difficulte que la Prediction,Adapte
6113,2020,Philosophie,1,La Notion de Logique,2,Les Raisonnements Valides,6,784,2,QO,0.18,0.48,71.8,19,8,27,24,19,5,1.12,79.17,Facile,Facile,0,Meme Difficulte que la Prediction,Adapte
784,2015,Philosophie,1,La Notion de Logique,2,Les Raisonnements Valides,6,785,3,QCU,0.24,0.59,47.11,24,27,51,45,24,21,1.13,53.33,Difficile,Moyen,1,Plus Facile que la Prediction,Pas Adapte
1850,2016,Philosophie,1,La Notion de Logique,2,Les Raisonnements Valides,6,785,3,QCU,0.35,0.74,62.54,36,22,58,57,36,21,1.02,63.16,Moyen,Moyen,0,Meme Difficulte que la Prediction,Adapte
2916,2017,Philosophie,1,La Notion de Logique,2,Les Raisonnements Valides,6,785,3,QCU,0.34,0.42,62.54,31,18,49,43,31,12,1.14,72.09,Moyen,Moyen,0,Meme Difficulte que la Prediction,Adapte
3982,2018,Philosophie,1,La Notion de Logique,2,Les Raisonnements Valides,6,785,3,QCU,0.2,0.6,62.54,32,19,51,51,32,19,1.0,62.75,Moyen,Moyen,0,Meme Difficulte que la Prediction,Adapte
5048,2019,Philosophie,1,La Notion de Logique,2,Les Raisonnements Valides,6,785,3,QROC,0.29,0.27,62.54,37,22,59,43,37,6,1.37,86.05,Moyen,Moyen,0,Meme Difficulte que la Prediction,Adapte
6114,2020,Philosophie,1,La Notion de Logique,2,Les Raisonnements Valides,6,785,3,QROC,0.34,0.4,62.54,39,24,63,53,39,14,1.19,73.58,Moyen,Moyen,0,Meme Difficulte que la Prediction,Adapte
785,2015,Philosophie,1,La Notion de Logique,2,Les Raisonnements Valides,6,786,4,QCU,0.16,0.99,75.59,14,5,19,16,14,2,1.19,87.5,Moyen,Facile,1,Plus Facile que la Prediction,Pas Adapte
1851,2016,Philosophie,1,La Notion de Logique,2,Les Raisonnements Valides,6,786,4,QCU,0.1,0.9,70.03,13,6,19,14,13,1,1.36,92.86,Facile,Facile,0,Meme Difficulte que la Prediction,Adapte
2917,2017,Philosophie,1,La Notion de Logique,2,Les Raisonnements Valides,6,786,4,QCU,0.03,0.89,70.03,15,7,22,22,15,7,1.0,68.18,Facile,Facile,0,Meme Difficulte que la Prediction,Adapte
3983,2018,Philosophie,1,La Notion de Logique,2,Les Raisonnements Valides,6,786,4,QCM,0.06,0.85,70.03,14,6,20,17,14,3,1.18,82.35,Facile,Facile,0,Meme Difficulte que la Prediction,Adapte
5049,2019,Philosophie,1,La Notion de Logique,2,Les Raisonnements Valides,6,786,4,QCM,0.1,0.75,70.03,13,6,19,15,13,2,1.27,86.67,Facile,Facile,0,Meme Difficulte que la Prediction,Adapte
6115,2020,Philosophie,1,La Notion de Logique,2,Les Raisonnements Valides,6,786,4,QCM,0.08,0.77,70.03,12,5,17,13,12,1,1.31,92.31,Facile,Facile,0,Meme Difficulte que la Prediction,Adapte
786,2015,Philosophie,1,La Notion de Logique,2,Les Raisonnements Valides,6,787,5,QCM,0.53,0.28,26.1,4,13,17,13,4,9,1.31,30.77,Difficile,Difficile,0,Meme Difficulte que la Prediction,Pas Adapte
1852,2016,Philosophie,1,La Notion de Logique,2,Les Raisonnements Valides,6,787,5,QCM,0.75,0.27,14.76,2,13,15,8,2,6,1.88,25.0,Difficile,Difficile,0,Meme Difficulte que la Prediction,Pas Adapte
2918,2017,Philosophie,1,La Notion de Logique,2,Les Raisonnements Valides,6,787,5,QCM,0.18,0.81,97.67,13,0,13,13,13,0,1.0,100.0,Facile,Facile,0,Meme Difficulte que la Prediction,Pas Adapte
3984,2018,Philosophie,1,La Notion de Logique,2,Les Raisonnements Valides,6,787,5,QCM,0.44,0.4,48.82,7,7,14,14,7,7,1.0,50.0,Facile,Moyen,-1,Plus Difficile que la Prediction,Pas Adapte
5050,2019,Philosophie,1,La Notion de Logique,2,Les Raisonnements Valides,6,787,5,QCU,0.54,0.2,2.34,0,16,16,8,0,8,2.0,0.0,Difficile,Difficile,0,Meme Difficulte que la Prediction,Pas Adapte
6116,2020,Philosophie,1,La Notion de Logique,2,Les Raisonnements Valides,6,787,5,QCU,0.0,0.97,72.01,10,4,14,12,10,2,1.17,83.33,Moyen,Facile,1,Plus Facile que la Prediction,Adapte
787,2015,Philosophie,1,La Notion de Logique,2,Les Raisonnements Valides,6,788,6,QCU,0.13,0.87,81.01,11,2,13,12,11,1,1.08,91.67,Facile,Facile,0,Meme Difficulte que la Prediction,Pas Adapte
1853,2016,Philosophie,1,La Notion de Logique,2,Les Raisonnements Valides,6,788,6,QCU,0.65,0.21,16.41,2,10,12,9,2,7,1.33,22.22,Moyen,Difficile,-1,Plus Difficile que la Prediction,Pas Adapte
2919,2017,Philosophie,1,La Notion de Logique,2,Les Raisonnements Valides,6,788,6,QCM,0.29,0.46,54.11,7,6,13,8,7,1,1.62,87.5,Difficile,Moyen,1,Plus Facile que la Prediction,Pas Adapte
3985,2018,Philosophie,1,La Notion de Logique,2,Les Raisonnements Valides,6,788,6,QCU,0.26,0.49,63.13,9,6,15,10,9,1,1.5,90.0,Facile,Moyen,-1,Plus Difficile que la Prediction,Adapte
5051,2019,Philosophie,1,La Notion de Logique,2,Les Raisonnements Valides,6,788,6,QCU,0.3,0.43,63.13,10,6,16,11,10,1,1.45,90.91,Moyen,Moyen,0,Meme Difficulte que la Prediction,Adapte
6117,2020,Philosophie,1,La Notion de Logique,2,Les Raisonnements Valides,6,788,6,QCU,0.24,0.74,63.13,11,6,17,13,11,2,1.31,84.62,Moyen,Moyen,0,Meme Difficulte que la Prediction,Adapte
788,2015,Philosophie,1,La Notion de Logique,3,Les Paradoxes,7,789,1,QCU,0.27,0.6,53.08,42,37,79,57,42,15,1.39,73.68,Moyen,Moyen,0,Meme Difficulte que la Prediction,Pas Adapte
1854,2016,Philosophie,1,La Notion de Logique,3,Les Paradoxes,7,789,1,QCU,0.03,0.91,92.15,84,7,91,88,84,4,1.03,95.45,Facile,Facile,0,Meme Difficulte que la Prediction,Pas Adapte
2920,2017,Philosophie,1,La Notion de Logique,3,Les Paradoxes,7,789,1,QCU,0.14,0.98,94.93,82,4,86,86,82,4,1.0,95.35,Facile,Facile,0,Meme Difficulte que la Prediction,Pas Adapte
3986,2018,Philosophie,1,La Notion de Logique,3,Les Paradoxes,7,789,1,QCU,0.54,0.37,3.71,3,74,77,36,3,33,2.14,8.33,Difficile,Difficile,0,Meme Difficulte que la Prediction,Pas Adapte
5052,2019,Philosophie,1,La Notion de Logique,3,Les Paradoxes,7,789,1,QCU,0.44,0.33,11.8,8,57,65,31,8,23,2.1,25.81,Facile,Difficile,-2,Beaucoup plus Difficile que la Prediction,Pas Adapte
6118,2020,Philosophie,1,La Notion de Logique,3,Les Paradoxes,7,789,1,QCU,0.14,0.92,88.84,52,6,58,57,52,5,1.02,91.23,Facile,Facile,0,Meme Difficulte que la Prediction,Pas Adapte
789,2015,Philosophie,1,La Notion de Logique,3,Les Paradoxes,7,790,2,QCM,0.46,0.65,46.58,29,34,63,39,29,10,1.62,74.36,Difficile,Moyen,1,Plus Facile que la Prediction,Pas Adapte
1855,2016,Philosophie,1,La Notion de Logique,3,Les Paradoxes,7,790,2,QCM,0.13,0.73,96.79,69,2,71,70,69,1,1.01,98.57,Difficile,Facile,2,Beaucoup plus Facile que la Prediction,Pas Adapte
2921,2017,Philosophie,1,La Notion de Logique,3,Les Paradoxes,7,790,2,QCM,0.63,0.25,11.22,8,66,74,70,8,62,1.06,11.43,Difficile,Difficile,0,Meme Difficulte que la Prediction,Pas Adapte
3987,2018,Philosophie,1,La Notion de Logique,3,Les Paradoxes,7,790,2,QO,0.96,0.02,33.43,23,47,70,60,23,37,1.17,38.33,Difficile,Difficile,0,Meme Difficulte que la Prediction,Pas Adapte
5053,2019,Philosophie,1,La Notion de Logique,3,Les Paradoxes,7,790,2,QO,0.1,0.8,72.92,58,22,80,70,58,12,1.14,82.86,Facile,Facile,0,Meme Difficulte que la Prediction,Adapte
6119,2020,Philosophie,1,La Notion de Logique,3,Les Paradoxes,7,790,2,QO,0.13,0.79,72.92,65,24,89,78,65,13,1.14,83.33,Facile,Facile,0,Meme Difficulte que la Prediction,Adapte
790,2015,Philosophie,1,La Notion de Logique,3,Les Paradoxes,7,791,3,QCM,0.17,0.78,93.67,50,3,53,52,50,2,1.02,96.15,Facile,Facile,0,Meme Difficulte que la Prediction,Pas Adapte
1856,2016,Philosophie,1,La Notion de Logique,3,Les Paradoxes,7,791,3,QCM,0.65,0.21,8.31,5,53,58,55,5,50,1.05,9.09,Difficile,Difficile,0,Meme Difficulte que la Prediction,Pas Adapte
2922,2017,Philosophie,1,La Notion de Logique,3,Les Paradoxes,7,791,3,QCM,0.3,0.4,48.7,32,34,66,61,32,29,1.08,52.46,Moyen,Moyen,0,Meme Difficulte que la Prediction,Pas Adapte
3988,2018,Philosophie,1,La Notion de Logique,3,Les Paradoxes,7,791,3,QCM,0.37,0.55,50.38,28,28,56,38,28,10,1.47,73.68,Moyen,Moyen,0,Meme Difficulte que la Prediction,Pas Adapte
5054,2019,Philosophie,1,La Notion de Logique,3,Les Paradoxes,7,791,3,QCM,0.01,0.93,87.03,45,7,52,49,45,4,1.06,91.84,Facile,Facile,0,Meme Difficulte que la Prediction,Pas Adapte
6120,2020,Philosophie,1,La Notion de Logique,3,Les Paradoxes,7,791,3,QCM,0.57,0.26,28.87,17,43,60,27,17,10,2.22,62.96,Difficile,Difficile,0,Meme Difficulte que la Prediction,Pas Adapte
791,2015,Philosophie,1,La Notion de Logique,3,Les Paradoxes,7,792,4,QCU,0.73,0.35,22.28,18,65,83,29,18,11,2.86,62.07,Facile,Difficile,-2,Beaucoup plus Difficile que la Prediction,Pas Adapte
1857,2016,Philosophie,1,La Notion de Logique,3,Les Paradoxes,7,792,4,QCU,0.41,0.38,18.67,16,72,88,56,16,40,1.57,28.57,Difficile,Difficile,0,Meme Difficulte que la Prediction,Pas Adapte
2923,2017,Philosophie,1,La Notion de Logique,3,Les Paradoxes,7,792,4,QCU,0.01,0.79,68.96,68,30,98,74,68,6,1.32,91.89,Facile,Facile,0,Meme Difficulte que la Prediction,Adapte
3989,2018,Philosophie,1,La Notion de Logique,3,Les Paradoxes,7,792,4,QCU,0.09,0.86,68.96,59,26,85,79,59,20,1.08,74.68,Facile,Facile,0,Meme Difficulte que la Prediction,Adapte
5055,2019,Philosophie,1,La Notion de Logique,3,Les Paradoxes,7,792,4,QROC,0.11,0.82,68.96,59,26,85,76,59,17,1.12,77.63,Facile,Facile,0,Meme Difficulte que la Prediction,Adapte
6121,2020,Philosophie,1,La Notion de Logique,3,Les Paradoxes,7,792,4,QROC,0.02,0.8,68.96,50,22,72,55,50,5,1.31,90.91,Facile,Facile,0,Meme Difficulte que la Prediction,Adapte
792,2015,Philosophie,1,La Notion de Logique,3,Les Paradoxes,7,793,5,QROC,0.47,0.4,62.31,26,15,41,39,26,13,1.05,66.67,Facile,Moyen,-1,Plus Difficile que la Prediction,Adapte
1858,2016,Philosophie,1,La Notion de Logique,3,Les Paradoxes,7,793,5,QROC,0.55,0.39,62.31,26,15,41,35,26,9,1.17,74.29,Moyen,Moyen,0,Meme Difficulte que la Prediction,Adapte
2924,2017,Philosophie,1,La Notion de Logique,3,Les Paradoxes,7,793,5,QROC,0.54,0.37,62.31,24,14,38,27,24,3,1.41,88.89,Moyen,Moyen,0,Meme Difficulte que la Prediction,Adapte
3990,2018,Philosophie,1,La Notion de Logique,3,Les Paradoxes,7,793,5,QROC,0.56,0.25,62.31,26,16,42,38,26,12,1.11,68.42,Moyen,Moyen,0,Meme Difficulte que la Prediction,Adapte
5056,2019,Philosophie,1,La Notion de Logique,3,Les Paradoxes,7,793,5,QROC,0.52,0.37,62.31,27,16,43,40,27,13,1.07,67.5,Moyen,Moyen,0,Meme Difficulte que la Prediction,Adapte
6122,2020,Philosophie,1,La Notion de Logique,3,Les Paradoxes,7,793,5,QO,0.52,0.19,62.31,29,17,46,36,29,7,1.28,80.56,Moyen,Moyen,0,Meme Difficulte que la Prediction,Adapte
793,2015,Philosophie,1,La Notion de Logique,3,Les Paradoxes,7,794,6,QCU,0.33,0.67,59.52,37,25,62,43,37,6,1.44,86.05,Difficile,Moyen,1,Plus Facile que la Prediction,Pas Adapte
1859,2016,Philosophie,1,La Notion de Logique,3,Les Paradoxes,7,794,6,QCM,0.09,0.86,80.11,54,13,67,56,54,2,1.2,96.43,Facile,Facile,0,Meme Difficulte que la Prediction,Pas Adapte
2925,2017,Philosophie,1,La Notion de Logique,3,Les Paradoxes,7,794,6,QCM,0.0,0.78,76.9,47,14,61,49,47,2,1.24,95.92,Facile,Facile,0,Meme Difficulte que la Prediction,Pas Adapte
3991,2018,Philosophie,1,La Notion de Logique,3,Les Paradoxes,7,794,6,QCM,0.37,0.39,47.6,32,36,68,65,32,33,1.05,49.23,Moyen,Moyen,0,Meme Difficulte que la Prediction,Pas Adapte
5057,2019,Philosophie,1,La Notion de Logique,3,Les Paradoxes,7,794,6,QCM,0.17,0.75,69.87,45,19,64,54,45,9,1.19,83.33,Facile,Facile,0,Meme Difficulte que la Prediction,Adapte
6123,2020,Philosophie,1,La Notion de Logique,3,Les Paradoxes,7,794,6,QCU,0.09,0.97,69.87,40,17,57,41,40,1,1.39,97.56,Facile,Facile,0,Meme Difficulte que la Prediction,Adapte
794,2015,Philosophie,1,La Notion de Logique,3,Les Paradoxes,7,795,7,QCU,0.27,0.73,37.09,23,39,62,58,23,35,1.07,39.66,Moyen,Moyen,0,Meme Difficulte que la Prediction,Pas Adapte
1860,2016,Philosophie,1,La Notion de Logique,3,Les Paradoxes,7,795,7,QCM,0.61,0.22,8.43,5,58,63,50,5,45,1.26,10.0,Difficile,Difficile,0,Meme Difficulte que la Prediction,Pas Adapte
2926,2017,Philosophie,1,La Notion de Logique,3,Les Paradoxes,7,795,7,QCM,0.6,0.18,11.58,6,50,56,53,6,47,1.06,11.32,Difficile,Difficile,0,Meme Difficulte que la Prediction,Pas Adapte
3992,2018,Philosophie,1,La Notion de Logique,3,Les Paradoxes,7,795,7,QCM,0.18,0.99,69.5,40,18,58,52,40,12,1.12,76.92,Facile,Facile,0,Meme Difficulte que la Prediction,Adapte
5058,2019,Philosophie,1,La Notion de Logique,3,Les Paradoxes,7,795,7,QCM,0.06,0.72,69.5,47,20,67,59,47,12,1.14,79.66,Facile,Facile,0,Meme Difficulte que la Prediction,Adapte
6124,2020,Philosophie,1,La Notion de Logique,3,Les Paradoxes,7,795,7,QCM,0.18,0.75,69.5,54,23,77,70,54,16,1.1,77.14,Facile,Facile,0,Meme Difficulte que la Prediction,Adapte
795,2015,Philosophie,1,La Notion de Logique,4,La Notion du Modele,11,796,1,QCM,0.14,0.71,85.73,15,3,18,16,15,1,1.12,93.75,Difficile,Facile,2,Beaucoup plus Facile que la Prediction,Pas Adapte
1861,2016,Philosophie,1,La Notion de Logique,4,La Notion du Modele,11,796,1,QCM,0.04,0.86,67.76,14,6,20,18,14,4,1.11,77.78,Difficile,Facile,2,Beaucoup plus Facile que la Prediction,Adapte
2927,2017,Philosophie,1,La Notion de Logique,4,La Notion du Modele,11,796,1,QCM,0.0,0.85,67.76,12,5,17,12,12,0,1.42,100.0,Facile,Facile,0,Meme Difficulte que la Prediction,Adapte
3993,2018,Philosophie,1,La Notion de Logique,4,La Notion du Modele,11,796,1,QCU,0.09,0.98,67.76,9,5,14,9,9,0,1.56,100.0,Facile,Facile,0,Meme Difficulte que la Prediction,Adapte
5059,2019,Philosophie,1,La Notion de Logique,4,La Notion du Modele,11,796,1,QCU,0.17,0.96,67.76,9,5,14,13,9,4,1.08,69.23,Facile,Facile,0,Meme Difficulte que la Prediction,Adapte
6125,2020,Philosophie,1,La Notion de Logique,4,La Notion du Modele,11,796,1,QCU,0.11,0.91,67.76,11,5,16,14,11,3,1.14,78.57,Facile,Facile,0,Meme Difficulte que la Prediction,Adapte
796,2015,Philosophie,1,La Notion de Logique,4,La Notion du Modele,11,797,2,QCM,0.72,0.3,33.05,22,46,68,33,22,11,2.06,66.67,Difficile,Difficile,0,Meme Difficulte que la Prediction,Pas Adapte
1862,2016,Philosophie,1,La Notion de Logique,4,La Notion du Modele,11,797,2,QCM,0.02,0.73,87.92,69,9,78,74,69,5,1.05,93.24,Facile,Facile,0,Meme Difficulte que la Prediction,Pas Adapte
2928,2017,Philosophie,1,La Notion de Logique,4,La Notion du Modele,11,797,2,QCM,0.31,0.35,44.78,34,42,76,65,34,31,1.17,52.31,Moyen,Moyen,0,Meme Difficulte que la Prediction,Pas Adapte
3994,2018,Philosophie,1,La Notion de Logique,4,La Notion du Modele,11,797,2,QCM,0.7,0.19,34.27,28,55,83,36,28,8,2.31,77.78,Difficile,Difficile,0,Meme Difficulte que la Prediction,Pas Adapte
5060,2019,Philosophie,1,La Notion de Logique,4,La Notion du Modele,11,797,2,QCM,0.18,0.86,93.44,78,5,83,80,78,2,1.04,97.5,Difficile,Facile,2,Beaucoup plus Facile que la Prediction,Pas Adapte
6126,2020,Philosophie,1,La Notion de Logique,4,La Notion du Modele,11,797,2,QCM,0.58,0.27,10.94,10,82,92,69,10,59,1.33,14.49,Facile,Difficile,-2,Beaucoup plus Difficile que la Prediction,Pas Adapte
797,2015,Philosophie,1,La Notion de Logique,4,La Notion du Modele,11,798,3,QCU,0.6,0.25,34.57,10,18,28,13,10,3,2.15,76.92,Moyen,Difficile,-1,Plus Difficile que la Prediction,Pas Adapte
1863,2016,Philosophie,1,La Notion de Logique,4,La Notion du Modele,11,798,3,QCU,0.17,0.82,95.28,25,1,26,25,25,0,1.04,100.0,Facile,Facile,0,Meme Difficulte que la Prediction,Pas Adapte
2929,2017,Philosophie,1,La Notion de Logique,4,La Notion du Modele,11,798,3,QROC,0.32,0.34,40.19,12,18,30,19,12,7,1.58,63.16,Moyen,Moyen,0,Meme Difficulte que la Prediction,Pas Adapte
3995,2018,Philosophie,1,La Notion de Logique,4,La Notion du Modele,11,798,3,QROC,0.86,0.06,14.31,4,23,27,19,4,15,1.42,21.05,Difficile,Difficile,0,Meme Difficulte que la Prediction,Pas Adapte
5061,2019,Philosophie,1,La Notion de Logique,4,La Notion du Modele,11,798,3,QROC,0.38,0.28,35.74,10,19,29,24,10,14,1.21,41.67,Moyen,Moyen,0,Meme Difficulte que la Prediction,Pas Adapte
6127,2020,Philosophie,1,La Notion de Logique,4,La Notion du Modele,11,798,3,QROC,0.99,0.18,30.15,9,21,30,13,9,4,2.31,69.23,Facile,Difficile,-2,Beaucoup plus Difficile que la Prediction,Pas Adapte
798,2015,Philosophie,1,La Notion de Logique,4,La Notion du Modele,11,799,4,QCM,0.13,0.74,71.74,70,28,98,87,70,17,1.13,80.46,Facile,Facile,0,Meme Difficulte que la Prediction,Adapte
1864,2016,Philosophie,1,La Notion de Logique,4,La Notion du Modele,11,799,4,QCM,0.11,0.96,71.74,65,26,91,69,65,4,1.32,94.2,Facile,Facile,0,Meme Difficulte que la Prediction,Adapte
2930,2017,Philosophie,1,La Notion de Logique,4,La Notion du Modele,11,799,4,QCM,0.1,0.89,71.74,60,24,84,79,60,19,1.06,75.95,Facile,Facile,0,Meme Difficulte que la Prediction,Adapte
3996,2018,Philosophie,1,La Notion de Logique,4,La Notion du Modele,11,799,4,QCM,0.05,0.9,71.74,65,25,90,70,65,5,1.29,92.86,Facile,Facile,0,Meme Difficulte que la Prediction,Adapte
5062,2019,Philosophie,1,La Notion de Logique,4,La Notion du Modele,11,799,4,QCM,0.07,1.0,71.74,68,27,95,77,68,9,1.23,88.31,Facile,Facile,0,Meme Difficulte que la Prediction,Adapte
6128,2020,Philosophie,1,La Notion de Logique,4,La Notion du Modele,11,799,4,QCM,0.11,0.8,71.74,69,27,96,83,69,14,1.16,83.13,Facile,Facile,0,Meme Difficulte que la Prediction,Adapte
799,2015,Philosophie,1,La Notion de Logique,4,La Notion du Modele,11,800,5,QCU,0.37,0.44,48.08,33,36,69,42,33,9,1.64,78.57,Moyen,Moyen,0,Meme Difficulte que la Prediction,Pas Adapte
1865,2016,Philosophie,1,La Notion de Logique,4,La Notion du Modele,11,800,5,QCU,0.2,0.61,42.34,29,39,68,30,29,1,2.27,96.67,Moyen,Moyen,0,Meme Difficulte que la Prediction,Pas Adapte
2931,2017,Philosophie,1,La Notion de Logique,4,La Notion du Modele,11,800,5,QCU,0.7,0.22,26.37,19,53,72,54,19,35,1.33,35.19,Difficile,Difficile,0,Meme Difficulte que la Prediction,Pas Adapte
3997,2018,Philosophie,1,La Notion de Logique,4,La Notion du Modele,11,800,5,QCU,0.43,0.37,22.48,19,64,83,72,19,53,1.15,26.39,Difficile,Difficile,0,Meme Difficulte que la Prediction,Pas Adapte
5063,2019,Philosophie,1,La Notion de Logique,4,La Notion du Modele,11,800,5,QCM,0.52,0.17,18.09,13,58,71,52,13,39,1.37,25.0,Moyen,Difficile,-1,Plus Difficile que la Prediction,Pas Adapte
6129,2020,Philosophie,1,La Notion de Logique,4,La Notion du Modele,11,800,5,QCM,0.23,0.52,35.29,22,41,63,61,22,39,1.03,36.07,Moyen,Moyen,0,Meme Difficulte que la Prediction,Pas Adapte
800,2015,Philosophie,1,La Notion de Logique,4,La Notion du Modele,11,801,6,QROC,0.7,0.14,18.9,1,5,6,4,1,3,1.5,25.0,Moyen,Difficile,-1,Plus Difficile que la Prediction,Pas Adapte
1866,2016,Philosophie,1,La Notion de Logique,4,La Notion du Modele,11,801,6,QROC,0.04,0.68,80.5,4,1,5,4,4,0,1.25,100.0,Moyen,Facile,1,Plus Facile que la Prediction,Pas Adapte
2932,2017,Philosophie,1,La Notion de Logique,4,La Notion du Modele,11,801,6,QROC,1.0,0.01,9.35,0,5,5,3,0,3,1.67,0.0,Moyen,Difficile,-1,Plus Difficile que la Prediction,Pas Adapte
3998,2018,Philosophie,1,La Notion de Logique,4,La Notion du Modele,11,801,6,QROC,0.21,0.29,46.94,2,2,4,4,2,2,1.0,50.0,Moyen,Moyen,0,Meme Difficulte que la Prediction,Pas Adapte
5064,2019,Philosophie,1,La Notion de Logique,4,La Notion du Modele,11,801,6,QROC,0.74,0.06,9.64,0,5,5,4,0,4,1.25,0.0,Difficile,Difficile,0,Meme Difficulte que la Prediction,Pas Adapte
6130,2020,Philosophie,1,La Notion de Logique,4,La Notion du Modele,11,801,6,QROC,0.75,0.21,12.15,1,5,6,3,1,2,2.0,33.33,Facile,Difficile,-2,Beaucoup plus Difficile que la Prediction,Pas Adapte
801,2015,Philosophie,1,La Notion de Logique,4,La Notion du Modele,11,802,7,QCM,0.54,0.18,11.89,10,75,85,33,10,23,2.58,30.3,Difficile,Difficile,0,Meme Difficulte que la Prediction,Pas Adapte
1867,2016,Philosophie,1,La Notion de Logique,4,La Notion du Modele,11,802,7,QCM,0.69,0.2,28.54,23,56,79,29,23,6,2.72,79.31,Difficile,Difficile,0,Meme Difficulte que la Prediction,Pas Adapte
2933,2017,Philosophie,1,La Notion de Logique,4,La Notion du Modele,11,802,7,QCM,0.15,0.7,76.47,60,18,78,69,60,9,1.13,86.96,Facile,Facile,0,Meme Difficulte que la Prediction,Pas Adapte
3999,2018,Philosophie,1,La Notion de Logique,4,La Notion du Modele,11,802,7,QCM,0.33,0.59,53.2,47,41,88,80,47,33,1.1,58.75,Moyen,Moyen,0,Meme Difficulte que la Prediction,Pas Adapte
5065,2019,Philosophie,1,La Notion de Logique,4,La Notion du Modele,11,802,7,QCM,0.05,0.92,80.24,66,16,82,77,66,11,1.06,85.71,Facile,Facile,0,Meme Difficulte que la Prediction,Pas Adapte
6131,2020,Philosophie,1,La Notion de Logique,4,La Notion du Modele,11,802,7,QCM,0.74,0.24,0.64,1,77,78,22,1,21,3.55,4.55,Difficile,Difficile,0,Meme Difficulte que la Prediction,Pas Adapte
802,2015,Philosophie,1,La Notion de Logique,4,La Notion du Modele,11,803,8,QCU,0.3,0.47,55.23,28,22,50,34,28,6,1.47,82.35,Facile,Moyen,-1,Plus Difficile que la Prediction,Pas Adapte
1868,2016,Philosophie,1,La Notion de Logique,4,La Notion du Modele,11,803,8,QCU,0.19,0.86,66.29,32,17,49,46,32,14,1.07,69.57,Facile,Facile,0,Meme Difficulte que la Prediction,Adapte
2934,2017,Philosophie,1,La Notion de Logique,4,La Notion du Modele,11,803,8,QCU,0.15,0.78,66.29,35,18,53,48,35,13,1.1,72.92,Facile,Facile,0,Meme Difficulte que la Prediction,Adapte
4000,2018,Philosophie,1,La Notion de Logique,4,La Notion du Modele,11,803,8,QCU,0.09,0.88,66.29,35,18,53,48,35,13,1.1,72.92,Facile,Facile,0,Meme Difficulte que la Prediction,Adapte
5066,2019,Philosophie,1,La Notion de Logique,4,La Notion du Modele,11,803,8,QCU,0.1,0.8,66.29,35,18,53,49,35,14,1.08,71.43,Facile,Facile,0,Meme Difficulte que la Prediction,Adapte
6132,2020,Philosophie,1,La Notion de Logique,4,La Notion du Modele,11,803,8,QCU,0.11,0.83,66.29,34,17,51,45,34,11,1.13,75.56,Facile,Facile,0,Meme Difficulte que la Prediction,Adapte
803,2015,Philosophie,1,La Notion de Logique,4,La Notion du Modele,11,804,9,QCU,0.67,0.39,9.04,6,61,67,66,6,60,1.02,9.09,Facile,Difficile,-2,Beaucoup plus Difficile que la Prediction,Pas Adapte
1869,2016,Philosophie,1,La Notion de Logique,4,La Notion du Modele,11,804,9,QCU,0.1,0.94,74.66,49,17,66,60,49,11,1.1,81.67,Facile,Facile,0,Meme Difficulte que la Prediction,Adapte
2935,2017,Philosophie,1,La Notion de Logique,4,La Notion du Modele,11,804,9,QCU,0.09,0.83,74.66,45,15,60,59,45,14,1.02,76.27,Facile,Facile,0,Meme Difficulte que la Prediction,Adapte
4001,2018,Philosophie,1,La Notion de Logique,4,La Notion du Modele,11,804,9,QCU,0.05,0.84,74.66,42,14,56,45,42,3,1.24,93.33,Facile,Facile,0,Meme Difficulte que la Prediction,Adapte
5067,2019,Philosophie,1,La Notion de Logique,4,La Notion du Modele,11,804,9,QCM,0.02,0.72,74.66,43,15,58,56,43,13,1.04,76.79,Facile,Facile,0,Meme Difficulte que la Prediction,Adapte
6133,2020,Philosophie,1,La Notion de Logique,4,La Notion du Modele,11,804,9,QCM,0.11,0.94,74.66,44,15,59,56,44,12,1.05,78.57,Facile,Facile,0,Meme Difficulte que la Prediction,Adapte
804,2015,Philosophie,1,La Notion de Logique,4,La Notion du Modele,11,805,10,QCU,0.44,0.34,28.74,28,69,97,44,28,16,2.2,63.64,Difficile,Difficile,0,Meme Difficulte que la Prediction,Pas Adapte
1870,2016,Philosophie,1,La Notion de Logique,4,La Notion du Modele,11,805,10,QCU,0.19,0.87,99.01,87,1,88,87,87,0,1.01,100.0,Facile,Facile,0,Meme Difficulte que la Prediction,Pas Adapte
2936,2017,Philosophie,1,La Notion de Logique,4,La Notion du Modele,11,805,10,QCU,0.01,0.99,68.22,57,26,83,62,57,5,1.34,91.94,Facile,Facile,0,Meme Difficulte que la Prediction,Adapte
4002,2018,Philosophie,1,La Notion de Logique,4,La Notion du Modele,11,805,10,QCU,0.07,0.96,68.22,50,23,73,72,50,22,1.01,69.44,Facile,Facile,0,Meme Difficulte que la Prediction,Adapte
5068,2019,Philosophie,1,La Notion de Logique,4,La Notion du Modele,11,805,10,QCU,0.05,0.79,68.22,55,26,81,59,55,4,1.37,93.22,Facile,Facile,0,Meme Difficulte que la Prediction,Adapte
6134,2020,Philosophie,1,La Notion de Logique,4,La Notion du Modele,11,805,10,QCU,0.19,0.92,68.22,63,29,92,68,63,5,1.35,92.65,Facile,Facile,0,Meme Difficulte que la Prediction,Adapte
805,2015,Philosophie,1,La Notion de Logique,4,La Notion du Modele,11,806,11,QCU,0.38,0.7,41.5,41,57,98,97,41,56,1.01,42.27,Moyen,Moyen,0,Meme Difficulte que la Prediction,Pas Adapte
1871,2016,Philosophie,1,La Notion de Logique,4,La Notion du Modele,11,806,11,QCU,0.69,0.25,25.04,25,73,98,44,25,19,2.23,56.82,Difficile,Difficile,0,Meme Difficulte que la Prediction,Pas Adapte
2937,2017,Philosophie,1,La Notion de Logique,4,La Notion du Modele,11,806,11,QCU,0.24,0.57,53.93,51,43,94,63,51,12,1.49,80.95,Difficile,Moyen,1,Plus Facile que la Prediction,Pas Adapte
4003,2018,Philosophie,1,La Notion de Logique,4,La Notion du Modele,11,806,11,QCU,0.17,0.88,71.62,76,30,106,99,76,23,1.07,76.77,Facile,Facile,0,Meme Difficulte que la Prediction,Adapte
5069,2019,Philosophie,1,La Notion de Logique,4,La Notion du Modele,11,806,11,QCU,0.1,0.83,71.62,87,34,121,102,87,15,1.19,85.29,Facile,Facile,0,Meme Difficulte que la Prediction,Adapte
6135,2020,Philosophie,1,La Notion de Logique,4,La Notion du Modele,11,806,11,QROC,0.08,0.73,71.62,96,38,134,114,96,18,1.18,84.21,Facile,Facile,0,Meme Difficulte que la Prediction,Adapte
806,2015,Philosophie,1,La Notion de Logique,5,Le Calcul des Sequents,12,807,1,QCM,0.41,0.6,47.19,41,46,87,76,41,35,1.14,53.95,Moyen,Moyen,0,Meme Difficulte que la Prediction,Pas Adapte
1872,2016,Philosophie,1,La Notion de Logique,5,Le Calcul des Sequents,12,807,1,QCM,0.51,0.16,27.35,21,55,76,76,21,55,1.0,27.63,Facile,Difficile,-2,Beaucoup plus Difficile que la Prediction,Pas Adapte
2938,2017,Philosophie,1,La Notion de Logique,5,Le Calcul des Sequents,12,807,1,QCU,0.09,0.77,65.2,54,29,83,75,54,21,1.11,72.0,Facile,Facile,0,Meme Difficulte que la Prediction,Adapte
4004,2018,Philosophie,1,La Notion de Logique,5,Le Calcul des Sequents,12,807,1,QCU,0.2,0.76,65.2,52,28,80,63,52,11,1.27,82.54,Facile,Facile,0,Meme Difficulte que la Prediction,Adapte
5070,2019,Philosophie,1,La Notion de Logique,5,Le Calcul des Sequents,12,807,1,QCU,0.16,0.88,65.2,44,24,68,61,44,17,1.11,72.13,Facile,Facile,0,Meme Difficulte que la Prediction,Adapte
6136,2020,Philosophie,1,La Notion de Logique,5,Le Calcul des Sequents,12,807,1,QCU,0.16,0.97,65.2,51,27,78,66,51,15,1.18,77.27,Facile,Facile,0,Meme Difficulte que la Prediction,Adapte
807,2015,Philosophie,1,La Notion de Logique,5,Le Calcul des Sequents,12,808,2,QROC,0.07,0.66,65.86,9,5,14,13,9,4,1.08,69.23,Moyen,Facile,1,Plus Facile que la Prediction,Adapte
1873,2016,Philosophie,1,La Notion de Logique,5,Le Calcul des Sequents,12,808,2,QROC,0.02,0.7,65.86,8,4,12,9,8,1,1.33,88.89,Facile,Facile,0,Meme Difficulte que la Prediction,Adapte
2939,2017,Philosophie,1,La Notion de Logique,5,Le Calcul des Sequents,12,808,2,QROC,0.13,0.78,65.86,7,4,11,9,7,2,1.22,77.78,Facile,Facile,0,Meme Difficulte que la Prediction,Adapte
4005,2018,Philosophie,1,La Notion de Logique,5,Le Calcul des Sequents,12,808,2,QROC,0.03,0.64,65.86,9,4,13,13,9,4,1.0,69.23,Facile,Facile,0,Meme Difficulte que la Prediction,Adapte
5071,2019,Philosophie,1,La Notion de Logique,5,Le Calcul des Sequents,12,808,2,QROC,0.19,0.67,65.86,7,4,11,7,7,0,1.57,100.0,Facile,Facile,0,Meme Difficulte que la Prediction,Adapte
6137,2020,Philosophie,1,La Notion de Logique,5,Le Calcul des Sequents,12,808,2,QROC,0.11,0.9,65.86,6,3,9,7,6,1,1.29,85.71,Facile,Facile,0,Meme Difficulte que la Prediction,Adapte
808,2015,Philosophie,1,La Notion de Logique,5,Le Calcul des Sequents,12,809,3,QCU,0.1,0.76,67.51,15,7,22,18,15,3,1.22,83.33,Facile,Facile,0,Meme Difficulte que la Prediction,Adapte
1874,2016,Philosophie,1,La Notion de Logique,5,Le Calcul des Sequents,12,809,3,QCU,0.04,0.87,67.51,15,7,22,21,15,6,1.05,71.43,Facile,Facile,0,Meme Difficulte que la Prediction,Adapte
2940,2017,Philosophie,1,La Notion de Logique,5,Le Calcul des Sequents,12,809,3,QCU,0.07,0.89,67.51,14,7,21,15,14,1,1.4,93.33,Facile,Facile,0,Meme Difficulte que la Prediction,Adapte
4006,2018,Philosophie,1,La Notion de Logique,5,Le Calcul des Sequents,12,809,3,QCU,0.06,0.8,67.51,16,7,23,17,16,1,1.35,94.12,Facile,Facile,0,Meme Difficulte que la Prediction,Adapte
5072,2019,Philosophie,1,La Notion de Logique,5,Le Calcul des Sequents,12,809,3,QCU,0.02,0.95,67.51,17,8,25,25,17,8,1.0,68.0,Facile,Facile,0,Meme Difficulte que la Prediction,Adapte
6138,2020,Philosophie,1,La Notion de Logique,5,Le Calcul des Sequents,12,809,3,QCU,0.18,0.76,67.51,17,8,25,20,17,3,1.25,85.0,Facile,Facile,0,Meme Difficulte que la Prediction,Adapte
809,2015,Philosophie,1,La Notion de Logique,5,Le Calcul des Sequents,12,810,4,QCM,0.09,0.92,81.74,57,13,70,59,57,2,1.19,96.61,Facile,Facile,0,Meme Difficulte que la Prediction,Pas Adapte
1875,2016,Philosophie,1,La Notion de Logique,5,Le Calcul des Sequents,12,810,4,QCM,0.21,0.57,58.19,43,31,74,65,43,22,1.14,66.15,Moyen,Moyen,0,Meme Difficulte que la Prediction,Pas Adapte
2941,2017,Philosophie,1,La Notion de Logique,5,Le Calcul des Sequents,12,810,4,QCM,0.11,0.85,70.56,55,23,78,63,55,8,1.24,87.3,Moyen,Facile,1,Plus Facile que la Prediction,Adapte
4007,2018,Philosophie,1,La Notion de Logique,5,Le Calcul des Sequents,12,810,4,QCM,0.15,0.99,70.56,55,23,78,60,55,5,1.3,91.67,Facile,Facile,0,Meme Difficulte que la Prediction,Adapte
5073,2019,Philosophie,1,La Notion de Logique,5,Le Calcul des Sequents,12,810,4,QCU,0.14,0.92,70.56,61,25,86,70,61,9,1.23,87.14,Facile,Facile,0,Meme Difficulte que la Prediction,Adapte
6139,2020,Philosophie,1,La Notion de Logique,5,Le Calcul des Sequents,12,810,4,QCU,0.01,0.95,70.56,56,24,80,72,56,16,1.11,77.78,Facile,Facile,0,Meme Difficulte que la Prediction,Adapte
810,2015,Philosophie,1,La Notion de Logique,5,Le Calcul des Sequents,12,811,5,QCU,0.11,1.0,92.06,6,0,6,6,6,0,1.0,100.0,Facile,Facile,0,Meme Difficulte que la Prediction,Pas Adapte
1876,2016,Philosophie,1,La Notion de Logique,5,Le Calcul des Sequents,12,811,5,QCU,0.42,0.23,8.82,1,6,7,7,1,6,1.0,14.29,Difficile,Difficile,0,Meme Difficulte que la Prediction,Pas Adapte
2942,2017,Philosophie,1,La Notion de Logique,5,Le Calcul des Sequents,12,811,5,QCU,0.26,0.54,35.78,3,4,7,4,3,1,1.75,75.0,Moyen,Moyen,0,Meme Difficulte que la Prediction,Pas Adapte
4008,2018,Philosophie,1,La Notion de Logique,5,Le Calcul des Sequents,12,811,5,QCM,0.13,0.98,82.49,6,1,7,6,6,0,1.17,100.0,Facile,Facile,0,Meme Difficulte que la Prediction,Pas Adapte
5074,2019,Philosophie,1,La Notion de Logique,5,Le Calcul des Sequents,12,811,5,QCM,0.43,0.42,47.47,3,3,6,5,3,2,1.2,60.0,Facile,Moyen,-1,Plus Difficile que la Prediction,Pas Adapte
6140,2020,Philosophie,1,La Notion de Logique,5,Le Calcul des Sequents,12,811,5,QCM,0.5,0.57,47.5,3,4,7,4,3,1,1.75,75.0,Moyen,Moyen,0,Meme Difficulte que la Prediction,Pas Adapte
811,2015,Philosophie,1,La Notion de Logique,5,Le Calcul des Sequents,12,812,6,QCU,0.7,0.24,28.79,13,32,45,36,13,23,1.25,36.11,Facile,Difficile,-2,Beaucoup plus Difficile que la Prediction,Pas Adapte
1877,2016,Philosophie,1,La Notion de Logique,5,Le Calcul des Sequents,12,812,6,QROC,0.39,0.26,47.66,24,27,51,46,24,22,1.11,52.17,Moyen,Moyen,0,Meme Difficulte que la Prediction,Pas Adapte
2943,2017,Philosophie,1,La Notion de Logique,5,Le Calcul des Sequents,12,812,6,QROC,0.81,0.07,21.74,12,45,57,52,12,40,1.1,23.08,Difficile,Difficile,0,Meme Difficulte que la Prediction,Pas Adapte
4009,2018,Philosophie,1,La Notion de Logique,5,Le Calcul des Sequents,12,812,6,QO,0.24,0.29,61.99,31,19,50,39,31,8,1.28,79.49,Moyen,Moyen,0,Meme Difficulte que la Prediction,Adapte
5075,2019,Philosophie,1,La Notion de Logique,5,Le Calcul des Sequents,12,812,6,QO,0.33,0.2,61.99,32,19,51,49,32,17,1.04,65.31,Moyen,Moyen,0,Meme Difficulte que la Prediction,Adapte
6141,2020,Philosophie,1,La Notion de Logique,5,Le Calcul des Sequents,12,812,6,QO,0.4,0.19,61.99,30,19,49,32,30,2,1.53,93.75,Moyen,Moyen,0,Meme Difficulte que la Prediction,Adapte
812,2015,Philosophie,1,La Notion de Logique,5,Le Calcul des Sequents,12,813,7,QROC,0.02,0.9,79.2,62,16,78,77,62,15,1.01,80.52,Facile,Facile,0,Meme Difficulte que la Prediction,Pas Adapte
1878,2016,Philosophie,1,La Notion de Logique,5,Le Calcul des Sequents,12,813,7,QROC,0.07,0.87,80.36,57,14,71,61,57,4,1.16,93.44,Facile,Facile,0,Meme Difficulte que la Prediction,Pas Adapte
2944,2017,Philosophie,1,La Notion de Logique,5,Le Calcul des Sequents,12,813,7,QO,0.93,0.14,26.85,22,59,81,60,22,38,1.35,36.67,Difficile,Difficile,0,Meme Difficulte que la Prediction,Pas Adapte
4010,2018,Philosophie,1,La Notion de Logique,5,Le Calcul des Sequents,12,813,7,QO,0.04,0.93,66.67,54,27,81,76,54,22,1.07,71.05,Facile,Facile,0,Meme Difficulte que la Prediction,Adapte
5076,2019,Philosophie,1,La Notion de Logique,5,Le Calcul des Sequents,12,813,7,QO,0.11,0.89,66.67,61,30,91,78,61,17,1.17,78.21,Facile,Facile,0,Meme Difficulte que la Prediction,Adapte
6142,2020,Philosophie,1,La Notion de Logique,5,Le Calcul des Sequents,12,813,7,QCM,0.0,0.93,66.67,61,30,91,70,61,9,1.3,87.14,Facile,Facile,0,Meme Difficulte que la Prediction,Adapte
813,2015,Philosophie,1,La Notion de Logique,5,Le Calcul des Sequents,12,814,8,QCM,0.18,0.82,87.94,73,10,83,81,73,8,1.02,90.12,Facile,Facile,0,Meme Difficulte que la Prediction,Pas Adapte
1879,2016,Philosophie,1,La Notion de Logique,5,Le Calcul des Sequents,12,814,8,QCM,0.67,0.21,26.27,22,62,84,70,22,48,1.2,31.43,Difficile,Difficile,0,Meme Difficulte que la Prediction,Pas Adapte
2945,2017,Philosophie,1,La Notion de Logique,5,Le Calcul des Sequents,12,814,8,QCM,0.01,0.78,65.71,64,33,97,67,64,3,1.45,95.52,Facile,Facile,0,Meme Difficulte que la Prediction,Adapte
4011,2018,Philosophie,1,La Notion de Logique,5,Le Calcul des Sequents,12,814,8,QCM,0.19,0.72,65.71,73,38,111,78,73,5,1.42,93.59,Facile,Facile,0,Meme Difficulte que la Prediction,Adapte
5077,2019,Philosophie,1,La Notion de Logique,5,Le Calcul des Sequents,12,814,8,QCU,0.1,0.96,65.71,72,37,109,108,72,36,1.01,66.67,Facile,Facile,0,Meme Difficulte que la Prediction,Adapte
6143,2020,Philosophie,1,La Notion de Logique,5,Le Calcul des Sequents,12,814,8,QCU,0.08,0.99,65.71,78,40,118,115,78,37,1.03,67.83,Facile,Facile,0,Meme Difficulte que la Prediction,Adapte
814,2015,Philosophie,1,La Notion de Logique,5,Le Calcul des Sequents,12,815,9,QCM,0.44,0.4,41.42,14,21,35,35,14,21,1.0,40.0,Facile,Moyen,-1,Plus Difficile que la Prediction,Pas Adapte
1880,2016,Philosophie,1,La Notion de Logique,5,Le Calcul des Sequents,12,815,9,QCM,0.55,0.25,19.4,7,27,34,10,7,3,3.4,70.0,Difficile,Difficile,0,Meme Difficulte que la Prediction,Pas Adapte
2946,2017,Philosophie,1,La Notion de Logique,5,Le Calcul des Sequents,12,815,9,QCM,0.51,0.29,16.39,6,28,34,15,6,9,2.27,40.0,Difficile,Difficile,0,Meme Difficulte que la Prediction,Pas Adapte
4012,2018,Philosophie,1,La Notion de Logique,5,Le Calcul des Sequents,12,815,9,QCM,0.69,0.16,6.17,2,30,32,25,2,23,1.28,8.0,Difficile,Difficile,0,Meme Difficulte que la Prediction,Pas Adapte
5078,2019,Philosophie,1,La Notion de Logique,5,Le Calcul des Sequents,12,815,9,QCM,0.12,0.74,74.88,24,8,32,29,24,5,1.1,82.76,Difficile,Facile,2,Beaucoup plus Facile que la Prediction,Adapte
6144,2020,Philosophie,1,La Notion de Logique,5,Le Calcul des Sequents,12,815,9,QCM,0.13,0.72,74.88,23,8,31,25,23,2,1.24,92.0,Facile,Facile,0,Meme Difficulte que la Prediction,Adapte
815,2015,Philosophie,1,La Notion de Logique,5,Le Calcul des Sequents,12,816,10,QROC,0.01,0.7,84.55,12,2,14,13,12,1,1.08,92.31,Facile,Facile,0,Meme Difficulte que la Prediction,Pas Adapte
1881,2016,Philosophie,1,La Notion de Logique,5,Le Calcul des Sequents,12,816,10,QROC,0.6,0.15,7.86,1,12,13,8,1,7,1.62,12.5,Facile,Difficile,-2,Beaucoup plus Difficile que la Prediction,Pas Adapte
2947,2017,Philosophie,1,La Notion de Logique,5,Le Calcul des Sequents,12,816,10,QROC,0.19,0.91,75.18,9,3,12,10,9,1,1.2,90.0,Moyen,Facile,1,Plus Facile que la Prediction,Pas Adapte
4013,2018,Philosophie,1,La Notion de Logique,5,Le Calcul des Sequents,12,816,10,QROC,0.06,0.79,96.58,14,0,14,14,14,0,1.0,100.0,Moyen,Facile,1,Plus Facile que la Prediction,Pas Adapte
5079,2019,Philosophie,1,La Notion de Logique,5,Le Calcul des Sequents,12,816,10,QROC,0.43,0.36,47.33,7,7,14,11,7,4,1.27,63.64,Difficile,Moyen,1,Plus Facile que la Prediction,Pas Adapte
6145,2020,Philosophie,1,La Notion de Logique,5,Le Calcul des Sequents,12,816,10,QROC,0.06,0.98,65.24,10,5,15,12,10,2,1.25,83.33,Difficile,Facile,2,Beaucoup plus Facile que la Prediction,Adapte
816,2015,Philosophie,1,La Notion de Logique,5,Le Calcul des Sequents,12,817,11,QCU,0.41,0.35,23.66,11,34,45,37,11,26,1.22,29.73,Moyen,Difficile,-1,Plus Difficile que la Prediction,Pas Adapte
1882,2016,Philosophie,1,La Notion de Logique,5,Le Calcul des Sequents,12,817,11,QCU,0.15,0.93,98.77,44,1,45,45,44,1,1.0,97.78,Facile,Facile,0,Meme Difficulte que la Prediction,Pas Adapte
2948,2017,Philosophie,1,La Notion de Logique,5,Le Calcul des Sequents,12,817,11,QO,0.56,0.26,64.08,33,18,51,34,33,1,1.5,97.06,Difficile,Moyen,1,Plus Facile que la Prediction,Adapte
4014,2018,Philosophie,1,La Notion de Logique,5,Le Calcul des Sequents,12,817,11,QO,0.28,0.2,64.08,28,15,43,33,28,5,1.3,84.85,Moyen,Moyen,0,Meme Difficulte que la Prediction,Adapte
5080,2019,Philosophie,1,La Notion de Logique,5,Le Calcul des Sequents,12,817,11,QO,0.55,0.16,64.08,26,14,40,37,26,11,1.08,70.27,Moyen,Moyen,0,Meme Difficulte que la Prediction,Adapte
6146,2020,Philosophie,1,La Notion de Logique,5,Le Calcul des Sequents,12,817,11,QO,0.58,0.25,64.08,24,14,38,31,24,7,1.23,77.42,Moyen,Moyen,0,Meme Difficulte que la Prediction,Adapte
817,2015,Philosophie,1,La Notion de Logique,5,Le Calcul des Sequents,12,818,12,QCU,0.03,0.8,92.09,87,7,94,94,87,7,1.0,92.55,Moyen,Facile,1,Plus Facile que la Prediction,Pas Adapte
1883,2016,Philosophie,1,La Notion de Logique,5,Le Calcul des Sequents,12,818,12,QCU,0.21,0.66,38.54,42,66,108,103,42,61,1.05,40.78,Moyen,Moyen,0,Meme Difficulte que la Prediction,Pas Adapte
2949,2017,Philosophie,1,La Notion de Logique,5,Le Calcul des Sequents,12,818,12,QCU,0.66,0.22,26.29,32,90,122,91,32,59,1.34,35.16,Difficile,Difficile,0,Meme Difficulte que la Prediction,Pas Adapte
4015,2018,Philosophie,1,La Notion de Logique,5,Le Calcul des Sequents,12,818,12,QCU,0.39,0.7,51.62,72,68,140,125,72,53,1.12,57.6,Moyen,Moyen,0,Meme Difficulte que la Prediction,Pas Adapte
5081,2019,Philosophie,1,La Notion de Logique,5,Le Calcul des Sequents,12,818,12,QCU,0.41,0.21,5.39,7,126,133,97,7,90,1.37,7.22,Difficile,Difficile,0,Meme Difficulte que la Prediction,Pas Adapte
6147,2020,Philosophie,1,La Notion de Logique,5,Le Calcul des Sequents,12,818,12,QCU,0.18,0.77,87.77,134,19,153,150,134,16,1.02,89.33,Facile,Facile,0,Meme Difficulte que la Prediction,Pas Adapte
818,2015,Philosophie,1,La Notion de Logique,6,Le Theoreme de Completude,7,819,1,QROC,0.18,0.48,69.16,25,11,36,34,25,9,1.06,73.53,Moyen,Facile,1,Plus Facile que la Prediction,Adapte
1884,2016,Philosophie,1,La Notion de Logique,6,Le Theoreme de Completude,7,819,1,QROC,0.1,0.47,69.16,22,10,32,26,22,4,1.23,84.62,Facile,Facile,0,Meme Difficulte que la Prediction,Adapte
2950,2017,Philosophie,1,La Notion de Logique,6,Le Theoreme de Completude,7,819,1,QROC,0.15,0.61,69.16,25,11,36,28,25,3,1.29,89.29,Facile,Facile,0,Meme Difficulte que la Prediction,Adapte
4016,2018,Philosophie,1,La Notion de Logique,6,Le Theoreme de Completude,7,819,1,QROC,0.09,0.5,69.16,24,11,35,34,24,10,1.03,70.59,Facile,Facile,0,Meme Difficulte que la Prediction,Adapte
5082,2019,Philosophie,1,La Notion de Logique,6,Le Theoreme de Completude,7,819,1,QROC,0.13,0.9,69.16,24,10,34,30,24,6,1.13,80.0,Facile,Facile,0,Meme Difficulte que la Prediction,Adapte
6148,2020,Philosophie,1,La Notion de Logique,6,Le Theoreme de Completude,7,819,1,QO,0.13,0.75,69.16,22,10,32,28,22,6,1.14,78.57,Facile,Facile,0,Meme Difficulte que la Prediction,Adapte
819,2015,Philosophie,1,La Notion de Logique,6,Le Theoreme de Completude,7,820,2,QROC,0.95,0.03,18.46,18,79,97,86,18,68,1.13,20.93,Difficile,Difficile,0,Meme Difficulte que la Prediction,Pas Adapte
1885,2016,Philosophie,1,La Notion de Logique,6,Le Theoreme de Completude,7,820,2,QO,0.48,0.18,51.13,43,42,85,71,43,28,1.2,60.56,Moyen,Moyen,0,Meme Difficulte que la Prediction,Pas Adapte
2951,2017,Philosophie,1,La Notion de Logique,6,Le Theoreme de Completude,7,820,2,QO,0.02,0.32,96.86,84,3,87,86,84,2,1.01,97.67,Moyen,Facile,1,Plus Facile que la Prediction,Pas Adapte
4017,2018,Philosophie,1,La Notion de Logique,6,Le Theoreme de Completude,7,820,2,QO,0.39,0.21,50.12,49,49,98,93,49,44,1.05,52.69,Difficile,Moyen,1,Plus Facile que la Prediction,Pas Adapte
5083,2019,Philosophie,1,La Notion de Logique,6,Le Theoreme de Completude,7,820,2,QO,0.21,0.25,56.28,51,40,91,69,51,18,1.32,73.91,Difficile,Moyen,1,Plus Facile que la Prediction,Pas Adapte
6149,2020,Philosophie,1,La Notion de Logique,6,Le Theoreme de Completude,7,820,2,QO,0.1,0.61,95.58,98,5,103,102,98,4,1.01,96.08,Facile,Facile,0,Meme Difficulte que la Prediction,Pas Adapte
820,2015,Philosophie,1,La Notion de Logique,6,Le Theoreme de Completude,7,821,3,QCU,0.33,0.44,47.79,25,28,53,42,25,17,1.26,59.52,Facile,Moyen,-1,Plus Difficile que la Prediction,Pas Adapte
1886,2016,Philosophie,1,La Notion de Logique,6,Le Theoreme de Completude,7,821,3,QCU,0.13,0.81,97.35,47,1,48,47,47,0,1.02,100.0,Facile,Facile,0,Meme Difficulte que la Prediction,Pas Adapte
2952,2017,Philosophie,1,La Notion de Logique,6,Le Theoreme de Completude,7,821,3,QCU,0.09,0.93,76.39,42,13,55,49,42,7,1.12,85.71,Difficile,Facile,2,Beaucoup plus Facile que la Prediction,Pas Adapte
4018,2018,Philosophie,1,La Notion de Logique,6,Le Theoreme de Completude,7,821,3,QCU,0.06,0.97,86.64,54,8,62,56,54,2,1.11,96.43,Moyen,Facile,1,Plus Facile que la Prediction,Pas Adapte
5084,2019,Philosophie,1,La Notion de Logique,6,Le Theoreme de Completude,7,821,3,QCU,0.23,0.69,41.51,29,42,71,57,29,28,1.25,50.88,Moyen,Moyen,0,Meme Difficulte que la Prediction,Pas Adapte
6150,2020,Philosophie,1,La Notion de Logique,6,Le Theoreme de Completude,7,821,3,QCU,0.59,0.23,25.51,15,45,60,33,15,18,1.82,45.45,Difficile,Difficile,0,Meme Difficulte que la Prediction,Pas Adapte
821,2015,Philosophie,1,La Notion de Logique,6,Le Theoreme de Completude,7,822,4,QCU,0.6,0.21,0.43,0,61,61,32,0,32,1.91,0.0,Difficile,Difficile,0,Meme Difficulte que la Prediction,Pas Adapte
1887,2016,Philosophie,1,La Notion de Logique,6,Le Theoreme de Completude,7,822,4,QCU,0.06,0.79,88.82,62,8,70,66,62,4,1.06,93.94,Facile,Facile,0,Meme Difficulte que la Prediction,Pas Adapte
2953,2017,Philosophie,1,La Notion de Logique,6,Le Theoreme de Completude,7,822,4,QCU,0.66,0.26,13.62,11,67,78,73,11,62,1.07,15.07,Facile,Difficile,-2,Beaucoup plus Difficile que la Prediction,Pas Adapte
4019,2018,Philosophie,1,La Notion de Logique,6,Le Theoreme de Completude,7,822,4,QCU,0.75,0.36,23.97,20,63,83,31,20,11,2.68,64.52,Moyen,Difficile,-1,Plus Difficile que la Prediction,Pas Adapte
5085,2019,Philosophie,1,La Notion de Logique,6,Le Theoreme de Completude,7,822,4,QCU,0.13,0.87,86.63,82,13,95,85,82,3,1.12,96.47,Facile,Facile,0,Meme Difficulte que la Prediction,Pas Adapte
6151,2020,Philosophie,1,La Notion de Logique,6,Le Theoreme de Completude,7,822,4,QCM,0.63,0.27,33.73,33,66,99,96,33,63,1.03,34.38,Difficile,Difficile,0,Meme Difficulte que la Prediction,Pas Adapte
822,2015,Philosophie,1,La Notion de Logique,6,Le Theoreme de Completude,7,823,5,QCU,0.27,0.69,58.07,18,13,31,20,18,2,1.55,90.0,Difficile,Moyen,1,Plus Facile que la Prediction,Pas Adapte
1888,2016,Philosophie,1,La Notion de Logique,6,Le Theoreme de Completude,7,823,5,QCU,0.33,0.59,54.07,16,13,29,19,16,3,1.53,84.21,Moyen,Moyen,0,Meme Difficulte que la Prediction,Pas Adapte
2954,2017,Philosophie,1,La Notion de Logique,6,Le Theoreme de Completude,7,823,5,QCU,0.68,0.38,14.55,4,26,30,26,4,22,1.15,15.38,Difficile,Difficile,0,Meme Difficulte que la Prediction,Pas Adapte
4020,2018,Philosophie,1,La Notion de Logique,6,Le Theoreme de Completude,7,823,5,QROC,0.01,0.59,88.94,27,3,30,29,27,2,1.03,93.1,Facile,Facile,0,Meme Difficulte que la Prediction,Pas Adapte
5086,2019,Philosophie,1,La Notion de Logique,6,Le Theoreme de Completude,7,823,5,QROC,0.57,0.38,39.42,12,18,30,27,12,15,1.11,44.44,Moyen,Moyen,0,Meme Difficulte que la Prediction,Pas Adapte
6152,2020,Philosophie,1,La Notion de Logique,6,Le Theoreme de Completude,7,823,5,QROC,0.78,0.23,24.54,7,21,28,13,7,6,2.15,53.85,Facile,Difficile,-2,Beaucoup plus Difficile que la Prediction,Pas Adapte
823,2015,Philosophie,1,La Notion de Logique,6,Le Theoreme de Completude,7,824,6,QROC,0.06,0.49,96.34,58,2,60,60,58,2,1.0,96.67,Facile,Facile,0,Meme Difficulte que la Prediction,Pas Adapte
1889,2016,Philosophie,1,La Notion de Logique,6,Le Theoreme de Completude,7,824,6,QROC,0.94,0.08,6.39,4,55,59,53,4,49,1.11,7.55,Difficile,Difficile,0,Meme Difficulte que la Prediction,Pas Adapte
2955,2017,Philosophie,1,La Notion de Logique,6,Le Theoreme de Completude,7,824,6,QROC,0.68,0.13,15.06,8,43,51,28,8,20,1.82,28.57,Difficile,Difficile,0,Meme Difficulte que la Prediction,Pas Adapte
4021,2018,Philosophie,1,La Notion de Logique,6,Le Theoreme de Completude,7,824,6,QROC,0.43,0.28,54.62,25,21,46,26,25,1,1.77,96.15,Moyen,Moyen,0,Meme Difficulte que la Prediction,Pas Adapte
5087,2019,Philosophie,1,La Notion de Logique,6,Le Theoreme de Completude,7,824,6,QROC,0.14,0.45,98.83,47,1,48,47,47,0,1.02,100.0,Moyen,Facile,1,Plus Facile que la Prediction,Pas Adapte
6153,2020,Philosophie,1,La Notion de Logique,6,Le Theoreme de Completude,7,824,6,QROC,0.02,0.43,76.65,41,12,53,48,41,7,1.1,85.42,Facile,Facile,0,Meme Difficulte que la Prediction,Pas Adapte
824,2015,Philosophie,1,La Notion de Logique,6,Le Theoreme de Completude,7,825,7,QCU,0.23,0.43,40.55,15,21,36,19,15,4,1.89,78.95,Moyen,Moyen,0,Meme Difficulte que la Prediction,Pas Adapte
1890,2016,Philosophie,1,La Notion de Logique,6,Le Theoreme de Completude,7,825,7,QCU,0.11,0.93,96.79,30,1,31,31,30,1,1.0,96.77,Facile,Facile,0,Meme Difficulte que la Prediction,Pas Adapte
2956,2017,Philosophie,1,La Notion de Logique,6,Le Theoreme de Completude,7,825,7,QCU,0.74,0.2,7.14,2,25,27,12,2,10,2.25,16.67,Moyen,Difficile,-1,Plus Difficile que la Prediction,Pas Adapte
4022,2018,Philosophie,1,La Notion de Logique,6,Le Theoreme de Completude,7,825,7,QCU,0.29,0.55,52.4,15,13,28,27,15,12,1.04,55.56,Moyen,Moyen,0,Meme Difficulte que la Prediction,Pas Adapte
5088,2019,Philosophie,1,La Notion de Logique,6,Le Theoreme de Completude,7,825,7,QCU,0.04,0.75,82.58,24,5,29,28,24,4,1.04,85.71,Facile,Facile,0,Meme Difficulte que la Prediction,Pas Adapte
6154,2020,Philosophie,1,La Notion de Logique,6,Le Theoreme de Completude,7,825,7,QCU,0.6,0.33,9.86,3,25,28,27,3,24,1.04,11.11,Facile,Difficile,-2,Beaucoup plus Difficile que la Prediction,Pas Adapte
825,2015,Philosophie,1,La Notion d'Ethique,1,La Recherche d'Ethique,6,826,1,QCU,0.18,0.87,88.52,88,11,99,91,88,3,1.09,96.7,Facile,Facile,0,Meme Difficulte que la Prediction,Pas Adapte
1891,2016,Philosophie,1,La Notion d'Ethique,1,La Recherche d'Ethique,6,826,1,QCU,0.56,0.34,23.26,26,87,113,83,26,57,1.36,31.33,Facile,Difficile,-2,Beaucoup plus Difficile que la Prediction,Pas Adapte
2957,2017,Philosophie,1,La Notion d'Ethique,1,La Recherche d'Ethique,6,826,1,QCU,0.72,0.32,10.45,11,93,104,48,11,37,2.17,22.92,Difficile,Difficile,0,Meme Difficulte que la Prediction,Pas Adapte
4023,2018,Philosophie,1,La Notion d'Ethique,1,La Recherche d'Ethique,6,826,1,QCU,0.11,0.84,71.59,67,26,93,86,67,19,1.08,77.91,Facile,Facile,0,Meme Difficulte que la Prediction,Adapte
5089,2019,Philosophie,1,La Notion d'Ethique,1,La Recherche d'Ethique,6,826,1,QCU,0.11,0.8,71.59,67,26,93,76,67,9,1.22,88.16,Facile,Facile,0,Meme Difficulte que la Prediction,Adapte
6155,2020,Philosophie,1,La Notion d'Ethique,1,La Recherche d'Ethique,6,826,1,QCU,0.16,0.96,71.59,65,26,91,87,65,22,1.05,74.71,Facile,Facile,0,Meme Difficulte que la Prediction,Adapte
826,2015,Philosophie,1,La Notion d'Ethique,1,La Recherche d'Ethique,6,827,2,QCU,0.21,0.52,64.84,16,9,25,21,16,5,1.19,76.19,Moyen,Moyen,0,Meme Difficulte que la Prediction,Adapte
1892,2016,Philosophie,1,La Notion d'Ethique,1,La Recherche d'Ethique,6,827,2,QCU,0.23,0.71,64.84,19,10,29,26,19,7,1.12,73.08,Moyen,Moyen,0,Meme Difficulte que la Prediction,Adapte
2958,2017,Philosophie,1,La Notion d'Ethique,1,La Recherche d'Ethique,6,827,2,QCU,0.31,0.51,64.84,21,11,32,22,21,1,1.45,95.45,Moyen,Moyen,0,Meme Difficulte que la Prediction,Adapte
4024,2018,Philosophie,1,La Notion d'Ethique,1,La Recherche d'Ethique,6,827,2,QCU,0.22,0.63,64.84,24,13,37,25,24,1,1.48,96.0,Moyen,Moyen,0,Meme Difficulte que la Prediction,Adapte
5090,2019,Philosophie,1,La Notion d'Ethique,1,La Recherche d'Ethique,6,827,2,QCU,0.26,0.44,64.84,25,14,39,28,25,3,1.39,89.29,Moyen,Moyen,0,Meme Difficulte que la Prediction,Adapte
6156,2020,Philosophie,1,La Notion d'Ethique,1,La Recherche d'Ethique,6,827,2,QCU,0.4,0.56,64.84,22,12,34,32,22,10,1.06,68.75,Moyen,Moyen,0,Meme Difficulte que la Prediction,Adapte
827,2015,Philosophie,1,La Notion d'Ethique,1,La Recherche d'Ethique,6,828,3,QROC,0.83,0.23,30.92,7,16,23,17,7,10,1.35,41.18,Difficile,Difficile,0,Meme Difficulte que la Prediction,Pas Adapte
1893,2016,Philosophie,1,La Notion d'Ethique,1,La Recherche d'Ethique,6,828,3,QROC,0.38,0.28,63.95,14,8,22,22,14,8,1.0,63.64,Moyen,Moyen,0,Meme Difficulte que la Prediction,Adapte
2959,2017,Philosophie,1,La Notion d'Ethique,1,La Recherche d'Ethique,6,828,3,QROC,0.57,0.34,63.95,15,9,24,20,15,5,1.2,75.0,Moyen,Moyen,0,Meme Difficulte que la Prediction,Adapte
4025,2018,Philosophie,1,La Notion d'Ethique,1,La Recherche d'Ethique,6,828,3,QROC,0.58,0.37,63.95,15,8,23,16,15,1,1.44,93.75,Moyen,Moyen,0,Meme Difficulte que la Prediction,Adapte
5091,2019,Philosophie,1,La Notion d'Ethique,1,La Recherche d'Ethique,6,828,3,QROC,0.44,0.29,63.95,13,8,21,15,13,2,1.4,86.67,Moyen,Moyen,0,Meme Difficulte que la Prediction,Adapte
6157,2020,Philosophie,1,La Notion d'Ethique,1,La Recherche d'Ethique,6,828,3,QROC,0.55,0.33,63.95,12,7,19,13,12,1,1.46,92.31,Moyen,Moyen,0,Meme Difficulte que la Prediction,Adapte
828,2015,Philosophie,1,La Notion d'Ethique,1,La Recherche d'Ethique,6,829,4,QCM,0.75,0.27,31.13,19,41,60,33,19,14,1.82,57.58,Difficile,Difficile,0,Meme Difficulte que la Prediction,Pas Adapte
1894,2016,Philosophie,1,La Notion d'Ethique,1,La Recherche d'Ethique,6,829,4,QCM,0.67,0.2,28.94,18,43,61,57,18,39,1.07,31.58,Facile,Difficile,-2,Beaucoup plus Difficile que la Prediction,Pas Adapte
2960,2017,Philosophie,1,La Notion d'Ethique,1,La Recherche d'Ethique,6,829,4,QCM,0.22,0.34,43.31,29,38,67,64,29,35,1.05,45.31,Difficile,Moyen,1,Plus Facile que la Prediction,Pas Adapte
4026,2018,Philosophie,1,La Notion d'Ethique,1,La Recherche d'Ethique,6,829,4,QCU,0.35,0.57,40.75,25,36,61,54,25,29,1.13,46.3,Difficile,Moyen,1,Plus Facile que la Prediction,Pas Adapte
5092,2019,Philosophie,1,La Notion d'Ethique,1,La Recherche d'Ethique,6,829,4,QCU,0.37,0.58,44.63,31,38,69,57,31,26,1.21,54.39,Moyen,Moyen,0,Meme Difficulte que la Prediction,Pas Adapte
6158,2020,Philosophie,1,La Notion d'Ethique,1,La Recherche d'Ethique,6,829,4,QCU,0.16,0.89,88.06,67,9,76,70,67,3,1.09,95.71,Difficile,Facile,2,Beaucoup plus Facile que la Prediction,Pas Adapte
829,2015,Philosophie,1,La Notion d'Ethique,1,La Recherche d'Ethique,6,830,5,QCU,0.7,0.25,13.89,13,84,97,83,13,70,1.17,15.66,Difficile,Difficile,0,Meme Difficulte que la Prediction,Pas Adapte
1895,2016,Philosophie,1,La Notion d'Ethique,1,La Recherche d'Ethique,6,830,5,QCU,0.13,0.76,91.11,101,10,111,106,101,5,1.05,95.28,Facile,Facile,0,Meme Difficulte que la Prediction,Pas Adapte
2961,2017,Philosophie,1,La Notion d'Ethique,1,La Recherche d'Ethique,6,830,5,QCU,0.57,0.29,29.09,33,80,113,95,33,62,1.19,34.74,Difficile,Difficile,0,Meme Difficulte que la Prediction,Pas Adapte
4027,2018,Philosophie,1,La Notion d'Ethique,1,La Recherche d'Ethique,6,830,5,QCU,0.02,0.9,65.42,72,38,110,80,72,8,1.38,90.0,Facile,Facile,0,Meme Difficulte que la Prediction,Adapte
5093,2019,Philosophie,1,La Notion d'Ethique,1,La Recherche d'Ethique,6,830,5,QCU,0.08,0.91,65.42,82,43,125,113,82,31,1.11,72.57,Facile,Facile,0,Meme Difficulte que la Prediction,Adapte
6159,2020,Philosophie,1,La Notion d'Ethique,1,La Recherche d'Ethique,6,830,5,QCU,0.1,0.75,65.42,70,37,107,72,70,2,1.49,97.22,Facile,Facile,0,Meme Difficulte que la Prediction,Adapte
830,2015,Philosophie,1,La Notion d'Ethique,1,La Recherche d'Ethique,6,831,6,QCU,0.68,0.22,9.74,7,61,68,47,7,40,1.45,14.89,Moyen,Difficile,-1,Plus Difficile que la Prediction,Pas Adapte
1896,2016,Philosophie,1,La Notion d'Ethique,1,La Recherche d'Ethique,6,831,6,QROC,0.6,0.14,14.84,12,66,78,36,12,24,2.17,33.33,Difficile,Difficile,0,Meme Difficulte que la Prediction,Pas Adapte
2962,2017,Philosophie,1,La Notion d'Ethique,1,La Recherche d'Ethique,6,831,6,QROC,0.53,0.28,51.65,41,38,79,43,41,2,1.84,95.35,Difficile,Moyen,1,Plus Facile que la Prediction,Pas Adapte
4028,2018,Philosophie,1,La Notion d'Ethique,1,La Recherche d'Ethique,6,831,6,QROC,0.94,0.18,28.84,21,51,72,56,21,35,1.29,37.5,Difficile,Difficile,0,Meme Difficulte que la Prediction,Pas Adapte
5094,2019,Philosophie,1,La Notion d'Ethique,1,La Recherche d'Ethique,6,831,6,QROC,0.71,0.25,28.05,19,49,68,51,19,32,1.33,37.25,Difficile,Difficile,0,Meme Difficulte que la Prediction,Pas Adapte
6160,2020,Philosophie,1,La Notion d'Ethique,1,La Recherche d'Ethique,6,831,6,QROC,0.11,0.45,99.9,63,0,63,63,63,0,1.0,100.0,Facile,Facile,0,Meme Difficulte que la Prediction,Pas Adapte
831,2015,Philosophie,1,La Notion d'Ethique,2,Libre Arbitre et Determinisme,12,832,1,QCM,0.06,0.74,84.44,43,8,51,49,43,6,1.04,87.76,Difficile,Facile,2,Beaucoup plus Facile que la Prediction,Pas Adapte
1897,2016,Philosophie,1,La Notion d'Ethique,2,Libre Arbitre et Determinisme,12,832,1,QCM,0.35,0.38,49.78,28,29,57,46,28,18,1.24,60.87,Difficile,Moyen,1,Plus Facile que la Prediction,Pas Adapte
2963,2017,Philosophie,1,La Notion d'Ethique,2,Libre Arbitre et Determinisme,12,832,1,QCM,0.02,0.94,67.22,42,21,63,61,42,19,1.03,68.85,Difficile,Facile,2,Beaucoup plus Facile que la Prediction,Adapte
4029,2018,Philosophie,1,La Notion d'Ethique,2,Libre Arbitre et Determinisme,12,832,1,QCU,0.04,0.85,67.22,39,19,58,50,39,11,1.16,78.0,Facile,Facile,0,Meme Difficulte que la Prediction,Adapte
5095,2019,Philosophie,1,La Notion d'Ethique,2,Libre Arbitre et Determinisme,12,832,1,QCU,0.11,0.79,67.22,44,21,65,48,44,4,1.35,91.67,Facile,Facile,0,Meme Difficulte que la Prediction,Adapte
6161,2020,Philosophie,1,La Notion d'Ethique,2,Libre Arbitre et Determinisme,12,832,1,QCU,0.09,0.97,67.22,39,19,58,49,39,10,1.18,79.59,Facile,Facile,0,Meme Difficulte que la Prediction,Adapte
832,2015,Philosophie,1,La Notion d'Ethique,2,Libre Arbitre et Determinisme,12,833,2,QROC,0.64,0.11,7.76,7,89,96,74,7,67,1.3,9.46,Difficile,Difficile,0,Meme Difficulte que la Prediction,Pas Adapte
1898,2016,Philosophie,1,La Notion d'Ethique,2,Libre Arbitre et Determinisme,12,833,2,QROC,0.25,0.26,60.83,66,42,108,100,66,34,1.08,66.0,Facile,Moyen,-1,Plus Difficile que la Prediction,Adapte
2964,2017,Philosophie,1,La Notion d'Ethique,2,Libre Arbitre et Determinisme,12,833,2,QROC,0.54,0.38,60.83,60,39,99,76,60,16,1.3,78.95,Moyen,Moyen,0,Meme Difficulte que la Prediction,Adapte
4030,2018,Philosophie,1,La Notion d'Ethique,2,Libre Arbitre et Determinisme,12,833,2,QROC,0.27,0.31,60.83,52,34,86,66,52,14,1.3,78.79,Moyen,Moyen,0,Meme Difficulte que la Prediction,Adapte
5096,2019,Philosophie,1,La Notion d'Ethique,2,Libre Arbitre et Determinisme,12,833,2,QROC,0.43,0.38,60.83,57,36,93,92,57,35,1.01,61.96,Moyen,Moyen,0,Meme Difficulte que la Prediction,Adapte
6162,2020,Philosophie,1,La Notion d'Ethique,2,Libre Arbitre et Determinisme,12,833,2,QO,0.23,0.18,60.83,49,31,80,68,49,19,1.18,72.06,Moyen,Moyen,0,Meme Difficulte que la Prediction,Adapte
833,2015,Philosophie,1,La Notion d'Ethique,2,Libre Arbitre et Determinisme,12,834,3,QCM,0.46,0.41,46.15,33,38,71,67,33,34,1.06,49.25,Facile,Moyen,-1,Plus Difficile que la Prediction,Pas Adapte
1899,2016,Philosophie,1,La Notion d'Ethique,2,Libre Arbitre et Determinisme,12,834,3,QCM,0.6,0.29,31.03,19,42,61,35,19,16,1.74,54.29,Difficile,Difficile,0,Meme Difficulte que la Prediction,Pas Adapte
2965,2017,Philosophie,1,La Notion d'Ethique,2,Libre Arbitre et Determinisme,12,834,3,QCM,0.68,0.27,1.37,1,63,64,35,1,34,1.83,2.86,Difficile,Difficile,0,Meme Difficulte que la Prediction,Pas Adapte
4031,2018,Philosophie,1,La Notion d'Ethique,2,Libre Arbitre et Determinisme,12,834,3,QCM,0.24,0.4,38.84,25,40,65,37,25,12,1.76,67.57,Moyen,Moyen,0,Meme Difficulte que la Prediction,Pas Adapte
5097,2019,Philosophie,1,La Notion d'Ethique,2,Libre Arbitre et Determinisme,12,834,3,QCM,0.23,0.63,49.54,37,38,75,72,37,35,1.04,51.39,Difficile,Moyen,1,Plus Facile que la Prediction,Pas Adapte
6163,2020,Philosophie,1,La Notion d'Ethique,2,Libre Arbitre et Determinisme,12,834,3,QCM,0.36,0.45,39.18,27,43,70,29,27,2,2.41,93.1,Moyen,Moyen,0,Meme Difficulte que la Prediction,Pas Adapte
834,2015,Philosophie,1,La Notion d'Ethique,2,Libre Arbitre et Determinisme,12,835,4,QCM,0.73,0.23,23.49,16,54,70,51,16,35,1.37,31.37,Difficile,Difficile,0,Meme Difficulte que la Prediction,Pas Adapte
1900,2016,Philosophie,1,La Notion d'Ethique,2,Libre Arbitre et Determinisme,12,835,4,QCM,0.64,0.23,26.5,18,51,69,68,18,50,1.01,26.47,Moyen,Difficile,-1,Plus Difficile que la Prediction,Pas Adapte
2966,2017,Philosophie,1,La Notion d'Ethique,2,Libre Arbitre et Determinisme,12,835,4,QCM,0.06,0.98,74.33,50,17,67,63,50,13,1.06,79.37,Facile,Facile,0,Meme Difficulte que la Prediction,Adapte
4032,2018,Philosophie,1,La Notion d'Ethique,2,Libre Arbitre et Determinisme,12,835,4,QCM,0.18,0.72,74.33,51,18,69,68,51,17,1.01,75.0,Facile,Facile,0,Meme Difficulte que la Prediction,Adapte
5098,2019,Philosophie,1,La Notion d'Ethique,2,Libre Arbitre et Determinisme,12,835,4,QROC,0.13,0.71,74.33,51,18,69,61,51,10,1.13,83.61,Facile,Facile,0,Meme Difficulte que la Prediction,Adapte
6164,2020,Philosophie,1,La Notion d'Ethique,2,Libre Arbitre et Determinisme,12,835,4,QROC,0.15,0.93,74.33,44,15,59,45,44,1,1.31,97.78,Facile,Facile,0,Meme Difficulte que la Prediction,Adapte
835,2015,Philosophie,1,La Notion d'Ethique,2,Libre Arbitre et Determinisme,12,836,5,QCM,0.76,0.16,17.03,13,62,75,64,13,51,1.17,20.31,Facile,Difficile,-2,Beaucoup plus Difficile que la Prediction,Pas Adapte
1901,2016,Philosophie,1,La Notion d'Ethique,2,Libre Arbitre et Determinisme,12,836,5,QCM,0.75,0.18,14.42,10,56,66,31,10,21,2.13,32.26,Moyen,Difficile,-1,Plus Difficile que la Prediction,Pas Adapte
2967,2017,Philosophie,1,La Notion d'Ethique,2,Libre Arbitre et Determinisme,12,836,5,QCM,0.45,0.67,47.45,31,35,66,45,31,14,1.47,68.89,Moyen,Moyen,0,Meme Difficulte que la Prediction,Pas Adapte
4033,2018,Philosophie,1,La Notion d'Ethique,2,Libre Arbitre et Determinisme,12,836,5,QCM,0.6,0.25,3.51,3,71,74,71,3,68,1.04,4.23,Difficile,Difficile,0,Meme Difficulte que la Prediction,Pas Adapte
5099,2019,Philosophie,1,La Notion d'Ethique,2,Libre Arbitre et Determinisme,12,836,5,QCU,0.01,0.99,87.44,57,8,65,58,57,1,1.12,98.28,Facile,Facile,0,Meme Difficulte que la Prediction,Pas Adapte
6165,2020,Philosophie,1,La Notion d'Ethique,2,Libre Arbitre et Determinisme,12,836,5,QCU,0.17,0.9,96.86,61,2,63,62,61,1,1.02,98.39,Facile,Facile,0,Meme Difficulte que la Prediction,Pas Adapte
836,2015,Philosophie,1,La Notion d'Ethique,2,Libre Arbitre et Determinisme,12,837,6,QROC,0.17,0.87,90.1,41,4,45,43,41,2,1.05,95.35,Facile,Facile,0,Meme Difficulte que la Prediction,Pas Adapte
1902,2016,Philosophie,1,La Notion d'Ethique,2,Libre Arbitre et Determinisme,12,837,6,QROC,0.12,0.97,65.36,33,18,51,37,33,4,1.38,89.19,Moyen,Facile,1,Plus Facile que la Prediction,Adapte
2968,2017,Philosophie,1,La Notion d'Ethique,2,Libre Arbitre et Determinisme,12,837,6,QROC,0.08,0.93,65.36,32,17,49,36,32,4,1.36,88.89,Facile,Facile,0,Meme Difficulte que la Prediction,Adapte
4034,2018,Philosophie,1,La Notion d'Ethique,2,Libre Arbitre et Determinisme,12,837,6,QROC,0.15,0.43,65.36,35,19,54,44,35,9,1.23,79.55,Facile,Facile,0,Meme Difficulte que la Prediction,Adapte
5100,2019,Philosophie,1,La Notion d'Ethique,2,Libre Arbitre et Determinisme,12,837,6,QROC,0.07,0.57,65.36,31,16,47,43,31,12,1.09,72.09,Facile,Facile,0,Meme Difficulte que la Prediction,Adapte
6166,2020,Philosophie,1,La Notion d'Ethique,2,Libre Arbitre et Determinisme,12,837,6,QROC,0.07,0.76,65.36,33,17,50,36,33,3,1.39,91.67,Facile,Facile,0,Meme Difficulte que la Prediction,Adapte
837,2015,Philosophie,1,La Notion d'Ethique,2,Libre Arbitre et Determinisme,12,838,7,QROC,0.01,0.8,84.35,22,4,26,22,22,0,1.18,100.0,Facile,Facile,0,Meme Difficulte que la Prediction,Pas Adapte
1903,2016,Philosophie,1,La Notion d'Ethique,2,Libre Arbitre et Determinisme,12,838,7,QROC,0.95,0.11,24.16,7,21,28,16,7,9,1.75,43.75,Difficile,Difficile,0,Meme Difficulte que la Prediction,Pas Adapte
2969,2017,Philosophie,1,La Notion d'Ethique,2,Libre Arbitre et Determinisme,12,838,7,QROC,0.65,0.08,19.59,5,19,24,12,5,7,2.0,41.67,Moyen,Difficile,-1,Plus Difficile que la Prediction,Pas Adapte
4035,2018,Philosophie,1,La Notion d'Ethique,2,Libre Arbitre et Determinisme,12,838,7,QROC,0.78,0.2,13.68,3,17,20,10,3,7,2.0,30.0,Difficile,Difficile,0,Meme Difficulte que la Prediction,Pas Adapte
5101,2019,Philosophie,1,La Notion d'Ethique,2,Libre Arbitre et Determinisme,12,838,7,QROC,0.14,0.48,97.9,22,0,22,22,22,0,1.0,100.0,Facile,Facile,0,Meme Difficulte que la Prediction,Pas Adapte
6167,2020,Philosophie,1,La Notion d'Ethique,2,Libre Arbitre et Determinisme,12,838,7,QROC,0.57,0.4,49.26,10,11,21,11,10,1,1.91,90.91,Facile,Moyen,-1,Plus Difficile que la Prediction,Pas Adapte
838,2015,Philosophie,1,La Notion d'Ethique,2,Libre Arbitre et Determinisme,12,839,8,QCU,0.17,0.91,87.76,19,3,22,20,19,1,1.1,95.0,Moyen,Facile,1,Plus Facile que la Prediction,Pas Adapte
1904,2016,Philosophie,1,La Notion d'Ethique,2,Libre Arbitre et Determinisme,12,839,8,QCU,0.32,0.42,38.58,8,14,22,18,8,10,1.22,44.44,Difficile,Moyen,1,Plus Facile que la Prediction,Pas Adapte
2970,2017,Philosophie,1,La Notion d'Ethique,2,Libre Arbitre et Determinisme,12,839,8,QCU,0.19,0.94,82.37,16,3,19,18,16,2,1.06,88.89,Facile,Facile,0,Meme Difficulte que la Prediction,Pas Adapte
4036,2018,Philosophie,1,La Notion d'Ethique,2,Libre Arbitre et Determinisme,12,839,8,QCU,0.38,0.51,48.58,10,11,21,11,10,1,1.91,90.91,Moyen,Moyen,0,Meme Difficulte que la Prediction,Pas Adapte
5102,2019,Philosophie,1,La Notion d'Ethique,2,Libre Arbitre et Determinisme,12,839,8,QCU,0.35,0.66,59.2,11,8,19,17,11,6,1.12,64.71,Moyen,Moyen,0,Meme Difficulte que la Prediction,Pas Adapte
6168,2020,Philosophie,1,La Notion d'Ethique,2,Libre Arbitre et Determinisme,12,839,8,QCU,0.36,0.58,48.71,9,10,19,13,9,4,1.46,69.23,Difficile,Moyen,1,Plus Facile que la Prediction,Pas Adapte
839,2015,Philosophie,1,La Notion d'Ethique,2,Libre Arbitre et Determinisme,12,840,9,QROC,0.11,0.77,97.33,63,2,65,64,63,1,1.02,98.44,Facile,Facile,0,Meme Difficulte que la Prediction,Pas Adapte
1905,2016,Philosophie,1,La Notion d'Ethique,2,Libre Arbitre et Determinisme,12,840,9,QROC,0.49,0.36,61.59,43,27,70,48,43,5,1.46,89.58,Moyen,Moyen,0,Meme Difficulte que la Prediction,Adapte
2971,2017,Philosophie,1,La Notion d'Ethique,2,Libre Arbitre et Determinisme,12,840,9,QROC,0.58,0.26,61.59,44,28,72,70,44,26,1.03,62.86,Moyen,Moyen,0,Meme Difficulte que la Prediction,Adapte
4037,2018,Philosophie,1,La Notion d'Ethique,2,Libre Arbitre et Determinisme,12,840,9,QROC,0.5,0.31,61.59,47,30,77,69,47,22,1.12,68.12,Moyen,Moyen,0,Meme Difficulte que la Prediction,Adapte
5103,2019,Philosophie,1,La Notion d'Ethique,2,Libre Arbitre et Determinisme,12,840,9,QROC,0.23,0.36,61.59,47,30,77,71,47,24,1.08,66.2,Moyen,Moyen,0,Meme Difficulte que la Prediction,Adapte
6169,2020,Philosophie,1,La Notion d'Ethique,2,Libre Arbitre et Determinisme,12,840,9,QROC,0.42,0.37,61.59,41,26,67,44,41,3,1.52,93.18,Moyen,Moyen,0,Meme Difficulte que la Prediction,Adapte
840,2015,Philosophie,1,La Notion d'Ethique,2,Libre Arbitre et Determinisme,12,841,10,QROC,0.94,0.21,15.33,1,6,7,4,1,3,1.75,25.0,Moyen,Difficile,-1,Plus Difficile que la Prediction,Pas Adapte
1906,2016,Philosophie,1,La Notion d'Ethique,2,Libre Arbitre et Determinisme,12,841,10,QROC,0.66,0.07,32.07,3,5,8,5,3,2,1.6,60.0,Difficile,Difficile,0,Meme Difficulte que la Prediction,Pas Adapte
2972,2017,Philosophie,1,La Notion d'Ethique,2,Libre Arbitre et Determinisme,12,841,10,QROC,0.64,0.0,18.52,2,7,9,5,2,3,1.8,40.0,Difficile,Difficile,0,Meme Difficulte que la Prediction,Pas Adapte
4038,2018,Philosophie,1,La Notion d'Ethique,2,Libre Arbitre et Determinisme,12,841,10,QROC,0.49,0.38,60.71,5,4,9,7,5,2,1.29,71.43,Moyen,Moyen,0,Meme Difficulte que la Prediction,Adapte
5104,2019,Philosophie,1,La Notion d'Ethique,2,Libre Arbitre et Determinisme,12,841,10,QROC,0.49,0.29,60.71,5,4,9,6,5,1,1.5,83.33,Moyen,Moyen,0,Meme Difficulte que la Prediction,Adapte
6170,2020,Philosophie,1,La Notion d'Ethique,2,Libre Arbitre et Determinisme,12,841,10,QROC,0.57,0.29,60.71,5,3,8,6,5,1,1.33,83.33,Moyen,Moyen,0,Meme Difficulte que la Prediction,Adapte
841,2015,Philosophie,1,La Notion d'Ethique,2,Libre Arbitre et Determinisme,12,842,11,QO,0.07,0.86,68.79,46,21,67,59,46,13,1.14,77.97,Difficile,Facile,2,Beaucoup plus Facile que la Prediction,Adapte
1907,2016,Philosophie,1,La Notion d'Ethique,2,Libre Arbitre et Determinisme,12,842,11,QROC,0.11,0.71,68.79,44,20,64,46,44,2,1.39,95.65,Facile,Facile,0,Meme Difficulte que la Prediction,Adapte
2973,2017,Philosophie,1,La Notion d'Ethique,2,Libre Arbitre et Determinisme,12,842,11,QROC,0.11,0.47,68.79,44,20,64,60,44,16,1.07,73.33,Facile,Facile,0,Meme Difficulte que la Prediction,Adapte
4039,2018,Philosophie,1,La Notion d'Ethique,2,Libre Arbitre et Determinisme,12,842,11,QROC,0.18,0.9,68.79,39,18,57,56,39,17,1.02,69.64,Facile,Facile,0,Meme Difficulte que la Prediction,Adapte
5105,2019,Philosophie,1,La Notion d'Ethique,2,Libre Arbitre et Determinisme,12,842,11,QROC,0.1,0.45,68.79,41,18,59,46,41,5,1.28,89.13,Facile,Facile,0,Meme Difficulte que la Prediction,Adapte
6171,2020,Philosophie,1,La Notion d'Ethique,2,Libre Arbitre et Determinisme,12,842,11,QCU,0.16,0.88,68.79,39,18,57,53,39,14,1.08,73.58,Facile,Facile,0,Meme Difficulte que la Prediction,Adapte
842,2015,Philosophie,1,La Notion d'Ethique,2,Libre Arbitre et Determinisme,12,843,12,QCU,0.17,0.89,89.15,67,8,75,72,67,5,1.04,93.06,Facile,Facile,0,Meme Difficulte que la Prediction,Pas Adapte
1908,2016,Philosophie,1,La Notion d'Ethique,2,Libre Arbitre et Determinisme,12,843,12,QCU,0.57,0.39,6.26,5,79,84,63,5,58,1.33,7.94,Difficile,Difficile,0,Meme Difficulte que la Prediction,Pas Adapte
2974,2017,Philosophie,1,La Notion d'Ethique,2,Libre Arbitre et Determinisme,12,843,12,QCU,0.24,0.53,44.3,39,49,88,62,39,23,1.42,62.9,Difficile,Moyen,1,Plus Facile que la Prediction,Pas Adapte
4040,2018,Philosophie,1,La Notion d'Ethique,2,Libre Arbitre et Determinisme,12,843,12,QCU,0.59,0.2,23.11,19,65,84,28,19,9,3.0,67.86,Difficile,Difficile,0,Meme Difficulte que la Prediction,Pas Adapte
5106,2019,Philosophie,1,La Notion d'Ethique,2,Libre Arbitre et Determinisme,12,843,12,QCU,0.06,0.95,88.86,72,9,81,79,72,7,1.03,91.14,Facile,Facile,0,Meme Difficulte que la Prediction,Pas Adapte
6172,2020,Philosophie,1,La Notion d'Ethique,2,Libre Arbitre et Determinisme,12,843,12,QCU,0.69,0.29,0.62,1,81,82,42,1,41,1.95,2.38,Difficile,Difficile,0,Meme Difficulte que la Prediction,Pas Adapte
843,2015,Philosophie,1,La Notion d'Ethique,3,Ethique du Devoir et Ethique Religieuse,9,844,1,QROC,0.61,0.15,3.71,3,66,69,41,3,38,1.68,7.32,Difficile,Difficile,0,Meme Difficulte que la Prediction,Pas Adapte
1909,2016,Philosophie,1,La Notion d'Ethique,3,Ethique du Devoir et Ethique Religieuse,9,844,1,QROC,0.73,0.09,26.21,19,52,71,65,19,46,1.09,29.23,Moyen,Difficile,-1,Plus Difficile que la Prediction,Pas Adapte
2975,2017,Philosophie,1,La Notion d'Ethique,3,Ethique du Devoir et Ethique Religieuse,9,844,1,QROC,0.92,0.24,23.54,16,52,68,50,16,34,1.36,32.0,Moyen,Difficile,-1,Plus Difficile que la Prediction,Pas Adapte
4041,2018,Philosophie,1,La Notion d'Ethique,3,Ethique du Devoir et Ethique Religieuse,9,844,1,QROC,0.08,0.54,78.02,51,15,66,56,51,5,1.18,91.07,Facile,Facile,0,Meme Difficulte que la Prediction,Pas Adapte
5107,2019,Philosophie,1,La Notion d'Ethique,3,Ethique du Devoir et Ethique Religieuse,9,844,1,QROC,0.23,0.28,53.04,38,34,72,69,38,31,1.04,55.07,Moyen,Moyen,0,Meme Difficulte que la Prediction,Pas Adapte
6173,2020,Philosophie,1,La Notion d'Ethique,3,Ethique du Devoir et Ethique Religieuse,9,844,1,QROC,0.54,0.35,62.33,42,25,67,48,42,6,1.4,87.5,Facile,Moyen,-1,Plus Difficile que la Prediction,Adapte
844,2015,Philosophie,1,La Notion d'Ethique,3,Ethique du Devoir et Ethique Religieuse,9,845,2,QCU,0.06,0.83,79.91,26,7,33,30,26,4,1.1,86.67,Facile,Facile,0,Meme Difficulte que la Prediction,Pas Adapte
1910,2016,Philosophie,1,La Notion d'Ethique,3,Ethique du Devoir et Ethique Religieuse,9,845,2,QCU,0.27,0.67,37.46,12,20,32,17,12,5,1.88,70.59,Difficile,Moyen,1,Plus Facile que la Prediction,Pas Adapte
2976,2017,Philosophie,1,La Notion d'Ethique,3,Ethique du Devoir et Ethique Religieuse,9,845,2,QCU,0.32,0.65,44.13,13,17,30,16,13,3,1.88,81.25,Moyen,Moyen,0,Meme Difficulte que la Prediction,Pas Adapte
4042,2018,Philosophie,1,La Notion d'Ethique,3,Ethique du Devoir et Ethique Religieuse,9,845,2,QCU,0.08,0.83,82.54,23,5,28,26,23,3,1.08,88.46,Difficile,Facile,2,Beaucoup plus Facile que la Prediction,Pas Adapte
5108,2019,Philosophie,1,La Notion d'Ethique,3,Ethique du Devoir et Ethique Religieuse,9,845,2,QCU,0.02,0.89,71.16,18,7,25,21,18,3,1.19,85.71,Facile,Facile,0,Meme Difficulte que la Prediction,Adapte
6174,2020,Philosophie,1,La Notion d'Ethique,3,Ethique du Devoir et Ethique Religieuse,9,845,2,QCU,0.11,0.98,71.16,15,6,21,16,15,1,1.31,93.75,Facile,Facile,0,Meme Difficulte que la Prediction,Adapte
845,2015,Philosophie,1,La Notion d'Ethique,3,Ethique du Devoir et Ethique Religieuse,9,846,3,QCU,0.13,0.97,77.95,38,11,49,48,38,10,1.02,79.17,Facile,Facile,0,Meme Difficulte que la Prediction,Pas Adapte
1911,2016,Philosophie,1,La Notion d'Ethique,3,Ethique du Devoir et Ethique Religieuse,9,846,3,QCU,0.42,0.36,2.47,1,45,46,28,1,27,1.64,3.57,Facile,Difficile,-2,Beaucoup plus Difficile que la Prediction,Pas Adapte
2977,2017,Philosophie,1,La Notion d'Ethique,3,Ethique du Devoir et Ethique Religieuse,9,846,3,QCU,0.1,0.96,86.96,39,6,45,41,39,2,1.1,95.12,Facile,Facile,0,Meme Difficulte que la Prediction,Pas Adapte
4043,2018,Philosophie,1,La Notion d'Ethique,3,Ethique du Devoir et Ethique Religieuse,9,846,3,QCU,0.54,0.29,31.9,14,30,44,30,14,16,1.47,46.67,Difficile,Difficile,0,Meme Difficulte que la Prediction,Pas Adapte
5109,2019,Philosophie,1,La Notion d'Ethique,3,Ethique du Devoir et Ethique Religieuse,9,846,3,QCU,0.62,0.21,31.96,15,31,46,17,15,2,2.71,88.24,Difficile,Difficile,0,Meme Difficulte que la Prediction,Pas Adapte
6175,2020,Philosophie,1,La Notion d'Ethique,3,Ethique du Devoir et Ethique Religieuse,9,846,3,QCU,0.35,0.68,43.28,21,27,48,48,21,27,1.0,43.75,Moyen,Moyen,0,Meme Difficulte que la Prediction,Pas Adapte
846,2015,Philosophie,1,La Notion d'Ethique,3,Ethique du Devoir et Ethique Religieuse,9,847,4,QCU,0.08,0.95,96.44,55,2,57,56,55,1,1.02,98.21,Facile,Facile,0,Meme Difficulte que la Prediction,Pas Adapte
1912,2016,Philosophie,1,La Notion d'Ethique,3,Ethique du Devoir et Ethique Religieuse,9,847,4,QCU,0.25,0.5,49.13,26,27,53,47,26,21,1.13,55.32,Moyen,Moyen,0,Meme Difficulte que la Prediction,Pas Adapte
2978,2017,Philosophie,1,La Notion d'Ethique,3,Ethique du Devoir et Ethique Religieuse,9,847,4,QCU,0.6,0.28,4.72,3,56,59,58,3,55,1.02,5.17,Facile,Difficile,-2,Beaucoup plus Difficile que la Prediction,Pas Adapte
4044,2018,Philosophie,1,La Notion d'Ethique,3,Ethique du Devoir et Ethique Religieuse,9,847,4,QCU,0.24,0.71,45.49,23,27,50,43,23,20,1.16,53.49,Moyen,Moyen,0,Meme Difficulte que la Prediction,Pas Adapte
5110,2019,Philosophie,1,La Notion d'Ethique,3,Ethique du Devoir et Ethique Religieuse,9,847,4,QCU,0.2,0.81,98.64,56,1,57,57,56,1,1.0,98.25,Facile,Facile,0,Meme Difficulte que la Prediction,Pas Adapte
6176,2020,Philosophie,1,La Notion d'Ethique,3,Ethique du Devoir et Ethique Religieuse,9,847,4,QCM,0.08,1.0,74.47,37,13,50,50,37,13,1.0,74.0,Facile,Facile,0,Meme Difficulte que la Prediction,Adapte
847,2015,Philosophie,1,La Notion d'Ethique,3,Ethique du Devoir et Ethique Religieuse,9,848,5,QCM,0.07,0.87,85.1,12,2,14,13,12,1,1.08,92.31,Facile,Facile,0,Meme Difficulte que la Prediction,Pas Adapte
1913,2016,Philosophie,1,La Notion d'Ethique,3,Ethique du Devoir et Ethique Religieuse,9,848,5,QCM,0.07,0.91,72.84,12,4,16,14,12,2,1.14,85.71,Facile,Facile,0,Meme Difficulte que la Prediction,Adapte
2979,2017,Philosophie,1,La Notion d'Ethique,3,Ethique du Devoir et Ethique Religieuse,9,848,5,QCM,0.08,0.98,72.84,12,4,16,15,12,3,1.07,80.0,Facile,Facile,0,Meme Difficulte que la Prediction,Adapte
4045,2018,Philosophie,1,La Notion d'Ethique,3,Ethique du Devoir et Ethique Religieuse,9,848,5,QROC,0.18,0.8,72.84,11,4,15,14,11,3,1.07,78.57,Facile,Facile,0,Meme Difficulte que la Prediction,Adapte
5111,2019,Philosophie,1,La Notion d'Ethique,3,Ethique du Devoir et Ethique Religieuse,9,848,5,QROC,0.16,0.45,72.84,10,4,14,14,10,4,1.0,71.43,Facile,Facile,0,Meme Difficulte que la Prediction,Adapte
6177,2020,Philosophie,1,La Notion d'Ethique,3,Ethique du Devoir et Ethique Religieuse,9,848,5,QROC,0.06,0.55,72.84,11,4,15,14,11,3,1.07,78.57,Facile,Facile,0,Meme Difficulte que la Prediction,Adapte
848,2015,Philosophie,1,La Notion d'Ethique,3,Ethique du Devoir et Ethique Religieuse,9,849,6,QCM,0.02,0.8,65.6,25,13,38,28,25,3,1.36,89.29,Difficile,Facile,2,Beaucoup plus Facile que la Prediction,Adapte
1914,2016,Philosophie,1,La Notion d'Ethique,3,Ethique du Devoir et Ethique Religieuse,9,849,6,QCM,0.17,0.73,65.6,22,12,34,22,22,0,1.55,100.0,Facile,Facile,0,Meme Difficulte que la Prediction,Adapte
2980,2017,Philosophie,1,La Notion d'Ethique,3,Ethique du Devoir et Ethique Religieuse,9,849,6,QCM,0.14,0.81,65.6,24,13,37,28,24,4,1.32,85.71,Facile,Facile,0,Meme Difficulte que la Prediction,Adapte
4046,2018,Philosophie,1,La Notion d'Ethique,3,Ethique du Devoir et Ethique Religieuse,9,849,6,QCM,0.12,0.94,65.6,22,12,34,25,22,3,1.36,88.0,Facile,Facile,0,Meme Difficulte que la Prediction,Adapte
5112,2019,Philosophie,1,La Notion d'Ethique,3,Ethique du Devoir et Ethique Religieuse,9,849,6,QCM,0.0,0.84,65.6,19,10,29,23,19,4,1.26,82.61,Facile,Facile,0,Meme Difficulte que la Prediction,Adapte
6178,2020,Philosophie,1,La Notion d'Ethique,3,Ethique du Devoir et Ethique Religieuse,9,849,6,QCM,0.19,0.99,65.6,21,11,32,28,21,7,1.14,75.0,Facile,Facile,0,Meme Difficulte que la Prediction,Adapte
849,2015,Philosophie,1,La Notion d'Ethique,3,Ethique du Devoir et Ethique Religieuse,9,850,7,QCM,0.06,0.9,96.9,96,3,99,98,96,2,1.01,97.96,Facile,Facile,0,Meme Difficulte que la Prediction,Pas Adapte
1915,2016,Philosophie,1,La Notion d'Ethique,3,Ethique du Devoir et Ethique Religieuse,9,850,7,QCM,0.58,0.25,26.7,26,71,97,94,26,68,1.03,27.66,Difficile,Difficile,0,Meme Difficulte que la Prediction,Pas Adapte
2981,2017,Philosophie,1,La Notion d'Ethique,3,Ethique du Devoir et Ethique Religieuse,9,850,7,QCM,0.55,0.19,1.02,1,83,84,36,1,35,2.33,2.78,Difficile,Difficile,0,Meme Difficulte que la Prediction,Pas Adapte
4047,2018,Philosophie,1,La Notion d'Ethique,3,Ethique du Devoir et Ethique Religieuse,9,850,7,QCM,0.39,0.31,42.72,32,44,76,38,32,6,2.0,84.21,Facile,Moyen,-1,Plus Difficile que la Prediction,Pas Adapte
5113,2019,Philosophie,1,La Notion d'Ethique,3,Ethique du Devoir et Ethique Religieuse,9,850,7,QCM,0.1,0.96,68.87,45,20,65,49,45,4,1.33,91.84,Facile,Facile,0,Meme Difficulte que la Prediction,Adapte
6179,2020,Philosophie,1,La Notion d'Ethique,3,Ethique du Devoir et Ethique Religieuse,9,850,7,QCM,0.07,0.97,68.87,44,20,64,46,44,2,1.39,95.65,Facile,Facile,0,Meme Difficulte que la Prediction,Adapte
850,2015,Philosophie,1,La Notion d'Ethique,3,Ethique du Devoir et Ethique Religieuse,9,851,8,QCM,0.6,0.22,1.91,0,19,19,5,0,5,3.8,0.0,Moyen,Difficile,-1,Plus Difficile que la Prediction,Pas Adapte
1916,2016,Philosophie,1,La Notion d'Ethique,3,Ethique du Devoir et Ethique Religieuse,9,851,8,QCM,0.05,0.84,79.6,15,4,19,18,15,3,1.06,83.33,Facile,Facile,0,Meme Difficulte que la Prediction,Pas Adapte
2982,2017,Philosophie,1,La Notion d'Ethique,3,Ethique du Devoir et Ethique Religieuse,9,851,8,QCM,0.19,0.92,81.66,17,4,21,21,17,4,1.0,80.95,Moyen,Facile,1,Plus Facile que la Prediction,Pas Adapte
4048,2018,Philosophie,1,La Notion d'Ethique,3,Ethique du Devoir et Ethique Religieuse,9,851,8,QCU,0.33,0.68,39.09,8,13,21,18,8,10,1.17,44.44,Moyen,Moyen,0,Meme Difficulte que la Prediction,Pas Adapte
5114,2019,Philosophie,1,La Notion d'Ethique,3,Ethique du Devoir et Ethique Religieuse,9,851,8,QO,0.14,0.9,97.7,23,1,24,23,23,0,1.04,100.0,Difficile,Facile,2,Beaucoup plus Facile que la Prediction,Pas Adapte
6180,2020,Philosophie,1,La Notion d'Ethique,3,Ethique du Devoir et Ethique Religieuse,9,851,8,QO,0.66,0.2,61.71,15,10,25,20,15,5,1.25,75.0,Facile,Moyen,-1,Plus Difficile que la Prediction,Adapte
851,2015,Philosophie,1,La Notion d'Ethique,3,Ethique du Devoir et Ethique Religieuse,9,852,9,QCU,0.3,0.54,63.29,8,5,13,9,8,1,1.44,88.89,Moyen,Moyen,0,Meme Difficulte que la Prediction,Adapte
1917,2016,Philosophie,1,La Notion d'Ethique,3,Ethique du Devoir et Ethique Religieuse,9,852,9,QCU,0.24,0.65,63.29,9,6,15,13,9,4,1.15,69.23,Moyen,Moyen,0,Meme Difficulte que la Prediction,Adapte
2983,2017,Philosophie,1,La Notion d'Ethique,3,Ethique du Devoir et Ethique Religieuse,9,852,9,QCU,0.33,0.63,63.29,8,5,13,11,8,3,1.18,72.73,Moyen,Moyen,0,Meme Difficulte que la Prediction,Adapte
4049,2018,Philosophie,1,La Notion d'Ethique,3,Ethique du Devoir et Ethique Religieuse,9,852,9,QO,0.44,0.23,63.29,9,6,15,14,9,5,1.07,64.29,Moyen,Moyen,0,Meme Difficulte que la Prediction,Adapte
5115,2019,Philosophie,1,La Notion d'Ethique,3,Ethique du Devoir et Ethique Religieuse,9,852,9,QO,0.67,0.29,63.29,11,6,17,16,11,5,1.06,68.75,Moyen,Moyen,0,Meme Difficulte que la Prediction,Adapte
6181,2020,Philosophie,1,La Notion d'Ethique,3,Ethique du Devoir et Ethique Religieuse,9,852,9,QO,0.42,0.28,63.29,13,7,20,16,13,3,1.25,81.25,Moyen,Moyen,0,Meme Difficulte que la Prediction,Adapte
852,2015,Philosophie,1,La Culture,1,Sentiments Croyance et Cultes Religieux,9,853,1,QCM,0.77,0.27,17.49,3,12,15,12,3,9,1.25,25.0,Difficile,Difficile,0,Meme Difficulte que la Prediction,Pas Adapte
1918,2016,Philosophie,1,La Culture,1,Sentiments Croyance et Cultes Religieux,9,853,1,QCU,0.45,0.35,21.4,4,13,17,13,4,9,1.31,30.77,Difficile,Difficile,0,Meme Difficulte que la Prediction,Pas Adapte
2984,2017,Philosophie,1,La Culture,1,Sentiments Croyance et Cultes Religieux,9,853,1,QCU,0.21,0.47,47.45,9,11,20,17,9,8,1.18,52.94,Facile,Moyen,-1,Plus Difficile que la Prediction,Pas Adapte
4050,2018,Philosophie,1,La Culture,1,Sentiments Croyance et Cultes Religieux,9,853,1,QROC,0.02,0.47,78.17,13,4,17,16,13,3,1.06,81.25,Facile,Facile,0,Meme Difficulte que la Prediction,Pas Adapte
5116,2019,Philosophie,1,La Culture,1,Sentiments Croyance et Cultes Religieux,9,853,1,QROC,0.54,0.35,62.18,9,5,14,14,9,5,1.0,64.29,Moyen,Moyen,0,Meme Difficulte que la Prediction,Adapte
6182,2020,Philosophie,1,La Culture,1,Sentiments Croyance et Cultes Religieux,9,853,1,QROC,0.22,0.34,62.18,10,6,16,14,10,4,1.14,71.43,Moyen,Moyen,0,Meme Difficulte que la Prediction,Adapte
853,2015,Philosophie,1,La Culture,1,Sentiments Croyance et Cultes Religieux,9,854,2,QROC,0.73,0.03,32.01,14,30,44,36,14,22,1.22,38.89,Difficile,Difficile,0,Meme Difficulte que la Prediction,Pas Adapte
1919,2016,Philosophie,1,La Culture,1,Sentiments Croyance et Cultes Religieux,9,854,2,QO,0.68,0.27,38.79,19,30,49,40,19,21,1.23,47.5,Difficile,Moyen,1,Plus Facile que la Prediction,Pas Adapte
2985,2017,Philosophie,1,La Culture,1,Sentiments Croyance et Cultes Religieux,9,854,2,QO,0.83,0.15,33.12,14,29,43,24,14,10,1.79,58.33,Moyen,Difficile,-1,Plus Difficile que la Prediction,Pas Adapte
4051,2018,Philosophie,1,La Culture,1,Sentiments Croyance et Cultes Religieux,9,854,2,QO,0.89,0.1,6.32,3,38,41,36,3,33,1.14,8.33,Moyen,Difficile,-1,Plus Difficile que la Prediction,Pas Adapte
5117,2019,Philosophie,1,La Culture,1,Sentiments Croyance et Cultes Religieux,9,854,2,QO,0.7,0.29,44.51,20,26,46,44,20,24,1.05,45.45,Moyen,Moyen,0,Meme Difficulte que la Prediction,Pas Adapte
6183,2020,Philosophie,1,La Culture,1,Sentiments Croyance et Cultes Religieux,9,854,2,QO,0.94,0.0,4.41,2,49,51,40,2,38,1.27,5.0,Difficile,Difficile,0,Meme Difficulte que la Prediction,Pas Adapte
854,2015,Philosophie,1,La Culture,1,Sentiments Croyance et Cultes Religieux,9,855,3,QCU,0.06,0.92,89.58,39,5,44,42,39,3,1.05,92.86,Facile,Facile,0,Meme Difficulte que la Prediction,Pas Adapte
1920,2016,Philosophie,1,La Culture,1,Sentiments Croyance et Cultes Religieux,9,855,3,QCU,0.45,0.2,31.32,12,27,39,24,12,12,1.62,50.0,Difficile,Difficile,0,Meme Difficulte que la Prediction,Pas Adapte
2986,2017,Philosophie,1,La Culture,1,Sentiments Croyance et Cultes Religieux,9,855,3,QCU,0.47,0.3,26.57,10,29,39,38,10,28,1.03,26.32,Moyen,Difficile,-1,Plus Difficile que la Prediction,Pas Adapte
4052,2018,Philosophie,1,La Culture,1,Sentiments Croyance et Cultes Religieux,9,855,3,QCU,0.37,0.59,64.35,28,16,44,32,28,4,1.38,87.5,Moyen,Moyen,0,Meme Difficulte que la Prediction,Adapte
5118,2019,Philosophie,1,La Culture,1,Sentiments Croyance et Cultes Religieux,9,855,3,QCM,0.38,0.57,64.35,28,15,43,29,28,1,1.48,96.55,Moyen,Moyen,0,Meme Difficulte que la Prediction,Adapte
6184,2020,Philosophie,1,La Culture,1,Sentiments Croyance et Cultes Religieux,9,855,3,QCM,0.25,0.51,64.35,24,14,38,35,24,11,1.09,68.57,Moyen,Moyen,0,Meme Difficulte que la Prediction,Adapte
855,2015,Philosophie,1,La Culture,1,Sentiments Croyance et Cultes Religieux,9,856,4,QCM,0.56,0.19,19.64,16,65,81,58,16,42,1.4,27.59,Difficile,Difficile,0,Meme Difficulte que la Prediction,Pas Adapte
1921,2016,Philosophie,1,La Culture,1,Sentiments Croyance et Cultes Religieux,9,856,4,QCM,0.51,0.23,24.07,19,62,81,49,19,30,1.65,38.78,Difficile,Difficile,0,Meme Difficulte que la Prediction,Pas Adapte
2987,2017,Philosophie,1,La Culture,1,Sentiments Croyance et Cultes Religieux,9,856,4,QCM,0.34,0.52,48.1,43,46,89,45,43,2,1.98,95.56,Moyen,Moyen,0,Meme Difficulte que la Prediction,Pas Adapte
4053,2018,Philosophie,1,La Culture,1,Sentiments Croyance et Cultes Religieux,9,856,4,QCM,0.67,0.19,21.59,21,75,96,53,21,32,1.81,39.62,Difficile,Difficile,0,Meme Difficulte que la Prediction,Pas Adapte
5119,2019,Philosophie,1,La Culture,1,Sentiments Croyance et Cultes Religieux,9,856,4,QCM,0.34,0.69,62.76,53,31,84,66,53,13,1.27,80.3,Moyen,Moyen,0,Meme Difficulte que la Prediction,Adapte
6185,2020,Philosophie,1,La Culture,1,Sentiments Croyance et Cultes Religieux,9,856,4,QCM,0.43,0.51,62.76,47,28,75,50,47,3,1.5,94.0,Moyen,Moyen,0,Meme Difficulte que la Prediction,Adapte
856,2015,Philosophie,1,La Culture,1,Sentiments Croyance et Cultes Religieux,9,857,5,QCM,0.1,0.98,86.48,8,1,9,9,8,1,1.0,88.89,Facile,Facile,0,Meme Difficulte que la Prediction,Pas Adapte
1922,2016,Philosophie,1,La Culture,1,Sentiments Croyance et Cultes Religieux,9,857,5,QCM,0.62,0.19,31.67,3,6,9,7,3,4,1.29,42.86,Moyen,Difficile,-1,Plus Difficile que la Prediction,Pas Adapte
2988,2017,Philosophie,1,La Culture,1,Sentiments Croyance et Cultes Religieux,9,857,5,QCM,0.13,0.99,66.6,6,3,9,7,6,1,1.29,85.71,Facile,Facile,0,Meme Difficulte que la Prediction,Adapte
4054,2018,Philosophie,1,La Culture,1,Sentiments Croyance et Cultes Religieux,9,857,5,QCM,0.13,0.95,66.6,6,3,9,8,6,2,1.12,75.0,Facile,Facile,0,Meme Difficulte que la Prediction,Adapte
5120,2019,Philosophie,1,La Culture,1,Sentiments Croyance et Cultes Religieux,9,857,5,QCM,0.06,0.83,66.6,5,3,8,6,5,1,1.33,83.33,Facile,Facile,0,Meme Difficulte que la Prediction,Adapte
6186,2020,Philosophie,1,La Culture,1,Sentiments Croyance et Cultes Religieux,9,857,5,QCM,0.05,0.99,66.6,6,3,9,9,6,3,1.0,66.67,Facile,Facile,0,Meme Difficulte que la Prediction,Adapte
857,2015,Philosophie,1,La Culture,1,Sentiments Croyance et Cultes Religieux,9,858,6,QCU,0.15,0.93,80.3,62,15,77,64,62,2,1.2,96.88,Facile,Facile,0,Meme Difficulte que la Prediction,Pas Adapte
1923,2016,Philosophie,1,La Culture,1,Sentiments Croyance et Cultes Religieux,9,858,6,QCM,0.71,0.23,7.53,6,73,79,62,6,56,1.27,9.68,Difficile,Difficile,0,Meme Difficulte que la Prediction,Pas Adapte
2989,2017,Philosophie,1,La Culture,1,Sentiments Croyance et Cultes Religieux,9,858,6,QCM,0.28,0.63,40.48,32,46,78,52,32,20,1.5,61.54,Moyen,Moyen,0,Meme Difficulte que la Prediction,Pas Adapte
4055,2018,Philosophie,1,La Culture,1,Sentiments Croyance et Cultes Religieux,9,858,6,QCM,0.37,0.49,51.87,45,41,86,83,45,38,1.04,54.22,Difficile,Moyen,1,Plus Facile que la Prediction,Pas Adapte
5121,2019,Philosophie,1,La Culture,1,Sentiments Croyance et Cultes Religieux,9,858,6,QCM,0.25,0.44,58.02,49,36,85,63,49,14,1.35,77.78,Difficile,Moyen,1,Plus Facile que la Prediction,Pas Adapte
6187,2020,Philosophie,1,La Culture,1,Sentiments Croyance et Cultes Religieux,9,858,6,QCU,0.55,0.21,27.73,27,71,98,86,27,59,1.14,31.4,Difficile,Difficile,0,Meme Difficulte que la Prediction,Pas Adapte
858,2015,Philosophie,1,La Culture,1,Sentiments Croyance et Cultes Religieux,9,859,7,QCM,0.78,0.26,9.61,2,21,23,17,2,15,1.35,11.76,Difficile,Difficile,0,Meme Difficulte que la Prediction,Pas Adapte
1924,2016,Philosophie,1,La Culture,1,Sentiments Croyance et Cultes Religieux,9,859,7,QCM,0.8,0.16,21.53,5,17,22,16,5,11,1.38,31.25,Difficile,Difficile,0,Meme Difficulte que la Prediction,Pas Adapte
2990,2017,Philosophie,1,La Culture,1,Sentiments Croyance et Cultes Religieux,9,859,7,QCU,0.06,0.92,72.64,18,7,25,23,18,5,1.09,78.26,Moyen,Facile,1,Plus Facile que la Prediction,Adapte
4056,2018,Philosophie,1,La Culture,1,Sentiments Croyance et Cultes Religieux,9,859,7,QCU,0.01,0.93,72.64,15,6,21,21,15,6,1.0,71.43,Facile,Facile,0,Meme Difficulte que la Prediction,Adapte
5122,2019,Philosophie,1,La Culture,1,Sentiments Croyance et Cultes Religieux,9,859,7,QCU,0.05,0.98,72.64,13,5,18,18,13,5,1.0,72.22,Facile,Facile,0,Meme Difficulte que la Prediction,Adapte
6188,2020,Philosophie,1,La Culture,1,Sentiments Croyance et Cultes Religieux,9,859,7,QCU,0.02,0.98,72.64,15,6,21,17,15,2,1.24,88.24,Facile,Facile,0,Meme Difficulte que la Prediction,Adapte
859,2015,Philosophie,1,La Culture,1,Sentiments Croyance et Cultes Religieux,9,860,8,QCU,0.01,0.89,90.58,19,2,21,20,19,1,1.05,95.0,Difficile,Facile,2,Beaucoup plus Facile que la Prediction,Pas Adapte
1925,2016,Philosophie,1,La Culture,1,Sentiments Croyance et Cultes Religieux,9,860,8,QCU,0.39,0.53,52.38,9,9,18,10,9,1,1.8,90.0,Difficile,Moyen,1,Plus Facile que la Prediction,Pas Adapte
2991,2017,Philosophie,1,La Culture,1,Sentiments Croyance et Cultes Religieux,9,860,8,QCU,0.6,0.37,1.44,0,20,20,11,0,11,1.82,0.0,Facile,Difficile,-2,Beaucoup plus Difficile que la Prediction,Pas Adapte
4057,2018,Philosophie,1,La Culture,1,Sentiments Croyance et Cultes Religieux,9,860,8,QCU,0.24,0.71,61.06,13,8,21,21,13,8,1.0,61.9,Moyen,Moyen,0,Meme Difficulte que la Prediction,Adapte
5123,2019,Philosophie,1,La Culture,1,Sentiments Croyance et Cultes Religieux,9,860,8,QO,0.37,0.27,61.06,13,8,21,14,13,1,1.5,92.86,Moyen,Moyen,0,Meme Difficulte que la Prediction,Adapte
6189,2020,Philosophie,1,La Culture,1,Sentiments Croyance et Cultes Religieux,9,860,8,QO,0.58,0.15,61.06,12,8,20,15,12,3,1.33,80.0,Moyen,Moyen,0,Meme Difficulte que la Prediction,Adapte
860,2015,Philosophie,1,La Culture,1,Sentiments Croyance et Cultes Religieux,9,861,9,QCU,0.13,0.93,66.69,6,3,9,8,6,2,1.12,75.0,Facile,Facile,0,Meme Difficulte que la Prediction,Adapte
1926,2016,Philosophie,1,La Culture,1,Sentiments Croyance et Cultes Religieux,9,861,9,QCU,0.07,0.9,66.69,5,3,8,7,5,2,1.14,71.43,Facile,Facile,0,Meme Difficulte que la Prediction,Adapte
2992,2017,Philosophie,1,La Culture,1,Sentiments Croyance et Cultes Religieux,9,861,9,QCU,0.04,0.98,66.69,5,3,8,7,5,2,1.14,71.43,Facile,Facile,0,Meme Difficulte que la Prediction,Adapte
4058,2018,Philosophie,1,La Culture,1,Sentiments Croyance et Cultes Religieux,9,861,9,QCM,0.2,0.73,66.69,6,3,9,6,6,0,1.5,100.0,Facile,Facile,0,Meme Difficulte que la Prediction,Adapte
5124,2019,Philosophie,1,La Culture,1,Sentiments Croyance et Cultes Religieux,9,861,9,QCM,0.15,0.74,66.69,6,3,9,8,6,2,1.12,75.0,Facile,Facile,0,Meme Difficulte que la Prediction,Adapte
6190,2020,Philosophie,1,La Culture,1,Sentiments Croyance et Cultes Religieux,9,861,9,QCM,0.16,0.89,66.69,6,3,9,8,6,2,1.12,75.0,Facile,Facile,0,Meme Difficulte que la Prediction,Adapte
861,2015,Philosophie,1,La Culture,2,Croyances Religieuses et Verite,7,862,1,QCM,0.06,0.73,71.55,51,20,71,67,51,16,1.06,76.12,Facile,Facile,0,Meme Difficulte que la Prediction,Adapte
1927,2016,Philosophie,1,La Culture,2,Croyances Religieuses et Verite,7,862,1,QROC,0.2,0.51,71.55,54,22,76,62,54,8,1.23,87.1,Facile,Facile,0,Meme Difficulte que la Prediction,Adapte
2993,2017,Philosophie,1,La Culture,2,Croyances Religieuses et Verite,7,862,1,QROC,0.17,0.45,71.55,54,22,76,73,54,19,1.04,73.97,Facile,Facile,0,Meme Difficulte que la Prediction,Adapte
4059,2018,Philosophie,1,La Culture,2,Croyances Religieuses et Verite,7,862,1,QROC,0.0,0.96,71.55,50,20,70,67,50,17,1.04,74.63,Facile,Facile,0,Meme Difficulte que la Prediction,Adapte
5125,2019,Philosophie,1,La Culture,2,Croyances Religieuses et Verite,7,862,1,QROC,0.17,0.64,71.55,46,18,64,51,46,5,1.25,90.2,Facile,Facile,0,Meme Difficulte que la Prediction,Adapte
6191,2020,Philosophie,1,La Culture,2,Croyances Religieuses et Verite,7,862,1,QROC,0.0,0.44,71.55,45,18,63,48,45,3,1.31,93.75,Facile,Facile,0,Meme Difficulte que la Prediction,Adapte
862,2015,Philosophie,1,La Culture,2,Croyances Religieuses et Verite,7,863,2,QCM,0.56,0.23,33.15,2,4,6,2,2,0,3.0,100.0,Difficile,Difficile,0,Meme Difficulte que la Prediction,Pas Adapte
1928,2016,Philosophie,1,La Culture,2,Croyances Religieuses et Verite,7,863,2,QCM,0.4,0.67,43.73,2,3,5,5,2,3,1.0,40.0,Moyen,Moyen,0,Meme Difficulte que la Prediction,Pas Adapte
2994,2017,Philosophie,1,La Culture,2,Croyances Religieuses et Verite,7,863,2,QCM,0.76,0.18,6.59,0,4,4,4,0,4,1.0,0.0,Difficile,Difficile,0,Meme Difficulte que la Prediction,Pas Adapte
4060,2018,Philosophie,1,La Culture,2,Croyances Religieuses et Verite,7,863,2,QO,0.12,0.57,79.56,2,1,3,2,2,0,1.5,100.0,Facile,Facile,0,Meme Difficulte que la Prediction,Pas Adapte
5126,2019,Philosophie,1,La Culture,2,Croyances Religieuses et Verite,7,863,2,QO,0.77,0.15,12.32,0,3,3,2,0,2,1.5,0.0,Facile,Difficile,-2,Beaucoup plus Difficile que la Prediction,Pas Adapte
6192,2020,Philosophie,1,La Culture,2,Croyances Religieuses et Verite,7,863,2,QROC,0.13,0.6,66.53,2,1,3,2,2,0,1.5,100.0,Facile,Facile,0,Meme Difficulte que la Prediction,Adapte
863,2015,Philosophie,1,La Culture,2,Croyances Religieuses et Verite,7,864,3,QCM,0.78,0.19,0.27,0,98,98,66,0,66,1.48,0.0,Difficile,Difficile,0,Meme Difficulte que la Prediction,Pas Adapte
1929,2016,Philosophie,1,La Culture,2,Croyances Religieuses et Verite,7,864,3,QCM,0.46,0.62,45.73,51,60,111,84,51,33,1.32,60.71,Moyen,Moyen,0,Meme Difficulte que la Prediction,Pas Adapte
2995,2017,Philosophie,1,La Culture,2,Croyances Religieuses et Verite,7,864,3,QCM,0.07,0.71,86.76,104,16,120,108,104,4,1.11,96.3,Moyen,Facile,1,Plus Facile que la Prediction,Pas Adapte
4061,2018,Philosophie,1,La Culture,2,Croyances Religieuses et Verite,7,864,3,QROC,0.66,0.02,24.61,26,81,107,81,26,55,1.32,32.1,Difficile,Difficile,0,Meme Difficulte que la Prediction,Pas Adapte
5127,2019,Philosophie,1,La Culture,2,Croyances Religieuses et Verite,7,864,3,QROC,0.91,0.12,14.65,15,84,99,84,15,69,1.18,17.86,Facile,Difficile,-2,Beaucoup plus Difficile que la Prediction,Pas Adapte
6193,2020,Philosophie,1,La Culture,2,Croyances Religieuses et Verite,7,864,3,QROC,0.07,0.62,74.67,76,26,102,81,76,5,1.26,93.83,Facile,Facile,0,Meme Difficulte que la Prediction,Adapte
864,2015,Philosophie,1,La Culture,2,Croyances Religieuses et Verite,7,865,4,QCM,0.51,0.18,30.13,23,53,76,23,23,0,3.3,100.0,Difficile,Difficile,0,Meme Difficulte que la Prediction,Pas Adapte
1930,2016,Philosophie,1,La Culture,2,Croyances Religieuses et Verite,7,865,4,QCM,0.29,0.68,43.5,32,42,74,42,32,10,1.76,76.19,Moyen,Moyen,0,Meme Difficulte que la Prediction,Pas Adapte
2996,2017,Philosophie,1,La Culture,2,Croyances Religieuses et Verite,7,865,4,QCM,0.71,0.17,21.17,14,52,66,23,14,9,2.87,60.87,Difficile,Difficile,0,Meme Difficulte que la Prediction,Pas Adapte
4062,2018,Philosophie,1,La Culture,2,Croyances Religieuses et Verite,7,865,4,QCM,0.26,0.62,39.32,22,35,57,33,22,11,1.73,66.67,Moyen,Moyen,0,Meme Difficulte que la Prediction,Pas Adapte
5128,2019,Philosophie,1,La Culture,2,Croyances Religieuses et Verite,7,865,4,QCU,0.45,0.25,13.2,7,47,54,43,7,36,1.26,16.28,Difficile,Difficile,0,Meme Difficulte que la Prediction,Pas Adapte
6194,2020,Philosophie,1,La Culture,2,Croyances Religieuses et Verite,7,865,4,QCU,0.61,0.37,23.79,14,43,57,24,14,10,2.38,58.33,Difficile,Difficile,0,Meme Difficulte que la Prediction,Pas Adapte
865,2015,Philosophie,1,La Culture,2,Croyances Religieuses et Verite,7,866,5,QROC,0.94,0.1,25.07,5,15,20,8,5,3,2.5,62.5,Facile,Difficile,-2,Beaucoup plus Difficile que la Prediction,Pas Adapte
1931,2016,Philosophie,1,La Culture,2,Croyances Religieuses et Verite,7,866,5,QROC,0.03,0.7,72.19,17,6,23,23,17,6,1.0,73.91,Facile,Facile,0,Meme Difficulte que la Prediction,Adapte
2997,2017,Philosophie,1,La Culture,2,Croyances Religieuses et Verite,7,866,5,QROC,0.16,0.77,72.19,18,7,25,19,18,1,1.32,94.74,Facile,Facile,0,Meme Difficulte que la Prediction,Adapte
4063,2018,Philosophie,1,La Culture,2,Croyances Religieuses et Verite,7,866,5,QO,0.02,0.64,72.19,20,8,28,21,20,1,1.33,95.24,Facile,Facile,0,Meme Difficulte que la Prediction,Adapte
5129,2019,Philosophie,1,La Culture,2,Croyances Religieuses et Verite,7,866,5,QO,0.15,0.9,72.19,17,7,24,22,17,5,1.09,77.27,Facile,Facile,0,Meme Difficulte que la Prediction,Adapte
6195,2020,Philosophie,1,La Culture,2,Croyances Religieuses et Verite,7,866,5,QO,0.16,0.65,72.19,16,6,22,17,16,1,1.29,94.12,Facile,Facile,0,Meme Difficulte que la Prediction,Adapte
866,2015,Philosophie,1,La Culture,2,Croyances Religieuses et Verite,7,867,6,QCU,0.17,0.8,86.02,19,3,22,19,19,0,1.16,100.0,Facile,Facile,0,Meme Difficulte que la Prediction,Pas Adapte
1932,2016,Philosophie,1,La Culture,2,Croyances Religieuses et Verite,7,867,6,QCU,0.19,0.95,75.84,18,6,24,19,18,1,1.26,94.74,Facile,Facile,0,Meme Difficulte que la Prediction,Pas Adapte
2998,2017,Philosophie,1,La Culture,2,Croyances Religieuses et Verite,7,867,6,QCU,0.6,0.27,12.48,3,23,26,14,3,11,1.86,21.43,Difficile,Difficile,0,Meme Difficulte que la Prediction,Pas Adapte
4064,2018,Philosophie,1,La Culture,2,Croyances Religieuses et Verite,7,867,6,QCU,0.75,0.27,17.08,4,18,22,10,4,6,2.2,40.0,Moyen,Difficile,-1,Plus Difficile que la Prediction,Pas Adapte
5130,2019,Philosophie,1,La Culture,2,Croyances Religieuses et Verite,7,867,6,QCU,0.26,0.42,44.25,9,12,21,15,9,6,1.4,60.0,Difficile,Moyen,1,Plus Facile que la Prediction,Pas Adapte
6196,2020,Philosophie,1,La Culture,2,Croyances Religieuses et Verite,7,867,6,QCU,0.11,0.76,81.78,20,4,24,21,20,1,1.14,95.24,Difficile,Facile,2,Beaucoup plus Facile que la Prediction,Pas Adapte
867,2015,Philosophie,1,La Culture,2,Croyances Religieuses et Verite,7,868,7,QCM,0.17,0.93,65.51,64,34,98,73,64,9,1.34,87.67,Difficile,Facile,2,Beaucoup plus Facile que la Prediction,Adapte
1933,2016,Philosophie,1,La Culture,2,Croyances Religieuses et Verite,7,868,7,QCM,0.02,0.75,65.51,65,34,99,79,65,14,1.25,82.28,Facile,Facile,0,Meme Difficulte que la Prediction,Adapte
2999,2017,Philosophie,1,La Culture,2,Croyances Religieuses et Verite,7,868,7,QCM,0.06,0.91,65.51,61,32,93,86,61,25,1.08,70.93,Facile,Facile,0,Meme Difficulte que la Prediction,Adapte
4065,2018,Philosophie,1,La Culture,2,Croyances Religieuses et Verite,7,868,7,QCM,0.18,0.73,65.51,52,28,80,53,52,1,1.51,98.11,Facile,Facile,0,Meme Difficulte que la Prediction,Adapte
5131,2019,Philosophie,1,La Culture,2,Croyances Religieuses et Verite,7,868,7,QCM,0.09,0.91,65.51,60,32,92,85,60,25,1.08,70.59,Facile,Facile,0,Meme Difficulte que la Prediction,Adapte
6197,2020,Philosophie,1,La Culture,2,Croyances Religieuses et Verite,7,868,7,QCM,0.11,0.9,65.51,67,36,103,96,67,29,1.07,69.79,Facile,Facile,0,Meme Difficulte que la Prediction,Adapte
868,2015,Philosophie,1,La Culture,3,Religion et Morale,10,869,1,QCM,0.41,0.59,38.0,18,30,48,22,18,4,2.18,81.82,Facile,Moyen,-1,Plus Difficile que la Prediction,Pas Adapte
1934,2016,Philosophie,1,La Culture,3,Religion et Morale,10,869,1,QCM,0.49,0.66,35.89,15,28,43,19,15,4,2.26,78.95,Facile,Moyen,-1,Plus Difficile que la Prediction,Pas Adapte
3000,2017,Philosophie,1,La Culture,3,Religion et Morale,10,869,1,QCM,0.16,0.77,78.1,33,9,42,39,33,6,1.08,84.62,Difficile,Facile,2,Beaucoup plus Facile que la Prediction,Pas Adapte
4066,2018,Philosophie,1,La Culture,3,Religion et Morale,10,869,1,QCM,0.76,0.22,15.17,6,32,38,35,6,29,1.09,17.14,Difficile,Difficile,0,Meme Difficulte que la Prediction,Pas Adapte
5132,2019,Philosophie,1,La Culture,3,Religion et Morale,10,869,1,QCU,0.26,0.68,48.23,20,21,41,30,20,10,1.37,66.67,Moyen,Moyen,0,Meme Difficulte que la Prediction,Pas Adapte
6198,2020,Philosophie,1,La Culture,3,Religion et Morale,10,869,1,QROC,0.12,0.89,79.85,32,8,40,39,32,7,1.03,82.05,Moyen,Facile,1,Plus Facile que la Prediction,Pas Adapte
869,2015,Philosophie,1,La Culture,3,Religion et Morale,10,870,2,QCU,0.59,0.29,7.83,1,13,14,9,1,8,1.56,11.11,Difficile,Difficile,0,Meme Difficulte que la Prediction,Pas Adapte
1935,2016,Philosophie,1,La Culture,3,Religion et Morale,10,870,2,QCU,0.17,0.99,91.55,15,1,16,15,15,0,1.07,100.0,Facile,Facile,0,Meme Difficulte que la Prediction,Pas Adapte
3001,2017,Philosophie,1,La Culture,3,Religion et Morale,10,870,2,QCU,0.39,0.52,51.79,9,8,17,11,9,2,1.55,81.82,Facile,Moyen,-1,Plus Difficile que la Prediction,Pas Adapte
4067,2018,Philosophie,1,La Culture,3,Religion et Morale,10,870,2,QO,0.68,0.2,58.55,11,7,18,13,11,2,1.38,84.62,Moyen,Moyen,0,Meme Difficulte que la Prediction,Pas Adapte
5133,2019,Philosophie,1,La Culture,3,Religion et Morale,10,870,2,QO,0.98,0.04,5.23,1,14,15,13,1,12,1.15,7.69,Difficile,Difficile,0,Meme Difficulte que la Prediction,Pas Adapte
6199,2020,Philosophie,1,La Culture,3,Religion et Morale,10,870,2,QO,0.03,0.95,94.93,14,1,15,15,14,1,1.0,93.33,Moyen,Facile,1,Plus Facile que la Prediction,Pas Adapte
870,2015,Philosophie,1,La Culture,3,Religion et Morale,10,871,3,QO,0.94,0.0,7.08,6,77,83,67,6,61,1.24,8.96,Difficile,Difficile,0,Meme Difficulte que la Prediction,Pas Adapte
1936,2016,Philosophie,1,La Culture,3,Religion et Morale,10,871,3,QO,0.94,0.0,32.57,23,49,72,63,23,40,1.14,36.51,Difficile,Difficile,0,Meme Difficulte que la Prediction,Pas Adapte
3002,2017,Philosophie,1,La Culture,3,Religion et Morale,10,871,3,QO,0.84,0.01,29.78,24,57,81,59,24,35,1.37,40.68,Moyen,Difficile,-1,Plus Difficile que la Prediction,Pas Adapte
4068,2018,Philosophie,1,La Culture,3,Religion et Morale,10,871,3,QROC,0.45,0.33,61.84,43,27,70,46,43,3,1.52,93.48,Facile,Moyen,-1,Plus Difficile que la Prediction,Adapte
5134,2019,Philosophie,1,La Culture,3,Religion et Morale,10,871,3,QROC,0.46,0.25,61.84,41,25,66,54,41,13,1.22,75.93,Moyen,Moyen,0,Meme Difficulte que la Prediction,Adapte
6200,2020,Philosophie,1,La Culture,3,Religion et Morale,10,871,3,QROC,0.31,0.26,61.84,36,22,58,52,36,16,1.12,69.23,Moyen,Moyen,0,Meme Difficulte que la Prediction,Adapte
871,2015,Philosophie,1,La Culture,3,Religion et Morale,10,872,4,QCM,0.33,0.5,37.02,30,52,82,68,30,38,1.21,44.12,Difficile,Moyen,1,Plus Facile que la Prediction,Pas Adapte
1937,2016,Philosophie,1,La Culture,3,Religion et Morale,10,872,4,QCM,0.61,0.24,3.85,3,74,77,59,3,56,1.31,5.08,Difficile,Difficile,0,Meme Difficulte que la Prediction,Pas Adapte
3003,2017,Philosophie,1,La Culture,3,Religion et Morale,10,872,4,QCM,0.78,0.22,21.58,17,60,77,60,17,43,1.28,28.33,Difficile,Difficile,0,Meme Difficulte que la Prediction,Pas Adapte
4069,2018,Philosophie,1,La Culture,3,Religion et Morale,10,872,4,QCM,0.33,0.46,53.78,46,40,86,68,46,22,1.26,67.65,Moyen,Moyen,0,Meme Difficulte que la Prediction,Pas Adapte
5135,2019,Philosophie,1,La Culture,3,Religion et Morale,10,872,4,QROC,0.51,0.37,51.76,48,44,92,83,48,35,1.11,57.83,Moyen,Moyen,0,Meme Difficulte que la Prediction,Pas Adapte
6201,2020,Philosophie,1,La Culture,3,Religion et Morale,10,872,4,QROC,1.0,0.14,2.08,2,97,99,94,2,92,1.05,2.13,Difficile,Difficile,0,Meme Difficulte que la Prediction,Pas Adapte
872,2015,Philosophie,1,La Culture,3,Religion et Morale,10,873,5,QCM,0.03,0.88,68.58,37,17,54,46,37,9,1.17,80.43,Facile,Facile,0,Meme Difficulte que la Prediction,Adapte
1938,2016,Philosophie,1,La Culture,3,Religion et Morale,10,873,5,QCM,0.03,0.81,68.58,32,15,47,40,32,8,1.18,80.0,Facile,Facile,0,Meme Difficulte que la Prediction,Adapte
3004,2017,Philosophie,1,La Culture,3,Religion et Morale,10,873,5,QCM,0.07,0.71,68.58,28,13,41,36,28,8,1.14,77.78,Facile,Facile,0,Meme Difficulte que la Prediction,Adapte
4070,2018,Philosophie,1,La Culture,3,Religion et Morale,10,873,5,QCM,0.19,0.85,68.58,25,11,36,33,25,8,1.09,75.76,Facile,Facile,0,Meme Difficulte que la Prediction,Adapte
5136,2019,Philosophie,1,La Culture,3,Religion et Morale,10,873,5,QCM,0.12,0.8,68.58,26,12,38,28,26,2,1.36,92.86,Facile,Facile,0,Meme Difficulte que la Prediction,Adapte
6202,2020,Philosophie,1,La Culture,3,Religion et Morale,10,873,5,QCM,0.09,0.86,68.58,27,12,39,34,27,7,1.15,79.41,Facile,Facile,0,Meme Difficulte que la Prediction,Adapte
873,2015,Philosophie,1,La Culture,3,Religion et Morale,10,874,6,QCM,0.55,0.28,6.3,3,41,44,42,3,39,1.05,7.14,Moyen,Difficile,-1,Plus Difficile que la Prediction,Pas Adapte
1939,2016,Philosophie,1,La Culture,3,Religion et Morale,10,874,6,QCM,0.3,0.66,61.78,23,15,38,34,23,11,1.12,67.65,Difficile,Moyen,1,Plus Facile que la Prediction,Adapte
3005,2017,Philosophie,1,La Culture,3,Religion et Morale,10,874,6,QCM,0.33,0.63,61.78,27,17,44,30,27,3,1.47,90.0,Moyen,Moyen,0,Meme Difficulte que la Prediction,Adapte
4071,2018,Philosophie,1,La Culture,3,Religion et Morale,10,874,6,QCU,0.3,0.65,61.78,25,15,40,29,25,4,1.38,86.21,Moyen,Moyen,0,Meme Difficulte que la Prediction,Adapte
5137,2019,Philosophie,1,La Culture,3,Religion et Morale,10,874,6,QCU,0.39,0.72,61.78,26,16,42,36,26,10,1.17,72.22,Moyen,Moyen,0,Meme Difficulte que la Prediction,Adapte
6203,2020,Philosophie,1,La Culture,3,Religion et Morale,10,874,6,QCU,0.22,0.74,61.78,23,15,38,25,23,2,1.52,92.0,Moyen,Moyen,0,Meme Difficulte que la Prediction,Adapte
874,2015,Philosophie,1,La Culture,3,Religion et Morale,10,875,7,QROC,0.09,0.85,94.6,41,2,43,43,41,2,1.0,95.35,Facile,Facile,0,Meme Difficulte que la Prediction,Pas Adapte
1940,2016,Philosophie,1,La Culture,3,Religion et Morale,10,875,7,QROC,0.82,0.24,23.96,9,30,39,32,9,23,1.22,28.12,Difficile,Difficile,0,Meme Difficulte que la Prediction,Pas Adapte
3006,2017,Philosophie,1,La Culture,3,Religion et Morale,10,875,7,QROC,0.01,0.53,68.22,25,11,36,26,25,1,1.38,96.15,Difficile,Facile,2,Beaucoup plus Facile que la Prediction,Adapte
4072,2018,Philosophie,1,La Culture,3,Religion et Morale,10,875,7,QROC,0.01,0.83,68.22,27,12,39,32,27,5,1.22,84.38,Facile,Facile,0,Meme Difficulte que la Prediction,Adapte
5138,2019,Philosophie,1,La Culture,3,Religion et Morale,10,875,7,QROC,0.17,0.96,68.22,29,14,43,42,29,13,1.02,69.05,Facile,Facile,0,Meme Difficulte que la Prediction,Adapte
6204,2020,Philosophie,1,La Culture,3,Religion et Morale,10,875,7,QROC,0.0,0.51,68.22,29,13,42,39,29,10,1.08,74.36,Facile,Facile,0,Meme Difficulte que la Prediction,Adapte
875,2015,Philosophie,1,La Culture,3,Religion et Morale,10,876,8,QROC,0.25,0.35,51.12,24,23,47,30,24,6,1.57,80.0,Moyen,Moyen,0,Meme Difficulte que la Prediction,Pas Adapte
1941,2016,Philosophie,1,La Culture,3,Religion et Morale,10,876,8,QO,0.1,0.71,95.68,38,2,40,39,38,1,1.03,97.44,Facile,Facile,0,Meme Difficulte que la Prediction,Pas Adapte
3007,2017,Philosophie,1,La Culture,3,Religion et Morale,10,876,8,QO,0.81,0.11,28.13,10,26,36,21,10,11,1.71,47.62,Difficile,Difficile,0,Meme Difficulte que la Prediction,Pas Adapte
4073,2018,Philosophie,1,La Culture,3,Religion et Morale,10,876,8,QO,0.15,0.88,86.71,29,5,34,30,29,1,1.13,96.67,Moyen,Facile,1,Plus Facile que la Prediction,Pas Adapte
5139,2019,Philosophie,1,La Culture,3,Religion et Morale,10,876,8,QROC,0.83,0.16,32.3,13,26,39,20,13,7,1.95,65.0,Difficile,Difficile,0,Meme Difficulte que la Prediction,Pas Adapte
6205,2020,Philosophie,1,La Culture,3,Religion et Morale,10,876,8,QROC,0.16,0.42,75.12,31,10,41,31,31,0,1.32,100.0,Facile,Facile,0,Meme Difficulte que la Prediction,Pas Adapte
876,2015,Philosophie,1,La Culture,3,Religion et Morale,10,877,9,QO,0.2,0.94,91.86,26,2,28,27,26,1,1.04,96.3,Facile,Facile,0,Meme Difficulte que la Prediction,Pas Adapte
1942,2016,Philosophie,1,La Culture,3,Religion et Morale,10,877,9,QO,0.33,0.19,58.2,16,12,28,18,16,2,1.56,88.89,Moyen,Moyen,0,Meme Difficulte que la Prediction,Pas Adapte
3008,2017,Philosophie,1,La Culture,3,Religion et Morale,10,877,9,QO,0.42,0.23,63.54,18,11,29,24,18,6,1.21,75.0,Moyen,Moyen,0,Meme Difficulte que la Prediction,Adapte
4074,2018,Philosophie,1,La Culture,3,Religion et Morale,10,877,9,QO,0.22,0.19,63.54,19,11,30,23,19,4,1.3,82.61,Moyen,Moyen,0,Meme Difficulte que la Prediction,Adapte
5140,2019,Philosophie,1,La Culture,3,Religion et Morale,10,877,9,QO,0.61,0.29,63.54,17,10,27,22,17,5,1.23,77.27,Moyen,Moyen,0,Meme Difficulte que la Prediction,Adapte
6206,2020,Philosophie,1,La Culture,3,Religion et Morale,10,877,9,QO,0.58,0.22,63.54,15,8,23,19,15,4,1.21,78.95,Moyen,Moyen,0,Meme Difficulte que la Prediction,Adapte
877,2015,Philosophie,1,La Culture,3,Religion et Morale,10,878,10,QO,0.59,0.25,53.94,11,9,20,11,11,0,1.82,100.0,Moyen,Moyen,0,Meme Difficulte que la Prediction,Pas Adapte
1943,2016,Philosophie,1,La Culture,3,Religion et Morale,10,878,10,QO,0.14,0.62,66.13,14,7,21,19,14,5,1.11,73.68,Facile,Facile,0,Meme Difficulte que la Prediction,Adapte
3009,2017,Philosophie,1,La Culture,3,Religion et Morale,10,878,10,QO,0.04,0.85,66.13,16,8,24,22,16,6,1.09,72.73,Facile,Facile,0,Meme Difficulte que la Prediction,Adapte
4075,2018,Philosophie,1,La Culture,3,Religion et Morale,10,878,10,QROC,0.02,0.91,66.13,15,7,22,18,15,3,1.22,83.33,Facile,Facile,0,Meme Difficulte que la Prediction,Adapte
5141,2019,Philosophie,1,La Culture,3,Religion et Morale,10,878,10,QROC,0.06,0.96,66.13,14,7,21,15,14,1,1.4,93.33,Facile,Facile,0,Meme Difficulte que la Prediction,Adapte
6207,2020,Philosophie,1,La Culture,3,Religion et Morale,10,878,10,QROC,0.17,0.73,66.13,12,6,18,17,12,5,1.06,70.59,Facile,Facile,0,Meme Difficulte que la Prediction,Adapte
878,2015,Sociologie,1,Les Differentes Approches de l'Economie,1,Comment l'Activite et la Science Economiques se detachent-elles de la Morale et de la Politique?,2,879,1,QCU,0.32,0.67,63.14,18,10,28,25,18,7,1.12,72.0,Difficile,Moyen,1,Plus Facile que la Prediction,Adapte
1944,2016,Sociologie,1,Les Differentes Approches de l'Economie,1,Comment l'Activite et la Science Economiques se detachent-elles de la Morale et de la Politique?,2,879,1,QCU,0.23,0.55,63.14,16,9,25,23,16,7,1.09,69.57,Moyen,Moyen,0,Meme Difficulte que la Prediction,Adapte
3010,2017,Sociologie,1,Les Differentes Approches de l'Economie,1,Comment l'Activite et la Science Economiques se detachent-elles de la Morale et de la Politique?,2,879,1,QROC,0.41,0.26,63.14,18,10,28,28,18,10,1.0,64.29,Moyen,Moyen,0,Meme Difficulte que la Prediction,Adapte
4076,2018,Sociologie,1,Les Differentes Approches de l'Economie,1,Comment l'Activite et la Science Economiques se detachent-elles de la Morale et de la Politique?,2,879,1,QROC,0.43,0.39,63.14,16,9,25,18,16,2,1.39,88.89,Moyen,Moyen,0,Meme Difficulte que la Prediction,Adapte
5142,2019,Sociologie,1,Les Differentes Approches de l'Economie,1,Comment l'Activite et la Science Economiques se detachent-elles de la Morale et de la Politique?,2,879,1,QROC,0.57,0.4,63.14,15,8,23,16,15,1,1.44,93.75,Moyen,Moyen,0,Meme Difficulte que la Prediction,Adapte
6208,2020,Sociologie,1,Les Differentes Approches de l'Economie,1,Comment l'Activite et la Science Economiques se detachent-elles de la Morale et de la Politique?,2,879,1,QROC,0.41,0.38,63.14,14,8,22,19,14,5,1.16,73.68,Moyen,Moyen,0,Meme Difficulte que la Prediction,Adapte
879,2015,Sociologie,1,Les Differentes Approches de l'Economie,1,Comment l'Activite et la Science Economiques se detachent-elles de la Morale et de la Politique?,2,880,2,QCM,0.12,0.81,78.59,24,6,30,25,24,1,1.2,96.0,Moyen,Facile,1,Plus Facile que la Prediction,Pas Adapte
1945,2016,Sociologie,1,Les Differentes Approches de l'Economie,1,Comment l'Activite et la Science Economiques se detachent-elles de la Morale et de la Politique?,2,880,2,QCM,0.47,0.32,48.94,17,17,34,31,17,14,1.1,54.84,Moyen,Moyen,0,Meme Difficulte que la Prediction,Pas Adapte
3011,2017,Sociologie,1,Les Differentes Approches de l'Economie,1,Comment l'Activite et la Science Economiques se detachent-elles de la Morale et de la Politique?,2,880,2,QCM,0.14,0.74,94.35,32,2,34,33,32,1,1.03,96.97,Difficile,Facile,2,Beaucoup plus Facile que la Prediction,Pas Adapte
4077,2018,Sociologie,1,Les Differentes Approches de l'Economie,1,Comment l'Activite et la Science Economiques se detachent-elles de la Morale et de la Politique?,2,880,2,QCM,0.21,0.68,49.11,19,20,39,23,19,4,1.7,82.61,Difficile,Moyen,1,Plus Facile que la Prediction,Pas Adapte
5143,2019,Sociologie,1,Les Differentes Approches de l'Economie,1,Comment l'Activite et la Science Economiques se detachent-elles de la Morale et de la Politique?,2,880,2,QCM,0.5,0.16,5.11,2,42,44,39,2,37,1.13,5.13,Difficile,Difficile,0,Meme Difficulte que la Prediction,Pas Adapte
6209,2020,Sociologie,1,Les Differentes Approches de l'Economie,1,Comment l'Activite et la Science Economiques se detachent-elles de la Morale et de la Politique?,2,880,2,QCM,0.2,0.4,54.33,22,18,40,36,22,14,1.11,61.11,Facile,Moyen,-1,Plus Difficile que la Prediction,Pas Adapte
880,2015,Sociologie,1,Les Differentes Approches de l'Economie,2,Les Auteurs Classiques,2,881,1,QCM,0.75,0.15,33.97,17,32,49,26,17,9,1.88,65.38,Difficile,Difficile,0,Meme Difficulte que la Prediction,Pas Adapte
1946,2016,Sociologie,1,Les Differentes Approches de l'Economie,2,Les Auteurs Classiques,2,881,1,QCM,0.18,0.86,82.61,45,9,54,47,45,2,1.15,95.74,Facile,Facile,0,Meme Difficulte que la Prediction,Pas Adapte
3012,2017,Sociologie,1,Les Differentes Approches de l'Economie,2,Les Auteurs Classiques,2,881,1,QCM,0.18,0.94,98.65,49,1,50,50,49,1,1.0,98.0,Moyen,Facile,1,Plus Facile que la Prediction,Pas Adapte
4078,2018,Sociologie,1,Les Differentes Approches de l'Economie,2,Les Auteurs Classiques,2,881,1,QROC,0.19,0.78,84.62,37,7,44,42,37,5,1.05,88.1,Difficile,Facile,2,Beaucoup plus Facile que la Prediction,Pas Adapte
5144,2019,Sociologie,1,Les Differentes Approches de l'Economie,2,Les Auteurs Classiques,2,881,1,QROC,0.15,0.85,69.42,29,13,42,31,29,2,1.35,93.55,Difficile,Facile,2,Beaucoup plus Facile que la Prediction,Adapte
6210,2020,Sociologie,1,Les Differentes Approches de l'Economie,2,Les Auteurs Classiques,2,881,1,QROC,0.03,0.76,69.42,31,13,44,34,31,3,1.29,91.18,Facile,Facile,0,Meme Difficulte que la Prediction,Adapte
881,2015,Sociologie,1,Les Differentes Approches de l'Economie,2,Les Auteurs Classiques,2,882,2,QCU,0.09,0.78,88.89,34,4,38,35,34,1,1.09,97.14,Facile,Facile,0,Meme Difficulte que la Prediction,Pas Adapte
1947,2016,Sociologie,1,Les Differentes Approches de l'Economie,2,Les Auteurs Classiques,2,882,2,QCU,0.35,0.62,40.58,17,25,42,29,17,12,1.45,58.62,Moyen,Moyen,0,Meme Difficulte que la Prediction,Pas Adapte
3013,2017,Sociologie,1,Les Differentes Approches de l'Economie,2,Les Auteurs Classiques,2,882,2,QCU,0.63,0.24,25.97,11,33,44,37,11,26,1.19,29.73,Difficile,Difficile,0,Meme Difficulte que la Prediction,Pas Adapte
4079,2018,Sociologie,1,Les Differentes Approches de l'Economie,2,Les Auteurs Classiques,2,882,2,QCU,0.58,0.31,14.58,7,40,47,18,7,11,2.61,38.89,Difficile,Difficile,0,Meme Difficulte que la Prediction,Pas Adapte
5145,2019,Sociologie,1,Les Differentes Approches de l'Economie,2,Les Auteurs Classiques,2,882,2,QCM,0.51,0.19,19.37,10,41,51,51,10,41,1.0,19.61,Moyen,Difficile,-1,Plus Difficile que la Prediction,Pas Adapte
6211,2020,Sociologie,1,Les Differentes Approches de l'Economie,2,Les Auteurs Classiques,2,882,2,QCM,0.13,0.92,73.96,38,14,52,48,38,10,1.08,79.17,Difficile,Facile,2,Beaucoup plus Facile que la Prediction,Adapte
882,2015,Sociologie,1,Les Differentes Approches de l'Economie,3,Les Auteurs Neoclassiques,5,883,1,QCM,0.09,0.86,70.78,18,7,25,25,18,7,1.0,72.0,Facile,Facile,0,Meme Difficulte que la Prediction,Adapte
1948,2016,Sociologie,1,Les Differentes Approches de l'Economie,3,Les Auteurs Neoclassiques,5,883,1,QCM,0.14,0.93,70.78,21,8,29,27,21,6,1.07,77.78,Facile,Facile,0,Meme Difficulte que la Prediction,Adapte
3014,2017,Sociologie,1,Les Differentes Approches de l'Economie,3,Les Auteurs Neoclassiques,5,883,1,QCM,0.06,0.86,70.78,20,8,28,23,20,3,1.22,86.96,Facile,Facile,0,Meme Difficulte que la Prediction,Adapte
4080,2018,Sociologie,1,Les Differentes Approches de l'Economie,3,Les Auteurs Neoclassiques,5,883,1,QCU,0.07,0.81,70.78,23,9,32,24,23,1,1.33,95.83,Facile,Facile,0,Meme Difficulte que la Prediction,Adapte
5146,2019,Sociologie,1,Les Differentes Approches de l'Economie,3,Les Auteurs Neoclassiques,5,883,1,QCU,0.1,0.86,70.78,22,9,31,29,22,7,1.07,75.86,Facile,Facile,0,Meme Difficulte que la Prediction,Adapte
6212,2020,Sociologie,1,Les Differentes Approches de l'Economie,3,Les Auteurs Neoclassiques,5,883,1,QCU,0.2,0.93,70.78,24,10,34,32,24,8,1.06,75.0,Facile,Facile,0,Meme Difficulte que la Prediction,Adapte
883,2015,Sociologie,1,Les Differentes Approches de l'Economie,3,Les Auteurs Neoclassiques,5,884,2,QCM,0.08,0.93,76.67,15,4,19,18,15,3,1.06,83.33,Facile,Facile,0,Meme Difficulte que la Prediction,Pas Adapte
1949,2016,Sociologie,1,Les Differentes Approches de l'Economie,3,Les Auteurs Neoclassiques,5,884,2,QCM,0.32,0.45,51.67,10,10,20,10,10,0,2.0,100.0,Moyen,Moyen,0,Meme Difficulte que la Prediction,Pas Adapte
3015,2017,Sociologie,1,Les Differentes Approches de l'Economie,3,Les Auteurs Neoclassiques,5,884,2,QCM,0.18,0.97,89.41,19,2,21,20,19,1,1.05,95.0,Facile,Facile,0,Meme Difficulte que la Prediction,Pas Adapte
4081,2018,Sociologie,1,Les Differentes Approches de l'Economie,3,Les Auteurs Neoclassiques,5,884,2,QCM,0.17,0.97,84.93,19,3,22,22,19,3,1.0,86.36,Facile,Facile,0,Meme Difficulte que la Prediction,Pas Adapte
5147,2019,Sociologie,1,Les Differentes Approches de l'Economie,3,Les Auteurs Neoclassiques,5,884,2,QCM,0.11,0.75,94.7,18,1,19,19,18,1,1.0,94.74,Facile,Facile,0,Meme Difficulte que la Prediction,Pas Adapte
6213,2020,Sociologie,1,Les Differentes Approches de l'Economie,3,Les Auteurs Neoclassiques,5,884,2,QCM,0.28,0.68,47.9,11,11,22,21,11,10,1.05,52.38,Difficile,Moyen,1,Plus Facile que la Prediction,Pas Adapte
884,2015,Sociologie,1,Les Differentes Approches de l'Economie,3,Les Auteurs Neoclassiques,5,885,3,QROC,0.49,0.33,64.97,47,26,73,63,47,16,1.16,74.6,Difficile,Moyen,1,Plus Facile que la Prediction,Adapte
1950,2016,Sociologie,1,Les Differentes Approches de l'Economie,3,Les Auteurs Neoclassiques,5,885,3,QROC,0.37,0.28,64.97,47,25,72,52,47,5,1.38,90.38,Moyen,Moyen,0,Meme Difficulte que la Prediction,Adapte
3016,2017,Sociologie,1,Les Differentes Approches de l'Economie,3,Les Auteurs Neoclassiques,5,885,3,QROC,0.55,0.38,64.97,48,26,74,54,48,6,1.37,88.89,Moyen,Moyen,0,Meme Difficulte que la Prediction,Adapte
4082,2018,Sociologie,1,Les Differentes Approches de l'Economie,3,Les Auteurs Neoclassiques,5,885,3,QROC,0.5,0.27,64.97,47,26,73,47,47,0,1.55,100.0,Moyen,Moyen,0,Meme Difficulte que la Prediction,Adapte
5148,2019,Sociologie,1,Les Differentes Approches de l'Economie,3,Les Auteurs Neoclassiques,5,885,3,QROC,0.44,0.35,64.97,50,27,77,64,50,14,1.2,78.12,Moyen,Moyen,0,Meme Difficulte que la Prediction,Adapte
6214,2020,Sociologie,1,Les Differentes Approches de l'Economie,3,Les Auteurs Neoclassiques,5,885,3,QROC,0.55,0.34,64.97,49,26,75,69,49,20,1.09,71.01,Moyen,Moyen,0,Meme Difficulte que la Prediction,Adapte
885,2015,Sociologie,1,Les Differentes Approches de l'Economie,3,Les Auteurs Neoclassiques,5,886,4,QCU,0.57,0.27,20.52,6,21,27,15,6,9,1.8,40.0,Difficile,Difficile,0,Meme Difficulte que la Prediction,Pas Adapte
1951,2016,Sociologie,1,Les Differentes Approches de l'Economie,3,Les Auteurs Neoclassiques,5,886,4,QCM,0.36,0.54,64.55,15,9,24,21,15,6,1.14,71.43,Facile,Moyen,-1,Plus Difficile que la Prediction,Adapte
3017,2017,Sociologie,1,Les Differentes Approches de l'Economie,3,Les Auteurs Neoclassiques,5,886,4,QCM,0.41,0.43,64.55,17,9,26,24,17,7,1.08,70.83,Moyen,Moyen,0,Meme Difficulte que la Prediction,Adapte
4083,2018,Sociologie,1,Les Differentes Approches de l'Economie,3,Les Auteurs Neoclassiques,5,886,4,QCM,0.44,0.3,64.55,16,9,25,23,16,7,1.09,69.57,Moyen,Moyen,0,Meme Difficulte que la Prediction,Adapte
5149,2019,Sociologie,1,Les Differentes Approches de l'Economie,3,Les Auteurs Neoclassiques,5,886,4,QCM,0.28,0.32,64.55,16,9,25,18,16,2,1.39,88.89,Moyen,Moyen,0,Meme Difficulte que la Prediction,Adapte
6215,2020,Sociologie,1,Les Differentes Approches de l'Economie,3,Les Auteurs Neoclassiques,5,886,4,QCM,0.29,0.61,64.55,17,9,26,19,17,2,1.37,89.47,Moyen,Moyen,0,Meme Difficulte que la Prediction,Adapte
886,2015,Sociologie,1,Les Differentes Approches de l'Economie,3,Les Auteurs Neoclassiques,5,887,5,QROC,0.14,0.96,92.62,32,3,35,33,32,1,1.06,96.97,Difficile,Facile,2,Beaucoup plus Facile que la Prediction,Pas Adapte
1952,2016,Sociologie,1,Les Differentes Approches de l'Economie,3,Les Auteurs Neoclassiques,5,887,5,QO,0.07,0.79,88.49,35,5,40,39,35,4,1.03,89.74,Moyen,Facile,1,Plus Facile que la Prediction,Pas Adapte
3018,2017,Sociologie,1,Les Differentes Approches de l'Economie,3,Les Auteurs Neoclassiques,5,887,5,QO,0.84,0.08,9.66,4,41,45,38,4,34,1.18,10.53,Difficile,Difficile,0,Meme Difficulte que la Prediction,Pas Adapte
4084,2018,Sociologie,1,Les Differentes Approches de l'Economie,3,Les Auteurs Neoclassiques,5,887,5,QO,0.48,0.15,52.07,27,25,52,29,27,2,1.79,93.1,Moyen,Moyen,0,Meme Difficulte que la Prediction,Pas Adapte
5150,2019,Sociologie,1,Les Differentes Approches de l'Economie,3,Les Auteurs Neoclassiques,5,887,5,QO,0.41,0.18,35.23,19,36,55,35,19,16,1.57,54.29,Moyen,Moyen,0,Meme Difficulte que la Prediction,Pas Adapte
6216,2020,Sociologie,1,Les Differentes Approches de l'Economie,3,Les Auteurs Neoclassiques,5,887,5,QROC,0.76,0.11,30.82,15,35,50,49,15,34,1.02,30.61,Facile,Difficile,-2,Beaucoup plus Difficile que la Prediction,Pas Adapte
887,2015,Sociologie,1,Les Differentes Approches de l'Economie,4,L'Analyse Marxiste,8,888,1,QCM,0.04,0.84,82.47,81,17,98,82,81,1,1.2,98.78,Facile,Facile,0,Meme Difficulte que la Prediction,Pas Adapte
1953,2016,Sociologie,1,Les Differentes Approches de l'Economie,4,L'Analyse Marxiste,8,888,1,QCM,0.62,0.2,26.37,30,82,112,84,30,54,1.33,35.71,Facile,Difficile,-2,Beaucoup plus Difficile que la Prediction,Pas Adapte
3019,2017,Sociologie,1,Les Differentes Approches de l'Economie,4,L'Analyse Marxiste,8,888,1,QCU,0.35,0.65,37.98,40,65,105,49,40,9,2.14,81.63,Difficile,Moyen,1,Plus Facile que la Prediction,Pas Adapte
4085,2018,Sociologie,1,Les Differentes Approches de l'Economie,4,L'Analyse Marxiste,8,888,1,QCU,0.32,0.48,60.67,63,41,104,100,63,37,1.04,63.0,Moyen,Moyen,0,Meme Difficulte que la Prediction,Adapte
5151,2019,Sociologie,1,Les Differentes Approches de l'Economie,4,L'Analyse Marxiste,8,888,1,QCU,0.2,0.41,60.67,62,40,102,97,62,35,1.05,63.92,Moyen,Moyen,0,Meme Difficulte que la Prediction,Adapte
6217,2020,Sociologie,1,Les Differentes Approches de l'Economie,4,L'Analyse Marxiste,8,888,1,QCM,0.31,0.55,60.67,61,40,101,64,61,3,1.58,95.31,Moyen,Moyen,0,Meme Difficulte que la Prediction,Adapte
888,2015,Sociologie,1,Les Differentes Approches de l'Economie,4,L'Analyse Marxiste,8,889,2,QO,0.07,0.98,90.86,55,6,61,60,55,5,1.02,91.67,Moyen,Facile,1,Plus Facile que la Prediction,Pas Adapte
1954,2016,Sociologie,1,Les Differentes Approches de l'Economie,4,L'Analyse Marxiste,8,889,2,QO,0.17,0.43,85.02,53,9,62,55,53,2,1.13,96.36,Moyen,Facile,1,Plus Facile que la Prediction,Pas Adapte
3020,2017,Sociologie,1,Les Differentes Approches de l'Economie,4,L'Analyse Marxiste,8,889,2,QO,0.88,0.14,2.87,2,67,69,35,2,33,1.97,5.71,Difficile,Difficile,0,Meme Difficulte que la Prediction,Pas Adapte
4086,2018,Sociologie,1,Les Differentes Approches de l'Economie,4,L'Analyse Marxiste,8,889,2,QCU,0.62,0.35,6.45,4,57,61,29,4,25,2.1,13.79,Difficile,Difficile,0,Meme Difficulte que la Prediction,Pas Adapte
5152,2019,Sociologie,1,Les Differentes Approches de l'Economie,4,L'Analyse Marxiste,8,889,2,QCU,0.34,0.67,43.15,30,39,69,30,30,0,2.3,100.0,Facile,Moyen,-1,Plus Difficile que la Prediction,Pas Adapte
6218,2020,Sociologie,1,Les Differentes Approches de l'Economie,4,L'Analyse Marxiste,8,889,2,QCU,0.57,0.32,3.3,3,73,76,33,3,30,2.3,9.09,Facile,Difficile,-2,Beaucoup plus Difficile que la Prediction,Pas Adapte
889,2015,Sociologie,1,Les Differentes Approches de l'Economie,4,L'Analyse Marxiste,8,890,3,QCM,0.49,0.35,41.25,18,25,43,38,18,20,1.13,47.37,Moyen,Moyen,0,Meme Difficulte que la Prediction,Pas Adapte
1955,2016,Sociologie,1,Les Differentes Approches de l'Economie,4,L'Analyse Marxiste,8,890,3,QCM,0.15,0.72,76.18,37,12,49,39,37,2,1.26,94.87,Facile,Facile,0,Meme Difficulte que la Prediction,Pas Adapte
3021,2017,Sociologie,1,Les Differentes Approches de l'Economie,4,L'Analyse Marxiste,8,890,3,QCM,0.02,0.96,98.96,44,0,44,44,44,0,1.0,100.0,Facile,Facile,0,Meme Difficulte que la Prediction,Pas Adapte
4087,2018,Sociologie,1,Les Differentes Approches de l'Economie,4,L'Analyse Marxiste,8,890,3,QCM,0.17,0.88,73.01,30,11,41,33,30,3,1.24,90.91,Difficile,Facile,2,Beaucoup plus Facile que la Prediction,Adapte
5153,2019,Sociologie,1,Les Differentes Approches de l'Economie,4,L'Analyse Marxiste,8,890,3,QCM,0.07,0.86,73.01,31,12,43,34,31,3,1.26,91.18,Facile,Facile,0,Meme Difficulte que la Prediction,Adapte
6219,2020,Sociologie,1,Les Differentes Approches de l'Economie,4,L'Analyse Marxiste,8,890,3,QCM,0.01,0.88,73.01,29,11,40,35,29,6,1.14,82.86,Facile,Facile,0,Meme Difficulte que la Prediction,Adapte
890,2015,Sociologie,1,Les Differentes Approches de l'Economie,4,L'Analyse Marxiste,8,891,4,QCM,0.74,0.17,20.42,16,62,78,26,16,10,3.0,61.54,Facile,Difficile,-2,Beaucoup plus Difficile que la Prediction,Pas Adapte
1956,2016,Sociologie,1,Les Differentes Approches de l'Economie,4,L'Analyse Marxiste,8,891,4,QCM,0.59,0.21,34.61,29,54,83,63,29,34,1.32,46.03,Facile,Difficile,-2,Beaucoup plus Difficile que la Prediction,Pas Adapte
3022,2017,Sociologie,1,Les Differentes Approches de l'Economie,4,L'Analyse Marxiste,8,891,4,QCM,0.49,0.39,48.19,42,46,88,53,42,11,1.66,79.25,Facile,Moyen,-1,Plus Difficile que la Prediction,Pas Adapte
4088,2018,Sociologie,1,Les Differentes Approches de l'Economie,4,L'Analyse Marxiste,8,891,4,QCU,0.13,0.98,80.37,68,16,84,81,68,13,1.04,83.95,Facile,Facile,0,Meme Difficulte que la Prediction,Pas Adapte
5154,2019,Sociologie,1,Les Differentes Approches de l'Economie,4,L'Analyse Marxiste,8,891,4,QCU,0.29,0.75,42.57,36,49,85,78,36,42,1.09,46.15,Moyen,Moyen,0,Meme Difficulte que la Prediction,Pas Adapte
6220,2020,Sociologie,1,Les Differentes Approches de l'Economie,4,L'Analyse Marxiste,8,891,4,QCU,0.35,0.72,49.76,46,47,93,73,46,27,1.27,63.01,Facile,Moyen,-1,Plus Difficile que la Prediction,Pas Adapte
891,2015,Sociologie,1,Les Differentes Approches de l'Economie,4,L'Analyse Marxiste,8,892,5,QCM,0.75,0.27,7.58,1,10,11,9,1,8,1.22,11.11,Difficile,Difficile,0,Meme Difficulte que la Prediction,Pas Adapte
1957,2016,Sociologie,1,Les Differentes Approches de l'Economie,4,L'Analyse Marxiste,8,892,5,QCM,0.04,0.89,90.57,11,1,12,12,11,1,1.0,91.67,Facile,Facile,0,Meme Difficulte que la Prediction,Pas Adapte
3023,2017,Sociologie,1,Les Differentes Approches de l'Economie,4,L'Analyse Marxiste,8,892,5,QCM,0.56,0.21,2.01,0,14,14,8,0,8,1.75,0.0,Difficile,Difficile,0,Meme Difficulte que la Prediction,Pas Adapte
4089,2018,Sociologie,1,Les Differentes Approches de l'Economie,4,L'Analyse Marxiste,8,892,5,QCM,0.11,0.87,68.18,10,5,15,14,10,4,1.07,71.43,Facile,Facile,0,Meme Difficulte que la Prediction,Adapte
5155,2019,Sociologie,1,Les Differentes Approches de l'Economie,4,L'Analyse Marxiste,8,892,5,QCM,0.0,0.91,68.18,10,5,15,13,10,3,1.15,76.92,Facile,Facile,0,Meme Difficulte que la Prediction,Adapte
6221,2020,Sociologie,1,Les Differentes Approches de l'Economie,4,L'Analyse Marxiste,8,892,5,QCM,0.16,0.96,68.18,10,4,14,12,10,2,1.17,83.33,Facile,Facile,0,Meme Difficulte que la Prediction,Adapte
892,2015,Sociologie,1,Les Differentes Approches de l'Economie,4,L'Analyse Marxiste,8,893,6,QO,0.16,0.85,90.26,39,4,43,41,39,2,1.05,95.12,Moyen,Facile,1,Plus Facile que la Prediction,Pas Adapte
1958,2016,Sociologie,1,Les Differentes Approches de l'Economie,4,L'Analyse Marxiste,8,893,6,QCM,0.15,0.72,98.4,37,1,38,37,37,0,1.03,100.0,Facile,Facile,0,Meme Difficulte que la Prediction,Pas Adapte
3024,2017,Sociologie,1,Les Differentes Approches de l'Economie,4,L'Analyse Marxiste,8,893,6,QCM,0.43,0.43,51.9,21,20,41,37,21,16,1.11,56.76,Facile,Moyen,-1,Plus Difficile que la Prediction,Pas Adapte
4090,2018,Sociologie,1,Les Differentes Approches de l'Economie,4,L'Analyse Marxiste,8,893,6,QCM,0.77,0.2,5.22,2,37,39,15,2,13,2.6,13.33,Difficile,Difficile,0,Meme Difficulte que la Prediction,Pas Adapte
5156,2019,Sociologie,1,Les Differentes Approches de l'Economie,4,L'Analyse Marxiste,8,893,6,QCU,0.55,0.26,27.21,11,28,39,14,11,3,2.79,78.57,Difficile,Difficile,0,Meme Difficulte que la Prediction,Pas Adapte
6222,2020,Sociologie,1,Les Differentes Approches de l'Economie,4,L'Analyse Marxiste,8,893,6,QCU,0.7,0.23,8.36,3,36,39,16,3,13,2.44,18.75,Difficile,Difficile,0,Meme Difficulte que la Prediction,Pas Adapte
893,2015,Sociologie,1,Les Differentes Approches de l'Economie,4,L'Analyse Marxiste,8,894,7,QROC,0.01,0.96,76.34,70,22,92,83,70,13,1.11,84.34,Facile,Facile,0,Meme Difficulte que la Prediction,Pas Adapte
1959,2016,Sociologie,1,Les Differentes Approches de l'Economie,4,L'Analyse Marxiste,8,894,7,QO,0.05,0.47,92.12,85,7,92,90,85,5,1.02,94.44,Facile,Facile,0,Meme Difficulte que la Prediction,Pas Adapte
3025,2017,Sociologie,1,Les Differentes Approches de l'Economie,4,L'Analyse Marxiste,8,894,7,QO,0.97,0.07,1.08,1,103,104,71,1,70,1.46,1.41,Difficile,Difficile,0,Meme Difficulte que la Prediction,Pas Adapte
4091,2018,Sociologie,1,Les Differentes Approches de l'Economie,4,L'Analyse Marxiste,8,894,7,QO,0.14,0.53,81.15,77,18,95,83,77,6,1.14,92.77,Facile,Facile,0,Meme Difficulte que la Prediction,Pas Adapte
5157,2019,Sociologie,1,Les Differentes Approches de l'Economie,4,L'Analyse Marxiste,8,894,7,QO,0.06,0.6,82.58,69,14,83,79,69,10,1.05,87.34,Difficile,Facile,2,Beaucoup plus Facile que la Prediction,Pas Adapte
6223,2020,Sociologie,1,Les Differentes Approches de l'Economie,4,L'Analyse Marxiste,8,894,7,QO,0.87,0.01,29.62,27,65,92,51,27,24,1.8,52.94,Difficile,Difficile,0,Meme Difficulte que la Prediction,Pas Adapte
894,2015,Sociologie,1,Les Differentes Approches de l'Economie,4,L'Analyse Marxiste,8,895,8,QCM,0.33,0.48,51.86,24,23,47,25,24,1,1.88,96.0,Moyen,Moyen,0,Meme Difficulte que la Prediction,Pas Adapte
1960,2016,Sociologie,1,Les Differentes Approches de l'Economie,4,L'Analyse Marxiste,8,895,8,QCM,0.29,0.45,60.25,33,21,54,50,33,17,1.08,66.0,Moyen,Moyen,0,Meme Difficulte que la Prediction,Adapte
3026,2017,Sociologie,1,Les Differentes Approches de l'Economie,4,L'Analyse Marxiste,8,895,8,QCM,0.23,0.56,60.25,28,18,46,29,28,1,1.59,96.55,Moyen,Moyen,0,Meme Difficulte que la Prediction,Adapte
4092,2018,Sociologie,1,Les Differentes Approches de l'Economie,4,L'Analyse Marxiste,8,895,8,QCM,0.41,0.33,60.25,31,21,52,32,31,1,1.62,96.88,Moyen,Moyen,0,Meme Difficulte que la Prediction,Adapte
5158,2019,Sociologie,1,Les Differentes Approches de l'Economie,4,L'Analyse Marxiste,8,895,8,QCM,0.37,0.64,60.25,27,18,45,35,27,8,1.29,77.14,Moyen,Moyen,0,Meme Difficulte que la Prediction,Adapte
6224,2020,Sociologie,1,Les Differentes Approches de l'Economie,4,L'Analyse Marxiste,8,895,8,QCM,0.36,0.54,60.25,28,18,46,32,28,4,1.44,87.5,Moyen,Moyen,0,Meme Difficulte que la Prediction,Adapte
895,2015,Sociologie,1,Les Differentes Approches de l'Economie,5,La Pensee Economique de Keynes,13,896,1,QCM,0.21,0.42,47.1,40,45,85,80,40,40,1.06,50.0,Facile,Moyen,-1,Plus Difficile que la Prediction,Pas Adapte
1961,2016,Sociologie,1,Les Differentes Approches de l'Economie,5,La Pensee Economique de Keynes,13,896,1,QCM,0.6,0.21,0.54,1,93,94,91,1,90,1.03,1.1,Difficile,Difficile,0,Meme Difficulte que la Prediction,Pas Adapte
3027,2017,Sociologie,1,Les Differentes Approches de l'Economie,5,La Pensee Economique de Keynes,13,896,1,QCM,0.45,0.54,50.71,50,48,98,83,50,33,1.18,60.24,Moyen,Moyen,0,Meme Difficulte que la Prediction,Pas Adapte
4093,2018,Sociologie,1,Les Differentes Approches de l'Economie,5,La Pensee Economique de Keynes,13,896,1,QCU,0.64,0.4,9.68,9,85,94,43,9,34,2.19,20.93,Difficile,Difficile,0,Meme Difficulte que la Prediction,Pas Adapte
5159,2019,Sociologie,1,Les Differentes Approches de l'Economie,5,La Pensee Economique de Keynes,13,896,1,QROC,0.13,0.58,96.41,100,4,104,104,100,4,1.0,96.15,Facile,Facile,0,Meme Difficulte que la Prediction,Pas Adapte
6225,2020,Sociologie,1,Les Differentes Approches de l'Economie,5,La Pensee Economique de Keynes,13,896,1,QROC,0.07,0.68,93.38,90,6,96,96,90,6,1.0,93.75,Difficile,Facile,2,Beaucoup plus Facile que la Prediction,Pas Adapte
896,2015,Sociologie,1,Les Differentes Approches de l'Economie,5,La Pensee Economique de Keynes,13,897,2,QCM,0.03,0.86,68.44,49,22,71,57,49,8,1.25,85.96,Difficile,Facile,2,Beaucoup plus Facile que la Prediction,Adapte
1962,2016,Sociologie,1,Les Differentes Approches de l'Economie,5,La Pensee Economique de Keynes,13,897,2,QCM,0.03,0.91,68.44,45,21,66,60,45,15,1.1,75.0,Facile,Facile,0,Meme Difficulte que la Prediction,Adapte
3028,2017,Sociologie,1,Les Differentes Approches de l'Economie,5,La Pensee Economique de Keynes,13,897,2,QCU,0.1,0.79,68.44,39,18,57,48,39,9,1.19,81.25,Facile,Facile,0,Meme Difficulte que la Prediction,Adapte
4094,2018,Sociologie,1,Les Differentes Approches de l'Economie,5,La Pensee Economique de Keynes,13,897,2,QCU,0.15,0.93,68.44,39,18,57,54,39,15,1.06,72.22,Facile,Facile,0,Meme Difficulte que la Prediction,Adapte
5160,2019,Sociologie,1,Les Differentes Approches de l'Economie,5,La Pensee Economique de Keynes,13,897,2,QCM,0.09,0.77,68.44,40,19,59,54,40,14,1.09,74.07,Facile,Facile,0,Meme Difficulte que la Prediction,Adapte
6226,2020,Sociologie,1,Les Differentes Approches de l'Economie,5,La Pensee Economique de Keynes,13,897,2,QCM,0.14,0.71,68.44,43,20,63,57,43,14,1.11,75.44,Facile,Facile,0,Meme Difficulte que la Prediction,Adapte
897,2015,Sociologie,1,Les Differentes Approches de l'Economie,5,La Pensee Economique de Keynes,13,898,3,QCU,0.33,0.69,41.09,3,5,8,5,3,2,1.6,60.0,Moyen,Moyen,0,Meme Difficulte que la Prediction,Pas Adapte
1963,2016,Sociologie,1,Les Differentes Approches de l'Economie,5,La Pensee Economique de Keynes,13,898,3,QCU,0.36,0.45,61.09,5,4,9,8,5,3,1.12,62.5,Moyen,Moyen,0,Meme Difficulte que la Prediction,Adapte
3029,2017,Sociologie,1,Les Differentes Approches de l'Economie,5,La Pensee Economique de Keynes,13,898,3,QCU,0.25,0.42,61.09,5,3,8,6,5,1,1.33,83.33,Moyen,Moyen,0,Meme Difficulte que la Prediction,Adapte
4095,2018,Sociologie,1,Les Differentes Approches de l'Economie,5,La Pensee Economique de Keynes,13,898,3,QCU,0.22,0.62,61.09,4,3,7,7,4,3,1.0,57.14,Moyen,Moyen,0,Meme Difficulte que la Prediction,Adapte
5161,2019,Sociologie,1,Les Differentes Approches de l'Economie,5,La Pensee Economique de Keynes,13,898,3,QCU,0.26,0.51,61.09,4,3,7,6,4,2,1.17,66.67,Moyen,Moyen,0,Meme Difficulte que la Prediction,Adapte
6227,2020,Sociologie,1,Les Differentes Approches de l'Economie,5,La Pensee Economique de Keynes,13,898,3,QCU,0.36,0.41,61.09,4,2,6,5,4,1,1.2,80.0,Moyen,Moyen,0,Meme Difficulte que la Prediction,Adapte
898,2015,Sociologie,1,Les Differentes Approches de l'Economie,5,La Pensee Economique de Keynes,13,899,4,QCU,0.29,0.46,51.28,22,20,42,26,22,4,1.62,84.62,Facile,Moyen,-1,Plus Difficile que la Prediction,Pas Adapte
1964,2016,Sociologie,1,Les Differentes Approches de l'Economie,5,La Pensee Economique de Keynes,13,899,4,QCU,0.09,0.91,77.68,33,10,43,38,33,5,1.13,86.84,Facile,Facile,0,Meme Difficulte que la Prediction,Pas Adapte
3030,2017,Sociologie,1,Les Differentes Approches de l'Economie,5,La Pensee Economique de Keynes,13,899,4,QCU,0.54,0.35,34.5,15,28,43,20,15,5,2.15,75.0,Difficile,Difficile,0,Meme Difficulte que la Prediction,Pas Adapte
4096,2018,Sociologie,1,Les Differentes Approches de l'Economie,5,La Pensee Economique de Keynes,13,899,4,QCM,0.08,0.9,84.11,41,8,49,42,41,1,1.17,97.62,Difficile,Facile,2,Beaucoup plus Facile que la Prediction,Pas Adapte
5162,2019,Sociologie,1,Les Differentes Approches de l'Economie,5,La Pensee Economique de Keynes,13,899,4,QCM,0.42,0.47,37.7,20,32,52,32,20,12,1.62,62.5,Moyen,Moyen,0,Meme Difficulte que la Prediction,Pas Adapte
6228,2020,Sociologie,1,Les Differentes Approches de l'Economie,5,La Pensee Economique de Keynes,13,899,4,QCM,0.32,0.67,42.25,24,33,57,38,24,14,1.5,63.16,Moyen,Moyen,0,Meme Difficulte que la Prediction,Pas Adapte
899,2015,Sociologie,1,Les Differentes Approches de l'Economie,5,La Pensee Economique de Keynes,13,900,5,QCM,0.39,0.37,57.82,8,6,14,9,8,1,1.56,88.89,Facile,Moyen,-1,Plus Difficile que la Prediction,Pas Adapte
1965,2016,Sociologie,1,Les Differentes Approches de l'Economie,5,La Pensee Economique de Keynes,13,900,5,QCM,0.62,0.28,27.46,4,11,15,9,4,5,1.67,44.44,Difficile,Difficile,0,Meme Difficulte que la Prediction,Pas Adapte
3031,2017,Sociologie,1,Les Differentes Approches de l'Economie,5,La Pensee Economique de Keynes,13,900,5,QCM,0.16,0.79,68.67,9,4,13,13,9,4,1.0,69.23,Facile,Facile,0,Meme Difficulte que la Prediction,Adapte
4097,2018,Sociologie,1,Les Differentes Approches de l'Economie,5,La Pensee Economique de Keynes,13,900,5,QCM,0.14,0.83,68.67,8,3,11,10,8,2,1.1,80.0,Facile,Facile,0,Meme Difficulte que la Prediction,Adapte
5163,2019,Sociologie,1,Les Differentes Approches de l'Economie,5,La Pensee Economique de Keynes,13,900,5,QCU,0.04,0.98,68.67,7,3,10,8,7,1,1.25,87.5,Facile,Facile,0,Meme Difficulte que la Prediction,Adapte
6229,2020,Sociologie,1,Les Differentes Approches de l'Economie,5,La Pensee Economique de Keynes,13,900,5,QCU,0.18,0.85,68.67,6,3,9,7,6,1,1.29,85.71,Facile,Facile,0,Meme Difficulte que la Prediction,Adapte
900,2015,Sociologie,1,Les Differentes Approches de l'Economie,5,La Pensee Economique de Keynes,13,901,6,QROC,0.78,0.23,6.97,1,19,20,9,1,8,2.22,11.11,Difficile,Difficile,0,Meme Difficulte que la Prediction,Pas Adapte
1966,2016,Sociologie,1,Les Differentes Approches de l'Economie,5,La Pensee Economique de Keynes,13,901,6,QROC,0.69,0.13,27.53,5,12,17,10,5,5,1.7,50.0,Difficile,Difficile,0,Meme Difficulte que la Prediction,Pas Adapte
3032,2017,Sociologie,1,Les Differentes Approches de l'Economie,5,La Pensee Economique de Keynes,13,901,6,QROC,0.23,0.4,48.43,7,8,15,15,7,8,1.0,46.67,Moyen,Moyen,0,Meme Difficulte que la Prediction,Pas Adapte
4098,2018,Sociologie,1,Les Differentes Approches de l'Economie,5,La Pensee Economique de Keynes,13,901,6,QROC,0.07,0.48,86.91,15,2,17,15,15,0,1.13,100.0,Difficile,Facile,2,Beaucoup plus Facile que la Prediction,Pas Adapte
5164,2019,Sociologie,1,Les Differentes Approches de l'Economie,5,La Pensee Economique de Keynes,13,901,6,QROC,0.52,0.36,51.79,9,9,18,14,9,5,1.29,64.29,Moyen,Moyen,0,Meme Difficulte que la Prediction,Pas Adapte
6230,2020,Sociologie,1,Les Differentes Approches de l'Economie,5,La Pensee Economique de Keynes,13,901,6,QROC,0.51,0.25,35.46,7,14,21,15,7,8,1.4,46.67,Moyen,Moyen,0,Meme Difficulte que la Prediction,Pas Adapte
901,2015,Sociologie,1,Les Differentes Approches de l'Economie,5,La Pensee Economique de Keynes,13,902,7,QROC,0.58,0.38,64.41,62,34,96,88,62,26,1.09,70.45,Moyen,Moyen,0,Meme Difficulte que la Prediction,Adapte
1967,2016,Sociologie,1,Les Differentes Approches de l'Economie,5,La Pensee Economique de Keynes,13,902,7,QROC,0.31,0.33,64.41,62,35,97,76,62,14,1.28,81.58,Moyen,Moyen,0,Meme Difficulte que la Prediction,Adapte
3033,2017,Sociologie,1,Les Differentes Approches de l'Economie,5,La Pensee Economique de Keynes,13,902,7,QROC,0.23,0.4,64.41,59,32,91,74,59,15,1.23,79.73,Moyen,Moyen,0,Meme Difficulte que la Prediction,Adapte
4099,2018,Sociologie,1,Les Differentes Approches de l'Economie,5,La Pensee Economique de Keynes,13,902,7,QROC,0.6,0.35,64.41,61,34,95,90,61,29,1.06,67.78,Moyen,Moyen,0,Meme Difficulte que la Prediction,Adapte
5165,2019,Sociologie,1,Les Differentes Approches de l'Economie,5,La Pensee Economique de Keynes,13,902,7,QROC,0.44,0.3,64.41,61,33,94,83,61,22,1.13,73.49,Moyen,Moyen,0,Meme Difficulte que la Prediction,Adapte
6231,2020,Sociologie,1,Les Differentes Approches de l'Economie,5,La Pensee Economique de Keynes,13,902,7,QROC,0.5,0.29,64.41,55,30,85,84,55,29,1.01,65.48,Moyen,Moyen,0,Meme Difficulte que la Prediction,Adapte
902,2015,Sociologie,1,Les Differentes Approches de l'Economie,5,La Pensee Economique de Keynes,13,903,8,QROC,0.2,0.36,48.85,30,31,61,41,30,11,1.49,73.17,Moyen,Moyen,0,Meme Difficulte que la Prediction,Pas Adapte
1968,2016,Sociologie,1,Les Differentes Approches de l'Economie,5,La Pensee Economique de Keynes,13,903,8,QROC,0.37,0.31,39.98,25,37,62,58,25,33,1.07,43.1,Moyen,Moyen,0,Meme Difficulte que la Prediction,Pas Adapte
3034,2017,Sociologie,1,Les Differentes Approches de l'Economie,5,La Pensee Economique de Keynes,13,903,8,QROC,0.83,0.13,9.21,6,61,67,34,6,28,1.97,17.65,Difficile,Difficile,0,Meme Difficulte que la Prediction,Pas Adapte
4100,2018,Sociologie,1,Les Differentes Approches de l'Economie,5,La Pensee Economique de Keynes,13,903,8,QO,0.54,0.21,64.76,38,21,59,58,38,20,1.02,65.52,Moyen,Moyen,0,Meme Difficulte que la Prediction,Adapte
5166,2019,Sociologie,1,Les Differentes Approches de l'Economie,5,La Pensee Economique de Keynes,13,903,8,QO,0.69,0.15,64.76,40,22,62,46,40,6,1.35,86.96,Moyen,Moyen,0,Meme Difficulte que la Prediction,Adapte
6232,2020,Sociologie,1,Les Differentes Approches de l'Economie,5,La Pensee Economique de Keynes,13,903,8,QO,0.39,0.15,64.76,45,25,70,58,45,13,1.21,77.59,Moyen,Moyen,0,Meme Difficulte que la Prediction,Adapte
903,2015,Sociologie,1,Les Differentes Approches de l'Economie,5,La Pensee Economique de Keynes,13,904,9,QCM,0.44,0.51,50.41,19,18,37,30,19,11,1.23,63.33,Facile,Moyen,-1,Plus Difficile que la Prediction,Pas Adapte
1969,2016,Sociologie,1,Les Differentes Approches de l'Economie,5,La Pensee Economique de Keynes,13,904,9,QCM,0.77,0.16,22.95,8,26,34,14,8,6,2.43,57.14,Difficile,Difficile,0,Meme Difficulte que la Prediction,Pas Adapte
3035,2017,Sociologie,1,Les Differentes Approches de l'Economie,5,La Pensee Economique de Keynes,13,904,9,QCM,0.1,0.78,83.7,32,6,38,37,32,5,1.03,86.49,Facile,Facile,0,Meme Difficulte que la Prediction,Pas Adapte
4101,2018,Sociologie,1,Les Differentes Approches de l'Economie,5,La Pensee Economique de Keynes,13,904,9,QCM,0.03,0.97,90.2,36,4,40,39,36,3,1.03,92.31,Facile,Facile,0,Meme Difficulte que la Prediction,Pas Adapte
5167,2019,Sociologie,1,Les Differentes Approches de l'Economie,5,La Pensee Economique de Keynes,13,904,9,QCM,0.33,0.6,47.25,20,22,42,31,20,11,1.35,64.52,Moyen,Moyen,0,Meme Difficulte que la Prediction,Pas Adapte
6233,2020,Sociologie,1,Les Differentes Approches de l'Economie,5,La Pensee Economique de Keynes,13,904,9,QCM,0.23,0.65,44.64,17,22,39,29,17,12,1.34,58.62,Facile,Moyen,-1,Plus Difficile que la Prediction,Pas Adapte
904,2015,Sociologie,1,Les Differentes Approches de l'Economie,5,La Pensee Economique de Keynes,13,905,10,QCU,0.36,0.64,61.76,30,18,48,31,30,1,1.55,96.77,Difficile,Moyen,1,Plus Facile que la Prediction,Adapte
1970,2016,Sociologie,1,Les Differentes Approches de l'Economie,5,La Pensee Economique de Keynes,13,905,10,QCU,0.34,0.59,61.76,28,17,45,43,28,15,1.05,65.12,Moyen,Moyen,0,Meme Difficulte que la Prediction,Adapte
3036,2017,Sociologie,1,Les Differentes Approches de l'Economie,5,La Pensee Economique de Keynes,13,905,10,QCU,0.38,0.54,61.76,29,18,47,37,29,8,1.27,78.38,Moyen,Moyen,0,Meme Difficulte que la Prediction,Adapte
4102,2018,Sociologie,1,Les Differentes Approches de l'Economie,5,La Pensee Economique de Keynes,13,905,10,QCU,0.32,0.72,61.76,31,20,51,50,31,19,1.02,62.0,Moyen,Moyen,0,Meme Difficulte que la Prediction,Adapte
5168,2019,Sociologie,1,Les Differentes Approches de l'Economie,5,La Pensee Economique de Keynes,13,905,10,QCM,0.41,0.31,61.76,31,20,51,37,31,6,1.38,83.78,Moyen,Moyen,0,Meme Difficulte que la Prediction,Adapte
6234,2020,Sociologie,1,Les Differentes Approches de l'Economie,5,La Pensee Economique de Keynes,13,905,10,QCM,0.4,0.36,61.76,30,19,49,41,30,11,1.2,73.17,Moyen,Moyen,0,Meme Difficulte que la Prediction,Adapte
905,2015,Sociologie,1,Les Differentes Approches de l'Economie,5,La Pensee Economique de Keynes,13,906,11,QCU,0.04,0.8,92.96,13,1,14,13,13,0,1.08,100.0,Facile,Facile,0,Meme Difficulte que la Prediction,Pas Adapte
1971,2016,Sociologie,1,Les Differentes Approches de l'Economie,5,La Pensee Economique de Keynes,13,906,11,QCU,0.72,0.38,1.88,0,16,16,10,0,10,1.6,0.0,Difficile,Difficile,0,Meme Difficulte que la Prediction,Pas Adapte
3037,2017,Sociologie,1,Les Differentes Approches de l'Economie,5,La Pensee Economique de Keynes,13,906,11,QCM,0.22,0.54,45.18,8,10,18,14,8,6,1.29,57.14,Facile,Moyen,-1,Plus Difficile que la Prediction,Pas Adapte
4103,2018,Sociologie,1,Les Differentes Approches de l'Economie,5,La Pensee Economique de Keynes,13,906,11,QCM,0.19,0.87,77.58,14,4,18,16,14,2,1.12,87.5,Facile,Facile,0,Meme Difficulte que la Prediction,Pas Adapte
5169,2019,Sociologie,1,Les Differentes Approches de l'Economie,5,La Pensee Economique de Keynes,13,906,11,QCM,0.57,0.18,29.39,6,13,19,13,6,7,1.46,46.15,Difficile,Difficile,0,Meme Difficulte que la Prediction,Pas Adapte
6235,2020,Sociologie,1,Les Differentes Approches de l'Economie,5,La Pensee Economique de Keynes,13,906,11,QCM,0.27,0.58,48.16,9,10,19,10,9,1,1.9,90.0,Moyen,Moyen,0,Meme Difficulte que la Prediction,Pas Adapte
906,2015,Sociologie,1,Les Differentes Approches de l'Economie,5,La Pensee Economique de Keynes,13,907,12,QCU,0.23,0.57,37.9,10,17,27,14,10,4,1.93,71.43,Moyen,Moyen,0,Meme Difficulte que la Prediction,Pas Adapte
1972,2016,Sociologie,1,Les Differentes Approches de l'Economie,5,La Pensee Economique de Keynes,13,907,12,QCU,0.46,0.27,11.49,3,22,25,12,3,9,2.08,25.0,Difficile,Difficile,0,Meme Difficulte que la Prediction,Pas Adapte
3038,2017,Sociologie,1,Les Differentes Approches de l'Economie,5,La Pensee Economique de Keynes,13,907,12,QCU,0.2,0.47,37.94,11,17,28,19,11,8,1.47,57.89,Moyen,Moyen,0,Meme Difficulte que la Prediction,Pas Adapte
4104,2018,Sociologie,1,Les Differentes Approches de l'Economie,5,La Pensee Economique de Keynes,13,907,12,QCU,0.64,0.28,26.82,7,19,26,22,7,15,1.18,31.82,Difficile,Difficile,0,Meme Difficulte que la Prediction,Pas Adapte
5170,2019,Sociologie,1,Les Differentes Approches de l'Economie,5,La Pensee Economique de Keynes,13,907,12,QCU,0.61,0.33,15.48,5,25,30,14,5,9,2.14,35.71,Difficile,Difficile,0,Meme Difficulte que la Prediction,Pas Adapte
6236,2020,Sociologie,1,Les Differentes Approches de l'Economie,5,La Pensee Economique de Keynes,13,907,12,QCU,0.68,0.27,9.16,2,24,26,16,2,14,1.62,12.5,Moyen,Difficile,-1,Plus Difficile que la Prediction,Pas Adapte
907,2015,Sociologie,1,Les Differentes Approches de l'Economie,5,La Pensee Economique de Keynes,13,908,13,QCU,0.12,0.92,94.02,54,3,57,56,54,2,1.02,96.43,Facile,Facile,0,Meme Difficulte que la Prediction,Pas Adapte
1973,2016,Sociologie,1,Les Differentes Approches de l'Economie,5,La Pensee Economique de Keynes,13,908,13,QCU,0.44,0.33,28.74,19,47,66,62,19,43,1.06,30.65,Difficile,Difficile,0,Meme Difficulte que la Prediction,Pas Adapte
3039,2017,Sociologie,1,Les Differentes Approches de l'Economie,5,La Pensee Economique de Keynes,13,908,13,QCU,0.61,0.39,34.2,26,50,76,55,26,29,1.38,47.27,Facile,Difficile,-2,Beaucoup plus Difficile que la Prediction,Pas Adapte
4105,2018,Sociologie,1,Les Differentes Approches de l'Economie,5,La Pensee Economique de Keynes,13,908,13,QCU,0.04,0.82,69.77,47,21,68,48,47,1,1.42,97.92,Facile,Facile,0,Meme Difficulte que la Prediction,Adapte
5171,2019,Sociologie,1,Les Differentes Approches de l'Economie,5,La Pensee Economique de Keynes,13,908,13,QO,0.11,0.85,69.77,49,21,70,61,49,12,1.15,80.33,Facile,Facile,0,Meme Difficulte que la Prediction,Adapte
6237,2020,Sociologie,1,Les Differentes Approches de l'Economie,5,La Pensee Economique de Keynes,13,908,13,QCU,0.19,0.8,69.77,48,21,69,66,48,18,1.05,72.73,Facile,Facile,0,Meme Difficulte que la Prediction,Adapte
908,2015,Sociologie,1,Les Differentes Approches de l'Economie,6,Les Insuffisances d'une Pensee purement Economique,9,909,1,QCU,0.17,0.98,80.6,55,13,68,62,55,7,1.1,88.71,Moyen,Facile,1,Plus Facile que la Prediction,Pas Adapte
1974,2016,Sociologie,1,Les Differentes Approches de l'Economie,6,Les Insuffisances d'une Pensee purement Economique,9,909,1,QCM,0.51,0.19,23.83,15,47,62,22,15,7,2.82,68.18,Difficile,Difficile,0,Meme Difficulte que la Prediction,Pas Adapte
3040,2017,Sociologie,1,Les Differentes Approches de l'Economie,6,Les Insuffisances d'une Pensee purement Economique,9,909,1,QROC,0.7,0.19,0.67,0,55,55,35,0,35,1.57,0.0,Difficile,Difficile,0,Meme Difficulte que la Prediction,Pas Adapte
4106,2018,Sociologie,1,Les Differentes Approches de l'Economie,6,Les Insuffisances d'une Pensee purement Economique,9,909,1,QROC,0.12,0.86,90.77,46,5,51,47,46,1,1.09,97.87,Facile,Facile,0,Meme Difficulte que la Prediction,Pas Adapte
5172,2019,Sociologie,1,Les Differentes Approches de l'Economie,6,Les Insuffisances d'une Pensee purement Economique,9,909,1,QCM,0.23,0.66,48.61,22,23,45,25,22,3,1.8,88.0,Moyen,Moyen,0,Meme Difficulte que la Prediction,Pas Adapte
6238,2020,Sociologie,1,Les Differentes Approches de l'Economie,6,Les Insuffisances d'une Pensee purement Economique,9,909,1,QCM,0.28,0.69,49.94,26,26,52,27,26,1,1.93,96.3,Moyen,Moyen,0,Meme Difficulte que la Prediction,Pas Adapte
909,2015,Sociologie,1,Les Differentes Approches de l'Economie,6,Les Insuffisances d'une Pensee purement Economique,9,910,2,QCU,0.02,0.8,65.51,25,13,38,31,25,6,1.23,80.65,Facile,Facile,0,Meme Difficulte que la Prediction,Adapte
1975,2016,Sociologie,1,Les Differentes Approches de l'Economie,6,Les Insuffisances d'une Pensee purement Economique,9,910,2,QCU,0.18,0.95,65.51,26,14,40,27,26,1,1.48,96.3,Facile,Facile,0,Meme Difficulte que la Prediction,Adapte
3041,2017,Sociologie,1,Les Differentes Approches de l'Economie,6,Les Insuffisances d'une Pensee purement Economique,9,910,2,QCU,0.03,0.95,65.51,28,14,42,38,28,10,1.11,73.68,Facile,Facile,0,Meme Difficulte que la Prediction,Adapte
4107,2018,Sociologie,1,Les Differentes Approches de l'Economie,6,Les Insuffisances d'une Pensee purement Economique,9,910,2,QCM,0.09,0.87,65.51,31,16,47,32,31,1,1.47,96.88,Facile,Facile,0,Meme Difficulte que la Prediction,Adapte
5173,2019,Sociologie,1,Les Differentes Approches de l'Economie,6,Les Insuffisances d'une Pensee purement Economique,9,910,2,QCM,0.06,0.96,65.51,35,19,54,50,35,15,1.08,70.0,Facile,Facile,0,Meme Difficulte que la Prediction,Adapte
6239,2020,Sociologie,1,Les Differentes Approches de l'Economie,6,Les Insuffisances d'une Pensee purement Economique,9,910,2,QCM,0.05,0.74,65.51,33,18,51,46,33,13,1.11,71.74,Facile,Facile,0,Meme Difficulte que la Prediction,Adapte
910,2015,Sociologie,1,Les Differentes Approches de l'Economie,6,Les Insuffisances d'une Pensee purement Economique,9,911,3,QCU,0.07,0.95,74.83,52,18,70,53,52,1,1.32,98.11,Facile,Facile,0,Meme Difficulte que la Prediction,Adapte
1976,2016,Sociologie,1,Les Differentes Approches de l'Economie,6,Les Insuffisances d'une Pensee purement Economique,9,911,3,QCU,0.04,0.97,74.83,49,17,66,50,49,1,1.32,98.0,Facile,Facile,0,Meme Difficulte que la Prediction,Adapte
3042,2017,Sociologie,1,Les Differentes Approches de l'Economie,6,Les Insuffisances d'une Pensee purement Economique,9,911,3,QCU,0.01,0.88,74.83,46,16,62,47,46,1,1.32,97.87,Facile,Facile,0,Meme Difficulte que la Prediction,Adapte
4108,2018,Sociologie,1,Les Differentes Approches de l'Economie,6,Les Insuffisances d'une Pensee purement Economique,9,911,3,QCU,0.14,0.77,74.83,40,14,54,47,40,7,1.15,85.11,Facile,Facile,0,Meme Difficulte que la Prediction,Adapte
5174,2019,Sociologie,1,Les Differentes Approches de l'Economie,6,Les Insuffisances d'une Pensee purement Economique,9,911,3,QO,0.07,0.87,74.83,43,15,58,48,43,5,1.21,89.58,Facile,Facile,0,Meme Difficulte que la Prediction,Adapte
6240,2020,Sociologie,1,Les Differentes Approches de l'Economie,6,Les Insuffisances d'une Pensee purement Economique,9,911,3,QCM,0.12,0.7,74.83,40,14,54,48,40,8,1.12,83.33,Facile,Facile,0,Meme Difficulte que la Prediction,Adapte
911,2015,Sociologie,1,Les Differentes Approches de l'Economie,6,Les Insuffisances d'une Pensee purement Economique,9,912,4,QCU,0.55,0.27,3.74,2,56,58,33,2,31,1.76,6.06,Difficile,Difficile,0,Meme Difficulte que la Prediction,Pas Adapte
1977,2016,Sociologie,1,Les Differentes Approches de l'Economie,6,Les Insuffisances d'une Pensee purement Economique,9,912,4,QCU,0.0,0.8,77.35,47,14,61,50,47,3,1.22,94.0,Facile,Facile,0,Meme Difficulte que la Prediction,Pas Adapte
3043,2017,Sociologie,1,Les Differentes Approches de l'Economie,6,Les Insuffisances d'une Pensee purement Economique,9,912,4,QCU,0.01,0.92,77.8,54,15,69,67,54,13,1.03,80.6,Facile,Facile,0,Meme Difficulte que la Prediction,Pas Adapte
4109,2018,Sociologie,1,Les Differentes Approches de l'Economie,6,Les Insuffisances d'une Pensee purement Economique,9,912,4,QCU,0.27,0.7,56.09,39,31,70,59,39,20,1.19,66.1,Moyen,Moyen,0,Meme Difficulte que la Prediction,Pas Adapte
5175,2019,Sociologie,1,Les Differentes Approches de l'Economie,6,Les Insuffisances d'une Pensee purement Economique,9,912,4,QCU,0.22,0.72,49.01,39,41,80,74,39,35,1.08,52.7,Facile,Moyen,-1,Plus Difficile que la Prediction,Pas Adapte
6241,2020,Sociologie,1,Les Differentes Approches de l'Economie,6,Les Insuffisances d'une Pensee purement Economique,9,912,4,QROC,0.15,0.86,92.71,81,6,87,81,81,0,1.07,100.0,Facile,Facile,0,Meme Difficulte que la Prediction,Pas Adapte
912,2015,Sociologie,1,Les Differentes Approches de l'Economie,6,Les Insuffisances d'une Pensee purement Economique,9,913,5,QO,0.06,0.74,89.82,70,8,78,72,70,2,1.08,97.22,Difficile,Facile,2,Beaucoup plus Facile que la Prediction,Pas Adapte
1978,2016,Sociologie,1,Les Differentes Approches de l'Economie,6,Les Insuffisances d'une Pensee purement Economique,9,913,5,QO,0.08,0.93,70.82,62,25,87,83,62,21,1.05,74.7,Facile,Facile,0,Meme Difficulte que la Prediction,Adapte
3044,2017,Sociologie,1,Les Differentes Approches de l'Economie,6,Les Insuffisances d'une Pensee purement Economique,9,913,5,QO,0.13,0.49,70.82,59,25,84,64,59,5,1.31,92.19,Facile,Facile,0,Meme Difficulte que la Prediction,Adapte
4110,2018,Sociologie,1,Les Differentes Approches de l'Economie,6,Les Insuffisances d'une Pensee purement Economique,9,913,5,QO,0.08,0.91,70.82,55,23,78,56,55,1,1.39,98.21,Facile,Facile,0,Meme Difficulte que la Prediction,Adapte
5176,2019,Sociologie,1,Les Differentes Approches de l'Economie,6,Les Insuffisances d'une Pensee purement Economique,9,913,5,QCM,0.18,0.91,70.82,54,22,76,75,54,21,1.01,72.0,Facile,Facile,0,Meme Difficulte que la Prediction,Adapte
6242,2020,Sociologie,1,Les Differentes Approches de l'Economie,6,Les Insuffisances d'une Pensee purement Economique,9,913,5,QCM,0.08,0.74,70.82,55,23,78,73,55,18,1.07,75.34,Facile,Facile,0,Meme Difficulte que la Prediction,Adapte
913,2015,Sociologie,1,Les Differentes Approches de l'Economie,6,Les Insuffisances d'une Pensee purement Economique,9,914,6,QCU,0.42,0.25,9.4,6,60,66,26,6,20,2.54,23.08,Moyen,Difficile,-1,Plus Difficile que la Prediction,Pas Adapte
1979,2016,Sociologie,1,Les Differentes Approches de l'Economie,6,Les Insuffisances d'une Pensee purement Economique,9,914,6,QCU,0.34,0.46,58.98,41,29,70,42,41,1,1.67,97.62,Facile,Moyen,-1,Plus Difficile que la Prediction,Pas Adapte
3045,2017,Sociologie,1,Les Differentes Approches de l'Economie,6,Les Insuffisances d'une Pensee purement Economique,9,914,6,QCU,0.21,0.48,53.71,38,32,70,57,38,19,1.23,66.67,Facile,Moyen,-1,Plus Difficile que la Prediction,Pas Adapte
4111,2018,Sociologie,1,Les Differentes Approches de l'Economie,6,Les Insuffisances d'une Pensee purement Economique,9,914,6,QCU,0.08,0.99,98.38,79,1,80,79,79,0,1.01,100.0,Facile,Facile,0,Meme Difficulte que la Prediction,Pas Adapte
5177,2019,Sociologie,1,Les Differentes Approches de l'Economie,6,Les Insuffisances d'une Pensee purement Economique,9,914,6,QCU,0.04,0.98,88.16,70,9,79,79,70,9,1.0,88.61,Facile,Facile,0,Meme Difficulte que la Prediction,Pas Adapte
6243,2020,Sociologie,1,Les Differentes Approches de l'Economie,6,Les Insuffisances d'une Pensee purement Economique,9,914,6,QCU,0.03,0.99,88.08,76,10,86,82,76,6,1.05,92.68,Facile,Facile,0,Meme Difficulte que la Prediction,Pas Adapte
914,2015,Sociologie,1,Les Differentes Approches de l'Economie,6,Les Insuffisances d'une Pensee purement Economique,9,915,7,QROC,0.79,0.04,19.62,16,64,80,71,16,55,1.13,22.54,Facile,Difficile,-2,Beaucoup plus Difficile que la Prediction,Pas Adapte
1980,2016,Sociologie,1,Les Differentes Approches de l'Economie,6,Les Insuffisances d'une Pensee purement Economique,9,915,7,QROC,0.55,0.28,63.53,56,32,88,78,56,22,1.13,71.79,Facile,Moyen,-1,Plus Difficile que la Prediction,Adapte
3046,2017,Sociologie,1,Les Differentes Approches de l'Economie,6,Les Insuffisances d'une Pensee purement Economique,9,915,7,QO,0.33,0.27,63.53,64,37,101,77,64,13,1.31,83.12,Moyen,Moyen,0,Meme Difficulte que la Prediction,Adapte
4112,2018,Sociologie,1,Les Differentes Approches de l'Economie,6,Les Insuffisances d'une Pensee purement Economique,9,915,7,QROC,0.33,0.27,63.53,59,34,93,78,59,19,1.19,75.64,Moyen,Moyen,0,Meme Difficulte que la Prediction,Adapte
5178,2019,Sociologie,1,Les Differentes Approches de l'Economie,6,Les Insuffisances d'une Pensee purement Economique,9,915,7,QROC,0.6,0.27,63.53,50,29,79,62,50,12,1.27,80.65,Moyen,Moyen,0,Meme Difficulte que la Prediction,Adapte
6244,2020,Sociologie,1,Les Differentes Approches de l'Economie,6,Les Insuffisances d'une Pensee purement Economique,9,915,7,QROC,0.21,0.26,63.53,52,30,82,59,52,7,1.39,88.14,Moyen,Moyen,0,Meme Difficulte que la Prediction,Adapte
915,2015,Sociologie,1,Les Differentes Approches de l'Economie,6,Les Insuffisances d'une Pensee purement Economique,9,916,8,QROC,0.04,0.94,93.69,80,5,85,81,80,1,1.05,98.77,Facile,Facile,0,Meme Difficulte que la Prediction,Pas Adapte
1981,2016,Sociologie,1,Les Differentes Approches de l'Economie,6,Les Insuffisances d'une Pensee purement Economique,9,916,8,QCU,0.06,0.89,94.78,86,5,91,88,86,2,1.03,97.73,Facile,Facile,0,Meme Difficulte que la Prediction,Pas Adapte
3047,2017,Sociologie,1,Les Differentes Approches de l'Economie,6,Les Insuffisances d'une Pensee purement Economique,9,916,8,QCU,0.29,0.44,44.26,42,52,94,55,42,13,1.71,76.36,Moyen,Moyen,0,Meme Difficulte que la Prediction,Pas Adapte
4113,2018,Sociologie,1,Les Differentes Approches de l'Economie,6,Les Insuffisances d'une Pensee purement Economique,9,916,8,QCU,0.14,0.97,83.68,69,13,82,72,69,3,1.14,95.83,Moyen,Facile,1,Plus Facile que la Prediction,Pas Adapte
5179,2019,Sociologie,1,Les Differentes Approches de l'Economie,6,Les Insuffisances d'une Pensee purement Economique,9,916,8,QCU,0.06,0.97,75.45,66,22,88,72,66,6,1.22,91.67,Moyen,Facile,1,Plus Facile que la Prediction,Pas Adapte
6245,2020,Sociologie,1,Les Differentes Approches de l'Economie,6,Les Insuffisances d'une Pensee purement Economique,9,916,8,QCU,0.09,0.86,91.35,72,7,79,73,72,1,1.08,98.63,Moyen,Facile,1,Plus Facile que la Prediction,Pas Adapte
916,2015,Sociologie,1,Les Differentes Approches de l'Economie,6,Les Insuffisances d'une Pensee purement Economique,9,917,9,QCU,0.28,0.41,44.21,31,38,69,55,31,24,1.25,56.36,Facile,Moyen,-1,Plus Difficile que la Prediction,Pas Adapte
1982,2016,Sociologie,1,Les Differentes Approches de l'Economie,6,Les Insuffisances d'une Pensee purement Economique,9,917,9,QCU,0.13,0.76,74.32,54,18,72,63,54,9,1.14,85.71,Facile,Facile,0,Meme Difficulte que la Prediction,Adapte
3048,2017,Sociologie,1,Les Differentes Approches de l'Economie,6,Les Insuffisances d'une Pensee purement Economique,9,917,9,QCM,0.13,0.73,74.32,59,20,79,73,59,14,1.08,80.82,Facile,Facile,0,Meme Difficulte que la Prediction,Adapte
4114,2018,Sociologie,1,Les Differentes Approches de l'Economie,6,Les Insuffisances d'une Pensee purement Economique,9,917,9,QCM,0.07,0.95,74.32,58,20,78,71,58,13,1.1,81.69,Facile,Facile,0,Meme Difficulte que la Prediction,Adapte
5180,2019,Sociologie,1,Les Differentes Approches de l'Economie,6,Les Insuffisances d'une Pensee purement Economique,9,917,9,QCM,0.07,0.76,74.32,58,20,78,74,58,16,1.05,78.38,Facile,Facile,0,Meme Difficulte que la Prediction,Adapte
6246,2020,Sociologie,1,Les Differentes Approches de l'Economie,6,Les Insuffisances d'une Pensee purement Economique,9,917,9,QCM,0.11,0.96,74.32,66,23,89,72,66,6,1.24,91.67,Facile,Facile,0,Meme Difficulte que la Prediction,Adapte
917,2015,Sociologie,1,Histoire de la Pensee Economique,1,Introduction,6,918,1,QCU,0.07,0.83,74.31,54,18,72,67,54,13,1.07,80.6,Difficile,Facile,2,Beaucoup plus Facile que la Prediction,Adapte
1983,2016,Sociologie,1,Histoire de la Pensee Economique,1,Introduction,6,918,1,QCM,0.0,0.8,74.31,56,20,76,58,56,2,1.31,96.55,Facile,Facile,0,Meme Difficulte que la Prediction,Adapte
3049,2017,Sociologie,1,Histoire de la Pensee Economique,1,Introduction,6,918,1,QCM,0.09,0.99,74.31,53,18,71,66,53,13,1.08,80.3,Facile,Facile,0,Meme Difficulte que la Prediction,Adapte
4115,2018,Sociologie,1,Histoire de la Pensee Economique,1,Introduction,6,918,1,QCU,0.15,0.82,74.31,51,18,69,56,51,5,1.23,91.07,Facile,Facile,0,Meme Difficulte que la Prediction,Adapte
5181,2019,Sociologie,1,Histoire de la Pensee Economique,1,Introduction,6,918,1,QCU,0.05,0.9,74.31,56,19,75,73,56,17,1.03,76.71,Facile,Facile,0,Meme Difficulte que la Prediction,Adapte
6247,2020,Sociologie,1,Histoire de la Pensee Economique,1,Introduction,6,918,1,QCU,0.11,0.95,74.31,56,19,75,65,56,9,1.15,86.15,Facile,Facile,0,Meme Difficulte que la Prediction,Adapte
918,2015,Sociologie,1,Histoire de la Pensee Economique,1,Introduction,6,919,2,QCU,0.53,0.28,27.88,15,40,55,27,15,12,2.04,55.56,Difficile,Difficile,0,Meme Difficulte que la Prediction,Pas Adapte
1984,2016,Sociologie,1,Histoire de la Pensee Economique,1,Introduction,6,919,2,QCU,0.46,0.25,30.89,18,40,58,32,18,14,1.81,56.25,Difficile,Difficile,0,Meme Difficulte que la Prediction,Pas Adapte
3050,2017,Sociologie,1,Histoire de la Pensee Economique,1,Introduction,6,919,2,QCU,0.45,0.21,15.88,9,49,58,51,9,42,1.14,17.65,Moyen,Difficile,-1,Plus Difficile que la Prediction,Pas Adapte
4116,2018,Sociologie,1,Histoire de la Pensee Economique,1,Introduction,6,919,2,QCM,0.13,0.76,77.58,49,14,63,60,49,11,1.05,81.67,Difficile,Facile,2,Beaucoup plus Facile que la Prediction,Pas Adapte
5182,2019,Sociologie,1,Histoire de la Pensee Economique,1,Introduction,6,919,2,QCM,0.57,0.23,3.47,2,67,69,37,2,35,1.86,5.41,Difficile,Difficile,0,Meme Difficulte que la Prediction,Pas Adapte
6248,2020,Sociologie,1,Histoire de la Pensee Economique,1,Introduction,6,919,2,QCU,0.31,0.53,41.06,29,42,71,58,29,29,1.22,50.0,Moyen,Moyen,0,Meme Difficulte que la Prediction,Pas Adapte
919,2015,Sociologie,1,Histoire de la Pensee Economique,1,Introduction,6,920,3,QCU,0.31,0.49,49.67,28,29,57,29,28,1,1.97,96.55,Difficile,Moyen,1,Plus Facile que la Prediction,Pas Adapte
1985,2016,Sociologie,1,Histoire de la Pensee Economique,1,Introduction,6,920,3,QCU,0.02,1.0,73.47,42,15,57,53,42,11,1.08,79.25,Facile,Facile,0,Meme Difficulte que la Prediction,Adapte
3051,2017,Sociologie,1,Histoire de la Pensee Economique,1,Introduction,6,920,3,QCU,0.15,0.93,73.47,37,13,50,47,37,10,1.06,78.72,Facile,Facile,0,Meme Difficulte que la Prediction,Adapte
4117,2018,Sociologie,1,Histoire de la Pensee Economique,1,Introduction,6,920,3,QROC,0.06,0.79,73.47,31,11,42,40,31,9,1.05,77.5,Facile,Facile,0,Meme Difficulte que la Prediction,Adapte
5183,2019,Sociologie,1,Histoire de la Pensee Economique,1,Introduction,6,920,3,QO,0.11,0.83,73.47,28,10,38,37,28,9,1.03,75.68,Facile,Facile,0,Meme Difficulte que la Prediction,Adapte
6249,2020,Sociologie,1,Histoire de la Pensee Economique,1,Introduction,6,920,3,QO,0.12,0.44,73.47,32,12,44,41,32,9,1.07,78.05,Facile,Facile,0,Meme Difficulte que la Prediction,Adapte
920,2015,Sociologie,1,Histoire de la Pensee Economique,1,Introduction,6,921,4,QCU,0.12,0.97,88.8,43,5,48,46,43,3,1.04,93.48,Difficile,Facile,2,Beaucoup plus Facile que la Prediction,Pas Adapte
1986,2016,Sociologie,1,Histoire de la Pensee Economique,1,Introduction,6,921,4,QCM,0.64,0.21,6.28,3,50,53,22,3,19,2.41,13.64,Difficile,Difficile,0,Meme Difficulte que la Prediction,Pas Adapte
3052,2017,Sociologie,1,Histoire de la Pensee Economique,1,Introduction,6,921,4,QCM,0.12,0.79,78.18,42,12,54,44,42,2,1.23,95.45,Facile,Facile,0,Meme Difficulte que la Prediction,Pas Adapte
4118,2018,Sociologie,1,Histoire de la Pensee Economique,1,Introduction,6,921,4,QCM,0.69,0.2,34.85,22,40,62,49,22,27,1.27,44.9,Facile,Difficile,-2,Beaucoup plus Difficile que la Prediction,Pas Adapte
5184,2019,Sociologie,1,Histoire de la Pensee Economique,1,Introduction,6,921,4,QCM,0.01,0.85,84.14,46,9,55,47,46,1,1.17,97.87,Facile,Facile,0,Meme Difficulte que la Prediction,Pas Adapte
6250,2020,Sociologie,1,Histoire de la Pensee Economique,1,Introduction,6,921,4,QROC,0.7,0.04,13.75,7,43,50,36,7,29,1.39,19.44,Difficile,Difficile,0,Meme Difficulte que la Prediction,Pas Adapte
921,2015,Sociologie,1,Histoire de la Pensee Economique,1,Introduction,6,922,5,QROC,0.15,0.93,70.0,69,29,98,85,69,16,1.15,81.18,Facile,Facile,0,Meme Difficulte que la Prediction,Adapte
1987,2016,Sociologie,1,Histoire de la Pensee Economique,1,Introduction,6,922,5,QROC,0.07,0.59,70.0,71,30,101,80,71,9,1.26,88.75,Facile,Facile,0,Meme Difficulte que la Prediction,Adapte
3053,2017,Sociologie,1,Histoire de la Pensee Economique,1,Introduction,6,922,5,QROC,0.12,0.98,70.0,77,33,110,104,77,27,1.06,74.04,Facile,Facile,0,Meme Difficulte que la Prediction,Adapte
4119,2018,Sociologie,1,Histoire de la Pensee Economique,1,Introduction,6,922,5,QROC,0.15,0.91,70.0,72,31,103,73,72,1,1.41,98.63,Facile,Facile,0,Meme Difficulte que la Prediction,Adapte
5185,2019,Sociologie,1,Histoire de la Pensee Economique,1,Introduction,6,922,5,QO,0.09,0.5,70.0,81,34,115,89,81,8,1.29,91.01,Facile,Facile,0,Meme Difficulte que la Prediction,Adapte
6251,2020,Sociologie,1,Histoire de la Pensee Economique,1,Introduction,6,922,5,QO,0.05,0.35,70.0,77,33,110,97,77,20,1.13,79.38,Facile,Facile,0,Meme Difficulte que la Prediction,Adapte
922,2015,Sociologie,1,Histoire de la Pensee Economique,1,Introduction,6,923,6,QCM,0.53,0.22,4.31,1,26,27,7,1,6,3.86,14.29,Difficile,Difficile,0,Meme Difficulte que la Prediction,Pas Adapte
1988,2016,Sociologie,1,Histoire de la Pensee Economique,1,Introduction,6,923,6,QCM,0.34,0.53,58.46,18,12,30,21,18,3,1.43,85.71,Facile,Moyen,-1,Plus Difficile que la Prediction,Pas Adapte
3054,2017,Sociologie,1,Histoire de la Pensee Economique,1,Introduction,6,923,6,QCM,0.5,0.3,11.85,4,29,33,22,4,18,1.5,18.18,Difficile,Difficile,0,Meme Difficulte que la Prediction,Pas Adapte
4120,2018,Sociologie,1,Histoire de la Pensee Economique,1,Introduction,6,923,6,QCM,0.74,0.23,32.7,9,19,28,11,9,2,2.55,81.82,Difficile,Difficile,0,Meme Difficulte que la Prediction,Pas Adapte
5186,2019,Sociologie,1,Histoire de la Pensee Economique,1,Introduction,6,923,6,QROC,0.87,0.24,10.44,3,24,27,27,3,24,1.0,11.11,Facile,Difficile,-2,Beaucoup plus Difficile que la Prediction,Pas Adapte
6252,2020,Sociologie,1,Histoire de la Pensee Economique,1,Introduction,6,923,6,QROC,0.97,0.03,10.06,2,21,23,18,2,16,1.28,11.11,Facile,Difficile,-2,Beaucoup plus Difficile que la Prediction,Pas Adapte
923,2015,Sociologie,1,Histoire de la Pensee Economique,2,La Formation de la Pensee Economique jusqu'a Adam Smith,14,924,1,QCU,0.09,0.93,81.04,75,17,92,83,75,8,1.11,90.36,Facile,Facile,0,Meme Difficulte que la Prediction,Pas Adapte
1989,2016,Sociologie,1,Histoire de la Pensee Economique,2,La Formation de la Pensee Economique jusqu'a Adam Smith,14,924,1,QCU,0.46,0.31,15.3,13,72,85,63,13,50,1.35,20.63,Difficile,Difficile,0,Meme Difficulte que la Prediction,Pas Adapte
3055,2017,Sociologie,1,Histoire de la Pensee Economique,2,La Formation de la Pensee Economique jusqu'a Adam Smith,14,924,1,QCM,0.32,0.53,61.61,48,30,78,73,48,25,1.07,65.75,Moyen,Moyen,0,Meme Difficulte que la Prediction,Adapte
4121,2018,Sociologie,1,Histoire de la Pensee Economique,2,La Formation de la Pensee Economique jusqu'a Adam Smith,14,924,1,QCM,0.45,0.64,61.61,49,31,80,80,49,31,1.0,61.25,Moyen,Moyen,0,Meme Difficulte que la Prediction,Adapte
5187,2019,Sociologie,1,Histoire de la Pensee Economique,2,La Formation de la Pensee Economique jusqu'a Adam Smith,14,924,1,QCM,0.43,0.4,61.61,44,28,72,55,44,11,1.31,80.0,Moyen,Moyen,0,Meme Difficulte que la Prediction,Adapte
6253,2020,Sociologie,1,Histoire de la Pensee Economique,2,La Formation de la Pensee Economique jusqu'a Adam Smith,14,924,1,QCM,0.22,0.6,61.61,49,30,79,52,49,3,1.52,94.23,Moyen,Moyen,0,Meme Difficulte que la Prediction,Adapte
924,2015,Sociologie,1,Histoire de la Pensee Economique,2,La Formation de la Pensee Economique jusqu'a Adam Smith,14,925,2,QCM,0.66,0.16,29.12,29,69,98,92,29,63,1.07,31.52,Difficile,Difficile,0,Meme Difficulte que la Prediction,Pas Adapte
1990,2016,Sociologie,1,Histoire de la Pensee Economique,2,La Formation de la Pensee Economique jusqu'a Adam Smith,14,925,2,QCM,0.77,0.23,29.42,30,71,101,84,30,54,1.2,35.71,Difficile,Difficile,0,Meme Difficulte que la Prediction,Pas Adapte
3056,2017,Sociologie,1,Histoire de la Pensee Economique,2,La Formation de la Pensee Economique jusqu'a Adam Smith,14,925,2,QCM,0.1,0.86,98.37,108,2,110,108,108,0,1.02,100.0,Facile,Facile,0,Meme Difficulte que la Prediction,Pas Adapte
4122,2018,Sociologie,1,Histoire de la Pensee Economique,2,La Formation de la Pensee Economique jusqu'a Adam Smith,14,925,2,QCM,0.13,0.89,65.53,62,32,94,91,62,29,1.03,68.13,Facile,Facile,0,Meme Difficulte que la Prediction,Adapte
5188,2019,Sociologie,1,Histoire de la Pensee Economique,2,La Formation de la Pensee Economique jusqu'a Adam Smith,14,925,2,QCM,0.11,0.73,65.53,62,33,95,81,62,19,1.17,76.54,Facile,Facile,0,Meme Difficulte que la Prediction,Adapte
6254,2020,Sociologie,1,Histoire de la Pensee Economique,2,La Formation de la Pensee Economique jusqu'a Adam Smith,14,925,2,QCM,0.03,0.99,65.53,63,33,96,86,63,23,1.12,73.26,Facile,Facile,0,Meme Difficulte que la Prediction,Adapte
925,2015,Sociologie,1,Histoire de la Pensee Economique,2,La Formation de la Pensee Economique jusqu'a Adam Smith,14,926,3,QCM,0.3,0.36,56.3,28,22,50,41,28,13,1.22,68.29,Difficile,Moyen,1,Plus Facile que la Prediction,Pas Adapte
1991,2016,Sociologie,1,Histoire de la Pensee Economique,2,La Formation de la Pensee Economique jusqu'a Adam Smith,14,926,3,QCM,0.15,0.72,74.42,36,12,48,38,36,2,1.26,94.74,Moyen,Facile,1,Plus Facile que la Prediction,Adapte
3057,2017,Sociologie,1,Histoire de la Pensee Economique,2,La Formation de la Pensee Economique jusqu'a Adam Smith,14,926,3,QO,0.16,0.63,74.42,39,13,52,42,39,3,1.24,92.86,Facile,Facile,0,Meme Difficulte que la Prediction,Adapte
4123,2018,Sociologie,1,Histoire de la Pensee Economique,2,La Formation de la Pensee Economique jusqu'a Adam Smith,14,926,3,QO,0.11,0.74,74.42,39,14,53,39,39,0,1.36,100.0,Facile,Facile,0,Meme Difficulte que la Prediction,Adapte
5189,2019,Sociologie,1,Histoire de la Pensee Economique,2,La Formation de la Pensee Economique jusqu'a Adam Smith,14,926,3,QCM,0.11,0.78,74.42,41,14,55,48,41,7,1.15,85.42,Facile,Facile,0,Meme Difficulte que la Prediction,Adapte
6255,2020,Sociologie,1,Histoire de la Pensee Economique,2,La Formation de la Pensee Economique jusqu'a Adam Smith,14,926,3,QCM,0.07,0.86,74.42,37,13,50,43,37,6,1.16,86.05,Facile,Facile,0,Meme Difficulte que la Prediction,Adapte
926,2015,Sociologie,1,Histoire de la Pensee Economique,2,La Formation de la Pensee Economique jusqu'a Adam Smith,14,927,4,QCM,0.12,0.74,95.72,58,3,61,59,58,1,1.03,98.31,Facile,Facile,0,Meme Difficulte que la Prediction,Pas Adapte
1992,2016,Sociologie,1,Histoire de la Pensee Economique,2,La Formation de la Pensee Economique jusqu'a Adam Smith,14,927,4,QCM,0.2,0.42,35.04,21,38,59,50,21,29,1.18,42.0,Facile,Moyen,-1,Plus Difficile que la Prediction,Pas Adapte
3058,2017,Sociologie,1,Histoire de la Pensee Economique,2,La Formation de la Pensee Economique jusqu'a Adam Smith,14,927,4,QCU,0.55,0.24,22.21,15,53,68,26,15,11,2.62,57.69,Difficile,Difficile,0,Meme Difficulte que la Prediction,Pas Adapte
4124,2018,Sociologie,1,Histoire de la Pensee Economique,2,La Formation de la Pensee Economique jusqu'a Adam Smith,14,927,4,QCU,0.25,0.54,55.92,35,28,63,56,35,21,1.12,62.5,Moyen,Moyen,0,Meme Difficulte que la Prediction,Pas Adapte
5190,2019,Sociologie,1,Histoire de la Pensee Economique,2,La Formation de la Pensee Economique jusqu'a Adam Smith,14,927,4,QCU,0.5,0.22,31.43,17,38,55,55,17,38,1.0,30.91,Difficile,Difficile,0,Meme Difficulte que la Prediction,Pas Adapte
6256,2020,Sociologie,1,Histoire de la Pensee Economique,2,La Formation de la Pensee Economique jusqu'a Adam Smith,14,927,4,QCU,0.72,0.33,22.11,12,42,54,36,12,24,1.5,33.33,Difficile,Difficile,0,Meme Difficulte que la Prediction,Pas Adapte
927,2015,Sociologie,1,Histoire de la Pensee Economique,2,La Formation de la Pensee Economique jusqu'a Adam Smith,14,928,5,QCM,0.14,0.76,87.64,49,7,56,51,49,2,1.1,96.08,Difficile,Facile,2,Beaucoup plus Facile que la Prediction,Pas Adapte
1993,2016,Sociologie,1,Histoire de la Pensee Economique,2,La Formation de la Pensee Economique jusqu'a Adam Smith,14,928,5,QCM,0.74,0.19,10.53,5,45,50,43,5,38,1.16,11.63,Difficile,Difficile,0,Meme Difficulte que la Prediction,Pas Adapte
3059,2017,Sociologie,1,Histoire de la Pensee Economique,2,La Formation de la Pensee Economique jusqu'a Adam Smith,14,928,5,QCM,0.2,0.37,43.54,23,29,52,33,23,10,1.58,69.7,Moyen,Moyen,0,Meme Difficulte que la Prediction,Pas Adapte
4125,2018,Sociologie,1,Histoire de la Pensee Economique,2,La Formation de la Pensee Economique jusqu'a Adam Smith,14,928,5,QCM,0.42,0.52,60.06,32,21,53,36,32,4,1.47,88.89,Difficile,Moyen,1,Plus Facile que la Prediction,Adapte
5191,2019,Sociologie,1,Histoire de la Pensee Economique,2,La Formation de la Pensee Economique jusqu'a Adam Smith,14,928,5,QCM,0.41,0.35,60.06,31,21,52,33,31,2,1.58,93.94,Moyen,Moyen,0,Meme Difficulte que la Prediction,Adapte
6257,2020,Sociologie,1,Histoire de la Pensee Economique,2,La Formation de la Pensee Economique jusqu'a Adam Smith,14,928,5,QCM,0.36,0.61,60.06,32,21,53,45,32,13,1.18,71.11,Moyen,Moyen,0,Meme Difficulte que la Prediction,Adapte
928,2015,Sociologie,1,Histoire de la Pensee Economique,2,La Formation de la Pensee Economique jusqu'a Adam Smith,14,929,6,QROC,0.47,0.37,42.68,29,40,69,63,29,34,1.1,46.03,Facile,Moyen,-1,Plus Difficile que la Prediction,Pas Adapte
1994,2016,Sociologie,1,Histoire de la Pensee Economique,2,La Formation de la Pensee Economique jusqu'a Adam Smith,14,929,6,QROC,0.17,0.66,76.93,55,17,72,58,55,3,1.24,94.83,Difficile,Facile,2,Beaucoup plus Facile que la Prediction,Pas Adapte
3060,2017,Sociologie,1,Histoire de la Pensee Economique,2,La Formation de la Pensee Economique jusqu'a Adam Smith,14,929,6,QO,0.1,0.7,87.31,53,8,61,56,53,3,1.09,94.64,Facile,Facile,0,Meme Difficulte que la Prediction,Pas Adapte
4126,2018,Sociologie,1,Histoire de la Pensee Economique,2,La Formation de la Pensee Economique jusqu'a Adam Smith,14,929,6,QO,0.69,0.25,63.06,38,22,60,59,38,21,1.02,64.41,Moyen,Moyen,0,Meme Difficulte que la Prediction,Adapte
5192,2019,Sociologie,1,Histoire de la Pensee Economique,2,La Formation de la Pensee Economique jusqu'a Adam Smith,14,929,6,QO,0.32,0.2,63.06,40,23,63,43,40,3,1.47,93.02,Moyen,Moyen,0,Meme Difficulte que la Prediction,Adapte
6258,2020,Sociologie,1,Histoire de la Pensee Economique,2,La Formation de la Pensee Economique jusqu'a Adam Smith,14,929,6,QO,0.64,0.17,63.06,34,20,54,39,34,5,1.38,87.18,Moyen,Moyen,0,Meme Difficulte que la Prediction,Adapte
929,2015,Sociologie,1,Histoire de la Pensee Economique,2,La Formation de la Pensee Economique jusqu'a Adam Smith,14,930,7,QCM,0.65,0.17,3.81,3,68,71,61,3,58,1.16,4.92,Facile,Difficile,-2,Beaucoup plus Difficile que la Prediction,Pas Adapte
1995,2016,Sociologie,1,Histoire de la Pensee Economique,2,La Formation de la Pensee Economique jusqu'a Adam Smith,14,930,7,QCM,0.24,0.41,57.28,40,30,70,67,40,27,1.04,59.7,Moyen,Moyen,0,Meme Difficulte que la Prediction,Pas Adapte
3061,2017,Sociologie,1,Histoire de la Pensee Economique,2,La Formation de la Pensee Economique jusqu'a Adam Smith,14,930,7,QCM,0.12,0.87,99.98,78,0,78,78,78,0,1.0,100.0,Facile,Facile,0,Meme Difficulte que la Prediction,Pas Adapte
4127,2018,Sociologie,1,Histoire de la Pensee Economique,2,La Formation de la Pensee Economique jusqu'a Adam Smith,14,930,7,QCM,0.32,0.52,44.83,30,38,68,55,30,25,1.24,54.55,Facile,Moyen,-1,Plus Difficile que la Prediction,Pas Adapte
5193,2019,Sociologie,1,Histoire de la Pensee Economique,2,La Formation de la Pensee Economique jusqu'a Adam Smith,14,930,7,QCM,0.44,0.47,52.0,36,33,69,58,36,22,1.19,62.07,Moyen,Moyen,0,Meme Difficulte que la Prediction,Pas Adapte
6259,2020,Sociologie,1,Histoire de la Pensee Economique,2,La Formation de la Pensee Economique jusqu'a Adam Smith,14,930,7,QCU,0.72,0.29,14.15,9,52,61,61,9,52,1.0,14.75,Facile,Difficile,-2,Beaucoup plus Difficile que la Prediction,Pas Adapte
930,2015,Sociologie,1,Histoire de la Pensee Economique,2,La Formation de la Pensee Economique jusqu'a Adam Smith,14,931,8,QCU,0.36,0.64,36.8,13,22,35,30,13,17,1.17,43.33,Moyen,Moyen,0,Meme Difficulte que la Prediction,Pas Adapte
1996,2016,Sociologie,1,Histoire de la Pensee Economique,2,La Formation de la Pensee Economique jusqu'a Adam Smith,14,931,8,QCU,0.27,0.46,53.07,16,15,31,25,16,9,1.24,64.0,Moyen,Moyen,0,Meme Difficulte que la Prediction,Pas Adapte
3062,2017,Sociologie,1,Histoire de la Pensee Economique,2,La Formation de la Pensee Economique jusqu'a Adam Smith,14,931,8,QCU,0.45,0.39,20.55,7,29,36,23,7,16,1.57,30.43,Moyen,Difficile,-1,Plus Difficile que la Prediction,Pas Adapte
4128,2018,Sociologie,1,Histoire de la Pensee Economique,2,La Formation de la Pensee Economique jusqu'a Adam Smith,14,931,8,QCU,0.67,0.38,17.91,7,30,37,24,7,17,1.54,29.17,Difficile,Difficile,0,Meme Difficulte que la Prediction,Pas Adapte
5194,2019,Sociologie,1,Histoire de la Pensee Economique,2,La Formation de la Pensee Economique jusqu'a Adam Smith,14,931,8,QCU,0.31,0.5,48.97,21,22,43,41,21,20,1.05,51.22,Difficile,Moyen,1,Plus Facile que la Prediction,Pas Adapte
6260,2020,Sociologie,1,Histoire de la Pensee Economique,2,La Formation de la Pensee Economique jusqu'a Adam Smith,14,931,8,QCU,0.32,0.67,64.97,25,13,38,32,25,7,1.19,78.12,Moyen,Moyen,0,Meme Difficulte que la Prediction,Adapte
931,2015,Sociologie,1,Histoire de la Pensee Economique,2,La Formation de la Pensee Economique jusqu'a Adam Smith,14,932,9,QO,0.87,0.03,3.67,3,87,90,53,3,50,1.7,5.66,Difficile,Difficile,0,Meme Difficulte que la Prediction,Pas Adapte
1997,2016,Sociologie,1,Histoire de la Pensee Economique,2,La Formation de la Pensee Economique jusqu'a Adam Smith,14,932,9,QO,0.32,0.18,45.73,45,53,98,65,45,20,1.51,69.23,Moyen,Moyen,0,Meme Difficulte que la Prediction,Pas Adapte
3063,2017,Sociologie,1,Histoire de la Pensee Economique,2,La Formation de la Pensee Economique jusqu'a Adam Smith,14,932,9,QROC,0.19,0.87,73.28,82,30,112,106,82,24,1.06,77.36,Facile,Facile,0,Meme Difficulte que la Prediction,Adapte
4129,2018,Sociologie,1,Histoire de la Pensee Economique,2,La Formation de la Pensee Economique jusqu'a Adam Smith,14,932,9,QROC,0.05,0.98,73.28,92,33,125,110,92,18,1.14,83.64,Facile,Facile,0,Meme Difficulte que la Prediction,Adapte
5195,2019,Sociologie,1,Histoire de la Pensee Economique,2,La Formation de la Pensee Economique jusqu'a Adam Smith,14,932,9,QO,0.06,0.54,73.28,105,38,143,138,105,33,1.04,76.09,Facile,Facile,0,Meme Difficulte que la Prediction,Adapte
6261,2020,Sociologie,1,Histoire de la Pensee Economique,2,La Formation de la Pensee Economique jusqu'a Adam Smith,14,932,9,QCM,0.16,0.76,73.28,114,42,156,149,114,35,1.05,76.51,Facile,Facile,0,Meme Difficulte que la Prediction,Adapte
932,2015,Sociologie,1,Histoire de la Pensee Economique,2,La Formation de la Pensee Economique jusqu'a Adam Smith,14,933,10,QCU,0.66,0.34,9.65,7,68,75,72,7,65,1.04,9.72,Difficile,Difficile,0,Meme Difficulte que la Prediction,Pas Adapte
1998,2016,Sociologie,1,Histoire de la Pensee Economique,2,La Formation de la Pensee Economique jusqu'a Adam Smith,14,933,10,QCU,0.46,0.35,2.27,2,67,69,62,2,60,1.11,3.23,Difficile,Difficile,0,Meme Difficulte que la Prediction,Pas Adapte
3064,2017,Sociologie,1,Histoire de la Pensee Economique,2,La Formation de la Pensee Economique jusqu'a Adam Smith,14,933,10,QCU,0.02,0.92,79.89,59,15,74,61,59,2,1.21,96.72,Moyen,Facile,1,Plus Facile que la Prediction,Pas Adapte
4130,2018,Sociologie,1,Histoire de la Pensee Economique,2,La Formation de la Pensee Economique jusqu'a Adam Smith,14,933,10,QCU,0.55,0.25,0.87,1,63,64,51,1,50,1.25,1.96,Difficile,Difficile,0,Meme Difficulte que la Prediction,Pas Adapte
5196,2019,Sociologie,1,Histoire de la Pensee Economique,2,La Formation de la Pensee Economique jusqu'a Adam Smith,14,933,10,QCU,0.06,0.92,66.71,42,21,63,51,42,9,1.24,82.35,Difficile,Facile,2,Beaucoup plus Facile que la Prediction,Adapte
6262,2020,Sociologie,1,Histoire de la Pensee Economique,2,La Formation de la Pensee Economique jusqu'a Adam Smith,14,933,10,QCU,0.06,0.88,66.71,37,18,55,44,37,7,1.25,84.09,Facile,Facile,0,Meme Difficulte que la Prediction,Adapte
933,2015,Sociologie,1,Histoire de la Pensee Economique,2,La Formation de la Pensee Economique jusqu'a Adam Smith,14,934,11,QCU,0.12,0.77,90.16,42,5,47,46,42,4,1.02,91.3,Difficile,Facile,2,Beaucoup plus Facile que la Prediction,Pas Adapte
1999,2016,Sociologie,1,Histoire de la Pensee Economique,2,La Formation de la Pensee Economique jusqu'a Adam Smith,14,934,11,QCU,0.29,0.47,39.5,20,31,51,41,20,21,1.24,48.78,Moyen,Moyen,0,Meme Difficulte que la Prediction,Pas Adapte
3065,2017,Sociologie,1,Histoire de la Pensee Economique,2,La Formation de la Pensee Economique jusqu'a Adam Smith,14,934,11,QCU,0.45,0.33,12.76,6,38,44,32,6,26,1.38,18.75,Difficile,Difficile,0,Meme Difficulte que la Prediction,Pas Adapte
4131,2018,Sociologie,1,Histoire de la Pensee Economique,2,La Formation de la Pensee Economique jusqu'a Adam Smith,14,934,11,QCU,0.57,0.4,5.71,2,35,37,34,2,32,1.09,5.88,Difficile,Difficile,0,Meme Difficulte que la Prediction,Pas Adapte
5197,2019,Sociologie,1,Histoire de la Pensee Economique,2,La Formation de la Pensee Economique jusqu'a Adam Smith,14,934,11,QCU,0.26,0.48,63.62,22,12,34,34,22,12,1.0,64.71,Facile,Moyen,-1,Plus Difficile que la Prediction,Adapte
6263,2020,Sociologie,1,Histoire de la Pensee Economique,2,La Formation de la Pensee Economique jusqu'a Adam Smith,14,934,11,QCU,0.31,0.44,63.62,22,12,34,34,22,12,1.0,64.71,Moyen,Moyen,0,Meme Difficulte que la Prediction,Adapte
934,2015,Sociologie,1,Histoire de la Pensee Economique,2,La Formation de la Pensee Economique jusqu'a Adam Smith,14,935,12,QCU,0.34,0.71,54.62,51,43,94,67,51,16,1.4,76.12,Moyen,Moyen,0,Meme Difficulte que la Prediction,Pas Adapte
2000,2016,Sociologie,1,Histoire de la Pensee Economique,2,La Formation de la Pensee Economique jusqu'a Adam Smith,14,935,12,QCU,0.07,0.76,72.2,64,25,89,76,64,12,1.17,84.21,Facile,Facile,0,Meme Difficulte que la Prediction,Adapte
3066,2017,Sociologie,1,Histoire de la Pensee Economique,2,La Formation de la Pensee Economique jusqu'a Adam Smith,14,935,12,QCU,0.15,0.84,72.2,72,28,100,92,72,20,1.09,78.26,Facile,Facile,0,Meme Difficulte que la Prediction,Adapte
4132,2018,Sociologie,1,Histoire de la Pensee Economique,2,La Formation de la Pensee Economique jusqu'a Adam Smith,14,935,12,QCU,0.06,0.75,72.2,83,32,115,102,83,19,1.13,81.37,Facile,Facile,0,Meme Difficulte que la Prediction,Adapte
5198,2019,Sociologie,1,Histoire de la Pensee Economique,2,La Formation de la Pensee Economique jusqu'a Adam Smith,14,935,12,QCU,0.09,0.92,72.2,82,31,113,88,82,6,1.28,93.18,Facile,Facile,0,Meme Difficulte que la Prediction,Adapte
6264,2020,Sociologie,1,Histoire de la Pensee Economique,2,La Formation de la Pensee Economique jusqu'a Adam Smith,14,935,12,QCU,0.2,0.94,72.2,73,28,101,95,73,22,1.06,76.84,Facile,Facile,0,Meme Difficulte que la Prediction,Adapte
935,2015,Sociologie,1,Histoire de la Pensee Economique,2,La Formation de la Pensee Economique jusqu'a Adam Smith,14,936,13,QCM,0.36,0.37,56.77,45,35,80,46,45,1,1.74,97.83,Difficile,Moyen,1,Plus Facile que la Prediction,Pas Adapte
2001,2016,Sociologie,1,Histoire de la Pensee Economique,2,La Formation de la Pensee Economique jusqu'a Adam Smith,14,936,13,QCM,0.12,0.79,72.0,55,22,77,77,55,22,1.0,71.43,Facile,Facile,0,Meme Difficulte que la Prediction,Adapte
3067,2017,Sociologie,1,Histoire de la Pensee Economique,2,La Formation de la Pensee Economique jusqu'a Adam Smith,14,936,13,QCM,0.11,0.79,72.0,62,24,86,76,62,14,1.13,81.58,Facile,Facile,0,Meme Difficulte que la Prediction,Adapte
4133,2018,Sociologie,1,Histoire de la Pensee Economique,2,La Formation de la Pensee Economique jusqu'a Adam Smith,14,936,13,QCU,0.13,0.86,72.0,57,22,79,76,57,19,1.04,75.0,Facile,Facile,0,Meme Difficulte que la Prediction,Adapte
5199,2019,Sociologie,1,Histoire de la Pensee Economique,2,La Formation de la Pensee Economique jusqu'a Adam Smith,14,936,13,QCM,0.09,0.76,72.0,49,19,68,59,49,10,1.15,83.05,Facile,Facile,0,Meme Difficulte que la Prediction,Adapte
6265,2020,Sociologie,1,Histoire de la Pensee Economique,2,La Formation de la Pensee Economique jusqu'a Adam Smith,14,936,13,QCM,0.01,0.82,72.0,48,19,67,56,48,8,1.2,85.71,Facile,Facile,0,Meme Difficulte que la Prediction,Adapte
936,2015,Sociologie,1,Histoire de la Pensee Economique,2,La Formation de la Pensee Economique jusqu'a Adam Smith,14,937,14,QCU,0.4,0.32,24.82,22,68,90,90,22,68,1.0,24.44,Moyen,Difficile,-1,Plus Difficile que la Prediction,Pas Adapte
2002,2016,Sociologie,1,Histoire de la Pensee Economique,2,La Formation de la Pensee Economique jusqu'a Adam Smith,14,937,14,QCU,0.64,0.3,16.85,17,81,98,49,17,32,2.0,34.69,Facile,Difficile,-2,Beaucoup plus Difficile que la Prediction,Pas Adapte
3068,2017,Sociologie,1,Histoire de la Pensee Economique,2,La Formation de la Pensee Economique jusqu'a Adam Smith,14,937,14,QCU,0.31,0.56,51.86,50,47,97,73,50,23,1.33,68.49,Difficile,Moyen,1,Plus Facile que la Prediction,Pas Adapte
4134,2018,Sociologie,1,Histoire de la Pensee Economique,2,La Formation de la Pensee Economique jusqu'a Adam Smith,14,937,14,QCU,0.16,0.78,73.85,82,29,111,111,82,29,1.0,73.87,Difficile,Facile,2,Beaucoup plus Facile que la Prediction,Adapte
5200,2019,Sociologie,1,Histoire de la Pensee Economique,2,La Formation de la Pensee Economique jusqu'a Adam Smith,14,937,14,QCU,0.05,0.79,73.85,75,27,102,82,75,7,1.24,91.46,Facile,Facile,0,Meme Difficulte que la Prediction,Adapte
6266,2020,Sociologie,1,Histoire de la Pensee Economique,2,La Formation de la Pensee Economique jusqu'a Adam Smith,14,937,14,QCU,0.07,0.77,73.85,83,29,112,111,83,28,1.01,74.77,Facile,Facile,0,Meme Difficulte que la Prediction,Adapte
937,2015,Sociologie,1,Histoire de la Pensee Economique,3,La Conception Liberale de l'Economie,6,938,1,QCU,0.52,0.3,28.25,8,19,27,27,8,19,1.0,29.63,Difficile,Difficile,0,Meme Difficulte que la Prediction,Pas Adapte
2003,2016,Sociologie,1,Histoire de la Pensee Economique,3,La Conception Liberale de l'Economie,6,938,1,QCU,0.1,0.85,67.39,16,8,24,19,16,3,1.26,84.21,Facile,Facile,0,Meme Difficulte que la Prediction,Adapte
3069,2017,Sociologie,1,Histoire de la Pensee Economique,3,La Conception Liberale de l'Economie,6,938,1,QCU,0.06,0.88,67.39,15,8,23,19,15,4,1.21,78.95,Facile,Facile,0,Meme Difficulte que la Prediction,Adapte
4135,2018,Sociologie,1,Histoire de la Pensee Economique,3,La Conception Liberale de l'Economie,6,938,1,QCM,0.19,0.71,67.39,13,7,20,19,13,6,1.05,68.42,Facile,Facile,0,Meme Difficulte que la Prediction,Adapte
5201,2019,Sociologie,1,Histoire de la Pensee Economique,3,La Conception Liberale de l'Economie,6,938,1,QCM,0.02,0.89,67.39,15,8,23,21,15,6,1.1,71.43,Facile,Facile,0,Meme Difficulte que la Prediction,Adapte
6267,2020,Sociologie,1,Histoire de la Pensee Economique,3,La Conception Liberale de l'Economie,6,938,1,QCM,0.06,0.86,67.39,14,7,21,18,14,4,1.17,77.78,Facile,Facile,0,Meme Difficulte que la Prediction,Adapte
938,2015,Sociologie,1,Histoire de la Pensee Economique,3,La Conception Liberale de l'Economie,6,939,2,QCU,0.62,0.4,22.62,9,33,42,24,9,15,1.75,37.5,Difficile,Difficile,0,Meme Difficulte que la Prediction,Pas Adapte
2004,2016,Sociologie,1,Histoire de la Pensee Economique,3,La Conception Liberale de l'Economie,6,939,2,QCU,0.19,0.96,88.28,41,6,47,43,41,2,1.09,95.35,Facile,Facile,0,Meme Difficulte que la Prediction,Pas Adapte
3070,2017,Sociologie,1,Histoire de la Pensee Economique,3,La Conception Liberale de l'Economie,6,939,2,QCU,0.05,0.88,67.19,32,15,47,33,32,1,1.42,96.97,Difficile,Facile,2,Beaucoup plus Facile que la Prediction,Adapte
4136,2018,Sociologie,1,Histoire de la Pensee Economique,3,La Conception Liberale de l'Economie,6,939,2,QCU,0.08,0.85,67.19,32,16,48,41,32,9,1.17,78.05,Facile,Facile,0,Meme Difficulte que la Prediction,Adapte
5202,2019,Sociologie,1,Histoire de la Pensee Economique,3,La Conception Liberale de l'Economie,6,939,2,QCM,0.1,0.82,67.19,34,16,50,35,34,1,1.43,97.14,Facile,Facile,0,Meme Difficulte que la Prediction,Adapte
6268,2020,Sociologie,1,Histoire de la Pensee Economique,3,La Conception Liberale de l'Economie,6,939,2,QCM,0.18,0.86,67.19,33,16,49,48,33,15,1.02,68.75,Facile,Facile,0,Meme Difficulte que la Prediction,Adapte
939,2015,Sociologie,1,Histoire de la Pensee Economique,3,La Conception Liberale de l'Economie,6,940,3,QCU,0.23,0.65,47.26,42,46,88,49,42,7,1.8,85.71,Moyen,Moyen,0,Meme Difficulte que la Prediction,Pas Adapte
2005,2016,Sociologie,1,Histoire de la Pensee Economique,3,La Conception Liberale de l'Economie,6,940,3,QCU,0.22,0.61,56.15,49,38,87,81,49,32,1.07,60.49,Moyen,Moyen,0,Meme Difficulte que la Prediction,Pas Adapte
3071,2017,Sociologie,1,Histoire de la Pensee Economique,3,La Conception Liberale de l'Economie,6,940,3,QCU,0.01,0.75,79.19,66,17,83,75,66,9,1.11,88.0,Difficile,Facile,2,Beaucoup plus Facile que la Prediction,Pas Adapte
4137,2018,Sociologie,1,Histoire de la Pensee Economique,3,La Conception Liberale de l'Economie,6,940,3,QCU,0.38,0.45,43.48,31,41,72,39,31,8,1.85,79.49,Moyen,Moyen,0,Meme Difficulte que la Prediction,Pas Adapte
5203,2019,Sociologie,1,Histoire de la Pensee Economique,3,La Conception Liberale de l'Economie,6,940,3,QCU,0.13,0.82,65.79,46,24,70,68,46,22,1.03,67.65,Facile,Facile,0,Meme Difficulte que la Prediction,Adapte
6269,2020,Sociologie,1,Histoire de la Pensee Economique,3,La Conception Liberale de l'Economie,6,940,3,QCU,0.0,0.91,65.79,41,22,63,52,41,11,1.21,78.85,Facile,Facile,0,Meme Difficulte que la Prediction,Adapte
940,2015,Sociologie,1,Histoire de la Pensee Economique,3,La Conception Liberale de l'Economie,6,941,4,QCM,0.01,0.74,74.89,14,5,19,16,14,2,1.19,87.5,Difficile,Facile,2,Beaucoup plus Facile que la Prediction,Adapte
2006,2016,Sociologie,1,Histoire de la Pensee Economique,3,La Conception Liberale de l'Economie,6,941,4,QCM,0.16,0.95,74.89,16,5,21,18,16,2,1.17,88.89,Facile,Facile,0,Meme Difficulte que la Prediction,Adapte
3072,2017,Sociologie,1,Histoire de la Pensee Economique,3,La Conception Liberale de l'Economie,6,941,4,QCM,0.1,0.89,74.89,16,5,21,18,16,2,1.17,88.89,Facile,Facile,0,Meme Difficulte que la Prediction,Adapte
4138,2018,Sociologie,1,Histoire de la Pensee Economique,3,La Conception Liberale de l'Economie,6,941,4,QCM,0.0,0.9,74.89,14,5,19,18,14,4,1.06,77.78,Facile,Facile,0,Meme Difficulte que la Prediction,Adapte
5204,2019,Sociologie,1,Histoire de la Pensee Economique,3,La Conception Liberale de l'Economie,6,941,4,QCU,0.05,0.82,74.89,15,5,20,16,15,1,1.25,93.75,Facile,Facile,0,Meme Difficulte que la Prediction,Adapte
6270,2020,Sociologie,1,Histoire de la Pensee Economique,3,La Conception Liberale de l'Economie,6,941,4,QCU,0.17,0.91,74.89,17,6,23,22,17,5,1.05,77.27,Facile,Facile,0,Meme Difficulte que la Prediction,Adapte
941,2015,Sociologie,1,Histoire de la Pensee Economique,3,La Conception Liberale de l'Economie,6,942,5,QCU,0.29,0.68,38.32,2,4,6,3,2,1,2.0,66.67,Moyen,Moyen,0,Meme Difficulte que la Prediction,Pas Adapte
2007,2016,Sociologie,1,Histoire de la Pensee Economique,3,La Conception Liberale de l'Economie,6,942,5,QCM,0.37,0.34,38.43,2,3,5,2,2,0,2.5,100.0,Moyen,Moyen,0,Meme Difficulte que la Prediction,Pas Adapte
3073,2017,Sociologie,1,Histoire de la Pensee Economique,3,La Conception Liberale de l'Economie,6,942,5,QCM,0.05,0.94,92.7,5,0,5,5,5,0,1.0,100.0,Difficile,Facile,2,Beaucoup plus Facile que la Prediction,Pas Adapte
4139,2018,Sociologie,1,Histoire de la Pensee Economique,3,La Conception Liberale de l'Economie,6,942,5,QCM,0.27,0.61,43.74,3,3,6,5,3,2,1.2,60.0,Moyen,Moyen,0,Meme Difficulte que la Prediction,Pas Adapte
5205,2019,Sociologie,1,Histoire de la Pensee Economique,3,La Conception Liberale de l'Economie,6,942,5,QCM,0.61,0.25,22.99,1,4,5,4,1,3,1.25,25.0,Facile,Difficile,-2,Beaucoup plus Difficile que la Prediction,Pas Adapte
6271,2020,Sociologie,1,Histoire de la Pensee Economique,3,La Conception Liberale de l'Economie,6,942,5,QCM,0.18,0.73,73.06,4,2,6,6,4,2,1.0,66.67,Facile,Facile,0,Meme Difficulte que la Prediction,Adapte
942,2015,Sociologie,1,Histoire de la Pensee Economique,3,La Conception Liberale de l'Economie,6,943,6,QCU,0.66,0.4,31.42,30,66,96,88,30,58,1.09,34.09,Moyen,Difficile,-1,Plus Difficile que la Prediction,Pas Adapte
2008,2016,Sociologie,1,Histoire de la Pensee Economique,3,La Conception Liberale de l'Economie,6,943,6,QCU,0.35,0.42,60.27,51,34,85,74,51,23,1.15,68.92,Moyen,Moyen,0,Meme Difficulte que la Prediction,Adapte
3074,2017,Sociologie,1,Histoire de la Pensee Economique,3,La Conception Liberale de l'Economie,6,943,6,QCU,0.39,0.72,60.27,47,31,78,63,47,16,1.24,74.6,Moyen,Moyen,0,Meme Difficulte que la Prediction,Adapte
4140,2018,Sociologie,1,Histoire de la Pensee Economique,3,La Conception Liberale de l'Economie,6,943,6,QCU,0.22,0.52,60.27,40,27,67,45,40,5,1.49,88.89,Moyen,Moyen,0,Meme Difficulte que la Prediction,Adapte
5206,2019,Sociologie,1,Histoire de la Pensee Economique,3,La Conception Liberale de l'Economie,6,943,6,QCU,0.25,0.7,60.27,36,23,59,58,36,22,1.02,62.07,Moyen,Moyen,0,Meme Difficulte que la Prediction,Adapte
6272,2020,Sociologie,1,Histoire de la Pensee Economique,3,La Conception Liberale de l'Economie,6,943,6,QCU,0.25,0.55,60.27,37,25,62,57,37,20,1.09,64.91,Moyen,Moyen,0,Meme Difficulte que la Prediction,Adapte
943,2015,Sociologie,1,Histoire de la Pensee Economique,4,L'Analyse Marxiste,9,944,1,QCM,0.05,0.82,73.53,20,7,27,25,20,5,1.08,80.0,Difficile,Facile,2,Beaucoup plus Facile que la Prediction,Adapte
2009,2016,Sociologie,1,Histoire de la Pensee Economique,4,L'Analyse Marxiste,9,944,1,QCM,0.2,0.74,73.53,22,8,30,27,22,5,1.11,81.48,Facile,Facile,0,Meme Difficulte que la Prediction,Adapte
3075,2017,Sociologie,1,Histoire de la Pensee Economique,4,L'Analyse Marxiste,9,944,1,QCM,0.18,0.96,73.53,25,9,34,31,25,6,1.1,80.65,Facile,Facile,0,Meme Difficulte que la Prediction,Adapte
4141,2018,Sociologie,1,Histoire de la Pensee Economique,4,L'Analyse Marxiste,9,944,1,QCM,0.19,0.73,73.53,24,8,32,28,24,4,1.14,85.71,Facile,Facile,0,Meme Difficulte que la Prediction,Adapte
5207,2019,Sociologie,1,Histoire de la Pensee Economique,4,L'Analyse Marxiste,9,944,1,QCM,0.2,0.79,73.53,22,8,30,25,22,3,1.2,88.0,Facile,Facile,0,Meme Difficulte que la Prediction,Adapte
6273,2020,Sociologie,1,Histoire de la Pensee Economique,4,L'Analyse Marxiste,9,944,1,QCU,0.05,0.88,73.53,24,9,33,25,24,1,1.32,96.0,Facile,Facile,0,Meme Difficulte que la Prediction,Adapte
944,2015,Sociologie,1,Histoire de la Pensee Economique,4,L'Analyse Marxiste,9,945,2,QCM,0.19,0.76,72.89,70,26,96,95,70,25,1.01,73.68,Facile,Facile,0,Meme Difficulte que la Prediction,Adapte
2010,2016,Sociologie,1,Histoire de la Pensee Economique,4,L'Analyse Marxiste,9,945,2,QCU,0.08,1.0,72.89,65,24,89,85,65,20,1.05,76.47,Facile,Facile,0,Meme Difficulte que la Prediction,Adapte
3076,2017,Sociologie,1,Histoire de la Pensee Economique,4,L'Analyse Marxiste,9,945,2,QCU,0.17,0.76,72.89,55,21,76,63,55,8,1.21,87.3,Facile,Facile,0,Meme Difficulte que la Prediction,Adapte
4142,2018,Sociologie,1,Histoire de la Pensee Economique,4,L'Analyse Marxiste,9,945,2,QCU,0.08,0.86,72.89,59,22,81,76,59,17,1.07,77.63,Facile,Facile,0,Meme Difficulte que la Prediction,Adapte
5208,2019,Sociologie,1,Histoire de la Pensee Economique,4,L'Analyse Marxiste,9,945,2,QCM,0.11,0.87,72.89,58,21,79,75,58,17,1.05,77.33,Facile,Facile,0,Meme Difficulte que la Prediction,Adapte
6274,2020,Sociologie,1,Histoire de la Pensee Economique,4,L'Analyse Marxiste,9,945,2,QCM,0.1,0.88,72.89,66,24,90,89,66,23,1.01,74.16,Facile,Facile,0,Meme Difficulte que la Prediction,Adapte
945,2015,Sociologie,1,Histoire de la Pensee Economique,4,L'Analyse Marxiste,9,946,3,QCU,0.61,0.37,6.75,5,70,75,70,5,65,1.07,7.14,Difficile,Difficile,0,Meme Difficulte que la Prediction,Pas Adapte
2011,2016,Sociologie,1,Histoire de la Pensee Economique,4,L'Analyse Marxiste,9,946,3,QCU,0.01,0.86,96.69,67,2,69,68,67,1,1.01,98.53,Difficile,Facile,2,Beaucoup plus Facile que la Prediction,Pas Adapte
3077,2017,Sociologie,1,Histoire de la Pensee Economique,4,L'Analyse Marxiste,9,946,3,QCU,0.02,0.97,97.88,77,2,79,79,77,2,1.0,97.47,Moyen,Facile,1,Plus Facile que la Prediction,Pas Adapte
4143,2018,Sociologie,1,Histoire de la Pensee Economique,4,L'Analyse Marxiste,9,946,3,QCM,0.24,0.69,47.9,40,43,83,76,40,36,1.09,52.63,Difficile,Moyen,1,Plus Facile que la Prediction,Pas Adapte
5209,2019,Sociologie,1,Histoire de la Pensee Economique,4,L'Analyse Marxiste,9,946,3,QCM,0.27,0.65,42.57,40,53,93,46,40,6,2.02,86.96,Moyen,Moyen,0,Meme Difficulte que la Prediction,Pas Adapte
6275,2020,Sociologie,1,Histoire de la Pensee Economique,4,L'Analyse Marxiste,9,946,3,QCM,0.3,0.49,45.65,36,43,79,62,36,26,1.27,58.06,Moyen,Moyen,0,Meme Difficulte que la Prediction,Pas Adapte
946,2015,Sociologie,1,Histoire de la Pensee Economique,4,L'Analyse Marxiste,9,947,4,QCM,0.51,0.23,22.99,13,43,56,42,13,29,1.33,30.95,Difficile,Difficile,0,Meme Difficulte que la Prediction,Pas Adapte
2012,2016,Sociologie,1,Histoire de la Pensee Economique,4,L'Analyse Marxiste,9,947,4,QCM,0.15,0.81,91.58,51,5,56,54,51,3,1.04,94.44,Moyen,Facile,1,Plus Facile que la Prediction,Pas Adapte
3078,2017,Sociologie,1,Histoire de la Pensee Economique,4,L'Analyse Marxiste,9,947,4,QCM,0.04,0.79,89.91,47,5,52,50,47,3,1.04,94.0,Difficile,Facile,2,Beaucoup plus Facile que la Prediction,Pas Adapte
4144,2018,Sociologie,1,Histoire de la Pensee Economique,4,L'Analyse Marxiste,9,947,4,QCM,0.47,0.45,38.98,22,35,57,55,22,33,1.04,40.0,Moyen,Moyen,0,Meme Difficulte que la Prediction,Pas Adapte
5210,2019,Sociologie,1,Histoire de la Pensee Economique,4,L'Analyse Marxiste,9,947,4,QCM,0.33,0.55,41.11,23,32,55,24,23,1,2.29,95.83,Difficile,Moyen,1,Plus Facile que la Prediction,Pas Adapte
6276,2020,Sociologie,1,Histoire de la Pensee Economique,4,L'Analyse Marxiste,9,947,4,QCM,0.05,0.89,99.29,59,0,59,59,59,0,1.0,100.0,Facile,Facile,0,Meme Difficulte que la Prediction,Pas Adapte
947,2015,Sociologie,1,Histoire de la Pensee Economique,4,L'Analyse Marxiste,9,948,5,QROC,0.15,0.68,68.87,10,4,14,14,10,4,1.0,71.43,Facile,Facile,0,Meme Difficulte que la Prediction,Adapte
2013,2016,Sociologie,1,Histoire de la Pensee Economique,4,L'Analyse Marxiste,9,948,5,QROC,0.19,0.66,68.87,8,4,12,9,8,1,1.33,88.89,Facile,Facile,0,Meme Difficulte que la Prediction,Adapte
3079,2017,Sociologie,1,Histoire de la Pensee Economique,4,L'Analyse Marxiste,9,948,5,QROC,0.04,0.53,68.87,8,3,11,11,8,3,1.0,72.73,Facile,Facile,0,Meme Difficulte que la Prediction,Adapte
4145,2018,Sociologie,1,Histoire de la Pensee Economique,4,L'Analyse Marxiste,9,948,5,QCM,0.16,0.99,68.87,6,3,9,6,6,0,1.5,100.0,Facile,Facile,0,Meme Difficulte que la Prediction,Adapte
5211,2019,Sociologie,1,Histoire de la Pensee Economique,4,L'Analyse Marxiste,9,948,5,QCU,0.14,0.88,68.87,7,3,10,8,7,1,1.25,87.5,Facile,Facile,0,Meme Difficulte que la Prediction,Adapte
6277,2020,Sociologie,1,Histoire de la Pensee Economique,4,L'Analyse Marxiste,9,948,5,QCU,0.17,0.84,68.87,6,2,8,6,6,0,1.33,100.0,Facile,Facile,0,Meme Difficulte que la Prediction,Adapte
948,2015,Sociologie,1,Histoire de la Pensee Economique,4,L'Analyse Marxiste,9,949,6,QROC,0.7,0.08,14.19,4,26,30,15,4,11,2.0,26.67,Facile,Difficile,-2,Beaucoup plus Difficile que la Prediction,Pas Adapte
2014,2016,Sociologie,1,Histoire de la Pensee Economique,4,L'Analyse Marxiste,9,949,6,QROC,0.63,0.23,28.76,9,23,32,24,9,15,1.33,37.5,Difficile,Difficile,0,Meme Difficulte que la Prediction,Pas Adapte
3080,2017,Sociologie,1,Histoire de la Pensee Economique,4,L'Analyse Marxiste,9,949,6,QROC,0.87,0.06,26.85,7,20,27,14,7,7,1.93,50.0,Moyen,Difficile,-1,Plus Difficile que la Prediction,Pas Adapte
4146,2018,Sociologie,1,Histoire de la Pensee Economique,4,L'Analyse Marxiste,9,949,6,QROC,0.51,0.34,54.27,14,11,25,19,14,5,1.32,73.68,Moyen,Moyen,0,Meme Difficulte que la Prediction,Pas Adapte
5212,2019,Sociologie,1,Histoire de la Pensee Economique,4,L'Analyse Marxiste,9,949,6,QROC,0.08,0.95,80.53,20,5,25,25,20,5,1.0,80.0,Difficile,Facile,2,Beaucoup plus Facile que la Prediction,Pas Adapte
6278,2020,Sociologie,1,Histoire de la Pensee Economique,4,L'Analyse Marxiste,9,949,6,QO,0.44,0.18,57.64,14,10,24,21,14,7,1.14,66.67,Moyen,Moyen,0,Meme Difficulte que la Prediction,Pas Adapte
949,2015,Sociologie,1,Histoire de la Pensee Economique,4,L'Analyse Marxiste,9,950,7,QROC,0.75,0.2,3.54,3,80,83,55,3,52,1.51,5.45,Facile,Difficile,-2,Beaucoup plus Difficile que la Prediction,Pas Adapte
2015,2016,Sociologie,1,Histoire de la Pensee Economique,4,L'Analyse Marxiste,9,950,7,QROC,0.28,0.25,60.97,46,29,75,54,46,8,1.39,85.19,Facile,Moyen,-1,Plus Difficile que la Prediction,Adapte
3081,2017,Sociologie,1,Histoire de la Pensee Economique,4,L'Analyse Marxiste,9,950,7,QROC,0.23,0.3,60.97,39,25,64,63,39,24,1.02,61.9,Moyen,Moyen,0,Meme Difficulte que la Prediction,Adapte
4147,2018,Sociologie,1,Histoire de la Pensee Economique,4,L'Analyse Marxiste,9,950,7,QROC,0.32,0.27,60.97,41,26,67,59,41,18,1.14,69.49,Moyen,Moyen,0,Meme Difficulte que la Prediction,Adapte
5213,2019,Sociologie,1,Histoire de la Pensee Economique,4,L'Analyse Marxiste,9,950,7,QROC,0.59,0.33,60.97,42,27,69,44,42,2,1.57,95.45,Moyen,Moyen,0,Meme Difficulte que la Prediction,Adapte
6279,2020,Sociologie,1,Histoire de la Pensee Economique,4,L'Analyse Marxiste,9,950,7,QROC,0.49,0.28,60.97,40,25,65,46,40,6,1.41,86.96,Moyen,Moyen,0,Meme Difficulte que la Prediction,Adapte
950,2015,Sociologie,1,Histoire de la Pensee Economique,4,L'Analyse Marxiste,9,951,8,QROC,0.2,0.43,96.34,72,3,75,75,72,3,1.0,96.0,Facile,Facile,0,Meme Difficulte que la Prediction,Pas Adapte
2016,2016,Sociologie,1,Histoire de la Pensee Economique,4,L'Analyse Marxiste,9,951,8,QROC,0.05,0.82,66.61,57,28,85,72,57,15,1.18,79.17,Difficile,Facile,2,Beaucoup plus Facile que la Prediction,Adapte
3082,2017,Sociologie,1,Histoire de la Pensee Economique,4,L'Analyse Marxiste,9,951,8,QROC,0.15,0.89,66.61,64,32,96,94,64,30,1.02,68.09,Facile,Facile,0,Meme Difficulte que la Prediction,Adapte
4148,2018,Sociologie,1,Histoire de la Pensee Economique,4,L'Analyse Marxiste,9,951,8,QO,0.14,0.63,66.61,59,30,89,88,59,29,1.01,67.05,Facile,Facile,0,Meme Difficulte que la Prediction,Adapte
5214,2019,Sociologie,1,Histoire de la Pensee Economique,4,L'Analyse Marxiste,9,951,8,QO,0.12,0.59,66.61,65,32,97,85,65,20,1.14,76.47,Facile,Facile,0,Meme Difficulte que la Prediction,Adapte
6280,2020,Sociologie,1,Histoire de la Pensee Economique,4,L'Analyse Marxiste,9,951,8,QO,0.16,0.98,66.61,58,29,87,80,58,22,1.09,72.5,Facile,Facile,0,Meme Difficulte que la Prediction,Adapte
951,2015,Sociologie,1,Histoire de la Pensee Economique,4,L'Analyse Marxiste,9,952,9,QCM,0.05,0.79,77.32,21,6,27,22,21,1,1.23,95.45,Moyen,Facile,1,Plus Facile que la Prediction,Pas Adapte
2017,2016,Sociologie,1,Histoire de la Pensee Economique,4,L'Analyse Marxiste,9,952,9,QCM,0.55,0.24,27.66,9,22,31,15,9,6,2.07,60.0,Difficile,Difficile,0,Meme Difficulte que la Prediction,Pas Adapte
3083,2017,Sociologie,1,Histoire de la Pensee Economique,4,L'Analyse Marxiste,9,952,9,QCM,0.36,0.63,44.0,16,20,36,31,16,15,1.16,51.61,Difficile,Moyen,1,Plus Facile que la Prediction,Pas Adapte
4149,2018,Sociologie,1,Histoire de la Pensee Economique,4,L'Analyse Marxiste,9,952,9,QCM,0.2,0.98,67.07,27,13,40,40,27,13,1.0,67.5,Facile,Facile,0,Meme Difficulte que la Prediction,Adapte
5215,2019,Sociologie,1,Histoire de la Pensee Economique,4,L'Analyse Marxiste,9,952,9,QCM,0.08,0.74,67.07,31,15,46,39,31,8,1.18,79.49,Facile,Facile,0,Meme Difficulte que la Prediction,Adapte
6281,2020,Sociologie,1,Histoire de la Pensee Economique,4,L'Analyse Marxiste,9,952,9,QCM,0.01,0.72,67.07,34,16,50,44,34,10,1.14,77.27,Facile,Facile,0,Meme Difficulte que la Prediction,Adapte
952,2015,Sociologie,1,Histoire de la Pensee Economique,5,La Revolution Keynesienne,9,953,1,QCM,0.11,0.75,93.9,92,6,98,94,92,2,1.04,97.87,Difficile,Facile,2,Beaucoup plus Facile que la Prediction,Pas Adapte
2018,2016,Sociologie,1,Histoire de la Pensee Economique,5,La Revolution Keynesienne,9,953,1,QCM,0.04,0.95,77.0,69,21,90,75,69,6,1.2,92.0,Moyen,Facile,1,Plus Facile que la Prediction,Pas Adapte
3084,2017,Sociologie,1,Histoire de la Pensee Economique,5,La Revolution Keynesienne,9,953,1,QCM,0.58,0.24,7.03,6,78,84,62,6,56,1.35,9.68,Moyen,Difficile,-1,Plus Difficile que la Prediction,Pas Adapte
4150,2018,Sociologie,1,Histoire de la Pensee Economique,5,La Revolution Keynesienne,9,953,1,QCM,0.08,0.88,67.43,51,25,76,71,51,20,1.07,71.83,Facile,Facile,0,Meme Difficulte que la Prediction,Adapte
5216,2019,Sociologie,1,Histoire de la Pensee Economique,5,La Revolution Keynesienne,9,953,1,QCM,0.04,0.78,67.43,53,25,78,78,53,25,1.0,67.95,Facile,Facile,0,Meme Difficulte que la Prediction,Adapte
6282,2020,Sociologie,1,Histoire de la Pensee Economique,5,La Revolution Keynesienne,9,953,1,QCU,0.08,0.96,67.43,51,25,76,74,51,23,1.03,68.92,Facile,Facile,0,Meme Difficulte que la Prediction,Adapte
953,2015,Sociologie,1,Histoire de la Pensee Economique,5,La Revolution Keynesienne,9,954,2,QCU,0.01,1.0,70.15,11,4,15,13,11,2,1.15,84.62,Difficile,Facile,2,Beaucoup plus Facile que la Prediction,Adapte
2019,2016,Sociologie,1,Histoire de la Pensee Economique,5,La Revolution Keynesienne,9,954,2,QCU,0.16,0.84,70.15,11,4,15,14,11,3,1.07,78.57,Facile,Facile,0,Meme Difficulte que la Prediction,Adapte
3085,2017,Sociologie,1,Histoire de la Pensee Economique,5,La Revolution Keynesienne,9,954,2,QCU,0.04,0.75,70.15,11,5,16,14,11,3,1.14,78.57,Facile,Facile,0,Meme Difficulte que la Prediction,Adapte
4151,2018,Sociologie,1,Histoire de la Pensee Economique,5,La Revolution Keynesienne,9,954,2,QCU,0.11,0.79,70.15,11,4,15,15,11,4,1.0,73.33,Facile,Facile,0,Meme Difficulte que la Prediction,Adapte
5217,2019,Sociologie,1,Histoire de la Pensee Economique,5,La Revolution Keynesienne,9,954,2,QCM,0.05,0.9,70.15,10,4,14,13,10,3,1.08,76.92,Facile,Facile,0,Meme Difficulte que la Prediction,Adapte
6283,2020,Sociologie,1,Histoire de la Pensee Economique,5,La Revolution Keynesienne,9,954,2,QCM,0.15,0.91,70.15,8,4,12,9,8,1,1.33,88.89,Facile,Facile,0,Meme Difficulte que la Prediction,Adapte
954,2015,Sociologie,1,Histoire de la Pensee Economique,5,La Revolution Keynesienne,9,955,3,QCU,0.14,0.96,68.27,36,16,52,42,36,6,1.24,85.71,Difficile,Facile,2,Beaucoup plus Facile que la Prediction,Adapte
2020,2016,Sociologie,1,Histoire de la Pensee Economique,5,La Revolution Keynesienne,9,955,3,QCM,0.08,0.76,68.27,40,19,59,42,40,2,1.4,95.24,Facile,Facile,0,Meme Difficulte que la Prediction,Adapte
3086,2017,Sociologie,1,Histoire de la Pensee Economique,5,La Revolution Keynesienne,9,955,3,QCM,0.08,0.9,68.27,35,16,51,38,35,3,1.34,92.11,Facile,Facile,0,Meme Difficulte que la Prediction,Adapte
4152,2018,Sociologie,1,Histoire de la Pensee Economique,5,La Revolution Keynesienne,9,955,3,QCM,0.14,0.96,68.27,31,15,46,40,31,9,1.15,77.5,Facile,Facile,0,Meme Difficulte que la Prediction,Adapte
5218,2019,Sociologie,1,Histoire de la Pensee Economique,5,La Revolution Keynesienne,9,955,3,QCM,0.04,0.75,68.27,27,12,39,35,27,8,1.11,77.14,Facile,Facile,0,Meme Difficulte que la Prediction,Adapte
6284,2020,Sociologie,1,Histoire de la Pensee Economique,5,La Revolution Keynesienne,9,955,3,QCM,0.05,0.97,68.27,30,14,44,38,30,8,1.16,78.95,Facile,Facile,0,Meme Difficulte que la Prediction,Adapte
955,2015,Sociologie,1,Histoire de la Pensee Economique,5,La Revolution Keynesienne,9,956,4,QCM,0.19,0.77,71.18,50,20,70,68,50,18,1.03,73.53,Moyen,Facile,1,Plus Facile que la Prediction,Adapte
2021,2016,Sociologie,1,Histoire de la Pensee Economique,5,La Revolution Keynesienne,9,956,4,QCM,0.12,0.73,71.18,49,20,69,64,49,15,1.08,76.56,Facile,Facile,0,Meme Difficulte que la Prediction,Adapte
3087,2017,Sociologie,1,Histoire de la Pensee Economique,5,La Revolution Keynesienne,9,956,4,QCU,0.02,0.92,71.18,48,20,68,60,48,12,1.13,80.0,Facile,Facile,0,Meme Difficulte que la Prediction,Adapte
4153,2018,Sociologie,1,Histoire de la Pensee Economique,5,La Revolution Keynesienne,9,956,4,QCU,0.15,0.89,71.18,53,22,75,74,53,21,1.01,71.62,Facile,Facile,0,Meme Difficulte que la Prediction,Adapte
5219,2019,Sociologie,1,Histoire de la Pensee Economique,5,La Revolution Keynesienne,9,956,4,QCU,0.1,0.98,71.18,61,24,85,67,61,6,1.27,91.04,Facile,Facile,0,Meme Difficulte que la Prediction,Adapte
6285,2020,Sociologie,1,Histoire de la Pensee Economique,5,La Revolution Keynesienne,9,956,4,QCU,0.1,0.78,71.18,61,24,85,73,61,12,1.16,83.56,Facile,Facile,0,Meme Difficulte que la Prediction,Adapte
956,2015,Sociologie,1,Histoire de la Pensee Economique,5,La Revolution Keynesienne,9,957,5,QCM,0.65,0.28,30.33,21,48,69,68,21,47,1.01,30.88,Moyen,Difficile,-1,Plus Difficile que la Prediction,Pas Adapte
2022,2016,Sociologie,1,Histoire de la Pensee Economique,5,La Revolution Keynesienne,9,957,5,QCM,0.05,0.77,73.07,50,19,69,53,50,3,1.3,94.34,Facile,Facile,0,Meme Difficulte que la Prediction,Adapte
3088,2017,Sociologie,1,Histoire de la Pensee Economique,5,La Revolution Keynesienne,9,957,5,QCM,0.19,0.81,73.07,53,20,73,69,53,16,1.06,76.81,Facile,Facile,0,Meme Difficulte que la Prediction,Adapte
4154,2018,Sociologie,1,Histoire de la Pensee Economique,5,La Revolution Keynesienne,9,957,5,QCM,0.18,0.79,73.07,53,19,72,62,53,9,1.16,85.48,Facile,Facile,0,Meme Difficulte que la Prediction,Adapte
5220,2019,Sociologie,1,Histoire de la Pensee Economique,5,La Revolution Keynesienne,9,957,5,QCM,0.09,0.82,73.07,58,22,80,65,58,7,1.23,89.23,Facile,Facile,0,Meme Difficulte que la Prediction,Adapte
6286,2020,Sociologie,1,Histoire de la Pensee Economique,5,La Revolution Keynesienne,9,957,5,QCM,0.18,0.89,73.07,53,20,73,69,53,16,1.06,76.81,Facile,Facile,0,Meme Difficulte que la Prediction,Adapte
957,2015,Sociologie,1,Histoire de la Pensee Economique,5,La Revolution Keynesienne,9,958,6,QCU,0.31,0.73,54.23,50,42,92,80,50,30,1.15,62.5,Moyen,Moyen,0,Meme Difficulte que la Prediction,Pas Adapte
2023,2016,Sociologie,1,Histoire de la Pensee Economique,5,La Revolution Keynesienne,9,958,6,QCU,0.51,0.39,34.71,28,54,82,44,28,16,1.86,63.64,Difficile,Difficile,0,Meme Difficulte que la Prediction,Pas Adapte
3089,2017,Sociologie,1,Histoire de la Pensee Economique,5,La Revolution Keynesienne,9,958,6,QCU,0.28,0.69,37.34,26,44,70,70,26,44,1.0,37.14,Moyen,Moyen,0,Meme Difficulte que la Prediction,Pas Adapte
4155,2018,Sociologie,1,Histoire de la Pensee Economique,5,La Revolution Keynesienne,9,958,6,QCU,0.08,0.75,81.8,59,13,72,65,59,6,1.11,90.77,Moyen,Facile,1,Plus Facile que la Prediction,Pas Adapte
5221,2019,Sociologie,1,Histoire de la Pensee Economique,5,La Revolution Keynesienne,9,958,6,QCU,0.5,0.39,3.47,3,72,75,71,3,68,1.06,4.23,Difficile,Difficile,0,Meme Difficulte que la Prediction,Pas Adapte
6287,2020,Sociologie,1,Histoire de la Pensee Economique,5,La Revolution Keynesienne,9,958,6,QCM,0.18,0.9,84.33,62,11,73,70,62,8,1.04,88.57,Facile,Facile,0,Meme Difficulte que la Prediction,Pas Adapte
958,2015,Sociologie,1,Histoire de la Pensee Economique,5,La Revolution Keynesienne,9,959,7,QO,0.9,0.14,29.52,29,69,98,88,29,59,1.11,32.95,Moyen,Difficile,-1,Plus Difficile que la Prediction,Pas Adapte
2024,2016,Sociologie,1,Histoire de la Pensee Economique,5,La Revolution Keynesienne,9,959,7,QO,0.16,0.67,81.71,87,20,107,92,87,5,1.16,94.57,Facile,Facile,0,Meme Difficulte que la Prediction,Pas Adapte
3090,2017,Sociologie,1,Histoire de la Pensee Economique,5,La Revolution Keynesienne,9,959,7,QO,0.3,0.21,60.18,69,45,114,90,69,21,1.27,76.67,Moyen,Moyen,0,Meme Difficulte que la Prediction,Adapte
4156,2018,Sociologie,1,Histoire de la Pensee Economique,5,La Revolution Keynesienne,9,959,7,QROC,0.27,0.27,60.18,77,51,128,97,77,20,1.32,79.38,Moyen,Moyen,0,Meme Difficulte que la Prediction,Adapte
5222,2019,Sociologie,1,Histoire de la Pensee Economique,5,La Revolution Keynesienne,9,959,7,QROC,0.47,0.32,60.18,79,53,132,97,79,18,1.36,81.44,Moyen,Moyen,0,Meme Difficulte que la Prediction,Adapte
6288,2020,Sociologie,1,Histoire de la Pensee Economique,5,La Revolution Keynesienne,9,959,7,QROC,0.2,0.35,60.18,73,48,121,98,73,25,1.23,74.49,Moyen,Moyen,0,Meme Difficulte que la Prediction,Adapte
959,2015,Sociologie,1,Histoire de la Pensee Economique,5,La Revolution Keynesienne,9,960,8,QROC,0.6,0.31,51.67,11,10,21,13,11,2,1.62,84.62,Moyen,Moyen,0,Meme Difficulte que la Prediction,Pas Adapte
2025,2016,Sociologie,1,Histoire de la Pensee Economique,5,La Revolution Keynesienne,9,960,8,QROC,0.03,0.44,75.85,16,5,21,18,16,2,1.17,88.89,Facile,Facile,0,Meme Difficulte que la Prediction,Pas Adapte
3091,2017,Sociologie,1,Histoire de la Pensee Economique,5,La Revolution Keynesienne,9,960,8,QO,0.91,0.14,21.11,5,18,23,21,5,16,1.1,23.81,Difficile,Difficile,0,Meme Difficulte que la Prediction,Pas Adapte
4157,2018,Sociologie,1,Histoire de la Pensee Economique,5,La Revolution Keynesienne,9,960,8,QO,0.25,0.21,58.26,14,10,24,22,14,8,1.09,63.64,Facile,Moyen,-1,Plus Difficile que la Prediction,Pas Adapte
5223,2019,Sociologie,1,Histoire de la Pensee Economique,5,La Revolution Keynesienne,9,960,8,QO,0.1,0.64,87.43,23,3,26,25,23,2,1.04,92.0,Facile,Facile,0,Meme Difficulte que la Prediction,Pas Adapte
6289,2020,Sociologie,1,Histoire de la Pensee Economique,5,La Revolution Keynesienne,9,960,8,QO,0.1,0.77,70.87,18,7,25,21,18,3,1.19,85.71,Moyen,Facile,1,Plus Facile que la Prediction,Adapte
960,2015,Sociologie,1,Histoire de la Pensee Economique,5,La Revolution Keynesienne,9,961,9,QCM,0.01,0.74,89.39,41,5,46,41,41,0,1.12,100.0,Facile,Facile,0,Meme Difficulte que la Prediction,Pas Adapte
2026,2016,Sociologie,1,Histoire de la Pensee Economique,5,La Revolution Keynesienne,9,961,9,QCM,0.11,0.72,90.97,38,4,42,41,38,3,1.02,92.68,Facile,Facile,0,Meme Difficulte que la Prediction,Pas Adapte
3092,2017,Sociologie,1,Histoire de la Pensee Economique,5,La Revolution Keynesienne,9,961,9,QCM,0.39,0.48,46.54,20,22,42,23,20,3,1.83,86.96,Moyen,Moyen,0,Meme Difficulte que la Prediction,Pas Adapte
4158,2018,Sociologie,1,Histoire de la Pensee Economique,5,La Revolution Keynesienne,9,961,9,QCM,0.07,0.76,92.88,44,3,47,45,44,1,1.04,97.78,Facile,Facile,0,Meme Difficulte que la Prediction,Pas Adapte
5224,2019,Sociologie,1,Histoire de la Pensee Economique,5,La Revolution Keynesienne,9,961,9,QCU,0.29,0.65,52.13,22,21,43,41,22,19,1.05,53.66,Moyen,Moyen,0,Meme Difficulte que la Prediction,Pas Adapte
6290,2020,Sociologie,1,Histoire de la Pensee Economique,5,La Revolution Keynesienne,9,961,9,QCU,0.4,0.26,21.04,10,39,49,18,10,8,2.72,55.56,Moyen,Difficile,-1,Plus Difficile que la Prediction,Pas Adapte
961,2015,Sociologie,1,"Travail, Emploi, Chomage",1,Caracteristiques de l'Emploi et du Chomage,1,962,1,QCM,0.18,0.77,67.03,15,8,23,20,15,5,1.15,75.0,Facile,Facile,0,Meme Difficulte que la Prediction,Adapte
2027,2016,Sociologie,1,"Travail, Emploi, Chomage",1,Caracteristiques de l'Emploi et du Chomage,1,962,1,QCU,0.08,0.87,67.03,17,9,26,22,17,5,1.18,77.27,Facile,Facile,0,Meme Difficulte que la Prediction,Adapte
3093,2017,Sociologie,1,"Travail, Emploi, Chomage",1,Caracteristiques de l'Emploi et du Chomage,1,962,1,QCU,0.09,0.92,67.03,16,8,24,18,16,2,1.33,88.89,Facile,Facile,0,Meme Difficulte que la Prediction,Adapte
4159,2018,Sociologie,1,"Travail, Emploi, Chomage",1,Caracteristiques de l'Emploi et du Chomage,1,962,1,QCU,0.01,0.82,67.03,19,9,28,25,19,6,1.12,76.0,Facile,Facile,0,Meme Difficulte que la Prediction,Adapte
5225,2019,Sociologie,1,"Travail, Emploi, Chomage",1,Caracteristiques de l'Emploi et du Chomage,1,962,1,QCU,0.09,0.99,67.03,18,9,27,21,18,3,1.29,85.71,Facile,Facile,0,Meme Difficulte que la Prediction,Adapte
6291,2020,Sociologie,1,"Travail, Emploi, Chomage",1,Caracteristiques de l'Emploi et du Chomage,1,962,1,QCM,0.17,0.96,67.03,19,10,29,25,19,6,1.16,76.0,Facile,Facile,0,Meme Difficulte que la Prediction,Adapte
962,2015,Sociologie,1,"Travail, Emploi, Chomage",2,Fonctionnement du Marche du Chomage dans les Theories Economiques,7,963,1,QROC,0.5,0.35,50.48,42,42,84,51,42,9,1.65,82.35,Moyen,Moyen,0,Meme Difficulte que la Prediction,Pas Adapte
2028,2016,Sociologie,1,"Travail, Emploi, Chomage",2,Fonctionnement du Marche du Chomage dans les Theories Economiques,7,963,1,QROC,0.02,0.43,66.07,63,33,96,79,63,16,1.22,79.75,Facile,Facile,0,Meme Difficulte que la Prediction,Adapte
3094,2017,Sociologie,1,"Travail, Emploi, Chomage",2,Fonctionnement du Marche du Chomage dans les Theories Economiques,7,963,1,QROC,0.07,0.6,66.07,71,37,108,88,71,17,1.23,80.68,Facile,Facile,0,Meme Difficulte que la Prediction,Adapte
4160,2018,Sociologie,1,"Travail, Emploi, Chomage",2,Fonctionnement du Marche du Chomage dans les Theories Economiques,7,963,1,QROC,0.1,0.68,66.07,74,38,112,95,74,21,1.18,77.89,Facile,Facile,0,Meme Difficulte que la Prediction,Adapte
5226,2019,Sociologie,1,"Travail, Emploi, Chomage",2,Fonctionnement du Marche du Chomage dans les Theories Economiques,7,963,1,QROC,0.17,0.98,66.07,77,40,117,114,77,37,1.03,67.54,Facile,Facile,0,Meme Difficulte que la Prediction,Adapte
6292,2020,Sociologie,1,"Travail, Emploi, Chomage",2,Fonctionnement du Marche du Chomage dans les Theories Economiques,7,963,1,QROC,0.19,0.78,66.07,68,35,103,70,68,2,1.47,97.14,Facile,Facile,0,Meme Difficulte que la Prediction,Adapte
963,2015,Sociologie,1,"Travail, Emploi, Chomage",2,Fonctionnement du Marche du Chomage dans les Theories Economiques,7,964,2,QROC,0.42,0.26,61.09,30,19,49,31,30,1,1.58,96.77,Difficile,Moyen,1,Plus Facile que la Prediction,Adapte
2029,2016,Sociologie,1,"Travail, Emploi, Chomage",2,Fonctionnement du Marche du Chomage dans les Theories Economiques,7,964,2,QROC,0.35,0.31,61.09,26,16,42,29,26,3,1.45,89.66,Moyen,Moyen,0,Meme Difficulte que la Prediction,Adapte
3095,2017,Sociologie,1,"Travail, Emploi, Chomage",2,Fonctionnement du Marche du Chomage dans les Theories Economiques,7,964,2,QROC,0.39,0.33,61.09,27,17,44,41,27,14,1.07,65.85,Moyen,Moyen,0,Meme Difficulte que la Prediction,Adapte
4161,2018,Sociologie,1,"Travail, Emploi, Chomage",2,Fonctionnement du Marche du Chomage dans les Theories Economiques,7,964,2,QROC,0.29,0.34,61.09,31,19,50,45,31,14,1.11,68.89,Moyen,Moyen,0,Meme Difficulte que la Prediction,Adapte
5227,2019,Sociologie,1,"Travail, Emploi, Chomage",2,Fonctionnement du Marche du Chomage dans les Theories Economiques,7,964,2,QCU,0.3,0.57,61.09,26,17,43,30,26,4,1.43,86.67,Moyen,Moyen,0,Meme Difficulte que la Prediction,Adapte
6293,2020,Sociologie,1,"Travail, Emploi, Chomage",2,Fonctionnement du Marche du Chomage dans les Theories Economiques,7,964,2,QCU,0.23,0.54,61.09,23,14,37,29,23,6,1.28,79.31,Moyen,Moyen,0,Meme Difficulte que la Prediction,Adapte
964,2015,Sociologie,1,"Travail, Emploi, Chomage",2,Fonctionnement du Marche du Chomage dans les Theories Economiques,7,965,3,QCU,0.34,0.72,61.77,25,16,41,40,25,15,1.02,62.5,Facile,Moyen,-1,Plus Difficile que la Prediction,Adapte
2030,2016,Sociologie,1,"Travail, Emploi, Chomage",2,Fonctionnement du Marche du Chomage dans les Theories Economiques,7,965,3,QCU,0.34,0.74,61.77,27,16,43,42,27,15,1.02,64.29,Moyen,Moyen,0,Meme Difficulte que la Prediction,Adapte
3096,2017,Sociologie,1,"Travail, Emploi, Chomage",2,Fonctionnement du Marche du Chomage dans les Theories Economiques,7,965,3,QCU,0.24,0.41,61.77,23,14,37,27,23,4,1.37,85.19,Moyen,Moyen,0,Meme Difficulte que la Prediction,Adapte
4162,2018,Sociologie,1,"Travail, Emploi, Chomage",2,Fonctionnement du Marche du Chomage dans les Theories Economiques,7,965,3,QCM,0.42,0.42,61.77,25,16,41,30,25,5,1.37,83.33,Moyen,Moyen,0,Meme Difficulte que la Prediction,Adapte
5228,2019,Sociologie,1,"Travail, Emploi, Chomage",2,Fonctionnement du Marche du Chomage dans les Theories Economiques,7,965,3,QCM,0.26,0.41,61.77,23,15,38,26,23,3,1.46,88.46,Moyen,Moyen,0,Meme Difficulte que la Prediction,Adapte
6294,2020,Sociologie,1,"Travail, Emploi, Chomage",2,Fonctionnement du Marche du Chomage dans les Theories Economiques,7,965,3,QCM,0.44,0.69,61.77,22,13,35,29,22,7,1.21,75.86,Moyen,Moyen,0,Meme Difficulte que la Prediction,Adapte
965,2015,Sociologie,1,"Travail, Emploi, Chomage",2,Fonctionnement du Marche du Chomage dans les Theories Economiques,7,966,4,QROC,0.55,0.3,49.11,19,19,38,36,19,17,1.06,52.78,Moyen,Moyen,0,Meme Difficulte que la Prediction,Pas Adapte
2031,2016,Sociologie,1,"Travail, Emploi, Chomage",2,Fonctionnement du Marche du Chomage dans les Theories Economiques,7,966,4,QROC,0.27,0.36,63.63,25,14,39,37,25,12,1.05,67.57,Moyen,Moyen,0,Meme Difficulte que la Prediction,Adapte
3097,2017,Sociologie,1,"Travail, Emploi, Chomage",2,Fonctionnement du Marche du Chomage dans les Theories Economiques,7,966,4,QROC,0.27,0.26,63.63,25,14,39,35,25,10,1.11,71.43,Moyen,Moyen,0,Meme Difficulte que la Prediction,Adapte
4163,2018,Sociologie,1,"Travail, Emploi, Chomage",2,Fonctionnement du Marche du Chomage dans les Theories Economiques,7,966,4,QROC,0.2,0.31,63.63,29,16,45,33,29,4,1.36,87.88,Moyen,Moyen,0,Meme Difficulte que la Prediction,Adapte
5229,2019,Sociologie,1,"Travail, Emploi, Chomage",2,Fonctionnement du Marche du Chomage dans les Theories Economiques,7,966,4,QROC,0.25,0.39,63.63,27,16,43,40,27,13,1.07,67.5,Moyen,Moyen,0,Meme Difficulte que la Prediction,Adapte
6295,2020,Sociologie,1,"Travail, Emploi, Chomage",2,Fonctionnement du Marche du Chomage dans les Theories Economiques,7,966,4,QROC,0.54,0.39,63.63,29,17,46,39,29,10,1.18,74.36,Moyen,Moyen,0,Meme Difficulte que la Prediction,Adapte
966,2015,Sociologie,1,"Travail, Emploi, Chomage",2,Fonctionnement du Marche du Chomage dans les Theories Economiques,7,967,5,QCU,0.18,0.83,98.76,82,1,83,83,82,1,1.0,98.8,Facile,Facile,0,Meme Difficulte que la Prediction,Pas Adapte
2032,2016,Sociologie,1,"Travail, Emploi, Chomage",2,Fonctionnement du Marche du Chomage dans les Theories Economiques,7,967,5,QCU,0.24,0.46,52.98,41,37,78,52,41,11,1.5,78.85,Moyen,Moyen,0,Meme Difficulte que la Prediction,Pas Adapte
3098,2017,Sociologie,1,"Travail, Emploi, Chomage",2,Fonctionnement du Marche du Chomage dans les Theories Economiques,7,967,5,QCU,0.14,0.92,98.63,84,1,85,84,84,0,1.01,100.0,Facile,Facile,0,Meme Difficulte que la Prediction,Pas Adapte
4164,2018,Sociologie,1,"Travail, Emploi, Chomage",2,Fonctionnement du Marche du Chomage dans les Theories Economiques,7,967,5,QCU,0.54,0.21,15.65,14,75,89,46,14,32,1.93,30.43,Moyen,Difficile,-1,Plus Difficile que la Prediction,Pas Adapte
5230,2019,Sociologie,1,"Travail, Emploi, Chomage",2,Fonctionnement du Marche du Chomage dans les Theories Economiques,7,967,5,QCU,0.73,0.33,15.1,13,71,84,45,13,32,1.87,28.89,Facile,Difficile,-2,Beaucoup plus Difficile que la Prediction,Pas Adapte
6296,2020,Sociologie,1,"Travail, Emploi, Chomage",2,Fonctionnement du Marche du Chomage dans les Theories Economiques,7,967,5,QCU,0.54,0.21,31.5,23,49,72,69,23,46,1.04,33.33,Moyen,Difficile,-1,Plus Difficile que la Prediction,Pas Adapte
967,2015,Sociologie,1,"Travail, Emploi, Chomage",2,Fonctionnement du Marche du Chomage dans les Theories Economiques,7,968,6,QCM,0.61,0.26,32.41,6,13,19,6,6,0,3.17,100.0,Moyen,Difficile,-1,Plus Difficile que la Prediction,Pas Adapte
2033,2016,Sociologie,1,"Travail, Emploi, Chomage",2,Fonctionnement du Marche du Chomage dans les Theories Economiques,7,968,6,QCM,0.71,0.25,32.19,5,11,16,6,5,1,2.67,83.33,Facile,Difficile,-2,Beaucoup plus Difficile que la Prediction,Pas Adapte
3099,2017,Sociologie,1,"Travail, Emploi, Chomage",2,Fonctionnement du Marche du Chomage dans les Theories Economiques,7,968,6,QCM,0.31,0.42,55.21,9,8,17,11,9,2,1.55,81.82,Moyen,Moyen,0,Meme Difficulte que la Prediction,Pas Adapte
4165,2018,Sociologie,1,"Travail, Emploi, Chomage",2,Fonctionnement du Marche du Chomage dans les Theories Economiques,7,968,6,QCU,0.51,0.34,6.93,1,18,19,12,1,11,1.58,8.33,Moyen,Difficile,-1,Plus Difficile que la Prediction,Pas Adapte
5231,2019,Sociologie,1,"Travail, Emploi, Chomage",2,Fonctionnement du Marche du Chomage dans les Theories Economiques,7,968,6,QCU,0.59,0.21,0.82,0,18,18,10,0,10,1.8,0.0,Difficile,Difficile,0,Meme Difficulte que la Prediction,Pas Adapte
6297,2020,Sociologie,1,"Travail, Emploi, Chomage",2,Fonctionnement du Marche du Chomage dans les Theories Economiques,7,968,6,QCU,0.19,0.84,73.99,13,4,17,16,13,3,1.06,81.25,Facile,Facile,0,Meme Difficulte que la Prediction,Adapte
968,2015,Sociologie,1,"Travail, Emploi, Chomage",2,Fonctionnement du Marche du Chomage dans les Theories Economiques,7,969,7,QCM,0.27,0.65,45.36,8,10,18,9,8,1,2.0,88.89,Facile,Moyen,-1,Plus Difficile que la Prediction,Pas Adapte
2034,2016,Sociologie,1,"Travail, Emploi, Chomage",2,Fonctionnement du Marche du Chomage dans les Theories Economiques,7,969,7,QCM,0.75,0.18,11.03,2,17,19,16,2,14,1.19,12.5,Moyen,Difficile,-1,Plus Difficile que la Prediction,Pas Adapte
3100,2017,Sociologie,1,"Travail, Emploi, Chomage",2,Fonctionnement du Marche du Chomage dans les Theories Economiques,7,969,7,QCM,0.22,0.58,64.98,13,7,20,18,13,5,1.11,72.22,Moyen,Moyen,0,Meme Difficulte que la Prediction,Adapte
4166,2018,Sociologie,1,"Travail, Emploi, Chomage",2,Fonctionnement du Marche du Chomage dans les Theories Economiques,7,969,7,QCM,0.47,0.62,64.98,11,6,17,16,11,5,1.06,68.75,Moyen,Moyen,0,Meme Difficulte que la Prediction,Adapte
5232,2019,Sociologie,1,"Travail, Emploi, Chomage",2,Fonctionnement du Marche du Chomage dans les Theories Economiques,7,969,7,QCM,0.29,0.57,64.98,12,6,18,18,12,6,1.0,66.67,Moyen,Moyen,0,Meme Difficulte que la Prediction,Adapte
6298,2020,Sociologie,1,"Travail, Emploi, Chomage",2,Fonctionnement du Marche du Chomage dans les Theories Economiques,7,969,7,QCM,0.29,0.41,64.98,11,6,17,15,11,4,1.13,73.33,Moyen,Moyen,0,Meme Difficulte que la Prediction,Adapte
969,2015,Sociologie,1,"Travail, Emploi, Chomage",3,Les Actions pour l'Emploi,8,970,1,QO,0.57,0.17,57.79,40,29,69,59,40,19,1.17,67.8,Moyen,Moyen,0,Meme Difficulte que la Prediction,Pas Adapte
2035,2016,Sociologie,1,"Travail, Emploi, Chomage",3,Les Actions pour l'Emploi,8,970,1,QO,0.07,0.82,91.31,67,6,73,71,67,4,1.03,94.37,Difficile,Facile,2,Beaucoup plus Facile que la Prediction,Pas Adapte
3101,2017,Sociologie,1,"Travail, Emploi, Chomage",3,Les Actions pour l'Emploi,8,970,1,QO,0.74,0.16,49.04,36,38,74,58,36,22,1.28,62.07,Difficile,Moyen,1,Plus Facile que la Prediction,Pas Adapte
4167,2018,Sociologie,1,"Travail, Emploi, Chomage",3,Les Actions pour l'Emploi,8,970,1,QO,0.63,0.28,36.16,26,46,72,45,26,19,1.6,57.78,Moyen,Moyen,0,Meme Difficulte que la Prediction,Pas Adapte
5233,2019,Sociologie,1,"Travail, Emploi, Chomage",3,Les Actions pour l'Emploi,8,970,1,QO,0.12,0.73,80.58,56,14,70,68,56,12,1.03,82.35,Difficile,Facile,2,Beaucoup plus Facile que la Prediction,Pas Adapte
6299,2020,Sociologie,1,"Travail, Emploi, Chomage",3,Les Actions pour l'Emploi,8,970,1,QO,0.03,0.37,87.96,66,9,75,67,66,1,1.12,98.51,Moyen,Facile,1,Plus Facile que la Prediction,Pas Adapte
970,2015,Sociologie,1,"Travail, Emploi, Chomage",3,Les Actions pour l'Emploi,8,971,2,QCM,0.03,0.75,86.97,24,4,28,24,24,0,1.17,100.0,Facile,Facile,0,Meme Difficulte que la Prediction,Pas Adapte
2036,2016,Sociologie,1,"Travail, Emploi, Chomage",3,Les Actions pour l'Emploi,8,971,2,QCM,0.15,0.72,67.89,21,10,31,29,21,8,1.07,72.41,Difficile,Facile,2,Beaucoup plus Facile que la Prediction,Adapte
3102,2017,Sociologie,1,"Travail, Emploi, Chomage",3,Les Actions pour l'Emploi,8,971,2,QCM,0.07,0.79,67.89,20,10,30,21,20,1,1.43,95.24,Facile,Facile,0,Meme Difficulte que la Prediction,Adapte
4168,2018,Sociologie,1,"Travail, Emploi, Chomage",3,Les Actions pour l'Emploi,8,971,2,QCM,0.15,0.98,67.89,22,11,33,29,22,7,1.14,75.86,Facile,Facile,0,Meme Difficulte que la Prediction,Adapte
5234,2019,Sociologie,1,"Travail, Emploi, Chomage",3,Les Actions pour l'Emploi,8,971,2,QCU,0.08,0.84,67.89,20,10,30,21,20,1,1.43,95.24,Facile,Facile,0,Meme Difficulte que la Prediction,Adapte
6300,2020,Sociologie,1,"Travail, Emploi, Chomage",3,Les Actions pour l'Emploi,8,971,2,QCU,0.01,0.82,67.89,21,10,31,23,21,2,1.35,91.3,Facile,Facile,0,Meme Difficulte que la Prediction,Adapte
971,2015,Sociologie,1,"Travail, Emploi, Chomage",3,Les Actions pour l'Emploi,8,972,3,QCU,0.46,0.35,27.73,2,5,7,6,2,4,1.17,33.33,Moyen,Difficile,-1,Plus Difficile que la Prediction,Pas Adapte
2037,2016,Sociologie,1,"Travail, Emploi, Chomage",3,Les Actions pour l'Emploi,8,972,3,QCU,0.18,0.99,90.34,7,1,8,8,7,1,1.0,87.5,Facile,Facile,0,Meme Difficulte que la Prediction,Pas Adapte
3103,2017,Sociologie,1,"Travail, Emploi, Chomage",3,Les Actions pour l'Emploi,8,972,3,QCU,0.1,0.83,65.0,5,2,7,5,5,0,1.4,100.0,Difficile,Facile,2,Beaucoup plus Facile que la Prediction,Adapte
4169,2018,Sociologie,1,"Travail, Emploi, Chomage",3,Les Actions pour l'Emploi,8,972,3,QCU,0.07,0.86,65.0,5,2,7,6,5,1,1.17,83.33,Facile,Facile,0,Meme Difficulte que la Prediction,Adapte
5235,2019,Sociologie,1,"Travail, Emploi, Chomage",3,Les Actions pour l'Emploi,8,972,3,QCU,0.18,0.87,65.0,5,2,7,5,5,0,1.4,100.0,Facile,Facile,0,Meme Difficulte que la Prediction,Adapte
6301,2020,Sociologie,1,"Travail, Emploi, Chomage",3,Les Actions pour l'Emploi,8,972,3,QCU,0.11,0.77,65.0,4,2,6,5,4,1,1.2,80.0,Facile,Facile,0,Meme Difficulte que la Prediction,Adapte
972,2015,Sociologie,1,"Travail, Emploi, Chomage",3,Les Actions pour l'Emploi,8,973,4,QCM,0.07,0.97,71.71,56,22,78,58,56,2,1.34,96.55,Facile,Facile,0,Meme Difficulte que la Prediction,Adapte
2038,2016,Sociologie,1,"Travail, Emploi, Chomage",3,Les Actions pour l'Emploi,8,973,4,QCM,0.02,0.81,71.71,54,21,75,74,54,20,1.01,72.97,Facile,Facile,0,Meme Difficulte que la Prediction,Adapte
3104,2017,Sociologie,1,"Travail, Emploi, Chomage",3,Les Actions pour l'Emploi,8,973,4,QCM,0.08,0.97,71.71,53,21,74,66,53,13,1.12,80.3,Facile,Facile,0,Meme Difficulte que la Prediction,Adapte
4170,2018,Sociologie,1,"Travail, Emploi, Chomage",3,Les Actions pour l'Emploi,8,973,4,QCM,0.07,0.93,71.71,49,20,69,51,49,2,1.35,96.08,Facile,Facile,0,Meme Difficulte que la Prediction,Adapte
5236,2019,Sociologie,1,"Travail, Emploi, Chomage",3,Les Actions pour l'Emploi,8,973,4,QCM,0.15,0.94,71.71,43,17,60,56,43,13,1.07,76.79,Facile,Facile,0,Meme Difficulte que la Prediction,Adapte
6302,2020,Sociologie,1,"Travail, Emploi, Chomage",3,Les Actions pour l'Emploi,8,973,4,QCU,0.03,0.77,71.71,42,16,58,47,42,5,1.23,89.36,Facile,Facile,0,Meme Difficulte que la Prediction,Adapte
973,2015,Sociologie,1,"Travail, Emploi, Chomage",3,Les Actions pour l'Emploi,8,974,5,QO,0.11,0.94,67.37,65,31,96,77,65,12,1.25,84.42,Facile,Facile,0,Meme Difficulte que la Prediction,Adapte
2039,2016,Sociologie,1,"Travail, Emploi, Chomage",3,Les Actions pour l'Emploi,8,974,5,QO,0.04,0.82,67.37,72,35,107,82,72,10,1.3,87.8,Facile,Facile,0,Meme Difficulte que la Prediction,Adapte
3105,2017,Sociologie,1,"Travail, Emploi, Chomage",3,Les Actions pour l'Emploi,8,974,5,QO,0.16,0.89,67.37,71,34,105,83,71,12,1.27,85.54,Facile,Facile,0,Meme Difficulte que la Prediction,Adapte
4171,2018,Sociologie,1,"Travail, Emploi, Chomage",3,Les Actions pour l'Emploi,8,974,5,QO,0.15,0.89,67.37,80,39,119,84,80,4,1.42,95.24,Facile,Facile,0,Meme Difficulte que la Prediction,Adapte
5237,2019,Sociologie,1,"Travail, Emploi, Chomage",3,Les Actions pour l'Emploi,8,974,5,QO,0.01,0.67,67.37,75,36,111,89,75,14,1.25,84.27,Facile,Facile,0,Meme Difficulte que la Prediction,Adapte
6303,2020,Sociologie,1,"Travail, Emploi, Chomage",3,Les Actions pour l'Emploi,8,974,5,QO,0.18,0.52,67.37,75,36,111,110,75,35,1.01,68.18,Facile,Facile,0,Meme Difficulte que la Prediction,Adapte
974,2015,Sociologie,1,"Travail, Emploi, Chomage",3,Les Actions pour l'Emploi,8,975,6,QCM,0.79,0.2,18.1,10,47,57,45,10,35,1.27,22.22,Difficile,Difficile,0,Meme Difficulte que la Prediction,Pas Adapte
2040,2016,Sociologie,1,"Travail, Emploi, Chomage",3,Les Actions pour l'Emploi,8,975,6,QCM,0.21,0.54,45.25,26,31,57,42,26,16,1.36,61.9,Difficile,Moyen,1,Plus Facile que la Prediction,Pas Adapte
3106,2017,Sociologie,1,"Travail, Emploi, Chomage",3,Les Actions pour l'Emploi,8,975,6,QCM,0.24,0.38,48.22,25,27,52,46,25,21,1.13,54.35,Facile,Moyen,-1,Plus Difficile que la Prediction,Pas Adapte
4172,2018,Sociologie,1,"Travail, Emploi, Chomage",3,Les Actions pour l'Emploi,8,975,6,QCM,0.18,0.96,80.15,39,10,49,43,39,4,1.14,90.7,Facile,Facile,0,Meme Difficulte que la Prediction,Pas Adapte
5238,2019,Sociologie,1,"Travail, Emploi, Chomage",3,Les Actions pour l'Emploi,8,975,6,QCM,0.45,0.6,36.02,20,35,55,20,20,0,2.75,100.0,Moyen,Moyen,0,Meme Difficulte que la Prediction,Pas Adapte
6304,2020,Sociologie,1,"Travail, Emploi, Chomage",3,Les Actions pour l'Emploi,8,975,6,QCM,0.11,0.92,93.82,49,3,52,50,49,1,1.04,98.0,Facile,Facile,0,Meme Difficulte que la Prediction,Pas Adapte
975,2015,Sociologie,1,"Travail, Emploi, Chomage",3,Les Actions pour l'Emploi,8,976,7,QCM,0.16,0.94,91.24,71,7,78,72,71,1,1.08,98.61,Facile,Facile,0,Meme Difficulte que la Prediction,Pas Adapte
2041,2016,Sociologie,1,"Travail, Emploi, Chomage",3,Les Actions pour l'Emploi,8,976,7,QCM,0.78,0.27,10.59,8,66,74,58,8,50,1.28,13.79,Difficile,Difficile,0,Meme Difficulte que la Prediction,Pas Adapte
3107,2017,Sociologie,1,"Travail, Emploi, Chomage",3,Les Actions pour l'Emploi,8,976,7,QCM,0.12,0.74,85.12,69,12,81,72,69,3,1.12,95.83,Facile,Facile,0,Meme Difficulte que la Prediction,Pas Adapte
4173,2018,Sociologie,1,"Travail, Emploi, Chomage",3,Les Actions pour l'Emploi,8,976,7,QCM,0.7,0.29,19.66,16,66,82,53,16,37,1.55,30.19,Difficile,Difficile,0,Meme Difficulte que la Prediction,Pas Adapte
5239,2019,Sociologie,1,"Travail, Emploi, Chomage",3,Les Actions pour l'Emploi,8,976,7,QCM,0.66,0.27,2.64,2,79,81,21,2,19,3.86,9.52,Difficile,Difficile,0,Meme Difficulte que la Prediction,Pas Adapte
6305,2020,Sociologie,1,"Travail, Emploi, Chomage",3,Les Actions pour l'Emploi,8,976,7,QCM,0.05,0.78,66.15,60,31,91,80,60,20,1.14,75.0,Facile,Facile,0,Meme Difficulte que la Prediction,Adapte
976,2015,Sociologie,1,"Travail, Emploi, Chomage",3,Les Actions pour l'Emploi,8,977,8,QO,0.93,0.1,3.88,3,82,85,75,3,72,1.13,4.0,Difficile,Difficile,0,Meme Difficulte que la Prediction,Pas Adapte
2042,2016,Sociologie,1,"Travail, Emploi, Chomage",3,Les Actions pour l'Emploi,8,977,8,QROC,0.41,0.31,55.92,50,40,90,79,50,29,1.14,63.29,Facile,Moyen,-1,Plus Difficile que la Prediction,Pas Adapte
3108,2017,Sociologie,1,"Travail, Emploi, Chomage",3,Les Actions pour l'Emploi,8,977,8,QROC,0.01,0.8,70.59,56,23,79,65,56,9,1.22,86.15,Difficile,Facile,2,Beaucoup plus Facile que la Prediction,Adapte
4174,2018,Sociologie,1,"Travail, Emploi, Chomage",3,Les Actions pour l'Emploi,8,977,8,QROC,0.14,0.56,70.59,47,20,67,52,47,5,1.29,90.38,Facile,Facile,0,Meme Difficulte que la Prediction,Adapte
5240,2019,Sociologie,1,"Travail, Emploi, Chomage",3,Les Actions pour l'Emploi,8,977,8,QROC,0.03,0.59,70.59,47,20,67,65,47,18,1.03,72.31,Facile,Facile,0,Meme Difficulte que la Prediction,Adapte
6306,2020,Sociologie,1,"Travail, Emploi, Chomage",3,Les Actions pour l'Emploi,8,977,8,QROC,0.07,0.76,70.59,47,20,67,64,47,17,1.05,73.44,Facile,Facile,0,Meme Difficulte que la Prediction,Adapte
977,2015,Sociologie,1,"Travail, Emploi, Chomage",4,La Question du Travail,8,978,1,QROC,0.66,0.08,11.62,10,74,84,62,10,52,1.35,16.13,Moyen,Difficile,-1,Plus Difficile que la Prediction,Pas Adapte
2043,2016,Sociologie,1,"Travail, Emploi, Chomage",4,La Question du Travail,8,978,1,QROC,0.12,0.83,88.97,77,9,86,81,77,4,1.06,95.06,Facile,Facile,0,Meme Difficulte que la Prediction,Pas Adapte
3109,2017,Sociologie,1,"Travail, Emploi, Chomage",4,La Question du Travail,8,978,1,QROC,0.5,0.37,59.88,46,31,77,52,46,6,1.48,88.46,Moyen,Moyen,0,Meme Difficulte que la Prediction,Pas Adapte
4175,2018,Sociologie,1,"Travail, Emploi, Chomage",4,La Question du Travail,8,978,1,QROC,0.39,0.37,42.12,37,50,87,78,37,41,1.12,47.44,Facile,Moyen,-1,Plus Difficile que la Prediction,Pas Adapte
5241,2019,Sociologie,1,"Travail, Emploi, Chomage",4,La Question du Travail,8,978,1,QROC,0.5,0.26,56.99,47,35,82,74,47,27,1.11,63.51,Difficile,Moyen,1,Plus Facile que la Prediction,Pas Adapte
6307,2020,Sociologie,1,"Travail, Emploi, Chomage",4,La Question du Travail,8,978,1,QROC,0.5,0.26,54.92,49,40,89,61,49,12,1.46,80.33,Moyen,Moyen,0,Meme Difficulte que la Prediction,Pas Adapte
978,2015,Sociologie,1,"Travail, Emploi, Chomage",4,La Question du Travail,8,979,2,QCU,0.24,0.57,53.05,8,7,15,10,8,2,1.5,80.0,Moyen,Moyen,0,Meme Difficulte que la Prediction,Pas Adapte
2044,2016,Sociologie,1,"Travail, Emploi, Chomage",4,La Question du Travail,8,979,2,QCU,0.09,0.89,71.96,12,5,17,17,12,5,1.0,70.59,Facile,Facile,0,Meme Difficulte que la Prediction,Adapte
3110,2017,Sociologie,1,"Travail, Emploi, Chomage",4,La Question du Travail,8,979,2,QCU,0.03,0.85,71.96,12,4,16,14,12,2,1.14,85.71,Facile,Facile,0,Meme Difficulte que la Prediction,Adapte
4176,2018,Sociologie,1,"Travail, Emploi, Chomage",4,La Question du Travail,8,979,2,QCM,0.19,0.85,71.96,12,4,16,13,12,1,1.23,92.31,Facile,Facile,0,Meme Difficulte que la Prediction,Adapte
5242,2019,Sociologie,1,"Travail, Emploi, Chomage",4,La Question du Travail,8,979,2,QCM,0.18,0.78,71.96,12,4,16,15,12,3,1.07,80.0,Facile,Facile,0,Meme Difficulte que la Prediction,Adapte
6308,2020,Sociologie,1,"Travail, Emploi, Chomage",4,La Question du Travail,8,979,2,QCM,0.11,0.71,71.96,12,5,17,13,12,1,1.31,92.31,Facile,Facile,0,Meme Difficulte que la Prediction,Adapte
979,2015,Sociologie,1,"Travail, Emploi, Chomage",4,La Question du Travail,8,980,3,QCU,0.75,0.23,30.52,17,40,57,56,17,39,1.02,30.36,Moyen,Difficile,-1,Plus Difficile que la Prediction,Pas Adapte
2045,2016,Sociologie,1,"Travail, Emploi, Chomage",4,La Question du Travail,8,980,3,QCU,0.53,0.28,9.68,5,45,50,19,5,14,2.63,26.32,Difficile,Difficile,0,Meme Difficulte que la Prediction,Pas Adapte
3111,2017,Sociologie,1,"Travail, Emploi, Chomage",4,La Question du Travail,8,980,3,QCU,0.49,0.24,8.96,4,46,50,31,4,27,1.61,12.9,Moyen,Difficile,-1,Plus Difficile que la Prediction,Pas Adapte
4177,2018,Sociologie,1,"Travail, Emploi, Chomage",4,La Question du Travail,8,980,3,QCU,0.08,0.92,86.32,38,6,44,40,38,2,1.1,95.0,Facile,Facile,0,Meme Difficulte que la Prediction,Pas Adapte
5243,2019,Sociologie,1,"Travail, Emploi, Chomage",4,La Question du Travail,8,980,3,QCU,0.65,0.37,34.1,17,32,49,45,17,28,1.09,37.78,Moyen,Difficile,-1,Plus Difficile que la Prediction,Pas Adapte
6309,2020,Sociologie,1,"Travail, Emploi, Chomage",4,La Question du Travail,8,980,3,QCU,0.27,0.6,59.88,33,22,55,52,33,19,1.06,63.46,Moyen,Moyen,0,Meme Difficulte que la Prediction,Pas Adapte
980,2015,Sociologie,1,"Travail, Emploi, Chomage",4,La Question du Travail,8,981,4,QCM,0.65,0.28,30.34,20,45,65,58,20,38,1.12,34.48,Facile,Difficile,-2,Beaucoup plus Difficile que la Prediction,Pas Adapte
2046,2016,Sociologie,1,"Travail, Emploi, Chomage",4,La Question du Travail,8,981,4,QCM,0.08,0.88,98.15,71,1,72,71,71,0,1.01,100.0,Difficile,Facile,2,Beaucoup plus Facile que la Prediction,Pas Adapte
3112,2017,Sociologie,1,"Travail, Emploi, Chomage",4,La Question du Travail,8,981,4,QCM,0.36,0.53,37.87,24,40,64,58,24,34,1.1,41.38,Moyen,Moyen,0,Meme Difficulte que la Prediction,Pas Adapte
4178,2018,Sociologie,1,"Travail, Emploi, Chomage",4,La Question du Travail,8,981,4,QCM,0.57,0.23,28.89,20,48,68,65,20,45,1.05,30.77,Moyen,Difficile,-1,Plus Difficile que la Prediction,Pas Adapte
5244,2019,Sociologie,1,"Travail, Emploi, Chomage",4,La Question du Travail,8,981,4,QCM,0.74,0.16,33.18,23,46,69,24,23,1,2.88,95.83,Difficile,Difficile,0,Meme Difficulte que la Prediction,Pas Adapte
6310,2020,Sociologie,1,"Travail, Emploi, Chomage",4,La Question du Travail,8,981,4,QCM,0.69,0.16,8.48,5,57,62,59,5,54,1.05,8.47,Difficile,Difficile,0,Meme Difficulte que la Prediction,Pas Adapte
981,2015,Sociologie,1,"Travail, Emploi, Chomage",4,La Question du Travail,8,982,5,QCU,0.73,0.37,16.38,6,31,37,19,6,13,1.95,31.58,Difficile,Difficile,0,Meme Difficulte que la Prediction,Pas Adapte
2047,2016,Sociologie,1,"Travail, Emploi, Chomage",4,La Question du Travail,8,982,5,QCM,0.59,0.16,4.24,2,37,39,28,2,26,1.39,7.14,Difficile,Difficile,0,Meme Difficulte que la Prediction,Pas Adapte
3113,2017,Sociologie,1,"Travail, Emploi, Chomage",4,La Question du Travail,8,982,5,QCM,0.52,0.2,9.75,4,34,38,23,4,19,1.65,17.39,Moyen,Difficile,-1,Plus Difficile que la Prediction,Pas Adapte
4179,2018,Sociologie,1,"Travail, Emploi, Chomage",4,La Question du Travail,8,982,5,QCM,0.62,0.22,4.66,2,35,37,30,2,28,1.23,6.67,Facile,Difficile,-2,Beaucoup plus Difficile que la Prediction,Pas Adapte
5245,2019,Sociologie,1,"Travail, Emploi, Chomage",4,La Question du Travail,8,982,5,QCM,0.15,0.84,90.45,30,3,33,30,30,0,1.1,100.0,Facile,Facile,0,Meme Difficulte que la Prediction,Pas Adapte
6311,2020,Sociologie,1,"Travail, Emploi, Chomage",4,La Question du Travail,8,982,5,QCM,0.06,0.71,73.84,25,9,34,27,25,2,1.26,92.59,Moyen,Facile,1,Plus Facile que la Prediction,Adapte
982,2015,Sociologie,1,"Travail, Emploi, Chomage",4,La Question du Travail,8,983,6,QROC,0.98,0.06,22.31,4,15,19,16,4,12,1.19,25.0,Difficile,Difficile,0,Meme Difficulte que la Prediction,Pas Adapte
2048,2016,Sociologie,1,"Travail, Emploi, Chomage",4,La Question du Travail,8,983,6,QROC,0.02,0.64,87.25,19,3,22,20,19,1,1.1,95.0,Moyen,Facile,1,Plus Facile que la Prediction,Pas Adapte
3114,2017,Sociologie,1,"Travail, Emploi, Chomage",4,La Question du Travail,8,983,6,QROC,0.73,0.05,2.85,1,19,20,15,1,14,1.33,6.67,Moyen,Difficile,-1,Plus Difficile que la Prediction,Pas Adapte
4180,2018,Sociologie,1,"Travail, Emploi, Chomage",4,La Question du Travail,8,983,6,QROC,0.13,0.86,89.15,16,2,18,17,16,1,1.06,94.12,Moyen,Facile,1,Plus Facile que la Prediction,Pas Adapte
5246,2019,Sociologie,1,"Travail, Emploi, Chomage",4,La Question du Travail,8,983,6,QROC,0.65,0.08,17.95,3,16,19,15,3,12,1.27,20.0,Difficile,Difficile,0,Meme Difficulte que la Prediction,Pas Adapte
6312,2020,Sociologie,1,"Travail, Emploi, Chomage",4,La Question du Travail,8,983,6,QO,0.93,0.05,12.16,2,15,17,12,2,10,1.42,16.67,Difficile,Difficile,0,Meme Difficulte que la Prediction,Pas Adapte
983,2015,Sociologie,1,"Travail, Emploi, Chomage",4,La Question du Travail,8,984,7,QCU,0.27,0.52,57.86,7,5,12,10,7,3,1.2,70.0,Facile,Moyen,-1,Plus Difficile que la Prediction,Pas Adapte
2049,2016,Sociologie,1,"Travail, Emploi, Chomage",4,La Question du Travail,8,984,7,QCU,0.24,0.49,64.32,9,5,14,10,9,1,1.4,90.0,Moyen,Moyen,0,Meme Difficulte que la Prediction,Adapte
3115,2017,Sociologie,1,"Travail, Emploi, Chomage",4,La Question du Travail,8,984,7,QCU,0.25,0.66,64.32,10,5,15,12,10,2,1.25,83.33,Moyen,Moyen,0,Meme Difficulte que la Prediction,Adapte
4181,2018,Sociologie,1,"Travail, Emploi, Chomage",4,La Question du Travail,8,984,7,QCU,0.33,0.73,64.32,10,6,16,11,10,1,1.45,90.91,Moyen,Moyen,0,Meme Difficulte que la Prediction,Adapte
5247,2019,Sociologie,1,"Travail, Emploi, Chomage",4,La Question du Travail,8,984,7,QCU,0.34,0.57,64.32,9,5,14,14,9,5,1.0,64.29,Moyen,Moyen,0,Meme Difficulte que la Prediction,Adapte
6313,2020,Sociologie,1,"Travail, Emploi, Chomage",4,La Question du Travail,8,984,7,QCU,0.21,0.64,64.32,10,5,15,13,10,3,1.15,76.92,Moyen,Moyen,0,Meme Difficulte que la Prediction,Adapte
984,2015,Sociologie,1,"Travail, Emploi, Chomage",4,La Question du Travail,8,985,8,QO,0.84,0.03,24.9,3,11,14,12,3,9,1.17,25.0,Difficile,Difficile,0,Meme Difficulte que la Prediction,Pas Adapte
2050,2016,Sociologie,1,"Travail, Emploi, Chomage",4,La Question du Travail,8,985,8,QO,0.09,0.84,82.36,12,3,15,15,12,3,1.0,80.0,Facile,Facile,0,Meme Difficulte que la Prediction,Pas Adapte
3116,2017,Sociologie,1,"Travail, Emploi, Chomage",4,La Question du Travail,8,985,8,QO,0.71,0.24,61.24,9,5,14,13,9,4,1.08,69.23,Difficile,Moyen,1,Plus Facile que la Prediction,Adapte
4182,2018,Sociologie,1,"Travail, Emploi, Chomage",4,La Question du Travail,8,985,8,QO,0.34,0.24,61.24,9,5,14,9,9,0,1.56,100.0,Moyen,Moyen,0,Meme Difficulte que la Prediction,Adapte
5248,2019,Sociologie,1,"Travail, Emploi, Chomage",4,La Question du Travail,8,985,8,QO,0.37,0.23,61.24,9,5,14,13,9,4,1.08,69.23,Moyen,Moyen,0,Meme Difficulte que la Prediction,Adapte
6314,2020,Sociologie,1,"Travail, Emploi, Chomage",4,La Question du Travail,8,985,8,QO,0.31,0.28,61.24,7,5,12,7,7,0,1.71,100.0,Moyen,Moyen,0,Meme Difficulte que la Prediction,Adapte
985,2015,Sociologie,1,Notions de Sociologie,1,Les Modernites,12,986,1,QCU,0.13,0.75,98.62,50,1,51,51,50,1,1.0,98.04,Moyen,Facile,1,Plus Facile que la Prediction,Pas Adapte
2051,2016,Sociologie,1,Notions de Sociologie,1,Les Modernites,12,986,1,QCU,0.54,0.33,6.53,3,44,47,36,3,33,1.31,8.33,Difficile,Difficile,0,Meme Difficulte que la Prediction,Pas Adapte
3117,2017,Sociologie,1,Notions de Sociologie,1,Les Modernites,12,986,1,QCU,0.45,0.39,22.99,11,39,50,33,11,22,1.52,33.33,Difficile,Difficile,0,Meme Difficulte que la Prediction,Pas Adapte
4183,2018,Sociologie,1,Notions de Sociologie,1,Les Modernites,12,986,1,QCU,0.09,0.79,78.05,41,11,52,47,41,6,1.11,87.23,Facile,Facile,0,Meme Difficulte que la Prediction,Pas Adapte
5249,2019,Sociologie,1,Notions de Sociologie,1,Les Modernites,12,986,1,QCU,0.01,0.87,81.47,43,10,53,47,43,4,1.13,91.49,Difficile,Facile,2,Beaucoup plus Facile que la Prediction,Pas Adapte
6315,2020,Sociologie,1,Notions de Sociologie,1,Les Modernites,12,986,1,QCM,0.4,0.61,61.29,37,23,60,46,37,9,1.3,80.43,Moyen,Moyen,0,Meme Difficulte que la Prediction,Adapte
986,2015,Sociologie,1,Notions de Sociologie,1,Les Modernites,12,987,2,QCM,0.17,0.94,99.76,59,0,59,59,59,0,1.0,100.0,Facile,Facile,0,Meme Difficulte que la Prediction,Pas Adapte
2052,2016,Sociologie,1,Notions de Sociologie,1,Les Modernites,12,987,2,QCU,0.51,0.23,23.43,12,38,50,27,12,15,1.85,44.44,Difficile,Difficile,0,Meme Difficulte que la Prediction,Pas Adapte
3118,2017,Sociologie,1,Notions de Sociologie,1,Les Modernites,12,987,2,QO,0.85,0.04,20.19,11,42,53,40,11,29,1.32,27.5,Facile,Difficile,-2,Beaucoup plus Difficile que la Prediction,Pas Adapte
4184,2018,Sociologie,1,Notions de Sociologie,1,Les Modernites,12,987,2,QO,0.09,0.59,93.62,45,3,48,45,45,0,1.07,100.0,Facile,Facile,0,Meme Difficulte que la Prediction,Pas Adapte
5250,2019,Sociologie,1,Notions de Sociologie,1,Les Modernites,12,987,2,QO,0.73,0.2,54.57,23,19,42,26,23,3,1.62,88.46,Moyen,Moyen,0,Meme Difficulte que la Prediction,Pas Adapte
6316,2020,Sociologie,1,Notions de Sociologie,1,Les Modernites,12,987,2,QO,0.16,0.48,79.15,34,9,43,37,34,3,1.16,91.89,Moyen,Facile,1,Plus Facile que la Prediction,Pas Adapte
987,2015,Sociologie,1,Notions de Sociologie,1,Les Modernites,12,988,3,QCU,0.1,0.88,89.85,68,8,76,71,68,3,1.07,95.77,Facile,Facile,0,Meme Difficulte que la Prediction,Pas Adapte
2053,2016,Sociologie,1,Notions de Sociologie,1,Les Modernites,12,988,3,QCU,0.42,0.2,17.63,15,68,83,50,15,35,1.66,30.0,Difficile,Difficile,0,Meme Difficulte que la Prediction,Pas Adapte
3119,2017,Sociologie,1,Notions de Sociologie,1,Les Modernites,12,988,3,QCU,0.63,0.39,28.46,24,61,85,52,24,28,1.63,46.15,Difficile,Difficile,0,Meme Difficulte que la Prediction,Pas Adapte
4185,2018,Sociologie,1,Notions de Sociologie,1,Les Modernites,12,988,3,QCU,0.37,0.6,62.94,50,29,79,71,50,21,1.11,70.42,Moyen,Moyen,0,Meme Difficulte que la Prediction,Adapte
5251,2019,Sociologie,1,Notions de Sociologie,1,Les Modernites,12,988,3,QCM,0.42,0.4,62.94,44,26,70,55,44,11,1.27,80.0,Moyen,Moyen,0,Meme Difficulte que la Prediction,Adapte
6317,2020,Sociologie,1,Notions de Sociologie,1,Les Modernites,12,988,3,QCM,0.32,0.42,62.94,40,24,64,40,40,0,1.6,100.0,Moyen,Moyen,0,Meme Difficulte que la Prediction,Adapte
988,2015,Sociologie,1,Notions de Sociologie,1,Les Modernites,12,989,4,QCU,0.09,0.94,66.87,60,30,90,65,60,5,1.38,92.31,Facile,Facile,0,Meme Difficulte que la Prediction,Adapte
2054,2016,Sociologie,1,Notions de Sociologie,1,Les Modernites,12,989,4,QCU,0.02,0.86,66.87,63,31,94,90,63,27,1.04,70.0,Facile,Facile,0,Meme Difficulte que la Prediction,Adapte
3120,2017,Sociologie,1,Notions de Sociologie,1,Les Modernites,12,989,4,QCU,0.15,0.75,66.87,61,30,91,88,61,27,1.03,69.32,Facile,Facile,0,Meme Difficulte que la Prediction,Adapte
4186,2018,Sociologie,1,Notions de Sociologie,1,Les Modernites,12,989,4,QCU,0.1,0.88,66.87,53,27,80,79,53,26,1.01,67.09,Facile,Facile,0,Meme Difficulte que la Prediction,Adapte
5252,2019,Sociologie,1,Notions de Sociologie,1,Les Modernites,12,989,4,QCU,0.17,0.76,66.87,53,27,80,79,53,26,1.01,67.09,Facile,Facile,0,Meme Difficulte que la Prediction,Adapte
6318,2020,Sociologie,1,Notions de Sociologie,1,Les Modernites,12,989,4,QCU,0.13,0.83,66.87,45,23,68,66,45,21,1.03,68.18,Facile,Facile,0,Meme Difficulte que la Prediction,Adapte
989,2015,Sociologie,1,Notions de Sociologie,1,Les Modernites,12,990,5,QCM,0.62,0.2,2.03,1,72,73,56,1,55,1.3,1.79,Difficile,Difficile,0,Meme Difficulte que la Prediction,Pas Adapte
2055,2016,Sociologie,1,Notions de Sociologie,1,Les Modernites,12,990,5,QCM,0.04,0.89,77.11,52,15,67,56,52,4,1.2,92.86,Difficile,Facile,2,Beaucoup plus Facile que la Prediction,Pas Adapte
3121,2017,Sociologie,1,Notions de Sociologie,1,Les Modernites,12,990,5,QCM,0.44,0.43,46.47,33,37,70,60,33,27,1.17,55.0,Difficile,Moyen,1,Plus Facile que la Prediction,Pas Adapte
4187,2018,Sociologie,1,Notions de Sociologie,1,Les Modernites,12,990,5,QCM,0.75,0.25,8.01,6,64,70,21,6,15,3.33,28.57,Facile,Difficile,-2,Beaucoup plus Difficile que la Prediction,Pas Adapte
5253,2019,Sociologie,1,Notions de Sociologie,1,Les Modernites,12,990,5,QCM,0.52,0.19,11.94,7,53,60,18,7,11,3.33,38.89,Facile,Difficile,-2,Beaucoup plus Difficile que la Prediction,Pas Adapte
6319,2020,Sociologie,1,Notions de Sociologie,1,Les Modernites,12,990,5,QCM,0.54,0.21,30.54,16,36,52,52,16,36,1.0,30.77,Difficile,Difficile,0,Meme Difficulte que la Prediction,Pas Adapte
990,2015,Sociologie,1,Notions de Sociologie,1,Les Modernites,12,991,6,QCM,0.75,0.28,17.73,12,53,65,51,12,39,1.27,23.53,Difficile,Difficile,0,Meme Difficulte que la Prediction,Pas Adapte
2056,2016,Sociologie,1,Notions de Sociologie,1,Les Modernites,12,991,6,QCM,0.73,0.22,15.94,9,47,56,25,9,16,2.24,36.0,Facile,Difficile,-2,Beaucoup plus Difficile que la Prediction,Pas Adapte
3122,2017,Sociologie,1,Notions de Sociologie,1,Les Modernites,12,991,6,QCM,0.22,0.64,60.22,31,20,51,35,31,4,1.46,88.57,Moyen,Moyen,0,Meme Difficulte que la Prediction,Adapte
4188,2018,Sociologie,1,Notions de Sociologie,1,Les Modernites,12,991,6,QCM,0.27,0.42,60.22,30,20,50,42,30,12,1.19,71.43,Moyen,Moyen,0,Meme Difficulte que la Prediction,Adapte
5254,2019,Sociologie,1,Notions de Sociologie,1,Les Modernites,12,991,6,QO,0.2,0.24,60.22,32,21,53,39,32,7,1.36,82.05,Moyen,Moyen,0,Meme Difficulte que la Prediction,Adapte
6320,2020,Sociologie,1,Notions de Sociologie,1,Les Modernites,12,991,6,QO,0.51,0.25,60.22,28,18,46,39,28,11,1.18,71.79,Moyen,Moyen,0,Meme Difficulte que la Prediction,Adapte
991,2015,Sociologie,1,Notions de Sociologie,1,Les Modernites,12,992,7,QCU,0.49,0.39,30.35,29,65,94,62,29,33,1.52,46.77,Facile,Difficile,-2,Beaucoup plus Difficile que la Prediction,Pas Adapte
2057,2016,Sociologie,1,Notions de Sociologie,1,Les Modernites,12,992,7,QCU,0.48,0.23,11.55,9,71,80,41,9,32,1.95,21.95,Facile,Difficile,-2,Beaucoup plus Difficile que la Prediction,Pas Adapte
3123,2017,Sociologie,1,Notions de Sociologie,1,Les Modernites,12,992,7,QROC,0.32,0.25,52.56,38,34,72,65,38,27,1.11,58.46,Facile,Moyen,-1,Plus Difficile que la Prediction,Pas Adapte
4189,2018,Sociologie,1,Notions de Sociologie,1,Les Modernites,12,992,7,QROC,0.97,0.18,10.84,8,68,76,71,8,63,1.07,11.27,Difficile,Difficile,0,Meme Difficulte que la Prediction,Pas Adapte
5255,2019,Sociologie,1,Notions de Sociologie,1,Les Modernites,12,992,7,QROC,0.11,0.92,85.28,55,10,65,60,55,5,1.08,91.67,Moyen,Facile,1,Plus Facile que la Prediction,Pas Adapte
6321,2020,Sociologie,1,Notions de Sociologie,1,Les Modernites,12,992,7,QROC,0.69,0.06,7.61,5,64,69,34,5,29,2.03,14.71,Moyen,Difficile,-1,Plus Difficile que la Prediction,Pas Adapte
992,2015,Sociologie,1,Notions de Sociologie,1,Les Modernites,12,993,8,QCU,0.56,0.22,31.98,4,10,14,7,4,3,2.0,57.14,Difficile,Difficile,0,Meme Difficulte que la Prediction,Pas Adapte
2058,2016,Sociologie,1,Notions de Sociologie,1,Les Modernites,12,993,8,QCU,0.12,0.85,93.65,13,1,14,13,13,0,1.08,100.0,Facile,Facile,0,Meme Difficulte que la Prediction,Pas Adapte
3124,2017,Sociologie,1,Notions de Sociologie,1,Les Modernites,12,993,8,QCU,0.05,0.93,86.04,13,2,15,14,13,1,1.07,92.86,Facile,Facile,0,Meme Difficulte que la Prediction,Pas Adapte
4190,2018,Sociologie,1,Notions de Sociologie,1,Les Modernites,12,993,8,QCU,0.17,0.92,81.34,12,3,15,14,12,2,1.07,85.71,Difficile,Facile,2,Beaucoup plus Facile que la Prediction,Pas Adapte
5256,2019,Sociologie,1,Notions de Sociologie,1,Les Modernites,12,993,8,QCU,0.72,0.27,26.39,4,10,14,5,4,1,2.8,80.0,Difficile,Difficile,0,Meme Difficulte que la Prediction,Pas Adapte
6322,2020,Sociologie,1,Notions de Sociologie,1,Les Modernites,12,993,8,QCU,0.41,0.2,30.26,4,9,13,8,4,4,1.62,50.0,Facile,Difficile,-2,Beaucoup plus Difficile que la Prediction,Pas Adapte
993,2015,Sociologie,1,Notions de Sociologie,1,Les Modernites,12,994,9,QCU,0.41,0.33,18.03,6,29,35,19,6,13,1.84,31.58,Moyen,Difficile,-1,Plus Difficile que la Prediction,Pas Adapte
2059,2016,Sociologie,1,Notions de Sociologie,1,Les Modernites,12,994,9,QCU,0.37,0.55,44.6,13,17,30,14,13,1,2.14,92.86,Facile,Moyen,-1,Plus Difficile que la Prediction,Pas Adapte
3125,2017,Sociologie,1,Notions de Sociologie,1,Les Modernites,12,994,9,QCU,0.63,0.34,0.35,0,27,27,9,0,9,3.0,0.0,Difficile,Difficile,0,Meme Difficulte que la Prediction,Pas Adapte
4191,2018,Sociologie,1,Notions de Sociologie,1,Les Modernites,12,994,9,QCU,0.32,0.48,57.0,17,12,29,25,17,8,1.16,68.0,Facile,Moyen,-1,Plus Difficile que la Prediction,Pas Adapte
5257,2019,Sociologie,1,Notions de Sociologie,1,Les Modernites,12,994,9,QCU,0.17,0.95,80.11,21,5,26,24,21,3,1.08,87.5,Difficile,Facile,2,Beaucoup plus Facile que la Prediction,Pas Adapte
6323,2020,Sociologie,1,Notions de Sociologie,1,Les Modernites,12,994,9,QCU,0.16,0.96,85.32,20,3,23,22,20,2,1.05,90.91,Facile,Facile,0,Meme Difficulte que la Prediction,Pas Adapte
994,2015,Sociologie,1,Notions de Sociologie,1,Les Modernites,12,995,10,QCU,0.34,0.68,56.74,7,6,13,12,7,5,1.08,58.33,Difficile,Moyen,1,Plus Facile que la Prediction,Pas Adapte
2060,2016,Sociologie,1,Notions de Sociologie,1,Les Modernites,12,995,10,QCM,0.79,0.28,25.3,3,9,12,6,3,3,2.0,50.0,Difficile,Difficile,0,Meme Difficulte que la Prediction,Pas Adapte
3126,2017,Sociologie,1,Notions de Sociologie,1,Les Modernites,12,995,10,QCM,0.14,0.92,88.16,10,1,11,11,10,1,1.0,90.91,Facile,Facile,0,Meme Difficulte que la Prediction,Pas Adapte
4192,2018,Sociologie,1,Notions de Sociologie,1,Les Modernites,12,995,10,QCM,0.15,0.92,87.5,8,1,9,8,8,0,1.12,100.0,Difficile,Facile,2,Beaucoup plus Facile que la Prediction,Pas Adapte
5258,2019,Sociologie,1,Notions de Sociologie,1,Les Modernites,12,995,10,QCM,0.18,0.81,98.9,8,0,8,8,8,0,1.0,100.0,Facile,Facile,0,Meme Difficulte que la Prediction,Pas Adapte
6324,2020,Sociologie,1,Notions de Sociologie,1,Les Modernites,12,995,10,QCM,0.52,0.29,31.02,2,5,7,6,2,4,1.17,33.33,Difficile,Difficile,0,Meme Difficulte que la Prediction,Pas Adapte
995,2015,Sociologie,1,Notions de Sociologie,1,Les Modernites,12,996,11,QCU,0.39,0.55,62.2,58,36,94,65,58,7,1.45,89.23,Difficile,Moyen,1,Plus Facile que la Prediction,Adapte
2061,2016,Sociologie,1,Notions de Sociologie,1,Les Modernites,12,996,11,QCU,0.3,0.64,62.2,50,30,80,70,50,20,1.14,71.43,Moyen,Moyen,0,Meme Difficulte que la Prediction,Adapte
3127,2017,Sociologie,1,Notions de Sociologie,1,Les Modernites,12,996,11,QCU,0.32,0.72,62.2,53,33,86,55,53,2,1.56,96.36,Moyen,Moyen,0,Meme Difficulte que la Prediction,Adapte
4193,2018,Sociologie,1,Notions de Sociologie,1,Les Modernites,12,996,11,QCU,0.39,0.46,62.2,57,35,92,59,57,2,1.56,96.61,Moyen,Moyen,0,Meme Difficulte que la Prediction,Adapte
5259,2019,Sociologie,1,Notions de Sociologie,1,Les Modernites,12,996,11,QCU,0.27,0.53,62.2,60,37,97,84,60,24,1.15,71.43,Moyen,Moyen,0,Meme Difficulte que la Prediction,Adapte
6325,2020,Sociologie,1,Notions de Sociologie,1,Les Modernites,12,996,11,QCU,0.23,0.49,62.2,53,33,86,85,53,32,1.01,62.35,Moyen,Moyen,0,Meme Difficulte que la Prediction,Adapte
996,2015,Sociologie,1,Notions de Sociologie,1,Les Modernites,12,997,12,QROC,0.09,0.92,79.5,41,11,52,42,41,1,1.24,97.62,Facile,Facile,0,Meme Difficulte que la Prediction,Pas Adapte
2062,2016,Sociologie,1,Notions de Sociologie,1,Les Modernites,12,997,12,QROC,0.01,0.75,65.51,30,16,46,45,30,15,1.02,66.67,Difficile,Facile,2,Beaucoup plus Facile que la Prediction,Adapte
3128,2017,Sociologie,1,Notions de Sociologie,1,Les Modernites,12,997,12,QROC,0.11,0.66,65.51,31,16,47,43,31,12,1.09,72.09,Facile,Facile,0,Meme Difficulte que la Prediction,Adapte
4194,2018,Sociologie,1,Notions de Sociologie,1,Les Modernites,12,997,12,QROC,0.02,0.89,65.51,31,17,48,33,31,2,1.45,93.94,Facile,Facile,0,Meme Difficulte que la Prediction,Adapte
5260,2019,Sociologie,1,Notions de Sociologie,1,Les Modernites,12,997,12,QROC,0.04,0.7,65.51,34,18,52,51,34,17,1.02,66.67,Facile,Facile,0,Meme Difficulte que la Prediction,Adapte
6326,2020,Sociologie,1,Notions de Sociologie,1,Les Modernites,12,997,12,QROC,0.06,0.53,65.51,32,17,49,38,32,6,1.29,84.21,Facile,Facile,0,Meme Difficulte que la Prediction,Adapte
997,2015,Sociologie,1,Notions de Sociologie,2,Structure et Classes Sociales,13,998,1,QCM,0.6,0.17,3.9,3,78,81,37,3,34,2.19,8.11,Difficile,Difficile,0,Meme Difficulte que la Prediction,Pas Adapte
2063,2016,Sociologie,1,Notions de Sociologie,2,Structure et Classes Sociales,13,998,1,QCM,0.06,0.83,83.72,58,11,69,66,58,8,1.05,87.88,Facile,Facile,0,Meme Difficulte que la Prediction,Pas Adapte
3129,2017,Sociologie,1,Notions de Sociologie,2,Structure et Classes Sociales,13,998,1,QO,0.11,0.59,96.87,64,2,66,65,64,1,1.02,98.46,Facile,Facile,0,Meme Difficulte que la Prediction,Pas Adapte
4195,2018,Sociologie,1,Notions de Sociologie,2,Structure et Classes Sociales,13,998,1,QO,0.07,0.34,72.26,46,18,64,58,46,12,1.1,79.31,Facile,Facile,0,Meme Difficulte que la Prediction,Adapte
5261,2019,Sociologie,1,Notions de Sociologie,2,Structure et Classes Sociales,13,998,1,QO,0.13,0.37,72.26,50,19,69,63,50,13,1.1,79.37,Facile,Facile,0,Meme Difficulte que la Prediction,Adapte
6327,2020,Sociologie,1,Notions de Sociologie,2,Structure et Classes Sociales,13,998,1,QO,0.06,0.83,72.26,49,19,68,55,49,6,1.24,89.09,Facile,Facile,0,Meme Difficulte que la Prediction,Adapte
998,2015,Sociologie,1,Notions de Sociologie,2,Structure et Classes Sociales,13,999,2,QCU,0.26,0.54,36.31,28,49,77,75,28,47,1.03,37.33,Facile,Moyen,-1,Plus Difficile que la Prediction,Pas Adapte
2064,2016,Sociologie,1,Notions de Sociologie,2,Structure et Classes Sociales,13,999,2,QCU,0.27,0.65,41.03,30,44,74,68,30,38,1.09,44.12,Moyen,Moyen,0,Meme Difficulte que la Prediction,Pas Adapte
3130,2017,Sociologie,1,Notions de Sociologie,2,Structure et Classes Sociales,13,999,2,QCU,0.51,0.28,6.04,5,72,77,51,5,46,1.51,9.8,Moyen,Difficile,-1,Plus Difficile que la Prediction,Pas Adapte
4196,2018,Sociologie,1,Notions de Sociologie,2,Structure et Classes Sociales,13,999,2,QCU,0.26,0.72,60.46,42,27,69,63,42,21,1.1,66.67,Facile,Moyen,-1,Plus Difficile que la Prediction,Adapte
5262,2019,Sociologie,1,Notions de Sociologie,2,Structure et Classes Sociales,13,999,2,QCU,0.25,0.55,60.46,36,23,59,46,36,10,1.28,78.26,Moyen,Moyen,0,Meme Difficulte que la Prediction,Adapte
6328,2020,Sociologie,1,Notions de Sociologie,2,Structure et Classes Sociales,13,999,2,QCU,0.39,0.43,60.46,34,22,56,48,34,14,1.17,70.83,Moyen,Moyen,0,Meme Difficulte que la Prediction,Adapte
999,2015,Sociologie,1,Notions de Sociologie,2,Structure et Classes Sociales,13,1000,3,QCU,0.46,0.25,18.43,10,46,56,28,10,18,2.0,35.71,Difficile,Difficile,0,Meme Difficulte que la Prediction,Pas Adapte
2065,2016,Sociologie,1,Notions de Sociologie,2,Structure et Classes Sociales,13,1000,3,QCU,0.74,0.3,0.88,1,58,59,46,1,45,1.28,2.17,Moyen,Difficile,-1,Plus Difficile que la Prediction,Pas Adapte
3131,2017,Sociologie,1,Notions de Sociologie,2,Structure et Classes Sociales,13,1000,3,QCU,0.63,0.22,16.03,9,46,55,22,9,13,2.5,40.91,Moyen,Difficile,-1,Plus Difficile que la Prediction,Pas Adapte
4197,2018,Sociologie,1,Notions de Sociologie,2,Structure et Classes Sociales,13,1000,3,QCU,0.45,0.36,21.45,13,47,60,54,13,41,1.11,24.07,Moyen,Difficile,-1,Plus Difficile que la Prediction,Pas Adapte
5263,2019,Sociologie,1,Notions de Sociologie,2,Structure et Classes Sociales,13,1000,3,QCM,0.01,0.94,78.26,44,12,56,50,44,6,1.12,88.0,Facile,Facile,0,Meme Difficulte que la Prediction,Pas Adapte
6329,2020,Sociologie,1,Notions de Sociologie,2,Structure et Classes Sociales,13,1000,3,QCM,0.57,0.27,32.43,21,43,64,33,21,12,1.94,63.64,Difficile,Difficile,0,Meme Difficulte que la Prediction,Pas Adapte
1000,2015,Sociologie,1,Notions de Sociologie,2,Structure et Classes Sociales,13,1001,4,QCU,0.33,0.69,37.54,12,20,32,19,12,7,1.68,63.16,Difficile,Moyen,1,Plus Facile que la Prediction,Pas Adapte
2066,2016,Sociologie,1,Notions de Sociologie,2,Structure et Classes Sociales,13,1001,4,QO,0.03,0.98,90.56,34,3,37,35,34,1,1.06,97.14,Facile,Facile,0,Meme Difficulte que la Prediction,Pas Adapte
3132,2017,Sociologie,1,Notions de Sociologie,2,Structure et Classes Sociales,13,1001,4,QO,0.06,0.36,92.4,40,3,43,42,40,2,1.02,95.24,Facile,Facile,0,Meme Difficulte que la Prediction,Pas Adapte
4198,2018,Sociologie,1,Notions de Sociologie,2,Structure et Classes Sociales,13,1001,4,QO,0.0,0.44,79.63,38,10,48,44,38,6,1.09,86.36,Facile,Facile,0,Meme Difficulte que la Prediction,Pas Adapte
5264,2019,Sociologie,1,Notions de Sociologie,2,Structure et Classes Sociales,13,1001,4,QO,0.09,0.42,86.66,45,7,52,49,45,4,1.06,91.84,Facile,Facile,0,Meme Difficulte que la Prediction,Pas Adapte
6330,2020,Sociologie,1,Notions de Sociologie,2,Structure et Classes Sociales,13,1001,4,QO,0.05,0.67,71.53,36,14,50,37,36,1,1.35,97.3,Difficile,Facile,2,Beaucoup plus Facile que la Prediction,Adapte
1001,2015,Sociologie,1,Notions de Sociologie,2,Structure et Classes Sociales,13,1002,5,QCU,0.32,0.66,36.72,10,17,27,22,10,12,1.23,45.45,Facile,Moyen,-1,Plus Difficile que la Prediction,Pas Adapte
2067,2016,Sociologie,1,Notions de Sociologie,2,Structure et Classes Sociales,13,1002,5,QCU,0.38,0.42,63.28,19,11,30,30,19,11,1.0,63.33,Moyen,Moyen,0,Meme Difficulte que la Prediction,Adapte
3133,2017,Sociologie,1,Notions de Sociologie,2,Structure et Classes Sociales,13,1002,5,QCU,0.23,0.69,63.28,16,10,26,16,16,0,1.62,100.0,Moyen,Moyen,0,Meme Difficulte que la Prediction,Adapte
4199,2018,Sociologie,1,Notions de Sociologie,2,Structure et Classes Sociales,13,1002,5,QCU,0.33,0.53,63.28,19,11,30,22,19,3,1.36,86.36,Moyen,Moyen,0,Meme Difficulte que la Prediction,Adapte
5265,2019,Sociologie,1,Notions de Sociologie,2,Structure et Classes Sociales,13,1002,5,QCU,0.23,0.71,63.28,18,11,29,23,18,5,1.26,78.26,Moyen,Moyen,0,Meme Difficulte que la Prediction,Adapte
6331,2020,Sociologie,1,Notions de Sociologie,2,Structure et Classes Sociales,13,1002,5,QCU,0.39,0.48,63.28,18,11,29,22,18,4,1.32,81.82,Moyen,Moyen,0,Meme Difficulte que la Prediction,Adapte
1002,2015,Sociologie,1,Notions de Sociologie,2,Structure et Classes Sociales,13,1003,6,QCM,0.21,0.47,48.62,13,13,26,17,13,4,1.53,76.47,Facile,Moyen,-1,Plus Difficile que la Prediction,Pas Adapte
2068,2016,Sociologie,1,Notions de Sociologie,2,Structure et Classes Sociales,13,1003,6,QCM,0.03,0.88,86.83,21,3,24,22,21,1,1.09,95.45,Moyen,Facile,1,Plus Facile que la Prediction,Pas Adapte
3134,2017,Sociologie,1,Notions de Sociologie,2,Structure et Classes Sociales,13,1003,6,QCM,0.49,0.32,57.45,14,10,24,18,14,4,1.33,77.78,Difficile,Moyen,1,Plus Facile que la Prediction,Pas Adapte
4200,2018,Sociologie,1,Notions de Sociologie,2,Structure et Classes Sociales,13,1003,6,QCM,0.07,0.82,89.71,19,2,21,20,19,1,1.05,95.0,Facile,Facile,0,Meme Difficulte que la Prediction,Pas Adapte
5266,2019,Sociologie,1,Notions de Sociologie,2,Structure et Classes Sociales,13,1003,6,QCM,0.31,0.3,46.84,10,12,22,19,10,9,1.16,52.63,Moyen,Moyen,0,Meme Difficulte que la Prediction,Pas Adapte
6332,2020,Sociologie,1,Notions de Sociologie,2,Structure et Classes Sociales,13,1003,6,QCM,0.53,0.25,0.8,0,24,24,7,0,7,3.43,0.0,Difficile,Difficile,0,Meme Difficulte que la Prediction,Pas Adapte
1003,2015,Sociologie,1,Notions de Sociologie,2,Structure et Classes Sociales,13,1004,7,QROC,0.52,0.28,43.63,37,47,84,38,37,1,2.21,97.37,Moyen,Moyen,0,Meme Difficulte que la Prediction,Pas Adapte
2069,2016,Sociologie,1,Notions de Sociologie,2,Structure et Classes Sociales,13,1004,7,QROC,0.06,0.49,70.53,63,26,89,84,63,21,1.06,75.0,Facile,Facile,0,Meme Difficulte que la Prediction,Adapte
3135,2017,Sociologie,1,Notions de Sociologie,2,Structure et Classes Sociales,13,1004,7,QROC,0.11,0.61,70.53,61,26,87,62,61,1,1.4,98.39,Facile,Facile,0,Meme Difficulte que la Prediction,Adapte
4201,2018,Sociologie,1,Notions de Sociologie,2,Structure et Classes Sociales,13,1004,7,QROC,0.09,0.85,70.53,63,27,90,69,63,6,1.3,91.3,Facile,Facile,0,Meme Difficulte que la Prediction,Adapte
5267,2019,Sociologie,1,Notions de Sociologie,2,Structure et Classes Sociales,13,1004,7,QROC,0.15,0.42,70.53,54,23,77,61,54,7,1.26,88.52,Facile,Facile,0,Meme Difficulte que la Prediction,Adapte
6333,2020,Sociologie,1,Notions de Sociologie,2,Structure et Classes Sociales,13,1004,7,QROC,0.06,0.77,70.53,63,26,89,73,63,10,1.22,86.3,Facile,Facile,0,Meme Difficulte que la Prediction,Adapte
1004,2015,Sociologie,1,Notions de Sociologie,2,Structure et Classes Sociales,13,1005,8,QCU,0.05,0.93,98.68,79,1,80,79,79,0,1.01,100.0,Moyen,Facile,1,Plus Facile que la Prediction,Pas Adapte
2070,2016,Sociologie,1,Notions de Sociologie,2,Structure et Classes Sociales,13,1005,8,QCU,0.29,0.41,52.47,48,43,91,62,48,14,1.47,77.42,Facile,Moyen,-1,Plus Difficile que la Prediction,Pas Adapte
3136,2017,Sociologie,1,Notions de Sociologie,2,Structure et Classes Sociales,13,1005,8,QCU,0.06,0.91,86.9,86,13,99,93,86,7,1.06,92.47,Facile,Facile,0,Meme Difficulte que la Prediction,Pas Adapte
4202,2018,Sociologie,1,Notions de Sociologie,2,Structure et Classes Sociales,13,1005,8,QCU,0.07,0.92,85.48,94,16,110,100,94,6,1.1,94.0,Facile,Facile,0,Meme Difficulte que la Prediction,Pas Adapte
5268,2019,Sociologie,1,Notions de Sociologie,2,Structure et Classes Sociales,13,1005,8,QCU,0.57,0.31,2.61,3,116,119,59,3,56,2.02,5.08,Moyen,Difficile,-1,Plus Difficile que la Prediction,Pas Adapte
6334,2020,Sociologie,1,Notions de Sociologie,2,Structure et Classes Sociales,13,1005,8,QCU,0.34,0.61,42.53,46,63,109,74,46,28,1.47,62.16,Difficile,Moyen,1,Plus Facile que la Prediction,Pas Adapte
1005,2015,Sociologie,1,Notions de Sociologie,2,Structure et Classes Sociales,13,1006,9,QCU,0.38,0.47,58.44,18,13,31,20,18,2,1.55,90.0,Moyen,Moyen,0,Meme Difficulte que la Prediction,Pas Adapte
2071,2016,Sociologie,1,Notions de Sociologie,2,Structure et Classes Sociales,13,1006,9,QROC,0.37,0.25,64.57,21,12,33,24,21,3,1.38,87.5,Moyen,Moyen,0,Meme Difficulte que la Prediction,Adapte
3137,2017,Sociologie,1,Notions de Sociologie,2,Structure et Classes Sociales,13,1006,9,QROC,0.46,0.33,64.57,18,10,28,23,18,5,1.22,78.26,Moyen,Moyen,0,Meme Difficulte que la Prediction,Adapte
4203,2018,Sociologie,1,Notions de Sociologie,2,Structure et Classes Sociales,13,1006,9,QROC,0.42,0.29,64.57,21,11,32,31,21,10,1.03,67.74,Moyen,Moyen,0,Meme Difficulte que la Prediction,Adapte
5269,2019,Sociologie,1,Notions de Sociologie,2,Structure et Classes Sociales,13,1006,9,QCM,0.24,0.68,64.57,21,11,32,25,21,4,1.28,84.0,Moyen,Moyen,0,Meme Difficulte que la Prediction,Adapte
6335,2020,Sociologie,1,Notions de Sociologie,2,Structure et Classes Sociales,13,1006,9,QCM,0.39,0.47,64.57,22,12,34,30,22,8,1.13,73.33,Moyen,Moyen,0,Meme Difficulte que la Prediction,Adapte
1006,2015,Sociologie,1,Notions de Sociologie,2,Structure et Classes Sociales,13,1007,10,QCM,0.11,0.99,85.04,42,7,49,47,42,5,1.04,89.36,Difficile,Facile,2,Beaucoup plus Facile que la Prediction,Pas Adapte
2072,2016,Sociologie,1,Notions de Sociologie,2,Structure et Classes Sociales,13,1007,10,QCM,0.21,0.45,49.01,23,23,46,36,23,13,1.28,63.89,Difficile,Moyen,1,Plus Facile que la Prediction,Pas Adapte
3138,2017,Sociologie,1,Notions de Sociologie,2,Structure et Classes Sociales,13,1007,10,QCM,0.04,0.85,82.72,36,8,44,41,36,5,1.07,87.8,Difficile,Facile,2,Beaucoup plus Facile que la Prediction,Pas Adapte
4204,2018,Sociologie,1,Notions de Sociologie,2,Structure et Classes Sociales,13,1007,10,QCM,0.08,0.75,73.16,32,12,44,35,32,3,1.26,91.43,Facile,Facile,0,Meme Difficulte que la Prediction,Adapte
5270,2019,Sociologie,1,Notions de Sociologie,2,Structure et Classes Sociales,13,1007,10,QCM,0.03,0.71,73.16,29,10,39,35,29,6,1.11,82.86,Facile,Facile,0,Meme Difficulte que la Prediction,Adapte
6336,2020,Sociologie,1,Notions de Sociologie,2,Structure et Classes Sociales,13,1007,10,QCM,0.11,0.78,73.16,26,9,35,34,26,8,1.03,76.47,Facile,Facile,0,Meme Difficulte que la Prediction,Adapte
1007,2015,Sociologie,1,Notions de Sociologie,2,Structure et Classes Sociales,13,1008,11,QCM,0.1,0.84,81.12,67,16,83,72,67,5,1.15,93.06,Facile,Facile,0,Meme Difficulte que la Prediction,Pas Adapte
2073,2016,Sociologie,1,Notions de Sociologie,2,Structure et Classes Sociales,13,1008,11,QCM,0.12,1.0,66.28,50,25,75,62,50,12,1.21,80.65,Difficile,Facile,2,Beaucoup plus Facile que la Prediction,Adapte
3139,2017,Sociologie,1,Notions de Sociologie,2,Structure et Classes Sociales,13,1008,11,QCM,0.09,0.96,66.28,53,27,80,55,53,2,1.45,96.36,Facile,Facile,0,Meme Difficulte que la Prediction,Adapte
4205,2018,Sociologie,1,Notions de Sociologie,2,Structure et Classes Sociales,13,1008,11,QCM,0.09,0.98,66.28,46,23,69,67,46,21,1.03,68.66,Facile,Facile,0,Meme Difficulte que la Prediction,Adapte
5271,2019,Sociologie,1,Notions de Sociologie,2,Structure et Classes Sociales,13,1008,11,QO,0.14,0.58,66.28,46,24,70,51,46,5,1.37,90.2,Facile,Facile,0,Meme Difficulte que la Prediction,Adapte
6337,2020,Sociologie,1,Notions de Sociologie,2,Structure et Classes Sociales,13,1008,11,QO,0.19,0.36,66.28,51,26,77,73,51,22,1.05,69.86,Facile,Facile,0,Meme Difficulte que la Prediction,Adapte
1008,2015,Sociologie,1,Notions de Sociologie,2,Structure et Classes Sociales,13,1009,12,QCM,0.4,0.63,54.45,26,22,48,28,26,2,1.71,92.86,Moyen,Moyen,0,Meme Difficulte que la Prediction,Pas Adapte
2074,2016,Sociologie,1,Notions de Sociologie,2,Structure et Classes Sociales,13,1009,12,QCM,0.02,0.81,84.24,40,7,47,40,40,0,1.18,100.0,Facile,Facile,0,Meme Difficulte que la Prediction,Pas Adapte
3140,2017,Sociologie,1,Notions de Sociologie,2,Structure et Classes Sociales,13,1009,12,QROC,0.77,0.09,25.33,10,30,40,20,10,10,2.0,50.0,Difficile,Difficile,0,Meme Difficulte que la Prediction,Pas Adapte
4206,2018,Sociologie,1,Notions de Sociologie,2,Structure et Classes Sociales,13,1009,12,QO,0.9,0.14,28.14,13,33,46,28,13,15,1.64,46.43,Facile,Difficile,-2,Beaucoup plus Difficile que la Prediction,Pas Adapte
5272,2019,Sociologie,1,Notions de Sociologie,2,Structure et Classes Sociales,13,1009,12,QO,0.0,0.69,66.48,28,14,42,32,28,4,1.31,87.5,Facile,Facile,0,Meme Difficulte que la Prediction,Adapte
6338,2020,Sociologie,1,Notions de Sociologie,2,Structure et Classes Sociales,13,1009,12,QO,0.13,0.43,66.48,31,15,46,32,31,1,1.44,96.88,Facile,Facile,0,Meme Difficulte que la Prediction,Adapte
1009,2015,Sociologie,1,Notions de Sociologie,2,Structure et Classes Sociales,13,1010,13,QO,0.08,0.7,96.62,15,1,16,16,15,1,1.0,93.75,Difficile,Facile,2,Beaucoup plus Facile que la Prediction,Pas Adapte
2075,2016,Sociologie,1,Notions de Sociologie,2,Structure et Classes Sociales,13,1010,13,QO,0.91,0.08,14.21,3,15,18,13,3,10,1.38,23.08,Difficile,Difficile,0,Meme Difficulte que la Prediction,Pas Adapte
3141,2017,Sociologie,1,Notions de Sociologie,2,Structure et Classes Sociales,13,1010,13,QO,0.04,0.51,81.5,15,4,19,16,15,1,1.19,93.75,Facile,Facile,0,Meme Difficulte que la Prediction,Pas Adapte
4207,2018,Sociologie,1,Notions de Sociologie,2,Structure et Classes Sociales,13,1010,13,QO,0.47,0.21,35.75,6,10,16,14,6,8,1.14,42.86,Moyen,Moyen,0,Meme Difficulte que la Prediction,Pas Adapte
5273,2019,Sociologie,1,Notions de Sociologie,2,Structure et Classes Sociales,13,1010,13,QO,0.57,0.28,56.29,9,7,16,12,9,3,1.33,75.0,Moyen,Moyen,0,Meme Difficulte que la Prediction,Pas Adapte
6339,2020,Sociologie,1,Notions de Sociologie,2,Structure et Classes Sociales,13,1010,13,QO,0.18,0.71,69.66,11,5,16,16,11,5,1.0,68.75,Difficile,Facile,2,Beaucoup plus Facile que la Prediction,Adapte
1010,2015,Sociologie,1,Notions de Sociologie,3,Organisation et Institution,4,1011,1,QCU,0.16,0.82,93.41,85,6,91,89,85,4,1.02,95.51,Facile,Facile,0,Meme Difficulte que la Prediction,Pas Adapte
2076,2016,Sociologie,1,Notions de Sociologie,3,Organisation et Institution,4,1011,1,QCU,0.23,0.51,61.43,59,37,96,73,59,14,1.32,80.82,Facile,Moyen,-1,Plus Difficile que la Prediction,Adapte
3142,2017,Sociologie,1,Notions de Sociologie,3,Organisation et Institution,4,1011,1,QCU,0.26,0.57,61.43,57,36,93,88,57,31,1.06,64.77,Moyen,Moyen,0,Meme Difficulte que la Prediction,Adapte
4208,2018,Sociologie,1,Notions de Sociologie,3,Organisation et Institution,4,1011,1,QCU,0.23,0.73,61.43,49,31,80,76,49,27,1.05,64.47,Moyen,Moyen,0,Meme Difficulte que la Prediction,Adapte
5274,2019,Sociologie,1,Notions de Sociologie,3,Organisation et Institution,4,1011,1,QCU,0.26,0.44,61.43,54,34,88,86,54,32,1.02,62.79,Moyen,Moyen,0,Meme Difficulte que la Prediction,Adapte
6340,2020,Sociologie,1,Notions de Sociologie,3,Organisation et Institution,4,1011,1,QCM,0.42,0.62,61.43,62,39,101,93,62,31,1.09,66.67,Moyen,Moyen,0,Meme Difficulte que la Prediction,Adapte
1011,2015,Sociologie,1,Notions de Sociologie,3,Organisation et Institution,4,1012,2,QO,0.04,1.0,99.45,40,0,40,40,40,0,1.0,100.0,Facile,Facile,0,Meme Difficulte que la Prediction,Pas Adapte
2077,2016,Sociologie,1,Notions de Sociologie,3,Organisation et Institution,4,1012,2,QCU,0.53,0.26,12.53,5,38,43,15,5,10,2.87,33.33,Difficile,Difficile,0,Meme Difficulte que la Prediction,Pas Adapte
3143,2017,Sociologie,1,Notions de Sociologie,3,Organisation et Institution,4,1012,2,QCU,0.2,0.87,65.46,26,13,39,33,26,7,1.18,78.79,Moyen,Facile,1,Plus Facile que la Prediction,Adapte
4209,2018,Sociologie,1,Notions de Sociologie,3,Organisation et Institution,4,1012,2,QCU,0.06,0.97,65.46,29,15,44,39,29,10,1.13,74.36,Facile,Facile,0,Meme Difficulte que la Prediction,Adapte
5275,2019,Sociologie,1,Notions de Sociologie,3,Organisation et Institution,4,1012,2,QCM,0.01,0.86,65.46,29,15,44,41,29,12,1.07,70.73,Facile,Facile,0,Meme Difficulte que la Prediction,Adapte
6341,2020,Sociologie,1,Notions de Sociologie,3,Organisation et Institution,4,1012,2,QCM,0.08,0.8,65.46,33,17,50,37,33,4,1.35,89.19,Facile,Facile,0,Meme Difficulte que la Prediction,Adapte
1012,2015,Sociologie,1,Notions de Sociologie,3,Organisation et Institution,4,1013,3,QCM,0.13,0.91,67.29,5,2,7,6,5,1,1.17,83.33,Moyen,Facile,1,Plus Facile que la Prediction,Adapte
2078,2016,Sociologie,1,Notions de Sociologie,3,Organisation et Institution,4,1013,3,QCM,0.01,0.72,67.29,4,2,6,4,4,0,1.5,100.0,Facile,Facile,0,Meme Difficulte que la Prediction,Adapte
3144,2017,Sociologie,1,Notions de Sociologie,3,Organisation et Institution,4,1013,3,QCM,0.17,0.99,67.29,5,2,7,5,5,0,1.4,100.0,Facile,Facile,0,Meme Difficulte que la Prediction,Adapte
4210,2018,Sociologie,1,Notions de Sociologie,3,Organisation et Institution,4,1013,3,QCM,0.02,0.92,67.29,4,2,6,5,4,1,1.2,80.0,Facile,Facile,0,Meme Difficulte que la Prediction,Adapte
5276,2019,Sociologie,1,Notions de Sociologie,3,Organisation et Institution,4,1013,3,QCM,0.18,0.78,67.29,3,2,5,4,3,1,1.25,75.0,Facile,Facile,0,Meme Difficulte que la Prediction,Adapte
6342,2020,Sociologie,1,Notions de Sociologie,3,Organisation et Institution,4,1013,3,QCM,0.15,0.91,67.29,3,2,5,4,3,1,1.25,75.0,Facile,Facile,0,Meme Difficulte que la Prediction,Adapte
1013,2015,Sociologie,1,Notions de Sociologie,3,Organisation et Institution,4,1014,4,QCU,0.71,0.24,29.92,20,46,66,61,20,41,1.08,32.79,Facile,Difficile,-2,Beaucoup plus Difficile que la Prediction,Pas Adapte
2079,2016,Sociologie,1,Notions de Sociologie,3,Organisation et Institution,4,1014,4,QCU,0.15,0.9,79.94,61,15,76,74,61,13,1.03,82.43,Facile,Facile,0,Meme Difficulte que la Prediction,Pas Adapte
3145,2017,Sociologie,1,Notions de Sociologie,3,Organisation et Institution,4,1014,4,QCU,0.03,0.85,96.22,69,3,72,69,69,0,1.04,100.0,Facile,Facile,0,Meme Difficulte que la Prediction,Pas Adapte
4211,2018,Sociologie,1,Notions de Sociologie,3,Organisation et Institution,4,1014,4,QCU,0.15,0.99,76.32,54,17,71,65,54,11,1.09,83.08,Facile,Facile,0,Meme Difficulte que la Prediction,Pas Adapte
5277,2019,Sociologie,1,Notions de Sociologie,3,Organisation et Institution,4,1014,4,QCU,0.66,0.26,11.58,8,63,71,26,8,18,2.73,30.77,Difficile,Difficile,0,Meme Difficulte que la Prediction,Pas Adapte
6343,2020,Sociologie,1,Notions de Sociologie,3,Organisation et Institution,4,1014,4,QCU,0.21,0.63,41.38,29,41,70,41,29,12,1.71,70.73,Moyen,Moyen,0,Meme Difficulte que la Prediction,Pas Adapte
1014,2015,Sociologie,1,Notions de Sociologie,4,La Socialisation,8,1015,1,QROC,0.88,0.0,11.92,7,48,55,45,7,38,1.22,15.56,Difficile,Difficile,0,Meme Difficulte que la Prediction,Pas Adapte
2080,2016,Sociologie,1,Notions de Sociologie,4,La Socialisation,8,1015,1,QROC,0.34,0.36,53.36,31,27,58,47,31,16,1.23,65.96,Moyen,Moyen,0,Meme Difficulte que la Prediction,Pas Adapte
3146,2017,Sociologie,1,Notions de Sociologie,4,La Socialisation,8,1015,1,QROC,0.93,0.09,14.6,9,56,65,37,9,28,1.76,24.32,Difficile,Difficile,0,Meme Difficulte que la Prediction,Pas Adapte
4212,2018,Sociologie,1,Notions de Sociologie,4,La Socialisation,8,1015,1,QO,0.28,0.26,54.43,32,26,58,57,32,25,1.02,56.14,Difficile,Moyen,1,Plus Facile que la Prediction,Pas Adapte
5278,2019,Sociologie,1,Notions de Sociologie,4,La Socialisation,8,1015,1,QO,0.1,0.99,78.7,53,14,67,62,53,9,1.08,85.48,Difficile,Facile,2,Beaucoup plus Facile que la Prediction,Pas Adapte
6344,2020,Sociologie,1,Notions de Sociologie,4,La Socialisation,8,1015,1,QO,1.0,0.05,18.5,11,51,62,61,11,50,1.02,18.03,Facile,Difficile,-2,Beaucoup plus Difficile que la Prediction,Pas Adapte
1015,2015,Sociologie,1,Notions de Sociologie,4,La Socialisation,8,1016,2,QCU,0.56,0.26,6.61,1,15,16,12,1,11,1.33,8.33,Difficile,Difficile,0,Meme Difficulte que la Prediction,Pas Adapte
2081,2016,Sociologie,1,Notions de Sociologie,4,La Socialisation,8,1016,2,QCU,0.12,0.96,97.67,15,0,15,15,15,0,1.0,100.0,Moyen,Facile,1,Plus Facile que la Prediction,Pas Adapte
3147,2017,Sociologie,1,Notions de Sociologie,4,La Socialisation,8,1016,2,QCU,0.25,0.66,61.53,9,5,14,11,9,2,1.27,81.82,Moyen,Moyen,0,Meme Difficulte que la Prediction,Adapte
4213,2018,Sociologie,1,Notions de Sociologie,4,La Socialisation,8,1016,2,QCM,0.34,0.43,61.53,7,5,12,12,7,5,1.0,58.33,Moyen,Moyen,0,Meme Difficulte que la Prediction,Adapte
5279,2019,Sociologie,1,Notions de Sociologie,4,La Socialisation,8,1016,2,QCM,0.39,0.47,61.53,7,4,11,10,7,3,1.1,70.0,Moyen,Moyen,0,Meme Difficulte que la Prediction,Adapte
6345,2020,Sociologie,1,Notions de Sociologie,4,La Socialisation,8,1016,2,QCM,0.34,0.46,61.53,6,4,10,6,6,0,1.67,100.0,Moyen,Moyen,0,Meme Difficulte que la Prediction,Adapte
1016,2015,Sociologie,1,Notions de Sociologie,4,La Socialisation,8,1017,3,QCM,0.67,0.15,18.64,17,72,89,27,17,10,3.3,62.96,Difficile,Difficile,0,Meme Difficulte que la Prediction,Pas Adapte
2082,2016,Sociologie,1,Notions de Sociologie,4,La Socialisation,8,1017,3,QCM,0.69,0.2,30.98,29,66,95,86,29,57,1.1,33.72,Difficile,Difficile,0,Meme Difficulte que la Prediction,Pas Adapte
3148,2017,Sociologie,1,Notions de Sociologie,4,La Socialisation,8,1017,3,QROC,0.87,0.07,0.86,1,97,98,67,1,66,1.46,1.49,Facile,Difficile,-2,Beaucoup plus Difficile que la Prediction,Pas Adapte
4214,2018,Sociologie,1,Notions de Sociologie,4,La Socialisation,8,1017,3,QROC,0.81,0.05,5.43,5,80,85,68,5,63,1.25,7.35,Difficile,Difficile,0,Meme Difficulte que la Prediction,Pas Adapte
5280,2019,Sociologie,1,Notions de Sociologie,4,La Socialisation,8,1017,3,QROC,0.15,0.8,97.87,77,2,79,78,77,1,1.01,98.72,Facile,Facile,0,Meme Difficulte que la Prediction,Pas Adapte
6346,2020,Sociologie,1,Notions de Sociologie,4,La Socialisation,8,1017,3,QROC,0.41,0.28,60.0,40,27,67,52,40,12,1.29,76.92,Moyen,Moyen,0,Meme Difficulte que la Prediction,Pas Adapte
1017,2015,Sociologie,1,Notions de Sociologie,4,La Socialisation,8,1018,4,QCM,0.13,0.73,89.53,45,5,50,46,45,1,1.09,97.83,Moyen,Facile,1,Plus Facile que la Prediction,Pas Adapte
2083,2016,Sociologie,1,Notions de Sociologie,4,La Socialisation,8,1018,4,QCM,0.78,0.26,16.37,8,40,48,27,8,19,1.78,29.63,Difficile,Difficile,0,Meme Difficulte que la Prediction,Pas Adapte
3149,2017,Sociologie,1,Notions de Sociologie,4,La Socialisation,8,1018,4,QCM,0.18,0.77,84.36,40,7,47,43,40,3,1.09,93.02,Facile,Facile,0,Meme Difficulte que la Prediction,Pas Adapte
4215,2018,Sociologie,1,Notions de Sociologie,4,La Socialisation,8,1018,4,QCM,0.44,0.5,56.69,29,22,51,40,29,11,1.27,72.5,Moyen,Moyen,0,Meme Difficulte que la Prediction,Pas Adapte
5281,2019,Sociologie,1,Notions de Sociologie,4,La Socialisation,8,1018,4,QCM,0.57,0.15,3.1,2,50,52,42,2,40,1.24,4.76,Difficile,Difficile,0,Meme Difficulte que la Prediction,Pas Adapte
6347,2020,Sociologie,1,Notions de Sociologie,4,La Socialisation,8,1018,4,QCM,0.58,0.24,32.36,15,31,46,30,15,15,1.53,50.0,Difficile,Difficile,0,Meme Difficulte que la Prediction,Pas Adapte
1018,2015,Sociologie,1,Notions de Sociologie,4,La Socialisation,8,1019,5,QCM,0.31,0.39,60.92,40,26,66,40,40,0,1.65,100.0,Difficile,Moyen,1,Plus Facile que la Prediction,Adapte
2084,2016,Sociologie,1,Notions de Sociologie,4,La Socialisation,8,1019,5,QCM,0.22,0.64,60.92,44,29,73,55,44,11,1.33,80.0,Moyen,Moyen,0,Meme Difficulte que la Prediction,Adapte
3150,2017,Sociologie,1,Notions de Sociologie,4,La Socialisation,8,1019,5,QCM,0.3,0.47,60.92,44,28,72,64,44,20,1.12,68.75,Moyen,Moyen,0,Meme Difficulte que la Prediction,Adapte
4216,2018,Sociologie,1,Notions de Sociologie,4,La Socialisation,8,1019,5,QROC,0.25,0.28,60.92,46,30,76,66,46,20,1.15,69.7,Moyen,Moyen,0,Meme Difficulte que la Prediction,Adapte
5282,2019,Sociologie,1,Notions de Sociologie,4,La Socialisation,8,1019,5,QROC,0.54,0.29,60.92,41,26,67,64,41,23,1.05,64.06,Moyen,Moyen,0,Meme Difficulte que la Prediction,Adapte
6348,2020,Sociologie,1,Notions de Sociologie,4,La Socialisation,8,1019,5,QROC,0.27,0.33,60.92,41,27,68,60,41,19,1.13,68.33,Moyen,Moyen,0,Meme Difficulte que la Prediction,Adapte
1019,2015,Sociologie,1,Notions de Sociologie,4,La Socialisation,8,1020,6,QCU,0.74,0.21,31.61,20,44,64,56,20,36,1.14,35.71,Facile,Difficile,-2,Beaucoup plus Difficile que la Prediction,Pas Adapte
2085,2016,Sociologie,1,Notions de Sociologie,4,La Socialisation,8,1020,6,QCU,0.31,0.5,63.09,39,23,62,59,39,20,1.05,66.1,Moyen,Moyen,0,Meme Difficulte que la Prediction,Adapte
3151,2017,Sociologie,1,Notions de Sociologie,4,La Socialisation,8,1020,6,QCU,0.3,0.44,63.09,34,20,54,53,34,19,1.02,64.15,Moyen,Moyen,0,Meme Difficulte que la Prediction,Adapte
4217,2018,Sociologie,1,Notions de Sociologie,4,La Socialisation,8,1020,6,QCU,0.21,0.59,63.09,31,18,49,37,31,6,1.32,83.78,Moyen,Moyen,0,Meme Difficulte que la Prediction,Adapte
5283,2019,Sociologie,1,Notions de Sociologie,4,La Socialisation,8,1020,6,QCU,0.3,0.7,63.09,35,21,56,54,35,19,1.04,64.81,Moyen,Moyen,0,Meme Difficulte que la Prediction,Adapte
6349,2020,Sociologie,1,Notions de Sociologie,4,La Socialisation,8,1020,6,QCU,0.24,0.46,63.09,37,22,59,53,37,16,1.11,69.81,Moyen,Moyen,0,Meme Difficulte que la Prediction,Adapte
1020,2015,Sociologie,1,Notions de Sociologie,4,La Socialisation,8,1021,7,QCM,0.3,0.69,51.26,47,45,92,77,47,30,1.19,61.04,Facile,Moyen,-1,Plus Difficile que la Prediction,Pas Adapte
2086,2016,Sociologie,1,Notions de Sociologie,4,La Socialisation,8,1021,7,QCM,0.41,0.32,60.42,48,31,79,67,48,19,1.18,71.64,Moyen,Moyen,0,Meme Difficulte que la Prediction,Adapte
3152,2017,Sociologie,1,Notions de Sociologie,4,La Socialisation,8,1021,7,QCM,0.26,0.59,60.42,50,32,82,57,50,7,1.44,87.72,Moyen,Moyen,0,Meme Difficulte que la Prediction,Adapte
4218,2018,Sociologie,1,Notions de Sociologie,4,La Socialisation,8,1021,7,QROC,0.43,0.3,60.42,57,37,94,79,57,22,1.19,72.15,Moyen,Moyen,0,Meme Difficulte que la Prediction,Adapte
5284,2019,Sociologie,1,Notions de Sociologie,4,La Socialisation,8,1021,7,QROC,0.58,0.27,60.42,59,38,97,60,59,1,1.62,98.33,Moyen,Moyen,0,Meme Difficulte que la Prediction,Adapte
6350,2020,Sociologie,1,Notions de Sociologie,4,La Socialisation,8,1021,7,QROC,0.28,0.37,60.42,57,38,95,77,57,20,1.23,74.03,Moyen,Moyen,0,Meme Difficulte que la Prediction,Adapte
1021,2015,Sociologie,1,Notions de Sociologie,4,La Socialisation,8,1022,8,QCM,0.52,0.23,31.89,12,27,39,25,12,13,1.56,48.0,Difficile,Difficile,0,Meme Difficulte que la Prediction,Pas Adapte
2087,2016,Sociologie,1,Notions de Sociologie,4,La Socialisation,8,1022,8,QCM,0.04,0.78,81.06,30,7,37,31,30,1,1.19,96.77,Difficile,Facile,2,Beaucoup plus Facile que la Prediction,Pas Adapte
3153,2017,Sociologie,1,Notions de Sociologie,4,La Socialisation,8,1022,8,QCM,0.5,0.29,11.01,4,30,34,27,4,23,1.26,14.81,Difficile,Difficile,0,Meme Difficulte que la Prediction,Pas Adapte
4219,2018,Sociologie,1,Notions de Sociologie,4,La Socialisation,8,1022,8,QCM,0.12,0.7,77.15,22,7,29,25,22,3,1.16,88.0,Moyen,Facile,1,Plus Facile que la Prediction,Pas Adapte
5285,2019,Sociologie,1,Notions de Sociologie,4,La Socialisation,8,1022,8,QCM,0.58,0.21,3.59,1,32,33,16,1,15,2.06,6.25,Moyen,Difficile,-1,Plus Difficile que la Prediction,Pas Adapte
6351,2020,Sociologie,1,Notions de Sociologie,4,La Socialisation,8,1022,8,QCM,0.71,0.21,3.3,1,36,37,23,1,22,1.61,4.35,Difficile,Difficile,0,Meme Difficulte que la Prediction,Pas Adapte
1022,2015,Sociologie,1,Notions de Sociologie,5,Au-dela de l'Idee de Societe,10,1023,1,QCU,0.23,0.56,47.45,36,39,75,72,36,36,1.04,50.0,Moyen,Moyen,0,Meme Difficulte que la Prediction,Pas Adapte
2088,2016,Sociologie,1,Notions de Sociologie,5,Au-dela de l'Idee de Societe,10,1023,1,QCU,0.65,0.39,16.01,13,69,82,42,13,29,1.95,30.95,Difficile,Difficile,0,Meme Difficulte que la Prediction,Pas Adapte
3154,2017,Sociologie,1,Notions de Sociologie,5,Au-dela de l'Idee de Societe,10,1023,1,QCU,0.55,0.21,26.19,25,69,94,55,25,30,1.71,45.45,Facile,Difficile,-2,Beaucoup plus Difficile que la Prediction,Pas Adapte
4220,2018,Sociologie,1,Notions de Sociologie,5,Au-dela de l'Idee de Societe,10,1023,1,QCM,0.55,0.21,15.79,17,91,108,60,17,43,1.8,28.33,Difficile,Difficile,0,Meme Difficulte que la Prediction,Pas Adapte
5286,2019,Sociologie,1,Notions de Sociologie,5,Au-dela de l'Idee de Societe,10,1023,1,QCM,0.15,0.88,68.64,65,30,95,74,65,9,1.28,87.84,Difficile,Facile,2,Beaucoup plus Facile que la Prediction,Adapte
6352,2020,Sociologie,1,Notions de Sociologie,5,Au-dela de l'Idee de Societe,10,1023,1,QCM,0.09,0.83,68.64,66,30,96,84,66,18,1.14,78.57,Facile,Facile,0,Meme Difficulte que la Prediction,Adapte
1023,2015,Sociologie,1,Notions de Sociologie,5,Au-dela de l'Idee de Societe,10,1024,2,QCU,0.18,0.87,92.63,80,6,86,84,80,4,1.02,95.24,Moyen,Facile,1,Plus Facile que la Prediction,Pas Adapte
2089,2016,Sociologie,1,Notions de Sociologie,5,Au-dela de l'Idee de Societe,10,1024,2,QCU,0.15,0.8,79.19,60,16,76,70,60,10,1.09,85.71,Facile,Facile,0,Meme Difficulte que la Prediction,Pas Adapte
3155,2017,Sociologie,1,Notions de Sociologie,5,Au-dela de l'Idee de Societe,10,1024,2,QCU,0.06,0.81,89.07,69,8,77,75,69,6,1.03,92.0,Facile,Facile,0,Meme Difficulte que la Prediction,Pas Adapte
4221,2018,Sociologie,1,Notions de Sociologie,5,Au-dela de l'Idee de Societe,10,1024,2,QCM,0.49,0.38,35.59,30,55,85,70,30,40,1.21,42.86,Moyen,Moyen,0,Meme Difficulte que la Prediction,Pas Adapte
5287,2019,Sociologie,1,Notions de Sociologie,5,Au-dela de l'Idee de Societe,10,1024,2,QCM,0.15,0.87,86.0,75,12,87,84,75,9,1.04,89.29,Facile,Facile,0,Meme Difficulte que la Prediction,Pas Adapte
6353,2020,Sociologie,1,Notions de Sociologie,5,Au-dela de l'Idee de Societe,10,1024,2,QCM,0.16,0.95,86.78,87,13,100,89,87,2,1.12,97.75,Facile,Facile,0,Meme Difficulte que la Prediction,Pas Adapte
1024,2015,Sociologie,1,Notions de Sociologie,5,Au-dela de l'Idee de Societe,10,1025,3,QO,0.16,0.8,88.79,26,3,29,26,26,0,1.12,100.0,Facile,Facile,0,Meme Difficulte que la Prediction,Pas Adapte
2090,2016,Sociologie,1,Notions de Sociologie,5,Au-dela de l'Idee de Societe,10,1025,3,QO,0.93,0.11,10.29,3,23,26,20,3,17,1.3,15.0,Difficile,Difficile,0,Meme Difficulte que la Prediction,Pas Adapte
3156,2017,Sociologie,1,Notions de Sociologie,5,Au-dela de l'Idee de Societe,10,1025,3,QO,0.81,0.12,29.61,7,17,24,22,7,15,1.09,31.82,Facile,Difficile,-2,Beaucoup plus Difficile que la Prediction,Pas Adapte
4222,2018,Sociologie,1,Notions de Sociologie,5,Au-dela de l'Idee de Societe,10,1025,3,QO,0.46,0.19,36.23,10,17,27,23,10,13,1.17,43.48,Moyen,Moyen,0,Meme Difficulte que la Prediction,Pas Adapte
5288,2019,Sociologie,1,Notions de Sociologie,5,Au-dela de l'Idee de Societe,10,1025,3,QO,0.96,0.05,19.82,6,24,30,23,6,17,1.3,26.09,Difficile,Difficile,0,Meme Difficulte que la Prediction,Pas Adapte
6354,2020,Sociologie,1,Notions de Sociologie,5,Au-dela de l'Idee de Societe,10,1025,3,QO,0.09,0.66,97.12,33,1,34,33,33,0,1.03,100.0,Difficile,Facile,2,Beaucoup plus Facile que la Prediction,Pas Adapte
1025,2015,Sociologie,1,Notions de Sociologie,5,Au-dela de l'Idee de Societe,10,1026,4,QCU,0.2,0.74,39.46,35,53,88,74,35,39,1.19,47.3,Difficile,Moyen,1,Plus Facile que la Prediction,Pas Adapte
2091,2016,Sociologie,1,Notions de Sociologie,5,Au-dela de l'Idee de Societe,10,1026,4,QCU,0.08,0.95,72.14,62,24,86,78,62,16,1.1,79.49,Facile,Facile,0,Meme Difficulte que la Prediction,Adapte
3157,2017,Sociologie,1,Notions de Sociologie,5,Au-dela de l'Idee de Societe,10,1026,4,QCU,0.06,0.82,72.14,68,26,94,73,68,5,1.29,93.15,Facile,Facile,0,Meme Difficulte que la Prediction,Adapte
4223,2018,Sociologie,1,Notions de Sociologie,5,Au-dela de l'Idee de Societe,10,1026,4,QCU,0.03,0.8,72.14,76,29,105,96,76,20,1.09,79.17,Facile,Facile,0,Meme Difficulte que la Prediction,Adapte
5289,2019,Sociologie,1,Notions de Sociologie,5,Au-dela de l'Idee de Societe,10,1026,4,QCU,0.08,0.76,72.14,78,30,108,100,78,22,1.08,78.0,Facile,Facile,0,Meme Difficulte que la Prediction,Adapte
6355,2020,Sociologie,1,Notions de Sociologie,5,Au-dela de l'Idee de Societe,10,1026,4,QCU,0.08,0.97,72.14,87,34,121,108,87,21,1.12,80.56,Facile,Facile,0,Meme Difficulte que la Prediction,Adapte
1026,2015,Sociologie,1,Notions de Sociologie,5,Au-dela de l'Idee de Societe,10,1027,5,QCU,0.72,0.23,0.09,0,30,30,10,0,10,3.0,0.0,Difficile,Difficile,0,Meme Difficulte que la Prediction,Pas Adapte
2092,2016,Sociologie,1,Notions de Sociologie,5,Au-dela de l'Idee de Societe,10,1027,5,QCM,0.62,0.29,28.4,8,19,27,11,8,3,2.45,72.73,Facile,Difficile,-2,Beaucoup plus Difficile que la Prediction,Pas Adapte
3158,2017,Sociologie,1,Notions de Sociologie,5,Au-dela de l'Idee de Societe,10,1027,5,QCM,0.31,0.35,38.11,12,19,31,26,12,14,1.19,46.15,Moyen,Moyen,0,Meme Difficulte que la Prediction,Pas Adapte
4224,2018,Sociologie,1,Notions de Sociologie,5,Au-dela de l'Idee de Societe,10,1027,5,QCM,0.09,0.79,81.41,28,6,34,33,28,5,1.03,84.85,Moyen,Facile,1,Plus Facile que la Prediction,Pas Adapte
5290,2019,Sociologie,1,Notions de Sociologie,5,Au-dela de l'Idee de Societe,10,1027,5,QCU,0.73,0.39,13.12,4,28,32,15,4,11,2.13,26.67,Moyen,Difficile,-1,Plus Difficile que la Prediction,Pas Adapte
6356,2020,Sociologie,1,Notions de Sociologie,5,Au-dela de l'Idee de Societe,10,1027,5,QCU,0.01,0.94,74.64,25,9,34,28,25,3,1.21,89.29,Facile,Facile,0,Meme Difficulte que la Prediction,Adapte
1027,2015,Sociologie,1,Notions de Sociologie,5,Au-dela de l'Idee de Societe,10,1028,6,QCU,0.05,0.94,91.1,54,5,59,58,54,4,1.02,93.1,Moyen,Facile,1,Plus Facile que la Prediction,Pas Adapte
2093,2016,Sociologie,1,Notions de Sociologie,5,Au-dela de l'Idee de Societe,10,1028,6,QCU,0.58,0.25,21.93,12,43,55,38,12,26,1.45,31.58,Facile,Difficile,-2,Beaucoup plus Difficile que la Prediction,Pas Adapte
3159,2017,Sociologie,1,Notions de Sociologie,5,Au-dela de l'Idee de Societe,10,1028,6,QCU,0.58,0.25,4.34,2,49,51,26,2,24,1.96,7.69,Difficile,Difficile,0,Meme Difficulte que la Prediction,Pas Adapte
4225,2018,Sociologie,1,Notions de Sociologie,5,Au-dela de l'Idee de Societe,10,1028,6,QCU,0.5,0.27,33.68,17,32,49,44,17,27,1.11,38.64,Moyen,Difficile,-1,Plus Difficile que la Prediction,Pas Adapte
5291,2019,Sociologie,1,Notions de Sociologie,5,Au-dela de l'Idee de Societe,10,1028,6,QCU,0.56,0.38,15.7,9,46,55,37,9,28,1.49,24.32,Difficile,Difficile,0,Meme Difficulte que la Prediction,Pas Adapte
6357,2020,Sociologie,1,Notions de Sociologie,5,Au-dela de l'Idee de Societe,10,1028,6,QCU,0.44,0.35,30.68,18,40,58,36,18,18,1.61,50.0,Difficile,Difficile,0,Meme Difficulte que la Prediction,Pas Adapte
1028,2015,Sociologie,1,Notions de Sociologie,5,Au-dela de l'Idee de Societe,10,1029,7,QCU,0.33,0.69,44.65,13,15,28,15,13,2,1.87,86.67,Moyen,Moyen,0,Meme Difficulte que la Prediction,Pas Adapte
2094,2016,Sociologie,1,Notions de Sociologie,5,Au-dela de l'Idee de Societe,10,1029,7,QCM,0.34,0.41,36.39,10,17,27,25,10,15,1.08,40.0,Facile,Moyen,-1,Plus Difficile que la Prediction,Pas Adapte
3160,2017,Sociologie,1,Notions de Sociologie,5,Au-dela de l'Idee de Societe,10,1029,7,QCM,0.76,0.28,0.78,0,26,26,7,0,7,3.71,0.0,Facile,Difficile,-2,Beaucoup plus Difficile que la Prediction,Pas Adapte
4226,2018,Sociologie,1,Notions de Sociologie,5,Au-dela de l'Idee de Societe,10,1029,7,QCM,0.19,0.84,67.47,20,10,30,22,20,2,1.36,90.91,Moyen,Facile,1,Plus Facile que la Prediction,Adapte
5292,2019,Sociologie,1,Notions de Sociologie,5,Au-dela de l'Idee de Societe,10,1029,7,QCM,0.18,0.84,67.47,18,9,27,24,18,6,1.12,75.0,Facile,Facile,0,Meme Difficulte que la Prediction,Adapte
6358,2020,Sociologie,1,Notions de Sociologie,5,Au-dela de l'Idee de Societe,10,1029,7,QCM,0.2,0.97,67.47,18,9,27,25,18,7,1.08,72.0,Facile,Facile,0,Meme Difficulte que la Prediction,Adapte
1029,2015,Sociologie,1,Notions de Sociologie,5,Au-dela de l'Idee de Societe,10,1030,8,QCU,0.04,0.99,74.83,70,24,94,92,70,22,1.02,76.09,Difficile,Facile,2,Beaucoup plus Facile que la Prediction,Adapte
2095,2016,Sociologie,1,Notions de Sociologie,5,Au-dela de l'Idee de Societe,10,1030,8,QCU,0.08,0.89,74.83,73,24,97,74,73,1,1.31,98.65,Facile,Facile,0,Meme Difficulte que la Prediction,Adapte
3161,2017,Sociologie,1,Notions de Sociologie,5,Au-dela de l'Idee de Societe,10,1030,8,QCU,0.0,0.81,74.83,80,27,107,105,80,25,1.02,76.19,Facile,Facile,0,Meme Difficulte que la Prediction,Adapte
4227,2018,Sociologie,1,Notions de Sociologie,5,Au-dela de l'Idee de Societe,10,1030,8,QCU,0.15,0.91,74.83,82,28,110,96,82,14,1.15,85.42,Facile,Facile,0,Meme Difficulte que la Prediction,Adapte
5293,2019,Sociologie,1,Notions de Sociologie,5,Au-dela de l'Idee de Societe,10,1030,8,QCU,0.06,0.83,74.83,79,26,105,83,79,4,1.27,95.18,Facile,Facile,0,Meme Difficulte que la Prediction,Adapte
6359,2020,Sociologie,1,Notions de Sociologie,5,Au-dela de l'Idee de Societe,10,1030,8,QCU,0.17,0.79,74.83,72,24,96,90,72,18,1.07,80.0,Facile,Facile,0,Meme Difficulte que la Prediction,Adapte
1030,2015,Sociologie,1,Notions de Sociologie,5,Au-dela de l'Idee de Societe,10,1031,9,QCM,0.09,0.84,65.76,66,34,100,80,66,14,1.25,82.5,Facile,Facile,0,Meme Difficulte que la Prediction,Adapte
2096,2016,Sociologie,1,Notions de Sociologie,5,Au-dela de l'Idee de Societe,10,1031,9,QCM,0.09,0.79,65.76,62,32,94,78,62,16,1.21,79.49,Facile,Facile,0,Meme Difficulte que la Prediction,Adapte
3162,2017,Sociologie,1,Notions de Sociologie,5,Au-dela de l'Idee de Societe,10,1031,9,QCM,0.08,0.87,65.76,62,33,95,81,62,19,1.17,76.54,Facile,Facile,0,Meme Difficulte que la Prediction,Adapte
4228,2018,Sociologie,1,Notions de Sociologie,5,Au-dela de l'Idee de Societe,10,1031,9,QCM,0.14,0.88,65.76,67,35,102,82,67,15,1.24,81.71,Facile,Facile,0,Meme Difficulte que la Prediction,Adapte
5294,2019,Sociologie,1,Notions de Sociologie,5,Au-dela de l'Idee de Societe,10,1031,9,QCM,0.07,0.81,65.76,64,33,97,96,64,32,1.01,66.67,Facile,Facile,0,Meme Difficulte que la Prediction,Adapte
6360,2020,Sociologie,1,Notions de Sociologie,5,Au-dela de l'Idee de Societe,10,1031,9,QCU,0.12,0.84,65.76,64,34,98,97,64,33,1.01,65.98,Facile,Facile,0,Meme Difficulte que la Prediction,Adapte
1031,2015,Sociologie,1,Notions de Sociologie,5,Au-dela de l'Idee de Societe,10,1032,10,QCU,0.34,0.41,64.85,4,2,6,6,4,2,1.0,66.67,Moyen,Moyen,0,Meme Difficulte que la Prediction,Adapte
2097,2016,Sociologie,1,Notions de Sociologie,5,Au-dela de l'Idee de Societe,10,1032,10,QCM,0.31,0.54,64.85,4,2,6,6,4,2,1.0,66.67,Moyen,Moyen,0,Meme Difficulte que la Prediction,Adapte
3163,2017,Sociologie,1,Notions de Sociologie,5,Au-dela de l'Idee de Societe,10,1032,10,QCM,0.45,0.49,64.85,5,2,7,5,5,0,1.4,100.0,Moyen,Moyen,0,Meme Difficulte que la Prediction,Adapte
4229,2018,Sociologie,1,Notions de Sociologie,5,Au-dela de l'Idee de Societe,10,1032,10,QCM,0.4,0.47,64.85,4,2,6,5,4,1,1.2,80.0,Moyen,Moyen,0,Meme Difficulte que la Prediction,Adapte
5295,2019,Sociologie,1,Notions de Sociologie,5,Au-dela de l'Idee de Societe,10,1032,10,QCU,0.22,0.44,64.85,5,2,7,6,5,1,1.17,83.33,Moyen,Moyen,0,Meme Difficulte que la Prediction,Adapte
6361,2020,Sociologie,1,Notions de Sociologie,5,Au-dela de l'Idee de Societe,10,1032,10,QCU,0.3,0.66,64.85,5,2,7,5,5,0,1.4,100.0,Moyen,Moyen,0,Meme Difficulte que la Prediction,Adapte
1032,2015,Sociologie,1,Sociologie Generale,1,"Le Sociologue, la Sociologie et la Vie Sociale",12,1033,1,QCU,0.11,0.83,93.83,68,4,72,71,68,3,1.01,95.77,Difficile,Facile,2,Beaucoup plus Facile que la Prediction,Pas Adapte
2098,2016,Sociologie,1,Sociologie Generale,1,"Le Sociologue, la Sociologie et la Vie Sociale",12,1033,1,QCU,0.44,0.25,21.48,14,49,63,53,14,39,1.19,26.42,Facile,Difficile,-2,Beaucoup plus Difficile que la Prediction,Pas Adapte
3164,2017,Sociologie,1,Sociologie Generale,1,"Le Sociologue, la Sociologie et la Vie Sociale",12,1033,1,QCU,0.34,0.5,53.31,35,30,65,54,35,19,1.2,64.81,Difficile,Moyen,1,Plus Facile que la Prediction,Pas Adapte
4230,2018,Sociologie,1,Sociologie Generale,1,"Le Sociologue, la Sociologie et la Vie Sociale",12,1033,1,QCM,0.75,0.3,31.67,18,38,56,25,18,7,2.24,72.0,Difficile,Difficile,0,Meme Difficulte que la Prediction,Pas Adapte
5296,2019,Sociologie,1,Sociologie Generale,1,"Le Sociologue, la Sociologie et la Vie Sociale",12,1033,1,QROC,0.62,0.03,29.73,19,45,64,36,19,17,1.78,52.78,Difficile,Difficile,0,Meme Difficulte que la Prediction,Pas Adapte
6362,2020,Sociologie,1,Sociologie Generale,1,"Le Sociologue, la Sociologie et la Vie Sociale",12,1033,1,QROC,0.09,0.94,89.71,49,6,55,54,49,5,1.02,90.74,Moyen,Facile,1,Plus Facile que la Prediction,Pas Adapte
1033,2015,Sociologie,1,Sociologie Generale,1,"Le Sociologue, la Sociologie et la Vie Sociale",12,1034,2,QCU,0.55,0.22,30.05,25,58,83,53,25,28,1.57,47.17,Facile,Difficile,-2,Beaucoup plus Difficile que la Prediction,Pas Adapte
2099,2016,Sociologie,1,Sociologie Generale,1,"Le Sociologue, la Sociologie et la Vie Sociale",12,1034,2,QCU,0.58,0.35,7.97,6,71,77,33,6,27,2.33,18.18,Facile,Difficile,-2,Beaucoup plus Difficile que la Prediction,Pas Adapte
3165,2017,Sociologie,1,Sociologie Generale,1,"Le Sociologue, la Sociologie et la Vie Sociale",12,1034,2,QCM,0.5,0.2,28.98,26,63,89,41,26,15,2.17,63.41,Moyen,Difficile,-1,Plus Difficile que la Prediction,Pas Adapte
4231,2018,Sociologie,1,Sociologie Generale,1,"Le Sociologue, la Sociologie et la Vie Sociale",12,1034,2,QCM,0.55,0.23,0.03,0,76,76,35,0,35,2.17,0.0,Difficile,Difficile,0,Meme Difficulte que la Prediction,Pas Adapte
5297,2019,Sociologie,1,Sociologie Generale,1,"Le Sociologue, la Sociologie et la Vie Sociale",12,1034,2,QCM,0.25,0.5,61.79,48,29,77,61,48,13,1.26,78.69,Facile,Moyen,-1,Plus Difficile que la Prediction,Adapte
6363,2020,Sociologie,1,Sociologie Generale,1,"Le Sociologue, la Sociologie et la Vie Sociale",12,1034,2,QCM,0.25,0.43,61.79,41,25,66,66,41,25,1.0,62.12,Moyen,Moyen,0,Meme Difficulte que la Prediction,Adapte
1034,2015,Sociologie,1,Sociologie Generale,1,"Le Sociologue, la Sociologie et la Vie Sociale",12,1035,3,QCU,0.1,0.8,69.34,66,29,95,75,66,9,1.27,88.0,Facile,Facile,0,Meme Difficulte que la Prediction,Adapte
2100,2016,Sociologie,1,Sociologie Generale,1,"Le Sociologue, la Sociologie et la Vie Sociale",12,1035,3,QO,0.2,0.97,69.34,67,29,96,82,67,15,1.17,81.71,Facile,Facile,0,Meme Difficulte que la Prediction,Adapte
3166,2017,Sociologie,1,Sociologie Generale,1,"Le Sociologue, la Sociologie et la Vie Sociale",12,1035,3,QO,0.18,0.96,69.34,65,29,94,75,65,10,1.25,86.67,Facile,Facile,0,Meme Difficulte que la Prediction,Adapte
4232,2018,Sociologie,1,Sociologie Generale,1,"Le Sociologue, la Sociologie et la Vie Sociale",12,1035,3,QROC,0.07,0.76,69.34,64,29,93,83,64,19,1.12,77.11,Facile,Facile,0,Meme Difficulte que la Prediction,Adapte
5298,2019,Sociologie,1,Sociologie Generale,1,"Le Sociologue, la Sociologie et la Vie Sociale",12,1035,3,QROC,0.1,0.56,69.34,66,29,95,88,66,22,1.08,75.0,Facile,Facile,0,Meme Difficulte que la Prediction,Adapte
6364,2020,Sociologie,1,Sociologie Generale,1,"Le Sociologue, la Sociologie et la Vie Sociale",12,1035,3,QROC,0.09,0.95,69.34,58,26,84,80,58,22,1.05,72.5,Facile,Facile,0,Meme Difficulte que la Prediction,Adapte
1035,2015,Sociologie,1,Sociologie Generale,1,"Le Sociologue, la Sociologie et la Vie Sociale",12,1036,4,QCM,0.4,0.38,50.49,26,26,52,35,26,9,1.49,74.29,Facile,Moyen,-1,Plus Difficile que la Prediction,Pas Adapte
2101,2016,Sociologie,1,Sociologie Generale,1,"Le Sociologue, la Sociologie et la Vie Sociale",12,1036,4,QCM,0.37,0.44,39.99,21,32,53,48,21,27,1.1,43.75,Moyen,Moyen,0,Meme Difficulte que la Prediction,Pas Adapte
3167,2017,Sociologie,1,Sociologie Generale,1,"Le Sociologue, la Sociologie et la Vie Sociale",12,1036,4,QCU,0.21,0.71,61.27,37,23,60,57,37,20,1.05,64.91,Moyen,Moyen,0,Meme Difficulte que la Prediction,Adapte
4233,2018,Sociologie,1,Sociologie Generale,1,"Le Sociologue, la Sociologie et la Vie Sociale",12,1036,4,QCU,0.31,0.53,61.27,40,26,66,44,40,4,1.5,90.91,Moyen,Moyen,0,Meme Difficulte que la Prediction,Adapte
5299,2019,Sociologie,1,Sociologie Generale,1,"Le Sociologue, la Sociologie et la Vie Sociale",12,1036,4,QCU,0.26,0.71,61.27,38,24,62,55,38,17,1.13,69.09,Moyen,Moyen,0,Meme Difficulte que la Prediction,Adapte
6365,2020,Sociologie,1,Sociologie Generale,1,"Le Sociologue, la Sociologie et la Vie Sociale",12,1036,4,QCU,0.23,0.58,61.27,40,25,65,44,40,4,1.48,90.91,Moyen,Moyen,0,Meme Difficulte que la Prediction,Adapte
1036,2015,Sociologie,1,Sociologie Generale,1,"Le Sociologue, la Sociologie et la Vie Sociale",12,1037,5,QCU,0.18,0.99,67.46,32,16,48,47,32,15,1.02,68.09,Facile,Facile,0,Meme Difficulte que la Prediction,Adapte
2102,2016,Sociologie,1,Sociologie Generale,1,"Le Sociologue, la Sociologie et la Vie Sociale",12,1037,5,QCU,0.14,0.83,67.46,30,15,45,34,30,4,1.32,88.24,Facile,Facile,0,Meme Difficulte que la Prediction,Adapte
3168,2017,Sociologie,1,Sociologie Generale,1,"Le Sociologue, la Sociologie et la Vie Sociale",12,1037,5,QCU,0.12,0.92,67.46,33,16,49,49,33,16,1.0,67.35,Facile,Facile,0,Meme Difficulte que la Prediction,Adapte
4234,2018,Sociologie,1,Sociologie Generale,1,"Le Sociologue, la Sociologie et la Vie Sociale",12,1037,5,QCU,0.06,0.8,67.46,29,14,43,40,29,11,1.07,72.5,Facile,Facile,0,Meme Difficulte que la Prediction,Adapte
5300,2019,Sociologie,1,Sociologie Generale,1,"Le Sociologue, la Sociologie et la Vie Sociale",12,1037,5,QCU,0.0,0.98,67.46,30,15,45,30,30,0,1.5,100.0,Facile,Facile,0,Meme Difficulte que la Prediction,Adapte
6366,2020,Sociologie,1,Sociologie Generale,1,"Le Sociologue, la Sociologie et la Vie Sociale",12,1037,5,QCU,0.15,0.89,67.46,34,17,51,42,34,8,1.21,80.95,Facile,Facile,0,Meme Difficulte que la Prediction,Adapte
1037,2015,Sociologie,1,Sociologie Generale,1,"Le Sociologue, la Sociologie et la Vie Sociale",12,1038,6,QCU,0.13,0.78,68.73,35,16,51,46,35,11,1.11,76.09,Difficile,Facile,2,Beaucoup plus Facile que la Prediction,Adapte
2103,2016,Sociologie,1,Sociologie Generale,1,"Le Sociologue, la Sociologie et la Vie Sociale",12,1038,6,QCU,0.01,1.0,68.73,34,16,50,45,34,11,1.11,75.56,Facile,Facile,0,Meme Difficulte que la Prediction,Adapte
3169,2017,Sociologie,1,Sociologie Generale,1,"Le Sociologue, la Sociologie et la Vie Sociale",12,1038,6,QCU,0.11,0.82,68.73,31,14,45,38,31,7,1.18,81.58,Facile,Facile,0,Meme Difficulte que la Prediction,Adapte
4235,2018,Sociologie,1,Sociologie Generale,1,"Le Sociologue, la Sociologie et la Vie Sociale",12,1038,6,QCU,0.03,0.92,68.73,32,15,47,43,32,11,1.09,74.42,Facile,Facile,0,Meme Difficulte que la Prediction,Adapte
5301,2019,Sociologie,1,Sociologie Generale,1,"Le Sociologue, la Sociologie et la Vie Sociale",12,1038,6,QCU,0.13,0.92,68.73,31,14,45,42,31,11,1.07,73.81,Facile,Facile,0,Meme Difficulte que la Prediction,Adapte
6367,2020,Sociologie,1,Sociologie Generale,1,"Le Sociologue, la Sociologie et la Vie Sociale",12,1038,6,QCU,0.15,0.9,68.73,34,16,50,35,34,1,1.43,97.14,Facile,Facile,0,Meme Difficulte que la Prediction,Adapte
1038,2015,Sociologie,1,Sociologie Generale,1,"Le Sociologue, la Sociologie et la Vie Sociale",12,1039,7,QCM,0.57,0.26,28.84,26,64,90,52,26,26,1.73,50.0,Difficile,Difficile,0,Meme Difficulte que la Prediction,Pas Adapte
2104,2016,Sociologie,1,Sociologie Generale,1,"Le Sociologue, la Sociologie et la Vie Sociale",12,1039,7,QCM,0.03,0.94,90.09,73,8,81,79,73,6,1.03,92.41,Facile,Facile,0,Meme Difficulte que la Prediction,Pas Adapte
3170,2017,Sociologie,1,Sociologie Generale,1,"Le Sociologue, la Sociologie et la Vie Sociale",12,1039,7,QCM,0.64,0.18,16.05,13,67,80,36,13,23,2.22,36.11,Difficile,Difficile,0,Meme Difficulte que la Prediction,Pas Adapte
4236,2018,Sociologie,1,Sociologie Generale,1,"Le Sociologue, la Sociologie et la Vie Sociale",12,1039,7,QCM,0.03,0.91,78.61,64,18,82,81,64,17,1.01,79.01,Facile,Facile,0,Meme Difficulte que la Prediction,Pas Adapte
5302,2019,Sociologie,1,Sociologie Generale,1,"Le Sociologue, la Sociologie et la Vie Sociale",12,1039,7,QCM,0.51,0.19,23.18,21,70,91,89,21,68,1.02,23.6,Facile,Difficile,-2,Beaucoup plus Difficile que la Prediction,Pas Adapte
6368,2020,Sociologie,1,Sociologie Generale,1,"Le Sociologue, la Sociologie et la Vie Sociale",12,1039,7,QCU,0.01,0.84,83.28,82,17,99,90,82,8,1.1,91.11,Difficile,Facile,2,Beaucoup plus Facile que la Prediction,Pas Adapte
1039,2015,Sociologie,1,Sociologie Generale,1,"Le Sociologue, la Sociologie et la Vie Sociale",12,1040,8,QCM,0.26,0.43,53.93,42,35,77,72,42,30,1.07,58.33,Moyen,Moyen,0,Meme Difficulte que la Prediction,Pas Adapte
2105,2016,Sociologie,1,Sociologie Generale,1,"Le Sociologue, la Sociologie et la Vie Sociale",12,1040,8,QCM,0.67,0.26,28.96,20,50,70,29,20,9,2.41,68.97,Difficile,Difficile,0,Meme Difficulte que la Prediction,Pas Adapte
3171,2017,Sociologie,1,Sociologie Generale,1,"Le Sociologue, la Sociologie et la Vie Sociale",12,1040,8,QCM,0.52,0.16,29.47,18,42,60,18,18,0,3.33,100.0,Difficile,Difficile,0,Meme Difficulte que la Prediction,Pas Adapte
4237,2018,Sociologie,1,Sociologie Generale,1,"Le Sociologue, la Sociologie et la Vie Sociale",12,1040,8,QCU,0.62,0.29,14.67,9,53,62,35,9,26,1.77,25.71,Difficile,Difficile,0,Meme Difficulte que la Prediction,Pas Adapte
5303,2019,Sociologie,1,Sociologie Generale,1,"Le Sociologue, la Sociologie et la Vie Sociale",12,1040,8,QCU,0.61,0.39,12.1,8,56,64,24,8,16,2.67,33.33,Difficile,Difficile,0,Meme Difficulte que la Prediction,Pas Adapte
6369,2020,Sociologie,1,Sociologie Generale,1,"Le Sociologue, la Sociologie et la Vie Sociale",12,1040,8,QCM,0.5,0.28,7.38,5,59,64,54,5,49,1.19,9.26,Difficile,Difficile,0,Meme Difficulte que la Prediction,Pas Adapte
1040,2015,Sociologie,1,Sociologie Generale,1,"Le Sociologue, la Sociologie et la Vie Sociale",12,1041,9,QCU,0.44,0.3,29.62,10,24,34,26,10,16,1.31,38.46,Difficile,Difficile,0,Meme Difficulte que la Prediction,Pas Adapte
2106,2016,Sociologie,1,Sociologie Generale,1,"Le Sociologue, la Sociologie et la Vie Sociale",12,1041,9,QCU,0.52,0.2,34.1,10,19,29,11,10,1,2.64,90.91,Difficile,Difficile,0,Meme Difficulte que la Prediction,Pas Adapte
3172,2017,Sociologie,1,Sociologie Generale,1,"Le Sociologue, la Sociologie et la Vie Sociale",12,1041,9,QCU,0.67,0.27,8.06,2,28,30,29,2,27,1.03,6.9,Facile,Difficile,-2,Beaucoup plus Difficile que la Prediction,Pas Adapte
4238,2018,Sociologie,1,Sociologie Generale,1,"Le Sociologue, la Sociologie et la Vie Sociale",12,1041,9,QCU,0.17,0.97,85.99,24,4,28,24,24,0,1.17,100.0,Difficile,Facile,2,Beaucoup plus Facile que la Prediction,Pas Adapte
5304,2019,Sociologie,1,Sociologie Generale,1,"Le Sociologue, la Sociologie et la Vie Sociale",12,1041,9,QCM,0.01,0.76,85.0,24,4,28,26,24,2,1.08,92.31,Moyen,Facile,1,Plus Facile que la Prediction,Pas Adapte
6370,2020,Sociologie,1,Sociologie Generale,1,"Le Sociologue, la Sociologie et la Vie Sociale",12,1041,9,QCU,0.48,0.22,22.68,5,19,24,18,5,13,1.33,27.78,Difficile,Difficile,0,Meme Difficulte que la Prediction,Pas Adapte
1041,2015,Sociologie,1,Sociologie Generale,1,"Le Sociologue, la Sociologie et la Vie Sociale",12,1042,10,QCM,0.07,0.89,98.82,52,1,53,53,52,1,1.0,98.11,Facile,Facile,0,Meme Difficulte que la Prediction,Pas Adapte
2107,2016,Sociologie,1,Sociologie Generale,1,"Le Sociologue, la Sociologie et la Vie Sociale",12,1042,10,QCM,0.44,0.67,56.44,27,21,48,39,27,12,1.23,69.23,Moyen,Moyen,0,Meme Difficulte que la Prediction,Pas Adapte
3173,2017,Sociologie,1,Sociologie Generale,1,"Le Sociologue, la Sociologie et la Vie Sociale",12,1042,10,QCM,0.52,0.19,6.91,4,49,53,45,4,41,1.18,8.89,Facile,Difficile,-2,Beaucoup plus Difficile que la Prediction,Pas Adapte
4239,2018,Sociologie,1,Sociologie Generale,1,"Le Sociologue, la Sociologie et la Vie Sociale",12,1042,10,QCM,0.21,0.34,35.45,18,34,52,49,18,31,1.06,36.73,Difficile,Moyen,1,Plus Facile que la Prediction,Pas Adapte
5305,2019,Sociologie,1,Sociologie Generale,1,"Le Sociologue, la Sociologie et la Vie Sociale",12,1042,10,QCM,0.16,0.97,94.6,51,3,54,51,51,0,1.06,100.0,Difficile,Facile,2,Beaucoup plus Facile que la Prediction,Pas Adapte
6371,2020,Sociologie,1,Sociologie Generale,1,"Le Sociologue, la Sociologie et la Vie Sociale",12,1042,10,QCM,0.5,0.2,1.5,1,48,49,28,1,27,1.75,3.57,Difficile,Difficile,0,Meme Difficulte que la Prediction,Pas Adapte
1042,2015,Sociologie,1,Sociologie Generale,1,"Le Sociologue, la Sociologie et la Vie Sociale",12,1043,11,QCU,0.23,0.41,58.49,39,27,66,60,39,21,1.1,65.0,Difficile,Moyen,1,Plus Facile que la Prediction,Pas Adapte
2108,2016,Sociologie,1,Sociologie Generale,1,"Le Sociologue, la Sociologie et la Vie Sociale",12,1043,11,QCU,0.69,0.37,26.11,20,55,75,46,20,26,1.63,43.48,Difficile,Difficile,0,Meme Difficulte que la Prediction,Pas Adapte
3174,2017,Sociologie,1,Sociologie Generale,1,"Le Sociologue, la Sociologie et la Vie Sociale",12,1043,11,QCU,0.69,0.35,6.21,5,71,76,39,5,34,1.95,12.82,Moyen,Difficile,-1,Plus Difficile que la Prediction,Pas Adapte
4240,2018,Sociologie,1,Sociologie Generale,1,"Le Sociologue, la Sociologie et la Vie Sociale",12,1043,11,QCM,0.11,0.9,96.64,63,2,65,64,63,1,1.02,98.44,Difficile,Facile,2,Beaucoup plus Facile que la Prediction,Pas Adapte
5306,2019,Sociologie,1,Sociologie Generale,1,"Le Sociologue, la Sociologie et la Vie Sociale",12,1043,11,QCM,0.69,0.22,24.32,16,50,66,32,16,16,2.06,50.0,Moyen,Difficile,-1,Plus Difficile que la Prediction,Pas Adapte
6372,2020,Sociologie,1,Sociologie Generale,1,"Le Sociologue, la Sociologie et la Vie Sociale",12,1043,11,QCM,0.17,0.91,71.84,48,19,67,66,48,18,1.02,72.73,Difficile,Facile,2,Beaucoup plus Facile que la Prediction,Adapte
1043,2015,Sociologie,1,Sociologie Generale,1,"Le Sociologue, la Sociologie et la Vie Sociale",12,1044,12,QCM,0.01,0.72,70.56,13,5,18,14,13,1,1.29,92.86,Moyen,Facile,1,Plus Facile que la Prediction,Adapte
2109,2016,Sociologie,1,Sociologie Generale,1,"Le Sociologue, la Sociologie et la Vie Sociale",12,1044,12,QCM,0.16,0.95,70.56,13,6,19,17,13,4,1.12,76.47,Facile,Facile,0,Meme Difficulte que la Prediction,Adapte
3175,2017,Sociologie,1,Sociologie Generale,1,"Le Sociologue, la Sociologie et la Vie Sociale",12,1044,12,QCM,0.05,0.78,70.56,12,5,17,12,12,0,1.42,100.0,Facile,Facile,0,Meme Difficulte que la Prediction,Adapte
4241,2018,Sociologie,1,Sociologie Generale,1,"Le Sociologue, la Sociologie et la Vie Sociale",12,1044,12,QCM,0.12,0.77,70.56,14,6,20,15,14,1,1.33,93.33,Facile,Facile,0,Meme Difficulte que la Prediction,Adapte
5307,2019,Sociologie,1,Sociologie Generale,1,"Le Sociologue, la Sociologie et la Vie Sociale",12,1044,12,QCM,0.11,0.84,70.56,12,5,17,16,12,4,1.06,75.0,Facile,Facile,0,Meme Difficulte que la Prediction,Adapte
6373,2020,Sociologie,1,Sociologie Generale,1,"Le Sociologue, la Sociologie et la Vie Sociale",12,1044,12,QCM,0.1,0.83,70.56,13,6,19,16,13,3,1.19,81.25,Facile,Facile,0,Meme Difficulte que la Prediction,Adapte
1044,2015,Sociologie,1,Sociologie Generale,2,La Theorie Sociologique,8,1045,1,QCU,0.27,0.69,63.17,25,15,40,37,25,12,1.08,67.57,Facile,Moyen,-1,Plus Difficile que la Prediction,Adapte
2110,2016,Sociologie,1,Sociologie Generale,2,La Theorie Sociologique,8,1045,1,QCU,0.38,0.64,63.17,24,14,38,32,24,8,1.19,75.0,Moyen,Moyen,0,Meme Difficulte que la Prediction,Adapte
3176,2017,Sociologie,1,Sociologie Generale,2,La Theorie Sociologique,8,1045,1,QCM,0.48,0.57,63.17,23,13,36,24,23,1,1.5,95.83,Moyen,Moyen,0,Meme Difficulte que la Prediction,Adapte
4242,2018,Sociologie,1,Sociologie Generale,2,La Theorie Sociologique,8,1045,1,QCM,0.24,0.38,63.17,22,13,35,24,22,2,1.46,91.67,Moyen,Moyen,0,Meme Difficulte que la Prediction,Adapte
5308,2019,Sociologie,1,Sociologie Generale,2,La Theorie Sociologique,8,1045,1,QCM,0.28,0.67,63.17,24,14,38,34,24,10,1.12,70.59,Moyen,Moyen,0,Meme Difficulte que la Prediction,Adapte
6374,2020,Sociologie,1,Sociologie Generale,2,La Theorie Sociologique,8,1045,1,QCM,0.24,0.32,63.17,26,15,41,36,26,10,1.14,72.22,Moyen,Moyen,0,Meme Difficulte que la Prediction,Adapte
1045,2015,Sociologie,1,Sociologie Generale,2,La Theorie Sociologique,8,1046,2,QO,0.66,0.25,48.7,4,4,8,5,4,1,1.6,80.0,Moyen,Moyen,0,Meme Difficulte que la Prediction,Pas Adapte
2111,2016,Sociologie,1,Sociologie Generale,2,La Theorie Sociologique,8,1046,2,QO,0.07,0.41,88.43,6,1,7,7,6,1,1.0,85.71,Facile,Facile,0,Meme Difficulte que la Prediction,Pas Adapte
3177,2017,Sociologie,1,Sociologie Generale,2,La Theorie Sociologique,8,1046,2,QO,0.25,0.22,45.17,4,4,8,7,4,3,1.14,57.14,Difficile,Moyen,1,Plus Facile que la Prediction,Pas Adapte
4243,2018,Sociologie,1,Sociologie Generale,2,La Theorie Sociologique,8,1046,2,QCM,0.73,0.18,8.84,1,8,9,5,1,4,1.8,20.0,Difficile,Difficile,0,Meme Difficulte que la Prediction,Pas Adapte
5309,2019,Sociologie,1,Sociologie Generale,2,La Theorie Sociologique,8,1046,2,QCM,0.77,0.16,30.06,3,7,10,7,3,4,1.43,42.86,Facile,Difficile,-2,Beaucoup plus Difficile que la Prediction,Pas Adapte
6375,2020,Sociologie,1,Sociologie Generale,2,La Theorie Sociologique,8,1046,2,QCM,0.35,0.61,38.9,4,6,10,9,4,5,1.11,44.44,Moyen,Moyen,0,Meme Difficulte que la Prediction,Pas Adapte
1046,2015,Sociologie,1,Sociologie Generale,2,La Theorie Sociologique,8,1047,3,QCM,0.12,0.74,83.5,33,7,40,39,33,6,1.03,84.62,Facile,Facile,0,Meme Difficulte que la Prediction,Pas Adapte
2112,2016,Sociologie,1,Sociologie Generale,2,La Theorie Sociologique,8,1047,3,QCM,0.74,0.19,0.46,0,44,44,12,0,12,3.67,0.0,Difficile,Difficile,0,Meme Difficulte que la Prediction,Pas Adapte
3178,2017,Sociologie,1,Sociologie Generale,2,La Theorie Sociologique,8,1047,3,QCM,0.54,0.15,12.08,6,43,49,40,6,34,1.23,15.0,Moyen,Difficile,-1,Plus Difficile que la Prediction,Pas Adapte
4244,2018,Sociologie,1,Sociologie Generale,2,La Theorie Sociologique,8,1047,3,QCM,0.69,0.22,27.8,15,40,55,16,15,1,3.44,93.75,Moyen,Difficile,-1,Plus Difficile que la Prediction,Pas Adapte
5310,2019,Sociologie,1,Sociologie Generale,2,La Theorie Sociologique,8,1047,3,QCM,0.63,0.17,9.1,6,56,62,44,6,38,1.41,13.64,Difficile,Difficile,0,Meme Difficulte que la Prediction,Pas Adapte
6376,2020,Sociologie,1,Sociologie Generale,2,La Theorie Sociologique,8,1047,3,QCM,0.08,0.72,97.89,52,1,53,53,52,1,1.0,98.11,Facile,Facile,0,Meme Difficulte que la Prediction,Pas Adapte
1047,2015,Sociologie,1,Sociologie Generale,2,La Theorie Sociologique,8,1048,4,QCM,0.1,1.0,91.7,65,6,71,66,65,1,1.08,98.48,Moyen,Facile,1,Plus Facile que la Prediction,Pas Adapte
2113,2016,Sociologie,1,Sociologie Generale,2,La Theorie Sociologique,8,1048,4,QCM,0.51,0.2,10.56,8,64,72,44,8,36,1.64,18.18,Moyen,Difficile,-1,Plus Difficile que la Prediction,Pas Adapte
3179,2017,Sociologie,1,Sociologie Generale,2,La Theorie Sociologique,8,1048,4,QCU,0.3,0.44,52.02,36,34,70,49,36,13,1.43,73.47,Moyen,Moyen,0,Meme Difficulte que la Prediction,Pas Adapte
4245,2018,Sociologie,1,Sociologie Generale,2,La Theorie Sociologique,8,1048,4,QCU,0.08,0.83,90.38,59,6,65,64,59,5,1.02,92.19,Facile,Facile,0,Meme Difficulte que la Prediction,Pas Adapte
5311,2019,Sociologie,1,Sociologie Generale,2,La Theorie Sociologique,8,1048,4,QCU,0.3,0.7,48.2,31,33,64,42,31,11,1.52,73.81,Moyen,Moyen,0,Meme Difficulte que la Prediction,Pas Adapte
6377,2020,Sociologie,1,Sociologie Generale,2,La Theorie Sociologique,8,1048,4,QCU,0.72,0.33,22.97,15,49,64,22,15,7,2.91,68.18,Difficile,Difficile,0,Meme Difficulte que la Prediction,Pas Adapte
1048,2015,Sociologie,1,Sociologie Generale,2,La Theorie Sociologique,8,1049,5,QCM,0.71,0.18,21.41,18,64,82,77,18,59,1.06,23.38,Difficile,Difficile,0,Meme Difficulte que la Prediction,Pas Adapte
2114,2016,Sociologie,1,Sociologie Generale,2,La Theorie Sociologique,8,1049,5,QCM,0.68,0.24,26.28,21,58,79,77,21,56,1.03,27.27,Moyen,Difficile,-1,Plus Difficile que la Prediction,Pas Adapte
3180,2017,Sociologie,1,Sociologie Generale,2,La Theorie Sociologique,8,1049,5,QCU,0.27,0.62,35.35,32,59,91,44,32,12,2.07,72.73,Moyen,Moyen,0,Meme Difficulte que la Prediction,Pas Adapte
4246,2018,Sociologie,1,Sociologie Generale,2,La Theorie Sociologique,8,1049,5,QROC,0.16,0.93,70.06,60,25,85,80,60,20,1.06,75.0,Difficile,Facile,2,Beaucoup plus Facile que la Prediction,Adapte
5312,2019,Sociologie,1,Sociologie Generale,2,La Theorie Sociologique,8,1049,5,QROC,0.19,0.94,70.06,62,26,88,85,62,23,1.04,72.94,Facile,Facile,0,Meme Difficulte que la Prediction,Adapte
6378,2020,Sociologie,1,Sociologie Generale,2,La Theorie Sociologique,8,1049,5,QROC,0.08,0.6,70.06,62,27,89,83,62,21,1.07,74.7,Facile,Facile,0,Meme Difficulte que la Prediction,Adapte
1049,2015,Sociologie,1,Sociologie Generale,2,La Theorie Sociologique,8,1050,6,QCU,0.26,0.45,36.48,19,34,53,20,19,1,2.65,95.0,Facile,Moyen,-1,Plus Difficile que la Prediction,Pas Adapte
2115,2016,Sociologie,1,Sociologie Generale,2,La Theorie Sociologique,8,1050,6,QCU,0.23,0.74,50.65,29,28,57,30,29,1,1.9,96.67,Moyen,Moyen,0,Meme Difficulte que la Prediction,Pas Adapte
3181,2017,Sociologie,1,Sociologie Generale,2,La Theorie Sociologique,8,1050,6,QCU,0.29,0.44,45.72,30,36,66,45,30,15,1.47,66.67,Moyen,Moyen,0,Meme Difficulte que la Prediction,Pas Adapte
4247,2018,Sociologie,1,Sociologie Generale,2,La Theorie Sociologique,8,1050,6,QCU,0.54,0.37,23.68,16,53,69,46,16,30,1.5,34.78,Difficile,Difficile,0,Meme Difficulte que la Prediction,Pas Adapte
5313,2019,Sociologie,1,Sociologie Generale,2,La Theorie Sociologique,8,1050,6,QCU,0.41,0.32,31.49,19,41,60,32,19,13,1.88,59.38,Difficile,Difficile,0,Meme Difficulte que la Prediction,Pas Adapte
6379,2020,Sociologie,1,Sociologie Generale,2,La Theorie Sociologique,8,1050,6,QCU,0.16,0.97,76.97,40,12,52,47,40,7,1.11,85.11,Facile,Facile,0,Meme Difficulte que la Prediction,Pas Adapte
1050,2015,Sociologie,1,Sociologie Generale,2,La Theorie Sociologique,8,1051,7,QCU,0.63,0.26,13.46,2,16,18,13,2,11,1.38,15.38,Difficile,Difficile,0,Meme Difficulte que la Prediction,Pas Adapte
2116,2016,Sociologie,1,Sociologie Generale,2,La Theorie Sociologique,8,1051,7,QCU,0.09,0.76,80.69,14,3,17,14,14,0,1.21,100.0,Facile,Facile,0,Meme Difficulte que la Prediction,Pas Adapte
3182,2017,Sociologie,1,Sociologie Generale,2,La Theorie Sociologique,8,1051,7,QCU,0.65,0.31,15.37,3,17,20,11,3,8,1.82,27.27,Difficile,Difficile,0,Meme Difficulte que la Prediction,Pas Adapte
4248,2018,Sociologie,1,Sociologie Generale,2,La Theorie Sociologique,8,1051,7,QCU,0.68,0.2,26.11,5,16,21,11,5,6,1.91,45.45,Difficile,Difficile,0,Meme Difficulte que la Prediction,Pas Adapte
5314,2019,Sociologie,1,Sociologie Generale,2,La Theorie Sociologique,8,1051,7,QCU,0.26,0.45,58.71,12,8,20,13,12,1,1.54,92.31,Moyen,Moyen,0,Meme Difficulte que la Prediction,Pas Adapte
6380,2020,Sociologie,1,Sociologie Generale,2,La Theorie Sociologique,8,1051,7,QCU,0.25,0.67,62.91,11,7,18,12,11,1,1.5,91.67,Moyen,Moyen,0,Meme Difficulte que la Prediction,Adapte
1051,2015,Sociologie,1,Sociologie Generale,2,La Theorie Sociologique,8,1052,8,QCU,0.59,0.29,3.72,3,66,69,63,3,60,1.1,4.76,Difficile,Difficile,0,Meme Difficulte que la Prediction,Pas Adapte
2117,2016,Sociologie,1,Sociologie Generale,2,La Theorie Sociologique,8,1052,8,QCU,0.45,0.35,25.48,20,58,78,60,20,40,1.3,33.33,Facile,Difficile,-2,Beaucoup plus Difficile que la Prediction,Pas Adapte
3183,2017,Sociologie,1,Sociologie Generale,2,La Theorie Sociologique,8,1052,8,QCM,0.51,0.28,29.6,22,51,73,26,22,4,2.81,84.62,Moyen,Difficile,-1,Plus Difficile que la Prediction,Pas Adapte
4249,2018,Sociologie,1,Sociologie Generale,2,La Theorie Sociologique,8,1052,8,QCM,0.74,0.21,32.8,21,44,65,32,21,11,2.03,65.62,Difficile,Difficile,0,Meme Difficulte que la Prediction,Pas Adapte
5315,2019,Sociologie,1,Sociologie Generale,2,La Theorie Sociologique,8,1052,8,QCM,0.75,0.2,5.52,4,66,70,48,4,44,1.46,8.33,Difficile,Difficile,0,Meme Difficulte que la Prediction,Pas Adapte
6381,2020,Sociologie,1,Sociologie Generale,2,La Theorie Sociologique,8,1052,8,QCM,0.59,0.17,7.82,5,55,60,37,5,32,1.62,13.51,Difficile,Difficile,0,Meme Difficulte que la Prediction,Pas Adapte
1052,2015,Sociologie,1,Sociologie Generale,3,La Condition Moderne,7,1053,1,QCU,0.15,0.96,75.43,49,16,65,64,49,15,1.02,76.56,Difficile,Facile,2,Beaucoup plus Facile que la Prediction,Pas Adapte
2118,2016,Sociologie,1,Sociologie Generale,3,La Condition Moderne,7,1053,1,QCU,0.7,0.24,1.15,1,72,73,28,1,27,2.61,3.57,Difficile,Difficile,0,Meme Difficulte que la Prediction,Pas Adapte
3184,2017,Sociologie,1,Sociologie Generale,3,La Condition Moderne,7,1053,1,QCU,0.55,0.26,17.32,12,58,70,43,12,31,1.63,27.91,Difficile,Difficile,0,Meme Difficulte que la Prediction,Pas Adapte
4250,2018,Sociologie,1,Sociologie Generale,3,La Condition Moderne,7,1053,1,QCU,0.34,0.68,51.88,42,38,80,45,42,3,1.78,93.33,Difficile,Moyen,1,Plus Facile que la Prediction,Pas Adapte
5316,2019,Sociologie,1,Sociologie Generale,3,La Condition Moderne,7,1053,1,QCU,0.34,0.53,48.85,39,40,79,41,39,2,1.93,95.12,Moyen,Moyen,0,Meme Difficulte que la Prediction,Pas Adapte
6382,2020,Sociologie,1,Sociologie Generale,3,La Condition Moderne,7,1053,1,QCU,0.05,0.77,73.78,55,20,75,55,55,0,1.36,100.0,Facile,Facile,0,Meme Difficulte que la Prediction,Adapte
1053,2015,Sociologie,1,Sociologie Generale,3,La Condition Moderne,7,1054,2,QROC,0.15,0.48,74.06,35,12,47,41,35,6,1.15,85.37,Moyen,Facile,1,Plus Facile que la Prediction,Adapte
2119,2016,Sociologie,1,Sociologie Generale,3,La Condition Moderne,7,1054,2,QROC,0.19,0.75,74.06,38,13,51,49,38,11,1.04,77.55,Facile,Facile,0,Meme Difficulte que la Prediction,Adapte
3185,2017,Sociologie,1,Sociologie Generale,3,La Condition Moderne,7,1054,2,QROC,0.12,0.69,74.06,34,12,46,39,34,5,1.18,87.18,Facile,Facile,0,Meme Difficulte que la Prediction,Adapte
4251,2018,Sociologie,1,Sociologie Generale,3,La Condition Moderne,7,1054,2,QROC,0.15,0.73,74.06,33,11,44,39,33,6,1.13,84.62,Facile,Facile,0,Meme Difficulte que la Prediction,Adapte
5317,2019,Sociologie,1,Sociologie Generale,3,La Condition Moderne,7,1054,2,QROC,0.03,0.86,74.06,36,13,49,37,36,1,1.32,97.3,Facile,Facile,0,Meme Difficulte que la Prediction,Adapte
6383,2020,Sociologie,1,Sociologie Generale,3,La Condition Moderne,7,1054,2,QROC,0.03,0.87,74.06,36,12,48,40,36,4,1.2,90.0,Facile,Facile,0,Meme Difficulte que la Prediction,Adapte
1054,2015,Sociologie,1,Sociologie Generale,3,La Condition Moderne,7,1055,3,QCU,0.65,0.27,17.13,10,49,59,31,10,21,1.9,32.26,Difficile,Difficile,0,Meme Difficulte que la Prediction,Pas Adapte
2120,2016,Sociologie,1,Sociologie Generale,3,La Condition Moderne,7,1055,3,QCM,0.39,0.49,57.46,36,27,63,45,36,9,1.4,80.0,Facile,Moyen,-1,Plus Difficile que la Prediction,Pas Adapte
3186,2017,Sociologie,1,Sociologie Generale,3,La Condition Moderne,7,1055,3,QCM,0.18,0.9,85.42,54,9,63,59,54,5,1.07,91.53,Facile,Facile,0,Meme Difficulte que la Prediction,Pas Adapte
4252,2018,Sociologie,1,Sociologie Generale,3,La Condition Moderne,7,1055,3,QCM,0.28,0.68,47.41,27,30,57,39,27,12,1.46,69.23,Moyen,Moyen,0,Meme Difficulte que la Prediction,Pas Adapte
5318,2019,Sociologie,1,Sociologie Generale,3,La Condition Moderne,7,1055,3,QCM,0.12,0.92,70.85,38,16,54,42,38,4,1.29,90.48,Facile,Facile,0,Meme Difficulte que la Prediction,Adapte
6384,2020,Sociologie,1,Sociologie Generale,3,La Condition Moderne,7,1055,3,QCU,0.12,0.91,70.85,44,18,62,52,44,8,1.19,84.62,Facile,Facile,0,Meme Difficulte que la Prediction,Adapte
1055,2015,Sociologie,1,Sociologie Generale,3,La Condition Moderne,7,1056,4,QCU,0.57,0.35,20.43,12,47,59,56,12,44,1.05,21.43,Facile,Difficile,-2,Beaucoup plus Difficile que la Prediction,Pas Adapte
2121,2016,Sociologie,1,Sociologie Generale,3,La Condition Moderne,7,1056,4,QCU,0.1,0.99,86.11,45,7,52,45,45,0,1.16,100.0,Facile,Facile,0,Meme Difficulte que la Prediction,Pas Adapte
3187,2017,Sociologie,1,Sociologie Generale,3,La Condition Moderne,7,1056,4,QCM,0.24,0.44,53.51,28,24,52,28,28,0,1.86,100.0,Moyen,Moyen,0,Meme Difficulte que la Prediction,Pas Adapte
4253,2018,Sociologie,1,Sociologie Generale,3,La Condition Moderne,7,1056,4,QCM,0.56,0.22,15.88,9,49,58,25,9,16,2.32,36.0,Difficile,Difficile,0,Meme Difficulte que la Prediction,Pas Adapte
5319,2019,Sociologie,1,Sociologie Generale,3,La Condition Moderne,7,1056,4,QCM,0.27,0.43,37.73,24,39,63,40,24,16,1.57,60.0,Moyen,Moyen,0,Meme Difficulte que la Prediction,Pas Adapte
6385,2020,Sociologie,1,Sociologie Generale,3,La Condition Moderne,7,1056,4,QCM,0.19,0.99,83.05,49,10,59,50,49,1,1.18,98.0,Difficile,Facile,2,Beaucoup plus Facile que la Prediction,Pas Adapte
1056,2015,Sociologie,1,Sociologie Generale,3,La Condition Moderne,7,1057,5,QCU,0.68,0.23,22.69,22,74,96,79,22,57,1.22,27.85,Difficile,Difficile,0,Meme Difficulte que la Prediction,Pas Adapte
2122,2016,Sociologie,1,Sociologie Generale,3,La Condition Moderne,7,1057,5,QCU,0.61,0.25,7.42,7,91,98,92,7,85,1.07,7.61,Moyen,Difficile,-1,Plus Difficile que la Prediction,Pas Adapte
3188,2017,Sociologie,1,Sociologie Generale,3,La Condition Moderne,7,1057,5,QCU,0.7,0.38,24.45,22,67,89,85,22,63,1.05,25.88,Moyen,Difficile,-1,Plus Difficile que la Prediction,Pas Adapte
4254,2018,Sociologie,1,Sociologie Generale,3,La Condition Moderne,7,1057,5,QCU,0.32,0.62,43.89,39,51,90,71,39,32,1.27,54.93,Difficile,Moyen,1,Plus Facile que la Prediction,Pas Adapte
5320,2019,Sociologie,1,Sociologie Generale,3,La Condition Moderne,7,1057,5,QCU,0.2,0.98,71.26,56,22,78,78,56,22,1.0,71.79,Facile,Facile,0,Meme Difficulte que la Prediction,Adapte
6386,2020,Sociologie,1,Sociologie Generale,3,La Condition Moderne,7,1057,5,QCU,0.13,0.96,71.26,56,23,79,60,56,4,1.32,93.33,Facile,Facile,0,Meme Difficulte que la Prediction,Adapte
1057,2015,Sociologie,1,Sociologie Generale,3,La Condition Moderne,7,1058,6,QCM,0.53,0.19,15.72,16,83,99,54,16,38,1.83,29.63,Facile,Difficile,-2,Beaucoup plus Difficile que la Prediction,Pas Adapte
2123,2016,Sociologie,1,Sociologie Generale,3,La Condition Moderne,7,1058,6,QCM,0.11,0.88,74.64,65,22,87,73,65,8,1.19,89.04,Moyen,Facile,1,Plus Facile que la Prediction,Adapte
3189,2017,Sociologie,1,Sociologie Generale,3,La Condition Moderne,7,1058,6,QCM,0.11,0.86,74.64,60,21,81,74,60,14,1.09,81.08,Facile,Facile,0,Meme Difficulte que la Prediction,Adapte
4255,2018,Sociologie,1,Sociologie Generale,3,La Condition Moderne,7,1058,6,QCM,0.13,0.93,74.64,59,20,79,71,59,12,1.11,83.1,Facile,Facile,0,Meme Difficulte que la Prediction,Adapte
5321,2019,Sociologie,1,Sociologie Generale,3,La Condition Moderne,7,1058,6,QCU,0.02,0.83,74.64,62,21,83,73,62,11,1.14,84.93,Facile,Facile,0,Meme Difficulte que la Prediction,Adapte
6387,2020,Sociologie,1,Sociologie Generale,3,La Condition Moderne,7,1058,6,QCM,0.07,0.72,74.64,64,22,86,68,64,4,1.26,94.12,Facile,Facile,0,Meme Difficulte que la Prediction,Adapte
1058,2015,Sociologie,1,Sociologie Generale,3,La Condition Moderne,7,1059,7,QCM,0.51,0.23,14.99,5,26,31,22,5,17,1.41,22.73,Difficile,Difficile,0,Meme Difficulte que la Prediction,Pas Adapte
2124,2016,Sociologie,1,Sociologie Generale,3,La Condition Moderne,7,1059,7,QCM,0.24,0.68,53.39,18,16,34,30,18,12,1.13,60.0,Facile,Moyen,-1,Plus Difficile que la Prediction,Pas Adapte
3190,2017,Sociologie,1,Sociologie Generale,3,La Condition Moderne,7,1059,7,QCM,0.59,0.3,6.49,2,34,36,32,2,30,1.12,6.25,Difficile,Difficile,0,Meme Difficulte que la Prediction,Pas Adapte
4256,2018,Sociologie,1,Sociologie Generale,3,La Condition Moderne,7,1059,7,QCM,0.63,0.17,23.3,9,30,39,12,9,3,3.25,75.0,Difficile,Difficile,0,Meme Difficulte que la Prediction,Pas Adapte
5322,2019,Sociologie,1,Sociologie Generale,3,La Condition Moderne,7,1059,7,QCM,0.33,0.51,62.6,26,15,41,26,26,0,1.58,100.0,Difficile,Moyen,1,Plus Facile que la Prediction,Adapte
6388,2020,Sociologie,1,Sociologie Generale,3,La Condition Moderne,7,1059,7,QCM,0.22,0.59,62.6,26,15,41,37,26,11,1.11,70.27,Moyen,Moyen,0,Meme Difficulte que la Prediction,Adapte
1059,2015,Sociologie,1,Sociologie Generale,4,Les Debats Sociologiques Contemporains,7,1060,1,QCU,0.53,0.3,9.66,2,23,25,16,2,14,1.56,12.5,Difficile,Difficile,0,Meme Difficulte que la Prediction,Pas Adapte
2125,2016,Sociologie,1,Sociologie Generale,4,Les Debats Sociologiques Contemporains,7,1060,1,QCU,0.58,0.2,0.08,0,26,26,24,0,24,1.08,0.0,Difficile,Difficile,0,Meme Difficulte que la Prediction,Pas Adapte
3191,2017,Sociologie,1,Sociologie Generale,4,Les Debats Sociologiques Contemporains,7,1060,1,QCU,0.44,0.3,11.58,3,25,28,16,3,13,1.75,18.75,Difficile,Difficile,0,Meme Difficulte que la Prediction,Pas Adapte
4257,2018,Sociologie,1,Sociologie Generale,4,Les Debats Sociologiques Contemporains,7,1060,1,QCU,0.12,0.97,75.1,24,8,32,32,24,8,1.0,75.0,Facile,Facile,0,Meme Difficulte que la Prediction,Pas Adapte
5323,2019,Sociologie,1,Sociologie Generale,4,Les Debats Sociologiques Contemporains,7,1060,1,QCU,0.22,0.55,51.23,14,14,28,21,14,7,1.33,66.67,Facile,Moyen,-1,Plus Difficile que la Prediction,Pas Adapte
6389,2020,Sociologie,1,Sociologie Generale,4,Les Debats Sociologiques Contemporains,7,1060,1,QCU,0.07,0.91,97.94,31,1,32,32,31,1,1.0,96.88,Facile,Facile,0,Meme Difficulte que la Prediction,Pas Adapte
1060,2015,Sociologie,1,Sociologie Generale,4,Les Debats Sociologiques Contemporains,7,1061,2,QCU,0.32,0.48,44.72,6,8,14,12,6,6,1.17,50.0,Moyen,Moyen,0,Meme Difficulte que la Prediction,Pas Adapte
2126,2016,Sociologie,1,Sociologie Generale,4,Les Debats Sociologiques Contemporains,7,1061,2,QCU,0.7,0.36,33.41,5,11,16,9,5,4,1.78,55.56,Difficile,Difficile,0,Meme Difficulte que la Prediction,Pas Adapte
3192,2017,Sociologie,1,Sociologie Generale,4,Les Debats Sociologiques Contemporains,7,1061,2,QROC,0.97,0.13,6.83,1,16,17,7,1,6,2.43,14.29,Difficile,Difficile,0,Meme Difficulte que la Prediction,Pas Adapte
4258,2018,Sociologie,1,Sociologie Generale,4,Les Debats Sociologiques Contemporains,7,1061,2,QROC,0.86,0.21,21.56,3,13,16,15,3,12,1.07,20.0,Difficile,Difficile,0,Meme Difficulte que la Prediction,Pas Adapte
5324,2019,Sociologie,1,Sociologie Generale,4,Les Debats Sociologiques Contemporains,7,1061,2,QROC,0.55,0.26,47.32,9,9,18,9,9,0,2.0,100.0,Moyen,Moyen,0,Meme Difficulte que la Prediction,Pas Adapte
6390,2020,Sociologie,1,Sociologie Generale,4,Les Debats Sociologiques Contemporains,7,1061,2,QROC,0.85,0.02,31.67,7,14,21,18,7,11,1.17,38.89,Moyen,Difficile,-1,Plus Difficile que la Prediction,Pas Adapte
1061,2015,Sociologie,1,Sociologie Generale,4,Les Debats Sociologiques Contemporains,7,1062,3,QCU,0.06,0.94,79.44,44,12,56,46,44,2,1.22,95.65,Facile,Facile,0,Meme Difficulte que la Prediction,Pas Adapte
2127,2016,Sociologie,1,Sociologie Generale,4,Les Debats Sociologiques Contemporains,7,1062,3,QROC,0.5,0.27,56.57,35,27,62,37,35,2,1.68,94.59,Moyen,Moyen,0,Meme Difficulte que la Prediction,Pas Adapte
3193,2017,Sociologie,1,Sociologie Generale,4,Les Debats Sociologiques Contemporains,7,1062,3,QROC,0.9,0.14,26.97,17,46,63,52,17,35,1.21,32.69,Difficile,Difficile,0,Meme Difficulte que la Prediction,Pas Adapte
4259,2018,Sociologie,1,Sociologie Generale,4,Les Debats Sociologiques Contemporains,7,1062,3,QROC,0.01,0.44,65.09,35,19,54,54,35,19,1.0,64.81,Facile,Facile,0,Meme Difficulte que la Prediction,Adapte
5325,2019,Sociologie,1,Sociologie Generale,4,Les Debats Sociologiques Contemporains,7,1062,3,QCM,0.08,0.82,65.09,35,19,54,46,35,11,1.17,76.09,Facile,Facile,0,Meme Difficulte que la Prediction,Adapte
6391,2020,Sociologie,1,Sociologie Generale,4,Les Debats Sociologiques Contemporains,7,1062,3,QROC,0.17,0.79,65.09,34,18,52,50,34,16,1.04,68.0,Facile,Facile,0,Meme Difficulte que la Prediction,Adapte
1062,2015,Sociologie,1,Sociologie Generale,4,Les Debats Sociologiques Contemporains,7,1063,4,QCM,0.41,0.46,51.07,46,44,90,72,46,26,1.25,63.89,Moyen,Moyen,0,Meme Difficulte que la Prediction,Pas Adapte
2128,2016,Sociologie,1,Sociologie Generale,4,Les Debats Sociologiques Contemporains,7,1063,4,QCM,0.6,0.22,15.12,12,68,80,34,12,22,2.35,35.29,Facile,Difficile,-2,Beaucoup plus Difficile que la Prediction,Pas Adapte
3194,2017,Sociologie,1,Sociologie Generale,4,Les Debats Sociologiques Contemporains,7,1063,4,QCM,0.34,0.45,43.45,37,49,86,83,37,46,1.04,44.58,Moyen,Moyen,0,Meme Difficulte que la Prediction,Pas Adapte
4260,2018,Sociologie,1,Sociologie Generale,4,Les Debats Sociologiques Contemporains,7,1063,4,QCM,0.69,0.15,27.15,24,66,90,43,24,19,2.09,55.81,Difficile,Difficile,0,Meme Difficulte que la Prediction,Pas Adapte
5326,2019,Sociologie,1,Sociologie Generale,4,Les Debats Sociologiques Contemporains,7,1063,4,QCM,0.1,0.71,89.63,68,8,76,73,68,5,1.04,93.15,Facile,Facile,0,Meme Difficulte que la Prediction,Pas Adapte
6392,2020,Sociologie,1,Sociologie Generale,4,Les Debats Sociologiques Contemporains,7,1063,4,QCM,0.6,0.26,11.59,8,59,67,46,8,38,1.46,17.39,Difficile,Difficile,0,Meme Difficulte que la Prediction,Pas Adapte
1063,2015,Sociologie,1,Sociologie Generale,4,Les Debats Sociologiques Contemporains,7,1064,5,QCU,0.68,0.33,32.57,10,21,31,27,10,17,1.15,37.04,Difficile,Difficile,0,Meme Difficulte que la Prediction,Pas Adapte
2129,2016,Sociologie,1,Sociologie Generale,4,Les Debats Sociologiques Contemporains,7,1064,5,QO,0.69,0.22,41.73,13,18,31,25,13,12,1.24,52.0,Moyen,Moyen,0,Meme Difficulte que la Prediction,Pas Adapte
3195,2017,Sociologie,1,Sociologie Generale,4,Les Debats Sociologiques Contemporains,7,1064,5,QO,0.98,0.07,17.25,6,26,32,23,6,17,1.39,26.09,Difficile,Difficile,0,Meme Difficulte que la Prediction,Pas Adapte
4261,2018,Sociologie,1,Sociologie Generale,4,Les Debats Sociologiques Contemporains,7,1064,5,QO,0.92,0.14,18.1,6,27,33,20,6,14,1.65,30.0,Difficile,Difficile,0,Meme Difficulte que la Prediction,Pas Adapte
5327,2019,Sociologie,1,Sociologie Generale,4,Les Debats Sociologiques Contemporains,7,1064,5,QO,0.48,0.24,60.62,22,15,37,28,22,6,1.32,78.57,Moyen,Moyen,0,Meme Difficulte que la Prediction,Adapte
6393,2020,Sociologie,1,Sociologie Generale,4,Les Debats Sociologiques Contemporains,7,1064,5,QO,0.24,0.17,60.62,24,16,40,35,24,11,1.14,68.57,Moyen,Moyen,0,Meme Difficulte que la Prediction,Adapte
1064,2015,Sociologie,1,Sociologie Generale,4,Les Debats Sociologiques Contemporains,7,1065,6,QCM,0.57,0.19,4.89,4,71,75,64,4,60,1.17,6.25,Difficile,Difficile,0,Meme Difficulte que la Prediction,Pas Adapte
2130,2016,Sociologie,1,Sociologie Generale,4,Les Debats Sociologiques Contemporains,7,1065,6,QCM,0.08,0.92,93.72,61,4,65,65,61,4,1.0,93.85,Moyen,Facile,1,Plus Facile que la Prediction,Pas Adapte
3196,2017,Sociologie,1,Sociologie Generale,4,Les Debats Sociologiques Contemporains,7,1065,6,QCM,0.1,0.9,68.96,43,20,63,48,43,5,1.31,89.58,Moyen,Facile,1,Plus Facile que la Prediction,Adapte
4262,2018,Sociologie,1,Sociologie Generale,4,Les Debats Sociologiques Contemporains,7,1065,6,QCM,0.06,0.82,68.96,40,18,58,42,40,2,1.38,95.24,Facile,Facile,0,Meme Difficulte que la Prediction,Adapte
5328,2019,Sociologie,1,Sociologie Generale,4,Les Debats Sociologiques Contemporains,7,1065,6,QCM,0.0,0.74,68.96,43,20,63,62,43,19,1.02,69.35,Facile,Facile,0,Meme Difficulte que la Prediction,Adapte
6394,2020,Sociologie,1,Sociologie Generale,4,Les Debats Sociologiques Contemporains,7,1065,6,QCM,0.07,0.89,68.96,39,17,56,51,39,12,1.1,76.47,Facile,Facile,0,Meme Difficulte que la Prediction,Adapte
1065,2015,Sociologie,1,Sociologie Generale,4,Les Debats Sociologiques Contemporains,7,1066,7,QCU,0.18,0.93,65.04,56,30,86,59,56,3,1.46,94.92,Moyen,Facile,1,Plus Facile que la Prediction,Adapte
2131,2016,Sociologie,1,Sociologie Generale,4,Les Debats Sociologiques Contemporains,7,1066,7,QCU,0.01,0.98,65.04,59,32,91,68,59,9,1.34,86.76,Facile,Facile,0,Meme Difficulte que la Prediction,Adapte
3197,2017,Sociologie,1,Sociologie Generale,4,Les Debats Sociologiques Contemporains,7,1066,7,QCU,0.02,0.93,65.04,52,28,80,54,52,2,1.48,96.3,Facile,Facile,0,Meme Difficulte que la Prediction,Adapte
4263,2018,Sociologie,1,Sociologie Generale,4,Les Debats Sociologiques Contemporains,7,1066,7,QCU,0.18,0.78,65.04,60,32,92,73,60,13,1.26,82.19,Facile,Facile,0,Meme Difficulte que la Prediction,Adapte
5329,2019,Sociologie,1,Sociologie Generale,4,Les Debats Sociologiques Contemporains,7,1066,7,QCU,0.16,0.85,65.04,58,31,89,71,58,13,1.25,81.69,Facile,Facile,0,Meme Difficulte que la Prediction,Adapte
6395,2020,Sociologie,1,Sociologie Generale,4,Les Debats Sociologiques Contemporains,7,1066,7,QCU,0.18,0.79,65.04,59,31,90,80,59,21,1.12,73.75,Facile,Facile,0,Meme Difficulte que la Prediction,Adapte
