,Year,Departement,Module_ID,Module,Chapter_ID,Chapter,Quiz_perChapter,Quizz_ID,Rank_onChapter,Quizz_Type,Slip,Guess,Success_Prct,Success_Attempts,Failure_Attempts,Number_Attempts,UniQ_Learner,Sucessful_Learners,Unsucessful_Learners,Avg_Attempts,Percent_Learners_Success,Predict_Difficulty,Correct_Difficulty,Score,Difficulty_String,Difficulty
0,2015,Droit,1,Histoire du Droit,1,La Grèce,3,1,1,QCU,0.02,0.91,86.09,82,13,95,85,82,3,1.12,96.47,Facile,Facile,0,Meme Difficulté,Pas Adapte
1111,2016,Droit,1,Histoire du Droit,1,La Grèce,3,1,1,QCU,0.47,0.25,34.26,33,63,96,57,33,24,1.68,57.89,Difficile,Difficile,0,Meme Difficulté,Pas Adapte
2222,2017,Droit,1,Histoire du Droit,1,La Grèce,3,1,1,QCU,0.16,0.77,96.93,92,3,95,95,92,3,1.0,96.84,Facile,Facile,0,Meme Difficulté,Pas Adapte
3333,2018,Droit,1,Histoire du Droit,1,La Grèce,3,1,1,QCU,0.44,0.36,12.95,10,71,81,48,10,38,1.69,20.83,Moyen,Difficile,-1,Plus Difficile,Pas Adapte
4444,2019,Droit,1,Histoire du Droit,1,La Grèce,3,1,1,QCU,0.21,0.42,36.85,29,51,80,48,29,19,1.67,60.42,Facile,Moyen,-1,Plus Difficile,Pas Adapte
5555,2020,Droit,1,Histoire du Droit,1,La Grèce,3,1,1,QCU,0.13,0.82,99.9,80,0,80,80,80,0,1.0,100.0,Facile,Facile,0,Meme Difficulté,Pas Adapte
1,2015,Droit,1,Histoire du Droit,1,La Grèce,3,2,2,QROC,0.96,0.2,15.86,5,25,30,29,5,24,1.03,17.24,Difficile,Difficile,0,Meme Difficulté,Pas Adapte
1112,2016,Droit,1,Histoire du Droit,1,La Grèce,3,2,2,QO,0.62,0.23,43.15,12,16,28,17,12,5,1.65,70.59,Facile,Moyen,-1,Plus Difficile,Pas Adapte
2223,2017,Droit,1,Histoire du Droit,1,La Grèce,3,2,2,QO,0.29,0.28,60.0,19,12,31,27,19,8,1.15,70.37,Facile,Moyen,-1,Plus Difficile,Pas Adapte
3334,2018,Droit,1,Histoire du Droit,1,La Grèce,3,2,2,QO,0.19,0.43,78.0,27,7,34,27,27,0,1.26,100.0,Moyen,Facile,1,Plus Facile,Pas Adapte
4445,2019,Droit,1,Histoire du Droit,1,La Grèce,3,2,2,QO,0.81,0.09,17.65,7,31,38,32,7,25,1.19,21.88,Facile,Difficile,-2,Beaucoup plus Difficile,Pas Adapte
5556,2020,Droit,1,Histoire du Droit,1,La Grèce,3,2,2,QO,0.76,0.05,12.83,4,30,34,19,4,15,1.79,21.05,Facile,Difficile,-2,Beaucoup plus Difficile,Pas Adapte
2,2015,Droit,1,Histoire du Droit,1,La Grèce,3,3,3,QCU,0.0,0.88,95.91,89,4,93,89,89,0,1.04,100.0,Moyen,Facile,1,Plus Facile,Pas Adapte
1113,2016,Droit,1,Histoire du Droit,1,La Grèce,3,3,3,QCU,0.63,0.37,13.06,14,90,104,71,14,57,1.46,19.72,Facile,Difficile,-2,Beaucoup plus Difficile,Pas Adapte
2224,2017,Droit,1,Histoire du Droit,1,La Grèce,3,3,3,QCU,0.44,0.36,16.76,19,95,114,93,19,74,1.23,20.43,Moyen,Difficile,-1,Plus Difficile,Pas Adapte
3335,2018,Droit,1,Histoire du Droit,1,La Grèce,3,3,3,QCU,0.38,0.49,57.45,67,49,116,70,67,3,1.66,95.71,Facile,Moyen,-1,Plus Difficile,Pas Adapte
4446,2019,Droit,1,Histoire du Droit,1,La Grèce,3,3,3,QCU,0.35,0.54,56.47,71,54,125,115,71,44,1.09,61.74,Moyen,Moyen,0,Meme Difficulté,Pas Adapte
5557,2020,Droit,1,Histoire du Droit,1,La Grèce,3,3,3,QCU,0.28,0.54,47.87,62,67,129,75,62,13,1.72,82.67,Facile,Moyen,-1,Plus Difficile,Pas Adapte
3,2015,Droit,1,Histoire du Droit,2,L'Italie,7,4,1,QCM,0.53,0.21,19.8,10,43,53,52,10,42,1.02,19.23,Moyen,Difficile,-1,Plus Difficile,Pas Adapte
1114,2016,Droit,1,Histoire du Droit,2,L'Italie,7,4,1,QCM,0.25,0.68,39.52,19,29,48,26,19,7,1.85,73.08,Moyen,Moyen,0,Meme Difficulté,Pas Adapte
2225,2017,Droit,1,Histoire du Droit,2,L'Italie,7,4,1,QCM,0.1,0.75,87.04,46,7,53,51,46,5,1.04,90.2,Moyen,Facile,1,Plus Facile,Pas Adapte
3336,2018,Droit,1,Histoire du Droit,2,L'Italie,7,4,1,QCM,0.58,0.2,8.91,5,56,61,41,5,36,1.49,12.2,Facile,Difficile,-2,Beaucoup plus Difficile,Pas Adapte
4447,2019,Droit,1,Histoire du Droit,2,L'Italie,7,4,1,QCM,0.33,0.38,62.01,42,26,68,52,42,10,1.31,80.77,Difficile,Moyen,1,Plus Facile,Pas Adapte
5558,2020,Droit,1,Histoire du Droit,2,L'Italie,7,4,1,QCM,0.01,0.82,81.75,57,13,70,66,57,9,1.06,86.36,Difficile,Facile,2,Beaucoup plus Facile,Pas Adapte
4,2015,Droit,1,Histoire du Droit,2,L'Italie,7,5,2,QROC,0.33,0.25,53.31,41,35,76,65,41,24,1.17,63.08,Moyen,Moyen,0,Meme Difficulté,Pas Adapte
1115,2016,Droit,1,Histoire du Droit,2,L'Italie,7,5,2,QROC,0.46,0.26,59.26,50,35,85,51,50,1,1.67,98.04,Moyen,Moyen,0,Meme Difficulté,Pas Adapte
2226,2017,Droit,1,Histoire du Droit,2,L'Italie,7,5,2,QROC,0.9,0.15,10.45,9,73,82,75,9,66,1.09,12.0,Facile,Difficile,-2,Beaucoup plus Difficile,Pas Adapte
3337,2018,Droit,1,Histoire du Droit,2,L'Italie,7,5,2,QROC,0.06,0.91,69.7,54,24,78,73,54,19,1.07,73.97,Moyen,Facile,1,Plus Facile,Adapte
4448,2019,Droit,1,Histoire du Droit,2,L'Italie,7,5,2,QROC,0.19,0.98,69.7,47,20,67,49,47,2,1.37,95.92,Facile,Facile,0,Meme Difficulté,Adapte
5559,2020,Droit,1,Histoire du Droit,2,L'Italie,7,5,2,QROC,0.02,0.62,69.7,53,23,76,72,53,19,1.06,73.61,Facile,Facile,0,Meme Difficulté,Adapte
5,2015,Droit,1,Histoire du Droit,2,L'Italie,7,6,3,QROC,0.11,0.59,69.89,57,24,81,60,57,3,1.35,95.0,Facile,Facile,0,Meme Difficulté,Adapte
1116,2016,Droit,1,Histoire du Droit,2,L'Italie,7,6,3,QROC,0.19,0.79,69.89,49,21,70,57,49,8,1.23,85.96,Facile,Facile,0,Meme Difficulté,Adapte
2227,2017,Droit,1,Histoire du Droit,2,L'Italie,7,6,3,QROC,0.02,0.7,69.89,50,22,72,55,50,5,1.31,90.91,Facile,Facile,0,Meme Difficulté,Adapte
3338,2018,Droit,1,Histoire du Droit,2,L'Italie,7,6,3,QROC,0.13,0.85,69.89,45,20,65,55,45,10,1.18,81.82,Facile,Facile,0,Meme Difficulté,Adapte
4449,2019,Droit,1,Histoire du Droit,2,L'Italie,7,6,3,QCM,0.1,0.73,69.89,43,19,62,60,43,17,1.03,71.67,Facile,Facile,0,Meme Difficulté,Adapte
5560,2020,Droit,1,Histoire du Droit,2,L'Italie,7,6,3,QCM,0.16,0.82,69.89,48,20,68,55,48,7,1.24,87.27,Facile,Facile,0,Meme Difficulté,Adapte
6,2015,Droit,1,Histoire du Droit,2,L'Italie,7,7,4,QROC,0.52,0.33,57.39,14,11,25,25,14,11,1.0,56.0,Difficile,Moyen,1,Plus Facile,Pas Adapte
1117,2016,Droit,1,Histoire du Droit,2,L'Italie,7,7,4,QROC,0.28,0.26,47.23,12,13,25,24,12,12,1.04,50.0,Difficile,Moyen,1,Plus Facile,Pas Adapte
2228,2017,Droit,1,Histoire du Droit,2,L'Italie,7,7,4,QO,0.04,0.95,69.08,17,8,25,18,17,1,1.39,94.44,Difficile,Facile,2,Beaucoup plus Facile,Adapte
3339,2018,Droit,1,Histoire du Droit,2,L'Italie,7,7,4,QO,0.17,0.45,69.08,20,9,29,28,20,8,1.04,71.43,Facile,Facile,0,Meme Difficulté,Adapte
4450,2019,Droit,1,Histoire du Droit,2,L'Italie,7,7,4,QO,0.0,0.92,69.08,19,8,27,27,19,8,1.0,70.37,Facile,Facile,0,Meme Difficulté,Adapte
5561,2020,Droit,1,Histoire du Droit,2,L'Italie,7,7,4,QO,0.05,0.38,69.08,16,7,23,22,16,6,1.05,72.73,Facile,Facile,0,Meme Difficulté,Adapte
7,2015,Droit,1,Histoire du Droit,2,L'Italie,7,8,5,QROC,0.48,0.3,40.85,30,44,74,39,30,9,1.9,76.92,Difficile,Moyen,1,Plus Facile,Pas Adapte
1118,2016,Droit,1,Histoire du Droit,2,L'Italie,7,8,5,QROC,0.42,0.26,64.0,53,30,83,54,53,1,1.54,98.15,Moyen,Moyen,0,Meme Difficulté,Pas Adapte
2229,2017,Droit,1,Histoire du Droit,2,L'Italie,7,8,5,QROC,0.16,0.51,82.0,76,17,93,77,76,1,1.21,98.7,Moyen,Facile,1,Plus Facile,Pas Adapte
3340,2018,Droit,1,Histoire du Droit,2,L'Italie,7,8,5,QROC,0.63,0.03,14.79,13,75,88,39,13,26,2.26,33.33,Difficile,Difficile,0,Meme Difficulté,Pas Adapte
4451,2019,Droit,1,Histoire du Droit,2,L'Italie,7,8,5,QROC,0.66,0.17,25.92,20,59,79,59,20,39,1.34,33.9,Facile,Difficile,-2,Beaucoup plus Difficile,Pas Adapte
5562,2020,Droit,1,Histoire du Droit,2,L'Italie,7,8,5,QROC,0.85,0.21,14.15,13,78,91,56,13,43,1.62,23.21,Moyen,Difficile,-1,Plus Difficile,Pas Adapte
8,2015,Droit,1,Histoire du Droit,2,L'Italie,7,9,6,QCM,0.59,0.29,31.95,25,52,77,67,25,42,1.15,37.31,Facile,Difficile,-2,Beaucoup plus Difficile,Pas Adapte
1119,2016,Droit,1,Histoire du Droit,2,L'Italie,7,9,6,QCM,0.52,0.16,27.8,20,53,73,44,20,24,1.66,45.45,Facile,Difficile,-2,Beaucoup plus Difficile,Pas Adapte
2230,2017,Droit,1,Histoire du Droit,2,L'Italie,7,9,6,QCM,0.02,0.79,65.08,51,28,79,73,51,22,1.08,69.86,Facile,Facile,0,Meme Difficulté,Adapte
3341,2018,Droit,1,Histoire du Droit,2,L'Italie,7,9,6,QCM,0.12,0.94,65.08,51,28,79,52,51,1,1.52,98.08,Facile,Facile,0,Meme Difficulté,Adapte
4452,2019,Droit,1,Histoire du Droit,2,L'Italie,7,9,6,QCM,0.16,0.92,65.08,51,28,79,78,51,27,1.01,65.38,Facile,Facile,0,Meme Difficulté,Adapte
5563,2020,Droit,1,Histoire du Droit,2,L'Italie,7,9,6,QCM,0.02,0.85,65.08,46,25,71,57,46,11,1.25,80.7,Facile,Facile,0,Meme Difficulté,Adapte
9,2015,Droit,1,Histoire du Droit,2,L'Italie,7,10,7,QROC,0.65,0.19,22.54,20,67,87,72,20,52,1.21,27.78,Moyen,Difficile,-1,Plus Difficile,Pas Adapte
1120,2016,Droit,1,Histoire du Droit,2,L'Italie,7,10,7,QROC,0.08,0.46,91.17,88,9,97,96,88,8,1.01,91.67,Facile,Facile,0,Meme Difficulté,Pas Adapte
2231,2017,Droit,1,Histoire du Droit,2,L'Italie,7,10,7,QO,0.04,0.68,73.76,81,29,110,92,81,11,1.2,88.04,Moyen,Facile,1,Plus Facile,Adapte
3342,2018,Droit,1,Histoire du Droit,2,L'Italie,7,10,7,QO,0.11,0.87,73.76,91,32,123,105,91,14,1.17,86.67,Facile,Facile,0,Meme Difficulté,Adapte
4453,2019,Droit,1,Histoire du Droit,2,L'Italie,7,10,7,QO,0.18,0.46,73.76,84,30,114,87,84,3,1.31,96.55,Facile,Facile,0,Meme Difficulté,Adapte
5564,2020,Droit,1,Histoire du Droit,2,L'Italie,7,10,7,QO,0.11,0.96,73.76,78,28,106,99,78,21,1.07,78.79,Facile,Facile,0,Meme Difficulté,Adapte
10,2015,Droit,2,Introduction Historique au Droit,1,L'Ancien Regime,4,11,1,QCM,0.75,0.28,2.23,0,9,9,5,0,5,1.8,0.0,Difficile,Difficile,0,Meme Difficulté,Pas Adapte
1121,2016,Droit,2,Introduction Historique au Droit,1,L'Ancien Regime,4,11,1,QCM,0.62,0.27,21.37,2,7,9,9,2,7,1.0,22.22,Difficile,Difficile,0,Meme Difficulté,Pas Adapte
2232,2017,Droit,2,Introduction Historique au Droit,1,L'Ancien Regime,4,11,1,QROC,0.07,0.47,93.38,9,1,10,9,9,0,1.11,100.0,Moyen,Facile,1,Plus Facile,Pas Adapte
3343,2018,Droit,2,Introduction Historique au Droit,1,L'Ancien Regime,4,11,1,QROC,0.68,0.22,33.29,4,7,11,5,4,1,2.2,80.0,Difficile,Difficile,0,Meme Difficulté,Pas Adapte
4454,2019,Droit,2,Introduction Historique au Droit,1,L'Ancien Regime,4,11,1,QROC,0.89,0.03,28.54,3,9,12,12,3,9,1.0,25.0,Difficile,Difficile,0,Meme Difficulté,Pas Adapte
5565,2020,Droit,2,Introduction Historique au Droit,1,L'Ancien Regime,4,11,1,QROC,0.98,0.23,8.1,1,12,13,7,1,6,1.86,14.29,Facile,Difficile,-2,Beaucoup plus Difficile,Pas Adapte
11,2015,Droit,2,Introduction Historique au Droit,1,L'Ancien Regime,4,12,2,QCU,0.31,0.57,54.15,50,42,92,56,50,6,1.64,89.29,Facile,Moyen,-1,Plus Difficile,Pas Adapte
1122,2016,Droit,2,Introduction Historique au Droit,1,L'Ancien Regime,4,12,2,QCU,0.28,0.68,60.87,52,34,86,72,52,20,1.19,72.22,Facile,Moyen,-1,Plus Difficile,Pas Adapte
2233,2017,Droit,2,Introduction Historique au Droit,1,L'Ancien Regime,4,12,2,QCU,0.2,0.49,38.29,31,49,80,56,31,25,1.43,55.36,Difficile,Moyen,1,Plus Facile,Pas Adapte
3344,2018,Droit,2,Introduction Historique au Droit,1,L'Ancien Regime,4,12,2,QCU,0.26,0.71,49.77,42,42,84,79,42,37,1.06,53.16,Moyen,Moyen,0,Meme Difficulté,Pas Adapte
4455,2019,Droit,2,Introduction Historique au Droit,1,L'Ancien Regime,4,12,2,QCU,0.31,0.59,54.79,40,33,73,67,40,27,1.09,59.7,Difficile,Moyen,1,Plus Facile,Pas Adapte
5566,2020,Droit,2,Introduction Historique au Droit,1,L'Ancien Regime,4,12,2,QCU,0.15,0.75,71.37,46,18,64,56,46,10,1.14,82.14,Difficile,Facile,2,Beaucoup plus Facile,Adapte
12,2015,Droit,2,Introduction Historique au Droit,1,L'Ancien Regime,4,13,3,QROC,0.16,0.61,81.77,44,10,54,54,44,10,1.0,81.48,Facile,Facile,0,Meme Difficulté,Pas Adapte
1123,2016,Droit,2,Introduction Historique au Droit,1,L'Ancien Regime,4,13,3,QROC,0.44,0.25,59.12,28,19,47,40,28,12,1.18,70.0,Difficile,Moyen,1,Plus Facile,Pas Adapte
2234,2017,Droit,2,Introduction Historique au Droit,1,L'Ancien Regime,4,13,3,QROC,0.11,0.78,79.82,43,11,54,52,43,9,1.04,82.69,Moyen,Facile,1,Plus Facile,Pas Adapte
3345,2018,Droit,2,Introduction Historique au Droit,1,L'Ancien Regime,4,13,3,QROC,0.6,0.22,2.61,1,55,56,55,1,54,1.02,1.82,Facile,Difficile,-2,Beaucoup plus Difficile,Pas Adapte
4456,2019,Droit,2,Introduction Historique au Droit,1,L'Ancien Regime,4,13,3,QROC,0.12,1.0,93.53,60,4,64,62,60,2,1.03,96.77,Difficile,Facile,2,Beaucoup plus Facile,Pas Adapte
5567,2020,Droit,2,Introduction Historique au Droit,1,L'Ancien Regime,4,13,3,QROC,0.1,1.0,81.86,58,13,71,71,58,13,1.0,81.69,Difficile,Facile,2,Beaucoup plus Facile,Pas Adapte
13,2015,Droit,2,Introduction Historique au Droit,1,L'Ancien Regime,4,14,4,QCU,0.16,0.94,73.4,65,24,89,78,65,13,1.14,83.33,Facile,Facile,0,Meme Difficulté,Adapte
1124,2016,Droit,2,Introduction Historique au Droit,1,L'Ancien Regime,4,14,4,QCU,0.06,0.79,73.4,65,24,89,71,65,6,1.25,91.55,Facile,Facile,0,Meme Difficulté,Adapte
2235,2017,Droit,2,Introduction Historique au Droit,1,L'Ancien Regime,4,14,4,QCU,0.17,0.95,73.4,74,27,101,84,74,10,1.2,88.1,Facile,Facile,0,Meme Difficulté,Adapte
3346,2018,Droit,2,Introduction Historique au Droit,1,L'Ancien Regime,4,14,4,QROC,0.14,0.62,73.4,64,23,87,72,64,8,1.21,88.89,Facile,Facile,0,Meme Difficulté,Adapte
4457,2019,Droit,2,Introduction Historique au Droit,1,L'Ancien Regime,4,14,4,QROC,0.06,0.55,73.4,62,22,84,80,62,18,1.05,77.5,Facile,Facile,0,Meme Difficulté,Adapte
5568,2020,Droit,2,Introduction Historique au Droit,1,L'Ancien Regime,4,14,4,QO,0.12,0.84,73.4,54,20,74,55,54,1,1.35,98.18,Facile,Facile,0,Meme Difficulté,Adapte
14,2015,Droit,2,Introduction Historique au Droit,2,La Contestation du Regime Feodal,13,15,1,QCU,0.19,0.83,72.68,58,22,80,69,58,11,1.16,84.06,Difficile,Facile,2,Beaucoup plus Facile,Adapte
1125,2016,Droit,2,Introduction Historique au Droit,2,La Contestation du Regime Feodal,13,15,1,QCU,0.01,0.82,72.68,52,20,72,60,52,8,1.2,86.67,Facile,Facile,0,Meme Difficulté,Adapte
2236,2017,Droit,2,Introduction Historique au Droit,2,La Contestation du Regime Feodal,13,15,1,QCM,0.11,0.98,72.68,48,18,66,52,48,4,1.27,92.31,Facile,Facile,0,Meme Difficulté,Adapte
3347,2018,Droit,2,Introduction Historique au Droit,2,La Contestation du Regime Feodal,13,15,1,QCM,0.18,0.94,72.68,43,16,59,53,43,10,1.11,81.13,Facile,Facile,0,Meme Difficulté,Adapte
4458,2019,Droit,2,Introduction Historique au Droit,2,La Contestation du Regime Feodal,13,15,1,QCM,0.1,0.84,72.68,45,17,62,54,45,9,1.15,83.33,Facile,Facile,0,Meme Difficulté,Adapte
5569,2020,Droit,2,Introduction Historique au Droit,2,La Contestation du Regime Feodal,13,15,1,QCU,0.07,0.77,72.68,47,18,65,48,47,1,1.35,97.92,Facile,Facile,0,Meme Difficulté,Adapte
15,2015,Droit,2,Introduction Historique au Droit,2,La Contestation du Regime Feodal,13,16,2,QCU,0.14,0.84,68.44,14,6,20,18,14,4,1.11,77.78,Difficile,Facile,2,Beaucoup plus Facile,Adapte
1126,2016,Droit,2,Introduction Historique au Droit,2,La Contestation du Regime Feodal,13,16,2,QCU,0.14,0.99,68.44,15,7,22,20,15,5,1.1,75.0,Facile,Facile,0,Meme Difficulté,Adapte
2237,2017,Droit,2,Introduction Historique au Droit,2,La Contestation du Regime Feodal,13,16,2,QCU,0.19,0.79,68.44,17,8,25,20,17,3,1.25,85.0,Facile,Facile,0,Meme Difficulté,Adapte
3348,2018,Droit,2,Introduction Historique au Droit,2,La Contestation du Regime Feodal,13,16,2,QCU,0.04,0.94,68.44,15,7,22,21,15,6,1.05,71.43,Facile,Facile,0,Meme Difficulté,Adapte
4459,2019,Droit,2,Introduction Historique au Droit,2,La Contestation du Regime Feodal,13,16,2,QCU,0.04,0.99,68.44,17,8,25,20,17,3,1.25,85.0,Facile,Facile,0,Meme Difficulté,Adapte
5570,2020,Droit,2,Introduction Historique au Droit,2,La Contestation du Regime Feodal,13,16,2,QCM,0.14,0.84,68.44,19,9,28,23,19,4,1.22,82.61,Facile,Facile,0,Meme Difficulté,Adapte
16,2015,Droit,2,Introduction Historique au Droit,2,La Contestation du Regime Feodal,13,17,3,QCU,0.13,0.9,99.25,10,0,10,10,10,0,1.0,100.0,Difficile,Facile,2,Beaucoup plus Facile,Pas Adapte
1127,2016,Droit,2,Introduction Historique au Droit,2,La Contestation du Regime Feodal,13,17,3,QO,0.99,0.04,33.0,4,7,11,8,4,4,1.38,50.0,Moyen,Difficile,-1,Plus Difficile,Pas Adapte
2238,2017,Droit,2,Introduction Historique au Droit,2,La Contestation du Regime Feodal,13,17,3,QO,0.05,0.47,70.78,9,4,13,10,9,1,1.3,90.0,Moyen,Facile,1,Plus Facile,Adapte
3349,2018,Droit,2,Introduction Historique au Droit,2,La Contestation du Regime Feodal,13,17,3,QO,0.07,0.35,70.78,11,4,15,15,11,4,1.0,73.33,Facile,Facile,0,Meme Difficulté,Adapte
4460,2019,Droit,2,Introduction Historique au Droit,2,La Contestation du Regime Feodal,13,17,3,QO,0.16,0.94,70.78,11,4,15,12,11,1,1.25,91.67,Facile,Facile,0,Meme Difficulté,Adapte
5571,2020,Droit,2,Introduction Historique au Droit,2,La Contestation du Regime Feodal,13,17,3,QO,0.11,0.9,70.78,10,4,14,11,10,1,1.27,90.91,Facile,Facile,0,Meme Difficulté,Adapte
17,2015,Droit,2,Introduction Historique au Droit,2,La Contestation du Regime Feodal,13,18,4,QCU,0.74,0.24,19.7,19,75,94,77,19,58,1.22,24.68,Moyen,Difficile,-1,Plus Difficile,Pas Adapte
1128,2016,Droit,2,Introduction Historique au Droit,2,La Contestation du Regime Feodal,13,18,4,QCU,0.46,0.3,33.21,31,63,94,56,31,25,1.68,55.36,Facile,Difficile,-2,Beaucoup plus Difficile,Pas Adapte
2239,2017,Droit,2,Introduction Historique au Droit,2,La Contestation du Regime Feodal,13,18,4,QCU,0.27,0.44,48.88,40,41,81,45,40,5,1.8,88.89,Difficile,Moyen,1,Plus Facile,Pas Adapte
3350,2018,Droit,2,Introduction Historique au Droit,2,La Contestation du Regime Feodal,13,18,4,QCM,0.05,0.77,72.9,59,22,81,64,59,5,1.27,92.19,Difficile,Facile,2,Beaucoup plus Facile,Adapte
4461,2019,Droit,2,Introduction Historique au Droit,2,La Contestation du Regime Feodal,13,18,4,QCM,0.14,0.98,72.9,65,24,89,87,65,22,1.02,74.71,Facile,Facile,0,Meme Difficulté,Adapte
5572,2020,Droit,2,Introduction Historique au Droit,2,La Contestation du Regime Feodal,13,18,4,QCM,0.17,0.77,72.9,67,25,92,82,67,15,1.12,81.71,Facile,Facile,0,Meme Difficulté,Adapte
18,2015,Droit,2,Introduction Historique au Droit,2,La Contestation du Regime Feodal,13,19,5,QROC,0.74,0.07,32.34,2,5,7,4,2,2,1.75,50.0,Difficile,Difficile,0,Meme Difficulté,Pas Adapte
1129,2016,Droit,2,Introduction Historique au Droit,2,La Contestation du Regime Feodal,13,19,5,QCM,0.69,0.18,17.18,1,7,8,3,1,2,2.67,33.33,Difficile,Difficile,0,Meme Difficulté,Pas Adapte
2240,2017,Droit,2,Introduction Historique au Droit,2,La Contestation du Regime Feodal,13,19,5,QCM,0.36,0.65,53.74,4,4,8,6,4,2,1.33,66.67,Facile,Moyen,-1,Plus Difficile,Pas Adapte
3351,2018,Droit,2,Introduction Historique au Droit,2,La Contestation du Regime Feodal,13,19,5,QCU,0.1,0.96,65.78,5,2,7,6,5,1,1.17,83.33,Facile,Facile,0,Meme Difficulté,Adapte
4462,2019,Droit,2,Introduction Historique au Droit,2,La Contestation du Regime Feodal,13,19,5,QCM,0.08,0.91,65.78,5,3,8,7,5,2,1.14,71.43,Facile,Facile,0,Meme Difficulté,Adapte
5573,2020,Droit,2,Introduction Historique au Droit,2,La Contestation du Regime Feodal,13,19,5,QCM,0.05,0.98,65.78,5,2,7,7,5,2,1.0,71.43,Facile,Facile,0,Meme Difficulté,Adapte
19,2015,Droit,2,Introduction Historique au Droit,2,La Contestation du Regime Feodal,13,20,6,QCM,0.53,0.21,22.34,21,73,94,38,21,17,2.47,55.26,Difficile,Difficile,0,Meme Difficulté,Pas Adapte
1130,2016,Droit,2,Introduction Historique au Droit,2,La Contestation du Regime Feodal,13,20,6,QCM,0.47,0.67,49.32,42,43,85,43,42,1,1.98,97.67,Facile,Moyen,-1,Plus Difficile,Pas Adapte
2241,2017,Droit,2,Introduction Historique au Droit,2,La Contestation du Regime Feodal,13,20,6,QCM,0.66,0.2,32.17,25,54,79,60,25,35,1.32,41.67,Facile,Difficile,-2,Beaucoup plus Difficile,Pas Adapte
3352,2018,Droit,2,Introduction Historique au Droit,2,La Contestation du Regime Feodal,13,20,6,QCM,0.48,0.54,61.86,53,33,86,74,53,21,1.16,71.62,Facile,Moyen,-1,Plus Difficile,Pas Adapte
4463,2019,Droit,2,Introduction Historique au Droit,2,La Contestation du Regime Feodal,13,20,6,QCU,0.44,0.25,22.32,18,61,79,45,18,27,1.76,40.0,Difficile,Difficile,0,Meme Difficulté,Pas Adapte
5574,2020,Droit,2,Introduction Historique au Droit,2,La Contestation du Regime Feodal,13,20,6,QCU,0.72,0.25,2.18,2,70,72,65,2,63,1.11,3.08,Difficile,Difficile,0,Meme Difficulté,Pas Adapte
20,2015,Droit,2,Introduction Historique au Droit,2,La Contestation du Regime Feodal,13,21,7,QCM,0.14,0.94,94.28,62,4,66,63,62,1,1.05,98.41,Facile,Facile,0,Meme Difficulté,Pas Adapte
1131,2016,Droit,2,Introduction Historique au Droit,2,La Contestation du Regime Feodal,13,21,7,QCM,0.66,0.17,18.49,11,50,61,18,11,7,3.39,61.11,Difficile,Difficile,0,Meme Difficulté,Pas Adapte
2242,2017,Droit,2,Introduction Historique au Droit,2,La Contestation du Regime Feodal,13,21,7,QCM,0.4,0.63,38.38,21,33,54,52,21,31,1.04,40.38,Moyen,Moyen,0,Meme Difficulté,Pas Adapte
3353,2018,Droit,2,Introduction Historique au Droit,2,La Contestation du Regime Feodal,13,21,7,QCM,0.37,0.67,53.03,27,23,50,48,27,21,1.04,56.25,Difficile,Moyen,1,Plus Facile,Pas Adapte
4464,2019,Droit,2,Introduction Historique au Droit,2,La Contestation du Regime Feodal,13,21,7,QCM,0.69,0.2,5.98,3,54,57,27,3,24,2.11,11.11,Moyen,Difficile,-1,Plus Difficile,Pas Adapte
5575,2020,Droit,2,Introduction Historique au Droit,2,La Contestation du Regime Feodal,13,21,7,QCM,0.05,0.8,86.65,42,6,48,42,42,0,1.14,100.0,Facile,Facile,0,Meme Difficulté,Pas Adapte
21,2015,Droit,2,Introduction Historique au Droit,2,La Contestation du Regime Feodal,13,22,8,QCU,0.31,0.63,36.46,32,57,89,65,32,33,1.37,49.23,Moyen,Moyen,0,Meme Difficulté,Pas Adapte
1132,2016,Droit,2,Introduction Historique au Droit,2,La Contestation du Regime Feodal,13,22,8,QCU,0.67,0.32,6.29,6,93,99,34,6,28,2.91,17.65,Difficile,Difficile,0,Meme Difficulté,Pas Adapte
2243,2017,Droit,2,Introduction Historique au Droit,2,La Contestation du Regime Feodal,13,22,8,QCU,0.09,0.81,65.51,56,29,85,79,56,23,1.08,70.89,Moyen,Facile,1,Plus Facile,Adapte
3354,2018,Droit,2,Introduction Historique au Droit,2,La Contestation du Regime Feodal,13,22,8,QROC,0.11,0.89,65.51,62,32,94,72,62,10,1.31,86.11,Facile,Facile,0,Meme Difficulté,Adapte
4465,2019,Droit,2,Introduction Historique au Droit,2,La Contestation du Regime Feodal,13,22,8,QROC,0.01,0.7,65.51,66,35,101,100,66,34,1.01,66.0,Facile,Facile,0,Meme Difficulté,Adapte
5576,2020,Droit,2,Introduction Historique au Droit,2,La Contestation du Regime Feodal,13,22,8,QROC,0.0,0.74,65.51,64,33,97,88,64,24,1.1,72.73,Facile,Facile,0,Meme Difficulté,Adapte
22,2015,Droit,2,Introduction Historique au Droit,2,La Contestation du Regime Feodal,13,23,9,QROC,0.23,0.39,44.59,10,12,22,16,10,6,1.38,62.5,Difficile,Moyen,1,Plus Facile,Pas Adapte
1133,2016,Droit,2,Introduction Historique au Droit,2,La Contestation du Regime Feodal,13,23,9,QROC,0.58,0.33,53.21,10,9,19,15,10,5,1.27,66.67,Difficile,Moyen,1,Plus Facile,Pas Adapte
2244,2017,Droit,2,Introduction Historique au Droit,2,La Contestation du Regime Feodal,13,23,9,QROC,0.04,0.5,95.62,16,1,17,17,16,1,1.0,94.12,Difficile,Facile,2,Beaucoup plus Facile,Pas Adapte
3355,2018,Droit,2,Introduction Historique au Droit,2,La Contestation du Regime Feodal,13,23,9,QROC,0.14,0.44,82.99,14,3,17,15,14,1,1.13,93.33,Moyen,Facile,1,Plus Facile,Pas Adapte
4466,2019,Droit,2,Introduction Historique au Droit,2,La Contestation du Regime Feodal,13,23,9,QROC,0.09,0.72,88.87,13,2,15,14,13,1,1.07,92.86,Difficile,Facile,2,Beaucoup plus Facile,Pas Adapte
5577,2020,Droit,2,Introduction Historique au Droit,2,La Contestation du Regime Feodal,13,23,9,QO,0.93,0.08,23.6,3,10,13,7,3,4,1.86,42.86,Difficile,Difficile,0,Meme Difficulté,Pas Adapte
23,2015,Droit,2,Introduction Historique au Droit,2,La Contestation du Regime Feodal,13,24,10,QCU,0.43,0.34,28.3,20,52,72,50,20,30,1.44,40.0,Facile,Difficile,-2,Beaucoup plus Difficile,Pas Adapte
1134,2016,Droit,2,Introduction Historique au Droit,2,La Contestation du Regime Feodal,13,24,10,QCU,0.0,0.82,99.53,61,0,61,61,61,0,1.0,100.0,Facile,Facile,0,Meme Difficulté,Pas Adapte
2245,2017,Droit,2,Introduction Historique au Droit,2,La Contestation du Regime Feodal,13,24,10,QCU,0.16,0.77,78.77,55,15,70,69,55,14,1.01,79.71,Difficile,Facile,2,Beaucoup plus Facile,Pas Adapte
3356,2018,Droit,2,Introduction Historique au Droit,2,La Contestation du Regime Feodal,13,24,10,QCU,0.67,0.32,29.67,19,46,65,62,19,43,1.05,30.65,Difficile,Difficile,0,Meme Difficulté,Pas Adapte
4467,2019,Droit,2,Introduction Historique au Droit,2,La Contestation du Regime Feodal,13,24,10,QCU,0.08,0.82,68.79,47,22,69,60,47,13,1.15,78.33,Moyen,Facile,1,Plus Facile,Adapte
5578,2020,Droit,2,Introduction Historique au Droit,2,La Contestation du Regime Feodal,13,24,10,QCU,0.2,0.85,68.79,50,23,73,69,50,19,1.06,72.46,Facile,Facile,0,Meme Difficulté,Adapte
24,2015,Droit,2,Introduction Historique au Droit,2,La Contestation du Regime Feodal,13,25,11,QCU,0.4,0.38,2.91,2,76,78,74,2,72,1.05,2.7,Facile,Difficile,-2,Beaucoup plus Difficile,Pas Adapte
1135,2016,Droit,2,Introduction Historique au Droit,2,La Contestation du Regime Feodal,13,25,11,QCU,0.04,0.91,71.51,58,23,81,70,58,12,1.16,82.86,Difficile,Facile,2,Beaucoup plus Facile,Adapte
2246,2017,Droit,2,Introduction Historique au Droit,2,La Contestation du Regime Feodal,13,25,11,QCU,0.19,0.79,71.51,51,21,72,69,51,18,1.04,73.91,Facile,Facile,0,Meme Difficulté,Adapte
3357,2018,Droit,2,Introduction Historique au Droit,2,La Contestation du Regime Feodal,13,25,11,QCU,0.11,0.79,71.51,57,23,80,74,57,17,1.08,77.03,Facile,Facile,0,Meme Difficulté,Adapte
4468,2019,Droit,2,Introduction Historique au Droit,2,La Contestation du Regime Feodal,13,25,11,QCU,0.09,0.76,71.51,51,21,72,63,51,12,1.14,80.95,Facile,Facile,0,Meme Difficulté,Adapte
5579,2020,Droit,2,Introduction Historique au Droit,2,La Contestation du Regime Feodal,13,25,11,QCU,0.01,0.89,71.51,52,21,73,69,52,17,1.06,75.36,Facile,Facile,0,Meme Difficulté,Adapte
25,2015,Droit,2,Introduction Historique au Droit,2,La Contestation du Regime Feodal,13,26,12,QCU,0.13,0.76,78.48,47,13,60,49,47,2,1.22,95.92,Facile,Facile,0,Meme Difficulté,Pas Adapte
1136,2016,Droit,2,Introduction Historique au Droit,2,La Contestation du Regime Feodal,13,26,12,QCU,0.09,0.9,93.27,63,5,68,67,63,4,1.01,94.03,Facile,Facile,0,Meme Difficulté,Pas Adapte
2247,2017,Droit,2,Introduction Historique au Droit,2,La Contestation du Regime Feodal,13,26,12,QCM,0.05,0.86,74.24,46,16,62,53,46,7,1.17,86.79,Moyen,Facile,1,Plus Facile,Adapte
3358,2018,Droit,2,Introduction Historique au Droit,2,La Contestation du Regime Feodal,13,26,12,QCM,0.12,0.7,74.24,41,14,55,46,41,5,1.2,89.13,Facile,Facile,0,Meme Difficulté,Adapte
4469,2019,Droit,2,Introduction Historique au Droit,2,La Contestation du Regime Feodal,13,26,12,QCU,0.12,0.99,74.24,36,13,49,43,36,7,1.14,83.72,Facile,Facile,0,Meme Difficulté,Adapte
5580,2020,Droit,2,Introduction Historique au Droit,2,La Contestation du Regime Feodal,13,26,12,QCU,0.02,0.92,74.24,40,14,54,45,40,5,1.2,88.89,Facile,Facile,0,Meme Difficulté,Adapte
26,2015,Droit,2,Introduction Historique au Droit,2,La Contestation du Regime Feodal,13,27,13,QCU,0.15,0.81,89.24,86,10,96,90,86,4,1.07,95.56,Difficile,Facile,2,Beaucoup plus Facile,Pas Adapte
1137,2016,Droit,2,Introduction Historique au Droit,2,La Contestation du Regime Feodal,13,27,13,QCU,0.11,0.83,79.92,87,22,109,90,87,3,1.21,96.67,Difficile,Facile,2,Beaucoup plus Facile,Pas Adapte
2248,2017,Droit,2,Introduction Historique au Droit,2,La Contestation du Regime Feodal,13,27,13,QCU,0.3,0.68,59.25,69,47,116,115,69,46,1.01,60.0,Facile,Moyen,-1,Plus Difficile,Pas Adapte
3359,2018,Droit,2,Introduction Historique au Droit,2,La Contestation du Regime Feodal,13,27,13,QCU,0.16,0.83,84.76,87,16,103,99,87,12,1.04,87.88,Facile,Facile,0,Meme Difficulté,Pas Adapte
4470,2019,Droit,2,Introduction Historique au Droit,2,La Contestation du Regime Feodal,13,27,13,QCM,0.46,0.48,51.65,49,45,94,73,49,24,1.29,67.12,Facile,Moyen,-1,Plus Difficile,Pas Adapte
5581,2020,Droit,2,Introduction Historique au Droit,2,La Contestation du Regime Feodal,13,27,13,QCM,0.15,0.83,73.04,71,26,97,76,71,5,1.28,93.42,Difficile,Facile,2,Beaucoup plus Facile,Adapte
27,2015,Droit,2,Introduction Historique au Droit,3,La Crise de l'Ancien Regime,2,28,1,QCU,0.31,0.44,56.76,27,21,48,44,27,17,1.09,61.36,Facile,Moyen,-1,Plus Difficile,Pas Adapte
1138,2016,Droit,2,Introduction Historique au Droit,3,La Crise de l'Ancien Regime,2,28,1,QCU,0.62,0.4,28.28,12,30,42,17,12,5,2.47,70.59,Facile,Difficile,-2,Beaucoup plus Difficile,Pas Adapte
2249,2017,Droit,2,Introduction Historique au Droit,3,La Crise de l'Ancien Regime,2,28,1,QCU,0.06,0.87,66.35,31,16,47,39,31,8,1.21,79.49,Moyen,Facile,1,Plus Facile,Adapte
3360,2018,Droit,2,Introduction Historique au Droit,3,La Crise de l'Ancien Regime,2,28,1,QCM,0.17,0.83,66.35,27,13,40,39,27,12,1.03,69.23,Facile,Facile,0,Meme Difficulté,Adapte
4471,2019,Droit,2,Introduction Historique au Droit,3,La Crise de l'Ancien Regime,2,28,1,QCM,0.14,0.83,66.35,23,11,34,30,23,7,1.13,76.67,Facile,Facile,0,Meme Difficulté,Adapte
5582,2020,Droit,2,Introduction Historique au Droit,3,La Crise de l'Ancien Regime,2,28,1,QCM,0.13,0.84,66.35,21,11,32,25,21,4,1.28,84.0,Facile,Facile,0,Meme Difficulté,Adapte
28,2015,Droit,2,Introduction Historique au Droit,3,La Crise de l'Ancien Regime,2,29,2,QCM,0.4,0.34,48.36,38,41,79,45,38,7,1.76,84.44,Difficile,Moyen,1,Plus Facile,Pas Adapte
1139,2016,Droit,2,Introduction Historique au Droit,3,La Crise de l'Ancien Regime,2,29,2,QCM,0.6,0.2,3.56,3,72,75,38,3,35,1.97,7.89,Facile,Difficile,-2,Beaucoup plus Difficile,Pas Adapte
2250,2017,Droit,2,Introduction Historique au Droit,3,La Crise de l'Ancien Regime,2,29,2,QROC,0.13,0.76,82.62,65,14,79,67,65,2,1.18,97.01,Facile,Facile,0,Meme Difficulté,Pas Adapte
3361,2018,Droit,2,Introduction Historique au Droit,3,La Crise de l'Ancien Regime,2,29,2,QO,0.44,0.28,42.29,29,39,68,46,29,17,1.48,63.04,Facile,Moyen,-1,Plus Difficile,Pas Adapte
4472,2019,Droit,2,Introduction Historique au Droit,3,La Crise de l'Ancien Regime,2,29,2,QROC,0.03,0.61,85.59,67,11,78,69,67,2,1.13,97.1,Facile,Facile,0,Meme Difficulté,Pas Adapte
5583,2020,Droit,2,Introduction Historique au Droit,3,La Crise de l'Ancien Regime,2,29,2,QCM,0.67,0.19,15.95,14,73,87,66,14,52,1.32,21.21,Difficile,Difficile,0,Meme Difficulté,Pas Adapte
29,2015,Droit,2,Introduction Historique au Droit,4,"La Revolution Francaise, l'Affirmation du Liberalisme",1,30,1,QCM,0.56,0.28,25.19,11,33,44,40,11,29,1.1,27.5,Facile,Difficile,-2,Beaucoup plus Difficile,Pas Adapte
1140,2016,Droit,2,Introduction Historique au Droit,4,"La Revolution Francaise, l'Affirmation du Liberalisme",1,30,1,QCM,0.45,0.56,41.77,18,25,43,21,18,3,2.05,85.71,Difficile,Moyen,1,Plus Facile,Pas Adapte
2251,2017,Droit,2,Introduction Historique au Droit,4,"La Revolution Francaise, l'Affirmation du Liberalisme",1,30,1,QCM,0.44,0.33,62.06,24,14,38,34,24,10,1.12,70.59,Facile,Moyen,-1,Plus Difficile,Pas Adapte
3362,2018,Droit,2,Introduction Historique au Droit,4,"La Revolution Francaise, l'Affirmation du Liberalisme",1,30,1,QCM,0.04,0.94,79.4,27,7,34,27,27,0,1.26,100.0,Moyen,Facile,1,Plus Facile,Pas Adapte
4473,2019,Droit,2,Introduction Historique au Droit,4,"La Revolution Francaise, l'Affirmation du Liberalisme",1,30,1,QCM,0.01,0.73,94.65,37,2,39,39,37,2,1.0,94.87,Difficile,Facile,2,Beaucoup plus Facile,Pas Adapte
5584,2020,Droit,2,Introduction Historique au Droit,4,"La Revolution Francaise, l'Affirmation du Liberalisme",1,30,1,QCM,0.59,0.28,29.03,10,23,33,28,10,18,1.18,35.71,Moyen,Difficile,-1,Plus Difficile,Pas Adapte
30,2015,Droit,2,Introduction Historique au Droit,5,L'Amenagement du Liberalisme,13,31,1,QCM,0.03,0.9,93.12,6,0,6,6,6,0,1.0,100.0,Moyen,Facile,1,Plus Facile,Pas Adapte
1141,2016,Droit,2,Introduction Historique au Droit,5,L'Amenagement du Liberalisme,13,31,1,QCM,0.36,0.62,45.92,3,3,6,6,3,3,1.0,50.0,Moyen,Moyen,0,Meme Difficulté,Pas Adapte
2252,2017,Droit,2,Introduction Historique au Droit,5,L'Amenagement du Liberalisme,13,31,1,QCM,0.36,0.61,35.37,2,5,7,3,2,1,2.33,66.67,Difficile,Moyen,1,Plus Facile,Pas Adapte
3363,2018,Droit,2,Introduction Historique au Droit,5,L'Amenagement du Liberalisme,13,31,1,QCM,0.63,0.26,22.91,2,6,8,7,2,5,1.14,28.57,Moyen,Difficile,-1,Plus Difficile,Pas Adapte
4474,2019,Droit,2,Introduction Historique au Droit,5,L'Amenagement du Liberalisme,13,31,1,QCM,0.08,0.81,75.26,7,2,9,8,7,1,1.12,87.5,Facile,Facile,0,Meme Difficulté,Pas Adapte
5585,2020,Droit,2,Introduction Historique au Droit,5,L'Amenagement du Liberalisme,13,31,1,QCM,0.44,0.33,53.12,5,5,10,6,5,1,1.67,83.33,Difficile,Moyen,1,Plus Facile,Pas Adapte
31,2015,Droit,2,Introduction Historique au Droit,5,L'Amenagement du Liberalisme,13,32,2,QO,0.36,0.22,56.11,3,3,6,5,3,2,1.2,60.0,Facile,Moyen,-1,Plus Difficile,Pas Adapte
1142,2016,Droit,2,Introduction Historique au Droit,5,L'Amenagement du Liberalisme,13,32,2,QO,0.04,0.76,93.95,7,0,7,7,7,0,1.0,100.0,Facile,Facile,0,Meme Difficulté,Pas Adapte
2253,2017,Droit,2,Introduction Historique au Droit,5,L'Amenagement du Liberalisme,13,32,2,QO,0.82,0.14,11.68,1,5,6,5,1,4,1.2,20.0,Difficile,Difficile,0,Meme Difficulté,Pas Adapte
3364,2018,Droit,2,Introduction Historique au Droit,5,L'Amenagement du Liberalisme,13,32,2,QO,0.6,0.15,56.72,3,3,6,5,3,2,1.2,60.0,Difficile,Moyen,1,Plus Facile,Pas Adapte
4475,2019,Droit,2,Introduction Historique au Droit,5,L'Amenagement du Liberalisme,13,32,2,QO,0.13,0.6,77.95,5,1,6,5,5,0,1.2,100.0,Difficile,Facile,2,Beaucoup plus Facile,Pas Adapte
5586,2020,Droit,2,Introduction Historique au Droit,5,L'Amenagement du Liberalisme,13,32,2,QO,0.1,0.41,70.64,5,2,7,6,5,1,1.17,83.33,Difficile,Facile,2,Beaucoup plus Facile,Adapte
32,2015,Droit,2,Introduction Historique au Droit,5,L'Amenagement du Liberalisme,13,33,3,QCM,0.02,0.92,81.93,48,10,58,54,48,6,1.07,88.89,Moyen,Facile,1,Plus Facile,Pas Adapte
1143,2016,Droit,2,Introduction Historique au Droit,5,L'Amenagement du Liberalisme,13,33,3,QCM,0.36,0.39,49.05,30,32,62,45,30,15,1.38,66.67,Facile,Moyen,-1,Plus Difficile,Pas Adapte
2254,2017,Droit,2,Introduction Historique au Droit,5,L'Amenagement du Liberalisme,13,33,3,QCM,0.18,0.75,75.68,40,13,53,51,40,11,1.04,78.43,Moyen,Facile,1,Plus Facile,Pas Adapte
3365,2018,Droit,2,Introduction Historique au Droit,5,L'Amenagement du Liberalisme,13,33,3,QCM,0.42,0.66,38.22,18,28,46,30,18,12,1.53,60.0,Facile,Moyen,-1,Plus Difficile,Pas Adapte
4476,2019,Droit,2,Introduction Historique au Droit,5,L'Amenagement du Liberalisme,13,33,3,QCM,0.73,0.18,17.53,8,39,47,19,8,11,2.47,42.11,Difficile,Difficile,0,Meme Difficulté,Pas Adapte
5587,2020,Droit,2,Introduction Historique au Droit,5,L'Amenagement du Liberalisme,13,33,3,QCM,0.37,0.38,42.98,22,29,51,43,22,21,1.19,51.16,Facile,Moyen,-1,Plus Difficile,Pas Adapte
33,2015,Droit,2,Introduction Historique au Droit,5,L'Amenagement du Liberalisme,13,34,4,QCM,0.25,0.52,64.3,26,15,41,32,26,6,1.28,81.25,Moyen,Moyen,0,Meme Difficulté,Pas Adapte
1144,2016,Droit,2,Introduction Historique au Droit,5,L'Amenagement du Liberalisme,13,34,4,QCM,0.45,0.63,37.94,15,24,39,36,15,21,1.08,41.67,Difficile,Moyen,1,Plus Facile,Pas Adapte
2255,2017,Droit,2,Introduction Historique au Droit,5,L'Amenagement du Liberalisme,13,34,4,QCM,0.04,1.0,69.32,24,10,34,34,24,10,1.0,70.59,Moyen,Facile,1,Plus Facile,Adapte
3366,2018,Droit,2,Introduction Historique au Droit,5,L'Amenagement du Liberalisme,13,34,4,QCM,0.09,0.86,69.32,20,9,29,23,20,3,1.26,86.96,Facile,Facile,0,Meme Difficulté,Adapte
4477,2019,Droit,2,Introduction Historique au Droit,5,L'Amenagement du Liberalisme,13,34,4,QCM,0.04,0.95,69.32,20,9,29,25,20,5,1.16,80.0,Facile,Facile,0,Meme Difficulté,Adapte
5588,2020,Droit,2,Introduction Historique au Droit,5,L'Amenagement du Liberalisme,13,34,4,QCM,0.19,0.92,69.32,21,10,31,24,21,3,1.29,87.5,Facile,Facile,0,Meme Difficulté,Adapte
34,2015,Droit,2,Introduction Historique au Droit,5,L'Amenagement du Liberalisme,13,35,5,QCU,0.4,0.25,8.38,8,83,91,64,8,56,1.42,12.5,Facile,Difficile,-2,Beaucoup plus Difficile,Pas Adapte
1145,2016,Droit,2,Introduction Historique au Droit,5,L'Amenagement du Liberalisme,13,35,5,QCU,0.47,0.23,30.18,30,70,100,58,30,28,1.72,51.72,Facile,Difficile,-2,Beaucoup plus Difficile,Pas Adapte
2256,2017,Droit,2,Introduction Historique au Droit,5,L'Amenagement du Liberalisme,13,35,5,QCU,0.66,0.39,11.95,11,85,96,50,11,39,1.92,22.0,Moyen,Difficile,-1,Plus Difficile,Pas Adapte
3367,2018,Droit,2,Introduction Historique au Droit,5,L'Amenagement du Liberalisme,13,35,5,QCU,0.19,0.79,99.28,90,1,91,91,90,1,1.0,98.9,Moyen,Facile,1,Plus Facile,Pas Adapte
4478,2019,Droit,2,Introduction Historique au Droit,5,L'Amenagement du Liberalisme,13,35,5,QROC,0.74,0.2,33.1,26,54,80,70,26,44,1.14,37.14,Difficile,Difficile,0,Meme Difficulté,Pas Adapte
5589,2020,Droit,2,Introduction Historique au Droit,5,L'Amenagement du Liberalisme,13,35,5,QROC,0.3,0.38,45.71,41,49,90,53,41,12,1.7,77.36,Moyen,Moyen,0,Meme Difficulté,Pas Adapte
35,2015,Droit,2,Introduction Historique au Droit,5,L'Amenagement du Liberalisme,13,36,6,QCU,0.08,0.87,96.14,14,1,15,14,14,0,1.07,100.0,Facile,Facile,0,Meme Difficulté,Pas Adapte
1146,2016,Droit,2,Introduction Historique au Droit,5,L'Amenagement du Liberalisme,13,36,6,QCU,0.29,0.64,36.87,6,10,16,14,6,8,1.14,42.86,Difficile,Moyen,1,Plus Facile,Pas Adapte
2257,2017,Droit,2,Introduction Historique au Droit,5,L'Amenagement du Liberalisme,13,36,6,QCU,0.23,0.73,61.35,11,7,18,14,11,3,1.29,78.57,Difficile,Moyen,1,Plus Facile,Pas Adapte
3368,2018,Droit,2,Introduction Historique au Droit,5,L'Amenagement du Liberalisme,13,36,6,QCU,0.07,0.91,87.22,16,2,18,17,16,1,1.06,94.12,Difficile,Facile,2,Beaucoup plus Facile,Pas Adapte
4479,2019,Droit,2,Introduction Historique au Droit,5,L'Amenagement du Liberalisme,13,36,6,QCU,0.29,0.44,35.18,5,10,15,15,5,10,1.0,33.33,Moyen,Moyen,0,Meme Difficulté,Pas Adapte
5590,2020,Droit,2,Introduction Historique au Droit,5,L'Amenagement du Liberalisme,13,36,6,QCU,0.48,0.4,18.67,2,11,13,11,2,9,1.18,18.18,Facile,Difficile,-2,Beaucoup plus Difficile,Pas Adapte
36,2015,Droit,2,Introduction Historique au Droit,5,L'Amenagement du Liberalisme,13,37,7,QCM,0.24,0.65,49.82,41,42,83,75,41,34,1.11,54.67,Difficile,Moyen,1,Plus Facile,Pas Adapte
1147,2016,Droit,2,Introduction Historique au Droit,5,L'Amenagement du Liberalisme,13,37,7,QCM,0.27,0.49,51.7,37,35,72,50,37,13,1.44,74.0,Difficile,Moyen,1,Plus Facile,Pas Adapte
2258,2017,Droit,2,Introduction Historique au Droit,5,L'Amenagement du Liberalisme,13,37,7,QCM,0.0,0.9,94.25,67,4,71,70,67,3,1.01,95.71,Facile,Facile,0,Meme Difficulté,Pas Adapte
3369,2018,Droit,2,Introduction Historique au Droit,5,L'Amenagement du Liberalisme,13,37,7,QCM,0.14,0.73,77.19,52,16,68,67,52,15,1.01,77.61,Moyen,Facile,1,Plus Facile,Pas Adapte
4480,2019,Droit,2,Introduction Historique au Droit,5,L'Amenagement du Liberalisme,13,37,7,QROC,0.54,0.35,58.56,43,31,74,73,43,30,1.01,58.9,Difficile,Moyen,1,Plus Facile,Pas Adapte
5591,2020,Droit,2,Introduction Historique au Droit,5,L'Amenagement du Liberalisme,13,37,7,QO,0.4,0.29,37.28,25,43,68,43,25,18,1.58,58.14,Facile,Moyen,-1,Plus Difficile,Pas Adapte
37,2015,Droit,2,Introduction Historique au Droit,5,L'Amenagement du Liberalisme,13,38,8,QCU,0.08,0.98,83.57,32,6,38,33,32,1,1.15,96.97,Difficile,Facile,2,Beaucoup plus Facile,Pas Adapte
1148,2016,Droit,2,Introduction Historique au Droit,5,L'Amenagement du Liberalisme,13,38,8,QCU,0.71,0.38,27.29,10,27,37,21,10,11,1.76,47.62,Difficile,Difficile,0,Meme Difficulté,Pas Adapte
2259,2017,Droit,2,Introduction Historique au Droit,5,L'Amenagement du Liberalisme,13,38,8,QCU,0.03,0.77,86.82,30,4,34,31,30,1,1.1,96.77,Difficile,Facile,2,Beaucoup plus Facile,Pas Adapte
3370,2018,Droit,2,Introduction Historique au Droit,5,L'Amenagement du Liberalisme,13,38,8,QCU,0.32,0.75,38.15,13,22,35,26,13,13,1.35,50.0,Facile,Moyen,-1,Plus Difficile,Pas Adapte
4481,2019,Droit,2,Introduction Historique au Droit,5,L'Amenagement du Liberalisme,13,38,8,QCU,0.63,0.22,9.58,4,33,37,19,4,15,1.95,21.05,Facile,Difficile,-2,Beaucoup plus Difficile,Pas Adapte
5592,2020,Droit,2,Introduction Historique au Droit,5,L'Amenagement du Liberalisme,13,38,8,QCU,0.61,0.35,11.35,4,32,36,19,4,15,1.89,21.05,Moyen,Difficile,-1,Plus Difficile,Pas Adapte
38,2015,Droit,2,Introduction Historique au Droit,5,L'Amenagement du Liberalisme,13,39,9,QROC,0.93,0.21,21.97,5,19,24,13,5,8,1.85,38.46,Difficile,Difficile,0,Meme Difficulté,Pas Adapte
1149,2016,Droit,2,Introduction Historique au Droit,5,L'Amenagement du Liberalisme,13,39,9,QROC,0.77,0.05,31.63,6,14,20,12,6,6,1.67,50.0,Moyen,Difficile,-1,Plus Difficile,Pas Adapte
2260,2017,Droit,2,Introduction Historique au Droit,5,L'Amenagement du Liberalisme,13,39,9,QROC,0.68,0.24,6.9,1,19,20,14,1,13,1.43,7.14,Facile,Difficile,-2,Beaucoup plus Difficile,Pas Adapte
3371,2018,Droit,2,Introduction Historique au Droit,5,L'Amenagement du Liberalisme,13,39,9,QROC,0.39,0.33,48.27,9,10,19,13,9,4,1.46,69.23,Facile,Moyen,-1,Plus Difficile,Pas Adapte
4482,2019,Droit,2,Introduction Historique au Droit,5,L'Amenagement du Liberalisme,13,39,9,QROC,0.5,0.36,39.48,7,10,17,7,7,0,2.43,100.0,Difficile,Moyen,1,Plus Facile,Pas Adapte
5593,2020,Droit,2,Introduction Historique au Droit,5,L'Amenagement du Liberalisme,13,39,9,QROC,0.16,0.8,88.48,16,2,18,18,16,2,1.0,88.89,Difficile,Facile,2,Beaucoup plus Facile,Pas Adapte
39,2015,Droit,2,Introduction Historique au Droit,5,L'Amenagement du Liberalisme,13,40,10,QCM,0.69,0.27,13.62,10,67,77,34,10,24,2.26,29.41,Difficile,Difficile,0,Meme Difficulté,Pas Adapte
1150,2016,Droit,2,Introduction Historique au Droit,5,L'Amenagement du Liberalisme,13,40,10,QCM,0.44,0.65,35.01,27,50,77,49,27,22,1.57,55.1,Facile,Moyen,-1,Plus Difficile,Pas Adapte
2261,2017,Droit,2,Introduction Historique au Droit,5,L'Amenagement du Liberalisme,13,40,10,QO,0.37,0.27,49.78,44,45,89,67,44,23,1.33,65.67,Facile,Moyen,-1,Plus Difficile,Pas Adapte
3372,2018,Droit,2,Introduction Historique au Droit,5,L'Amenagement du Liberalisme,13,40,10,QO,0.87,0.08,18.83,19,83,102,53,19,34,1.92,35.85,Difficile,Difficile,0,Meme Difficulté,Pas Adapte
4483,2019,Droit,2,Introduction Historique au Droit,5,L'Amenagement du Liberalisme,13,40,10,QO,0.69,0.16,44.25,41,51,92,48,41,7,1.92,85.42,Moyen,Moyen,0,Meme Difficulté,Pas Adapte
5594,2020,Droit,2,Introduction Historique au Droit,5,L'Amenagement du Liberalisme,13,40,10,QO,0.88,0.06,27.95,22,57,79,60,22,38,1.32,36.67,Moyen,Difficile,-1,Plus Difficile,Pas Adapte
40,2015,Droit,2,Introduction Historique au Droit,5,L'Amenagement du Liberalisme,13,41,11,QROC,0.2,0.27,40.39,25,38,63,34,25,9,1.85,73.53,Facile,Moyen,-1,Plus Difficile,Pas Adapte
1151,2016,Droit,2,Introduction Historique au Droit,5,L'Amenagement du Liberalisme,13,41,11,QROC,0.02,0.8,68.95,45,20,65,48,45,3,1.35,93.75,Facile,Facile,0,Meme Difficulté,Adapte
2262,2017,Droit,2,Introduction Historique au Droit,5,L'Amenagement du Liberalisme,13,41,11,QROC,0.06,0.45,68.95,48,21,69,61,48,13,1.13,78.69,Facile,Facile,0,Meme Difficulté,Adapte
3373,2018,Droit,2,Introduction Historique au Droit,5,L'Amenagement du Liberalisme,13,41,11,QROC,0.12,0.46,68.95,50,22,72,63,50,13,1.14,79.37,Facile,Facile,0,Meme Difficulté,Adapte
4484,2019,Droit,2,Introduction Historique au Droit,5,L'Amenagement du Liberalisme,13,41,11,QROC,0.19,0.71,68.95,55,25,80,70,55,15,1.14,78.57,Facile,Facile,0,Meme Difficulté,Adapte
5595,2020,Droit,2,Introduction Historique au Droit,5,L'Amenagement du Liberalisme,13,41,11,QROC,0.03,0.56,68.95,47,21,68,57,47,10,1.19,82.46,Facile,Facile,0,Meme Difficulté,Adapte
41,2015,Droit,2,Introduction Historique au Droit,5,L'Amenagement du Liberalisme,13,42,12,QROC,0.55,0.31,55.15,26,21,47,27,26,1,1.74,96.3,Facile,Moyen,-1,Plus Difficile,Pas Adapte
1152,2016,Droit,2,Introduction Historique au Droit,5,L'Amenagement du Liberalisme,13,42,12,QO,0.6,0.29,57.61,29,21,50,37,29,8,1.35,78.38,Facile,Moyen,-1,Plus Difficile,Pas Adapte
2263,2017,Droit,2,Introduction Historique au Droit,5,L'Amenagement du Liberalisme,13,42,12,QROC,0.88,0.01,24.36,14,43,57,49,14,35,1.16,28.57,Facile,Difficile,-2,Beaucoup plus Difficile,Pas Adapte
3374,2018,Droit,2,Introduction Historique au Droit,5,L'Amenagement du Liberalisme,13,42,12,QO,0.08,0.46,77.28,44,13,57,50,44,6,1.14,88.0,Moyen,Facile,1,Plus Facile,Pas Adapte
4485,2019,Droit,2,Introduction Historique au Droit,5,L'Amenagement du Liberalisme,13,42,12,QO,0.59,0.28,42.06,24,32,56,42,24,18,1.33,57.14,Difficile,Moyen,1,Plus Facile,Pas Adapte
5596,2020,Droit,2,Introduction Historique au Droit,5,L'Amenagement du Liberalisme,13,42,12,QO,0.99,0.05,25.78,14,40,54,44,14,30,1.23,31.82,Difficile,Difficile,0,Meme Difficulté,Pas Adapte
42,2015,Droit,2,Introduction Historique au Droit,5,L'Amenagement du Liberalisme,13,43,13,QROC,0.52,0.34,58.78,16,11,27,23,16,7,1.17,69.57,Facile,Moyen,-1,Plus Difficile,Pas Adapte
1153,2016,Droit,2,Introduction Historique au Droit,5,L'Amenagement du Liberalisme,13,43,13,QROC,0.94,0.03,17.83,4,19,23,11,4,7,2.09,36.36,Difficile,Difficile,0,Meme Difficulté,Pas Adapte
2264,2017,Droit,2,Introduction Historique au Droit,5,L'Amenagement du Liberalisme,13,43,13,QROC,0.7,0.05,21.76,5,17,22,17,5,12,1.29,29.41,Difficile,Difficile,0,Meme Difficulté,Pas Adapte
3375,2018,Droit,2,Introduction Historique au Droit,5,L'Amenagement du Liberalisme,13,43,13,QROC,0.07,0.55,94.06,21,1,22,22,21,1,1.0,95.45,Moyen,Facile,1,Plus Facile,Pas Adapte
4486,2019,Droit,2,Introduction Historique au Droit,5,L'Amenagement du Liberalisme,13,43,13,QROC,0.78,0.07,8.56,2,19,21,14,2,12,1.5,14.29,Difficile,Difficile,0,Meme Difficulté,Pas Adapte
5597,2020,Droit,2,Introduction Historique au Droit,5,L'Amenagement du Liberalisme,13,43,13,QROC,0.12,0.68,87.21,17,3,20,18,17,1,1.11,94.44,Moyen,Facile,1,Plus Facile,Pas Adapte
43,2015,Droit,3,Relations Internationales,1,Introduction,12,44,1,QCM,0.73,0.26,16.98,11,54,65,54,11,43,1.2,20.37,Difficile,Difficile,0,Meme Difficulté,Pas Adapte
1154,2016,Droit,3,Relations Internationales,1,Introduction,12,44,1,QCM,0.66,0.15,18.41,11,47,58,56,11,45,1.04,19.64,Moyen,Difficile,-1,Plus Difficile,Pas Adapte
2265,2017,Droit,3,Relations Internationales,1,Introduction,12,44,1,QCM,0.19,0.83,73.36,49,18,67,64,49,15,1.05,76.56,Facile,Facile,0,Meme Difficulté,Adapte
3376,2018,Droit,3,Relations Internationales,1,Introduction,12,44,1,QCM,0.11,1.0,73.36,45,17,62,47,45,2,1.32,95.74,Facile,Facile,0,Meme Difficulté,Adapte
4487,2019,Droit,3,Relations Internationales,1,Introduction,12,44,1,QCM,0.13,0.92,73.36,50,18,68,62,50,12,1.1,80.65,Facile,Facile,0,Meme Difficulté,Adapte
5598,2020,Droit,3,Relations Internationales,1,Introduction,12,44,1,QCM,0.13,0.98,73.36,43,16,59,58,43,15,1.02,74.14,Facile,Facile,0,Meme Difficulté,Adapte
44,2015,Droit,3,Relations Internationales,1,Introduction,12,45,2,QCU,0.1,0.93,77.57,45,13,58,54,45,9,1.07,83.33,Moyen,Facile,1,Plus Facile,Pas Adapte
1155,2016,Droit,3,Relations Internationales,1,Introduction,12,45,2,QCU,0.08,0.75,79.68,44,11,55,48,44,4,1.15,91.67,Facile,Facile,0,Meme Difficulté,Pas Adapte
2266,2017,Droit,3,Relations Internationales,1,Introduction,12,45,2,QCU,0.2,0.74,40.7,20,30,50,30,20,10,1.67,66.67,Moyen,Moyen,0,Meme Difficulté,Pas Adapte
3377,2018,Droit,3,Relations Internationales,1,Introduction,12,45,2,QCU,0.16,0.96,65.28,31,16,47,43,31,12,1.09,72.09,Difficile,Facile,2,Beaucoup plus Facile,Adapte
4488,2019,Droit,3,Relations Internationales,1,Introduction,12,45,2,QCU,0.02,0.91,65.28,33,17,50,46,33,13,1.09,71.74,Facile,Facile,0,Meme Difficulté,Adapte
5599,2020,Droit,3,Relations Internationales,1,Introduction,12,45,2,QCU,0.01,0.77,65.28,36,19,55,38,36,2,1.45,94.74,Facile,Facile,0,Meme Difficulté,Adapte
45,2015,Droit,3,Relations Internationales,1,Introduction,12,46,3,QROC,0.04,0.55,71.06,7,3,10,8,7,1,1.25,87.5,Facile,Facile,0,Meme Difficulté,Adapte
1156,2016,Droit,3,Relations Internationales,1,Introduction,12,46,3,QROC,0.04,0.76,71.06,8,3,11,9,8,1,1.22,88.89,Facile,Facile,0,Meme Difficulté,Adapte
2267,2017,Droit,3,Relations Internationales,1,Introduction,12,46,3,QROC,0.12,0.93,71.06,6,3,9,8,6,2,1.12,75.0,Facile,Facile,0,Meme Difficulté,Adapte
3378,2018,Droit,3,Relations Internationales,1,Introduction,12,46,3,QROC,0.01,0.57,71.06,6,3,9,7,6,1,1.29,85.71,Facile,Facile,0,Meme Difficulté,Adapte
4489,2019,Droit,3,Relations Internationales,1,Introduction,12,46,3,QROC,0.1,0.76,71.06,6,2,8,6,6,0,1.33,100.0,Facile,Facile,0,Meme Difficulté,Adapte
5600,2020,Droit,3,Relations Internationales,1,Introduction,12,46,3,QO,0.08,0.7,71.06,5,2,7,7,5,2,1.0,71.43,Facile,Facile,0,Meme Difficulté,Adapte
46,2015,Droit,3,Relations Internationales,1,Introduction,12,47,4,QCU,0.01,0.88,85.62,56,9,65,59,56,3,1.1,94.92,Facile,Facile,0,Meme Difficulté,Pas Adapte
1157,2016,Droit,3,Relations Internationales,1,Introduction,12,47,4,QCU,0.03,0.88,79.59,45,12,57,48,45,3,1.19,93.75,Facile,Facile,0,Meme Difficulté,Pas Adapte
2268,2017,Droit,3,Relations Internationales,1,Introduction,12,47,4,QCU,0.61,0.26,30.4,19,43,62,28,19,9,2.21,67.86,Moyen,Difficile,-1,Plus Difficile,Pas Adapte
3379,2018,Droit,3,Relations Internationales,1,Introduction,12,47,4,QCU,0.15,0.93,82.85,49,10,59,53,49,4,1.11,92.45,Facile,Facile,0,Meme Difficulté,Pas Adapte
4490,2019,Droit,3,Relations Internationales,1,Introduction,12,47,4,QCU,0.14,0.81,67.11,36,18,54,37,36,1,1.46,97.3,Facile,Facile,0,Meme Difficulté,Adapte
5601,2020,Droit,3,Relations Internationales,1,Introduction,12,47,4,QCU,0.08,0.87,67.11,36,17,53,48,36,12,1.1,75.0,Facile,Facile,0,Meme Difficulté,Adapte
47,2015,Droit,3,Relations Internationales,1,Introduction,12,48,5,QROC,0.46,0.31,55.11,51,42,93,73,51,22,1.27,69.86,Moyen,Moyen,0,Meme Difficulté,Pas Adapte
1158,2016,Droit,3,Relations Internationales,1,Introduction,12,48,5,QROC,0.54,0.31,63.45,68,39,107,87,68,19,1.23,78.16,Difficile,Moyen,1,Plus Facile,Pas Adapte
2269,2017,Droit,3,Relations Internationales,1,Introduction,12,48,5,QO,0.13,0.53,74.04,91,32,123,92,91,1,1.34,98.91,Facile,Facile,0,Meme Difficulté,Adapte
3380,2018,Droit,3,Relations Internationales,1,Introduction,12,48,5,QO,0.0,0.78,74.04,86,30,116,93,86,7,1.25,92.47,Facile,Facile,0,Meme Difficulté,Adapte
4491,2019,Droit,3,Relations Internationales,1,Introduction,12,48,5,QO,0.09,0.66,74.04,76,27,103,89,76,13,1.16,85.39,Facile,Facile,0,Meme Difficulté,Adapte
5602,2020,Droit,3,Relations Internationales,1,Introduction,12,48,5,QO,0.17,0.5,74.04,74,26,100,96,74,22,1.04,77.08,Facile,Facile,0,Meme Difficulté,Adapte
48,2015,Droit,3,Relations Internationales,1,Introduction,12,49,6,QO,0.77,0.11,31.92,7,14,21,19,7,12,1.11,36.84,Moyen,Difficile,-1,Plus Difficile,Pas Adapte
1159,2016,Droit,3,Relations Internationales,1,Introduction,12,49,6,QO,0.94,0.07,5.07,1,17,18,14,1,13,1.29,7.14,Moyen,Difficile,-1,Plus Difficile,Pas Adapte
2270,2017,Droit,3,Relations Internationales,1,Introduction,12,49,6,QO,0.23,0.23,38.55,7,12,19,11,7,4,1.73,63.64,Facile,Moyen,-1,Plus Difficile,Pas Adapte
3381,2018,Droit,3,Relations Internationales,1,Introduction,12,49,6,QO,0.35,0.25,40.31,9,13,22,21,9,12,1.05,42.86,Moyen,Moyen,0,Meme Difficulté,Pas Adapte
4492,2019,Droit,3,Relations Internationales,1,Introduction,12,49,6,QO,0.66,0.16,45.31,10,11,21,12,10,2,1.75,83.33,Facile,Moyen,-1,Plus Difficile,Pas Adapte
5603,2020,Droit,3,Relations Internationales,1,Introduction,12,49,6,QO,0.94,0.02,15.74,3,18,21,15,3,12,1.4,20.0,Difficile,Difficile,0,Meme Difficulté,Pas Adapte
49,2015,Droit,3,Relations Internationales,1,Introduction,12,50,7,QCM,0.16,0.81,73.73,62,22,84,66,62,4,1.27,93.94,Facile,Facile,0,Meme Difficulté,Adapte
1160,2016,Droit,3,Relations Internationales,1,Introduction,12,50,7,QCM,0.08,0.9,73.73,64,23,87,85,64,21,1.02,75.29,Facile,Facile,0,Meme Difficulté,Adapte
2271,2017,Droit,3,Relations Internationales,1,Introduction,12,50,7,QCM,0.04,0.78,73.73,69,24,93,82,69,13,1.13,84.15,Facile,Facile,0,Meme Difficulté,Adapte
3382,2018,Droit,3,Relations Internationales,1,Introduction,12,50,7,QCM,0.2,0.88,73.73,71,25,96,78,71,7,1.23,91.03,Facile,Facile,0,Meme Difficulté,Adapte
4493,2019,Droit,3,Relations Internationales,1,Introduction,12,50,7,QCM,0.04,0.78,73.73,66,24,90,79,66,13,1.14,83.54,Facile,Facile,0,Meme Difficulté,Adapte
5604,2020,Droit,3,Relations Internationales,1,Introduction,12,50,7,QCM,0.03,0.99,73.73,69,24,93,88,69,19,1.06,78.41,Facile,Facile,0,Meme Difficulté,Adapte
50,2015,Droit,3,Relations Internationales,1,Introduction,12,51,8,QROC,0.15,0.61,91.07,8,1,9,9,8,1,1.0,88.89,Moyen,Facile,1,Plus Facile,Pas Adapte
1161,2016,Droit,3,Relations Internationales,1,Introduction,12,51,8,QO,0.12,0.71,72.78,6,2,8,7,6,1,1.14,85.71,Moyen,Facile,1,Plus Facile,Adapte
2272,2017,Droit,3,Relations Internationales,1,Introduction,12,51,8,QO,0.17,0.57,72.78,6,2,8,7,6,1,1.14,85.71,Facile,Facile,0,Meme Difficulté,Adapte
3383,2018,Droit,3,Relations Internationales,1,Introduction,12,51,8,QO,0.16,0.66,72.78,7,2,9,8,7,1,1.12,87.5,Facile,Facile,0,Meme Difficulté,Adapte
4494,2019,Droit,3,Relations Internationales,1,Introduction,12,51,8,QO,0.19,0.76,72.78,6,2,8,7,6,1,1.14,85.71,Facile,Facile,0,Meme Difficulté,Adapte
5605,2020,Droit,3,Relations Internationales,1,Introduction,12,51,8,QROC,0.17,0.49,72.78,5,2,7,6,5,1,1.17,83.33,Facile,Facile,0,Meme Difficulté,Adapte
51,2015,Droit,3,Relations Internationales,1,Introduction,12,52,9,QCU,0.28,0.47,46.44,42,49,91,46,42,4,1.98,91.3,Moyen,Moyen,0,Meme Difficulté,Pas Adapte
1162,2016,Droit,3,Relations Internationales,1,Introduction,12,52,9,QCM,0.8,0.19,7.8,7,86,93,89,7,82,1.04,7.87,Difficile,Difficile,0,Meme Difficulté,Pas Adapte
2273,2017,Droit,3,Relations Internationales,1,Introduction,12,52,9,QCM,0.01,0.83,77.24,68,20,88,78,68,10,1.13,87.18,Moyen,Facile,1,Plus Facile,Pas Adapte
3384,2018,Droit,3,Relations Internationales,1,Introduction,12,52,9,QCM,0.13,0.92,98.63,88,1,89,88,88,0,1.01,100.0,Facile,Facile,0,Meme Difficulté,Pas Adapte
4495,2019,Droit,3,Relations Internationales,1,Introduction,12,52,9,QCM,0.4,0.37,51.06,41,40,81,42,41,1,1.93,97.62,Facile,Moyen,-1,Plus Difficile,Pas Adapte
5606,2020,Droit,3,Relations Internationales,1,Introduction,12,52,9,QCM,0.59,0.27,10.87,8,64,72,66,8,58,1.09,12.12,Facile,Difficile,-2,Beaucoup plus Difficile,Pas Adapte
52,2015,Droit,3,Relations Internationales,1,Introduction,12,53,10,QO,0.06,0.95,86.57,22,3,25,23,22,1,1.09,95.65,Difficile,Facile,2,Beaucoup plus Facile,Pas Adapte
1163,2016,Droit,3,Relations Internationales,1,Introduction,12,53,10,QO,0.06,0.56,90.99,25,2,27,26,25,1,1.04,96.15,Moyen,Facile,1,Plus Facile,Pas Adapte
2274,2017,Droit,3,Relations Internationales,1,Introduction,12,53,10,QROC,0.35,0.39,60.47,18,11,29,29,18,11,1.0,62.07,Difficile,Moyen,1,Plus Facile,Pas Adapte
3385,2018,Droit,3,Relations Internationales,1,Introduction,12,53,10,QROC,0.11,0.66,79.43,20,5,25,24,20,4,1.04,83.33,Difficile,Facile,2,Beaucoup plus Facile,Pas Adapte
4496,2019,Droit,3,Relations Internationales,1,Introduction,12,53,10,QO,0.04,0.32,89.0,20,2,22,21,20,1,1.05,95.24,Facile,Facile,0,Meme Difficulté,Pas Adapte
5607,2020,Droit,3,Relations Internationales,1,Introduction,12,53,10,QO,0.8,0.14,11.93,2,18,20,15,2,13,1.33,13.33,Facile,Difficile,-2,Beaucoup plus Difficile,Pas Adapte
53,2015,Droit,3,Relations Internationales,1,Introduction,12,54,11,QROC,0.23,0.31,41.32,31,43,74,44,31,13,1.68,70.45,Difficile,Moyen,1,Plus Facile,Pas Adapte
1164,2016,Droit,3,Relations Internationales,1,Introduction,12,54,11,QROC,0.01,0.91,92.87,67,5,72,68,67,1,1.06,98.53,Difficile,Facile,2,Beaucoup plus Facile,Pas Adapte
2275,2017,Droit,3,Relations Internationales,1,Introduction,12,54,11,QROC,0.2,0.54,87.62,58,8,66,61,58,3,1.08,95.08,Facile,Facile,0,Meme Difficulté,Pas Adapte
3386,2018,Droit,3,Relations Internationales,1,Introduction,12,54,11,QROC,0.8,0.25,16.86,10,47,57,55,10,45,1.04,18.18,Facile,Difficile,-2,Beaucoup plus Difficile,Pas Adapte
4497,2019,Droit,3,Relations Internationales,1,Introduction,12,54,11,QROC,0.18,0.64,78.05,49,14,63,53,49,4,1.19,92.45,Difficile,Facile,2,Beaucoup plus Facile,Pas Adapte
5608,2020,Droit,3,Relations Internationales,1,Introduction,12,54,11,QROC,0.04,0.51,82.41,51,11,62,52,51,1,1.19,98.08,Facile,Facile,0,Meme Difficulté,Pas Adapte
54,2015,Droit,3,Relations Internationales,1,Introduction,12,55,12,QCM,0.46,0.3,50.41,17,16,33,22,17,5,1.5,77.27,Facile,Moyen,-1,Plus Difficile,Pas Adapte
1165,2016,Droit,3,Relations Internationales,1,Introduction,12,55,12,QCM,0.57,0.19,18.75,6,28,34,13,6,7,2.62,46.15,Difficile,Difficile,0,Meme Difficulté,Pas Adapte
2276,2017,Droit,3,Relations Internationales,1,Introduction,12,55,12,QCM,0.16,0.7,84.31,25,5,30,28,25,3,1.07,89.29,Facile,Facile,0,Meme Difficulté,Pas Adapte
3387,2018,Droit,3,Relations Internationales,1,Introduction,12,55,12,QROC,0.13,0.83,75.2,22,7,29,28,22,6,1.04,78.57,Facile,Facile,0,Meme Difficulté,Pas Adapte
4498,2019,Droit,3,Relations Internationales,1,Introduction,12,55,12,QROC,0.03,0.75,98.05,25,1,26,25,25,0,1.04,100.0,Difficile,Facile,2,Beaucoup plus Facile,Pas Adapte
5609,2020,Droit,3,Relations Internationales,1,Introduction,12,55,12,QROC,0.64,0.2,18.79,5,21,26,25,5,20,1.04,20.0,Moyen,Difficile,-1,Plus Difficile,Pas Adapte
55,2015,Droit,3,Relations Internationales,2,Les Acteurs des Relations Internationales,9,56,1,QCU,0.58,0.36,12.39,4,27,31,25,4,21,1.24,16.0,Difficile,Difficile,0,Meme Difficulté,Pas Adapte
1166,2016,Droit,3,Relations Internationales,2,Les Acteurs des Relations Internationales,9,56,1,QCU,0.73,0.34,16.94,5,24,29,23,5,18,1.26,21.74,Facile,Difficile,-2,Beaucoup plus Difficile,Pas Adapte
2277,2017,Droit,3,Relations Internationales,2,Les Acteurs des Relations Internationales,9,56,1,QCU,0.37,0.69,41.11,10,15,25,21,10,11,1.19,47.62,Difficile,Moyen,1,Plus Facile,Pas Adapte
3388,2018,Droit,3,Relations Internationales,2,Les Acteurs des Relations Internationales,9,56,1,QCU,0.32,0.41,42.02,9,12,21,19,9,10,1.11,47.37,Facile,Moyen,-1,Plus Difficile,Pas Adapte
4499,2019,Droit,3,Relations Internationales,2,Les Acteurs des Relations Internationales,9,56,1,QCU,0.12,0.89,66.13,14,7,21,15,14,1,1.4,93.33,Facile,Facile,0,Meme Difficulté,Adapte
5610,2020,Droit,3,Relations Internationales,2,Les Acteurs des Relations Internationales,9,56,1,QCU,0.08,0.8,66.13,12,6,18,17,12,5,1.06,70.59,Facile,Facile,0,Meme Difficulté,Adapte
56,2015,Droit,3,Relations Internationales,2,Les Acteurs des Relations Internationales,9,57,2,QCM,0.59,0.28,26.49,18,49,67,34,18,16,1.97,52.94,Facile,Difficile,-2,Beaucoup plus Difficile,Pas Adapte
1167,2016,Droit,3,Relations Internationales,2,Les Acteurs des Relations Internationales,9,57,2,QCM,0.4,0.3,61.1,41,26,67,57,41,16,1.18,71.93,Difficile,Moyen,1,Plus Facile,Pas Adapte
2278,2017,Droit,3,Relations Internationales,2,Les Acteurs des Relations Internationales,9,57,2,QCM,0.26,0.61,35.31,25,45,70,39,25,14,1.79,64.1,Difficile,Moyen,1,Plus Facile,Pas Adapte
3389,2018,Droit,3,Relations Internationales,2,Les Acteurs des Relations Internationales,9,57,2,QCM,0.52,0.16,13.27,9,60,69,60,9,51,1.15,15.0,Difficile,Difficile,0,Meme Difficulté,Pas Adapte
4500,2019,Droit,3,Relations Internationales,2,Les Acteurs des Relations Internationales,9,57,2,QCM,0.17,0.96,72.6,48,18,66,50,48,2,1.32,96.0,Moyen,Facile,1,Plus Facile,Adapte
5611,2020,Droit,3,Relations Internationales,2,Les Acteurs des Relations Internationales,9,57,2,QCM,0.06,0.99,72.6,44,17,61,49,44,5,1.24,89.8,Facile,Facile,0,Meme Difficulté,Adapte
57,2015,Droit,3,Relations Internationales,2,Les Acteurs des Relations Internationales,9,58,3,QCM,0.78,0.22,21.46,17,63,80,70,17,53,1.14,24.29,Difficile,Difficile,0,Meme Difficulté,Pas Adapte
1168,2016,Droit,3,Relations Internationales,2,Les Acteurs des Relations Internationales,9,58,3,QCM,0.65,0.24,10.57,7,61,68,42,7,35,1.62,16.67,Facile,Difficile,-2,Beaucoup plus Difficile,Pas Adapte
2279,2017,Droit,3,Relations Internationales,2,Les Acteurs des Relations Internationales,9,58,3,QCM,0.63,0.21,10.0,8,70,78,39,8,31,2.0,20.51,Facile,Difficile,-2,Beaucoup plus Difficile,Pas Adapte
3390,2018,Droit,3,Relations Internationales,2,Les Acteurs des Relations Internationales,9,58,3,QCM,0.45,0.39,63.88,57,32,89,67,57,10,1.33,85.07,Difficile,Moyen,1,Plus Facile,Pas Adapte
4501,2019,Droit,3,Relations Internationales,2,Les Acteurs des Relations Internationales,9,58,3,QCM,0.1,0.73,87.07,77,11,88,86,77,9,1.02,89.53,Moyen,Facile,1,Plus Facile,Pas Adapte
5612,2020,Droit,3,Relations Internationales,2,Les Acteurs des Relations Internationales,9,58,3,QCM,0.21,0.49,40.01,34,52,86,78,34,44,1.1,43.59,Moyen,Moyen,0,Meme Difficulté,Pas Adapte
58,2015,Droit,3,Relations Internationales,2,Les Acteurs des Relations Internationales,9,59,4,QCU,0.64,0.29,31.95,19,41,60,31,19,12,1.94,61.29,Moyen,Difficile,-1,Plus Difficile,Pas Adapte
1169,2016,Droit,3,Relations Internationales,2,Les Acteurs des Relations Internationales,9,59,4,QCU,0.62,0.3,32.33,21,43,64,50,21,29,1.28,42.0,Moyen,Difficile,-1,Plus Difficile,Pas Adapte
2280,2017,Droit,3,Relations Internationales,2,Les Acteurs des Relations Internationales,9,59,4,QROC,0.37,0.33,38.05,25,42,67,27,25,2,2.48,92.59,Moyen,Moyen,0,Meme Difficulté,Pas Adapte
3391,2018,Droit,3,Relations Internationales,2,Les Acteurs des Relations Internationales,9,59,4,QROC,0.62,0.08,33.33,21,42,63,33,21,12,1.91,63.64,Facile,Difficile,-2,Beaucoup plus Difficile,Pas Adapte
4502,2019,Droit,3,Relations Internationales,2,Les Acteurs des Relations Internationales,9,59,4,QO,0.9,0.13,2.84,2,64,66,51,2,49,1.29,3.92,Difficile,Difficile,0,Meme Difficulté,Pas Adapte
5613,2020,Droit,3,Relations Internationales,2,Les Acteurs des Relations Internationales,9,59,4,QO,0.03,0.57,82.43,60,13,73,66,60,6,1.11,90.91,Facile,Facile,0,Meme Difficulté,Pas Adapte
59,2015,Droit,3,Relations Internationales,2,Les Acteurs des Relations Internationales,9,60,5,QROC,0.56,0.39,46.3,10,11,21,18,10,8,1.17,55.56,Difficile,Moyen,1,Plus Facile,Pas Adapte
1170,2016,Droit,3,Relations Internationales,2,Les Acteurs des Relations Internationales,9,60,5,QROC,0.57,0.33,60.16,14,9,23,19,14,5,1.21,73.68,Difficile,Moyen,1,Plus Facile,Pas Adapte
2281,2017,Droit,3,Relations Internationales,2,Les Acteurs des Relations Internationales,9,60,5,QO,0.15,0.33,75.07,19,6,25,20,19,1,1.25,95.0,Difficile,Facile,2,Beaucoup plus Facile,Pas Adapte
3392,2018,Droit,3,Relations Internationales,2,Les Acteurs des Relations Internationales,9,60,5,QROC,0.16,0.95,90.97,24,2,26,25,24,1,1.04,96.0,Facile,Facile,0,Meme Difficulté,Pas Adapte
4503,2019,Droit,3,Relations Internationales,2,Les Acteurs des Relations Internationales,9,60,5,QROC,0.97,0.05,10.37,2,20,22,10,2,8,2.2,20.0,Facile,Difficile,-2,Beaucoup plus Difficile,Pas Adapte
5614,2020,Droit,3,Relations Internationales,2,Les Acteurs des Relations Internationales,9,60,5,QROC,0.09,0.96,97.27,22,1,23,23,22,1,1.0,95.65,Facile,Facile,0,Meme Difficulté,Pas Adapte
60,2015,Droit,3,Relations Internationales,2,Les Acteurs des Relations Internationales,9,61,6,QCU,0.1,0.94,79.16,75,20,95,84,75,9,1.13,89.29,Difficile,Facile,2,Beaucoup plus Facile,Pas Adapte
1171,2016,Droit,3,Relations Internationales,2,Les Acteurs des Relations Internationales,9,61,6,QCU,0.03,0.98,66.62,54,27,81,61,54,7,1.33,88.52,Moyen,Facile,1,Plus Facile,Adapte
2282,2017,Droit,3,Relations Internationales,2,Les Acteurs des Relations Internationales,9,61,6,QCU,0.08,0.9,66.62,52,26,78,57,52,5,1.37,91.23,Facile,Facile,0,Meme Difficulté,Adapte
3393,2018,Droit,3,Relations Internationales,2,Les Acteurs des Relations Internationales,9,61,6,QCU,0.15,0.94,66.62,51,25,76,60,51,9,1.27,85.0,Facile,Facile,0,Meme Difficulté,Adapte
4504,2019,Droit,3,Relations Internationales,2,Les Acteurs des Relations Internationales,9,61,6,QO,0.02,0.65,66.62,57,29,86,76,57,19,1.13,75.0,Facile,Facile,0,Meme Difficulté,Adapte
5615,2020,Droit,3,Relations Internationales,2,Les Acteurs des Relations Internationales,9,61,6,QO,0.19,0.5,66.62,51,26,77,73,51,22,1.05,69.86,Facile,Facile,0,Meme Difficulté,Adapte
61,2015,Droit,3,Relations Internationales,2,Les Acteurs des Relations Internationales,9,62,7,QROC,0.94,0.06,15.4,13,74,87,70,13,57,1.24,18.57,Difficile,Difficile,0,Meme Difficulté,Pas Adapte
1172,2016,Droit,3,Relations Internationales,2,Les Acteurs des Relations Internationales,9,62,7,QROC,0.65,0.21,10.56,9,75,84,72,9,63,1.17,12.5,Moyen,Difficile,-1,Plus Difficile,Pas Adapte
2283,2017,Droit,3,Relations Internationales,2,Les Acteurs des Relations Internationales,9,62,7,QROC,0.31,0.32,50.22,46,46,92,65,46,19,1.42,70.77,Difficile,Moyen,1,Plus Facile,Pas Adapte
3394,2018,Droit,3,Relations Internationales,2,Les Acteurs des Relations Internationales,9,62,7,QROC,0.96,0.17,2.15,2,92,94,60,2,58,1.57,3.33,Facile,Difficile,-2,Beaucoup plus Difficile,Pas Adapte
4505,2019,Droit,3,Relations Internationales,2,Les Acteurs des Relations Internationales,9,62,7,QROC,0.19,0.97,74.03,61,22,83,63,61,2,1.32,96.83,Facile,Facile,0,Meme Difficulté,Adapte
5616,2020,Droit,3,Relations Internationales,2,Les Acteurs des Relations Internationales,9,62,7,QROC,0.02,0.6,74.03,60,21,81,80,60,20,1.01,75.0,Facile,Facile,0,Meme Difficulté,Adapte
62,2015,Droit,3,Relations Internationales,2,Les Acteurs des Relations Internationales,9,63,8,QCU,0.14,0.86,76.46,18,6,24,21,18,3,1.14,85.71,Facile,Facile,0,Meme Difficulté,Pas Adapte
1173,2016,Droit,3,Relations Internationales,2,Les Acteurs des Relations Internationales,9,63,8,QCU,0.26,0.58,44.82,12,14,26,22,12,10,1.18,54.55,Facile,Moyen,-1,Plus Difficile,Pas Adapte
2284,2017,Droit,3,Relations Internationales,2,Les Acteurs des Relations Internationales,9,63,8,QCU,0.27,0.51,52.49,14,12,26,15,14,1,1.73,93.33,Facile,Moyen,-1,Plus Difficile,Pas Adapte
3395,2018,Droit,3,Relations Internationales,2,Les Acteurs des Relations Internationales,9,63,8,QCU,0.56,0.29,23.9,5,17,22,19,5,14,1.16,26.32,Moyen,Difficile,-1,Plus Difficile,Pas Adapte
4506,2019,Droit,3,Relations Internationales,2,Les Acteurs des Relations Internationales,9,63,8,QCU,0.59,0.32,16.61,4,19,23,19,4,15,1.21,21.05,Moyen,Difficile,-1,Plus Difficile,Pas Adapte
5617,2020,Droit,3,Relations Internationales,2,Les Acteurs des Relations Internationales,9,63,8,QO,0.9,0.05,27.75,6,17,23,13,6,7,1.77,46.15,Moyen,Difficile,-1,Plus Difficile,Pas Adapte
63,2015,Droit,3,Relations Internationales,2,Les Acteurs des Relations Internationales,9,64,9,QCU,0.3,0.44,47.95,16,17,33,29,16,13,1.14,55.17,Facile,Moyen,-1,Plus Difficile,Pas Adapte
1174,2016,Droit,3,Relations Internationales,2,Les Acteurs des Relations Internationales,9,64,9,QCM,0.01,0.87,66.34,21,11,32,22,21,1,1.45,95.45,Facile,Facile,0,Meme Difficulté,Adapte
2285,2017,Droit,3,Relations Internationales,2,Les Acteurs des Relations Internationales,9,64,9,QCM,0.18,0.89,66.34,23,11,34,29,23,6,1.17,79.31,Facile,Facile,0,Meme Difficulté,Adapte
3396,2018,Droit,3,Relations Internationales,2,Les Acteurs des Relations Internationales,9,64,9,QCM,0.2,0.82,66.34,19,10,29,23,19,4,1.26,82.61,Facile,Facile,0,Meme Difficulté,Adapte
4507,2019,Droit,3,Relations Internationales,2,Les Acteurs des Relations Internationales,9,64,9,QCU,0.17,0.8,66.34,19,9,28,23,19,4,1.22,82.61,Facile,Facile,0,Meme Difficulté,Adapte
5618,2020,Droit,3,Relations Internationales,2,Les Acteurs des Relations Internationales,9,64,9,QCU,0.07,0.95,66.34,17,9,26,26,17,9,1.0,65.38,Facile,Facile,0,Meme Difficulté,Adapte
64,2015,Droit,3,Relations Internationales,3,Les Grands Principes regissant les Relations Internationales,10,65,1,QCM,0.27,0.44,37.91,25,41,66,28,25,3,2.36,89.29,Facile,Moyen,-1,Plus Difficile,Pas Adapte
1175,2016,Droit,3,Relations Internationales,3,Les Grands Principes regissant les Relations Internationales,10,65,1,QCM,0.12,0.95,83.04,51,10,61,53,51,2,1.15,96.23,Moyen,Facile,1,Plus Facile,Pas Adapte
2286,2017,Droit,3,Relations Internationales,3,Les Grands Principes regissant les Relations Internationales,10,65,1,QCM,0.18,0.7,91.62,60,6,66,65,60,5,1.02,92.31,Facile,Facile,0,Meme Difficulté,Pas Adapte
3397,2018,Droit,3,Relations Internationales,3,Les Grands Principes regissant les Relations Internationales,10,65,1,QCU,0.72,0.26,12.97,7,49,56,48,7,41,1.17,14.58,Moyen,Difficile,-1,Plus Difficile,Pas Adapte
4508,2019,Droit,3,Relations Internationales,3,Les Grands Principes regissant les Relations Internationales,10,65,1,QCU,0.38,0.48,35.4,19,35,54,43,19,24,1.26,44.19,Difficile,Moyen,1,Plus Facile,Pas Adapte
5619,2020,Droit,3,Relations Internationales,3,Les Grands Principes regissant les Relations Internationales,10,65,1,QCU,0.6,0.38,25.51,14,40,54,26,14,12,2.08,53.85,Moyen,Difficile,-1,Plus Difficile,Pas Adapte
65,2015,Droit,3,Relations Internationales,3,Les Grands Principes regissant les Relations Internationales,10,66,2,QCU,0.64,0.21,15.08,6,33,39,30,6,24,1.3,20.0,Facile,Difficile,-2,Beaucoup plus Difficile,Pas Adapte
1176,2016,Droit,3,Relations Internationales,3,Les Grands Principes regissant les Relations Internationales,10,66,2,QCU,0.3,0.62,55.02,24,19,43,27,24,3,1.59,88.89,Facile,Moyen,-1,Plus Difficile,Pas Adapte
2287,2017,Droit,3,Relations Internationales,3,Les Grands Principes regissant les Relations Internationales,10,66,2,QCU,0.63,0.28,28.23,13,34,47,38,13,25,1.24,34.21,Facile,Difficile,-2,Beaucoup plus Difficile,Pas Adapte
3398,2018,Droit,3,Relations Internationales,3,Les Grands Principes regissant les Relations Internationales,10,66,2,QO,0.9,0.03,2.57,1,47,48,24,1,23,2.0,4.17,Moyen,Difficile,-1,Plus Difficile,Pas Adapte
4509,2019,Droit,3,Relations Internationales,3,Les Grands Principes regissant les Relations Internationales,10,66,2,QO,0.51,0.23,39.53,20,31,51,49,20,29,1.04,40.82,Difficile,Moyen,1,Plus Facile,Pas Adapte
5620,2020,Droit,3,Relations Internationales,3,Les Grands Principes regissant les Relations Internationales,10,66,2,QO,0.38,0.24,40.39,21,32,53,39,21,18,1.36,53.85,Facile,Moyen,-1,Plus Difficile,Pas Adapte
66,2015,Droit,3,Relations Internationales,3,Les Grands Principes regissant les Relations Internationales,10,67,3,QROC,0.18,0.89,74.01,28,10,38,30,28,2,1.27,93.33,Moyen,Facile,1,Plus Facile,Adapte
1177,2016,Droit,3,Relations Internationales,3,Les Grands Principes regissant les Relations Internationales,10,67,3,QROC,0.06,0.5,74.01,32,11,43,41,32,9,1.05,78.05,Facile,Facile,0,Meme Difficulté,Adapte
2288,2017,Droit,3,Relations Internationales,3,Les Grands Principes regissant les Relations Internationales,10,67,3,QROC,0.01,0.62,74.01,28,10,38,35,28,7,1.09,80.0,Facile,Facile,0,Meme Difficulté,Adapte
3399,2018,Droit,3,Relations Internationales,3,Les Grands Principes regissant les Relations Internationales,10,67,3,QROC,0.09,0.96,74.01,24,8,32,24,24,0,1.33,100.0,Facile,Facile,0,Meme Difficulté,Adapte
4510,2019,Droit,3,Relations Internationales,3,Les Grands Principes regissant les Relations Internationales,10,67,3,QROC,0.2,0.71,74.01,23,8,31,23,23,0,1.35,100.0,Facile,Facile,0,Meme Difficulté,Adapte
5621,2020,Droit,3,Relations Internationales,3,Les Grands Principes regissant les Relations Internationales,10,67,3,QROC,0.13,0.42,74.01,23,8,31,31,23,8,1.0,74.19,Facile,Facile,0,Meme Difficulté,Adapte
67,2015,Droit,3,Relations Internationales,3,Les Grands Principes regissant les Relations Internationales,10,68,4,QCU,0.56,0.32,30.05,6,14,20,19,6,13,1.05,31.58,Moyen,Difficile,-1,Plus Difficile,Pas Adapte
1178,2016,Droit,3,Relations Internationales,3,Les Grands Principes regissant les Relations Internationales,10,68,4,QCU,0.29,0.47,48.63,9,10,19,15,9,6,1.27,60.0,Difficile,Moyen,1,Plus Facile,Pas Adapte
2289,2017,Droit,3,Relations Internationales,3,Les Grands Principes regissant les Relations Internationales,10,68,4,QO,0.12,0.8,65.24,14,7,21,19,14,5,1.11,73.68,Difficile,Facile,2,Beaucoup plus Facile,Adapte
3400,2018,Droit,3,Relations Internationales,3,Les Grands Principes regissant les Relations Internationales,10,68,4,QO,0.16,0.99,65.24,15,8,23,20,15,5,1.15,75.0,Facile,Facile,0,Meme Difficulté,Adapte
4511,2019,Droit,3,Relations Internationales,3,Les Grands Principes regissant les Relations Internationales,10,68,4,QO,0.05,0.42,65.24,16,9,25,24,16,8,1.04,66.67,Facile,Facile,0,Meme Difficulté,Adapte
5622,2020,Droit,3,Relations Internationales,3,Les Grands Principes regissant les Relations Internationales,10,68,4,QO,0.11,0.88,65.24,14,8,22,18,14,4,1.22,77.78,Facile,Facile,0,Meme Difficulté,Adapte
68,2015,Droit,3,Relations Internationales,3,Les Grands Principes regissant les Relations Internationales,10,69,5,QCM,0.1,0.85,78.25,64,18,82,70,64,6,1.17,91.43,Facile,Facile,0,Meme Difficulté,Pas Adapte
1179,2016,Droit,3,Relations Internationales,3,Les Grands Principes regissant les Relations Internationales,10,69,5,QCM,0.01,0.96,73.5,61,22,83,72,61,11,1.15,84.72,Facile,Facile,0,Meme Difficulté,Adapte
2290,2017,Droit,3,Relations Internationales,3,Les Grands Principes regissant les Relations Internationales,10,69,5,QCM,0.02,0.72,73.5,58,21,79,60,58,2,1.32,96.67,Facile,Facile,0,Meme Difficulté,Adapte
3401,2018,Droit,3,Relations Internationales,3,Les Grands Principes regissant les Relations Internationales,10,69,5,QCM,0.11,0.97,73.5,64,23,87,74,64,10,1.18,86.49,Facile,Facile,0,Meme Difficulté,Adapte
4512,2019,Droit,3,Relations Internationales,3,Les Grands Principes regissant les Relations Internationales,10,69,5,QCM,0.09,0.89,73.5,74,26,100,78,74,4,1.28,94.87,Facile,Facile,0,Meme Difficulté,Adapte
5623,2020,Droit,3,Relations Internationales,3,Les Grands Principes regissant les Relations Internationales,10,69,5,QCM,0.07,0.71,73.5,76,27,103,76,76,0,1.36,100.0,Facile,Facile,0,Meme Difficulté,Adapte
69,2015,Droit,3,Relations Internationales,3,Les Grands Principes regissant les Relations Internationales,10,70,6,QCU,0.71,0.34,10.48,6,56,62,48,6,42,1.29,12.5,Difficile,Difficile,0,Meme Difficulté,Pas Adapte
1180,2016,Droit,3,Relations Internationales,3,Les Grands Principes regissant les Relations Internationales,10,70,6,QCU,0.21,0.6,38.08,21,34,55,29,21,8,1.9,72.41,Moyen,Moyen,0,Meme Difficulté,Pas Adapte
2291,2017,Droit,3,Relations Internationales,3,Les Grands Principes regissant les Relations Internationales,10,70,6,QROC,0.16,0.89,81.0,48,11,59,53,48,5,1.11,90.57,Facile,Facile,0,Meme Difficulté,Pas Adapte
3402,2018,Droit,3,Relations Internationales,3,Les Grands Principes regissant les Relations Internationales,10,70,6,QROC,0.88,0.11,19.14,10,44,54,45,10,35,1.2,22.22,Facile,Difficile,-2,Beaucoup plus Difficile,Pas Adapte
4513,2019,Droit,3,Relations Internationales,3,Les Grands Principes regissant les Relations Internationales,10,70,6,QROC,0.15,0.62,96.64,56,2,58,58,56,2,1.0,96.55,Facile,Facile,0,Meme Difficulté,Pas Adapte
5624,2020,Droit,3,Relations Internationales,3,Les Grands Principes regissant les Relations Internationales,10,70,6,QROC,0.83,0.17,20.85,12,47,59,46,12,34,1.28,26.09,Difficile,Difficile,0,Meme Difficulté,Pas Adapte
70,2015,Droit,3,Relations Internationales,3,Les Grands Principes regissant les Relations Internationales,10,71,7,QCU,0.31,0.74,45.06,22,26,48,31,22,9,1.55,70.97,Facile,Moyen,-1,Plus Difficile,Pas Adapte
1181,2016,Droit,3,Relations Internationales,3,Les Grands Principes regissant les Relations Internationales,10,71,7,QCU,0.04,0.81,74.85,32,11,43,37,32,5,1.16,86.49,Facile,Facile,0,Meme Difficulté,Adapte
2292,2017,Droit,3,Relations Internationales,3,Les Grands Principes regissant les Relations Internationales,10,71,7,QCU,0.02,0.76,74.85,28,9,37,35,28,7,1.06,80.0,Facile,Facile,0,Meme Difficulté,Adapte
3403,2018,Droit,3,Relations Internationales,3,Les Grands Principes regissant les Relations Internationales,10,71,7,QCU,0.02,0.92,74.85,27,9,36,34,27,7,1.06,79.41,Facile,Facile,0,Meme Difficulté,Adapte
4514,2019,Droit,3,Relations Internationales,3,Les Grands Principes regissant les Relations Internationales,10,71,7,QCU,0.1,0.96,74.85,23,8,31,25,23,2,1.24,92.0,Facile,Facile,0,Meme Difficulté,Adapte
5625,2020,Droit,3,Relations Internationales,3,Les Grands Principes regissant les Relations Internationales,10,71,7,QCU,0.03,0.79,74.85,27,9,36,33,27,6,1.09,81.82,Facile,Facile,0,Meme Difficulté,Adapte
71,2015,Droit,3,Relations Internationales,3,Les Grands Principes regissant les Relations Internationales,10,72,8,QROC,0.97,0.03,9.5,2,24,26,12,2,10,2.17,16.67,Moyen,Difficile,-1,Plus Difficile,Pas Adapte
1182,2016,Droit,3,Relations Internationales,3,Les Grands Principes regissant les Relations Internationales,10,72,8,QROC,0.5,0.3,43.61,10,13,23,14,10,4,1.64,71.43,Facile,Moyen,-1,Plus Difficile,Pas Adapte
2293,2017,Droit,3,Relations Internationales,3,Les Grands Principes regissant les Relations Internationales,10,72,8,QO,0.09,0.42,73.38,16,6,22,18,16,2,1.22,88.89,Facile,Facile,0,Meme Difficulté,Adapte
3404,2018,Droit,3,Relations Internationales,3,Les Grands Principes regissant les Relations Internationales,10,72,8,QO,0.02,0.56,73.38,18,6,24,23,18,5,1.04,78.26,Facile,Facile,0,Meme Difficulté,Adapte
4515,2019,Droit,3,Relations Internationales,3,Les Grands Principes regissant les Relations Internationales,10,72,8,QO,0.09,0.86,73.38,18,6,24,21,18,3,1.14,85.71,Facile,Facile,0,Meme Difficulté,Adapte
5626,2020,Droit,3,Relations Internationales,3,Les Grands Principes regissant les Relations Internationales,10,72,8,QO,0.09,0.45,73.38,15,5,20,15,15,0,1.33,100.0,Facile,Facile,0,Meme Difficulté,Adapte
72,2015,Droit,3,Relations Internationales,3,Les Grands Principes regissant les Relations Internationales,10,73,9,QCU,0.29,0.7,54.67,17,15,32,28,17,11,1.14,60.71,Facile,Moyen,-1,Plus Difficile,Pas Adapte
1183,2016,Droit,3,Relations Internationales,3,Les Grands Principes regissant les Relations Internationales,10,73,9,QCU,0.27,0.54,37.43,11,18,29,16,11,5,1.81,68.75,Difficile,Moyen,1,Plus Facile,Pas Adapte
2294,2017,Droit,3,Relations Internationales,3,Les Grands Principes regissant les Relations Internationales,10,73,9,QCU,0.74,0.38,13.82,4,23,27,22,4,18,1.23,18.18,Moyen,Difficile,-1,Plus Difficile,Pas Adapte
3405,2018,Droit,3,Relations Internationales,3,Les Grands Principes regissant les Relations Internationales,10,73,9,QCU,0.21,0.55,35.95,8,15,23,18,8,10,1.28,44.44,Difficile,Moyen,1,Plus Facile,Pas Adapte
4516,2019,Droit,3,Relations Internationales,3,Les Grands Principes regissant les Relations Internationales,10,73,9,QCU,0.72,0.34,32.12,7,15,22,21,7,14,1.05,33.33,Moyen,Difficile,-1,Plus Difficile,Pas Adapte
5627,2020,Droit,3,Relations Internationales,3,Les Grands Principes regissant les Relations Internationales,10,73,9,QCU,0.01,0.77,67.91,13,6,19,13,13,0,1.46,100.0,Difficile,Facile,2,Beaucoup plus Facile,Adapte
73,2015,Droit,3,Relations Internationales,3,Les Grands Principes regissant les Relations Internationales,10,74,10,QCM,0.77,0.23,20.54,8,29,37,33,8,25,1.12,24.24,Facile,Difficile,-2,Beaucoup plus Difficile,Pas Adapte
1184,2016,Droit,3,Relations Internationales,3,Les Grands Principes regissant les Relations Internationales,10,74,10,QCM,0.71,0.28,27.87,10,25,35,11,10,1,3.18,90.91,Facile,Difficile,-2,Beaucoup plus Difficile,Pas Adapte
2295,2017,Droit,3,Relations Internationales,3,Les Grands Principes regissant les Relations Internationales,10,74,10,QCU,0.42,0.28,4.95,2,31,33,16,2,14,2.06,12.5,Facile,Difficile,-2,Beaucoup plus Difficile,Pas Adapte
3406,2018,Droit,3,Relations Internationales,3,Les Grands Principes regissant les Relations Internationales,10,74,10,QCM,0.38,0.63,44.71,15,18,33,24,15,9,1.38,62.5,Difficile,Moyen,1,Plus Facile,Pas Adapte
4517,2019,Droit,3,Relations Internationales,3,Les Grands Principes regissant les Relations Internationales,10,74,10,QCM,0.57,0.2,10.66,4,31,35,11,4,7,3.18,36.36,Facile,Difficile,-2,Beaucoup plus Difficile,Pas Adapte
5628,2020,Droit,3,Relations Internationales,3,Les Grands Principes regissant les Relations Internationales,10,74,10,QCM,0.72,0.25,15.18,5,25,30,19,5,14,1.58,26.32,Difficile,Difficile,0,Meme Difficulté,Pas Adapte
74,2015,Droit,4,Proces et Institution Juridictionnelles,1,Introduction,6,75,1,QCM,0.25,0.3,59.87,50,34,84,63,50,13,1.33,79.37,Facile,Moyen,-1,Plus Difficile,Pas Adapte
1185,2016,Droit,4,Proces et Institution Juridictionnelles,1,Introduction,6,75,1,QCM,0.35,0.42,62.5,47,28,75,47,47,0,1.6,100.0,Facile,Moyen,-1,Plus Difficile,Pas Adapte
2296,2017,Droit,4,Proces et Institution Juridictionnelles,1,Introduction,6,75,1,QCM,0.46,0.46,53.12,35,30,65,51,35,16,1.27,68.63,Facile,Moyen,-1,Plus Difficile,Pas Adapte
3407,2018,Droit,4,Proces et Institution Juridictionnelles,1,Introduction,6,75,1,QO,0.79,0.09,9.06,6,61,67,66,6,60,1.02,9.09,Difficile,Difficile,0,Meme Difficulté,Pas Adapte
4518,2019,Droit,4,Proces et Institution Juridictionnelles,1,Introduction,6,75,1,QO,0.13,0.58,95.19,69,4,73,73,69,4,1.0,94.52,Moyen,Facile,1,Plus Facile,Pas Adapte
5629,2020,Droit,4,Proces et Institution Juridictionnelles,1,Introduction,6,75,1,QO,0.34,0.19,47.61,30,32,62,33,30,3,1.88,90.91,Difficile,Moyen,1,Plus Facile,Pas Adapte
75,2015,Droit,4,Proces et Institution Juridictionnelles,1,Introduction,6,76,2,QCM,0.46,0.58,50.55,36,36,72,46,36,10,1.57,78.26,Facile,Moyen,-1,Plus Difficile,Pas Adapte
1186,2016,Droit,4,Proces et Institution Juridictionnelles,1,Introduction,6,76,2,QCM,0.74,0.18,13.21,9,60,69,60,9,51,1.15,15.0,Difficile,Difficile,0,Meme Difficulté,Pas Adapte
2297,2017,Droit,4,Proces et Institution Juridictionnelles,1,Introduction,6,76,2,QCM,0.78,0.27,30.88,23,51,74,59,23,36,1.25,38.98,Moyen,Difficile,-1,Plus Difficile,Pas Adapte
3408,2018,Droit,4,Proces et Institution Juridictionnelles,1,Introduction,6,76,2,QCM,0.13,0.79,70.23,47,20,67,52,47,5,1.29,90.38,Facile,Facile,0,Meme Difficulté,Adapte
4519,2019,Droit,4,Proces et Institution Juridictionnelles,1,Introduction,6,76,2,QCU,0.14,0.87,70.23,48,21,69,64,48,16,1.08,75.0,Facile,Facile,0,Meme Difficulté,Adapte
5630,2020,Droit,4,Proces et Institution Juridictionnelles,1,Introduction,6,76,2,QCU,0.07,0.98,70.23,50,21,71,50,50,0,1.42,100.0,Facile,Facile,0,Meme Difficulté,Adapte
76,2015,Droit,4,Proces et Institution Juridictionnelles,1,Introduction,6,77,3,QROC,0.59,0.34,58.52,28,19,47,34,28,6,1.38,82.35,Facile,Moyen,-1,Plus Difficile,Pas Adapte
1187,2016,Droit,4,Proces et Institution Juridictionnelles,1,Introduction,6,77,3,QROC,0.22,0.32,50.81,21,21,42,39,21,18,1.08,53.85,Moyen,Moyen,0,Meme Difficulté,Pas Adapte
2298,2017,Droit,4,Proces et Institution Juridictionnelles,1,Introduction,6,77,3,QROC,0.52,0.38,43.62,19,24,43,40,19,21,1.07,47.5,Facile,Moyen,-1,Plus Difficile,Pas Adapte
3409,2018,Droit,4,Proces et Institution Juridictionnelles,1,Introduction,6,77,3,QROC,0.22,0.3,50.33,23,23,46,38,23,15,1.21,60.53,Difficile,Moyen,1,Plus Facile,Pas Adapte
4520,2019,Droit,4,Proces et Institution Juridictionnelles,1,Introduction,6,77,3,QROC,0.99,0.18,25.76,12,33,45,35,12,23,1.29,34.29,Difficile,Difficile,0,Meme Difficulté,Pas Adapte
5631,2020,Droit,4,Proces et Institution Juridictionnelles,1,Introduction,6,77,3,QROC,0.82,0.17,24.57,10,32,42,38,10,28,1.11,26.32,Difficile,Difficile,0,Meme Difficulté,Pas Adapte
77,2015,Droit,4,Proces et Institution Juridictionnelles,1,Introduction,6,78,4,QCM,0.01,0.95,72.26,4,1,5,5,4,1,1.0,80.0,Moyen,Facile,1,Plus Facile,Adapte
1188,2016,Droit,4,Proces et Institution Juridictionnelles,1,Introduction,6,78,4,QCM,0.09,0.93,72.26,3,1,4,3,3,0,1.33,100.0,Facile,Facile,0,Meme Difficulté,Adapte
2299,2017,Droit,4,Proces et Institution Juridictionnelles,1,Introduction,6,78,4,QCU,0.16,0.98,72.26,4,1,5,4,4,0,1.25,100.0,Facile,Facile,0,Meme Difficulté,Adapte
3410,2018,Droit,4,Proces et Institution Juridictionnelles,1,Introduction,6,78,4,QCU,0.11,0.78,72.26,4,2,6,5,4,1,1.2,80.0,Facile,Facile,0,Meme Difficulté,Adapte
4521,2019,Droit,4,Proces et Institution Juridictionnelles,1,Introduction,6,78,4,QCU,0.11,0.87,72.26,4,1,5,4,4,0,1.25,100.0,Facile,Facile,0,Meme Difficulté,Adapte
5632,2020,Droit,4,Proces et Institution Juridictionnelles,1,Introduction,6,78,4,QROC,0.15,0.81,72.26,3,1,4,4,3,1,1.0,75.0,Facile,Facile,0,Meme Difficulté,Adapte
78,2015,Droit,4,Proces et Institution Juridictionnelles,1,Introduction,6,79,5,QCM,0.2,0.54,64.56,35,19,54,44,35,9,1.23,79.55,Difficile,Moyen,1,Plus Facile,Pas Adapte
1189,2016,Droit,4,Proces et Institution Juridictionnelles,1,Introduction,6,79,5,QCM,0.11,0.76,91.42,46,4,50,48,46,2,1.04,95.83,Moyen,Facile,1,Plus Facile,Pas Adapte
2300,2017,Droit,4,Proces et Institution Juridictionnelles,1,Introduction,6,79,5,QCM,0.75,0.18,9.63,5,42,47,45,5,40,1.04,11.11,Difficile,Difficile,0,Meme Difficulté,Pas Adapte
3411,2018,Droit,4,Proces et Institution Juridictionnelles,1,Introduction,6,79,5,QCM,0.02,0.95,76.68,38,11,49,44,38,6,1.11,86.36,Difficile,Facile,2,Beaucoup plus Facile,Pas Adapte
4522,2019,Droit,4,Proces et Institution Juridictionnelles,1,Introduction,6,79,5,QCM,0.55,0.25,16.4,9,46,55,18,9,9,3.06,50.0,Difficile,Difficile,0,Meme Difficulté,Pas Adapte
5633,2020,Droit,4,Proces et Institution Juridictionnelles,1,Introduction,6,79,5,QCM,0.56,0.28,22.49,12,42,54,29,12,17,1.86,41.38,Moyen,Difficile,-1,Plus Difficile,Pas Adapte
79,2015,Droit,4,Proces et Institution Juridictionnelles,1,Introduction,6,80,6,QCM,0.55,0.18,34.58,20,37,57,38,20,18,1.5,52.63,Facile,Difficile,-2,Beaucoup plus Difficile,Pas Adapte
1190,2016,Droit,4,Proces et Institution Juridictionnelles,1,Introduction,6,80,6,QCM,0.18,0.99,75.79,37,12,49,46,37,9,1.07,80.43,Facile,Facile,0,Meme Difficulté,Pas Adapte
2301,2017,Droit,4,Proces et Institution Juridictionnelles,1,Introduction,6,80,6,QCM,0.53,0.19,34.19,16,32,48,27,16,11,1.78,59.26,Difficile,Difficile,0,Meme Difficulté,Pas Adapte
3412,2018,Droit,4,Proces et Institution Juridictionnelles,1,Introduction,6,80,6,QCM,0.55,0.16,23.88,12,37,49,21,12,9,2.33,57.14,Moyen,Difficile,-1,Plus Difficile,Pas Adapte
4523,2019,Droit,4,Proces et Institution Juridictionnelles,1,Introduction,6,80,6,QROC,0.9,0.01,9.08,4,42,46,21,4,17,2.19,19.05,Facile,Difficile,-2,Beaucoup plus Difficile,Pas Adapte
5634,2020,Droit,4,Proces et Institution Juridictionnelles,1,Introduction,6,80,6,QO,0.04,0.41,82.87,41,9,50,44,41,3,1.14,93.18,Facile,Facile,0,Meme Difficulté,Pas Adapte
80,2015,Droit,4,Proces et Institution Juridictionnelles,2,La Trame de la Scene Judiciaire,14,81,1,QO,0.97,0.11,21.66,10,35,45,34,10,24,1.32,29.41,Difficile,Difficile,0,Meme Difficulté,Pas Adapte
1191,2016,Droit,4,Proces et Institution Juridictionnelles,2,La Trame de la Scene Judiciaire,14,81,1,QO,0.15,0.31,84.92,35,6,41,35,35,0,1.17,100.0,Facile,Facile,0,Meme Difficulté,Pas Adapte
2302,2017,Droit,4,Proces et Institution Juridictionnelles,2,La Trame de la Scene Judiciaire,14,81,1,QO,0.05,1.0,92.3,42,3,45,43,42,1,1.05,97.67,Facile,Facile,0,Meme Difficulté,Pas Adapte
3413,2018,Droit,4,Proces et Institution Juridictionnelles,2,La Trame de la Scene Judiciaire,14,81,1,QO,0.9,0.04,29.18,14,33,47,47,14,33,1.0,29.79,Difficile,Difficile,0,Meme Difficulté,Pas Adapte
4524,2019,Droit,4,Proces et Institution Juridictionnelles,2,La Trame de la Scene Judiciaire,14,81,1,QO,0.59,0.26,60.31,27,17,44,30,27,3,1.47,90.0,Facile,Moyen,-1,Plus Difficile,Pas Adapte
5635,2020,Droit,4,Proces et Institution Juridictionnelles,2,La Trame de la Scene Judiciaire,14,81,1,QO,0.57,0.24,51.74,23,22,45,35,23,12,1.29,65.71,Moyen,Moyen,0,Meme Difficulté,Pas Adapte
81,2015,Droit,4,Proces et Institution Juridictionnelles,2,La Trame de la Scene Judiciaire,14,82,2,QCU,0.53,0.21,29.22,29,69,98,51,29,22,1.92,56.86,Facile,Difficile,-2,Beaucoup plus Difficile,Pas Adapte
1192,2016,Droit,4,Proces et Institution Juridictionnelles,2,La Trame de la Scene Judiciaire,14,82,2,QCU,0.28,0.59,61.15,56,36,92,68,56,12,1.35,82.35,Moyen,Moyen,0,Meme Difficulté,Pas Adapte
2303,2017,Droit,4,Proces et Institution Juridictionnelles,2,La Trame de la Scene Judiciaire,14,82,2,QCU,0.33,0.51,48.15,38,41,79,61,38,23,1.3,62.3,Facile,Moyen,-1,Plus Difficile,Pas Adapte
3414,2018,Droit,4,Proces et Institution Juridictionnelles,2,La Trame de la Scene Judiciaire,14,82,2,QCM,0.69,0.28,27.07,23,63,86,23,23,0,3.74,100.0,Facile,Difficile,-2,Beaucoup plus Difficile,Pas Adapte
4525,2019,Droit,4,Proces et Institution Juridictionnelles,2,La Trame de la Scene Judiciaire,14,82,2,QCM,0.79,0.16,34.88,35,64,99,81,35,46,1.22,43.21,Difficile,Difficile,0,Meme Difficulté,Pas Adapte
5636,2020,Droit,4,Proces et Institution Juridictionnelles,2,La Trame de la Scene Judiciaire,14,82,2,QCM,0.44,0.47,59.69,63,43,106,91,63,28,1.16,69.23,Moyen,Moyen,0,Meme Difficulté,Pas Adapte
82,2015,Droit,4,Proces et Institution Juridictionnelles,2,La Trame de la Scene Judiciaire,14,83,3,QCM,0.33,0.48,59.14,48,34,82,80,48,32,1.02,60.0,Difficile,Moyen,1,Plus Facile,Pas Adapte
1193,2016,Droit,4,Proces et Institution Juridictionnelles,2,La Trame de la Scene Judiciaire,14,83,3,QCM,0.54,0.26,10.36,9,78,87,79,9,70,1.1,11.39,Difficile,Difficile,0,Meme Difficulté,Pas Adapte
2304,2017,Droit,4,Proces et Institution Juridictionnelles,2,La Trame de la Scene Judiciaire,14,83,3,QCM,0.42,0.51,46.01,43,50,93,69,43,26,1.35,62.32,Difficile,Moyen,1,Plus Facile,Pas Adapte
3415,2018,Droit,4,Proces et Institution Juridictionnelles,2,La Trame de la Scene Judiciaire,14,83,3,QCM,0.7,0.18,28.33,26,65,91,66,26,40,1.38,39.39,Moyen,Difficile,-1,Plus Difficile,Pas Adapte
4526,2019,Droit,4,Proces et Institution Juridictionnelles,2,La Trame de la Scene Judiciaire,14,83,3,QCM,0.18,0.9,80.48,79,19,98,87,79,8,1.13,90.8,Facile,Facile,0,Meme Difficulté,Pas Adapte
5637,2020,Droit,4,Proces et Institution Juridictionnelles,2,La Trame de la Scene Judiciaire,14,83,3,QCM,0.8,0.21,8.58,7,76,83,60,7,53,1.38,11.67,Difficile,Difficile,0,Meme Difficulté,Pas Adapte
83,2015,Droit,4,Proces et Institution Juridictionnelles,2,La Trame de la Scene Judiciaire,14,84,4,QCU,0.64,0.32,2.22,2,71,73,72,2,70,1.01,2.78,Difficile,Difficile,0,Meme Difficulté,Pas Adapte
1194,2016,Droit,4,Proces et Institution Juridictionnelles,2,La Trame de la Scene Judiciaire,14,84,4,QCU,0.02,0.83,75.86,54,17,71,60,54,6,1.18,90.0,Difficile,Facile,2,Beaucoup plus Facile,Pas Adapte
2305,2017,Droit,4,Proces et Institution Juridictionnelles,2,La Trame de la Scene Judiciaire,14,84,4,QCU,0.35,0.6,42.51,29,40,69,44,29,15,1.57,65.91,Moyen,Moyen,0,Meme Difficulté,Pas Adapte
3416,2018,Droit,4,Proces et Institution Juridictionnelles,2,La Trame de la Scene Judiciaire,14,84,4,QCU,0.19,0.83,78.99,55,15,70,65,55,10,1.08,84.62,Facile,Facile,0,Meme Difficulté,Pas Adapte
4527,2019,Droit,4,Proces et Institution Juridictionnelles,2,La Trame de la Scene Judiciaire,14,84,4,QCU,0.48,0.32,31.69,23,49,72,34,23,11,2.12,67.65,Moyen,Difficile,-1,Plus Difficile,Pas Adapte
5638,2020,Droit,4,Proces et Institution Juridictionnelles,2,La Trame de la Scene Judiciaire,14,84,4,QCU,0.03,1.0,68.28,53,24,77,71,53,18,1.08,74.65,Facile,Facile,0,Meme Difficulté,Adapte
84,2015,Droit,4,Proces et Institution Juridictionnelles,2,La Trame de la Scene Judiciaire,14,85,5,QCM,0.73,0.3,1.39,1,46,47,30,1,29,1.57,3.33,Difficile,Difficile,0,Meme Difficulté,Pas Adapte
1195,2016,Droit,4,Proces et Institution Juridictionnelles,2,La Trame de la Scene Judiciaire,14,85,5,QCM,0.63,0.26,33.55,17,33,50,42,17,25,1.19,40.48,Difficile,Difficile,0,Meme Difficulté,Pas Adapte
2306,2017,Droit,4,Proces et Institution Juridictionnelles,2,La Trame de la Scene Judiciaire,14,85,5,QCU,0.6,0.35,22.52,11,36,47,34,11,23,1.38,32.35,Difficile,Difficile,0,Meme Difficulté,Pas Adapte
3417,2018,Droit,4,Proces et Institution Juridictionnelles,2,La Trame de la Scene Judiciaire,14,85,5,QCU,0.46,0.2,2.18,1,46,47,22,1,21,2.14,4.55,Facile,Difficile,-2,Beaucoup plus Difficile,Pas Adapte
4528,2019,Droit,4,Proces et Institution Juridictionnelles,2,La Trame de la Scene Judiciaire,14,85,5,QCU,0.32,0.56,39.96,18,28,46,21,18,3,2.19,85.71,Difficile,Moyen,1,Plus Facile,Pas Adapte
5639,2020,Droit,4,Proces et Institution Juridictionnelles,2,La Trame de la Scene Judiciaire,14,85,5,QCU,0.13,0.98,76.68,35,11,46,44,35,9,1.05,79.55,Facile,Facile,0,Meme Difficulté,Pas Adapte
85,2015,Droit,4,Proces et Institution Juridictionnelles,2,La Trame de la Scene Judiciaire,14,86,6,QCM,0.73,0.25,31.69,4,10,14,9,4,5,1.56,44.44,Difficile,Difficile,0,Meme Difficulté,Pas Adapte
1196,2016,Droit,4,Proces et Institution Juridictionnelles,2,La Trame de la Scene Judiciaire,14,86,6,QCM,0.65,0.18,26.28,4,11,15,13,4,9,1.15,30.77,Facile,Difficile,-2,Beaucoup plus Difficile,Pas Adapte
2307,2017,Droit,4,Proces et Institution Juridictionnelles,2,La Trame de la Scene Judiciaire,14,86,6,QCM,0.69,0.24,26.31,4,10,14,14,4,10,1.0,28.57,Difficile,Difficile,0,Meme Difficulté,Pas Adapte
3418,2018,Droit,4,Proces et Institution Juridictionnelles,2,La Trame de la Scene Judiciaire,14,86,6,QCM,0.73,0.18,15.71,2,11,13,6,2,4,2.17,33.33,Facile,Difficile,-2,Beaucoup plus Difficile,Pas Adapte
4529,2019,Droit,4,Proces et Institution Juridictionnelles,2,La Trame de la Scene Judiciaire,14,86,6,QCM,0.1,1.0,73.82,8,3,11,8,8,0,1.38,100.0,Difficile,Facile,2,Beaucoup plus Facile,Adapte
5640,2020,Droit,4,Proces et Institution Juridictionnelles,2,La Trame de la Scene Judiciaire,14,86,6,QCM,0.12,0.92,73.82,8,3,11,9,8,1,1.22,88.89,Facile,Facile,0,Meme Difficulté,Adapte
86,2015,Droit,4,Proces et Institution Juridictionnelles,2,La Trame de la Scene Judiciaire,14,87,7,QO,0.74,0.24,59.61,52,36,88,68,52,16,1.29,76.47,Difficile,Moyen,1,Plus Facile,Pas Adapte
1197,2016,Droit,4,Proces et Institution Juridictionnelles,2,La Trame de la Scene Judiciaire,14,87,7,QO,0.07,0.59,87.12,75,11,86,75,75,0,1.15,100.0,Facile,Facile,0,Meme Difficulté,Pas Adapte
2308,2017,Droit,4,Proces et Institution Juridictionnelles,2,La Trame de la Scene Judiciaire,14,87,7,QO,0.81,0.08,23.21,20,66,86,77,20,57,1.12,25.97,Moyen,Difficile,-1,Plus Difficile,Pas Adapte
3419,2018,Droit,4,Proces et Institution Juridictionnelles,2,La Trame de la Scene Judiciaire,14,87,7,QO,0.01,0.3,93.32,91,7,98,98,91,7,1.0,92.86,Facile,Facile,0,Meme Difficulté,Pas Adapte
4530,2019,Droit,4,Proces et Institution Juridictionnelles,2,La Trame de la Scene Judiciaire,14,87,7,QO,0.87,0.1,7.88,9,102,111,73,9,64,1.52,12.33,Moyen,Difficile,-1,Plus Difficile,Pas Adapte
5641,2020,Droit,4,Proces et Institution Juridictionnelles,2,La Trame de la Scene Judiciaire,14,87,7,QO,0.1,0.8,73.52,79,29,108,99,79,20,1.09,79.8,Difficile,Facile,2,Beaucoup plus Facile,Adapte
87,2015,Droit,4,Proces et Institution Juridictionnelles,2,La Trame de la Scene Judiciaire,14,88,8,QROC,0.63,0.17,30.02,5,12,17,9,5,4,1.89,55.56,Facile,Difficile,-2,Beaucoup plus Difficile,Pas Adapte
1198,2016,Droit,4,Proces et Institution Juridictionnelles,2,La Trame de la Scene Judiciaire,14,88,8,QROC,0.36,0.3,59.93,9,6,15,15,9,6,1.0,60.0,Facile,Moyen,-1,Plus Difficile,Pas Adapte
2309,2017,Droit,4,Proces et Institution Juridictionnelles,2,La Trame de la Scene Judiciaire,14,88,8,QROC,0.36,0.38,48.98,7,7,14,9,7,2,1.56,77.78,Facile,Moyen,-1,Plus Difficile,Pas Adapte
3420,2018,Droit,4,Proces et Institution Juridictionnelles,2,La Trame de la Scene Judiciaire,14,88,8,QROC,0.66,0.07,23.87,3,9,12,8,3,5,1.5,37.5,Difficile,Difficile,0,Meme Difficulté,Pas Adapte
4531,2019,Droit,4,Proces et Institution Juridictionnelles,2,La Trame de la Scene Judiciaire,14,88,8,QROC,0.23,0.28,44.62,6,7,13,13,6,7,1.0,46.15,Difficile,Moyen,1,Plus Facile,Pas Adapte
5642,2020,Droit,4,Proces et Institution Juridictionnelles,2,La Trame de la Scene Judiciaire,14,88,8,QROC,0.84,0.17,22.98,3,10,13,9,3,6,1.44,33.33,Facile,Difficile,-2,Beaucoup plus Difficile,Pas Adapte
88,2015,Droit,4,Proces et Institution Juridictionnelles,2,La Trame de la Scene Judiciaire,14,89,9,QCM,0.07,0.88,97.16,31,1,32,31,31,0,1.03,100.0,Difficile,Facile,2,Beaucoup plus Facile,Pas Adapte
1199,2016,Droit,4,Proces et Institution Juridictionnelles,2,La Trame de la Scene Judiciaire,14,89,9,QCM,0.05,0.84,67.15,22,11,33,25,22,3,1.32,88.0,Moyen,Facile,1,Plus Facile,Adapte
2310,2017,Droit,4,Proces et Institution Juridictionnelles,2,La Trame de la Scene Judiciaire,14,89,9,QCM,0.12,0.72,67.15,23,11,34,26,23,3,1.31,88.46,Facile,Facile,0,Meme Difficulté,Adapte
3421,2018,Droit,4,Proces et Institution Juridictionnelles,2,La Trame de la Scene Judiciaire,14,89,9,QCM,0.12,0.79,67.15,24,11,35,28,24,4,1.25,85.71,Facile,Facile,0,Meme Difficulté,Adapte
4532,2019,Droit,4,Proces et Institution Juridictionnelles,2,La Trame de la Scene Judiciaire,14,89,9,QCM,0.17,0.72,67.15,22,11,33,22,22,0,1.5,100.0,Facile,Facile,0,Meme Difficulté,Adapte
5643,2020,Droit,4,Proces et Institution Juridictionnelles,2,La Trame de la Scene Judiciaire,14,89,9,QCM,0.03,0.93,67.15,21,11,32,30,21,9,1.07,70.0,Facile,Facile,0,Meme Difficulté,Adapte
89,2015,Droit,4,Proces et Institution Juridictionnelles,2,La Trame de la Scene Judiciaire,14,90,10,QO,0.28,0.21,51.43,40,37,77,62,40,22,1.24,64.52,Difficile,Moyen,1,Plus Facile,Pas Adapte
1200,2016,Droit,4,Proces et Institution Juridictionnelles,2,La Trame de la Scene Judiciaire,14,90,10,QROC,0.54,0.36,45.15,40,48,88,87,40,47,1.01,45.98,Facile,Moyen,-1,Plus Difficile,Pas Adapte
2311,2017,Droit,4,Proces et Institution Juridictionnelles,2,La Trame de la Scene Judiciaire,14,90,10,QROC,0.45,0.33,48.07,48,51,99,98,48,50,1.01,48.98,Moyen,Moyen,0,Meme Difficulté,Pas Adapte
3422,2018,Droit,4,Proces et Institution Juridictionnelles,2,La Trame de la Scene Judiciaire,14,90,10,QROC,0.03,0.94,65.52,69,37,106,70,69,1,1.51,98.57,Difficile,Facile,2,Beaucoup plus Facile,Adapte
4533,2019,Droit,4,Proces et Institution Juridictionnelles,2,La Trame de la Scene Judiciaire,14,90,10,QROC,0.02,0.45,65.52,67,35,102,68,67,1,1.5,98.53,Facile,Facile,0,Meme Difficulté,Adapte
5644,2020,Droit,4,Proces et Institution Juridictionnelles,2,La Trame de la Scene Judiciaire,14,90,10,QROC,0.03,0.73,65.52,77,40,117,91,77,14,1.29,84.62,Facile,Facile,0,Meme Difficulté,Adapte
90,2015,Droit,4,Proces et Institution Juridictionnelles,2,La Trame de la Scene Judiciaire,14,91,11,QCU,0.37,0.69,51.33,36,35,71,64,36,28,1.11,56.25,Difficile,Moyen,1,Plus Facile,Pas Adapte
1201,2016,Droit,4,Proces et Institution Juridictionnelles,2,La Trame de la Scene Judiciaire,14,91,11,QCU,0.11,0.94,72.19,45,18,63,63,45,18,1.0,71.43,Difficile,Facile,2,Beaucoup plus Facile,Adapte
2312,2017,Droit,4,Proces et Institution Juridictionnelles,2,La Trame de la Scene Judiciaire,14,91,11,QROC,0.01,0.9,72.19,45,18,63,46,45,1,1.37,97.83,Facile,Facile,0,Meme Difficulté,Adapte
3423,2018,Droit,4,Proces et Institution Juridictionnelles,2,La Trame de la Scene Judiciaire,14,91,11,QO,0.2,0.38,72.19,47,18,65,61,47,14,1.07,77.05,Facile,Facile,0,Meme Difficulté,Adapte
4534,2019,Droit,4,Proces et Institution Juridictionnelles,2,La Trame de la Scene Judiciaire,14,91,11,QO,0.05,0.89,72.19,43,17,60,56,43,13,1.07,76.79,Facile,Facile,0,Meme Difficulté,Adapte
5645,2020,Droit,4,Proces et Institution Juridictionnelles,2,La Trame de la Scene Judiciaire,14,91,11,QO,0.07,0.74,72.19,39,15,54,49,39,10,1.1,79.59,Facile,Facile,0,Meme Difficulté,Adapte
91,2015,Droit,4,Proces et Institution Juridictionnelles,2,La Trame de la Scene Judiciaire,14,92,12,QCM,0.05,0.93,94.63,9,0,9,9,9,0,1.0,100.0,Facile,Facile,0,Meme Difficulté,Pas Adapte
1202,2016,Droit,4,Proces et Institution Juridictionnelles,2,La Trame de la Scene Judiciaire,14,92,12,QCM,0.17,0.8,88.99,9,1,10,10,9,1,1.0,90.0,Facile,Facile,0,Meme Difficulté,Pas Adapte
2313,2017,Droit,4,Proces et Institution Juridictionnelles,2,La Trame de la Scene Judiciaire,14,92,12,QCU,0.56,0.37,18.59,2,9,11,10,2,8,1.1,20.0,Moyen,Difficile,-1,Plus Difficile,Pas Adapte
3424,2018,Droit,4,Proces et Institution Juridictionnelles,2,La Trame de la Scene Judiciaire,14,92,12,QCU,0.18,0.83,94.66,10,1,11,11,10,1,1.0,90.91,Facile,Facile,0,Meme Difficulté,Pas Adapte
4535,2019,Droit,4,Proces et Institution Juridictionnelles,2,La Trame de la Scene Judiciaire,14,92,12,QCU,0.05,0.88,67.43,6,3,9,7,6,1,1.29,85.71,Facile,Facile,0,Meme Difficulté,Adapte
5646,2020,Droit,4,Proces et Institution Juridictionnelles,2,La Trame de la Scene Judiciaire,14,92,12,QCU,0.02,0.76,67.43,6,3,9,8,6,2,1.12,75.0,Facile,Facile,0,Meme Difficulté,Adapte
92,2015,Droit,4,Proces et Institution Juridictionnelles,2,La Trame de la Scene Judiciaire,14,93,13,QCU,0.57,0.38,3.75,4,95,99,46,4,42,2.15,8.7,Difficile,Difficile,0,Meme Difficulté,Pas Adapte
1203,2016,Droit,4,Proces et Institution Juridictionnelles,2,La Trame de la Scene Judiciaire,14,93,13,QCU,0.43,0.24,33.65,29,57,86,41,29,12,2.1,70.73,Moyen,Difficile,-1,Plus Difficile,Pas Adapte
2314,2017,Droit,4,Proces et Institution Juridictionnelles,2,La Trame de la Scene Judiciaire,14,93,13,QCU,0.45,0.33,24.99,20,60,80,30,20,10,2.67,66.67,Facile,Difficile,-2,Beaucoup plus Difficile,Pas Adapte
3425,2018,Droit,4,Proces et Institution Juridictionnelles,2,La Trame de la Scene Judiciaire,14,93,13,QCM,0.7,0.28,10.92,9,74,83,46,9,37,1.8,19.57,Moyen,Difficile,-1,Plus Difficile,Pas Adapte
4536,2019,Droit,4,Proces et Institution Juridictionnelles,2,La Trame de la Scene Judiciaire,14,93,13,QCM,0.72,0.26,18.97,15,64,79,56,15,41,1.41,26.79,Difficile,Difficile,0,Meme Difficulté,Pas Adapte
5647,2020,Droit,4,Proces et Institution Juridictionnelles,2,La Trame de la Scene Judiciaire,14,93,13,QCM,0.72,0.26,13.78,11,72,83,59,11,48,1.41,18.64,Difficile,Difficile,0,Meme Difficulté,Pas Adapte
93,2015,Droit,4,Proces et Institution Juridictionnelles,2,La Trame de la Scene Judiciaire,14,94,14,QCM,0.63,0.24,33.06,6,13,19,17,6,11,1.12,35.29,Facile,Difficile,-2,Beaucoup plus Difficile,Pas Adapte
1204,2016,Droit,4,Proces et Institution Juridictionnelles,2,La Trame de la Scene Judiciaire,14,94,14,QCM,0.2,0.76,97.05,16,0,16,16,16,0,1.0,100.0,Moyen,Facile,1,Plus Facile,Pas Adapte
2315,2017,Droit,4,Proces et Institution Juridictionnelles,2,La Trame de la Scene Judiciaire,14,94,14,QCM,0.48,0.43,46.51,8,10,18,12,8,4,1.5,66.67,Facile,Moyen,-1,Plus Difficile,Pas Adapte
3426,2018,Droit,4,Proces et Institution Juridictionnelles,2,La Trame de la Scene Judiciaire,14,94,14,QCM,0.35,0.54,36.7,6,9,15,13,6,7,1.15,46.15,Facile,Moyen,-1,Plus Difficile,Pas Adapte
4537,2019,Droit,4,Proces et Institution Juridictionnelles,2,La Trame de la Scene Judiciaire,14,94,14,QCM,0.8,0.29,14.28,2,11,13,10,2,8,1.3,20.0,Facile,Difficile,-2,Beaucoup plus Difficile,Pas Adapte
5648,2020,Droit,4,Proces et Institution Juridictionnelles,2,La Trame de la Scene Judiciaire,14,94,14,QCU,0.63,0.38,19.45,3,12,15,13,3,10,1.15,23.08,Facile,Difficile,-2,Beaucoup plus Difficile,Pas Adapte
94,2015,Droit,4,Proces et Institution Juridictionnelles,3,Le Theatre de la Scene Judiciaire,7,95,1,QCM,0.09,0.89,97.76,72,2,74,73,72,1,1.01,98.63,Difficile,Facile,2,Beaucoup plus Facile,Pas Adapte
1205,2016,Droit,4,Proces et Institution Juridictionnelles,3,Le Theatre de la Scene Judiciaire,7,95,1,QCM,0.13,0.99,89.69,73,8,81,77,73,4,1.05,94.81,Moyen,Facile,1,Plus Facile,Pas Adapte
2316,2017,Droit,4,Proces et Institution Juridictionnelles,3,Le Theatre de la Scene Judiciaire,7,95,1,QCM,0.14,0.9,72.9,64,24,88,75,64,11,1.17,85.33,Difficile,Facile,2,Beaucoup plus Facile,Adapte
3427,2018,Droit,4,Proces et Institution Juridictionnelles,3,Le Theatre de la Scene Judiciaire,7,95,1,QCM,0.01,0.97,72.9,56,21,77,65,56,9,1.18,86.15,Facile,Facile,0,Meme Difficulté,Adapte
4538,2019,Droit,4,Proces et Institution Juridictionnelles,3,Le Theatre de la Scene Judiciaire,7,95,1,QCM,0.07,0.79,72.9,51,19,70,61,51,10,1.15,83.61,Facile,Facile,0,Meme Difficulté,Adapte
5649,2020,Droit,4,Proces et Institution Juridictionnelles,3,Le Theatre de la Scene Judiciaire,7,95,1,QCM,0.18,0.99,72.9,53,20,73,54,53,1,1.35,98.15,Facile,Facile,0,Meme Difficulté,Adapte
95,2015,Droit,4,Proces et Institution Juridictionnelles,3,Le Theatre de la Scene Judiciaire,7,96,2,QCU,0.5,0.22,29.33,9,21,30,28,9,19,1.07,32.14,Facile,Difficile,-2,Beaucoup plus Difficile,Pas Adapte
1206,2016,Droit,4,Proces et Institution Juridictionnelles,3,Le Theatre de la Scene Judiciaire,7,96,2,QCU,0.27,0.43,41.28,13,18,31,16,13,3,1.94,81.25,Moyen,Moyen,0,Meme Difficulté,Pas Adapte
2317,2017,Droit,4,Proces et Institution Juridictionnelles,3,Le Theatre de la Scene Judiciaire,7,96,2,QROC,0.0,0.94,75.72,23,7,30,24,23,1,1.25,95.83,Facile,Facile,0,Meme Difficulté,Pas Adapte
3428,2018,Droit,4,Proces et Institution Juridictionnelles,3,Le Theatre de la Scene Judiciaire,7,96,2,QROC,0.9,0.08,14.84,5,27,32,20,5,15,1.6,25.0,Facile,Difficile,-2,Beaucoup plus Difficile,Pas Adapte
4539,2019,Droit,4,Proces et Institution Juridictionnelles,3,Le Theatre de la Scene Judiciaire,7,96,2,QROC,0.09,0.98,92.25,32,3,35,33,32,1,1.06,96.97,Facile,Facile,0,Meme Difficulté,Pas Adapte
5650,2020,Droit,4,Proces et Institution Juridictionnelles,3,Le Theatre de la Scene Judiciaire,7,96,2,QROC,0.83,0.05,16.47,6,32,38,22,6,16,1.73,27.27,Moyen,Difficile,-1,Plus Difficile,Pas Adapte
96,2015,Droit,4,Proces et Institution Juridictionnelles,3,Le Theatre de la Scene Judiciaire,7,97,3,QCM,0.7,0.25,18.26,5,24,29,13,5,8,2.23,38.46,Facile,Difficile,-2,Beaucoup plus Difficile,Pas Adapte
1207,2016,Droit,4,Proces et Institution Juridictionnelles,3,Le Theatre de la Scene Judiciaire,7,97,3,QCM,0.54,0.25,31.05,9,21,30,19,9,10,1.58,47.37,Facile,Difficile,-2,Beaucoup plus Difficile,Pas Adapte
2318,2017,Droit,4,Proces et Institution Juridictionnelles,3,Le Theatre de la Scene Judiciaire,7,97,3,QCM,0.34,0.52,52.78,17,15,32,29,17,12,1.1,58.62,Moyen,Moyen,0,Meme Difficulté,Pas Adapte
3429,2018,Droit,4,Proces et Institution Juridictionnelles,3,Le Theatre de la Scene Judiciaire,7,97,3,QCM,0.38,0.68,58.76,18,12,30,24,18,6,1.25,75.0,Moyen,Moyen,0,Meme Difficulté,Pas Adapte
4540,2019,Droit,4,Proces et Institution Juridictionnelles,3,Le Theatre de la Scene Judiciaire,7,97,3,QCM,0.65,0.21,26.27,9,25,34,26,9,17,1.31,34.62,Moyen,Difficile,-1,Plus Difficile,Pas Adapte
5651,2020,Droit,4,Proces et Institution Juridictionnelles,3,Le Theatre de la Scene Judiciaire,7,97,3,QCM,0.63,0.25,20.05,7,29,36,27,7,20,1.33,25.93,Difficile,Difficile,0,Meme Difficulté,Pas Adapte
97,2015,Droit,4,Proces et Institution Juridictionnelles,3,Le Theatre de la Scene Judiciaire,7,98,4,QCU,0.51,0.34,29.07,28,68,96,32,28,4,3.0,87.5,Facile,Difficile,-2,Beaucoup plus Difficile,Pas Adapte
1208,2016,Droit,4,Proces et Institution Juridictionnelles,3,Le Theatre de la Scene Judiciaire,7,98,4,QCU,0.15,0.93,88.26,87,12,99,94,87,7,1.05,92.55,Facile,Facile,0,Meme Difficulté,Pas Adapte
2319,2017,Droit,4,Proces et Institution Juridictionnelles,3,Le Theatre de la Scene Judiciaire,7,98,4,QCU,0.32,0.45,43.87,43,56,99,57,43,14,1.74,75.44,Difficile,Moyen,1,Plus Facile,Pas Adapte
3430,2018,Droit,4,Proces et Institution Juridictionnelles,3,Le Theatre de la Scene Judiciaire,7,98,4,QCU,0.01,0.88,66.92,75,37,112,85,75,10,1.32,88.24,Difficile,Facile,2,Beaucoup plus Facile,Adapte
4541,2019,Droit,4,Proces et Institution Juridictionnelles,3,Le Theatre de la Scene Judiciaire,7,98,4,QCU,0.17,0.99,66.92,76,37,113,103,76,27,1.1,73.79,Facile,Facile,0,Meme Difficulté,Adapte
5652,2020,Droit,4,Proces et Institution Juridictionnelles,3,Le Theatre de la Scene Judiciaire,7,98,4,QCU,0.16,0.86,66.92,69,34,103,69,69,0,1.49,100.0,Facile,Facile,0,Meme Difficulté,Adapte
98,2015,Droit,4,Proces et Institution Juridictionnelles,3,Le Theatre de la Scene Judiciaire,7,99,5,QCM,0.3,0.39,39.66,3,5,8,4,3,1,2.0,75.0,Difficile,Moyen,1,Plus Facile,Pas Adapte
1209,2016,Droit,4,Proces et Institution Juridictionnelles,3,Le Theatre de la Scene Judiciaire,7,99,5,QROC,0.91,0.02,34.1,3,5,8,4,3,1,2.0,75.0,Moyen,Difficile,-1,Plus Difficile,Pas Adapte
2320,2017,Droit,4,Proces et Institution Juridictionnelles,3,Le Theatre de la Scene Judiciaire,7,99,5,QROC,0.54,0.36,38.54,3,5,8,4,3,1,2.0,75.0,Difficile,Moyen,1,Plus Facile,Pas Adapte
3431,2018,Droit,4,Proces et Institution Juridictionnelles,3,Le Theatre de la Scene Judiciaire,7,99,5,QROC,0.03,0.48,73.06,5,2,7,6,5,1,1.17,83.33,Difficile,Facile,2,Beaucoup plus Facile,Adapte
4542,2019,Droit,4,Proces et Institution Juridictionnelles,3,Le Theatre de la Scene Judiciaire,7,99,5,QROC,0.18,0.55,73.06,6,2,8,7,6,1,1.14,85.71,Facile,Facile,0,Meme Difficulté,Adapte
5653,2020,Droit,4,Proces et Institution Juridictionnelles,3,Le Theatre de la Scene Judiciaire,7,99,5,QO,0.04,0.36,73.06,7,2,9,8,7,1,1.12,87.5,Facile,Facile,0,Meme Difficulté,Adapte
99,2015,Droit,4,Proces et Institution Juridictionnelles,3,Le Theatre de la Scene Judiciaire,7,100,6,QCM,0.11,0.84,71.29,6,2,8,7,6,1,1.14,85.71,Moyen,Facile,1,Plus Facile,Adapte
1210,2016,Droit,4,Proces et Institution Juridictionnelles,3,Le Theatre de la Scene Judiciaire,7,100,6,QCM,0.2,0.74,71.29,6,2,8,7,6,1,1.14,85.71,Facile,Facile,0,Meme Difficulté,Adapte
2321,2017,Droit,4,Proces et Institution Juridictionnelles,3,Le Theatre de la Scene Judiciaire,7,100,6,QCM,0.08,0.86,71.29,6,3,9,7,6,1,1.29,85.71,Facile,Facile,0,Meme Difficulté,Adapte
3432,2018,Droit,4,Proces et Institution Juridictionnelles,3,Le Theatre de la Scene Judiciaire,7,100,6,QCM,0.06,0.9,71.29,6,3,9,6,6,0,1.5,100.0,Facile,Facile,0,Meme Difficulté,Adapte
4543,2019,Droit,4,Proces et Institution Juridictionnelles,3,Le Theatre de la Scene Judiciaire,7,100,6,QCM,0.11,0.76,71.29,6,3,9,9,6,3,1.0,66.67,Facile,Facile,0,Meme Difficulté,Adapte
5654,2020,Droit,4,Proces et Institution Juridictionnelles,3,Le Theatre de la Scene Judiciaire,7,100,6,QROC,0.09,0.49,71.29,6,2,8,8,6,2,1.0,75.0,Facile,Facile,0,Meme Difficulté,Adapte
100,2015,Droit,4,Proces et Institution Juridictionnelles,3,Le Theatre de la Scene Judiciaire,7,101,7,QCU,0.08,0.98,83.79,71,14,85,85,71,14,1.0,83.53,Moyen,Facile,1,Plus Facile,Pas Adapte
1211,2016,Droit,4,Proces et Institution Juridictionnelles,3,Le Theatre de la Scene Judiciaire,7,101,7,QCU,0.68,0.22,33.2,33,65,98,71,33,38,1.38,46.48,Difficile,Difficile,0,Meme Difficulté,Pas Adapte
2322,2017,Droit,4,Proces et Institution Juridictionnelles,3,Le Theatre de la Scene Judiciaire,7,101,7,QCU,0.19,0.75,98.08,100,2,102,101,100,1,1.01,99.01,Facile,Facile,0,Meme Difficulté,Pas Adapte
3433,2018,Droit,4,Proces et Institution Juridictionnelles,3,Le Theatre de la Scene Judiciaire,7,101,7,QCU,0.73,0.3,22.58,20,67,87,62,20,42,1.4,32.26,Facile,Difficile,-2,Beaucoup plus Difficile,Pas Adapte
4544,2019,Droit,4,Proces et Institution Juridictionnelles,3,Le Theatre de la Scene Judiciaire,7,101,7,QCU,0.13,0.92,87.51,77,11,88,81,77,4,1.09,95.06,Difficile,Facile,2,Beaucoup plus Facile,Pas Adapte
5655,2020,Droit,4,Proces et Institution Juridictionnelles,3,Le Theatre de la Scene Judiciaire,7,101,7,QCU,0.21,0.46,59.37,59,40,99,71,59,12,1.39,83.1,Facile,Moyen,-1,Plus Difficile,Pas Adapte
101,2015,Droit,5,Constitution de la Cinquieme Republique,1,"La Cinquieme Republique, une Conception du Pouvoir",6,102,1,QCM,0.47,0.42,35.82,30,55,85,36,30,6,2.36,83.33,Difficile,Moyen,1,Plus Facile,Pas Adapte
1212,2016,Droit,5,Constitution de la Cinquieme Republique,1,"La Cinquieme Republique, une Conception du Pouvoir",6,102,1,QCM,0.73,0.29,28.55,26,65,91,81,26,55,1.12,32.1,Difficile,Difficile,0,Meme Difficulté,Pas Adapte
2323,2017,Droit,5,Constitution de la Cinquieme Republique,1,"La Cinquieme Republique, une Conception du Pouvoir",6,102,1,QCM,0.15,0.86,74.85,77,26,103,86,77,9,1.2,89.53,Difficile,Facile,2,Beaucoup plus Facile,Adapte
3434,2018,Droit,5,Constitution de la Cinquieme Republique,1,"La Cinquieme Republique, une Conception du Pouvoir",6,102,1,QCM,0.04,0.77,74.85,80,27,107,88,80,8,1.22,90.91,Facile,Facile,0,Meme Difficulté,Adapte
4545,2019,Droit,5,Constitution de la Cinquieme Republique,1,"La Cinquieme Republique, une Conception du Pouvoir",6,102,1,QCM,0.08,0.85,74.85,69,23,92,80,69,11,1.15,86.25,Facile,Facile,0,Meme Difficulté,Adapte
5656,2020,Droit,5,Constitution de la Cinquieme Republique,1,"La Cinquieme Republique, une Conception du Pouvoir",6,102,1,QCM,0.02,0.86,74.85,66,22,88,68,66,2,1.29,97.06,Facile,Facile,0,Meme Difficulté,Adapte
102,2015,Droit,5,Constitution de la Cinquieme Republique,1,"La Cinquieme Republique, une Conception du Pouvoir",6,103,2,QCU,0.46,0.27,14.47,13,74,87,45,13,32,1.93,28.89,Moyen,Difficile,-1,Plus Difficile,Pas Adapte
1213,2016,Droit,5,Constitution de la Cinquieme Republique,1,"La Cinquieme Republique, une Conception du Pouvoir",6,103,2,QCU,0.49,0.37,28.86,25,63,88,72,25,47,1.22,34.72,Facile,Difficile,-2,Beaucoup plus Difficile,Pas Adapte
2324,2017,Droit,5,Constitution de la Cinquieme Republique,1,"La Cinquieme Republique, une Conception du Pouvoir",6,103,2,QCU,0.49,0.27,14.38,14,80,94,32,14,18,2.94,43.75,Difficile,Difficile,0,Meme Difficulté,Pas Adapte
3435,2018,Droit,5,Constitution de la Cinquieme Republique,1,"La Cinquieme Republique, une Conception du Pouvoir",6,103,2,QCU,0.11,0.91,91.77,99,9,108,100,99,1,1.08,99.0,Difficile,Facile,2,Beaucoup plus Facile,Pas Adapte
4546,2019,Droit,5,Constitution de la Cinquieme Republique,1,"La Cinquieme Republique, une Conception du Pouvoir",6,103,2,QCU,0.12,0.97,89.64,103,12,115,110,103,7,1.05,93.64,Moyen,Facile,1,Plus Facile,Pas Adapte
5657,2020,Droit,5,Constitution de la Cinquieme Republique,1,"La Cinquieme Republique, une Conception du Pouvoir",6,103,2,QCU,0.24,0.74,57.5,75,55,130,114,75,39,1.14,65.79,Facile,Moyen,-1,Plus Difficile,Pas Adapte
103,2015,Droit,5,Constitution de la Cinquieme Republique,1,"La Cinquieme Republique, une Conception du Pouvoir",6,104,3,QROC,0.93,0.12,16.55,5,28,33,19,5,14,1.74,26.32,Difficile,Difficile,0,Meme Difficulté,Pas Adapte
1214,2016,Droit,5,Constitution de la Cinquieme Republique,1,"La Cinquieme Republique, une Conception du Pouvoir",6,104,3,QROC,0.5,0.37,39.44,14,22,36,20,14,6,1.8,70.0,Moyen,Moyen,0,Meme Difficulté,Pas Adapte
2325,2017,Droit,5,Constitution de la Cinquieme Republique,1,"La Cinquieme Republique, une Conception du Pouvoir",6,104,3,QROC,0.02,0.75,65.47,25,13,38,36,25,11,1.06,69.44,Difficile,Facile,2,Beaucoup plus Facile,Adapte
3436,2018,Droit,5,Constitution de la Cinquieme Republique,1,"La Cinquieme Republique, une Conception du Pouvoir",6,104,3,QROC,0.08,0.53,65.47,25,13,38,35,25,10,1.09,71.43,Facile,Facile,0,Meme Difficulté,Adapte
4547,2019,Droit,5,Constitution de la Cinquieme Republique,1,"La Cinquieme Republique, une Conception du Pouvoir",6,104,3,QROC,0.16,0.43,65.47,25,13,38,26,25,1,1.46,96.15,Facile,Facile,0,Meme Difficulté,Adapte
5658,2020,Droit,5,Constitution de la Cinquieme Republique,1,"La Cinquieme Republique, une Conception du Pouvoir",6,104,3,QROC,0.15,0.44,65.47,24,13,37,30,24,6,1.23,80.0,Facile,Facile,0,Meme Difficulté,Adapte
104,2015,Droit,5,Constitution de la Cinquieme Republique,1,"La Cinquieme Republique, une Conception du Pouvoir",6,105,4,QCM,0.57,0.15,13.44,3,23,26,14,3,11,1.86,21.43,Facile,Difficile,-2,Beaucoup plus Difficile,Pas Adapte
1215,2016,Droit,5,Constitution de la Cinquieme Republique,1,"La Cinquieme Republique, une Conception du Pouvoir",6,105,4,QCM,0.05,0.71,94.46,27,2,29,29,27,2,1.0,93.1,Difficile,Facile,2,Beaucoup plus Facile,Pas Adapte
2326,2017,Droit,5,Constitution de la Cinquieme Republique,1,"La Cinquieme Republique, une Conception du Pouvoir",6,105,4,QCM,0.15,0.96,96.87,31,1,32,31,31,0,1.03,100.0,Difficile,Facile,2,Beaucoup plus Facile,Pas Adapte
3437,2018,Droit,5,Constitution de la Cinquieme Republique,1,"La Cinquieme Republique, une Conception du Pouvoir",6,105,4,QCM,0.48,0.3,57.8,16,12,28,20,16,4,1.4,80.0,Moyen,Moyen,0,Meme Difficulté,Pas Adapte
4548,2019,Droit,5,Constitution de la Cinquieme Republique,1,"La Cinquieme Republique, une Conception du Pouvoir",6,105,4,QCM,0.67,0.23,14.13,5,27,32,11,5,6,2.91,45.45,Facile,Difficile,-2,Beaucoup plus Difficile,Pas Adapte
5659,2020,Droit,5,Constitution de la Cinquieme Republique,1,"La Cinquieme Republique, une Conception du Pouvoir",6,105,4,QCM,0.48,0.4,62.11,21,13,34,24,21,3,1.42,87.5,Moyen,Moyen,0,Meme Difficulté,Pas Adapte
105,2015,Droit,5,Constitution de la Cinquieme Republique,1,"La Cinquieme Republique, une Conception du Pouvoir",6,106,5,QCU,0.01,0.79,68.78,20,9,29,28,20,8,1.04,71.43,Facile,Facile,0,Meme Difficulté,Adapte
1216,2016,Droit,5,Constitution de la Cinquieme Republique,1,"La Cinquieme Republique, une Conception du Pouvoir",6,106,5,QCU,0.19,0.99,68.78,23,10,33,26,23,3,1.27,88.46,Facile,Facile,0,Meme Difficulté,Adapte
2327,2017,Droit,5,Constitution de la Cinquieme Republique,1,"La Cinquieme Republique, une Conception du Pouvoir",6,106,5,QCU,0.03,0.88,68.78,24,11,35,33,24,9,1.06,72.73,Facile,Facile,0,Meme Difficulté,Adapte
3438,2018,Droit,5,Constitution de la Cinquieme Republique,1,"La Cinquieme Republique, une Conception du Pouvoir",6,106,5,QCU,0.17,0.8,68.78,24,11,35,34,24,10,1.03,70.59,Facile,Facile,0,Meme Difficulté,Adapte
4549,2019,Droit,5,Constitution de la Cinquieme Republique,1,"La Cinquieme Republique, une Conception du Pouvoir",6,106,5,QCU,0.17,0.83,68.78,28,12,40,34,28,6,1.18,82.35,Facile,Facile,0,Meme Difficulté,Adapte
5660,2020,Droit,5,Constitution de la Cinquieme Republique,1,"La Cinquieme Republique, une Conception du Pouvoir",6,106,5,QO,0.05,0.69,68.78,25,11,36,26,25,1,1.38,96.15,Facile,Facile,0,Meme Difficulté,Adapte
106,2015,Droit,5,Constitution de la Cinquieme Republique,1,"La Cinquieme Republique, une Conception du Pouvoir",6,107,6,QCU,0.37,0.56,43.14,20,26,46,23,20,3,2.0,86.96,Moyen,Moyen,0,Meme Difficulté,Pas Adapte
1217,2016,Droit,5,Constitution de la Cinquieme Republique,1,"La Cinquieme Republique, une Conception du Pouvoir",6,107,6,QCU,0.01,0.89,89.79,48,5,53,52,48,4,1.02,92.31,Moyen,Facile,1,Plus Facile,Pas Adapte
2328,2017,Droit,5,Constitution de la Cinquieme Republique,1,"La Cinquieme Republique, une Conception du Pouvoir",6,107,6,QCU,0.22,0.47,62.31,31,18,49,41,31,10,1.2,75.61,Moyen,Moyen,0,Meme Difficulté,Pas Adapte
3439,2018,Droit,5,Constitution de la Cinquieme Republique,1,"La Cinquieme Republique, une Conception du Pouvoir",6,107,6,QCU,0.26,0.58,36.36,16,28,44,41,16,25,1.07,39.02,Moyen,Moyen,0,Meme Difficulté,Pas Adapte
4550,2019,Droit,5,Constitution de la Cinquieme Republique,1,"La Cinquieme Republique, une Conception du Pouvoir",6,107,6,QCU,0.72,0.32,31.83,12,27,39,19,12,7,2.05,63.16,Facile,Difficile,-2,Beaucoup plus Difficile,Pas Adapte
5661,2020,Droit,5,Constitution de la Cinquieme Republique,1,"La Cinquieme Republique, une Conception du Pouvoir",6,107,6,QCU,0.1,0.94,67.68,22,11,33,27,22,5,1.22,81.48,Moyen,Facile,1,Plus Facile,Adapte
107,2015,Droit,5,Constitution de la Cinquieme Republique,2,Le Pouvoir Gouvernant,13,108,1,QROC,0.16,0.78,95.85,11,0,11,11,11,0,1.0,100.0,Facile,Facile,0,Meme Difficulté,Pas Adapte
1218,2016,Droit,5,Constitution de la Cinquieme Republique,2,Le Pouvoir Gouvernant,13,108,1,QROC,0.64,0.08,30.34,4,9,13,7,4,3,1.86,57.14,Facile,Difficile,-2,Beaucoup plus Difficile,Pas Adapte
2329,2017,Droit,5,Constitution de la Cinquieme Republique,2,Le Pouvoir Gouvernant,13,108,1,QO,0.29,0.29,40.76,5,8,13,12,5,7,1.08,41.67,Facile,Moyen,-1,Plus Difficile,Pas Adapte
3440,2018,Droit,5,Constitution de la Cinquieme Republique,2,Le Pouvoir Gouvernant,13,108,1,QO,0.9,0.11,14.69,2,9,11,10,2,8,1.1,20.0,Moyen,Difficile,-1,Plus Difficile,Pas Adapte
4551,2019,Droit,5,Constitution de la Cinquieme Republique,2,Le Pouvoir Gouvernant,13,108,1,QO,0.06,0.99,86.18,11,2,13,13,11,2,1.0,84.62,Moyen,Facile,1,Plus Facile,Pas Adapte
5662,2020,Droit,5,Constitution de la Cinquieme Republique,2,Le Pouvoir Gouvernant,13,108,1,QO,0.1,0.48,92.11,11,1,12,11,11,0,1.09,100.0,Moyen,Facile,1,Plus Facile,Pas Adapte
108,2015,Droit,5,Constitution de la Cinquieme Republique,2,Le Pouvoir Gouvernant,13,109,2,QROC,0.18,0.48,91.09,36,4,40,38,36,2,1.05,94.74,Difficile,Facile,2,Beaucoup plus Facile,Pas Adapte
1219,2016,Droit,5,Constitution de la Cinquieme Republique,2,Le Pouvoir Gouvernant,13,109,2,QROC,0.12,0.42,71.9,27,10,37,27,27,0,1.37,100.0,Difficile,Facile,2,Beaucoup plus Facile,Adapte
2330,2017,Droit,5,Constitution de la Cinquieme Republique,2,Le Pouvoir Gouvernant,13,109,2,QO,0.18,0.65,71.9,28,11,39,30,28,2,1.3,93.33,Facile,Facile,0,Meme Difficulté,Adapte
3441,2018,Droit,5,Constitution de la Cinquieme Republique,2,Le Pouvoir Gouvernant,13,109,2,QO,0.07,0.35,71.9,28,11,39,33,28,5,1.18,84.85,Facile,Facile,0,Meme Difficulté,Adapte
4552,2019,Droit,5,Constitution de la Cinquieme Republique,2,Le Pouvoir Gouvernant,13,109,2,QO,0.16,0.69,71.9,27,11,38,29,27,2,1.31,93.1,Facile,Facile,0,Meme Difficulté,Adapte
5663,2020,Droit,5,Constitution de la Cinquieme Republique,2,Le Pouvoir Gouvernant,13,109,2,QO,0.1,0.94,71.9,24,9,33,26,24,2,1.27,92.31,Facile,Facile,0,Meme Difficulté,Adapte
109,2015,Droit,5,Constitution de la Cinquieme Republique,2,Le Pouvoir Gouvernant,13,110,3,QCU,0.34,0.45,59.4,5,4,9,9,5,4,1.0,55.56,Difficile,Moyen,1,Plus Facile,Pas Adapte
1220,2016,Droit,5,Constitution de la Cinquieme Republique,2,Le Pouvoir Gouvernant,13,110,3,QCU,0.42,0.35,12.45,1,7,8,7,1,6,1.14,14.29,Facile,Difficile,-2,Beaucoup plus Difficile,Pas Adapte
2331,2017,Droit,5,Constitution de la Cinquieme Republique,2,Le Pouvoir Gouvernant,13,110,3,QCU,0.53,0.35,30.52,2,5,7,6,2,4,1.17,33.33,Facile,Difficile,-2,Beaucoup plus Difficile,Pas Adapte
3442,2018,Droit,5,Constitution de la Cinquieme Republique,2,Le Pouvoir Gouvernant,13,110,3,QCM,0.11,0.97,97.41,8,0,8,8,8,0,1.0,100.0,Facile,Facile,0,Meme Difficulté,Pas Adapte
4553,2019,Droit,5,Constitution de la Cinquieme Republique,2,Le Pouvoir Gouvernant,13,110,3,QCM,0.09,1.0,83.87,7,1,8,8,7,1,1.0,87.5,Difficile,Facile,2,Beaucoup plus Facile,Pas Adapte
5664,2020,Droit,5,Constitution de la Cinquieme Republique,2,Le Pouvoir Gouvernant,13,110,3,QCM,0.01,0.71,96.97,7,0,7,7,7,0,1.0,100.0,Facile,Facile,0,Meme Difficulté,Pas Adapte
110,2015,Droit,5,Constitution de la Cinquieme Republique,2,Le Pouvoir Gouvernant,13,111,4,QROC,0.69,0.05,22.61,13,46,59,27,13,14,2.19,48.15,Moyen,Difficile,-1,Plus Difficile,Pas Adapte
1221,2016,Droit,5,Constitution de la Cinquieme Republique,2,Le Pouvoir Gouvernant,13,111,4,QROC,0.29,0.39,57.62,35,25,60,51,35,16,1.18,68.63,Difficile,Moyen,1,Plus Facile,Pas Adapte
2332,2017,Droit,5,Constitution de la Cinquieme Republique,2,Le Pouvoir Gouvernant,13,111,4,QROC,0.08,0.92,79.94,42,10,52,43,42,1,1.21,97.67,Facile,Facile,0,Meme Difficulté,Pas Adapte
3443,2018,Droit,5,Constitution de la Cinquieme Republique,2,Le Pouvoir Gouvernant,13,111,4,QROC,0.85,0.07,6.96,3,44,47,28,3,25,1.68,10.71,Facile,Difficile,-2,Beaucoup plus Difficile,Pas Adapte
4554,2019,Droit,5,Constitution de la Cinquieme Republique,2,Le Pouvoir Gouvernant,13,111,4,QROC,0.13,0.95,81.18,34,8,42,38,34,4,1.11,89.47,Difficile,Facile,2,Beaucoup plus Facile,Pas Adapte
5665,2020,Droit,5,Constitution de la Cinquieme Republique,2,Le Pouvoir Gouvernant,13,111,4,QROC,0.78,0.15,21.2,9,33,42,20,9,11,2.1,45.0,Difficile,Difficile,0,Meme Difficulté,Pas Adapte
111,2015,Droit,5,Constitution de la Cinquieme Republique,2,Le Pouvoir Gouvernant,13,112,5,QCM,0.42,0.59,63.25,4,3,7,5,4,1,1.4,80.0,Facile,Moyen,-1,Plus Difficile,Pas Adapte
1222,2016,Droit,5,Constitution de la Cinquieme Republique,2,Le Pouvoir Gouvernant,13,112,5,QCU,0.15,0.97,68.59,5,2,7,6,5,1,1.17,83.33,Facile,Facile,0,Meme Difficulté,Adapte
2333,2017,Droit,5,Constitution de la Cinquieme Republique,2,Le Pouvoir Gouvernant,13,112,5,QCU,0.1,0.94,68.59,4,2,6,4,4,0,1.5,100.0,Facile,Facile,0,Meme Difficulté,Adapte
3444,2018,Droit,5,Constitution de la Cinquieme Republique,2,Le Pouvoir Gouvernant,13,112,5,QCU,0.04,0.79,68.59,3,2,5,3,3,0,1.67,100.0,Facile,Facile,0,Meme Difficulté,Adapte
4555,2019,Droit,5,Constitution de la Cinquieme Republique,2,Le Pouvoir Gouvernant,13,112,5,QCU,0.02,0.8,68.59,4,2,6,5,4,1,1.2,80.0,Facile,Facile,0,Meme Difficulté,Adapte
5666,2020,Droit,5,Constitution de la Cinquieme Republique,2,Le Pouvoir Gouvernant,13,112,5,QCU,0.07,0.92,68.59,3,2,5,5,3,2,1.0,60.0,Facile,Facile,0,Meme Difficulté,Adapte
112,2015,Droit,5,Constitution de la Cinquieme Republique,2,Le Pouvoir Gouvernant,13,113,6,QROC,0.55,0.25,38.31,17,28,45,34,17,17,1.32,50.0,Moyen,Moyen,0,Meme Difficulté,Pas Adapte
1223,2016,Droit,5,Constitution de la Cinquieme Republique,2,Le Pouvoir Gouvernant,13,113,6,QROC,0.3,0.31,63.94,27,16,43,35,27,8,1.23,77.14,Facile,Moyen,-1,Plus Difficile,Pas Adapte
2334,2017,Droit,5,Constitution de la Cinquieme Republique,2,Le Pouvoir Gouvernant,13,113,6,QROC,0.73,0.06,30.69,13,28,41,37,13,24,1.11,35.14,Moyen,Difficile,-1,Plus Difficile,Pas Adapte
3445,2018,Droit,5,Constitution de la Cinquieme Republique,2,Le Pouvoir Gouvernant,13,113,6,QCM,0.62,0.2,17.76,7,34,41,13,7,6,3.15,53.85,Difficile,Difficile,0,Meme Difficulté,Pas Adapte
4556,2019,Droit,5,Constitution de la Cinquieme Republique,2,Le Pouvoir Gouvernant,13,113,6,QCM,0.01,0.7,71.41,32,13,45,43,32,11,1.05,74.42,Facile,Facile,0,Meme Difficulté,Adapte
5667,2020,Droit,5,Constitution de la Cinquieme Republique,2,Le Pouvoir Gouvernant,13,113,6,QCM,0.16,0.84,71.41,29,12,41,32,29,3,1.28,90.62,Facile,Facile,0,Meme Difficulté,Adapte
113,2015,Droit,5,Constitution de la Cinquieme Republique,2,Le Pouvoir Gouvernant,13,114,7,QCU,0.72,0.38,23.08,20,67,87,83,20,63,1.05,24.1,Moyen,Difficile,-1,Plus Difficile,Pas Adapte
1224,2016,Droit,5,Constitution de la Cinquieme Republique,2,Le Pouvoir Gouvernant,13,114,7,QCU,0.17,0.88,89.65,75,9,84,78,75,3,1.08,96.15,Facile,Facile,0,Meme Difficulté,Pas Adapte
2335,2017,Droit,5,Constitution de la Cinquieme Republique,2,Le Pouvoir Gouvernant,13,114,7,QCU,0.1,0.87,87.37,63,9,72,64,63,1,1.12,98.44,Facile,Facile,0,Meme Difficulté,Pas Adapte
3446,2018,Droit,5,Constitution de la Cinquieme Republique,2,Le Pouvoir Gouvernant,13,114,7,QCU,0.08,0.96,78.69,62,17,79,67,62,5,1.18,92.54,Moyen,Facile,1,Plus Facile,Pas Adapte
4557,2019,Droit,5,Constitution de la Cinquieme Republique,2,Le Pouvoir Gouvernant,13,114,7,QCU,0.05,0.8,90.01,74,8,82,81,74,7,1.01,91.36,Facile,Facile,0,Meme Difficulté,Pas Adapte
5668,2020,Droit,5,Constitution de la Cinquieme Republique,2,Le Pouvoir Gouvernant,13,114,7,QCU,0.2,0.81,86.87,75,11,86,79,75,4,1.09,94.94,Moyen,Facile,1,Plus Facile,Pas Adapte
114,2015,Droit,5,Constitution de la Cinquieme Republique,2,Le Pouvoir Gouvernant,13,115,8,QCU,0.55,0.33,12.46,6,40,46,27,6,21,1.7,22.22,Facile,Difficile,-2,Beaucoup plus Difficile,Pas Adapte
1225,2016,Droit,5,Constitution de la Cinquieme Republique,2,Le Pouvoir Gouvernant,13,115,8,QCU,0.18,0.93,74.29,38,13,51,39,38,1,1.31,97.44,Moyen,Facile,1,Plus Facile,Adapte
2336,2017,Droit,5,Constitution de la Cinquieme Republique,2,Le Pouvoir Gouvernant,13,115,8,QCU,0.1,0.94,74.29,42,14,56,44,42,2,1.27,95.45,Facile,Facile,0,Meme Difficulté,Adapte
3447,2018,Droit,5,Constitution de la Cinquieme Republique,2,Le Pouvoir Gouvernant,13,115,8,QROC,0.13,0.83,74.29,38,13,51,46,38,8,1.11,82.61,Facile,Facile,0,Meme Difficulté,Adapte
4558,2019,Droit,5,Constitution de la Cinquieme Republique,2,Le Pouvoir Gouvernant,13,115,8,QROC,0.11,0.52,74.29,36,12,48,39,36,3,1.23,92.31,Facile,Facile,0,Meme Difficulté,Adapte
5669,2020,Droit,5,Constitution de la Cinquieme Republique,2,Le Pouvoir Gouvernant,13,115,8,QROC,0.08,0.57,74.29,36,13,49,42,36,6,1.17,85.71,Facile,Facile,0,Meme Difficulté,Adapte
115,2015,Droit,5,Constitution de la Cinquieme Republique,2,Le Pouvoir Gouvernant,13,116,9,QCU,0.7,0.31,23.51,8,28,36,22,8,14,1.64,36.36,Moyen,Difficile,-1,Plus Difficile,Pas Adapte
1226,2016,Droit,5,Constitution de la Cinquieme Republique,2,Le Pouvoir Gouvernant,13,116,9,QCU,0.09,0.87,82.34,32,7,39,37,32,5,1.05,86.49,Facile,Facile,0,Meme Difficulté,Pas Adapte
2337,2017,Droit,5,Constitution de la Cinquieme Republique,2,Le Pouvoir Gouvernant,13,116,9,QCU,0.3,0.55,46.58,18,21,39,22,18,4,1.77,81.82,Difficile,Moyen,1,Plus Facile,Pas Adapte
3448,2018,Droit,5,Constitution de la Cinquieme Republique,2,Le Pouvoir Gouvernant,13,116,9,QCU,0.42,0.3,27.53,9,25,34,15,9,6,2.27,60.0,Difficile,Difficile,0,Meme Difficulté,Pas Adapte
4559,2019,Droit,5,Constitution de la Cinquieme Republique,2,Le Pouvoir Gouvernant,13,116,9,QROC,0.18,0.96,96.92,28,1,29,28,28,0,1.04,100.0,Moyen,Facile,1,Plus Facile,Pas Adapte
5670,2020,Droit,5,Constitution de la Cinquieme Republique,2,Le Pouvoir Gouvernant,13,116,9,QROC,0.67,0.09,11.93,3,26,29,15,3,12,1.93,20.0,Moyen,Difficile,-1,Plus Difficile,Pas Adapte
116,2015,Droit,5,Constitution de la Cinquieme Republique,2,Le Pouvoir Gouvernant,13,117,10,QCU,0.19,1.0,99.15,10,0,10,10,10,0,1.0,100.0,Moyen,Facile,1,Plus Facile,Pas Adapte
1227,2016,Droit,5,Constitution de la Cinquieme Republique,2,Le Pouvoir Gouvernant,13,117,10,QCU,0.28,0.48,42.58,5,6,11,9,5,4,1.22,55.56,Moyen,Moyen,0,Meme Difficulté,Pas Adapte
2338,2017,Droit,5,Constitution de la Cinquieme Republique,2,Le Pouvoir Gouvernant,13,117,10,QCU,0.4,0.47,42.52,4,6,10,6,4,2,1.67,66.67,Facile,Moyen,-1,Plus Difficile,Pas Adapte
3449,2018,Droit,5,Constitution de la Cinquieme Republique,2,Le Pouvoir Gouvernant,13,117,10,QCU,0.45,0.33,25.53,2,7,9,6,2,4,1.5,33.33,Facile,Difficile,-2,Beaucoup plus Difficile,Pas Adapte
4560,2019,Droit,5,Constitution de la Cinquieme Republique,2,Le Pouvoir Gouvernant,13,117,10,QCU,0.67,0.23,13.9,1,8,9,8,1,7,1.12,12.5,Facile,Difficile,-2,Beaucoup plus Difficile,Pas Adapte
5671,2020,Droit,5,Constitution de la Cinquieme Republique,2,Le Pouvoir Gouvernant,13,117,10,QCU,0.52,0.32,12.02,1,9,10,5,1,4,2.0,20.0,Facile,Difficile,-2,Beaucoup plus Difficile,Pas Adapte
117,2015,Droit,5,Constitution de la Cinquieme Republique,2,Le Pouvoir Gouvernant,13,118,11,QROC,0.42,0.31,59.75,27,19,46,32,27,5,1.44,84.38,Moyen,Moyen,0,Meme Difficulté,Pas Adapte
1228,2016,Droit,5,Constitution de la Cinquieme Republique,2,Le Pouvoir Gouvernant,13,118,11,QROC,0.06,0.7,95.1,40,2,42,42,40,2,1.0,95.24,Moyen,Facile,1,Plus Facile,Pas Adapte
2339,2017,Droit,5,Constitution de la Cinquieme Republique,2,Le Pouvoir Gouvernant,13,118,11,QROC,0.04,0.76,80.96,31,7,38,36,31,5,1.06,86.11,Difficile,Facile,2,Beaucoup plus Facile,Pas Adapte
3450,2018,Droit,5,Constitution de la Cinquieme Republique,2,Le Pouvoir Gouvernant,13,118,11,QROC,0.21,0.34,38.25,15,25,40,19,15,4,2.11,78.95,Moyen,Moyen,0,Meme Difficulté,Pas Adapte
4561,2019,Droit,5,Constitution de la Cinquieme Republique,2,Le Pouvoir Gouvernant,13,118,11,QROC,0.94,0.25,10.1,4,35,39,39,4,35,1.0,10.26,Difficile,Difficile,0,Meme Difficulté,Pas Adapte
5672,2020,Droit,5,Constitution de la Cinquieme Republique,2,Le Pouvoir Gouvernant,13,118,11,QROC,0.23,0.32,35.26,13,24,37,24,13,11,1.54,54.17,Moyen,Moyen,0,Meme Difficulté,Pas Adapte
118,2015,Droit,5,Constitution de la Cinquieme Republique,2,Le Pouvoir Gouvernant,13,119,12,QO,0.08,0.5,80.33,62,15,77,65,62,3,1.18,95.38,Difficile,Facile,2,Beaucoup plus Facile,Pas Adapte
1229,2016,Droit,5,Constitution de la Cinquieme Republique,2,Le Pouvoir Gouvernant,13,119,12,QO,0.57,0.29,62.9,50,29,79,62,50,12,1.27,80.65,Facile,Moyen,-1,Plus Difficile,Pas Adapte
2340,2017,Droit,5,Constitution de la Cinquieme Republique,2,Le Pouvoir Gouvernant,13,119,12,QO,0.3,0.25,50.39,44,44,88,82,44,38,1.07,53.66,Difficile,Moyen,1,Plus Facile,Pas Adapte
3451,2018,Droit,5,Constitution de la Cinquieme Republique,2,Le Pouvoir Gouvernant,13,119,12,QO,0.08,0.35,69.43,60,27,87,73,60,13,1.19,82.19,Moyen,Facile,1,Plus Facile,Adapte
4562,2019,Droit,5,Constitution de la Cinquieme Republique,2,Le Pouvoir Gouvernant,13,119,12,QO,0.06,0.45,69.43,57,25,82,73,57,16,1.12,78.08,Facile,Facile,0,Meme Difficulté,Adapte
5673,2020,Droit,5,Constitution de la Cinquieme Republique,2,Le Pouvoir Gouvernant,13,119,12,QO,0.08,0.96,69.43,56,24,80,76,56,20,1.05,73.68,Facile,Facile,0,Meme Difficulté,Adapte
119,2015,Droit,5,Constitution de la Cinquieme Republique,2,Le Pouvoir Gouvernant,13,120,13,QCU,0.37,0.7,52.93,37,32,69,63,37,26,1.1,58.73,Moyen,Moyen,0,Meme Difficulté,Pas Adapte
1230,2016,Droit,5,Constitution de la Cinquieme Republique,2,Le Pouvoir Gouvernant,13,120,13,QCM,0.34,0.31,57.67,40,29,69,51,40,11,1.35,78.43,Difficile,Moyen,1,Plus Facile,Pas Adapte
2341,2017,Droit,5,Constitution de la Cinquieme Republique,2,Le Pouvoir Gouvernant,13,120,13,QCM,0.27,0.7,51.6,32,30,62,36,32,4,1.72,88.89,Difficile,Moyen,1,Plus Facile,Pas Adapte
3452,2018,Droit,5,Constitution de la Cinquieme Republique,2,Le Pouvoir Gouvernant,13,120,13,QCM,0.08,1.0,84.67,58,10,68,62,58,4,1.1,93.55,Facile,Facile,0,Meme Difficulté,Pas Adapte
4563,2019,Droit,5,Constitution de la Cinquieme Republique,2,Le Pouvoir Gouvernant,13,120,13,QROC,0.91,0.2,30.6,24,54,78,57,24,33,1.37,42.11,Facile,Difficile,-2,Beaucoup plus Difficile,Pas Adapte
5674,2020,Droit,5,Constitution de la Cinquieme Republique,2,Le Pouvoir Gouvernant,13,120,13,QROC,0.62,0.12,28.28,25,63,88,49,25,24,1.8,51.02,Difficile,Difficile,0,Meme Difficulté,Pas Adapte
120,2015,Droit,5,Constitution de la Cinquieme Republique,3,Le Pouvoir Legislatif,7,121,1,QCM,0.68,0.23,17.92,2,11,13,11,2,9,1.18,18.18,Facile,Difficile,-2,Beaucoup plus Difficile,Pas Adapte
1231,2016,Droit,5,Constitution de la Cinquieme Republique,3,Le Pouvoir Legislatif,7,121,1,QCM,0.14,0.95,77.55,10,3,13,10,10,0,1.3,100.0,Difficile,Facile,2,Beaucoup plus Facile,Pas Adapte
2342,2017,Droit,5,Constitution de la Cinquieme Republique,3,Le Pouvoir Legislatif,7,121,1,QCM,0.61,0.22,28.72,4,10,14,11,4,7,1.27,36.36,Facile,Difficile,-2,Beaucoup plus Difficile,Pas Adapte
3453,2018,Droit,5,Constitution de la Cinquieme Republique,3,Le Pouvoir Legislatif,7,121,1,QCU,0.0,0.95,99.85,16,0,16,16,16,0,1.0,100.0,Moyen,Facile,1,Plus Facile,Pas Adapte
4564,2019,Droit,5,Constitution de la Cinquieme Republique,3,Le Pouvoir Legislatif,7,121,1,QCU,0.22,0.44,57.75,9,6,15,11,9,2,1.36,81.82,Difficile,Moyen,1,Plus Facile,Pas Adapte
5675,2020,Droit,5,Constitution de la Cinquieme Republique,3,Le Pouvoir Legislatif,7,121,1,QROC,0.21,0.33,37.96,5,9,14,11,5,6,1.27,45.45,Difficile,Moyen,1,Plus Facile,Pas Adapte
121,2015,Droit,5,Constitution de la Cinquieme Republique,3,Le Pouvoir Legislatif,7,122,2,QCM,0.38,0.38,53.73,52,44,96,81,52,29,1.19,64.2,Difficile,Moyen,1,Plus Facile,Pas Adapte
1232,2016,Droit,5,Constitution de la Cinquieme Republique,3,Le Pouvoir Legislatif,7,122,2,QCM,0.42,0.58,61.49,55,35,90,56,55,1,1.61,98.21,Difficile,Moyen,1,Plus Facile,Pas Adapte
2343,2017,Droit,5,Constitution de la Cinquieme Republique,3,Le Pouvoir Legislatif,7,122,2,QROC,0.89,0.08,20.83,20,74,94,69,20,49,1.36,28.99,Moyen,Difficile,-1,Plus Difficile,Pas Adapte
3454,2018,Droit,5,Constitution de la Cinquieme Republique,3,Le Pouvoir Legislatif,7,122,2,QROC,0.54,0.39,38.25,41,67,108,59,41,18,1.83,69.49,Moyen,Moyen,0,Meme Difficulté,Pas Adapte
4565,2019,Droit,5,Constitution de la Cinquieme Republique,3,Le Pouvoir Legislatif,7,122,2,QROC,0.29,0.31,36.87,39,67,106,48,39,9,2.21,81.25,Facile,Moyen,-1,Plus Difficile,Pas Adapte
5676,2020,Droit,5,Constitution de la Cinquieme Republique,3,Le Pouvoir Legislatif,7,122,2,QROC,0.38,0.38,46.36,46,53,99,60,46,14,1.65,76.67,Difficile,Moyen,1,Plus Facile,Pas Adapte
122,2015,Droit,5,Constitution de la Cinquieme Republique,3,Le Pouvoir Legislatif,7,123,3,QCU,0.33,0.52,43.06,4,6,10,8,4,4,1.25,50.0,Difficile,Moyen,1,Plus Facile,Pas Adapte
1233,2016,Droit,5,Constitution de la Cinquieme Republique,3,Le Pouvoir Legislatif,7,123,3,QCU,0.27,0.58,49.14,4,4,8,8,4,4,1.0,50.0,Facile,Moyen,-1,Plus Difficile,Pas Adapte
2344,2017,Droit,5,Constitution de la Cinquieme Republique,3,Le Pouvoir Legislatif,7,123,3,QCU,0.28,0.49,57.9,5,3,8,6,5,1,1.33,83.33,Moyen,Moyen,0,Meme Difficulté,Pas Adapte
3455,2018,Droit,5,Constitution de la Cinquieme Republique,3,Le Pouvoir Legislatif,7,123,3,QCU,0.09,0.98,66.3,6,3,9,7,6,1,1.29,85.71,Facile,Facile,0,Meme Difficulté,Adapte
4566,2019,Droit,5,Constitution de la Cinquieme Republique,3,Le Pouvoir Legislatif,7,123,3,QCU,0.12,0.96,66.3,6,3,9,7,6,1,1.29,85.71,Facile,Facile,0,Meme Difficulté,Adapte
5677,2020,Droit,5,Constitution de la Cinquieme Republique,3,Le Pouvoir Legislatif,7,123,3,QCU,0.12,0.99,66.3,5,3,8,7,5,2,1.14,71.43,Facile,Facile,0,Meme Difficulté,Adapte
123,2015,Droit,5,Constitution de la Cinquieme Republique,3,Le Pouvoir Legislatif,7,124,4,QCM,0.16,0.76,86.84,59,9,68,60,59,1,1.13,98.33,Facile,Facile,0,Meme Difficulté,Pas Adapte
1234,2016,Droit,5,Constitution de la Cinquieme Republique,3,Le Pouvoir Legislatif,7,124,4,QROC,0.11,0.46,93.16,73,5,78,74,73,1,1.05,98.65,Difficile,Facile,2,Beaucoup plus Facile,Pas Adapte
2345,2017,Droit,5,Constitution de la Cinquieme Republique,3,Le Pouvoir Legislatif,7,124,4,QROC,0.86,0.09,11.76,8,58,66,47,8,39,1.4,17.02,Facile,Difficile,-2,Beaucoup plus Difficile,Pas Adapte
3456,2018,Droit,5,Constitution de la Cinquieme Republique,3,Le Pouvoir Legislatif,7,124,4,QROC,0.62,0.09,22.54,14,48,62,38,14,24,1.63,36.84,Difficile,Difficile,0,Meme Difficulté,Pas Adapte
4567,2019,Droit,5,Constitution de la Cinquieme Republique,3,Le Pouvoir Legislatif,7,124,4,QROC,0.26,0.38,56.97,35,27,62,57,35,22,1.09,61.4,Moyen,Moyen,0,Meme Difficulté,Pas Adapte
5678,2020,Droit,5,Constitution de la Cinquieme Republique,3,Le Pouvoir Legislatif,7,124,4,QROC,0.79,0.04,26.08,17,47,64,37,17,20,1.73,45.95,Facile,Difficile,-2,Beaucoup plus Difficile,Pas Adapte
124,2015,Droit,5,Constitution de la Cinquieme Republique,3,Le Pouvoir Legislatif,7,125,5,QCM,0.55,0.26,28.39,7,17,24,19,7,12,1.26,36.84,Facile,Difficile,-2,Beaucoup plus Difficile,Pas Adapte
1235,2016,Droit,5,Constitution de la Cinquieme Republique,3,Le Pouvoir Legislatif,7,125,5,QCM,0.39,0.4,62.67,14,8,22,17,14,3,1.29,82.35,Difficile,Moyen,1,Plus Facile,Pas Adapte
2346,2017,Droit,5,Constitution de la Cinquieme Republique,3,Le Pouvoir Legislatif,7,125,5,QCM,0.06,0.86,94.07,24,1,25,24,24,0,1.04,100.0,Moyen,Facile,1,Plus Facile,Pas Adapte
3457,2018,Droit,5,Constitution de la Cinquieme Republique,3,Le Pouvoir Legislatif,7,125,5,QCM,0.01,0.95,81.43,24,5,29,24,24,0,1.21,100.0,Moyen,Facile,1,Plus Facile,Pas Adapte
4568,2019,Droit,5,Constitution de la Cinquieme Republique,3,Le Pouvoir Legislatif,7,125,5,QCM,0.67,0.21,25.76,7,19,26,13,7,6,2.0,53.85,Difficile,Difficile,0,Meme Difficulté,Pas Adapte
5679,2020,Droit,5,Constitution de la Cinquieme Republique,3,Le Pouvoir Legislatif,7,125,5,QCU,0.34,0.4,50.67,12,12,24,19,12,7,1.26,63.16,Difficile,Moyen,1,Plus Facile,Pas Adapte
125,2015,Droit,5,Constitution de la Cinquieme Republique,3,Le Pouvoir Legislatif,7,126,6,QO,0.39,0.17,40.39,15,22,37,31,15,16,1.19,48.39,Difficile,Moyen,1,Plus Facile,Pas Adapte
1236,2016,Droit,5,Constitution de la Cinquieme Republique,3,Le Pouvoir Legislatif,7,126,6,QO,0.4,0.3,63.52,23,13,36,31,23,8,1.16,74.19,Facile,Moyen,-1,Plus Difficile,Pas Adapte
2347,2017,Droit,5,Constitution de la Cinquieme Republique,3,Le Pouvoir Legislatif,7,126,6,QO,0.86,0.01,20.25,7,28,35,24,7,17,1.46,29.17,Facile,Difficile,-2,Beaucoup plus Difficile,Pas Adapte
3458,2018,Droit,5,Constitution de la Cinquieme Republique,3,Le Pouvoir Legislatif,7,126,6,QO,0.0,0.99,99.95,31,0,31,31,31,0,1.0,100.0,Facile,Facile,0,Meme Difficulté,Pas Adapte
4569,2019,Droit,5,Constitution de la Cinquieme Republique,3,Le Pouvoir Legislatif,7,126,6,QO,0.54,0.21,42.21,15,20,35,20,15,5,1.75,75.0,Difficile,Moyen,1,Plus Facile,Pas Adapte
5680,2020,Droit,5,Constitution de la Cinquieme Republique,3,Le Pouvoir Legislatif,7,126,6,QO,0.1,0.79,85.44,26,4,30,28,26,2,1.07,92.86,Moyen,Facile,1,Plus Facile,Pas Adapte
126,2015,Droit,5,Constitution de la Cinquieme Republique,3,Le Pouvoir Legislatif,7,127,7,QCU,0.15,0.9,90.78,60,6,66,61,60,1,1.08,98.36,Facile,Facile,0,Meme Difficulté,Pas Adapte
1237,2016,Droit,5,Constitution de la Cinquieme Republique,3,Le Pouvoir Legislatif,7,127,7,QCU,0.63,0.33,5.05,3,60,63,24,3,21,2.62,12.5,Facile,Difficile,-2,Beaucoup plus Difficile,Pas Adapte
2348,2017,Droit,5,Constitution de la Cinquieme Republique,3,Le Pouvoir Legislatif,7,127,7,QCU,0.33,0.57,63.67,43,24,67,48,43,5,1.4,89.58,Moyen,Moyen,0,Meme Difficulté,Pas Adapte
3459,2018,Droit,5,Constitution de la Cinquieme Republique,3,Le Pouvoir Legislatif,7,127,7,QCU,0.06,0.98,83.01,48,10,58,56,48,8,1.04,85.71,Facile,Facile,0,Meme Difficulté,Pas Adapte
4570,2019,Droit,5,Constitution de la Cinquieme Republique,3,Le Pouvoir Legislatif,7,127,7,QCU,0.3,0.47,60.59,39,25,64,40,39,1,1.6,97.5,Difficile,Moyen,1,Plus Facile,Pas Adapte
5681,2020,Droit,5,Constitution de la Cinquieme Republique,3,Le Pouvoir Legislatif,7,127,7,QCU,0.43,0.36,31.12,23,51,74,66,23,43,1.12,34.85,Difficile,Difficile,0,Meme Difficulté,Pas Adapte
127,2015,Droit,5,Constitution de la Cinquieme Republique,4,Le Controle de Constitutionnalite,14,128,1,QCU,0.53,0.37,7.81,0,5,5,4,0,4,1.25,0.0,Moyen,Difficile,-1,Plus Difficile,Pas Adapte
1238,2016,Droit,5,Constitution de la Cinquieme Republique,4,Le Controle de Constitutionnalite,14,128,1,QCU,0.31,0.62,55.19,3,3,6,4,3,1,1.5,75.0,Difficile,Moyen,1,Plus Facile,Pas Adapte
2349,2017,Droit,5,Constitution de la Cinquieme Republique,4,Le Controle de Constitutionnalite,14,128,1,QCU,0.36,0.56,49.4,3,3,6,4,3,1,1.5,75.0,Moyen,Moyen,0,Meme Difficulté,Pas Adapte
3460,2018,Droit,5,Constitution de la Cinquieme Republique,4,Le Controle de Constitutionnalite,14,128,1,QCU,0.33,0.44,35.34,2,4,6,3,2,1,2.0,66.67,Moyen,Moyen,0,Meme Difficulté,Pas Adapte
4571,2019,Droit,5,Constitution de la Cinquieme Republique,4,Le Controle de Constitutionnalite,14,128,1,QCU,0.5,0.22,26.46,2,4,6,5,2,3,1.2,40.0,Moyen,Difficile,-1,Plus Difficile,Pas Adapte
5682,2020,Droit,5,Constitution de la Cinquieme Republique,4,Le Controle de Constitutionnalite,14,128,1,QCU,0.31,0.57,61.68,3,2,5,4,3,1,1.25,75.0,Difficile,Moyen,1,Plus Facile,Pas Adapte
128,2015,Droit,5,Constitution de la Cinquieme Republique,4,Le Controle de Constitutionnalite,14,129,2,QCU,0.7,0.38,13.5,3,16,19,15,3,12,1.27,20.0,Moyen,Difficile,-1,Plus Difficile,Pas Adapte
1239,2016,Droit,5,Constitution de la Cinquieme Republique,4,Le Controle de Constitutionnalite,14,129,2,QCU,0.53,0.34,27.38,6,16,22,9,6,3,2.44,66.67,Difficile,Difficile,0,Meme Difficulté,Pas Adapte
2350,2017,Droit,5,Constitution de la Cinquieme Republique,4,Le Controle de Constitutionnalite,14,129,2,QCU,0.44,0.27,2.13,0,23,23,11,0,11,2.09,0.0,Facile,Difficile,-2,Beaucoup plus Difficile,Pas Adapte
3461,2018,Droit,5,Constitution de la Cinquieme Republique,4,Le Controle de Constitutionnalite,14,129,2,QROC,0.6,0.06,17.24,3,17,20,16,3,13,1.25,18.75,Facile,Difficile,-2,Beaucoup plus Difficile,Pas Adapte
4572,2019,Droit,5,Constitution de la Cinquieme Republique,4,Le Controle de Constitutionnalite,14,129,2,QROC,0.63,0.14,24.59,5,14,19,13,5,8,1.46,38.46,Moyen,Difficile,-1,Plus Difficile,Pas Adapte
5683,2020,Droit,5,Constitution de la Cinquieme Republique,4,Le Controle de Constitutionnalite,14,129,2,QROC,0.03,0.84,71.87,11,5,16,12,11,1,1.33,91.67,Moyen,Facile,1,Plus Facile,Adapte
129,2015,Droit,5,Constitution de la Cinquieme Republique,4,Le Controle de Constitutionnalite,14,130,3,QCU,0.31,0.43,53.29,50,43,93,53,50,3,1.75,94.34,Facile,Moyen,-1,Plus Difficile,Pas Adapte
1240,2016,Droit,5,Constitution de la Cinquieme Republique,4,Le Controle de Constitutionnalite,14,130,3,QCU,0.75,0.37,33.43,32,64,96,41,32,9,2.34,78.05,Facile,Difficile,-2,Beaucoup plus Difficile,Pas Adapte
2351,2017,Droit,5,Constitution de la Cinquieme Republique,4,Le Controle de Constitutionnalite,14,130,3,QCU,0.13,0.76,73.61,72,26,98,93,72,21,1.05,77.42,Difficile,Facile,2,Beaucoup plus Facile,Adapte
3462,2018,Droit,5,Constitution de la Cinquieme Republique,4,Le Controle de Constitutionnalite,14,130,3,QCM,0.12,0.81,73.61,66,24,90,79,66,13,1.14,83.54,Facile,Facile,0,Meme Difficulté,Adapte
4573,2019,Droit,5,Constitution de la Cinquieme Republique,4,Le Controle de Constitutionnalite,14,130,3,QCM,0.12,0.94,73.61,59,21,80,66,59,7,1.21,89.39,Facile,Facile,0,Meme Difficulté,Adapte
5684,2020,Droit,5,Constitution de la Cinquieme Republique,4,Le Controle de Constitutionnalite,14,130,3,QCM,0.2,0.95,73.61,54,20,74,65,54,11,1.14,83.08,Facile,Facile,0,Meme Difficulté,Adapte
130,2015,Droit,5,Constitution de la Cinquieme Republique,4,Le Controle de Constitutionnalite,14,131,4,QCU,0.49,0.23,9.43,6,58,64,47,6,41,1.36,12.77,Facile,Difficile,-2,Beaucoup plus Difficile,Pas Adapte
1241,2016,Droit,5,Constitution de la Cinquieme Republique,4,Le Controle de Constitutionnalite,14,131,4,QCU,0.43,0.35,16.1,12,61,73,72,12,60,1.01,16.67,Facile,Difficile,-2,Beaucoup plus Difficile,Pas Adapte
2352,2017,Droit,5,Constitution de la Cinquieme Republique,4,Le Controle de Constitutionnalite,14,131,4,QCU,0.49,0.27,22.56,15,50,65,47,15,32,1.38,31.91,Difficile,Difficile,0,Meme Difficulté,Pas Adapte
3463,2018,Droit,5,Constitution de la Cinquieme Republique,4,Le Controle de Constitutionnalite,14,131,4,QCU,0.36,0.72,49.79,30,31,61,61,30,31,1.0,49.18,Facile,Moyen,-1,Plus Difficile,Pas Adapte
4574,2019,Droit,5,Constitution de la Cinquieme Republique,4,Le Controle de Constitutionnalite,14,131,4,QCU,0.62,0.4,16.5,9,43,52,50,9,41,1.04,18.0,Moyen,Difficile,-1,Plus Difficile,Pas Adapte
5685,2020,Droit,5,Constitution de la Cinquieme Republique,4,Le Controle de Constitutionnalite,14,131,4,QCU,0.54,0.29,14.67,8,44,52,48,8,40,1.08,16.67,Difficile,Difficile,0,Meme Difficulté,Pas Adapte
131,2015,Droit,5,Constitution de la Cinquieme Republique,4,Le Controle de Constitutionnalite,14,132,5,QCM,0.0,0.99,81.86,8,2,10,8,8,0,1.25,100.0,Moyen,Facile,1,Plus Facile,Pas Adapte
1242,2016,Droit,5,Constitution de la Cinquieme Republique,4,Le Controle de Constitutionnalite,14,132,5,QCM,0.75,0.19,22.67,2,8,10,5,2,3,2.0,40.0,Difficile,Difficile,0,Meme Difficulté,Pas Adapte
2353,2017,Droit,5,Constitution de la Cinquieme Republique,4,Le Controle de Constitutionnalite,14,132,5,QCM,0.73,0.2,33.29,3,6,9,7,3,4,1.29,42.86,Facile,Difficile,-2,Beaucoup plus Difficile,Pas Adapte
3464,2018,Droit,5,Constitution de la Cinquieme Republique,4,Le Controle de Constitutionnalite,14,132,5,QCM,0.79,0.22,13.19,1,7,8,4,1,3,2.0,25.0,Moyen,Difficile,-1,Plus Difficile,Pas Adapte
4575,2019,Droit,5,Constitution de la Cinquieme Republique,4,Le Controle de Constitutionnalite,14,132,5,QCM,0.73,0.2,21.97,2,6,8,4,2,2,2.0,50.0,Difficile,Difficile,0,Meme Difficulté,Pas Adapte
5686,2020,Droit,5,Constitution de la Cinquieme Republique,4,Le Controle de Constitutionnalite,14,132,5,QCM,0.64,0.28,31.05,3,6,9,5,3,2,1.8,60.0,Facile,Difficile,-2,Beaucoup plus Difficile,Pas Adapte
132,2015,Droit,5,Constitution de la Cinquieme Republique,4,Le Controle de Constitutionnalite,14,133,6,QCM,0.11,0.75,89.13,22,3,25,24,22,2,1.04,91.67,Facile,Facile,0,Meme Difficulté,Pas Adapte
1243,2016,Droit,5,Constitution de la Cinquieme Republique,4,Le Controle de Constitutionnalite,14,133,6,QCM,0.01,0.86,79.32,19,5,24,20,19,1,1.2,95.0,Facile,Facile,0,Meme Difficulté,Pas Adapte
2354,2017,Droit,5,Constitution de la Cinquieme Republique,4,Le Controle de Constitutionnalite,14,133,6,QCM,0.37,0.41,41.86,8,12,20,11,8,3,1.82,72.73,Facile,Moyen,-1,Plus Difficile,Pas Adapte
3465,2018,Droit,5,Constitution de la Cinquieme Republique,4,Le Controle de Constitutionnalite,14,133,6,QCM,0.12,0.92,88.31,18,2,20,20,18,2,1.0,90.0,Difficile,Facile,2,Beaucoup plus Facile,Pas Adapte
4576,2019,Droit,5,Constitution de la Cinquieme Republique,4,Le Controle de Constitutionnalite,14,133,6,QCM,0.59,0.2,26.35,6,16,22,16,6,10,1.38,37.5,Facile,Difficile,-2,Beaucoup plus Difficile,Pas Adapte
5687,2020,Droit,5,Constitution de la Cinquieme Republique,4,Le Controle de Constitutionnalite,14,133,6,QCM,0.74,0.16,3.49,1,23,24,8,1,7,3.0,12.5,Moyen,Difficile,-1,Plus Difficile,Pas Adapte
133,2015,Droit,5,Constitution de la Cinquieme Republique,4,Le Controle de Constitutionnalite,14,134,7,QROC,0.27,0.26,39.2,22,34,56,41,22,19,1.37,53.66,Difficile,Moyen,1,Plus Facile,Pas Adapte
1244,2016,Droit,5,Constitution de la Cinquieme Republique,4,Le Controle de Constitutionnalite,14,134,7,QROC,0.1,0.82,93.83,48,3,51,50,48,2,1.02,96.0,Difficile,Facile,2,Beaucoup plus Facile,Pas Adapte
2355,2017,Droit,5,Constitution de la Cinquieme Republique,4,Le Controle de Constitutionnalite,14,134,7,QO,0.1,0.32,83.5,39,8,47,41,39,2,1.15,95.12,Difficile,Facile,2,Beaucoup plus Facile,Pas Adapte
3466,2018,Droit,5,Constitution de la Cinquieme Republique,4,Le Controle de Constitutionnalite,14,134,7,QO,0.64,0.28,36.56,16,29,45,36,16,20,1.25,44.44,Facile,Moyen,-1,Plus Difficile,Pas Adapte
4577,2019,Droit,5,Constitution de la Cinquieme Republique,4,Le Controle de Constitutionnalite,14,134,7,QO,0.34,0.17,43.33,19,24,43,27,19,8,1.59,70.37,Difficile,Moyen,1,Plus Facile,Pas Adapte
5688,2020,Droit,5,Constitution de la Cinquieme Republique,4,Le Controle de Constitutionnalite,14,134,7,QO,0.87,0.11,32.15,14,29,43,30,14,16,1.43,46.67,Difficile,Difficile,0,Meme Difficulté,Pas Adapte
134,2015,Droit,5,Constitution de la Cinquieme Republique,4,Le Controle de Constitutionnalite,14,135,8,QCM,0.6,0.27,4.78,3,53,56,27,3,24,2.07,11.11,Difficile,Difficile,0,Meme Difficulté,Pas Adapte
1245,2016,Droit,5,Constitution de la Cinquieme Republique,4,Le Controle de Constitutionnalite,14,135,8,QCM,0.37,0.46,54.34,33,27,60,40,33,7,1.5,82.5,Difficile,Moyen,1,Plus Facile,Pas Adapte
2356,2017,Droit,5,Constitution de la Cinquieme Republique,4,Le Controle de Constitutionnalite,14,135,8,QCM,0.71,0.18,34.29,21,40,61,50,21,29,1.22,42.0,Difficile,Difficile,0,Meme Difficulté,Pas Adapte
3467,2018,Droit,5,Constitution de la Cinquieme Republique,4,Le Controle de Constitutionnalite,14,135,8,QCM,0.47,0.61,44.83,24,30,54,32,24,8,1.69,75.0,Facile,Moyen,-1,Plus Difficile,Pas Adapte
4578,2019,Droit,5,Constitution de la Cinquieme Republique,4,Le Controle de Constitutionnalite,14,135,8,QCM,0.54,0.21,27.0,15,39,54,41,15,26,1.32,36.59,Moyen,Difficile,-1,Plus Difficile,Pas Adapte
5689,2020,Droit,5,Constitution de la Cinquieme Republique,4,Le Controle de Constitutionnalite,14,135,8,QCM,0.79,0.19,4.25,2,54,56,33,2,31,1.7,6.06,Difficile,Difficile,0,Meme Difficulté,Pas Adapte
135,2015,Droit,5,Constitution de la Cinquieme Republique,4,Le Controle de Constitutionnalite,14,136,9,QCU,0.13,0.86,67.93,58,28,86,85,58,27,1.01,68.24,Moyen,Facile,1,Plus Facile,Adapte
1246,2016,Droit,5,Constitution de la Cinquieme Republique,4,Le Controle de Constitutionnalite,14,136,9,QCU,0.13,0.86,67.93,58,28,86,70,58,12,1.23,82.86,Facile,Facile,0,Meme Difficulté,Adapte
2357,2017,Droit,5,Constitution de la Cinquieme Republique,4,Le Controle de Constitutionnalite,14,136,9,QCU,0.08,0.86,67.93,62,30,92,71,62,9,1.3,87.32,Facile,Facile,0,Meme Difficulté,Adapte
3468,2018,Droit,5,Constitution de la Cinquieme Republique,4,Le Controle de Constitutionnalite,14,136,9,QCU,0.13,0.9,67.93,58,27,85,71,58,13,1.2,81.69,Facile,Facile,0,Meme Difficulté,Adapte
4579,2019,Droit,5,Constitution de la Cinquieme Republique,4,Le Controle de Constitutionnalite,14,136,9,QCU,0.19,0.9,67.93,58,28,86,65,58,7,1.32,89.23,Facile,Facile,0,Meme Difficulté,Adapte
5690,2020,Droit,5,Constitution de la Cinquieme Republique,4,Le Controle de Constitutionnalite,14,136,9,QCU,0.17,0.84,67.93,59,28,87,78,59,19,1.12,75.64,Facile,Facile,0,Meme Difficulté,Adapte
136,2015,Droit,5,Constitution de la Cinquieme Republique,4,Le Controle de Constitutionnalite,14,137,10,QROC,0.02,0.97,87.11,18,3,21,20,18,2,1.05,90.0,Facile,Facile,0,Meme Difficulté,Pas Adapte
1247,2016,Droit,5,Constitution de la Cinquieme Republique,4,Le Controle de Constitutionnalite,14,137,10,QO,0.05,0.4,80.53,19,5,24,23,19,4,1.04,82.61,Facile,Facile,0,Meme Difficulté,Pas Adapte
2358,2017,Droit,5,Constitution de la Cinquieme Republique,4,Le Controle de Constitutionnalite,14,137,10,QO,0.93,0.14,1.93,1,25,26,13,1,12,2.0,7.69,Facile,Difficile,-2,Beaucoup plus Difficile,Pas Adapte
3469,2018,Droit,5,Constitution de la Cinquieme Republique,4,Le Controle de Constitutionnalite,14,137,10,QROC,0.13,0.94,75.59,23,7,30,25,23,2,1.2,92.0,Moyen,Facile,1,Plus Facile,Pas Adapte
4580,2019,Droit,5,Constitution de la Cinquieme Republique,4,Le Controle de Constitutionnalite,14,137,10,QROC,0.89,0.14,34.11,12,22,34,20,12,8,1.7,60.0,Difficile,Difficile,0,Meme Difficulté,Pas Adapte
5691,2020,Droit,5,Constitution de la Cinquieme Republique,4,Le Controle de Constitutionnalite,14,137,10,QO,0.13,0.59,94.79,29,2,31,31,29,2,1.0,93.55,Difficile,Facile,2,Beaucoup plus Facile,Pas Adapte
137,2015,Droit,5,Constitution de la Cinquieme Republique,4,Le Controle de Constitutionnalite,14,138,11,QROC,0.6,0.12,17.95,17,80,97,86,17,69,1.13,19.77,Facile,Difficile,-2,Beaucoup plus Difficile,Pas Adapte
1248,2016,Droit,5,Constitution de la Cinquieme Republique,4,Le Controle de Constitutionnalite,14,138,11,QROC,0.91,0.05,17.42,17,81,98,77,17,60,1.27,22.08,Moyen,Difficile,-1,Plus Difficile,Pas Adapte
2359,2017,Droit,5,Constitution de la Cinquieme Republique,4,Le Controle de Constitutionnalite,14,138,11,QROC,0.98,0.08,9.57,8,78,86,49,8,41,1.76,16.33,Facile,Difficile,-2,Beaucoup plus Difficile,Pas Adapte
3470,2018,Droit,5,Constitution de la Cinquieme Republique,4,Le Controle de Constitutionnalite,14,138,11,QROC,0.24,0.36,41.37,36,50,86,58,36,22,1.48,62.07,Moyen,Moyen,0,Meme Difficulté,Pas Adapte
4581,2019,Droit,5,Constitution de la Cinquieme Republique,4,Le Controle de Constitutionnalite,14,138,11,QROC,0.31,0.38,55.44,55,44,99,94,55,39,1.05,58.51,Difficile,Moyen,1,Plus Facile,Pas Adapte
5692,2020,Droit,5,Constitution de la Cinquieme Republique,4,Le Controle de Constitutionnalite,14,138,11,QROC,0.86,0.09,26.23,22,63,85,67,22,45,1.27,32.84,Difficile,Difficile,0,Meme Difficulté,Pas Adapte
138,2015,Droit,5,Constitution de la Cinquieme Republique,4,Le Controle de Constitutionnalite,14,139,12,QCU,0.18,0.82,82.35,16,4,20,17,16,1,1.18,94.12,Moyen,Facile,1,Plus Facile,Pas Adapte
1249,2016,Droit,5,Constitution de la Cinquieme Republique,4,Le Controle de Constitutionnalite,14,139,12,QCM,0.32,0.43,38.13,8,14,22,9,8,1,2.44,88.89,Facile,Moyen,-1,Plus Difficile,Pas Adapte
2360,2017,Droit,5,Constitution de la Cinquieme Republique,4,Le Controle de Constitutionnalite,14,139,12,QCM,0.62,0.25,27.01,5,15,20,15,5,10,1.33,33.33,Difficile,Difficile,0,Meme Difficulté,Pas Adapte
3471,2018,Droit,5,Constitution de la Cinquieme Republique,4,Le Controle de Constitutionnalite,14,139,12,QCM,0.56,0.2,10.8,2,17,19,18,2,16,1.06,11.11,Moyen,Difficile,-1,Plus Difficile,Pas Adapte
4582,2019,Droit,5,Constitution de la Cinquieme Republique,4,Le Controle de Constitutionnalite,14,139,12,QCU,0.05,0.78,88.64,20,2,22,22,20,2,1.0,90.91,Facile,Facile,0,Meme Difficulté,Pas Adapte
5693,2020,Droit,5,Constitution de la Cinquieme Republique,4,Le Controle de Constitutionnalite,14,139,12,QCU,0.31,0.42,36.49,7,13,20,11,7,4,1.82,63.64,Moyen,Moyen,0,Meme Difficulté,Pas Adapte
139,2015,Droit,5,Constitution de la Cinquieme Republique,4,Le Controle de Constitutionnalite,14,140,13,QROC,0.42,0.38,57.0,28,21,49,36,28,8,1.36,77.78,Difficile,Moyen,1,Plus Facile,Pas Adapte
1250,2016,Droit,5,Constitution de la Cinquieme Republique,4,Le Controle de Constitutionnalite,14,140,13,QROC,0.41,0.37,37.87,18,29,47,20,18,2,2.35,90.0,Moyen,Moyen,0,Meme Difficulté,Pas Adapte
2361,2017,Droit,5,Constitution de la Cinquieme Republique,4,Le Controle de Constitutionnalite,14,140,13,QROC,0.34,0.36,54.23,29,24,53,47,29,18,1.13,61.7,Facile,Moyen,-1,Plus Difficile,Pas Adapte
3472,2018,Droit,5,Constitution de la Cinquieme Republique,4,Le Controle de Constitutionnalite,14,140,13,QROC,0.46,0.35,53.12,29,25,54,40,29,11,1.35,72.5,Difficile,Moyen,1,Plus Facile,Pas Adapte
4583,2019,Droit,5,Constitution de la Cinquieme Republique,4,Le Controle de Constitutionnalite,14,140,13,QROC,0.17,0.49,73.95,35,12,47,45,35,10,1.04,77.78,Facile,Facile,0,Meme Difficulté,Adapte
5694,2020,Droit,5,Constitution de la Cinquieme Republique,4,Le Controle de Constitutionnalite,14,140,13,QROC,0.02,0.4,73.95,33,11,44,35,33,2,1.26,94.29,Facile,Facile,0,Meme Difficulté,Adapte
140,2015,Droit,5,Constitution de la Cinquieme Republique,4,Le Controle de Constitutionnalite,14,141,14,QCM,0.11,0.88,94.32,40,2,42,42,40,2,1.0,95.24,Difficile,Facile,2,Beaucoup plus Facile,Pas Adapte
1251,2016,Droit,5,Constitution de la Cinquieme Republique,4,Le Controle de Constitutionnalite,14,141,14,QCM,0.02,0.72,75.42,33,11,44,42,33,9,1.05,78.57,Facile,Facile,0,Meme Difficulté,Pas Adapte
2362,2017,Droit,5,Constitution de la Cinquieme Republique,4,Le Controle de Constitutionnalite,14,141,14,QCM,0.32,0.47,61.98,24,15,39,38,24,14,1.03,63.16,Difficile,Moyen,1,Plus Facile,Pas Adapte
3473,2018,Droit,5,Constitution de la Cinquieme Republique,4,Le Controle de Constitutionnalite,14,141,14,QCM,0.18,0.83,98.05,34,1,35,34,34,0,1.03,100.0,Facile,Facile,0,Meme Difficulté,Pas Adapte
4584,2019,Droit,5,Constitution de la Cinquieme Republique,4,Le Controle de Constitutionnalite,14,141,14,QCU,0.38,0.66,57.08,18,14,32,20,18,2,1.6,90.0,Facile,Moyen,-1,Plus Difficile,Pas Adapte
5695,2020,Droit,5,Constitution de la Cinquieme Republique,4,Le Controle de Constitutionnalite,14,141,14,QCU,0.2,0.68,36.07,13,23,36,14,13,1,2.57,92.86,Facile,Moyen,-1,Plus Difficile,Pas Adapte
141,2015,Economie,1,L'Economie et son Domaine,1,L'Objet de la Science Economique,9,142,1,QROC,0.51,0.29,62.84,57,33,90,89,57,32,1.01,64.04,Facile,Moyen,-1,Plus Difficile,Pas Adapte
1252,2016,Economie,1,L'Economie et son Domaine,1,L'Objet de la Science Economique,9,142,1,QROC,0.4,0.35,43.58,36,47,83,58,36,22,1.43,62.07,Moyen,Moyen,0,Meme Difficulté,Pas Adapte
2363,2017,Economie,1,L'Economie et son Domaine,1,L'Objet de la Science Economique,9,142,1,QROC,0.46,0.3,37.56,34,56,90,45,34,11,2.0,75.56,Facile,Moyen,-1,Plus Difficile,Pas Adapte
3474,2018,Economie,1,L'Economie et son Domaine,1,L'Objet de la Science Economique,9,142,1,QROC,0.1,0.6,73.65,59,21,80,67,59,8,1.19,88.06,Moyen,Facile,1,Plus Facile,Adapte
4585,2019,Economie,1,L'Economie et son Domaine,1,L'Objet de la Science Economique,9,142,1,QROC,0.05,0.55,73.65,59,21,80,62,59,3,1.29,95.16,Facile,Facile,0,Meme Difficulté,Adapte
5696,2020,Economie,1,L'Economie et son Domaine,1,L'Objet de la Science Economique,9,142,1,QROC,0.18,0.87,73.65,60,21,81,77,60,17,1.05,77.92,Facile,Facile,0,Meme Difficulté,Adapte
142,2015,Economie,1,L'Economie et son Domaine,1,L'Objet de la Science Economique,9,143,2,QCU,0.19,0.89,96.71,93,3,96,94,93,1,1.02,98.94,Difficile,Facile,2,Beaucoup plus Facile,Pas Adapte
1253,2016,Economie,1,L'Economie et son Domaine,1,L'Objet de la Science Economique,9,143,2,QCU,0.19,0.8,76.55,79,24,103,84,79,5,1.23,94.05,Facile,Facile,0,Meme Difficulté,Pas Adapte
2364,2017,Economie,1,L'Economie et son Domaine,1,L'Objet de la Science Economique,9,143,2,QCU,0.13,0.89,72.98,69,26,95,70,69,1,1.36,98.57,Facile,Facile,0,Meme Difficulté,Adapte
3475,2018,Economie,1,L'Economie et son Domaine,1,L'Objet de la Science Economique,9,143,2,QCU,0.02,0.92,72.98,69,25,94,74,69,5,1.27,93.24,Facile,Facile,0,Meme Difficulté,Adapte
4586,2019,Economie,1,L'Economie et son Domaine,1,L'Objet de la Science Economique,9,143,2,QCM,0.02,0.83,72.98,68,25,93,70,68,2,1.33,97.14,Facile,Facile,0,Meme Difficulté,Adapte
5697,2020,Economie,1,L'Economie et son Domaine,1,L'Objet de la Science Economique,9,143,2,QCM,0.08,0.89,72.98,66,25,91,71,66,5,1.28,92.96,Facile,Facile,0,Meme Difficulté,Adapte
143,2015,Economie,1,L'Economie et son Domaine,1,L'Objet de la Science Economique,9,144,3,QCU,0.4,0.46,39.55,14,21,35,26,14,12,1.35,53.85,Moyen,Moyen,0,Meme Difficulté,Pas Adapte
1254,2016,Economie,1,L'Economie et son Domaine,1,L'Objet de la Science Economique,9,144,3,QCU,0.29,0.54,37.82,13,21,34,21,13,8,1.62,61.9,Moyen,Moyen,0,Meme Difficulté,Pas Adapte
2365,2017,Economie,1,L'Economie et son Domaine,1,L'Objet de la Science Economique,9,144,3,QCU,0.34,0.61,43.1,16,22,38,33,16,17,1.15,48.48,Facile,Moyen,-1,Plus Difficile,Pas Adapte
3476,2018,Economie,1,L'Economie et son Domaine,1,L'Objet de la Science Economique,9,144,3,QCU,0.73,0.35,33.65,14,29,43,41,14,27,1.05,34.15,Facile,Difficile,-2,Beaucoup plus Difficile,Pas Adapte
4587,2019,Economie,1,L'Economie et son Domaine,1,L'Objet de la Science Economique,9,144,3,QCU,0.34,0.61,55.71,26,20,46,29,26,3,1.59,89.66,Facile,Moyen,-1,Plus Difficile,Pas Adapte
5698,2020,Economie,1,L'Economie et son Domaine,1,L'Objet de la Science Economique,9,144,3,QCU,0.58,0.37,14.14,6,38,44,40,6,34,1.1,15.0,Facile,Difficile,-2,Beaucoup plus Difficile,Pas Adapte
144,2015,Economie,1,L'Economie et son Domaine,1,L'Objet de la Science Economique,9,145,4,QCU,0.61,0.33,18.02,12,52,64,29,12,17,2.21,41.38,Difficile,Difficile,0,Meme Difficulté,Pas Adapte
1255,2016,Economie,1,L'Economie et son Domaine,1,L'Objet de la Science Economique,9,145,4,QCU,0.35,0.59,54.67,36,30,66,48,36,12,1.38,75.0,Difficile,Moyen,1,Plus Facile,Pas Adapte
2366,2017,Economie,1,L'Economie et son Domaine,1,L'Objet de la Science Economique,9,145,4,QCU,0.57,0.39,31.15,17,39,56,37,17,20,1.51,45.95,Moyen,Difficile,-1,Plus Difficile,Pas Adapte
3477,2018,Economie,1,L'Economie et son Domaine,1,L'Objet de la Science Economique,9,145,4,QCU,0.5,0.33,13.46,7,46,53,41,7,34,1.29,17.07,Difficile,Difficile,0,Meme Difficulté,Pas Adapte
4588,2019,Economie,1,L'Economie et son Domaine,1,L'Objet de la Science Economique,9,145,4,QCU,0.13,0.81,91.55,48,4,52,50,48,2,1.04,96.0,Difficile,Facile,2,Beaucoup plus Facile,Pas Adapte
5699,2020,Economie,1,L'Economie et son Domaine,1,L'Objet de la Science Economique,9,145,4,QCU,0.29,0.71,37.39,17,29,46,43,17,26,1.07,39.53,Moyen,Moyen,0,Meme Difficulté,Pas Adapte
145,2015,Economie,1,L'Economie et son Domaine,1,L'Objet de la Science Economique,9,146,5,QCM,0.22,0.52,41.35,7,10,17,11,7,4,1.55,63.64,Facile,Moyen,-1,Plus Difficile,Pas Adapte
1256,2016,Economie,1,L'Economie et son Domaine,1,L'Objet de la Science Economique,9,146,5,QCM,0.25,0.52,50.07,8,8,16,12,8,4,1.33,66.67,Facile,Moyen,-1,Plus Difficile,Pas Adapte
2367,2017,Economie,1,L'Economie et son Domaine,1,L'Objet de la Science Economique,9,146,5,QCM,0.63,0.22,14.59,2,12,14,10,2,8,1.4,20.0,Facile,Difficile,-2,Beaucoup plus Difficile,Pas Adapte
3478,2018,Economie,1,L'Economie et son Domaine,1,L'Objet de la Science Economique,9,146,5,QCM,0.16,0.98,67.81,11,5,16,12,11,1,1.33,91.67,Facile,Facile,0,Meme Difficulté,Adapte
4589,2019,Economie,1,L'Economie et son Domaine,1,L'Objet de la Science Economique,9,146,5,QCM,0.11,0.78,67.81,11,5,16,14,11,3,1.14,78.57,Facile,Facile,0,Meme Difficulté,Adapte
5700,2020,Economie,1,L'Economie et son Domaine,1,L'Objet de la Science Economique,9,146,5,QCM,0.18,0.97,67.81,12,6,18,15,12,3,1.2,80.0,Facile,Facile,0,Meme Difficulté,Adapte
146,2015,Economie,1,L'Economie et son Domaine,1,L'Objet de la Science Economique,9,147,6,QCM,0.45,0.46,44.57,15,18,33,32,15,17,1.03,46.88,Facile,Moyen,-1,Plus Difficile,Pas Adapte
1257,2016,Economie,1,L'Economie et son Domaine,1,L'Objet de la Science Economique,9,147,6,QROC,0.15,0.77,93.88,28,2,30,29,28,1,1.03,96.55,Difficile,Facile,2,Beaucoup plus Facile,Pas Adapte
2368,2017,Economie,1,L'Economie et son Domaine,1,L'Objet de la Science Economique,9,147,6,QCM,0.66,0.25,34.23,11,21,32,15,11,4,2.13,73.33,Facile,Difficile,-2,Beaucoup plus Difficile,Pas Adapte
3479,2018,Economie,1,L'Economie et son Domaine,1,L'Objet de la Science Economique,9,147,6,QCM,0.5,0.35,60.11,20,13,33,32,20,12,1.03,62.5,Facile,Moyen,-1,Plus Difficile,Pas Adapte
4590,2019,Economie,1,L'Economie et son Domaine,1,L'Objet de la Science Economique,9,147,6,QCM,0.14,0.71,86.79,24,4,28,26,24,2,1.08,92.31,Moyen,Facile,1,Plus Facile,Pas Adapte
5701,2020,Economie,1,L'Economie et son Domaine,1,L'Objet de la Science Economique,9,147,6,QCM,0.57,0.17,26.97,8,21,29,14,8,6,2.07,57.14,Facile,Difficile,-2,Beaucoup plus Difficile,Pas Adapte
147,2015,Economie,1,L'Economie et son Domaine,1,L'Objet de la Science Economique,9,148,7,QO,0.04,0.97,67.73,22,11,33,26,22,4,1.27,84.62,Difficile,Facile,2,Beaucoup plus Facile,Adapte
1258,2016,Economie,1,L'Economie et son Domaine,1,L'Objet de la Science Economique,9,148,7,QO,0.13,0.47,67.73,22,10,32,23,22,1,1.39,95.65,Facile,Facile,0,Meme Difficulté,Adapte
2369,2017,Economie,1,L'Economie et son Domaine,1,L'Objet de la Science Economique,9,148,7,QO,0.2,0.6,67.73,22,11,33,26,22,4,1.27,84.62,Facile,Facile,0,Meme Difficulté,Adapte
3480,2018,Economie,1,L'Economie et son Domaine,1,L'Objet de la Science Economique,9,148,7,QO,0.17,0.45,67.73,23,11,34,28,23,5,1.21,82.14,Facile,Facile,0,Meme Difficulté,Adapte
4591,2019,Economie,1,L'Economie et son Domaine,1,L'Objet de la Science Economique,9,148,7,QO,0.06,0.68,67.73,25,12,37,32,25,7,1.16,78.12,Facile,Facile,0,Meme Difficulté,Adapte
5702,2020,Economie,1,L'Economie et son Domaine,1,L'Objet de la Science Economique,9,148,7,QO,0.15,0.96,67.73,24,11,35,24,24,0,1.46,100.0,Facile,Facile,0,Meme Difficulté,Adapte
148,2015,Economie,1,L'Economie et son Domaine,1,L'Objet de la Science Economique,9,149,8,QROC,0.64,0.02,33.08,23,47,70,40,23,17,1.75,57.5,Facile,Difficile,-2,Beaucoup plus Difficile,Pas Adapte
1259,2016,Economie,1,L'Economie et son Domaine,1,L'Objet de la Science Economique,9,149,8,QO,0.16,0.53,94.46,69,4,73,72,69,3,1.01,95.83,Facile,Facile,0,Meme Difficulté,Pas Adapte
2370,2017,Economie,1,L'Economie et son Domaine,1,L'Objet de la Science Economique,9,149,8,QO,0.84,0.14,11.73,10,74,84,63,10,53,1.33,15.87,Facile,Difficile,-2,Beaucoup plus Difficile,Pas Adapte
3481,2018,Economie,1,L'Economie et son Domaine,1,L'Objet de la Science Economique,9,149,8,QO,0.17,0.6,88.73,77,10,87,81,77,4,1.07,95.06,Facile,Facile,0,Meme Difficulté,Pas Adapte
4592,2019,Economie,1,L'Economie et son Domaine,1,L'Objet de la Science Economique,9,149,8,QO,0.18,0.74,91.31,82,8,90,85,82,3,1.06,96.47,Facile,Facile,0,Meme Difficulté,Pas Adapte
5703,2020,Economie,1,L'Economie et son Domaine,1,L'Objet de la Science Economique,9,149,8,QCU,0.19,0.84,89.73,78,9,87,83,78,5,1.05,93.98,Moyen,Facile,1,Plus Facile,Pas Adapte
149,2015,Economie,1,L'Economie et son Domaine,1,L'Objet de la Science Economique,9,150,9,QROC,0.62,0.18,3.88,1,25,26,11,1,10,2.36,9.09,Moyen,Difficile,-1,Plus Difficile,Pas Adapte
1260,2016,Economie,1,L'Economie et son Domaine,1,L'Objet de la Science Economique,9,150,9,QROC,0.17,0.72,82.35,22,5,27,26,22,4,1.04,84.62,Facile,Facile,0,Meme Difficulté,Pas Adapte
2371,2017,Economie,1,L'Economie et son Domaine,1,L'Objet de la Science Economique,9,150,9,QROC,0.96,0.19,7.04,2,29,31,17,2,15,1.82,11.76,Facile,Difficile,-2,Beaucoup plus Difficile,Pas Adapte
3482,2018,Economie,1,L'Economie et son Domaine,1,L'Objet de la Science Economique,9,150,9,QROC,0.04,0.52,95.44,33,2,35,34,33,1,1.03,97.06,Moyen,Facile,1,Plus Facile,Pas Adapte
4593,2019,Economie,1,L'Economie et son Domaine,1,L'Objet de la Science Economique,9,150,9,QROC,0.38,0.36,48.27,14,16,30,14,14,0,2.14,100.0,Difficile,Moyen,1,Plus Facile,Pas Adapte
5704,2020,Economie,1,L'Economie et son Domaine,1,L'Objet de la Science Economique,9,150,9,QROC,0.29,0.31,39.8,12,18,30,22,12,10,1.36,54.55,Moyen,Moyen,0,Meme Difficulté,Pas Adapte
150,2015,Economie,1,L'Economie et son Domaine,2,Les Grands Courants de la Pensee Economique,8,151,1,QCM,0.5,0.36,57.2,7,6,13,8,7,1,1.62,87.5,Facile,Moyen,-1,Plus Difficile,Pas Adapte
1261,2016,Economie,1,L'Economie et son Domaine,2,Les Grands Courants de la Pensee Economique,8,151,1,QCM,0.35,0.69,37.82,5,8,13,10,5,5,1.3,50.0,Facile,Moyen,-1,Plus Difficile,Pas Adapte
2372,2017,Economie,1,L'Economie et son Domaine,2,Les Grands Courants de la Pensee Economique,8,151,1,QCM,0.7,0.26,2.41,0,15,15,15,0,15,1.0,0.0,Difficile,Difficile,0,Meme Difficulté,Pas Adapte
3483,2018,Economie,1,L'Economie et son Domaine,2,Les Grands Courants de la Pensee Economique,8,151,1,QCM,0.56,0.28,20.0,3,10,13,5,3,2,2.6,60.0,Facile,Difficile,-2,Beaucoup plus Difficile,Pas Adapte
4594,2019,Economie,1,L'Economie et son Domaine,2,Les Grands Courants de la Pensee Economique,8,151,1,QCM,0.52,0.16,18.1,2,10,12,4,2,2,3.0,50.0,Moyen,Difficile,-1,Plus Difficile,Pas Adapte
5705,2020,Economie,1,L'Economie et son Domaine,2,Les Grands Courants de la Pensee Economique,8,151,1,QCM,0.5,0.21,24.34,2,8,10,3,2,1,3.33,66.67,Facile,Difficile,-2,Beaucoup plus Difficile,Pas Adapte
151,2015,Economie,1,L'Economie et son Domaine,2,Les Grands Courants de la Pensee Economique,8,152,2,QCU,0.21,0.54,57.67,53,39,92,85,53,32,1.08,62.35,Moyen,Moyen,0,Meme Difficulté,Pas Adapte
1262,2016,Economie,1,L'Economie et son Domaine,2,Les Grands Courants de la Pensee Economique,8,152,2,QCU,0.01,0.99,67.53,70,33,103,80,70,10,1.29,87.5,Facile,Facile,0,Meme Difficulté,Adapte
2373,2017,Economie,1,L'Economie et son Domaine,2,Les Grands Courants de la Pensee Economique,8,152,2,QCU,0.02,0.97,67.53,69,33,102,99,69,30,1.03,69.7,Facile,Facile,0,Meme Difficulté,Adapte
3484,2018,Economie,1,L'Economie et son Domaine,2,Les Grands Courants de la Pensee Economique,8,152,2,QCU,0.06,0.94,67.53,63,30,93,91,63,28,1.02,69.23,Facile,Facile,0,Meme Difficulté,Adapte
4595,2019,Economie,1,L'Economie et son Domaine,2,Les Grands Courants de la Pensee Economique,8,152,2,QCU,0.14,0.88,67.53,66,32,98,67,66,1,1.46,98.51,Facile,Facile,0,Meme Difficulté,Adapte
5706,2020,Economie,1,L'Economie et son Domaine,2,Les Grands Courants de la Pensee Economique,8,152,2,QCU,0.05,0.85,67.53,62,30,92,81,62,19,1.14,76.54,Facile,Facile,0,Meme Difficulté,Adapte
152,2015,Economie,1,L'Economie et son Domaine,2,Les Grands Courants de la Pensee Economique,8,153,3,QCU,0.17,0.99,72.24,59,22,81,64,59,5,1.27,92.19,Facile,Facile,0,Meme Difficulté,Adapte
1263,2016,Economie,1,L'Economie et son Domaine,2,Les Grands Courants de la Pensee Economique,8,153,3,QCU,0.11,0.9,72.24,61,23,84,63,61,2,1.33,96.83,Facile,Facile,0,Meme Difficulté,Adapte
2374,2017,Economie,1,L'Economie et son Domaine,2,Les Grands Courants de la Pensee Economique,8,153,3,QCU,0.01,0.8,72.24,68,26,94,87,68,19,1.08,78.16,Facile,Facile,0,Meme Difficulté,Adapte
3485,2018,Economie,1,L'Economie et son Domaine,2,Les Grands Courants de la Pensee Economique,8,153,3,QCU,0.18,0.78,72.24,73,28,101,94,73,21,1.07,77.66,Facile,Facile,0,Meme Difficulté,Adapte
4596,2019,Economie,1,L'Economie et son Domaine,2,Les Grands Courants de la Pensee Economique,8,153,3,QCU,0.09,0.98,72.24,82,32,114,83,82,1,1.37,98.8,Facile,Facile,0,Meme Difficulté,Adapte
5707,2020,Economie,1,L'Economie et son Domaine,2,Les Grands Courants de la Pensee Economique,8,153,3,QCU,0.13,0.78,72.24,88,34,122,106,88,18,1.15,83.02,Facile,Facile,0,Meme Difficulté,Adapte
153,2015,Economie,1,L'Economie et son Domaine,2,Les Grands Courants de la Pensee Economique,8,154,4,QCU,0.21,0.46,61.31,11,7,18,17,11,6,1.06,64.71,Difficile,Moyen,1,Plus Facile,Pas Adapte
1264,2016,Economie,1,L'Economie et son Domaine,2,Les Grands Courants de la Pensee Economique,8,154,4,QO,0.04,0.95,88.11,18,2,20,19,18,1,1.05,94.74,Facile,Facile,0,Meme Difficulté,Pas Adapte
2375,2017,Economie,1,L'Economie et son Domaine,2,Les Grands Courants de la Pensee Economique,8,154,4,QCM,0.62,0.23,18.49,4,15,19,19,4,15,1.0,21.05,Difficile,Difficile,0,Meme Difficulté,Pas Adapte
3486,2018,Economie,1,L'Economie et son Domaine,2,Les Grands Courants de la Pensee Economique,8,154,4,QCM,0.13,0.9,67.27,13,7,20,16,13,3,1.25,81.25,Difficile,Facile,2,Beaucoup plus Facile,Adapte
4597,2019,Economie,1,L'Economie et son Domaine,2,Les Grands Courants de la Pensee Economique,8,154,4,QO,0.17,0.79,67.27,12,6,18,15,12,3,1.2,80.0,Facile,Facile,0,Meme Difficulté,Adapte
5708,2020,Economie,1,L'Economie et son Domaine,2,Les Grands Courants de la Pensee Economique,8,154,4,QO,0.15,0.88,67.27,13,6,19,17,13,4,1.12,76.47,Facile,Facile,0,Meme Difficulté,Adapte
154,2015,Economie,1,L'Economie et son Domaine,2,Les Grands Courants de la Pensee Economique,8,155,5,QCU,0.49,0.37,21.32,10,38,48,24,10,14,2.0,41.67,Difficile,Difficile,0,Meme Difficulté,Pas Adapte
1265,2016,Economie,1,L'Economie et son Domaine,2,Les Grands Courants de la Pensee Economique,8,155,5,QCU,0.24,0.45,64.35,28,16,44,30,28,2,1.47,93.33,Difficile,Moyen,1,Plus Facile,Pas Adapte
2376,2017,Economie,1,L'Economie et son Domaine,2,Les Grands Courants de la Pensee Economique,8,155,5,QCU,0.4,0.4,20.75,11,40,51,38,11,27,1.34,28.95,Difficile,Difficile,0,Meme Difficulté,Pas Adapte
3487,2018,Economie,1,L'Economie et son Domaine,2,Les Grands Courants de la Pensee Economique,8,155,5,QCU,0.75,0.26,29.31,14,35,49,43,14,29,1.14,32.56,Facile,Difficile,-2,Beaucoup plus Difficile,Pas Adapte
4598,2019,Economie,1,L'Economie et son Domaine,2,Les Grands Courants de la Pensee Economique,8,155,5,QCU,0.35,0.67,56.5,30,23,53,45,30,15,1.18,66.67,Difficile,Moyen,1,Plus Facile,Pas Adapte
5709,2020,Economie,1,L'Economie et son Domaine,2,Les Grands Courants de la Pensee Economique,8,155,5,QCU,0.18,0.9,91.08,53,5,58,54,53,1,1.07,98.15,Moyen,Facile,1,Plus Facile,Pas Adapte
155,2015,Economie,1,L'Economie et son Domaine,2,Les Grands Courants de la Pensee Economique,8,156,6,QCU,0.23,0.63,51.46,4,4,8,8,4,4,1.0,50.0,Difficile,Moyen,1,Plus Facile,Pas Adapte
1266,2016,Economie,1,L'Economie et son Domaine,2,Les Grands Courants de la Pensee Economique,8,156,6,QCU,0.33,0.61,52.15,4,4,8,6,4,2,1.33,66.67,Facile,Moyen,-1,Plus Difficile,Pas Adapte
2377,2017,Economie,1,L'Economie et son Domaine,2,Les Grands Courants de la Pensee Economique,8,156,6,QCU,0.33,0.67,42.6,3,4,7,4,3,1,1.75,75.0,Moyen,Moyen,0,Meme Difficulté,Pas Adapte
3488,2018,Economie,1,L'Economie et son Domaine,2,Les Grands Courants de la Pensee Economique,8,156,6,QCU,0.4,0.28,7.61,1,6,7,5,1,4,1.4,20.0,Difficile,Difficile,0,Meme Difficulté,Pas Adapte
4599,2019,Economie,1,L'Economie et son Domaine,2,Les Grands Courants de la Pensee Economique,8,156,6,QCU,0.1,0.94,80.95,6,2,8,8,6,2,1.0,75.0,Facile,Facile,0,Meme Difficulté,Pas Adapte
5710,2020,Economie,1,L'Economie et son Domaine,2,Les Grands Courants de la Pensee Economique,8,156,6,QCU,0.36,0.7,63.82,5,3,8,8,5,3,1.0,62.5,Moyen,Moyen,0,Meme Difficulté,Pas Adapte
156,2015,Economie,1,L'Economie et son Domaine,2,Les Grands Courants de la Pensee Economique,8,157,7,QCM,0.32,0.63,61.63,38,24,62,58,38,20,1.07,65.52,Difficile,Moyen,1,Plus Facile,Pas Adapte
1267,2016,Economie,1,L'Economie et son Domaine,2,Les Grands Courants de la Pensee Economique,8,157,7,QCM,0.8,0.16,14.96,8,45,53,30,8,22,1.77,26.67,Moyen,Difficile,-1,Plus Difficile,Pas Adapte
2378,2017,Economie,1,L'Economie et son Domaine,2,Les Grands Courants de la Pensee Economique,8,157,7,QROC,0.07,0.86,82.66,50,11,61,55,50,5,1.11,90.91,Difficile,Facile,2,Beaucoup plus Facile,Pas Adapte
3489,2018,Economie,1,L'Economie et son Domaine,2,Les Grands Courants de la Pensee Economique,8,157,7,QCU,0.36,0.62,64.65,39,21,60,48,39,9,1.25,81.25,Difficile,Moyen,1,Plus Facile,Pas Adapte
4600,2019,Economie,1,L'Economie et son Domaine,2,Les Grands Courants de la Pensee Economique,8,157,7,QCU,0.02,0.89,73.77,49,18,67,64,49,15,1.05,76.56,Facile,Facile,0,Meme Difficulté,Adapte
5711,2020,Economie,1,L'Economie et son Domaine,2,Les Grands Courants de la Pensee Economique,8,157,7,QCU,0.06,0.84,73.77,53,19,72,54,53,1,1.33,98.15,Facile,Facile,0,Meme Difficulté,Adapte
157,2015,Economie,1,L'Economie et son Domaine,2,Les Grands Courants de la Pensee Economique,8,158,8,QO,0.16,0.75,72.91,61,22,83,81,61,20,1.02,75.31,Facile,Facile,0,Meme Difficulté,Adapte
1268,2016,Economie,1,L'Economie et son Domaine,2,Les Grands Courants de la Pensee Economique,8,158,8,QO,0.06,0.72,72.91,67,25,92,74,67,7,1.24,90.54,Facile,Facile,0,Meme Difficulté,Adapte
2379,2017,Economie,1,L'Economie et son Domaine,2,Les Grands Courants de la Pensee Economique,8,158,8,QO,0.17,0.91,72.91,70,26,96,71,70,1,1.35,98.59,Facile,Facile,0,Meme Difficulté,Adapte
3490,2018,Economie,1,L'Economie et son Domaine,2,Les Grands Courants de la Pensee Economique,8,158,8,QCU,0.02,0.86,72.91,69,25,94,70,69,1,1.34,98.57,Facile,Facile,0,Meme Difficulté,Adapte
4601,2019,Economie,1,L'Economie et son Domaine,2,Les Grands Courants de la Pensee Economique,8,158,8,QCU,0.18,0.94,72.91,69,26,95,86,69,17,1.1,80.23,Facile,Facile,0,Meme Difficulté,Adapte
5712,2020,Economie,1,L'Economie et son Domaine,2,Les Grands Courants de la Pensee Economique,8,158,8,QCU,0.2,0.89,72.91,66,24,90,75,66,9,1.2,88.0,Facile,Facile,0,Meme Difficulté,Adapte
158,2015,Economie,1,L'Economie et son Domaine,3,Modele d'Organisation de la Societe et Systeme Economique,10,159,1,QCU,0.23,0.5,60.62,6,4,10,9,6,3,1.11,66.67,Facile,Moyen,-1,Plus Difficile,Pas Adapte
1269,2016,Economie,1,L'Economie et son Domaine,3,Modele d'Organisation de la Societe et Systeme Economique,10,159,1,QCU,0.67,0.2,16.33,2,10,12,10,2,8,1.2,20.0,Difficile,Difficile,0,Meme Difficulté,Pas Adapte
2380,2017,Economie,1,L'Economie et son Domaine,3,Modele d'Organisation de la Societe et Systeme Economique,10,159,1,QCM,0.73,0.19,8.79,1,11,12,3,1,2,4.0,33.33,Facile,Difficile,-2,Beaucoup plus Difficile,Pas Adapte
3491,2018,Economie,1,L'Economie et son Domaine,3,Modele d'Organisation de la Societe et Systeme Economique,10,159,1,QCM,0.56,0.27,22.58,2,8,10,7,2,5,1.43,28.57,Moyen,Difficile,-1,Plus Difficile,Pas Adapte
4602,2019,Economie,1,L'Economie et son Domaine,3,Modele d'Organisation de la Societe et Systeme Economique,10,159,1,QCM,0.18,0.7,66.05,6,3,9,8,6,2,1.12,75.0,Difficile,Facile,2,Beaucoup plus Facile,Adapte
5713,2020,Economie,1,L'Economie et son Domaine,3,Modele d'Organisation de la Societe et Systeme Economique,10,159,1,QCU,0.02,0.85,66.05,7,3,10,9,7,2,1.11,77.78,Facile,Facile,0,Meme Difficulté,Adapte
159,2015,Economie,1,L'Economie et son Domaine,3,Modele d'Organisation de la Societe et Systeme Economique,10,160,2,QROC,0.09,0.81,71.51,16,7,23,17,16,1,1.35,94.12,Moyen,Facile,1,Plus Facile,Adapte
1270,2016,Economie,1,L'Economie et son Domaine,3,Modele d'Organisation de la Societe et Systeme Economique,10,160,2,QROC,0.08,0.9,71.51,17,7,24,17,17,0,1.41,100.0,Facile,Facile,0,Meme Difficulté,Adapte
2381,2017,Economie,1,L'Economie et son Domaine,3,Modele d'Organisation de la Societe et Systeme Economique,10,160,2,QROC,0.04,0.53,71.51,17,7,24,20,17,3,1.2,85.0,Facile,Facile,0,Meme Difficulté,Adapte
3492,2018,Economie,1,L'Economie et son Domaine,3,Modele d'Organisation de la Societe et Systeme Economique,10,160,2,QROC,0.13,0.57,71.51,16,6,22,18,16,2,1.22,88.89,Facile,Facile,0,Meme Difficulté,Adapte
4603,2019,Economie,1,L'Economie et son Domaine,3,Modele d'Organisation de la Societe et Systeme Economique,10,160,2,QO,0.06,0.76,71.51,18,7,25,20,18,2,1.25,90.0,Facile,Facile,0,Meme Difficulté,Adapte
5714,2020,Economie,1,L'Economie et son Domaine,3,Modele d'Organisation de la Societe et Systeme Economique,10,160,2,QO,0.03,0.51,71.51,16,7,23,19,16,3,1.21,84.21,Facile,Facile,0,Meme Difficulté,Adapte
160,2015,Economie,1,L'Economie et son Domaine,3,Modele d'Organisation de la Societe et Systeme Economique,10,161,3,QCU,0.26,0.64,42.15,19,26,45,41,19,22,1.1,46.34,Moyen,Moyen,0,Meme Difficulté,Pas Adapte
1271,2016,Economie,1,L'Economie et son Domaine,3,Modele d'Organisation de la Societe et Systeme Economique,10,161,3,QCM,0.54,0.28,34.27,15,29,44,26,15,11,1.69,57.69,Difficile,Difficile,0,Meme Difficulté,Pas Adapte
2382,2017,Economie,1,L'Economie et son Domaine,3,Modele d'Organisation de la Societe et Systeme Economique,10,161,3,QCM,0.02,0.99,81.78,34,7,41,36,34,2,1.14,94.44,Moyen,Facile,1,Plus Facile,Pas Adapte
3493,2018,Economie,1,L'Economie et son Domaine,3,Modele d'Organisation de la Societe et Systeme Economique,10,161,3,QCM,0.0,0.71,90.03,41,4,45,42,41,1,1.07,97.62,Facile,Facile,0,Meme Difficulté,Pas Adapte
4604,2019,Economie,1,L'Economie et son Domaine,3,Modele d'Organisation de la Societe et Systeme Economique,10,161,3,QCM,0.58,0.21,18.21,8,37,45,43,8,35,1.05,18.6,Moyen,Difficile,-1,Plus Difficile,Pas Adapte
5715,2020,Economie,1,L'Economie et son Domaine,3,Modele d'Organisation de la Societe et Systeme Economique,10,161,3,QCM,0.74,0.29,17.53,9,41,50,49,9,40,1.02,18.37,Difficile,Difficile,0,Meme Difficulté,Pas Adapte
161,2015,Economie,1,L'Economie et son Domaine,3,Modele d'Organisation de la Societe et Systeme Economique,10,162,4,QCU,0.04,0.95,68.63,8,3,11,10,8,2,1.1,80.0,Moyen,Facile,1,Plus Facile,Adapte
1272,2016,Economie,1,L'Economie et son Domaine,3,Modele d'Organisation de la Societe et Systeme Economique,10,162,4,QCU,0.03,0.82,68.63,7,3,10,10,7,3,1.0,70.0,Facile,Facile,0,Meme Difficulté,Adapte
2383,2017,Economie,1,L'Economie et son Domaine,3,Modele d'Organisation de la Societe et Systeme Economique,10,162,4,QCU,0.09,0.78,68.63,8,3,11,10,8,2,1.1,80.0,Facile,Facile,0,Meme Difficulté,Adapte
3494,2018,Economie,1,L'Economie et son Domaine,3,Modele d'Organisation de la Societe et Systeme Economique,10,162,4,QCU,0.05,0.8,68.63,8,4,12,9,8,1,1.33,88.89,Facile,Facile,0,Meme Difficulté,Adapte
4605,2019,Economie,1,L'Economie et son Domaine,3,Modele d'Organisation de la Societe et Systeme Economique,10,162,4,QCU,0.01,0.88,68.63,10,4,14,11,10,1,1.27,90.91,Facile,Facile,0,Meme Difficulté,Adapte
5716,2020,Economie,1,L'Economie et son Domaine,3,Modele d'Organisation de la Societe et Systeme Economique,10,162,4,QCU,0.2,0.88,68.63,10,5,15,14,10,4,1.07,71.43,Facile,Facile,0,Meme Difficulté,Adapte
162,2015,Economie,1,L'Economie et son Domaine,3,Modele d'Organisation de la Societe et Systeme Economique,10,163,5,QCU,0.58,0.31,4.1,4,93,97,80,4,76,1.21,5.0,Facile,Difficile,-2,Beaucoup plus Difficile,Pas Adapte
1273,2016,Economie,1,L'Economie et son Domaine,3,Modele d'Organisation de la Societe et Systeme Economique,10,163,5,QCU,0.36,0.73,42.84,37,50,87,70,37,33,1.24,52.86,Facile,Moyen,-1,Plus Difficile,Pas Adapte
2384,2017,Economie,1,L'Economie et son Domaine,3,Modele d'Organisation de la Societe et Systeme Economique,10,163,5,QCU,0.41,0.32,23.24,21,69,90,82,21,61,1.1,25.61,Difficile,Difficile,0,Meme Difficulté,Pas Adapte
3495,2018,Economie,1,L'Economie et son Domaine,3,Modele d'Organisation de la Societe et Systeme Economique,10,163,5,QCU,0.65,0.2,2.48,2,86,88,54,2,52,1.63,3.7,Difficile,Difficile,0,Meme Difficulté,Pas Adapte
4606,2019,Economie,1,L'Economie et son Domaine,3,Modele d'Organisation de la Societe et Systeme Economique,10,163,5,QCU,0.38,0.74,55.92,45,36,81,66,45,21,1.23,68.18,Facile,Moyen,-1,Plus Difficile,Pas Adapte
5717,2020,Economie,1,L'Economie et son Domaine,3,Modele d'Organisation de la Societe et Systeme Economique,10,163,5,QCU,0.25,0.43,55.66,43,35,78,76,43,33,1.03,56.58,Facile,Moyen,-1,Plus Difficile,Pas Adapte
163,2015,Economie,1,L'Economie et son Domaine,3,Modele d'Organisation de la Societe et Systeme Economique,10,164,6,QCM,0.06,0.79,92.43,35,3,38,38,35,3,1.0,92.11,Facile,Facile,0,Meme Difficulté,Pas Adapte
1274,2016,Economie,1,L'Economie et son Domaine,3,Modele d'Organisation de la Societe et Systeme Economique,10,164,6,QCM,0.35,0.65,36.19,12,22,34,28,12,16,1.21,42.86,Moyen,Moyen,0,Meme Difficulté,Pas Adapte
2385,2017,Economie,1,L'Economie et son Domaine,3,Modele d'Organisation de la Societe et Systeme Economique,10,164,6,QCM,0.37,0.4,54.71,16,13,29,18,16,2,1.61,88.89,Moyen,Moyen,0,Meme Difficulté,Pas Adapte
3496,2018,Economie,1,L'Economie et son Domaine,3,Modele d'Organisation de la Societe et Systeme Economique,10,164,6,QCU,0.29,0.71,54.88,15,13,28,22,15,7,1.27,68.18,Moyen,Moyen,0,Meme Difficulté,Pas Adapte
4607,2019,Economie,1,L'Economie et son Domaine,3,Modele d'Organisation de la Societe et Systeme Economique,10,164,6,QCU,0.39,0.52,56.17,16,13,29,29,16,13,1.0,55.17,Difficile,Moyen,1,Plus Facile,Pas Adapte
5718,2020,Economie,1,L'Economie et son Domaine,3,Modele d'Organisation de la Societe et Systeme Economique,10,164,6,QCU,0.72,0.36,11.74,4,28,32,22,4,18,1.45,18.18,Difficile,Difficile,0,Meme Difficulté,Pas Adapte
164,2015,Economie,1,L'Economie et son Domaine,3,Modele d'Organisation de la Societe et Systeme Economique,10,165,7,QCM,0.34,0.66,64.51,25,14,39,32,25,7,1.22,78.12,Moyen,Moyen,0,Meme Difficulté,Pas Adapte
1275,2016,Economie,1,L'Economie et son Domaine,3,Modele d'Organisation de la Societe et Systeme Economique,10,165,7,QCU,0.46,0.25,19.97,7,29,36,17,7,10,2.12,41.18,Facile,Difficile,-2,Beaucoup plus Difficile,Pas Adapte
2386,2017,Economie,1,L'Economie et son Domaine,3,Modele d'Organisation de la Societe et Systeme Economique,10,165,7,QCU,0.08,0.79,67.78,25,12,37,33,25,8,1.12,75.76,Difficile,Facile,2,Beaucoup plus Facile,Adapte
3497,2018,Economie,1,L'Economie et son Domaine,3,Modele d'Organisation de la Societe et Systeme Economique,10,165,7,QCM,0.08,0.94,67.78,24,11,35,28,24,4,1.25,85.71,Facile,Facile,0,Meme Difficulté,Adapte
4608,2019,Economie,1,L'Economie et son Domaine,3,Modele d'Organisation de la Societe et Systeme Economique,10,165,7,QROC,0.16,0.93,67.78,22,10,32,26,22,4,1.23,84.62,Facile,Facile,0,Meme Difficulté,Adapte
5719,2020,Economie,1,L'Economie et son Domaine,3,Modele d'Organisation de la Societe et Systeme Economique,10,165,7,QROC,0.18,0.89,67.78,23,11,34,31,23,8,1.1,74.19,Facile,Facile,0,Meme Difficulté,Adapte
165,2015,Economie,1,L'Economie et son Domaine,3,Modele d'Organisation de la Societe et Systeme Economique,10,166,8,QO,0.57,0.28,49.28,44,46,90,87,44,43,1.03,50.57,Moyen,Moyen,0,Meme Difficulté,Pas Adapte
1276,2016,Economie,1,L'Economie et son Domaine,3,Modele d'Organisation de la Societe et Systeme Economique,10,166,8,QO,0.89,0.01,26.97,22,59,81,68,22,46,1.19,32.35,Difficile,Difficile,0,Meme Difficulté,Pas Adapte
2387,2017,Economie,1,L'Economie et son Domaine,3,Modele d'Organisation de la Societe et Systeme Economique,10,166,8,QO,0.85,0.1,34.31,32,61,93,51,32,19,1.82,62.75,Facile,Difficile,-2,Beaucoup plus Difficile,Pas Adapte
3498,2018,Economie,1,L'Economie et son Domaine,3,Modele d'Organisation de la Societe et Systeme Economique,10,166,8,QO,0.84,0.05,0.08,0,96,96,76,0,76,1.26,0.0,Facile,Difficile,-2,Beaucoup plus Difficile,Pas Adapte
4609,2019,Economie,1,L'Economie et son Domaine,3,Modele d'Organisation de la Societe et Systeme Economique,10,166,8,QO,0.7,0.21,52.79,48,42,90,55,48,7,1.64,87.27,Difficile,Moyen,1,Plus Facile,Pas Adapte
5720,2020,Economie,1,L'Economie et son Domaine,3,Modele d'Organisation de la Societe et Systeme Economique,10,166,8,QO,0.02,0.81,70.06,70,30,100,85,70,15,1.18,82.35,Difficile,Facile,2,Beaucoup plus Facile,Adapte
166,2015,Economie,1,L'Economie et son Domaine,3,Modele d'Organisation de la Societe et Systeme Economique,10,167,9,QCU,0.32,0.42,40.47,34,50,84,82,34,48,1.02,41.46,Facile,Moyen,-1,Plus Difficile,Pas Adapte
1277,2016,Economie,1,L'Economie et son Domaine,3,Modele d'Organisation de la Societe et Systeme Economique,10,167,9,QCU,0.03,0.92,69.51,67,29,96,96,67,29,1.0,69.79,Facile,Facile,0,Meme Difficulté,Adapte
2388,2017,Economie,1,L'Economie et son Domaine,3,Modele d'Organisation de la Societe et Systeme Economique,10,167,9,QCU,0.05,0.85,69.51,70,31,101,91,70,21,1.11,76.92,Facile,Facile,0,Meme Difficulté,Adapte
3499,2018,Economie,1,L'Economie et son Domaine,3,Modele d'Organisation de la Societe et Systeme Economique,10,167,9,QCU,0.18,0.81,69.51,66,29,95,80,66,14,1.19,82.5,Facile,Facile,0,Meme Difficulté,Adapte
4610,2019,Economie,1,L'Economie et son Domaine,3,Modele d'Organisation de la Societe et Systeme Economique,10,167,9,QCU,0.05,0.83,69.51,59,26,85,79,59,20,1.08,74.68,Facile,Facile,0,Meme Difficulté,Adapte
5721,2020,Economie,1,L'Economie et son Domaine,3,Modele d'Organisation de la Societe et Systeme Economique,10,167,9,QCU,0.03,0.87,69.51,65,28,93,78,65,13,1.19,83.33,Facile,Facile,0,Meme Difficulté,Adapte
167,2015,Economie,1,L'Economie et son Domaine,3,Modele d'Organisation de la Societe et Systeme Economique,10,168,10,QCU,0.54,0.34,11.29,4,30,34,26,4,22,1.31,15.38,Facile,Difficile,-2,Beaucoup plus Difficile,Pas Adapte
1278,2016,Economie,1,L'Economie et son Domaine,3,Modele d'Organisation de la Societe et Systeme Economique,10,168,10,QCU,0.45,0.25,30.99,11,23,34,24,11,13,1.42,45.83,Facile,Difficile,-2,Beaucoup plus Difficile,Pas Adapte
2389,2017,Economie,1,L'Economie et son Domaine,3,Modele d'Organisation de la Societe et Systeme Economique,10,168,10,QCU,0.4,0.46,64.0,24,13,37,31,24,7,1.19,77.42,Difficile,Moyen,1,Plus Facile,Pas Adapte
3500,2018,Economie,1,L'Economie et son Domaine,3,Modele d'Organisation de la Societe et Systeme Economique,10,168,10,QCU,0.28,0.52,37.11,14,25,39,24,14,10,1.62,58.33,Difficile,Moyen,1,Plus Facile,Pas Adapte
4611,2019,Economie,1,L'Economie et son Domaine,3,Modele d'Organisation de la Societe et Systeme Economique,10,168,10,QCU,0.73,0.21,21.61,8,27,35,31,8,23,1.13,25.81,Moyen,Difficile,-1,Plus Difficile,Pas Adapte
5722,2020,Economie,1,L'Economie et son Domaine,3,Modele d'Organisation de la Societe et Systeme Economique,10,168,10,QCM,0.15,0.81,94.37,33,2,35,34,33,1,1.03,97.06,Facile,Facile,0,Meme Difficulté,Pas Adapte
168,2015,Economie,2,La Representation de l'Activite Economique: Le Circuit Economique,1,Les Agents Economiques et leurs Operations,8,169,1,QCM,0.12,0.71,86.51,24,4,28,26,24,2,1.08,92.31,Moyen,Facile,1,Plus Facile,Pas Adapte
1279,2016,Economie,2,La Representation de l'Activite Economique: Le Circuit Economique,1,Les Agents Economiques et leurs Operations,8,169,1,QCM,0.76,0.17,15.92,5,26,31,16,5,11,1.94,31.25,Moyen,Difficile,-1,Plus Difficile,Pas Adapte
2390,2017,Economie,2,La Representation de l'Activite Economique: Le Circuit Economique,1,Les Agents Economiques et leurs Operations,8,169,1,QO,0.83,0.15,24.73,7,22,29,20,7,13,1.45,35.0,Moyen,Difficile,-1,Plus Difficile,Pas Adapte
3501,2018,Economie,2,La Representation de l'Activite Economique: Le Circuit Economique,1,Les Agents Economiques et leurs Operations,8,169,1,QO,0.4,0.17,37.51,11,18,29,18,11,7,1.61,61.11,Moyen,Moyen,0,Meme Difficulté,Pas Adapte
4612,2019,Economie,2,La Representation de l'Activite Economique: Le Circuit Economique,1,Les Agents Economiques et leurs Operations,8,169,1,QO,0.13,0.87,65.86,18,9,27,23,18,5,1.17,78.26,Moyen,Facile,1,Plus Facile,Adapte
5723,2020,Economie,2,La Representation de l'Activite Economique: Le Circuit Economique,1,Les Agents Economiques et leurs Operations,8,169,1,QCU,0.13,0.88,65.86,17,9,26,24,17,7,1.08,70.83,Facile,Facile,0,Meme Difficulté,Adapte
169,2015,Economie,2,La Representation de l'Activite Economique: Le Circuit Economique,1,Les Agents Economiques et leurs Operations,8,170,2,QO,0.02,0.61,72.18,40,15,55,55,40,15,1.0,72.73,Difficile,Facile,2,Beaucoup plus Facile,Adapte
1280,2016,Economie,2,La Representation de l'Activite Economique: Le Circuit Economique,1,Les Agents Economiques et leurs Operations,8,170,2,QROC,0.16,0.56,72.18,41,16,57,49,41,8,1.16,83.67,Facile,Facile,0,Meme Difficulté,Adapte
2391,2017,Economie,2,La Representation de l'Activite Economique: Le Circuit Economique,1,Les Agents Economiques et leurs Operations,8,170,2,QO,0.15,0.96,72.18,35,13,48,35,35,0,1.37,100.0,Facile,Facile,0,Meme Difficulté,Adapte
3502,2018,Economie,2,La Representation de l'Activite Economique: Le Circuit Economique,1,Les Agents Economiques et leurs Operations,8,170,2,QO,0.16,0.35,72.18,34,13,47,42,34,8,1.12,80.95,Facile,Facile,0,Meme Difficulté,Adapte
4613,2019,Economie,2,La Representation de l'Activite Economique: Le Circuit Economique,1,Les Agents Economiques et leurs Operations,8,170,2,QO,0.12,0.73,72.18,39,15,54,49,39,10,1.1,79.59,Facile,Facile,0,Meme Difficulté,Adapte
5724,2020,Economie,2,La Representation de l'Activite Economique: Le Circuit Economique,1,Les Agents Economiques et leurs Operations,8,170,2,QO,0.12,0.6,72.18,42,16,58,51,42,9,1.14,82.35,Facile,Facile,0,Meme Difficulté,Adapte
170,2015,Economie,2,La Representation de l'Activite Economique: Le Circuit Economique,1,Les Agents Economiques et leurs Operations,8,171,3,QCU,0.3,0.64,56.85,38,29,67,66,38,28,1.02,57.58,Facile,Moyen,-1,Plus Difficile,Pas Adapte
1281,2016,Economie,2,La Representation de l'Activite Economique: Le Circuit Economique,1,Les Agents Economiques et leurs Operations,8,171,3,QCU,0.39,0.57,46.88,27,31,58,28,27,1,2.07,96.43,Difficile,Moyen,1,Plus Facile,Pas Adapte
2392,2017,Economie,2,La Representation de l'Activite Economique: Le Circuit Economique,1,Les Agents Economiques et leurs Operations,8,171,3,QCM,0.48,0.45,59.1,37,25,62,39,37,2,1.59,94.87,Difficile,Moyen,1,Plus Facile,Pas Adapte
3503,2018,Economie,2,La Representation de l'Activite Economique: Le Circuit Economique,1,Les Agents Economiques et leurs Operations,8,171,3,QCM,0.04,0.97,80.29,54,13,67,56,54,2,1.2,96.43,Facile,Facile,0,Meme Difficulté,Pas Adapte
4614,2019,Economie,2,La Representation de l'Activite Economique: Le Circuit Economique,1,Les Agents Economiques et leurs Operations,8,171,3,QCM,0.01,0.83,77.3,53,16,69,61,53,8,1.13,86.89,Difficile,Facile,2,Beaucoup plus Facile,Pas Adapte
5725,2020,Economie,2,La Representation de l'Activite Economique: Le Circuit Economique,1,Les Agents Economiques et leurs Operations,8,171,3,QCM,0.5,0.19,18.66,14,62,76,42,14,28,1.81,33.33,Difficile,Difficile,0,Meme Difficulté,Pas Adapte
171,2015,Economie,2,La Representation de l'Activite Economique: Le Circuit Economique,1,Les Agents Economiques et leurs Operations,8,172,4,QROC,0.08,0.63,92.91,58,4,62,59,58,1,1.05,98.31,Moyen,Facile,1,Plus Facile,Pas Adapte
1282,2016,Economie,2,La Representation de l'Activite Economique: Le Circuit Economique,1,Les Agents Economiques et leurs Operations,8,172,4,QROC,0.1,0.56,68.5,42,19,61,43,42,1,1.42,97.67,Difficile,Facile,2,Beaucoup plus Facile,Adapte
2393,2017,Economie,2,La Representation de l'Activite Economique: Le Circuit Economique,1,Les Agents Economiques et leurs Operations,8,172,4,QROC,0.12,0.79,68.5,42,20,62,51,42,9,1.22,82.35,Facile,Facile,0,Meme Difficulté,Adapte
3504,2018,Economie,2,La Representation de l'Activite Economique: Le Circuit Economique,1,Les Agents Economiques et leurs Operations,8,172,4,QROC,0.03,0.95,68.5,44,20,64,44,44,0,1.45,100.0,Facile,Facile,0,Meme Difficulté,Adapte
4615,2019,Economie,2,La Representation de l'Activite Economique: Le Circuit Economique,1,Les Agents Economiques et leurs Operations,8,172,4,QCM,0.02,0.76,68.5,43,20,63,55,43,12,1.15,78.18,Facile,Facile,0,Meme Difficulté,Adapte
5726,2020,Economie,2,La Representation de l'Activite Economique: Le Circuit Economique,1,Les Agents Economiques et leurs Operations,8,172,4,QCM,0.01,0.95,68.5,49,23,72,62,49,13,1.16,79.03,Facile,Facile,0,Meme Difficulté,Adapte
172,2015,Economie,2,La Representation de l'Activite Economique: Le Circuit Economique,1,Les Agents Economiques et leurs Operations,8,173,5,QCM,0.34,0.37,61.89,5,3,8,8,5,3,1.0,62.5,Difficile,Moyen,1,Plus Facile,Pas Adapte
1283,2016,Economie,2,La Representation de l'Activite Economique: Le Circuit Economique,1,Les Agents Economiques et leurs Operations,8,173,5,QCM,0.62,0.3,15.89,1,6,7,4,1,3,1.75,25.0,Difficile,Difficile,0,Meme Difficulté,Pas Adapte
2394,2017,Economie,2,La Representation de l'Activite Economique: Le Circuit Economique,1,Les Agents Economiques et leurs Operations,8,173,5,QCM,0.11,0.81,75.14,5,2,7,5,5,0,1.4,100.0,Moyen,Facile,1,Plus Facile,Pas Adapte
3505,2018,Economie,2,La Representation de l'Activite Economique: Le Circuit Economique,1,Les Agents Economiques et leurs Operations,8,173,5,QCM,0.02,0.77,65.61,5,2,7,5,5,0,1.4,100.0,Facile,Facile,0,Meme Difficulté,Adapte
4616,2019,Economie,2,La Representation de l'Activite Economique: Le Circuit Economique,1,Les Agents Economiques et leurs Operations,8,173,5,QCU,0.15,0.84,65.61,5,2,7,6,5,1,1.17,83.33,Facile,Facile,0,Meme Difficulté,Adapte
5727,2020,Economie,2,La Representation de l'Activite Economique: Le Circuit Economique,1,Les Agents Economiques et leurs Operations,8,173,5,QCU,0.18,0.95,65.61,4,2,6,4,4,0,1.5,100.0,Facile,Facile,0,Meme Difficulté,Adapte
173,2015,Economie,2,La Representation de l'Activite Economique: Le Circuit Economique,1,Les Agents Economiques et leurs Operations,8,174,6,QCU,0.7,0.31,22.74,13,46,59,31,13,18,1.9,41.94,Difficile,Difficile,0,Meme Difficulté,Pas Adapte
1284,2016,Economie,2,La Representation de l'Activite Economique: Le Circuit Economique,1,Les Agents Economiques et leurs Operations,8,174,6,QCU,0.42,0.38,33.97,20,40,60,27,20,7,2.22,74.07,Moyen,Difficile,-1,Plus Difficile,Pas Adapte
2395,2017,Economie,2,La Representation de l'Activite Economique: Le Circuit Economique,1,Les Agents Economiques et leurs Operations,8,174,6,QCU,0.48,0.2,14.93,9,51,60,34,9,25,1.76,26.47,Facile,Difficile,-2,Beaucoup plus Difficile,Pas Adapte
3506,2018,Economie,2,La Representation de l'Activite Economique: Le Circuit Economique,1,Les Agents Economiques et leurs Operations,8,174,6,QCU,0.24,0.48,57.19,38,28,66,62,38,24,1.06,61.29,Moyen,Moyen,0,Meme Difficulté,Pas Adapte
4617,2019,Economie,2,La Representation de l'Activite Economique: Le Circuit Economique,1,Les Agents Economiques et leurs Operations,8,174,6,QCU,0.33,0.59,58.82,33,23,56,46,33,13,1.22,71.74,Facile,Moyen,-1,Plus Difficile,Pas Adapte
5728,2020,Economie,2,La Representation de l'Activite Economique: Le Circuit Economique,1,Les Agents Economiques et leurs Operations,8,174,6,QO,0.5,0.29,35.29,21,38,59,47,21,26,1.26,44.68,Difficile,Moyen,1,Plus Facile,Pas Adapte
174,2015,Economie,2,La Representation de l'Activite Economique: Le Circuit Economique,1,Les Agents Economiques et leurs Operations,8,175,7,QCM,0.73,0.21,31.95,21,44,65,21,21,0,3.1,100.0,Difficile,Difficile,0,Meme Difficulté,Pas Adapte
1285,2016,Economie,2,La Representation de l'Activite Economique: Le Circuit Economique,1,Les Agents Economiques et leurs Operations,8,175,7,QCM,0.7,0.23,27.31,19,50,69,26,19,7,2.65,73.08,Facile,Difficile,-2,Beaucoup plus Difficile,Pas Adapte
2396,2017,Economie,2,La Representation de l'Activite Economique: Le Circuit Economique,1,Les Agents Economiques et leurs Operations,8,175,7,QCM,0.05,0.79,69.26,44,20,64,62,44,18,1.03,70.97,Difficile,Facile,2,Beaucoup plus Facile,Adapte
3507,2018,Economie,2,La Representation de l'Activite Economique: Le Circuit Economique,1,Les Agents Economiques et leurs Operations,8,175,7,QCM,0.08,0.81,69.26,51,23,74,58,51,7,1.28,87.93,Facile,Facile,0,Meme Difficulté,Adapte
4618,2019,Economie,2,La Representation de l'Activite Economique: Le Circuit Economique,1,Les Agents Economiques et leurs Operations,8,175,7,QCM,0.03,0.85,69.26,56,25,81,58,56,2,1.4,96.55,Facile,Facile,0,Meme Difficulté,Adapte
5729,2020,Economie,2,La Representation de l'Activite Economique: Le Circuit Economique,1,Les Agents Economiques et leurs Operations,8,175,7,QCM,0.02,0.82,69.26,60,26,86,72,60,12,1.19,83.33,Facile,Facile,0,Meme Difficulté,Adapte
175,2015,Economie,2,La Representation de l'Activite Economique: Le Circuit Economique,1,Les Agents Economiques et leurs Operations,8,176,8,QCU,0.48,0.26,18.99,9,39,48,25,9,16,1.92,36.0,Facile,Difficile,-2,Beaucoup plus Difficile,Pas Adapte
1286,2016,Economie,2,La Representation de l'Activite Economique: Le Circuit Economique,1,Les Agents Economiques et leurs Operations,8,176,8,QROC,0.14,0.56,95.53,47,2,49,47,47,0,1.04,100.0,Moyen,Facile,1,Plus Facile,Pas Adapte
2397,2017,Economie,2,La Representation de l'Activite Economique: Le Circuit Economique,1,Les Agents Economiques et leurs Operations,8,176,8,QROC,0.26,0.28,36.64,19,34,53,22,19,3,2.41,86.36,Difficile,Moyen,1,Plus Facile,Pas Adapte
3508,2018,Economie,2,La Representation de l'Activite Economique: Le Circuit Economique,1,Les Agents Economiques et leurs Operations,8,176,8,QROC,0.82,0.23,23.19,11,36,47,46,11,35,1.02,23.91,Difficile,Difficile,0,Meme Difficulté,Pas Adapte
4619,2019,Economie,2,La Representation de l'Activite Economique: Le Circuit Economique,1,Les Agents Economiques et leurs Operations,8,176,8,QROC,0.88,0.05,28.86,12,31,43,22,12,10,1.95,54.55,Facile,Difficile,-2,Beaucoup plus Difficile,Pas Adapte
5730,2020,Economie,2,La Representation de l'Activite Economique: Le Circuit Economique,1,Les Agents Economiques et leurs Operations,8,176,8,QROC,0.89,0.14,7.0,3,35,38,33,3,30,1.15,9.09,Facile,Difficile,-2,Beaucoup plus Difficile,Pas Adapte
176,2015,Economie,2,La Representation de l'Activite Economique: Le Circuit Economique,2,Le Circuit Economique dans le Cadre National,5,177,1,QROC,0.99,0.2,14.5,7,40,47,38,7,31,1.24,18.42,Facile,Difficile,-2,Beaucoup plus Difficile,Pas Adapte
1287,2016,Economie,2,La Representation de l'Activite Economique: Le Circuit Economique,2,Le Circuit Economique dans le Cadre National,5,177,1,QROC,0.67,0.12,14.76,7,43,50,48,7,41,1.04,14.58,Facile,Difficile,-2,Beaucoup plus Difficile,Pas Adapte
2398,2017,Economie,2,La Representation de l'Activite Economique: Le Circuit Economique,2,Le Circuit Economique dans le Cadre National,5,177,1,QROC,0.02,0.52,66.12,30,16,46,42,30,12,1.1,71.43,Difficile,Facile,2,Beaucoup plus Facile,Adapte
3509,2018,Economie,2,La Representation de l'Activite Economique: Le Circuit Economique,2,Le Circuit Economique dans le Cadre National,5,177,1,QROC,0.07,0.94,66.12,34,18,52,51,34,17,1.02,66.67,Facile,Facile,0,Meme Difficulté,Adapte
4620,2019,Economie,2,La Representation de l'Activite Economique: Le Circuit Economique,2,Le Circuit Economique dans le Cadre National,5,177,1,QROC,0.14,0.82,66.12,29,15,44,35,29,6,1.26,82.86,Facile,Facile,0,Meme Difficulté,Adapte
5731,2020,Economie,2,La Representation de l'Activite Economique: Le Circuit Economique,2,Le Circuit Economique dans le Cadre National,5,177,1,QROC,0.08,0.92,66.12,25,13,38,25,25,0,1.52,100.0,Facile,Facile,0,Meme Difficulté,Adapte
177,2015,Economie,2,La Representation de l'Activite Economique: Le Circuit Economique,2,Le Circuit Economique dans le Cadre National,5,178,2,QROC,0.97,0.03,10.17,6,56,62,38,6,32,1.63,15.79,Moyen,Difficile,-1,Plus Difficile,Pas Adapte
1288,2016,Economie,2,La Representation de l'Activite Economique: Le Circuit Economique,2,Le Circuit Economique dans le Cadre National,5,178,2,QROC,0.94,0.01,4.08,3,63,66,37,3,34,1.78,8.11,Difficile,Difficile,0,Meme Difficulté,Pas Adapte
2399,2017,Economie,2,La Representation de l'Activite Economique: Le Circuit Economique,2,Le Circuit Economique dans le Cadre National,5,178,2,QROC,0.06,0.45,81.54,56,13,69,57,56,1,1.21,98.25,Difficile,Facile,2,Beaucoup plus Facile,Pas Adapte
3510,2018,Economie,2,La Representation de l'Activite Economique: Le Circuit Economique,2,Le Circuit Economique dans le Cadre National,5,178,2,QROC,0.34,0.39,43.43,29,38,67,36,29,7,1.86,80.56,Facile,Moyen,-1,Plus Difficile,Pas Adapte
4621,2019,Economie,2,La Representation de l'Activite Economique: Le Circuit Economique,2,Le Circuit Economique dans le Cadre National,5,178,2,QROC,0.95,0.01,33.21,26,51,77,49,26,23,1.57,53.06,Facile,Difficile,-2,Beaucoup plus Difficile,Pas Adapte
5732,2020,Economie,2,La Representation de l'Activite Economique: Le Circuit Economique,2,Le Circuit Economique dans le Cadre National,5,178,2,QROC,0.8,0.01,0.13,0,83,83,63,0,63,1.32,0.0,Difficile,Difficile,0,Meme Difficulté,Pas Adapte
178,2015,Economie,2,La Representation de l'Activite Economique: Le Circuit Economique,2,Le Circuit Economique dans le Cadre National,5,179,3,QCU,0.7,0.29,1.44,1,41,42,30,1,29,1.4,3.33,Facile,Difficile,-2,Beaucoup plus Difficile,Pas Adapte
1289,2016,Economie,2,La Representation de l'Activite Economique: Le Circuit Economique,2,Le Circuit Economique dans le Cadre National,5,179,3,QCU,0.55,0.31,21.21,9,35,44,38,9,29,1.16,23.68,Moyen,Difficile,-1,Plus Difficile,Pas Adapte
2400,2017,Economie,2,La Representation de l'Activite Economique: Le Circuit Economique,2,Le Circuit Economique dans le Cadre National,5,179,3,QCU,0.58,0.38,26.77,11,30,41,41,11,30,1.0,26.83,Difficile,Difficile,0,Meme Difficulté,Pas Adapte
3511,2018,Economie,2,La Representation de l'Activite Economique: Le Circuit Economique,2,Le Circuit Economique dans le Cadre National,5,179,3,QCU,0.07,0.77,83.37,38,7,45,44,38,6,1.02,86.36,Moyen,Facile,1,Plus Facile,Pas Adapte
4622,2019,Economie,2,La Representation de l'Activite Economique: Le Circuit Economique,2,Le Circuit Economique dans le Cadre National,5,179,3,QCU,0.59,0.34,34.0,17,33,50,33,17,16,1.52,51.52,Difficile,Difficile,0,Meme Difficulté,Pas Adapte
5733,2020,Economie,2,La Representation de l'Activite Economique: Le Circuit Economique,2,Le Circuit Economique dans le Cadre National,5,179,3,QCU,0.08,0.92,88.47,49,6,55,55,49,6,1.0,89.09,Facile,Facile,0,Meme Difficulté,Pas Adapte
179,2015,Economie,2,La Representation de l'Activite Economique: Le Circuit Economique,2,Le Circuit Economique dans le Cadre National,5,180,4,QCM,0.33,0.46,36.6,24,42,66,46,24,22,1.43,52.17,Moyen,Moyen,0,Meme Difficulté,Pas Adapte
1290,2016,Economie,2,La Representation de l'Activite Economique: Le Circuit Economique,2,Le Circuit Economique dans le Cadre National,5,180,4,QCM,0.36,0.38,46.92,33,37,70,56,33,23,1.25,58.93,Moyen,Moyen,0,Meme Difficulté,Pas Adapte
2401,2017,Economie,2,La Representation de l'Activite Economique: Le Circuit Economique,2,Le Circuit Economique dans le Cadre National,5,180,4,QCM,0.62,0.15,22.2,16,55,71,56,16,40,1.27,28.57,Moyen,Difficile,-1,Plus Difficile,Pas Adapte
3512,2018,Economie,2,La Representation de l'Activite Economique: Le Circuit Economique,2,Le Circuit Economique dans le Cadre National,5,180,4,QCU,0.4,0.27,17.19,12,55,67,39,12,27,1.72,30.77,Difficile,Difficile,0,Meme Difficulté,Pas Adapte
4623,2019,Economie,2,La Representation de l'Activite Economique: Le Circuit Economique,2,Le Circuit Economique dans le Cadre National,5,180,4,QCU,0.38,0.71,38.31,26,43,69,69,26,43,1.0,37.68,Moyen,Moyen,0,Meme Difficulté,Pas Adapte
5734,2020,Economie,2,La Representation de l'Activite Economique: Le Circuit Economique,2,Le Circuit Economique dans le Cadre National,5,180,4,QCU,0.01,0.91,78.37,57,16,73,57,57,0,1.28,100.0,Difficile,Facile,2,Beaucoup plus Facile,Pas Adapte
180,2015,Economie,2,La Representation de l'Activite Economique: Le Circuit Economique,2,Le Circuit Economique dans le Cadre National,5,181,5,QCM,0.12,0.93,89.87,15,2,17,15,15,0,1.13,100.0,Facile,Facile,0,Meme Difficulté,Pas Adapte
1291,2016,Economie,2,La Representation de l'Activite Economique: Le Circuit Economique,2,Le Circuit Economique dans le Cadre National,5,181,5,QCM,0.24,0.4,59.12,9,7,16,12,9,3,1.33,75.0,Moyen,Moyen,0,Meme Difficulté,Pas Adapte
2402,2017,Economie,2,La Representation de l'Activite Economique: Le Circuit Economique,2,Le Circuit Economique dans le Cadre National,5,181,5,QCM,0.5,0.22,27.55,4,11,15,13,4,9,1.15,30.77,Difficile,Difficile,0,Meme Difficulté,Pas Adapte
3513,2018,Economie,2,La Representation de l'Activite Economique: Le Circuit Economique,2,Le Circuit Economique dans le Cadre National,5,181,5,QCU,0.05,0.86,85.34,13,2,15,14,13,1,1.07,92.86,Facile,Facile,0,Meme Difficulté,Pas Adapte
4624,2019,Economie,2,La Representation de l'Activite Economique: Le Circuit Economique,2,Le Circuit Economique dans le Cadre National,5,181,5,QCU,0.05,0.86,71.65,11,5,16,13,11,2,1.23,84.62,Moyen,Facile,1,Plus Facile,Adapte
5735,2020,Economie,2,La Representation de l'Activite Economique: Le Circuit Economique,2,Le Circuit Economique dans le Cadre National,5,181,5,QCU,0.1,0.9,71.65,11,4,15,12,11,1,1.25,91.67,Facile,Facile,0,Meme Difficulté,Adapte
181,2015,Economie,2,La Representation de l'Activite Economique: Le Circuit Economique,3,Les Interdependances Economiques entre les Nations,7,182,1,QCM,0.28,0.6,57.27,5,3,8,8,5,3,1.0,62.5,Facile,Moyen,-1,Plus Difficile,Pas Adapte
1292,2016,Economie,2,La Representation de l'Activite Economique: Le Circuit Economique,3,Les Interdependances Economiques entre les Nations,7,182,1,QCM,0.49,0.35,51.14,5,4,9,6,5,1,1.5,83.33,Moyen,Moyen,0,Meme Difficulté,Pas Adapte
2403,2017,Economie,2,La Representation de l'Activite Economique: Le Circuit Economique,3,Les Interdependances Economiques entre les Nations,7,182,1,QCM,0.14,0.76,79.3,8,2,10,9,8,1,1.11,88.89,Facile,Facile,0,Meme Difficulté,Pas Adapte
3514,2018,Economie,2,La Representation de l'Activite Economique: Le Circuit Economique,3,Les Interdependances Economiques entre les Nations,7,182,1,QCM,0.56,0.18,0.88,0,11,11,5,0,5,2.2,0.0,Moyen,Difficile,-1,Plus Difficile,Pas Adapte
4625,2019,Economie,2,La Representation de l'Activite Economique: Le Circuit Economique,3,Les Interdependances Economiques entre les Nations,7,182,1,QCM,0.46,0.46,54.33,7,6,13,11,7,4,1.18,63.64,Facile,Moyen,-1,Plus Difficile,Pas Adapte
5736,2020,Economie,2,La Representation de l'Activite Economique: Le Circuit Economique,3,Les Interdependances Economiques entre les Nations,7,182,1,QCM,0.01,0.93,75.45,11,4,15,15,11,4,1.0,73.33,Difficile,Facile,2,Beaucoup plus Facile,Pas Adapte
182,2015,Economie,2,La Representation de l'Activite Economique: Le Circuit Economique,3,Les Interdependances Economiques entre les Nations,7,183,2,QCU,0.06,0.9,72.97,39,14,53,43,39,4,1.23,90.7,Difficile,Facile,2,Beaucoup plus Facile,Adapte
1293,2016,Economie,2,La Representation de l'Activite Economique: Le Circuit Economique,3,Les Interdependances Economiques entre les Nations,7,183,2,QCU,0.17,0.94,72.97,33,12,45,40,33,7,1.12,82.5,Facile,Facile,0,Meme Difficulté,Adapte
2404,2017,Economie,2,La Representation de l'Activite Economique: Le Circuit Economique,3,Les Interdependances Economiques entre les Nations,7,183,2,QCU,0.01,0.9,72.97,29,11,40,35,29,6,1.14,82.86,Facile,Facile,0,Meme Difficulté,Adapte
3515,2018,Economie,2,La Representation de l'Activite Economique: Le Circuit Economique,3,Les Interdependances Economiques entre les Nations,7,183,2,QCU,0.16,1.0,72.97,30,11,41,37,30,7,1.11,81.08,Facile,Facile,0,Meme Difficulté,Adapte
4626,2019,Economie,2,La Representation de l'Activite Economique: Le Circuit Economique,3,Les Interdependances Economiques entre les Nations,7,183,2,QCU,0.03,0.79,72.97,33,12,45,33,33,0,1.36,100.0,Facile,Facile,0,Meme Difficulté,Adapte
5737,2020,Economie,2,La Representation de l'Activite Economique: Le Circuit Economique,3,Les Interdependances Economiques entre les Nations,7,183,2,QCU,0.11,0.81,72.97,29,11,40,30,29,1,1.33,96.67,Facile,Facile,0,Meme Difficulté,Adapte
183,2015,Economie,2,La Representation de l'Activite Economique: Le Circuit Economique,3,Les Interdependances Economiques entre les Nations,7,184,3,QCM,0.12,0.96,94.23,93,6,99,96,93,3,1.03,96.88,Moyen,Facile,1,Plus Facile,Pas Adapte
1294,2016,Economie,2,La Representation de l'Activite Economique: Le Circuit Economique,3,Les Interdependances Economiques entre les Nations,7,184,3,QCM,0.21,0.61,51.45,58,55,113,62,58,4,1.82,93.55,Difficile,Moyen,1,Plus Facile,Pas Adapte
2405,2017,Economie,2,La Representation de l'Activite Economique: Le Circuit Economique,3,Les Interdependances Economiques entre les Nations,7,184,3,QCM,0.77,0.27,32.59,33,68,101,55,33,22,1.84,60.0,Moyen,Difficile,-1,Plus Difficile,Pas Adapte
3516,2018,Economie,2,La Representation de l'Activite Economique: Le Circuit Economique,3,Les Interdependances Economiques entre les Nations,7,184,3,QCM,0.14,0.88,69.05,79,36,115,109,79,30,1.06,72.48,Facile,Facile,0,Meme Difficulté,Adapte
4627,2019,Economie,2,La Representation de l'Activite Economique: Le Circuit Economique,3,Les Interdependances Economiques entre les Nations,7,184,3,QCM,0.05,0.83,69.05,73,32,105,88,73,15,1.19,82.95,Facile,Facile,0,Meme Difficulté,Adapte
5738,2020,Economie,2,La Representation de l'Activite Economique: Le Circuit Economique,3,Les Interdependances Economiques entre les Nations,7,184,3,QCM,0.05,0.91,69.05,64,28,92,92,64,28,1.0,69.57,Facile,Facile,0,Meme Difficulté,Adapte
184,2015,Economie,2,La Representation de l'Activite Economique: Le Circuit Economique,3,Les Interdependances Economiques entre les Nations,7,185,4,QCU,0.59,0.29,27.51,10,26,36,36,10,26,1.0,27.78,Moyen,Difficile,-1,Plus Difficile,Pas Adapte
1295,2016,Economie,2,La Representation de l'Activite Economique: Le Circuit Economique,3,Les Interdependances Economiques entre les Nations,7,185,4,QCU,0.12,0.78,91.96,37,3,40,37,37,0,1.08,100.0,Facile,Facile,0,Meme Difficulté,Pas Adapte
2406,2017,Economie,2,La Representation de l'Activite Economique: Le Circuit Economique,3,Les Interdependances Economiques entre les Nations,7,185,4,QCU,0.6,0.22,1.19,1,42,43,32,1,31,1.34,3.12,Difficile,Difficile,0,Meme Difficulté,Pas Adapte
3517,2018,Economie,2,La Representation de l'Activite Economique: Le Circuit Economique,3,Les Interdependances Economiques entre les Nations,7,185,4,QCU,0.45,0.22,32.02,13,27,40,25,13,12,1.6,52.0,Moyen,Difficile,-1,Plus Difficile,Pas Adapte
4628,2019,Economie,2,La Representation de l'Activite Economique: Le Circuit Economique,3,Les Interdependances Economiques entre les Nations,7,185,4,QCU,0.72,0.25,7.04,2,32,34,17,2,15,2.0,11.76,Moyen,Difficile,-1,Plus Difficile,Pas Adapte
5739,2020,Economie,2,La Representation de l'Activite Economique: Le Circuit Economique,3,Les Interdependances Economiques entre les Nations,7,185,4,QCM,0.18,0.88,99.41,32,0,32,32,32,0,1.0,100.0,Moyen,Facile,1,Plus Facile,Pas Adapte
185,2015,Economie,2,La Representation de l'Activite Economique: Le Circuit Economique,3,Les Interdependances Economiques entre les Nations,7,186,5,QCU,0.27,0.71,44.84,23,28,51,38,23,15,1.34,60.53,Facile,Moyen,-1,Plus Difficile,Pas Adapte
1296,2016,Economie,2,La Representation de l'Activite Economique: Le Circuit Economique,3,Les Interdependances Economiques entre les Nations,7,186,5,QCU,0.24,0.58,56.82,32,24,56,34,32,2,1.65,94.12,Facile,Moyen,-1,Plus Difficile,Pas Adapte
2407,2017,Economie,2,La Representation de l'Activite Economique: Le Circuit Economique,3,Les Interdependances Economiques entre les Nations,7,186,5,QCM,0.07,0.81,80.08,39,10,49,40,39,1,1.23,97.5,Difficile,Facile,2,Beaucoup plus Facile,Pas Adapte
3518,2018,Economie,2,La Representation de l'Activite Economique: Le Circuit Economique,3,Les Interdependances Economiques entre les Nations,7,186,5,QCM,0.01,0.86,73.21,40,14,54,51,40,11,1.06,78.43,Difficile,Facile,2,Beaucoup plus Facile,Adapte
4629,2019,Economie,2,La Representation de l'Activite Economique: Le Circuit Economique,3,Les Interdependances Economiques entre les Nations,7,186,5,QCM,0.02,0.8,73.21,34,12,46,45,34,11,1.02,75.56,Facile,Facile,0,Meme Difficulté,Adapte
5740,2020,Economie,2,La Representation de l'Activite Economique: Le Circuit Economique,3,Les Interdependances Economiques entre les Nations,7,186,5,QCM,0.02,0.95,73.21,29,11,40,33,29,4,1.21,87.88,Facile,Facile,0,Meme Difficulté,Adapte
186,2015,Economie,2,La Representation de l'Activite Economique: Le Circuit Economique,3,Les Interdependances Economiques entre les Nations,7,187,6,QCM,0.08,0.88,81.73,73,16,89,80,73,7,1.11,91.25,Moyen,Facile,1,Plus Facile,Pas Adapte
1297,2016,Economie,2,La Representation de l'Activite Economique: Le Circuit Economique,3,Les Interdependances Economiques entre les Nations,7,187,6,QCM,0.65,0.23,26.48,25,68,93,60,25,35,1.55,41.67,Facile,Difficile,-2,Beaucoup plus Difficile,Pas Adapte
2408,2017,Economie,2,La Representation de l'Activite Economique: Le Circuit Economique,3,Les Interdependances Economiques entre les Nations,7,187,6,QCM,0.16,0.93,81.47,68,15,83,76,68,8,1.09,89.47,Facile,Facile,0,Meme Difficulté,Pas Adapte
3519,2018,Economie,2,La Representation de l'Activite Economique: Le Circuit Economique,3,Les Interdependances Economiques entre les Nations,7,187,6,QCM,0.06,0.9,71.07,62,25,87,77,62,15,1.13,80.52,Moyen,Facile,1,Plus Facile,Adapte
4630,2019,Economie,2,La Representation de l'Activite Economique: Le Circuit Economique,3,Les Interdependances Economiques entre les Nations,7,187,6,QCM,0.06,0.73,71.07,58,23,81,80,58,22,1.01,72.5,Facile,Facile,0,Meme Difficulté,Adapte
5741,2020,Economie,2,La Representation de l'Activite Economique: Le Circuit Economique,3,Les Interdependances Economiques entre les Nations,7,187,6,QCM,0.09,0.76,71.07,65,27,92,72,65,7,1.28,90.28,Facile,Facile,0,Meme Difficulté,Adapte
187,2015,Economie,2,La Representation de l'Activite Economique: Le Circuit Economique,3,Les Interdependances Economiques entre les Nations,7,188,7,QCM,0.01,0.74,95.2,30,2,32,32,30,2,1.0,93.75,Facile,Facile,0,Meme Difficulté,Pas Adapte
1298,2016,Economie,2,La Representation de l'Activite Economique: Le Circuit Economique,3,Les Interdependances Economiques entre les Nations,7,188,7,QCM,0.13,0.94,98.39,34,1,35,35,34,1,1.0,97.14,Facile,Facile,0,Meme Difficulté,Pas Adapte
2409,2017,Economie,2,La Representation de l'Activite Economique: Le Circuit Economique,3,Les Interdependances Economiques entre les Nations,7,188,7,QCM,0.07,0.83,65.55,25,13,38,32,25,7,1.19,78.12,Moyen,Facile,1,Plus Facile,Adapte
3520,2018,Economie,2,La Representation de l'Activite Economique: Le Circuit Economique,3,Les Interdependances Economiques entre les Nations,7,188,7,QCM,0.17,0.93,65.55,29,15,44,38,29,9,1.16,76.32,Facile,Facile,0,Meme Difficulté,Adapte
4631,2019,Economie,2,La Representation de l'Activite Economique: Le Circuit Economique,3,Les Interdependances Economiques entre les Nations,7,188,7,QCM,0.0,0.77,65.55,25,13,38,38,25,13,1.0,65.79,Facile,Facile,0,Meme Difficulté,Adapte
5742,2020,Economie,2,La Representation de l'Activite Economique: Le Circuit Economique,3,Les Interdependances Economiques entre les Nations,7,188,7,QCM,0.04,0.73,65.55,28,15,43,30,28,2,1.43,93.33,Facile,Facile,0,Meme Difficulté,Adapte
188,2015,Economie,3,La Production,1,La Notion de Production,9,189,1,QCU,0.22,0.51,50.41,13,12,25,17,13,4,1.47,76.47,Moyen,Moyen,0,Meme Difficulté,Pas Adapte
1299,2016,Economie,3,La Production,1,La Notion de Production,9,189,1,QCU,0.04,0.75,79.67,21,5,26,24,21,3,1.08,87.5,Moyen,Facile,1,Plus Facile,Pas Adapte
2410,2017,Economie,3,La Production,1,La Notion de Production,9,189,1,QCU,0.4,0.5,38.75,9,14,23,13,9,4,1.77,69.23,Facile,Moyen,-1,Plus Difficile,Pas Adapte
3521,2018,Economie,3,La Production,1,La Notion de Production,9,189,1,QCU,0.11,0.83,81.04,18,4,22,19,18,1,1.16,94.74,Moyen,Facile,1,Plus Facile,Pas Adapte
4632,2019,Economie,3,La Production,1,La Notion de Production,9,189,1,QCU,0.16,0.88,71.1,16,6,22,19,16,3,1.16,84.21,Moyen,Facile,1,Plus Facile,Adapte
5743,2020,Economie,3,La Production,1,La Notion de Production,9,189,1,QCU,0.12,0.9,71.1,17,7,24,20,17,3,1.2,85.0,Facile,Facile,0,Meme Difficulté,Adapte
189,2015,Economie,3,La Production,1,La Notion de Production,9,190,2,QCU,0.32,0.74,46.27,39,46,85,82,39,43,1.04,47.56,Facile,Moyen,-1,Plus Difficile,Pas Adapte
1300,2016,Economie,3,La Production,1,La Notion de Production,9,190,2,QCM,0.65,0.23,14.1,12,75,87,38,12,26,2.29,31.58,Facile,Difficile,-2,Beaucoup plus Difficile,Pas Adapte
2411,2017,Economie,3,La Production,1,La Notion de Production,9,190,2,QCM,0.05,0.76,72.1,56,21,77,63,56,7,1.22,88.89,Moyen,Facile,1,Plus Facile,Adapte
3522,2018,Economie,3,La Production,1,La Notion de Production,9,190,2,QCM,0.03,0.84,72.1,56,21,77,76,56,20,1.01,73.68,Facile,Facile,0,Meme Difficulté,Adapte
4633,2019,Economie,3,La Production,1,La Notion de Production,9,190,2,QCM,0.18,0.73,72.1,62,24,86,66,62,4,1.3,93.94,Facile,Facile,0,Meme Difficulté,Adapte
5744,2020,Economie,3,La Production,1,La Notion de Production,9,190,2,QCM,0.02,0.73,72.1,64,25,89,85,64,21,1.05,75.29,Facile,Facile,0,Meme Difficulté,Adapte
190,2015,Economie,3,La Production,1,La Notion de Production,9,191,3,QCU,0.11,0.88,86.89,51,8,59,54,51,3,1.09,94.44,Moyen,Facile,1,Plus Facile,Pas Adapte
1301,2016,Economie,3,La Production,1,La Notion de Production,9,191,3,QCU,0.39,0.72,39.02,24,37,61,41,24,17,1.49,58.54,Moyen,Moyen,0,Meme Difficulté,Pas Adapte
2412,2017,Economie,3,La Production,1,La Notion de Production,9,191,3,QCU,0.17,0.75,90.6,62,6,68,63,62,1,1.08,98.41,Difficile,Facile,2,Beaucoup plus Facile,Pas Adapte
3523,2018,Economie,3,La Production,1,La Notion de Production,9,191,3,QCU,0.03,0.96,92.34,59,5,64,62,59,3,1.03,95.16,Moyen,Facile,1,Plus Facile,Pas Adapte
4634,2019,Economie,3,La Production,1,La Notion de Production,9,191,3,QCU,0.74,0.36,21.5,12,45,57,34,12,22,1.68,35.29,Difficile,Difficile,0,Meme Difficulté,Pas Adapte
5745,2020,Economie,3,La Production,1,La Notion de Production,9,191,3,QCM,0.61,0.27,2.8,2,56,58,17,2,15,3.41,11.76,Moyen,Difficile,-1,Plus Difficile,Pas Adapte
191,2015,Economie,3,La Production,1,La Notion de Production,9,192,4,QCU,0.03,0.75,68.58,45,21,66,50,45,5,1.32,90.0,Moyen,Facile,1,Plus Facile,Adapte
1302,2016,Economie,3,La Production,1,La Notion de Production,9,192,4,QCU,0.18,0.99,68.58,41,19,60,58,41,17,1.03,70.69,Facile,Facile,0,Meme Difficulté,Adapte
2413,2017,Economie,3,La Production,1,La Notion de Production,9,192,4,QCU,0.16,0.92,68.58,36,16,52,46,36,10,1.13,78.26,Facile,Facile,0,Meme Difficulté,Adapte
3524,2018,Economie,3,La Production,1,La Notion de Production,9,192,4,QCU,0.1,0.96,68.58,31,14,45,38,31,7,1.18,81.58,Facile,Facile,0,Meme Difficulté,Adapte
4635,2019,Economie,3,La Production,1,La Notion de Production,9,192,4,QCU,0.15,0.88,68.58,32,14,46,36,32,4,1.28,88.89,Facile,Facile,0,Meme Difficulté,Adapte
5746,2020,Economie,3,La Production,1,La Notion de Production,9,192,4,QCU,0.16,0.95,68.58,33,15,48,34,33,1,1.41,97.06,Facile,Facile,0,Meme Difficulté,Adapte
192,2015,Economie,3,La Production,1,La Notion de Production,9,193,5,QCM,0.54,0.18,4.44,3,56,59,23,3,20,2.57,13.04,Facile,Difficile,-2,Beaucoup plus Difficile,Pas Adapte
1303,2016,Economie,3,La Production,1,La Notion de Production,9,193,5,QCM,0.28,0.54,57.28,36,27,63,49,36,13,1.29,73.47,Moyen,Moyen,0,Meme Difficulté,Pas Adapte
2414,2017,Economie,3,La Production,1,La Notion de Production,9,193,5,QCU,0.64,0.34,10.91,7,58,65,55,7,48,1.18,12.73,Difficile,Difficile,0,Meme Difficulté,Pas Adapte
3525,2018,Economie,3,La Production,1,La Notion de Production,9,193,5,QCU,0.15,0.95,69.51,42,18,60,49,42,7,1.22,85.71,Difficile,Facile,2,Beaucoup plus Facile,Adapte
4636,2019,Economie,3,La Production,1,La Notion de Production,9,193,5,QCU,0.14,0.95,69.51,35,16,51,41,35,6,1.24,85.37,Facile,Facile,0,Meme Difficulté,Adapte
5747,2020,Economie,3,La Production,1,La Notion de Production,9,193,5,QCU,0.14,0.85,69.51,40,18,58,55,40,15,1.05,72.73,Facile,Facile,0,Meme Difficulté,Adapte
193,2015,Economie,3,La Production,1,La Notion de Production,9,194,6,QROC,0.86,0.24,13.98,11,66,77,66,11,55,1.17,16.67,Facile,Difficile,-2,Beaucoup plus Difficile,Pas Adapte
1304,2016,Economie,3,La Production,1,La Notion de Production,9,194,6,QROC,0.16,0.77,80.87,60,14,74,64,60,4,1.16,93.75,Difficile,Facile,2,Beaucoup plus Facile,Pas Adapte
2415,2017,Economie,3,La Production,1,La Notion de Production,9,194,6,QROC,0.07,0.5,94.03,70,4,74,70,70,0,1.06,100.0,Moyen,Facile,1,Plus Facile,Pas Adapte
3526,2018,Economie,3,La Production,1,La Notion de Production,9,194,6,QROC,0.42,0.38,39.56,27,40,67,52,27,25,1.29,51.92,Facile,Moyen,-1,Plus Difficile,Pas Adapte
4637,2019,Economie,3,La Production,1,La Notion de Production,9,194,6,QROC,0.19,0.68,84.87,64,11,75,75,64,11,1.0,85.33,Moyen,Facile,1,Plus Facile,Pas Adapte
5748,2020,Economie,3,La Production,1,La Notion de Production,9,194,6,QROC,0.76,0.19,26.56,22,59,81,47,22,25,1.72,46.81,Facile,Difficile,-2,Beaucoup plus Difficile,Pas Adapte
194,2015,Economie,3,La Production,1,La Notion de Production,9,195,7,QCU,0.28,0.58,40.22,11,17,28,21,11,10,1.33,52.38,Moyen,Moyen,0,Meme Difficulté,Pas Adapte
1305,2016,Economie,3,La Production,1,La Notion de Production,9,195,7,QCU,0.34,0.65,52.56,15,14,29,25,15,10,1.16,60.0,Difficile,Moyen,1,Plus Facile,Pas Adapte
2416,2017,Economie,3,La Production,1,La Notion de Production,9,195,7,QROC,0.91,0.16,7.89,2,29,31,25,2,23,1.24,8.0,Moyen,Difficile,-1,Plus Difficile,Pas Adapte
3527,2018,Economie,3,La Production,1,La Notion de Production,9,195,7,QROC,0.6,0.14,23.96,8,27,35,22,8,14,1.59,36.36,Difficile,Difficile,0,Meme Difficulté,Pas Adapte
4638,2019,Economie,3,La Production,1,La Notion de Production,9,195,7,QROC,0.45,0.39,39.0,16,24,40,23,16,7,1.74,69.57,Facile,Moyen,-1,Plus Difficile,Pas Adapte
5749,2020,Economie,3,La Production,1,La Notion de Production,9,195,7,QROC,0.11,0.67,94.13,40,3,43,40,40,0,1.07,100.0,Difficile,Facile,2,Beaucoup plus Facile,Pas Adapte
195,2015,Economie,3,La Production,1,La Notion de Production,9,196,8,QCM,0.3,0.34,36.26,12,21,33,24,12,12,1.38,50.0,Moyen,Moyen,0,Meme Difficulté,Pas Adapte
1306,2016,Economie,3,La Production,1,La Notion de Production,9,196,8,QCM,0.07,0.86,74.47,25,8,33,29,25,4,1.14,86.21,Facile,Facile,0,Meme Difficulté,Adapte
2417,2017,Economie,3,La Production,1,La Notion de Production,9,196,8,QCM,0.03,0.85,74.47,21,7,28,25,21,4,1.12,84.0,Facile,Facile,0,Meme Difficulté,Adapte
3528,2018,Economie,3,La Production,1,La Notion de Production,9,196,8,QCM,0.05,0.85,74.47,20,7,27,20,20,0,1.35,100.0,Facile,Facile,0,Meme Difficulté,Adapte
4639,2019,Economie,3,La Production,1,La Notion de Production,9,196,8,QCM,0.01,0.91,74.47,22,8,30,24,22,2,1.25,91.67,Facile,Facile,0,Meme Difficulté,Adapte
5750,2020,Economie,3,La Production,1,La Notion de Production,9,196,8,QCU,0.01,0.8,74.47,19,7,26,25,19,6,1.04,76.0,Facile,Facile,0,Meme Difficulté,Adapte
196,2015,Economie,3,La Production,1,La Notion de Production,9,197,9,QROC,0.21,0.34,42.67,6,8,14,9,6,3,1.56,66.67,Difficile,Moyen,1,Plus Facile,Pas Adapte
1307,2016,Economie,3,La Production,1,La Notion de Production,9,197,9,QROC,0.55,0.28,45.65,7,9,16,12,7,5,1.33,58.33,Moyen,Moyen,0,Meme Difficulté,Pas Adapte
2418,2017,Economie,3,La Production,1,La Notion de Production,9,197,9,QROC,0.42,0.31,53.91,9,7,16,15,9,6,1.07,60.0,Difficile,Moyen,1,Plus Facile,Pas Adapte
3529,2018,Economie,3,La Production,1,La Notion de Production,9,197,9,QROC,0.95,0.03,23.62,4,12,16,12,4,8,1.33,33.33,Moyen,Difficile,-1,Plus Difficile,Pas Adapte
4640,2019,Economie,3,La Production,1,La Notion de Production,9,197,9,QO,0.3,0.17,51.53,8,8,16,16,8,8,1.0,50.0,Difficile,Moyen,1,Plus Facile,Pas Adapte
5751,2020,Economie,3,La Production,1,La Notion de Production,9,197,9,QO,0.61,0.18,41.57,7,9,16,13,7,6,1.23,53.85,Moyen,Moyen,0,Meme Difficulté,Pas Adapte
197,2015,Economie,3,La Production,2,L'Importance de la Production Marchande et de la Production Non-Marchande,7,198,1,QROC,0.64,0.12,34.82,27,51,78,37,27,10,2.11,72.97,Moyen,Difficile,-1,Plus Difficile,Pas Adapte
1308,2016,Economie,3,La Production,2,L'Importance de la Production Marchande et de la Production Non-Marchande,7,198,1,QROC,0.97,0.14,31.2,24,52,76,61,24,37,1.25,39.34,Difficile,Difficile,0,Meme Difficulté,Pas Adapte
2419,2017,Economie,3,La Production,2,L'Importance de la Production Marchande et de la Production Non-Marchande,7,198,1,QROC,0.28,0.27,54.01,36,31,67,39,36,3,1.72,92.31,Moyen,Moyen,0,Meme Difficulté,Pas Adapte
3530,2018,Economie,3,La Production,2,L'Importance de la Production Marchande et de la Production Non-Marchande,7,198,1,QROC,0.59,0.28,45.79,27,31,58,31,27,4,1.87,87.1,Moyen,Moyen,0,Meme Difficulté,Pas Adapte
4641,2019,Economie,3,La Production,2,L'Importance de la Production Marchande et de la Production Non-Marchande,7,198,1,QCM,0.72,0.18,26.35,13,36,49,22,13,9,2.23,59.09,Facile,Difficile,-2,Beaucoup plus Difficile,Pas Adapte
5752,2020,Economie,3,La Production,2,L'Importance de la Production Marchande et de la Production Non-Marchande,7,198,1,QCM,0.73,0.29,19.23,11,44,55,46,11,35,1.2,23.91,Difficile,Difficile,0,Meme Difficulté,Pas Adapte
198,2015,Economie,3,La Production,2,L'Importance de la Production Marchande et de la Production Non-Marchande,7,199,2,QCM,0.31,0.33,47.35,15,16,31,23,15,8,1.35,65.22,Difficile,Moyen,1,Plus Facile,Pas Adapte
1309,2016,Economie,3,La Production,2,L'Importance de la Production Marchande et de la Production Non-Marchande,7,199,2,QCM,0.35,0.52,37.7,12,20,32,24,12,12,1.33,50.0,Facile,Moyen,-1,Plus Difficile,Pas Adapte
2420,2017,Economie,3,La Production,2,L'Importance de la Production Marchande et de la Production Non-Marchande,7,199,2,QCU,0.29,0.72,46.12,14,16,30,25,14,11,1.2,56.0,Moyen,Moyen,0,Meme Difficulté,Pas Adapte
3531,2018,Economie,3,La Production,2,L'Importance de la Production Marchande et de la Production Non-Marchande,7,199,2,QCU,0.64,0.28,3.93,1,33,34,18,1,17,1.89,5.56,Facile,Difficile,-2,Beaucoup plus Difficile,Pas Adapte
4642,2019,Economie,3,La Production,2,L'Importance de la Production Marchande et de la Production Non-Marchande,7,199,2,QCU,0.7,0.33,22.9,9,30,39,13,9,4,3.0,69.23,Facile,Difficile,-2,Beaucoup plus Difficile,Pas Adapte
5753,2020,Economie,3,La Production,2,L'Importance de la Production Marchande et de la Production Non-Marchande,7,199,2,QCU,0.09,0.88,67.91,23,11,34,29,23,6,1.17,79.31,Facile,Facile,0,Meme Difficulté,Adapte
199,2015,Economie,3,La Production,2,L'Importance de la Production Marchande et de la Production Non-Marchande,7,200,3,QO,0.1,0.32,77.48,49,14,63,55,49,6,1.15,89.09,Moyen,Facile,1,Plus Facile,Pas Adapte
1310,2016,Economie,3,La Production,2,L'Importance de la Production Marchande et de la Production Non-Marchande,7,200,3,QO,0.77,0.08,19.79,11,45,56,46,11,35,1.22,23.91,Facile,Difficile,-2,Beaucoup plus Difficile,Pas Adapte
2421,2017,Economie,3,La Production,2,L'Importance de la Production Marchande et de la Production Non-Marchande,7,200,3,QO,0.9,0.14,10.65,7,57,64,41,7,34,1.56,17.07,Moyen,Difficile,-1,Plus Difficile,Pas Adapte
3532,2018,Economie,3,La Production,2,L'Importance de la Production Marchande et de la Production Non-Marchande,7,200,3,QROC,0.41,0.27,48.72,34,36,70,48,34,14,1.46,70.83,Facile,Moyen,-1,Plus Difficile,Pas Adapte
4643,2019,Economie,3,La Production,2,L'Importance de la Production Marchande et de la Production Non-Marchande,7,200,3,QROC,0.57,0.32,43.92,26,34,60,35,26,9,1.71,74.29,Facile,Moyen,-1,Plus Difficile,Pas Adapte
5754,2020,Economie,3,La Production,2,L'Importance de la Production Marchande et de la Production Non-Marchande,7,200,3,QROC,0.65,0.18,16.39,10,50,60,45,10,35,1.33,22.22,Difficile,Difficile,0,Meme Difficulté,Pas Adapte
200,2015,Economie,3,La Production,2,L'Importance de la Production Marchande et de la Production Non-Marchande,7,201,4,QCM,0.65,0.2,6.51,1,11,12,11,1,10,1.09,9.09,Facile,Difficile,-2,Beaucoup plus Difficile,Pas Adapte
1311,2016,Economie,3,La Production,2,L'Importance de la Production Marchande et de la Production Non-Marchande,7,201,4,QCM,0.1,0.8,91.75,9,1,10,9,9,0,1.11,100.0,Facile,Facile,0,Meme Difficulté,Pas Adapte
2422,2017,Economie,3,La Production,2,L'Importance de la Production Marchande et de la Production Non-Marchande,7,201,4,QCM,0.62,0.26,24.59,3,8,11,4,3,1,2.75,75.0,Moyen,Difficile,-1,Plus Difficile,Pas Adapte
3533,2018,Economie,3,La Production,2,L'Importance de la Production Marchande et de la Production Non-Marchande,7,201,4,QCM,0.32,0.47,64.14,6,4,10,6,6,0,1.67,100.0,Facile,Moyen,-1,Plus Difficile,Pas Adapte
4644,2019,Economie,3,La Production,2,L'Importance de la Production Marchande et de la Production Non-Marchande,7,201,4,QCM,0.38,0.42,44.73,5,6,11,8,5,3,1.38,62.5,Facile,Moyen,-1,Plus Difficile,Pas Adapte
5755,2020,Economie,3,La Production,2,L'Importance de la Production Marchande et de la Production Non-Marchande,7,201,4,QCM,0.58,0.27,3.57,0,13,13,12,0,12,1.08,0.0,Difficile,Difficile,0,Meme Difficulté,Pas Adapte
201,2015,Economie,3,La Production,2,L'Importance de la Production Marchande et de la Production Non-Marchande,7,202,5,QO,0.2,0.65,66.31,32,17,49,42,32,10,1.17,76.19,Difficile,Facile,2,Beaucoup plus Facile,Adapte
1312,2016,Economie,3,La Production,2,L'Importance de la Production Marchande et de la Production Non-Marchande,7,202,5,QROC,0.07,0.65,66.31,34,17,51,35,34,1,1.46,97.14,Facile,Facile,0,Meme Difficulté,Adapte
2423,2017,Economie,3,La Production,2,L'Importance de la Production Marchande et de la Production Non-Marchande,7,202,5,QROC,0.05,0.99,66.31,36,18,54,42,36,6,1.29,85.71,Facile,Facile,0,Meme Difficulté,Adapte
3534,2018,Economie,3,La Production,2,L'Importance de la Production Marchande et de la Production Non-Marchande,7,202,5,QROC,0.06,1.0,66.31,31,16,47,40,31,9,1.18,77.5,Facile,Facile,0,Meme Difficulté,Adapte
4645,2019,Economie,3,La Production,2,L'Importance de la Production Marchande et de la Production Non-Marchande,7,202,5,QROC,0.02,0.53,66.31,27,14,41,34,27,7,1.21,79.41,Facile,Facile,0,Meme Difficulté,Adapte
5756,2020,Economie,3,La Production,2,L'Importance de la Production Marchande et de la Production Non-Marchande,7,202,5,QROC,0.1,0.84,66.31,23,12,35,30,23,7,1.17,76.67,Facile,Facile,0,Meme Difficulté,Adapte
202,2015,Economie,3,La Production,2,L'Importance de la Production Marchande et de la Production Non-Marchande,7,203,6,QCM,0.09,0.72,66.95,15,7,22,19,15,4,1.16,78.95,Facile,Facile,0,Meme Difficulté,Adapte
1313,2016,Economie,3,La Production,2,L'Importance de la Production Marchande et de la Production Non-Marchande,7,203,6,QCM,0.09,0.7,66.95,14,7,21,15,14,1,1.4,93.33,Facile,Facile,0,Meme Difficulté,Adapte
2424,2017,Economie,3,La Production,2,L'Importance de la Production Marchande et de la Production Non-Marchande,7,203,6,QCM,0.16,0.82,66.95,16,8,24,21,16,5,1.14,76.19,Facile,Facile,0,Meme Difficulté,Adapte
3535,2018,Economie,3,La Production,2,L'Importance de la Production Marchande et de la Production Non-Marchande,7,203,6,QCM,0.03,0.73,66.95,18,9,27,22,18,4,1.23,81.82,Facile,Facile,0,Meme Difficulté,Adapte
4646,2019,Economie,3,La Production,2,L'Importance de la Production Marchande et de la Production Non-Marchande,7,203,6,QCM,0.11,0.94,66.95,21,10,31,22,21,1,1.41,95.45,Facile,Facile,0,Meme Difficulté,Adapte
5757,2020,Economie,3,La Production,2,L'Importance de la Production Marchande et de la Production Non-Marchande,7,203,6,QCM,0.0,0.91,66.95,23,12,35,35,23,12,1.0,65.71,Facile,Facile,0,Meme Difficulté,Adapte
203,2015,Economie,3,La Production,2,L'Importance de la Production Marchande et de la Production Non-Marchande,7,204,7,QROC,0.33,0.29,43.53,25,32,57,36,25,11,1.58,69.44,Difficile,Moyen,1,Plus Facile,Pas Adapte
1314,2016,Economie,3,La Production,2,L'Importance de la Production Marchande et de la Production Non-Marchande,7,204,7,QCM,0.11,0.72,67.07,32,16,48,43,32,11,1.12,74.42,Facile,Facile,0,Meme Difficulté,Adapte
2425,2017,Economie,3,La Production,2,L'Importance de la Production Marchande et de la Production Non-Marchande,7,204,7,QCM,0.01,0.93,67.07,33,16,49,37,33,4,1.32,89.19,Facile,Facile,0,Meme Difficulté,Adapte
3536,2018,Economie,3,La Production,2,L'Importance de la Production Marchande et de la Production Non-Marchande,7,204,7,QCM,0.03,0.91,67.07,33,16,49,41,33,8,1.2,80.49,Facile,Facile,0,Meme Difficulté,Adapte
4647,2019,Economie,3,La Production,2,L'Importance de la Production Marchande et de la Production Non-Marchande,7,204,7,QCM,0.17,0.95,67.07,34,17,51,41,34,7,1.24,82.93,Facile,Facile,0,Meme Difficulté,Adapte
5758,2020,Economie,3,La Production,2,L'Importance de la Production Marchande et de la Production Non-Marchande,7,204,7,QCU,0.04,0.96,67.07,38,18,56,54,38,16,1.04,70.37,Facile,Facile,0,Meme Difficulté,Adapte
204,2015,Economie,3,La Production,3,Valeur Ajouee et Mesure de la Richesse,9,205,1,QROC,0.78,0.09,17.67,4,20,24,22,4,18,1.09,18.18,Moyen,Difficile,-1,Plus Difficile,Pas Adapte
1315,2016,Economie,3,La Production,3,Valeur Ajouee et Mesure de la Richesse,9,205,1,QCM,0.09,0.9,66.14,16,8,24,22,16,6,1.09,72.73,Difficile,Facile,2,Beaucoup plus Facile,Adapte
2426,2017,Economie,3,La Production,3,Valeur Ajouee et Mesure de la Richesse,9,205,1,QCM,0.09,0.77,66.14,14,7,21,20,14,6,1.05,70.0,Facile,Facile,0,Meme Difficulté,Adapte
3537,2018,Economie,3,La Production,3,Valeur Ajouee et Mesure de la Richesse,9,205,1,QCM,0.18,0.86,66.14,13,7,20,16,13,3,1.25,81.25,Facile,Facile,0,Meme Difficulté,Adapte
4648,2019,Economie,3,La Production,3,Valeur Ajouee et Mesure de la Richesse,9,205,1,QROC,0.04,0.95,66.14,13,7,20,13,13,0,1.54,100.0,Facile,Facile,0,Meme Difficulté,Adapte
5759,2020,Economie,3,La Production,3,Valeur Ajouee et Mesure de la Richesse,9,205,1,QROC,0.13,0.54,66.14,15,7,22,21,15,6,1.05,71.43,Facile,Facile,0,Meme Difficulté,Adapte
205,2015,Economie,3,La Production,3,Valeur Ajouee et Mesure de la Richesse,9,206,2,QCM,0.23,0.38,63.66,7,4,11,10,7,3,1.1,70.0,Moyen,Moyen,0,Meme Difficulté,Pas Adapte
1316,2016,Economie,3,La Production,3,Valeur Ajouee et Mesure de la Richesse,9,206,2,QCU,0.19,0.81,82.52,9,2,11,11,9,2,1.0,81.82,Moyen,Facile,1,Plus Facile,Pas Adapte
2427,2017,Economie,3,La Production,3,Valeur Ajouee et Mesure de la Richesse,9,206,2,QCU,0.38,0.74,54.57,5,4,9,7,5,2,1.29,71.43,Facile,Moyen,-1,Plus Difficile,Pas Adapte
3538,2018,Economie,3,La Production,3,Valeur Ajouee et Mesure de la Richesse,9,206,2,QCU,0.68,0.38,29.62,2,6,8,4,2,2,2.0,50.0,Facile,Difficile,-2,Beaucoup plus Difficile,Pas Adapte
4649,2019,Economie,3,La Production,3,Valeur Ajouee et Mesure de la Richesse,9,206,2,QCU,0.38,0.55,56.46,5,3,8,7,5,2,1.14,71.43,Difficile,Moyen,1,Plus Facile,Pas Adapte
5760,2020,Economie,3,La Production,3,Valeur Ajouee et Mesure de la Richesse,9,206,2,QCU,0.03,0.97,91.21,7,1,8,7,7,0,1.14,100.0,Facile,Facile,0,Meme Difficulté,Pas Adapte
206,2015,Economie,3,La Production,3,Valeur Ajouee et Mesure de la Richesse,9,207,3,QCU,0.51,0.36,19.34,6,23,29,11,6,5,2.64,54.55,Difficile,Difficile,0,Meme Difficulté,Pas Adapte
1317,2016,Economie,3,La Production,3,Valeur Ajouee et Mesure de la Richesse,9,207,3,QCU,0.4,0.55,57.68,18,14,32,24,18,6,1.33,75.0,Difficile,Moyen,1,Plus Facile,Pas Adapte
2428,2017,Economie,3,La Production,3,Valeur Ajouee et Mesure de la Richesse,9,207,3,QCU,0.03,0.99,73.96,24,8,32,31,24,7,1.03,77.42,Moyen,Facile,1,Plus Facile,Adapte
3539,2018,Economie,3,La Production,3,Valeur Ajouee et Mesure de la Richesse,9,207,3,QCU,0.17,0.83,73.96,26,9,35,32,26,6,1.09,81.25,Facile,Facile,0,Meme Difficulté,Adapte
4650,2019,Economie,3,La Production,3,Valeur Ajouee et Mesure de la Richesse,9,207,3,QCU,0.06,0.9,73.96,27,9,36,35,27,8,1.03,77.14,Facile,Facile,0,Meme Difficulté,Adapte
5761,2020,Economie,3,La Production,3,Valeur Ajouee et Mesure de la Richesse,9,207,3,QO,0.16,0.48,73.96,30,11,41,37,30,7,1.11,81.08,Facile,Facile,0,Meme Difficulté,Adapte
207,2015,Economie,3,La Production,3,Valeur Ajouee et Mesure de la Richesse,9,208,4,QO,0.11,0.35,90.65,86,9,95,87,86,1,1.09,98.85,Moyen,Facile,1,Plus Facile,Pas Adapte
1318,2016,Economie,3,La Production,3,Valeur Ajouee et Mesure de la Richesse,9,208,4,QO,0.61,0.15,52.56,43,39,82,51,43,8,1.61,84.31,Difficile,Moyen,1,Plus Facile,Pas Adapte
2429,2017,Economie,3,La Production,3,Valeur Ajouee et Mesure de la Richesse,9,208,4,QO,0.86,0.04,34.12,31,60,91,81,31,50,1.12,38.27,Moyen,Difficile,-1,Plus Difficile,Pas Adapte
3540,2018,Economie,3,La Production,3,Valeur Ajouee et Mesure de la Richesse,9,208,4,QO,0.51,0.29,59.77,50,34,84,64,50,14,1.31,78.12,Difficile,Moyen,1,Plus Facile,Pas Adapte
4651,2019,Economie,3,La Production,3,Valeur Ajouee et Mesure de la Richesse,9,208,4,QCM,0.26,0.53,36.22,33,57,90,74,33,41,1.22,44.59,Difficile,Moyen,1,Plus Facile,Pas Adapte
5762,2020,Economie,3,La Production,3,Valeur Ajouee et Mesure de la Richesse,9,208,4,QCM,0.72,0.23,4.44,5,97,102,67,5,62,1.52,7.46,Moyen,Difficile,-1,Plus Difficile,Pas Adapte
208,2015,Economie,3,La Production,3,Valeur Ajouee et Mesure de la Richesse,9,209,5,QO,0.78,0.1,1.52,1,85,86,48,1,47,1.79,2.08,Difficile,Difficile,0,Meme Difficulté,Pas Adapte
1319,2016,Economie,3,La Production,3,Valeur Ajouee et Mesure de la Richesse,9,209,5,QO,0.1,0.4,88.95,80,10,90,87,80,7,1.03,91.95,Moyen,Facile,1,Plus Facile,Pas Adapte
2430,2017,Economie,3,La Production,3,Valeur Ajouee et Mesure de la Richesse,9,209,5,QO,0.18,0.88,93.08,71,5,76,73,71,2,1.04,97.26,Moyen,Facile,1,Plus Facile,Pas Adapte
3541,2018,Economie,3,La Production,3,Valeur Ajouee et Mesure de la Richesse,9,209,5,QO,0.87,0.03,10.37,8,71,79,69,8,61,1.14,11.59,Facile,Difficile,-2,Beaucoup plus Difficile,Pas Adapte
4652,2019,Economie,3,La Production,3,Valeur Ajouee et Mesure de la Richesse,9,209,5,QO,0.51,0.18,36.91,30,51,81,56,30,26,1.45,53.57,Difficile,Moyen,1,Plus Facile,Pas Adapte
5763,2020,Economie,3,La Production,3,Valeur Ajouee et Mesure de la Richesse,9,209,5,QO,0.04,0.93,88.89,72,9,81,78,72,6,1.04,92.31,Difficile,Facile,2,Beaucoup plus Facile,Pas Adapte
209,2015,Economie,3,La Production,3,Valeur Ajouee et Mesure de la Richesse,9,210,6,QCU,0.5,0.29,17.85,13,61,74,29,13,16,2.55,44.83,Moyen,Difficile,-1,Plus Difficile,Pas Adapte
1320,2016,Economie,3,La Production,3,Valeur Ajouee et Mesure de la Richesse,9,210,6,QCU,0.09,0.9,93.15,71,5,76,75,71,4,1.01,94.67,Moyen,Facile,1,Plus Facile,Pas Adapte
2431,2017,Economie,3,La Production,3,Valeur Ajouee et Mesure de la Richesse,9,210,6,QO,0.94,0.01,0.77,1,78,79,55,1,54,1.44,1.82,Moyen,Difficile,-1,Plus Difficile,Pas Adapte
3542,2018,Economie,3,La Production,3,Valeur Ajouee et Mesure de la Richesse,9,210,6,QROC,0.38,0.32,48.34,44,46,90,52,44,8,1.73,84.62,Moyen,Moyen,0,Meme Difficulté,Pas Adapte
4653,2019,Economie,3,La Production,3,Valeur Ajouee et Mesure de la Richesse,9,210,6,QO,0.46,0.28,38.58,37,60,97,64,37,27,1.52,57.81,Facile,Moyen,-1,Plus Difficile,Pas Adapte
5764,2020,Economie,3,La Production,3,Valeur Ajouee et Mesure de la Richesse,9,210,6,QO,0.21,0.16,60.11,67,44,111,109,67,42,1.02,61.47,Difficile,Moyen,1,Plus Facile,Pas Adapte
210,2015,Economie,3,La Production,3,Valeur Ajouee et Mesure de la Richesse,9,211,7,QCM,0.72,0.22,0.93,0,10,10,3,0,3,3.33,0.0,Moyen,Difficile,-1,Plus Difficile,Pas Adapte
1321,2016,Economie,3,La Production,3,Valeur Ajouee et Mesure de la Richesse,9,211,7,QCM,0.54,0.24,34.98,4,7,11,5,4,1,2.2,80.0,Difficile,Difficile,0,Meme Difficulté,Pas Adapte
2432,2017,Economie,3,La Production,3,Valeur Ajouee et Mesure de la Richesse,9,211,7,QCM,0.78,0.23,20.86,3,9,12,8,3,5,1.5,37.5,Moyen,Difficile,-1,Plus Difficile,Pas Adapte
3543,2018,Economie,3,La Production,3,Valeur Ajouee et Mesure de la Richesse,9,211,7,QCM,0.75,0.23,32.96,4,9,13,6,4,2,2.17,66.67,Moyen,Difficile,-1,Plus Difficile,Pas Adapte
4654,2019,Economie,3,La Production,3,Valeur Ajouee et Mesure de la Richesse,9,211,7,QCM,0.11,0.77,66.43,10,5,15,13,10,3,1.15,76.92,Facile,Facile,0,Meme Difficulté,Adapte
5765,2020,Economie,3,La Production,3,Valeur Ajouee et Mesure de la Richesse,9,211,7,QCM,0.13,0.83,66.43,9,5,14,10,9,1,1.4,90.0,Facile,Facile,0,Meme Difficulté,Adapte
211,2015,Economie,3,La Production,3,Valeur Ajouee et Mesure de la Richesse,9,212,8,QCU,0.46,0.28,24.04,13,42,55,46,13,33,1.2,28.26,Moyen,Difficile,-1,Plus Difficile,Pas Adapte
1322,2016,Economie,3,La Production,3,Valeur Ajouee et Mesure de la Richesse,9,212,8,QCU,0.03,0.77,73.2,38,14,52,46,38,8,1.13,82.61,Difficile,Facile,2,Beaucoup plus Facile,Adapte
2433,2017,Economie,3,La Production,3,Valeur Ajouee et Mesure de la Richesse,9,212,8,QCU,0.05,0.86,73.2,37,14,51,42,37,5,1.21,88.1,Facile,Facile,0,Meme Difficulté,Adapte
3544,2018,Economie,3,La Production,3,Valeur Ajouee et Mesure de la Richesse,9,212,8,QCU,0.03,0.81,73.2,35,13,48,44,35,9,1.09,79.55,Facile,Facile,0,Meme Difficulté,Adapte
4655,2019,Economie,3,La Production,3,Valeur Ajouee et Mesure de la Richesse,9,212,8,QCU,0.16,0.76,73.2,40,14,54,44,40,4,1.23,90.91,Facile,Facile,0,Meme Difficulté,Adapte
5766,2020,Economie,3,La Production,3,Valeur Ajouee et Mesure de la Richesse,9,212,8,QCU,0.16,0.97,73.2,45,16,61,57,45,12,1.07,78.95,Facile,Facile,0,Meme Difficulté,Adapte
212,2015,Economie,3,La Production,3,Valeur Ajouee et Mesure de la Richesse,9,213,9,QO,0.94,0.07,1.92,0,24,24,19,0,19,1.26,0.0,Difficile,Difficile,0,Meme Difficulté,Pas Adapte
1323,2016,Economie,3,La Production,3,Valeur Ajouee et Mesure de la Richesse,9,213,9,QCU,0.43,0.21,22.3,6,19,25,22,6,16,1.14,27.27,Facile,Difficile,-2,Beaucoup plus Difficile,Pas Adapte
2434,2017,Economie,3,La Production,3,Valeur Ajouee et Mesure de la Richesse,9,213,9,QCU,0.52,0.38,33.92,8,16,24,17,8,9,1.41,47.06,Moyen,Difficile,-1,Plus Difficile,Pas Adapte
3545,2018,Economie,3,La Production,3,Valeur Ajouee et Mesure de la Richesse,9,213,9,QCU,0.28,0.6,41.92,10,15,25,15,10,5,1.67,66.67,Facile,Moyen,-1,Plus Difficile,Pas Adapte
4656,2019,Economie,3,La Production,3,Valeur Ajouee et Mesure de la Richesse,9,213,9,QCU,0.55,0.25,26.07,8,21,29,14,8,6,2.07,57.14,Facile,Difficile,-2,Beaucoup plus Difficile,Pas Adapte
5767,2020,Economie,3,La Production,3,Valeur Ajouee et Mesure de la Richesse,9,213,9,QCU,0.14,0.96,82.06,22,5,27,23,22,1,1.17,95.65,Difficile,Facile,2,Beaucoup plus Facile,Pas Adapte
213,2015,Economie,3,La Production,4,Les Limites de la Mesure de la Production,6,214,1,QCU,0.14,0.97,96.24,38,2,40,40,38,2,1.0,95.0,Difficile,Facile,2,Beaucoup plus Facile,Pas Adapte
1324,2016,Economie,3,La Production,4,Les Limites de la Mesure de la Production,6,214,1,QCU,0.27,0.47,36.38,14,25,39,17,14,3,2.29,82.35,Difficile,Moyen,1,Plus Facile,Pas Adapte
2435,2017,Economie,3,La Production,4,Les Limites de la Mesure de la Production,6,214,1,QCU,0.48,0.35,28.54,13,31,44,16,13,3,2.75,81.25,Difficile,Difficile,0,Meme Difficulté,Pas Adapte
3546,2018,Economie,3,La Production,4,Les Limites de la Mesure de la Production,6,214,1,QCU,0.33,0.68,57.9,25,18,43,30,25,5,1.43,83.33,Moyen,Moyen,0,Meme Difficulté,Pas Adapte
4657,2019,Economie,3,La Production,4,Les Limites de la Mesure de la Production,6,214,1,QCU,0.26,0.61,55.0,23,18,41,33,23,10,1.24,69.7,Difficile,Moyen,1,Plus Facile,Pas Adapte
5768,2020,Economie,3,La Production,4,Les Limites de la Mesure de la Production,6,214,1,QCU,0.1,0.98,69.97,24,11,35,27,24,3,1.3,88.89,Facile,Facile,0,Meme Difficulté,Adapte
214,2015,Economie,3,La Production,4,Les Limites de la Mesure de la Production,6,215,2,QCM,0.11,0.76,74.94,43,15,58,52,43,9,1.12,82.69,Difficile,Facile,2,Beaucoup plus Facile,Adapte
1325,2016,Economie,3,La Production,4,Les Limites de la Mesure de la Production,6,215,2,QCM,0.0,0.76,74.94,37,12,49,41,37,4,1.2,90.24,Facile,Facile,0,Meme Difficulté,Adapte
2436,2017,Economie,3,La Production,4,Les Limites de la Mesure de la Production,6,215,2,QCM,0.06,0.97,74.94,35,12,47,38,35,3,1.24,92.11,Facile,Facile,0,Meme Difficulté,Adapte
3547,2018,Economie,3,La Production,4,Les Limites de la Mesure de la Production,6,215,2,QCU,0.0,0.76,74.94,31,10,41,40,31,9,1.02,77.5,Facile,Facile,0,Meme Difficulté,Adapte
4658,2019,Economie,3,La Production,4,Les Limites de la Mesure de la Production,6,215,2,QCM,0.11,0.8,74.94,27,9,36,28,27,1,1.29,96.43,Facile,Facile,0,Meme Difficulté,Adapte
5769,2020,Economie,3,La Production,4,Les Limites de la Mesure de la Production,6,215,2,QCM,0.15,0.71,74.94,25,8,33,33,25,8,1.0,75.76,Facile,Facile,0,Meme Difficulté,Adapte
215,2015,Economie,3,La Production,4,Les Limites de la Mesure de la Production,6,216,3,QCM,0.31,0.69,48.16,28,31,59,38,28,10,1.55,73.68,Facile,Moyen,-1,Plus Difficile,Pas Adapte
1326,2016,Economie,3,La Production,4,Les Limites de la Mesure de la Production,6,216,3,QCM,0.63,0.3,2.83,2,59,61,52,2,50,1.17,3.85,Difficile,Difficile,0,Meme Difficulté,Pas Adapte
2437,2017,Economie,3,La Production,4,Les Limites de la Mesure de la Production,6,216,3,QCM,0.7,0.19,13.24,7,46,53,29,7,22,1.83,24.14,Moyen,Difficile,-1,Plus Difficile,Pas Adapte
3548,2018,Economie,3,La Production,4,Les Limites de la Mesure de la Production,6,216,3,QCM,0.16,0.9,76.17,40,13,53,46,40,6,1.15,86.96,Moyen,Facile,1,Plus Facile,Pas Adapte
4659,2019,Economie,3,La Production,4,Les Limites de la Mesure de la Production,6,216,3,QCM,0.32,0.47,60.12,36,24,60,48,36,12,1.25,75.0,Moyen,Moyen,0,Meme Difficulté,Pas Adapte
5770,2020,Economie,3,La Production,4,Les Limites de la Mesure de la Production,6,216,3,QCM,0.05,0.77,80.01,49,12,61,51,49,2,1.2,96.08,Moyen,Facile,1,Plus Facile,Pas Adapte
216,2015,Economie,3,La Production,4,Les Limites de la Mesure de la Production,6,217,4,QCU,0.67,0.21,9.83,6,50,56,21,6,15,2.67,28.57,Difficile,Difficile,0,Meme Difficulté,Pas Adapte
1327,2016,Economie,3,La Production,4,Les Limites de la Mesure de la Production,6,217,4,QCU,0.4,0.37,31.07,18,40,58,50,18,32,1.16,36.0,Moyen,Difficile,-1,Plus Difficile,Pas Adapte
2438,2017,Economie,3,La Production,4,Les Limites de la Mesure de la Production,6,217,4,QCU,0.5,0.34,13.01,8,56,64,35,8,27,1.83,22.86,Moyen,Difficile,-1,Plus Difficile,Pas Adapte
3549,2018,Economie,3,La Production,4,Les Limites de la Mesure de la Production,6,217,4,QCU,0.14,0.98,78.86,50,13,63,54,50,4,1.17,92.59,Facile,Facile,0,Meme Difficulté,Pas Adapte
4660,2019,Economie,3,La Production,4,Les Limites de la Mesure de la Production,6,217,4,QCU,0.37,0.4,36.32,21,36,57,54,21,33,1.06,38.89,Difficile,Moyen,1,Plus Facile,Pas Adapte
5771,2020,Economie,3,La Production,4,Les Limites de la Mesure de la Production,6,217,4,QCU,0.09,0.84,86.71,45,7,52,51,45,6,1.02,88.24,Facile,Facile,0,Meme Difficulté,Pas Adapte
217,2015,Economie,3,La Production,4,Les Limites de la Mesure de la Production,6,218,5,QROC,0.79,0.21,13.44,3,19,22,20,3,17,1.1,15.0,Facile,Difficile,-2,Beaucoup plus Difficile,Pas Adapte
1328,2016,Economie,3,La Production,4,Les Limites de la Mesure de la Production,6,218,5,QROC,0.83,0.19,32.69,8,16,24,23,8,15,1.04,34.78,Difficile,Difficile,0,Meme Difficulté,Pas Adapte
2439,2017,Economie,3,La Production,4,Les Limites de la Mesure de la Production,6,218,5,QROC,0.95,0.13,26.86,7,19,26,11,7,4,2.36,63.64,Moyen,Difficile,-1,Plus Difficile,Pas Adapte
3550,2018,Economie,3,La Production,4,Les Limites de la Mesure de la Production,6,218,5,QROC,0.02,0.77,97.55,26,1,27,26,26,0,1.04,100.0,Facile,Facile,0,Meme Difficulté,Pas Adapte
4661,2019,Economie,3,La Production,4,Les Limites de la Mesure de la Production,6,218,5,QROC,0.74,0.19,28.95,7,18,25,22,7,15,1.14,31.82,Difficile,Difficile,0,Meme Difficulté,Pas Adapte
5772,2020,Economie,3,La Production,4,Les Limites de la Mesure de la Production,6,218,5,QROC,0.02,0.66,89.72,22,2,24,23,22,1,1.04,95.65,Moyen,Facile,1,Plus Facile,Pas Adapte
218,2015,Economie,3,La Production,4,Les Limites de la Mesure de la Production,6,219,6,QROC,0.64,0.13,24.88,10,32,42,38,10,28,1.11,26.32,Difficile,Difficile,0,Meme Difficulté,Pas Adapte
1329,2016,Economie,3,La Production,4,Les Limites de la Mesure de la Production,6,219,6,QROC,0.2,0.53,85.99,31,5,36,34,31,3,1.06,91.18,Difficile,Facile,2,Beaucoup plus Facile,Pas Adapte
2440,2017,Economie,3,La Production,4,Les Limites de la Mesure de la Production,6,219,6,QROC,0.44,0.38,63.95,24,13,37,24,24,0,1.54,100.0,Difficile,Moyen,1,Plus Facile,Pas Adapte
3551,2018,Economie,3,La Production,4,Les Limites de la Mesure de la Production,6,219,6,QROC,0.01,0.59,78.06,32,9,41,34,32,2,1.21,94.12,Difficile,Facile,2,Beaucoup plus Facile,Pas Adapte
4662,2019,Economie,3,La Production,4,Les Limites de la Mesure de la Production,6,219,6,QROC,0.8,0.04,12.98,6,40,46,44,6,38,1.05,13.64,Facile,Difficile,-2,Beaucoup plus Difficile,Pas Adapte
5773,2020,Economie,3,La Production,4,Les Limites de la Mesure de la Production,6,219,6,QROC,0.17,0.67,84.79,43,8,51,50,43,7,1.02,86.0,Facile,Facile,0,Meme Difficulté,Pas Adapte
219,2015,Economie,4,Le Travail,1,Les Aspects Quantitatifs et Qualitatifs du Travail,8,220,1,QCU,0.67,0.3,8.3,2,27,29,25,2,23,1.16,8.0,Difficile,Difficile,0,Meme Difficulté,Pas Adapte
1330,2016,Economie,4,Le Travail,1,Les Aspects Quantitatifs et Qualitatifs du Travail,8,220,1,QCU,0.02,0.9,83.9,23,5,28,27,23,4,1.04,85.19,Moyen,Facile,1,Plus Facile,Pas Adapte
2441,2017,Economie,4,Le Travail,1,Les Aspects Quantitatifs et Qualitatifs du Travail,8,220,1,QROC,0.67,0.12,18.16,5,21,26,20,5,15,1.3,25.0,Moyen,Difficile,-1,Plus Difficile,Pas Adapte
3552,2018,Economie,4,Le Travail,1,Les Aspects Quantitatifs et Qualitatifs du Travail,8,220,1,QROC,0.29,0.38,57.35,16,12,28,24,16,8,1.17,66.67,Moyen,Moyen,0,Meme Difficulté,Pas Adapte
4663,2019,Economie,4,Le Travail,1,Les Aspects Quantitatifs et Qualitatifs du Travail,8,220,1,QROC,0.96,0.03,29.27,8,20,28,20,8,12,1.4,40.0,Difficile,Difficile,0,Meme Difficulté,Pas Adapte
5774,2020,Economie,4,Le Travail,1,Les Aspects Quantitatifs et Qualitatifs du Travail,8,220,1,QROC,0.83,0.2,9.8,2,23,25,11,2,9,2.27,18.18,Moyen,Difficile,-1,Plus Difficile,Pas Adapte
220,2015,Economie,4,Le Travail,1,Les Aspects Quantitatifs et Qualitatifs du Travail,8,221,2,QCU,0.04,0.98,97.89,83,2,85,85,83,2,1.0,97.65,Difficile,Facile,2,Beaucoup plus Facile,Pas Adapte
1331,2016,Economie,4,Le Travail,1,Les Aspects Quantitatifs et Qualitatifs du Travail,8,221,2,QCU,0.27,0.46,43.9,43,55,98,82,43,39,1.2,52.44,Moyen,Moyen,0,Meme Difficulté,Pas Adapte
2442,2017,Economie,4,Le Travail,1,Les Aspects Quantitatifs et Qualitatifs du Travail,8,221,2,QCU,0.43,0.27,13.04,13,83,96,90,13,77,1.07,14.44,Facile,Difficile,-2,Beaucoup plus Difficile,Pas Adapte
3553,2018,Economie,4,Le Travail,1,Les Aspects Quantitatifs et Qualitatifs du Travail,8,221,2,QCU,0.58,0.31,24.38,26,79,105,65,26,39,1.62,40.0,Difficile,Difficile,0,Meme Difficulté,Pas Adapte
4664,2019,Economie,4,Le Travail,1,Les Aspects Quantitatifs et Qualitatifs du Travail,8,221,2,QCU,0.14,0.88,98.02,108,2,110,109,108,1,1.01,99.08,Facile,Facile,0,Meme Difficulté,Pas Adapte
5775,2020,Economie,4,Le Travail,1,Les Aspects Quantitatifs et Qualitatifs du Travail,8,221,2,QCU,0.41,0.39,6.82,7,100,107,61,7,54,1.75,11.48,Difficile,Difficile,0,Meme Difficulté,Pas Adapte
221,2015,Economie,4,Le Travail,1,Les Aspects Quantitatifs et Qualitatifs du Travail,8,222,3,QCU,0.49,0.21,30.53,21,49,70,49,21,28,1.43,42.86,Facile,Difficile,-2,Beaucoup plus Difficile,Pas Adapte
1332,2016,Economie,4,Le Travail,1,Les Aspects Quantitatifs et Qualitatifs du Travail,8,222,3,QCU,0.18,0.99,83.41,60,12,72,63,60,3,1.14,95.24,Difficile,Facile,2,Beaucoup plus Facile,Pas Adapte
2443,2017,Economie,4,Le Travail,1,Les Aspects Quantitatifs et Qualitatifs du Travail,8,222,3,QCU,0.28,0.45,57.91,36,26,62,54,36,18,1.15,66.67,Facile,Moyen,-1,Plus Difficile,Pas Adapte
3554,2018,Economie,4,Le Travail,1,Les Aspects Quantitatifs et Qualitatifs du Travail,8,222,3,QCU,0.02,0.89,79.71,46,12,58,53,46,7,1.09,86.79,Difficile,Facile,2,Beaucoup plus Facile,Pas Adapte
4665,2019,Economie,4,Le Travail,1,Les Aspects Quantitatifs et Qualitatifs du Travail,8,222,3,QCU,0.35,0.44,57.98,34,24,58,39,34,5,1.49,87.18,Facile,Moyen,-1,Plus Difficile,Pas Adapte
5776,2020,Economie,4,Le Travail,1,Les Aspects Quantitatifs et Qualitatifs du Travail,8,222,3,QCU,0.0,0.92,98.16,54,1,55,54,54,0,1.02,100.0,Facile,Facile,0,Meme Difficulté,Pas Adapte
222,2015,Economie,4,Le Travail,1,Les Aspects Quantitatifs et Qualitatifs du Travail,8,223,4,QROC,0.87,0.24,13.46,2,11,13,11,2,9,1.18,18.18,Moyen,Difficile,-1,Plus Difficile,Pas Adapte
1333,2016,Economie,4,Le Travail,1,Les Aspects Quantitatifs et Qualitatifs du Travail,8,223,4,QROC,0.7,0.02,12.11,1,11,12,9,1,8,1.33,11.11,Facile,Difficile,-2,Beaucoup plus Difficile,Pas Adapte
2444,2017,Economie,4,Le Travail,1,Les Aspects Quantitatifs et Qualitatifs du Travail,8,223,4,QROC,0.87,0.2,33.32,3,7,10,5,3,2,2.0,60.0,Facile,Difficile,-2,Beaucoup plus Difficile,Pas Adapte
3555,2018,Economie,4,Le Travail,1,Les Aspects Quantitatifs et Qualitatifs du Travail,8,223,4,QROC,0.72,0.13,26.04,3,9,12,6,3,3,2.0,50.0,Difficile,Difficile,0,Meme Difficulté,Pas Adapte
4666,2019,Economie,4,Le Travail,1,Les Aspects Quantitatifs et Qualitatifs du Travail,8,223,4,QROC,0.14,0.46,72.63,7,3,10,8,7,1,1.25,87.5,Moyen,Facile,1,Plus Facile,Adapte
5777,2020,Economie,4,Le Travail,1,Les Aspects Quantitatifs et Qualitatifs du Travail,8,223,4,QROC,0.12,0.49,72.63,7,3,10,7,7,0,1.43,100.0,Facile,Facile,0,Meme Difficulté,Adapte
223,2015,Economie,4,Le Travail,1,Les Aspects Quantitatifs et Qualitatifs du Travail,8,224,5,QCM,0.32,0.37,60.5,39,26,65,51,39,12,1.27,76.47,Moyen,Moyen,0,Meme Difficulté,Pas Adapte
1334,2016,Economie,4,Le Travail,1,Les Aspects Quantitatifs et Qualitatifs du Travail,8,224,5,QCM,0.36,0.65,37.69,21,35,56,22,21,1,2.55,95.45,Facile,Moyen,-1,Plus Difficile,Pas Adapte
2445,2017,Economie,4,Le Travail,1,Les Aspects Quantitatifs et Qualitatifs du Travail,8,224,5,QCU,0.57,0.34,5.4,3,52,55,38,3,35,1.45,7.89,Moyen,Difficile,-1,Plus Difficile,Pas Adapte
3556,2018,Economie,4,Le Travail,1,Les Aspects Quantitatifs et Qualitatifs du Travail,8,224,5,QCU,0.58,0.25,14.74,7,43,50,44,7,37,1.14,15.91,Moyen,Difficile,-1,Plus Difficile,Pas Adapte
4667,2019,Economie,4,Le Travail,1,Les Aspects Quantitatifs et Qualitatifs du Travail,8,224,5,QCU,0.62,0.33,5.52,2,41,43,41,2,39,1.05,4.88,Difficile,Difficile,0,Meme Difficulté,Pas Adapte
5778,2020,Economie,4,Le Travail,1,Les Aspects Quantitatifs et Qualitatifs du Travail,8,224,5,QCU,0.23,0.59,45.08,21,25,46,21,21,0,2.19,100.0,Facile,Moyen,-1,Plus Difficile,Pas Adapte
224,2015,Economie,4,Le Travail,1,Les Aspects Quantitatifs et Qualitatifs du Travail,8,225,6,QCU,0.17,0.75,86.23,53,8,61,57,53,4,1.07,92.98,Moyen,Facile,1,Plus Facile,Pas Adapte
1335,2016,Economie,4,Le Travail,1,Les Aspects Quantitatifs et Qualitatifs du Travail,8,225,6,QCU,0.01,0.86,70.35,44,18,62,55,44,11,1.13,80.0,Moyen,Facile,1,Plus Facile,Adapte
2446,2017,Economie,4,Le Travail,1,Les Aspects Quantitatifs et Qualitatifs du Travail,8,225,6,QCU,0.13,0.87,70.35,43,18,61,54,43,11,1.13,79.63,Facile,Facile,0,Meme Difficulté,Adapte
3557,2018,Economie,4,Le Travail,1,Les Aspects Quantitatifs et Qualitatifs du Travail,8,225,6,QCU,0.14,0.81,70.35,46,20,66,48,46,2,1.38,95.83,Facile,Facile,0,Meme Difficulté,Adapte
4668,2019,Economie,4,Le Travail,1,Les Aspects Quantitatifs et Qualitatifs du Travail,8,225,6,QCU,0.03,0.84,70.35,53,22,75,65,53,12,1.15,81.54,Facile,Facile,0,Meme Difficulté,Adapte
5779,2020,Economie,4,Le Travail,1,Les Aspects Quantitatifs et Qualitatifs du Travail,8,225,6,QCU,0.09,0.89,70.35,59,25,84,59,59,0,1.42,100.0,Facile,Facile,0,Meme Difficulté,Adapte
225,2015,Economie,4,Le Travail,1,Les Aspects Quantitatifs et Qualitatifs du Travail,8,226,7,QCU,0.55,0.26,2.98,0,14,14,6,0,6,2.33,0.0,Difficile,Difficile,0,Meme Difficulté,Pas Adapte
1336,2016,Economie,4,Le Travail,1,Les Aspects Quantitatifs et Qualitatifs du Travail,8,226,7,QCU,0.32,0.62,52.98,8,7,15,9,8,1,1.67,88.89,Difficile,Moyen,1,Plus Facile,Pas Adapte
2447,2017,Economie,4,Le Travail,1,Les Aspects Quantitatifs et Qualitatifs du Travail,8,226,7,QCU,0.71,0.33,23.4,4,12,16,13,4,9,1.23,30.77,Moyen,Difficile,-1,Plus Difficile,Pas Adapte
3558,2018,Economie,4,Le Travail,1,Les Aspects Quantitatifs et Qualitatifs du Travail,8,226,7,QCU,0.14,0.86,70.53,11,4,15,13,11,2,1.15,84.62,Difficile,Facile,2,Beaucoup plus Facile,Adapte
4669,2019,Economie,4,Le Travail,1,Les Aspects Quantitatifs et Qualitatifs du Travail,8,226,7,QCU,0.02,0.77,70.53,9,4,13,11,9,2,1.18,81.82,Facile,Facile,0,Meme Difficulté,Adapte
5780,2020,Economie,4,Le Travail,1,Les Aspects Quantitatifs et Qualitatifs du Travail,8,226,7,QCU,0.17,0.81,70.53,8,4,12,11,8,3,1.09,72.73,Facile,Facile,0,Meme Difficulté,Adapte
226,2015,Economie,4,Le Travail,1,Les Aspects Quantitatifs et Qualitatifs du Travail,8,227,8,QCU,0.36,0.59,44.67,29,35,64,45,29,16,1.42,64.44,Difficile,Moyen,1,Plus Facile,Pas Adapte
1337,2016,Economie,4,Le Travail,1,Les Aspects Quantitatifs et Qualitatifs du Travail,8,227,8,QCU,0.1,0.79,92.45,57,5,62,59,57,2,1.05,96.61,Difficile,Facile,2,Beaucoup plus Facile,Pas Adapte
2448,2017,Economie,4,Le Travail,1,Les Aspects Quantitatifs et Qualitatifs du Travail,8,227,8,QCU,0.38,0.63,61.14,34,22,56,53,34,19,1.06,64.15,Facile,Moyen,-1,Plus Difficile,Pas Adapte
3559,2018,Economie,4,Le Travail,1,Les Aspects Quantitatifs et Qualitatifs du Travail,8,227,8,QCU,0.41,0.34,30.6,15,33,48,16,15,1,3.0,93.75,Facile,Difficile,-2,Beaucoup plus Difficile,Pas Adapte
4670,2019,Economie,4,Le Travail,1,Les Aspects Quantitatifs et Qualitatifs du Travail,8,227,8,QCM,0.65,0.29,18.26,8,37,45,40,8,32,1.12,20.0,Difficile,Difficile,0,Meme Difficulté,Pas Adapte
5781,2020,Economie,4,Le Travail,1,Les Aspects Quantitatifs et Qualitatifs du Travail,8,227,8,QCM,0.76,0.28,2.56,1,38,39,32,1,31,1.22,3.12,Facile,Difficile,-2,Beaucoup plus Difficile,Pas Adapte
227,2015,Economie,4,Le Travail,2,La Productivite du Travail et la Notion de Capital Humain,10,228,1,QCM,0.51,0.21,18.11,5,23,28,7,5,2,4.0,71.43,Difficile,Difficile,0,Meme Difficulté,Pas Adapte
1338,2016,Economie,4,Le Travail,2,La Productivite du Travail et la Notion de Capital Humain,10,228,1,QCM,0.55,0.19,8.09,2,24,26,23,2,21,1.13,8.7,Difficile,Difficile,0,Meme Difficulté,Pas Adapte
2449,2017,Economie,4,Le Travail,2,La Productivite du Travail et la Notion de Capital Humain,10,228,1,QCM,0.41,0.58,48.06,12,12,24,14,12,2,1.71,85.71,Moyen,Moyen,0,Meme Difficulté,Pas Adapte
3560,2018,Economie,4,Le Travail,2,La Productivite du Travail et la Notion de Capital Humain,10,228,1,QCM,0.49,0.58,60.68,13,8,21,17,13,4,1.24,76.47,Facile,Moyen,-1,Plus Difficile,Pas Adapte
4671,2019,Economie,4,Le Travail,2,La Productivite du Travail et la Notion de Capital Humain,10,228,1,QCM,0.68,0.17,8.47,2,17,19,13,2,11,1.46,15.38,Moyen,Difficile,-1,Plus Difficile,Pas Adapte
5782,2020,Economie,4,Le Travail,2,La Productivite du Travail et la Notion de Capital Humain,10,228,1,QCM,0.01,0.89,93.32,16,1,17,16,16,0,1.06,100.0,Facile,Facile,0,Meme Difficulté,Pas Adapte
228,2015,Economie,4,Le Travail,2,La Productivite du Travail et la Notion de Capital Humain,10,229,2,QCM,0.59,0.22,2.2,2,94,96,42,2,40,2.29,4.76,Difficile,Difficile,0,Meme Difficulté,Pas Adapte
1339,2016,Economie,4,Le Travail,2,La Productivite du Travail et la Notion de Capital Humain,10,229,2,QCM,0.59,0.29,13.26,11,74,85,29,11,18,2.93,37.93,Facile,Difficile,-2,Beaucoup plus Difficile,Pas Adapte
2450,2017,Economie,4,Le Travail,2,La Productivite du Travail et la Notion de Capital Humain,10,229,2,QCM,0.52,0.18,27.09,22,60,82,73,22,51,1.12,30.14,Difficile,Difficile,0,Meme Difficulté,Pas Adapte
3561,2018,Economie,4,Le Travail,2,La Productivite du Travail et la Notion de Capital Humain,10,229,2,QCM,0.24,0.64,55.28,44,35,79,53,44,9,1.49,83.02,Moyen,Moyen,0,Meme Difficulté,Pas Adapte
4672,2019,Economie,4,Le Travail,2,La Productivite du Travail et la Notion de Capital Humain,10,229,2,QCM,0.11,0.96,68.55,47,21,68,59,47,12,1.15,79.66,Difficile,Facile,2,Beaucoup plus Facile,Adapte
5783,2020,Economie,4,Le Travail,2,La Productivite du Travail et la Notion de Capital Humain,10,229,2,QCM,0.03,0.73,68.55,46,21,67,64,46,18,1.05,71.88,Facile,Facile,0,Meme Difficulté,Adapte
229,2015,Economie,4,Le Travail,2,La Productivite du Travail et la Notion de Capital Humain,10,230,3,QCM,0.46,0.67,42.23,36,50,86,40,36,4,2.15,90.0,Moyen,Moyen,0,Meme Difficulté,Pas Adapte
1340,2016,Economie,4,Le Travail,2,La Productivite du Travail et la Notion de Capital Humain,10,230,3,QCM,0.37,0.46,58.91,54,37,91,85,54,31,1.07,63.53,Moyen,Moyen,0,Meme Difficulté,Pas Adapte
2451,2017,Economie,4,Le Travail,2,La Productivite du Travail et la Notion de Capital Humain,10,230,3,QCM,0.62,0.24,0.37,0,97,97,54,0,54,1.8,0.0,Facile,Difficile,-2,Beaucoup plus Difficile,Pas Adapte
3562,2018,Economie,4,Le Travail,2,La Productivite du Travail et la Notion de Capital Humain,10,230,3,QCU,0.16,0.89,85.04,71,12,83,83,71,12,1.0,85.54,Facile,Facile,0,Meme Difficulté,Pas Adapte
4673,2019,Economie,4,Le Travail,2,La Productivite du Travail et la Notion de Capital Humain,10,230,3,QCM,0.59,0.26,11.59,11,84,95,64,11,53,1.48,17.19,Moyen,Difficile,-1,Plus Difficile,Pas Adapte
5784,2020,Economie,4,Le Travail,2,La Productivite du Travail et la Notion de Capital Humain,10,230,3,QCM,0.23,0.41,64.58,61,34,95,79,61,18,1.2,77.22,Difficile,Moyen,1,Plus Facile,Pas Adapte
230,2015,Economie,4,Le Travail,2,La Productivite du Travail et la Notion de Capital Humain,10,231,4,QCU,0.74,0.32,7.69,3,37,40,16,3,13,2.5,18.75,Moyen,Difficile,-1,Plus Difficile,Pas Adapte
1341,2016,Economie,4,Le Travail,2,La Productivite du Travail et la Notion de Capital Humain,10,231,4,QCU,0.02,0.95,94.87,42,2,44,44,42,2,1.0,95.45,Facile,Facile,0,Meme Difficulté,Pas Adapte
2452,2017,Economie,4,Le Travail,2,La Productivite du Travail et la Notion de Capital Humain,10,231,4,QCU,0.06,0.76,72.83,36,13,49,46,36,10,1.07,78.26,Facile,Facile,0,Meme Difficulté,Adapte
3563,2018,Economie,4,Le Travail,2,La Productivite du Travail et la Notion de Capital Humain,10,231,4,QCU,0.16,0.77,72.83,39,14,53,47,39,8,1.13,82.98,Facile,Facile,0,Meme Difficulté,Adapte
4674,2019,Economie,4,Le Travail,2,La Productivite du Travail et la Notion de Capital Humain,10,231,4,QCU,0.09,0.89,72.83,43,16,59,45,43,2,1.31,95.56,Facile,Facile,0,Meme Difficulté,Adapte
5785,2020,Economie,4,Le Travail,2,La Productivite du Travail et la Notion de Capital Humain,10,231,4,QCU,0.11,0.84,72.83,46,17,63,58,46,12,1.09,79.31,Facile,Facile,0,Meme Difficulté,Adapte
231,2015,Economie,4,Le Travail,2,La Productivite du Travail et la Notion de Capital Humain,10,232,5,QCU,0.51,0.26,30.17,9,20,29,21,9,12,1.38,42.86,Difficile,Difficile,0,Meme Difficulté,Pas Adapte
1342,2016,Economie,4,Le Travail,2,La Productivite du Travail et la Notion de Capital Humain,10,232,5,QCU,0.37,0.46,53.21,14,12,26,15,14,1,1.73,93.33,Moyen,Moyen,0,Meme Difficulté,Pas Adapte
2453,2017,Economie,4,Le Travail,2,La Productivite du Travail et la Notion de Capital Humain,10,232,5,QCU,0.29,0.46,43.84,12,15,27,15,12,3,1.8,80.0,Facile,Moyen,-1,Plus Difficile,Pas Adapte
3564,2018,Economie,4,Le Travail,2,La Productivite du Travail et la Notion de Capital Humain,10,232,5,QCM,0.44,0.5,43.03,13,18,31,16,13,3,1.94,81.25,Difficile,Moyen,1,Plus Facile,Pas Adapte
4675,2019,Economie,4,Le Travail,2,La Productivite du Travail et la Notion de Capital Humain,10,232,5,QCM,0.48,0.42,39.4,12,18,30,30,12,18,1.0,40.0,Moyen,Moyen,0,Meme Difficulté,Pas Adapte
5786,2020,Economie,4,Le Travail,2,La Productivite du Travail et la Notion de Capital Humain,10,232,5,QCM,0.24,0.67,38.43,12,18,30,16,12,4,1.88,75.0,Difficile,Moyen,1,Plus Facile,Pas Adapte
232,2015,Economie,4,Le Travail,2,La Productivite du Travail et la Notion de Capital Humain,10,233,6,QCU,0.35,0.57,35.68,22,41,63,57,22,35,1.11,38.6,Facile,Moyen,-1,Plus Difficile,Pas Adapte
1343,2016,Economie,4,Le Travail,2,La Productivite du Travail et la Notion de Capital Humain,10,233,6,QCU,0.45,0.26,30.68,20,46,66,29,20,9,2.28,68.97,Moyen,Difficile,-1,Plus Difficile,Pas Adapte
2454,2017,Economie,4,Le Travail,2,La Productivite du Travail et la Notion de Capital Humain,10,233,6,QCU,0.43,0.32,9.27,6,57,63,25,6,19,2.52,24.0,Facile,Difficile,-2,Beaucoup plus Difficile,Pas Adapte
3565,2018,Economie,4,Le Travail,2,La Productivite du Travail et la Notion de Capital Humain,10,233,6,QCU,0.4,0.61,51.83,32,30,62,50,32,18,1.24,64.0,Difficile,Moyen,1,Plus Facile,Pas Adapte
4676,2019,Economie,4,Le Travail,2,La Productivite du Travail et la Notion de Capital Humain,10,233,6,QCU,0.52,0.25,7.13,5,62,67,35,5,30,1.91,14.29,Difficile,Difficile,0,Meme Difficulté,Pas Adapte
5787,2020,Economie,4,Le Travail,2,La Productivite du Travail et la Notion de Capital Humain,10,233,6,QCU,0.64,0.36,9.22,7,69,76,33,7,26,2.3,21.21,Facile,Difficile,-2,Beaucoup plus Difficile,Pas Adapte
233,2015,Economie,4,Le Travail,2,La Productivite du Travail et la Notion de Capital Humain,10,234,7,QCM,0.74,0.22,2.03,0,23,23,13,0,13,1.77,0.0,Difficile,Difficile,0,Meme Difficulté,Pas Adapte
1344,2016,Economie,4,Le Travail,2,La Productivite du Travail et la Notion de Capital Humain,10,234,7,QCM,0.12,0.98,87.46,20,3,23,22,20,2,1.05,90.91,Facile,Facile,0,Meme Difficulté,Pas Adapte
2455,2017,Economie,4,Le Travail,2,La Productivite du Travail et la Notion de Capital Humain,10,234,7,QCM,0.58,0.24,22.85,5,17,22,15,5,10,1.47,33.33,Difficile,Difficile,0,Meme Difficulté,Pas Adapte
3566,2018,Economie,4,Le Travail,2,La Productivite du Travail et la Notion de Capital Humain,10,234,7,QCM,0.06,0.83,65.7,13,7,20,17,13,4,1.18,76.47,Difficile,Facile,2,Beaucoup plus Facile,Adapte
4677,2019,Economie,4,Le Travail,2,La Productivite du Travail et la Notion de Capital Humain,10,234,7,QCM,0.04,0.9,65.7,13,7,20,16,13,3,1.25,81.25,Facile,Facile,0,Meme Difficulté,Adapte
5788,2020,Economie,4,Le Travail,2,La Productivite du Travail et la Notion de Capital Humain,10,234,7,QCM,0.18,0.74,65.7,15,8,23,21,15,6,1.1,71.43,Facile,Facile,0,Meme Difficulté,Adapte
234,2015,Economie,4,Le Travail,2,La Productivite du Travail et la Notion de Capital Humain,10,235,8,QCU,0.08,0.76,80.36,62,15,77,65,62,3,1.18,95.38,Facile,Facile,0,Meme Difficulté,Pas Adapte
1345,2016,Economie,4,Le Travail,2,La Productivite du Travail et la Notion de Capital Humain,10,235,8,QCU,0.01,0.93,77.97,58,16,74,69,58,11,1.07,84.06,Facile,Facile,0,Meme Difficulté,Pas Adapte
2456,2017,Economie,4,Le Travail,2,La Productivite du Travail et la Notion de Capital Humain,10,235,8,QCU,0.34,0.46,43.69,34,44,78,48,34,14,1.62,70.83,Facile,Moyen,-1,Plus Difficile,Pas Adapte
3567,2018,Economie,4,Le Travail,2,La Productivite du Travail et la Notion de Capital Humain,10,235,8,QCU,0.07,0.75,98.63,68,1,69,69,68,1,1.0,98.55,Moyen,Facile,1,Plus Facile,Pas Adapte
4678,2019,Economie,4,Le Travail,2,La Productivite du Travail et la Notion de Capital Humain,10,235,8,QCU,0.17,0.97,91.54,66,6,72,67,66,1,1.07,98.51,Moyen,Facile,1,Plus Facile,Pas Adapte
5789,2020,Economie,4,Le Travail,2,La Productivite du Travail et la Notion de Capital Humain,10,235,8,QCM,0.15,0.94,95.27,65,3,68,66,65,1,1.03,98.48,Difficile,Facile,2,Beaucoup plus Facile,Pas Adapte
235,2015,Economie,4,Le Travail,2,La Productivite du Travail et la Notion de Capital Humain,10,236,9,QROC,0.0,0.67,79.56,10,2,12,11,10,1,1.09,90.91,Difficile,Facile,2,Beaucoup plus Facile,Pas Adapte
1346,2016,Economie,4,Le Travail,2,La Productivite du Travail et la Notion de Capital Humain,10,236,9,QROC,0.53,0.25,43.92,6,7,13,13,6,7,1.0,46.15,Facile,Moyen,-1,Plus Difficile,Pas Adapte
2457,2017,Economie,4,Le Travail,2,La Productivite du Travail et la Notion de Capital Humain,10,236,9,QROC,0.16,0.98,99.7,14,0,14,14,14,0,1.0,100.0,Moyen,Facile,1,Plus Facile,Pas Adapte
3568,2018,Economie,4,Le Travail,2,La Productivite du Travail et la Notion de Capital Humain,10,236,9,QROC,0.71,0.16,5.73,1,11,12,5,1,4,2.4,20.0,Moyen,Difficile,-1,Plus Difficile,Pas Adapte
4679,2019,Economie,4,Le Travail,2,La Productivite du Travail et la Notion de Capital Humain,10,236,9,QROC,0.16,0.61,81.45,10,2,12,12,10,2,1.0,83.33,Difficile,Facile,2,Beaucoup plus Facile,Pas Adapte
5790,2020,Economie,4,Le Travail,2,La Productivite du Travail et la Notion de Capital Humain,10,236,9,QO,0.5,0.2,60.95,7,4,11,11,7,4,1.0,63.64,Facile,Moyen,-1,Plus Difficile,Pas Adapte
236,2015,Economie,4,Le Travail,2,La Productivite du Travail et la Notion de Capital Humain,10,237,10,QCM,0.51,0.27,16.48,5,24,29,23,5,18,1.26,21.74,Moyen,Difficile,-1,Plus Difficile,Pas Adapte
1347,2016,Economie,4,Le Travail,2,La Productivite du Travail et la Notion de Capital Humain,10,237,10,QCM,0.64,0.25,1.87,0,25,25,18,0,18,1.39,0.0,Facile,Difficile,-2,Beaucoup plus Difficile,Pas Adapte
2458,2017,Economie,4,Le Travail,2,La Productivite du Travail et la Notion de Capital Humain,10,237,10,QCM,0.06,0.79,69.38,19,9,28,24,19,5,1.17,79.17,Moyen,Facile,1,Plus Facile,Adapte
3569,2018,Economie,4,Le Travail,2,La Productivite du Travail et la Notion de Capital Humain,10,237,10,QCM,0.11,0.73,69.38,19,8,27,26,19,7,1.04,73.08,Facile,Facile,0,Meme Difficulté,Adapte
4680,2019,Economie,4,Le Travail,2,La Productivite du Travail et la Notion de Capital Humain,10,237,10,QCU,0.09,0.93,69.38,19,9,28,21,19,2,1.33,90.48,Facile,Facile,0,Meme Difficulté,Adapte
5791,2020,Economie,4,Le Travail,2,La Productivite du Travail et la Notion de Capital Humain,10,237,10,QCU,0.14,0.89,69.38,18,8,26,20,18,2,1.3,90.0,Facile,Facile,0,Meme Difficulté,Adapte
237,2015,Economie,5,Le Capital et le Progres Technique,1,Le Capital et l'Investissement,6,238,1,QROC,0.52,0.38,58.47,14,10,24,19,14,5,1.26,73.68,Facile,Moyen,-1,Plus Difficile,Pas Adapte
1348,2016,Economie,5,Le Capital et le Progres Technique,1,Le Capital et l'Investissement,6,238,1,QROC,1.0,0.12,7.49,2,26,28,24,2,22,1.17,8.33,Difficile,Difficile,0,Meme Difficulté,Pas Adapte
2459,2017,Economie,5,Le Capital et le Progres Technique,1,Le Capital et l'Investissement,6,238,1,QROC,0.53,0.39,40.55,13,18,31,14,13,1,2.21,92.86,Moyen,Moyen,0,Meme Difficulté,Pas Adapte
3570,2018,Economie,5,Le Capital et le Progres Technique,1,Le Capital et l'Investissement,6,238,1,QROC,0.18,0.89,85.92,23,4,27,25,23,2,1.08,92.0,Moyen,Facile,1,Plus Facile,Pas Adapte
4681,2019,Economie,5,Le Capital et le Progres Technique,1,Le Capital et l'Investissement,6,238,1,QROC,0.47,0.38,59.92,15,10,25,17,15,2,1.47,88.24,Facile,Moyen,-1,Plus Difficile,Pas Adapte
5792,2020,Economie,5,Le Capital et le Progres Technique,1,Le Capital et l'Investissement,6,238,1,QROC,0.2,0.71,81.53,20,5,25,25,20,5,1.0,80.0,Facile,Facile,0,Meme Difficulté,Pas Adapte
238,2015,Economie,5,Le Capital et le Progres Technique,1,Le Capital et l'Investissement,6,239,2,QCM,0.11,0.75,82.96,80,17,97,96,80,16,1.01,83.33,Moyen,Facile,1,Plus Facile,Pas Adapte
1349,2016,Economie,5,Le Capital et le Progres Technique,1,Le Capital et l'Investissement,6,239,2,QCM,0.01,0.83,76.98,71,21,92,84,71,13,1.1,84.52,Difficile,Facile,2,Beaucoup plus Facile,Pas Adapte
2460,2017,Economie,5,Le Capital et le Progres Technique,1,Le Capital et l'Investissement,6,239,2,QCM,0.71,0.17,16.3,16,85,101,71,16,55,1.42,22.54,Moyen,Difficile,-1,Plus Difficile,Pas Adapte
3571,2018,Economie,5,Le Capital et le Progres Technique,1,Le Capital et l'Investissement,6,239,2,QCM,0.18,0.94,78.83,81,22,103,89,81,8,1.16,91.01,Difficile,Facile,2,Beaucoup plus Facile,Pas Adapte
4682,2019,Economie,5,Le Capital et le Progres Technique,1,Le Capital et l'Investissement,6,239,2,QCM,0.62,0.21,17.76,20,93,113,56,20,36,2.02,35.71,Facile,Difficile,-2,Beaucoup plus Difficile,Pas Adapte
5793,2020,Economie,5,Le Capital et le Progres Technique,1,Le Capital et l'Investissement,6,239,2,QCM,0.41,0.55,35.28,46,84,130,98,46,52,1.33,46.94,Difficile,Moyen,1,Plus Facile,Pas Adapte
239,2015,Economie,5,Le Capital et le Progres Technique,1,Le Capital et l'Investissement,6,240,3,QCU,0.11,0.87,76.8,65,19,84,72,65,7,1.17,90.28,Difficile,Facile,2,Beaucoup plus Facile,Pas Adapte
1350,2016,Economie,5,Le Capital et le Progres Technique,1,Le Capital et l'Investissement,6,240,3,QCU,0.0,0.96,91.33,70,7,77,77,70,7,1.0,90.91,Facile,Facile,0,Meme Difficulté,Pas Adapte
2461,2017,Economie,5,Le Capital et le Progres Technique,1,Le Capital et l'Investissement,6,240,3,QCU,0.08,0.77,70.66,47,20,67,55,47,8,1.22,85.45,Facile,Facile,0,Meme Difficulté,Adapte
3572,2018,Economie,5,Le Capital et le Progres Technique,1,Le Capital et l'Investissement,6,240,3,QCU,0.0,0.85,70.66,50,21,71,56,50,6,1.27,89.29,Facile,Facile,0,Meme Difficulté,Adapte
4683,2019,Economie,5,Le Capital et le Progres Technique,1,Le Capital et l'Investissement,6,240,3,QCU,0.1,0.96,70.66,52,22,74,61,52,9,1.21,85.25,Facile,Facile,0,Meme Difficulté,Adapte
5794,2020,Economie,5,Le Capital et le Progres Technique,1,Le Capital et l'Investissement,6,240,3,QCU,0.14,0.8,70.66,59,25,84,62,59,3,1.35,95.16,Facile,Facile,0,Meme Difficulté,Adapte
240,2015,Economie,5,Le Capital et le Progres Technique,1,Le Capital et l'Investissement,6,241,4,QCU,0.53,0.36,34.67,19,35,54,39,19,20,1.38,48.72,Moyen,Difficile,-1,Plus Difficile,Pas Adapte
1351,2016,Economie,5,Le Capital et le Progres Technique,1,Le Capital et l'Investissement,6,241,4,QCU,0.11,0.83,67.57,34,16,50,36,34,2,1.39,94.44,Facile,Facile,0,Meme Difficulté,Adapte
2462,2017,Economie,5,Le Capital et le Progres Technique,1,Le Capital et l'Investissement,6,241,4,QCU,0.05,0.92,67.57,29,14,43,32,29,3,1.34,90.62,Facile,Facile,0,Meme Difficulté,Adapte
3573,2018,Economie,5,Le Capital et le Progres Technique,1,Le Capital et l'Investissement,6,241,4,QCU,0.01,0.91,67.57,32,16,48,47,32,15,1.02,68.09,Facile,Facile,0,Meme Difficulté,Adapte
4684,2019,Economie,5,Le Capital et le Progres Technique,1,Le Capital et l'Investissement,6,241,4,QCU,0.19,0.77,67.57,31,15,46,34,31,3,1.35,91.18,Facile,Facile,0,Meme Difficulté,Adapte
5795,2020,Economie,5,Le Capital et le Progres Technique,1,Le Capital et l'Investissement,6,241,4,QCU,0.06,0.87,67.57,30,14,44,34,30,4,1.29,88.24,Facile,Facile,0,Meme Difficulté,Adapte
241,2015,Economie,5,Le Capital et le Progres Technique,1,Le Capital et l'Investissement,6,242,5,QROC,0.79,0.11,6.52,6,83,89,43,6,37,2.07,13.95,Facile,Difficile,-2,Beaucoup plus Difficile,Pas Adapte
1352,2016,Economie,5,Le Capital et le Progres Technique,1,Le Capital et l'Investissement,6,242,5,QROC,0.0,0.99,83.68,75,15,90,82,75,7,1.1,91.46,Moyen,Facile,1,Plus Facile,Pas Adapte
2463,2017,Economie,5,Le Capital et le Progres Technique,1,Le Capital et l'Investissement,6,242,5,QROC,0.08,0.44,66.8,55,27,82,73,55,18,1.12,75.34,Moyen,Facile,1,Plus Facile,Adapte
3574,2018,Economie,5,Le Capital et le Progres Technique,1,Le Capital et l'Investissement,6,242,5,QROC,0.05,0.41,66.8,47,23,70,64,47,17,1.09,73.44,Facile,Facile,0,Meme Difficulté,Adapte
4685,2019,Economie,5,Le Capital et le Progres Technique,1,Le Capital et l'Investissement,6,242,5,QROC,0.09,0.53,66.8,40,20,60,52,40,12,1.15,76.92,Facile,Facile,0,Meme Difficulté,Adapte
5796,2020,Economie,5,Le Capital et le Progres Technique,1,Le Capital et l'Investissement,6,242,5,QROC,0.07,0.82,66.8,43,21,64,58,43,15,1.1,74.14,Facile,Facile,0,Meme Difficulté,Adapte
242,2015,Economie,5,Le Capital et le Progres Technique,1,Le Capital et l'Investissement,6,243,6,QCM,0.34,0.53,62.45,9,6,15,14,9,5,1.07,64.29,Moyen,Moyen,0,Meme Difficulté,Pas Adapte
1353,2016,Economie,5,Le Capital et le Progres Technique,1,Le Capital et l'Investissement,6,243,6,QCM,0.7,0.28,25.24,4,10,14,10,4,6,1.4,40.0,Facile,Difficile,-2,Beaucoup plus Difficile,Pas Adapte
2464,2017,Economie,5,Le Capital et le Progres Technique,1,Le Capital et l'Investissement,6,243,6,QCM,0.17,0.89,86.92,12,2,14,13,12,1,1.08,92.31,Moyen,Facile,1,Plus Facile,Pas Adapte
3575,2018,Economie,5,Le Capital et le Progres Technique,1,Le Capital et l'Investissement,6,243,6,QCU,0.16,0.91,77.96,9,3,12,9,9,0,1.33,100.0,Facile,Facile,0,Meme Difficulté,Pas Adapte
4686,2019,Economie,5,Le Capital et le Progres Technique,1,Le Capital et l'Investissement,6,243,6,QCU,0.3,0.54,60.17,8,5,13,9,8,1,1.44,88.89,Difficile,Moyen,1,Plus Facile,Pas Adapte
5797,2020,Economie,5,Le Capital et le Progres Technique,1,Le Capital et l'Investissement,6,243,6,QCU,0.35,0.65,52.5,7,6,13,8,7,1,1.62,87.5,Facile,Moyen,-1,Plus Difficile,Pas Adapte
243,2015,Economie,5,Le Capital et le Progres Technique,2,Le Capital: Aspect Physiques et Financiers,10,244,1,QROC,0.1,0.48,78.87,54,15,69,61,54,7,1.13,88.52,Facile,Facile,0,Meme Difficulté,Pas Adapte
1354,2016,Economie,5,Le Capital et le Progres Technique,2,Le Capital: Aspect Physiques et Financiers,10,244,1,QROC,0.75,0.07,3.53,3,68,71,51,3,48,1.39,5.88,Facile,Difficile,-2,Beaucoup plus Difficile,Pas Adapte
2465,2017,Economie,5,Le Capital et le Progres Technique,2,Le Capital: Aspect Physiques et Financiers,10,244,1,QO,0.98,0.04,10.95,8,66,74,66,8,58,1.12,12.12,Facile,Difficile,-2,Beaucoup plus Difficile,Pas Adapte
3576,2018,Economie,5,Le Capital et le Progres Technique,2,Le Capital: Aspect Physiques et Financiers,10,244,1,QO,0.73,0.27,46.57,29,34,63,48,29,19,1.31,60.42,Moyen,Moyen,0,Meme Difficulté,Pas Adapte
4687,2019,Economie,5,Le Capital et le Progres Technique,2,Le Capital: Aspect Physiques et Financiers,10,244,1,QROC,0.77,0.04,3.95,2,55,57,34,2,32,1.68,5.88,Difficile,Difficile,0,Meme Difficulté,Pas Adapte
5798,2020,Economie,5,Le Capital et le Progres Technique,2,Le Capital: Aspect Physiques et Financiers,10,244,1,QROC,0.88,0.24,1.35,1,49,50,49,1,48,1.02,2.04,Difficile,Difficile,0,Meme Difficulté,Pas Adapte
244,2015,Economie,5,Le Capital et le Progres Technique,2,Le Capital: Aspect Physiques et Financiers,10,245,2,QCU,0.11,0.81,81.91,78,17,95,88,78,10,1.08,88.64,Moyen,Facile,1,Plus Facile,Pas Adapte
1355,2016,Economie,5,Le Capital et le Progres Technique,2,Le Capital: Aspect Physiques et Financiers,10,245,2,QCM,0.03,0.83,81.97,86,19,105,87,86,1,1.21,98.85,Moyen,Facile,1,Plus Facile,Pas Adapte
2466,2017,Economie,5,Le Capital et le Progres Technique,2,Le Capital: Aspect Physiques et Financiers,10,245,2,QCU,0.17,0.92,68.45,62,29,91,90,62,28,1.01,68.89,Difficile,Facile,2,Beaucoup plus Facile,Adapte
3577,2018,Economie,5,Le Capital et le Progres Technique,2,Le Capital: Aspect Physiques et Financiers,10,245,2,QCU,0.1,0.99,68.45,61,28,89,87,61,26,1.02,70.11,Facile,Facile,0,Meme Difficulté,Adapte
4688,2019,Economie,5,Le Capital et le Progres Technique,2,Le Capital: Aspect Physiques et Financiers,10,245,2,QCU,0.11,0.99,68.45,55,26,81,72,55,17,1.12,76.39,Facile,Facile,0,Meme Difficulté,Adapte
5799,2020,Economie,5,Le Capital et le Progres Technique,2,Le Capital: Aspect Physiques et Financiers,10,245,2,QCU,0.01,0.85,68.45,50,23,73,58,50,8,1.26,86.21,Facile,Facile,0,Meme Difficulté,Adapte
245,2015,Economie,5,Le Capital et le Progres Technique,2,Le Capital: Aspect Physiques et Financiers,10,246,3,QROC,0.76,0.24,1.12,1,67,68,45,1,44,1.51,2.22,Facile,Difficile,-2,Beaucoup plus Difficile,Pas Adapte
1356,2016,Economie,5,Le Capital et le Progres Technique,2,Le Capital: Aspect Physiques et Financiers,10,246,3,QROC,0.08,0.46,72.31,50,19,69,64,50,14,1.08,78.12,Facile,Facile,0,Meme Difficulté,Adapte
2467,2017,Economie,5,Le Capital et le Progres Technique,2,Le Capital: Aspect Physiques et Financiers,10,246,3,QROC,0.14,0.99,72.31,54,21,75,69,54,15,1.09,78.26,Facile,Facile,0,Meme Difficulté,Adapte
3578,2018,Economie,5,Le Capital et le Progres Technique,2,Le Capital: Aspect Physiques et Financiers,10,246,3,QROC,0.06,0.68,72.31,47,18,65,65,47,18,1.0,72.31,Facile,Facile,0,Meme Difficulté,Adapte
4689,2019,Economie,5,Le Capital et le Progres Technique,2,Le Capital: Aspect Physiques et Financiers,10,246,3,QROC,0.12,0.9,72.31,49,19,68,68,49,19,1.0,72.06,Facile,Facile,0,Meme Difficulté,Adapte
5800,2020,Economie,5,Le Capital et le Progres Technique,2,Le Capital: Aspect Physiques et Financiers,10,246,3,QROC,0.11,0.5,72.31,46,17,63,51,46,5,1.24,90.2,Facile,Facile,0,Meme Difficulté,Adapte
246,2015,Economie,5,Le Capital et le Progres Technique,2,Le Capital: Aspect Physiques et Financiers,10,247,4,QCU,0.06,0.9,86.61,22,3,25,22,22,0,1.14,100.0,Facile,Facile,0,Meme Difficulté,Pas Adapte
1357,2016,Economie,5,Le Capital et le Progres Technique,2,Le Capital: Aspect Physiques et Financiers,10,247,4,QCU,0.41,0.28,6.94,2,24,26,15,2,13,1.73,13.33,Moyen,Difficile,-1,Plus Difficile,Pas Adapte
2468,2017,Economie,5,Le Capital et le Progres Technique,2,Le Capital: Aspect Physiques et Financiers,10,247,4,QCU,0.22,0.61,49.12,12,12,24,23,12,11,1.04,52.17,Facile,Moyen,-1,Plus Difficile,Pas Adapte
3579,2018,Economie,5,Le Capital et le Progres Technique,2,Le Capital: Aspect Physiques et Financiers,10,247,4,QCM,0.72,0.15,19.62,5,20,25,17,5,12,1.47,29.41,Difficile,Difficile,0,Meme Difficulté,Pas Adapte
4690,2019,Economie,5,Le Capital et le Progres Technique,2,Le Capital: Aspect Physiques et Financiers,10,247,4,QCM,0.12,0.75,74.13,20,7,27,26,20,6,1.04,76.92,Difficile,Facile,2,Beaucoup plus Facile,Adapte
5801,2020,Economie,5,Le Capital et le Progres Technique,2,Le Capital: Aspect Physiques et Financiers,10,247,4,QCM,0.11,0.78,74.13,19,6,25,24,19,5,1.04,79.17,Facile,Facile,0,Meme Difficulté,Adapte
247,2015,Economie,5,Le Capital et le Progres Technique,2,Le Capital: Aspect Physiques et Financiers,10,248,5,QCU,0.31,0.56,36.23,32,57,89,33,32,1,2.7,96.97,Moyen,Moyen,0,Meme Difficulté,Pas Adapte
1358,2016,Economie,5,Le Capital et le Progres Technique,2,Le Capital: Aspect Physiques et Financiers,10,248,5,QCU,0.61,0.3,7.18,7,86,93,51,7,44,1.82,13.73,Difficile,Difficile,0,Meme Difficulté,Pas Adapte
2469,2017,Economie,5,Le Capital et le Progres Technique,2,Le Capital: Aspect Physiques et Financiers,10,248,5,QCU,0.53,0.3,28.89,25,63,88,46,25,21,1.91,54.35,Facile,Difficile,-2,Beaucoup plus Difficile,Pas Adapte
3580,2018,Economie,5,Le Capital et le Progres Technique,2,Le Capital: Aspect Physiques et Financiers,10,248,5,QCU,0.23,0.59,39.45,32,49,81,64,32,32,1.27,50.0,Difficile,Moyen,1,Plus Facile,Pas Adapte
4691,2019,Economie,5,Le Capital et le Progres Technique,2,Le Capital: Aspect Physiques et Financiers,10,248,5,QCU,0.04,0.96,98.55,77,1,78,78,77,1,1.0,98.72,Difficile,Facile,2,Beaucoup plus Facile,Pas Adapte
5802,2020,Economie,5,Le Capital et le Progres Technique,2,Le Capital: Aspect Physiques et Financiers,10,248,5,QCU,0.69,0.39,34.8,29,54,83,39,29,10,2.13,74.36,Facile,Difficile,-2,Beaucoup plus Difficile,Pas Adapte
248,2015,Economie,5,Le Capital et le Progres Technique,2,Le Capital: Aspect Physiques et Financiers,10,249,6,QO,0.06,0.85,74.99,51,17,68,61,51,10,1.11,83.61,Moyen,Facile,1,Plus Facile,Adapte
1359,2016,Economie,5,Le Capital et le Progres Technique,2,Le Capital: Aspect Physiques et Financiers,10,249,6,QO,0.02,0.46,74.99,49,17,66,62,49,13,1.06,79.03,Facile,Facile,0,Meme Difficulté,Adapte
2470,2017,Economie,5,Le Capital et le Progres Technique,2,Le Capital: Aspect Physiques et Financiers,10,249,6,QO,0.1,0.46,74.99,52,18,70,64,52,12,1.09,81.25,Facile,Facile,0,Meme Difficulté,Adapte
3581,2018,Economie,5,Le Capital et le Progres Technique,2,Le Capital: Aspect Physiques et Financiers,10,249,6,QO,0.02,0.96,74.99,52,18,70,57,52,5,1.23,91.23,Facile,Facile,0,Meme Difficulté,Adapte
4692,2019,Economie,5,Le Capital et le Progres Technique,2,Le Capital: Aspect Physiques et Financiers,10,249,6,QO,0.17,0.89,74.99,54,18,72,71,54,17,1.01,76.06,Facile,Facile,0,Meme Difficulté,Adapte
5803,2020,Economie,5,Le Capital et le Progres Technique,2,Le Capital: Aspect Physiques et Financiers,10,249,6,QO,0.05,0.47,74.99,55,19,74,64,55,9,1.16,85.94,Facile,Facile,0,Meme Difficulté,Adapte
249,2015,Economie,5,Le Capital et le Progres Technique,2,Le Capital: Aspect Physiques et Financiers,10,250,7,QCU,0.45,0.33,27.02,17,47,64,58,17,41,1.1,29.31,Difficile,Difficile,0,Meme Difficulté,Pas Adapte
1360,2016,Economie,5,Le Capital et le Progres Technique,2,Le Capital: Aspect Physiques et Financiers,10,250,7,QCU,0.56,0.21,15.55,11,57,68,42,11,31,1.62,26.19,Moyen,Difficile,-1,Plus Difficile,Pas Adapte
2471,2017,Economie,5,Le Capital et le Progres Technique,2,Le Capital: Aspect Physiques et Financiers,10,250,7,QCU,0.73,0.33,34.2,25,47,72,37,25,12,1.95,67.57,Difficile,Difficile,0,Meme Difficulté,Pas Adapte
3582,2018,Economie,5,Le Capital et le Progres Technique,2,Le Capital: Aspect Physiques et Financiers,10,250,7,QCU,0.07,0.99,74.15,55,19,74,69,55,14,1.07,79.71,Difficile,Facile,2,Beaucoup plus Facile,Adapte
4693,2019,Economie,5,Le Capital et le Progres Technique,2,Le Capital: Aspect Physiques et Financiers,10,250,7,QCM,0.17,0.86,74.15,56,19,75,69,56,13,1.09,81.16,Facile,Facile,0,Meme Difficulté,Adapte
5804,2020,Economie,5,Le Capital et le Progres Technique,2,Le Capital: Aspect Physiques et Financiers,10,250,7,QCM,0.05,0.8,74.15,50,17,67,66,50,16,1.02,75.76,Facile,Facile,0,Meme Difficulté,Adapte
250,2015,Economie,5,Le Capital et le Progres Technique,2,Le Capital: Aspect Physiques et Financiers,10,251,8,QCU,0.0,0.99,65.57,45,24,69,68,45,23,1.01,66.18,Moyen,Facile,1,Plus Facile,Adapte
1361,2016,Economie,5,Le Capital et le Progres Technique,2,Le Capital: Aspect Physiques et Financiers,10,251,8,QCU,0.01,0.82,65.57,43,22,65,51,43,8,1.27,84.31,Facile,Facile,0,Meme Difficulté,Adapte
2472,2017,Economie,5,Le Capital et le Progres Technique,2,Le Capital: Aspect Physiques et Financiers,10,251,8,QCU,0.11,0.85,65.57,41,22,63,46,41,5,1.37,89.13,Facile,Facile,0,Meme Difficulté,Adapte
3583,2018,Economie,5,Le Capital et le Progres Technique,2,Le Capital: Aspect Physiques et Financiers,10,251,8,QCU,0.13,0.85,65.57,45,23,68,47,45,2,1.45,95.74,Facile,Facile,0,Meme Difficulté,Adapte
4694,2019,Economie,5,Le Capital et le Progres Technique,2,Le Capital: Aspect Physiques et Financiers,10,251,8,QCU,0.01,0.92,65.57,47,24,71,59,47,12,1.2,79.66,Facile,Facile,0,Meme Difficulté,Adapte
5805,2020,Economie,5,Le Capital et le Progres Technique,2,Le Capital: Aspect Physiques et Financiers,10,251,8,QCU,0.04,0.85,65.57,49,25,74,50,49,1,1.48,98.0,Facile,Facile,0,Meme Difficulté,Adapte
251,2015,Economie,5,Le Capital et le Progres Technique,2,Le Capital: Aspect Physiques et Financiers,10,252,9,QCM,0.57,0.2,5.17,5,88,93,44,5,39,2.11,11.36,Moyen,Difficile,-1,Plus Difficile,Pas Adapte
1362,2016,Economie,5,Le Capital et le Progres Technique,2,Le Capital: Aspect Physiques et Financiers,10,252,9,QCM,0.06,0.76,80.01,68,17,85,78,68,10,1.09,87.18,Difficile,Facile,2,Beaucoup plus Facile,Pas Adapte
2473,2017,Economie,5,Le Capital et le Progres Technique,2,Le Capital: Aspect Physiques et Financiers,10,252,9,QCM,0.75,0.29,30.87,24,55,79,46,24,22,1.72,52.17,Difficile,Difficile,0,Meme Difficulté,Pas Adapte
3584,2018,Economie,5,Le Capital et le Progres Technique,2,Le Capital: Aspect Physiques et Financiers,10,252,9,QCM,0.68,0.2,25.43,19,55,74,48,19,29,1.54,39.58,Difficile,Difficile,0,Meme Difficulté,Pas Adapte
4695,2019,Economie,5,Le Capital et le Progres Technique,2,Le Capital: Aspect Physiques et Financiers,10,252,9,QCM,0.64,0.29,15.35,13,72,85,29,13,16,2.93,44.83,Facile,Difficile,-2,Beaucoup plus Difficile,Pas Adapte
5806,2020,Economie,5,Le Capital et le Progres Technique,2,Le Capital: Aspect Physiques et Financiers,10,252,9,QCM,0.13,0.95,70.74,52,21,73,72,52,20,1.01,72.22,Moyen,Facile,1,Plus Facile,Adapte
252,2015,Economie,5,Le Capital et le Progres Technique,2,Le Capital: Aspect Physiques et Financiers,10,253,10,QCU,0.61,0.38,32.84,13,26,39,38,13,25,1.03,34.21,Difficile,Difficile,0,Meme Difficulté,Pas Adapte
1363,2016,Economie,5,Le Capital et le Progres Technique,2,Le Capital: Aspect Physiques et Financiers,10,253,10,QCU,0.02,0.99,90.24,32,4,36,33,32,1,1.09,96.97,Facile,Facile,0,Meme Difficulté,Pas Adapte
2474,2017,Economie,5,Le Capital et le Progres Technique,2,Le Capital: Aspect Physiques et Financiers,10,253,10,QCU,0.75,0.25,31.01,11,25,36,29,11,18,1.24,37.93,Moyen,Difficile,-1,Plus Difficile,Pas Adapte
3585,2018,Economie,5,Le Capital et le Progres Technique,2,Le Capital: Aspect Physiques et Financiers,10,253,10,QCU,0.67,0.27,15.51,5,26,31,22,5,17,1.41,22.73,Facile,Difficile,-2,Beaucoup plus Difficile,Pas Adapte
4696,2019,Economie,5,Le Capital et le Progres Technique,2,Le Capital: Aspect Physiques et Financiers,10,253,10,QCU,0.11,0.91,90.27,32,4,36,35,32,3,1.03,91.43,Difficile,Facile,2,Beaucoup plus Facile,Pas Adapte
5807,2020,Economie,5,Le Capital et le Progres Technique,2,Le Capital: Aspect Physiques et Financiers,10,253,10,QCU,0.23,0.44,62.76,21,12,33,24,21,3,1.38,87.5,Facile,Moyen,-1,Plus Difficile,Pas Adapte
253,2015,Economie,5,Le Capital et le Progres Technique,3,Les Differents Types d'Investissement et le Poids de l'Investissement Immateriel,13,254,1,QCU,0.56,0.3,21.92,14,49,63,44,14,30,1.43,31.82,Difficile,Difficile,0,Meme Difficulté,Pas Adapte
1364,2016,Economie,5,Le Capital et le Progres Technique,3,Les Differents Types d'Investissement et le Poids de l'Investissement Immateriel,13,254,1,QCU,0.03,0.76,83.12,60,12,72,67,60,7,1.07,89.55,Difficile,Facile,2,Beaucoup plus Facile,Pas Adapte
2475,2017,Economie,5,Le Capital et le Progres Technique,3,Les Differents Types d'Investissement et le Poids de l'Investissement Immateriel,13,254,1,QCU,0.22,0.42,45.96,37,44,81,59,37,22,1.37,62.71,Difficile,Moyen,1,Plus Facile,Pas Adapte
3586,2018,Economie,5,Le Capital et le Progres Technique,3,Les Differents Types d'Investissement et le Poids de l'Investissement Immateriel,13,254,1,QCU,0.5,0.29,16.39,12,61,73,47,12,35,1.55,25.53,Moyen,Difficile,-1,Plus Difficile,Pas Adapte
4697,2019,Economie,5,Le Capital et le Progres Technique,3,Les Differents Types d'Investissement et le Poids de l'Investissement Immateriel,13,254,1,QCM,0.31,0.33,59.91,38,26,64,49,38,11,1.31,77.55,Difficile,Moyen,1,Plus Facile,Pas Adapte
5808,2020,Economie,5,Le Capital et le Progres Technique,3,Les Differents Types d'Investissement et le Poids de l'Investissement Immateriel,13,254,1,QCM,0.61,0.16,27.09,15,39,54,24,15,9,2.25,62.5,Moyen,Difficile,-1,Plus Difficile,Pas Adapte
254,2015,Economie,5,Le Capital et le Progres Technique,3,Les Differents Types d'Investissement et le Poids de l'Investissement Immateriel,13,255,2,QCM,0.49,0.68,42.13,40,54,94,66,40,26,1.42,60.61,Moyen,Moyen,0,Meme Difficulté,Pas Adapte
1365,2016,Economie,5,Le Capital et le Progres Technique,3,Les Differents Types d'Investissement et le Poids de l'Investissement Immateriel,13,255,2,QCU,0.07,0.81,98.91,84,1,85,84,84,0,1.01,100.0,Moyen,Facile,1,Plus Facile,Pas Adapte
2476,2017,Economie,5,Le Capital et le Progres Technique,3,Les Differents Types d'Investissement et le Poids de l'Investissement Immateriel,13,255,2,QCU,0.28,0.55,53.8,44,38,82,76,44,32,1.08,57.89,Moyen,Moyen,0,Meme Difficulté,Pas Adapte
3587,2018,Economie,5,Le Capital et le Progres Technique,3,Les Differents Types d'Investissement et le Poids de l'Investissement Immateriel,13,255,2,QCM,0.08,0.71,88.35,75,10,85,83,75,8,1.02,90.36,Difficile,Facile,2,Beaucoup plus Facile,Pas Adapte
4698,2019,Economie,5,Le Capital et le Progres Technique,3,Les Differents Types d'Investissement et le Poids de l'Investissement Immateriel,13,255,2,QCM,0.55,0.16,10.85,9,71,80,56,9,47,1.43,16.07,Difficile,Difficile,0,Meme Difficulté,Pas Adapte
5809,2020,Economie,5,Le Capital et le Progres Technique,3,Les Differents Types d'Investissement et le Poids de l'Investissement Immateriel,13,255,2,QCM,0.3,0.4,52.35,39,36,75,60,39,21,1.25,65.0,Facile,Moyen,-1,Plus Difficile,Pas Adapte
255,2015,Economie,5,Le Capital et le Progres Technique,3,Les Differents Types d'Investissement et le Poids de l'Investissement Immateriel,13,256,3,QCU,0.02,0.75,94.12,7,0,7,7,7,0,1.0,100.0,Moyen,Facile,1,Plus Facile,Pas Adapte
1366,2016,Economie,5,Le Capital et le Progres Technique,3,Les Differents Types d'Investissement et le Poids de l'Investissement Immateriel,13,256,3,QROC,0.73,0.03,32.22,3,5,8,7,3,4,1.14,42.86,Difficile,Difficile,0,Meme Difficulté,Pas Adapte
2477,2017,Economie,5,Le Capital et le Progres Technique,3,Les Differents Types d'Investissement et le Poids de l'Investissement Immateriel,13,256,3,QROC,0.75,0.11,24.54,2,6,8,5,2,3,1.6,40.0,Moyen,Difficile,-1,Plus Difficile,Pas Adapte
3588,2018,Economie,5,Le Capital et le Progres Technique,3,Les Differents Types d'Investissement et le Poids de l'Investissement Immateriel,13,256,3,QROC,0.1,0.9,98.01,9,0,9,9,9,0,1.0,100.0,Facile,Facile,0,Meme Difficulté,Pas Adapte
4699,2019,Economie,5,Le Capital et le Progres Technique,3,Les Differents Types d'Investissement et le Poids de l'Investissement Immateriel,13,256,3,QROC,0.97,0.24,10.02,1,8,9,8,1,7,1.12,12.5,Facile,Difficile,-2,Beaucoup plus Difficile,Pas Adapte
5810,2020,Economie,5,Le Capital et le Progres Technique,3,Les Differents Types d'Investissement et le Poids de l'Investissement Immateriel,13,256,3,QROC,0.42,0.26,48.8,5,5,10,7,5,2,1.43,71.43,Difficile,Moyen,1,Plus Facile,Pas Adapte
256,2015,Economie,5,Le Capital et le Progres Technique,3,Les Differents Types d'Investissement et le Poids de l'Investissement Immateriel,13,257,4,QCU,0.15,0.87,87.85,73,10,83,82,73,9,1.01,89.02,Moyen,Facile,1,Plus Facile,Pas Adapte
1367,2016,Economie,5,Le Capital et le Progres Technique,3,Les Differents Types d'Investissement et le Poids de l'Investissement Immateriel,13,257,4,QCU,0.36,0.51,37.7,32,53,85,41,32,9,2.07,78.05,Moyen,Moyen,0,Meme Difficulté,Pas Adapte
2478,2017,Economie,5,Le Capital et le Progres Technique,3,Les Differents Types d'Investissement et le Poids de l'Investissement Immateriel,13,257,4,QCU,0.05,0.84,95.26,83,4,87,84,83,1,1.04,98.81,Facile,Facile,0,Meme Difficulté,Pas Adapte
3589,2018,Economie,5,Le Capital et le Progres Technique,3,Les Differents Types d'Investissement et le Poids de l'Investissement Immateriel,13,257,4,QCU,0.14,0.8,70.29,59,25,84,82,59,23,1.02,71.95,Difficile,Facile,2,Beaucoup plus Facile,Adapte
4700,2019,Economie,5,Le Capital et le Progres Technique,3,Les Differents Types d'Investissement et le Poids de l'Investissement Immateriel,13,257,4,QCU,0.09,0.93,70.29,61,26,87,65,61,4,1.34,93.85,Facile,Facile,0,Meme Difficulté,Adapte
5811,2020,Economie,5,Le Capital et le Progres Technique,3,Les Differents Types d'Investissement et le Poids de l'Investissement Immateriel,13,257,4,QCU,0.01,0.81,70.29,65,27,92,70,65,5,1.31,92.86,Facile,Facile,0,Meme Difficulté,Adapte
257,2015,Economie,5,Le Capital et le Progres Technique,3,Les Differents Types d'Investissement et le Poids de l'Investissement Immateriel,13,258,5,QCM,0.1,0.83,95.72,15,1,16,15,15,0,1.07,100.0,Difficile,Facile,2,Beaucoup plus Facile,Pas Adapte
1368,2016,Economie,5,Le Capital et le Progres Technique,3,Les Differents Types d'Investissement et le Poids de l'Investissement Immateriel,13,258,5,QCM,0.09,0.78,85.12,14,2,16,16,14,2,1.0,87.5,Difficile,Facile,2,Beaucoup plus Facile,Pas Adapte
2479,2017,Economie,5,Le Capital et le Progres Technique,3,Les Differents Types d'Investissement et le Poids de l'Investissement Immateriel,13,258,5,QCM,0.54,0.2,2.56,0,15,15,9,0,9,1.67,0.0,Difficile,Difficile,0,Meme Difficulté,Pas Adapte
3590,2018,Economie,5,Le Capital et le Progres Technique,3,Les Differents Types d'Investissement et le Poids de l'Investissement Immateriel,13,258,5,QCM,0.39,0.4,54.13,9,8,17,14,9,5,1.21,64.29,Moyen,Moyen,0,Meme Difficulté,Pas Adapte
4701,2019,Economie,5,Le Capital et le Progres Technique,3,Les Differents Types d'Investissement et le Poids de l'Investissement Immateriel,13,258,5,QCU,0.29,0.62,60.45,12,8,20,19,12,7,1.05,63.16,Moyen,Moyen,0,Meme Difficulté,Pas Adapte
5812,2020,Economie,5,Le Capital et le Progres Technique,3,Les Differents Types d'Investissement et le Poids de l'Investissement Immateriel,13,258,5,QROC,0.99,0.21,7.31,1,19,20,11,1,10,1.82,9.09,Facile,Difficile,-2,Beaucoup plus Difficile,Pas Adapte
258,2015,Economie,5,Le Capital et le Progres Technique,3,Les Differents Types d'Investissement et le Poids de l'Investissement Immateriel,13,259,6,QROC,0.7,0.14,18.08,2,7,9,5,2,3,1.8,40.0,Moyen,Difficile,-1,Plus Difficile,Pas Adapte
1369,2016,Economie,5,Le Capital et le Progres Technique,3,Les Differents Types d'Investissement et le Poids de l'Investissement Immateriel,13,259,6,QROC,0.41,0.37,42.61,4,5,9,5,4,1,1.8,80.0,Difficile,Moyen,1,Plus Facile,Pas Adapte
2480,2017,Economie,5,Le Capital et le Progres Technique,3,Les Differents Types d'Investissement et le Poids de l'Investissement Immateriel,13,259,6,QCM,0.19,0.76,66.04,6,3,9,9,6,3,1.0,66.67,Facile,Facile,0,Meme Difficulté,Adapte
3591,2018,Economie,5,Le Capital et le Progres Technique,3,Les Differents Types d'Investissement et le Poids de l'Investissement Immateriel,13,259,6,QCM,0.14,0.92,66.04,6,3,9,8,6,2,1.12,75.0,Facile,Facile,0,Meme Difficulté,Adapte
4702,2019,Economie,5,Le Capital et le Progres Technique,3,Les Differents Types d'Investissement et le Poids de l'Investissement Immateriel,13,259,6,QCM,0.08,0.77,66.04,7,3,10,10,7,3,1.0,70.0,Facile,Facile,0,Meme Difficulté,Adapte
5813,2020,Economie,5,Le Capital et le Progres Technique,3,Les Differents Types d'Investissement et le Poids de l'Investissement Immateriel,13,259,6,QCM,0.09,0.97,66.04,7,3,10,8,7,1,1.25,87.5,Facile,Facile,0,Meme Difficulté,Adapte
259,2015,Economie,5,Le Capital et le Progres Technique,3,Les Differents Types d'Investissement et le Poids de l'Investissement Immateriel,13,260,7,QCM,0.57,0.17,15.05,10,57,67,59,10,49,1.14,16.95,Difficile,Difficile,0,Meme Difficulté,Pas Adapte
1370,2016,Economie,5,Le Capital et le Progres Technique,3,Les Differents Types d'Investissement et le Poids de l'Investissement Immateriel,13,260,7,QCM,0.28,0.32,63.67,45,26,71,61,45,16,1.16,73.77,Moyen,Moyen,0,Meme Difficulté,Pas Adapte
2481,2017,Economie,5,Le Capital et le Progres Technique,3,Les Differents Types d'Investissement et le Poids de l'Investissement Immateriel,13,260,7,QCU,0.37,0.67,40.26,33,49,82,73,33,40,1.12,45.21,Difficile,Moyen,1,Plus Facile,Pas Adapte
3592,2018,Economie,5,Le Capital et le Progres Technique,3,Les Differents Types d'Investissement et le Poids de l'Investissement Immateriel,13,260,7,QCU,0.06,0.79,79.61,67,17,84,70,67,3,1.2,95.71,Facile,Facile,0,Meme Difficulté,Pas Adapte
4703,2019,Economie,5,Le Capital et le Progres Technique,3,Les Differents Types d'Investissement et le Poids de l'Investissement Immateriel,13,260,7,QCU,0.1,0.83,87.59,81,12,93,84,81,3,1.11,96.43,Facile,Facile,0,Meme Difficulté,Pas Adapte
5814,2020,Economie,5,Le Capital et le Progres Technique,3,Les Differents Types d'Investissement et le Poids de l'Investissement Immateriel,13,260,7,QCU,0.03,0.83,88.49,81,10,91,85,81,4,1.07,95.29,Facile,Facile,0,Meme Difficulté,Pas Adapte
260,2015,Economie,5,Le Capital et le Progres Technique,3,Les Differents Types d'Investissement et le Poids de l'Investissement Immateriel,13,261,8,QCU,0.23,0.48,36.2,28,50,78,36,28,8,2.17,77.78,Facile,Moyen,-1,Plus Difficile,Pas Adapte
1371,2016,Economie,5,Le Capital et le Progres Technique,3,Les Differents Types d'Investissement et le Poids de l'Investissement Immateriel,13,261,8,QCM,0.5,0.22,28.81,25,62,87,70,25,45,1.24,35.71,Moyen,Difficile,-1,Plus Difficile,Pas Adapte
2482,2017,Economie,5,Le Capital et le Progres Technique,3,Les Differents Types d'Investissement et le Poids de l'Investissement Immateriel,13,261,8,QROC,0.04,0.8,85.57,74,12,86,79,74,5,1.09,93.67,Facile,Facile,0,Meme Difficulté,Pas Adapte
3593,2018,Economie,5,Le Capital et le Progres Technique,3,Les Differents Types d'Investissement et le Poids de l'Investissement Immateriel,13,261,8,QROC,0.26,0.35,53.55,47,41,88,86,47,39,1.02,54.65,Difficile,Moyen,1,Plus Facile,Pas Adapte
4704,2019,Economie,5,Le Capital et le Progres Technique,3,Les Differents Types d'Investissement et le Poids de l'Investissement Immateriel,13,261,8,QROC,0.53,0.32,42.96,41,54,95,62,41,21,1.53,66.13,Facile,Moyen,-1,Plus Difficile,Pas Adapte
5815,2020,Economie,5,Le Capital et le Progres Technique,3,Les Differents Types d'Investissement et le Poids de l'Investissement Immateriel,13,261,8,QO,0.72,0.15,60.82,58,38,96,72,58,14,1.33,80.56,Difficile,Moyen,1,Plus Facile,Pas Adapte
261,2015,Economie,5,Le Capital et le Progres Technique,3,Les Differents Types d'Investissement et le Poids de l'Investissement Immateriel,13,262,9,QCM,0.37,0.54,53.29,20,17,37,37,20,17,1.0,54.05,Difficile,Moyen,1,Plus Facile,Pas Adapte
1372,2016,Economie,5,Le Capital et le Progres Technique,3,Les Differents Types d'Investissement et le Poids de l'Investissement Immateriel,13,262,9,QCM,0.09,0.8,65.39,27,14,41,39,27,12,1.05,69.23,Facile,Facile,0,Meme Difficulté,Adapte
2483,2017,Economie,5,Le Capital et le Progres Technique,3,Les Differents Types d'Investissement et le Poids de l'Investissement Immateriel,13,262,9,QCM,0.06,0.92,65.39,24,13,37,32,24,8,1.16,75.0,Facile,Facile,0,Meme Difficulté,Adapte
3594,2018,Economie,5,Le Capital et le Progres Technique,3,Les Differents Types d'Investissement et le Poids de l'Investissement Immateriel,13,262,9,QCU,0.11,0.78,65.39,26,13,39,33,26,7,1.18,78.79,Facile,Facile,0,Meme Difficulté,Adapte
4705,2019,Economie,5,Le Capital et le Progres Technique,3,Les Differents Types d'Investissement et le Poids de l'Investissement Immateriel,13,262,9,QCU,0.13,0.83,65.39,24,13,37,28,24,4,1.32,85.71,Facile,Facile,0,Meme Difficulté,Adapte
5816,2020,Economie,5,Le Capital et le Progres Technique,3,Les Differents Types d'Investissement et le Poids de l'Investissement Immateriel,13,262,9,QCU,0.19,0.85,65.39,26,14,40,27,26,1,1.48,96.3,Facile,Facile,0,Meme Difficulté,Adapte
262,2015,Economie,5,Le Capital et le Progres Technique,3,Les Differents Types d'Investissement et le Poids de l'Investissement Immateriel,13,263,10,QCU,0.72,0.2,20.94,15,56,71,26,15,11,2.73,57.69,Difficile,Difficile,0,Meme Difficulté,Pas Adapte
1373,2016,Economie,5,Le Capital et le Progres Technique,3,Les Differents Types d'Investissement et le Poids de l'Investissement Immateriel,13,263,10,QCU,0.2,0.89,91.28,75,7,82,81,75,6,1.01,92.59,Difficile,Facile,2,Beaucoup plus Facile,Pas Adapte
2484,2017,Economie,5,Le Capital et le Progres Technique,3,Les Differents Types d'Investissement et le Poids de l'Investissement Immateriel,13,263,10,QCU,0.63,0.3,5.0,5,89,94,42,5,37,2.24,11.9,Difficile,Difficile,0,Meme Difficulté,Pas Adapte
3595,2018,Economie,5,Le Capital et le Progres Technique,3,Les Differents Types d'Investissement et le Poids de l'Investissement Immateriel,13,263,10,QROC,0.49,0.39,45.46,41,49,90,44,41,3,2.05,93.18,Moyen,Moyen,0,Meme Difficulté,Pas Adapte
4706,2019,Economie,5,Le Capital et le Progres Technique,3,Les Differents Types d'Investissement et le Poids de l'Investissement Immateriel,13,263,10,QROC,0.69,0.22,25.34,23,66,89,60,23,37,1.48,38.33,Moyen,Difficile,-1,Plus Difficile,Pas Adapte
5817,2020,Economie,5,Le Capital et le Progres Technique,3,Les Differents Types d'Investissement et le Poids de l'Investissement Immateriel,13,263,10,QROC,0.92,0.11,26.52,23,62,85,82,23,59,1.04,28.05,Difficile,Difficile,0,Meme Difficulté,Pas Adapte
263,2015,Economie,5,Le Capital et le Progres Technique,3,Les Differents Types d'Investissement et le Poids de l'Investissement Immateriel,13,264,11,QROC,0.22,0.4,63.35,62,36,98,64,62,2,1.53,96.88,Facile,Moyen,-1,Plus Difficile,Pas Adapte
1374,2016,Economie,5,Le Capital et le Progres Technique,3,Les Differents Types d'Investissement et le Poids de l'Investissement Immateriel,13,264,11,QROC,0.93,0.09,10.13,11,97,108,95,11,84,1.14,11.58,Facile,Difficile,-2,Beaucoup plus Difficile,Pas Adapte
2485,2017,Economie,5,Le Capital et le Progres Technique,3,Les Differents Types d'Investissement et le Poids de l'Investissement Immateriel,13,264,11,QROC,0.64,0.13,2.34,2,98,100,62,2,60,1.61,3.23,Difficile,Difficile,0,Meme Difficulté,Pas Adapte
3596,2018,Economie,5,Le Capital et le Progres Technique,3,Les Differents Types d'Investissement et le Poids de l'Investissement Immateriel,13,264,11,QROC,0.31,0.3,38.23,35,56,91,82,35,47,1.11,42.68,Moyen,Moyen,0,Meme Difficulté,Pas Adapte
4707,2019,Economie,5,Le Capital et le Progres Technique,3,Les Differents Types d'Investissement et le Poids de l'Investissement Immateriel,13,264,11,QROC,0.2,0.26,37.86,33,53,86,62,33,29,1.39,53.23,Difficile,Moyen,1,Plus Facile,Pas Adapte
5818,2020,Economie,5,Le Capital et le Progres Technique,3,Les Differents Types d'Investissement et le Poids de l'Investissement Immateriel,13,264,11,QROC,0.59,0.36,46.16,40,47,87,64,40,24,1.36,62.5,Difficile,Moyen,1,Plus Facile,Pas Adapte
264,2015,Economie,5,Le Capital et le Progres Technique,3,Les Differents Types d'Investissement et le Poids de l'Investissement Immateriel,13,265,12,QCM,0.08,0.99,91.13,11,1,12,12,11,1,1.0,91.67,Difficile,Facile,2,Beaucoup plus Facile,Pas Adapte
1375,2016,Economie,5,Le Capital et le Progres Technique,3,Les Differents Types d'Investissement et le Poids de l'Investissement Immateriel,13,265,12,QCM,0.16,0.78,79.92,8,2,10,9,8,1,1.11,88.89,Facile,Facile,0,Meme Difficulté,Pas Adapte
2486,2017,Economie,5,Le Capital et le Progres Technique,3,Les Differents Types d'Investissement et le Poids de l'Investissement Immateriel,13,265,12,QCU,0.62,0.33,20.0,2,8,10,6,2,4,1.67,33.33,Difficile,Difficile,0,Meme Difficulté,Pas Adapte
3597,2018,Economie,5,Le Capital et le Progres Technique,3,Les Differents Types d'Investissement et le Poids de l'Investissement Immateriel,13,265,12,QCU,0.02,0.8,68.89,6,3,9,9,6,3,1.0,66.67,Facile,Facile,0,Meme Difficulté,Adapte
4708,2019,Economie,5,Le Capital et le Progres Technique,3,Les Differents Types d'Investissement et le Poids de l'Investissement Immateriel,13,265,12,QCU,0.17,0.81,68.89,7,3,10,7,7,0,1.43,100.0,Facile,Facile,0,Meme Difficulté,Adapte
5819,2020,Economie,5,Le Capital et le Progres Technique,3,Les Differents Types d'Investissement et le Poids de l'Investissement Immateriel,13,265,12,QCU,0.11,0.82,68.89,6,3,9,9,6,3,1.0,66.67,Facile,Facile,0,Meme Difficulté,Adapte
265,2015,Economie,5,Le Capital et le Progres Technique,3,Les Differents Types d'Investissement et le Poids de l'Investissement Immateriel,13,266,13,QCM,0.35,0.46,41.82,17,23,40,28,17,11,1.43,60.71,Moyen,Moyen,0,Meme Difficulté,Pas Adapte
1376,2016,Economie,5,Le Capital et le Progres Technique,3,Les Differents Types d'Investissement et le Poids de l'Investissement Immateriel,13,266,13,QCM,0.04,0.76,98.54,43,1,44,43,43,0,1.02,100.0,Difficile,Facile,2,Beaucoup plus Facile,Pas Adapte
2487,2017,Economie,5,Le Capital et le Progres Technique,3,Les Differents Types d'Investissement et le Poids de l'Investissement Immateriel,13,266,13,QCM,0.24,0.55,40.5,21,30,51,50,21,29,1.02,42.0,Facile,Moyen,-1,Plus Difficile,Pas Adapte
3598,2018,Economie,5,Le Capital et le Progres Technique,3,Les Differents Types d'Investissement et le Poids de l'Investissement Immateriel,13,266,13,QCM,0.47,0.66,39.97,21,32,53,44,21,23,1.2,47.73,Difficile,Moyen,1,Plus Facile,Pas Adapte
4709,2019,Economie,5,Le Capital et le Progres Technique,3,Les Differents Types d'Investissement et le Poids de l'Investissement Immateriel,13,266,13,QCM,0.71,0.22,14.72,9,49,58,24,9,15,2.42,37.5,Facile,Difficile,-2,Beaucoup plus Difficile,Pas Adapte
5820,2020,Economie,5,Le Capital et le Progres Technique,3,Les Differents Types d'Investissement et le Poids de l'Investissement Immateriel,13,266,13,QCU,0.07,0.79,88.34,46,6,52,48,46,2,1.08,95.83,Moyen,Facile,1,Plus Facile,Pas Adapte
266,2015,Economie,5,Le Capital et le Progres Technique,4,Le Progres Technique - Nature et Role,6,267,1,QROC,0.2,0.8,95.92,54,2,56,56,54,2,1.0,96.43,Facile,Facile,0,Meme Difficulté,Pas Adapte
1377,2016,Economie,5,Le Capital et le Progres Technique,4,Le Progres Technique - Nature et Role,6,267,1,QROC,0.19,0.62,68.07,35,17,52,41,35,6,1.27,85.37,Moyen,Facile,1,Plus Facile,Adapte
2488,2017,Economie,5,Le Capital et le Progres Technique,4,Le Progres Technique - Nature et Role,6,267,1,QROC,0.04,0.6,68.07,31,15,46,39,31,8,1.18,79.49,Facile,Facile,0,Meme Difficulté,Adapte
3599,2018,Economie,5,Le Capital et le Progres Technique,4,Le Progres Technique - Nature et Role,6,267,1,QROC,0.01,0.83,68.07,31,15,46,45,31,14,1.02,68.89,Facile,Facile,0,Meme Difficulté,Adapte
4710,2019,Economie,5,Le Capital et le Progres Technique,4,Le Progres Technique - Nature et Role,6,267,1,QROC,0.06,0.56,68.07,34,16,50,44,34,10,1.14,77.27,Facile,Facile,0,Meme Difficulté,Adapte
5821,2020,Economie,5,Le Capital et le Progres Technique,4,Le Progres Technique - Nature et Role,6,267,1,QROC,0.15,0.68,68.07,39,18,57,54,39,15,1.06,72.22,Facile,Facile,0,Meme Difficulté,Adapte
267,2015,Economie,5,Le Capital et le Progres Technique,4,Le Progres Technique - Nature et Role,6,268,2,QCM,0.11,0.85,78.24,73,20,93,92,73,19,1.01,79.35,Moyen,Facile,1,Plus Facile,Pas Adapte
1378,2016,Economie,5,Le Capital et le Progres Technique,4,Le Progres Technique - Nature et Role,6,268,2,QCM,0.19,0.87,96.55,102,4,106,105,102,3,1.01,97.14,Moyen,Facile,1,Plus Facile,Pas Adapte
2489,2017,Economie,5,Le Capital et le Progres Technique,4,Le Progres Technique - Nature et Role,6,268,2,QCM,0.62,0.23,15.29,18,98,116,44,18,26,2.64,40.91,Moyen,Difficile,-1,Plus Difficile,Pas Adapte
3600,2018,Economie,5,Le Capital et le Progres Technique,4,Le Progres Technique - Nature et Role,6,268,2,QCM,0.01,0.78,80.37,98,24,122,102,98,4,1.2,96.08,Facile,Facile,0,Meme Difficulté,Pas Adapte
4711,2019,Economie,5,Le Capital et le Progres Technique,4,Le Progres Technique - Nature et Role,6,268,2,QCM,0.02,0.86,81.52,99,23,122,113,99,14,1.08,87.61,Facile,Facile,0,Meme Difficulté,Pas Adapte
5822,2020,Economie,5,Le Capital et le Progres Technique,4,Le Progres Technique - Nature et Role,6,268,2,QCU,0.55,0.3,4.1,5,120,125,75,5,70,1.67,6.67,Moyen,Difficile,-1,Plus Difficile,Pas Adapte
268,2015,Economie,5,Le Capital et le Progres Technique,4,Le Progres Technique - Nature et Role,6,269,3,QCM,0.46,0.32,57.57,47,34,81,75,47,28,1.08,62.67,Difficile,Moyen,1,Plus Facile,Pas Adapte
1379,2016,Economie,5,Le Capital et le Progres Technique,4,Le Progres Technique - Nature et Role,6,269,3,QCM,0.29,0.39,48.51,40,43,83,81,40,41,1.02,49.38,Difficile,Moyen,1,Plus Facile,Pas Adapte
2490,2017,Economie,5,Le Capital et le Progres Technique,4,Le Progres Technique - Nature et Role,6,269,3,QCM,0.55,0.22,3.16,2,74,76,57,2,55,1.33,3.51,Difficile,Difficile,0,Meme Difficulté,Pas Adapte
3601,2018,Economie,5,Le Capital et le Progres Technique,4,Le Progres Technique - Nature et Role,6,269,3,QROC,0.64,0.1,32.05,24,52,76,60,24,36,1.27,40.0,Difficile,Difficile,0,Meme Difficulté,Pas Adapte
4712,2019,Economie,5,Le Capital et le Progres Technique,4,Le Progres Technique - Nature et Role,6,269,3,QROC,0.73,0.11,16.12,14,73,87,64,14,50,1.36,21.88,Difficile,Difficile,0,Meme Difficulté,Pas Adapte
5823,2020,Economie,5,Le Capital et le Progres Technique,4,Le Progres Technique - Nature et Role,6,269,3,QO,0.81,0.04,9.75,9,79,88,66,9,57,1.33,13.64,Moyen,Difficile,-1,Plus Difficile,Pas Adapte
269,2015,Economie,5,Le Capital et le Progres Technique,4,Le Progres Technique - Nature et Role,6,270,4,QCU,0.11,0.94,72.61,46,18,64,62,46,16,1.03,74.19,Facile,Facile,0,Meme Difficulté,Adapte
1380,2016,Economie,5,Le Capital et le Progres Technique,4,Le Progres Technique - Nature et Role,6,270,4,QCU,0.14,0.88,72.61,52,20,72,68,52,16,1.06,76.47,Facile,Facile,0,Meme Difficulté,Adapte
2491,2017,Economie,5,Le Capital et le Progres Technique,4,Le Progres Technique - Nature et Role,6,270,4,QCM,0.19,0.89,72.61,49,18,67,65,49,16,1.03,75.38,Facile,Facile,0,Meme Difficulté,Adapte
3602,2018,Economie,5,Le Capital et le Progres Technique,4,Le Progres Technique - Nature et Role,6,270,4,QCM,0.05,0.99,72.61,46,18,64,63,46,17,1.02,73.02,Facile,Facile,0,Meme Difficulté,Adapte
4713,2019,Economie,5,Le Capital et le Progres Technique,4,Le Progres Technique - Nature et Role,6,270,4,QCM,0.2,1.0,72.61,41,16,57,50,41,9,1.14,82.0,Facile,Facile,0,Meme Difficulté,Adapte
5824,2020,Economie,5,Le Capital et le Progres Technique,4,Le Progres Technique - Nature et Role,6,270,4,QCM,0.07,0.95,72.61,37,14,51,47,37,10,1.09,78.72,Facile,Facile,0,Meme Difficulté,Adapte
270,2015,Economie,5,Le Capital et le Progres Technique,4,Le Progres Technique - Nature et Role,6,271,5,QCM,0.23,0.59,53.63,41,36,77,65,41,24,1.18,63.08,Facile,Moyen,-1,Plus Difficile,Pas Adapte
1381,2016,Economie,5,Le Capital et le Progres Technique,4,Le Progres Technique - Nature et Role,6,271,5,QCM,0.61,0.28,8.45,7,77,84,81,7,74,1.04,8.64,Difficile,Difficile,0,Meme Difficulté,Pas Adapte
2492,2017,Economie,5,Le Capital et le Progres Technique,4,Le Progres Technique - Nature et Role,6,271,5,QCM,0.53,0.22,2.97,3,82,85,47,3,44,1.81,6.38,Moyen,Difficile,-1,Plus Difficile,Pas Adapte
3603,2018,Economie,5,Le Capital et le Progres Technique,4,Le Progres Technique - Nature et Role,6,271,5,QCM,0.65,0.26,32.28,26,53,79,61,26,35,1.3,42.62,Moyen,Difficile,-1,Plus Difficile,Pas Adapte
4714,2019,Economie,5,Le Capital et le Progres Technique,4,Le Progres Technique - Nature et Role,6,271,5,QCM,0.1,0.78,80.85,65,16,81,77,65,12,1.05,84.42,Difficile,Facile,2,Beaucoup plus Facile,Pas Adapte
5825,2020,Economie,5,Le Capital et le Progres Technique,4,Le Progres Technique - Nature et Role,6,271,5,QCM,0.57,0.27,12.96,10,70,80,74,10,64,1.08,13.51,Facile,Difficile,-2,Beaucoup plus Difficile,Pas Adapte
271,2015,Economie,5,Le Capital et le Progres Technique,4,Le Progres Technique - Nature et Role,6,272,6,QO,0.11,0.38,87.42,81,12,93,81,81,0,1.15,100.0,Moyen,Facile,1,Plus Facile,Pas Adapte
1382,2016,Economie,5,Le Capital et le Progres Technique,4,Le Progres Technique - Nature et Role,6,272,6,QO,0.18,0.51,89.95,96,11,107,98,96,2,1.09,97.96,Moyen,Facile,1,Plus Facile,Pas Adapte
2493,2017,Economie,5,Le Capital et le Progres Technique,4,Le Progres Technique - Nature et Role,6,272,6,QO,0.99,0.12,16.52,18,88,106,91,18,73,1.16,19.78,Facile,Difficile,-2,Beaucoup plus Difficile,Pas Adapte
3604,2018,Economie,5,Le Capital et le Progres Technique,4,Le Progres Technique - Nature et Role,6,272,6,QO,0.16,0.58,89.49,107,13,120,109,107,2,1.1,98.17,Moyen,Facile,1,Plus Facile,Pas Adapte
4715,2019,Economie,5,Le Capital et le Progres Technique,4,Le Progres Technique - Nature et Role,6,272,6,QO,0.94,0.02,29.46,37,90,127,65,37,28,1.95,56.92,Facile,Difficile,-2,Beaucoup plus Difficile,Pas Adapte
5826,2020,Economie,5,Le Capital et le Progres Technique,4,Le Progres Technique - Nature et Role,6,272,6,QO,0.95,0.04,17.9,24,108,132,111,24,87,1.19,21.62,Facile,Difficile,-2,Beaucoup plus Difficile,Pas Adapte
272,2015,Information-Communication,1,Introduction a l'Etude du Langage,1,La Nature du Langage,5,273,1,QROC,0.99,0.19,11.61,7,52,59,46,7,39,1.28,15.22,Difficile,Difficile,0,Meme Difficulté,Pas Adapte
1383,2016,Information-Communication,1,Introduction a l'Etude du Langage,1,La Nature du Langage,5,273,1,QROC,0.91,0.01,19.86,12,49,61,53,12,41,1.15,22.64,Difficile,Difficile,0,Meme Difficulté,Pas Adapte
2494,2017,Information-Communication,1,Introduction a l'Etude du Langage,1,La Nature du Langage,5,273,1,QROC,0.78,0.18,15.75,11,58,69,62,11,51,1.11,17.74,Facile,Difficile,-2,Beaucoup plus Difficile,Pas Adapte
3605,2018,Information-Communication,1,Introduction a l'Etude du Langage,1,La Nature du Langage,5,273,1,QROC,0.17,0.84,75.93,51,16,67,64,51,13,1.05,79.69,Difficile,Facile,2,Beaucoup plus Facile,Pas Adapte
4716,2019,Information-Communication,1,Introduction a l'Etude du Langage,1,La Nature du Langage,5,273,1,QROC,0.1,0.91,74.74,43,15,58,58,43,15,1.0,74.14,Difficile,Facile,2,Beaucoup plus Facile,Adapte
5827,2020,Information-Communication,1,Introduction a l'Etude du Langage,1,La Nature du Langage,5,273,1,QROC,0.18,0.68,74.74,43,14,57,47,43,4,1.21,91.49,Facile,Facile,0,Meme Difficulté,Adapte
273,2015,Information-Communication,1,Introduction a l'Etude du Langage,1,La Nature du Langage,5,274,2,QO,0.74,0.2,49.26,46,47,93,62,46,16,1.5,74.19,Facile,Moyen,-1,Plus Difficile,Pas Adapte
1384,2016,Information-Communication,1,Introduction a l'Etude du Langage,1,La Nature du Langage,5,274,2,QO,0.49,0.24,64.87,58,31,89,60,58,2,1.48,96.67,Facile,Moyen,-1,Plus Difficile,Pas Adapte
2495,2017,Information-Communication,1,Introduction a l'Etude du Langage,1,La Nature du Langage,5,274,2,QO,0.08,0.53,76.79,78,24,102,93,78,15,1.1,83.87,Facile,Facile,0,Meme Difficulté,Pas Adapte
3606,2018,Information-Communication,1,Introduction a l'Etude du Langage,1,La Nature du Langage,5,274,2,QO,0.1,0.36,67.11,75,37,112,89,75,14,1.26,84.27,Facile,Facile,0,Meme Difficulté,Adapte
4717,2019,Information-Communication,1,Introduction a l'Etude du Langage,1,La Nature du Langage,5,274,2,QO,0.03,0.8,67.11,85,41,126,90,85,5,1.4,94.44,Facile,Facile,0,Meme Difficulté,Adapte
5828,2020,Information-Communication,1,Introduction a l'Etude du Langage,1,La Nature du Langage,5,274,2,QO,0.1,0.3,67.11,83,40,123,92,83,9,1.34,90.22,Facile,Facile,0,Meme Difficulté,Adapte
274,2015,Information-Communication,1,Introduction a l'Etude du Langage,1,La Nature du Langage,5,275,3,QCU,0.29,0.58,55.44,27,21,48,35,27,8,1.37,77.14,Moyen,Moyen,0,Meme Difficulté,Pas Adapte
1385,2016,Information-Communication,1,Introduction a l'Etude du Langage,1,La Nature du Langage,5,275,3,QCU,0.42,0.33,19.59,9,39,48,24,9,15,2.0,37.5,Difficile,Difficile,0,Meme Difficulté,Pas Adapte
2496,2017,Information-Communication,1,Introduction a l'Etude du Langage,1,La Nature du Langage,5,275,3,QCU,0.48,0.28,15.25,8,43,51,44,8,36,1.16,18.18,Facile,Difficile,-2,Beaucoup plus Difficile,Pas Adapte
3607,2018,Information-Communication,1,Introduction a l'Etude du Langage,1,La Nature du Langage,5,275,3,QCU,0.14,0.75,94.3,48,3,51,48,48,0,1.06,100.0,Moyen,Facile,1,Plus Facile,Pas Adapte
4718,2019,Information-Communication,1,Introduction a l'Etude du Langage,1,La Nature du Langage,5,275,3,QCU,0.05,0.95,86.1,47,8,55,50,47,3,1.1,94.0,Moyen,Facile,1,Plus Facile,Pas Adapte
5829,2020,Information-Communication,1,Introduction a l'Etude du Langage,1,La Nature du Langage,5,275,3,QCU,0.36,0.61,58.21,29,21,50,33,29,4,1.52,87.88,Moyen,Moyen,0,Meme Difficulté,Pas Adapte
275,2015,Information-Communication,1,Introduction a l'Etude du Langage,1,La Nature du Langage,5,276,4,QCU,0.18,0.94,98.75,24,0,24,24,24,0,1.0,100.0,Difficile,Facile,2,Beaucoup plus Facile,Pas Adapte
1386,2016,Information-Communication,1,Introduction a l'Etude du Langage,1,La Nature du Langage,5,276,4,QCM,0.48,0.4,45.07,13,15,28,23,13,10,1.22,56.52,Moyen,Moyen,0,Meme Difficulté,Pas Adapte
2497,2017,Information-Communication,1,Introduction a l'Etude du Langage,1,La Nature du Langage,5,276,4,QCM,0.67,0.16,4.57,1,27,28,24,1,23,1.17,4.17,Facile,Difficile,-2,Beaucoup plus Difficile,Pas Adapte
3608,2018,Information-Communication,1,Introduction a l'Etude du Langage,1,La Nature du Langage,5,276,4,QCM,0.18,0.79,99.69,31,0,31,31,31,0,1.0,100.0,Moyen,Facile,1,Plus Facile,Pas Adapte
4719,2019,Information-Communication,1,Introduction a l'Etude du Langage,1,La Nature du Langage,5,276,4,QCM,0.42,0.36,49.71,14,15,29,25,14,11,1.16,56.0,Difficile,Moyen,1,Plus Facile,Pas Adapte
5830,2020,Information-Communication,1,Introduction a l'Etude du Langage,1,La Nature du Langage,5,276,4,QCM,0.47,0.33,61.54,18,12,30,23,18,5,1.3,78.26,Moyen,Moyen,0,Meme Difficulté,Pas Adapte
276,2015,Information-Communication,1,Introduction a l'Etude du Langage,1,La Nature du Langage,5,277,5,QCU,0.17,0.93,73.35,56,21,77,71,56,15,1.08,78.87,Facile,Facile,0,Meme Difficulté,Adapte
1387,2016,Information-Communication,1,Introduction a l'Etude du Langage,1,La Nature du Langage,5,277,5,QCU,0.15,0.76,73.35,52,19,71,61,52,9,1.16,85.25,Facile,Facile,0,Meme Difficulté,Adapte
2498,2017,Information-Communication,1,Introduction a l'Etude du Langage,1,La Nature du Langage,5,277,5,QCU,0.06,0.94,73.35,53,19,72,59,53,6,1.22,89.83,Facile,Facile,0,Meme Difficulté,Adapte
3609,2018,Information-Communication,1,Introduction a l'Etude du Langage,1,La Nature du Langage,5,277,5,QCU,0.13,0.81,73.35,50,18,68,65,50,15,1.05,76.92,Facile,Facile,0,Meme Difficulté,Adapte
4720,2019,Information-Communication,1,Introduction a l'Etude du Langage,1,La Nature du Langage,5,277,5,QCU,0.07,0.89,73.35,54,20,74,63,54,9,1.17,85.71,Facile,Facile,0,Meme Difficulté,Adapte
5831,2020,Information-Communication,1,Introduction a l'Etude du Langage,1,La Nature du Langage,5,277,5,QCU,0.1,0.79,73.35,54,19,73,56,54,2,1.3,96.43,Facile,Facile,0,Meme Difficulté,Adapte
277,2015,Information-Communication,1,Introduction a l'Etude du Langage,2,La Semiotique,9,278,1,QCM,0.72,0.25,32.53,27,56,83,33,27,6,2.52,81.82,Moyen,Difficile,-1,Plus Difficile,Pas Adapte
1388,2016,Information-Communication,1,Introduction a l'Etude du Langage,2,La Semiotique,9,278,1,QCM,0.3,0.49,45.65,39,46,85,65,39,26,1.31,60.0,Moyen,Moyen,0,Meme Difficulté,Pas Adapte
2499,2017,Information-Communication,1,Introduction a l'Etude du Langage,2,La Semiotique,9,278,1,QCU,0.35,0.58,57.55,44,33,77,65,44,21,1.18,67.69,Facile,Moyen,-1,Plus Difficile,Pas Adapte
3610,2018,Information-Communication,1,Introduction a l'Etude du Langage,2,La Semiotique,9,278,1,QCU,0.53,0.37,27.16,22,60,82,65,22,43,1.26,33.85,Difficile,Difficile,0,Meme Difficulté,Pas Adapte
4721,2019,Information-Communication,1,Introduction a l'Etude du Langage,2,La Semiotique,9,278,1,QCU,0.18,0.75,76.63,59,18,77,64,59,5,1.2,92.19,Facile,Facile,0,Meme Difficulté,Pas Adapte
5832,2020,Information-Communication,1,Introduction a l'Etude du Langage,2,La Semiotique,9,278,1,QCU,0.04,0.76,93.31,63,4,67,65,63,2,1.03,96.92,Moyen,Facile,1,Plus Facile,Pas Adapte
278,2015,Information-Communication,1,Introduction a l'Etude du Langage,2,La Semiotique,9,279,2,QCM,0.69,0.21,31.08,16,36,52,19,16,3,2.74,84.21,Difficile,Difficile,0,Meme Difficulté,Pas Adapte
1389,2016,Information-Communication,1,Introduction a l'Etude du Langage,2,La Semiotique,9,279,2,QCM,0.58,0.21,10.89,6,49,55,14,6,8,3.93,42.86,Difficile,Difficile,0,Meme Difficulté,Pas Adapte
2500,2017,Information-Communication,1,Introduction a l'Etude du Langage,2,La Semiotique,9,279,2,QCM,0.78,0.23,20.5,13,48,61,42,13,29,1.45,30.95,Difficile,Difficile,0,Meme Difficulté,Pas Adapte
3611,2018,Information-Communication,1,Introduction a l'Etude du Langage,2,La Semiotique,9,279,2,QCM,0.09,0.83,73.95,47,17,64,49,47,2,1.31,95.92,Moyen,Facile,1,Plus Facile,Adapte
4722,2019,Information-Communication,1,Introduction a l'Etude du Langage,2,La Semiotique,9,279,2,QROC,0.16,0.73,73.95,47,17,64,60,47,13,1.07,78.33,Facile,Facile,0,Meme Difficulté,Adapte
5833,2020,Information-Communication,1,Introduction a l'Etude du Langage,2,La Semiotique,9,279,2,QO,0.12,0.35,73.95,41,14,55,44,41,3,1.25,93.18,Facile,Facile,0,Meme Difficulté,Adapte
279,2015,Information-Communication,1,Introduction a l'Etude du Langage,2,La Semiotique,9,280,3,QCU,0.34,0.49,64.21,19,11,30,21,19,2,1.43,90.48,Difficile,Moyen,1,Plus Facile,Pas Adapte
1390,2016,Information-Communication,1,Introduction a l'Etude du Langage,2,La Semiotique,9,280,3,QROC,0.04,0.46,76.65,26,8,34,27,26,1,1.26,96.3,Difficile,Facile,2,Beaucoup plus Facile,Pas Adapte
2501,2017,Information-Communication,1,Introduction a l'Etude du Langage,2,La Semiotique,9,280,3,QROC,0.09,0.52,76.55,30,9,39,30,30,0,1.3,100.0,Facile,Facile,0,Meme Difficulté,Pas Adapte
3612,2018,Information-Communication,1,Introduction a l'Etude du Langage,2,La Semiotique,9,280,3,QROC,0.31,0.29,43.08,17,23,40,24,17,7,1.67,70.83,Difficile,Moyen,1,Plus Facile,Pas Adapte
4723,2019,Information-Communication,1,Introduction a l'Etude du Langage,2,La Semiotique,9,280,3,QROC,0.07,0.73,97.32,45,1,46,45,45,0,1.02,100.0,Facile,Facile,0,Meme Difficulté,Pas Adapte
5834,2020,Information-Communication,1,Introduction a l'Etude du Langage,2,La Semiotique,9,280,3,QROC,0.09,0.63,67.79,27,13,40,29,27,2,1.38,93.1,Moyen,Facile,1,Plus Facile,Adapte
280,2015,Information-Communication,1,Introduction a l'Etude du Langage,2,La Semiotique,9,281,4,QCM,0.15,0.96,75.05,75,25,100,79,75,4,1.27,94.94,Difficile,Facile,2,Beaucoup plus Facile,Pas Adapte
1391,2016,Information-Communication,1,Introduction a l'Etude du Langage,2,La Semiotique,9,281,4,QCM,0.66,0.2,25.65,23,65,88,48,23,25,1.83,47.92,Difficile,Difficile,0,Meme Difficulté,Pas Adapte
2502,2017,Information-Communication,1,Introduction a l'Etude du Langage,2,La Semiotique,9,281,4,QCM,0.01,0.97,76.12,70,22,92,80,70,10,1.15,87.5,Moyen,Facile,1,Plus Facile,Pas Adapte
3613,2018,Information-Communication,1,Introduction a l'Etude du Langage,2,La Semiotique,9,281,4,QCM,0.03,0.97,82.36,68,14,82,79,68,11,1.04,86.08,Facile,Facile,0,Meme Difficulté,Pas Adapte
4724,2019,Information-Communication,1,Introduction a l'Etude du Langage,2,La Semiotique,9,281,4,QCM,0.27,0.33,41.9,34,47,81,66,34,32,1.23,51.52,Difficile,Moyen,1,Plus Facile,Pas Adapte
5835,2020,Information-Communication,1,Introduction a l'Etude du Langage,2,La Semiotique,9,281,4,QCM,0.35,0.65,60.31,55,36,91,88,55,33,1.03,62.5,Facile,Moyen,-1,Plus Difficile,Pas Adapte
281,2015,Information-Communication,1,Introduction a l'Etude du Langage,2,La Semiotique,9,282,5,QCM,0.57,0.15,16.3,2,13,15,8,2,6,1.88,25.0,Facile,Difficile,-2,Beaucoup plus Difficile,Pas Adapte
1392,2016,Information-Communication,1,Introduction a l'Etude du Langage,2,La Semiotique,9,282,5,QCM,0.1,0.91,85.41,11,2,13,13,11,2,1.0,84.62,Facile,Facile,0,Meme Difficulté,Pas Adapte
2503,2017,Information-Communication,1,Introduction a l'Etude du Langage,2,La Semiotique,9,282,5,QO,0.2,0.56,79.91,11,3,14,11,11,0,1.27,100.0,Difficile,Facile,2,Beaucoup plus Facile,Pas Adapte
3614,2018,Information-Communication,1,Introduction a l'Etude du Langage,2,La Semiotique,9,282,5,QO,0.54,0.21,40.07,6,10,16,10,6,4,1.6,60.0,Difficile,Moyen,1,Plus Facile,Pas Adapte
4725,2019,Information-Communication,1,Introduction a l'Etude du Langage,2,La Semiotique,9,282,5,QROC,0.88,0.05,11.47,2,13,15,6,2,4,2.5,33.33,Facile,Difficile,-2,Beaucoup plus Difficile,Pas Adapte
5836,2020,Information-Communication,1,Introduction a l'Etude du Langage,2,La Semiotique,9,282,5,QO,0.04,0.91,65.77,9,5,14,10,9,1,1.4,90.0,Facile,Facile,0,Meme Difficulté,Adapte
282,2015,Information-Communication,1,Introduction a l'Etude du Langage,2,La Semiotique,9,283,6,QCU,0.13,0.91,71.15,38,16,54,50,38,12,1.08,76.0,Moyen,Facile,1,Plus Facile,Adapte
1393,2016,Information-Communication,1,Introduction a l'Etude du Langage,2,La Semiotique,9,283,6,QCU,0.04,1.0,71.15,38,15,53,50,38,12,1.06,76.0,Facile,Facile,0,Meme Difficulté,Adapte
2504,2017,Information-Communication,1,Introduction a l'Etude du Langage,2,La Semiotique,9,283,6,QCU,0.19,0.84,71.15,36,15,51,47,36,11,1.09,76.6,Facile,Facile,0,Meme Difficulté,Adapte
3615,2018,Information-Communication,1,Introduction a l'Etude du Langage,2,La Semiotique,9,283,6,QCU,0.1,0.83,71.15,33,14,47,44,33,11,1.07,75.0,Facile,Facile,0,Meme Difficulté,Adapte
4726,2019,Information-Communication,1,Introduction a l'Etude du Langage,2,La Semiotique,9,283,6,QCU,0.13,0.88,71.15,30,12,42,32,30,2,1.31,93.75,Facile,Facile,0,Meme Difficulté,Adapte
5837,2020,Information-Communication,1,Introduction a l'Etude du Langage,2,La Semiotique,9,283,6,QCU,0.09,0.78,71.15,29,12,41,38,29,9,1.08,76.32,Facile,Facile,0,Meme Difficulté,Adapte
283,2015,Information-Communication,1,Introduction a l'Etude du Langage,2,La Semiotique,9,284,7,QCM,0.79,0.25,20.91,10,40,50,19,10,9,2.63,52.63,Moyen,Difficile,-1,Plus Difficile,Pas Adapte
1394,2016,Information-Communication,1,Introduction a l'Etude du Langage,2,La Semiotique,9,284,7,QCM,0.79,0.21,19.34,9,35,44,17,9,8,2.59,52.94,Facile,Difficile,-2,Beaucoup plus Difficile,Pas Adapte
2505,2017,Information-Communication,1,Introduction a l'Etude du Langage,2,La Semiotique,9,284,7,QO,0.12,0.94,67.71,25,12,37,32,25,7,1.16,78.12,Difficile,Facile,2,Beaucoup plus Facile,Adapte
3616,2018,Information-Communication,1,Introduction a l'Etude du Langage,2,La Semiotique,9,284,7,QO,0.07,0.68,67.71,22,11,33,28,22,6,1.18,78.57,Facile,Facile,0,Meme Difficulté,Adapte
4727,2019,Information-Communication,1,Introduction a l'Etude du Langage,2,La Semiotique,9,284,7,QO,0.02,0.71,67.71,21,10,31,30,21,9,1.03,70.0,Facile,Facile,0,Meme Difficulté,Adapte
5838,2020,Information-Communication,1,Introduction a l'Etude du Langage,2,La Semiotique,9,284,7,QO,0.06,0.58,67.71,21,10,31,24,21,3,1.29,87.5,Facile,Facile,0,Meme Difficulté,Adapte
284,2015,Information-Communication,1,Introduction a l'Etude du Langage,2,La Semiotique,9,285,8,QCU,0.35,0.4,59.22,38,27,65,64,38,26,1.02,59.38,Difficile,Moyen,1,Plus Facile,Pas Adapte
1395,2016,Information-Communication,1,Introduction a l'Etude du Langage,2,La Semiotique,9,285,8,QCU,0.18,0.78,77.87,45,13,58,54,45,9,1.07,83.33,Difficile,Facile,2,Beaucoup plus Facile,Pas Adapte
2506,2017,Information-Communication,1,Introduction a l'Etude du Langage,2,La Semiotique,9,285,8,QCU,0.74,0.4,0.88,0,54,54,50,0,50,1.08,0.0,Moyen,Difficile,-1,Plus Difficile,Pas Adapte
3617,2018,Information-Communication,1,Introduction a l'Etude du Langage,2,La Semiotique,9,285,8,QCU,0.32,0.69,62.36,36,21,57,54,36,18,1.06,66.67,Difficile,Moyen,1,Plus Facile,Pas Adapte
4728,2019,Information-Communication,1,Introduction a l'Etude du Langage,2,La Semiotique,9,285,8,QCU,0.12,0.97,80.95,52,12,64,55,52,3,1.16,94.55,Facile,Facile,0,Meme Difficulté,Pas Adapte
5839,2020,Information-Communication,1,Introduction a l'Etude du Langage,2,La Semiotique,9,285,8,QCU,0.13,0.76,86.28,49,8,57,51,49,2,1.12,96.08,Moyen,Facile,1,Plus Facile,Pas Adapte
285,2015,Information-Communication,1,Introduction a l'Etude du Langage,2,La Semiotique,9,286,9,QCM,0.12,0.8,77.48,60,17,77,61,60,1,1.26,98.36,Moyen,Facile,1,Plus Facile,Pas Adapte
1396,2016,Information-Communication,1,Introduction a l'Etude du Langage,2,La Semiotique,9,286,9,QCM,0.1,0.81,90.78,76,8,84,81,76,5,1.04,93.83,Difficile,Facile,2,Beaucoup plus Facile,Pas Adapte
2507,2017,Information-Communication,1,Introduction a l'Etude du Langage,2,La Semiotique,9,286,9,QCM,0.49,0.58,57.48,43,31,74,51,43,8,1.45,84.31,Moyen,Moyen,0,Meme Difficulté,Pas Adapte
3618,2018,Information-Communication,1,Introduction a l'Etude du Langage,2,La Semiotique,9,286,9,QCM,0.73,0.18,14.51,12,68,80,62,12,50,1.29,19.35,Facile,Difficile,-2,Beaucoup plus Difficile,Pas Adapte
4729,2019,Information-Communication,1,Introduction a l'Etude du Langage,2,La Semiotique,9,286,9,QCM,0.54,0.21,31.86,29,63,92,53,29,24,1.74,54.72,Difficile,Difficile,0,Meme Difficulté,Pas Adapte
5840,2020,Information-Communication,1,Introduction a l'Etude du Langage,2,La Semiotique,9,286,9,QCM,0.77,0.29,14.48,13,77,90,89,13,76,1.01,14.61,Moyen,Difficile,-1,Plus Difficile,Pas Adapte
286,2015,Information-Communication,1,Introduction a l'Etude du Langage,3,La Morphologie,2,287,1,QROC,0.68,0.12,10.14,1,10,11,7,1,6,1.57,14.29,Moyen,Difficile,-1,Plus Difficile,Pas Adapte
1397,2016,Information-Communication,1,Introduction a l'Etude du Langage,3,La Morphologie,2,287,1,QROC,0.14,0.65,98.07,9,0,9,9,9,0,1.0,100.0,Facile,Facile,0,Meme Difficulté,Pas Adapte
2508,2017,Information-Communication,1,Introduction a l'Etude du Langage,3,La Morphologie,2,287,1,QROC,0.01,0.67,95.83,9,0,9,9,9,0,1.0,100.0,Moyen,Facile,1,Plus Facile,Pas Adapte
3619,2018,Information-Communication,1,Introduction a l'Etude du Langage,3,La Morphologie,2,287,1,QROC,0.29,0.36,38.48,4,6,10,7,4,3,1.43,57.14,Difficile,Moyen,1,Plus Facile,Pas Adapte
4730,2019,Information-Communication,1,Introduction a l'Etude du Langage,3,La Morphologie,2,287,1,QROC,0.52,0.38,63.81,7,4,11,9,7,2,1.22,77.78,Difficile,Moyen,1,Plus Facile,Pas Adapte
5841,2020,Information-Communication,1,Introduction a l'Etude du Langage,3,La Morphologie,2,287,1,QCU,0.5,0.21,3.3,0,10,10,8,0,8,1.25,0.0,Difficile,Difficile,0,Meme Difficulté,Pas Adapte
287,2015,Information-Communication,1,Introduction a l'Etude du Langage,3,La Morphologie,2,288,2,QCM,0.7,0.19,21.8,12,43,55,53,12,41,1.04,22.64,Facile,Difficile,-2,Beaucoup plus Difficile,Pas Adapte
1398,2016,Information-Communication,1,Introduction a l'Etude du Langage,3,La Morphologie,2,288,2,QCM,0.46,0.48,36.76,19,32,51,25,19,6,2.04,76.0,Moyen,Moyen,0,Meme Difficulté,Pas Adapte
2509,2017,Information-Communication,1,Introduction a l'Etude du Langage,3,La Morphologie,2,288,2,QCM,0.01,0.76,79.86,35,9,44,40,35,5,1.1,87.5,Facile,Facile,0,Meme Difficulté,Pas Adapte
3620,2018,Information-Communication,1,Introduction a l'Etude du Langage,3,La Morphologie,2,288,2,QCM,0.52,0.25,1.36,1,50,51,46,1,45,1.11,2.17,Facile,Difficile,-2,Beaucoup plus Difficile,Pas Adapte
4731,2019,Information-Communication,1,Introduction a l'Etude du Langage,3,La Morphologie,2,288,2,QCM,0.6,0.24,16.74,8,41,49,33,8,25,1.48,24.24,Moyen,Difficile,-1,Plus Difficile,Pas Adapte
5842,2020,Information-Communication,1,Introduction a l'Etude du Langage,3,La Morphologie,2,288,2,QCM,0.7,0.21,13.42,7,42,49,22,7,15,2.23,31.82,Moyen,Difficile,-1,Plus Difficile,Pas Adapte
288,2015,Information-Communication,1,Introduction a l'Etude du Langage,4,La Phonetique,8,289,1,QCU,0.18,0.84,69.49,24,10,34,30,24,6,1.13,80.0,Moyen,Facile,1,Plus Facile,Adapte
1399,2016,Information-Communication,1,Introduction a l'Etude du Langage,4,La Phonetique,8,289,1,QCU,0.16,0.75,69.49,26,12,38,28,26,2,1.36,92.86,Facile,Facile,0,Meme Difficulté,Adapte
2510,2017,Information-Communication,1,Introduction a l'Etude du Langage,4,La Phonetique,8,289,1,QCU,0.15,0.87,69.49,29,13,42,42,29,13,1.0,69.05,Facile,Facile,0,Meme Difficulté,Adapte
3621,2018,Information-Communication,1,Introduction a l'Etude du Langage,4,La Phonetique,8,289,1,QCU,0.06,0.81,69.49,32,14,46,38,32,6,1.21,84.21,Facile,Facile,0,Meme Difficulté,Adapte
4732,2019,Information-Communication,1,Introduction a l'Etude du Langage,4,La Phonetique,8,289,1,QCU,0.05,0.79,69.49,34,15,49,37,34,3,1.32,91.89,Facile,Facile,0,Meme Difficulté,Adapte
5843,2020,Information-Communication,1,Introduction a l'Etude du Langage,4,La Phonetique,8,289,1,QCU,0.12,0.97,69.49,38,16,54,42,38,4,1.29,90.48,Facile,Facile,0,Meme Difficulté,Adapte
289,2015,Information-Communication,1,Introduction a l'Etude du Langage,4,La Phonetique,8,290,2,QCM,0.09,0.84,95.97,43,2,45,44,43,1,1.02,97.73,Difficile,Facile,2,Beaucoup plus Facile,Pas Adapte
1400,2016,Information-Communication,1,Introduction a l'Etude du Langage,4,La Phonetique,8,290,2,QCU,0.45,0.36,3.22,1,39,40,25,1,24,1.6,4.0,Moyen,Difficile,-1,Plus Difficile,Pas Adapte
2511,2017,Information-Communication,1,Introduction a l'Etude du Langage,4,La Phonetique,8,290,2,QCU,0.25,0.65,64.19,28,15,43,36,28,8,1.19,77.78,Moyen,Moyen,0,Meme Difficulté,Pas Adapte
3622,2018,Information-Communication,1,Introduction a l'Etude du Langage,4,La Phonetique,8,290,2,QCU,0.61,0.34,19.81,9,34,43,39,9,30,1.1,23.08,Facile,Difficile,-2,Beaucoup plus Difficile,Pas Adapte
4733,2019,Information-Communication,1,Introduction a l'Etude du Langage,4,La Phonetique,8,290,2,QCU,0.04,0.99,98.48,37,1,38,38,37,1,1.0,97.37,Moyen,Facile,1,Plus Facile,Pas Adapte
5844,2020,Information-Communication,1,Introduction a l'Etude du Langage,4,La Phonetique,8,290,2,QCU,0.2,0.81,90.8,39,4,43,39,39,0,1.1,100.0,Facile,Facile,0,Meme Difficulté,Pas Adapte
290,2015,Information-Communication,1,Introduction a l'Etude du Langage,4,La Phonetique,8,291,3,QCM,0.22,0.38,59.18,20,13,33,27,20,7,1.22,74.07,Facile,Moyen,-1,Plus Difficile,Pas Adapte
1401,2016,Information-Communication,1,Introduction a l'Etude du Langage,4,La Phonetique,8,291,3,QCM,0.57,0.22,20.36,6,23,29,24,6,18,1.21,25.0,Difficile,Difficile,0,Meme Difficulté,Pas Adapte
2512,2017,Information-Communication,1,Introduction a l'Etude du Langage,4,La Phonetique,8,291,3,QCM,0.12,0.92,85.56,23,4,27,25,23,2,1.08,92.0,Facile,Facile,0,Meme Difficulté,Pas Adapte
3623,2018,Information-Communication,1,Introduction a l'Etude du Langage,4,La Phonetique,8,291,3,QCM,0.25,0.43,47.33,14,16,30,25,14,11,1.2,56.0,Difficile,Moyen,1,Plus Facile,Pas Adapte
4734,2019,Information-Communication,1,Introduction a l'Etude du Langage,4,La Phonetique,8,291,3,QCM,0.69,0.29,19.07,6,28,34,17,6,11,2.0,35.29,Facile,Difficile,-2,Beaucoup plus Difficile,Pas Adapte
5845,2020,Information-Communication,1,Introduction a l'Etude du Langage,4,La Phonetique,8,291,3,QCM,0.25,0.6,41.59,14,19,33,15,14,1,2.2,93.33,Difficile,Moyen,1,Plus Facile,Pas Adapte
291,2015,Information-Communication,1,Introduction a l'Etude du Langage,4,La Phonetique,8,292,4,QCM,0.09,0.94,89.56,79,9,88,80,79,1,1.1,98.75,Moyen,Facile,1,Plus Facile,Pas Adapte
1402,2016,Information-Communication,1,Introduction a l'Etude du Langage,4,La Phonetique,8,292,4,QCM,0.05,0.79,93.24,87,6,93,88,87,1,1.06,98.86,Moyen,Facile,1,Plus Facile,Pas Adapte
2513,2017,Information-Communication,1,Introduction a l'Etude du Langage,4,La Phonetique,8,292,4,QCM,0.8,0.28,6.4,6,86,92,31,6,25,2.97,19.35,Facile,Difficile,-2,Beaucoup plus Difficile,Pas Adapte
3624,2018,Information-Communication,1,Introduction a l'Etude du Langage,4,La Phonetique,8,292,4,QCM,0.73,0.16,22.96,23,78,101,51,23,28,1.98,45.1,Facile,Difficile,-2,Beaucoup plus Difficile,Pas Adapte
4735,2019,Information-Communication,1,Introduction a l'Etude du Langage,4,La Phonetique,8,292,4,QCM,0.18,0.74,71.65,80,31,111,107,80,27,1.04,74.77,Facile,Facile,0,Meme Difficulté,Adapte
5846,2020,Information-Communication,1,Introduction a l'Etude du Langage,4,La Phonetique,8,292,4,QCM,0.11,0.89,71.65,68,27,95,69,68,1,1.38,98.55,Facile,Facile,0,Meme Difficulté,Adapte
292,2015,Information-Communication,1,Introduction a l'Etude du Langage,4,La Phonetique,8,293,5,QCM,0.13,0.76,68.25,68,31,99,86,68,18,1.15,79.07,Difficile,Facile,2,Beaucoup plus Facile,Adapte
1403,2016,Information-Communication,1,Introduction a l'Etude du Langage,4,La Phonetique,8,293,5,QCM,0.13,0.8,68.25,64,30,94,75,64,11,1.25,85.33,Facile,Facile,0,Meme Difficulté,Adapte
2514,2017,Information-Communication,1,Introduction a l'Etude du Langage,4,La Phonetique,8,293,5,QCM,0.01,0.99,68.25,68,32,100,100,68,32,1.0,68.0,Facile,Facile,0,Meme Difficulté,Adapte
3625,2018,Information-Communication,1,Introduction a l'Etude du Langage,4,La Phonetique,8,293,5,QO,0.14,0.83,68.25,71,33,104,82,71,11,1.27,86.59,Facile,Facile,0,Meme Difficulté,Adapte
4736,2019,Information-Communication,1,Introduction a l'Etude du Langage,4,La Phonetique,8,293,5,QO,0.01,0.35,68.25,60,28,88,86,60,26,1.02,69.77,Facile,Facile,0,Meme Difficulté,Adapte
5847,2020,Information-Communication,1,Introduction a l'Etude du Langage,4,La Phonetique,8,293,5,QO,0.04,0.89,68.25,57,27,84,83,57,26,1.01,68.67,Facile,Facile,0,Meme Difficulté,Adapte
293,2015,Information-Communication,1,Introduction a l'Etude du Langage,4,La Phonetique,8,294,6,QO,0.71,0.27,49.32,49,50,99,53,49,4,1.87,92.45,Moyen,Moyen,0,Meme Difficulté,Pas Adapte
1404,2016,Information-Communication,1,Introduction a l'Etude du Langage,4,La Phonetique,8,294,6,QO,0.47,0.28,46.23,40,46,86,74,40,34,1.16,54.05,Facile,Moyen,-1,Plus Difficile,Pas Adapte
2515,2017,Information-Communication,1,Introduction a l'Etude du Langage,4,La Phonetique,8,294,6,QO,0.87,0.02,1.03,1,95,96,49,1,48,1.96,2.04,Difficile,Difficile,0,Meme Difficulté,Pas Adapte
3626,2018,Information-Communication,1,Introduction a l'Etude du Langage,4,La Phonetique,8,294,6,QO,0.18,0.81,99.25,93,1,94,94,93,1,1.0,98.94,Facile,Facile,0,Meme Difficulté,Pas Adapte
4737,2019,Information-Communication,1,Introduction a l'Etude du Langage,4,La Phonetique,8,294,6,QO,0.74,0.23,58.27,59,42,101,82,59,23,1.23,71.95,Difficile,Moyen,1,Plus Facile,Pas Adapte
5848,2020,Information-Communication,1,Introduction a l'Etude du Langage,4,La Phonetique,8,294,6,QO,0.87,0.06,19.16,20,87,107,82,20,62,1.3,24.39,Facile,Difficile,-2,Beaucoup plus Difficile,Pas Adapte
294,2015,Information-Communication,1,Introduction a l'Etude du Langage,4,La Phonetique,8,295,7,QCU,0.06,0.83,68.79,40,18,58,45,40,5,1.29,88.89,Moyen,Facile,1,Plus Facile,Adapte
1405,2016,Information-Communication,1,Introduction a l'Etude du Langage,4,La Phonetique,8,295,7,QCU,0.03,0.88,68.79,41,19,60,43,41,2,1.4,95.35,Facile,Facile,0,Meme Difficulté,Adapte
2516,2017,Information-Communication,1,Introduction a l'Etude du Langage,4,La Phonetique,8,295,7,QCU,0.09,0.97,68.79,36,16,52,48,36,12,1.08,75.0,Facile,Facile,0,Meme Difficulté,Adapte
3627,2018,Information-Communication,1,Introduction a l'Etude du Langage,4,La Phonetique,8,295,7,QCU,0.18,0.89,68.79,36,17,53,39,36,3,1.36,92.31,Facile,Facile,0,Meme Difficulté,Adapte
4738,2019,Information-Communication,1,Introduction a l'Etude du Langage,4,La Phonetique,8,295,7,QCU,0.07,0.96,68.79,36,16,52,50,36,14,1.04,72.0,Facile,Facile,0,Meme Difficulté,Adapte
5849,2020,Information-Communication,1,Introduction a l'Etude du Langage,4,La Phonetique,8,295,7,QCU,0.02,0.84,68.79,41,18,59,53,41,12,1.11,77.36,Facile,Facile,0,Meme Difficulté,Adapte
295,2015,Information-Communication,1,Introduction a l'Etude du Langage,4,La Phonetique,8,296,8,QCU,0.54,0.34,6.34,2,25,27,17,2,15,1.59,11.76,Facile,Difficile,-2,Beaucoup plus Difficile,Pas Adapte
1406,2016,Information-Communication,1,Introduction a l'Etude du Langage,4,La Phonetique,8,296,8,QCU,0.36,0.67,54.47,15,12,27,18,15,3,1.5,83.33,Moyen,Moyen,0,Meme Difficulté,Pas Adapte
2517,2017,Information-Communication,1,Introduction a l'Etude du Langage,4,La Phonetique,8,296,8,QCM,0.16,0.81,77.58,24,7,31,26,24,2,1.19,92.31,Difficile,Facile,2,Beaucoup plus Facile,Pas Adapte
3628,2018,Information-Communication,1,Introduction a l'Etude du Langage,4,La Phonetique,8,296,8,QCM,0.51,0.29,33.65,11,22,33,12,11,1,2.75,91.67,Facile,Difficile,-2,Beaucoup plus Difficile,Pas Adapte
4739,2019,Information-Communication,1,Introduction a l'Etude du Langage,4,La Phonetique,8,296,8,QCM,0.43,0.45,51.74,20,18,38,26,20,6,1.46,76.92,Difficile,Moyen,1,Plus Facile,Pas Adapte
5850,2020,Information-Communication,1,Introduction a l'Etude du Langage,4,La Phonetique,8,296,8,QCM,0.36,0.61,62.22,21,12,33,21,21,0,1.57,100.0,Facile,Moyen,-1,Plus Difficile,Pas Adapte
296,2015,Information-Communication,1,Introduction a l'Etude du Langage,5,La Phonologie,2,297,1,QCU,0.07,0.86,78.37,63,18,81,66,63,3,1.23,95.45,Moyen,Facile,1,Plus Facile,Pas Adapte
1407,2016,Information-Communication,1,Introduction a l'Etude du Langage,5,La Phonologie,2,297,1,QCU,0.25,0.67,56.05,48,37,85,58,48,10,1.47,82.76,Facile,Moyen,-1,Plus Difficile,Pas Adapte
2518,2017,Information-Communication,1,Introduction a l'Etude du Langage,5,La Phonologie,2,297,1,QCU,0.2,0.96,83.23,62,13,75,75,62,13,1.0,82.67,Facile,Facile,0,Meme Difficulté,Pas Adapte
3629,2018,Information-Communication,1,Introduction a l'Etude du Langage,5,La Phonologie,2,297,1,QCU,0.2,0.96,78.75,60,16,76,62,60,2,1.23,96.77,Difficile,Facile,2,Beaucoup plus Facile,Pas Adapte
4740,2019,Information-Communication,1,Introduction a l'Etude du Langage,5,La Phonologie,2,297,1,QCU,0.12,0.99,84.95,59,11,70,66,59,7,1.06,89.39,Moyen,Facile,1,Plus Facile,Pas Adapte
5851,2020,Information-Communication,1,Introduction a l'Etude du Langage,5,La Phonologie,2,297,1,QCU,0.7,0.2,24.36,19,58,77,69,19,50,1.12,27.54,Facile,Difficile,-2,Beaucoup plus Difficile,Pas Adapte
297,2015,Information-Communication,1,Introduction a l'Etude du Langage,5,La Phonologie,2,298,2,QROC,0.82,0.16,10.38,5,43,48,46,5,41,1.04,10.87,Facile,Difficile,-2,Beaucoup plus Difficile,Pas Adapte
1408,2016,Information-Communication,1,Introduction a l'Etude du Langage,5,La Phonologie,2,298,2,QROC,0.54,0.33,42.12,18,25,43,33,18,15,1.3,54.55,Difficile,Moyen,1,Plus Facile,Pas Adapte
2519,2017,Information-Communication,1,Introduction a l'Etude du Langage,5,La Phonologie,2,298,2,QROC,0.45,0.4,60.83,26,17,43,40,26,14,1.07,65.0,Difficile,Moyen,1,Plus Facile,Pas Adapte
3630,2018,Information-Communication,1,Introduction a l'Etude du Langage,5,La Phonologie,2,298,2,QROC,0.74,0.2,4.94,2,46,48,40,2,38,1.2,5.0,Facile,Difficile,-2,Beaucoup plus Difficile,Pas Adapte
4741,2019,Information-Communication,1,Introduction a l'Etude du Langage,5,La Phonologie,2,298,2,QROC,0.52,0.29,64.66,28,16,44,44,28,16,1.0,63.64,Facile,Moyen,-1,Plus Difficile,Pas Adapte
5852,2020,Information-Communication,1,Introduction a l'Etude du Langage,5,La Phonologie,2,298,2,QROC,0.37,0.38,50.42,20,19,39,27,20,7,1.44,74.07,Moyen,Moyen,0,Meme Difficulté,Pas Adapte
298,2015,Information-Communication,1,Introduction a l'Etude du Langage,6,La Syntaxe,7,299,1,QCM,0.66,0.24,20.98,20,73,93,27,20,7,3.44,74.07,Moyen,Difficile,-1,Plus Difficile,Pas Adapte
1409,2016,Information-Communication,1,Introduction a l'Etude du Langage,6,La Syntaxe,7,299,1,QCM,0.8,0.26,28.68,28,70,98,31,28,3,3.16,90.32,Difficile,Difficile,0,Meme Difficulté,Pas Adapte
2520,2017,Information-Communication,1,Introduction a l'Etude du Langage,6,La Syntaxe,7,299,1,QCM,0.75,0.27,14.5,16,97,113,63,16,47,1.79,25.4,Facile,Difficile,-2,Beaucoup plus Difficile,Pas Adapte
3631,2018,Information-Communication,1,Introduction a l'Etude du Langage,6,La Syntaxe,7,299,1,QCM,0.12,0.7,75.08,94,31,125,100,94,6,1.25,94.0,Moyen,Facile,1,Plus Facile,Pas Adapte
4742,2019,Information-Communication,1,Introduction a l'Etude du Langage,6,La Syntaxe,7,299,1,QCM,0.06,0.9,78.04,94,27,121,114,94,20,1.06,82.46,Facile,Facile,0,Meme Difficulté,Pas Adapte
5853,2020,Information-Communication,1,Introduction a l'Etude du Langage,6,La Syntaxe,7,299,1,QCM,0.16,0.73,74.69,79,27,106,95,79,16,1.12,83.16,Difficile,Facile,2,Beaucoup plus Facile,Adapte
299,2015,Information-Communication,1,Introduction a l'Etude du Langage,6,La Syntaxe,7,300,2,QROC,0.1,0.83,85.33,21,4,25,24,21,3,1.04,87.5,Facile,Facile,0,Meme Difficulté,Pas Adapte
1410,2016,Information-Communication,1,Introduction a l'Etude du Langage,6,La Syntaxe,7,300,2,QO,0.9,0.1,9.15,3,25,28,28,3,25,1.0,10.71,Moyen,Difficile,-1,Plus Difficile,Pas Adapte
2521,2017,Information-Communication,1,Introduction a l'Etude du Langage,6,La Syntaxe,7,300,2,QO,0.06,0.8,70.01,22,9,31,30,22,8,1.03,73.33,Facile,Facile,0,Meme Difficulté,Adapte
3632,2018,Information-Communication,1,Introduction a l'Etude du Langage,6,La Syntaxe,7,300,2,QROC,0.09,0.56,70.01,25,10,35,31,25,6,1.13,80.65,Facile,Facile,0,Meme Difficulté,Adapte
4743,2019,Information-Communication,1,Introduction a l'Etude du Langage,6,La Syntaxe,7,300,2,QROC,0.06,0.92,70.01,28,12,40,37,28,9,1.08,75.68,Facile,Facile,0,Meme Difficulté,Adapte
5854,2020,Information-Communication,1,Introduction a l'Etude du Langage,6,La Syntaxe,7,300,2,QROC,0.02,0.68,70.01,24,10,34,33,24,9,1.03,72.73,Facile,Facile,0,Meme Difficulté,Adapte
300,2015,Information-Communication,1,Introduction a l'Etude du Langage,6,La Syntaxe,7,301,3,QROC,0.16,1.0,88.54,72,9,81,76,72,4,1.07,94.74,Moyen,Facile,1,Plus Facile,Pas Adapte
1411,2016,Information-Communication,1,Introduction a l'Etude du Langage,6,La Syntaxe,7,301,3,QO,0.91,0.02,9.76,8,74,82,79,8,71,1.04,10.13,Facile,Difficile,-2,Beaucoup plus Difficile,Pas Adapte
2522,2017,Information-Communication,1,Introduction a l'Etude du Langage,6,La Syntaxe,7,301,3,QCM,0.61,0.25,12.38,11,76,87,37,11,26,2.35,29.73,Facile,Difficile,-2,Beaucoup plus Difficile,Pas Adapte
3633,2018,Information-Communication,1,Introduction a l'Etude du Langage,6,La Syntaxe,7,301,3,QCM,0.43,0.6,61.21,59,38,97,63,59,4,1.54,93.65,Facile,Moyen,-1,Plus Difficile,Pas Adapte
4744,2019,Information-Communication,1,Introduction a l'Etude du Langage,6,La Syntaxe,7,301,3,QCM,0.2,0.8,76.67,77,24,101,95,77,18,1.06,81.05,Facile,Facile,0,Meme Difficulté,Pas Adapte
5855,2020,Information-Communication,1,Introduction a l'Etude du Langage,6,La Syntaxe,7,301,3,QCM,0.33,0.59,57.9,60,44,104,95,60,35,1.09,63.16,Facile,Moyen,-1,Plus Difficile,Pas Adapte
301,2015,Information-Communication,1,Introduction a l'Etude du Langage,6,La Syntaxe,7,302,4,QCM,0.57,0.22,1.43,1,39,40,22,1,21,1.82,4.55,Moyen,Difficile,-1,Plus Difficile,Pas Adapte
1412,2016,Information-Communication,1,Introduction a l'Etude du Langage,6,La Syntaxe,7,302,4,QCM,0.78,0.15,4.66,2,39,41,38,2,36,1.08,5.26,Facile,Difficile,-2,Beaucoup plus Difficile,Pas Adapte
2523,2017,Information-Communication,1,Introduction a l'Etude du Langage,6,La Syntaxe,7,302,4,QCU,0.68,0.26,11.59,5,42,47,21,5,16,2.24,23.81,Facile,Difficile,-2,Beaucoup plus Difficile,Pas Adapte
3634,2018,Information-Communication,1,Introduction a l'Etude du Langage,6,La Syntaxe,7,302,4,QCU,0.72,0.35,26.8,14,39,53,28,14,14,1.89,50.0,Moyen,Difficile,-1,Plus Difficile,Pas Adapte
4745,2019,Information-Communication,1,Introduction a l'Etude du Langage,6,La Syntaxe,7,302,4,QCU,0.24,0.71,49.04,23,24,47,24,23,1,1.96,95.83,Moyen,Moyen,0,Meme Difficulté,Pas Adapte
5856,2020,Information-Communication,1,Introduction a l'Etude du Langage,6,La Syntaxe,7,302,4,QCU,0.15,0.97,65.5,29,15,44,30,29,1,1.47,96.67,Difficile,Facile,2,Beaucoup plus Facile,Adapte
302,2015,Information-Communication,1,Introduction a l'Etude du Langage,6,La Syntaxe,7,303,5,QCM,0.02,0.96,97.05,41,1,42,42,41,1,1.0,97.62,Moyen,Facile,1,Plus Facile,Pas Adapte
1413,2016,Information-Communication,1,Introduction a l'Etude du Langage,6,La Syntaxe,7,303,5,QCM,0.38,0.35,63.35,28,16,44,39,28,11,1.13,71.79,Moyen,Moyen,0,Meme Difficulté,Pas Adapte
2524,2017,Information-Communication,1,Introduction a l'Etude du Langage,6,La Syntaxe,7,303,5,QO,0.29,0.15,62.71,24,15,39,30,24,6,1.3,80.0,Difficile,Moyen,1,Plus Facile,Pas Adapte
3635,2018,Information-Communication,1,Introduction a l'Etude du Langage,6,La Syntaxe,7,303,5,QO,0.38,0.17,46.37,17,20,37,28,17,11,1.32,60.71,Facile,Moyen,-1,Plus Difficile,Pas Adapte
4746,2019,Information-Communication,1,Introduction a l'Etude du Langage,6,La Syntaxe,7,303,5,QO,0.21,0.25,36.05,14,24,38,23,14,9,1.65,60.87,Facile,Moyen,-1,Plus Difficile,Pas Adapte
5857,2020,Information-Communication,1,Introduction a l'Etude du Langage,6,La Syntaxe,7,303,5,QO,0.05,0.69,89.25,36,4,40,37,36,1,1.08,97.3,Moyen,Facile,1,Plus Facile,Pas Adapte
303,2015,Information-Communication,1,Introduction a l'Etude du Langage,6,La Syntaxe,7,304,6,QCM,0.05,0.87,86.9,17,3,20,19,17,2,1.05,89.47,Moyen,Facile,1,Plus Facile,Pas Adapte
1414,2016,Information-Communication,1,Introduction a l'Etude du Langage,6,La Syntaxe,7,304,6,QROC,0.38,0.34,52.45,10,9,19,14,10,4,1.36,71.43,Facile,Moyen,-1,Plus Difficile,Pas Adapte
2525,2017,Information-Communication,1,Introduction a l'Etude du Langage,6,La Syntaxe,7,304,6,QROC,0.64,0.18,16.35,3,16,19,9,3,6,2.11,33.33,Difficile,Difficile,0,Meme Difficulté,Pas Adapte
3636,2018,Information-Communication,1,Introduction a l'Etude du Langage,6,La Syntaxe,7,304,6,QROC,0.59,0.38,51.21,9,8,17,12,9,3,1.42,75.0,Difficile,Moyen,1,Plus Facile,Pas Adapte
4747,2019,Information-Communication,1,Introduction a l'Etude du Langage,6,La Syntaxe,7,304,6,QROC,0.01,0.73,85.43,16,3,19,19,16,3,1.0,84.21,Moyen,Facile,1,Plus Facile,Pas Adapte
5858,2020,Information-Communication,1,Introduction a l'Etude du Langage,6,La Syntaxe,7,304,6,QCU,0.32,0.73,64.52,11,6,17,15,11,4,1.13,73.33,Difficile,Moyen,1,Plus Facile,Pas Adapte
304,2015,Information-Communication,1,Introduction a l'Etude du Langage,6,La Syntaxe,7,305,7,QCU,0.34,0.52,57.27,10,8,18,10,10,0,1.8,100.0,Facile,Moyen,-1,Plus Difficile,Pas Adapte
1415,2016,Information-Communication,1,Introduction a l'Etude du Langage,6,La Syntaxe,7,305,7,QCU,0.05,0.97,68.66,12,6,18,14,12,2,1.29,85.71,Difficile,Facile,2,Beaucoup plus Facile,Adapte
2526,2017,Information-Communication,1,Introduction a l'Etude du Langage,6,La Syntaxe,7,305,7,QCU,0.07,0.76,68.66,11,5,16,15,11,4,1.07,73.33,Facile,Facile,0,Meme Difficulté,Adapte
3637,2018,Information-Communication,1,Introduction a l'Etude du Langage,6,La Syntaxe,7,305,7,QCU,0.15,0.86,68.66,10,5,15,13,10,3,1.15,76.92,Facile,Facile,0,Meme Difficulté,Adapte
4748,2019,Information-Communication,1,Introduction a l'Etude du Langage,6,La Syntaxe,7,305,7,QCU,0.07,0.87,68.66,11,5,16,15,11,4,1.07,73.33,Facile,Facile,0,Meme Difficulté,Adapte
5859,2020,Information-Communication,1,Introduction a l'Etude du Langage,6,La Syntaxe,7,305,7,QCU,0.09,0.84,68.66,10,5,15,11,10,1,1.36,90.91,Facile,Facile,0,Meme Difficulté,Adapte
305,2015,Information-Communication,1,Introduction a l'Etude du Langage,7,Le Developpement du Langage,7,306,1,QROC,0.96,0.15,23.91,7,24,31,20,7,13,1.55,35.0,Moyen,Difficile,-1,Plus Difficile,Pas Adapte
1416,2016,Information-Communication,1,Introduction a l'Etude du Langage,7,Le Developpement du Langage,7,306,1,QROC,0.56,0.35,57.44,21,15,36,22,21,1,1.64,95.45,Difficile,Moyen,1,Plus Facile,Pas Adapte
2527,2017,Information-Communication,1,Introduction a l'Etude du Langage,7,Le Developpement du Langage,7,306,1,QROC,0.11,0.72,76.86,31,9,40,39,31,8,1.03,79.49,Difficile,Facile,2,Beaucoup plus Facile,Pas Adapte
3638,2018,Information-Communication,1,Introduction a l'Etude du Langage,7,Le Developpement du Langage,7,306,1,QROC,0.03,0.52,93.8,38,3,41,38,38,0,1.08,100.0,Difficile,Facile,2,Beaucoup plus Facile,Pas Adapte
4749,2019,Information-Communication,1,Introduction a l'Etude du Langage,7,Le Developpement du Langage,7,306,1,QCM,0.59,0.28,30.73,12,28,40,14,12,2,2.86,85.71,Moyen,Difficile,-1,Plus Difficile,Pas Adapte
5860,2020,Information-Communication,1,Introduction a l'Etude du Langage,7,Le Developpement du Langage,7,306,1,QROC,0.01,0.93,90.25,32,4,36,33,32,1,1.09,96.97,Difficile,Facile,2,Beaucoup plus Facile,Pas Adapte
306,2015,Information-Communication,1,Introduction a l'Etude du Langage,7,Le Developpement du Langage,7,307,2,QROC,0.05,0.9,88.7,46,6,52,47,46,1,1.11,97.87,Facile,Facile,0,Meme Difficulté,Pas Adapte
1417,2016,Information-Communication,1,Introduction a l'Etude du Langage,7,Le Developpement du Langage,7,307,2,QO,0.83,0.13,32.02,16,34,50,38,16,22,1.32,42.11,Facile,Difficile,-2,Beaucoup plus Difficile,Pas Adapte
2528,2017,Information-Communication,1,Introduction a l'Etude du Langage,7,Le Developpement du Langage,7,307,2,QO,0.85,0.07,26.36,12,34,46,23,12,11,2.0,52.17,Facile,Difficile,-2,Beaucoup plus Difficile,Pas Adapte
3639,2018,Information-Communication,1,Introduction a l'Etude du Langage,7,Le Developpement du Langage,7,307,2,QO,0.19,0.57,81.56,37,8,45,41,37,4,1.1,90.24,Moyen,Facile,1,Plus Facile,Pas Adapte
4750,2019,Information-Communication,1,Introduction a l'Etude du Langage,7,Le Developpement du Langage,7,307,2,QO,0.69,0.24,60.58,27,17,44,43,27,16,1.02,62.79,Facile,Moyen,-1,Plus Difficile,Pas Adapte
5861,2020,Information-Communication,1,Introduction a l'Etude du Langage,7,Le Developpement du Langage,7,307,2,QO,0.26,0.26,45.99,17,20,37,34,17,17,1.09,50.0,Moyen,Moyen,0,Meme Difficulté,Pas Adapte
307,2015,Information-Communication,1,Introduction a l'Etude du Langage,7,Le Developpement du Langage,7,308,3,QO,0.75,0.1,27.28,19,50,69,69,19,50,1.0,27.54,Moyen,Difficile,-1,Plus Difficile,Pas Adapte
1418,2016,Information-Communication,1,Introduction a l'Etude du Langage,7,Le Developpement du Langage,7,308,3,QO,0.5,0.17,56.51,35,27,62,44,35,9,1.41,79.55,Moyen,Moyen,0,Meme Difficulté,Pas Adapte
2529,2017,Information-Communication,1,Introduction a l'Etude du Langage,7,Le Developpement du Langage,7,308,3,QO,0.96,0.1,13.61,8,49,57,43,8,35,1.33,18.6,Facile,Difficile,-2,Beaucoup plus Difficile,Pas Adapte
3640,2018,Information-Communication,1,Introduction a l'Etude du Langage,7,Le Developpement du Langage,7,308,3,QO,0.2,0.41,74.0,47,16,63,53,47,6,1.19,88.68,Difficile,Facile,2,Beaucoup plus Facile,Adapte
4751,2019,Information-Communication,1,Introduction a l'Etude du Langage,7,Le Developpement du Langage,7,308,3,QROC,0.09,0.79,74.0,53,19,72,71,53,18,1.01,74.65,Facile,Facile,0,Meme Difficulté,Adapte
5862,2020,Information-Communication,1,Introduction a l'Etude du Langage,7,Le Developpement du Langage,7,308,3,QROC,0.1,0.43,74.0,56,19,75,67,56,11,1.12,83.58,Facile,Facile,0,Meme Difficulté,Adapte
308,2015,Information-Communication,1,Introduction a l'Etude du Langage,7,Le Developpement du Langage,7,309,4,QCM,0.12,0.8,69.0,49,22,71,50,49,1,1.42,98.0,Difficile,Facile,2,Beaucoup plus Facile,Adapte
1419,2016,Information-Communication,1,Introduction a l'Etude du Langage,7,Le Developpement du Langage,7,309,4,QCM,0.16,0.75,69.0,43,20,63,52,43,9,1.21,82.69,Facile,Facile,0,Meme Difficulté,Adapte
2530,2017,Information-Communication,1,Introduction a l'Etude du Langage,7,Le Developpement du Langage,7,309,4,QCM,0.09,0.71,69.0,39,17,56,46,39,7,1.22,84.78,Facile,Facile,0,Meme Difficulté,Adapte
3641,2018,Information-Communication,1,Introduction a l'Etude du Langage,7,Le Developpement du Langage,7,309,4,QCM,0.14,0.96,69.0,37,16,53,52,37,15,1.02,71.15,Facile,Facile,0,Meme Difficulté,Adapte
4752,2019,Information-Communication,1,Introduction a l'Etude du Langage,7,Le Developpement du Langage,7,309,4,QCM,0.08,0.87,69.0,37,16,53,47,37,10,1.13,78.72,Facile,Facile,0,Meme Difficulté,Adapte
5863,2020,Information-Communication,1,Introduction a l'Etude du Langage,7,Le Developpement du Langage,7,309,4,QCU,0.12,0.95,69.0,33,15,48,45,33,12,1.07,73.33,Facile,Facile,0,Meme Difficulté,Adapte
309,2015,Information-Communication,1,Introduction a l'Etude du Langage,7,Le Developpement du Langage,7,310,5,QCM,0.68,0.19,29.74,8,18,26,23,8,15,1.13,34.78,Difficile,Difficile,0,Meme Difficulté,Pas Adapte
1420,2016,Information-Communication,1,Introduction a l'Etude du Langage,7,Le Developpement du Langage,7,310,5,QCM,0.69,0.2,15.09,4,22,26,16,4,12,1.62,25.0,Difficile,Difficile,0,Meme Difficulté,Pas Adapte
2531,2017,Information-Communication,1,Introduction a l'Etude du Langage,7,Le Developpement du Langage,7,310,5,QCM,0.16,0.78,83.79,20,4,24,20,20,0,1.2,100.0,Facile,Facile,0,Meme Difficulté,Pas Adapte
3642,2018,Information-Communication,1,Introduction a l'Etude du Langage,7,Le Developpement du Langage,7,310,5,QCM,0.56,0.26,28.47,7,19,26,21,7,14,1.24,33.33,Difficile,Difficile,0,Meme Difficulté,Pas Adapte
4753,2019,Information-Communication,1,Introduction a l'Etude du Langage,7,Le Developpement du Langage,7,310,5,QCM,0.52,0.25,6.13,2,28,30,12,2,10,2.5,16.67,Moyen,Difficile,-1,Plus Difficile,Pas Adapte
5864,2020,Information-Communication,1,Introduction a l'Etude du Langage,7,Le Developpement du Langage,7,310,5,QCM,0.43,0.47,53.49,18,15,33,19,18,1,1.74,94.74,Difficile,Moyen,1,Plus Facile,Pas Adapte
310,2015,Information-Communication,1,Introduction a l'Etude du Langage,7,Le Developpement du Langage,7,311,6,QCU,0.33,0.44,61.8,25,15,40,29,25,4,1.38,86.21,Moyen,Moyen,0,Meme Difficulté,Pas Adapte
1421,2016,Information-Communication,1,Introduction a l'Etude du Langage,7,Le Developpement du Langage,7,311,6,QCU,0.34,0.53,45.31,18,21,39,27,18,9,1.44,66.67,Facile,Moyen,-1,Plus Difficile,Pas Adapte
2532,2017,Information-Communication,1,Introduction a l'Etude du Langage,7,Le Developpement du Langage,7,311,6,QROC,0.36,0.25,64.98,26,14,40,29,26,3,1.38,89.66,Facile,Moyen,-1,Plus Difficile,Pas Adapte
3643,2018,Information-Communication,1,Introduction a l'Etude du Langage,7,Le Developpement du Langage,7,311,6,QROC,0.13,0.64,73.33,26,10,36,34,26,8,1.06,76.47,Facile,Facile,0,Meme Difficulté,Adapte
4754,2019,Information-Communication,1,Introduction a l'Etude du Langage,7,Le Developpement du Langage,7,311,6,QROC,0.17,0.98,73.33,24,9,33,26,24,2,1.27,92.31,Facile,Facile,0,Meme Difficulté,Adapte
5865,2020,Information-Communication,1,Introduction a l'Etude du Langage,7,Le Developpement du Langage,7,311,6,QO,0.19,0.54,73.33,28,10,38,33,28,5,1.15,84.85,Facile,Facile,0,Meme Difficulté,Adapte
311,2015,Information-Communication,1,Introduction a l'Etude du Langage,7,Le Developpement du Langage,7,312,7,QCU,0.4,0.25,30.25,21,50,71,30,21,9,2.37,70.0,Difficile,Difficile,0,Meme Difficulté,Pas Adapte
1422,2016,Information-Communication,1,Introduction a l'Etude du Langage,7,Le Developpement du Langage,7,312,7,QCU,0.14,0.88,78.37,54,15,69,62,54,8,1.11,87.1,Difficile,Facile,2,Beaucoup plus Facile,Pas Adapte
2533,2017,Information-Communication,1,Introduction a l'Etude du Langage,7,Le Developpement du Langage,7,312,7,QCU,0.33,0.42,55.05,43,36,79,47,43,4,1.68,91.49,Difficile,Moyen,1,Plus Facile,Pas Adapte
3644,2018,Information-Communication,1,Introduction a l'Etude du Langage,7,Le Developpement du Langage,7,312,7,QO,0.37,0.22,50.04,38,38,76,49,38,11,1.55,77.55,Facile,Moyen,-1,Plus Difficile,Pas Adapte
4755,2019,Information-Communication,1,Introduction a l'Etude du Langage,7,Le Developpement du Langage,7,312,7,QO,0.16,0.65,83.56,72,14,86,78,72,6,1.1,92.31,Difficile,Facile,2,Beaucoup plus Facile,Pas Adapte
5866,2020,Information-Communication,1,Introduction a l'Etude du Langage,7,Le Developpement du Langage,7,312,7,QO,0.8,0.07,12.38,10,74,84,61,10,51,1.38,16.39,Facile,Difficile,-2,Beaucoup plus Difficile,Pas Adapte
312,2015,Information-Communication,1,Introduction a l'Etude du Langage,8,L'Apprentissage de la Langue Seconde,10,313,1,QCM,0.02,0.93,88.98,28,4,32,30,28,2,1.07,93.33,Moyen,Facile,1,Plus Facile,Pas Adapte
1423,2016,Information-Communication,1,Introduction a l'Etude du Langage,8,L'Apprentissage de la Langue Seconde,10,313,1,QCM,0.43,0.45,54.82,18,15,33,28,18,10,1.18,64.29,Moyen,Moyen,0,Meme Difficulté,Pas Adapte
2534,2017,Information-Communication,1,Introduction a l'Etude du Langage,8,L'Apprentissage de la Langue Seconde,10,313,1,QCM,0.25,0.47,56.35,16,12,28,21,16,5,1.33,76.19,Moyen,Moyen,0,Meme Difficulté,Pas Adapte
3645,2018,Information-Communication,1,Introduction a l'Etude du Langage,8,L'Apprentissage de la Langue Seconde,10,313,1,QCM,0.56,0.23,5.89,2,30,32,9,2,7,3.56,22.22,Facile,Difficile,-2,Beaucoup plus Difficile,Pas Adapte
4756,2019,Information-Communication,1,Introduction a l'Etude du Langage,8,L'Apprentissage de la Langue Seconde,10,313,1,QCM,0.27,0.47,57.88,21,16,37,27,21,6,1.37,77.78,Facile,Moyen,-1,Plus Difficile,Pas Adapte
5867,2020,Information-Communication,1,Introduction a l'Etude du Langage,8,L'Apprentissage de la Langue Seconde,10,313,1,QCM,0.35,0.68,53.25,22,19,41,37,22,15,1.11,59.46,Difficile,Moyen,1,Plus Facile,Pas Adapte
313,2015,Information-Communication,1,Introduction a l'Etude du Langage,8,L'Apprentissage de la Langue Seconde,10,314,2,QCM,0.18,0.77,66.47,5,3,8,6,5,1,1.33,83.33,Facile,Facile,0,Meme Difficulté,Adapte
1424,2016,Information-Communication,1,Introduction a l'Etude du Langage,8,L'Apprentissage de la Langue Seconde,10,314,2,QCM,0.11,1.0,66.47,6,3,9,7,6,1,1.29,85.71,Facile,Facile,0,Meme Difficulté,Adapte
2535,2017,Information-Communication,1,Introduction a l'Etude du Langage,8,L'Apprentissage de la Langue Seconde,10,314,2,QCM,0.01,0.78,66.47,7,3,10,9,7,2,1.11,77.78,Facile,Facile,0,Meme Difficulté,Adapte
3646,2018,Information-Communication,1,Introduction a l'Etude du Langage,8,L'Apprentissage de la Langue Seconde,10,314,2,QCM,0.09,0.8,66.47,5,3,8,5,5,0,1.6,100.0,Facile,Facile,0,Meme Difficulté,Adapte
4757,2019,Information-Communication,1,Introduction a l'Etude du Langage,8,L'Apprentissage de la Langue Seconde,10,314,2,QCM,0.1,0.86,66.47,6,3,9,9,6,3,1.0,66.67,Facile,Facile,0,Meme Difficulté,Adapte
5868,2020,Information-Communication,1,Introduction a l'Etude du Langage,8,L'Apprentissage de la Langue Seconde,10,314,2,QCU,0.09,0.85,66.47,5,3,8,6,5,1,1.33,83.33,Facile,Facile,0,Meme Difficulté,Adapte
314,2015,Information-Communication,1,Introduction a l'Etude du Langage,8,L'Apprentissage de la Langue Seconde,10,315,3,QCM,0.2,0.92,77.93,5,2,7,7,5,2,1.0,71.43,Moyen,Facile,1,Plus Facile,Pas Adapte
1425,2016,Information-Communication,1,Introduction a l'Etude du Langage,8,L'Apprentissage de la Langue Seconde,10,315,3,QCM,0.71,0.21,27.77,2,5,7,4,2,2,1.75,50.0,Difficile,Difficile,0,Meme Difficulté,Pas Adapte
2536,2017,Information-Communication,1,Introduction a l'Etude du Langage,8,L'Apprentissage de la Langue Seconde,10,315,3,QCM,0.51,0.25,16.74,1,7,8,6,1,5,1.33,16.67,Difficile,Difficile,0,Meme Difficulté,Pas Adapte
3647,2018,Information-Communication,1,Introduction a l'Etude du Langage,8,L'Apprentissage de la Langue Seconde,10,315,3,QCM,0.31,0.31,52.28,4,4,8,6,4,2,1.33,66.67,Moyen,Moyen,0,Meme Difficulté,Pas Adapte
4758,2019,Information-Communication,1,Introduction a l'Etude du Langage,8,L'Apprentissage de la Langue Seconde,10,315,3,QROC,0.27,0.39,54.76,4,4,8,4,4,0,2.0,100.0,Difficile,Moyen,1,Plus Facile,Pas Adapte
5869,2020,Information-Communication,1,Introduction a l'Etude du Langage,8,L'Apprentissage de la Langue Seconde,10,315,3,QROC,0.18,0.99,93.03,7,1,8,7,7,0,1.14,100.0,Facile,Facile,0,Meme Difficulté,Pas Adapte
315,2015,Information-Communication,1,Introduction a l'Etude du Langage,8,L'Apprentissage de la Langue Seconde,10,316,4,QCM,0.48,0.49,60.64,10,6,16,13,10,3,1.23,76.92,Facile,Moyen,-1,Plus Difficile,Pas Adapte
1426,2016,Information-Communication,1,Introduction a l'Etude du Langage,8,L'Apprentissage de la Langue Seconde,10,316,4,QCM,0.12,0.73,87.43,16,2,18,18,16,2,1.0,88.89,Facile,Facile,0,Meme Difficulté,Pas Adapte
2537,2017,Information-Communication,1,Introduction a l'Etude du Langage,8,L'Apprentissage de la Langue Seconde,10,316,4,QCU,0.02,0.8,78.99,15,4,19,15,15,0,1.27,100.0,Moyen,Facile,1,Plus Facile,Pas Adapte
3648,2018,Information-Communication,1,Introduction a l'Etude du Langage,8,L'Apprentissage de la Langue Seconde,10,316,4,QCU,0.02,0.86,67.49,15,7,22,17,15,2,1.29,88.24,Difficile,Facile,2,Beaucoup plus Facile,Adapte
4759,2019,Information-Communication,1,Introduction a l'Etude du Langage,8,L'Apprentissage de la Langue Seconde,10,316,4,QCU,0.13,0.87,67.49,16,8,24,22,16,6,1.09,72.73,Facile,Facile,0,Meme Difficulté,Adapte
5870,2020,Information-Communication,1,Introduction a l'Etude du Langage,8,L'Apprentissage de la Langue Seconde,10,316,4,QCU,0.1,0.8,67.49,18,9,27,26,18,8,1.04,69.23,Facile,Facile,0,Meme Difficulté,Adapte
316,2015,Information-Communication,1,Introduction a l'Etude du Langage,8,L'Apprentissage de la Langue Seconde,10,317,5,QCU,0.66,0.37,28.94,10,24,34,14,10,4,2.43,71.43,Facile,Difficile,-2,Beaucoup plus Difficile,Pas Adapte
1427,2016,Information-Communication,1,Introduction a l'Etude du Langage,8,L'Apprentissage de la Langue Seconde,10,317,5,QCU,0.74,0.38,17.43,6,31,37,29,6,23,1.28,20.69,Facile,Difficile,-2,Beaucoup plus Difficile,Pas Adapte
2538,2017,Information-Communication,1,Introduction a l'Etude du Langage,8,L'Apprentissage de la Langue Seconde,10,317,5,QCU,0.15,1.0,70.42,23,10,33,28,23,5,1.18,82.14,Facile,Facile,0,Meme Difficulté,Adapte
3649,2018,Information-Communication,1,Introduction a l'Etude du Langage,8,L'Apprentissage de la Langue Seconde,10,317,5,QCU,0.14,0.77,70.42,21,9,30,27,21,6,1.11,77.78,Facile,Facile,0,Meme Difficulté,Adapte
4760,2019,Information-Communication,1,Introduction a l'Etude du Langage,8,L'Apprentissage de la Langue Seconde,10,317,5,QCU,0.07,0.95,70.42,23,9,32,25,23,2,1.28,92.0,Facile,Facile,0,Meme Difficulté,Adapte
5871,2020,Information-Communication,1,Introduction a l'Etude du Langage,8,L'Apprentissage de la Langue Seconde,10,317,5,QCU,0.12,0.98,70.42,21,9,30,26,21,5,1.15,80.77,Facile,Facile,0,Meme Difficulté,Adapte
317,2015,Information-Communication,1,Introduction a l'Etude du Langage,8,L'Apprentissage de la Langue Seconde,10,318,6,QO,0.91,0.0,0.73,1,78,79,41,1,40,1.93,2.44,Facile,Difficile,-2,Beaucoup plus Difficile,Pas Adapte
1428,2016,Information-Communication,1,Introduction a l'Etude du Langage,8,L'Apprentissage de la Langue Seconde,10,318,6,QO,0.05,0.73,71.36,54,21,75,71,54,17,1.06,76.06,Difficile,Facile,2,Beaucoup plus Facile,Adapte
2539,2017,Information-Communication,1,Introduction a l'Etude du Langage,8,L'Apprentissage de la Langue Seconde,10,318,6,QO,0.08,0.66,71.36,50,20,70,67,50,17,1.04,74.63,Facile,Facile,0,Meme Difficulté,Adapte
3650,2018,Information-Communication,1,Introduction a l'Etude du Langage,8,L'Apprentissage de la Langue Seconde,10,318,6,QO,0.03,0.72,71.36,44,17,61,48,44,4,1.27,91.67,Facile,Facile,0,Meme Difficulté,Adapte
4761,2019,Information-Communication,1,Introduction a l'Etude du Langage,8,L'Apprentissage de la Langue Seconde,10,318,6,QO,0.16,0.37,71.36,48,19,67,63,48,15,1.06,76.19,Facile,Facile,0,Meme Difficulté,Adapte
5872,2020,Information-Communication,1,Introduction a l'Etude du Langage,8,L'Apprentissage de la Langue Seconde,10,318,6,QO,0.19,0.66,71.36,52,21,73,61,52,9,1.2,85.25,Facile,Facile,0,Meme Difficulté,Adapte
318,2015,Information-Communication,1,Introduction a l'Etude du Langage,8,L'Apprentissage de la Langue Seconde,10,319,7,QCU,0.3,0.46,54.27,28,24,52,37,28,9,1.41,75.68,Moyen,Moyen,0,Meme Difficulté,Pas Adapte
1429,2016,Information-Communication,1,Introduction a l'Etude du Langage,8,L'Apprentissage de la Langue Seconde,10,319,7,QCU,0.12,0.78,81.69,37,8,45,39,37,2,1.15,94.87,Facile,Facile,0,Meme Difficulté,Pas Adapte
2540,2017,Information-Communication,1,Introduction a l'Etude du Langage,8,L'Apprentissage de la Langue Seconde,10,319,7,QCU,0.37,0.44,61.47,25,15,40,26,25,1,1.54,96.15,Moyen,Moyen,0,Meme Difficulté,Pas Adapte
3651,2018,Information-Communication,1,Introduction a l'Etude du Langage,8,L'Apprentissage de la Langue Seconde,10,319,7,QCU,0.33,0.72,64.44,29,16,45,38,29,9,1.18,76.32,Facile,Moyen,-1,Plus Difficile,Pas Adapte
4762,2019,Information-Communication,1,Introduction a l'Etude du Langage,8,L'Apprentissage de la Langue Seconde,10,319,7,QCM,0.61,0.2,15.37,8,42,50,23,8,15,2.17,34.78,Facile,Difficile,-2,Beaucoup plus Difficile,Pas Adapte
5873,2020,Information-Communication,1,Introduction a l'Etude du Langage,8,L'Apprentissage de la Langue Seconde,10,319,7,QCM,0.34,0.67,52.01,25,24,49,43,25,18,1.14,58.14,Facile,Moyen,-1,Plus Difficile,Pas Adapte
319,2015,Information-Communication,1,Introduction a l'Etude du Langage,8,L'Apprentissage de la Langue Seconde,10,320,8,QCU,0.75,0.26,9.83,3,32,35,12,3,9,2.92,25.0,Difficile,Difficile,0,Meme Difficulté,Pas Adapte
1430,2016,Information-Communication,1,Introduction a l'Etude du Langage,8,L'Apprentissage de la Langue Seconde,10,320,8,QO,0.09,0.6,82.35,26,6,32,27,26,1,1.19,96.3,Difficile,Facile,2,Beaucoup plus Facile,Pas Adapte
2541,2017,Information-Communication,1,Introduction a l'Etude du Langage,8,L'Apprentissage de la Langue Seconde,10,320,8,QO,0.86,0.03,10.28,4,31,35,23,4,19,1.52,17.39,Facile,Difficile,-2,Beaucoup plus Difficile,Pas Adapte
3652,2018,Information-Communication,1,Introduction a l'Etude du Langage,8,L'Apprentissage de la Langue Seconde,10,320,8,QO,0.05,0.69,83.34,25,5,30,26,25,1,1.15,96.15,Facile,Facile,0,Meme Difficulté,Pas Adapte
4763,2019,Information-Communication,1,Introduction a l'Etude du Langage,8,L'Apprentissage de la Langue Seconde,10,320,8,QO,0.08,0.44,88.54,27,4,31,31,27,4,1.0,87.1,Moyen,Facile,1,Plus Facile,Pas Adapte
5874,2020,Information-Communication,1,Introduction a l'Etude du Langage,8,L'Apprentissage de la Langue Seconde,10,320,8,QO,0.14,0.55,88.0,25,3,28,26,25,1,1.08,96.15,Facile,Facile,0,Meme Difficulté,Pas Adapte
320,2015,Information-Communication,1,Introduction a l'Etude du Langage,8,L'Apprentissage de la Langue Seconde,10,321,9,QCM,0.68,0.23,3.78,2,46,48,34,2,32,1.41,5.88,Difficile,Difficile,0,Meme Difficulté,Pas Adapte
1431,2016,Information-Communication,1,Introduction a l'Etude du Langage,8,L'Apprentissage de la Langue Seconde,10,321,9,QCM,0.61,0.26,1.1,1,50,51,47,1,46,1.09,2.13,Difficile,Difficile,0,Meme Difficulté,Pas Adapte
2542,2017,Information-Communication,1,Introduction a l'Etude du Langage,8,L'Apprentissage de la Langue Seconde,10,321,9,QCU,0.06,0.83,84.35,42,8,50,46,42,4,1.09,91.3,Facile,Facile,0,Meme Difficulté,Pas Adapte
3653,2018,Information-Communication,1,Introduction a l'Etude du Langage,8,L'Apprentissage de la Langue Seconde,10,321,9,QCU,0.63,0.22,20.54,10,39,49,44,10,34,1.11,22.73,Moyen,Difficile,-1,Plus Difficile,Pas Adapte
4764,2019,Information-Communication,1,Introduction a l'Etude du Langage,8,L'Apprentissage de la Langue Seconde,10,321,9,QCU,0.08,0.79,88.68,46,6,52,52,46,6,1.0,88.46,Facile,Facile,0,Meme Difficulté,Pas Adapte
5875,2020,Information-Communication,1,Introduction a l'Etude du Langage,8,L'Apprentissage de la Langue Seconde,10,321,9,QCU,0.73,0.24,19.81,9,36,45,42,9,33,1.07,21.43,Moyen,Difficile,-1,Plus Difficile,Pas Adapte
321,2015,Information-Communication,1,Introduction a l'Etude du Langage,8,L'Apprentissage de la Langue Seconde,10,322,10,QCM,0.03,0.79,79.28,66,17,83,76,66,10,1.09,86.84,Difficile,Facile,2,Beaucoup plus Facile,Pas Adapte
1432,2016,Information-Communication,1,Introduction a l'Etude du Langage,8,L'Apprentissage de la Langue Seconde,10,322,10,QCM,0.54,0.17,28.89,26,65,91,38,26,12,2.39,68.42,Difficile,Difficile,0,Meme Difficulté,Pas Adapte
2543,2017,Information-Communication,1,Introduction a l'Etude du Langage,8,L'Apprentissage de la Langue Seconde,10,322,10,QCM,0.17,0.9,68.22,55,25,80,66,55,11,1.21,83.33,Moyen,Facile,1,Plus Facile,Adapte
3654,2018,Information-Communication,1,Introduction a l'Etude du Langage,8,L'Apprentissage de la Langue Seconde,10,322,10,QCM,0.02,0.77,68.22,60,28,88,65,60,5,1.35,92.31,Facile,Facile,0,Meme Difficulté,Adapte
4765,2019,Information-Communication,1,Introduction a l'Etude du Langage,8,L'Apprentissage de la Langue Seconde,10,322,10,QCM,0.12,0.89,68.22,55,25,80,76,55,21,1.05,72.37,Facile,Facile,0,Meme Difficulté,Adapte
5876,2020,Information-Communication,1,Introduction a l'Etude du Langage,8,L'Apprentissage de la Langue Seconde,10,322,10,QO,0.16,0.86,68.22,52,24,76,76,52,24,1.0,68.42,Facile,Facile,0,Meme Difficulté,Adapte
322,2015,Information-Communication,1,Introduction a l'Etude du Langage,9,La Sociolinguistique et la Dialectologie,12,323,1,QCU,0.34,0.45,41.2,33,47,80,39,33,6,2.05,84.62,Moyen,Moyen,0,Meme Difficulté,Pas Adapte
1433,2016,Information-Communication,1,Introduction a l'Etude du Langage,9,La Sociolinguistique et la Dialectologie,12,323,1,QCM,0.56,0.22,11.72,11,81,92,26,11,15,3.54,42.31,Facile,Difficile,-2,Beaucoup plus Difficile,Pas Adapte
2544,2017,Information-Communication,1,Introduction a l'Etude du Langage,9,La Sociolinguistique et la Dialectologie,12,323,1,QCM,0.47,0.57,62.69,53,32,85,58,53,5,1.47,91.38,Difficile,Moyen,1,Plus Facile,Pas Adapte
3655,2018,Information-Communication,1,Introduction a l'Etude du Langage,9,La Sociolinguistique et la Dialectologie,12,323,1,QCM,0.01,0.79,83.27,63,13,76,75,63,12,1.01,84.0,Difficile,Facile,2,Beaucoup plus Facile,Pas Adapte
4766,2019,Information-Communication,1,Introduction a l'Etude du Langage,9,La Sociolinguistique et la Dialectologie,12,323,1,QCU,0.62,0.22,21.21,14,53,67,51,14,37,1.31,27.45,Difficile,Difficile,0,Meme Difficulté,Pas Adapte
5877,2020,Information-Communication,1,Introduction a l'Etude du Langage,9,La Sociolinguistique et la Dialectologie,12,323,1,QCU,0.3,0.67,49.69,34,35,69,58,34,24,1.19,58.62,Difficile,Moyen,1,Plus Facile,Pas Adapte
323,2015,Information-Communication,1,Introduction a l'Etude du Langage,9,La Sociolinguistique et la Dialectologie,12,324,2,QCM,0.77,0.24,30.55,24,54,78,49,24,25,1.59,48.98,Difficile,Difficile,0,Meme Difficulté,Pas Adapte
1434,2016,Information-Communication,1,Introduction a l'Etude du Langage,9,La Sociolinguistique et la Dialectologie,12,324,2,QCM,0.24,0.33,42.53,29,39,68,35,29,6,1.94,82.86,Moyen,Moyen,0,Meme Difficulté,Pas Adapte
2545,2017,Information-Communication,1,Introduction a l'Etude du Langage,9,La Sociolinguistique et la Dialectologie,12,324,2,QCM,0.07,0.8,77.71,52,15,67,58,52,6,1.16,89.66,Difficile,Facile,2,Beaucoup plus Facile,Pas Adapte
3656,2018,Information-Communication,1,Introduction a l'Etude du Langage,9,La Sociolinguistique et la Dialectologie,12,324,2,QCU,0.52,0.28,33.27,23,45,68,61,23,38,1.11,37.7,Moyen,Difficile,-1,Plus Difficile,Pas Adapte
4767,2019,Information-Communication,1,Introduction a l'Etude du Langage,9,La Sociolinguistique et la Dialectologie,12,324,2,QCU,0.3,0.56,39.51,24,38,62,55,24,31,1.13,43.64,Moyen,Moyen,0,Meme Difficulté,Pas Adapte
5878,2020,Information-Communication,1,Introduction a l'Etude du Langage,9,La Sociolinguistique et la Dialectologie,12,324,2,QCU,0.62,0.28,8.84,6,57,63,57,6,51,1.11,10.53,Moyen,Difficile,-1,Plus Difficile,Pas Adapte
324,2015,Information-Communication,1,Introduction a l'Etude du Langage,9,La Sociolinguistique et la Dialectologie,12,325,3,QCU,0.36,0.57,35.48,7,12,19,13,7,6,1.46,53.85,Facile,Moyen,-1,Plus Difficile,Pas Adapte
1435,2016,Information-Communication,1,Introduction a l'Etude du Langage,9,La Sociolinguistique et la Dialectologie,12,325,3,QCU,0.34,0.51,50.5,10,9,19,12,10,2,1.58,83.33,Difficile,Moyen,1,Plus Facile,Pas Adapte
2546,2017,Information-Communication,1,Introduction a l'Etude du Langage,9,La Sociolinguistique et la Dialectologie,12,325,3,QCU,0.11,0.85,65.45,13,7,20,19,13,6,1.05,68.42,Facile,Facile,0,Meme Difficulté,Adapte
3657,2018,Information-Communication,1,Introduction a l'Etude du Langage,9,La Sociolinguistique et la Dialectologie,12,325,3,QCU,0.12,0.94,65.45,12,7,19,16,12,4,1.19,75.0,Facile,Facile,0,Meme Difficulté,Adapte
4768,2019,Information-Communication,1,Introduction a l'Etude du Langage,9,La Sociolinguistique et la Dialectologie,12,325,3,QCU,0.07,0.89,65.45,14,7,21,19,14,5,1.11,73.68,Facile,Facile,0,Meme Difficulté,Adapte
5879,2020,Information-Communication,1,Introduction a l'Etude du Langage,9,La Sociolinguistique et la Dialectologie,12,325,3,QCU,0.17,0.85,65.45,15,8,23,22,15,7,1.05,68.18,Facile,Facile,0,Meme Difficulté,Adapte
325,2015,Information-Communication,1,Introduction a l'Etude du Langage,9,La Sociolinguistique et la Dialectologie,12,326,4,QCM,0.45,0.51,58.05,34,25,59,46,34,12,1.28,73.91,Moyen,Moyen,0,Meme Difficulté,Pas Adapte
1436,2016,Information-Communication,1,Introduction a l'Etude du Langage,9,La Sociolinguistique et la Dialectologie,12,326,4,QCM,0.64,0.28,7.38,4,49,53,52,4,48,1.02,7.69,Difficile,Difficile,0,Meme Difficulté,Pas Adapte
2547,2017,Information-Communication,1,Introduction a l'Etude du Langage,9,La Sociolinguistique et la Dialectologie,12,326,4,QCM,0.33,0.64,39.45,19,28,47,37,19,18,1.27,51.35,Difficile,Moyen,1,Plus Facile,Pas Adapte
3658,2018,Information-Communication,1,Introduction a l'Etude du Langage,9,La Sociolinguistique et la Dialectologie,12,326,4,QCM,0.26,0.61,36.06,16,28,44,24,16,8,1.83,66.67,Difficile,Moyen,1,Plus Facile,Pas Adapte
4769,2019,Information-Communication,1,Introduction a l'Etude du Langage,9,La Sociolinguistique et la Dialectologie,12,326,4,QCU,0.7,0.28,21.56,8,31,39,32,8,24,1.22,25.0,Difficile,Difficile,0,Meme Difficulté,Pas Adapte
5880,2020,Information-Communication,1,Introduction a l'Etude du Langage,9,La Sociolinguistique et la Dialectologie,12,326,4,QCU,0.39,0.72,35.09,14,27,41,34,14,20,1.21,41.18,Moyen,Moyen,0,Meme Difficulté,Pas Adapte
326,2015,Information-Communication,1,Introduction a l'Etude du Langage,9,La Sociolinguistique et la Dialectologie,12,327,5,QCM,0.4,0.58,39.45,17,25,42,36,17,19,1.17,47.22,Difficile,Moyen,1,Plus Facile,Pas Adapte
1437,2016,Information-Communication,1,Introduction a l'Etude du Langage,9,La Sociolinguistique et la Dialectologie,12,327,5,QROC,0.54,0.26,54.76,25,20,45,37,25,12,1.22,67.57,Moyen,Moyen,0,Meme Difficulté,Pas Adapte
2548,2017,Information-Communication,1,Introduction a l'Etude du Langage,9,La Sociolinguistique et la Dialectologie,12,327,5,QROC,0.05,0.45,98.25,41,1,42,41,41,0,1.02,100.0,Difficile,Facile,2,Beaucoup plus Facile,Pas Adapte
3659,2018,Information-Communication,1,Introduction a l'Etude du Langage,9,La Sociolinguistique et la Dialectologie,12,327,5,QO,0.15,0.44,71.33,30,12,42,33,30,3,1.27,90.91,Facile,Facile,0,Meme Difficulté,Adapte
4770,2019,Information-Communication,1,Introduction a l'Etude du Langage,9,La Sociolinguistique et la Dialectologie,12,327,5,QO,0.07,0.96,71.33,31,12,43,36,31,5,1.19,86.11,Facile,Facile,0,Meme Difficulté,Adapte
5881,2020,Information-Communication,1,Introduction a l'Etude du Langage,9,La Sociolinguistique et la Dialectologie,12,327,5,QO,0.1,0.45,71.33,34,14,48,45,34,11,1.07,75.56,Facile,Facile,0,Meme Difficulté,Adapte
327,2015,Information-Communication,1,Introduction a l'Etude du Langage,9,La Sociolinguistique et la Dialectologie,12,328,6,QCU,0.55,0.2,24.04,9,29,38,16,9,7,2.38,56.25,Difficile,Difficile,0,Meme Difficulté,Pas Adapte
1438,2016,Information-Communication,1,Introduction a l'Etude du Langage,9,La Sociolinguistique et la Dialectologie,12,328,6,QCU,0.71,0.35,6.38,2,35,37,22,2,20,1.68,9.09,Facile,Difficile,-2,Beaucoup plus Difficile,Pas Adapte
2549,2017,Information-Communication,1,Introduction a l'Etude du Langage,9,La Sociolinguistique et la Dialectologie,12,328,6,QCU,0.09,0.97,88.06,38,5,43,41,38,3,1.05,92.68,Difficile,Facile,2,Beaucoup plus Facile,Pas Adapte
3660,2018,Information-Communication,1,Introduction a l'Etude du Langage,9,La Sociolinguistique et la Dialectologie,12,328,6,QCU,0.29,0.49,42.87,18,24,42,37,18,19,1.14,48.65,Facile,Moyen,-1,Plus Difficile,Pas Adapte
4771,2019,Information-Communication,1,Introduction a l'Etude du Langage,9,La Sociolinguistique et la Dialectologie,12,328,6,QCU,0.1,0.86,94.02,42,3,45,45,42,3,1.0,93.33,Facile,Facile,0,Meme Difficulté,Pas Adapte
5882,2020,Information-Communication,1,Introduction a l'Etude du Langage,9,La Sociolinguistique et la Dialectologie,12,328,6,QCU,0.2,0.46,47.1,24,27,51,31,24,7,1.65,77.42,Difficile,Moyen,1,Plus Facile,Pas Adapte
328,2015,Information-Communication,1,Introduction a l'Etude du Langage,9,La Sociolinguistique et la Dialectologie,12,329,7,QCU,0.43,0.37,31.71,5,11,16,16,5,11,1.0,31.25,Difficile,Difficile,0,Meme Difficulté,Pas Adapte
1439,2016,Information-Communication,1,Introduction a l'Etude du Langage,9,La Sociolinguistique et la Dialectologie,12,329,7,QCU,0.04,0.85,67.05,11,5,16,15,11,4,1.07,73.33,Facile,Facile,0,Meme Difficulté,Adapte
2550,2017,Information-Communication,1,Introduction a l'Etude du Langage,9,La Sociolinguistique et la Dialectologie,12,329,7,QCU,0.11,0.98,67.05,10,5,15,13,10,3,1.15,76.92,Facile,Facile,0,Meme Difficulté,Adapte
3661,2018,Information-Communication,1,Introduction a l'Etude du Langage,9,La Sociolinguistique et la Dialectologie,12,329,7,QCU,0.16,0.77,67.05,9,4,13,13,9,4,1.0,69.23,Facile,Facile,0,Meme Difficulté,Adapte
4772,2019,Information-Communication,1,Introduction a l'Etude du Langage,9,La Sociolinguistique et la Dialectologie,12,329,7,QCU,0.18,0.97,67.05,9,5,14,11,9,2,1.27,81.82,Facile,Facile,0,Meme Difficulté,Adapte
5883,2020,Information-Communication,1,Introduction a l'Etude du Langage,9,La Sociolinguistique et la Dialectologie,12,329,7,QCU,0.02,0.97,67.05,10,5,15,12,10,2,1.25,83.33,Facile,Facile,0,Meme Difficulté,Adapte
329,2015,Information-Communication,1,Introduction a l'Etude du Langage,9,La Sociolinguistique et la Dialectologie,12,330,8,QCM,0.35,0.57,55.99,7,5,12,8,7,1,1.5,87.5,Difficile,Moyen,1,Plus Facile,Pas Adapte
1440,2016,Information-Communication,1,Introduction a l'Etude du Langage,9,La Sociolinguistique et la Dialectologie,12,330,8,QCU,0.44,0.23,5.84,1,9,10,4,1,3,2.5,25.0,Facile,Difficile,-2,Beaucoup plus Difficile,Pas Adapte
2551,2017,Information-Communication,1,Introduction a l'Etude du Langage,9,La Sociolinguistique et la Dialectologie,12,330,8,QCU,0.7,0.33,2.83,0,8,8,7,0,7,1.14,0.0,Facile,Difficile,-2,Beaucoup plus Difficile,Pas Adapte
3662,2018,Information-Communication,1,Introduction a l'Etude du Langage,9,La Sociolinguistique et la Dialectologie,12,330,8,QCU,0.05,0.93,74.1,6,2,8,7,6,1,1.14,85.71,Facile,Facile,0,Meme Difficulté,Adapte
4773,2019,Information-Communication,1,Introduction a l'Etude du Langage,9,La Sociolinguistique et la Dialectologie,12,330,8,QCM,0.01,0.95,74.1,5,2,7,6,5,1,1.17,83.33,Facile,Facile,0,Meme Difficulté,Adapte
5884,2020,Information-Communication,1,Introduction a l'Etude du Langage,9,La Sociolinguistique et la Dialectologie,12,330,8,QCM,0.17,0.72,74.1,6,2,8,7,6,1,1.14,85.71,Facile,Facile,0,Meme Difficulté,Adapte
330,2015,Information-Communication,1,Introduction a l'Etude du Langage,9,La Sociolinguistique et la Dialectologie,12,331,9,QCM,0.08,0.74,92.61,84,7,91,89,84,5,1.02,94.38,Moyen,Facile,1,Plus Facile,Pas Adapte
1441,2016,Information-Communication,1,Introduction a l'Etude du Langage,9,La Sociolinguistique et la Dialectologie,12,331,9,QCM,0.35,0.38,58.63,57,40,97,59,57,2,1.64,96.61,Difficile,Moyen,1,Plus Facile,Pas Adapte
2552,2017,Information-Communication,1,Introduction a l'Etude du Langage,9,La Sociolinguistique et la Dialectologie,12,331,9,QCM,0.74,0.21,0.1,0,103,103,86,0,86,1.2,0.0,Facile,Difficile,-2,Beaucoup plus Difficile,Pas Adapte
3663,2018,Information-Communication,1,Introduction a l'Etude du Langage,9,La Sociolinguistique et la Dialectologie,12,331,9,QCM,0.04,0.89,84.98,100,18,118,112,100,12,1.05,89.29,Facile,Facile,0,Meme Difficulté,Pas Adapte
4774,2019,Information-Communication,1,Introduction a l'Etude du Langage,9,La Sociolinguistique et la Dialectologie,12,331,9,QCM,0.58,0.25,8.62,11,122,133,110,11,99,1.21,10.0,Facile,Difficile,-2,Beaucoup plus Difficile,Pas Adapte
5885,2020,Information-Communication,1,Introduction a l'Etude du Langage,9,La Sociolinguistique et la Dialectologie,12,331,9,QCM,0.52,0.26,2.94,4,116,120,54,4,50,2.22,7.41,Difficile,Difficile,0,Meme Difficulté,Pas Adapte
331,2015,Information-Communication,1,Introduction a l'Etude du Langage,9,La Sociolinguistique et la Dialectologie,12,332,10,QCM,0.07,0.79,80.55,49,12,61,50,49,1,1.22,98.0,Difficile,Facile,2,Beaucoup plus Facile,Pas Adapte
1442,2016,Information-Communication,1,Introduction a l'Etude du Langage,9,La Sociolinguistique et la Dialectologie,12,332,10,QCM,0.22,0.6,40.99,28,40,68,68,28,40,1.0,41.18,Facile,Moyen,-1,Plus Difficile,Pas Adapte
2553,2017,Information-Communication,1,Introduction a l'Etude du Langage,9,La Sociolinguistique et la Dialectologie,12,332,10,QCM,0.14,0.9,93.18,54,4,58,57,54,3,1.02,94.74,Facile,Facile,0,Meme Difficulté,Pas Adapte
3664,2018,Information-Communication,1,Introduction a l'Etude du Langage,9,La Sociolinguistique et la Dialectologie,12,332,10,QCM,0.78,0.23,2.98,2,59,61,25,2,23,2.44,8.0,Difficile,Difficile,0,Meme Difficulté,Pas Adapte
4775,2019,Information-Communication,1,Introduction a l'Etude du Langage,9,La Sociolinguistique et la Dialectologie,12,332,10,QCM,0.25,0.53,51.68,28,26,54,33,28,5,1.64,84.85,Moyen,Moyen,0,Meme Difficulté,Pas Adapte
5886,2020,Information-Communication,1,Introduction a l'Etude du Langage,9,La Sociolinguistique et la Dialectologie,12,332,10,QCM,0.38,0.51,59.16,28,19,47,29,28,1,1.62,96.55,Facile,Moyen,-1,Plus Difficile,Pas Adapte
332,2015,Information-Communication,1,Introduction a l'Etude du Langage,9,La Sociolinguistique et la Dialectologie,12,333,11,QCU,0.45,0.32,10.11,3,27,30,26,3,23,1.15,11.54,Facile,Difficile,-2,Beaucoup plus Difficile,Pas Adapte
1443,2016,Information-Communication,1,Introduction a l'Etude du Langage,9,La Sociolinguistique et la Dialectologie,12,333,11,QCU,0.02,0.94,69.39,18,8,26,22,18,4,1.18,81.82,Facile,Facile,0,Meme Difficulté,Adapte
2554,2017,Information-Communication,1,Introduction a l'Etude du Langage,9,La Sociolinguistique et la Dialectologie,12,333,11,QCU,0.03,0.77,69.39,18,8,26,21,18,3,1.24,85.71,Facile,Facile,0,Meme Difficulté,Adapte
3665,2018,Information-Communication,1,Introduction a l'Etude du Langage,9,La Sociolinguistique et la Dialectologie,12,333,11,QCM,0.04,0.8,69.39,18,8,26,26,18,8,1.0,69.23,Facile,Facile,0,Meme Difficulté,Adapte
4776,2019,Information-Communication,1,Introduction a l'Etude du Langage,9,La Sociolinguistique et la Dialectologie,12,333,11,QCM,0.1,0.71,69.39,19,8,27,24,19,5,1.12,79.17,Facile,Facile,0,Meme Difficulté,Adapte
5887,2020,Information-Communication,1,Introduction a l'Etude du Langage,9,La Sociolinguistique et la Dialectologie,12,333,11,QCM,0.12,0.76,69.39,19,9,28,24,19,5,1.17,79.17,Facile,Facile,0,Meme Difficulté,Adapte
333,2015,Information-Communication,1,Introduction a l'Etude du Langage,9,La Sociolinguistique et la Dialectologie,12,334,12,QCU,0.18,0.86,90.16,11,1,12,11,11,0,1.09,100.0,Moyen,Facile,1,Plus Facile,Pas Adapte
1444,2016,Information-Communication,1,Introduction a l'Etude du Langage,9,La Sociolinguistique et la Dialectologie,12,334,12,QCM,0.35,0.37,52.57,5,5,10,5,5,0,2.0,100.0,Facile,Moyen,-1,Plus Difficile,Pas Adapte
2555,2017,Information-Communication,1,Introduction a l'Etude du Langage,9,La Sociolinguistique et la Dialectologie,12,334,12,QCM,0.12,0.9,86.19,7,1,8,7,7,0,1.14,100.0,Facile,Facile,0,Meme Difficulté,Pas Adapte
3666,2018,Information-Communication,1,Introduction a l'Etude du Langage,9,La Sociolinguistique et la Dialectologie,12,334,12,QCM,0.41,0.37,47.22,4,5,9,8,4,4,1.12,50.0,Difficile,Moyen,1,Plus Facile,Pas Adapte
4777,2019,Information-Communication,1,Introduction a l'Etude du Langage,9,La Sociolinguistique et la Dialectologie,12,334,12,QCM,0.02,0.87,82.17,7,1,8,8,7,1,1.0,87.5,Facile,Facile,0,Meme Difficulté,Pas Adapte
5888,2020,Information-Communication,1,Introduction a l'Etude du Langage,9,La Sociolinguistique et la Dialectologie,12,334,12,QCM,0.32,0.38,62.24,4,3,7,6,4,2,1.17,66.67,Facile,Moyen,-1,Plus Difficile,Pas Adapte
334,2015,Information-Communication,1,Introduction a l'Etude du Langage,10,L'Amenagement Linguistique,13,335,1,QCM,0.47,0.69,40.53,25,36,61,55,25,30,1.11,45.45,Moyen,Moyen,0,Meme Difficulté,Pas Adapte
1445,2016,Information-Communication,1,Introduction a l'Etude du Langage,10,L'Amenagement Linguistique,13,335,1,QCM,0.04,0.85,97.76,60,1,61,61,60,1,1.0,98.36,Difficile,Facile,2,Beaucoup plus Facile,Pas Adapte
2556,2017,Information-Communication,1,Introduction a l'Etude du Langage,10,L'Amenagement Linguistique,13,335,1,QCM,0.08,0.91,65.5,42,22,64,53,42,11,1.21,79.25,Facile,Facile,0,Meme Difficulté,Adapte
3667,2018,Information-Communication,1,Introduction a l'Etude du Langage,10,L'Amenagement Linguistique,13,335,1,QCM,0.11,0.72,65.5,45,23,68,53,45,8,1.28,84.91,Facile,Facile,0,Meme Difficulté,Adapte
4778,2019,Information-Communication,1,Introduction a l'Etude du Langage,10,L'Amenagement Linguistique,13,335,1,QCM,0.12,0.96,65.5,48,26,74,59,48,11,1.25,81.36,Facile,Facile,0,Meme Difficulté,Adapte
5889,2020,Information-Communication,1,Introduction a l'Etude du Langage,10,L'Amenagement Linguistique,13,335,1,QCM,0.14,0.87,65.5,47,24,71,64,47,17,1.11,73.44,Facile,Facile,0,Meme Difficulté,Adapte
335,2015,Information-Communication,1,Introduction a l'Etude du Langage,10,L'Amenagement Linguistique,13,336,2,QCU,0.51,0.29,14.86,10,55,65,53,10,43,1.23,18.87,Facile,Difficile,-2,Beaucoup plus Difficile,Pas Adapte
1446,2016,Information-Communication,1,Introduction a l'Etude du Langage,10,L'Amenagement Linguistique,13,336,2,QCU,0.67,0.21,22.75,14,46,60,43,14,29,1.4,32.56,Moyen,Difficile,-1,Plus Difficile,Pas Adapte
2557,2017,Information-Communication,1,Introduction a l'Etude du Langage,10,L'Amenagement Linguistique,13,336,2,QCM,0.75,0.25,3.36,2,63,65,26,2,24,2.5,7.69,Facile,Difficile,-2,Beaucoup plus Difficile,Pas Adapte
3668,2018,Information-Communication,1,Introduction a l'Etude du Langage,10,L'Amenagement Linguistique,13,336,2,QCM,0.18,0.75,71.55,49,20,69,64,49,15,1.08,76.56,Difficile,Facile,2,Beaucoup plus Facile,Adapte
4779,2019,Information-Communication,1,Introduction a l'Etude du Langage,10,L'Amenagement Linguistique,13,336,2,QCM,0.14,0.95,71.55,45,18,63,45,45,0,1.4,100.0,Facile,Facile,0,Meme Difficulté,Adapte
5890,2020,Information-Communication,1,Introduction a l'Etude du Langage,10,L'Amenagement Linguistique,13,336,2,QCM,0.15,0.76,71.55,39,16,55,46,39,7,1.2,84.78,Facile,Facile,0,Meme Difficulté,Adapte
336,2015,Information-Communication,1,Introduction a l'Etude du Langage,10,L'Amenagement Linguistique,13,337,3,QCM,0.7,0.25,8.73,2,18,20,13,2,11,1.54,15.38,Moyen,Difficile,-1,Plus Difficile,Pas Adapte
1447,2016,Information-Communication,1,Introduction a l'Etude du Langage,10,L'Amenagement Linguistique,13,337,3,QCM,0.21,0.43,63.69,13,8,21,13,13,0,1.62,100.0,Difficile,Moyen,1,Plus Facile,Pas Adapte
2558,2017,Information-Communication,1,Introduction a l'Etude du Langage,10,L'Amenagement Linguistique,13,337,3,QCM,0.36,0.49,58.16,13,9,22,16,13,3,1.38,81.25,Difficile,Moyen,1,Plus Facile,Pas Adapte
3669,2018,Information-Communication,1,Introduction a l'Etude du Langage,10,L'Amenagement Linguistique,13,337,3,QCM,0.06,0.88,68.86,17,8,25,21,17,4,1.19,80.95,Difficile,Facile,2,Beaucoup plus Facile,Adapte
4780,2019,Information-Communication,1,Introduction a l'Etude du Langage,10,L'Amenagement Linguistique,13,337,3,QCM,0.0,0.83,68.86,19,8,27,21,19,2,1.29,90.48,Facile,Facile,0,Meme Difficulté,Adapte
5891,2020,Information-Communication,1,Introduction a l'Etude du Langage,10,L'Amenagement Linguistique,13,337,3,QCM,0.19,0.89,68.86,20,9,29,20,20,0,1.45,100.0,Facile,Facile,0,Meme Difficulté,Adapte
337,2015,Information-Communication,1,Introduction a l'Etude du Langage,10,L'Amenagement Linguistique,13,338,4,QCM,0.59,0.2,12.48,9,60,69,46,9,37,1.5,19.57,Facile,Difficile,-2,Beaucoup plus Difficile,Pas Adapte
1448,2016,Information-Communication,1,Introduction a l'Etude du Langage,10,L'Amenagement Linguistique,13,338,4,QCM,0.79,0.24,31.65,20,43,63,51,20,31,1.24,39.22,Difficile,Difficile,0,Meme Difficulté,Pas Adapte
2559,2017,Information-Communication,1,Introduction a l'Etude du Langage,10,L'Amenagement Linguistique,13,338,4,QCM,0.09,0.83,88.23,49,6,55,49,49,0,1.12,100.0,Difficile,Facile,2,Beaucoup plus Facile,Pas Adapte
3670,2018,Information-Communication,1,Introduction a l'Etude du Langage,10,L'Amenagement Linguistique,13,338,4,QCM,0.15,0.94,70.02,34,14,48,36,34,2,1.33,94.44,Moyen,Facile,1,Plus Facile,Adapte
4781,2019,Information-Communication,1,Introduction a l'Etude du Langage,10,L'Amenagement Linguistique,13,338,4,QCM,0.06,0.77,70.02,33,14,47,42,33,9,1.12,78.57,Facile,Facile,0,Meme Difficulté,Adapte
5892,2020,Information-Communication,1,Introduction a l'Etude du Langage,10,L'Amenagement Linguistique,13,338,4,QCM,0.19,0.89,70.02,31,13,44,42,31,11,1.05,73.81,Facile,Facile,0,Meme Difficulté,Adapte
338,2015,Information-Communication,1,Introduction a l'Etude du Langage,10,L'Amenagement Linguistique,13,339,5,QCU,0.47,0.21,2.08,1,65,66,65,1,64,1.02,1.54,Moyen,Difficile,-1,Plus Difficile,Pas Adapte
1449,2016,Information-Communication,1,Introduction a l'Etude du Langage,10,L'Amenagement Linguistique,13,339,5,QCU,0.35,0.74,42.31,24,32,56,35,24,11,1.6,68.57,Moyen,Moyen,0,Meme Difficulté,Pas Adapte
2560,2017,Information-Communication,1,Introduction a l'Etude du Langage,10,L'Amenagement Linguistique,13,339,5,QCU,0.36,0.42,38.71,24,39,63,27,24,3,2.33,88.89,Difficile,Moyen,1,Plus Facile,Pas Adapte
3671,2018,Information-Communication,1,Introduction a l'Etude du Langage,10,L'Amenagement Linguistique,13,339,5,QCU,0.32,0.55,45.14,30,36,66,58,30,28,1.14,51.72,Difficile,Moyen,1,Plus Facile,Pas Adapte
4782,2019,Information-Communication,1,Introduction a l'Etude du Langage,10,L'Amenagement Linguistique,13,339,5,QCU,0.32,0.49,41.13,26,38,64,30,26,4,2.13,86.67,Moyen,Moyen,0,Meme Difficulté,Pas Adapte
5893,2020,Information-Communication,1,Introduction a l'Etude du Langage,10,L'Amenagement Linguistique,13,339,5,QCU,0.62,0.31,25.14,14,42,56,46,14,32,1.22,30.43,Moyen,Difficile,-1,Plus Difficile,Pas Adapte
339,2015,Information-Communication,1,Introduction a l'Etude du Langage,10,L'Amenagement Linguistique,13,340,6,QROC,0.79,0.22,34.41,34,64,98,98,34,64,1.0,34.69,Moyen,Difficile,-1,Plus Difficile,Pas Adapte
1450,2016,Information-Communication,1,Introduction a l'Etude du Langage,10,L'Amenagement Linguistique,13,340,6,QO,0.81,0.07,18.86,18,76,94,54,18,36,1.74,33.33,Moyen,Difficile,-1,Plus Difficile,Pas Adapte
2561,2017,Information-Communication,1,Introduction a l'Etude du Langage,10,L'Amenagement Linguistique,13,340,6,QROC,0.61,0.05,26.54,25,70,95,94,25,69,1.01,26.6,Facile,Difficile,-2,Beaucoup plus Difficile,Pas Adapte
3672,2018,Information-Communication,1,Introduction a l'Etude du Langage,10,L'Amenagement Linguistique,13,340,6,QROC,0.99,0.0,11.57,10,75,85,53,10,43,1.6,18.87,Moyen,Difficile,-1,Plus Difficile,Pas Adapte
4783,2019,Information-Communication,1,Introduction a l'Etude du Langage,10,L'Amenagement Linguistique,13,340,6,QROC,0.81,0.16,18.67,15,65,80,62,15,47,1.29,24.19,Moyen,Difficile,-1,Plus Difficile,Pas Adapte
5894,2020,Information-Communication,1,Introduction a l'Etude du Langage,10,L'Amenagement Linguistique,13,340,6,QROC,0.02,0.75,70.45,53,22,75,73,53,20,1.03,72.6,Difficile,Facile,2,Beaucoup plus Facile,Adapte
340,2015,Information-Communication,1,Introduction a l'Etude du Langage,10,L'Amenagement Linguistique,13,341,7,QCU,0.12,0.93,74.99,22,8,30,23,22,1,1.3,95.65,Facile,Facile,0,Meme Difficulté,Adapte
1451,2016,Information-Communication,1,Introduction a l'Etude du Langage,10,L'Amenagement Linguistique,13,341,7,QCU,0.06,0.98,74.99,25,8,33,31,25,6,1.06,80.65,Facile,Facile,0,Meme Difficulté,Adapte
2562,2017,Information-Communication,1,Introduction a l'Etude du Langage,10,L'Amenagement Linguistique,13,341,7,QCU,0.09,0.89,74.99,23,8,31,27,23,4,1.15,85.19,Facile,Facile,0,Meme Difficulté,Adapte
3673,2018,Information-Communication,1,Introduction a l'Etude du Langage,10,L'Amenagement Linguistique,13,341,7,QCU,0.17,0.82,74.99,24,8,32,27,24,3,1.19,88.89,Facile,Facile,0,Meme Difficulté,Adapte
4784,2019,Information-Communication,1,Introduction a l'Etude du Langage,10,L'Amenagement Linguistique,13,341,7,QCU,0.14,0.85,74.99,25,9,34,29,25,4,1.17,86.21,Facile,Facile,0,Meme Difficulté,Adapte
5895,2020,Information-Communication,1,Introduction a l'Etude du Langage,10,L'Amenagement Linguistique,13,341,7,QCU,0.16,0.92,74.99,27,9,36,27,27,0,1.33,100.0,Facile,Facile,0,Meme Difficulté,Adapte
341,2015,Information-Communication,1,Introduction a l'Etude du Langage,10,L'Amenagement Linguistique,13,342,8,QCU,0.74,0.26,31.02,29,65,94,90,29,61,1.04,32.22,Facile,Difficile,-2,Beaucoup plus Difficile,Pas Adapte
1452,2016,Information-Communication,1,Introduction a l'Etude du Langage,10,L'Amenagement Linguistique,13,342,8,QCU,0.51,0.3,17.94,16,74,90,61,16,45,1.48,26.23,Difficile,Difficile,0,Meme Difficulté,Pas Adapte
2563,2017,Information-Communication,1,Introduction a l'Etude du Langage,10,L'Amenagement Linguistique,13,342,8,QCU,0.61,0.29,11.92,12,88,100,41,12,29,2.44,29.27,Moyen,Difficile,-1,Plus Difficile,Pas Adapte
3674,2018,Information-Communication,1,Introduction a l'Etude du Langage,10,L'Amenagement Linguistique,13,342,8,QCU,0.68,0.38,17.88,17,77,94,69,17,52,1.36,24.64,Moyen,Difficile,-1,Plus Difficile,Pas Adapte
4785,2019,Information-Communication,1,Introduction a l'Etude du Langage,10,L'Amenagement Linguistique,13,342,8,QCU,0.26,0.47,64.71,67,36,103,73,67,6,1.41,91.78,Moyen,Moyen,0,Meme Difficulté,Pas Adapte
5896,2020,Information-Communication,1,Introduction a l'Etude du Langage,10,L'Amenagement Linguistique,13,342,8,QCU,0.57,0.28,29.31,32,76,108,89,32,57,1.21,35.96,Difficile,Difficile,0,Meme Difficulté,Pas Adapte
342,2015,Information-Communication,1,Introduction a l'Etude du Langage,10,L'Amenagement Linguistique,13,343,9,QROC,0.34,0.36,48.81,24,26,50,37,24,13,1.35,64.86,Difficile,Moyen,1,Plus Facile,Pas Adapte
1453,2016,Information-Communication,1,Introduction a l'Etude du Langage,10,L'Amenagement Linguistique,13,343,9,QROC,0.05,0.63,79.97,40,10,50,44,40,4,1.14,90.91,Moyen,Facile,1,Plus Facile,Pas Adapte
2564,2017,Information-Communication,1,Introduction a l'Etude du Langage,10,L'Amenagement Linguistique,13,343,9,QO,0.16,0.99,80.58,46,11,57,52,46,6,1.1,88.46,Difficile,Facile,2,Beaucoup plus Facile,Pas Adapte
3675,2018,Information-Communication,1,Introduction a l'Etude du Langage,10,L'Amenagement Linguistique,13,343,9,QO,0.97,0.02,24.63,12,36,48,35,12,23,1.37,34.29,Moyen,Difficile,-1,Plus Difficile,Pas Adapte
4786,2019,Information-Communication,1,Introduction a l'Etude du Langage,10,L'Amenagement Linguistique,13,343,9,QO,0.86,0.1,7.39,4,51,55,53,4,49,1.04,7.55,Facile,Difficile,-2,Beaucoup plus Difficile,Pas Adapte
5897,2020,Information-Communication,1,Introduction a l'Etude du Langage,10,L'Amenagement Linguistique,13,343,9,QROC,0.74,0.17,7.11,4,55,59,48,4,44,1.23,8.33,Facile,Difficile,-2,Beaucoup plus Difficile,Pas Adapte
343,2015,Information-Communication,1,Introduction a l'Etude du Langage,10,L'Amenagement Linguistique,13,344,10,QCU,0.22,0.6,55.75,4,3,7,6,4,2,1.17,66.67,Facile,Moyen,-1,Plus Difficile,Pas Adapte
1454,2016,Information-Communication,1,Introduction a l'Etude du Langage,10,L'Amenagement Linguistique,13,344,10,QCU,0.11,0.97,71.94,4,2,6,5,4,1,1.2,80.0,Moyen,Facile,1,Plus Facile,Adapte
2565,2017,Information-Communication,1,Introduction a l'Etude du Langage,10,L'Amenagement Linguistique,13,344,10,QCU,0.01,0.94,71.94,5,2,7,7,5,2,1.0,71.43,Facile,Facile,0,Meme Difficulté,Adapte
3676,2018,Information-Communication,1,Introduction a l'Etude du Langage,10,L'Amenagement Linguistique,13,344,10,QCU,0.04,0.78,71.94,5,2,7,6,5,1,1.17,83.33,Facile,Facile,0,Meme Difficulté,Adapte
4787,2019,Information-Communication,1,Introduction a l'Etude du Langage,10,L'Amenagement Linguistique,13,344,10,QCU,0.15,0.86,71.94,6,2,8,7,6,1,1.14,85.71,Facile,Facile,0,Meme Difficulté,Adapte
5898,2020,Information-Communication,1,Introduction a l'Etude du Langage,10,L'Amenagement Linguistique,13,344,10,QCU,0.17,0.76,71.94,6,2,8,7,6,1,1.14,85.71,Facile,Facile,0,Meme Difficulté,Adapte
344,2015,Information-Communication,1,Introduction a l'Etude du Langage,10,L'Amenagement Linguistique,13,345,11,QCM,0.75,0.25,31.91,24,52,76,54,24,30,1.41,44.44,Facile,Difficile,-2,Beaucoup plus Difficile,Pas Adapte
1455,2016,Information-Communication,1,Introduction a l'Etude du Langage,10,L'Amenagement Linguistique,13,345,11,QCM,0.54,0.25,30.52,23,54,77,68,23,45,1.13,33.82,Difficile,Difficile,0,Meme Difficulté,Pas Adapte
2566,2017,Information-Communication,1,Introduction a l'Etude du Langage,10,L'Amenagement Linguistique,13,345,11,QCU,0.23,0.71,60.06,45,30,75,71,45,26,1.06,63.38,Moyen,Moyen,0,Meme Difficulté,Pas Adapte
3677,2018,Information-Communication,1,Introduction a l'Etude du Langage,10,L'Amenagement Linguistique,13,345,11,QCU,0.53,0.38,18.32,15,67,82,30,15,15,2.73,50.0,Facile,Difficile,-2,Beaucoup plus Difficile,Pas Adapte
4788,2019,Information-Communication,1,Introduction a l'Etude du Langage,10,L'Amenagement Linguistique,13,345,11,QCU,0.22,0.61,64.43,57,31,88,60,57,3,1.47,95.0,Difficile,Moyen,1,Plus Facile,Pas Adapte
5899,2020,Information-Communication,1,Introduction a l'Etude du Langage,10,L'Amenagement Linguistique,13,345,11,QCU,0.28,0.59,64.78,64,35,99,81,64,17,1.22,79.01,Difficile,Moyen,1,Plus Facile,Pas Adapte
345,2015,Information-Communication,1,Introduction a l'Etude du Langage,10,L'Amenagement Linguistique,13,346,12,QCM,0.38,0.55,57.69,18,13,31,30,18,12,1.03,60.0,Difficile,Moyen,1,Plus Facile,Pas Adapte
1456,2016,Information-Communication,1,Introduction a l'Etude du Langage,10,L'Amenagement Linguistique,13,346,12,QCM,0.33,0.6,44.09,13,17,30,28,13,15,1.07,46.43,Moyen,Moyen,0,Meme Difficulté,Pas Adapte
2567,2017,Information-Communication,1,Introduction a l'Etude du Langage,10,L'Amenagement Linguistique,13,346,12,QCM,0.35,0.55,35.78,10,18,28,20,10,10,1.4,50.0,Difficile,Moyen,1,Plus Facile,Pas Adapte
3678,2018,Information-Communication,1,Introduction a l'Etude du Langage,10,L'Amenagement Linguistique,13,346,12,QCM,0.52,0.27,25.21,7,19,26,25,7,18,1.04,28.0,Moyen,Difficile,-1,Plus Difficile,Pas Adapte
4789,2019,Information-Communication,1,Introduction a l'Etude du Langage,10,L'Amenagement Linguistique,13,346,12,QCM,0.2,0.9,88.49,26,3,29,27,26,1,1.07,96.3,Facile,Facile,0,Meme Difficulté,Pas Adapte
5900,2020,Information-Communication,1,Introduction a l'Etude du Langage,10,L'Amenagement Linguistique,13,346,12,QCM,0.53,0.22,22.93,8,25,33,20,8,12,1.65,40.0,Difficile,Difficile,0,Meme Difficulté,Pas Adapte
346,2015,Information-Communication,1,Introduction a l'Etude du Langage,10,L'Amenagement Linguistique,13,347,13,QCU,0.09,0.86,86.69,70,11,81,76,70,6,1.07,92.11,Facile,Facile,0,Meme Difficulté,Pas Adapte
1457,2016,Information-Communication,1,Introduction a l'Etude du Langage,10,L'Amenagement Linguistique,13,347,13,QCU,0.26,0.44,37.04,33,56,89,39,33,6,2.28,84.62,Moyen,Moyen,0,Meme Difficulté,Pas Adapte
2568,2017,Information-Communication,1,Introduction a l'Etude du Langage,10,L'Amenagement Linguistique,13,347,13,QCU,0.7,0.35,23.1,22,75,97,55,22,33,1.76,40.0,Moyen,Difficile,-1,Plus Difficile,Pas Adapte
3679,2018,Information-Communication,1,Introduction a l'Etude du Langage,10,L'Amenagement Linguistique,13,347,13,QCU,0.43,0.27,17.42,19,90,109,103,19,84,1.06,18.45,Moyen,Difficile,-1,Plus Difficile,Pas Adapte
4790,2019,Information-Communication,1,Introduction a l'Etude du Langage,10,L'Amenagement Linguistique,13,347,13,QCU,0.4,0.61,40.28,49,73,122,55,49,6,2.22,89.09,Facile,Moyen,-1,Plus Difficile,Pas Adapte
5901,2020,Information-Communication,1,Introduction a l'Etude du Langage,10,L'Amenagement Linguistique,13,347,13,QCU,0.54,0.33,9.82,12,110,122,45,12,33,2.71,26.67,Facile,Difficile,-2,Beaucoup plus Difficile,Pas Adapte
347,2015,Information-Communication,2,Grammaire Lexicale Fonctionnelle,1,Les Traits Syntaxiques,6,348,1,QCM,0.66,0.26,6.85,6,85,91,81,6,75,1.12,7.41,Moyen,Difficile,-1,Plus Difficile,Pas Adapte
1458,2016,Information-Communication,2,Grammaire Lexicale Fonctionnelle,1,Les Traits Syntaxiques,6,348,1,QCM,0.35,0.32,56.96,44,34,78,48,44,4,1.62,91.67,Moyen,Moyen,0,Meme Difficulté,Pas Adapte
2569,2017,Information-Communication,2,Grammaire Lexicale Fonctionnelle,1,Les Traits Syntaxiques,6,348,1,QCM,0.16,0.74,86.9,65,10,75,68,65,3,1.1,95.59,Moyen,Facile,1,Plus Facile,Pas Adapte
3680,2018,Information-Communication,2,Grammaire Lexicale Fonctionnelle,1,Les Traits Syntaxiques,6,348,1,QCM,0.01,0.96,94.7,77,4,81,79,77,2,1.03,97.47,Facile,Facile,0,Meme Difficulté,Pas Adapte
4791,2019,Information-Communication,2,Grammaire Lexicale Fonctionnelle,1,Les Traits Syntaxiques,6,348,1,QCM,0.37,0.3,63.71,45,26,71,66,45,21,1.08,68.18,Difficile,Moyen,1,Plus Facile,Pas Adapte
5902,2020,Information-Communication,2,Grammaire Lexicale Fonctionnelle,1,Les Traits Syntaxiques,6,348,1,QCU,0.05,0.87,88.75,56,7,63,60,56,4,1.05,93.33,Moyen,Facile,1,Plus Facile,Pas Adapte
348,2015,Information-Communication,2,Grammaire Lexicale Fonctionnelle,1,Les Traits Syntaxiques,6,349,2,QCU,0.04,0.98,86.62,87,13,100,93,87,6,1.08,93.55,Difficile,Facile,2,Beaucoup plus Facile,Pas Adapte
1459,2016,Information-Communication,2,Grammaire Lexicale Fonctionnelle,1,Les Traits Syntaxiques,6,349,2,QCM,0.26,0.37,60.83,57,37,94,93,57,36,1.01,61.29,Facile,Moyen,-1,Plus Difficile,Pas Adapte
2570,2017,Information-Communication,2,Grammaire Lexicale Fonctionnelle,1,Les Traits Syntaxiques,6,349,2,QCM,0.47,0.44,50.18,41,40,81,71,41,30,1.14,57.75,Facile,Moyen,-1,Plus Difficile,Pas Adapte
3681,2018,Information-Communication,2,Grammaire Lexicale Fonctionnelle,1,Les Traits Syntaxiques,6,349,2,QCM,0.77,0.17,32.16,23,50,73,69,23,46,1.06,33.33,Moyen,Difficile,-1,Plus Difficile,Pas Adapte
4792,2019,Information-Communication,2,Grammaire Lexicale Fonctionnelle,1,Les Traits Syntaxiques,6,349,2,QCM,0.53,0.24,15.4,11,61,72,43,11,32,1.67,25.58,Facile,Difficile,-2,Beaucoup plus Difficile,Pas Adapte
5903,2020,Information-Communication,2,Grammaire Lexicale Fonctionnelle,1,Les Traits Syntaxiques,6,349,2,QCM,0.16,0.79,87.75,61,8,69,65,61,4,1.06,93.85,Moyen,Facile,1,Plus Facile,Pas Adapte
349,2015,Information-Communication,2,Grammaire Lexicale Fonctionnelle,1,Les Traits Syntaxiques,6,350,3,QROC,0.78,0.05,25.11,4,12,16,7,4,3,2.29,57.14,Difficile,Difficile,0,Meme Difficulté,Pas Adapte
1460,2016,Information-Communication,2,Grammaire Lexicale Fonctionnelle,1,Les Traits Syntaxiques,6,350,3,QROC,0.08,0.77,65.38,12,6,18,16,12,4,1.12,75.0,Moyen,Facile,1,Plus Facile,Adapte
2571,2017,Information-Communication,2,Grammaire Lexicale Fonctionnelle,1,Les Traits Syntaxiques,6,350,3,QROC,0.17,0.81,65.38,12,7,19,18,12,6,1.06,66.67,Facile,Facile,0,Meme Difficulté,Adapte
3682,2018,Information-Communication,2,Grammaire Lexicale Fonctionnelle,1,Les Traits Syntaxiques,6,350,3,QCM,0.17,0.76,65.38,14,8,22,16,14,2,1.38,87.5,Facile,Facile,0,Meme Difficulté,Adapte
4793,2019,Information-Communication,2,Grammaire Lexicale Fonctionnelle,1,Les Traits Syntaxiques,6,350,3,QCM,0.1,0.93,65.38,16,9,25,24,16,8,1.04,66.67,Facile,Facile,0,Meme Difficulté,Adapte
5904,2020,Information-Communication,2,Grammaire Lexicale Fonctionnelle,1,Les Traits Syntaxiques,6,350,3,QCM,0.08,0.73,65.38,17,9,26,20,17,3,1.3,85.0,Facile,Facile,0,Meme Difficulté,Adapte
350,2015,Information-Communication,2,Grammaire Lexicale Fonctionnelle,1,Les Traits Syntaxiques,6,351,4,QCU,0.6,0.39,8.29,5,59,64,29,5,24,2.21,17.24,Facile,Difficile,-2,Beaucoup plus Difficile,Pas Adapte
1461,2016,Information-Communication,2,Grammaire Lexicale Fonctionnelle,1,Les Traits Syntaxiques,6,351,4,QCU,0.32,0.62,41.18,26,36,62,33,26,7,1.88,78.79,Moyen,Moyen,0,Meme Difficulté,Pas Adapte
2572,2017,Information-Communication,2,Grammaire Lexicale Fonctionnelle,1,Les Traits Syntaxiques,6,351,4,QCU,0.36,0.73,45.59,30,36,66,59,30,29,1.12,50.85,Facile,Moyen,-1,Plus Difficile,Pas Adapte
3683,2018,Information-Communication,2,Grammaire Lexicale Fonctionnelle,1,Les Traits Syntaxiques,6,351,4,QCU,0.11,0.78,66.2,44,23,67,54,44,10,1.24,81.48,Difficile,Facile,2,Beaucoup plus Facile,Adapte
4794,2019,Information-Communication,2,Grammaire Lexicale Fonctionnelle,1,Les Traits Syntaxiques,6,351,4,QCU,0.09,0.97,66.2,51,26,77,66,51,15,1.17,77.27,Facile,Facile,0,Meme Difficulté,Adapte
5905,2020,Information-Communication,2,Grammaire Lexicale Fonctionnelle,1,Les Traits Syntaxiques,6,351,4,QCU,0.15,0.95,66.2,43,22,65,46,43,3,1.41,93.48,Facile,Facile,0,Meme Difficulté,Adapte
351,2015,Information-Communication,2,Grammaire Lexicale Fonctionnelle,1,Les Traits Syntaxiques,6,352,5,QCM,0.72,0.15,0.7,0,45,45,14,0,14,3.21,0.0,Facile,Difficile,-2,Beaucoup plus Difficile,Pas Adapte
1462,2016,Information-Communication,2,Grammaire Lexicale Fonctionnelle,1,Les Traits Syntaxiques,6,352,5,QCM,0.67,0.24,34.03,13,26,39,22,13,9,1.77,59.09,Moyen,Difficile,-1,Plus Difficile,Pas Adapte
2573,2017,Information-Communication,2,Grammaire Lexicale Fonctionnelle,1,Les Traits Syntaxiques,6,352,5,QCM,0.28,0.57,60.54,26,17,43,29,26,3,1.48,89.66,Moyen,Moyen,0,Meme Difficulté,Pas Adapte
3684,2018,Information-Communication,2,Grammaire Lexicale Fonctionnelle,1,Les Traits Syntaxiques,6,352,5,QCM,0.79,0.18,33.46,15,30,45,40,15,25,1.12,37.5,Facile,Difficile,-2,Beaucoup plus Difficile,Pas Adapte
4795,2019,Information-Communication,2,Grammaire Lexicale Fonctionnelle,1,Les Traits Syntaxiques,6,352,5,QCM,0.26,0.47,64.5,28,16,44,31,28,3,1.42,90.32,Moyen,Moyen,0,Meme Difficulté,Pas Adapte
5906,2020,Information-Communication,2,Grammaire Lexicale Fonctionnelle,1,Les Traits Syntaxiques,6,352,5,QCM,0.75,0.18,29.49,12,30,42,34,12,22,1.24,35.29,Difficile,Difficile,0,Meme Difficulté,Pas Adapte
352,2015,Information-Communication,2,Grammaire Lexicale Fonctionnelle,1,Les Traits Syntaxiques,6,353,6,QCM,0.59,0.22,5.28,0,5,5,3,0,3,1.67,0.0,Difficile,Difficile,0,Meme Difficulté,Pas Adapte
1463,2016,Information-Communication,2,Grammaire Lexicale Fonctionnelle,1,Les Traits Syntaxiques,6,353,6,QCU,0.33,0.68,46.8,2,3,5,3,2,1,1.67,66.67,Moyen,Moyen,0,Meme Difficulté,Pas Adapte
2574,2017,Information-Communication,2,Grammaire Lexicale Fonctionnelle,1,Les Traits Syntaxiques,6,353,6,QCU,0.48,0.27,6.41,0,4,4,3,0,3,1.33,0.0,Facile,Difficile,-2,Beaucoup plus Difficile,Pas Adapte
3685,2018,Information-Communication,2,Grammaire Lexicale Fonctionnelle,1,Les Traits Syntaxiques,6,353,6,QCU,0.06,0.81,91.71,3,0,3,3,3,0,1.0,100.0,Difficile,Facile,2,Beaucoup plus Facile,Pas Adapte
4796,2019,Information-Communication,2,Grammaire Lexicale Fonctionnelle,1,Les Traits Syntaxiques,6,353,6,QCU,0.73,0.21,33.82,1,2,3,1,1,0,3.0,100.0,Facile,Difficile,-2,Beaucoup plus Difficile,Pas Adapte
5907,2020,Information-Communication,2,Grammaire Lexicale Fonctionnelle,1,Les Traits Syntaxiques,6,353,6,QCM,0.65,0.28,1.03,0,3,3,2,0,2,1.5,0.0,Facile,Difficile,-2,Beaucoup plus Difficile,Pas Adapte
353,2015,Information-Communication,2,Grammaire Lexicale Fonctionnelle,2,Les Fonctions,14,354,1,QCM,0.64,0.15,8.19,6,62,68,22,6,16,3.09,27.27,Difficile,Difficile,0,Meme Difficulté,Pas Adapte
1464,2016,Information-Communication,2,Grammaire Lexicale Fonctionnelle,2,Les Fonctions,14,354,1,QCU,0.01,0.82,93.7,58,4,62,58,58,0,1.07,100.0,Facile,Facile,0,Meme Difficulté,Pas Adapte
2575,2017,Information-Communication,2,Grammaire Lexicale Fonctionnelle,2,Les Fonctions,14,354,1,QCU,0.44,0.23,25.45,15,45,60,60,15,45,1.0,25.0,Facile,Difficile,-2,Beaucoup plus Difficile,Pas Adapte
3686,2018,Information-Communication,2,Grammaire Lexicale Fonctionnelle,2,Les Fonctions,14,354,1,QCU,0.37,0.46,35.57,20,37,57,31,20,11,1.84,64.52,Facile,Moyen,-1,Plus Difficile,Pas Adapte
4797,2019,Information-Communication,2,Grammaire Lexicale Fonctionnelle,2,Les Fonctions,14,354,1,QCU,0.28,0.46,48.77,26,28,54,30,26,4,1.8,86.67,Facile,Moyen,-1,Plus Difficile,Pas Adapte
5908,2020,Information-Communication,2,Grammaire Lexicale Fonctionnelle,2,Les Fonctions,14,354,1,QCU,0.43,0.23,9.69,5,47,52,34,5,29,1.53,14.71,Facile,Difficile,-2,Beaucoup plus Difficile,Pas Adapte
354,2015,Information-Communication,2,Grammaire Lexicale Fonctionnelle,2,Les Fonctions,14,355,2,QO,0.8,0.14,27.01,11,31,42,32,11,21,1.31,34.38,Moyen,Difficile,-1,Plus Difficile,Pas Adapte
1465,2016,Information-Communication,2,Grammaire Lexicale Fonctionnelle,2,Les Fonctions,14,355,2,QO,0.47,0.25,56.71,24,19,43,31,24,7,1.39,77.42,Facile,Moyen,-1,Plus Difficile,Pas Adapte
2576,2017,Information-Communication,2,Grammaire Lexicale Fonctionnelle,2,Les Fonctions,14,355,2,QO,0.9,0.09,34.35,16,31,47,34,16,18,1.38,47.06,Facile,Difficile,-2,Beaucoup plus Difficile,Pas Adapte
3687,2018,Information-Communication,2,Grammaire Lexicale Fonctionnelle,2,Les Fonctions,14,355,2,QO,0.9,0.1,11.19,5,37,42,23,5,18,1.83,21.74,Moyen,Difficile,-1,Plus Difficile,Pas Adapte
4798,2019,Information-Communication,2,Grammaire Lexicale Fonctionnelle,2,Les Fonctions,14,355,2,QO,0.65,0.25,57.19,26,19,45,31,26,5,1.45,83.87,Facile,Moyen,-1,Plus Difficile,Pas Adapte
5909,2020,Information-Communication,2,Grammaire Lexicale Fonctionnelle,2,Les Fonctions,14,355,2,QO,0.56,0.27,49.4,24,24,48,38,24,14,1.26,63.16,Facile,Moyen,-1,Plus Difficile,Pas Adapte
355,2015,Information-Communication,2,Grammaire Lexicale Fonctionnelle,2,Les Fonctions,14,356,3,QCU,0.44,0.4,12.11,10,72,82,76,10,66,1.08,13.16,Facile,Difficile,-2,Beaucoup plus Difficile,Pas Adapte
1466,2016,Information-Communication,2,Grammaire Lexicale Fonctionnelle,2,Les Fonctions,14,356,3,QCU,0.13,0.83,71.53,51,21,72,53,51,2,1.36,96.23,Moyen,Facile,1,Plus Facile,Adapte
2577,2017,Information-Communication,2,Grammaire Lexicale Fonctionnelle,2,Les Fonctions,14,356,3,QCU,0.04,0.98,71.53,46,18,64,60,46,14,1.07,76.67,Facile,Facile,0,Meme Difficulté,Adapte
3688,2018,Information-Communication,2,Grammaire Lexicale Fonctionnelle,2,Les Fonctions,14,356,3,QCU,0.03,0.84,71.53,41,17,58,56,41,15,1.04,73.21,Facile,Facile,0,Meme Difficulté,Adapte
4799,2019,Information-Communication,2,Grammaire Lexicale Fonctionnelle,2,Les Fonctions,14,356,3,QCU,0.16,0.75,71.53,37,15,52,37,37,0,1.41,100.0,Facile,Facile,0,Meme Difficulté,Adapte
5910,2020,Information-Communication,2,Grammaire Lexicale Fonctionnelle,2,Les Fonctions,14,356,3,QROC,0.03,0.66,71.53,35,14,49,37,35,2,1.32,94.59,Facile,Facile,0,Meme Difficulté,Adapte
356,2015,Information-Communication,2,Grammaire Lexicale Fonctionnelle,2,Les Fonctions,14,357,4,QCU,0.12,0.89,70.86,32,13,45,36,32,4,1.25,88.89,Moyen,Facile,1,Plus Facile,Adapte
1467,2016,Information-Communication,2,Grammaire Lexicale Fonctionnelle,2,Les Fonctions,14,357,4,QCU,0.03,0.95,70.86,27,11,38,32,27,5,1.19,84.38,Facile,Facile,0,Meme Difficulté,Adapte
2578,2017,Information-Communication,2,Grammaire Lexicale Fonctionnelle,2,Les Fonctions,14,357,4,QCM,0.08,0.84,70.86,28,12,40,37,28,9,1.08,75.68,Facile,Facile,0,Meme Difficulté,Adapte
3689,2018,Information-Communication,2,Grammaire Lexicale Fonctionnelle,2,Les Fonctions,14,357,4,QCM,0.12,0.74,70.86,31,13,44,39,31,8,1.13,79.49,Facile,Facile,0,Meme Difficulté,Adapte
4800,2019,Information-Communication,2,Grammaire Lexicale Fonctionnelle,2,Les Fonctions,14,357,4,QCU,0.17,0.99,70.86,35,15,50,47,35,12,1.06,74.47,Facile,Facile,0,Meme Difficulté,Adapte
5911,2020,Information-Communication,2,Grammaire Lexicale Fonctionnelle,2,Les Fonctions,14,357,4,QCU,0.15,0.93,70.86,34,14,48,45,34,11,1.07,75.56,Facile,Facile,0,Meme Difficulté,Adapte
357,2015,Information-Communication,2,Grammaire Lexicale Fonctionnelle,2,Les Fonctions,14,358,5,QCU,0.73,0.23,6.83,2,34,36,35,2,33,1.03,5.71,Facile,Difficile,-2,Beaucoup plus Difficile,Pas Adapte
1468,2016,Information-Communication,2,Grammaire Lexicale Fonctionnelle,2,Les Fonctions,14,358,5,QCU,0.71,0.24,25.72,8,23,31,26,8,18,1.19,30.77,Difficile,Difficile,0,Meme Difficulté,Pas Adapte
2579,2017,Information-Communication,2,Grammaire Lexicale Fonctionnelle,2,Les Fonctions,14,358,5,QCM,0.64,0.16,16.74,5,27,32,28,5,23,1.14,17.86,Difficile,Difficile,0,Meme Difficulté,Pas Adapte
3690,2018,Information-Communication,2,Grammaire Lexicale Fonctionnelle,2,Les Fonctions,14,358,5,QO,0.28,0.24,46.25,17,19,36,25,17,8,1.44,68.0,Difficile,Moyen,1,Plus Facile,Pas Adapte
4801,2019,Information-Communication,2,Grammaire Lexicale Fonctionnelle,2,Les Fonctions,14,358,5,QO,0.84,0.07,14.05,6,34,40,24,6,18,1.67,25.0,Difficile,Difficile,0,Meme Difficulté,Pas Adapte
5912,2020,Information-Communication,2,Grammaire Lexicale Fonctionnelle,2,Les Fonctions,14,358,5,QO,0.8,0.05,24.49,11,33,44,28,11,17,1.57,39.29,Facile,Difficile,-2,Beaucoup plus Difficile,Pas Adapte
358,2015,Information-Communication,2,Grammaire Lexicale Fonctionnelle,2,Les Fonctions,14,359,6,QCU,0.37,0.44,37.14,8,14,22,13,8,5,1.69,61.54,Facile,Moyen,-1,Plus Difficile,Pas Adapte
1469,2016,Information-Communication,2,Grammaire Lexicale Fonctionnelle,2,Les Fonctions,14,359,6,QCU,0.64,0.27,23.03,4,15,19,17,4,13,1.12,23.53,Difficile,Difficile,0,Meme Difficulté,Pas Adapte
2580,2017,Information-Communication,2,Grammaire Lexicale Fonctionnelle,2,Les Fonctions,14,359,6,QCU,0.06,0.77,98.98,20,0,20,20,20,0,1.0,100.0,Moyen,Facile,1,Plus Facile,Pas Adapte
3691,2018,Information-Communication,2,Grammaire Lexicale Fonctionnelle,2,Les Fonctions,14,359,6,QCU,0.63,0.27,5.52,1,17,18,18,1,17,1.0,5.56,Facile,Difficile,-2,Beaucoup plus Difficile,Pas Adapte
4802,2019,Information-Communication,2,Grammaire Lexicale Fonctionnelle,2,Les Fonctions,14,359,6,QCU,0.36,0.68,56.39,12,9,21,14,12,2,1.5,85.71,Moyen,Moyen,0,Meme Difficulté,Pas Adapte
5913,2020,Information-Communication,2,Grammaire Lexicale Fonctionnelle,2,Les Fonctions,14,359,6,QCU,0.51,0.33,31.78,7,14,21,13,7,6,1.62,53.85,Facile,Difficile,-2,Beaucoup plus Difficile,Pas Adapte
359,2015,Information-Communication,2,Grammaire Lexicale Fonctionnelle,2,Les Fonctions,14,360,7,QCM,0.63,0.19,31.63,27,59,86,72,27,45,1.19,37.5,Difficile,Difficile,0,Meme Difficulté,Pas Adapte
1470,2016,Information-Communication,2,Grammaire Lexicale Fonctionnelle,2,Les Fonctions,14,360,7,QCM,0.7,0.16,25.05,22,65,87,79,22,57,1.1,27.85,Moyen,Difficile,-1,Plus Difficile,Pas Adapte
2581,2017,Information-Communication,2,Grammaire Lexicale Fonctionnelle,2,Les Fonctions,14,360,7,QCM,0.2,0.94,71.69,62,24,86,82,62,20,1.05,75.61,Moyen,Facile,1,Plus Facile,Adapte
3692,2018,Information-Communication,2,Grammaire Lexicale Fonctionnelle,2,Les Fonctions,14,360,7,QCM,0.18,0.89,71.69,65,25,90,68,65,3,1.32,95.59,Facile,Facile,0,Meme Difficulté,Adapte
4803,2019,Information-Communication,2,Grammaire Lexicale Fonctionnelle,2,Les Fonctions,14,360,7,QCU,0.02,1.0,71.69,72,29,101,76,72,4,1.33,94.74,Facile,Facile,0,Meme Difficulté,Adapte
5914,2020,Information-Communication,2,Grammaire Lexicale Fonctionnelle,2,Les Fonctions,14,360,7,QCU,0.01,0.97,71.69,66,26,92,86,66,20,1.07,76.74,Facile,Facile,0,Meme Difficulté,Adapte
360,2015,Information-Communication,2,Grammaire Lexicale Fonctionnelle,2,Les Fonctions,14,361,8,QCU,0.29,0.49,62.39,29,18,47,47,29,18,1.0,61.7,Facile,Moyen,-1,Plus Difficile,Pas Adapte
1471,2016,Information-Communication,2,Grammaire Lexicale Fonctionnelle,2,Les Fonctions,14,361,8,QCU,0.18,0.92,78.84,39,10,49,48,39,9,1.02,81.25,Moyen,Facile,1,Plus Facile,Pas Adapte
2582,2017,Information-Communication,2,Grammaire Lexicale Fonctionnelle,2,Les Fonctions,14,361,8,QCM,0.23,0.39,58.59,28,19,47,40,28,12,1.18,70.0,Difficile,Moyen,1,Plus Facile,Pas Adapte
3693,2018,Information-Communication,2,Grammaire Lexicale Fonctionnelle,2,Les Fonctions,14,361,8,QCM,0.16,0.96,76.34,39,12,51,39,39,0,1.31,100.0,Moyen,Facile,1,Plus Facile,Pas Adapte
4804,2019,Information-Communication,2,Grammaire Lexicale Fonctionnelle,2,Les Fonctions,14,361,8,QCU,0.34,0.42,35.99,18,33,51,21,18,3,2.43,85.71,Facile,Moyen,-1,Plus Difficile,Pas Adapte
5915,2020,Information-Communication,2,Grammaire Lexicale Fonctionnelle,2,Les Fonctions,14,361,8,QCU,0.37,0.53,46.1,21,24,45,35,21,14,1.29,60.0,Moyen,Moyen,0,Meme Difficulté,Pas Adapte
361,2015,Information-Communication,2,Grammaire Lexicale Fonctionnelle,2,Les Fonctions,14,362,9,QCU,0.29,0.54,42.08,32,45,77,46,32,14,1.67,69.57,Facile,Moyen,-1,Plus Difficile,Pas Adapte
1472,2016,Information-Communication,2,Grammaire Lexicale Fonctionnelle,2,Les Fonctions,14,362,9,QCU,0.56,0.34,27.27,21,55,76,32,21,11,2.38,65.62,Difficile,Difficile,0,Meme Difficulté,Pas Adapte
2583,2017,Information-Communication,2,Grammaire Lexicale Fonctionnelle,2,Les Fonctions,14,362,9,QCU,0.39,0.53,42.53,36,48,84,41,36,5,2.05,87.8,Moyen,Moyen,0,Meme Difficulté,Pas Adapte
3694,2018,Information-Communication,2,Grammaire Lexicale Fonctionnelle,2,Les Fonctions,14,362,9,QCU,0.24,0.65,45.86,34,41,75,40,34,6,1.88,85.0,Facile,Moyen,-1,Plus Difficile,Pas Adapte
4805,2019,Information-Communication,2,Grammaire Lexicale Fonctionnelle,2,Les Fonctions,14,362,9,QCM,0.11,0.87,96.47,65,2,67,66,65,1,1.02,98.48,Facile,Facile,0,Meme Difficulté,Pas Adapte
5916,2020,Information-Communication,2,Grammaire Lexicale Fonctionnelle,2,Les Fonctions,14,362,9,QCM,0.35,0.51,41.45,30,43,73,31,30,1,2.35,96.77,Facile,Moyen,-1,Plus Difficile,Pas Adapte
362,2015,Information-Communication,2,Grammaire Lexicale Fonctionnelle,2,Les Fonctions,14,363,10,QCM,0.46,0.47,64.33,20,11,31,28,20,8,1.11,71.43,Moyen,Moyen,0,Meme Difficulté,Pas Adapte
1473,2016,Information-Communication,2,Grammaire Lexicale Fonctionnelle,2,Les Fonctions,14,363,10,QCU,0.37,0.54,36.63,12,20,32,19,12,7,1.68,63.16,Facile,Moyen,-1,Plus Difficile,Pas Adapte
2584,2017,Information-Communication,2,Grammaire Lexicale Fonctionnelle,2,Les Fonctions,14,363,10,QCU,0.68,0.32,24.22,7,21,28,21,7,14,1.33,33.33,Moyen,Difficile,-1,Plus Difficile,Pas Adapte
3695,2018,Information-Communication,2,Grammaire Lexicale Fonctionnelle,2,Les Fonctions,14,363,10,QCM,0.19,0.72,87.19,27,4,31,30,27,3,1.03,90.0,Moyen,Facile,1,Plus Facile,Pas Adapte
4806,2019,Information-Communication,2,Grammaire Lexicale Fonctionnelle,2,Les Fonctions,14,363,10,QCM,0.4,0.65,61.68,17,10,27,21,17,4,1.29,80.95,Moyen,Moyen,0,Meme Difficulté,Pas Adapte
5917,2020,Information-Communication,2,Grammaire Lexicale Fonctionnelle,2,Les Fonctions,14,363,10,QCM,0.03,0.81,82.17,25,5,30,26,25,1,1.15,96.15,Facile,Facile,0,Meme Difficulté,Pas Adapte
363,2015,Information-Communication,2,Grammaire Lexicale Fonctionnelle,2,Les Fonctions,14,364,11,QCU,0.08,0.97,85.53,67,11,78,74,67,7,1.05,90.54,Difficile,Facile,2,Beaucoup plus Facile,Pas Adapte
1474,2016,Information-Communication,2,Grammaire Lexicale Fonctionnelle,2,Les Fonctions,14,364,11,QCU,0.2,0.72,58.56,50,36,86,73,50,23,1.18,68.49,Difficile,Moyen,1,Plus Facile,Pas Adapte
2585,2017,Information-Communication,2,Grammaire Lexicale Fonctionnelle,2,Les Fonctions,14,364,11,QCU,0.07,0.87,92.9,76,6,82,80,76,4,1.02,95.0,Moyen,Facile,1,Plus Facile,Pas Adapte
3696,2018,Information-Communication,2,Grammaire Lexicale Fonctionnelle,2,Les Fonctions,14,364,11,QCU,0.04,0.8,86.79,79,12,91,90,79,11,1.01,87.78,Difficile,Facile,2,Beaucoup plus Facile,Pas Adapte
4807,2019,Information-Communication,2,Grammaire Lexicale Fonctionnelle,2,Les Fonctions,14,364,11,QCU,0.44,0.31,18.16,18,80,98,61,18,43,1.61,29.51,Facile,Difficile,-2,Beaucoup plus Difficile,Pas Adapte
5918,2020,Information-Communication,2,Grammaire Lexicale Fonctionnelle,2,Les Fonctions,14,364,11,QCU,0.61,0.35,33.08,28,56,84,47,28,19,1.79,59.57,Moyen,Difficile,-1,Plus Difficile,Pas Adapte
364,2015,Information-Communication,2,Grammaire Lexicale Fonctionnelle,2,Les Fonctions,14,365,12,QROC,0.58,0.39,37.02,8,14,22,18,8,10,1.22,44.44,Facile,Moyen,-1,Plus Difficile,Pas Adapte
1475,2016,Information-Communication,2,Grammaire Lexicale Fonctionnelle,2,Les Fonctions,14,365,12,QROC,0.36,0.29,53.64,10,9,19,11,10,1,1.73,90.91,Facile,Moyen,-1,Plus Difficile,Pas Adapte
2586,2017,Information-Communication,2,Grammaire Lexicale Fonctionnelle,2,Les Fonctions,14,365,12,QCM,0.64,0.2,34.14,7,14,21,9,7,2,2.33,77.78,Difficile,Difficile,0,Meme Difficulté,Pas Adapte
3697,2018,Information-Communication,2,Grammaire Lexicale Fonctionnelle,2,Les Fonctions,14,365,12,QCM,0.1,0.89,81.02,19,4,23,19,19,0,1.21,100.0,Facile,Facile,0,Meme Difficulté,Pas Adapte
4808,2019,Information-Communication,2,Grammaire Lexicale Fonctionnelle,2,Les Fonctions,14,365,12,QCM,0.51,0.18,25.34,6,19,25,20,6,14,1.25,30.0,Moyen,Difficile,-1,Plus Difficile,Pas Adapte
5919,2020,Information-Communication,2,Grammaire Lexicale Fonctionnelle,2,Les Fonctions,14,365,12,QCM,0.26,0.61,44.38,10,12,22,21,10,11,1.05,47.62,Facile,Moyen,-1,Plus Difficile,Pas Adapte
365,2015,Information-Communication,2,Grammaire Lexicale Fonctionnelle,2,Les Fonctions,14,366,13,QCU,0.63,0.27,30.42,5,11,16,9,5,4,1.78,55.56,Facile,Difficile,-2,Beaucoup plus Difficile,Pas Adapte
1476,2016,Information-Communication,2,Grammaire Lexicale Fonctionnelle,2,Les Fonctions,14,366,13,QCU,0.35,0.64,49.7,7,7,14,10,7,3,1.4,70.0,Facile,Moyen,-1,Plus Difficile,Pas Adapte
2587,2017,Information-Communication,2,Grammaire Lexicale Fonctionnelle,2,Les Fonctions,14,366,13,QCU,0.57,0.31,12.54,2,10,12,7,2,5,1.71,28.57,Facile,Difficile,-2,Beaucoup plus Difficile,Pas Adapte
3698,2018,Information-Communication,2,Grammaire Lexicale Fonctionnelle,2,Les Fonctions,14,366,13,QCU,0.7,0.25,22.57,3,9,12,11,3,8,1.09,27.27,Difficile,Difficile,0,Meme Difficulté,Pas Adapte
4809,2019,Information-Communication,2,Grammaire Lexicale Fonctionnelle,2,Les Fonctions,14,366,13,QCM,0.26,0.65,62.99,6,4,10,6,6,0,1.67,100.0,Difficile,Moyen,1,Plus Facile,Pas Adapte
5920,2020,Information-Communication,2,Grammaire Lexicale Fonctionnelle,2,Les Fonctions,14,366,13,QCM,0.24,0.41,56.05,7,5,12,10,7,3,1.2,70.0,Difficile,Moyen,1,Plus Facile,Pas Adapte
366,2015,Information-Communication,2,Grammaire Lexicale Fonctionnelle,2,Les Fonctions,14,367,14,QROC,0.45,0.28,40.04,8,12,20,10,8,2,2.0,80.0,Difficile,Moyen,1,Plus Facile,Pas Adapte
1477,2016,Information-Communication,2,Grammaire Lexicale Fonctionnelle,2,Les Fonctions,14,367,14,QROC,0.28,0.34,51.63,11,11,22,12,11,1,1.83,91.67,Difficile,Moyen,1,Plus Facile,Pas Adapte
2588,2017,Information-Communication,2,Grammaire Lexicale Fonctionnelle,2,Les Fonctions,14,367,14,QROC,0.11,0.56,74.56,17,6,23,19,17,2,1.21,89.47,Facile,Facile,0,Meme Difficulté,Adapte
3699,2018,Information-Communication,2,Grammaire Lexicale Fonctionnelle,2,Les Fonctions,14,367,14,QROC,0.09,0.45,74.56,19,7,26,23,19,4,1.13,82.61,Facile,Facile,0,Meme Difficulté,Adapte
4810,2019,Information-Communication,2,Grammaire Lexicale Fonctionnelle,2,Les Fonctions,14,367,14,QO,0.16,0.64,74.56,21,7,28,22,21,1,1.27,95.45,Facile,Facile,0,Meme Difficulté,Adapte
5921,2020,Information-Communication,2,Grammaire Lexicale Fonctionnelle,2,Les Fonctions,14,367,14,QO,0.01,0.46,74.56,18,6,24,19,18,1,1.26,94.74,Facile,Facile,0,Meme Difficulté,Adapte
367,2015,Information-Communication,2,Grammaire Lexicale Fonctionnelle,3,Ecrire une Grammaire Lexicale Fonctionnelle,8,368,1,QCM,0.52,0.15,25.61,7,22,29,26,7,19,1.12,26.92,Facile,Difficile,-2,Beaucoup plus Difficile,Pas Adapte
1478,2016,Information-Communication,2,Grammaire Lexicale Fonctionnelle,3,Ecrire une Grammaire Lexicale Fonctionnelle,8,368,1,QCU,0.51,0.21,34.36,10,19,29,14,10,4,2.07,71.43,Moyen,Difficile,-1,Plus Difficile,Pas Adapte
2589,2017,Information-Communication,2,Grammaire Lexicale Fonctionnelle,3,Ecrire une Grammaire Lexicale Fonctionnelle,8,368,1,QCU,0.43,0.24,22.99,7,24,31,29,7,22,1.07,24.14,Difficile,Difficile,0,Meme Difficulté,Pas Adapte
3700,2018,Information-Communication,2,Grammaire Lexicale Fonctionnelle,3,Ecrire une Grammaire Lexicale Fonctionnelle,8,368,1,QCU,0.53,0.34,4.54,2,32,34,20,2,18,1.7,10.0,Facile,Difficile,-2,Beaucoup plus Difficile,Pas Adapte
4811,2019,Information-Communication,2,Grammaire Lexicale Fonctionnelle,3,Ecrire une Grammaire Lexicale Fonctionnelle,8,368,1,QCM,0.77,0.17,8.95,3,29,32,17,3,14,1.88,17.65,Moyen,Difficile,-1,Plus Difficile,Pas Adapte
5922,2020,Information-Communication,2,Grammaire Lexicale Fonctionnelle,3,Ecrire une Grammaire Lexicale Fonctionnelle,8,368,1,QCM,0.07,0.8,72.34,26,10,36,26,26,0,1.38,100.0,Difficile,Facile,2,Beaucoup plus Facile,Adapte
368,2015,Information-Communication,2,Grammaire Lexicale Fonctionnelle,3,Ecrire une Grammaire Lexicale Fonctionnelle,8,369,2,QROC,0.77,0.04,18.72,11,46,57,30,11,19,1.9,36.67,Facile,Difficile,-2,Beaucoup plus Difficile,Pas Adapte
1479,2016,Information-Communication,2,Grammaire Lexicale Fonctionnelle,3,Ecrire une Grammaire Lexicale Fonctionnelle,8,369,2,QROC,0.65,0.02,19.31,11,46,57,53,11,42,1.08,20.75,Facile,Difficile,-2,Beaucoup plus Difficile,Pas Adapte
2590,2017,Information-Communication,2,Grammaire Lexicale Fonctionnelle,3,Ecrire une Grammaire Lexicale Fonctionnelle,8,369,2,QROC,0.05,0.57,78.38,45,13,58,50,45,5,1.16,90.0,Difficile,Facile,2,Beaucoup plus Facile,Pas Adapte
3701,2018,Information-Communication,2,Grammaire Lexicale Fonctionnelle,3,Ecrire une Grammaire Lexicale Fonctionnelle,8,369,2,QROC,1.0,0.05,5.76,4,58,62,51,4,47,1.22,7.84,Difficile,Difficile,0,Meme Difficulté,Pas Adapte
4812,2019,Information-Communication,2,Grammaire Lexicale Fonctionnelle,3,Ecrire une Grammaire Lexicale Fonctionnelle,8,369,2,QO,0.3,0.23,43.71,25,33,58,48,25,23,1.21,52.08,Facile,Moyen,-1,Plus Difficile,Pas Adapte
5923,2020,Information-Communication,2,Grammaire Lexicale Fonctionnelle,3,Ecrire une Grammaire Lexicale Fonctionnelle,8,369,2,QO,0.16,0.34,95.42,55,3,58,58,55,3,1.0,94.83,Difficile,Facile,2,Beaucoup plus Facile,Pas Adapte
369,2015,Information-Communication,2,Grammaire Lexicale Fonctionnelle,3,Ecrire une Grammaire Lexicale Fonctionnelle,8,370,3,QCU,0.28,0.6,44.09,30,39,69,32,30,2,2.16,93.75,Difficile,Moyen,1,Plus Facile,Pas Adapte
1480,2016,Information-Communication,2,Grammaire Lexicale Fonctionnelle,3,Ecrire une Grammaire Lexicale Fonctionnelle,8,370,3,QCM,0.55,0.16,17.2,11,52,63,48,11,37,1.31,22.92,Difficile,Difficile,0,Meme Difficulté,Pas Adapte
2591,2017,Information-Communication,2,Grammaire Lexicale Fonctionnelle,3,Ecrire une Grammaire Lexicale Fonctionnelle,8,370,3,QCM,0.49,0.7,52.66,31,28,59,37,31,6,1.59,83.78,Moyen,Moyen,0,Meme Difficulté,Pas Adapte
3702,2018,Information-Communication,2,Grammaire Lexicale Fonctionnelle,3,Ecrire une Grammaire Lexicale Fonctionnelle,8,370,3,QCM,0.04,0.91,98.92,64,1,65,64,64,0,1.02,100.0,Moyen,Facile,1,Plus Facile,Pas Adapte
4813,2019,Information-Communication,2,Grammaire Lexicale Fonctionnelle,3,Ecrire une Grammaire Lexicale Fonctionnelle,8,370,3,QCM,0.5,0.45,57.82,43,32,75,51,43,8,1.47,84.31,Facile,Moyen,-1,Plus Difficile,Pas Adapte
5924,2020,Information-Communication,2,Grammaire Lexicale Fonctionnelle,3,Ecrire une Grammaire Lexicale Fonctionnelle,8,370,3,QROC,0.54,0.33,51.06,34,32,66,34,34,0,1.94,100.0,Difficile,Moyen,1,Plus Facile,Pas Adapte
370,2015,Information-Communication,2,Grammaire Lexicale Fonctionnelle,3,Ecrire une Grammaire Lexicale Fonctionnelle,8,371,4,QCU,0.15,0.98,97.77,66,2,68,66,66,0,1.03,100.0,Difficile,Facile,2,Beaucoup plus Facile,Pas Adapte
1481,2016,Information-Communication,2,Grammaire Lexicale Fonctionnelle,3,Ecrire une Grammaire Lexicale Fonctionnelle,8,371,4,QROC,0.13,0.55,92.31,62,5,67,65,62,3,1.03,95.38,Facile,Facile,0,Meme Difficulté,Pas Adapte
2592,2017,Information-Communication,2,Grammaire Lexicale Fonctionnelle,3,Ecrire une Grammaire Lexicale Fonctionnelle,8,371,4,QROC,0.21,0.38,53.91,40,35,75,40,40,0,1.88,100.0,Facile,Moyen,-1,Plus Difficile,Pas Adapte
3703,2018,Information-Communication,2,Grammaire Lexicale Fonctionnelle,3,Ecrire une Grammaire Lexicale Fonctionnelle,8,371,4,QROC,0.3,0.27,51.46,36,34,70,65,36,29,1.08,55.38,Facile,Moyen,-1,Plus Difficile,Pas Adapte
4814,2019,Information-Communication,2,Grammaire Lexicale Fonctionnelle,3,Ecrire une Grammaire Lexicale Fonctionnelle,8,371,4,QROC,0.96,0.2,25.34,18,53,71,55,18,37,1.29,32.73,Facile,Difficile,-2,Beaucoup plus Difficile,Pas Adapte
5925,2020,Information-Communication,2,Grammaire Lexicale Fonctionnelle,3,Ecrire une Grammaire Lexicale Fonctionnelle,8,371,4,QROC,0.12,0.72,80.96,63,15,78,66,63,3,1.18,95.45,Difficile,Facile,2,Beaucoup plus Facile,Pas Adapte
371,2015,Information-Communication,2,Grammaire Lexicale Fonctionnelle,3,Ecrire une Grammaire Lexicale Fonctionnelle,8,372,5,QROC,0.67,0.12,23.75,10,32,42,34,10,24,1.24,29.41,Moyen,Difficile,-1,Plus Difficile,Pas Adapte
1482,2016,Information-Communication,2,Grammaire Lexicale Fonctionnelle,3,Ecrire une Grammaire Lexicale Fonctionnelle,8,372,5,QROC,0.12,0.95,92.66,34,3,37,37,34,3,1.0,91.89,Facile,Facile,0,Meme Difficulté,Pas Adapte
2593,2017,Information-Communication,2,Grammaire Lexicale Fonctionnelle,3,Ecrire une Grammaire Lexicale Fonctionnelle,8,372,5,QO,0.05,0.62,80.34,28,7,35,29,28,1,1.21,96.55,Moyen,Facile,1,Plus Facile,Pas Adapte
3704,2018,Information-Communication,2,Grammaire Lexicale Fonctionnelle,3,Ecrire une Grammaire Lexicale Fonctionnelle,8,372,5,QO,0.81,0.13,29.45,10,24,34,18,10,8,1.89,55.56,Difficile,Difficile,0,Meme Difficulté,Pas Adapte
4815,2019,Information-Communication,2,Grammaire Lexicale Fonctionnelle,3,Ecrire une Grammaire Lexicale Fonctionnelle,8,372,5,QCU,0.34,0.55,41.68,14,19,33,30,14,16,1.1,46.67,Difficile,Moyen,1,Plus Facile,Pas Adapte
5926,2020,Information-Communication,2,Grammaire Lexicale Fonctionnelle,3,Ecrire une Grammaire Lexicale Fonctionnelle,8,372,5,QCU,0.04,0.87,96.64,32,1,33,33,32,1,1.0,96.97,Facile,Facile,0,Meme Difficulté,Pas Adapte
372,2015,Information-Communication,2,Grammaire Lexicale Fonctionnelle,3,Ecrire une Grammaire Lexicale Fonctionnelle,8,373,6,QO,0.92,0.03,29.77,19,45,64,57,19,38,1.12,33.33,Difficile,Difficile,0,Meme Difficulté,Pas Adapte
1483,2016,Information-Communication,2,Grammaire Lexicale Fonctionnelle,3,Ecrire une Grammaire Lexicale Fonctionnelle,8,373,6,QO,0.53,0.21,63.48,38,22,60,47,38,9,1.28,80.85,Facile,Moyen,-1,Plus Difficile,Pas Adapte
2594,2017,Information-Communication,2,Grammaire Lexicale Fonctionnelle,3,Ecrire une Grammaire Lexicale Fonctionnelle,8,373,6,QO,0.14,0.65,67.51,41,20,61,52,41,11,1.17,78.85,Facile,Facile,0,Meme Difficulté,Adapte
3705,2018,Information-Communication,2,Grammaire Lexicale Fonctionnelle,3,Ecrire une Grammaire Lexicale Fonctionnelle,8,373,6,QROC,0.1,0.64,67.51,41,20,61,43,41,2,1.42,95.35,Facile,Facile,0,Meme Difficulté,Adapte
4816,2019,Information-Communication,2,Grammaire Lexicale Fonctionnelle,3,Ecrire une Grammaire Lexicale Fonctionnelle,8,373,6,QROC,0.02,0.5,67.51,38,19,57,47,38,9,1.21,80.85,Facile,Facile,0,Meme Difficulté,Adapte
5927,2020,Information-Communication,2,Grammaire Lexicale Fonctionnelle,3,Ecrire une Grammaire Lexicale Fonctionnelle,8,373,6,QO,0.06,0.53,67.51,42,20,62,48,42,6,1.29,87.5,Facile,Facile,0,Meme Difficulté,Adapte
373,2015,Information-Communication,2,Grammaire Lexicale Fonctionnelle,3,Ecrire une Grammaire Lexicale Fonctionnelle,8,374,7,QCM,0.11,0.98,65.61,39,20,59,41,39,2,1.44,95.12,Moyen,Facile,1,Plus Facile,Adapte
1484,2016,Information-Communication,2,Grammaire Lexicale Fonctionnelle,3,Ecrire une Grammaire Lexicale Fonctionnelle,8,374,7,QCM,0.09,0.73,65.61,37,19,56,39,37,2,1.44,94.87,Facile,Facile,0,Meme Difficulté,Adapte
2595,2017,Information-Communication,2,Grammaire Lexicale Fonctionnelle,3,Ecrire une Grammaire Lexicale Fonctionnelle,8,374,7,QCM,0.14,0.79,65.61,39,20,59,43,39,4,1.37,90.7,Facile,Facile,0,Meme Difficulté,Adapte
3706,2018,Information-Communication,2,Grammaire Lexicale Fonctionnelle,3,Ecrire une Grammaire Lexicale Fonctionnelle,8,374,7,QCM,0.17,0.78,65.61,37,19,56,40,37,3,1.4,92.5,Facile,Facile,0,Meme Difficulté,Adapte
4817,2019,Information-Communication,2,Grammaire Lexicale Fonctionnelle,3,Ecrire une Grammaire Lexicale Fonctionnelle,8,374,7,QCM,0.18,0.76,65.61,39,21,60,48,39,9,1.25,81.25,Facile,Facile,0,Meme Difficulté,Adapte
5928,2020,Information-Communication,2,Grammaire Lexicale Fonctionnelle,3,Ecrire une Grammaire Lexicale Fonctionnelle,8,374,7,QCM,0.11,0.85,65.61,42,22,64,55,42,13,1.16,76.36,Facile,Facile,0,Meme Difficulté,Adapte
374,2015,Information-Communication,2,Grammaire Lexicale Fonctionnelle,3,Ecrire une Grammaire Lexicale Fonctionnelle,8,375,8,QO,0.04,0.53,77.18,23,7,30,25,23,2,1.2,92.0,Difficile,Facile,2,Beaucoup plus Facile,Pas Adapte
1485,2016,Information-Communication,2,Grammaire Lexicale Fonctionnelle,3,Ecrire une Grammaire Lexicale Fonctionnelle,8,375,8,QO,0.85,0.03,18.26,6,25,31,29,6,23,1.07,20.69,Moyen,Difficile,-1,Plus Difficile,Pas Adapte
2596,2017,Information-Communication,2,Grammaire Lexicale Fonctionnelle,3,Ecrire une Grammaire Lexicale Fonctionnelle,8,375,8,QO,0.09,0.35,78.36,28,8,36,30,28,2,1.2,93.33,Facile,Facile,0,Meme Difficulté,Pas Adapte
3707,2018,Information-Communication,2,Grammaire Lexicale Fonctionnelle,3,Ecrire une Grammaire Lexicale Fonctionnelle,8,375,8,QO,0.54,0.19,61.55,20,12,32,28,20,8,1.14,71.43,Facile,Moyen,-1,Plus Difficile,Pas Adapte
4818,2019,Information-Communication,2,Grammaire Lexicale Fonctionnelle,3,Ecrire une Grammaire Lexicale Fonctionnelle,8,375,8,QO,0.1,0.51,72.32,21,8,29,21,21,0,1.38,100.0,Moyen,Facile,1,Plus Facile,Adapte
5929,2020,Information-Communication,2,Grammaire Lexicale Fonctionnelle,3,Ecrire une Grammaire Lexicale Fonctionnelle,8,375,8,QROC,0.19,0.58,72.32,20,7,27,25,20,5,1.08,80.0,Facile,Facile,0,Meme Difficulté,Adapte
375,2015,Information-Communication,2,Grammaire Lexicale Fonctionnelle,4,Diversite des Fonctions Grammaticales,14,376,1,QROC,0.24,0.31,37.45,3,5,8,8,3,5,1.0,37.5,Difficile,Moyen,1,Plus Facile,Pas Adapte
1486,2016,Information-Communication,2,Grammaire Lexicale Fonctionnelle,4,Diversite des Fonctions Grammaticales,14,376,1,QROC,0.55,0.31,58.0,5,4,9,6,5,1,1.5,83.33,Facile,Moyen,-1,Plus Difficile,Pas Adapte
2597,2017,Information-Communication,2,Grammaire Lexicale Fonctionnelle,4,Diversite des Fonctions Grammaticales,14,376,1,QROC,0.62,0.12,21.86,2,7,9,7,2,5,1.29,28.57,Facile,Difficile,-2,Beaucoup plus Difficile,Pas Adapte
3708,2018,Information-Communication,2,Grammaire Lexicale Fonctionnelle,4,Diversite des Fonctions Grammaticales,14,376,1,QROC,0.05,0.58,69.94,6,3,9,8,6,2,1.12,75.0,Difficile,Facile,2,Beaucoup plus Facile,Adapte
4819,2019,Information-Communication,2,Grammaire Lexicale Fonctionnelle,4,Diversite des Fonctions Grammaticales,14,376,1,QROC,0.16,0.44,69.94,6,2,8,6,6,0,1.33,100.0,Facile,Facile,0,Meme Difficulté,Adapte
5930,2020,Information-Communication,2,Grammaire Lexicale Fonctionnelle,4,Diversite des Fonctions Grammaticales,14,376,1,QROC,0.09,0.65,69.94,6,2,8,8,6,2,1.0,75.0,Facile,Facile,0,Meme Difficulté,Adapte
376,2015,Information-Communication,2,Grammaire Lexicale Fonctionnelle,4,Diversite des Fonctions Grammaticales,14,377,2,QCU,0.39,0.42,53.79,28,24,52,39,28,11,1.33,71.79,Difficile,Moyen,1,Plus Facile,Pas Adapte
1487,2016,Information-Communication,2,Grammaire Lexicale Fonctionnelle,4,Diversite des Fonctions Grammaticales,14,377,2,QCU,0.13,0.76,92.82,42,3,45,44,42,2,1.02,95.45,Facile,Facile,0,Meme Difficulté,Pas Adapte
2598,2017,Information-Communication,2,Grammaire Lexicale Fonctionnelle,4,Diversite des Fonctions Grammaticales,14,377,2,QCU,0.55,0.24,1.28,1,41,42,25,1,24,1.68,4.0,Difficile,Difficile,0,Meme Difficulté,Pas Adapte
3709,2018,Information-Communication,2,Grammaire Lexicale Fonctionnelle,4,Diversite des Fonctions Grammaticales,14,377,2,QCU,0.46,0.39,14.04,6,40,46,46,6,40,1.0,13.04,Difficile,Difficile,0,Meme Difficulté,Pas Adapte
4820,2019,Information-Communication,2,Grammaire Lexicale Fonctionnelle,4,Diversite des Fonctions Grammaticales,14,377,2,QCU,0.04,0.95,81.51,36,8,44,40,36,4,1.1,90.0,Difficile,Facile,2,Beaucoup plus Facile,Pas Adapte
5931,2020,Information-Communication,2,Grammaire Lexicale Fonctionnelle,4,Diversite des Fonctions Grammaticales,14,377,2,QCU,0.73,0.37,25.13,11,34,45,41,11,30,1.1,26.83,Facile,Difficile,-2,Beaucoup plus Difficile,Pas Adapte
377,2015,Information-Communication,2,Grammaire Lexicale Fonctionnelle,4,Diversite des Fonctions Grammaticales,14,378,3,QO,0.02,0.5,73.22,27,10,37,27,27,0,1.37,100.0,Difficile,Facile,2,Beaucoup plus Facile,Adapte
1488,2016,Information-Communication,2,Grammaire Lexicale Fonctionnelle,4,Diversite des Fonctions Grammaticales,14,378,3,QO,0.06,0.96,73.22,31,12,43,40,31,9,1.07,77.5,Facile,Facile,0,Meme Difficulté,Adapte
2599,2017,Information-Communication,2,Grammaire Lexicale Fonctionnelle,4,Diversite des Fonctions Grammaticales,14,378,3,QROC,0.09,0.5,73.22,36,13,49,39,36,3,1.26,92.31,Facile,Facile,0,Meme Difficulté,Adapte
3710,2018,Information-Communication,2,Grammaire Lexicale Fonctionnelle,4,Diversite des Fonctions Grammaticales,14,378,3,QROC,0.08,0.85,73.22,36,13,49,44,36,8,1.11,81.82,Facile,Facile,0,Meme Difficulté,Adapte
4821,2019,Information-Communication,2,Grammaire Lexicale Fonctionnelle,4,Diversite des Fonctions Grammaticales,14,378,3,QROC,0.09,0.41,73.22,38,14,52,51,38,13,1.02,74.51,Facile,Facile,0,Meme Difficulté,Adapte
5932,2020,Information-Communication,2,Grammaire Lexicale Fonctionnelle,4,Diversite des Fonctions Grammaticales,14,378,3,QROC,0.09,0.77,73.22,42,16,58,47,42,5,1.23,89.36,Facile,Facile,0,Meme Difficulté,Adapte
378,2015,Information-Communication,2,Grammaire Lexicale Fonctionnelle,4,Diversite des Fonctions Grammaticales,14,379,4,QCU,0.51,0.37,33.19,11,21,32,24,11,13,1.33,45.83,Facile,Difficile,-2,Beaucoup plus Difficile,Pas Adapte
1489,2016,Information-Communication,2,Grammaire Lexicale Fonctionnelle,4,Diversite des Fonctions Grammaticales,14,379,4,QCU,0.17,0.84,72.14,25,10,35,31,25,6,1.13,80.65,Facile,Facile,0,Meme Difficulté,Adapte
2600,2017,Information-Communication,2,Grammaire Lexicale Fonctionnelle,4,Diversite des Fonctions Grammaticales,14,379,4,QCU,0.16,0.92,72.14,25,10,35,35,25,10,1.0,71.43,Facile,Facile,0,Meme Difficulté,Adapte
3711,2018,Information-Communication,2,Grammaire Lexicale Fonctionnelle,4,Diversite des Fonctions Grammaticales,14,379,4,QCU,0.01,0.81,72.14,23,9,32,30,23,7,1.07,76.67,Facile,Facile,0,Meme Difficulté,Adapte
4822,2019,Information-Communication,2,Grammaire Lexicale Fonctionnelle,4,Diversite des Fonctions Grammaticales,14,379,4,QROC,0.08,0.4,72.14,21,8,29,26,21,5,1.12,80.77,Facile,Facile,0,Meme Difficulté,Adapte
5933,2020,Information-Communication,2,Grammaire Lexicale Fonctionnelle,4,Diversite des Fonctions Grammaticales,14,379,4,QROC,0.02,0.49,72.14,23,9,32,27,23,4,1.19,85.19,Facile,Facile,0,Meme Difficulté,Adapte
379,2015,Information-Communication,2,Grammaire Lexicale Fonctionnelle,4,Diversite des Fonctions Grammaticales,14,380,5,QCU,0.48,0.26,33.06,17,33,50,35,17,18,1.43,48.57,Difficile,Difficile,0,Meme Difficulté,Pas Adapte
1490,2016,Information-Communication,2,Grammaire Lexicale Fonctionnelle,4,Diversite des Fonctions Grammaticales,14,380,5,QCU,0.69,0.27,10.08,6,49,55,37,6,31,1.49,16.22,Difficile,Difficile,0,Meme Difficulté,Pas Adapte
2601,2017,Information-Communication,2,Grammaire Lexicale Fonctionnelle,4,Diversite des Fonctions Grammaticales,14,380,5,QCU,0.1,1.0,72.28,45,17,62,55,45,10,1.13,81.82,Difficile,Facile,2,Beaucoup plus Facile,Adapte
3712,2018,Information-Communication,2,Grammaire Lexicale Fonctionnelle,4,Diversite des Fonctions Grammaticales,14,380,5,QCU,0.13,0.95,72.28,40,16,56,56,40,16,1.0,71.43,Facile,Facile,0,Meme Difficulté,Adapte
4823,2019,Information-Communication,2,Grammaire Lexicale Fonctionnelle,4,Diversite des Fonctions Grammaticales,14,380,5,QCU,0.15,0.94,72.28,35,13,48,42,35,7,1.14,83.33,Facile,Facile,0,Meme Difficulté,Adapte
5934,2020,Information-Communication,2,Grammaire Lexicale Fonctionnelle,4,Diversite des Fonctions Grammaticales,14,380,5,QCU,0.06,0.94,72.28,40,15,55,43,40,3,1.28,93.02,Facile,Facile,0,Meme Difficulté,Adapte
380,2015,Information-Communication,2,Grammaire Lexicale Fonctionnelle,4,Diversite des Fonctions Grammaticales,14,381,6,QCM,0.13,0.88,69.44,19,8,27,26,19,7,1.04,73.08,Facile,Facile,0,Meme Difficulté,Adapte
1491,2016,Information-Communication,2,Grammaire Lexicale Fonctionnelle,4,Diversite des Fonctions Grammaticales,14,381,6,QCM,0.01,0.99,69.44,22,9,31,26,22,4,1.19,84.62,Facile,Facile,0,Meme Difficulté,Adapte
2602,2017,Information-Communication,2,Grammaire Lexicale Fonctionnelle,4,Diversite des Fonctions Grammaticales,14,381,6,QCM,0.19,0.92,69.44,23,10,33,25,23,2,1.32,92.0,Facile,Facile,0,Meme Difficulté,Adapte
3713,2018,Information-Communication,2,Grammaire Lexicale Fonctionnelle,4,Diversite des Fonctions Grammaticales,14,381,6,QCM,0.03,0.95,69.44,21,9,30,23,21,2,1.3,91.3,Facile,Facile,0,Meme Difficulté,Adapte
4824,2019,Information-Communication,2,Grammaire Lexicale Fonctionnelle,4,Diversite des Fonctions Grammaticales,14,381,6,QCM,0.09,0.95,69.44,22,9,31,25,22,3,1.24,88.0,Facile,Facile,0,Meme Difficulté,Adapte
5935,2020,Information-Communication,2,Grammaire Lexicale Fonctionnelle,4,Diversite des Fonctions Grammaticales,14,381,6,QCM,0.03,0.95,69.44,18,8,26,22,18,4,1.18,81.82,Facile,Facile,0,Meme Difficulté,Adapte
381,2015,Information-Communication,2,Grammaire Lexicale Fonctionnelle,4,Diversite des Fonctions Grammaticales,14,382,7,QCU,0.56,0.29,13.92,10,59,69,35,10,25,1.97,28.57,Difficile,Difficile,0,Meme Difficulté,Pas Adapte
1492,2016,Information-Communication,2,Grammaire Lexicale Fonctionnelle,4,Diversite des Fonctions Grammaticales,14,382,7,QCU,0.49,0.4,23.44,17,55,72,71,17,54,1.01,23.94,Moyen,Difficile,-1,Plus Difficile,Pas Adapte
2603,2017,Information-Communication,2,Grammaire Lexicale Fonctionnelle,4,Diversite des Fonctions Grammaticales,14,382,7,QCU,0.38,0.66,50.12,32,31,63,52,32,20,1.21,61.54,Moyen,Moyen,0,Meme Difficulté,Pas Adapte
3714,2018,Information-Communication,2,Grammaire Lexicale Fonctionnelle,4,Diversite des Fonctions Grammaticales,14,382,7,QCU,0.04,0.99,86.46,62,10,72,68,62,6,1.06,91.18,Facile,Facile,0,Meme Difficulté,Pas Adapte
4825,2019,Information-Communication,2,Grammaire Lexicale Fonctionnelle,4,Diversite des Fonctions Grammaticales,14,382,7,QCU,0.42,0.38,5.15,4,71,75,35,4,31,2.14,11.43,Facile,Difficile,-2,Beaucoup plus Difficile,Pas Adapte
5936,2020,Information-Communication,2,Grammaire Lexicale Fonctionnelle,4,Diversite des Fonctions Grammaticales,14,382,7,QCU,0.75,0.26,3.77,3,67,70,40,3,37,1.75,7.5,Difficile,Difficile,0,Meme Difficulté,Pas Adapte
382,2015,Information-Communication,2,Grammaire Lexicale Fonctionnelle,4,Diversite des Fonctions Grammaticales,14,383,8,QCU,0.19,0.96,75.07,5,1,6,5,5,0,1.2,100.0,Difficile,Facile,2,Beaucoup plus Facile,Pas Adapte
1493,2016,Information-Communication,2,Grammaire Lexicale Fonctionnelle,4,Diversite des Fonctions Grammaticales,14,383,8,QROC,0.8,0.11,9.47,1,6,7,4,1,3,1.75,25.0,Difficile,Difficile,0,Meme Difficulté,Pas Adapte
2604,2017,Information-Communication,2,Grammaire Lexicale Fonctionnelle,4,Diversite des Fonctions Grammaticales,14,383,8,QROC,0.13,0.83,69.0,5,2,7,6,5,1,1.17,83.33,Moyen,Facile,1,Plus Facile,Adapte
3715,2018,Information-Communication,2,Grammaire Lexicale Fonctionnelle,4,Diversite des Fonctions Grammaticales,14,383,8,QROC,0.15,0.61,69.0,6,2,8,7,6,1,1.14,85.71,Facile,Facile,0,Meme Difficulté,Adapte
4826,2019,Information-Communication,2,Grammaire Lexicale Fonctionnelle,4,Diversite des Fonctions Grammaticales,14,383,8,QROC,0.12,0.85,69.0,6,3,9,8,6,2,1.12,75.0,Facile,Facile,0,Meme Difficulté,Adapte
5937,2020,Information-Communication,2,Grammaire Lexicale Fonctionnelle,4,Diversite des Fonctions Grammaticales,14,383,8,QROC,0.09,0.57,69.0,6,3,9,8,6,2,1.12,75.0,Facile,Facile,0,Meme Difficulté,Adapte
383,2015,Information-Communication,2,Grammaire Lexicale Fonctionnelle,4,Diversite des Fonctions Grammaticales,14,384,9,QCU,0.28,0.41,42.92,12,17,29,24,12,12,1.21,50.0,Difficile,Moyen,1,Plus Facile,Pas Adapte
1494,2016,Information-Communication,2,Grammaire Lexicale Fonctionnelle,4,Diversite des Fonctions Grammaticales,14,384,9,QCU,0.66,0.28,22.19,6,20,26,22,6,16,1.18,27.27,Facile,Difficile,-2,Beaucoup plus Difficile,Pas Adapte
2605,2017,Information-Communication,2,Grammaire Lexicale Fonctionnelle,4,Diversite des Fonctions Grammaticales,14,384,9,QCU,0.57,0.28,12.12,4,25,29,23,4,19,1.26,17.39,Facile,Difficile,-2,Beaucoup plus Difficile,Pas Adapte
3716,2018,Information-Communication,2,Grammaire Lexicale Fonctionnelle,4,Diversite des Fonctions Grammaticales,14,384,9,QCU,0.14,0.81,97.29,30,1,31,31,30,1,1.0,96.77,Facile,Facile,0,Meme Difficulté,Pas Adapte
4827,2019,Information-Communication,2,Grammaire Lexicale Fonctionnelle,4,Diversite des Fonctions Grammaticales,14,384,9,QCU,0.69,0.23,25.04,9,25,34,23,9,14,1.48,39.13,Moyen,Difficile,-1,Plus Difficile,Pas Adapte
5938,2020,Information-Communication,2,Grammaire Lexicale Fonctionnelle,4,Diversite des Fonctions Grammaticales,14,384,9,QCU,0.0,0.9,80.72,31,7,38,38,31,7,1.0,81.58,Difficile,Facile,2,Beaucoup plus Facile,Pas Adapte
384,2015,Information-Communication,2,Grammaire Lexicale Fonctionnelle,4,Diversite des Fonctions Grammaticales,14,385,10,QCU,0.08,0.86,70.15,8,3,11,10,8,2,1.1,80.0,Moyen,Facile,1,Plus Facile,Adapte
1495,2016,Information-Communication,2,Grammaire Lexicale Fonctionnelle,4,Diversite des Fonctions Grammaticales,14,385,10,QCU,0.14,0.87,70.15,6,3,9,8,6,2,1.12,75.0,Facile,Facile,0,Meme Difficulté,Adapte
2606,2017,Information-Communication,2,Grammaire Lexicale Fonctionnelle,4,Diversite des Fonctions Grammaticales,14,385,10,QCU,0.1,0.83,70.15,6,2,8,6,6,0,1.33,100.0,Facile,Facile,0,Meme Difficulté,Adapte
3717,2018,Information-Communication,2,Grammaire Lexicale Fonctionnelle,4,Diversite des Fonctions Grammaticales,14,385,10,QCU,0.2,0.95,70.15,6,2,8,6,6,0,1.33,100.0,Facile,Facile,0,Meme Difficulté,Adapte
4828,2019,Information-Communication,2,Grammaire Lexicale Fonctionnelle,4,Diversite des Fonctions Grammaticales,14,385,10,QCU,0.17,0.8,70.15,6,2,8,7,6,1,1.14,85.71,Facile,Facile,0,Meme Difficulté,Adapte
5939,2020,Information-Communication,2,Grammaire Lexicale Fonctionnelle,4,Diversite des Fonctions Grammaticales,14,385,10,QCU,0.1,0.98,70.15,6,2,8,6,6,0,1.33,100.0,Facile,Facile,0,Meme Difficulté,Adapte
385,2015,Information-Communication,2,Grammaire Lexicale Fonctionnelle,4,Diversite des Fonctions Grammaticales,14,386,11,QROC,0.52,0.31,59.28,5,3,8,6,5,1,1.33,83.33,Moyen,Moyen,0,Meme Difficulté,Pas Adapte
1496,2016,Information-Communication,2,Grammaire Lexicale Fonctionnelle,4,Diversite des Fonctions Grammaticales,14,386,11,QO,0.75,0.04,15.57,1,6,7,4,1,3,1.75,25.0,Moyen,Difficile,-1,Plus Difficile,Pas Adapte
2607,2017,Information-Communication,2,Grammaire Lexicale Fonctionnelle,4,Diversite des Fonctions Grammaticales,14,386,11,QO,0.74,0.2,44.66,3,3,6,5,3,2,1.2,60.0,Facile,Moyen,-1,Plus Difficile,Pas Adapte
3718,2018,Information-Communication,2,Grammaire Lexicale Fonctionnelle,4,Diversite des Fonctions Grammaticales,14,386,11,QO,0.91,0.04,0.29,0,6,6,6,0,6,1.0,0.0,Difficile,Difficile,0,Meme Difficulté,Pas Adapte
4829,2019,Information-Communication,2,Grammaire Lexicale Fonctionnelle,4,Diversite des Fonctions Grammaticales,14,386,11,QO,0.19,0.7,97.71,5,0,5,5,5,0,1.0,100.0,Difficile,Facile,2,Beaucoup plus Facile,Pas Adapte
5940,2020,Information-Communication,2,Grammaire Lexicale Fonctionnelle,4,Diversite des Fonctions Grammaticales,14,386,11,QO,0.85,0.12,17.27,1,3,4,4,1,3,1.0,25.0,Difficile,Difficile,0,Meme Difficulté,Pas Adapte
386,2015,Information-Communication,2,Grammaire Lexicale Fonctionnelle,4,Diversite des Fonctions Grammaticales,14,387,12,QROC,0.19,0.55,98.6,56,1,57,57,56,1,1.0,98.25,Difficile,Facile,2,Beaucoup plus Facile,Pas Adapte
1497,2016,Information-Communication,2,Grammaire Lexicale Fonctionnelle,4,Diversite des Fonctions Grammaticales,14,387,12,QROC,0.34,0.38,53.03,27,23,50,41,27,14,1.22,65.85,Moyen,Moyen,0,Meme Difficulté,Pas Adapte
2608,2017,Information-Communication,2,Grammaire Lexicale Fonctionnelle,4,Diversite des Fonctions Grammaticales,14,387,12,QROC,0.19,0.96,81.39,42,10,52,43,42,1,1.21,97.67,Difficile,Facile,2,Beaucoup plus Facile,Pas Adapte
3719,2018,Information-Communication,2,Grammaire Lexicale Fonctionnelle,4,Diversite des Fonctions Grammaticales,14,387,12,QROC,0.78,0.12,17.54,8,37,45,20,8,12,2.25,40.0,Facile,Difficile,-2,Beaucoup plus Difficile,Pas Adapte
4830,2019,Information-Communication,2,Grammaire Lexicale Fonctionnelle,4,Diversite des Fonctions Grammaticales,14,387,12,QROC,0.18,0.88,74.84,38,13,51,42,38,4,1.21,90.48,Facile,Facile,0,Meme Difficulté,Adapte
5941,2020,Information-Communication,2,Grammaire Lexicale Fonctionnelle,4,Diversite des Fonctions Grammaticales,14,387,12,QROC,0.2,0.67,74.84,39,13,52,49,39,10,1.06,79.59,Facile,Facile,0,Meme Difficulté,Adapte
387,2015,Information-Communication,2,Grammaire Lexicale Fonctionnelle,4,Diversite des Fonctions Grammaticales,14,388,13,QCM,0.63,0.18,14.72,14,83,97,34,14,20,2.85,41.18,Moyen,Difficile,-1,Plus Difficile,Pas Adapte
1498,2016,Information-Communication,2,Grammaire Lexicale Fonctionnelle,4,Diversite des Fonctions Grammaticales,14,388,13,QCM,0.53,0.17,4.47,4,94,98,63,4,59,1.56,6.35,Difficile,Difficile,0,Meme Difficulté,Pas Adapte
2609,2017,Information-Communication,2,Grammaire Lexicale Fonctionnelle,4,Diversite des Fonctions Grammaticales,14,388,13,QCM,0.09,0.97,86.25,90,14,104,101,90,11,1.03,89.11,Difficile,Facile,2,Beaucoup plus Facile,Pas Adapte
3720,2018,Information-Communication,2,Grammaire Lexicale Fonctionnelle,4,Diversite des Fonctions Grammaticales,14,388,13,QCM,0.22,0.64,40.85,44,63,107,90,44,46,1.19,48.89,Facile,Moyen,-1,Plus Difficile,Pas Adapte
4831,2019,Information-Communication,2,Grammaire Lexicale Fonctionnelle,4,Diversite des Fonctions Grammaticales,14,388,13,QCM,0.13,0.71,83.65,91,18,109,99,91,8,1.1,91.92,Difficile,Facile,2,Beaucoup plus Facile,Pas Adapte
5942,2020,Information-Communication,2,Grammaire Lexicale Fonctionnelle,4,Diversite des Fonctions Grammaticales,14,388,13,QCM,0.64,0.2,6.82,8,116,124,33,8,25,3.76,24.24,Moyen,Difficile,-1,Plus Difficile,Pas Adapte
388,2015,Information-Communication,2,Grammaire Lexicale Fonctionnelle,4,Diversite des Fonctions Grammaticales,14,389,14,QCM,0.45,0.66,48.31,22,24,46,34,22,12,1.35,64.71,Facile,Moyen,-1,Plus Difficile,Pas Adapte
1499,2016,Information-Communication,2,Grammaire Lexicale Fonctionnelle,4,Diversite des Fonctions Grammaticales,14,389,14,QCM,0.01,0.8,83.68,39,8,47,44,39,5,1.07,88.64,Facile,Facile,0,Meme Difficulté,Pas Adapte
2610,2017,Information-Communication,2,Grammaire Lexicale Fonctionnelle,4,Diversite des Fonctions Grammaticales,14,389,14,QCM,0.07,0.72,68.26,30,14,44,36,30,6,1.22,83.33,Moyen,Facile,1,Plus Facile,Adapte
3721,2018,Information-Communication,2,Grammaire Lexicale Fonctionnelle,4,Diversite des Fonctions Grammaticales,14,389,14,QCM,0.07,0.96,68.26,31,14,45,42,31,11,1.07,73.81,Facile,Facile,0,Meme Difficulté,Adapte
4832,2019,Information-Communication,2,Grammaire Lexicale Fonctionnelle,4,Diversite des Fonctions Grammaticales,14,389,14,QCM,0.19,0.79,68.26,31,15,46,46,31,15,1.0,67.39,Facile,Facile,0,Meme Difficulté,Adapte
5943,2020,Information-Communication,2,Grammaire Lexicale Fonctionnelle,4,Diversite des Fonctions Grammaticales,14,389,14,QCM,0.08,0.74,68.26,30,14,44,34,30,4,1.29,88.24,Facile,Facile,0,Meme Difficulté,Adapte
389,2015,Information-Communication,3,Grammaire et Syntaxe,1,Les Subordonnees,6,390,1,QCU,0.62,0.38,0.84,0,50,50,34,0,34,1.47,0.0,Difficile,Difficile,0,Meme Difficulté,Pas Adapte
1500,2016,Information-Communication,3,Grammaire et Syntaxe,1,Les Subordonnees,6,390,1,QCU,0.46,0.32,25.55,13,36,49,17,13,4,2.88,76.47,Moyen,Difficile,-1,Plus Difficile,Pas Adapte
2611,2017,Information-Communication,3,Grammaire et Syntaxe,1,Les Subordonnees,6,390,1,QCM,0.76,0.21,26.91,12,31,43,24,12,12,1.79,50.0,Facile,Difficile,-2,Beaucoup plus Difficile,Pas Adapte
3722,2018,Information-Communication,3,Grammaire et Syntaxe,1,Les Subordonnees,6,390,1,QCM,0.33,0.36,45.29,22,27,49,33,22,11,1.48,66.67,Facile,Moyen,-1,Plus Difficile,Pas Adapte
4833,2019,Information-Communication,3,Grammaire et Syntaxe,1,Les Subordonnees,6,390,1,QCM,0.06,0.78,89.74,39,5,44,43,39,4,1.02,90.7,Facile,Facile,0,Meme Difficulté,Pas Adapte
5944,2020,Information-Communication,3,Grammaire et Syntaxe,1,Les Subordonnees,6,390,1,QCM,0.22,0.47,62.12,23,14,37,25,23,2,1.48,92.0,Facile,Moyen,-1,Plus Difficile,Pas Adapte
390,2015,Information-Communication,3,Grammaire et Syntaxe,1,Les Subordonnees,6,391,2,QCM,0.61,0.16,8.46,5,50,55,55,5,50,1.0,9.09,Moyen,Difficile,-1,Plus Difficile,Pas Adapte
1501,2016,Information-Communication,3,Grammaire et Syntaxe,1,Les Subordonnees,6,391,2,QCM,0.76,0.25,9.96,5,47,52,47,5,42,1.11,10.64,Facile,Difficile,-2,Beaucoup plus Difficile,Pas Adapte
2612,2017,Information-Communication,3,Grammaire et Syntaxe,1,Les Subordonnees,6,391,2,QCM,0.29,0.62,56.44,33,26,59,36,33,3,1.64,91.67,Facile,Moyen,-1,Plus Difficile,Pas Adapte
3723,2018,Information-Communication,3,Grammaire et Syntaxe,1,Les Subordonnees,6,391,2,QCM,0.17,0.92,94.0,54,3,57,57,54,3,1.0,94.74,Difficile,Facile,2,Beaucoup plus Facile,Pas Adapte
4834,2019,Information-Communication,3,Grammaire et Syntaxe,1,Les Subordonnees,6,391,2,QCM,0.28,0.4,38.8,21,32,53,38,21,17,1.39,55.26,Facile,Moyen,-1,Plus Difficile,Pas Adapte
5945,2020,Information-Communication,3,Grammaire et Syntaxe,1,Les Subordonnees,6,391,2,QCM,0.6,0.29,0.17,0,58,58,31,0,31,1.87,0.0,Moyen,Difficile,-1,Plus Difficile,Pas Adapte
391,2015,Information-Communication,3,Grammaire et Syntaxe,1,Les Subordonnees,6,392,3,QCU,0.15,0.86,80.8,15,3,18,16,15,1,1.12,93.75,Difficile,Facile,2,Beaucoup plus Facile,Pas Adapte
1502,2016,Information-Communication,3,Grammaire et Syntaxe,1,Les Subordonnees,6,392,3,QCU,0.25,0.45,64.5,12,6,18,17,12,5,1.06,70.59,Difficile,Moyen,1,Plus Facile,Pas Adapte
2613,2017,Information-Communication,3,Grammaire et Syntaxe,1,Les Subordonnees,6,392,3,QCU,0.36,0.68,59.33,10,7,17,13,10,3,1.31,76.92,Moyen,Moyen,0,Meme Difficulté,Pas Adapte
3724,2018,Information-Communication,3,Grammaire et Syntaxe,1,Les Subordonnees,6,392,3,QCU,0.39,0.44,43.97,7,9,16,14,7,7,1.14,50.0,Difficile,Moyen,1,Plus Facile,Pas Adapte
4835,2019,Information-Communication,3,Grammaire et Syntaxe,1,Les Subordonnees,6,392,3,QCU,0.35,0.56,61.69,10,7,17,11,10,1,1.55,90.91,Difficile,Moyen,1,Plus Facile,Pas Adapte
5946,2020,Information-Communication,3,Grammaire et Syntaxe,1,Les Subordonnees,6,392,3,QCU,0.21,0.45,61.09,10,6,16,12,10,2,1.33,83.33,Facile,Moyen,-1,Plus Difficile,Pas Adapte
392,2015,Information-Communication,3,Grammaire et Syntaxe,1,Les Subordonnees,6,393,4,QCU,0.43,0.36,19.52,5,20,25,14,5,9,1.79,35.71,Moyen,Difficile,-1,Plus Difficile,Pas Adapte
1503,2016,Information-Communication,3,Grammaire et Syntaxe,1,Les Subordonnees,6,393,4,QCU,0.62,0.34,5.95,2,26,28,26,2,24,1.08,7.69,Difficile,Difficile,0,Meme Difficulté,Pas Adapte
2614,2017,Information-Communication,3,Grammaire et Syntaxe,1,Les Subordonnees,6,393,4,QCU,0.08,0.92,98.0,24,0,24,24,24,0,1.0,100.0,Moyen,Facile,1,Plus Facile,Pas Adapte
3725,2018,Information-Communication,3,Grammaire et Syntaxe,1,Les Subordonnees,6,393,4,QCU,0.14,0.76,75.47,16,5,21,19,16,3,1.11,84.21,Facile,Facile,0,Meme Difficulté,Pas Adapte
4836,2019,Information-Communication,3,Grammaire et Syntaxe,1,Les Subordonnees,6,393,4,QCU,0.21,0.62,58.18,13,10,23,20,13,7,1.15,65.0,Facile,Moyen,-1,Plus Difficile,Pas Adapte
5947,2020,Information-Communication,3,Grammaire et Syntaxe,1,Les Subordonnees,6,393,4,QCU,0.38,0.48,55.69,14,12,26,26,14,12,1.0,53.85,Difficile,Moyen,1,Plus Facile,Pas Adapte
393,2015,Information-Communication,3,Grammaire et Syntaxe,1,Les Subordonnees,6,394,5,QCM,0.65,0.17,2.38,1,27,28,13,1,12,2.15,7.69,Facile,Difficile,-2,Beaucoup plus Difficile,Pas Adapte
1504,2016,Information-Communication,3,Grammaire et Syntaxe,1,Les Subordonnees,6,394,5,QCM,0.28,0.45,52.77,13,12,25,15,13,2,1.67,86.67,Moyen,Moyen,0,Meme Difficulté,Pas Adapte
2615,2017,Information-Communication,3,Grammaire et Syntaxe,1,Les Subordonnees,6,394,5,QCU,0.68,0.2,27.15,7,17,24,14,7,7,1.71,50.0,Difficile,Difficile,0,Meme Difficulté,Pas Adapte
3726,2018,Information-Communication,3,Grammaire et Syntaxe,1,Les Subordonnees,6,394,5,QCM,0.22,0.59,64.53,15,9,24,17,15,2,1.41,88.24,Difficile,Moyen,1,Plus Facile,Pas Adapte
4837,2019,Information-Communication,3,Grammaire et Syntaxe,1,Les Subordonnees,6,394,5,QCM,0.67,0.29,28.74,7,17,24,23,7,16,1.04,30.43,Facile,Difficile,-2,Beaucoup plus Difficile,Pas Adapte
5948,2020,Information-Communication,3,Grammaire et Syntaxe,1,Les Subordonnees,6,394,5,QCU,0.58,0.34,21.34,6,21,27,18,6,12,1.5,33.33,Difficile,Difficile,0,Meme Difficulté,Pas Adapte
394,2015,Information-Communication,3,Grammaire et Syntaxe,1,Les Subordonnees,6,395,6,QCM,0.61,0.17,22.87,15,49,64,55,15,40,1.16,27.27,Facile,Difficile,-2,Beaucoup plus Difficile,Pas Adapte
1505,2016,Information-Communication,3,Grammaire et Syntaxe,1,Les Subordonnees,6,395,6,QCM,0.16,0.92,95.07,52,3,55,53,52,1,1.04,98.11,Difficile,Facile,2,Beaucoup plus Facile,Pas Adapte
2616,2017,Information-Communication,3,Grammaire et Syntaxe,1,Les Subordonnees,6,395,6,QCM,0.68,0.27,16.95,9,44,53,19,9,10,2.79,47.37,Difficile,Difficile,0,Meme Difficulté,Pas Adapte
3727,2018,Information-Communication,3,Grammaire et Syntaxe,1,Les Subordonnees,6,395,6,QCM,0.04,0.84,87.55,46,7,53,52,46,6,1.02,88.46,Moyen,Facile,1,Plus Facile,Pas Adapte
4838,2019,Information-Communication,3,Grammaire et Syntaxe,1,Les Subordonnees,6,395,6,QCM,0.45,0.59,47.09,29,32,61,57,29,28,1.07,50.88,Moyen,Moyen,0,Meme Difficulté,Pas Adapte
5949,2020,Information-Communication,3,Grammaire et Syntaxe,1,Les Subordonnees,6,395,6,QCM,0.71,0.27,15.16,9,51,60,47,9,38,1.28,19.15,Difficile,Difficile,0,Meme Difficulté,Pas Adapte
395,2015,Information-Communication,3,Grammaire et Syntaxe,2,La Coordination,10,396,1,QO,0.42,0.3,37.52,20,33,53,35,20,15,1.51,57.14,Facile,Moyen,-1,Plus Difficile,Pas Adapte
1506,2016,Information-Communication,3,Grammaire et Syntaxe,2,La Coordination,10,396,1,QO,0.82,0.01,15.57,9,46,55,53,9,44,1.04,16.98,Moyen,Difficile,-1,Plus Difficile,Pas Adapte
2617,2017,Information-Communication,3,Grammaire et Syntaxe,2,La Coordination,10,396,1,QO,0.58,0.18,42.88,21,28,49,29,21,8,1.69,72.41,Moyen,Moyen,0,Meme Difficulté,Pas Adapte
3728,2018,Information-Communication,3,Grammaire et Syntaxe,2,La Coordination,10,396,1,QROC,0.99,0.25,24.98,12,36,48,29,12,17,1.66,41.38,Difficile,Difficile,0,Meme Difficulté,Pas Adapte
4839,2019,Information-Communication,3,Grammaire et Syntaxe,2,La Coordination,10,396,1,QROC,0.56,0.38,53.6,28,24,52,33,28,5,1.58,84.85,Difficile,Moyen,1,Plus Facile,Pas Adapte
5950,2020,Information-Communication,3,Grammaire et Syntaxe,2,La Coordination,10,396,1,QROC,0.18,0.56,92.84,44,3,47,46,44,2,1.02,95.65,Difficile,Facile,2,Beaucoup plus Facile,Pas Adapte
396,2015,Information-Communication,3,Grammaire et Syntaxe,2,La Coordination,10,397,2,QCM,0.57,0.25,16.52,2,12,14,4,2,2,3.5,50.0,Moyen,Difficile,-1,Plus Difficile,Pas Adapte
1507,2016,Information-Communication,3,Grammaire et Syntaxe,2,La Coordination,10,397,2,QCM,0.03,0.72,81.72,11,3,14,12,11,1,1.17,91.67,Facile,Facile,0,Meme Difficulté,Pas Adapte
2618,2017,Information-Communication,3,Grammaire et Syntaxe,2,La Coordination,10,397,2,QCM,0.08,0.91,94.03,12,1,13,13,12,1,1.0,92.31,Facile,Facile,0,Meme Difficulté,Pas Adapte
3729,2018,Information-Communication,3,Grammaire et Syntaxe,2,La Coordination,10,397,2,QCM,0.74,0.16,33.25,4,8,12,5,4,1,2.4,80.0,Difficile,Difficile,0,Meme Difficulté,Pas Adapte
4840,2019,Information-Communication,3,Grammaire et Syntaxe,2,La Coordination,10,397,2,QCU,0.38,0.49,48.68,5,6,11,6,5,1,1.83,83.33,Difficile,Moyen,1,Plus Facile,Pas Adapte
5951,2020,Information-Communication,3,Grammaire et Syntaxe,2,La Coordination,10,397,2,QCU,0.41,0.3,3.6,0,10,10,4,0,4,2.5,0.0,Facile,Difficile,-2,Beaucoup plus Difficile,Pas Adapte
397,2015,Information-Communication,3,Grammaire et Syntaxe,2,La Coordination,10,398,3,QO,0.86,0.11,26.9,10,26,36,28,10,18,1.29,35.71,Facile,Difficile,-2,Beaucoup plus Difficile,Pas Adapte
1508,2016,Information-Communication,3,Grammaire et Syntaxe,2,La Coordination,10,398,3,QO,0.73,0.28,56.92,22,17,39,32,22,10,1.22,68.75,Difficile,Moyen,1,Plus Facile,Pas Adapte
2619,2017,Information-Communication,3,Grammaire et Syntaxe,2,La Coordination,10,398,3,QO,0.69,0.16,49.6,19,19,38,37,19,18,1.03,51.35,Facile,Moyen,-1,Plus Difficile,Pas Adapte
3730,2018,Information-Communication,3,Grammaire et Syntaxe,2,La Coordination,10,398,3,QO,0.8,0.07,20.06,8,30,38,33,8,25,1.15,24.24,Moyen,Difficile,-1,Plus Difficile,Pas Adapte
4841,2019,Information-Communication,3,Grammaire et Syntaxe,2,La Coordination,10,398,3,QO,0.92,0.12,15.1,5,27,32,22,5,17,1.45,22.73,Difficile,Difficile,0,Meme Difficulté,Pas Adapte
5952,2020,Information-Communication,3,Grammaire et Syntaxe,2,La Coordination,10,398,3,QO,0.87,0.06,15.24,4,24,28,26,4,22,1.08,15.38,Facile,Difficile,-2,Beaucoup plus Difficile,Pas Adapte
398,2015,Information-Communication,3,Grammaire et Syntaxe,2,La Coordination,10,399,4,QCU,0.01,0.95,68.89,21,10,31,26,21,5,1.19,80.77,Moyen,Facile,1,Plus Facile,Adapte
1509,2016,Information-Communication,3,Grammaire et Syntaxe,2,La Coordination,10,399,4,QCU,0.02,0.77,68.89,19,8,27,20,19,1,1.35,95.0,Facile,Facile,0,Meme Difficulté,Adapte
2620,2017,Information-Communication,3,Grammaire et Syntaxe,2,La Coordination,10,399,4,QCU,0.0,0.95,68.89,20,9,29,21,20,1,1.38,95.24,Facile,Facile,0,Meme Difficulté,Adapte
3731,2018,Information-Communication,3,Grammaire et Syntaxe,2,La Coordination,10,399,4,QCM,0.17,0.91,68.89,23,10,33,29,23,6,1.14,79.31,Facile,Facile,0,Meme Difficulté,Adapte
4842,2019,Information-Communication,3,Grammaire et Syntaxe,2,La Coordination,10,399,4,QCM,0.08,0.73,68.89,25,12,37,34,25,9,1.09,73.53,Facile,Facile,0,Meme Difficulté,Adapte
5953,2020,Information-Communication,3,Grammaire et Syntaxe,2,La Coordination,10,399,4,QCM,0.07,0.92,68.89,24,11,35,32,24,8,1.09,75.0,Facile,Facile,0,Meme Difficulté,Adapte
399,2015,Information-Communication,3,Grammaire et Syntaxe,2,La Coordination,10,400,5,QCU,0.29,0.43,50.75,20,20,40,38,20,18,1.05,52.63,Moyen,Moyen,0,Meme Difficulté,Pas Adapte
1510,2016,Information-Communication,3,Grammaire et Syntaxe,2,La Coordination,10,400,5,QCU,0.27,0.6,64.31,28,16,44,33,28,5,1.33,84.85,Difficile,Moyen,1,Plus Facile,Pas Adapte
2621,2017,Information-Communication,3,Grammaire et Syntaxe,2,La Coordination,10,400,5,QCU,0.1,0.94,67.53,30,14,44,42,30,12,1.05,71.43,Moyen,Facile,1,Plus Facile,Adapte
3732,2018,Information-Communication,3,Grammaire et Syntaxe,2,La Coordination,10,400,5,QCU,0.09,0.8,67.53,32,15,47,35,32,3,1.34,91.43,Facile,Facile,0,Meme Difficulté,Adapte
4843,2019,Information-Communication,3,Grammaire et Syntaxe,2,La Coordination,10,400,5,QCU,0.09,0.91,67.53,34,17,51,43,34,9,1.19,79.07,Facile,Facile,0,Meme Difficulté,Adapte
5954,2020,Information-Communication,3,Grammaire et Syntaxe,2,La Coordination,10,400,5,QCM,0.15,0.8,67.53,36,18,54,50,36,14,1.08,72.0,Facile,Facile,0,Meme Difficulté,Adapte
400,2015,Information-Communication,3,Grammaire et Syntaxe,2,La Coordination,10,401,6,QO,0.78,0.13,16.51,12,59,71,59,12,47,1.2,20.34,Difficile,Difficile,0,Meme Difficulté,Pas Adapte
1511,2016,Information-Communication,3,Grammaire et Syntaxe,2,La Coordination,10,401,6,QO,0.71,0.27,38.92,30,46,76,39,30,9,1.95,76.92,Moyen,Moyen,0,Meme Difficulté,Pas Adapte
2622,2017,Information-Communication,3,Grammaire et Syntaxe,2,La Coordination,10,401,6,QO,0.89,0.01,13.6,12,74,86,50,12,38,1.72,24.0,Difficile,Difficile,0,Meme Difficulté,Pas Adapte
3733,2018,Information-Communication,3,Grammaire et Syntaxe,2,La Coordination,10,401,6,QO,0.95,0.03,7.67,7,86,93,65,7,58,1.43,10.77,Facile,Difficile,-2,Beaucoup plus Difficile,Pas Adapte
4844,2019,Information-Communication,3,Grammaire et Syntaxe,2,La Coordination,10,401,6,QO,0.17,0.66,71.43,66,26,92,67,66,1,1.37,98.51,Difficile,Facile,2,Beaucoup plus Facile,Adapte
5955,2020,Information-Communication,3,Grammaire et Syntaxe,2,La Coordination,10,401,6,QO,0.11,0.32,71.43,57,23,80,71,57,14,1.13,80.28,Facile,Facile,0,Meme Difficulté,Adapte
401,2015,Information-Communication,3,Grammaire et Syntaxe,2,La Coordination,10,402,7,QCU,0.14,0.79,83.59,59,12,71,63,59,4,1.13,93.65,Facile,Facile,0,Meme Difficulté,Pas Adapte
1512,2016,Information-Communication,3,Grammaire et Syntaxe,2,La Coordination,10,402,7,QCU,0.72,0.35,12.19,9,62,71,50,9,41,1.42,18.0,Moyen,Difficile,-1,Plus Difficile,Pas Adapte
2623,2017,Information-Communication,3,Grammaire et Syntaxe,2,La Coordination,10,402,7,QCU,0.73,0.24,8.81,6,61,67,63,6,57,1.06,9.52,Facile,Difficile,-2,Beaucoup plus Difficile,Pas Adapte
3734,2018,Information-Communication,3,Grammaire et Syntaxe,2,La Coordination,10,402,7,QCU,0.32,0.58,54.68,40,34,74,70,40,30,1.06,57.14,Difficile,Moyen,1,Plus Facile,Pas Adapte
4845,2019,Information-Communication,3,Grammaire et Syntaxe,2,La Coordination,10,402,7,QCU,0.49,0.37,7.29,6,73,79,64,6,58,1.23,9.38,Difficile,Difficile,0,Meme Difficulté,Pas Adapte
5956,2020,Information-Communication,3,Grammaire et Syntaxe,2,La Coordination,10,402,7,QCM,0.66,0.2,19.46,13,56,69,21,13,8,3.29,61.9,Moyen,Difficile,-1,Plus Difficile,Pas Adapte
402,2015,Information-Communication,3,Grammaire et Syntaxe,2,La Coordination,10,403,8,QCM,0.2,0.95,91.55,42,4,46,45,42,3,1.02,93.33,Moyen,Facile,1,Plus Facile,Pas Adapte
1513,2016,Information-Communication,3,Grammaire et Syntaxe,2,La Coordination,10,403,8,QCM,0.8,0.23,3.6,2,43,45,41,2,39,1.1,4.88,Facile,Difficile,-2,Beaucoup plus Difficile,Pas Adapte
2624,2017,Information-Communication,3,Grammaire et Syntaxe,2,La Coordination,10,403,8,QCM,0.11,0.74,95.27,40,2,42,40,40,0,1.05,100.0,Moyen,Facile,1,Plus Facile,Pas Adapte
3735,2018,Information-Communication,3,Grammaire et Syntaxe,2,La Coordination,10,403,8,QCM,0.33,0.53,39.21,17,27,44,41,17,24,1.07,41.46,Difficile,Moyen,1,Plus Facile,Pas Adapte
4846,2019,Information-Communication,3,Grammaire et Syntaxe,2,La Coordination,10,403,8,QCM,0.12,0.94,99.02,42,0,42,42,42,0,1.0,100.0,Difficile,Facile,2,Beaucoup plus Facile,Pas Adapte
5957,2020,Information-Communication,3,Grammaire et Syntaxe,2,La Coordination,10,403,8,QROC,0.09,0.51,97.37,40,1,41,40,40,0,1.02,100.0,Difficile,Facile,2,Beaucoup plus Facile,Pas Adapte
403,2015,Information-Communication,3,Grammaire et Syntaxe,2,La Coordination,10,404,9,QCU,0.28,0.62,45.88,45,54,99,99,45,54,1.0,45.45,Facile,Moyen,-1,Plus Difficile,Pas Adapte
1514,2016,Information-Communication,3,Grammaire et Syntaxe,2,La Coordination,10,404,9,QCU,0.11,0.97,90.2,89,10,99,97,89,8,1.02,91.75,Facile,Facile,0,Meme Difficulté,Pas Adapte
2625,2017,Information-Communication,3,Grammaire et Syntaxe,2,La Coordination,10,404,9,QCU,0.04,0.99,87.6,95,14,109,95,95,0,1.15,100.0,Difficile,Facile,2,Beaucoup plus Facile,Pas Adapte
3736,2018,Information-Communication,3,Grammaire et Syntaxe,2,La Coordination,10,404,9,QCU,0.33,0.67,42.49,48,66,114,53,48,5,2.15,90.57,Moyen,Moyen,0,Meme Difficulté,Pas Adapte
4847,2019,Information-Communication,3,Grammaire et Syntaxe,2,La Coordination,10,404,9,QCU,0.42,0.26,22.88,30,99,129,70,30,40,1.84,42.86,Moyen,Difficile,-1,Plus Difficile,Pas Adapte
5958,2020,Information-Communication,3,Grammaire et Syntaxe,2,La Coordination,10,404,9,QCU,0.15,0.92,86.75,120,18,138,132,120,12,1.05,90.91,Difficile,Facile,2,Beaucoup plus Facile,Pas Adapte
404,2015,Information-Communication,3,Grammaire et Syntaxe,2,La Coordination,10,405,10,QCU,0.47,0.3,3.34,1,26,27,11,1,10,2.45,9.09,Moyen,Difficile,-1,Plus Difficile,Pas Adapte
1515,2016,Information-Communication,3,Grammaire et Syntaxe,2,La Coordination,10,405,10,QCU,0.06,0.77,66.52,17,9,26,18,17,1,1.44,94.44,Moyen,Facile,1,Plus Facile,Adapte
2626,2017,Information-Communication,3,Grammaire et Syntaxe,2,La Coordination,10,405,10,QCU,0.03,0.93,66.52,20,10,30,26,20,6,1.15,76.92,Facile,Facile,0,Meme Difficulté,Adapte
3737,2018,Information-Communication,3,Grammaire et Syntaxe,2,La Coordination,10,405,10,QCU,0.05,0.9,66.52,18,9,27,23,18,5,1.17,78.26,Facile,Facile,0,Meme Difficulté,Adapte
4848,2019,Information-Communication,3,Grammaire et Syntaxe,2,La Coordination,10,405,10,QCU,0.11,0.77,66.52,15,8,23,16,15,1,1.44,93.75,Facile,Facile,0,Meme Difficulté,Adapte
5959,2020,Information-Communication,3,Grammaire et Syntaxe,2,La Coordination,10,405,10,QCM,0.16,0.7,66.52,16,8,24,23,16,7,1.04,69.57,Facile,Facile,0,Meme Difficulté,Adapte
405,2015,Information-Communication,3,Grammaire et Syntaxe,3,Le Statut des Pronoms,1,406,1,QCM,0.01,0.74,97.24,78,2,80,80,78,2,1.0,97.5,Facile,Facile,0,Meme Difficulté,Pas Adapte
1516,2016,Information-Communication,3,Grammaire et Syntaxe,3,Le Statut des Pronoms,1,406,1,QCM,0.44,0.45,44.57,37,45,82,71,37,34,1.15,52.11,Moyen,Moyen,0,Meme Difficulté,Pas Adapte
2627,2017,Information-Communication,3,Grammaire et Syntaxe,3,Le Statut des Pronoms,1,406,1,QCU,0.18,1.0,67.82,52,24,76,66,52,14,1.15,78.79,Facile,Facile,0,Meme Difficulté,Adapte
3738,2018,Information-Communication,3,Grammaire et Syntaxe,3,Le Statut des Pronoms,1,406,1,QCU,0.06,0.79,67.82,49,23,72,68,49,19,1.06,72.06,Facile,Facile,0,Meme Difficulté,Adapte
4849,2019,Information-Communication,3,Grammaire et Syntaxe,3,Le Statut des Pronoms,1,406,1,QCU,0.06,0.79,67.82,56,26,82,73,56,17,1.12,76.71,Facile,Facile,0,Meme Difficulté,Adapte
5960,2020,Information-Communication,3,Grammaire et Syntaxe,3,Le Statut des Pronoms,1,406,1,QROC,0.1,0.73,67.82,60,28,88,65,60,5,1.35,92.31,Facile,Facile,0,Meme Difficulté,Adapte
406,2015,Information-Communication,4,Neologie,1,Les Innovations Lexicales,13,407,1,QCM,0.34,0.47,57.32,18,14,32,29,18,11,1.1,62.07,Moyen,Moyen,0,Meme Difficulté,Pas Adapte
1517,2016,Information-Communication,4,Neologie,1,Les Innovations Lexicales,13,407,1,QCM,0.18,0.72,65.77,21,11,32,31,21,10,1.03,67.74,Difficile,Facile,2,Beaucoup plus Facile,Adapte
2628,2017,Information-Communication,4,Neologie,1,Les Innovations Lexicales,13,407,1,QCM,0.1,0.82,65.77,22,12,34,29,22,7,1.17,75.86,Facile,Facile,0,Meme Difficulté,Adapte
3739,2018,Information-Communication,4,Neologie,1,Les Innovations Lexicales,13,407,1,QCU,0.19,0.88,65.77,23,12,35,32,23,9,1.09,71.88,Facile,Facile,0,Meme Difficulté,Adapte
4850,2019,Information-Communication,4,Neologie,1,Les Innovations Lexicales,13,407,1,QCU,0.01,0.94,65.77,26,13,39,36,26,10,1.08,72.22,Facile,Facile,0,Meme Difficulté,Adapte
5961,2020,Information-Communication,4,Neologie,1,Les Innovations Lexicales,13,407,1,QCU,0.06,0.89,65.77,24,12,36,27,24,3,1.33,88.89,Facile,Facile,0,Meme Difficulté,Adapte
407,2015,Information-Communication,4,Neologie,1,Les Innovations Lexicales,13,408,2,QO,0.99,0.09,0.91,0,19,19,12,0,12,1.58,0.0,Difficile,Difficile,0,Meme Difficulté,Pas Adapte
1518,2016,Information-Communication,4,Neologie,1,Les Innovations Lexicales,13,408,2,QO,0.8,0.12,2.14,0,19,19,12,0,12,1.58,0.0,Moyen,Difficile,-1,Plus Difficile,Pas Adapte
2629,2017,Information-Communication,4,Neologie,1,Les Innovations Lexicales,13,408,2,QO,0.87,0.13,31.57,7,15,22,12,7,5,1.83,58.33,Facile,Difficile,-2,Beaucoup plus Difficile,Pas Adapte
3740,2018,Information-Communication,4,Neologie,1,Les Innovations Lexicales,13,408,2,QO,0.92,0.14,14.54,3,21,24,22,3,19,1.09,13.64,Difficile,Difficile,0,Meme Difficulté,Pas Adapte
4851,2019,Information-Communication,4,Neologie,1,Les Innovations Lexicales,13,408,2,QO,0.78,0.03,6.1,1,22,23,22,1,21,1.05,4.55,Difficile,Difficile,0,Meme Difficulté,Pas Adapte
5962,2020,Information-Communication,4,Neologie,1,Les Innovations Lexicales,13,408,2,QO,0.88,0.11,0.16,0,26,26,16,0,16,1.62,0.0,Facile,Difficile,-2,Beaucoup plus Difficile,Pas Adapte
408,2015,Information-Communication,4,Neologie,1,Les Innovations Lexicales,13,409,3,QCU,0.73,0.21,2.64,1,19,20,10,1,9,2.0,10.0,Facile,Difficile,-2,Beaucoup plus Difficile,Pas Adapte
1519,2016,Information-Communication,4,Neologie,1,Les Innovations Lexicales,13,409,3,QCU,0.69,0.25,22.16,4,13,17,10,4,6,1.7,40.0,Difficile,Difficile,0,Meme Difficulté,Pas Adapte
2630,2017,Information-Communication,4,Neologie,1,Les Innovations Lexicales,13,409,3,QCU,0.59,0.21,2.44,0,20,20,14,0,14,1.43,0.0,Facile,Difficile,-2,Beaucoup plus Difficile,Pas Adapte
3741,2018,Information-Communication,4,Neologie,1,Les Innovations Lexicales,13,409,3,QCU,0.29,0.7,53.54,10,9,19,16,10,6,1.19,62.5,Facile,Moyen,-1,Plus Difficile,Pas Adapte
4852,2019,Information-Communication,4,Neologie,1,Les Innovations Lexicales,13,409,3,QCU,0.09,0.85,68.66,12,6,18,16,12,4,1.12,75.0,Difficile,Facile,2,Beaucoup plus Facile,Adapte
5963,2020,Information-Communication,4,Neologie,1,Les Innovations Lexicales,13,409,3,QCU,0.01,0.86,68.66,14,6,20,14,14,0,1.43,100.0,Facile,Facile,0,Meme Difficulté,Adapte
409,2015,Information-Communication,4,Neologie,1,Les Innovations Lexicales,13,410,4,QCU,0.23,0.54,47.6,26,28,54,32,26,6,1.69,81.25,Facile,Moyen,-1,Plus Difficile,Pas Adapte
1520,2016,Information-Communication,4,Neologie,1,Les Innovations Lexicales,13,410,4,QCU,0.58,0.25,15.6,9,47,56,27,9,18,2.07,33.33,Facile,Difficile,-2,Beaucoup plus Difficile,Pas Adapte
2631,2017,Information-Communication,4,Neologie,1,Les Innovations Lexicales,13,410,4,QCU,0.21,0.69,44.54,25,32,57,51,25,26,1.12,49.02,Difficile,Moyen,1,Plus Facile,Pas Adapte
3742,2018,Information-Communication,4,Neologie,1,Les Innovations Lexicales,13,410,4,QCU,0.3,0.51,42.47,22,29,51,29,22,7,1.76,75.86,Facile,Moyen,-1,Plus Difficile,Pas Adapte
4853,2019,Information-Communication,4,Neologie,1,Les Innovations Lexicales,13,410,4,QCU,0.22,0.52,36.94,16,28,44,38,16,22,1.16,42.11,Moyen,Moyen,0,Meme Difficulté,Pas Adapte
5964,2020,Information-Communication,4,Neologie,1,Les Innovations Lexicales,13,410,4,QCU,0.01,0.93,95.16,46,2,48,46,46,0,1.04,100.0,Difficile,Facile,2,Beaucoup plus Facile,Pas Adapte
410,2015,Information-Communication,4,Neologie,1,Les Innovations Lexicales,13,411,5,QCU,0.63,0.39,25.85,5,14,19,8,5,3,2.38,62.5,Moyen,Difficile,-1,Plus Difficile,Pas Adapte
1521,2016,Information-Communication,4,Neologie,1,Les Innovations Lexicales,13,411,5,QCU,0.32,0.74,56.99,10,8,18,16,10,6,1.12,62.5,Moyen,Moyen,0,Meme Difficulté,Pas Adapte
2632,2017,Information-Communication,4,Neologie,1,Les Innovations Lexicales,13,411,5,QCU,0.24,0.44,59.65,13,8,21,15,13,2,1.4,86.67,Moyen,Moyen,0,Meme Difficulté,Pas Adapte
3743,2018,Information-Communication,4,Neologie,1,Les Innovations Lexicales,13,411,5,QCU,0.58,0.37,17.32,3,15,18,14,3,11,1.29,21.43,Facile,Difficile,-2,Beaucoup plus Difficile,Pas Adapte
4854,2019,Information-Communication,4,Neologie,1,Les Innovations Lexicales,13,411,5,QCU,0.35,0.42,37.97,7,12,19,14,7,7,1.36,50.0,Difficile,Moyen,1,Plus Facile,Pas Adapte
5965,2020,Information-Communication,4,Neologie,1,Les Innovations Lexicales,13,411,5,QCU,0.73,0.24,1.46,0,16,16,7,0,7,2.29,0.0,Moyen,Difficile,-1,Plus Difficile,Pas Adapte
411,2015,Information-Communication,4,Neologie,1,Les Innovations Lexicales,13,412,6,QCU,0.51,0.31,9.28,4,42,46,43,4,39,1.07,9.3,Difficile,Difficile,0,Meme Difficulté,Pas Adapte
1522,2016,Information-Communication,4,Neologie,1,Les Innovations Lexicales,13,412,6,QCU,0.18,0.83,68.4,28,13,41,33,28,5,1.24,84.85,Facile,Facile,0,Meme Difficulté,Adapte
2633,2017,Information-Communication,4,Neologie,1,Les Innovations Lexicales,13,412,6,QCU,0.04,0.83,68.4,30,14,44,44,30,14,1.0,68.18,Facile,Facile,0,Meme Difficulté,Adapte
3744,2018,Information-Communication,4,Neologie,1,Les Innovations Lexicales,13,412,6,QCU,0.05,0.89,68.4,25,12,37,36,25,11,1.03,69.44,Facile,Facile,0,Meme Difficulté,Adapte
4855,2019,Information-Communication,4,Neologie,1,Les Innovations Lexicales,13,412,6,QCM,0.06,0.79,68.4,24,11,35,31,24,7,1.13,77.42,Facile,Facile,0,Meme Difficulté,Adapte
5966,2020,Information-Communication,4,Neologie,1,Les Innovations Lexicales,13,412,6,QCM,0.08,0.9,68.4,27,13,40,38,27,11,1.05,71.05,Facile,Facile,0,Meme Difficulté,Adapte
412,2015,Information-Communication,4,Neologie,1,Les Innovations Lexicales,13,413,7,QO,0.03,0.5,69.41,38,17,55,44,38,6,1.25,86.36,Moyen,Facile,1,Plus Facile,Adapte
1523,2016,Information-Communication,4,Neologie,1,Les Innovations Lexicales,13,413,7,QROC,0.16,0.82,69.41,42,18,60,49,42,7,1.22,85.71,Facile,Facile,0,Meme Difficulté,Adapte
2634,2017,Information-Communication,4,Neologie,1,Les Innovations Lexicales,13,413,7,QROC,0.17,0.93,69.41,44,19,63,46,44,2,1.37,95.65,Facile,Facile,0,Meme Difficulté,Adapte
3745,2018,Information-Communication,4,Neologie,1,Les Innovations Lexicales,13,413,7,QROC,0.19,0.66,69.41,40,18,58,55,40,15,1.05,72.73,Facile,Facile,0,Meme Difficulté,Adapte
4856,2019,Information-Communication,4,Neologie,1,Les Innovations Lexicales,13,413,7,QROC,0.13,0.58,69.41,39,17,56,49,39,10,1.14,79.59,Facile,Facile,0,Meme Difficulté,Adapte
5967,2020,Information-Communication,4,Neologie,1,Les Innovations Lexicales,13,413,7,QROC,0.18,0.57,69.41,38,17,55,47,38,9,1.17,80.85,Facile,Facile,0,Meme Difficulté,Adapte
413,2015,Information-Communication,4,Neologie,1,Les Innovations Lexicales,13,414,8,QCU,0.08,0.8,67.67,28,13,41,40,28,12,1.02,70.0,Difficile,Facile,2,Beaucoup plus Facile,Adapte
1524,2016,Information-Communication,4,Neologie,1,Les Innovations Lexicales,13,414,8,QCU,0.15,0.84,67.67,24,12,36,25,24,1,1.44,96.0,Facile,Facile,0,Meme Difficulté,Adapte
2635,2017,Information-Communication,4,Neologie,1,Les Innovations Lexicales,13,414,8,QCU,0.16,0.94,67.67,25,12,37,32,25,7,1.16,78.12,Facile,Facile,0,Meme Difficulté,Adapte
3746,2018,Information-Communication,4,Neologie,1,Les Innovations Lexicales,13,414,8,QCU,0.01,0.98,67.67,24,12,36,27,24,3,1.33,88.89,Facile,Facile,0,Meme Difficulté,Adapte
4857,2019,Information-Communication,4,Neologie,1,Les Innovations Lexicales,13,414,8,QCU,0.06,0.91,67.67,26,13,39,33,26,7,1.18,78.79,Facile,Facile,0,Meme Difficulté,Adapte
5968,2020,Information-Communication,4,Neologie,1,Les Innovations Lexicales,13,414,8,QCU,0.01,0.82,67.67,27,13,40,40,27,13,1.0,67.5,Facile,Facile,0,Meme Difficulté,Adapte
414,2015,Information-Communication,4,Neologie,1,Les Innovations Lexicales,13,415,9,QCU,0.42,0.31,32.15,21,44,65,42,21,21,1.55,50.0,Facile,Difficile,-2,Beaucoup plus Difficile,Pas Adapte
1525,2016,Information-Communication,4,Neologie,1,Les Innovations Lexicales,13,415,9,QCU,0.21,0.43,64.47,48,26,74,49,48,1,1.51,97.96,Difficile,Moyen,1,Plus Facile,Pas Adapte
2636,2017,Information-Communication,4,Neologie,1,Les Innovations Lexicales,13,415,9,QCM,0.69,0.19,22.88,19,64,83,53,19,34,1.57,35.85,Facile,Difficile,-2,Beaucoup plus Difficile,Pas Adapte
3747,2018,Information-Communication,4,Neologie,1,Les Innovations Lexicales,13,415,9,QCM,0.24,0.43,52.15,46,43,89,61,46,15,1.46,75.41,Difficile,Moyen,1,Plus Facile,Pas Adapte
4858,2019,Information-Communication,4,Neologie,1,Les Innovations Lexicales,13,415,9,QCM,0.44,0.41,45.41,39,46,85,81,39,42,1.05,48.15,Difficile,Moyen,1,Plus Facile,Pas Adapte
5969,2020,Information-Communication,4,Neologie,1,Les Innovations Lexicales,13,415,9,QCM,0.7,0.29,34.01,33,63,96,76,33,43,1.26,43.42,Difficile,Difficile,0,Meme Difficulté,Pas Adapte
415,2015,Information-Communication,4,Neologie,1,Les Innovations Lexicales,13,416,10,QCM,0.56,0.24,21.41,1,4,5,3,1,2,1.67,33.33,Moyen,Difficile,-1,Plus Difficile,Pas Adapte
1526,2016,Information-Communication,4,Neologie,1,Les Innovations Lexicales,13,416,10,QCM,0.7,0.27,3.05,0,6,6,2,0,2,3.0,0.0,Difficile,Difficile,0,Meme Difficulté,Pas Adapte
2637,2017,Information-Communication,4,Neologie,1,Les Innovations Lexicales,13,416,10,QCM,0.28,0.54,35.29,2,4,6,2,2,0,3.0,100.0,Moyen,Moyen,0,Meme Difficulté,Pas Adapte
3748,2018,Information-Communication,4,Neologie,1,Les Innovations Lexicales,13,416,10,QCM,0.62,0.2,9.34,1,6,7,6,1,5,1.17,16.67,Difficile,Difficile,0,Meme Difficulté,Pas Adapte
4859,2019,Information-Communication,4,Neologie,1,Les Innovations Lexicales,13,416,10,QCM,0.01,0.85,82.62,6,1,7,7,6,1,1.0,85.71,Moyen,Facile,1,Plus Facile,Pas Adapte
5970,2020,Information-Communication,4,Neologie,1,Les Innovations Lexicales,13,416,10,QCM,0.35,0.32,54.01,4,3,7,5,4,1,1.4,80.0,Difficile,Moyen,1,Plus Facile,Pas Adapte
416,2015,Information-Communication,4,Neologie,1,Les Innovations Lexicales,13,417,11,QCM,0.41,0.53,50.26,45,45,90,67,45,22,1.34,67.16,Difficile,Moyen,1,Plus Facile,Pas Adapte
1527,2016,Information-Communication,4,Neologie,1,Les Innovations Lexicales,13,417,11,QCM,0.61,0.3,21.81,21,76,97,84,21,63,1.15,25.0,Facile,Difficile,-2,Beaucoup plus Difficile,Pas Adapte
2638,2017,Information-Communication,4,Neologie,1,Les Innovations Lexicales,13,417,11,QCU,0.5,0.38,20.99,22,83,105,79,22,57,1.33,27.85,Moyen,Difficile,-1,Plus Difficile,Pas Adapte
3749,2018,Information-Communication,4,Neologie,1,Les Innovations Lexicales,13,417,11,QCU,0.66,0.38,16.79,18,87,105,81,18,63,1.3,22.22,Difficile,Difficile,0,Meme Difficulté,Pas Adapte
4860,2019,Information-Communication,4,Neologie,1,Les Innovations Lexicales,13,417,11,QCU,0.15,0.93,79.51,76,20,96,79,76,3,1.22,96.2,Facile,Facile,0,Meme Difficulté,Pas Adapte
5971,2020,Information-Communication,4,Neologie,1,Les Innovations Lexicales,13,417,11,QCU,0.68,0.38,12.07,10,74,84,39,10,29,2.15,25.64,Moyen,Difficile,-1,Plus Difficile,Pas Adapte
417,2015,Information-Communication,4,Neologie,1,Les Innovations Lexicales,13,418,12,QROC,0.89,0.01,1.2,0,10,10,9,0,9,1.11,0.0,Moyen,Difficile,-1,Plus Difficile,Pas Adapte
1528,2016,Information-Communication,4,Neologie,1,Les Innovations Lexicales,13,418,12,QROC,0.72,0.17,2.67,0,9,9,4,0,4,2.25,0.0,Moyen,Difficile,-1,Plus Difficile,Pas Adapte
2639,2017,Information-Communication,4,Neologie,1,Les Innovations Lexicales,13,418,12,QROC,0.5,0.37,60.41,5,3,8,5,5,0,1.6,100.0,Moyen,Moyen,0,Meme Difficulté,Pas Adapte
3750,2018,Information-Communication,4,Neologie,1,Les Innovations Lexicales,13,418,12,QROC,0.45,0.37,54.27,4,3,7,5,4,1,1.4,80.0,Moyen,Moyen,0,Meme Difficulté,Pas Adapte
4861,2019,Information-Communication,4,Neologie,1,Les Innovations Lexicales,13,418,12,QROC,0.54,0.29,44.38,3,4,7,5,3,2,1.4,60.0,Facile,Moyen,-1,Plus Difficile,Pas Adapte
5972,2020,Information-Communication,4,Neologie,1,Les Innovations Lexicales,13,418,12,QROC,1.0,0.12,6.53,0,6,6,3,0,3,2.0,0.0,Facile,Difficile,-2,Beaucoup plus Difficile,Pas Adapte
418,2015,Information-Communication,4,Neologie,1,Les Innovations Lexicales,13,419,13,QCM,0.08,0.91,69.62,56,24,80,71,56,15,1.13,78.87,Difficile,Facile,2,Beaucoup plus Facile,Adapte
1529,2016,Information-Communication,4,Neologie,1,Les Innovations Lexicales,13,419,13,QCM,0.18,0.72,69.62,49,21,70,54,49,5,1.3,90.74,Facile,Facile,0,Meme Difficulté,Adapte
2640,2017,Information-Communication,4,Neologie,1,Les Innovations Lexicales,13,419,13,QCM,0.14,0.81,69.62,45,20,65,49,45,4,1.33,91.84,Facile,Facile,0,Meme Difficulté,Adapte
3751,2018,Information-Communication,4,Neologie,1,Les Innovations Lexicales,13,419,13,QCM,0.11,0.72,69.62,40,17,57,42,40,2,1.36,95.24,Facile,Facile,0,Meme Difficulté,Adapte
4862,2019,Information-Communication,4,Neologie,1,Les Innovations Lexicales,13,419,13,QCM,0.2,0.95,69.62,43,19,62,44,43,1,1.41,97.73,Facile,Facile,0,Meme Difficulté,Adapte
5973,2020,Information-Communication,4,Neologie,1,Les Innovations Lexicales,13,419,13,QCM,0.15,0.89,69.62,40,18,58,51,40,11,1.14,78.43,Facile,Facile,0,Meme Difficulté,Adapte
419,2015,Information-Communication,4,Neologie,2,La Motivation Neologique,7,420,1,QCU,0.63,0.31,28.31,17,43,60,40,17,23,1.5,42.5,Moyen,Difficile,-1,Plus Difficile,Pas Adapte
1530,2016,Information-Communication,4,Neologie,2,La Motivation Neologique,7,420,1,QCU,0.65,0.34,6.7,4,52,56,49,4,45,1.14,8.16,Difficile,Difficile,0,Meme Difficulté,Pas Adapte
2641,2017,Information-Communication,4,Neologie,2,La Motivation Neologique,7,420,1,QROC,0.46,0.34,56.02,31,24,55,53,31,22,1.04,58.49,Facile,Moyen,-1,Plus Difficile,Pas Adapte
3752,2018,Information-Communication,4,Neologie,2,La Motivation Neologique,7,420,1,QROC,0.01,0.91,80.83,39,9,48,43,39,4,1.12,90.7,Difficile,Facile,2,Beaucoup plus Facile,Pas Adapte
4863,2019,Information-Communication,4,Neologie,2,La Motivation Neologique,7,420,1,QROC,0.13,0.76,72.56,40,15,55,54,40,14,1.02,74.07,Facile,Facile,0,Meme Difficulté,Adapte
5974,2020,Information-Communication,4,Neologie,2,La Motivation Neologique,7,420,1,QROC,0.18,0.68,72.56,37,14,51,40,37,3,1.27,92.5,Facile,Facile,0,Meme Difficulté,Adapte
420,2015,Information-Communication,4,Neologie,2,La Motivation Neologique,7,421,2,QCM,0.33,0.7,58.73,16,12,28,22,16,6,1.27,72.73,Difficile,Moyen,1,Plus Facile,Pas Adapte
1531,2016,Information-Communication,4,Neologie,2,La Motivation Neologique,7,421,2,QCM,0.61,0.26,4.12,1,23,24,23,1,22,1.04,4.35,Facile,Difficile,-2,Beaucoup plus Difficile,Pas Adapte
2642,2017,Information-Communication,4,Neologie,2,La Motivation Neologique,7,421,2,QCM,0.53,0.25,28.54,8,19,27,11,8,3,2.45,72.73,Facile,Difficile,-2,Beaucoup plus Difficile,Pas Adapte
3753,2018,Information-Communication,4,Neologie,2,La Motivation Neologique,7,421,2,QCM,0.69,0.28,6.12,1,22,23,14,1,13,1.64,7.14,Moyen,Difficile,-1,Plus Difficile,Pas Adapte
4864,2019,Information-Communication,4,Neologie,2,La Motivation Neologique,7,421,2,QCM,0.2,0.89,80.36,16,4,20,16,16,0,1.25,100.0,Moyen,Facile,1,Plus Facile,Pas Adapte
5975,2020,Information-Communication,4,Neologie,2,La Motivation Neologique,7,421,2,QCM,0.58,0.19,23.19,5,17,22,8,5,3,2.75,62.5,Difficile,Difficile,0,Meme Difficulté,Pas Adapte
421,2015,Information-Communication,4,Neologie,2,La Motivation Neologique,7,422,3,QCM,0.06,0.78,69.93,30,13,43,38,30,8,1.13,78.95,Moyen,Facile,1,Plus Facile,Adapte
1532,2016,Information-Communication,4,Neologie,2,La Motivation Neologique,7,422,3,QCU,0.08,0.76,69.93,28,12,40,39,28,11,1.03,71.79,Facile,Facile,0,Meme Difficulté,Adapte
2643,2017,Information-Communication,4,Neologie,2,La Motivation Neologique,7,422,3,QCU,0.1,0.83,69.93,27,12,39,38,27,11,1.03,71.05,Facile,Facile,0,Meme Difficulté,Adapte
3754,2018,Information-Communication,4,Neologie,2,La Motivation Neologique,7,422,3,QCU,0.16,0.82,69.93,24,11,35,25,24,1,1.4,96.0,Facile,Facile,0,Meme Difficulté,Adapte
4865,2019,Information-Communication,4,Neologie,2,La Motivation Neologique,7,422,3,QCU,0.14,0.78,69.93,27,11,38,33,27,6,1.15,81.82,Facile,Facile,0,Meme Difficulté,Adapte
5976,2020,Information-Communication,4,Neologie,2,La Motivation Neologique,7,422,3,QCU,0.16,0.84,69.93,27,11,38,38,27,11,1.0,71.05,Facile,Facile,0,Meme Difficulté,Adapte
422,2015,Information-Communication,4,Neologie,2,La Motivation Neologique,7,423,4,QCM,0.38,0.52,40.57,39,56,95,41,39,2,2.32,95.12,Difficile,Moyen,1,Plus Facile,Pas Adapte
1533,2016,Information-Communication,4,Neologie,2,La Motivation Neologique,7,423,4,QCM,0.74,0.29,5.85,6,91,97,83,6,77,1.17,7.23,Facile,Difficile,-2,Beaucoup plus Difficile,Pas Adapte
2644,2017,Information-Communication,4,Neologie,2,La Motivation Neologique,7,423,4,QCM,0.01,0.8,76.17,62,20,82,63,62,1,1.3,98.41,Difficile,Facile,2,Beaucoup plus Facile,Pas Adapte
3755,2018,Information-Communication,4,Neologie,2,La Motivation Neologique,7,423,4,QCM,0.5,0.4,57.01,50,37,87,63,50,13,1.38,79.37,Difficile,Moyen,1,Plus Facile,Pas Adapte
4866,2019,Information-Communication,4,Neologie,2,La Motivation Neologique,7,423,4,QCM,0.75,0.24,8.44,7,78,85,34,7,27,2.5,20.59,Difficile,Difficile,0,Meme Difficulté,Pas Adapte
5977,2020,Information-Communication,4,Neologie,2,La Motivation Neologique,7,423,4,QCU,0.23,0.46,36.28,33,59,92,77,33,44,1.19,42.86,Facile,Moyen,-1,Plus Difficile,Pas Adapte
423,2015,Information-Communication,4,Neologie,2,La Motivation Neologique,7,424,5,QCU,0.7,0.24,15.92,6,30,36,17,6,11,2.12,35.29,Facile,Difficile,-2,Beaucoup plus Difficile,Pas Adapte
1534,2016,Information-Communication,4,Neologie,2,La Motivation Neologique,7,424,5,QCU,0.68,0.37,24.47,9,26,35,15,9,6,2.33,60.0,Facile,Difficile,-2,Beaucoup plus Difficile,Pas Adapte
2645,2017,Information-Communication,4,Neologie,2,La Motivation Neologique,7,424,5,QCU,0.7,0.22,7.09,3,33,36,22,3,19,1.64,13.64,Difficile,Difficile,0,Meme Difficulté,Pas Adapte
3756,2018,Information-Communication,4,Neologie,2,La Motivation Neologique,7,424,5,QCU,0.74,0.27,17.71,7,32,39,35,7,28,1.11,20.0,Difficile,Difficile,0,Meme Difficulté,Pas Adapte
4867,2019,Information-Communication,4,Neologie,2,La Motivation Neologique,7,424,5,QCU,0.41,0.4,17.23,6,31,37,18,6,12,2.06,33.33,Difficile,Difficile,0,Meme Difficulté,Pas Adapte
5978,2020,Information-Communication,4,Neologie,2,La Motivation Neologique,7,424,5,QROC,0.64,0.08,7.42,3,39,42,35,3,32,1.2,8.57,Difficile,Difficile,0,Meme Difficulté,Pas Adapte
424,2015,Information-Communication,4,Neologie,2,La Motivation Neologique,7,425,6,QO,0.14,0.55,65.66,55,29,84,76,55,21,1.11,72.37,Facile,Facile,0,Meme Difficulté,Adapte
1535,2016,Information-Communication,4,Neologie,2,La Motivation Neologique,7,425,6,QO,0.17,0.45,65.66,63,33,96,72,63,9,1.33,87.5,Facile,Facile,0,Meme Difficulté,Adapte
2646,2017,Information-Communication,4,Neologie,2,La Motivation Neologique,7,425,6,QO,0.03,0.53,65.66,72,38,110,81,72,9,1.36,88.89,Facile,Facile,0,Meme Difficulté,Adapte
3757,2018,Information-Communication,4,Neologie,2,La Motivation Neologique,7,425,6,QO,0.06,0.89,65.66,75,39,114,90,75,15,1.27,83.33,Facile,Facile,0,Meme Difficulté,Adapte
4868,2019,Information-Communication,4,Neologie,2,La Motivation Neologique,7,425,6,QO,0.19,0.86,65.66,64,33,97,79,64,15,1.23,81.01,Facile,Facile,0,Meme Difficulté,Adapte
5979,2020,Information-Communication,4,Neologie,2,La Motivation Neologique,7,425,6,QO,0.02,0.33,65.66,69,36,105,104,69,35,1.01,66.35,Facile,Facile,0,Meme Difficulté,Adapte
425,2015,Information-Communication,4,Neologie,2,La Motivation Neologique,7,426,7,QCU,0.32,0.55,41.8,18,26,44,40,18,22,1.1,45.0,Difficile,Moyen,1,Plus Facile,Pas Adapte
1536,2016,Information-Communication,4,Neologie,2,La Motivation Neologique,7,426,7,QCU,0.73,0.31,11.9,5,35,40,21,5,16,1.9,23.81,Moyen,Difficile,-1,Plus Difficile,Pas Adapte
2647,2017,Information-Communication,4,Neologie,2,La Motivation Neologique,7,426,7,QROC,0.67,0.15,7.14,3,35,38,29,3,26,1.31,10.34,Difficile,Difficile,0,Meme Difficulté,Pas Adapte
3758,2018,Information-Communication,4,Neologie,2,La Motivation Neologique,7,426,7,QROC,0.02,0.98,75.53,24,8,32,26,24,2,1.23,92.31,Difficile,Facile,2,Beaucoup plus Facile,Pas Adapte
4869,2019,Information-Communication,4,Neologie,2,La Motivation Neologique,7,426,7,QROC,0.07,0.46,71.52,26,11,37,28,26,2,1.32,92.86,Difficile,Facile,2,Beaucoup plus Facile,Adapte
5980,2020,Information-Communication,4,Neologie,2,La Motivation Neologique,7,426,7,QROC,0.05,0.55,71.52,22,9,31,29,22,7,1.07,75.86,Facile,Facile,0,Meme Difficulté,Adapte
426,2015,Information-Communication,4,Neologie,3,La Creation Neologique,9,427,1,QCU,0.04,0.81,80.57,79,19,98,96,79,17,1.02,82.29,Moyen,Facile,1,Plus Facile,Pas Adapte
1537,2016,Information-Communication,4,Neologie,3,La Creation Neologique,9,427,1,QCM,0.15,0.92,66.0,57,29,86,61,57,4,1.41,93.44,Facile,Facile,0,Meme Difficulté,Adapte
2648,2017,Information-Communication,4,Neologie,3,La Creation Neologique,9,427,1,QCM,0.06,0.93,66.0,59,31,90,71,59,12,1.27,83.1,Facile,Facile,0,Meme Difficulté,Adapte
3759,2018,Information-Communication,4,Neologie,3,La Creation Neologique,9,427,1,QCM,0.16,0.75,66.0,59,30,89,60,59,1,1.48,98.33,Facile,Facile,0,Meme Difficulté,Adapte
4870,2019,Information-Communication,4,Neologie,3,La Creation Neologique,9,427,1,QCM,0.14,0.72,66.0,67,35,102,81,67,14,1.26,82.72,Facile,Facile,0,Meme Difficulté,Adapte
5981,2020,Information-Communication,4,Neologie,3,La Creation Neologique,9,427,1,QCM,0.11,0.99,66.0,76,39,115,102,76,26,1.13,74.51,Facile,Facile,0,Meme Difficulté,Adapte
427,2015,Information-Communication,4,Neologie,3,La Creation Neologique,9,428,2,QCU,0.16,0.83,81.34,28,6,34,28,28,0,1.21,100.0,Moyen,Facile,1,Plus Facile,Pas Adapte
1538,2016,Information-Communication,4,Neologie,3,La Creation Neologique,9,428,2,QCU,0.67,0.33,9.34,3,29,32,24,3,21,1.33,12.5,Facile,Difficile,-2,Beaucoup plus Difficile,Pas Adapte
2649,2017,Information-Communication,4,Neologie,3,La Creation Neologique,9,428,2,QCU,0.2,0.46,35.05,12,22,34,32,12,20,1.06,37.5,Moyen,Moyen,0,Meme Difficulté,Pas Adapte
3760,2018,Information-Communication,4,Neologie,3,La Creation Neologique,9,428,2,QCU,0.29,0.5,43.21,15,20,35,16,15,1,2.19,93.75,Difficile,Moyen,1,Plus Facile,Pas Adapte
4871,2019,Information-Communication,4,Neologie,3,La Creation Neologique,9,428,2,QCU,0.14,0.9,99.95,32,0,32,32,32,0,1.0,100.0,Difficile,Facile,2,Beaucoup plus Facile,Pas Adapte
5982,2020,Information-Communication,4,Neologie,3,La Creation Neologique,9,428,2,QCU,0.43,0.38,22.95,7,22,29,19,7,12,1.53,36.84,Moyen,Difficile,-1,Plus Difficile,Pas Adapte
428,2015,Information-Communication,4,Neologie,3,La Creation Neologique,9,429,3,QROC,0.09,0.98,98.19,24,0,24,24,24,0,1.0,100.0,Moyen,Facile,1,Plus Facile,Pas Adapte
1539,2016,Information-Communication,4,Neologie,3,La Creation Neologique,9,429,3,QROC,0.99,0.08,11.23,3,25,28,14,3,11,2.0,21.43,Difficile,Difficile,0,Meme Difficulté,Pas Adapte
2650,2017,Information-Communication,4,Neologie,3,La Creation Neologique,9,429,3,QROC,0.72,0.12,7.73,2,26,28,27,2,25,1.04,7.41,Moyen,Difficile,-1,Plus Difficile,Pas Adapte
3761,2018,Information-Communication,4,Neologie,3,La Creation Neologique,9,429,3,QROC,0.46,0.34,50.99,14,14,28,19,14,5,1.47,73.68,Moyen,Moyen,0,Meme Difficulté,Pas Adapte
4872,2019,Information-Communication,4,Neologie,3,La Creation Neologique,9,429,3,QROC,1.0,0.04,23.02,7,23,30,24,7,17,1.25,29.17,Facile,Difficile,-2,Beaucoup plus Difficile,Pas Adapte
5983,2020,Information-Communication,4,Neologie,3,La Creation Neologique,9,429,3,QROC,0.35,0.34,38.8,12,19,31,19,12,7,1.63,63.16,Moyen,Moyen,0,Meme Difficulté,Pas Adapte
429,2015,Information-Communication,4,Neologie,3,La Creation Neologique,9,430,4,QCU,0.27,0.59,46.7,5,5,10,8,5,3,1.25,62.5,Moyen,Moyen,0,Meme Difficulté,Pas Adapte
1540,2016,Information-Communication,4,Neologie,3,La Creation Neologique,9,430,4,QCU,0.26,0.74,64.86,7,4,11,10,7,3,1.1,70.0,Facile,Moyen,-1,Plus Difficile,Pas Adapte
2651,2017,Information-Communication,4,Neologie,3,La Creation Neologique,9,430,4,QCU,0.01,0.75,74.64,7,3,10,9,7,2,1.11,77.78,Difficile,Facile,2,Beaucoup plus Facile,Adapte
3762,2018,Information-Communication,4,Neologie,3,La Creation Neologique,9,430,4,QCU,0.1,0.95,74.64,9,3,12,9,9,0,1.33,100.0,Facile,Facile,0,Meme Difficulté,Adapte
4873,2019,Information-Communication,4,Neologie,3,La Creation Neologique,9,430,4,QCM,0.08,0.77,74.64,9,3,12,10,9,1,1.2,90.0,Facile,Facile,0,Meme Difficulté,Adapte
5984,2020,Information-Communication,4,Neologie,3,La Creation Neologique,9,430,4,QCM,0.02,0.88,74.64,7,3,10,10,7,3,1.0,70.0,Facile,Facile,0,Meme Difficulté,Adapte
430,2015,Information-Communication,4,Neologie,3,La Creation Neologique,9,431,5,QCU,0.42,0.22,28.94,27,66,93,57,27,30,1.63,47.37,Facile,Difficile,-2,Beaucoup plus Difficile,Pas Adapte
1541,2016,Information-Communication,4,Neologie,3,La Creation Neologique,9,431,5,QCU,0.39,0.46,50.27,50,49,99,51,50,1,1.94,98.04,Facile,Moyen,-1,Plus Difficile,Pas Adapte
2652,2017,Information-Communication,4,Neologie,3,La Creation Neologique,9,431,5,QCU,0.62,0.24,12.77,12,85,97,50,12,38,1.94,24.0,Moyen,Difficile,-1,Plus Difficile,Pas Adapte
3763,2018,Information-Communication,4,Neologie,3,La Creation Neologique,9,431,5,QCU,0.43,0.3,20.69,17,67,84,70,17,53,1.2,24.29,Facile,Difficile,-2,Beaucoup plus Difficile,Pas Adapte
4874,2019,Information-Communication,4,Neologie,3,La Creation Neologique,9,431,5,QCU,0.51,0.34,14.01,12,75,87,58,12,46,1.5,20.69,Moyen,Difficile,-1,Plus Difficile,Pas Adapte
5985,2020,Information-Communication,4,Neologie,3,La Creation Neologique,9,431,5,QCM,0.45,0.5,61.54,55,34,89,67,55,12,1.33,82.09,Difficile,Moyen,1,Plus Facile,Pas Adapte
431,2015,Information-Communication,4,Neologie,3,La Creation Neologique,9,432,6,QCU,0.67,0.38,23.8,20,63,83,40,20,20,2.08,50.0,Facile,Difficile,-2,Beaucoup plus Difficile,Pas Adapte
1542,2016,Information-Communication,4,Neologie,3,La Creation Neologique,9,432,6,QCU,0.57,0.23,13.91,11,69,80,56,11,45,1.43,19.64,Moyen,Difficile,-1,Plus Difficile,Pas Adapte
2653,2017,Information-Communication,4,Neologie,3,La Creation Neologique,9,432,6,QCU,0.75,0.33,6.02,4,69,73,42,4,38,1.74,9.52,Difficile,Difficile,0,Meme Difficulté,Pas Adapte
3764,2018,Information-Communication,4,Neologie,3,La Creation Neologique,9,432,6,QCU,0.2,0.81,90.92,67,7,74,71,67,4,1.04,94.37,Difficile,Facile,2,Beaucoup plus Facile,Pas Adapte
4875,2019,Information-Communication,4,Neologie,3,La Creation Neologique,9,432,6,QCU,0.53,0.3,29.1,24,60,84,43,24,19,1.95,55.81,Facile,Difficile,-2,Beaucoup plus Difficile,Pas Adapte
5986,2020,Information-Communication,4,Neologie,3,La Creation Neologique,9,432,6,QCU,0.14,0.91,71.79,69,27,96,83,69,14,1.16,83.13,Moyen,Facile,1,Plus Facile,Adapte
432,2015,Information-Communication,4,Neologie,3,La Creation Neologique,9,433,7,QCU,0.17,0.97,84.12,27,5,32,28,27,1,1.14,96.43,Moyen,Facile,1,Plus Facile,Pas Adapte
1543,2016,Information-Communication,4,Neologie,3,La Creation Neologique,9,433,7,QCU,0.1,0.83,87.1,31,5,36,35,31,4,1.03,88.57,Moyen,Facile,1,Plus Facile,Pas Adapte
2654,2017,Information-Communication,4,Neologie,3,La Creation Neologique,9,433,7,QCU,0.41,0.32,21.31,9,31,40,19,9,10,2.11,47.37,Moyen,Difficile,-1,Plus Difficile,Pas Adapte
3765,2018,Information-Communication,4,Neologie,3,La Creation Neologique,9,433,7,QCU,0.39,0.74,55.46,23,18,41,30,23,7,1.37,76.67,Difficile,Moyen,1,Plus Facile,Pas Adapte
4876,2019,Information-Communication,4,Neologie,3,La Creation Neologique,9,433,7,QCU,0.35,0.46,45.33,20,25,45,24,20,4,1.88,83.33,Facile,Moyen,-1,Plus Difficile,Pas Adapte
5987,2020,Information-Communication,4,Neologie,3,La Creation Neologique,9,433,7,QCU,0.04,0.9,77.86,34,10,44,37,34,3,1.19,91.89,Moyen,Facile,1,Plus Facile,Pas Adapte
433,2015,Information-Communication,4,Neologie,3,La Creation Neologique,9,434,8,QCU,0.19,0.95,98.82,56,1,57,56,56,0,1.02,100.0,Facile,Facile,0,Meme Difficulté,Pas Adapte
1544,2016,Information-Communication,4,Neologie,3,La Creation Neologique,9,434,8,QCM,0.23,0.7,39.8,26,40,66,58,26,32,1.14,44.83,Moyen,Moyen,0,Meme Difficulté,Pas Adapte
2655,2017,Information-Communication,4,Neologie,3,La Creation Neologique,9,434,8,QCM,0.73,0.19,7.58,6,69,75,59,6,53,1.27,10.17,Facile,Difficile,-2,Beaucoup plus Difficile,Pas Adapte
3766,2018,Information-Communication,4,Neologie,3,La Creation Neologique,9,434,8,QCM,0.32,0.33,49.42,32,33,65,32,32,0,2.03,100.0,Facile,Moyen,-1,Plus Difficile,Pas Adapte
4877,2019,Information-Communication,4,Neologie,3,La Creation Neologique,9,434,8,QCM,0.38,0.41,53.25,33,29,62,59,33,26,1.05,55.93,Difficile,Moyen,1,Plus Facile,Pas Adapte
5988,2020,Information-Communication,4,Neologie,3,La Creation Neologique,9,434,8,QCM,0.1,0.94,97.12,68,2,70,69,68,1,1.01,98.55,Difficile,Facile,2,Beaucoup plus Facile,Pas Adapte
434,2015,Information-Communication,4,Neologie,3,La Creation Neologique,9,435,9,QO,0.5,0.23,62.85,45,26,71,50,45,5,1.42,90.0,Difficile,Moyen,1,Plus Facile,Pas Adapte
1545,2016,Information-Communication,4,Neologie,3,La Creation Neologique,9,435,9,QO,0.26,0.26,55.3,35,28,63,62,35,27,1.02,56.45,Difficile,Moyen,1,Plus Facile,Pas Adapte
2656,2017,Information-Communication,4,Neologie,3,La Creation Neologique,9,435,9,QO,0.12,0.47,68.52,38,18,56,54,38,16,1.04,70.37,Difficile,Facile,2,Beaucoup plus Facile,Adapte
3767,2018,Information-Communication,4,Neologie,3,La Creation Neologique,9,435,9,QO,0.04,0.79,68.52,38,17,55,42,38,4,1.31,90.48,Facile,Facile,0,Meme Difficulté,Adapte
4878,2019,Information-Communication,4,Neologie,3,La Creation Neologique,9,435,9,QO,0.02,0.98,68.52,41,19,60,54,41,13,1.11,75.93,Facile,Facile,0,Meme Difficulté,Adapte
5989,2020,Information-Communication,4,Neologie,3,La Creation Neologique,9,435,9,QO,0.05,0.58,68.52,42,19,61,49,42,7,1.24,85.71,Facile,Facile,0,Meme Difficulté,Adapte
435,2015,Information-Communication,4,Neologie,4,Les Accidents Lexicaux,10,436,1,QCM,0.15,0.75,88.36,84,11,95,91,84,7,1.04,92.31,Facile,Facile,0,Meme Difficulté,Pas Adapte
1546,2016,Information-Communication,4,Neologie,4,Les Accidents Lexicaux,10,436,1,QCM,0.02,0.88,65.41,53,28,81,73,53,20,1.11,72.6,Moyen,Facile,1,Plus Facile,Adapte
2657,2017,Information-Communication,4,Neologie,4,Les Accidents Lexicaux,10,436,1,QCM,0.03,0.94,65.41,53,28,81,54,53,1,1.5,98.15,Facile,Facile,0,Meme Difficulté,Adapte
3768,2018,Information-Communication,4,Neologie,4,Les Accidents Lexicaux,10,436,1,QCM,0.05,0.71,65.41,58,31,89,75,58,17,1.19,77.33,Facile,Facile,0,Meme Difficulté,Adapte
4879,2019,Information-Communication,4,Neologie,4,Les Accidents Lexicaux,10,436,1,QCM,0.02,0.99,65.41,61,33,94,77,61,16,1.22,79.22,Facile,Facile,0,Meme Difficulté,Adapte
5990,2020,Information-Communication,4,Neologie,4,Les Accidents Lexicaux,10,436,1,QCM,0.13,0.93,65.41,69,36,105,73,69,4,1.44,94.52,Facile,Facile,0,Meme Difficulté,Adapte
436,2015,Information-Communication,4,Neologie,4,Les Accidents Lexicaux,10,437,2,QCM,0.41,0.48,40.03,22,33,55,43,22,21,1.28,51.16,Moyen,Moyen,0,Meme Difficulté,Pas Adapte
1547,2016,Information-Communication,4,Neologie,4,Les Accidents Lexicaux,10,437,2,QCM,0.01,0.93,72.87,43,16,59,48,43,5,1.23,89.58,Moyen,Facile,1,Plus Facile,Adapte
2658,2017,Information-Communication,4,Neologie,4,Les Accidents Lexicaux,10,437,2,QCM,0.19,0.98,72.87,44,16,60,44,44,0,1.36,100.0,Facile,Facile,0,Meme Difficulté,Adapte
3769,2018,Information-Communication,4,Neologie,4,Les Accidents Lexicaux,10,437,2,QCM,0.12,0.97,72.87,49,18,67,54,49,5,1.24,90.74,Facile,Facile,0,Meme Difficulté,Adapte
4880,2019,Information-Communication,4,Neologie,4,Les Accidents Lexicaux,10,437,2,QCM,0.04,0.82,72.87,55,20,75,65,55,10,1.15,84.62,Facile,Facile,0,Meme Difficulté,Adapte
5991,2020,Information-Communication,4,Neologie,4,Les Accidents Lexicaux,10,437,2,QO,0.04,0.77,72.87,60,22,82,72,60,12,1.14,83.33,Facile,Facile,0,Meme Difficulté,Adapte
437,2015,Information-Communication,4,Neologie,4,Les Accidents Lexicaux,10,438,3,QCM,0.02,0.84,85.5,28,5,33,29,28,1,1.14,96.55,Moyen,Facile,1,Plus Facile,Pas Adapte
1548,2016,Information-Communication,4,Neologie,4,Les Accidents Lexicaux,10,438,3,QCM,0.1,0.94,70.7,20,8,28,23,20,3,1.22,86.96,Moyen,Facile,1,Plus Facile,Adapte
2659,2017,Information-Communication,4,Neologie,4,Les Accidents Lexicaux,10,438,3,QCM,0.0,0.88,70.7,18,8,26,25,18,7,1.04,72.0,Facile,Facile,0,Meme Difficulté,Adapte
3770,2018,Information-Communication,4,Neologie,4,Les Accidents Lexicaux,10,438,3,QCM,0.12,0.72,70.7,18,8,26,21,18,3,1.24,85.71,Facile,Facile,0,Meme Difficulté,Adapte
4881,2019,Information-Communication,4,Neologie,4,Les Accidents Lexicaux,10,438,3,QCM,0.12,0.94,70.7,18,8,26,22,18,4,1.18,81.82,Facile,Facile,0,Meme Difficulté,Adapte
5992,2020,Information-Communication,4,Neologie,4,Les Accidents Lexicaux,10,438,3,QCM,0.18,0.98,70.7,21,8,29,23,21,2,1.26,91.3,Facile,Facile,0,Meme Difficulté,Adapte
438,2015,Information-Communication,4,Neologie,4,Les Accidents Lexicaux,10,439,4,QCU,0.44,0.27,17.4,16,77,93,90,16,74,1.03,17.78,Difficile,Difficile,0,Meme Difficulté,Pas Adapte
1549,2016,Information-Communication,4,Neologie,4,Les Accidents Lexicaux,10,439,4,QROC,0.76,0.1,34.32,35,66,101,90,35,55,1.12,38.89,Facile,Difficile,-2,Beaucoup plus Difficile,Pas Adapte
2660,2017,Information-Communication,4,Neologie,4,Les Accidents Lexicaux,10,439,4,QROC,0.63,0.18,33.95,36,69,105,88,36,52,1.19,40.91,Moyen,Difficile,-1,Plus Difficile,Pas Adapte
3771,2018,Information-Communication,4,Neologie,4,Les Accidents Lexicaux,10,439,4,QROC,0.23,0.25,64.95,65,35,100,84,65,19,1.19,77.38,Difficile,Moyen,1,Plus Facile,Pas Adapte
4882,2019,Information-Communication,4,Neologie,4,Les Accidents Lexicaux,10,439,4,QROC,0.74,0.23,30.61,28,63,91,51,28,23,1.78,54.9,Moyen,Difficile,-1,Plus Difficile,Pas Adapte
5993,2020,Information-Communication,4,Neologie,4,Les Accidents Lexicaux,10,439,4,QO,0.84,0.1,3.19,3,84,87,77,3,74,1.13,3.9,Difficile,Difficile,0,Meme Difficulté,Pas Adapte
439,2015,Information-Communication,4,Neologie,4,Les Accidents Lexicaux,10,440,5,QCM,0.68,0.21,9.5,1,6,7,3,1,2,2.33,33.33,Facile,Difficile,-2,Beaucoup plus Difficile,Pas Adapte
1550,2016,Information-Communication,4,Neologie,4,Les Accidents Lexicaux,10,440,5,QCM,0.11,0.9,90.54,7,1,8,8,7,1,1.0,87.5,Difficile,Facile,2,Beaucoup plus Facile,Pas Adapte
2661,2017,Information-Communication,4,Neologie,4,Les Accidents Lexicaux,10,440,5,QROC,0.06,0.72,66.44,5,2,7,6,5,1,1.17,83.33,Difficile,Facile,2,Beaucoup plus Facile,Adapte
3772,2018,Information-Communication,4,Neologie,4,Les Accidents Lexicaux,10,440,5,QROC,0.06,0.81,66.44,5,2,7,5,5,0,1.4,100.0,Facile,Facile,0,Meme Difficulté,Adapte
4883,2019,Information-Communication,4,Neologie,4,Les Accidents Lexicaux,10,440,5,QCM,0.18,0.81,66.44,5,2,7,6,5,1,1.17,83.33,Facile,Facile,0,Meme Difficulté,Adapte
5994,2020,Information-Communication,4,Neologie,4,Les Accidents Lexicaux,10,440,5,QCM,0.14,0.82,66.44,5,3,8,7,5,2,1.14,71.43,Facile,Facile,0,Meme Difficulté,Adapte
440,2015,Information-Communication,4,Neologie,4,Les Accidents Lexicaux,10,441,6,QCM,0.01,0.99,77.06,6,2,8,8,6,2,1.0,75.0,Moyen,Facile,1,Plus Facile,Pas Adapte
1551,2016,Information-Communication,4,Neologie,4,Les Accidents Lexicaux,10,441,6,QCM,0.6,0.19,9.94,1,8,9,7,1,6,1.29,14.29,Moyen,Difficile,-1,Plus Difficile,Pas Adapte
2662,2017,Information-Communication,4,Neologie,4,Les Accidents Lexicaux,10,441,6,QCM,0.02,0.85,89.39,8,1,9,9,8,1,1.0,88.89,Difficile,Facile,2,Beaucoup plus Facile,Pas Adapte
3773,2018,Information-Communication,4,Neologie,4,Les Accidents Lexicaux,10,441,6,QCM,0.65,0.22,32.43,3,5,8,6,3,3,1.33,50.0,Moyen,Difficile,-1,Plus Difficile,Pas Adapte
4884,2019,Information-Communication,4,Neologie,4,Les Accidents Lexicaux,10,441,6,QCM,0.02,0.89,97.43,8,0,8,8,8,0,1.0,100.0,Facile,Facile,0,Meme Difficulté,Pas Adapte
5995,2020,Information-Communication,4,Neologie,4,Les Accidents Lexicaux,10,441,6,QCM,0.06,0.84,76.56,5,2,7,5,5,0,1.4,100.0,Difficile,Facile,2,Beaucoup plus Facile,Pas Adapte
441,2015,Information-Communication,4,Neologie,4,Les Accidents Lexicaux,10,442,7,QROC,0.52,0.32,46.04,14,17,31,17,14,3,1.82,82.35,Facile,Moyen,-1,Plus Difficile,Pas Adapte
1552,2016,Information-Communication,4,Neologie,4,Les Accidents Lexicaux,10,442,7,QROC,0.08,0.5,98.7,26,0,26,26,26,0,1.0,100.0,Moyen,Facile,1,Plus Facile,Pas Adapte
2663,2017,Information-Communication,4,Neologie,4,Les Accidents Lexicaux,10,442,7,QROC,0.96,0.24,28.75,7,17,24,22,7,15,1.09,31.82,Difficile,Difficile,0,Meme Difficulté,Pas Adapte
3774,2018,Information-Communication,4,Neologie,4,Les Accidents Lexicaux,10,442,7,QROC,0.05,0.44,98.01,25,0,25,25,25,0,1.0,100.0,Difficile,Facile,2,Beaucoup plus Facile,Pas Adapte
4885,2019,Information-Communication,4,Neologie,4,Les Accidents Lexicaux,10,442,7,QO,0.84,0.12,14.73,4,22,26,23,4,19,1.13,17.39,Difficile,Difficile,0,Meme Difficulté,Pas Adapte
5996,2020,Information-Communication,4,Neologie,4,Les Accidents Lexicaux,10,442,7,QO,0.42,0.21,36.14,8,14,22,19,8,11,1.16,42.11,Facile,Moyen,-1,Plus Difficile,Pas Adapte
442,2015,Information-Communication,4,Neologie,4,Les Accidents Lexicaux,10,443,8,QROC,0.27,0.28,36.29,29,51,80,71,29,42,1.13,40.85,Moyen,Moyen,0,Meme Difficulté,Pas Adapte
1553,2016,Information-Communication,4,Neologie,4,Les Accidents Lexicaux,10,443,8,QROC,0.76,0.15,13.81,10,61,71,70,10,60,1.01,14.29,Moyen,Difficile,-1,Plus Difficile,Pas Adapte
2664,2017,Information-Communication,4,Neologie,4,Les Accidents Lexicaux,10,443,8,QROC,0.22,0.4,37.68,28,45,73,62,28,34,1.18,45.16,Moyen,Moyen,0,Meme Difficulté,Pas Adapte
3775,2018,Information-Communication,4,Neologie,4,Les Accidents Lexicaux,10,443,8,QROC,0.0,0.61,73.47,46,17,63,50,46,4,1.26,92.0,Difficile,Facile,2,Beaucoup plus Facile,Adapte
4886,2019,Information-Communication,4,Neologie,4,Les Accidents Lexicaux,10,443,8,QROC,0.18,0.59,73.47,41,15,56,47,41,6,1.19,87.23,Facile,Facile,0,Meme Difficulté,Adapte
5997,2020,Information-Communication,4,Neologie,4,Les Accidents Lexicaux,10,443,8,QROC,0.0,0.6,73.47,47,17,64,56,47,9,1.14,83.93,Facile,Facile,0,Meme Difficulté,Adapte
443,2015,Information-Communication,4,Neologie,4,Les Accidents Lexicaux,10,444,9,QCM,0.17,0.8,83.48,9,2,11,9,9,0,1.22,100.0,Moyen,Facile,1,Plus Facile,Pas Adapte
1554,2016,Information-Communication,4,Neologie,4,Les Accidents Lexicaux,10,444,9,QCM,0.1,0.85,87.32,10,1,11,10,10,0,1.1,100.0,Moyen,Facile,1,Plus Facile,Pas Adapte
2665,2017,Information-Communication,4,Neologie,4,Les Accidents Lexicaux,10,444,9,QCM,0.79,0.17,2.18,0,11,11,3,0,3,3.67,0.0,Moyen,Difficile,-1,Plus Difficile,Pas Adapte
3776,2018,Information-Communication,4,Neologie,4,Les Accidents Lexicaux,10,444,9,QCM,0.37,0.33,35.91,4,8,12,9,4,5,1.33,44.44,Facile,Moyen,-1,Plus Difficile,Pas Adapte
4887,2019,Information-Communication,4,Neologie,4,Les Accidents Lexicaux,10,444,9,QCM,0.07,0.8,97.13,11,0,11,11,11,0,1.0,100.0,Facile,Facile,0,Meme Difficulté,Pas Adapte
5998,2020,Information-Communication,4,Neologie,4,Les Accidents Lexicaux,10,444,9,QCM,0.51,0.22,17.62,2,9,11,8,2,6,1.38,25.0,Facile,Difficile,-2,Beaucoup plus Difficile,Pas Adapte
444,2015,Information-Communication,4,Neologie,4,Les Accidents Lexicaux,10,445,10,QCU,0.33,0.69,51.88,8,8,16,10,8,2,1.6,80.0,Difficile,Moyen,1,Plus Facile,Pas Adapte
1555,2016,Information-Communication,4,Neologie,4,Les Accidents Lexicaux,10,445,10,QCU,0.59,0.38,25.24,4,11,15,8,4,4,1.88,50.0,Difficile,Difficile,0,Meme Difficulté,Pas Adapte
2666,2017,Information-Communication,4,Neologie,4,Les Accidents Lexicaux,10,445,10,QCU,0.21,0.75,48.32,7,8,15,14,7,7,1.07,50.0,Facile,Moyen,-1,Plus Difficile,Pas Adapte
3777,2018,Information-Communication,4,Neologie,4,Les Accidents Lexicaux,10,445,10,QCU,0.68,0.34,33.32,5,9,14,10,5,5,1.4,50.0,Facile,Difficile,-2,Beaucoup plus Difficile,Pas Adapte
4888,2019,Information-Communication,4,Neologie,4,Les Accidents Lexicaux,10,445,10,QCU,0.33,0.49,55.15,7,6,13,8,7,1,1.62,87.5,Facile,Moyen,-1,Plus Difficile,Pas Adapte
5999,2020,Information-Communication,4,Neologie,4,Les Accidents Lexicaux,10,445,10,QCU,0.56,0.29,7.22,1,12,13,11,1,10,1.18,9.09,Moyen,Difficile,-1,Plus Difficile,Pas Adapte
445,2015,Information-Communication,5,Construction Morphologique,1,Alterations,6,446,1,QCU,0.53,0.26,10.03,10,90,100,41,10,31,2.44,24.39,Difficile,Difficile,0,Meme Difficulté,Pas Adapte
1556,2016,Information-Communication,5,Construction Morphologique,1,Alterations,6,446,1,QCU,0.07,0.93,91.9,96,8,104,102,96,6,1.02,94.12,Difficile,Facile,2,Beaucoup plus Facile,Pas Adapte
2667,2017,Information-Communication,5,Construction Morphologique,1,Alterations,6,446,1,QCM,0.53,0.21,14.31,15,93,108,59,15,44,1.83,25.42,Difficile,Difficile,0,Meme Difficulté,Pas Adapte
3778,2018,Information-Communication,5,Construction Morphologique,1,Alterations,6,446,1,QCM,0.21,0.67,43.95,49,62,111,97,49,48,1.14,50.52,Difficile,Moyen,1,Plus Facile,Pas Adapte
4889,2019,Information-Communication,5,Construction Morphologique,1,Alterations,6,446,1,QCM,0.32,0.47,50.89,49,48,97,65,49,16,1.49,75.38,Difficile,Moyen,1,Plus Facile,Pas Adapte
6000,2020,Information-Communication,5,Construction Morphologique,1,Alterations,6,446,1,QCM,0.33,0.62,39.19,33,52,85,35,33,2,2.43,94.29,Facile,Moyen,-1,Plus Difficile,Pas Adapte
446,2015,Information-Communication,5,Construction Morphologique,1,Alterations,6,447,2,QCM,0.58,0.26,0.43,0,96,96,47,0,47,2.04,0.0,Moyen,Difficile,-1,Plus Difficile,Pas Adapte
1557,2016,Information-Communication,5,Construction Morphologique,1,Alterations,6,447,2,QCU,0.75,0.38,18.28,20,89,109,89,20,69,1.22,22.47,Facile,Difficile,-2,Beaucoup plus Difficile,Pas Adapte
2668,2017,Information-Communication,5,Construction Morphologique,1,Alterations,6,447,2,QCU,0.22,0.57,58.83,68,48,116,69,68,1,1.68,98.55,Difficile,Moyen,1,Plus Facile,Pas Adapte
3779,2018,Information-Communication,5,Construction Morphologique,1,Alterations,6,447,2,QCU,0.49,0.21,22.73,25,87,112,76,25,51,1.47,32.89,Moyen,Difficile,-1,Plus Difficile,Pas Adapte
4890,2019,Information-Communication,5,Construction Morphologique,1,Alterations,6,447,2,QCU,0.53,0.34,8.98,10,100,110,71,10,61,1.55,14.08,Facile,Difficile,-2,Beaucoup plus Difficile,Pas Adapte
6001,2020,Information-Communication,5,Construction Morphologique,1,Alterations,6,447,2,QCM,0.12,0.93,78.72,83,23,106,88,83,5,1.2,94.32,Facile,Facile,0,Meme Difficulté,Pas Adapte
447,2015,Information-Communication,5,Construction Morphologique,1,Alterations,6,448,3,QCU,0.47,0.3,25.17,9,25,34,24,9,15,1.42,37.5,Difficile,Difficile,0,Meme Difficulté,Pas Adapte
1558,2016,Information-Communication,5,Construction Morphologique,1,Alterations,6,448,3,QO,0.2,0.88,90.59,34,3,37,36,34,2,1.03,94.44,Moyen,Facile,1,Plus Facile,Pas Adapte
2669,2017,Information-Communication,5,Construction Morphologique,1,Alterations,6,448,3,QO,0.89,0.14,7.7,3,38,41,21,3,18,1.95,14.29,Facile,Difficile,-2,Beaucoup plus Difficile,Pas Adapte
3780,2018,Information-Communication,5,Construction Morphologique,1,Alterations,6,448,3,QO,0.99,0.04,4.7,2,35,37,37,2,35,1.0,5.41,Moyen,Difficile,-1,Plus Difficile,Pas Adapte
4891,2019,Information-Communication,5,Construction Morphologique,1,Alterations,6,448,3,QO,0.81,0.07,2.95,1,38,39,35,1,34,1.11,2.86,Difficile,Difficile,0,Meme Difficulté,Pas Adapte
6002,2020,Information-Communication,5,Construction Morphologique,1,Alterations,6,448,3,QO,0.81,0.05,16.05,6,29,35,19,6,13,1.84,31.58,Moyen,Difficile,-1,Plus Difficile,Pas Adapte
448,2015,Information-Communication,5,Construction Morphologique,1,Alterations,6,449,4,QO,0.03,0.46,90.71,72,7,79,77,72,5,1.03,93.51,Difficile,Facile,2,Beaucoup plus Facile,Pas Adapte
1559,2016,Information-Communication,5,Construction Morphologique,1,Alterations,6,449,4,QO,0.14,0.78,84.03,65,12,77,74,65,9,1.04,87.84,Facile,Facile,0,Meme Difficulté,Pas Adapte
2670,2017,Information-Communication,5,Construction Morphologique,1,Alterations,6,449,4,QCM,0.65,0.23,33.25,23,46,69,59,23,36,1.17,38.98,Difficile,Difficile,0,Meme Difficulté,Pas Adapte
3781,2018,Information-Communication,5,Construction Morphologique,1,Alterations,6,449,4,QCM,0.58,0.26,2.46,2,75,77,57,2,55,1.35,3.51,Facile,Difficile,-2,Beaucoup plus Difficile,Pas Adapte
4892,2019,Information-Communication,5,Construction Morphologique,1,Alterations,6,449,4,QCM,0.15,0.79,89.5,69,8,77,74,69,5,1.04,93.24,Moyen,Facile,1,Plus Facile,Pas Adapte
6003,2020,Information-Communication,5,Construction Morphologique,1,Alterations,6,449,4,QCM,0.8,0.17,25.91,19,56,75,43,19,24,1.74,44.19,Facile,Difficile,-2,Beaucoup plus Difficile,Pas Adapte
449,2015,Information-Communication,5,Construction Morphologique,1,Alterations,6,450,5,QROC,0.02,0.52,96.25,39,2,41,39,39,0,1.05,100.0,Facile,Facile,0,Meme Difficulté,Pas Adapte
1560,2016,Information-Communication,5,Construction Morphologique,1,Alterations,6,450,5,QROC,0.15,0.65,94.51,34,2,36,34,34,0,1.06,100.0,Difficile,Facile,2,Beaucoup plus Facile,Pas Adapte
2671,2017,Information-Communication,5,Construction Morphologique,1,Alterations,6,450,5,QROC,0.56,0.33,44.01,17,21,38,21,17,4,1.81,80.95,Difficile,Moyen,1,Plus Facile,Pas Adapte
3782,2018,Information-Communication,5,Construction Morphologique,1,Alterations,6,450,5,QROC,0.92,0.12,8.59,3,34,37,17,3,14,2.18,17.65,Facile,Difficile,-2,Beaucoup plus Difficile,Pas Adapte
4893,2019,Information-Communication,5,Construction Morphologique,1,Alterations,6,450,5,QROC,0.35,0.33,35.81,13,22,35,22,13,9,1.59,59.09,Facile,Moyen,-1,Plus Difficile,Pas Adapte
6004,2020,Information-Communication,5,Construction Morphologique,1,Alterations,6,450,5,QCM,0.73,0.19,3.35,1,31,32,19,1,18,1.68,5.26,Moyen,Difficile,-1,Plus Difficile,Pas Adapte
450,2015,Information-Communication,5,Construction Morphologique,1,Alterations,6,451,6,QCM,0.77,0.29,18.82,3,11,14,11,3,8,1.27,27.27,Difficile,Difficile,0,Meme Difficulté,Pas Adapte
1561,2016,Information-Communication,5,Construction Morphologique,1,Alterations,6,451,6,QCM,0.2,0.43,36.93,5,9,14,11,5,6,1.27,45.45,Difficile,Moyen,1,Plus Facile,Pas Adapte
2672,2017,Information-Communication,5,Construction Morphologique,1,Alterations,6,451,6,QCM,0.41,0.57,60.81,9,6,15,12,9,3,1.25,75.0,Facile,Moyen,-1,Plus Difficile,Pas Adapte
3783,2018,Information-Communication,5,Construction Morphologique,1,Alterations,6,451,6,QCM,0.77,0.26,25.63,4,10,14,6,4,2,2.33,66.67,Difficile,Difficile,0,Meme Difficulté,Pas Adapte
4894,2019,Information-Communication,5,Construction Morphologique,1,Alterations,6,451,6,QCM,0.05,0.83,86.79,12,2,14,14,12,2,1.0,85.71,Moyen,Facile,1,Plus Facile,Pas Adapte
6005,2020,Information-Communication,5,Construction Morphologique,1,Alterations,6,451,6,QCM,0.47,0.46,54.76,8,7,15,13,8,5,1.15,61.54,Difficile,Moyen,1,Plus Facile,Pas Adapte
451,2015,Information-Communication,5,Construction Morphologique,2,Transferts,7,452,1,QCU,0.35,0.45,63.07,45,26,71,63,45,18,1.13,71.43,Moyen,Moyen,0,Meme Difficulté,Pas Adapte
1562,2016,Information-Communication,5,Construction Morphologique,2,Transferts,7,452,1,QCU,0.2,0.99,87.16,60,9,69,68,60,8,1.01,88.24,Moyen,Facile,1,Plus Facile,Pas Adapte
2673,2017,Information-Communication,5,Construction Morphologique,2,Transferts,7,452,1,QCU,0.42,0.3,1.56,1,62,63,21,1,20,3.0,4.76,Moyen,Difficile,-1,Plus Difficile,Pas Adapte
3784,2018,Information-Communication,5,Construction Morphologique,2,Transferts,7,452,1,QCU,0.07,0.84,91.21,62,6,68,65,62,3,1.05,95.38,Moyen,Facile,1,Plus Facile,Pas Adapte
4895,2019,Information-Communication,5,Construction Morphologique,2,Transferts,7,452,1,QCU,0.68,0.29,5.03,3,65,68,67,3,64,1.01,4.48,Facile,Difficile,-2,Beaucoup plus Difficile,Pas Adapte
6006,2020,Information-Communication,5,Construction Morphologique,2,Transferts,7,452,1,QCU,0.28,0.66,39.96,24,37,61,36,24,12,1.69,66.67,Difficile,Moyen,1,Plus Facile,Pas Adapte
452,2015,Information-Communication,5,Construction Morphologique,2,Transferts,7,453,2,QCU,0.05,0.86,90.68,12,1,13,13,12,1,1.0,92.31,Difficile,Facile,2,Beaucoup plus Facile,Pas Adapte
1563,2016,Information-Communication,5,Construction Morphologique,2,Transferts,7,453,2,QCU,0.29,0.55,50.12,6,5,11,9,6,3,1.22,66.67,Facile,Moyen,-1,Plus Difficile,Pas Adapte
2674,2017,Information-Communication,5,Construction Morphologique,2,Transferts,7,453,2,QCU,0.06,0.77,92.25,10,1,11,11,10,1,1.0,90.91,Facile,Facile,0,Meme Difficulté,Pas Adapte
3785,2018,Information-Communication,5,Construction Morphologique,2,Transferts,7,453,2,QCM,0.78,0.18,7.51,1,8,9,6,1,5,1.5,16.67,Difficile,Difficile,0,Meme Difficulté,Pas Adapte
4896,2019,Information-Communication,5,Construction Morphologique,2,Transferts,7,453,2,QCM,0.53,0.26,13.0,1,8,9,9,1,8,1.0,11.11,Difficile,Difficile,0,Meme Difficulté,Pas Adapte
6007,2020,Information-Communication,5,Construction Morphologique,2,Transferts,7,453,2,QCM,0.03,0.74,70.18,6,3,9,7,6,1,1.29,85.71,Moyen,Facile,1,Plus Facile,Adapte
453,2015,Information-Communication,5,Construction Morphologique,2,Transferts,7,454,3,QROC,0.11,0.47,97.55,40,1,41,40,40,0,1.02,100.0,Moyen,Facile,1,Plus Facile,Pas Adapte
1564,2016,Information-Communication,5,Construction Morphologique,2,Transferts,7,454,3,QROC,0.8,0.16,29.96,13,30,43,30,13,17,1.43,43.33,Difficile,Difficile,0,Meme Difficulté,Pas Adapte
2675,2017,Information-Communication,5,Construction Morphologique,2,Transferts,7,454,3,QROC,0.76,0.14,0.93,0,41,41,40,0,40,1.02,0.0,Moyen,Difficile,-1,Plus Difficile,Pas Adapte
3786,2018,Information-Communication,5,Construction Morphologique,2,Transferts,7,454,3,QROC,0.04,0.53,77.0,30,9,39,38,30,8,1.03,78.95,Facile,Facile,0,Meme Difficulté,Pas Adapte
4897,2019,Information-Communication,5,Construction Morphologique,2,Transferts,7,454,3,QROC,0.01,0.41,69.25,29,13,42,33,29,4,1.27,87.88,Facile,Facile,0,Meme Difficulté,Adapte
6008,2020,Information-Communication,5,Construction Morphologique,2,Transferts,7,454,3,QROC,0.07,0.55,69.25,33,15,48,46,33,13,1.04,71.74,Facile,Facile,0,Meme Difficulté,Adapte
454,2015,Information-Communication,5,Construction Morphologique,2,Transferts,7,455,4,QCU,0.14,0.76,76.58,43,13,56,50,43,7,1.12,86.0,Difficile,Facile,2,Beaucoup plus Facile,Pas Adapte
1565,2016,Information-Communication,5,Construction Morphologique,2,Transferts,7,455,4,QCU,0.2,0.5,51.8,27,26,53,41,27,14,1.29,65.85,Facile,Moyen,-1,Plus Difficile,Pas Adapte
2676,2017,Information-Communication,5,Construction Morphologique,2,Transferts,7,455,4,QCU,0.17,0.99,89.72,43,5,48,47,43,4,1.02,91.49,Facile,Facile,0,Meme Difficulté,Pas Adapte
3787,2018,Information-Communication,5,Construction Morphologique,2,Transferts,7,455,4,QCU,0.45,0.34,11.54,5,36,41,18,5,13,2.28,27.78,Difficile,Difficile,0,Meme Difficulté,Pas Adapte
4898,2019,Information-Communication,5,Construction Morphologique,2,Transferts,7,455,4,QCU,0.47,0.28,1.62,1,46,47,24,1,23,1.96,4.17,Moyen,Difficile,-1,Plus Difficile,Pas Adapte
6009,2020,Information-Communication,5,Construction Morphologique,2,Transferts,7,455,4,QCU,0.65,0.37,19.26,10,44,54,50,10,40,1.08,20.0,Facile,Difficile,-2,Beaucoup plus Difficile,Pas Adapte
455,2015,Information-Communication,5,Construction Morphologique,2,Transferts,7,456,5,QCM,0.21,0.4,51.92,50,46,96,51,50,1,1.88,98.04,Facile,Moyen,-1,Plus Difficile,Pas Adapte
1566,2016,Information-Communication,5,Construction Morphologique,2,Transferts,7,456,5,QCM,0.17,0.87,70.85,76,31,107,102,76,26,1.05,74.51,Difficile,Facile,2,Beaucoup plus Facile,Adapte
2677,2017,Information-Communication,5,Construction Morphologique,2,Transferts,7,456,5,QCM,0.02,0.79,70.85,86,35,121,93,86,7,1.3,92.47,Facile,Facile,0,Meme Difficulté,Adapte
3788,2018,Information-Communication,5,Construction Morphologique,2,Transferts,7,456,5,QCU,0.09,0.81,70.85,96,40,136,119,96,23,1.14,80.67,Facile,Facile,0,Meme Difficulté,Adapte
4899,2019,Information-Communication,5,Construction Morphologique,2,Transferts,7,456,5,QCU,0.11,0.9,70.85,97,40,137,124,97,27,1.1,78.23,Facile,Facile,0,Meme Difficulté,Adapte
6010,2020,Information-Communication,5,Construction Morphologique,2,Transferts,7,456,5,QCU,0.13,0.97,70.85,100,41,141,126,100,26,1.12,79.37,Facile,Facile,0,Meme Difficulté,Adapte
456,2015,Information-Communication,5,Construction Morphologique,2,Transferts,7,457,6,QROC,0.55,0.33,42.57,10,13,23,15,10,5,1.53,66.67,Difficile,Moyen,1,Plus Facile,Pas Adapte
1567,2016,Information-Communication,5,Construction Morphologique,2,Transferts,7,457,6,QROC,0.71,0.25,34.81,7,14,21,14,7,7,1.5,50.0,Moyen,Difficile,-1,Plus Difficile,Pas Adapte
2678,2017,Information-Communication,5,Construction Morphologique,2,Transferts,7,457,6,QCM,0.1,1.0,89.27,18,2,20,19,18,1,1.05,94.74,Moyen,Facile,1,Plus Facile,Pas Adapte
3789,2018,Information-Communication,5,Construction Morphologique,2,Transferts,7,457,6,QCM,0.41,0.65,62.5,12,7,19,14,12,2,1.36,85.71,Moyen,Moyen,0,Meme Difficulté,Pas Adapte
4900,2019,Information-Communication,5,Construction Morphologique,2,Transferts,7,457,6,QCM,0.6,0.22,7.57,1,17,18,18,1,17,1.0,5.56,Difficile,Difficile,0,Meme Difficulté,Pas Adapte
6011,2020,Information-Communication,5,Construction Morphologique,2,Transferts,7,457,6,QCM,0.67,0.27,18.44,3,12,15,14,3,11,1.07,21.43,Moyen,Difficile,-1,Plus Difficile,Pas Adapte
457,2015,Information-Communication,5,Construction Morphologique,2,Transferts,7,458,7,QROC,0.37,0.3,54.16,44,37,81,47,44,3,1.72,93.62,Facile,Moyen,-1,Plus Difficile,Pas Adapte
1568,2016,Information-Communication,5,Construction Morphologique,2,Transferts,7,458,7,QROC,0.61,0.19,11.16,8,61,69,57,8,49,1.21,14.04,Facile,Difficile,-2,Beaucoup plus Difficile,Pas Adapte
2679,2017,Information-Communication,5,Construction Morphologique,2,Transferts,7,458,7,QCM,0.55,0.29,32.6,23,49,72,63,23,40,1.14,36.51,Difficile,Difficile,0,Meme Difficulté,Pas Adapte
3790,2018,Information-Communication,5,Construction Morphologique,2,Transferts,7,458,7,QCM,0.79,0.22,0.29,0,78,78,60,0,60,1.3,0.0,Facile,Difficile,-2,Beaucoup plus Difficile,Pas Adapte
4901,2019,Information-Communication,5,Construction Morphologique,2,Transferts,7,458,7,QCM,0.31,0.6,45.35,41,49,90,70,41,29,1.29,58.57,Facile,Moyen,-1,Plus Difficile,Pas Adapte
6012,2020,Information-Communication,5,Construction Morphologique,2,Transferts,7,458,7,QCM,0.35,0.42,48.1,40,44,84,65,40,25,1.29,61.54,Difficile,Moyen,1,Plus Facile,Pas Adapte
458,2015,Information-Communication,5,Construction Morphologique,3,Sens Predictible et Atteste,2,459,1,QCU,0.35,0.65,35.79,21,38,59,32,21,11,1.84,65.62,Difficile,Moyen,1,Plus Facile,Pas Adapte
1569,2016,Information-Communication,5,Construction Morphologique,3,Sens Predictible et Atteste,2,459,1,QCU,0.59,0.38,5.38,3,61,64,58,3,55,1.1,5.17,Difficile,Difficile,0,Meme Difficulté,Pas Adapte
2680,2017,Information-Communication,5,Construction Morphologique,3,Sens Predictible et Atteste,2,459,1,QCU,0.07,0.98,75.98,48,15,63,63,48,15,1.0,76.19,Moyen,Facile,1,Plus Facile,Pas Adapte
3791,2018,Information-Communication,5,Construction Morphologique,3,Sens Predictible et Atteste,2,459,1,QCU,0.29,0.47,38.53,25,40,65,38,25,13,1.71,65.79,Difficile,Moyen,1,Plus Facile,Pas Adapte
4902,2019,Information-Communication,5,Construction Morphologique,3,Sens Predictible et Atteste,2,459,1,QCU,0.39,0.47,49.18,30,31,61,58,30,28,1.05,51.72,Moyen,Moyen,0,Meme Difficulté,Pas Adapte
6013,2020,Information-Communication,5,Construction Morphologique,3,Sens Predictible et Atteste,2,459,1,QCU,0.11,0.96,74.08,42,15,57,55,42,13,1.04,76.36,Moyen,Facile,1,Plus Facile,Adapte
459,2015,Information-Communication,5,Construction Morphologique,3,Sens Predictible et Atteste,2,460,2,QCM,0.2,0.4,43.4,23,30,53,46,23,23,1.15,50.0,Moyen,Moyen,0,Meme Difficulté,Pas Adapte
1570,2016,Information-Communication,5,Construction Morphologique,3,Sens Predictible et Atteste,2,460,2,QCM,0.54,0.28,18.88,10,44,54,15,10,5,3.6,66.67,Facile,Difficile,-2,Beaucoup plus Difficile,Pas Adapte
2681,2017,Information-Communication,5,Construction Morphologique,3,Sens Predictible et Atteste,2,460,2,QCM,0.06,0.76,99.1,49,0,49,49,49,0,1.0,100.0,Facile,Facile,0,Meme Difficulté,Pas Adapte
3792,2018,Information-Communication,5,Construction Morphologique,3,Sens Predictible et Atteste,2,460,2,QCM,0.14,0.97,67.8,33,15,48,41,33,8,1.17,80.49,Facile,Facile,0,Meme Difficulté,Adapte
4903,2019,Information-Communication,5,Construction Morphologique,3,Sens Predictible et Atteste,2,460,2,QCM,0.18,1.0,67.8,32,15,47,33,32,1,1.42,96.97,Facile,Facile,0,Meme Difficulté,Adapte
6014,2020,Information-Communication,5,Construction Morphologique,3,Sens Predictible et Atteste,2,460,2,QCM,0.06,0.95,67.8,35,16,51,45,35,10,1.13,77.78,Facile,Facile,0,Meme Difficulté,Adapte
460,2015,Informatique,1,Generalites sur les Systeme Informatiques,1,Definitions et Vocabulaire de Base,6,461,1,QROC,0.05,1.0,95.0,26,1,27,27,26,1,1.0,96.3,Difficile,Facile,2,Beaucoup plus Facile,Pas Adapte
1571,2016,Informatique,1,Generalites sur les Systeme Informatiques,1,Definitions et Vocabulaire de Base,6,461,1,QROC,0.14,0.53,95.6,30,1,31,31,30,1,1.0,96.77,Facile,Facile,0,Meme Difficulté,Pas Adapte
2682,2017,Informatique,1,Generalites sur les Systeme Informatiques,1,Definitions et Vocabulaire de Base,6,461,1,QROC,0.05,0.92,70.87,23,10,33,27,23,4,1.22,85.19,Moyen,Facile,1,Plus Facile,Adapte
3793,2018,Informatique,1,Generalites sur les Systeme Informatiques,1,Definitions et Vocabulaire de Base,6,461,1,QROC,0.07,0.9,70.87,21,9,30,27,21,6,1.11,77.78,Facile,Facile,0,Meme Difficulté,Adapte
4904,2019,Informatique,1,Generalites sur les Systeme Informatiques,1,Definitions et Vocabulaire de Base,6,461,1,QROC,0.19,0.65,70.87,24,10,34,32,24,8,1.06,75.0,Facile,Facile,0,Meme Difficulté,Adapte
6015,2020,Informatique,1,Generalites sur les Systeme Informatiques,1,Definitions et Vocabulaire de Base,6,461,1,QO,0.17,0.93,70.87,21,9,30,27,21,6,1.11,77.78,Facile,Facile,0,Meme Difficulté,Adapte
461,2015,Informatique,1,Generalites sur les Systeme Informatiques,1,Definitions et Vocabulaire de Base,6,462,2,QCU,0.15,0.8,75.19,17,5,22,19,17,2,1.16,89.47,Moyen,Facile,1,Plus Facile,Pas Adapte
1572,2016,Informatique,1,Generalites sur les Systeme Informatiques,1,Definitions et Vocabulaire de Base,6,462,2,QCU,0.15,0.79,89.85,17,2,19,18,17,1,1.06,94.44,Difficile,Facile,2,Beaucoup plus Facile,Pas Adapte
2683,2017,Informatique,1,Generalites sur les Systeme Informatiques,1,Definitions et Vocabulaire de Base,6,462,2,QCU,0.05,0.98,65.66,14,8,22,18,14,4,1.22,77.78,Facile,Facile,0,Meme Difficulté,Adapte
3794,2018,Informatique,1,Generalites sur les Systeme Informatiques,1,Definitions et Vocabulaire de Base,6,462,2,QCU,0.17,0.84,65.66,13,7,20,14,13,1,1.43,92.86,Facile,Facile,0,Meme Difficulté,Adapte
4905,2019,Informatique,1,Generalites sur les Systeme Informatiques,1,Definitions et Vocabulaire de Base,6,462,2,QCU,0.19,0.9,65.66,14,7,21,17,14,3,1.24,82.35,Facile,Facile,0,Meme Difficulté,Adapte
6016,2020,Informatique,1,Generalites sur les Systeme Informatiques,1,Definitions et Vocabulaire de Base,6,462,2,QCU,0.2,0.79,65.66,14,7,21,20,14,6,1.05,70.0,Facile,Facile,0,Meme Difficulté,Adapte
462,2015,Informatique,1,Generalites sur les Systeme Informatiques,1,Definitions et Vocabulaire de Base,6,463,3,QROC,0.17,0.46,80.5,11,3,14,13,11,2,1.08,84.62,Facile,Facile,0,Meme Difficulté,Pas Adapte
1573,2016,Informatique,1,Generalites sur les Systeme Informatiques,1,Definitions et Vocabulaire de Base,6,463,3,QROC,0.55,0.4,51.93,8,8,16,12,8,4,1.33,66.67,Facile,Moyen,-1,Plus Difficile,Pas Adapte
2684,2017,Informatique,1,Generalites sur les Systeme Informatiques,1,Definitions et Vocabulaire de Base,6,463,3,QROC,0.05,0.87,75.01,13,4,17,13,13,0,1.31,100.0,Moyen,Facile,1,Plus Facile,Pas Adapte
3795,2018,Informatique,1,Generalites sur les Systeme Informatiques,1,Definitions et Vocabulaire de Base,6,463,3,QROC,0.73,0.17,6.66,1,18,19,15,1,14,1.27,6.67,Difficile,Difficile,0,Meme Difficulté,Pas Adapte
4906,2019,Informatique,1,Generalites sur les Systeme Informatiques,1,Definitions et Vocabulaire de Base,6,463,3,QROC,0.61,0.0,26.97,4,12,16,7,4,3,2.29,57.14,Moyen,Difficile,-1,Plus Difficile,Pas Adapte
6017,2020,Informatique,1,Generalites sur les Systeme Informatiques,1,Definitions et Vocabulaire de Base,6,463,3,QROC,0.09,0.76,69.98,13,5,18,15,13,2,1.2,86.67,Difficile,Facile,2,Beaucoup plus Facile,Adapte
463,2015,Informatique,1,Generalites sur les Systeme Informatiques,1,Definitions et Vocabulaire de Base,6,464,4,QCU,0.18,0.92,84.97,54,10,64,60,54,6,1.07,90.0,Moyen,Facile,1,Plus Facile,Pas Adapte
1574,2016,Informatique,1,Generalites sur les Systeme Informatiques,1,Definitions et Vocabulaire de Base,6,464,4,QCU,0.51,0.2,18.2,10,44,54,31,10,21,1.74,32.26,Moyen,Difficile,-1,Plus Difficile,Pas Adapte
2685,2017,Informatique,1,Generalites sur les Systeme Informatiques,1,Definitions et Vocabulaire de Base,6,464,4,QCU,0.2,0.46,36.6,22,38,60,44,22,22,1.36,50.0,Facile,Moyen,-1,Plus Difficile,Pas Adapte
3796,2018,Informatique,1,Generalites sur les Systeme Informatiques,1,Definitions et Vocabulaire de Base,6,464,4,QCU,0.0,0.88,88.85,58,7,65,64,58,6,1.02,90.62,Difficile,Facile,2,Beaucoup plus Facile,Pas Adapte
4907,2019,Informatique,1,Generalites sur les Systeme Informatiques,1,Definitions et Vocabulaire de Base,6,464,4,QCU,0.34,0.72,64.58,48,26,74,70,48,22,1.06,68.57,Difficile,Moyen,1,Plus Facile,Pas Adapte
6018,2020,Informatique,1,Generalites sur les Systeme Informatiques,1,Definitions et Vocabulaire de Base,6,464,4,QCU,0.56,0.29,18.6,15,63,78,76,15,61,1.03,19.74,Difficile,Difficile,0,Meme Difficulté,Pas Adapte
464,2015,Informatique,1,Generalites sur les Systeme Informatiques,1,Definitions et Vocabulaire de Base,6,465,5,QCU,0.18,0.83,83.53,43,8,51,51,43,8,1.0,84.31,Moyen,Facile,1,Plus Facile,Pas Adapte
1575,2016,Informatique,1,Generalites sur les Systeme Informatiques,1,Definitions et Vocabulaire de Base,6,465,5,QCU,0.75,0.39,30.93,15,34,49,24,15,9,2.04,62.5,Facile,Difficile,-2,Beaucoup plus Difficile,Pas Adapte
2686,2017,Informatique,1,Generalites sur les Systeme Informatiques,1,Definitions et Vocabulaire de Base,6,465,5,QCU,0.47,0.32,33.12,16,31,47,38,16,22,1.24,42.11,Moyen,Difficile,-1,Plus Difficile,Pas Adapte
3797,2018,Informatique,1,Generalites sur les Systeme Informatiques,1,Definitions et Vocabulaire de Base,6,465,5,QCU,0.27,0.43,64.01,29,17,46,37,29,8,1.24,78.38,Facile,Moyen,-1,Plus Difficile,Pas Adapte
4908,2019,Informatique,1,Generalites sur les Systeme Informatiques,1,Definitions et Vocabulaire de Base,6,465,5,QCU,0.19,0.9,99.72,46,0,46,46,46,0,1.0,100.0,Moyen,Facile,1,Plus Facile,Pas Adapte
6019,2020,Informatique,1,Generalites sur les Systeme Informatiques,1,Definitions et Vocabulaire de Base,6,465,5,QCM,0.25,0.3,35.15,19,34,53,23,19,4,2.3,82.61,Facile,Moyen,-1,Plus Difficile,Pas Adapte
465,2015,Informatique,1,Generalites sur les Systeme Informatiques,1,Definitions et Vocabulaire de Base,6,466,6,QCU,0.07,1.0,97.81,97,2,99,98,97,1,1.01,98.98,Difficile,Facile,2,Beaucoup plus Facile,Pas Adapte
1576,2016,Informatique,1,Generalites sur les Systeme Informatiques,1,Definitions et Vocabulaire de Base,6,466,6,QCU,0.27,0.5,52.72,47,43,90,60,47,13,1.5,78.33,Moyen,Moyen,0,Meme Difficulté,Pas Adapte
2687,2017,Informatique,1,Generalites sur les Systeme Informatiques,1,Definitions et Vocabulaire de Base,6,466,6,QCM,0.01,0.99,82.09,67,15,82,80,67,13,1.02,83.75,Moyen,Facile,1,Plus Facile,Pas Adapte
3798,2018,Informatique,1,Generalites sur les Systeme Informatiques,1,Definitions et Vocabulaire de Base,6,466,6,QCM,0.33,0.48,47.19,37,42,79,40,37,3,1.98,92.5,Difficile,Moyen,1,Plus Facile,Pas Adapte
4909,2019,Informatique,1,Generalites sur les Systeme Informatiques,1,Definitions et Vocabulaire de Base,6,466,6,QCM,0.67,0.21,0.57,1,90,91,90,1,89,1.01,1.11,Difficile,Difficile,0,Meme Difficulté,Pas Adapte
6020,2020,Informatique,1,Generalites sur les Systeme Informatiques,1,Definitions et Vocabulaire de Base,6,466,6,QCM,0.12,0.91,65.67,52,27,79,58,52,6,1.36,89.66,Moyen,Facile,1,Plus Facile,Adapte
466,2015,Informatique,1,Generalites sur les Systeme Informatiques,2,Structure de l'Ordinateur,7,467,1,QCM,0.28,0.64,51.06,36,35,71,68,36,32,1.04,52.94,Difficile,Moyen,1,Plus Facile,Pas Adapte
1577,2016,Informatique,1,Generalites sur les Systeme Informatiques,2,Structure de l'Ordinateur,7,467,1,QCM,0.16,0.78,79.88,58,14,72,60,58,2,1.2,96.67,Moyen,Facile,1,Plus Facile,Pas Adapte
2688,2017,Informatique,1,Generalites sur les Systeme Informatiques,2,Structure de l'Ordinateur,7,467,1,QCM,0.59,0.17,1.53,1,73,74,69,1,68,1.07,1.45,Facile,Difficile,-2,Beaucoup plus Difficile,Pas Adapte
3799,2018,Informatique,1,Generalites sur les Systeme Informatiques,2,Structure de l'Ordinateur,7,467,1,QCM,0.11,0.8,93.64,67,5,72,71,67,4,1.01,94.37,Facile,Facile,0,Meme Difficulté,Pas Adapte
4910,2019,Informatique,1,Generalites sur les Systeme Informatiques,2,Structure de l'Ordinateur,7,467,1,QCM,0.41,0.65,54.06,35,29,64,61,35,26,1.05,57.38,Facile,Moyen,-1,Plus Difficile,Pas Adapte
6021,2020,Informatique,1,Generalites sur les Systeme Informatiques,2,Structure de l'Ordinateur,7,467,1,QCU,0.23,0.67,46.87,27,31,58,32,27,5,1.81,84.38,Difficile,Moyen,1,Plus Facile,Pas Adapte
467,2015,Informatique,1,Generalites sur les Systeme Informatiques,2,Structure de l'Ordinateur,7,468,2,QCU,0.06,0.82,88.06,52,7,59,57,52,5,1.04,91.23,Difficile,Facile,2,Beaucoup plus Facile,Pas Adapte
1578,2016,Informatique,1,Generalites sur les Systeme Informatiques,2,Structure de l'Ordinateur,7,468,2,QCU,0.7,0.27,16.19,11,54,65,40,11,29,1.62,27.5,Difficile,Difficile,0,Meme Difficulté,Pas Adapte
2689,2017,Informatique,1,Generalites sur les Systeme Informatiques,2,Structure de l'Ordinateur,7,468,2,QCM,0.03,0.75,83.34,48,10,58,54,48,6,1.07,88.89,Difficile,Facile,2,Beaucoup plus Facile,Pas Adapte
3800,2018,Informatique,1,Generalites sur les Systeme Informatiques,2,Structure de l'Ordinateur,7,468,2,QCM,0.07,0.84,79.0,45,12,57,55,45,10,1.04,81.82,Difficile,Facile,2,Beaucoup plus Facile,Pas Adapte
4911,2019,Informatique,1,Generalites sur les Systeme Informatiques,2,Structure de l'Ordinateur,7,468,2,QCM,0.18,0.72,67.9,35,17,52,51,35,16,1.02,68.63,Facile,Facile,0,Meme Difficulté,Adapte
6022,2020,Informatique,1,Generalites sur les Systeme Informatiques,2,Structure de l'Ordinateur,7,468,2,QCM,0.07,0.92,67.9,35,17,52,40,35,5,1.3,87.5,Facile,Facile,0,Meme Difficulté,Adapte
468,2015,Informatique,1,Generalites sur les Systeme Informatiques,2,Structure de l'Ordinateur,7,469,3,QCU,0.23,0.47,38.07,28,45,73,55,28,27,1.33,50.91,Facile,Moyen,-1,Plus Difficile,Pas Adapte
1579,2016,Informatique,1,Generalites sur les Systeme Informatiques,2,Structure de l'Ordinateur,7,469,3,QROC,0.03,0.84,95.74,64,3,67,66,64,2,1.02,96.97,Facile,Facile,0,Meme Difficulté,Pas Adapte
2690,2017,Informatique,1,Generalites sur les Systeme Informatiques,2,Structure de l'Ordinateur,7,469,3,QROC,0.77,0.03,28.8,20,50,70,66,20,46,1.06,30.3,Difficile,Difficile,0,Meme Difficulté,Pas Adapte
3801,2018,Informatique,1,Generalites sur les Systeme Informatiques,2,Structure de l'Ordinateur,7,469,3,QROC,0.11,0.42,97.92,67,1,68,68,67,1,1.0,98.53,Moyen,Facile,1,Plus Facile,Pas Adapte
4912,2019,Informatique,1,Generalites sur les Systeme Informatiques,2,Structure de l'Ordinateur,7,469,3,QROC,0.72,0.24,29.35,17,41,58,33,17,16,1.76,51.52,Facile,Difficile,-2,Beaucoup plus Difficile,Pas Adapte
6023,2020,Informatique,1,Generalites sur les Systeme Informatiques,2,Structure de l'Ordinateur,7,469,3,QROC,0.48,0.32,62.85,33,19,52,34,33,1,1.53,97.06,Moyen,Moyen,0,Meme Difficulté,Pas Adapte
469,2015,Informatique,1,Generalites sur les Systeme Informatiques,2,Structure de l'Ordinateur,7,470,4,QCU,0.59,0.29,10.09,2,14,16,11,2,9,1.45,18.18,Facile,Difficile,-2,Beaucoup plus Difficile,Pas Adapte
1580,2016,Informatique,1,Generalites sur les Systeme Informatiques,2,Structure de l'Ordinateur,7,470,4,QCU,0.35,0.53,58.4,9,7,16,14,9,5,1.14,64.29,Difficile,Moyen,1,Plus Facile,Pas Adapte
2691,2017,Informatique,1,Generalites sur les Systeme Informatiques,2,Structure de l'Ordinateur,7,470,4,QCU,0.05,0.76,78.74,11,3,14,14,11,3,1.0,78.57,Difficile,Facile,2,Beaucoup plus Facile,Pas Adapte
3802,2018,Informatique,1,Generalites sur les Systeme Informatiques,2,Structure de l'Ordinateur,7,470,4,QCU,0.34,0.68,54.6,8,6,14,13,8,5,1.08,61.54,Moyen,Moyen,0,Meme Difficulté,Pas Adapte
4913,2019,Informatique,1,Generalites sur les Systeme Informatiques,2,Structure de l'Ordinateur,7,470,4,QCU,0.62,0.33,9.01,1,12,13,9,1,8,1.44,11.11,Facile,Difficile,-2,Beaucoup plus Difficile,Pas Adapte
6024,2020,Informatique,1,Generalites sur les Systeme Informatiques,2,Structure de l'Ordinateur,7,470,4,QCU,0.31,0.45,61.16,8,5,13,13,8,5,1.0,61.54,Facile,Moyen,-1,Plus Difficile,Pas Adapte
470,2015,Informatique,1,Generalites sur les Systeme Informatiques,2,Structure de l'Ordinateur,7,471,5,QCU,0.38,0.68,51.45,30,28,58,44,30,14,1.32,68.18,Difficile,Moyen,1,Plus Facile,Pas Adapte
1581,2016,Informatique,1,Generalites sur les Systeme Informatiques,2,Structure de l'Ordinateur,7,471,5,QCU,0.75,0.4,7.77,5,54,59,30,5,25,1.97,16.67,Facile,Difficile,-2,Beaucoup plus Difficile,Pas Adapte
2692,2017,Informatique,1,Generalites sur les Systeme Informatiques,2,Structure de l'Ordinateur,7,471,5,QCU,0.06,1.0,70.92,44,18,62,45,44,1,1.38,97.78,Moyen,Facile,1,Plus Facile,Adapte
3803,2018,Informatique,1,Generalites sur les Systeme Informatiques,2,Structure de l'Ordinateur,7,471,5,QCU,0.04,0.92,70.92,39,16,55,50,39,11,1.1,78.0,Facile,Facile,0,Meme Difficulté,Adapte
4914,2019,Informatique,1,Generalites sur les Systeme Informatiques,2,Structure de l'Ordinateur,7,471,5,QCM,0.13,0.81,70.92,40,16,56,44,40,4,1.27,90.91,Facile,Facile,0,Meme Difficulté,Adapte
6025,2020,Informatique,1,Generalites sur les Systeme Informatiques,2,Structure de l'Ordinateur,7,471,5,QCM,0.18,0.97,70.92,36,15,51,47,36,11,1.09,76.6,Facile,Facile,0,Meme Difficulté,Adapte
471,2015,Informatique,1,Generalites sur les Systeme Informatiques,2,Structure de l'Ordinateur,7,472,6,QCU,0.07,0.9,94.44,37,2,39,38,37,1,1.03,97.37,Moyen,Facile,1,Plus Facile,Pas Adapte
1582,2016,Informatique,1,Generalites sur les Systeme Informatiques,2,Structure de l'Ordinateur,7,472,6,QCU,0.01,0.91,98.17,43,1,44,44,43,1,1.0,97.73,Difficile,Facile,2,Beaucoup plus Facile,Pas Adapte
2693,2017,Informatique,1,Generalites sur les Systeme Informatiques,2,Structure de l'Ordinateur,7,472,6,QO,0.89,0.04,15.36,6,35,41,30,6,24,1.37,20.0,Difficile,Difficile,0,Meme Difficulté,Pas Adapte
3804,2018,Informatique,1,Generalites sur les Systeme Informatiques,2,Structure de l'Ordinateur,7,472,6,QO,0.25,0.18,57.84,24,17,41,27,24,3,1.52,88.89,Moyen,Moyen,0,Meme Difficulté,Pas Adapte
4915,2019,Informatique,1,Generalites sur les Systeme Informatiques,2,Structure de l'Ordinateur,7,472,6,QO,0.19,0.82,71.4,28,11,39,34,28,6,1.15,82.35,Difficile,Facile,2,Beaucoup plus Facile,Adapte
6026,2020,Informatique,1,Generalites sur les Systeme Informatiques,2,Structure de l'Ordinateur,7,472,6,QO,0.16,0.51,71.4,27,11,38,31,27,4,1.23,87.1,Facile,Facile,0,Meme Difficulté,Adapte
472,2015,Informatique,1,Generalites sur les Systeme Informatiques,2,Structure de l'Ordinateur,7,473,7,QROC,0.49,0.34,44.03,22,28,50,34,22,12,1.47,64.71,Facile,Moyen,-1,Plus Difficile,Pas Adapte
1583,2016,Informatique,1,Generalites sur les Systeme Informatiques,2,Structure de l'Ordinateur,7,473,7,QO,0.63,0.19,55.32,25,20,45,39,25,14,1.15,64.1,Difficile,Moyen,1,Plus Facile,Pas Adapte
2694,2017,Informatique,1,Generalites sur les Systeme Informatiques,2,Structure de l'Ordinateur,7,473,7,QO,0.78,0.0,14.85,7,41,48,27,7,20,1.78,25.93,Difficile,Difficile,0,Meme Difficulté,Pas Adapte
3805,2018,Informatique,1,Generalites sur les Systeme Informatiques,2,Structure de l'Ordinateur,7,473,7,QO,0.53,0.19,47.31,26,28,54,44,26,18,1.23,59.09,Difficile,Moyen,1,Plus Facile,Pas Adapte
4916,2019,Informatique,1,Generalites sur les Systeme Informatiques,2,Structure de l'Ordinateur,7,473,7,QO,0.19,0.64,95.79,58,3,61,59,58,1,1.03,98.31,Difficile,Facile,2,Beaucoup plus Facile,Pas Adapte
6027,2020,Informatique,1,Generalites sur les Systeme Informatiques,2,Structure de l'Ordinateur,7,473,7,QO,0.82,0.02,12.9,7,45,52,27,7,20,1.93,25.93,Difficile,Difficile,0,Meme Difficulté,Pas Adapte
473,2015,Informatique,1,Generalites sur les Systeme Informatiques,3,Logiciels et Domaines d'Applicationd de l'Informatique,5,474,1,QCM,0.1,0.77,86.22,12,2,14,13,12,1,1.08,92.31,Difficile,Facile,2,Beaucoup plus Facile,Pas Adapte
1584,2016,Informatique,1,Generalites sur les Systeme Informatiques,3,Logiciels et Domaines d'Applicationd de l'Informatique,5,474,1,QCM,0.65,0.18,30.62,5,10,15,14,5,9,1.07,35.71,Difficile,Difficile,0,Meme Difficulté,Pas Adapte
2695,2017,Informatique,1,Generalites sur les Systeme Informatiques,3,Logiciels et Domaines d'Applicationd de l'Informatique,5,474,1,QCM,0.49,0.51,56.77,9,6,15,13,9,4,1.15,69.23,Facile,Moyen,-1,Plus Difficile,Pas Adapte
3806,2018,Informatique,1,Generalites sur les Systeme Informatiques,3,Logiciels et Domaines d'Applicationd de l'Informatique,5,474,1,QCU,0.14,0.91,85.31,11,2,13,13,11,2,1.0,84.62,Facile,Facile,0,Meme Difficulté,Pas Adapte
4917,2019,Informatique,1,Generalites sur les Systeme Informatiques,3,Logiciels et Domaines d'Applicationd de l'Informatique,5,474,1,QCU,0.57,0.27,18.99,2,9,11,6,2,4,1.83,33.33,Moyen,Difficile,-1,Plus Difficile,Pas Adapte
6028,2020,Informatique,1,Generalites sur les Systeme Informatiques,3,Logiciels et Domaines d'Applicationd de l'Informatique,5,474,1,QCU,0.01,0.9,75.94,10,3,13,12,10,2,1.08,83.33,Difficile,Facile,2,Beaucoup plus Facile,Pas Adapte
474,2015,Informatique,1,Generalites sur les Systeme Informatiques,3,Logiciels et Domaines d'Applicationd de l'Informatique,5,475,2,QCM,0.46,0.49,42.83,37,50,87,41,37,4,2.12,90.24,Moyen,Moyen,0,Meme Difficulté,Pas Adapte
1585,2016,Informatique,1,Generalites sur les Systeme Informatiques,3,Logiciels et Domaines d'Applicationd de l'Informatique,5,475,2,QCM,0.11,0.9,68.41,67,31,98,76,67,9,1.29,88.16,Moyen,Facile,1,Plus Facile,Adapte
2696,2017,Informatique,1,Generalites sur les Systeme Informatiques,3,Logiciels et Domaines d'Applicationd de l'Informatique,5,475,2,QCM,0.18,0.99,68.41,66,31,97,80,66,14,1.21,82.5,Facile,Facile,0,Meme Difficulté,Adapte
3807,2018,Informatique,1,Generalites sur les Systeme Informatiques,3,Logiciels et Domaines d'Applicationd de l'Informatique,5,475,2,QCM,0.16,0.89,68.41,66,31,97,90,66,24,1.08,73.33,Facile,Facile,0,Meme Difficulté,Adapte
4918,2019,Informatique,1,Generalites sur les Systeme Informatiques,3,Logiciels et Domaines d'Applicationd de l'Informatique,5,475,2,QCM,0.09,0.79,68.41,63,29,92,78,63,15,1.18,80.77,Facile,Facile,0,Meme Difficulté,Adapte
6029,2020,Informatique,1,Generalites sur les Systeme Informatiques,3,Logiciels et Domaines d'Applicationd de l'Informatique,5,475,2,QCM,0.07,0.96,68.41,70,33,103,88,70,18,1.17,79.55,Facile,Facile,0,Meme Difficulté,Adapte
475,2015,Informatique,1,Generalites sur les Systeme Informatiques,3,Logiciels et Domaines d'Applicationd de l'Informatique,5,476,3,QROC,0.03,0.57,79.92,68,17,85,78,68,10,1.09,87.18,Facile,Facile,0,Meme Difficulté,Pas Adapte
1586,2016,Informatique,1,Generalites sur les Systeme Informatiques,3,Logiciels et Domaines d'Applicationd de l'Informatique,5,476,3,QROC,0.98,0.22,3.27,3,74,77,44,3,41,1.75,6.82,Moyen,Difficile,-1,Plus Difficile,Pas Adapte
2697,2017,Informatique,1,Generalites sur les Systeme Informatiques,3,Logiciels et Domaines d'Applicationd de l'Informatique,5,476,3,QROC,0.07,0.45,92.34,66,5,71,69,66,3,1.03,95.65,Facile,Facile,0,Meme Difficulté,Pas Adapte
3808,2018,Informatique,1,Generalites sur les Systeme Informatiques,3,Logiciels et Domaines d'Applicationd de l'Informatique,5,476,3,QCU,0.29,0.64,38.88,27,42,69,58,27,31,1.19,46.55,Moyen,Moyen,0,Meme Difficulté,Pas Adapte
4919,2019,Informatique,1,Generalites sur les Systeme Informatiques,3,Logiciels et Domaines d'Applicationd de l'Informatique,5,476,3,QCU,0.13,0.77,88.23,65,9,74,73,65,8,1.01,89.04,Facile,Facile,0,Meme Difficulté,Pas Adapte
6030,2020,Informatique,1,Generalites sur les Systeme Informatiques,3,Logiciels et Domaines d'Applicationd de l'Informatique,5,476,3,QCM,0.64,0.29,28.59,18,46,64,44,18,26,1.45,40.91,Facile,Difficile,-2,Beaucoup plus Difficile,Pas Adapte
476,2015,Informatique,1,Generalites sur les Systeme Informatiques,3,Logiciels et Domaines d'Applicationd de l'Informatique,5,477,4,QCM,0.51,0.25,21.33,8,30,38,38,8,30,1.0,21.05,Difficile,Difficile,0,Meme Difficulté,Pas Adapte
1587,2016,Informatique,1,Generalites sur les Systeme Informatiques,3,Logiciels et Domaines d'Applicationd de l'Informatique,5,477,4,QCM,0.53,0.29,4.84,2,38,40,21,2,19,1.9,9.52,Moyen,Difficile,-1,Plus Difficile,Pas Adapte
2698,2017,Informatique,1,Generalites sur les Systeme Informatiques,3,Logiciels et Domaines d'Applicationd de l'Informatique,5,477,4,QCM,0.66,0.25,17.93,7,31,38,14,7,7,2.71,50.0,Difficile,Difficile,0,Meme Difficulté,Pas Adapte
3809,2018,Informatique,1,Generalites sur les Systeme Informatiques,3,Logiciels et Domaines d'Applicationd de l'Informatique,5,477,4,QCU,0.52,0.31,29.44,11,25,36,13,11,2,2.77,84.62,Facile,Difficile,-2,Beaucoup plus Difficile,Pas Adapte
4920,2019,Informatique,1,Generalites sur les Systeme Informatiques,3,Logiciels et Domaines d'Applicationd de l'Informatique,5,477,4,QCU,0.39,0.68,62.05,19,12,31,30,19,11,1.03,63.33,Facile,Moyen,-1,Plus Difficile,Pas Adapte
6031,2020,Informatique,1,Generalites sur les Systeme Informatiques,3,Logiciels et Domaines d'Applicationd de l'Informatique,5,477,4,QCU,0.53,0.4,9.87,3,24,27,14,3,11,1.93,21.43,Facile,Difficile,-2,Beaucoup plus Difficile,Pas Adapte
477,2015,Informatique,1,Generalites sur les Systeme Informatiques,3,Logiciels et Domaines d'Applicationd de l'Informatique,5,478,5,QCU,0.56,0.27,13.59,1,6,7,4,1,3,1.75,25.0,Facile,Difficile,-2,Beaucoup plus Difficile,Pas Adapte
1588,2016,Informatique,1,Generalites sur les Systeme Informatiques,3,Logiciels et Domaines d'Applicationd de l'Informatique,5,478,5,QCU,0.44,0.23,31.09,2,5,7,6,2,4,1.17,33.33,Difficile,Difficile,0,Meme Difficulté,Pas Adapte
2699,2017,Informatique,1,Generalites sur les Systeme Informatiques,3,Logiciels et Domaines d'Applicationd de l'Informatique,5,478,5,QCU,0.31,0.44,48.62,4,4,8,6,4,2,1.33,66.67,Moyen,Moyen,0,Meme Difficulté,Pas Adapte
3810,2018,Informatique,1,Generalites sur les Systeme Informatiques,3,Logiciels et Domaines d'Applicationd de l'Informatique,5,478,5,QCU,0.01,0.87,81.7,7,2,9,7,7,0,1.29,100.0,Moyen,Facile,1,Plus Facile,Pas Adapte
4921,2019,Informatique,1,Generalites sur les Systeme Informatiques,3,Logiciels et Domaines d'Applicationd de l'Informatique,5,478,5,QCU,0.33,0.54,43.59,4,5,9,4,4,0,2.25,100.0,Difficile,Moyen,1,Plus Facile,Pas Adapte
6032,2020,Informatique,1,Generalites sur les Systeme Informatiques,3,Logiciels et Domaines d'Applicationd de l'Informatique,5,478,5,QCU,0.04,0.75,89.38,8,1,9,9,8,1,1.0,88.89,Difficile,Facile,2,Beaucoup plus Facile,Pas Adapte
478,2015,Informatique,2,Les Logiciels,1,Systeme d'Exploitation,5,479,1,QCM,0.18,0.84,99.71,63,0,63,63,63,0,1.0,100.0,Difficile,Facile,2,Beaucoup plus Facile,Pas Adapte
1589,2016,Informatique,2,Les Logiciels,1,Systeme d'Exploitation,5,479,1,QCM,0.22,0.43,60.59,41,26,67,49,41,8,1.37,83.67,Facile,Moyen,-1,Plus Difficile,Pas Adapte
2700,2017,Informatique,2,Les Logiciels,1,Systeme d'Exploitation,5,479,1,QCU,0.08,0.75,98.59,76,1,77,76,76,0,1.01,100.0,Moyen,Facile,1,Plus Facile,Pas Adapte
3811,2018,Informatique,2,Les Logiciels,1,Systeme d'Exploitation,5,479,1,QCU,0.71,0.27,25.89,18,51,69,63,18,45,1.1,28.57,Difficile,Difficile,0,Meme Difficulté,Pas Adapte
4922,2019,Informatique,2,Les Logiciels,1,Systeme d'Exploitation,5,479,1,QCU,0.66,0.3,33.21,24,48,72,30,24,6,2.4,80.0,Facile,Difficile,-2,Beaucoup plus Difficile,Pas Adapte
6033,2020,Informatique,2,Les Logiciels,1,Systeme d'Exploitation,5,479,1,QCM,0.68,0.15,3.14,2,65,67,60,2,58,1.12,3.33,Moyen,Difficile,-1,Plus Difficile,Pas Adapte
479,2015,Informatique,2,Les Logiciels,1,Systeme d'Exploitation,5,480,2,QROC,0.86,0.15,14.79,1,4,5,3,1,2,1.67,33.33,Difficile,Difficile,0,Meme Difficulté,Pas Adapte
1590,2016,Informatique,2,Les Logiciels,1,Systeme d'Exploitation,5,480,2,QROC,0.63,0.22,0.1,0,6,6,6,0,6,1.0,0.0,Facile,Difficile,-2,Beaucoup plus Difficile,Pas Adapte
2701,2017,Informatique,2,Les Logiciels,1,Systeme d'Exploitation,5,480,2,QROC,0.28,0.27,58.21,4,3,7,6,4,2,1.17,66.67,Facile,Moyen,-1,Plus Difficile,Pas Adapte
3812,2018,Informatique,2,Les Logiciels,1,Systeme d'Exploitation,5,480,2,QROC,0.44,0.39,62.01,4,2,6,4,4,0,1.5,100.0,Difficile,Moyen,1,Plus Facile,Pas Adapte
4923,2019,Informatique,2,Les Logiciels,1,Systeme d'Exploitation,5,480,2,QROC,0.06,0.67,93.21,6,0,6,6,6,0,1.0,100.0,Moyen,Facile,1,Plus Facile,Pas Adapte
6034,2020,Informatique,2,Les Logiciels,1,Systeme d'Exploitation,5,480,2,QROC,0.3,0.31,52.83,3,3,6,4,3,1,1.5,75.0,Facile,Moyen,-1,Plus Difficile,Pas Adapte
480,2015,Informatique,2,Les Logiciels,1,Systeme d'Exploitation,5,481,3,QCM,0.75,0.18,2.03,1,56,57,23,1,22,2.48,4.35,Facile,Difficile,-2,Beaucoup plus Difficile,Pas Adapte
1591,2016,Informatique,2,Les Logiciels,1,Systeme d'Exploitation,5,481,3,QCM,0.68,0.17,12.48,7,49,56,28,7,21,2.0,25.0,Moyen,Difficile,-1,Plus Difficile,Pas Adapte
2702,2017,Informatique,2,Les Logiciels,1,Systeme d'Exploitation,5,481,3,QCM,0.19,0.72,83.74,53,10,63,55,53,2,1.15,96.36,Facile,Facile,0,Meme Difficulté,Pas Adapte
3813,2018,Informatique,2,Les Logiciels,1,Systeme d'Exploitation,5,481,3,QCM,0.78,0.26,23.37,13,44,57,38,13,25,1.5,34.21,Moyen,Difficile,-1,Plus Difficile,Pas Adapte
4924,2019,Informatique,2,Les Logiciels,1,Systeme d'Exploitation,5,481,3,QCM,0.14,0.81,81.95,51,11,62,62,51,11,1.0,82.26,Facile,Facile,0,Meme Difficulté,Pas Adapte
6035,2020,Informatique,2,Les Logiciels,1,Systeme d'Exploitation,5,481,3,QCM,0.65,0.23,4.39,3,58,61,22,3,19,2.77,13.64,Facile,Difficile,-2,Beaucoup plus Difficile,Pas Adapte
481,2015,Informatique,2,Les Logiciels,1,Systeme d'Exploitation,5,482,4,QCU,0.6,0.39,26.31,26,72,98,46,26,20,2.13,56.52,Difficile,Difficile,0,Meme Difficulté,Pas Adapte
1592,2016,Informatique,2,Les Logiciels,1,Systeme d'Exploitation,5,482,4,QCU,0.66,0.32,29.19,31,75,106,57,31,26,1.86,54.39,Difficile,Difficile,0,Meme Difficulté,Pas Adapte
2703,2017,Informatique,2,Les Logiciels,1,Systeme d'Exploitation,5,482,4,QCU,0.46,0.22,19.43,22,89,111,53,22,31,2.09,41.51,Facile,Difficile,-2,Beaucoup plus Difficile,Pas Adapte
3814,2018,Informatique,2,Les Logiciels,1,Systeme d'Exploitation,5,482,4,QCU,0.74,0.36,25.93,32,92,124,98,32,66,1.27,32.65,Facile,Difficile,-2,Beaucoup plus Difficile,Pas Adapte
4925,2019,Informatique,2,Les Logiciels,1,Systeme d'Exploitation,5,482,4,QCU,0.02,0.91,94.25,121,7,128,124,121,3,1.03,97.58,Difficile,Facile,2,Beaucoup plus Facile,Pas Adapte
6036,2020,Informatique,2,Les Logiciels,1,Systeme d'Exploitation,5,482,4,QROC,0.12,0.78,98.55,141,2,143,142,141,1,1.01,99.3,Moyen,Facile,1,Plus Facile,Pas Adapte
482,2015,Informatique,2,Les Logiciels,1,Systeme d'Exploitation,5,483,5,QCM,0.16,0.71,69.2,58,26,84,72,58,14,1.17,80.56,Difficile,Facile,2,Beaucoup plus Facile,Adapte
1593,2016,Informatique,2,Les Logiciels,1,Systeme d'Exploitation,5,483,5,QCM,0.19,0.77,69.2,49,22,71,66,49,17,1.08,74.24,Facile,Facile,0,Meme Difficulté,Adapte
2704,2017,Informatique,2,Les Logiciels,1,Systeme d'Exploitation,5,483,5,QCM,0.07,0.94,69.2,49,22,71,59,49,10,1.2,83.05,Facile,Facile,0,Meme Difficulté,Adapte
3815,2018,Informatique,2,Les Logiciels,1,Systeme d'Exploitation,5,483,5,QCM,0.11,0.72,69.2,51,23,74,74,51,23,1.0,68.92,Facile,Facile,0,Meme Difficulté,Adapte
4926,2019,Informatique,2,Les Logiciels,1,Systeme d'Exploitation,5,483,5,QCM,0.18,0.81,69.2,53,23,76,60,53,7,1.27,88.33,Facile,Facile,0,Meme Difficulté,Adapte
6037,2020,Informatique,2,Les Logiciels,1,Systeme d'Exploitation,5,483,5,QCM,0.13,0.72,69.2,56,25,81,57,56,1,1.42,98.25,Facile,Facile,0,Meme Difficulté,Adapte
483,2015,Informatique,2,Les Logiciels,2,Traitement de Texte,6,484,1,QCU,0.61,0.22,16.53,15,76,91,55,15,40,1.65,27.27,Difficile,Difficile,0,Meme Difficulté,Pas Adapte
1594,2016,Informatique,2,Les Logiciels,2,Traitement de Texte,6,484,1,QCU,0.38,0.71,61.58,47,30,77,55,47,8,1.4,85.45,Moyen,Moyen,0,Meme Difficulté,Pas Adapte
2705,2017,Informatique,2,Les Logiciels,2,Traitement de Texte,6,484,1,QCU,0.39,0.45,56.09,42,33,75,63,42,21,1.19,66.67,Facile,Moyen,-1,Plus Difficile,Pas Adapte
3816,2018,Informatique,2,Les Logiciels,2,Traitement de Texte,6,484,1,QCU,0.1,0.97,71.0,45,19,64,62,45,17,1.03,72.58,Moyen,Facile,1,Plus Facile,Adapte
4927,2019,Informatique,2,Les Logiciels,2,Traitement de Texte,6,484,1,QCU,0.07,0.77,71.0,46,19,65,64,46,18,1.02,71.88,Facile,Facile,0,Meme Difficulté,Adapte
6038,2020,Informatique,2,Les Logiciels,2,Traitement de Texte,6,484,1,QCU,0.11,0.79,71.0,40,16,56,42,40,2,1.33,95.24,Facile,Facile,0,Meme Difficulté,Adapte
484,2015,Informatique,2,Les Logiciels,2,Traitement de Texte,6,485,2,QCM,0.67,0.25,17.31,16,77,93,87,16,71,1.07,18.39,Moyen,Difficile,-1,Plus Difficile,Pas Adapte
1595,2016,Informatique,2,Les Logiciels,2,Traitement de Texte,6,485,2,QCM,0.43,0.59,36.79,31,54,85,82,31,51,1.04,37.8,Difficile,Moyen,1,Plus Facile,Pas Adapte
2706,2017,Informatique,2,Les Logiciels,2,Traitement de Texte,6,485,2,QCM,0.73,0.21,13.51,10,65,75,43,10,33,1.74,23.26,Moyen,Difficile,-1,Plus Difficile,Pas Adapte
3817,2018,Informatique,2,Les Logiciels,2,Traitement de Texte,6,485,2,QCM,0.73,0.16,26.05,20,57,77,48,20,28,1.6,41.67,Moyen,Difficile,-1,Plus Difficile,Pas Adapte
4928,2019,Informatique,2,Les Logiciels,2,Traitement de Texte,6,485,2,QCU,0.02,0.83,89.29,59,7,66,59,59,0,1.12,100.0,Difficile,Facile,2,Beaucoup plus Facile,Pas Adapte
6039,2020,Informatique,2,Les Logiciels,2,Traitement de Texte,6,485,2,QCM,0.76,0.17,29.12,19,47,66,20,19,1,3.3,95.0,Moyen,Difficile,-1,Plus Difficile,Pas Adapte
485,2015,Informatique,2,Les Logiciels,2,Traitement de Texte,6,486,3,QCU,0.08,0.85,95.18,15,1,16,15,15,0,1.07,100.0,Facile,Facile,0,Meme Difficulté,Pas Adapte
1596,2016,Informatique,2,Les Logiciels,2,Traitement de Texte,6,486,3,QCU,0.28,0.51,59.83,10,7,17,10,10,0,1.7,100.0,Facile,Moyen,-1,Plus Difficile,Pas Adapte
2707,2017,Informatique,2,Les Logiciels,2,Traitement de Texte,6,486,3,QCU,0.29,0.71,54.41,8,7,15,12,8,4,1.25,66.67,Difficile,Moyen,1,Plus Facile,Pas Adapte
3818,2018,Informatique,2,Les Logiciels,2,Traitement de Texte,6,486,3,QCM,0.03,0.86,74.34,12,4,16,15,12,3,1.07,80.0,Facile,Facile,0,Meme Difficulté,Adapte
4929,2019,Informatique,2,Les Logiciels,2,Traitement de Texte,6,486,3,QCM,0.06,0.96,74.34,10,4,14,14,10,4,1.0,71.43,Facile,Facile,0,Meme Difficulté,Adapte
6040,2020,Informatique,2,Les Logiciels,2,Traitement de Texte,6,486,3,QCM,0.03,0.89,74.34,10,4,14,12,10,2,1.17,83.33,Facile,Facile,0,Meme Difficulté,Adapte
486,2015,Informatique,2,Les Logiciels,2,Traitement de Texte,6,487,4,QCM,0.52,0.22,32.56,28,58,86,75,28,47,1.15,37.33,Facile,Difficile,-2,Beaucoup plus Difficile,Pas Adapte
1597,2016,Informatique,2,Les Logiciels,2,Traitement de Texte,6,487,4,QCM,0.41,0.65,54.54,44,36,80,57,44,13,1.4,77.19,Facile,Moyen,-1,Plus Difficile,Pas Adapte
2708,2017,Informatique,2,Les Logiciels,2,Traitement de Texte,6,487,4,QCM,0.48,0.41,48.8,40,41,81,46,40,6,1.76,86.96,Facile,Moyen,-1,Plus Difficile,Pas Adapte
3819,2018,Informatique,2,Les Logiciels,2,Traitement de Texte,6,487,4,QCM,0.08,0.88,80.35,57,14,71,70,57,13,1.01,81.43,Moyen,Facile,1,Plus Facile,Pas Adapte
4930,2019,Informatique,2,Les Logiciels,2,Traitement de Texte,6,487,4,QCM,0.6,0.26,21.67,15,54,69,20,15,5,3.45,75.0,Moyen,Difficile,-1,Plus Difficile,Pas Adapte
6041,2020,Informatique,2,Les Logiciels,2,Traitement de Texte,6,487,4,QCM,0.31,0.59,41.99,28,38,66,39,28,11,1.69,71.79,Facile,Moyen,-1,Plus Difficile,Pas Adapte
487,2015,Informatique,2,Les Logiciels,2,Traitement de Texte,6,488,5,QCU,0.08,0.93,65.29,64,34,98,94,64,30,1.04,68.09,Difficile,Facile,2,Beaucoup plus Facile,Adapte
1598,2016,Informatique,2,Les Logiciels,2,Traitement de Texte,6,488,5,QCU,0.08,0.95,65.29,59,32,91,91,59,32,1.0,64.84,Facile,Facile,0,Meme Difficulté,Adapte
2709,2017,Informatique,2,Les Logiciels,2,Traitement de Texte,6,488,5,QCU,0.08,0.78,65.29,59,31,90,80,59,21,1.12,73.75,Facile,Facile,0,Meme Difficulté,Adapte
3820,2018,Informatique,2,Les Logiciels,2,Traitement de Texte,6,488,5,QCU,0.2,0.79,65.29,66,35,101,83,66,17,1.22,79.52,Facile,Facile,0,Meme Difficulté,Adapte
4931,2019,Informatique,2,Les Logiciels,2,Traitement de Texte,6,488,5,QCU,0.03,0.79,65.29,70,37,107,75,70,5,1.43,93.33,Facile,Facile,0,Meme Difficulté,Adapte
6042,2020,Informatique,2,Les Logiciels,2,Traitement de Texte,6,488,5,QCU,0.03,0.76,65.29,63,33,96,89,63,26,1.08,70.79,Facile,Facile,0,Meme Difficulté,Adapte
488,2015,Informatique,2,Les Logiciels,2,Traitement de Texte,6,489,6,QCU,0.65,0.31,17.99,4,16,20,17,4,13,1.18,23.53,Facile,Difficile,-2,Beaucoup plus Difficile,Pas Adapte
1599,2016,Informatique,2,Les Logiciels,2,Traitement de Texte,6,489,6,QCU,0.23,0.68,47.49,10,11,21,10,10,0,2.1,100.0,Difficile,Moyen,1,Plus Facile,Pas Adapte
2710,2017,Informatique,2,Les Logiciels,2,Traitement de Texte,6,489,6,QCM,0.41,0.57,45.83,11,12,23,13,11,2,1.77,84.62,Moyen,Moyen,0,Meme Difficulté,Pas Adapte
3821,2018,Informatique,2,Les Logiciels,2,Traitement de Texte,6,489,6,QCM,0.45,0.48,44.12,11,14,25,25,11,14,1.0,44.0,Facile,Moyen,-1,Plus Difficile,Pas Adapte
4932,2019,Informatique,2,Les Logiciels,2,Traitement de Texte,6,489,6,QCM,0.09,0.82,85.84,19,3,22,21,19,2,1.05,90.48,Difficile,Facile,2,Beaucoup plus Facile,Pas Adapte
6043,2020,Informatique,2,Les Logiciels,2,Traitement de Texte,6,489,6,QCM,0.34,0.67,48.43,12,12,24,19,12,7,1.26,63.16,Facile,Moyen,-1,Plus Difficile,Pas Adapte
489,2015,Informatique,2,Les Logiciels,3,Les Tableurs,5,490,1,QCM,0.12,0.7,75.28,50,17,67,61,50,11,1.1,81.97,Moyen,Facile,1,Plus Facile,Pas Adapte
1600,2016,Informatique,2,Les Logiciels,3,Les Tableurs,5,490,1,QCM,0.55,0.27,18.85,13,58,71,32,13,19,2.22,40.62,Facile,Difficile,-2,Beaucoup plus Difficile,Pas Adapte
2711,2017,Informatique,2,Les Logiciels,3,Les Tableurs,5,490,1,QCM,0.15,1.0,73.48,44,16,60,53,44,9,1.13,83.02,Difficile,Facile,2,Beaucoup plus Facile,Adapte
3822,2018,Informatique,2,Les Logiciels,3,Les Tableurs,5,490,1,QCM,0.06,1.0,73.48,50,18,68,53,50,3,1.28,94.34,Facile,Facile,0,Meme Difficulté,Adapte
4933,2019,Informatique,2,Les Logiciels,3,Les Tableurs,5,490,1,QCM,0.15,0.96,73.48,52,19,71,53,52,1,1.34,98.11,Facile,Facile,0,Meme Difficulté,Adapte
6044,2020,Informatique,2,Les Logiciels,3,Les Tableurs,5,490,1,QCM,0.06,0.71,73.48,55,20,75,74,55,19,1.01,74.32,Facile,Facile,0,Meme Difficulté,Adapte
490,2015,Informatique,2,Les Logiciels,3,Les Tableurs,5,491,2,QCU,0.02,0.98,76.57,29,9,38,34,29,5,1.12,85.29,Facile,Facile,0,Meme Difficulté,Pas Adapte
1601,2016,Informatique,2,Les Logiciels,3,Les Tableurs,5,491,2,QCU,0.2,0.54,51.24,16,16,32,22,16,6,1.45,72.73,Moyen,Moyen,0,Meme Difficulté,Pas Adapte
2712,2017,Informatique,2,Les Logiciels,3,Les Tableurs,5,491,2,QCU,0.69,0.37,7.78,3,32,35,13,3,10,2.69,23.08,Difficile,Difficile,0,Meme Difficulté,Pas Adapte
3823,2018,Informatique,2,Les Logiciels,3,Les Tableurs,5,491,2,QCU,0.1,0.85,76.58,25,7,32,27,25,2,1.19,92.59,Facile,Facile,0,Meme Difficulté,Pas Adapte
4934,2019,Informatique,2,Les Logiciels,3,Les Tableurs,5,491,2,QCM,0.12,0.94,80.18,22,5,27,23,22,1,1.17,95.65,Moyen,Facile,1,Plus Facile,Pas Adapte
6045,2020,Informatique,2,Les Logiciels,3,Les Tableurs,5,491,2,QCM,0.26,0.45,55.32,15,12,27,17,15,2,1.59,88.24,Difficile,Moyen,1,Plus Facile,Pas Adapte
491,2015,Informatique,2,Les Logiciels,3,Les Tableurs,5,492,3,QCU,0.25,0.41,62.55,28,17,45,29,28,1,1.55,96.55,Difficile,Moyen,1,Plus Facile,Pas Adapte
1602,2016,Informatique,2,Les Logiciels,3,Les Tableurs,5,492,3,QCU,0.47,0.28,9.17,4,36,40,19,4,15,2.11,21.05,Difficile,Difficile,0,Meme Difficulté,Pas Adapte
2713,2017,Informatique,2,Les Logiciels,3,Les Tableurs,5,492,3,QCU,0.03,0.91,85.94,38,6,44,41,38,3,1.07,92.68,Difficile,Facile,2,Beaucoup plus Facile,Pas Adapte
3824,2018,Informatique,2,Les Logiciels,3,Les Tableurs,5,492,3,QCU,0.01,0.98,91.27,43,4,47,46,43,3,1.02,93.48,Facile,Facile,0,Meme Difficulté,Pas Adapte
4935,2019,Informatique,2,Les Logiciels,3,Les Tableurs,5,492,3,QCU,0.07,0.97,84.23,34,6,40,39,34,5,1.03,87.18,Facile,Facile,0,Meme Difficulté,Pas Adapte
6046,2020,Informatique,2,Les Logiciels,3,Les Tableurs,5,492,3,QCU,0.54,0.37,31.58,11,24,35,24,11,13,1.46,45.83,Facile,Difficile,-2,Beaucoup plus Difficile,Pas Adapte
492,2015,Informatique,2,Les Logiciels,3,Les Tableurs,5,493,4,QCU,0.17,0.76,66.85,64,31,95,93,64,29,1.02,68.82,Difficile,Facile,2,Beaucoup plus Facile,Adapte
1603,2016,Informatique,2,Les Logiciels,3,Les Tableurs,5,493,4,QCU,0.11,0.82,66.85,63,31,94,72,63,9,1.31,87.5,Facile,Facile,0,Meme Difficulté,Adapte
2714,2017,Informatique,2,Les Logiciels,3,Les Tableurs,5,493,4,QCU,0.08,0.85,66.85,69,34,103,94,69,25,1.1,73.4,Facile,Facile,0,Meme Difficulté,Adapte
3825,2018,Informatique,2,Les Logiciels,3,Les Tableurs,5,493,4,QCU,0.14,0.99,66.85,60,30,90,72,60,12,1.25,83.33,Facile,Facile,0,Meme Difficulté,Adapte
4936,2019,Informatique,2,Les Logiciels,3,Les Tableurs,5,493,4,QCU,0.01,0.87,66.85,51,25,76,74,51,23,1.03,68.92,Facile,Facile,0,Meme Difficulté,Adapte
6047,2020,Informatique,2,Les Logiciels,3,Les Tableurs,5,493,4,QCM,0.1,0.94,66.85,57,28,85,59,57,2,1.44,96.61,Facile,Facile,0,Meme Difficulté,Adapte
493,2015,Informatique,2,Les Logiciels,3,Les Tableurs,5,494,5,QO,0.02,0.74,91.13,89,9,98,90,89,1,1.09,98.89,Difficile,Facile,2,Beaucoup plus Facile,Pas Adapte
1604,2016,Informatique,2,Les Logiciels,3,Les Tableurs,5,494,5,QO,0.17,0.79,78.11,76,21,97,87,76,11,1.11,87.36,Moyen,Facile,1,Plus Facile,Pas Adapte
2715,2017,Informatique,2,Les Logiciels,3,Les Tableurs,5,494,5,QO,0.97,0.1,28.31,24,62,86,72,24,48,1.19,33.33,Facile,Difficile,-2,Beaucoup plus Difficile,Pas Adapte
3826,2018,Informatique,2,Les Logiciels,3,Les Tableurs,5,494,5,QROC,0.51,0.28,56.44,49,38,87,68,49,19,1.28,72.06,Difficile,Moyen,1,Plus Facile,Pas Adapte
4937,2019,Informatique,2,Les Logiciels,3,Les Tableurs,5,494,5,QROC,0.55,0.26,39.61,37,57,94,78,37,41,1.21,47.44,Difficile,Moyen,1,Plus Facile,Pas Adapte
6048,2020,Informatique,2,Les Logiciels,3,Les Tableurs,5,494,5,QROC,0.49,0.37,63.92,53,30,83,63,53,10,1.32,84.13,Facile,Moyen,-1,Plus Difficile,Pas Adapte
494,2015,Informatique,3,Algorithme et Programmation,1,Notion d'Algorithme,5,495,1,QCM,0.03,0.88,82.53,77,16,93,87,77,10,1.07,88.51,Facile,Facile,0,Meme Difficulté,Pas Adapte
1605,2016,Informatique,3,Algorithme et Programmation,1,Notion d'Algorithme,5,495,1,QCM,0.32,0.57,64.39,53,30,83,74,53,21,1.12,71.62,Difficile,Moyen,1,Plus Facile,Pas Adapte
2716,2017,Informatique,3,Algorithme et Programmation,1,Notion d'Algorithme,5,495,1,QCU,0.7,0.3,11.11,11,84,95,52,11,41,1.83,21.15,Facile,Difficile,-2,Beaucoup plus Difficile,Pas Adapte
3827,2018,Informatique,3,Algorithme et Programmation,1,Notion d'Algorithme,5,495,1,QCU,0.12,0.97,88.61,95,12,107,98,95,3,1.09,96.94,Difficile,Facile,2,Beaucoup plus Facile,Pas Adapte
4938,2019,Informatique,3,Algorithme et Programmation,1,Notion d'Algorithme,5,495,1,QCU,0.32,0.63,60.2,55,36,91,88,55,33,1.03,62.5,Facile,Moyen,-1,Plus Difficile,Pas Adapte
6049,2020,Informatique,3,Algorithme et Programmation,1,Notion d'Algorithme,5,495,1,QCM,0.37,0.59,51.05,45,43,88,85,45,40,1.04,52.94,Facile,Moyen,-1,Plus Difficile,Pas Adapte
495,2015,Informatique,3,Algorithme et Programmation,1,Notion d'Algorithme,5,496,2,QCU,0.28,0.47,49.32,29,29,58,53,29,24,1.09,54.72,Difficile,Moyen,1,Plus Facile,Pas Adapte
1606,2016,Informatique,3,Algorithme et Programmation,1,Notion d'Algorithme,5,496,2,QCU,0.38,0.64,45.13,25,31,56,42,25,17,1.33,59.52,Facile,Moyen,-1,Plus Difficile,Pas Adapte
2717,2017,Informatique,3,Algorithme et Programmation,1,Notion d'Algorithme,5,496,2,QCU,0.49,0.27,26.99,15,40,55,24,15,9,2.29,62.5,Difficile,Difficile,0,Meme Difficulté,Pas Adapte
3828,2018,Informatique,3,Algorithme et Programmation,1,Notion d'Algorithme,5,496,2,QCU,0.21,0.66,41.76,20,28,48,48,20,28,1.0,41.67,Moyen,Moyen,0,Meme Difficulté,Pas Adapte
4939,2019,Informatique,3,Algorithme et Programmation,1,Notion d'Algorithme,5,496,2,QCU,0.06,0.93,71.75,30,12,42,39,30,9,1.08,76.92,Moyen,Facile,1,Plus Facile,Adapte
6050,2020,Informatique,3,Algorithme et Programmation,1,Notion d'Algorithme,5,496,2,QCM,0.09,0.98,71.75,29,12,41,34,29,5,1.21,85.29,Facile,Facile,0,Meme Difficulté,Adapte
496,2015,Informatique,3,Algorithme et Programmation,1,Notion d'Algorithme,5,497,3,QCU,0.1,0.77,68.1,67,31,98,74,67,7,1.32,90.54,Difficile,Facile,2,Beaucoup plus Facile,Adapte
1607,2016,Informatique,3,Algorithme et Programmation,1,Notion d'Algorithme,5,497,3,QO,0.05,0.78,68.1,66,31,97,94,66,28,1.03,70.21,Facile,Facile,0,Meme Difficulté,Adapte
2718,2017,Informatique,3,Algorithme et Programmation,1,Notion d'Algorithme,5,497,3,QCM,0.11,0.82,68.1,68,32,100,71,68,3,1.41,95.77,Facile,Facile,0,Meme Difficulté,Adapte
3829,2018,Informatique,3,Algorithme et Programmation,1,Notion d'Algorithme,5,497,3,QCM,0.06,0.94,68.1,67,32,99,80,67,13,1.24,83.75,Facile,Facile,0,Meme Difficulté,Adapte
4940,2019,Informatique,3,Algorithme et Programmation,1,Notion d'Algorithme,5,497,3,QCM,0.07,0.87,68.1,71,33,104,79,71,8,1.32,89.87,Facile,Facile,0,Meme Difficulté,Adapte
6051,2020,Informatique,3,Algorithme et Programmation,1,Notion d'Algorithme,5,497,3,QCM,0.0,0.85,68.1,69,33,102,85,69,16,1.2,81.18,Facile,Facile,0,Meme Difficulté,Adapte
497,2015,Informatique,3,Algorithme et Programmation,1,Notion d'Algorithme,5,498,4,QCU,0.67,0.22,1.49,1,82,83,38,1,37,2.18,2.63,Facile,Difficile,-2,Beaucoup plus Difficile,Pas Adapte
1608,2016,Informatique,3,Algorithme et Programmation,1,Notion d'Algorithme,5,498,4,QCU,0.18,0.76,83.21,70,14,84,83,70,13,1.01,84.34,Facile,Facile,0,Meme Difficulté,Pas Adapte
2719,2017,Informatique,3,Algorithme et Programmation,1,Notion d'Algorithme,5,498,4,QCU,0.5,0.31,10.7,9,71,80,36,9,27,2.22,25.0,Difficile,Difficile,0,Meme Difficulté,Pas Adapte
3830,2018,Informatique,3,Algorithme et Programmation,1,Notion d'Algorithme,5,498,4,QCU,0.15,0.84,88.81,60,8,68,62,60,2,1.1,96.77,Difficile,Facile,2,Beaucoup plus Facile,Pas Adapte
4941,2019,Informatique,3,Algorithme et Programmation,1,Notion d'Algorithme,5,498,4,QCM,0.44,0.42,46.14,30,36,66,63,30,33,1.05,47.62,Difficile,Moyen,1,Plus Facile,Pas Adapte
6052,2020,Informatique,3,Algorithme et Programmation,1,Notion d'Algorithme,5,498,4,QROC,0.22,0.31,35.87,22,38,60,28,22,6,2.14,78.57,Difficile,Moyen,1,Plus Facile,Pas Adapte
498,2015,Informatique,3,Algorithme et Programmation,1,Notion d'Algorithme,5,499,5,QROC,0.82,0.02,4.89,4,78,82,82,4,78,1.0,4.88,Difficile,Difficile,0,Meme Difficulté,Pas Adapte
1609,2016,Informatique,3,Algorithme et Programmation,1,Notion d'Algorithme,5,499,5,QROC,0.26,0.31,36.58,34,60,94,65,34,31,1.45,52.31,Moyen,Moyen,0,Meme Difficulté,Pas Adapte
2720,2017,Informatique,3,Algorithme et Programmation,1,Notion d'Algorithme,5,499,5,QROC,0.58,0.31,36.98,38,66,104,84,38,46,1.24,45.24,Moyen,Moyen,0,Meme Difficulté,Pas Adapte
3831,2018,Informatique,3,Algorithme et Programmation,1,Notion d'Algorithme,5,499,5,QROC,0.2,0.27,46.45,52,60,112,69,52,17,1.62,75.36,Moyen,Moyen,0,Meme Difficulté,Pas Adapte
4942,2019,Informatique,3,Algorithme et Programmation,1,Notion d'Algorithme,5,499,5,QROC,0.12,0.88,77.55,78,23,101,87,78,9,1.16,89.66,Difficile,Facile,2,Beaucoup plus Facile,Pas Adapte
6053,2020,Informatique,3,Algorithme et Programmation,1,Notion d'Algorithme,5,499,5,QROC,0.15,0.48,85.28,89,15,104,101,89,12,1.03,88.12,Facile,Facile,0,Meme Difficulté,Pas Adapte
499,2015,Informatique,3,Algorithme et Programmation,2,Instruction de Base,9,500,1,QCU,0.05,0.78,91.86,43,4,47,46,43,3,1.02,93.48,Facile,Facile,0,Meme Difficulté,Pas Adapte
1610,2016,Informatique,3,Algorithme et Programmation,2,Instruction de Base,9,500,1,QCU,0.25,0.52,57.04,25,19,44,32,25,7,1.38,78.12,Moyen,Moyen,0,Meme Difficulté,Pas Adapte
2721,2017,Informatique,3,Algorithme et Programmation,2,Instruction de Base,9,500,1,QCU,0.27,0.48,61.03,24,16,40,37,24,13,1.08,64.86,Moyen,Moyen,0,Meme Difficulté,Pas Adapte
3832,2018,Informatique,3,Algorithme et Programmation,2,Instruction de Base,9,500,1,QO,0.78,0.15,2.44,1,40,41,37,1,36,1.11,2.7,Moyen,Difficile,-1,Plus Difficile,Pas Adapte
4943,2019,Informatique,3,Algorithme et Programmation,2,Instruction de Base,9,500,1,QO,0.57,0.27,50.51,22,21,43,24,22,2,1.79,91.67,Facile,Moyen,-1,Plus Difficile,Pas Adapte
6054,2020,Informatique,3,Algorithme et Programmation,2,Instruction de Base,9,500,1,QO,0.59,0.2,60.97,23,15,38,37,23,14,1.03,62.16,Moyen,Moyen,0,Meme Difficulté,Pas Adapte
500,2015,Informatique,3,Algorithme et Programmation,2,Instruction de Base,9,501,2,QCM,0.34,0.6,62.34,54,33,87,86,54,32,1.01,62.79,Facile,Moyen,-1,Plus Difficile,Pas Adapte
1611,2016,Informatique,3,Algorithme et Programmation,2,Instruction de Base,9,501,2,QCM,0.26,0.32,50.0,42,42,84,55,42,13,1.53,76.36,Facile,Moyen,-1,Plus Difficile,Pas Adapte
2722,2017,Informatique,3,Algorithme et Programmation,2,Instruction de Base,9,501,2,QCM,0.46,0.44,58.42,57,40,97,77,57,20,1.26,74.03,Difficile,Moyen,1,Plus Facile,Pas Adapte
3833,2018,Informatique,3,Algorithme et Programmation,2,Instruction de Base,9,501,2,QCM,0.6,0.2,18.84,17,74,91,63,17,46,1.44,26.98,Difficile,Difficile,0,Meme Difficulté,Pas Adapte
4944,2019,Informatique,3,Algorithme et Programmation,2,Instruction de Base,9,501,2,QCM,0.61,0.26,16.1,16,81,97,87,16,71,1.11,18.39,Moyen,Difficile,-1,Plus Difficile,Pas Adapte
6055,2020,Informatique,3,Algorithme et Programmation,2,Instruction de Base,9,501,2,QCM,0.19,0.98,76.75,66,20,86,75,66,9,1.15,88.0,Facile,Facile,0,Meme Difficulté,Pas Adapte
501,2015,Informatique,3,Algorithme et Programmation,2,Instruction de Base,9,502,3,QROC,0.2,0.42,90.71,78,8,86,84,78,6,1.02,92.86,Difficile,Facile,2,Beaucoup plus Facile,Pas Adapte
1612,2016,Informatique,3,Algorithme et Programmation,2,Instruction de Base,9,502,3,QROC,0.85,0.15,32.23,27,57,84,59,27,32,1.42,45.76,Difficile,Difficile,0,Meme Difficulté,Pas Adapte
2723,2017,Informatique,3,Algorithme et Programmation,2,Instruction de Base,9,502,3,QROC,0.12,0.83,80.88,70,17,87,85,70,15,1.02,82.35,Difficile,Facile,2,Beaucoup plus Facile,Pas Adapte
3834,2018,Informatique,3,Algorithme et Programmation,2,Instruction de Base,9,502,3,QROC,0.0,0.9,75.14,65,21,86,78,65,13,1.1,83.33,Facile,Facile,0,Meme Difficulté,Pas Adapte
4945,2019,Informatique,3,Algorithme et Programmation,2,Instruction de Base,9,502,3,QROC,0.18,0.94,92.47,79,6,85,83,79,4,1.02,95.18,Moyen,Facile,1,Plus Facile,Pas Adapte
6056,2020,Informatique,3,Algorithme et Programmation,2,Instruction de Base,9,502,3,QO,0.16,0.8,76.58,73,22,95,82,73,9,1.16,89.02,Moyen,Facile,1,Plus Facile,Pas Adapte
502,2015,Informatique,3,Algorithme et Programmation,2,Instruction de Base,9,503,4,QCM,0.32,0.4,38.31,13,22,35,22,13,9,1.59,59.09,Difficile,Moyen,1,Plus Facile,Pas Adapte
1613,2016,Informatique,3,Algorithme et Programmation,2,Instruction de Base,9,503,4,QCM,0.13,0.73,91.09,35,3,38,35,35,0,1.09,100.0,Facile,Facile,0,Meme Difficulté,Pas Adapte
2724,2017,Informatique,3,Algorithme et Programmation,2,Instruction de Base,9,503,4,QCM,0.45,0.64,62.66,22,13,35,28,22,6,1.25,78.57,Facile,Moyen,-1,Plus Difficile,Pas Adapte
3835,2018,Informatique,3,Algorithme et Programmation,2,Instruction de Base,9,503,4,QROC,0.19,0.78,88.62,28,4,32,29,28,1,1.1,96.55,Facile,Facile,0,Meme Difficulté,Pas Adapte
4946,2019,Informatique,3,Algorithme et Programmation,2,Instruction de Base,9,503,4,QROC,0.87,0.15,17.86,5,22,27,24,5,19,1.12,20.83,Moyen,Difficile,-1,Plus Difficile,Pas Adapte
6057,2020,Informatique,3,Algorithme et Programmation,2,Instruction de Base,9,503,4,QROC,0.06,0.59,66.34,19,10,29,26,19,7,1.12,73.08,Facile,Facile,0,Meme Difficulté,Adapte
503,2015,Informatique,3,Algorithme et Programmation,2,Instruction de Base,9,504,5,QCU,0.74,0.22,10.38,8,68,76,48,8,40,1.58,16.67,Moyen,Difficile,-1,Plus Difficile,Pas Adapte
1614,2016,Informatique,3,Algorithme et Programmation,2,Instruction de Base,9,504,5,QCU,0.6,0.37,32.62,21,44,65,62,21,41,1.05,33.87,Difficile,Difficile,0,Meme Difficulté,Pas Adapte
2725,2017,Informatique,3,Algorithme et Programmation,2,Instruction de Base,9,504,5,QCU,0.05,0.79,93.58,51,4,55,55,51,4,1.0,92.73,Difficile,Facile,2,Beaucoup plus Facile,Pas Adapte
3836,2018,Informatique,3,Algorithme et Programmation,2,Instruction de Base,9,504,5,QCU,0.53,0.36,23.35,14,44,58,47,14,33,1.23,29.79,Moyen,Difficile,-1,Plus Difficile,Pas Adapte
4947,2019,Informatique,3,Algorithme et Programmation,2,Instruction de Base,9,504,5,QCU,0.39,0.5,57.23,38,28,66,42,38,4,1.57,90.48,Facile,Moyen,-1,Plus Difficile,Pas Adapte
6058,2020,Informatique,3,Algorithme et Programmation,2,Instruction de Base,9,504,5,QCU,0.4,0.46,60.33,43,28,71,46,43,3,1.54,93.48,Difficile,Moyen,1,Plus Facile,Pas Adapte
504,2015,Informatique,3,Algorithme et Programmation,2,Instruction de Base,9,505,6,QCM,0.6,0.18,10.08,8,68,76,24,8,16,3.17,33.33,Difficile,Difficile,0,Meme Difficulté,Pas Adapte
1615,2016,Informatique,3,Algorithme et Programmation,2,Instruction de Base,9,505,6,QCM,0.59,0.25,30.63,21,47,68,49,21,28,1.39,42.86,Difficile,Difficile,0,Meme Difficulté,Pas Adapte
2726,2017,Informatique,3,Algorithme et Programmation,2,Instruction de Base,9,505,6,QCM,0.63,0.3,8.98,6,64,70,30,6,24,2.33,20.0,Moyen,Difficile,-1,Plus Difficile,Pas Adapte
3837,2018,Informatique,3,Algorithme et Programmation,2,Instruction de Base,9,505,6,QROC,0.03,0.54,75.38,46,15,61,47,46,1,1.3,97.87,Facile,Facile,0,Meme Difficulté,Pas Adapte
4948,2019,Informatique,3,Algorithme et Programmation,2,Instruction de Base,9,505,6,QROC,0.05,0.88,69.97,43,18,61,51,43,8,1.2,84.31,Moyen,Facile,1,Plus Facile,Adapte
6059,2020,Informatique,3,Algorithme et Programmation,2,Instruction de Base,9,505,6,QROC,0.13,0.78,69.97,38,16,54,47,38,9,1.15,80.85,Facile,Facile,0,Meme Difficulté,Adapte
505,2015,Informatique,3,Algorithme et Programmation,2,Instruction de Base,9,506,7,QCU,0.34,0.72,61.71,24,15,39,29,24,5,1.34,82.76,Moyen,Moyen,0,Meme Difficulté,Pas Adapte
1616,2016,Informatique,3,Algorithme et Programmation,2,Instruction de Base,9,506,7,QCU,0.01,0.86,73.09,29,10,39,36,29,7,1.08,80.56,Moyen,Facile,1,Plus Facile,Adapte
2727,2017,Informatique,3,Algorithme et Programmation,2,Instruction de Base,9,506,7,QCU,0.14,0.86,73.09,27,10,37,30,27,3,1.23,90.0,Facile,Facile,0,Meme Difficulté,Adapte
3838,2018,Informatique,3,Algorithme et Programmation,2,Instruction de Base,9,506,7,QCU,0.13,0.83,73.09,23,8,31,24,23,1,1.29,95.83,Facile,Facile,0,Meme Difficulté,Adapte
4949,2019,Informatique,3,Algorithme et Programmation,2,Instruction de Base,9,506,7,QCU,0.18,0.84,73.09,21,8,29,26,21,5,1.12,80.77,Facile,Facile,0,Meme Difficulté,Adapte
6060,2020,Informatique,3,Algorithme et Programmation,2,Instruction de Base,9,506,7,QCU,0.08,0.87,73.09,23,8,31,30,23,7,1.03,76.67,Facile,Facile,0,Meme Difficulté,Adapte
506,2015,Informatique,3,Algorithme et Programmation,2,Instruction de Base,9,507,8,QCU,0.48,0.21,0.95,0,40,40,27,0,27,1.48,0.0,Facile,Difficile,-2,Beaucoup plus Difficile,Pas Adapte
1617,2016,Informatique,3,Algorithme et Programmation,2,Instruction de Base,9,507,8,QCU,0.73,0.34,22.27,8,28,36,22,8,14,1.64,36.36,Difficile,Difficile,0,Meme Difficulté,Pas Adapte
2728,2017,Informatique,3,Algorithme et Programmation,2,Instruction de Base,9,507,8,QCM,0.15,0.9,80.94,26,6,32,28,26,2,1.14,92.86,Facile,Facile,0,Meme Difficulté,Pas Adapte
3839,2018,Informatique,3,Algorithme et Programmation,2,Instruction de Base,9,507,8,QCM,0.31,0.44,39.74,12,17,29,16,12,4,1.81,75.0,Facile,Moyen,-1,Plus Difficile,Pas Adapte
4950,2019,Informatique,3,Algorithme et Programmation,2,Instruction de Base,9,507,8,QCM,0.08,0.94,91.63,26,2,28,27,26,1,1.04,96.3,Facile,Facile,0,Meme Difficulté,Pas Adapte
6061,2020,Informatique,3,Algorithme et Programmation,2,Instruction de Base,9,507,8,QCM,0.59,0.19,4.37,1,28,29,24,1,23,1.21,4.17,Difficile,Difficile,0,Meme Difficulté,Pas Adapte
507,2015,Informatique,3,Algorithme et Programmation,2,Instruction de Base,9,508,9,QCU,0.67,0.21,28.27,15,38,53,48,15,33,1.1,31.25,Moyen,Difficile,-1,Plus Difficile,Pas Adapte
1618,2016,Informatique,3,Algorithme et Programmation,2,Instruction de Base,9,508,9,QCU,0.55,0.3,23.59,14,44,58,37,14,23,1.57,37.84,Moyen,Difficile,-1,Plus Difficile,Pas Adapte
2729,2017,Informatique,3,Algorithme et Programmation,2,Instruction de Base,9,508,9,QCU,0.22,0.57,57.5,33,24,57,47,33,14,1.21,70.21,Moyen,Moyen,0,Meme Difficulté,Pas Adapte
3840,2018,Informatique,3,Algorithme et Programmation,2,Instruction de Base,9,508,9,QCU,0.29,0.47,51.12,30,29,59,41,30,11,1.44,73.17,Moyen,Moyen,0,Meme Difficulté,Pas Adapte
4951,2019,Informatique,3,Algorithme et Programmation,2,Instruction de Base,9,508,9,QCU,0.12,0.82,74.16,38,13,51,48,38,10,1.06,79.17,Difficile,Facile,2,Beaucoup plus Facile,Adapte
6062,2020,Informatique,3,Algorithme et Programmation,2,Instruction de Base,9,508,9,QCU,0.08,0.76,74.16,44,15,59,54,44,10,1.09,81.48,Facile,Facile,0,Meme Difficulté,Adapte
508,2015,Informatique,3,Algorithme et Programmation,3,Les Langagues de Programmation,8,509,1,QROC,0.04,0.78,75.99,6,2,8,6,6,0,1.33,100.0,Moyen,Facile,1,Plus Facile,Pas Adapte
1619,2016,Informatique,3,Algorithme et Programmation,3,Les Langagues de Programmation,8,509,1,QO,0.66,0.22,39.76,3,5,8,6,3,3,1.33,50.0,Facile,Moyen,-1,Plus Difficile,Pas Adapte
2730,2017,Informatique,3,Algorithme et Programmation,3,Les Langagues de Programmation,8,509,1,QO,0.02,0.85,90.25,8,1,9,8,8,0,1.12,100.0,Moyen,Facile,1,Plus Facile,Pas Adapte
3841,2018,Informatique,3,Algorithme et Programmation,3,Les Langagues de Programmation,8,509,1,QO,0.17,0.32,89.45,7,1,8,8,7,1,1.0,87.5,Difficile,Facile,2,Beaucoup plus Facile,Pas Adapte
4952,2019,Informatique,3,Algorithme et Programmation,3,Les Langagues de Programmation,8,509,1,QO,0.97,0.03,9.75,1,6,7,6,1,5,1.17,16.67,Moyen,Difficile,-1,Plus Difficile,Pas Adapte
6063,2020,Informatique,3,Algorithme et Programmation,3,Les Langagues de Programmation,8,509,1,QO,0.88,0.12,19.27,1,5,6,5,1,4,1.2,20.0,Moyen,Difficile,-1,Plus Difficile,Pas Adapte
509,2015,Informatique,3,Algorithme et Programmation,3,Les Langagues de Programmation,8,510,2,QCU,0.4,0.69,63.81,36,21,57,57,36,21,1.0,63.16,Difficile,Moyen,1,Plus Facile,Pas Adapte
1620,2016,Informatique,3,Algorithme et Programmation,3,Les Langagues de Programmation,8,510,2,QCU,0.43,0.23,18.2,11,48,59,29,11,18,2.03,37.93,Moyen,Difficile,-1,Plus Difficile,Pas Adapte
2731,2017,Informatique,3,Algorithme et Programmation,3,Les Langagues de Programmation,8,510,2,QCU,0.5,0.32,8.12,4,46,50,46,4,42,1.09,8.7,Facile,Difficile,-2,Beaucoup plus Difficile,Pas Adapte
3842,2018,Informatique,3,Algorithme et Programmation,3,Les Langagues de Programmation,8,510,2,QCU,0.13,0.89,90.02,48,5,53,50,48,2,1.06,96.0,Moyen,Facile,1,Plus Facile,Pas Adapte
4953,2019,Informatique,3,Algorithme et Programmation,3,Les Langagues de Programmation,8,510,2,QCU,0.73,0.28,16.38,8,41,49,46,8,38,1.07,17.39,Difficile,Difficile,0,Meme Difficulté,Pas Adapte
6064,2020,Informatique,3,Algorithme et Programmation,3,Les Langagues de Programmation,8,510,2,QCU,0.28,0.52,35.97,16,28,44,38,16,22,1.16,42.11,Moyen,Moyen,0,Meme Difficulté,Pas Adapte
510,2015,Informatique,3,Algorithme et Programmation,3,Les Langagues de Programmation,8,511,3,QCU,0.2,0.9,74.07,26,9,35,32,26,6,1.09,81.25,Difficile,Facile,2,Beaucoup plus Facile,Adapte
1621,2016,Informatique,3,Algorithme et Programmation,3,Les Langagues de Programmation,8,511,3,QCU,0.08,0.91,74.07,25,9,34,26,25,1,1.31,96.15,Facile,Facile,0,Meme Difficulté,Adapte
2732,2017,Informatique,3,Algorithme et Programmation,3,Les Langagues de Programmation,8,511,3,QCU,0.18,0.81,74.07,22,8,30,22,22,0,1.36,100.0,Facile,Facile,0,Meme Difficulté,Adapte
3843,2018,Informatique,3,Algorithme et Programmation,3,Les Langagues de Programmation,8,511,3,QCU,0.07,0.95,74.07,19,7,26,20,19,1,1.3,95.0,Facile,Facile,0,Meme Difficulté,Adapte
4954,2019,Informatique,3,Algorithme et Programmation,3,Les Langagues de Programmation,8,511,3,QCU,0.09,0.95,74.07,21,8,29,23,21,2,1.26,91.3,Facile,Facile,0,Meme Difficulté,Adapte
6065,2020,Informatique,3,Algorithme et Programmation,3,Les Langagues de Programmation,8,511,3,QCU,0.01,0.77,74.07,19,7,26,20,19,1,1.3,95.0,Facile,Facile,0,Meme Difficulté,Adapte
511,2015,Informatique,3,Algorithme et Programmation,3,Les Langagues de Programmation,8,512,4,QCU,0.1,0.83,90.54,12,1,13,13,12,1,1.0,92.31,Difficile,Facile,2,Beaucoup plus Facile,Pas Adapte
1622,2016,Informatique,3,Algorithme et Programmation,3,Les Langagues de Programmation,8,512,4,QCU,0.52,0.28,25.01,3,9,12,8,3,5,1.5,37.5,Facile,Difficile,-2,Beaucoup plus Difficile,Pas Adapte
2733,2017,Informatique,3,Algorithme et Programmation,3,Les Langagues de Programmation,8,512,4,QCU,0.47,0.33,33.06,3,7,10,8,3,5,1.25,37.5,Moyen,Difficile,-1,Plus Difficile,Pas Adapte
3844,2018,Informatique,3,Algorithme et Programmation,3,Les Langagues de Programmation,8,512,4,QCU,0.36,0.6,40.13,3,5,8,6,3,3,1.33,50.0,Facile,Moyen,-1,Plus Difficile,Pas Adapte
4955,2019,Informatique,3,Algorithme et Programmation,3,Les Langagues de Programmation,8,512,4,QCU,0.12,0.9,99.46,9,0,9,9,9,0,1.0,100.0,Difficile,Facile,2,Beaucoup plus Facile,Pas Adapte
6066,2020,Informatique,3,Algorithme et Programmation,3,Les Langagues de Programmation,8,512,4,QCU,0.09,0.91,90.3,9,1,10,10,9,1,1.0,90.0,Moyen,Facile,1,Plus Facile,Pas Adapte
512,2015,Informatique,3,Algorithme et Programmation,3,Les Langagues de Programmation,8,513,5,QCU,0.12,0.81,78.41,24,7,31,25,24,1,1.24,96.0,Difficile,Facile,2,Beaucoup plus Facile,Pas Adapte
1623,2016,Informatique,3,Algorithme et Programmation,3,Les Langagues de Programmation,8,513,5,QCU,0.18,0.78,68.72,24,11,35,34,24,10,1.03,70.59,Difficile,Facile,2,Beaucoup plus Facile,Adapte
2734,2017,Informatique,3,Algorithme et Programmation,3,Les Langagues de Programmation,8,513,5,QCU,0.0,1.0,68.72,21,9,30,25,21,4,1.2,84.0,Facile,Facile,0,Meme Difficulté,Adapte
3845,2018,Informatique,3,Algorithme et Programmation,3,Les Langagues de Programmation,8,513,5,QCU,0.18,0.77,68.72,23,10,33,23,23,0,1.43,100.0,Facile,Facile,0,Meme Difficulté,Adapte
4956,2019,Informatique,3,Algorithme et Programmation,3,Les Langagues de Programmation,8,513,5,QCU,0.08,0.87,68.72,23,11,34,29,23,6,1.17,79.31,Facile,Facile,0,Meme Difficulté,Adapte
6067,2020,Informatique,3,Algorithme et Programmation,3,Les Langagues de Programmation,8,513,5,QCU,0.11,0.87,68.72,24,11,35,27,24,3,1.3,88.89,Facile,Facile,0,Meme Difficulté,Adapte
513,2015,Informatique,3,Algorithme et Programmation,3,Les Langagues de Programmation,8,514,6,QCM,0.73,0.26,5.54,4,60,64,39,4,35,1.64,10.26,Difficile,Difficile,0,Meme Difficulté,Pas Adapte
1624,2016,Informatique,3,Algorithme et Programmation,3,Les Langagues de Programmation,8,514,6,QCM,0.3,0.58,37.54,26,43,69,59,26,33,1.17,44.07,Difficile,Moyen,1,Plus Facile,Pas Adapte
2735,2017,Informatique,3,Algorithme et Programmation,3,Les Langagues de Programmation,8,514,6,QCM,0.47,0.42,50.89,35,33,68,39,35,4,1.74,89.74,Facile,Moyen,-1,Plus Difficile,Pas Adapte
3846,2018,Informatique,3,Algorithme et Programmation,3,Les Langagues de Programmation,8,514,6,QCM,0.1,0.82,78.04,48,13,61,50,48,2,1.22,96.0,Difficile,Facile,2,Beaucoup plus Facile,Pas Adapte
4957,2019,Informatique,3,Algorithme et Programmation,3,Les Langagues de Programmation,8,514,6,QCM,0.62,0.17,3.09,2,61,63,60,2,58,1.05,3.33,Facile,Difficile,-2,Beaucoup plus Difficile,Pas Adapte
6068,2020,Informatique,3,Algorithme et Programmation,3,Les Langagues de Programmation,8,514,6,QCM,0.24,0.43,51.11,37,35,72,50,37,13,1.44,74.0,Moyen,Moyen,0,Meme Difficulté,Pas Adapte
514,2015,Informatique,3,Algorithme et Programmation,3,Les Langagues de Programmation,8,515,7,QCU,0.28,0.44,41.36,14,21,35,25,14,11,1.4,56.0,Facile,Moyen,-1,Plus Difficile,Pas Adapte
1625,2016,Informatique,3,Algorithme et Programmation,3,Les Langagues de Programmation,8,515,7,QCU,0.07,0.77,78.45,27,7,34,31,27,4,1.1,87.1,Moyen,Facile,1,Plus Facile,Pas Adapte
2736,2017,Informatique,3,Algorithme et Programmation,3,Les Langagues de Programmation,8,515,7,QCU,0.32,0.41,38.63,15,24,39,27,15,12,1.44,55.56,Difficile,Moyen,1,Plus Facile,Pas Adapte
3847,2018,Informatique,3,Algorithme et Programmation,3,Les Langagues de Programmation,8,515,7,QCU,0.28,0.46,44.12,17,22,39,23,17,6,1.7,73.91,Facile,Moyen,-1,Plus Difficile,Pas Adapte
4958,2019,Informatique,3,Algorithme et Programmation,3,Les Langagues de Programmation,8,515,7,QCU,0.73,0.37,16.92,7,33,40,36,7,29,1.11,19.44,Moyen,Difficile,-1,Plus Difficile,Pas Adapte
6069,2020,Informatique,3,Algorithme et Programmation,3,Les Langagues de Programmation,8,515,7,QCU,0.6,0.28,21.33,9,35,44,21,9,12,2.1,42.86,Moyen,Difficile,-1,Plus Difficile,Pas Adapte
515,2015,Informatique,3,Algorithme et Programmation,3,Les Langagues de Programmation,8,516,8,QCM,0.77,0.15,27.3,27,72,99,31,27,4,3.19,87.1,Difficile,Difficile,0,Meme Difficulté,Pas Adapte
1626,2016,Informatique,3,Algorithme et Programmation,3,Les Langagues de Programmation,8,516,8,QCM,0.15,0.97,73.36,69,25,94,70,69,1,1.34,98.57,Difficile,Facile,2,Beaucoup plus Facile,Adapte
2737,2017,Informatique,3,Algorithme et Programmation,3,Les Langagues de Programmation,8,516,8,QCU,0.05,0.98,73.36,77,28,105,95,77,18,1.11,81.05,Facile,Facile,0,Meme Difficulté,Adapte
3848,2018,Informatique,3,Algorithme et Programmation,3,Les Langagues de Programmation,8,516,8,QROC,0.09,0.53,73.36,89,32,121,94,89,5,1.29,94.68,Facile,Facile,0,Meme Difficulté,Adapte
4959,2019,Informatique,3,Algorithme et Programmation,3,Les Langagues de Programmation,8,516,8,QCU,0.15,0.87,73.36,83,30,113,88,83,5,1.28,94.32,Facile,Facile,0,Meme Difficulté,Adapte
6070,2020,Informatique,3,Algorithme et Programmation,3,Les Langagues de Programmation,8,516,8,QCU,0.16,0.91,73.36,90,33,123,101,90,11,1.22,89.11,Facile,Facile,0,Meme Difficulté,Adapte
516,2015,Informatique,4,Reseaux et Internet,1,Notion de Reseau Informatique,10,517,1,QO,0.18,0.84,88.88,42,5,47,46,42,4,1.02,91.3,Facile,Facile,0,Meme Difficulté,Pas Adapte
1627,2016,Informatique,4,Reseaux et Internet,1,Notion de Reseau Informatique,10,517,1,QROC,0.82,0.15,25.88,13,38,51,29,13,16,1.76,44.83,Moyen,Difficile,-1,Plus Difficile,Pas Adapte
2738,2017,Informatique,4,Reseaux et Internet,1,Notion de Reseau Informatique,10,517,1,QCM,0.47,0.46,42.2,23,32,55,45,23,22,1.22,51.11,Moyen,Moyen,0,Meme Difficulté,Pas Adapte
3849,2018,Informatique,4,Reseaux et Internet,1,Notion de Reseau Informatique,10,517,1,QCM,0.27,0.58,58.73,32,22,54,48,32,16,1.12,66.67,Facile,Moyen,-1,Plus Difficile,Pas Adapte
4960,2019,Informatique,4,Reseaux et Internet,1,Notion de Reseau Informatique,10,517,1,QCU,0.02,0.93,99.29,46,0,46,46,46,0,1.0,100.0,Facile,Facile,0,Meme Difficulté,Pas Adapte
6071,2020,Informatique,4,Reseaux et Internet,1,Notion de Reseau Informatique,10,517,1,QCU,0.14,0.98,75.47,34,11,45,35,34,1,1.29,97.14,Difficile,Facile,2,Beaucoup plus Facile,Pas Adapte
517,2015,Informatique,4,Reseaux et Internet,1,Notion de Reseau Informatique,10,518,2,QROC,0.58,0.33,41.67,23,31,54,43,23,20,1.26,53.49,Difficile,Moyen,1,Plus Facile,Pas Adapte
1628,2016,Informatique,4,Reseaux et Internet,1,Notion de Reseau Informatique,10,518,2,QROC,0.48,0.37,48.91,29,31,60,47,29,18,1.28,61.7,Facile,Moyen,-1,Plus Difficile,Pas Adapte
2739,2017,Informatique,4,Reseaux et Internet,1,Notion de Reseau Informatique,10,518,2,QO,0.13,0.68,66.64,39,20,59,56,39,17,1.05,69.64,Moyen,Facile,1,Plus Facile,Adapte
3850,2018,Informatique,4,Reseaux et Internet,1,Notion de Reseau Informatique,10,518,2,QCM,0.12,0.77,66.64,34,17,51,50,34,16,1.02,68.0,Facile,Facile,0,Meme Difficulté,Adapte
4961,2019,Informatique,4,Reseaux et Internet,1,Notion de Reseau Informatique,10,518,2,QCU,0.19,0.81,66.64,31,16,47,39,31,8,1.21,79.49,Facile,Facile,0,Meme Difficulté,Adapte
6072,2020,Informatique,4,Reseaux et Internet,1,Notion de Reseau Informatique,10,518,2,QCU,0.09,0.92,66.64,29,15,44,39,29,10,1.13,74.36,Facile,Facile,0,Meme Difficulté,Adapte
518,2015,Informatique,4,Reseaux et Internet,1,Notion de Reseau Informatique,10,519,3,QROC,0.55,0.35,35.83,9,17,26,17,9,8,1.53,52.94,Facile,Moyen,-1,Plus Difficile,Pas Adapte
1629,2016,Informatique,4,Reseaux et Internet,1,Notion de Reseau Informatique,10,519,3,QROC,0.39,0.36,52.44,13,12,25,15,13,2,1.67,86.67,Moyen,Moyen,0,Meme Difficulté,Pas Adapte
2740,2017,Informatique,4,Reseaux et Internet,1,Notion de Reseau Informatique,10,519,3,QROC,0.95,0.12,7.61,2,23,25,12,2,10,2.08,16.67,Moyen,Difficile,-1,Plus Difficile,Pas Adapte
3851,2018,Informatique,4,Reseaux et Internet,1,Notion de Reseau Informatique,10,519,3,QROC,0.1,0.92,81.23,22,5,27,26,22,4,1.04,84.62,Difficile,Facile,2,Beaucoup plus Facile,Pas Adapte
4962,2019,Informatique,4,Reseaux et Internet,1,Notion de Reseau Informatique,10,519,3,QROC,0.04,0.72,89.72,27,3,30,30,27,3,1.0,90.0,Facile,Facile,0,Meme Difficulté,Pas Adapte
6073,2020,Informatique,4,Reseaux et Internet,1,Notion de Reseau Informatique,10,519,3,QROC,0.77,0.11,26.73,9,24,33,26,9,17,1.27,34.62,Moyen,Difficile,-1,Plus Difficile,Pas Adapte
519,2015,Informatique,4,Reseaux et Internet,1,Notion de Reseau Informatique,10,520,4,QCU,0.73,0.35,16.91,17,81,98,40,17,23,2.45,42.5,Difficile,Difficile,0,Meme Difficulté,Pas Adapte
1630,2016,Informatique,4,Reseaux et Internet,1,Notion de Reseau Informatique,10,520,4,QCU,0.36,0.41,41.54,42,60,102,82,42,40,1.24,51.22,Facile,Moyen,-1,Plus Difficile,Pas Adapte
2741,2017,Informatique,4,Reseaux et Internet,1,Notion de Reseau Informatique,10,520,4,QCU,0.56,0.39,30.38,35,79,114,39,35,4,2.92,89.74,Difficile,Difficile,0,Meme Difficulté,Pas Adapte
3852,2018,Informatique,4,Reseaux et Internet,1,Notion de Reseau Informatique,10,520,4,QCU,0.61,0.27,26.9,31,86,117,71,31,40,1.65,43.66,Moyen,Difficile,-1,Plus Difficile,Pas Adapte
4963,2019,Informatique,4,Reseaux et Internet,1,Notion de Reseau Informatique,10,520,4,QROC,0.47,0.32,40.25,49,72,121,92,49,43,1.32,53.26,Facile,Moyen,-1,Plus Difficile,Pas Adapte
6074,2020,Informatique,4,Reseaux et Internet,1,Notion de Reseau Informatique,10,520,4,QROC,0.72,0.02,30.57,35,80,115,89,35,54,1.29,39.33,Moyen,Difficile,-1,Plus Difficile,Pas Adapte
520,2015,Informatique,4,Reseaux et Internet,1,Notion de Reseau Informatique,10,521,5,QCU,0.55,0.21,12.33,7,53,60,55,7,48,1.09,12.73,Moyen,Difficile,-1,Plus Difficile,Pas Adapte
1631,2016,Informatique,4,Reseaux et Internet,1,Notion de Reseau Informatique,10,521,5,QCU,0.09,0.99,72.0,50,19,69,60,50,10,1.15,83.33,Moyen,Facile,1,Plus Facile,Adapte
2742,2017,Informatique,4,Reseaux et Internet,1,Notion de Reseau Informatique,10,521,5,QCU,0.11,0.83,72.0,53,21,74,60,53,7,1.23,88.33,Facile,Facile,0,Meme Difficulté,Adapte
3853,2018,Informatique,4,Reseaux et Internet,1,Notion de Reseau Informatique,10,521,5,QCU,0.01,0.94,72.0,55,22,77,63,55,8,1.22,87.3,Facile,Facile,0,Meme Difficulté,Adapte
4964,2019,Informatique,4,Reseaux et Internet,1,Notion de Reseau Informatique,10,521,5,QCM,0.13,0.7,72.0,63,25,88,72,63,9,1.22,87.5,Facile,Facile,0,Meme Difficulté,Adapte
6075,2020,Informatique,4,Reseaux et Internet,1,Notion de Reseau Informatique,10,521,5,QCM,0.0,0.83,72.0,68,27,95,72,68,4,1.32,94.44,Facile,Facile,0,Meme Difficulté,Adapte
521,2015,Informatique,4,Reseaux et Internet,1,Notion de Reseau Informatique,10,522,6,QCU,0.58,0.36,23.37,11,35,46,45,11,34,1.02,24.44,Moyen,Difficile,-1,Plus Difficile,Pas Adapte
1632,2016,Informatique,4,Reseaux et Internet,1,Notion de Reseau Informatique,10,522,6,QCU,0.28,0.44,44.25,20,26,46,41,20,21,1.12,48.78,Moyen,Moyen,0,Meme Difficulté,Pas Adapte
2743,2017,Informatique,4,Reseaux et Internet,1,Notion de Reseau Informatique,10,522,6,QCU,0.4,0.72,49.48,22,23,45,36,22,14,1.25,61.11,Moyen,Moyen,0,Meme Difficulté,Pas Adapte
3854,2018,Informatique,4,Reseaux et Internet,1,Notion de Reseau Informatique,10,522,6,QCU,0.2,0.41,54.54,27,22,49,42,27,15,1.17,64.29,Facile,Moyen,-1,Plus Difficile,Pas Adapte
4965,2019,Informatique,4,Reseaux et Internet,1,Notion de Reseau Informatique,10,522,6,QCU,0.26,0.58,64.43,31,17,48,34,31,3,1.41,91.18,Difficile,Moyen,1,Plus Facile,Pas Adapte
6076,2020,Informatique,4,Reseaux et Internet,1,Notion de Reseau Informatique,10,522,6,QCU,0.36,0.49,63.31,29,17,46,44,29,15,1.05,65.91,Facile,Moyen,-1,Plus Difficile,Pas Adapte
522,2015,Informatique,4,Reseaux et Internet,1,Notion de Reseau Informatique,10,523,7,QROC,0.16,0.77,72.07,24,9,33,30,24,6,1.1,80.0,Moyen,Facile,1,Plus Facile,Adapte
1633,2016,Informatique,4,Reseaux et Internet,1,Notion de Reseau Informatique,10,523,7,QROC,0.05,0.48,72.07,23,9,32,28,23,5,1.14,82.14,Facile,Facile,0,Meme Difficulté,Adapte
2744,2017,Informatique,4,Reseaux et Internet,1,Notion de Reseau Informatique,10,523,7,QROC,0.17,0.59,72.07,27,10,37,37,27,10,1.0,72.97,Facile,Facile,0,Meme Difficulté,Adapte
3855,2018,Informatique,4,Reseaux et Internet,1,Notion de Reseau Informatique,10,523,7,QROC,0.08,0.74,72.07,25,9,34,29,25,4,1.17,86.21,Facile,Facile,0,Meme Difficulté,Adapte
4966,2019,Informatique,4,Reseaux et Internet,1,Notion de Reseau Informatique,10,523,7,QROC,0.04,0.82,72.07,23,9,32,23,23,0,1.39,100.0,Facile,Facile,0,Meme Difficulté,Adapte
6077,2020,Informatique,4,Reseaux et Internet,1,Notion de Reseau Informatique,10,523,7,QROC,0.17,0.65,72.07,20,8,28,22,20,2,1.27,90.91,Facile,Facile,0,Meme Difficulté,Adapte
523,2015,Informatique,4,Reseaux et Internet,1,Notion de Reseau Informatique,10,524,8,QCU,0.33,0.57,42.79,23,30,53,42,23,19,1.26,54.76,Difficile,Moyen,1,Plus Facile,Pas Adapte
1634,2016,Informatique,4,Reseaux et Internet,1,Notion de Reseau Informatique,10,524,8,QCU,0.28,0.5,46.3,28,32,60,39,28,11,1.54,71.79,Moyen,Moyen,0,Meme Difficulté,Pas Adapte
2745,2017,Informatique,4,Reseaux et Internet,1,Notion de Reseau Informatique,10,524,8,QCU,0.09,0.98,76.29,40,12,52,41,40,1,1.27,97.56,Difficile,Facile,2,Beaucoup plus Facile,Pas Adapte
3856,2018,Informatique,4,Reseaux et Internet,1,Notion de Reseau Informatique,10,524,8,QCU,0.59,0.37,32.21,19,39,58,32,19,13,1.81,59.38,Difficile,Difficile,0,Meme Difficulté,Pas Adapte
4967,2019,Informatique,4,Reseaux et Internet,1,Notion de Reseau Informatique,10,524,8,QCU,0.25,0.47,43.72,25,32,57,56,25,31,1.02,44.64,Moyen,Moyen,0,Meme Difficulté,Pas Adapte
6078,2020,Informatique,4,Reseaux et Internet,1,Notion de Reseau Informatique,10,524,8,QCU,0.06,0.92,88.23,52,7,59,58,52,6,1.02,89.66,Facile,Facile,0,Meme Difficulté,Pas Adapte
524,2015,Informatique,4,Reseaux et Internet,1,Notion de Reseau Informatique,10,525,9,QROC,0.97,0.17,26.94,25,66,91,69,25,44,1.32,36.23,Facile,Difficile,-2,Beaucoup plus Difficile,Pas Adapte
1635,2016,Informatique,4,Reseaux et Internet,1,Notion de Reseau Informatique,10,525,9,QO,0.33,0.23,57.51,51,37,88,87,51,36,1.01,58.62,Difficile,Moyen,1,Plus Facile,Pas Adapte
2746,2017,Informatique,4,Reseaux et Internet,1,Notion de Reseau Informatique,10,525,9,QO,0.07,0.84,76.74,68,20,88,71,68,3,1.24,95.77,Difficile,Facile,2,Beaucoup plus Facile,Pas Adapte
3857,2018,Informatique,4,Reseaux et Internet,1,Notion de Reseau Informatique,10,525,9,QROC,0.29,0.29,62.75,49,29,78,53,49,4,1.47,92.45,Moyen,Moyen,0,Meme Difficulté,Pas Adapte
4968,2019,Informatique,4,Reseaux et Internet,1,Notion de Reseau Informatique,10,525,9,QROC,0.03,0.79,84.14,56,10,66,62,56,6,1.06,90.32,Facile,Facile,0,Meme Difficulté,Pas Adapte
6079,2020,Informatique,4,Reseaux et Internet,1,Notion de Reseau Informatique,10,525,9,QROC,0.74,0.09,22.37,14,47,61,32,14,18,1.91,43.75,Difficile,Difficile,0,Meme Difficulté,Pas Adapte
525,2015,Informatique,4,Reseaux et Internet,1,Notion de Reseau Informatique,10,526,10,QCU,0.26,0.47,39.75,33,50,83,63,33,30,1.32,52.38,Facile,Moyen,-1,Plus Difficile,Pas Adapte
1636,2016,Informatique,4,Reseaux et Internet,1,Notion de Reseau Informatique,10,526,10,QCU,0.52,0.32,15.68,14,78,92,43,14,29,2.14,32.56,Difficile,Difficile,0,Meme Difficulté,Pas Adapte
2747,2017,Informatique,4,Reseaux et Internet,1,Notion de Reseau Informatique,10,526,10,QCU,0.66,0.28,5.51,5,82,87,40,5,35,2.17,12.5,Moyen,Difficile,-1,Plus Difficile,Pas Adapte
3858,2018,Informatique,4,Reseaux et Internet,1,Notion de Reseau Informatique,10,526,10,QCU,0.22,0.4,62.81,58,34,92,76,58,18,1.21,76.32,Difficile,Moyen,1,Plus Facile,Pas Adapte
4969,2019,Informatique,4,Reseaux et Internet,1,Notion de Reseau Informatique,10,526,10,QCU,0.49,0.37,28.21,27,67,94,58,27,31,1.62,46.55,Moyen,Difficile,-1,Plus Difficile,Pas Adapte
6080,2020,Informatique,4,Reseaux et Internet,1,Notion de Reseau Informatique,10,526,10,QCU,0.05,0.94,91.82,88,8,96,91,88,3,1.05,96.7,Difficile,Facile,2,Beaucoup plus Facile,Pas Adapte
526,2015,Mathematique,1,L'Algebre Lineaire,1,Sommes de Sous Espaces,12,527,1,QCU,0.22,0.74,48.0,29,32,61,50,29,21,1.22,58.0,Difficile,Moyen,1,Plus Facile,Pas Adapte
1637,2016,Mathematique,1,L'Algebre Lineaire,1,Sommes de Sous Espaces,12,527,1,QCU,0.58,0.21,5.0,3,60,63,29,3,26,2.17,10.34,Facile,Difficile,-2,Beaucoup plus Difficile,Pas Adapte
2748,2017,Mathematique,1,L'Algebre Lineaire,1,Sommes de Sous Espaces,12,527,1,QCU,0.32,0.52,56.0,35,27,62,39,35,4,1.59,89.74,Facile,Moyen,-1,Plus Difficile,Pas Adapte
3859,2018,Mathematique,1,L'Algebre Lineaire,1,Sommes de Sous Espaces,12,527,1,QCU,0.11,0.78,68.0,47,22,69,66,47,19,1.05,71.21,Facile,Facile,0,Meme Difficulté,Adapte
4970,2019,Mathematique,1,L'Algebre Lineaire,1,Sommes de Sous Espaces,12,527,1,QCU,0.14,0.87,68.0,52,25,77,76,52,24,1.01,68.42,Facile,Facile,0,Meme Difficulté,Adapte
6081,2020,Mathematique,1,L'Algebre Lineaire,1,Sommes de Sous Espaces,12,527,1,QCU,0.08,0.84,68.0,48,22,70,53,48,5,1.32,90.57,Facile,Facile,0,Meme Difficulté,Adapte
527,2015,Mathematique,1,L'Algebre Lineaire,1,Sommes de Sous Espaces,12,528,2,QROC,0.57,0.34,38.0,6,10,16,9,6,3,1.78,66.67,Difficile,Moyen,1,Plus Facile,Pas Adapte
1638,2016,Mathematique,1,L'Algebre Lineaire,1,Sommes de Sous Espaces,12,528,2,QROC,0.43,0.35,63.0,10,6,16,13,10,3,1.23,76.92,Facile,Moyen,-1,Plus Difficile,Pas Adapte
2749,2017,Mathematique,1,L'Algebre Lineaire,1,Sommes de Sous Espaces,12,528,2,QROC,0.97,0.21,3.0,1,16,17,8,1,7,2.12,12.5,Facile,Difficile,-2,Beaucoup plus Difficile,Pas Adapte
3860,2018,Mathematique,1,L'Algebre Lineaire,1,Sommes de Sous Espaces,12,528,2,QROC,0.99,0.06,22.0,4,16,20,12,4,8,1.67,33.33,Difficile,Difficile,0,Meme Difficulté,Pas Adapte
4971,2019,Mathematique,1,L'Algebre Lineaire,1,Sommes de Sous Espaces,12,528,2,QROC,0.23,0.39,59.0,11,8,19,11,11,0,1.73,100.0,Difficile,Moyen,1,Plus Facile,Pas Adapte
6082,2020,Mathematique,1,L'Algebre Lineaire,1,Sommes de Sous Espaces,12,528,2,QROC,0.6,0.19,17.0,3,17,20,12,3,9,1.67,25.0,Facile,Difficile,-2,Beaucoup plus Difficile,Pas Adapte
528,2015,Mathematique,1,L'Algebre Lineaire,1,Sommes de Sous Espaces,12,529,3,QCU,0.64,0.3,31.0,22,50,72,47,22,25,1.53,46.81,Facile,Difficile,-2,Beaucoup plus Difficile,Pas Adapte
1639,2016,Mathematique,1,L'Algebre Lineaire,1,Sommes de Sous Espaces,12,529,3,QCU,0.74,0.37,32.0,23,48,71,48,23,25,1.48,47.92,Facile,Difficile,-2,Beaucoup plus Difficile,Pas Adapte
2750,2017,Mathematique,1,L'Algebre Lineaire,1,Sommes de Sous Espaces,12,529,3,QCU,0.53,0.38,21.0,14,54,68,39,14,25,1.74,35.9,Facile,Difficile,-2,Beaucoup plus Difficile,Pas Adapte
3861,2018,Mathematique,1,L'Algebre Lineaire,1,Sommes de Sous Espaces,12,529,3,QCU,0.48,0.3,33.0,24,49,73,33,24,9,2.21,72.73,Moyen,Difficile,-1,Plus Difficile,Pas Adapte
4972,2019,Mathematique,1,L'Algebre Lineaire,1,Sommes de Sous Espaces,12,529,3,QO,0.98,0.07,11.0,8,67,75,74,8,66,1.01,10.81,Facile,Difficile,-2,Beaucoup plus Difficile,Pas Adapte
6083,2020,Mathematique,1,L'Algebre Lineaire,1,Sommes de Sous Espaces,12,529,3,QO,0.77,0.08,1.0,1,82,83,51,1,50,1.63,1.96,Difficile,Difficile,0,Meme Difficulté,Pas Adapte
529,2015,Mathematique,1,L'Algebre Lineaire,1,Sommes de Sous Espaces,12,530,4,QCU,0.71,0.23,16.0,15,80,95,83,15,68,1.14,18.07,Difficile,Difficile,0,Meme Difficulté,Pas Adapte
1640,2016,Mathematique,1,L'Algebre Lineaire,1,Sommes de Sous Espaces,12,530,4,QCU,0.39,0.51,43.0,45,59,104,92,45,47,1.13,48.91,Difficile,Moyen,1,Plus Facile,Pas Adapte
2751,2017,Mathematique,1,L'Algebre Lineaire,1,Sommes de Sous Espaces,12,530,4,QCU,0.2,0.72,37.0,37,63,100,43,37,6,2.33,86.05,Facile,Moyen,-1,Plus Difficile,Pas Adapte
3862,2018,Mathematique,1,L'Algebre Lineaire,1,Sommes de Sous Espaces,12,530,4,QCU,0.66,0.34,3.0,3,103,106,88,3,85,1.2,3.41,Facile,Difficile,-2,Beaucoup plus Difficile,Pas Adapte
4973,2019,Mathematique,1,L'Algebre Lineaire,1,Sommes de Sous Espaces,12,530,4,QCU,0.22,0.58,40.0,36,54,90,48,36,12,1.88,75.0,Difficile,Moyen,1,Plus Facile,Pas Adapte
6084,2020,Mathematique,1,L'Algebre Lineaire,1,Sommes de Sous Espaces,12,530,4,QCU,0.57,0.26,26.0,26,74,100,99,26,73,1.01,26.26,Moyen,Difficile,-1,Plus Difficile,Pas Adapte
530,2015,Mathematique,1,L'Algebre Lineaire,1,Sommes de Sous Espaces,12,531,5,QCU,0.57,0.21,34.0,25,48,73,37,25,12,1.97,67.57,Facile,Difficile,-2,Beaucoup plus Difficile,Pas Adapte
1641,2016,Mathematique,1,L'Algebre Lineaire,1,Sommes de Sous Espaces,12,531,5,QCU,0.39,0.44,57.0,39,30,69,45,39,6,1.53,86.67,Difficile,Moyen,1,Plus Facile,Pas Adapte
2752,2017,Mathematique,1,L'Algebre Lineaire,1,Sommes de Sous Espaces,12,531,5,QCU,0.56,0.23,1.0,1,75,76,27,1,26,2.81,3.7,Moyen,Difficile,-1,Plus Difficile,Pas Adapte
3863,2018,Mathematique,1,L'Algebre Lineaire,1,Sommes de Sous Espaces,12,531,5,QCU,0.31,0.52,60.0,39,26,65,54,39,15,1.2,72.22,Facile,Moyen,-1,Plus Difficile,Pas Adapte
4974,2019,Mathematique,1,L'Algebre Lineaire,1,Sommes de Sous Espaces,12,531,5,QCU,0.35,0.63,53.0,39,34,73,62,39,23,1.18,62.9,Moyen,Moyen,0,Meme Difficulté,Pas Adapte
6085,2020,Mathematique,1,L'Algebre Lineaire,1,Sommes de Sous Espaces,12,531,5,QCU,0.32,0.69,59.0,45,32,77,66,45,21,1.17,68.18,Moyen,Moyen,0,Meme Difficulté,Pas Adapte
531,2015,Mathematique,1,L'Algebre Lineaire,1,Sommes de Sous Espaces,12,532,6,QCU,0.51,0.37,2.0,2,82,84,29,2,27,2.9,6.9,Difficile,Difficile,0,Meme Difficulté,Pas Adapte
1642,2016,Mathematique,1,L'Algebre Lineaire,1,Sommes de Sous Espaces,12,532,6,QCU,0.25,0.47,58.0,55,39,94,73,55,18,1.29,75.34,Facile,Moyen,-1,Plus Difficile,Pas Adapte
2753,2017,Mathematique,1,L'Algebre Lineaire,1,Sommes de Sous Espaces,12,532,6,QROC,0.02,0.87,67.0,68,34,102,89,68,21,1.15,76.4,Difficile,Facile,2,Beaucoup plus Facile,Adapte
3864,2018,Mathematique,1,L'Algebre Lineaire,1,Sommes de Sous Espaces,12,532,6,QROC,0.04,1.0,67.0,65,32,97,83,65,18,1.17,78.31,Facile,Facile,0,Meme Difficulté,Adapte
4975,2019,Mathematique,1,L'Algebre Lineaire,1,Sommes de Sous Espaces,12,532,6,QROC,0.16,0.87,67.0,71,35,106,76,71,5,1.39,93.42,Facile,Facile,0,Meme Difficulté,Adapte
6086,2020,Mathematique,1,L'Algebre Lineaire,1,Sommes de Sous Espaces,12,532,6,QROC,0.19,0.73,67.0,60,30,90,77,60,17,1.17,77.92,Facile,Facile,0,Meme Difficulté,Adapte
532,2015,Mathematique,1,L'Algebre Lineaire,1,Sommes de Sous Espaces,12,533,7,QROC,0.58,0.28,40.0,19,29,48,34,19,15,1.41,55.88,Difficile,Moyen,1,Plus Facile,Pas Adapte
1643,2016,Mathematique,1,L'Algebre Lineaire,1,Sommes de Sous Espaces,12,533,7,QCM,0.39,0.45,51.0,21,20,41,30,21,9,1.37,70.0,Facile,Moyen,-1,Plus Difficile,Pas Adapte
2754,2017,Mathematique,1,L'Algebre Lineaire,1,Sommes de Sous Espaces,12,533,7,QCM,0.74,0.27,30.0,12,27,39,31,12,19,1.26,38.71,Moyen,Difficile,-1,Plus Difficile,Pas Adapte
3865,2018,Mathematique,1,L'Algebre Lineaire,1,Sommes de Sous Espaces,12,533,7,QCM,0.75,0.28,24.0,10,32,42,18,10,8,2.33,55.56,Moyen,Difficile,-1,Plus Difficile,Pas Adapte
4976,2019,Mathematique,1,L'Algebre Lineaire,1,Sommes de Sous Espaces,12,533,7,QCU,0.74,0.39,21.0,9,34,43,22,9,13,1.95,40.91,Difficile,Difficile,0,Meme Difficulté,Pas Adapte
6087,2020,Mathematique,1,L'Algebre Lineaire,1,Sommes de Sous Espaces,12,533,7,QCU,0.43,0.24,26.0,10,30,40,19,10,9,2.11,52.63,Difficile,Difficile,0,Meme Difficulté,Pas Adapte
533,2015,Mathematique,1,L'Algebre Lineaire,1,Sommes de Sous Espaces,12,534,8,QCU,0.67,0.37,21.0,6,23,29,18,6,12,1.61,33.33,Facile,Difficile,-2,Beaucoup plus Difficile,Pas Adapte
1644,2016,Mathematique,1,L'Algebre Lineaire,1,Sommes de Sous Espaces,12,534,8,QCU,0.26,0.58,56.0,15,12,27,20,15,5,1.35,75.0,Moyen,Moyen,0,Meme Difficulté,Pas Adapte
2755,2017,Mathematique,1,L'Algebre Lineaire,1,Sommes de Sous Espaces,12,534,8,QCU,0.09,0.94,67.0,19,10,29,21,19,2,1.38,90.48,Facile,Facile,0,Meme Difficulté,Adapte
3866,2018,Mathematique,1,L'Algebre Lineaire,1,Sommes de Sous Espaces,12,534,8,QCU,0.06,0.79,67.0,21,10,31,25,21,4,1.24,84.0,Facile,Facile,0,Meme Difficulté,Adapte
4977,2019,Mathematique,1,L'Algebre Lineaire,1,Sommes de Sous Espaces,12,534,8,QCU,0.01,0.84,67.0,22,11,33,32,22,10,1.03,68.75,Facile,Facile,0,Meme Difficulté,Adapte
6088,2020,Mathematique,1,L'Algebre Lineaire,1,Sommes de Sous Espaces,12,534,8,QCU,0.06,0.94,67.0,25,12,37,35,25,10,1.06,71.43,Facile,Facile,0,Meme Difficulté,Adapte
534,2015,Mathematique,1,L'Algebre Lineaire,1,Sommes de Sous Espaces,12,535,9,QCM,0.57,0.2,8.0,5,62,67,47,5,42,1.43,10.64,Moyen,Difficile,-1,Plus Difficile,Pas Adapte
1645,2016,Mathematique,1,L'Algebre Lineaire,1,Sommes de Sous Espaces,12,535,9,QCM,0.24,0.51,52.0,40,36,76,73,40,33,1.04,54.79,Difficile,Moyen,1,Plus Facile,Pas Adapte
2756,2017,Mathematique,1,L'Algebre Lineaire,1,Sommes de Sous Espaces,12,535,9,QCM,0.52,0.17,9.0,7,76,83,68,7,61,1.22,10.29,Facile,Difficile,-2,Beaucoup plus Difficile,Pas Adapte
3867,2018,Mathematique,1,L'Algebre Lineaire,1,Sommes de Sous Espaces,12,535,9,QCM,0.54,0.2,2.0,2,82,84,54,2,52,1.56,3.7,Moyen,Difficile,-1,Plus Difficile,Pas Adapte
4978,2019,Mathematique,1,L'Algebre Lineaire,1,Sommes de Sous Espaces,12,535,9,QCU,0.28,0.46,58.0,55,40,95,87,55,32,1.09,63.22,Facile,Moyen,-1,Plus Difficile,Pas Adapte
6089,2020,Mathematique,1,L'Algebre Lineaire,1,Sommes de Sous Espaces,12,535,9,QCU,0.44,0.28,34.0,34,67,101,67,34,33,1.51,50.75,Difficile,Difficile,0,Meme Difficulté,Pas Adapte
535,2015,Mathematique,1,L'Algebre Lineaire,1,Sommes de Sous Espaces,12,536,10,QCU,0.31,0.67,58.0,34,25,59,35,34,1,1.69,97.14,Facile,Moyen,-1,Plus Difficile,Pas Adapte
1646,2016,Mathematique,1,L'Algebre Lineaire,1,Sommes de Sous Espaces,12,536,10,QCM,0.44,0.31,64.0,37,21,58,56,37,19,1.04,66.07,Difficile,Moyen,1,Plus Facile,Pas Adapte
2757,2017,Mathematique,1,L'Algebre Lineaire,1,Sommes de Sous Espaces,12,536,10,QCM,0.52,0.23,18.0,10,47,57,40,10,30,1.43,25.0,Moyen,Difficile,-1,Plus Difficile,Pas Adapte
3868,2018,Mathematique,1,L'Algebre Lineaire,1,Sommes de Sous Espaces,12,536,10,QCM,0.52,0.19,32.0,16,34,50,25,16,9,2.0,64.0,Facile,Difficile,-2,Beaucoup plus Difficile,Pas Adapte
4979,2019,Mathematique,1,L'Algebre Lineaire,1,Sommes de Sous Espaces,12,536,10,QCM,0.56,0.17,25.0,14,41,55,45,14,31,1.22,31.11,Facile,Difficile,-2,Beaucoup plus Difficile,Pas Adapte
6090,2020,Mathematique,1,L'Algebre Lineaire,1,Sommes de Sous Espaces,12,536,10,QCM,0.42,0.61,54.0,29,25,54,39,29,10,1.38,74.36,Facile,Moyen,-1,Plus Difficile,Pas Adapte
536,2015,Mathematique,1,L'Algebre Lineaire,1,Sommes de Sous Espaces,12,537,11,QCM,0.51,0.16,30.0,23,54,77,55,23,32,1.4,41.82,Difficile,Difficile,0,Meme Difficulté,Pas Adapte
1647,2016,Mathematique,1,L'Algebre Lineaire,1,Sommes de Sous Espaces,12,537,11,QCM,0.26,0.4,58.0,41,30,71,61,41,20,1.16,67.21,Difficile,Moyen,1,Plus Facile,Pas Adapte
2758,2017,Mathematique,1,L'Algebre Lineaire,1,Sommes de Sous Espaces,12,537,11,QCM,0.56,0.27,2.0,1,61,62,21,1,20,2.95,4.76,Difficile,Difficile,0,Meme Difficulté,Pas Adapte
3869,2018,Mathematique,1,L'Algebre Lineaire,1,Sommes de Sous Espaces,12,537,11,QCM,0.3,0.39,51.0,27,26,53,37,27,10,1.43,72.97,Moyen,Moyen,0,Meme Difficulté,Pas Adapte
4980,2019,Mathematique,1,L'Algebre Lineaire,1,Sommes de Sous Espaces,12,537,11,QCU,0.13,0.84,68.0,31,15,46,43,31,12,1.07,72.09,Moyen,Facile,1,Plus Facile,Adapte
6091,2020,Mathematique,1,L'Algebre Lineaire,1,Sommes de Sous Espaces,12,537,11,QCM,0.17,0.71,68.0,29,14,43,39,29,10,1.1,74.36,Facile,Facile,0,Meme Difficulté,Adapte
537,2015,Mathematique,1,L'Algebre Lineaire,1,Sommes de Sous Espaces,12,538,12,QCU,0.65,0.39,31.0,12,28,40,22,12,10,1.82,54.55,Moyen,Difficile,-1,Plus Difficile,Pas Adapte
1648,2016,Mathematique,1,L'Algebre Lineaire,1,Sommes de Sous Espaces,12,538,12,QCU,0.42,0.35,3.0,1,39,40,23,1,22,1.74,4.35,Facile,Difficile,-2,Beaucoup plus Difficile,Pas Adapte
2759,2017,Mathematique,1,L'Algebre Lineaire,1,Sommes de Sous Espaces,12,538,12,QCU,0.29,0.65,63.0,24,14,38,31,24,7,1.23,77.42,Facile,Moyen,-1,Plus Difficile,Pas Adapte
3870,2018,Mathematique,1,L'Algebre Lineaire,1,Sommes de Sous Espaces,12,538,12,QCU,0.3,0.74,64.0,26,14,40,39,26,13,1.03,66.67,Difficile,Moyen,1,Plus Facile,Pas Adapte
4981,2019,Mathematique,1,L'Algebre Lineaire,1,Sommes de Sous Espaces,12,538,12,QCU,0.06,0.98,67.0,31,15,46,36,31,5,1.28,86.11,Difficile,Facile,2,Beaucoup plus Facile,Adapte
6092,2020,Mathematique,1,L'Algebre Lineaire,1,Sommes de Sous Espaces,12,538,12,QCU,0.2,0.82,67.0,29,15,44,33,29,4,1.33,87.88,Facile,Facile,0,Meme Difficulté,Adapte
538,2015,Mathematique,1,L'Algebre Lineaire,2,Sous Espaces Supplementaires,8,539,1,QCU,0.62,0.37,32.0,12,24,36,17,12,5,2.12,70.59,Difficile,Difficile,0,Meme Difficulté,Pas Adapte
1649,2016,Mathematique,1,L'Algebre Lineaire,2,Sous Espaces Supplementaires,8,539,1,QCU,0.29,0.41,55.0,19,16,35,20,19,1,1.75,95.0,Difficile,Moyen,1,Plus Facile,Pas Adapte
2760,2017,Mathematique,1,L'Algebre Lineaire,2,Sous Espaces Supplementaires,8,539,1,QCM,0.29,0.42,43.0,15,19,34,23,15,8,1.48,65.22,Difficile,Moyen,1,Plus Facile,Pas Adapte
3871,2018,Mathematique,1,L'Algebre Lineaire,2,Sous Espaces Supplementaires,8,539,1,QCM,0.24,0.33,47.0,18,20,38,32,18,14,1.19,56.25,Difficile,Moyen,1,Plus Facile,Pas Adapte
4982,2019,Mathematique,1,L'Algebre Lineaire,2,Sous Espaces Supplementaires,8,539,1,QCM,0.8,0.24,30.0,13,29,42,28,13,15,1.5,46.43,Facile,Difficile,-2,Beaucoup plus Difficile,Pas Adapte
6093,2020,Mathematique,1,L'Algebre Lineaire,2,Sous Espaces Supplementaires,8,539,1,QCM,0.26,0.37,61.0,22,14,36,22,22,0,1.64,100.0,Moyen,Moyen,0,Meme Difficulté,Pas Adapte
539,2015,Mathematique,1,L'Algebre Lineaire,2,Sous Espaces Supplementaires,8,540,2,QCU,0.23,0.48,62.0,50,30,80,67,50,17,1.19,74.63,Difficile,Moyen,1,Plus Facile,Pas Adapte
1650,2016,Mathematique,1,L'Algebre Lineaire,2,Sous Espaces Supplementaires,8,540,2,QCU,0.4,0.25,29.0,21,52,73,67,21,46,1.09,31.34,Facile,Difficile,-2,Beaucoup plus Difficile,Pas Adapte
2761,2017,Mathematique,1,L'Algebre Lineaire,2,Sous Espaces Supplementaires,8,540,2,QCU,0.24,0.42,60.0,43,29,72,59,43,16,1.22,72.88,Difficile,Moyen,1,Plus Facile,Pas Adapte
3872,2018,Mathematique,1,L'Algebre Lineaire,2,Sous Espaces Supplementaires,8,540,2,QCM,0.09,0.72,67.0,44,22,66,46,44,2,1.43,95.65,Facile,Facile,0,Meme Difficulté,Adapte
4983,2019,Mathematique,1,L'Algebre Lineaire,2,Sous Espaces Supplementaires,8,540,2,QCM,0.2,1.0,67.0,45,22,67,57,45,12,1.18,78.95,Facile,Facile,0,Meme Difficulté,Adapte
6094,2020,Mathematique,1,L'Algebre Lineaire,2,Sous Espaces Supplementaires,8,540,2,QCM,0.06,0.83,67.0,46,22,68,64,46,18,1.06,71.88,Facile,Facile,0,Meme Difficulté,Adapte
540,2015,Mathematique,1,L'Algebre Lineaire,2,Sous Espaces Supplementaires,8,541,3,QCU,0.65,0.2,17.0,10,47,57,46,10,36,1.24,21.74,Moyen,Difficile,-1,Plus Difficile,Pas Adapte
1651,2016,Mathematique,1,L'Algebre Lineaire,2,Sous Espaces Supplementaires,8,541,3,QCU,0.4,0.74,46.0,28,33,61,58,28,30,1.05,48.28,Difficile,Moyen,1,Plus Facile,Pas Adapte
2762,2017,Mathematique,1,L'Algebre Lineaire,2,Sous Espaces Supplementaires,8,541,3,QCU,0.67,0.25,24.0,16,51,67,43,16,27,1.56,37.21,Difficile,Difficile,0,Meme Difficulté,Pas Adapte
3873,2018,Mathematique,1,L'Algebre Lineaire,2,Sous Espaces Supplementaires,8,541,3,QCM,0.27,0.63,51.0,35,33,68,55,35,20,1.24,63.64,Difficile,Moyen,1,Plus Facile,Pas Adapte
4984,2019,Mathematique,1,L'Algebre Lineaire,2,Sous Espaces Supplementaires,8,541,3,QCM,0.69,0.17,16.0,11,58,69,21,11,10,3.29,52.38,Difficile,Difficile,0,Meme Difficulté,Pas Adapte
6095,2020,Mathematique,1,L'Algebre Lineaire,2,Sous Espaces Supplementaires,8,541,3,QCM,0.47,0.53,53.0,40,35,75,68,40,28,1.1,58.82,Facile,Moyen,-1,Plus Difficile,Pas Adapte
541,2015,Mathematique,1,L'Algebre Lineaire,2,Sous Espaces Supplementaires,8,542,4,QCU,0.58,0.37,24.0,4,13,17,6,4,2,2.83,66.67,Facile,Difficile,-2,Beaucoup plus Difficile,Pas Adapte
1652,2016,Mathematique,1,L'Algebre Lineaire,2,Sous Espaces Supplementaires,8,542,4,QCU,0.31,0.63,64.0,9,5,14,13,9,4,1.08,69.23,Facile,Moyen,-1,Plus Difficile,Pas Adapte
2763,2017,Mathematique,1,L'Algebre Lineaire,2,Sous Espaces Supplementaires,8,542,4,QCU,0.45,0.33,13.0,2,10,12,6,2,4,2.0,33.33,Facile,Difficile,-2,Beaucoup plus Difficile,Pas Adapte
3874,2018,Mathematique,1,L'Algebre Lineaire,2,Sous Espaces Supplementaires,8,542,4,QCM,0.52,0.29,13.0,2,12,14,8,2,6,1.75,25.0,Facile,Difficile,-2,Beaucoup plus Difficile,Pas Adapte
4985,2019,Mathematique,1,L'Algebre Lineaire,2,Sous Espaces Supplementaires,8,542,4,QCM,0.34,0.67,36.0,6,10,16,8,6,2,2.0,75.0,Facile,Moyen,-1,Plus Difficile,Pas Adapte
6096,2020,Mathematique,1,L'Algebre Lineaire,2,Sous Espaces Supplementaires,8,542,4,QCM,0.55,0.23,10.0,2,14,16,15,2,13,1.07,13.33,Difficile,Difficile,0,Meme Difficulté,Pas Adapte
542,2015,Mathematique,1,L'Algebre Lineaire,2,Sous Espaces Supplementaires,8,543,5,QCM,0.72,0.26,6.0,3,39,42,11,3,8,3.82,27.27,Facile,Difficile,-2,Beaucoup plus Difficile,Pas Adapte
1653,2016,Mathematique,1,L'Algebre Lineaire,2,Sous Espaces Supplementaires,8,543,5,QCM,0.52,0.28,20.0,9,37,46,22,9,13,2.09,40.91,Moyen,Difficile,-1,Plus Difficile,Pas Adapte
2764,2017,Mathematique,1,L'Algebre Lineaire,2,Sous Espaces Supplementaires,8,543,5,QCM,0.48,0.6,55.0,26,22,48,44,26,18,1.09,59.09,Difficile,Moyen,1,Plus Facile,Pas Adapte
3875,2018,Mathematique,1,L'Algebre Lineaire,2,Sous Espaces Supplementaires,8,543,5,QCM,0.48,0.41,59.0,28,19,47,40,28,12,1.18,70.0,Moyen,Moyen,0,Meme Difficulté,Pas Adapte
4986,2019,Mathematique,1,L'Algebre Lineaire,2,Sous Espaces Supplementaires,8,543,5,QCM,0.78,0.18,16.0,8,44,52,43,8,35,1.21,18.6,Facile,Difficile,-2,Beaucoup plus Difficile,Pas Adapte
6097,2020,Mathematique,1,L'Algebre Lineaire,2,Sous Espaces Supplementaires,8,543,5,QCM,0.51,0.19,23.0,13,43,56,53,13,40,1.06,24.53,Difficile,Difficile,0,Meme Difficulté,Pas Adapte
543,2015,Mathematique,1,L'Algebre Lineaire,2,Sous Espaces Supplementaires,8,544,6,QCU,0.43,0.22,29.0,18,43,61,28,18,10,2.18,64.29,Moyen,Difficile,-1,Plus Difficile,Pas Adapte
1654,2016,Mathematique,1,L'Algebre Lineaire,2,Sous Espaces Supplementaires,8,544,6,QCU,0.63,0.38,23.0,15,49,64,47,15,32,1.36,31.91,Difficile,Difficile,0,Meme Difficulté,Pas Adapte
2765,2017,Mathematique,1,L'Algebre Lineaire,2,Sous Espaces Supplementaires,8,544,6,QROC,0.52,0.34,42.0,26,37,63,52,26,26,1.21,50.0,Difficile,Moyen,1,Plus Facile,Pas Adapte
3876,2018,Mathematique,1,L'Algebre Lineaire,2,Sous Espaces Supplementaires,8,544,6,QROC,0.24,0.39,58.0,35,26,61,39,35,4,1.56,89.74,Difficile,Moyen,1,Plus Facile,Pas Adapte
4987,2019,Mathematique,1,L'Algebre Lineaire,2,Sous Espaces Supplementaires,8,544,6,QROC,0.6,0.16,20.0,11,42,53,46,11,35,1.15,23.91,Moyen,Difficile,-1,Plus Difficile,Pas Adapte
6098,2020,Mathematique,1,L'Algebre Lineaire,2,Sous Espaces Supplementaires,8,544,6,QCM,0.8,0.29,10.0,5,45,50,33,5,28,1.52,15.15,Facile,Difficile,-2,Beaucoup plus Difficile,Pas Adapte
544,2015,Mathematique,1,L'Algebre Lineaire,2,Sous Espaces Supplementaires,8,545,7,QCM,0.29,0.47,54.0,33,29,62,52,33,19,1.19,63.46,Moyen,Moyen,0,Meme Difficulté,Pas Adapte
1655,2016,Mathematique,1,L'Algebre Lineaire,2,Sous Espaces Supplementaires,8,545,7,QCM,0.46,0.39,42.0,23,32,55,50,23,27,1.1,46.0,Facile,Moyen,-1,Plus Difficile,Pas Adapte
2766,2017,Mathematique,1,L'Algebre Lineaire,2,Sous Espaces Supplementaires,8,545,7,QCM,0.08,0.94,66.0,38,19,57,41,38,3,1.39,92.68,Facile,Facile,0,Meme Difficulté,Adapte
3877,2018,Mathematique,1,L'Algebre Lineaire,2,Sous Espaces Supplementaires,8,545,7,QCM,0.01,0.71,66.0,41,21,62,58,41,17,1.07,70.69,Facile,Facile,0,Meme Difficulté,Adapte
4988,2019,Mathematique,1,L'Algebre Lineaire,2,Sous Espaces Supplementaires,8,545,7,QCM,0.05,0.92,66.0,36,18,54,46,36,10,1.17,78.26,Facile,Facile,0,Meme Difficulté,Adapte
6099,2020,Mathematique,1,L'Algebre Lineaire,2,Sous Espaces Supplementaires,8,545,7,QCU,0.16,0.94,66.0,40,20,60,55,40,15,1.09,72.73,Facile,Facile,0,Meme Difficulté,Adapte
545,2015,Mathematique,1,L'Algebre Lineaire,2,Sous Espaces Supplementaires,8,546,8,QCU,0.35,0.54,63.0,8,5,13,13,8,5,1.0,61.54,Moyen,Moyen,0,Meme Difficulté,Pas Adapte
1656,2016,Mathematique,1,L'Algebre Lineaire,2,Sous Espaces Supplementaires,8,546,8,QCU,0.21,0.5,36.0,4,7,11,5,4,1,2.2,80.0,Difficile,Moyen,1,Plus Facile,Pas Adapte
2767,2017,Mathematique,1,L'Algebre Lineaire,2,Sous Espaces Supplementaires,8,546,8,QCU,0.06,0.91,70.0,6,3,9,9,6,3,1.0,66.67,Difficile,Facile,2,Beaucoup plus Facile,Adapte
3878,2018,Mathematique,1,L'Algebre Lineaire,2,Sous Espaces Supplementaires,8,546,8,QCU,0.15,0.89,70.0,7,3,10,9,7,2,1.11,77.78,Facile,Facile,0,Meme Difficulté,Adapte
4989,2019,Mathematique,1,L'Algebre Lineaire,2,Sous Espaces Supplementaires,8,546,8,QCU,0.07,0.77,70.0,8,3,11,11,8,3,1.0,72.73,Facile,Facile,0,Meme Difficulté,Adapte
6100,2020,Mathematique,1,L'Algebre Lineaire,2,Sous Espaces Supplementaires,8,546,8,QROC,0.02,0.74,70.0,9,4,13,11,9,2,1.18,81.82,Facile,Facile,0,Meme Difficulté,Adapte
546,2015,Mathematique,1,L'Algebre Lineaire,3,Theoreme du Rang,3,547,1,QCM,0.52,0.19,4.0,4,89,93,53,4,49,1.75,7.55,Facile,Difficile,-2,Beaucoup plus Difficile,Pas Adapte
1657,2016,Mathematique,1,L'Algebre Lineaire,3,Theoreme du Rang,3,547,1,QCM,0.39,0.33,54.0,48,41,89,62,48,14,1.44,77.42,Difficile,Moyen,1,Plus Facile,Pas Adapte
2768,2017,Mathematique,1,L'Algebre Lineaire,3,Theoreme du Rang,3,547,1,QCM,0.51,0.3,21.0,19,70,89,69,19,50,1.29,27.54,Moyen,Difficile,-1,Plus Difficile,Pas Adapte
3879,2018,Mathematique,1,L'Algebre Lineaire,3,Theoreme du Rang,3,547,1,QCM,0.65,0.2,13.0,11,71,82,78,11,67,1.05,14.1,Difficile,Difficile,0,Meme Difficulté,Pas Adapte
4990,2019,Mathematique,1,L'Algebre Lineaire,3,Theoreme du Rang,3,547,1,QCM,0.78,0.24,15.0,14,78,92,57,14,43,1.61,24.56,Difficile,Difficile,0,Meme Difficulté,Pas Adapte
6101,2020,Mathematique,1,L'Algebre Lineaire,3,Theoreme du Rang,3,547,1,QCM,0.3,0.41,49.0,42,44,86,64,42,22,1.34,65.62,Facile,Moyen,-1,Plus Difficile,Pas Adapte
547,2015,Mathematique,1,L'Algebre Lineaire,3,Theoreme du Rang,3,548,2,QROC,0.32,0.35,52.0,11,10,21,17,11,6,1.24,64.71,Moyen,Moyen,0,Meme Difficulté,Pas Adapte
1658,2016,Mathematique,1,L'Algebre Lineaire,3,Theoreme du Rang,3,548,2,QROC,0.18,0.66,69.0,13,6,19,17,13,4,1.12,76.47,Facile,Facile,0,Meme Difficulté,Adapte
2769,2017,Mathematique,1,L'Algebre Lineaire,3,Theoreme du Rang,3,548,2,QROC,0.11,0.56,69.0,14,7,21,19,14,5,1.11,73.68,Facile,Facile,0,Meme Difficulté,Adapte
3880,2018,Mathematique,1,L'Algebre Lineaire,3,Theoreme du Rang,3,548,2,QROC,0.06,0.41,69.0,14,7,21,19,14,5,1.11,73.68,Facile,Facile,0,Meme Difficulté,Adapte
4991,2019,Mathematique,1,L'Algebre Lineaire,3,Theoreme du Rang,3,548,2,QROC,0.12,0.48,69.0,14,7,21,19,14,5,1.11,73.68,Facile,Facile,0,Meme Difficulté,Adapte
6102,2020,Mathematique,1,L'Algebre Lineaire,3,Theoreme du Rang,3,548,2,QROC,0.04,0.66,69.0,16,7,23,17,16,1,1.35,94.12,Facile,Facile,0,Meme Difficulté,Adapte
548,2015,Mathematique,1,L'Algebre Lineaire,3,Theoreme du Rang,3,549,3,QCM,0.48,0.38,48.0,29,32,61,34,29,5,1.79,85.29,Facile,Moyen,-1,Plus Difficile,Pas Adapte
1659,2016,Mathematique,1,L'Algebre Lineaire,3,Theoreme du Rang,3,549,3,QCM,0.53,0.27,24.0,16,52,68,38,16,22,1.79,42.11,Moyen,Difficile,-1,Plus Difficile,Pas Adapte
2770,2017,Mathematique,1,L'Algebre Lineaire,3,Theoreme du Rang,3,549,3,QCM,0.73,0.28,24.0,15,49,64,55,15,40,1.16,27.27,Facile,Difficile,-2,Beaucoup plus Difficile,Pas Adapte
3881,2018,Mathematique,1,L'Algebre Lineaire,3,Theoreme du Rang,3,549,3,QCM,0.45,0.36,42.0,30,42,72,43,30,13,1.67,69.77,Moyen,Moyen,0,Meme Difficulté,Pas Adapte
4992,2019,Mathematique,1,L'Algebre Lineaire,3,Theoreme du Rang,3,549,3,QCM,0.43,0.37,54.0,34,29,63,58,34,24,1.09,58.62,Facile,Moyen,-1,Plus Difficile,Pas Adapte
6103,2020,Mathematique,1,L'Algebre Lineaire,3,Theoreme du Rang,3,549,3,QCM,0.26,0.38,49.0,35,36,71,51,35,16,1.39,68.63,Difficile,Moyen,1,Plus Facile,Pas Adapte
549,2015,Mathematique,1,L'Algebre Lineaire,4,Projecteurs et Symetries,10,550,1,QCM,0.75,0.29,1.0,1,61,62,61,1,60,1.02,1.64,Facile,Difficile,-2,Beaucoup plus Difficile,Pas Adapte
1660,2016,Mathematique,1,L'Algebre Lineaire,4,Projecteurs et Symetries,10,550,1,QCM,0.57,0.2,33.0,22,46,68,52,22,30,1.31,42.31,Facile,Difficile,-2,Beaucoup plus Difficile,Pas Adapte
2771,2017,Mathematique,1,L'Algebre Lineaire,4,Projecteurs et Symetries,10,550,1,QROC,0.62,0.1,3.0,2,65,67,59,2,57,1.14,3.39,Moyen,Difficile,-1,Plus Difficile,Pas Adapte
3882,2018,Mathematique,1,L'Algebre Lineaire,4,Projecteurs et Symetries,10,550,1,QROC,0.85,0.1,35.0,21,39,60,32,21,11,1.88,65.62,Facile,Difficile,-2,Beaucoup plus Difficile,Pas Adapte
4993,2019,Mathematique,1,L'Algebre Lineaire,4,Projecteurs et Symetries,10,550,1,QROC,0.61,0.19,29.0,17,43,60,30,17,13,2.0,56.67,Moyen,Difficile,-1,Plus Difficile,Pas Adapte
6104,2020,Mathematique,1,L'Algebre Lineaire,4,Projecteurs et Symetries,10,550,1,QROC,1.0,0.06,19.0,12,53,65,38,12,26,1.71,31.58,Facile,Difficile,-2,Beaucoup plus Difficile,Pas Adapte
550,2015,Mathematique,1,L'Algebre Lineaire,4,Projecteurs et Symetries,10,551,2,QCM,0.64,0.24,24.0,6,17,23,20,6,14,1.15,30.0,Difficile,Difficile,0,Meme Difficulté,Pas Adapte
1661,2016,Mathematique,1,L'Algebre Lineaire,4,Projecteurs et Symetries,10,551,2,QCM,0.14,0.77,69.0,18,8,26,24,18,6,1.08,75.0,Facile,Facile,0,Meme Difficulté,Adapte
2772,2017,Mathematique,1,L'Algebre Lineaire,4,Projecteurs et Symetries,10,551,2,QCM,0.08,0.73,69.0,15,7,22,18,15,3,1.22,83.33,Facile,Facile,0,Meme Difficulté,Adapte
3883,2018,Mathematique,1,L'Algebre Lineaire,4,Projecteurs et Symetries,10,551,2,QCM,0.06,0.82,69.0,15,7,22,18,15,3,1.22,83.33,Facile,Facile,0,Meme Difficulté,Adapte
4994,2019,Mathematique,1,L'Algebre Lineaire,4,Projecteurs et Symetries,10,551,2,QCM,0.0,0.72,69.0,17,8,25,22,17,5,1.14,77.27,Facile,Facile,0,Meme Difficulté,Adapte
6105,2020,Mathematique,1,L'Algebre Lineaire,4,Projecteurs et Symetries,10,551,2,QCM,0.08,0.84,69.0,17,7,24,22,17,5,1.09,77.27,Facile,Facile,0,Meme Difficulté,Adapte
551,2015,Mathematique,1,L'Algebre Lineaire,4,Projecteurs et Symetries,10,552,3,QCM,0.54,0.28,1.0,0,27,27,17,0,17,1.59,0.0,Facile,Difficile,-2,Beaucoup plus Difficile,Pas Adapte
1662,2016,Mathematique,1,L'Algebre Lineaire,4,Projecteurs et Symetries,10,552,3,QCM,0.78,0.22,31.0,7,17,24,11,7,4,2.18,63.64,Facile,Difficile,-2,Beaucoup plus Difficile,Pas Adapte
2773,2017,Mathematique,1,L'Algebre Lineaire,4,Projecteurs et Symetries,10,552,3,QCM,0.21,0.53,49.0,10,10,20,11,10,1,1.82,90.91,Difficile,Moyen,1,Plus Facile,Pas Adapte
3884,2018,Mathematique,1,L'Algebre Lineaire,4,Projecteurs et Symetries,10,552,3,QCM,0.6,0.2,26.0,6,17,23,11,6,5,2.09,54.55,Difficile,Difficile,0,Meme Difficulté,Pas Adapte
4995,2019,Mathematique,1,L'Algebre Lineaire,4,Projecteurs et Symetries,10,552,3,QCM,0.27,0.46,61.0,16,10,26,24,16,8,1.08,66.67,Difficile,Moyen,1,Plus Facile,Pas Adapte
6106,2020,Mathematique,1,L'Algebre Lineaire,4,Projecteurs et Symetries,10,552,3,QCM,0.73,0.17,34.0,9,17,26,19,9,10,1.37,47.37,Difficile,Difficile,0,Meme Difficulté,Pas Adapte
552,2015,Mathematique,1,L'Algebre Lineaire,4,Projecteurs et Symetries,10,553,4,QCM,0.37,0.53,58.0,8,5,13,11,8,3,1.18,72.73,Moyen,Moyen,0,Meme Difficulté,Pas Adapte
1663,2016,Mathematique,1,L'Algebre Lineaire,4,Projecteurs et Symetries,10,553,4,QCM,0.21,0.57,39.0,4,7,11,5,4,1,2.2,80.0,Moyen,Moyen,0,Meme Difficulté,Pas Adapte
2774,2017,Mathematique,1,L'Algebre Lineaire,4,Projecteurs et Symetries,10,553,4,QCM,0.3,0.4,46.0,6,7,13,10,6,4,1.3,60.0,Facile,Moyen,-1,Plus Difficile,Pas Adapte
3885,2018,Mathematique,1,L'Algebre Lineaire,4,Projecteurs et Symetries,10,553,4,QCM,0.33,0.33,42.0,6,8,14,8,6,2,1.75,75.0,Difficile,Moyen,1,Plus Facile,Pas Adapte
4996,2019,Mathematique,1,L'Algebre Lineaire,4,Projecteurs et Symetries,10,553,4,QCM,0.56,0.16,7.0,1,15,16,8,1,7,2.0,12.5,Facile,Difficile,-2,Beaucoup plus Difficile,Pas Adapte
6107,2020,Mathematique,1,L'Algebre Lineaire,4,Projecteurs et Symetries,10,553,4,QCM,0.22,0.54,39.0,7,10,17,11,7,4,1.55,63.64,Moyen,Moyen,0,Meme Difficulté,Pas Adapte
553,2015,Mathematique,1,L'Algebre Lineaire,4,Projecteurs et Symetries,10,554,5,QROC,0.59,0.32,52.0,24,22,46,25,24,1,1.84,96.0,Difficile,Moyen,1,Plus Facile,Pas Adapte
1664,2016,Mathematique,1,L'Algebre Lineaire,4,Projecteurs et Symetries,10,554,5,QROC,0.61,0.2,9.0,5,48,53,24,5,19,2.21,20.83,Difficile,Difficile,0,Meme Difficulté,Pas Adapte
2775,2017,Mathematique,1,L'Algebre Lineaire,4,Projecteurs et Symetries,10,554,5,QROC,0.28,0.32,40.0,21,31,52,48,21,27,1.08,43.75,Difficile,Moyen,1,Plus Facile,Pas Adapte
3886,2018,Mathematique,1,L'Algebre Lineaire,4,Projecteurs et Symetries,10,554,5,QROC,0.82,0.15,12.0,7,49,56,48,7,41,1.17,14.58,Moyen,Difficile,-1,Plus Difficile,Pas Adapte
4997,2019,Mathematique,1,L'Algebre Lineaire,4,Projecteurs et Symetries,10,554,5,QO,0.28,0.28,58.0,34,24,58,40,34,6,1.45,85.0,Facile,Moyen,-1,Plus Difficile,Pas Adapte
6108,2020,Mathematique,1,L'Algebre Lineaire,4,Projecteurs et Symetries,10,554,5,QO,0.9,0.05,6.0,4,55,59,48,4,44,1.23,8.33,Moyen,Difficile,-1,Plus Difficile,Pas Adapte
554,2015,Mathematique,1,L'Algebre Lineaire,4,Projecteurs et Symetries,10,555,6,QCU,0.1,0.77,66.0,19,10,29,23,19,4,1.26,82.61,Difficile,Facile,2,Beaucoup plus Facile,Adapte
1665,2016,Mathematique,1,L'Algebre Lineaire,4,Projecteurs et Symetries,10,555,6,QCU,0.14,0.89,66.0,20,10,30,27,20,7,1.11,74.07,Facile,Facile,0,Meme Difficulté,Adapte
2776,2017,Mathematique,1,L'Algebre Lineaire,4,Projecteurs et Symetries,10,555,6,QCU,0.13,0.81,66.0,22,12,34,30,22,8,1.13,73.33,Facile,Facile,0,Meme Difficulté,Adapte
3887,2018,Mathematique,1,L'Algebre Lineaire,4,Projecteurs et Symetries,10,555,6,QCM,0.19,0.96,66.0,19,10,29,23,19,4,1.26,82.61,Facile,Facile,0,Meme Difficulté,Adapte
4998,2019,Mathematique,1,L'Algebre Lineaire,4,Projecteurs et Symetries,10,555,6,QCM,0.18,0.8,66.0,22,11,33,29,22,7,1.14,75.86,Facile,Facile,0,Meme Difficulté,Adapte
6109,2020,Mathematique,1,L'Algebre Lineaire,4,Projecteurs et Symetries,10,555,6,QCM,0.13,0.88,66.0,20,11,31,21,20,1,1.48,95.24,Facile,Facile,0,Meme Difficulté,Adapte
555,2015,Mathematique,1,L'Algebre Lineaire,4,Projecteurs et Symetries,10,556,7,QCM,0.77,0.26,15.0,9,52,61,21,9,12,2.9,42.86,Difficile,Difficile,0,Meme Difficulté,Pas Adapte
1666,2016,Mathematique,1,L'Algebre Lineaire,4,Projecteurs et Symetries,10,556,7,QCM,0.53,0.28,15.0,8,48,56,40,8,32,1.4,20.0,Facile,Difficile,-2,Beaucoup plus Difficile,Pas Adapte
2777,2017,Mathematique,1,L'Algebre Lineaire,4,Projecteurs et Symetries,10,556,7,QCM,0.37,0.61,39.0,22,35,57,45,22,23,1.27,48.89,Moyen,Moyen,0,Meme Difficulté,Pas Adapte
3888,2018,Mathematique,1,L'Algebre Lineaire,4,Projecteurs et Symetries,10,556,7,QCM,0.23,0.59,39.0,24,37,61,58,24,34,1.05,41.38,Moyen,Moyen,0,Meme Difficulté,Pas Adapte
4999,2019,Mathematique,1,L'Algebre Lineaire,4,Projecteurs et Symetries,10,556,7,QCU,0.52,0.22,4.0,3,66,69,53,3,50,1.3,5.66,Difficile,Difficile,0,Meme Difficulté,Pas Adapte
6110,2020,Mathematique,1,L'Algebre Lineaire,4,Projecteurs et Symetries,10,556,7,QCM,0.34,0.62,47.0,34,39,73,44,34,10,1.66,77.27,Facile,Moyen,-1,Plus Difficile,Pas Adapte
556,2015,Mathematique,1,L'Algebre Lineaire,4,Projecteurs et Symetries,10,557,8,QCU,0.27,0.73,40.0,36,53,89,73,36,37,1.22,49.32,Difficile,Moyen,1,Plus Facile,Pas Adapte
1667,2016,Mathematique,1,L'Algebre Lineaire,4,Projecteurs et Symetries,10,557,8,QCU,0.23,0.43,46.0,40,48,88,46,40,6,1.91,86.96,Moyen,Moyen,0,Meme Difficulté,Pas Adapte
2778,2017,Mathematique,1,L'Algebre Lineaire,4,Projecteurs et Symetries,10,557,8,QCU,0.24,0.54,44.0,35,45,80,42,35,7,1.9,83.33,Difficile,Moyen,1,Plus Facile,Pas Adapte
3889,2018,Mathematique,1,L'Algebre Lineaire,4,Projecteurs et Symetries,10,557,8,QCU,0.21,0.52,49.0,36,37,73,66,36,30,1.11,54.55,Difficile,Moyen,1,Plus Facile,Pas Adapte
5000,2019,Mathematique,1,L'Algebre Lineaire,4,Projecteurs et Symetries,10,557,8,QCU,0.32,0.71,45.0,34,42,76,60,34,26,1.27,56.67,Difficile,Moyen,1,Plus Facile,Pas Adapte
6111,2020,Mathematique,1,L'Algebre Lineaire,4,Projecteurs et Symetries,10,557,8,QCU,0.45,0.33,32.0,26,56,82,41,26,15,2.0,63.41,Difficile,Difficile,0,Meme Difficulté,Pas Adapte
557,2015,Mathematique,1,L'Algebre Lineaire,4,Projecteurs et Symetries,10,558,9,QROC,0.79,0.15,30.0,19,45,64,50,19,31,1.28,38.0,Difficile,Difficile,0,Meme Difficulté,Pas Adapte
1668,2016,Mathematique,1,L'Algebre Lineaire,4,Projecteurs et Symetries,10,558,9,QROC,0.95,0.04,27.0,16,42,58,48,16,32,1.21,33.33,Facile,Difficile,-2,Beaucoup plus Difficile,Pas Adapte
2779,2017,Mathematique,1,L'Algebre Lineaire,4,Projecteurs et Symetries,10,558,9,QROC,0.43,0.4,64.0,36,20,56,44,36,8,1.27,81.82,Moyen,Moyen,0,Meme Difficulté,Pas Adapte
3890,2018,Mathematique,1,L'Algebre Lineaire,4,Projecteurs et Symetries,10,558,9,QROC,1.0,0.16,25.0,15,46,61,45,15,30,1.36,33.33,Facile,Difficile,-2,Beaucoup plus Difficile,Pas Adapte
5001,2019,Mathematique,1,L'Algebre Lineaire,4,Projecteurs et Symetries,10,558,9,QO,0.99,0.1,8.0,5,63,68,58,5,53,1.17,8.62,Facile,Difficile,-2,Beaucoup plus Difficile,Pas Adapte
6112,2020,Mathematique,1,L'Algebre Lineaire,4,Projecteurs et Symetries,10,558,9,QO,0.52,0.23,44.0,31,39,70,53,31,22,1.32,58.49,Moyen,Moyen,0,Meme Difficulté,Pas Adapte
558,2015,Mathematique,1,L'Algebre Lineaire,4,Projecteurs et Symetries,10,559,10,QCU,0.24,0.66,58.0,57,42,99,67,57,10,1.48,85.07,Moyen,Moyen,0,Meme Difficulté,Pas Adapte
1669,2016,Mathematique,1,L'Algebre Lineaire,4,Projecteurs et Symetries,10,559,10,QCU,0.58,0.4,14.0,16,95,111,59,16,43,1.88,27.12,Moyen,Difficile,-1,Plus Difficile,Pas Adapte
2780,2017,Mathematique,1,L'Algebre Lineaire,4,Projecteurs et Symetries,10,559,10,QCU,0.2,0.46,61.0,62,39,101,101,62,39,1.0,61.39,Difficile,Moyen,1,Plus Facile,Pas Adapte
3891,2018,Mathematique,1,L'Algebre Lineaire,4,Projecteurs et Symetries,10,559,10,QCU,0.7,0.29,18.0,21,93,114,80,21,59,1.43,26.25,Facile,Difficile,-2,Beaucoup plus Difficile,Pas Adapte
5002,2019,Mathematique,1,L'Algebre Lineaire,4,Projecteurs et Symetries,10,559,10,QCU,0.27,0.46,40.0,51,77,128,83,51,32,1.54,61.45,Moyen,Moyen,0,Meme Difficulté,Pas Adapte
6113,2020,Mathematique,1,L'Algebre Lineaire,4,Projecteurs et Symetries,10,559,10,QCU,0.69,0.25,9.0,11,107,118,44,11,33,2.68,25.0,Difficile,Difficile,0,Meme Difficulté,Pas Adapte
559,2015,Mathematique,1,L'Algebre Lineaire,5,Determination et Construction d'Applications Lineaires,14,560,1,QCU,0.37,0.41,51.0,32,30,62,58,32,26,1.07,55.17,Moyen,Moyen,0,Meme Difficulté,Pas Adapte
1670,2016,Mathematique,1,L'Algebre Lineaire,5,Determination et Construction d'Applications Lineaires,14,560,1,QCU,0.6,0.23,33.0,21,42,63,36,21,15,1.75,58.33,Moyen,Difficile,-1,Plus Difficile,Pas Adapte
2781,2017,Mathematique,1,L'Algebre Lineaire,5,Determination et Construction d'Applications Lineaires,14,560,1,QCM,0.78,0.16,17.0,11,54,65,22,11,11,2.95,50.0,Facile,Difficile,-2,Beaucoup plus Difficile,Pas Adapte
3892,2018,Mathematique,1,L'Algebre Lineaire,5,Determination et Construction d'Applications Lineaires,14,560,1,QCM,0.0,0.95,66.0,40,21,61,50,40,10,1.22,80.0,Difficile,Facile,2,Beaucoup plus Facile,Adapte
5003,2019,Mathematique,1,L'Algebre Lineaire,5,Determination et Construction d'Applications Lineaires,14,560,1,QCM,0.2,0.88,66.0,42,22,64,55,42,13,1.16,76.36,Facile,Facile,0,Meme Difficulté,Adapte
6114,2020,Mathematique,1,L'Algebre Lineaire,5,Determination et Construction d'Applications Lineaires,14,560,1,QCM,0.04,0.95,66.0,41,21,62,50,41,9,1.24,82.0,Facile,Facile,0,Meme Difficulté,Adapte
560,2015,Mathematique,1,L'Algebre Lineaire,5,Determination et Construction d'Applications Lineaires,14,561,2,QCU,0.67,0.23,21.0,9,32,41,14,9,5,2.93,64.29,Difficile,Difficile,0,Meme Difficulté,Pas Adapte
1671,2016,Mathematique,1,L'Algebre Lineaire,5,Determination et Construction d'Applications Lineaires,14,561,2,QCU,0.41,0.4,29.0,13,31,44,41,13,28,1.07,31.71,Difficile,Difficile,0,Meme Difficulté,Pas Adapte
2782,2017,Mathematique,1,L'Algebre Lineaire,5,Determination et Construction d'Applications Lineaires,14,561,2,QCM,0.58,0.18,4.0,2,49,51,15,2,13,3.4,13.33,Difficile,Difficile,0,Meme Difficulté,Pas Adapte
3893,2018,Mathematique,1,L'Algebre Lineaire,5,Determination et Construction d'Applications Lineaires,14,561,2,QCM,0.35,0.46,60.0,35,24,59,45,35,10,1.31,77.78,Facile,Moyen,-1,Plus Difficile,Pas Adapte
5004,2019,Mathematique,1,L'Algebre Lineaire,5,Determination et Construction d'Applications Lineaires,14,561,2,QCM,0.26,0.42,61.0,36,23,59,48,36,12,1.23,75.0,Facile,Moyen,-1,Plus Difficile,Pas Adapte
6115,2020,Mathematique,1,L'Algebre Lineaire,5,Determination et Construction d'Applications Lineaires,14,561,2,QCM,0.58,0.17,34.0,18,36,54,36,18,18,1.5,50.0,Facile,Difficile,-2,Beaucoup plus Difficile,Pas Adapte
561,2015,Mathematique,1,L'Algebre Lineaire,5,Determination et Construction d'Applications Lineaires,14,562,3,QCU,0.33,0.74,45.0,32,40,72,45,32,13,1.6,71.11,Difficile,Moyen,1,Plus Facile,Pas Adapte
1672,2016,Mathematique,1,L'Algebre Lineaire,5,Determination et Construction d'Applications Lineaires,14,562,3,QO,0.3,0.16,49.0,32,33,65,64,32,32,1.02,50.0,Facile,Moyen,-1,Plus Difficile,Pas Adapte
2783,2017,Mathematique,1,L'Algebre Lineaire,5,Determination et Construction d'Applications Lineaires,14,562,3,QCM,0.5,0.18,20.0,14,56,70,34,14,20,2.06,41.18,Difficile,Difficile,0,Meme Difficulté,Pas Adapte
3894,2018,Mathematique,1,L'Algebre Lineaire,5,Determination et Construction d'Applications Lineaires,14,562,3,QCU,0.2,0.46,42.0,32,44,76,65,32,33,1.17,49.23,Moyen,Moyen,0,Meme Difficulté,Pas Adapte
5005,2019,Mathematique,1,L'Algebre Lineaire,5,Determination et Construction d'Applications Lineaires,14,562,3,QCU,0.38,0.72,61.0,43,27,70,61,43,18,1.15,70.49,Moyen,Moyen,0,Meme Difficulté,Pas Adapte
6116,2020,Mathematique,1,L'Algebre Lineaire,5,Determination et Construction d'Applications Lineaires,14,562,3,QCU,0.16,0.84,65.0,49,26,75,70,49,21,1.07,70.0,Moyen,Facile,1,Plus Facile,Adapte
562,2015,Mathematique,1,L'Algebre Lineaire,5,Determination et Construction d'Applications Lineaires,14,563,4,QCM,0.53,0.29,13.0,8,56,64,53,8,45,1.21,15.09,Difficile,Difficile,0,Meme Difficulté,Pas Adapte
1673,2016,Mathematique,1,L'Algebre Lineaire,5,Determination et Construction d'Applications Lineaires,14,563,4,QCM,0.32,0.52,56.0,33,26,59,33,33,0,1.79,100.0,Facile,Moyen,-1,Plus Difficile,Pas Adapte
2784,2017,Mathematique,1,L'Algebre Lineaire,5,Determination et Construction d'Applications Lineaires,14,563,4,QCM,0.8,0.18,24.0,15,49,64,51,15,36,1.25,29.41,Moyen,Difficile,-1,Plus Difficile,Pas Adapte
3895,2018,Mathematique,1,L'Algebre Lineaire,5,Determination et Construction d'Applications Lineaires,14,563,4,QCM,0.73,0.2,29.0,19,45,64,45,19,26,1.42,42.22,Difficile,Difficile,0,Meme Difficulté,Pas Adapte
5006,2019,Mathematique,1,L'Algebre Lineaire,5,Determination et Construction d'Applications Lineaires,14,563,4,QCM,0.53,0.27,35.0,24,44,68,54,24,30,1.26,44.44,Facile,Difficile,-2,Beaucoup plus Difficile,Pas Adapte
6117,2020,Mathematique,1,L'Algebre Lineaire,5,Determination et Construction d'Applications Lineaires,14,563,4,QCM,0.35,0.37,61.0,37,24,61,46,37,9,1.33,80.43,Difficile,Moyen,1,Plus Facile,Pas Adapte
563,2015,Mathematique,1,L'Algebre Lineaire,5,Determination et Construction d'Applications Lineaires,14,564,5,QCM,0.6,0.26,13.0,9,61,70,23,9,14,3.04,39.13,Difficile,Difficile,0,Meme Difficulté,Pas Adapte
1674,2016,Mathematique,1,L'Algebre Lineaire,5,Determination et Construction d'Applications Lineaires,14,564,5,QCM,0.76,0.18,9.0,7,67,74,61,7,54,1.21,11.48,Moyen,Difficile,-1,Plus Difficile,Pas Adapte
2785,2017,Mathematique,1,L'Algebre Lineaire,5,Determination et Construction d'Applications Lineaires,14,564,5,QCM,0.74,0.22,13.0,9,59,68,38,9,29,1.79,23.68,Facile,Difficile,-2,Beaucoup plus Difficile,Pas Adapte
3896,2018,Mathematique,1,L'Algebre Lineaire,5,Determination et Construction d'Applications Lineaires,14,564,5,QCM,0.53,0.19,17.0,10,49,59,23,10,13,2.57,43.48,Difficile,Difficile,0,Meme Difficulté,Pas Adapte
5007,2019,Mathematique,1,L'Algebre Lineaire,5,Determination et Construction d'Applications Lineaires,14,564,5,QCM,0.48,0.34,61.0,40,25,65,50,40,10,1.3,80.0,Difficile,Moyen,1,Plus Facile,Pas Adapte
6118,2020,Mathematique,1,L'Algebre Lineaire,5,Determination et Construction d'Applications Lineaires,14,564,5,QCM,0.61,0.27,15.0,9,53,62,23,9,14,2.7,39.13,Difficile,Difficile,0,Meme Difficulté,Pas Adapte
564,2015,Mathematique,1,L'Algebre Lineaire,5,Determination et Construction d'Applications Lineaires,14,565,6,QCM,0.64,0.26,31.0,24,55,79,38,24,14,2.08,63.16,Facile,Difficile,-2,Beaucoup plus Difficile,Pas Adapte
1675,2016,Mathematique,1,L'Algebre Lineaire,5,Determination et Construction d'Applications Lineaires,14,565,6,QCM,0.47,0.43,42.0,32,43,75,53,32,21,1.42,60.38,Moyen,Moyen,0,Meme Difficulté,Pas Adapte
2786,2017,Mathematique,1,L'Algebre Lineaire,5,Determination et Construction d'Applications Lineaires,14,565,6,QCM,0.75,0.22,21.0,15,56,71,67,15,52,1.06,22.39,Difficile,Difficile,0,Meme Difficulté,Pas Adapte
3897,2018,Mathematique,1,L'Algebre Lineaire,5,Determination et Construction d'Applications Lineaires,14,565,6,QCM,0.77,0.15,12.0,10,71,81,70,10,60,1.16,14.29,Difficile,Difficile,0,Meme Difficulté,Pas Adapte
5008,2019,Mathematique,1,L'Algebre Lineaire,5,Determination et Construction d'Applications Lineaires,14,565,6,QCM,0.74,0.18,12.0,8,62,70,35,8,27,2.0,22.86,Moyen,Difficile,-1,Plus Difficile,Pas Adapte
6119,2020,Mathematique,1,L'Algebre Lineaire,5,Determination et Construction d'Applications Lineaires,14,565,6,QCM,0.68,0.19,25.0,16,49,65,25,16,9,2.6,64.0,Difficile,Difficile,0,Meme Difficulté,Pas Adapte
565,2015,Mathematique,1,L'Algebre Lineaire,5,Determination et Construction d'Applications Lineaires,14,566,7,QCM,0.39,0.31,45.0,21,25,46,39,21,18,1.18,53.85,Facile,Moyen,-1,Plus Difficile,Pas Adapte
1676,2016,Mathematique,1,L'Algebre Lineaire,5,Determination et Construction d'Applications Lineaires,14,566,7,QCM,0.76,0.26,23.0,12,40,52,19,12,7,2.74,63.16,Facile,Difficile,-2,Beaucoup plus Difficile,Pas Adapte
2787,2017,Mathematique,1,L'Algebre Lineaire,5,Determination et Construction d'Applications Lineaires,14,566,7,QCM,0.68,0.19,13.0,6,40,46,37,6,31,1.24,16.22,Facile,Difficile,-2,Beaucoup plus Difficile,Pas Adapte
3898,2018,Mathematique,1,L'Algebre Lineaire,5,Determination et Construction d'Applications Lineaires,14,566,7,QCM,0.54,0.19,27.0,11,30,41,39,11,28,1.05,28.21,Facile,Difficile,-2,Beaucoup plus Difficile,Pas Adapte
5009,2019,Mathematique,1,L'Algebre Lineaire,5,Determination et Construction d'Applications Lineaires,14,566,7,QROC,0.84,0.09,15.0,7,40,47,41,7,34,1.15,17.07,Difficile,Difficile,0,Meme Difficulté,Pas Adapte
6120,2020,Mathematique,1,L'Algebre Lineaire,5,Determination et Construction d'Applications Lineaires,14,566,7,QROC,0.08,0.79,68.0,32,15,47,34,32,2,1.38,94.12,Moyen,Facile,1,Plus Facile,Adapte
566,2015,Mathematique,1,L'Algebre Lineaire,5,Determination et Construction d'Applications Lineaires,14,567,8,QCU,0.34,0.53,47.0,43,48,91,85,43,42,1.07,50.59,Moyen,Moyen,0,Meme Difficulté,Pas Adapte
1677,2016,Mathematique,1,L'Algebre Lineaire,5,Determination et Construction d'Applications Lineaires,14,567,8,QCU,0.63,0.33,17.0,13,66,79,73,13,60,1.08,17.81,Moyen,Difficile,-1,Plus Difficile,Pas Adapte
2788,2017,Mathematique,1,L'Algebre Lineaire,5,Determination et Construction d'Applications Lineaires,14,567,8,QCU,0.71,0.23,32.0,28,58,86,59,28,31,1.46,47.46,Facile,Difficile,-2,Beaucoup plus Difficile,Pas Adapte
3899,2018,Mathematique,1,L'Algebre Lineaire,5,Determination et Construction d'Applications Lineaires,14,567,8,QCU,0.21,0.56,41.0,40,58,98,85,40,45,1.15,47.06,Difficile,Moyen,1,Plus Facile,Pas Adapte
5010,2019,Mathematique,1,L'Algebre Lineaire,5,Determination et Construction d'Applications Lineaires,14,567,8,QCU,0.34,0.69,37.0,41,69,110,79,41,38,1.39,51.9,Facile,Moyen,-1,Plus Difficile,Pas Adapte
6121,2020,Mathematique,1,L'Algebre Lineaire,5,Determination et Construction d'Applications Lineaires,14,567,8,QCU,0.02,0.92,69.0,82,37,119,95,82,13,1.25,86.32,Moyen,Facile,1,Plus Facile,Adapte
567,2015,Mathematique,1,L'Algebre Lineaire,5,Determination et Construction d'Applications Lineaires,14,568,9,QCU,0.54,0.27,26.0,22,61,83,42,22,20,1.98,52.38,Moyen,Difficile,-1,Plus Difficile,Pas Adapte
1678,2016,Mathematique,1,L'Algebre Lineaire,5,Determination et Construction d'Applications Lineaires,14,568,9,QCU,0.52,0.22,16.0,12,65,77,57,12,45,1.35,21.05,Facile,Difficile,-2,Beaucoup plus Difficile,Pas Adapte
2789,2017,Mathematique,1,L'Algebre Lineaire,5,Determination et Construction d'Applications Lineaires,14,568,9,QCU,0.36,0.56,46.0,34,39,73,46,34,12,1.59,73.91,Facile,Moyen,-1,Plus Difficile,Pas Adapte
3900,2018,Mathematique,1,L'Algebre Lineaire,5,Determination et Construction d'Applications Lineaires,14,568,9,QCU,0.69,0.33,18.0,14,65,79,76,14,62,1.04,18.42,Moyen,Difficile,-1,Plus Difficile,Pas Adapte
5011,2019,Mathematique,1,L'Algebre Lineaire,5,Determination et Construction d'Applications Lineaires,14,568,9,QCM,0.04,0.8,68.0,47,22,69,48,47,1,1.44,97.92,Difficile,Facile,2,Beaucoup plus Facile,Adapte
6122,2020,Mathematique,1,L'Algebre Lineaire,5,Determination et Construction d'Applications Lineaires,14,568,9,QROC,0.02,0.52,68.0,46,22,68,50,46,4,1.36,92.0,Facile,Facile,0,Meme Difficulté,Adapte
568,2015,Mathematique,1,L'Algebre Lineaire,5,Determination et Construction d'Applications Lineaires,14,569,10,QCM,0.51,0.26,28.0,9,24,33,24,9,15,1.38,37.5,Difficile,Difficile,0,Meme Difficulté,Pas Adapte
1679,2016,Mathematique,1,L'Algebre Lineaire,5,Determination et Construction d'Applications Lineaires,14,569,10,QCM,0.48,0.37,36.0,11,20,31,27,11,16,1.15,40.74,Moyen,Moyen,0,Meme Difficulté,Pas Adapte
2790,2017,Mathematique,1,L'Algebre Lineaire,5,Determination et Construction d'Applications Lineaires,14,569,10,QCM,0.77,0.3,16.0,4,23,27,21,4,17,1.29,19.05,Difficile,Difficile,0,Meme Difficulté,Pas Adapte
3901,2018,Mathematique,1,L'Algebre Lineaire,5,Determination et Construction d'Applications Lineaires,14,569,10,QCM,0.62,0.18,15.0,4,20,24,12,4,8,2.0,33.33,Facile,Difficile,-2,Beaucoup plus Difficile,Pas Adapte
5012,2019,Mathematique,1,L'Algebre Lineaire,5,Determination et Construction d'Applications Lineaires,14,569,10,QCM,0.76,0.28,3.0,1,21,22,11,1,10,2.0,9.09,Facile,Difficile,-2,Beaucoup plus Difficile,Pas Adapte
6123,2020,Mathematique,1,L'Algebre Lineaire,5,Determination et Construction d'Applications Lineaires,14,569,10,QCM,0.71,0.2,33.0,7,13,20,11,7,4,1.82,63.64,Difficile,Difficile,0,Meme Difficulté,Pas Adapte
569,2015,Mathematique,1,L'Algebre Lineaire,5,Determination et Construction d'Applications Lineaires,14,570,11,QROC,0.78,0.24,33.0,7,15,22,20,7,13,1.1,35.0,Facile,Difficile,-2,Beaucoup plus Difficile,Pas Adapte
1680,2016,Mathematique,1,L'Algebre Lineaire,5,Determination et Construction d'Applications Lineaires,14,570,11,QO,0.9,0.03,25.0,6,16,22,12,6,6,1.83,50.0,Difficile,Difficile,0,Meme Difficulté,Pas Adapte
2791,2017,Mathematique,1,L'Algebre Lineaire,5,Determination et Construction d'Applications Lineaires,14,570,11,QO,0.96,0.12,13.0,3,19,22,18,3,15,1.22,16.67,Difficile,Difficile,0,Meme Difficulté,Pas Adapte
3902,2018,Mathematique,1,L'Algebre Lineaire,5,Determination et Construction d'Applications Lineaires,14,570,11,QO,0.95,0.03,26.0,6,19,25,23,6,17,1.09,26.09,Facile,Difficile,-2,Beaucoup plus Difficile,Pas Adapte
5013,2019,Mathematique,1,L'Algebre Lineaire,5,Determination et Construction d'Applications Lineaires,14,570,11,QO,0.12,0.66,66.0,18,9,27,18,18,0,1.5,100.0,Difficile,Facile,2,Beaucoup plus Facile,Adapte
6124,2020,Mathematique,1,L'Algebre Lineaire,5,Determination et Construction d'Applications Lineaires,14,570,11,QO,0.06,0.37,66.0,20,11,31,23,20,3,1.35,86.96,Facile,Facile,0,Meme Difficulté,Adapte
570,2015,Mathematique,1,L'Algebre Lineaire,5,Determination et Construction d'Applications Lineaires,14,571,12,QO,0.48,0.27,44.0,22,27,49,43,22,21,1.14,51.16,Difficile,Moyen,1,Plus Facile,Pas Adapte
1681,2016,Mathematique,1,L'Algebre Lineaire,5,Determination et Construction d'Applications Lineaires,14,571,12,QO,0.52,0.3,39.0,18,27,45,25,18,7,1.8,72.0,Moyen,Moyen,0,Meme Difficulté,Pas Adapte
2792,2017,Mathematique,1,L'Algebre Lineaire,5,Determination et Construction d'Applications Lineaires,14,571,12,QO,0.44,0.25,37.0,16,28,44,34,16,18,1.29,47.06,Facile,Moyen,-1,Plus Difficile,Pas Adapte
3903,2018,Mathematique,1,L'Algebre Lineaire,5,Determination et Construction d'Applications Lineaires,14,571,12,QO,0.27,0.22,41.0,17,25,42,40,17,23,1.05,42.5,Moyen,Moyen,0,Meme Difficulté,Pas Adapte
5014,2019,Mathematique,1,L'Algebre Lineaire,5,Determination et Construction d'Applications Lineaires,14,571,12,QO,0.2,0.21,43.0,18,24,42,31,18,13,1.35,58.06,Moyen,Moyen,0,Meme Difficulté,Pas Adapte
6125,2020,Mathematique,1,L'Algebre Lineaire,5,Determination et Construction d'Applications Lineaires,14,571,12,QO,0.59,0.27,40.0,19,29,48,31,19,12,1.55,61.29,Moyen,Moyen,0,Meme Difficulté,Pas Adapte
571,2015,Mathematique,1,L'Algebre Lineaire,5,Determination et Construction d'Applications Lineaires,14,572,13,QCU,0.64,0.33,14.0,2,9,11,6,2,4,1.83,33.33,Facile,Difficile,-2,Beaucoup plus Difficile,Pas Adapte
1682,2016,Mathematique,1,L'Algebre Lineaire,5,Determination et Construction d'Applications Lineaires,14,572,13,QCU,0.74,0.29,8.0,1,8,9,8,1,7,1.12,12.5,Facile,Difficile,-2,Beaucoup plus Difficile,Pas Adapte
2793,2017,Mathematique,1,L'Algebre Lineaire,5,Determination et Construction d'Applications Lineaires,14,572,13,QCU,0.28,0.5,40.0,4,5,9,8,4,4,1.12,50.0,Difficile,Moyen,1,Plus Facile,Pas Adapte
3904,2018,Mathematique,1,L'Algebre Lineaire,5,Determination et Construction d'Applications Lineaires,14,572,13,QCU,0.27,0.63,46.0,5,5,10,9,5,4,1.11,55.56,Facile,Moyen,-1,Plus Difficile,Pas Adapte
5015,2019,Mathematique,1,L'Algebre Lineaire,5,Determination et Construction d'Applications Lineaires,14,572,13,QCU,0.37,0.4,61.0,5,3,8,6,5,1,1.33,83.33,Difficile,Moyen,1,Plus Facile,Pas Adapte
6126,2020,Mathematique,1,L'Algebre Lineaire,5,Determination et Construction d'Applications Lineaires,14,572,13,QCU,0.47,0.32,34.0,2,5,7,6,2,4,1.17,33.33,Moyen,Difficile,-1,Plus Difficile,Pas Adapte
572,2015,Mathematique,1,L'Algebre Lineaire,5,Determination et Construction d'Applications Lineaires,14,573,14,QCM,0.46,0.31,49.0,41,42,83,69,41,28,1.2,59.42,Moyen,Moyen,0,Meme Difficulté,Pas Adapte
1683,2016,Mathematique,1,L'Algebre Lineaire,5,Determination et Construction d'Applications Lineaires,14,573,14,QCM,0.16,0.88,69.0,49,22,71,49,49,0,1.45,100.0,Facile,Facile,0,Meme Difficulté,Adapte
2794,2017,Mathematique,1,L'Algebre Lineaire,5,Determination et Construction d'Applications Lineaires,14,573,14,QCM,0.07,0.76,69.0,44,20,64,60,44,16,1.07,73.33,Facile,Facile,0,Meme Difficulté,Adapte
3905,2018,Mathematique,1,L'Algebre Lineaire,5,Determination et Construction d'Applications Lineaires,14,573,14,QCM,0.11,0.92,69.0,46,20,66,65,46,19,1.02,70.77,Facile,Facile,0,Meme Difficulté,Adapte
5016,2019,Mathematique,1,L'Algebre Lineaire,5,Determination et Construction d'Applications Lineaires,14,573,14,QCM,0.09,0.74,69.0,41,19,60,44,41,3,1.36,93.18,Facile,Facile,0,Meme Difficulté,Adapte
6127,2020,Mathematique,1,L'Algebre Lineaire,5,Determination et Construction d'Applications Lineaires,14,573,14,QCM,0.05,0.83,69.0,41,19,60,53,41,12,1.13,77.36,Facile,Facile,0,Meme Difficulté,Adapte
573,2015,Mathematique,1,L'Algebre Lineaire,6,"Calcul de Dimensions et Construction de Bases, utilisant de la Dualite",2,574,1,QCM,0.72,0.16,10.0,3,31,34,25,3,22,1.36,12.0,Difficile,Difficile,0,Meme Difficulté,Pas Adapte
1684,2016,Mathematique,1,L'Algebre Lineaire,6,"Calcul de Dimensions et Construction de Bases, utilisant de la Dualite",2,574,1,QCM,0.79,0.15,34.0,13,26,39,18,13,5,2.17,72.22,Moyen,Difficile,-1,Plus Difficile,Pas Adapte
2795,2017,Mathematique,1,L'Algebre Lineaire,6,"Calcul de Dimensions et Construction de Bases, utilisant de la Dualite",2,574,1,QCM,0.76,0.24,34.0,11,22,33,25,11,14,1.32,44.0,Moyen,Difficile,-1,Plus Difficile,Pas Adapte
3906,2018,Mathematique,1,L'Algebre Lineaire,6,"Calcul de Dimensions et Construction de Bases, utilisant de la Dualite",2,574,1,QCM,0.62,0.27,14.0,5,33,38,12,5,7,3.17,41.67,Difficile,Difficile,0,Meme Difficulté,Pas Adapte
5017,2019,Mathematique,1,L'Algebre Lineaire,6,"Calcul de Dimensions et Construction de Bases, utilisant de la Dualite",2,574,1,QCM,0.38,0.39,60.0,23,16,39,34,23,11,1.15,67.65,Facile,Moyen,-1,Plus Difficile,Pas Adapte
6128,2020,Mathematique,1,L'Algebre Lineaire,6,"Calcul de Dimensions et Construction de Bases, utilisant de la Dualite",2,574,1,QCM,0.5,0.33,64.0,22,13,35,32,22,10,1.09,68.75,Moyen,Moyen,0,Meme Difficulté,Pas Adapte
574,2015,Mathematique,1,L'Algebre Lineaire,6,"Calcul de Dimensions et Construction de Bases, utilisant de la Dualite",2,575,2,QCU,0.46,0.26,32.0,6,14,20,10,6,4,2.0,60.0,Difficile,Difficile,0,Meme Difficulté,Pas Adapte
1685,2016,Mathematique,1,L'Algebre Lineaire,6,"Calcul de Dimensions et Construction de Bases, utilisant de la Dualite",2,575,2,QCU,0.4,0.6,37.0,8,14,22,17,8,9,1.29,47.06,Facile,Moyen,-1,Plus Difficile,Pas Adapte
2796,2017,Mathematique,1,L'Algebre Lineaire,6,"Calcul de Dimensions et Construction de Bases, utilisant de la Dualite",2,575,2,QCU,0.39,0.64,38.0,9,14,23,13,9,4,1.77,69.23,Difficile,Moyen,1,Plus Facile,Pas Adapte
3907,2018,Mathematique,1,L'Algebre Lineaire,6,"Calcul de Dimensions et Construction de Bases, utilisant de la Dualite",2,575,2,QCU,0.29,0.58,46.0,12,14,26,23,12,11,1.13,52.17,Difficile,Moyen,1,Plus Facile,Pas Adapte
5018,2019,Mathematique,1,L'Algebre Lineaire,6,"Calcul de Dimensions et Construction de Bases, utilisant de la Dualite",2,575,2,QCU,0.09,0.89,66.0,18,10,28,27,18,9,1.04,66.67,Difficile,Facile,2,Beaucoup plus Facile,Adapte
6129,2020,Mathematique,1,L'Algebre Lineaire,6,"Calcul de Dimensions et Construction de Bases, utilisant de la Dualite",2,575,2,QCU,0.16,0.75,66.0,21,11,32,22,21,1,1.45,95.45,Facile,Facile,0,Meme Difficulté,Adapte
575,2015,Mathematique,2,Le Calcul d'Integral,1,Les Divers Types d'Integrale,14,576,1,QCM,0.61,0.21,29.0,5,11,16,13,5,8,1.23,38.46,Moyen,Difficile,-1,Plus Difficile,Pas Adapte
1686,2016,Mathematique,2,Le Calcul d'Integral,1,Les Divers Types d'Integrale,14,576,1,QCU,0.14,0.93,66.0,9,5,14,12,9,3,1.17,75.0,Difficile,Facile,2,Beaucoup plus Facile,Adapte
2797,2017,Mathematique,2,Le Calcul d'Integral,1,Les Divers Types d'Integrale,14,576,1,QROC,0.08,0.5,66.0,11,5,16,13,11,2,1.23,84.62,Facile,Facile,0,Meme Difficulté,Adapte
3908,2018,Mathematique,2,Le Calcul d'Integral,1,Les Divers Types d'Integrale,14,576,1,QROC,0.12,0.55,66.0,10,5,15,12,10,2,1.25,83.33,Facile,Facile,0,Meme Difficulté,Adapte
5019,2019,Mathematique,2,Le Calcul d'Integral,1,Les Divers Types d'Integrale,14,576,1,QO,0.05,0.39,66.0,9,5,14,12,9,3,1.17,75.0,Facile,Facile,0,Meme Difficulté,Adapte
6130,2020,Mathematique,2,Le Calcul d'Integral,1,Les Divers Types d'Integrale,14,576,1,QO,0.12,0.71,66.0,8,4,12,11,8,3,1.09,72.73,Facile,Facile,0,Meme Difficulté,Adapte
576,2015,Mathematique,2,Le Calcul d'Integral,1,Les Divers Types d'Integrale,14,577,2,QCU,0.64,0.32,21.0,2,8,10,4,2,2,2.5,50.0,Difficile,Difficile,0,Meme Difficulté,Pas Adapte
1687,2016,Mathematique,2,Le Calcul d'Integral,1,Les Divers Types d'Integrale,14,577,2,QCU,0.29,0.72,62.0,6,3,9,8,6,2,1.12,75.0,Facile,Moyen,-1,Plus Difficile,Pas Adapte
2798,2017,Mathematique,2,Le Calcul d'Integral,1,Les Divers Types d'Integrale,14,577,2,QCM,0.69,0.28,13.0,1,9,10,4,1,3,2.5,25.0,Facile,Difficile,-2,Beaucoup plus Difficile,Pas Adapte
3909,2018,Mathematique,2,Le Calcul d'Integral,1,Les Divers Types d'Integrale,14,577,2,QCM,0.33,0.47,42.0,5,7,12,11,5,6,1.09,45.45,Moyen,Moyen,0,Meme Difficulté,Pas Adapte
5020,2019,Mathematique,2,Le Calcul d'Integral,1,Les Divers Types d'Integrale,14,577,2,QCM,0.79,0.29,14.0,1,9,10,10,1,9,1.0,10.0,Difficile,Difficile,0,Meme Difficulté,Pas Adapte
6131,2020,Mathematique,2,Le Calcul d'Integral,1,Les Divers Types d'Integrale,14,577,2,QCM,0.54,0.29,22.0,2,9,11,3,2,1,3.67,66.67,Difficile,Difficile,0,Meme Difficulté,Pas Adapte
577,2015,Mathematique,2,Le Calcul d'Integral,1,Les Divers Types d'Integrale,14,578,3,QROC,0.63,0.0,25.0,14,41,55,28,14,14,1.96,50.0,Difficile,Difficile,0,Meme Difficulté,Pas Adapte
1688,2016,Mathematique,2,Le Calcul d'Integral,1,Les Divers Types d'Integrale,14,578,3,QROC,0.67,0.02,24.0,13,40,53,50,13,37,1.06,26.0,Difficile,Difficile,0,Meme Difficulté,Pas Adapte
2799,2017,Mathematique,2,Le Calcul d'Integral,1,Les Divers Types d'Integrale,14,578,3,QROC,0.54,0.35,55.0,31,26,57,34,31,3,1.68,91.18,Moyen,Moyen,0,Meme Difficulté,Pas Adapte
3910,2018,Mathematique,2,Le Calcul d'Integral,1,Les Divers Types d'Integrale,14,578,3,QROC,0.45,0.28,49.0,28,30,58,34,28,6,1.71,82.35,Facile,Moyen,-1,Plus Difficile,Pas Adapte
5021,2019,Mathematique,2,Le Calcul d'Integral,1,Les Divers Types d'Integrale,14,578,3,QROC,0.78,0.1,1.0,1,59,60,42,1,41,1.43,2.38,Moyen,Difficile,-1,Plus Difficile,Pas Adapte
6132,2020,Mathematique,2,Le Calcul d'Integral,1,Les Divers Types d'Integrale,14,578,3,QROC,0.83,0.17,18.0,12,56,68,59,12,47,1.15,20.34,Difficile,Difficile,0,Meme Difficulté,Pas Adapte
578,2015,Mathematique,2,Le Calcul d'Integral,1,Les Divers Types d'Integrale,14,579,4,QCU,0.29,0.47,39.0,38,59,97,54,38,16,1.8,70.37,Facile,Moyen,-1,Plus Difficile,Pas Adapte
1689,2016,Mathematique,2,Le Calcul d'Integral,1,Les Divers Types d'Integrale,14,579,4,QCU,0.58,0.22,23.0,19,63,82,71,19,52,1.15,26.76,Moyen,Difficile,-1,Plus Difficile,Pas Adapte
2800,2017,Mathematique,2,Le Calcul d'Integral,1,Les Divers Types d'Integrale,14,579,4,QCU,0.51,0.27,6.0,4,66,70,26,4,22,2.69,15.38,Difficile,Difficile,0,Meme Difficulté,Pas Adapte
3911,2018,Mathematique,2,Le Calcul d'Integral,1,Les Divers Types d'Integrale,14,579,4,QCU,0.42,0.37,1.0,1,74,75,60,1,59,1.25,1.67,Difficile,Difficile,0,Meme Difficulté,Pas Adapte
5022,2019,Mathematique,2,Le Calcul d'Integral,1,Les Divers Types d'Integrale,14,579,4,QCU,0.47,0.32,14.0,10,58,68,24,10,14,2.83,41.67,Facile,Difficile,-2,Beaucoup plus Difficile,Pas Adapte
6133,2020,Mathematique,2,Le Calcul d'Integral,1,Les Divers Types d'Integrale,14,579,4,QCU,0.59,0.39,7.0,5,66,71,40,5,35,1.77,12.5,Moyen,Difficile,-1,Plus Difficile,Pas Adapte
579,2015,Mathematique,2,Le Calcul d'Integral,1,Les Divers Types d'Integrale,14,580,5,QCM,0.73,0.3,31.0,22,49,71,61,22,39,1.16,36.07,Difficile,Difficile,0,Meme Difficulté,Pas Adapte
1690,2016,Mathematique,2,Le Calcul d'Integral,1,Les Divers Types d'Integrale,14,580,5,QCU,0.22,0.41,40.0,30,46,76,36,30,6,2.11,83.33,Difficile,Moyen,1,Plus Facile,Pas Adapte
2801,2017,Mathematique,2,Le Calcul d'Integral,1,Les Divers Types d'Integrale,14,580,5,QCU,0.63,0.31,8.0,6,70,76,43,6,37,1.77,13.95,Facile,Difficile,-2,Beaucoup plus Difficile,Pas Adapte
3912,2018,Mathematique,2,Le Calcul d'Integral,1,Les Divers Types d'Integrale,14,580,5,QCM,0.58,0.23,8.0,5,62,67,53,5,48,1.26,9.43,Difficile,Difficile,0,Meme Difficulté,Pas Adapte
5023,2019,Mathematique,2,Le Calcul d'Integral,1,Les Divers Types d'Integrale,14,580,5,QCU,0.64,0.37,21.0,13,47,60,44,13,31,1.36,29.55,Difficile,Difficile,0,Meme Difficulté,Pas Adapte
6134,2020,Mathematique,2,Le Calcul d'Integral,1,Les Divers Types d'Integrale,14,580,5,QCM,0.4,0.58,39.0,21,34,55,38,21,17,1.45,55.26,Difficile,Moyen,1,Plus Facile,Pas Adapte
580,2015,Mathematique,2,Le Calcul d'Integral,1,Les Divers Types d'Integrale,14,581,6,QCU,0.64,0.23,7.0,3,38,41,30,3,27,1.37,10.0,Moyen,Difficile,-1,Plus Difficile,Pas Adapte
1691,2016,Mathematique,2,Le Calcul d'Integral,1,Les Divers Types d'Integrale,14,581,6,QCU,0.69,0.28,27.0,12,33,45,37,12,25,1.22,32.43,Facile,Difficile,-2,Beaucoup plus Difficile,Pas Adapte
2802,2017,Mathematique,2,Le Calcul d'Integral,1,Les Divers Types d'Integrale,14,581,6,QCU,0.35,0.62,57.0,29,22,51,31,29,2,1.65,93.55,Moyen,Moyen,0,Meme Difficulté,Pas Adapte
3913,2018,Mathematique,2,Le Calcul d'Integral,1,Les Divers Types d'Integrale,14,581,6,QCU,0.1,0.81,67.0,30,15,45,34,30,4,1.32,88.24,Moyen,Facile,1,Plus Facile,Adapte
5024,2019,Mathematique,2,Le Calcul d'Integral,1,Les Divers Types d'Integrale,14,581,6,QCU,0.03,0.78,67.0,34,17,51,45,34,11,1.13,75.56,Facile,Facile,0,Meme Difficulté,Adapte
6135,2020,Mathematique,2,Le Calcul d'Integral,1,Les Divers Types d'Integrale,14,581,6,QCU,0.05,0.8,67.0,38,19,57,51,38,13,1.12,74.51,Facile,Facile,0,Meme Difficulté,Adapte
581,2015,Mathematique,2,Le Calcul d'Integral,1,Les Divers Types d'Integrale,14,582,7,QROC,0.22,0.37,58.0,39,28,67,45,39,6,1.49,86.67,Difficile,Moyen,1,Plus Facile,Pas Adapte
1692,2016,Mathematique,2,Le Calcul d'Integral,1,Les Divers Types d'Integrale,14,582,7,QROC,0.36,0.36,37.0,27,46,73,37,27,10,1.97,72.97,Difficile,Moyen,1,Plus Facile,Pas Adapte
2803,2017,Mathematique,2,Le Calcul d'Integral,1,Les Divers Types d'Integrale,14,582,7,QROC,0.94,0.01,15.0,13,71,84,45,13,32,1.87,28.89,Difficile,Difficile,0,Meme Difficulté,Pas Adapte
3914,2018,Mathematique,2,Le Calcul d'Integral,1,Les Divers Types d'Integrale,14,582,7,QROC,0.23,0.27,59.0,57,40,97,76,57,19,1.28,75.0,Facile,Moyen,-1,Plus Difficile,Pas Adapte
5025,2019,Mathematique,2,Le Calcul d'Integral,1,Les Divers Types d'Integrale,14,582,7,QROC,0.62,0.24,22.0,25,87,112,50,25,25,2.24,50.0,Difficile,Difficile,0,Meme Difficulté,Pas Adapte
6136,2020,Mathematique,2,Le Calcul d'Integral,1,Les Divers Types d'Integrale,14,582,7,QROC,0.56,0.35,50.0,54,53,107,71,54,17,1.51,76.06,Moyen,Moyen,0,Meme Difficulté,Pas Adapte
582,2015,Mathematique,2,Le Calcul d'Integral,1,Les Divers Types d'Integrale,14,583,8,QROC,0.23,0.36,50.0,6,6,12,8,6,2,1.5,75.0,Facile,Moyen,-1,Plus Difficile,Pas Adapte
1693,2016,Mathematique,2,Le Calcul d'Integral,1,Les Divers Types d'Integrale,14,583,8,QROC,0.92,0.04,15.0,2,12,14,7,2,5,2.0,28.57,Moyen,Difficile,-1,Plus Difficile,Pas Adapte
2804,2017,Mathematique,2,Le Calcul d'Integral,1,Les Divers Types d'Integrale,14,583,8,QROC,0.34,0.25,46.0,7,9,16,10,7,3,1.6,70.0,Facile,Moyen,-1,Plus Difficile,Pas Adapte
3915,2018,Mathematique,2,Le Calcul d'Integral,1,Les Divers Types d'Integrale,14,583,8,QROC,0.46,0.37,50.0,8,9,17,10,8,2,1.7,80.0,Difficile,Moyen,1,Plus Facile,Pas Adapte
5026,2019,Mathematique,2,Le Calcul d'Integral,1,Les Divers Types d'Integrale,14,583,8,QROC,0.63,0.03,1.0,0,15,15,14,0,14,1.07,0.0,Facile,Difficile,-2,Beaucoup plus Difficile,Pas Adapte
6137,2020,Mathematique,2,Le Calcul d'Integral,1,Les Divers Types d'Integrale,14,583,8,QROC,0.33,0.33,58.0,9,7,16,14,9,5,1.14,64.29,Difficile,Moyen,1,Plus Facile,Pas Adapte
583,2015,Mathematique,2,Le Calcul d'Integral,1,Les Divers Types d'Integrale,14,584,9,QCM,0.51,0.22,2.0,2,91,93,84,2,82,1.11,2.38,Moyen,Difficile,-1,Plus Difficile,Pas Adapte
1694,2016,Mathematique,2,Le Calcul d'Integral,1,Les Divers Types d'Integrale,14,584,9,QCM,0.24,0.62,48.0,51,56,107,104,51,53,1.03,49.04,Facile,Moyen,-1,Plus Difficile,Pas Adapte
2805,2017,Mathematique,2,Le Calcul d'Integral,1,Les Divers Types d'Integrale,14,584,9,QCM,0.34,0.69,41.0,50,71,121,84,50,34,1.44,59.52,Difficile,Moyen,1,Plus Facile,Pas Adapte
3916,2018,Mathematique,2,Le Calcul d'Integral,1,Les Divers Types d'Integrale,14,584,9,QCM,0.64,0.28,11.0,13,103,116,40,13,27,2.9,32.5,Difficile,Difficile,0,Meme Difficulté,Pas Adapte
5027,2019,Mathematique,2,Le Calcul d'Integral,1,Les Divers Types d'Integrale,14,584,9,QCM,0.37,0.47,57.0,67,51,118,115,67,48,1.03,58.26,Moyen,Moyen,0,Meme Difficulté,Pas Adapte
6138,2020,Mathematique,2,Le Calcul d'Integral,1,Les Divers Types d'Integrale,14,584,9,QCM,0.6,0.24,28.0,38,97,135,94,38,56,1.44,40.43,Facile,Difficile,-2,Beaucoup plus Difficile,Pas Adapte
584,2015,Mathematique,2,Le Calcul d'Integral,1,Les Divers Types d'Integrale,14,585,10,QCM,0.71,0.28,8.0,5,52,57,42,5,37,1.36,11.9,Difficile,Difficile,0,Meme Difficulté,Pas Adapte
1695,2016,Mathematique,2,Le Calcul d'Integral,1,Les Divers Types d'Integrale,14,585,10,QCU,0.3,0.6,44.0,25,31,56,54,25,29,1.04,46.3,Moyen,Moyen,0,Meme Difficulté,Pas Adapte
2806,2017,Mathematique,2,Le Calcul d'Integral,1,Les Divers Types d'Integrale,14,585,10,QCM,0.37,0.52,39.0,23,36,59,47,23,24,1.26,48.94,Facile,Moyen,-1,Plus Difficile,Pas Adapte
3917,2018,Mathematique,2,Le Calcul d'Integral,1,Les Divers Types d'Integrale,14,585,10,QCM,0.6,0.28,20.0,10,41,51,41,10,31,1.24,24.39,Facile,Difficile,-2,Beaucoup plus Difficile,Pas Adapte
5028,2019,Mathematique,2,Le Calcul d'Integral,1,Les Divers Types d'Integrale,14,585,10,QCM,0.33,0.5,49.0,28,29,57,31,28,3,1.84,90.32,Facile,Moyen,-1,Plus Difficile,Pas Adapte
6139,2020,Mathematique,2,Le Calcul d'Integral,1,Les Divers Types d'Integrale,14,585,10,QCM,0.45,0.5,45.0,29,35,64,45,29,16,1.42,64.44,Moyen,Moyen,0,Meme Difficulté,Pas Adapte
585,2015,Mathematique,2,Le Calcul d'Integral,1,Les Divers Types d'Integrale,14,586,11,QCU,0.49,0.29,23.0,16,52,68,52,16,36,1.31,30.77,Difficile,Difficile,0,Meme Difficulté,Pas Adapte
1696,2016,Mathematique,2,Le Calcul d'Integral,1,Les Divers Types d'Integrale,14,586,11,QCU,0.4,0.3,19.0,15,62,77,35,15,20,2.2,42.86,Moyen,Difficile,-1,Plus Difficile,Pas Adapte
2807,2017,Mathematique,2,Le Calcul d'Integral,1,Les Divers Types d'Integrale,14,586,11,QCU,0.58,0.22,9.0,7,69,76,42,7,35,1.81,16.67,Difficile,Difficile,0,Meme Difficulté,Pas Adapte
3918,2018,Mathematique,2,Le Calcul d'Integral,1,Les Divers Types d'Integrale,14,586,11,QCU,0.37,0.62,56.0,39,30,69,54,39,15,1.28,72.22,Difficile,Moyen,1,Plus Facile,Pas Adapte
5029,2019,Mathematique,2,Le Calcul d'Integral,1,Les Divers Types d'Integrale,14,586,11,QCU,0.21,0.63,47.0,37,41,78,41,37,4,1.9,90.24,Facile,Moyen,-1,Plus Difficile,Pas Adapte
6140,2020,Mathematique,2,Le Calcul d'Integral,1,Les Divers Types d'Integrale,14,586,11,QCU,0.33,0.69,39.0,35,54,89,53,35,18,1.68,66.04,Moyen,Moyen,0,Meme Difficulté,Pas Adapte
586,2015,Mathematique,2,Le Calcul d'Integral,1,Les Divers Types d'Integrale,14,587,12,QCM,0.58,0.2,11.0,4,29,33,15,4,11,2.2,26.67,Facile,Difficile,-2,Beaucoup plus Difficile,Pas Adapte
1697,2016,Mathematique,2,Le Calcul d'Integral,1,Les Divers Types d'Integrale,14,587,12,QCM,0.55,0.26,24.0,9,27,36,35,9,26,1.03,25.71,Difficile,Difficile,0,Meme Difficulté,Pas Adapte
2808,2017,Mathematique,2,Le Calcul d'Integral,1,Les Divers Types d'Integrale,14,587,12,QCM,0.65,0.3,21.0,8,32,40,39,8,31,1.03,20.51,Facile,Difficile,-2,Beaucoup plus Difficile,Pas Adapte
3919,2018,Mathematique,2,Le Calcul d'Integral,1,Les Divers Types d'Integrale,14,587,12,QCM,0.25,0.55,54.0,22,19,41,27,22,5,1.52,81.48,Facile,Moyen,-1,Plus Difficile,Pas Adapte
5030,2019,Mathematique,2,Le Calcul d'Integral,1,Les Divers Types d'Integrale,14,587,12,QCM,0.1,0.89,66.0,23,12,35,24,23,1,1.46,95.83,Moyen,Facile,1,Plus Facile,Adapte
6141,2020,Mathematique,2,Le Calcul d'Integral,1,Les Divers Types d'Integrale,14,587,12,QCM,0.01,0.96,66.0,23,12,35,31,23,8,1.13,74.19,Facile,Facile,0,Meme Difficulté,Adapte
587,2015,Mathematique,2,Le Calcul d'Integral,1,Les Divers Types d'Integrale,14,588,13,QCM,0.42,0.34,59.0,50,35,85,58,50,8,1.47,86.21,Difficile,Moyen,1,Plus Facile,Pas Adapte
1698,2016,Mathematique,2,Le Calcul d'Integral,1,Les Divers Types d'Integrale,14,588,13,QCU,0.5,0.37,7.0,6,77,83,52,6,46,1.6,11.54,Facile,Difficile,-2,Beaucoup plus Difficile,Pas Adapte
2809,2017,Mathematique,2,Le Calcul d'Integral,1,Les Divers Types d'Integrale,14,588,13,QCU,0.68,0.32,12.0,9,68,77,74,9,65,1.04,12.16,Facile,Difficile,-2,Beaucoup plus Difficile,Pas Adapte
3920,2018,Mathematique,2,Le Calcul d'Integral,1,Les Divers Types d'Integrale,14,588,13,QCU,0.25,0.75,45.0,38,46,84,39,38,1,2.15,97.44,Difficile,Moyen,1,Plus Facile,Pas Adapte
5031,2019,Mathematique,2,Le Calcul d'Integral,1,Les Divers Types d'Integrale,14,588,13,QCU,0.41,0.35,12.0,11,84,95,32,11,21,2.97,34.38,Difficile,Difficile,0,Meme Difficulté,Pas Adapte
6142,2020,Mathematique,2,Le Calcul d'Integral,1,Les Divers Types d'Integrale,14,588,13,QCM,0.26,0.3,49.0,42,44,86,72,42,30,1.19,58.33,Facile,Moyen,-1,Plus Difficile,Pas Adapte
588,2015,Mathematique,2,Le Calcul d'Integral,1,Les Divers Types d'Integrale,14,589,14,QROC,0.44,0.39,60.0,42,28,70,51,42,9,1.37,82.35,Facile,Moyen,-1,Plus Difficile,Pas Adapte
1699,2016,Mathematique,2,Le Calcul d'Integral,1,Les Divers Types d'Integrale,14,589,14,QCU,0.64,0.3,33.0,24,50,74,44,24,20,1.68,54.55,Moyen,Difficile,-1,Plus Difficile,Pas Adapte
2810,2017,Mathematique,2,Le Calcul d'Integral,1,Les Divers Types d'Integrale,14,589,14,QCU,0.21,0.69,55.0,45,36,81,69,45,24,1.17,65.22,Facile,Moyen,-1,Plus Difficile,Pas Adapte
3921,2018,Mathematique,2,Le Calcul d'Integral,1,Les Divers Types d'Integrale,14,589,14,QCU,0.42,0.25,10.0,8,75,83,71,8,63,1.17,11.27,Moyen,Difficile,-1,Plus Difficile,Pas Adapte
5032,2019,Mathematique,2,Le Calcul d'Integral,1,Les Divers Types d'Integrale,14,589,14,QCU,0.37,0.69,37.0,29,50,79,31,29,2,2.55,93.55,Facile,Moyen,-1,Plus Difficile,Pas Adapte
6143,2020,Mathematique,2,Le Calcul d'Integral,1,Les Divers Types d'Integrale,14,589,14,QCM,0.31,0.56,40.0,31,47,78,65,31,34,1.2,47.69,Moyen,Moyen,0,Meme Difficulté,Pas Adapte
589,2015,Mathematique,2,Le Calcul d'Integral,2,Les Methodes Generales d'Integration,7,590,1,QCM,0.43,0.42,61.0,56,35,91,62,56,6,1.47,90.32,Facile,Moyen,-1,Plus Difficile,Pas Adapte
1700,2016,Mathematique,2,Le Calcul d'Integral,2,Les Methodes Generales d'Integration,7,590,1,QCM,0.47,0.52,47.0,41,46,87,67,41,26,1.3,61.19,Moyen,Moyen,0,Meme Difficulté,Pas Adapte
2811,2017,Mathematique,2,Le Calcul d'Integral,2,Les Methodes Generales d'Integration,7,590,1,QCM,0.3,0.65,47.0,43,49,92,69,43,26,1.33,62.32,Moyen,Moyen,0,Meme Difficulté,Pas Adapte
3922,2018,Mathematique,2,Le Calcul d'Integral,2,Les Methodes Generales d'Integration,7,590,1,QCM,0.57,0.19,25.0,21,62,83,69,21,48,1.2,30.43,Difficile,Difficile,0,Meme Difficulté,Pas Adapte
5033,2019,Mathematique,2,Le Calcul d'Integral,2,Les Methodes Generales d'Integration,7,590,1,QCU,0.43,0.27,15.0,12,69,81,48,12,36,1.69,25.0,Moyen,Difficile,-1,Plus Difficile,Pas Adapte
6144,2020,Mathematique,2,Le Calcul d'Integral,2,Les Methodes Generales d'Integration,7,590,1,QCU,0.51,0.27,18.0,12,57,69,23,12,11,3.0,52.17,Moyen,Difficile,-1,Plus Difficile,Pas Adapte
590,2015,Mathematique,2,Le Calcul d'Integral,2,Les Methodes Generales d'Integration,7,591,2,QCU,0.35,0.7,46.0,41,48,89,83,41,42,1.07,49.4,Facile,Moyen,-1,Plus Difficile,Pas Adapte
1701,2016,Mathematique,2,Le Calcul d'Integral,2,Les Methodes Generales d'Integration,7,591,2,QCU,0.31,0.49,38.0,30,48,78,30,30,0,2.6,100.0,Difficile,Moyen,1,Plus Facile,Pas Adapte
2812,2017,Mathematique,2,Le Calcul d'Integral,2,Les Methodes Generales d'Integration,7,591,2,QCU,0.7,0.33,13.0,10,70,80,67,10,57,1.19,14.93,Moyen,Difficile,-1,Plus Difficile,Pas Adapte
3923,2018,Mathematique,2,Le Calcul d'Integral,2,Les Methodes Generales d'Integration,7,591,2,QCU,0.2,0.45,61.0,44,28,72,60,44,16,1.2,73.33,Difficile,Moyen,1,Plus Facile,Pas Adapte
5034,2019,Mathematique,2,Le Calcul d'Integral,2,Les Methodes Generales d'Integration,7,591,2,QCU,0.46,0.4,22.0,16,57,73,39,16,23,1.87,41.03,Difficile,Difficile,0,Meme Difficulté,Pas Adapte
6145,2020,Mathematique,2,Le Calcul d'Integral,2,Les Methodes Generales d'Integration,7,591,2,QCM,0.11,0.72,69.0,45,20,65,51,45,6,1.27,88.24,Difficile,Facile,2,Beaucoup plus Facile,Adapte
591,2015,Mathematique,2,Le Calcul d'Integral,2,Les Methodes Generales d'Integration,7,592,3,QCU,0.54,0.38,20.0,2,7,9,5,2,3,1.8,40.0,Moyen,Difficile,-1,Plus Difficile,Pas Adapte
1702,2016,Mathematique,2,Le Calcul d'Integral,2,Les Methodes Generales d'Integration,7,592,3,QCM,0.3,0.47,50.0,4,4,8,6,4,2,1.33,66.67,Moyen,Moyen,0,Meme Difficulté,Pas Adapte
2813,2017,Mathematique,2,Le Calcul d'Integral,2,Les Methodes Generales d'Integration,7,592,3,QCM,0.53,0.19,21.0,2,6,8,3,2,1,2.67,66.67,Moyen,Difficile,-1,Plus Difficile,Pas Adapte
3924,2018,Mathematique,2,Le Calcul d'Integral,2,Les Methodes Generales d'Integration,7,592,3,QCM,0.49,0.59,61.0,5,4,9,8,5,3,1.12,62.5,Facile,Moyen,-1,Plus Difficile,Pas Adapte
5035,2019,Mathematique,2,Le Calcul d'Integral,2,Les Methodes Generales d'Integration,7,592,3,QCM,0.58,0.26,4.0,0,10,10,9,0,9,1.11,0.0,Difficile,Difficile,0,Meme Difficulté,Pas Adapte
6146,2020,Mathematique,2,Le Calcul d'Integral,2,Les Methodes Generales d'Integration,7,592,3,QCU,0.67,0.36,16.0,2,10,12,9,2,7,1.33,22.22,Facile,Difficile,-2,Beaucoup plus Difficile,Pas Adapte
592,2015,Mathematique,2,Le Calcul d'Integral,2,Les Methodes Generales d'Integration,7,593,4,QO,0.6,0.16,53.0,42,38,80,70,42,28,1.14,60.0,Facile,Moyen,-1,Plus Difficile,Pas Adapte
1703,2016,Mathematique,2,Le Calcul d'Integral,2,Les Methodes Generales d'Integration,7,593,4,QCM,0.24,0.52,55.0,46,38,84,54,46,8,1.56,85.19,Moyen,Moyen,0,Meme Difficulté,Pas Adapte
2814,2017,Mathematique,2,Le Calcul d'Integral,2,Les Methodes Generales d'Integration,7,593,4,QCM,0.44,0.42,42.0,32,45,77,46,32,14,1.67,69.57,Facile,Moyen,-1,Plus Difficile,Pas Adapte
3925,2018,Mathematique,2,Le Calcul d'Integral,2,Les Methodes Generales d'Integration,7,593,4,QCM,0.59,0.21,12.0,9,70,79,67,9,58,1.18,13.43,Facile,Difficile,-2,Beaucoup plus Difficile,Pas Adapte
5036,2019,Mathematique,2,Le Calcul d'Integral,2,Les Methodes Generales d'Integration,7,593,4,QCM,0.37,0.55,53.0,39,34,73,41,39,2,1.78,95.12,Facile,Moyen,-1,Plus Difficile,Pas Adapte
6147,2020,Mathematique,2,Le Calcul d'Integral,2,Les Methodes Generales d'Integration,7,593,4,QCM,0.57,0.22,23.0,15,49,64,59,15,44,1.08,25.42,Moyen,Difficile,-1,Plus Difficile,Pas Adapte
593,2015,Mathematique,2,Le Calcul d'Integral,2,Les Methodes Generales d'Integration,7,594,5,QCM,0.53,0.18,24.0,11,36,47,30,11,19,1.57,36.67,Difficile,Difficile,0,Meme Difficulté,Pas Adapte
1704,2016,Mathematique,2,Le Calcul d'Integral,2,Les Methodes Generales d'Integration,7,594,5,QCM,0.35,0.44,45.0,24,29,53,50,24,26,1.06,48.0,Moyen,Moyen,0,Meme Difficulté,Pas Adapte
2815,2017,Mathematique,2,Le Calcul d'Integral,2,Les Methodes Generales d'Integration,7,594,5,QCM,0.71,0.18,27.0,15,41,56,40,15,25,1.4,37.5,Moyen,Difficile,-1,Plus Difficile,Pas Adapte
3926,2018,Mathematique,2,Le Calcul d'Integral,2,Les Methodes Generales d'Integration,7,594,5,QCM,0.38,0.69,48.0,27,29,56,42,27,15,1.33,64.29,Moyen,Moyen,0,Meme Difficulté,Pas Adapte
5037,2019,Mathematique,2,Le Calcul d'Integral,2,Les Methodes Generales d'Integration,7,594,5,QCM,0.28,0.32,44.0,28,35,63,34,28,6,1.85,82.35,Difficile,Moyen,1,Plus Facile,Pas Adapte
6148,2020,Mathematique,2,Le Calcul d'Integral,2,Les Methodes Generales d'Integration,7,594,5,QCM,0.52,0.23,30.0,21,50,71,33,21,12,2.15,63.64,Facile,Difficile,-2,Beaucoup plus Difficile,Pas Adapte
594,2015,Mathematique,2,Le Calcul d'Integral,2,Les Methodes Generales d'Integration,7,595,6,QCM,0.36,0.49,61.0,49,32,81,61,49,12,1.33,80.33,Difficile,Moyen,1,Plus Facile,Pas Adapte
1705,2016,Mathematique,2,Le Calcul d'Integral,2,Les Methodes Generales d'Integration,7,595,6,QCM,0.55,0.19,25.0,20,61,81,77,20,57,1.05,25.97,Facile,Difficile,-2,Beaucoup plus Difficile,Pas Adapte
2816,2017,Mathematique,2,Le Calcul d'Integral,2,Les Methodes Generales d'Integration,7,595,6,QCM,0.74,0.17,0.0,0,88,88,42,0,42,2.1,0.0,Moyen,Difficile,-1,Plus Difficile,Pas Adapte
3927,2018,Mathematique,2,Le Calcul d'Integral,2,Les Methodes Generales d'Integration,7,595,6,QCU,0.22,0.59,48.0,38,41,79,51,38,13,1.55,74.51,Difficile,Moyen,1,Plus Facile,Pas Adapte
5038,2019,Mathematique,2,Le Calcul d'Integral,2,Les Methodes Generales d'Integration,7,595,6,QCU,0.72,0.28,33.0,23,46,69,66,23,43,1.05,34.85,Difficile,Difficile,0,Meme Difficulté,Pas Adapte
6149,2020,Mathematique,2,Le Calcul d'Integral,2,Les Methodes Generales d'Integration,7,595,6,QCU,0.72,0.37,29.0,18,43,61,61,18,43,1.0,29.51,Facile,Difficile,-2,Beaucoup plus Difficile,Pas Adapte
595,2015,Mathematique,2,Le Calcul d'Integral,2,Les Methodes Generales d'Integration,7,596,7,QCU,0.1,0.96,67.0,23,11,34,30,23,7,1.13,76.67,Facile,Facile,0,Meme Difficulté,Adapte
1706,2016,Mathematique,2,Le Calcul d'Integral,2,Les Methodes Generales d'Integration,7,596,7,QCU,0.11,0.99,67.0,23,11,34,25,23,2,1.36,92.0,Facile,Facile,0,Meme Difficulté,Adapte
2817,2017,Mathematique,2,Le Calcul d'Integral,2,Les Methodes Generales d'Integration,7,596,7,QCU,0.03,0.77,67.0,22,11,33,32,22,10,1.03,68.75,Facile,Facile,0,Meme Difficulté,Adapte
3928,2018,Mathematique,2,Le Calcul d'Integral,2,Les Methodes Generales d'Integration,7,596,7,QCU,0.11,0.93,67.0,23,12,35,23,23,0,1.52,100.0,Facile,Facile,0,Meme Difficulté,Adapte
5039,2019,Mathematique,2,Le Calcul d'Integral,2,Les Methodes Generales d'Integration,7,596,7,QCU,0.19,0.89,67.0,26,13,39,37,26,11,1.05,70.27,Facile,Facile,0,Meme Difficulté,Adapte
6150,2020,Mathematique,2,Le Calcul d'Integral,2,Les Methodes Generales d'Integration,7,596,7,QCU,0.05,0.89,67.0,30,15,45,39,30,9,1.15,76.92,Facile,Facile,0,Meme Difficulté,Adapte
596,2015,Mathematique,2,Le Calcul d'Integral,3,Integration des Fractions Rationnelles,8,597,1,QCM,0.56,0.26,5.0,1,10,11,5,1,4,2.2,20.0,Difficile,Difficile,0,Meme Difficulté,Pas Adapte
1707,2016,Mathematique,2,Le Calcul d'Integral,3,Integration des Fractions Rationnelles,8,597,1,QCM,0.75,0.29,19.0,2,11,13,7,2,5,1.86,28.57,Moyen,Difficile,-1,Plus Difficile,Pas Adapte
2818,2017,Mathematique,2,Le Calcul d'Integral,3,Integration des Fractions Rationnelles,8,597,1,QCM,0.77,0.25,15.0,2,13,15,10,2,8,1.5,20.0,Facile,Difficile,-2,Beaucoup plus Difficile,Pas Adapte
3929,2018,Mathematique,2,Le Calcul d'Integral,3,Integration des Fractions Rationnelles,8,597,1,QCM,0.52,0.27,19.0,3,13,16,9,3,6,1.78,33.33,Difficile,Difficile,0,Meme Difficulté,Pas Adapte
5040,2019,Mathematique,2,Le Calcul d'Integral,3,Integration des Fractions Rationnelles,8,597,1,QCM,0.57,0.23,16.0,3,15,18,8,3,5,2.25,37.5,Facile,Difficile,-2,Beaucoup plus Difficile,Pas Adapte
6151,2020,Mathematique,2,Le Calcul d'Integral,3,Integration des Fractions Rationnelles,8,597,1,QCM,0.24,0.36,45.0,8,9,17,10,8,2,1.7,80.0,Facile,Moyen,-1,Plus Difficile,Pas Adapte
597,2015,Mathematique,2,Le Calcul d'Integral,3,Integration des Fractions Rationnelles,8,598,2,QCU,0.64,0.28,6.0,4,59,63,55,4,51,1.15,7.27,Difficile,Difficile,0,Meme Difficulté,Pas Adapte
1708,2016,Mathematique,2,Le Calcul d'Integral,3,Integration des Fractions Rationnelles,8,598,2,QCU,0.45,0.27,1.0,1,56,57,39,1,38,1.46,2.56,Difficile,Difficile,0,Meme Difficulté,Pas Adapte
2819,2017,Mathematique,2,Le Calcul d'Integral,3,Integration des Fractions Rationnelles,8,598,2,QCU,0.33,0.5,47.0,29,32,61,38,29,9,1.61,76.32,Moyen,Moyen,0,Meme Difficulté,Pas Adapte
3930,2018,Mathematique,2,Le Calcul d'Integral,3,Integration des Fractions Rationnelles,8,598,2,QCU,0.52,0.22,27.0,16,44,60,31,16,15,1.94,51.61,Difficile,Difficile,0,Meme Difficulté,Pas Adapte
5041,2019,Mathematique,2,Le Calcul d'Integral,3,Integration des Fractions Rationnelles,8,598,2,QCU,0.71,0.2,5.0,3,61,64,37,3,34,1.73,8.11,Difficile,Difficile,0,Meme Difficulté,Pas Adapte
6152,2020,Mathematique,2,Le Calcul d'Integral,3,Integration des Fractions Rationnelles,8,598,2,QCU,0.59,0.4,31.0,20,44,64,49,20,29,1.31,40.82,Moyen,Difficile,-1,Plus Difficile,Pas Adapte
598,2015,Mathematique,2,Le Calcul d'Integral,3,Integration des Fractions Rationnelles,8,599,3,QO,0.14,0.98,68.0,50,23,73,52,50,2,1.4,96.15,Moyen,Facile,1,Plus Facile,Adapte
1709,2016,Mathematique,2,Le Calcul d'Integral,3,Integration des Fractions Rationnelles,8,599,3,QO,0.06,0.76,68.0,54,26,80,77,54,23,1.04,70.13,Facile,Facile,0,Meme Difficulté,Adapte
2820,2017,Mathematique,2,Le Calcul d'Integral,3,Integration des Fractions Rationnelles,8,599,3,QO,0.08,0.86,68.0,62,29,91,72,62,10,1.26,86.11,Facile,Facile,0,Meme Difficulté,Adapte
3931,2018,Mathematique,2,Le Calcul d'Integral,3,Integration des Fractions Rationnelles,8,599,3,QO,0.02,0.43,68.0,52,25,77,53,52,1,1.45,98.11,Facile,Facile,0,Meme Difficulté,Adapte
5042,2019,Mathematique,2,Le Calcul d'Integral,3,Integration des Fractions Rationnelles,8,599,3,QO,0.19,0.84,68.0,51,24,75,58,51,7,1.29,87.93,Facile,Facile,0,Meme Difficulté,Adapte
6153,2020,Mathematique,2,Le Calcul d'Integral,3,Integration des Fractions Rationnelles,8,599,3,QO,0.0,0.73,68.0,52,24,76,72,52,20,1.06,72.22,Facile,Facile,0,Meme Difficulté,Adapte
599,2015,Mathematique,2,Le Calcul d'Integral,3,Integration des Fractions Rationnelles,8,600,4,QCM,0.11,0.77,69.0,37,17,54,40,37,3,1.35,92.5,Facile,Facile,0,Meme Difficulté,Adapte
1710,2016,Mathematique,2,Le Calcul d'Integral,3,Integration des Fractions Rationnelles,8,600,4,QCM,0.16,0.89,69.0,40,18,58,41,40,1,1.41,97.56,Facile,Facile,0,Meme Difficulté,Adapte
2821,2017,Mathematique,2,Le Calcul d'Integral,3,Integration des Fractions Rationnelles,8,600,4,QCM,0.04,0.94,69.0,43,19,62,47,43,4,1.32,91.49,Facile,Facile,0,Meme Difficulté,Adapte
3932,2018,Mathematique,2,Le Calcul d'Integral,3,Integration des Fractions Rationnelles,8,600,4,QCM,0.13,0.78,69.0,37,17,54,48,37,11,1.12,77.08,Facile,Facile,0,Meme Difficulté,Adapte
5043,2019,Mathematique,2,Le Calcul d'Integral,3,Integration des Fractions Rationnelles,8,600,4,QCM,0.07,0.86,69.0,32,14,46,43,32,11,1.07,74.42,Facile,Facile,0,Meme Difficulté,Adapte
6154,2020,Mathematique,2,Le Calcul d'Integral,3,Integration des Fractions Rationnelles,8,600,4,QCM,0.02,0.97,69.0,33,15,48,47,33,14,1.02,70.21,Facile,Facile,0,Meme Difficulté,Adapte
600,2015,Mathematique,2,Le Calcul d'Integral,3,Integration des Fractions Rationnelles,8,601,5,QO,0.01,0.79,70.0,13,5,18,16,13,3,1.12,81.25,Facile,Facile,0,Meme Difficulté,Adapte
1711,2016,Mathematique,2,Le Calcul d'Integral,3,Integration des Fractions Rationnelles,8,601,5,QO,0.01,0.34,70.0,13,6,19,18,13,5,1.06,72.22,Facile,Facile,0,Meme Difficulté,Adapte
2822,2017,Mathematique,2,Le Calcul d'Integral,3,Integration des Fractions Rationnelles,8,601,5,QROC,0.04,0.57,70.0,13,6,19,14,13,1,1.36,92.86,Facile,Facile,0,Meme Difficulté,Adapte
3933,2018,Mathematique,2,Le Calcul d'Integral,3,Integration des Fractions Rationnelles,8,601,5,QROC,0.02,0.62,70.0,12,5,17,16,12,4,1.06,75.0,Facile,Facile,0,Meme Difficulté,Adapte
5044,2019,Mathematique,2,Le Calcul d'Integral,3,Integration des Fractions Rationnelles,8,601,5,QROC,0.1,0.48,70.0,13,6,19,16,13,3,1.19,81.25,Facile,Facile,0,Meme Difficulté,Adapte
6155,2020,Mathematique,2,Le Calcul d'Integral,3,Integration des Fractions Rationnelles,8,601,5,QROC,0.05,0.72,70.0,13,6,19,19,13,6,1.0,68.42,Facile,Facile,0,Meme Difficulté,Adapte
601,2015,Mathematique,2,Le Calcul d'Integral,3,Integration des Fractions Rationnelles,8,602,6,QCU,0.51,0.34,5.0,5,90,95,80,5,75,1.19,6.25,Difficile,Difficile,0,Meme Difficulté,Pas Adapte
1712,2016,Mathematique,2,Le Calcul d'Integral,3,Integration des Fractions Rationnelles,8,602,6,QCU,0.67,0.33,27.0,22,60,82,46,22,24,1.78,47.83,Difficile,Difficile,0,Meme Difficulté,Pas Adapte
2823,2017,Mathematique,2,Le Calcul d'Integral,3,Integration des Fractions Rationnelles,8,602,6,QCU,0.29,0.56,59.0,43,30,73,59,43,16,1.24,72.88,Moyen,Moyen,0,Meme Difficulté,Pas Adapte
3934,2018,Mathematique,2,Le Calcul d'Integral,3,Integration des Fractions Rationnelles,8,602,6,QCU,0.28,0.55,50.0,36,37,73,39,36,3,1.87,92.31,Difficile,Moyen,1,Plus Facile,Pas Adapte
5045,2019,Mathematique,2,Le Calcul d'Integral,3,Integration des Fractions Rationnelles,8,602,6,QCU,0.32,0.63,53.0,33,30,63,37,33,4,1.7,89.19,Moyen,Moyen,0,Meme Difficulté,Pas Adapte
6156,2020,Mathematique,2,Le Calcul d'Integral,3,Integration des Fractions Rationnelles,8,602,6,QCU,0.02,0.81,67.0,44,22,66,56,44,12,1.18,78.57,Facile,Facile,0,Meme Difficulté,Adapte
602,2015,Mathematique,2,Le Calcul d'Integral,3,Integration des Fractions Rationnelles,8,603,7,QCU,0.57,0.26,31.0,10,21,31,18,10,8,1.72,55.56,Facile,Difficile,-2,Beaucoup plus Difficile,Pas Adapte
1713,2016,Mathematique,2,Le Calcul d'Integral,3,Integration des Fractions Rationnelles,8,603,7,QCU,0.35,0.58,61.0,21,13,34,26,21,5,1.31,80.77,Facile,Moyen,-1,Plus Difficile,Pas Adapte
2824,2017,Mathematique,2,Le Calcul d'Integral,3,Integration des Fractions Rationnelles,8,603,7,QCU,0.59,0.29,2.0,1,31,32,15,1,14,2.13,6.67,Facile,Difficile,-2,Beaucoup plus Difficile,Pas Adapte
3935,2018,Mathematique,2,Le Calcul d'Integral,3,Integration des Fractions Rationnelles,8,603,7,QCU,0.38,0.66,39.0,13,21,34,13,13,0,2.62,100.0,Facile,Moyen,-1,Plus Difficile,Pas Adapte
5046,2019,Mathematique,2,Le Calcul d'Integral,3,Integration des Fractions Rationnelles,8,603,7,QCU,0.42,0.23,30.0,11,26,37,34,11,23,1.09,32.35,Difficile,Difficile,0,Meme Difficulté,Pas Adapte
6157,2020,Mathematique,2,Le Calcul d'Integral,3,Integration des Fractions Rationnelles,8,603,7,QCU,0.39,0.51,40.0,14,20,34,28,14,14,1.21,50.0,Difficile,Moyen,1,Plus Facile,Pas Adapte
603,2015,Mathematique,2,Le Calcul d'Integral,3,Integration des Fractions Rationnelles,8,604,8,QCU,0.39,0.72,44.0,37,48,85,72,37,35,1.18,51.39,Difficile,Moyen,1,Plus Facile,Pas Adapte
1714,2016,Mathematique,2,Le Calcul d'Integral,3,Integration des Fractions Rationnelles,8,604,8,QCU,0.24,0.62,39.0,33,52,85,64,33,31,1.33,51.56,Difficile,Moyen,1,Plus Facile,Pas Adapte
2825,2017,Mathematique,2,Le Calcul d'Integral,3,Integration des Fractions Rationnelles,8,604,8,QCU,0.39,0.4,57.0,46,35,81,47,46,1,1.72,97.87,Difficile,Moyen,1,Plus Facile,Pas Adapte
3936,2018,Mathematique,2,Le Calcul d'Integral,3,Integration des Fractions Rationnelles,8,604,8,QCU,0.32,0.7,49.0,39,40,79,79,39,40,1.0,49.37,Facile,Moyen,-1,Plus Difficile,Pas Adapte
5047,2019,Mathematique,2,Le Calcul d'Integral,3,Integration des Fractions Rationnelles,8,604,8,QCU,0.4,0.2,4.0,3,74,77,27,3,24,2.85,11.11,Moyen,Difficile,-1,Plus Difficile,Pas Adapte
6158,2020,Mathematique,2,Le Calcul d'Integral,3,Integration des Fractions Rationnelles,8,604,8,QCU,0.23,0.7,53.0,34,31,65,55,34,21,1.18,61.82,Facile,Moyen,-1,Plus Difficile,Pas Adapte
604,2015,Mathematique,2,Le Calcul d'Integral,4,Fonction Trigonometriques,11,605,1,QCM,0.43,0.53,61.0,28,18,46,35,28,7,1.31,80.0,Difficile,Moyen,1,Plus Facile,Pas Adapte
1715,2016,Mathematique,2,Le Calcul d'Integral,4,Fonction Trigonometriques,11,605,1,QCM,0.78,0.15,24.0,9,30,39,27,9,18,1.44,33.33,Moyen,Difficile,-1,Plus Difficile,Pas Adapte
2826,2017,Mathematique,2,Le Calcul d'Integral,4,Fonction Trigonometriques,11,605,1,QCM,0.07,0.94,65.0,25,14,39,34,25,9,1.15,73.53,Difficile,Facile,2,Beaucoup plus Facile,Adapte
3937,2018,Mathematique,2,Le Calcul d'Integral,4,Fonction Trigonometriques,11,605,1,QCM,0.13,0.72,65.0,23,13,36,24,23,1,1.5,95.83,Facile,Facile,0,Meme Difficulté,Adapte
5048,2019,Mathematique,2,Le Calcul d'Integral,4,Fonction Trigonometriques,11,605,1,QCM,0.07,0.93,65.0,24,13,37,25,24,1,1.48,96.0,Facile,Facile,0,Meme Difficulté,Adapte
6159,2020,Mathematique,2,Le Calcul d'Integral,4,Fonction Trigonometriques,11,605,1,QCM,0.02,0.88,65.0,25,14,39,28,25,3,1.39,89.29,Facile,Facile,0,Meme Difficulté,Adapte
605,2015,Mathematique,2,Le Calcul d'Integral,4,Fonction Trigonometriques,11,606,2,QROC,0.56,0.27,52.0,12,12,24,12,12,0,2.0,100.0,Difficile,Moyen,1,Plus Facile,Pas Adapte
1716,2016,Mathematique,2,Le Calcul d'Integral,4,Fonction Trigonometriques,11,606,2,QO,0.9,0.13,17.0,4,18,22,19,4,15,1.16,21.05,Difficile,Difficile,0,Meme Difficulté,Pas Adapte
2827,2017,Mathematique,2,Le Calcul d'Integral,4,Fonction Trigonometriques,11,606,2,QO,0.46,0.2,45.0,11,13,24,18,11,7,1.33,61.11,Difficile,Moyen,1,Plus Facile,Pas Adapte
3938,2018,Mathematique,2,Le Calcul d'Integral,4,Fonction Trigonometriques,11,606,2,QO,0.37,0.23,57.0,11,9,20,12,11,1,1.67,91.67,Facile,Moyen,-1,Plus Difficile,Pas Adapte
5049,2019,Mathematique,2,Le Calcul d'Integral,4,Fonction Trigonometriques,11,606,2,QO,0.51,0.22,45.0,9,10,19,15,9,6,1.27,60.0,Facile,Moyen,-1,Plus Difficile,Pas Adapte
6160,2020,Mathematique,2,Le Calcul d'Integral,4,Fonction Trigonometriques,11,606,2,QO,0.95,0.0,28.0,6,14,20,19,6,13,1.05,31.58,Facile,Difficile,-2,Beaucoup plus Difficile,Pas Adapte
606,2015,Mathematique,2,Le Calcul d'Integral,4,Fonction Trigonometriques,11,607,3,QROC,0.82,0.16,35.0,23,44,67,50,23,27,1.34,46.0,Difficile,Difficile,0,Meme Difficulté,Pas Adapte
1717,2016,Mathematique,2,Le Calcul d'Integral,4,Fonction Trigonometriques,11,607,3,QROC,0.57,0.39,43.0,30,39,69,63,30,33,1.1,47.62,Moyen,Moyen,0,Meme Difficulté,Pas Adapte
2828,2017,Mathematique,2,Le Calcul d'Integral,4,Fonction Trigonometriques,11,607,3,QROC,0.43,0.27,57.0,40,31,71,69,40,29,1.03,57.97,Moyen,Moyen,0,Meme Difficulté,Pas Adapte
3939,2018,Mathematique,2,Le Calcul d'Integral,4,Fonction Trigonometriques,11,607,3,QROC,0.96,0.15,31.0,24,54,78,45,24,21,1.73,53.33,Difficile,Difficile,0,Meme Difficulté,Pas Adapte
5050,2019,Mathematique,2,Le Calcul d'Integral,4,Fonction Trigonometriques,11,607,3,QROC,0.89,0.17,33.0,23,48,71,50,23,27,1.42,46.0,Difficile,Difficile,0,Meme Difficulté,Pas Adapte
6161,2020,Mathematique,2,Le Calcul d'Integral,4,Fonction Trigonometriques,11,607,3,QROC,0.39,0.4,58.0,42,31,73,69,42,27,1.06,60.87,Difficile,Moyen,1,Plus Facile,Pas Adapte
607,2015,Mathematique,2,Le Calcul d'Integral,4,Fonction Trigonometriques,11,608,4,QCU,0.36,0.57,36.0,26,46,72,67,26,41,1.07,38.81,Facile,Moyen,-1,Plus Difficile,Pas Adapte
1718,2016,Mathematique,2,Le Calcul d'Integral,4,Fonction Trigonometriques,11,608,4,QCU,0.64,0.3,35.0,24,45,69,46,24,22,1.5,52.17,Facile,Difficile,-2,Beaucoup plus Difficile,Pas Adapte
2829,2017,Mathematique,2,Le Calcul d'Integral,4,Fonction Trigonometriques,11,608,4,QCU,0.54,0.26,13.0,8,51,59,54,8,46,1.09,14.81,Difficile,Difficile,0,Meme Difficulté,Pas Adapte
3940,2018,Mathematique,2,Le Calcul d'Integral,4,Fonction Trigonometriques,11,608,4,QCU,0.67,0.2,11.0,6,53,59,58,6,52,1.02,10.34,Moyen,Difficile,-1,Plus Difficile,Pas Adapte
5051,2019,Mathematique,2,Le Calcul d'Integral,4,Fonction Trigonometriques,11,608,4,QCU,0.7,0.3,13.0,8,51,59,21,8,13,2.81,38.1,Facile,Difficile,-2,Beaucoup plus Difficile,Pas Adapte
6162,2020,Mathematique,2,Le Calcul d'Integral,4,Fonction Trigonometriques,11,608,4,QCU,0.72,0.35,12.0,8,57,65,42,8,34,1.55,19.05,Facile,Difficile,-2,Beaucoup plus Difficile,Pas Adapte
608,2015,Mathematique,2,Le Calcul d'Integral,4,Fonction Trigonometriques,11,609,5,QCM,0.51,0.25,2.0,2,92,94,33,2,31,2.85,6.06,Moyen,Difficile,-1,Plus Difficile,Pas Adapte
1719,2016,Mathematique,2,Le Calcul d'Integral,4,Fonction Trigonometriques,11,609,5,QCU,0.48,0.23,8.0,7,78,85,65,7,58,1.31,10.77,Difficile,Difficile,0,Meme Difficulté,Pas Adapte
2830,2017,Mathematique,2,Le Calcul d'Integral,4,Fonction Trigonometriques,11,609,5,QCU,0.51,0.37,22.0,20,71,91,57,20,37,1.6,35.09,Facile,Difficile,-2,Beaucoup plus Difficile,Pas Adapte
3941,2018,Mathematique,2,Le Calcul d'Integral,4,Fonction Trigonometriques,11,609,5,QCU,0.58,0.31,27.0,26,70,96,35,26,9,2.74,74.29,Difficile,Difficile,0,Meme Difficulté,Pas Adapte
5052,2019,Mathematique,2,Le Calcul d'Integral,4,Fonction Trigonometriques,11,609,5,QCU,0.31,0.56,43.0,46,62,108,107,46,61,1.01,42.99,Moyen,Moyen,0,Meme Difficulté,Pas Adapte
6163,2020,Mathematique,2,Le Calcul d'Integral,4,Fonction Trigonometriques,11,609,5,QCU,0.26,0.74,39.0,37,59,96,70,37,33,1.37,52.86,Facile,Moyen,-1,Plus Difficile,Pas Adapte
609,2015,Mathematique,2,Le Calcul d'Integral,4,Fonction Trigonometriques,11,610,6,QCU,0.5,0.36,6.0,2,33,35,13,2,11,2.69,15.38,Moyen,Difficile,-1,Plus Difficile,Pas Adapte
1720,2016,Mathematique,2,Le Calcul d'Integral,4,Fonction Trigonometriques,11,610,6,QCU,0.73,0.22,16.0,5,27,32,18,5,13,1.78,27.78,Facile,Difficile,-2,Beaucoup plus Difficile,Pas Adapte
2831,2017,Mathematique,2,Le Calcul d'Integral,4,Fonction Trigonometriques,11,610,6,QCU,0.26,0.5,62.0,20,13,33,22,20,2,1.5,90.91,Moyen,Moyen,0,Meme Difficulté,Pas Adapte
3942,2018,Mathematique,2,Le Calcul d'Integral,4,Fonction Trigonometriques,11,610,6,QCU,0.31,0.68,43.0,14,19,33,15,14,1,2.2,93.33,Difficile,Moyen,1,Plus Facile,Pas Adapte
5053,2019,Mathematique,2,Le Calcul d'Integral,4,Fonction Trigonometriques,11,610,6,QCU,0.26,0.73,54.0,20,17,37,30,20,10,1.23,66.67,Difficile,Moyen,1,Plus Facile,Pas Adapte
6164,2020,Mathematique,2,Le Calcul d'Integral,4,Fonction Trigonometriques,11,610,6,QCU,0.45,0.34,9.0,4,37,41,31,4,27,1.32,12.9,Facile,Difficile,-2,Beaucoup plus Difficile,Pas Adapte
610,2015,Mathematique,2,Le Calcul d'Integral,4,Fonction Trigonometriques,11,611,7,QCM,0.55,0.29,17.0,10,49,59,22,10,12,2.68,45.45,Difficile,Difficile,0,Meme Difficulté,Pas Adapte
1721,2016,Mathematique,2,Le Calcul d'Integral,4,Fonction Trigonometriques,11,611,7,QCU,0.67,0.38,6.0,3,51,54,54,3,51,1.0,5.56,Difficile,Difficile,0,Meme Difficulté,Pas Adapte
2832,2017,Mathematique,2,Le Calcul d'Integral,4,Fonction Trigonometriques,11,611,7,QCU,0.05,0.93,70.0,38,17,55,45,38,7,1.22,84.44,Difficile,Facile,2,Beaucoup plus Facile,Adapte
3943,2018,Mathematique,2,Le Calcul d'Integral,4,Fonction Trigonometriques,11,611,7,QO,0.01,0.52,70.0,35,15,50,48,35,13,1.04,72.92,Facile,Facile,0,Meme Difficulté,Adapte
5054,2019,Mathematique,2,Le Calcul d'Integral,4,Fonction Trigonometriques,11,611,7,QO,0.2,0.96,70.0,30,13,43,32,30,2,1.34,93.75,Facile,Facile,0,Meme Difficulté,Adapte
6165,2020,Mathematique,2,Le Calcul d'Integral,4,Fonction Trigonometriques,11,611,7,QROC,0.05,0.74,70.0,31,13,44,33,31,2,1.33,93.94,Facile,Facile,0,Meme Difficulté,Adapte
611,2015,Mathematique,2,Le Calcul d'Integral,4,Fonction Trigonometriques,11,612,8,QCM,0.35,0.37,47.0,40,46,86,80,40,40,1.07,50.0,Facile,Moyen,-1,Plus Difficile,Pas Adapte
1722,2016,Mathematique,2,Le Calcul d'Integral,4,Fonction Trigonometriques,11,612,8,QCM,0.55,0.23,20.0,18,74,92,74,18,56,1.24,24.32,Facile,Difficile,-2,Beaucoup plus Difficile,Pas Adapte
2833,2017,Mathematique,2,Le Calcul d'Integral,4,Fonction Trigonometriques,11,612,8,QCM,0.63,0.29,18.0,19,85,104,67,19,48,1.55,28.36,Moyen,Difficile,-1,Plus Difficile,Pas Adapte
3944,2018,Mathematique,2,Le Calcul d'Integral,4,Fonction Trigonometriques,11,612,8,QCM,0.67,0.18,26.0,25,71,96,88,25,63,1.09,28.41,Difficile,Difficile,0,Meme Difficulté,Pas Adapte
5055,2019,Mathematique,2,Le Calcul d'Integral,4,Fonction Trigonometriques,11,612,8,QCU,0.08,0.87,65.0,62,34,96,70,62,8,1.37,88.57,Facile,Facile,0,Meme Difficulté,Adapte
6166,2020,Mathematique,2,Le Calcul d'Integral,4,Fonction Trigonometriques,11,612,8,QCU,0.04,0.99,65.0,67,36,103,85,67,18,1.21,78.82,Facile,Facile,0,Meme Difficulté,Adapte
612,2015,Mathematique,2,Le Calcul d'Integral,4,Fonction Trigonometriques,11,613,9,QCU,0.54,0.28,7.0,1,17,18,15,1,14,1.2,6.67,Facile,Difficile,-2,Beaucoup plus Difficile,Pas Adapte
1723,2016,Mathematique,2,Le Calcul d'Integral,4,Fonction Trigonometriques,11,613,9,QCU,0.24,0.6,39.0,6,10,16,7,6,1,2.29,85.71,Difficile,Moyen,1,Plus Facile,Pas Adapte
2834,2017,Mathematique,2,Le Calcul d'Integral,4,Fonction Trigonometriques,11,613,9,QCU,0.56,0.26,15.0,2,14,16,16,2,14,1.0,12.5,Facile,Difficile,-2,Beaucoup plus Difficile,Pas Adapte
3945,2018,Mathematique,2,Le Calcul d'Integral,4,Fonction Trigonometriques,11,613,9,QCU,0.35,0.52,64.0,10,5,15,12,10,2,1.25,83.33,Difficile,Moyen,1,Plus Facile,Pas Adapte
5056,2019,Mathematique,2,Le Calcul d'Integral,4,Fonction Trigonometriques,11,613,9,QCU,0.23,0.68,63.0,10,6,16,15,10,5,1.07,66.67,Facile,Moyen,-1,Plus Difficile,Pas Adapte
6167,2020,Mathematique,2,Le Calcul d'Integral,4,Fonction Trigonometriques,11,613,9,QCU,0.25,0.42,43.0,6,9,15,9,6,3,1.67,66.67,Facile,Moyen,-1,Plus Difficile,Pas Adapte
613,2015,Mathematique,2,Le Calcul d'Integral,4,Fonction Trigonometriques,11,614,10,QCM,0.43,0.58,47.0,7,7,14,12,7,5,1.17,58.33,Moyen,Moyen,0,Meme Difficulté,Pas Adapte
1724,2016,Mathematique,2,Le Calcul d'Integral,4,Fonction Trigonometriques,11,614,10,QCM,0.66,0.22,12.0,2,12,14,9,2,7,1.56,22.22,Facile,Difficile,-2,Beaucoup plus Difficile,Pas Adapte
2835,2017,Mathematique,2,Le Calcul d'Integral,4,Fonction Trigonometriques,11,614,10,QCM,0.75,0.23,12.0,2,12,14,7,2,5,2.0,28.57,Moyen,Difficile,-1,Plus Difficile,Pas Adapte
3946,2018,Mathematique,2,Le Calcul d'Integral,4,Fonction Trigonometriques,11,614,10,QCU,0.31,0.73,43.0,7,9,16,7,7,0,2.29,100.0,Difficile,Moyen,1,Plus Facile,Pas Adapte
5057,2019,Mathematique,2,Le Calcul d'Integral,4,Fonction Trigonometriques,11,614,10,QCU,0.39,0.65,37.0,6,10,16,12,6,6,1.33,50.0,Facile,Moyen,-1,Plus Difficile,Pas Adapte
6168,2020,Mathematique,2,Le Calcul d'Integral,4,Fonction Trigonometriques,11,614,10,QCU,0.65,0.37,18.0,3,11,14,8,3,5,1.75,37.5,Difficile,Difficile,0,Meme Difficulté,Pas Adapte
614,2015,Mathematique,2,Le Calcul d'Integral,4,Fonction Trigonometriques,11,615,11,QROC,0.65,0.22,16.0,12,60,72,63,12,51,1.14,19.05,Facile,Difficile,-2,Beaucoup plus Difficile,Pas Adapte
1725,2016,Mathematique,2,Le Calcul d'Integral,4,Fonction Trigonometriques,11,615,11,QROC,0.08,0.63,68.0,47,22,69,48,47,1,1.44,97.92,Facile,Facile,0,Meme Difficulté,Adapte
2836,2017,Mathematique,2,Le Calcul d'Integral,4,Fonction Trigonometriques,11,615,11,QROC,0.18,0.85,68.0,50,24,74,59,50,9,1.25,84.75,Facile,Facile,0,Meme Difficulté,Adapte
3947,2018,Mathematique,2,Le Calcul d'Integral,4,Fonction Trigonometriques,11,615,11,QO,0.04,0.95,68.0,45,21,66,48,45,3,1.38,93.75,Facile,Facile,0,Meme Difficulté,Adapte
5058,2019,Mathematique,2,Le Calcul d'Integral,4,Fonction Trigonometriques,11,615,11,QO,0.17,0.66,68.0,41,20,61,46,41,5,1.33,89.13,Facile,Facile,0,Meme Difficulté,Adapte
6169,2020,Mathematique,2,Le Calcul d'Integral,4,Fonction Trigonometriques,11,615,11,QO,0.02,0.58,68.0,35,17,52,45,35,10,1.16,77.78,Facile,Facile,0,Meme Difficulté,Adapte
615,2015,Mathematique,2,Le Calcul d'Integral,5,Integrales Abeliennes,9,616,1,QCU,0.55,0.21,7.0,1,7,8,5,1,4,1.6,20.0,Difficile,Difficile,0,Meme Difficulté,Pas Adapte
1726,2016,Mathematique,2,Le Calcul d'Integral,5,Integrales Abeliennes,9,616,1,QCM,0.41,0.62,61.0,5,3,8,6,5,1,1.33,83.33,Difficile,Moyen,1,Plus Facile,Pas Adapte
2837,2017,Mathematique,2,Le Calcul d'Integral,5,Integrales Abeliennes,9,616,1,QROC,0.7,0.08,21.0,2,6,8,7,2,5,1.14,28.57,Facile,Difficile,-2,Beaucoup plus Difficile,Pas Adapte
3948,2018,Mathematique,2,Le Calcul d'Integral,5,Integrales Abeliennes,9,616,1,QROC,0.45,0.38,53.0,4,4,8,8,4,4,1.0,50.0,Difficile,Moyen,1,Plus Facile,Pas Adapte
5059,2019,Mathematique,2,Le Calcul d'Integral,5,Integrales Abeliennes,9,616,1,QROC,0.5,0.33,45.0,4,5,9,6,4,2,1.5,66.67,Facile,Moyen,-1,Plus Difficile,Pas Adapte
6170,2020,Mathematique,2,Le Calcul d'Integral,5,Integrales Abeliennes,9,616,1,QROC,0.94,0.24,35.0,3,5,8,4,3,1,2.0,75.0,Difficile,Difficile,0,Meme Difficulté,Pas Adapte
616,2015,Mathematique,2,Le Calcul d'Integral,5,Integrales Abeliennes,9,617,2,QCM,0.72,0.2,17.0,15,73,88,38,15,23,2.32,39.47,Difficile,Difficile,0,Meme Difficulté,Pas Adapte
1727,2016,Mathematique,2,Le Calcul d'Integral,5,Integrales Abeliennes,9,617,2,QCM,0.42,0.62,53.0,43,38,81,45,43,2,1.8,95.56,Moyen,Moyen,0,Meme Difficulté,Pas Adapte
2838,2017,Mathematique,2,Le Calcul d'Integral,5,Integrales Abeliennes,9,617,2,QCM,0.43,0.65,42.0,37,52,89,89,37,52,1.0,41.57,Moyen,Moyen,0,Meme Difficulté,Pas Adapte
3949,2018,Mathematique,2,Le Calcul d'Integral,5,Integrales Abeliennes,9,617,2,QCM,0.46,0.46,48.0,40,44,84,62,40,22,1.35,64.52,Difficile,Moyen,1,Plus Facile,Pas Adapte
5060,2019,Mathematique,2,Le Calcul d'Integral,5,Integrales Abeliennes,9,617,2,QCM,0.33,0.64,47.0,34,39,73,48,34,14,1.52,70.83,Difficile,Moyen,1,Plus Facile,Pas Adapte
6171,2020,Mathematique,2,Le Calcul d'Integral,5,Integrales Abeliennes,9,617,2,QCM,0.33,0.55,40.0,25,37,62,44,25,19,1.41,56.82,Moyen,Moyen,0,Meme Difficulté,Pas Adapte
617,2015,Mathematique,2,Le Calcul d'Integral,5,Integrales Abeliennes,9,618,3,QCM,0.78,0.23,33.0,16,34,50,22,16,6,2.27,72.73,Facile,Difficile,-2,Beaucoup plus Difficile,Pas Adapte
1728,2016,Mathematique,2,Le Calcul d'Integral,5,Integrales Abeliennes,9,618,3,QCM,0.43,0.53,58.0,29,21,50,33,29,4,1.52,87.88,Difficile,Moyen,1,Plus Facile,Pas Adapte
2839,2017,Mathematique,2,Le Calcul d'Integral,5,Integrales Abeliennes,9,618,3,QCM,0.21,0.6,41.0,23,34,57,43,23,20,1.33,53.49,Moyen,Moyen,0,Meme Difficulté,Pas Adapte
3950,2018,Mathematique,2,Le Calcul d'Integral,5,Integrales Abeliennes,9,618,3,QCM,0.41,0.37,63.0,40,24,64,43,40,3,1.49,93.02,Difficile,Moyen,1,Plus Facile,Pas Adapte
5061,2019,Mathematique,2,Le Calcul d'Integral,5,Integrales Abeliennes,9,618,3,QROC,0.84,0.15,33.0,23,47,70,40,23,17,1.75,57.5,Difficile,Difficile,0,Meme Difficulté,Pas Adapte
6172,2020,Mathematique,2,Le Calcul d'Integral,5,Integrales Abeliennes,9,618,3,QROC,0.5,0.29,42.0,32,43,75,43,32,11,1.74,74.42,Moyen,Moyen,0,Meme Difficulté,Pas Adapte
618,2015,Mathematique,2,Le Calcul d'Integral,5,Integrales Abeliennes,9,619,4,QROC,0.6,0.1,33.0,15,31,46,34,15,19,1.35,44.12,Difficile,Difficile,0,Meme Difficulté,Pas Adapte
1729,2016,Mathematique,2,Le Calcul d'Integral,5,Integrales Abeliennes,9,619,4,QROC,0.68,0.19,1.0,0,45,45,23,0,23,1.96,0.0,Difficile,Difficile,0,Meme Difficulté,Pas Adapte
2840,2017,Mathematique,2,Le Calcul d'Integral,5,Integrales Abeliennes,9,619,4,QO,0.98,0.09,9.0,4,35,39,34,4,30,1.15,11.76,Facile,Difficile,-2,Beaucoup plus Difficile,Pas Adapte
3951,2018,Mathematique,2,Le Calcul d'Integral,5,Integrales Abeliennes,9,619,4,QCM,0.02,0.95,65.0,29,15,44,38,29,9,1.16,76.32,Moyen,Facile,1,Plus Facile,Adapte
5062,2019,Mathematique,2,Le Calcul d'Integral,5,Integrales Abeliennes,9,619,4,QCU,0.06,0.76,65.0,25,13,38,34,25,9,1.12,73.53,Facile,Facile,0,Meme Difficulté,Adapte
6173,2020,Mathematique,2,Le Calcul d'Integral,5,Integrales Abeliennes,9,619,4,QCU,0.07,0.99,65.0,28,15,43,31,28,3,1.39,90.32,Facile,Facile,0,Meme Difficulté,Adapte
619,2015,Mathematique,2,Le Calcul d'Integral,5,Integrales Abeliennes,9,620,5,QO,0.22,0.22,62.0,4,3,7,5,4,1,1.4,80.0,Facile,Moyen,-1,Plus Difficile,Pas Adapte
1730,2016,Mathematique,2,Le Calcul d'Integral,5,Integrales Abeliennes,9,620,5,QO,0.93,0.14,30.0,2,6,8,5,2,3,1.6,40.0,Moyen,Difficile,-1,Plus Difficile,Pas Adapte
2841,2017,Mathematique,2,Le Calcul d'Integral,5,Integrales Abeliennes,9,620,5,QO,0.39,0.17,58.0,5,4,9,5,5,0,1.8,100.0,Difficile,Moyen,1,Plus Facile,Pas Adapte
3952,2018,Mathematique,2,Le Calcul d'Integral,5,Integrales Abeliennes,9,620,5,QO,0.3,0.23,49.0,4,5,9,5,4,1,1.8,80.0,Facile,Moyen,-1,Plus Difficile,Pas Adapte
5063,2019,Mathematique,2,Le Calcul d'Integral,5,Integrales Abeliennes,9,620,5,QO,0.67,0.19,51.0,5,5,10,6,5,1,1.67,83.33,Moyen,Moyen,0,Meme Difficulté,Pas Adapte
6174,2020,Mathematique,2,Le Calcul d'Integral,5,Integrales Abeliennes,9,620,5,QO,0.71,0.17,59.0,5,3,8,7,5,2,1.14,71.43,Facile,Moyen,-1,Plus Difficile,Pas Adapte
620,2015,Mathematique,2,Le Calcul d'Integral,5,Integrales Abeliennes,9,621,6,QCU,0.5,0.24,12.0,2,17,19,17,2,15,1.12,11.76,Difficile,Difficile,0,Meme Difficulté,Pas Adapte
1731,2016,Mathematique,2,Le Calcul d'Integral,5,Integrales Abeliennes,9,621,6,QCU,0.75,0.31,7.0,1,17,18,10,1,9,1.8,10.0,Difficile,Difficile,0,Meme Difficulté,Pas Adapte
2842,2017,Mathematique,2,Le Calcul d'Integral,5,Integrales Abeliennes,9,621,6,QCU,0.29,0.54,57.0,10,7,17,10,10,0,1.7,100.0,Facile,Moyen,-1,Plus Difficile,Pas Adapte
3953,2018,Mathematique,2,Le Calcul d'Integral,5,Integrales Abeliennes,9,621,6,QCU,0.39,0.51,62.0,9,6,15,14,9,5,1.07,64.29,Facile,Moyen,-1,Plus Difficile,Pas Adapte
5064,2019,Mathematique,2,Le Calcul d'Integral,5,Integrales Abeliennes,9,621,6,QCU,0.2,0.69,44.0,7,10,17,11,7,4,1.55,63.64,Difficile,Moyen,1,Plus Facile,Pas Adapte
6175,2020,Mathematique,2,Le Calcul d'Integral,5,Integrales Abeliennes,9,621,6,QCU,0.71,0.34,34.0,5,9,14,13,5,8,1.08,38.46,Moyen,Difficile,-1,Plus Difficile,Pas Adapte
621,2015,Mathematique,2,Le Calcul d'Integral,5,Integrales Abeliennes,9,622,7,QCM,0.28,0.6,58.0,4,3,7,5,4,1,1.4,80.0,Facile,Moyen,-1,Plus Difficile,Pas Adapte
1732,2016,Mathematique,2,Le Calcul d'Integral,5,Integrales Abeliennes,9,622,7,QO,0.25,0.23,57.0,5,3,8,6,5,1,1.33,83.33,Difficile,Moyen,1,Plus Facile,Pas Adapte
2843,2017,Mathematique,2,Le Calcul d'Integral,5,Integrales Abeliennes,9,622,7,QO,0.35,0.24,46.0,4,5,9,6,4,2,1.5,66.67,Moyen,Moyen,0,Meme Difficulté,Pas Adapte
3954,2018,Mathematique,2,Le Calcul d'Integral,5,Integrales Abeliennes,9,622,7,QO,0.8,0.03,11.0,1,8,9,7,1,6,1.29,14.29,Moyen,Difficile,-1,Plus Difficile,Pas Adapte
5065,2019,Mathematique,2,Le Calcul d'Integral,5,Integrales Abeliennes,9,622,7,QO,0.29,0.21,58.0,5,4,9,7,5,2,1.29,71.43,Difficile,Moyen,1,Plus Facile,Pas Adapte
6176,2020,Mathematique,2,Le Calcul d'Integral,5,Integrales Abeliennes,9,622,7,QROC,0.9,0.1,3.0,0,9,9,4,0,4,2.25,0.0,Moyen,Difficile,-1,Plus Difficile,Pas Adapte
622,2015,Mathematique,2,Le Calcul d'Integral,5,Integrales Abeliennes,9,623,8,QCM,0.5,0.2,23.0,11,35,46,14,11,3,3.29,78.57,Moyen,Difficile,-1,Plus Difficile,Pas Adapte
1733,2016,Mathematique,2,Le Calcul d'Integral,5,Integrales Abeliennes,9,623,8,QCM,0.51,0.16,30.0,14,32,46,44,14,30,1.05,31.82,Facile,Difficile,-2,Beaucoup plus Difficile,Pas Adapte
2844,2017,Mathematique,2,Le Calcul d'Integral,5,Integrales Abeliennes,9,623,8,QCM,0.79,0.19,27.0,11,29,40,13,11,2,3.08,84.62,Facile,Difficile,-2,Beaucoup plus Difficile,Pas Adapte
3955,2018,Mathematique,2,Le Calcul d'Integral,5,Integrales Abeliennes,9,623,8,QCM,0.43,0.42,45.0,20,25,45,38,20,18,1.18,52.63,Facile,Moyen,-1,Plus Difficile,Pas Adapte
5066,2019,Mathematique,2,Le Calcul d'Integral,5,Integrales Abeliennes,9,623,8,QCM,0.62,0.19,4.0,2,50,52,41,2,39,1.27,4.88,Difficile,Difficile,0,Meme Difficulté,Pas Adapte
6177,2020,Mathematique,2,Le Calcul d'Integral,5,Integrales Abeliennes,9,623,8,QCU,0.27,0.65,62.0,34,21,55,42,34,8,1.31,80.95,Facile,Moyen,-1,Plus Difficile,Pas Adapte
623,2015,Mathematique,2,Le Calcul d'Integral,5,Integrales Abeliennes,9,624,9,QCM,0.36,0.68,48.0,33,35,68,44,33,11,1.55,75.0,Difficile,Moyen,1,Plus Facile,Pas Adapte
1734,2016,Mathematique,2,Le Calcul d'Integral,5,Integrales Abeliennes,9,624,9,QCM,0.29,0.37,44.0,26,33,59,52,26,26,1.13,50.0,Moyen,Moyen,0,Meme Difficulté,Pas Adapte
2845,2017,Mathematique,2,Le Calcul d'Integral,5,Integrales Abeliennes,9,624,9,QCM,0.55,0.25,34.0,19,36,55,36,19,17,1.53,52.78,Facile,Difficile,-2,Beaucoup plus Difficile,Pas Adapte
3956,2018,Mathematique,2,Le Calcul d'Integral,5,Integrales Abeliennes,9,624,9,QCM,0.38,0.62,50.0,26,27,53,40,26,14,1.32,65.0,Facile,Moyen,-1,Plus Difficile,Pas Adapte
5067,2019,Mathematique,2,Le Calcul d'Integral,5,Integrales Abeliennes,9,624,9,QCM,0.41,0.38,54.0,27,23,50,33,27,6,1.52,81.82,Moyen,Moyen,0,Meme Difficulté,Pas Adapte
6178,2020,Mathematique,2,Le Calcul d'Integral,5,Integrales Abeliennes,9,624,9,QCM,0.54,0.2,21.0,11,41,52,16,11,5,3.25,68.75,Difficile,Difficile,0,Meme Difficulté,Pas Adapte
624,2015,Mathematique,2,Le Calcul d'Integral,6,Quelques Exemples en Maple,6,625,1,QCU,0.36,0.71,42.0,10,13,23,16,10,6,1.44,62.5,Facile,Moyen,-1,Plus Difficile,Pas Adapte
1735,2016,Mathematique,2,Le Calcul d'Integral,6,Quelques Exemples en Maple,6,625,1,QCU,0.55,0.35,34.0,7,15,22,18,7,11,1.22,38.89,Facile,Difficile,-2,Beaucoup plus Difficile,Pas Adapte
2846,2017,Mathematique,2,Le Calcul d'Integral,6,Quelques Exemples en Maple,6,625,1,QCU,0.31,0.61,48.0,11,12,23,22,11,11,1.05,50.0,Facile,Moyen,-1,Plus Difficile,Pas Adapte
3957,2018,Mathematique,2,Le Calcul d'Integral,6,Quelques Exemples en Maple,6,625,1,QCU,0.6,0.38,25.0,5,16,21,8,5,3,2.62,62.5,Moyen,Difficile,-1,Plus Difficile,Pas Adapte
5068,2019,Mathematique,2,Le Calcul d'Integral,6,Quelques Exemples en Maple,6,625,1,QCU,0.43,0.32,16.0,3,17,20,15,3,12,1.33,20.0,Facile,Difficile,-2,Beaucoup plus Difficile,Pas Adapte
6179,2020,Mathematique,2,Le Calcul d'Integral,6,Quelques Exemples en Maple,6,625,1,QCU,0.62,0.2,31.0,5,12,17,10,5,5,1.7,50.0,Moyen,Difficile,-1,Plus Difficile,Pas Adapte
625,2015,Mathematique,2,Le Calcul d'Integral,6,Quelques Exemples en Maple,6,626,2,QCM,0.39,0.48,45.0,32,40,72,52,32,20,1.38,61.54,Difficile,Moyen,1,Plus Facile,Pas Adapte
1736,2016,Mathematique,2,Le Calcul d'Integral,6,Quelques Exemples en Maple,6,626,2,QO,0.92,0.07,35.0,28,51,79,73,28,45,1.08,38.36,Difficile,Difficile,0,Meme Difficulté,Pas Adapte
2847,2017,Mathematique,2,Le Calcul d'Integral,6,Quelques Exemples en Maple,6,626,2,QO,0.43,0.19,47.0,36,40,76,66,36,30,1.15,54.55,Facile,Moyen,-1,Plus Difficile,Pas Adapte
3958,2018,Mathematique,2,Le Calcul d'Integral,6,Quelques Exemples en Maple,6,626,2,QO,0.95,0.0,17.0,15,71,86,67,15,52,1.28,22.39,Facile,Difficile,-2,Beaucoup plus Difficile,Pas Adapte
5069,2019,Mathematique,2,Le Calcul d'Integral,6,Quelques Exemples en Maple,6,626,2,QO,0.83,0.09,32.0,27,56,83,58,27,31,1.43,46.55,Moyen,Difficile,-1,Plus Difficile,Pas Adapte
6180,2020,Mathematique,2,Le Calcul d'Integral,6,Quelques Exemples en Maple,6,626,2,QO,0.81,0.01,28.0,25,65,90,63,25,38,1.43,39.68,Facile,Difficile,-2,Beaucoup plus Difficile,Pas Adapte
626,2015,Mathematique,2,Le Calcul d'Integral,6,Quelques Exemples en Maple,6,627,3,QCM,0.4,0.47,36.0,27,47,74,47,27,20,1.57,57.45,Facile,Moyen,-1,Plus Difficile,Pas Adapte
1737,2016,Mathematique,2,Le Calcul d'Integral,6,Quelques Exemples en Maple,6,627,3,QCM,0.42,0.4,39.0,29,45,74,42,29,13,1.76,69.05,Difficile,Moyen,1,Plus Facile,Pas Adapte
2848,2017,Mathematique,2,Le Calcul d'Integral,6,Quelques Exemples en Maple,6,627,3,QCM,0.75,0.28,6.0,4,66,70,49,4,45,1.43,8.16,Facile,Difficile,-2,Beaucoup plus Difficile,Pas Adapte
3959,2018,Mathematique,2,Le Calcul d'Integral,6,Quelques Exemples en Maple,6,627,3,QCM,0.8,0.16,9.0,7,68,75,24,7,17,3.12,29.17,Moyen,Difficile,-1,Plus Difficile,Pas Adapte
5070,2019,Mathematique,2,Le Calcul d'Integral,6,Quelques Exemples en Maple,6,627,3,QCU,0.06,0.92,65.0,43,23,66,53,43,10,1.25,81.13,Facile,Facile,0,Meme Difficulté,Adapte
6181,2020,Mathematique,2,Le Calcul d'Integral,6,Quelques Exemples en Maple,6,627,3,QCU,0.17,0.79,65.0,38,21,59,45,38,7,1.31,84.44,Facile,Facile,0,Meme Difficulté,Adapte
627,2015,Mathematique,2,Le Calcul d'Integral,6,Quelques Exemples en Maple,6,628,4,QO,0.95,0.07,3.0,1,28,29,22,1,21,1.32,4.55,Moyen,Difficile,-1,Plus Difficile,Pas Adapte
1738,2016,Mathematique,2,Le Calcul d'Integral,6,Quelques Exemples en Maple,6,628,4,QO,0.77,0.09,33.0,10,19,29,15,10,5,1.93,66.67,Difficile,Difficile,0,Meme Difficulté,Pas Adapte
2849,2017,Mathematique,2,Le Calcul d'Integral,6,Quelques Exemples en Maple,6,628,4,QROC,0.28,0.28,41.0,12,17,29,19,12,7,1.53,63.16,Moyen,Moyen,0,Meme Difficulté,Pas Adapte
3960,2018,Mathematique,2,Le Calcul d'Integral,6,Quelques Exemples en Maple,6,628,4,QO,0.65,0.25,50.0,16,16,32,29,16,13,1.1,55.17,Moyen,Moyen,0,Meme Difficulté,Pas Adapte
5071,2019,Mathematique,2,Le Calcul d'Integral,6,Quelques Exemples en Maple,6,628,4,QROC,0.86,0.23,11.0,4,28,32,25,4,21,1.28,16.0,Moyen,Difficile,-1,Plus Difficile,Pas Adapte
6182,2020,Mathematique,2,Le Calcul d'Integral,6,Quelques Exemples en Maple,6,628,4,QO,0.98,0.02,23.0,6,22,28,14,6,8,2.0,42.86,Difficile,Difficile,0,Meme Difficulté,Pas Adapte
628,2015,Mathematique,2,Le Calcul d'Integral,6,Quelques Exemples en Maple,6,629,5,QCM,0.65,0.2,9.0,1,5,6,6,1,5,1.0,16.67,Facile,Difficile,-2,Beaucoup plus Difficile,Pas Adapte
1739,2016,Mathematique,2,Le Calcul d'Integral,6,Quelques Exemples en Maple,6,629,5,QO,0.95,0.13,18.0,1,6,7,6,1,5,1.17,16.67,Difficile,Difficile,0,Meme Difficulté,Pas Adapte
2850,2017,Mathematique,2,Le Calcul d'Integral,6,Quelques Exemples en Maple,6,629,5,QO,0.86,0.01,18.0,1,6,7,6,1,5,1.17,16.67,Facile,Difficile,-2,Beaucoup plus Difficile,Pas Adapte
3961,2018,Mathematique,2,Le Calcul d'Integral,6,Quelques Exemples en Maple,6,629,5,QO,0.9,0.08,20.0,1,5,6,5,1,4,1.2,20.0,Moyen,Difficile,-1,Plus Difficile,Pas Adapte
5072,2019,Mathematique,2,Le Calcul d'Integral,6,Quelques Exemples en Maple,6,629,5,QO,0.81,0.09,1.0,0,6,6,4,0,4,1.5,0.0,Difficile,Difficile,0,Meme Difficulté,Pas Adapte
6183,2020,Mathematique,2,Le Calcul d'Integral,6,Quelques Exemples en Maple,6,629,5,QO,0.76,0.1,27.0,2,5,7,6,2,4,1.17,33.33,Facile,Difficile,-2,Beaucoup plus Difficile,Pas Adapte
629,2015,Mathematique,2,Le Calcul d'Integral,6,Quelques Exemples en Maple,6,630,6,QCM,0.22,0.64,61.0,24,16,40,38,24,14,1.05,63.16,Difficile,Moyen,1,Plus Facile,Pas Adapte
1740,2016,Mathematique,2,Le Calcul d'Integral,6,Quelques Exemples en Maple,6,630,6,QCM,0.5,0.32,58.0,22,16,38,33,22,11,1.15,66.67,Difficile,Moyen,1,Plus Facile,Pas Adapte
2851,2017,Mathematique,2,Le Calcul d'Integral,6,Quelques Exemples en Maple,6,630,6,QCU,0.32,0.61,54.0,22,18,40,26,22,4,1.54,84.62,Facile,Moyen,-1,Plus Difficile,Pas Adapte
3962,2018,Mathematique,2,Le Calcul d'Integral,6,Quelques Exemples en Maple,6,630,6,QCU,0.49,0.34,30.0,12,29,41,38,12,26,1.08,31.58,Moyen,Difficile,-1,Plus Difficile,Pas Adapte
5073,2019,Mathematique,2,Le Calcul d'Integral,6,Quelques Exemples en Maple,6,630,6,QCU,0.26,0.65,42.0,16,21,37,34,16,18,1.09,47.06,Difficile,Moyen,1,Plus Facile,Pas Adapte
6184,2020,Mathematique,2,Le Calcul d'Integral,6,Quelques Exemples en Maple,6,630,6,QCM,0.66,0.23,17.0,6,30,36,12,6,6,3.0,50.0,Difficile,Difficile,0,Meme Difficulté,Pas Adapte
630,2015,Mathematique,3,La Derivation,1,Derivee en un Point,7,631,1,QCM,0.42,0.41,62.0,30,19,49,37,30,7,1.32,81.08,Difficile,Moyen,1,Plus Facile,Pas Adapte
1741,2016,Mathematique,3,La Derivation,1,Derivee en un Point,7,631,1,QCM,0.21,0.5,47.0,26,30,56,31,26,5,1.81,83.87,Moyen,Moyen,0,Meme Difficulté,Pas Adapte
2852,2017,Mathematique,3,La Derivation,1,Derivee en un Point,7,631,1,QCM,0.34,0.67,50.0,26,27,53,43,26,17,1.23,60.47,Difficile,Moyen,1,Plus Facile,Pas Adapte
3963,2018,Mathematique,3,La Derivation,1,Derivee en un Point,7,631,1,QCM,0.39,0.62,49.0,24,26,50,31,24,7,1.61,77.42,Difficile,Moyen,1,Plus Facile,Pas Adapte
5074,2019,Mathematique,3,La Derivation,1,Derivee en un Point,7,631,1,QROC,0.48,0.26,62.0,34,21,55,52,34,18,1.06,65.38,Facile,Moyen,-1,Plus Difficile,Pas Adapte
6185,2020,Mathematique,3,La Derivation,1,Derivee en un Point,7,631,1,QROC,0.84,0.08,11.0,7,53,60,51,7,44,1.18,13.73,Difficile,Difficile,0,Meme Difficulté,Pas Adapte
631,2015,Mathematique,3,La Derivation,1,Derivee en un Point,7,632,2,QROC,0.76,0.09,13.0,6,42,48,20,6,14,2.4,30.0,Facile,Difficile,-2,Beaucoup plus Difficile,Pas Adapte
1742,2016,Mathematique,3,La Derivation,1,Derivee en un Point,7,632,2,QROC,0.76,0.01,22.0,9,32,41,34,9,25,1.21,26.47,Difficile,Difficile,0,Meme Difficulté,Pas Adapte
2853,2017,Mathematique,3,La Derivation,1,Derivee en un Point,7,632,2,QROC,0.61,0.0,24.0,9,30,39,29,9,20,1.34,31.03,Moyen,Difficile,-1,Plus Difficile,Pas Adapte
3964,2018,Mathematique,3,La Derivation,1,Derivee en un Point,7,632,2,QROC,0.89,0.13,14.0,5,31,36,25,5,20,1.44,20.0,Difficile,Difficile,0,Meme Difficulté,Pas Adapte
5075,2019,Mathematique,3,La Derivation,1,Derivee en un Point,7,632,2,QROC,0.64,0.04,7.0,2,29,31,20,2,18,1.55,10.0,Moyen,Difficile,-1,Plus Difficile,Pas Adapte
6186,2020,Mathematique,3,La Derivation,1,Derivee en un Point,7,632,2,QROC,0.2,0.29,38.0,11,17,28,16,11,5,1.75,68.75,Moyen,Moyen,0,Meme Difficulté,Pas Adapte
632,2015,Mathematique,3,La Derivation,1,Derivee en un Point,7,633,3,QROC,0.85,0.16,24.0,10,33,43,23,10,13,1.87,43.48,Facile,Difficile,-2,Beaucoup plus Difficile,Pas Adapte
1743,2016,Mathematique,3,La Derivation,1,Derivee en un Point,7,633,3,QROC,0.21,0.36,62.0,28,17,45,36,28,8,1.25,77.78,Facile,Moyen,-1,Plus Difficile,Pas Adapte
2854,2017,Mathematique,3,La Derivation,1,Derivee en un Point,7,633,3,QROC,0.99,0.02,22.0,11,41,52,22,11,11,2.36,50.0,Moyen,Difficile,-1,Plus Difficile,Pas Adapte
3965,2018,Mathematique,3,La Derivation,1,Derivee en un Point,7,633,3,QROC,0.65,0.15,4.0,2,54,56,25,2,23,2.24,8.0,Difficile,Difficile,0,Meme Difficulté,Pas Adapte
5076,2019,Mathematique,3,La Derivation,1,Derivee en un Point,7,633,3,QROC,0.4,0.31,36.0,17,31,48,31,17,14,1.55,54.84,Facile,Moyen,-1,Plus Difficile,Pas Adapte
6187,2020,Mathematique,3,La Derivation,1,Derivee en un Point,7,633,3,QROC,0.6,0.31,58.0,26,19,45,41,26,15,1.1,63.41,Difficile,Moyen,1,Plus Facile,Pas Adapte
633,2015,Mathematique,3,La Derivation,1,Derivee en un Point,7,634,4,QCU,0.5,0.37,32.0,6,14,20,19,6,13,1.05,31.58,Difficile,Difficile,0,Meme Difficulté,Pas Adapte
1744,2016,Mathematique,3,La Derivation,1,Derivee en un Point,7,634,4,QCU,0.33,0.52,64.0,14,8,22,21,14,7,1.05,66.67,Difficile,Moyen,1,Plus Facile,Pas Adapte
2855,2017,Mathematique,3,La Derivation,1,Derivee en un Point,7,634,4,QCU,0.24,0.43,63.0,14,9,23,15,14,1,1.53,93.33,Facile,Moyen,-1,Plus Difficile,Pas Adapte
3966,2018,Mathematique,3,La Derivation,1,Derivee en un Point,7,634,4,QCU,0.41,0.29,31.0,7,15,22,18,7,11,1.22,38.89,Difficile,Difficile,0,Meme Difficulté,Pas Adapte
5077,2019,Mathematique,3,La Derivation,1,Derivee en un Point,7,634,4,QCU,0.58,0.2,6.0,2,23,25,12,2,10,2.08,16.67,Facile,Difficile,-2,Beaucoup plus Difficile,Pas Adapte
6188,2020,Mathematique,3,La Derivation,1,Derivee en un Point,7,634,4,QCU,0.62,0.25,10.0,3,23,26,26,3,23,1.0,11.54,Difficile,Difficile,0,Meme Difficulté,Pas Adapte
634,2015,Mathematique,3,La Derivation,1,Derivee en un Point,7,635,5,QCU,0.61,0.21,15.0,12,69,81,76,12,64,1.07,15.79,Facile,Difficile,-2,Beaucoup plus Difficile,Pas Adapte
1745,2016,Mathematique,3,La Derivation,1,Derivee en un Point,7,635,5,QCU,0.28,0.55,61.0,43,28,71,66,43,23,1.08,65.15,Moyen,Moyen,0,Meme Difficulté,Pas Adapte
2856,2017,Mathematique,3,La Derivation,1,Derivee en un Point,7,635,5,QROC,0.71,0.07,31.0,21,48,69,65,21,44,1.06,32.31,Moyen,Difficile,-1,Plus Difficile,Pas Adapte
3967,2018,Mathematique,3,La Derivation,1,Derivee en un Point,7,635,5,QCM,0.46,0.38,37.0,23,38,61,28,23,5,2.18,82.14,Facile,Moyen,-1,Plus Difficile,Pas Adapte
5078,2019,Mathematique,3,La Derivation,1,Derivee en un Point,7,635,5,QCU,0.53,0.28,17.0,12,58,70,35,12,23,2.0,34.29,Facile,Difficile,-2,Beaucoup plus Difficile,Pas Adapte
6189,2020,Mathematique,3,La Derivation,1,Derivee en un Point,7,635,5,QCU,0.55,0.28,12.0,9,69,78,59,9,50,1.32,15.25,Moyen,Difficile,-1,Plus Difficile,Pas Adapte
635,2015,Mathematique,3,La Derivation,1,Derivee en un Point,7,636,6,QCM,0.75,0.19,10.0,9,77,86,39,9,30,2.21,23.08,Facile,Difficile,-2,Beaucoup plus Difficile,Pas Adapte
1746,2016,Mathematique,3,La Derivation,1,Derivee en un Point,7,636,6,QCM,0.66,0.18,4.0,4,94,98,47,4,43,2.09,8.51,Facile,Difficile,-2,Beaucoup plus Difficile,Pas Adapte
2857,2017,Mathematique,3,La Derivation,1,Derivee en un Point,7,636,6,QCM,0.24,0.61,39.0,41,64,105,74,41,33,1.42,55.41,Facile,Moyen,-1,Plus Difficile,Pas Adapte
3968,2018,Mathematique,3,La Derivation,1,Derivee en un Point,7,636,6,QCM,0.38,0.47,51.0,54,51,105,81,54,27,1.3,66.67,Moyen,Moyen,0,Meme Difficulté,Pas Adapte
5079,2019,Mathematique,3,La Derivation,1,Derivee en un Point,7,636,6,QCM,0.73,0.21,28.0,29,73,102,88,29,59,1.16,32.95,Difficile,Difficile,0,Meme Difficulté,Pas Adapte
6190,2020,Mathematique,3,La Derivation,1,Derivee en un Point,7,636,6,QCM,0.34,0.59,55.0,51,41,92,66,51,15,1.39,77.27,Facile,Moyen,-1,Plus Difficile,Pas Adapte
636,2015,Mathematique,3,La Derivation,1,Derivee en un Point,7,637,7,QCM,0.54,0.25,23.0,14,49,63,25,14,11,2.52,56.0,Facile,Difficile,-2,Beaucoup plus Difficile,Pas Adapte
1747,2016,Mathematique,3,La Derivation,1,Derivee en un Point,7,637,7,QCM,0.5,0.59,53.0,37,33,70,40,37,3,1.75,92.5,Facile,Moyen,-1,Plus Difficile,Pas Adapte
2858,2017,Mathematique,3,La Derivation,1,Derivee en un Point,7,637,7,QCM,0.27,0.56,42.0,33,45,78,56,33,23,1.39,58.93,Moyen,Moyen,0,Meme Difficulté,Pas Adapte
3969,2018,Mathematique,3,La Derivation,1,Derivee en un Point,7,637,7,QCM,0.25,0.57,39.0,34,53,87,81,34,47,1.07,41.98,Moyen,Moyen,0,Meme Difficulté,Pas Adapte
5080,2019,Mathematique,3,La Derivation,1,Derivee en un Point,7,637,7,QCM,0.35,0.6,58.0,52,38,90,71,52,19,1.27,73.24,Facile,Moyen,-1,Plus Difficile,Pas Adapte
6191,2020,Mathematique,3,La Derivation,1,Derivee en un Point,7,637,7,QCM,0.43,0.35,41.0,40,57,97,80,40,40,1.21,50.0,Difficile,Moyen,1,Plus Facile,Pas Adapte
637,2015,Mathematique,3,La Derivation,2,Derivee Globale,7,638,1,QO,0.47,0.2,60.0,21,14,35,35,21,14,1.0,60.0,Facile,Moyen,-1,Plus Difficile,Pas Adapte
1748,2016,Mathematique,3,La Derivation,2,Derivee Globale,7,638,1,QO,0.87,0.11,14.0,5,32,37,29,5,24,1.28,17.24,Moyen,Difficile,-1,Plus Difficile,Pas Adapte
2859,2017,Mathematique,3,La Derivation,2,Derivee Globale,7,638,1,QO,0.61,0.23,56.0,21,17,38,32,21,11,1.19,65.62,Difficile,Moyen,1,Plus Facile,Pas Adapte
3970,2018,Mathematique,3,La Derivation,2,Derivee Globale,7,638,1,QCM,0.6,0.27,18.0,6,30,36,31,6,25,1.16,19.35,Difficile,Difficile,0,Meme Difficulté,Pas Adapte
5081,2019,Mathematique,3,La Derivation,2,Derivee Globale,7,638,1,QCM,0.31,0.33,39.0,15,24,39,22,15,7,1.77,68.18,Difficile,Moyen,1,Plus Facile,Pas Adapte
6192,2020,Mathematique,3,La Derivation,2,Derivee Globale,7,638,1,QCM,0.36,0.64,61.0,20,13,33,27,20,7,1.22,74.07,Difficile,Moyen,1,Plus Facile,Pas Adapte
638,2015,Mathematique,3,La Derivation,2,Derivee Globale,7,639,2,QCM,0.38,0.62,49.0,44,46,90,71,44,27,1.27,61.97,Facile,Moyen,-1,Plus Difficile,Pas Adapte
1749,2016,Mathematique,3,La Derivation,2,Derivee Globale,7,639,2,QCM,0.27,0.62,43.0,43,57,100,59,43,16,1.69,72.88,Facile,Moyen,-1,Plus Difficile,Pas Adapte
2860,2017,Mathematique,3,La Derivation,2,Derivee Globale,7,639,2,QCU,0.68,0.38,29.0,31,76,107,103,31,72,1.04,30.1,Moyen,Difficile,-1,Plus Difficile,Pas Adapte
3971,2018,Mathematique,3,La Derivation,2,Derivee Globale,7,639,2,QCU,0.74,0.39,11.0,10,82,92,89,10,79,1.03,11.24,Facile,Difficile,-2,Beaucoup plus Difficile,Pas Adapte
5082,2019,Mathematique,3,La Derivation,2,Derivee Globale,7,639,2,QCU,0.25,0.59,48.0,48,53,101,62,48,14,1.63,77.42,Facile,Moyen,-1,Plus Difficile,Pas Adapte
6193,2020,Mathematique,3,La Derivation,2,Derivee Globale,7,639,2,QCU,0.71,0.36,29.0,31,77,108,57,31,26,1.89,54.39,Difficile,Difficile,0,Meme Difficulté,Pas Adapte
639,2015,Mathematique,3,La Derivation,2,Derivee Globale,7,640,3,QCU,0.45,0.22,9.0,4,45,49,32,4,28,1.53,12.5,Difficile,Difficile,0,Meme Difficulté,Pas Adapte
1750,2016,Mathematique,3,La Derivation,2,Derivee Globale,7,640,3,QCU,0.65,0.31,33.0,17,36,53,20,17,3,2.65,85.0,Facile,Difficile,-2,Beaucoup plus Difficile,Pas Adapte
2861,2017,Mathematique,3,La Derivation,2,Derivee Globale,7,640,3,QCU,0.21,0.7,40.0,22,33,55,26,22,4,2.12,84.62,Facile,Moyen,-1,Plus Difficile,Pas Adapte
3972,2018,Mathematique,3,La Derivation,2,Derivee Globale,7,640,3,QCU,0.55,0.25,29.0,17,40,57,45,17,28,1.27,37.78,Difficile,Difficile,0,Meme Difficulté,Pas Adapte
5083,2019,Mathematique,3,La Derivation,2,Derivee Globale,7,640,3,QCU,0.53,0.23,33.0,18,36,54,19,18,1,2.84,94.74,Difficile,Difficile,0,Meme Difficulté,Pas Adapte
6194,2020,Mathematique,3,La Derivation,2,Derivee Globale,7,640,3,QCU,0.65,0.39,34.0,20,38,58,21,20,1,2.76,95.24,Difficile,Difficile,0,Meme Difficulté,Pas Adapte
640,2015,Mathematique,3,La Derivation,2,Derivee Globale,7,641,4,QCM,0.61,0.23,6.0,1,20,21,13,1,12,1.62,7.69,Moyen,Difficile,-1,Plus Difficile,Pas Adapte
1751,2016,Mathematique,3,La Derivation,2,Derivee Globale,7,641,4,QCU,0.21,0.62,47.0,10,11,21,17,10,7,1.24,58.82,Moyen,Moyen,0,Meme Difficulté,Pas Adapte
2862,2017,Mathematique,3,La Derivation,2,Derivee Globale,7,641,4,QCU,0.61,0.21,29.0,6,13,19,13,6,7,1.46,46.15,Difficile,Difficile,0,Meme Difficulté,Pas Adapte
3973,2018,Mathematique,3,La Derivation,2,Derivee Globale,7,641,4,QCU,0.37,0.51,52.0,10,9,19,18,10,8,1.06,55.56,Facile,Moyen,-1,Plus Difficile,Pas Adapte
5084,2019,Mathematique,3,La Derivation,2,Derivee Globale,7,641,4,QCU,0.31,0.61,54.0,10,8,18,15,10,5,1.2,66.67,Facile,Moyen,-1,Plus Difficile,Pas Adapte
6195,2020,Mathematique,3,La Derivation,2,Derivee Globale,7,641,4,QCU,0.11,0.78,69.0,11,5,16,13,11,2,1.23,84.62,Facile,Facile,0,Meme Difficulté,Adapte
641,2015,Mathematique,3,La Derivation,2,Derivee Globale,7,642,5,QROC,0.8,0.04,21.0,16,61,77,34,16,18,2.26,47.06,Facile,Difficile,-2,Beaucoup plus Difficile,Pas Adapte
1752,2016,Mathematique,3,La Derivation,2,Derivee Globale,7,642,5,QROC,0.88,0.19,27.0,24,64,88,59,24,35,1.49,40.68,Difficile,Difficile,0,Meme Difficulté,Pas Adapte
2863,2017,Mathematique,3,La Derivation,2,Derivee Globale,7,642,5,QO,0.74,0.16,64.0,55,31,86,82,55,27,1.05,67.07,Difficile,Moyen,1,Plus Facile,Pas Adapte
3974,2018,Mathematique,3,La Derivation,2,Derivee Globale,7,642,5,QROC,0.61,0.09,32.0,26,54,80,80,26,54,1.0,32.5,Facile,Difficile,-2,Beaucoup plus Difficile,Pas Adapte
5085,2019,Mathematique,3,La Derivation,2,Derivee Globale,7,642,5,QROC,0.59,0.31,54.0,48,40,88,76,48,28,1.16,63.16,Facile,Moyen,-1,Plus Difficile,Pas Adapte
6196,2020,Mathematique,3,La Derivation,2,Derivee Globale,7,642,5,QROC,0.17,0.64,65.0,64,35,99,79,64,15,1.25,81.01,Difficile,Facile,2,Beaucoup plus Facile,Adapte
642,2015,Mathematique,3,La Derivation,2,Derivee Globale,7,643,6,QROC,0.76,0.09,2.0,1,32,33,15,1,14,2.2,6.67,Difficile,Difficile,0,Meme Difficulté,Pas Adapte
1753,2016,Mathematique,3,La Derivation,2,Derivee Globale,7,643,6,QROC,0.72,0.15,26.0,8,24,32,24,8,16,1.33,33.33,Difficile,Difficile,0,Meme Difficulté,Pas Adapte
2864,2017,Mathematique,3,La Derivation,2,Derivee Globale,7,643,6,QROC,0.64,0.04,31.0,10,21,31,13,10,3,2.38,76.92,Moyen,Difficile,-1,Plus Difficile,Pas Adapte
3975,2018,Mathematique,3,La Derivation,2,Derivee Globale,7,643,6,QROC,0.0,0.61,67.0,22,11,33,26,22,4,1.27,84.62,Moyen,Facile,1,Plus Facile,Adapte
5086,2019,Mathematique,3,La Derivation,2,Derivee Globale,7,643,6,QROC,0.1,1.0,67.0,20,10,30,23,20,3,1.3,86.96,Facile,Facile,0,Meme Difficulté,Adapte
6197,2020,Mathematique,3,La Derivation,2,Derivee Globale,7,643,6,QROC,0.11,0.46,67.0,21,10,31,28,21,7,1.11,75.0,Facile,Facile,0,Meme Difficulté,Adapte
643,2015,Mathematique,3,La Derivation,2,Derivee Globale,7,644,7,QCM,0.52,0.25,6.0,2,35,37,22,2,20,1.68,9.09,Facile,Difficile,-2,Beaucoup plus Difficile,Pas Adapte
1754,2016,Mathematique,3,La Derivation,2,Derivee Globale,7,644,7,QCU,0.61,0.37,14.0,5,34,39,27,5,22,1.44,18.52,Facile,Difficile,-2,Beaucoup plus Difficile,Pas Adapte
2865,2017,Mathematique,3,La Derivation,2,Derivee Globale,7,644,7,QCU,0.18,0.81,68.0,27,13,40,33,27,6,1.21,81.82,Moyen,Facile,1,Plus Facile,Adapte
3976,2018,Mathematique,3,La Derivation,2,Derivee Globale,7,644,7,QCU,0.14,0.84,68.0,29,13,42,39,29,10,1.08,74.36,Facile,Facile,0,Meme Difficulté,Adapte
5087,2019,Mathematique,3,La Derivation,2,Derivee Globale,7,644,7,QCU,0.2,0.95,68.0,25,12,37,28,25,3,1.32,89.29,Facile,Facile,0,Meme Difficulté,Adapte
6198,2020,Mathematique,3,La Derivation,2,Derivee Globale,7,644,7,QROC,0.06,0.65,68.0,22,10,32,24,22,2,1.33,91.67,Facile,Facile,0,Meme Difficulté,Adapte
644,2015,Mathematique,3,La Derivation,3,Theroeme de Rolle et des Accroissements Finis,14,645,1,QCU,0.21,0.74,57.0,22,17,39,26,22,4,1.5,84.62,Moyen,Moyen,0,Meme Difficulté,Pas Adapte
1755,2016,Mathematique,3,La Derivation,3,Theroeme de Rolle et des Accroissements Finis,14,645,1,QCU,0.27,0.54,53.0,21,19,40,23,21,2,1.74,91.3,Difficile,Moyen,1,Plus Facile,Pas Adapte
2866,2017,Mathematique,3,La Derivation,3,Theroeme de Rolle et des Accroissements Finis,14,645,1,QCU,0.23,0.6,37.0,15,26,41,16,15,1,2.56,93.75,Moyen,Moyen,0,Meme Difficulté,Pas Adapte
3977,2018,Mathematique,3,La Derivation,3,Theroeme de Rolle et des Accroissements Finis,14,645,1,QCU,0.69,0.21,16.0,6,33,39,25,6,19,1.56,24.0,Difficile,Difficile,0,Meme Difficulté,Pas Adapte
5088,2019,Mathematique,3,La Derivation,3,Theroeme de Rolle et des Accroissements Finis,14,645,1,QCU,0.64,0.24,7.0,3,33,36,13,3,10,2.77,23.08,Difficile,Difficile,0,Meme Difficulté,Pas Adapte
6199,2020,Mathematique,3,La Derivation,3,Theroeme de Rolle et des Accroissements Finis,14,645,1,QCU,0.34,0.71,61.0,22,14,36,23,22,1,1.57,95.65,Facile,Moyen,-1,Plus Difficile,Pas Adapte
645,2015,Mathematique,3,La Derivation,3,Theroeme de Rolle et des Accroissements Finis,14,646,2,QCU,0.68,0.37,12.0,2,13,15,14,2,12,1.07,14.29,Difficile,Difficile,0,Meme Difficulté,Pas Adapte
1756,2016,Mathematique,3,La Derivation,3,Theroeme de Rolle et des Accroissements Finis,14,646,2,QCU,0.7,0.35,6.0,1,13,14,10,1,9,1.4,10.0,Facile,Difficile,-2,Beaucoup plus Difficile,Pas Adapte
2867,2017,Mathematique,3,La Derivation,3,Theroeme de Rolle et des Accroissements Finis,14,646,2,QCU,0.74,0.27,4.0,1,13,14,5,1,4,2.8,20.0,Difficile,Difficile,0,Meme Difficulté,Pas Adapte
3978,2018,Mathematique,3,La Derivation,3,Theroeme de Rolle et des Accroissements Finis,14,646,2,QCU,0.5,0.38,10.0,1,11,12,6,1,5,2.0,16.67,Moyen,Difficile,-1,Plus Difficile,Pas Adapte
5089,2019,Mathematique,3,La Derivation,3,Theroeme de Rolle et des Accroissements Finis,14,646,2,QCU,0.52,0.39,16.0,2,10,12,11,2,9,1.09,18.18,Moyen,Difficile,-1,Plus Difficile,Pas Adapte
6200,2020,Mathematique,3,La Derivation,3,Theroeme de Rolle et des Accroissements Finis,14,646,2,QCU,0.44,0.27,1.0,0,10,10,4,0,4,2.5,0.0,Difficile,Difficile,0,Meme Difficulté,Pas Adapte
646,2015,Mathematique,3,La Derivation,3,Theroeme de Rolle et des Accroissements Finis,14,647,3,QCM,0.64,0.16,29.0,28,70,98,93,28,65,1.05,30.11,Difficile,Difficile,0,Meme Difficulté,Pas Adapte
1757,2016,Mathematique,3,La Derivation,3,Theroeme de Rolle et des Accroissements Finis,14,647,3,QCU,0.47,0.4,8.0,7,82,89,33,7,26,2.7,21.21,Moyen,Difficile,-1,Plus Difficile,Pas Adapte
2868,2017,Mathematique,3,La Derivation,3,Theroeme de Rolle et des Accroissements Finis,14,647,3,QCU,0.44,0.31,13.0,11,72,83,48,11,37,1.73,22.92,Facile,Difficile,-2,Beaucoup plus Difficile,Pas Adapte
3979,2018,Mathematique,3,La Derivation,3,Theroeme de Rolle et des Accroissements Finis,14,647,3,QCU,0.62,0.25,27.0,19,53,72,55,19,36,1.31,34.55,Facile,Difficile,-2,Beaucoup plus Difficile,Pas Adapte
5090,2019,Mathematique,3,La Derivation,3,Theroeme de Rolle et des Accroissements Finis,14,647,3,QCM,0.39,0.3,38.0,28,47,75,35,28,7,2.14,80.0,Moyen,Moyen,0,Meme Difficulté,Pas Adapte
6201,2020,Mathematique,3,La Derivation,3,Theroeme de Rolle et des Accroissements Finis,14,647,3,QCM,0.57,0.15,32.0,25,52,77,66,25,41,1.17,37.88,Facile,Difficile,-2,Beaucoup plus Difficile,Pas Adapte
647,2015,Mathematique,3,La Derivation,3,Theroeme de Rolle et des Accroissements Finis,14,648,4,QCU,0.26,0.5,40.0,25,37,62,29,25,4,2.14,86.21,Moyen,Moyen,0,Meme Difficulté,Pas Adapte
1758,2016,Mathematique,3,La Derivation,3,Theroeme de Rolle et des Accroissements Finis,14,648,4,QCU,0.74,0.32,23.0,15,49,64,45,15,30,1.42,33.33,Facile,Difficile,-2,Beaucoup plus Difficile,Pas Adapte
2869,2017,Mathematique,3,La Derivation,3,Theroeme de Rolle et des Accroissements Finis,14,648,4,QCU,0.57,0.39,1.0,1,60,61,31,1,30,1.97,3.23,Facile,Difficile,-2,Beaucoup plus Difficile,Pas Adapte
3980,2018,Mathematique,3,La Derivation,3,Theroeme de Rolle et des Accroissements Finis,14,648,4,QCU,0.4,0.21,25.0,15,44,59,26,15,11,2.27,57.69,Difficile,Difficile,0,Meme Difficulté,Pas Adapte
5091,2019,Mathematique,3,La Derivation,3,Theroeme de Rolle et des Accroissements Finis,14,648,4,QCU,0.46,0.34,16.0,10,50,60,52,10,42,1.15,19.23,Facile,Difficile,-2,Beaucoup plus Difficile,Pas Adapte
6202,2020,Mathematique,3,La Derivation,3,Theroeme de Rolle et des Accroissements Finis,14,648,4,QCU,0.68,0.25,7.0,4,54,58,39,4,35,1.49,10.26,Facile,Difficile,-2,Beaucoup plus Difficile,Pas Adapte
648,2015,Mathematique,3,La Derivation,3,Theroeme de Rolle et des Accroissements Finis,14,649,5,QCU,0.43,0.32,12.0,7,55,62,34,7,27,1.82,20.59,Moyen,Difficile,-1,Plus Difficile,Pas Adapte
1759,2016,Mathematique,3,La Derivation,3,Theroeme de Rolle et des Accroissements Finis,14,649,5,QCU,0.29,0.57,59.0,35,25,60,41,35,6,1.46,85.37,Moyen,Moyen,0,Meme Difficulté,Pas Adapte
2870,2017,Mathematique,3,La Derivation,3,Theroeme de Rolle et des Accroissements Finis,14,649,5,QCU,0.41,0.25,18.0,11,50,61,27,11,16,2.26,40.74,Moyen,Difficile,-1,Plus Difficile,Pas Adapte
3981,2018,Mathematique,3,La Derivation,3,Theroeme de Rolle et des Accroissements Finis,14,649,5,QCU,0.2,0.48,59.0,37,25,62,54,37,17,1.15,68.52,Difficile,Moyen,1,Plus Facile,Pas Adapte
5092,2019,Mathematique,3,La Derivation,3,Theroeme de Rolle et des Accroissements Finis,14,649,5,QCU,0.57,0.26,22.0,13,46,59,22,13,9,2.68,59.09,Moyen,Difficile,-1,Plus Difficile,Pas Adapte
6203,2020,Mathematique,3,La Derivation,3,Theroeme de Rolle et des Accroissements Finis,14,649,5,QCU,0.4,0.45,40.0,27,40,67,29,27,2,2.31,93.1,Difficile,Moyen,1,Plus Facile,Pas Adapte
649,2015,Mathematique,3,La Derivation,3,Theroeme de Rolle et des Accroissements Finis,14,650,6,QCU,0.14,0.81,66.0,48,24,72,68,48,20,1.06,70.59,Facile,Facile,0,Meme Difficulté,Adapte
1760,2016,Mathematique,3,La Derivation,3,Theroeme de Rolle et des Accroissements Finis,14,650,6,QCU,0.13,0.89,66.0,48,24,72,59,48,11,1.22,81.36,Facile,Facile,0,Meme Difficulté,Adapte
2871,2017,Mathematique,3,La Derivation,3,Theroeme de Rolle et des Accroissements Finis,14,650,6,QCU,0.03,0.9,66.0,53,28,81,81,53,28,1.0,65.43,Facile,Facile,0,Meme Difficulté,Adapte
3982,2018,Mathematique,3,La Derivation,3,Theroeme de Rolle et des Accroissements Finis,14,650,6,QCU,0.14,0.9,66.0,52,27,79,77,52,25,1.03,67.53,Facile,Facile,0,Meme Difficulté,Adapte
5093,2019,Mathematique,3,La Derivation,3,Theroeme de Rolle et des Accroissements Finis,14,650,6,QCU,0.11,0.83,66.0,49,25,74,56,49,7,1.32,87.5,Facile,Facile,0,Meme Difficulté,Adapte
6204,2020,Mathematique,3,La Derivation,3,Theroeme de Rolle et des Accroissements Finis,14,650,6,QCU,0.05,0.9,66.0,50,25,75,53,50,3,1.42,94.34,Facile,Facile,0,Meme Difficulté,Adapte
650,2015,Mathematique,3,La Derivation,3,Theroeme de Rolle et des Accroissements Finis,14,651,7,QCM,0.31,0.42,37.0,26,45,71,31,26,5,2.29,83.87,Facile,Moyen,-1,Plus Difficile,Pas Adapte
1761,2016,Mathematique,3,La Derivation,3,Theroeme de Rolle et des Accroissements Finis,14,651,7,QCM,0.77,0.22,30.0,18,43,61,43,18,25,1.42,41.86,Difficile,Difficile,0,Meme Difficulté,Pas Adapte
2872,2017,Mathematique,3,La Derivation,3,Theroeme de Rolle et des Accroissements Finis,14,651,7,QCM,0.26,0.55,64.0,39,22,61,54,39,15,1.13,72.22,Difficile,Moyen,1,Plus Facile,Pas Adapte
3983,2018,Mathematique,3,La Derivation,3,Theroeme de Rolle et des Accroissements Finis,14,651,7,QCM,0.16,0.88,67.0,46,23,69,47,46,1,1.47,97.87,Facile,Facile,0,Meme Difficulté,Adapte
5094,2019,Mathematique,3,La Derivation,3,Theroeme de Rolle et des Accroissements Finis,14,651,7,QCM,0.03,0.84,67.0,53,26,79,68,53,15,1.16,77.94,Facile,Facile,0,Meme Difficulté,Adapte
6205,2020,Mathematique,3,La Derivation,3,Theroeme de Rolle et des Accroissements Finis,14,651,7,QCM,0.19,0.89,67.0,60,30,90,67,60,7,1.34,89.55,Facile,Facile,0,Meme Difficulté,Adapte
651,2015,Mathematique,3,La Derivation,3,Theroeme de Rolle et des Accroissements Finis,14,652,8,QCU,0.56,0.33,26.0,3,9,12,9,3,6,1.33,33.33,Facile,Difficile,-2,Beaucoup plus Difficile,Pas Adapte
1762,2016,Mathematique,3,La Derivation,3,Theroeme de Rolle et des Accroissements Finis,14,652,8,QO,0.81,0.12,30.0,3,7,10,9,3,6,1.11,33.33,Facile,Difficile,-2,Beaucoup plus Difficile,Pas Adapte
2873,2017,Mathematique,3,La Derivation,3,Theroeme de Rolle et des Accroissements Finis,14,652,8,QO,0.21,0.17,58.0,7,5,12,10,7,3,1.2,70.0,Moyen,Moyen,0,Meme Difficulté,Pas Adapte
3984,2018,Mathematique,3,La Derivation,3,Theroeme de Rolle et des Accroissements Finis,14,652,8,QO,0.24,0.23,54.0,6,6,12,8,6,2,1.5,75.0,Difficile,Moyen,1,Plus Facile,Pas Adapte
5095,2019,Mathematique,3,La Derivation,3,Theroeme de Rolle et des Accroissements Finis,14,652,8,QCM,0.59,0.18,6.0,1,10,11,7,1,6,1.57,14.29,Facile,Difficile,-2,Beaucoup plus Difficile,Pas Adapte
6206,2020,Mathematique,3,La Derivation,3,Theroeme de Rolle et des Accroissements Finis,14,652,8,QCM,0.69,0.26,11.0,1,8,9,4,1,3,2.25,25.0,Moyen,Difficile,-1,Plus Difficile,Pas Adapte
652,2015,Mathematique,3,La Derivation,3,Theroeme de Rolle et des Accroissements Finis,14,653,9,QCM,0.66,0.3,11.0,6,52,58,55,6,49,1.05,10.91,Moyen,Difficile,-1,Plus Difficile,Pas Adapte
1763,2016,Mathematique,3,La Derivation,3,Theroeme de Rolle et des Accroissements Finis,14,653,9,QO,0.3,0.26,57.0,28,22,50,42,28,14,1.19,66.67,Facile,Moyen,-1,Plus Difficile,Pas Adapte
2874,2017,Mathematique,3,La Derivation,3,Theroeme de Rolle et des Accroissements Finis,14,653,9,QO,0.66,0.24,38.0,19,32,51,36,19,17,1.42,52.78,Difficile,Moyen,1,Plus Facile,Pas Adapte
3985,2018,Mathematique,3,La Derivation,3,Theroeme de Rolle et des Accroissements Finis,14,653,9,QCU,0.24,0.69,40.0,19,28,47,42,19,23,1.12,45.24,Moyen,Moyen,0,Meme Difficulté,Pas Adapte
5096,2019,Mathematique,3,La Derivation,3,Theroeme de Rolle et des Accroissements Finis,14,653,9,QCU,0.5,0.22,23.0,11,38,49,17,11,6,2.88,64.71,Difficile,Difficile,0,Meme Difficulté,Pas Adapte
6207,2020,Mathematique,3,La Derivation,3,Theroeme de Rolle et des Accroissements Finis,14,653,9,QCU,0.19,0.87,65.0,33,18,51,41,33,8,1.24,80.49,Facile,Facile,0,Meme Difficulté,Adapte
653,2015,Mathematique,3,La Derivation,3,Theroeme de Rolle et des Accroissements Finis,14,654,10,QCU,0.72,0.29,26.0,4,12,16,7,4,3,2.29,57.14,Facile,Difficile,-2,Beaucoup plus Difficile,Pas Adapte
1764,2016,Mathematique,3,La Derivation,3,Theroeme de Rolle et des Accroissements Finis,14,654,10,QCM,0.21,0.61,38.0,6,11,17,12,6,6,1.42,50.0,Moyen,Moyen,0,Meme Difficulté,Pas Adapte
2875,2017,Mathematique,3,La Derivation,3,Theroeme de Rolle et des Accroissements Finis,14,654,10,QCM,0.74,0.19,3.0,1,17,18,13,1,12,1.38,7.69,Moyen,Difficile,-1,Plus Difficile,Pas Adapte
3986,2018,Mathematique,3,La Derivation,3,Theroeme de Rolle et des Accroissements Finis,14,654,10,QCM,0.45,0.47,40.0,8,13,21,14,8,6,1.5,57.14,Facile,Moyen,-1,Plus Difficile,Pas Adapte
5097,2019,Mathematique,3,La Derivation,3,Theroeme de Rolle et des Accroissements Finis,14,654,10,QROC,0.71,0.04,25.0,6,17,23,20,6,14,1.15,30.0,Moyen,Difficile,-1,Plus Difficile,Pas Adapte
6208,2020,Mathematique,3,La Derivation,3,Theroeme de Rolle et des Accroissements Finis,14,654,10,QROC,0.01,0.79,68.0,15,7,22,19,15,4,1.16,78.95,Facile,Facile,0,Meme Difficulté,Adapte
654,2015,Mathematique,3,La Derivation,3,Theroeme de Rolle et des Accroissements Finis,14,655,11,QCU,0.58,0.33,28.0,17,43,60,37,17,20,1.62,45.95,Facile,Difficile,-2,Beaucoup plus Difficile,Pas Adapte
1765,2016,Mathematique,3,La Derivation,3,Theroeme de Rolle et des Accroissements Finis,14,655,11,QCU,0.34,0.62,64.0,40,22,62,61,40,21,1.02,65.57,Moyen,Moyen,0,Meme Difficulté,Pas Adapte
2876,2017,Mathematique,3,La Derivation,3,Theroeme de Rolle et des Accroissements Finis,14,655,11,QCU,0.62,0.2,9.0,5,54,59,45,5,40,1.31,11.11,Difficile,Difficile,0,Meme Difficulté,Pas Adapte
3987,2018,Mathematique,3,La Derivation,3,Theroeme de Rolle et des Accroissements Finis,14,655,11,QCU,0.27,0.52,57.0,30,23,53,30,30,0,1.77,100.0,Facile,Moyen,-1,Plus Difficile,Pas Adapte
5098,2019,Mathematique,3,La Derivation,3,Theroeme de Rolle et des Accroissements Finis,14,655,11,QCU,0.36,0.48,64.0,29,17,46,34,29,5,1.35,85.29,Moyen,Moyen,0,Meme Difficulté,Pas Adapte
6209,2020,Mathematique,3,La Derivation,3,Theroeme de Rolle et des Accroissements Finis,14,655,11,QCU,0.27,0.72,43.0,18,23,41,40,18,22,1.02,45.0,Facile,Moyen,-1,Plus Difficile,Pas Adapte
655,2015,Mathematique,3,La Derivation,3,Theroeme de Rolle et des Accroissements Finis,14,656,12,QCU,0.21,0.67,46.0,41,49,90,87,41,46,1.03,47.13,Moyen,Moyen,0,Meme Difficulté,Pas Adapte
1766,2016,Mathematique,3,La Derivation,3,Theroeme de Rolle et des Accroissements Finis,14,656,12,QCU,0.28,0.64,51.0,40,39,79,62,40,22,1.27,64.52,Difficile,Moyen,1,Plus Facile,Pas Adapte
2877,2017,Mathematique,3,La Derivation,3,Theroeme de Rolle et des Accroissements Finis,14,656,12,QCU,0.24,0.53,54.0,48,40,88,85,48,37,1.04,56.47,Difficile,Moyen,1,Plus Facile,Pas Adapte
3988,2018,Mathematique,3,La Derivation,3,Theroeme de Rolle et des Accroissements Finis,14,656,12,QCU,0.63,0.34,34.0,26,49,75,40,26,14,1.88,65.0,Difficile,Difficile,0,Meme Difficulté,Pas Adapte
5099,2019,Mathematique,3,La Derivation,3,Theroeme de Rolle et des Accroissements Finis,14,656,12,QCU,0.22,0.45,48.0,36,40,76,37,36,1,2.05,97.3,Facile,Moyen,-1,Plus Difficile,Pas Adapte
6210,2020,Mathematique,3,La Derivation,3,Theroeme de Rolle et des Accroissements Finis,14,656,12,QCU,0.15,0.87,66.0,47,24,71,67,47,20,1.06,70.15,Difficile,Facile,2,Beaucoup plus Facile,Adapte
656,2015,Mathematique,3,La Derivation,3,Theroeme de Rolle et des Accroissements Finis,14,657,13,QROC,0.76,0.2,30.0,9,20,29,19,9,10,1.53,47.37,Facile,Difficile,-2,Beaucoup plus Difficile,Pas Adapte
1767,2016,Mathematique,3,La Derivation,3,Theroeme de Rolle et des Accroissements Finis,14,657,13,QROC,0.72,0.04,33.0,11,22,33,25,11,14,1.32,44.0,Facile,Difficile,-2,Beaucoup plus Difficile,Pas Adapte
2878,2017,Mathematique,3,La Derivation,3,Theroeme de Rolle et des Accroissements Finis,14,657,13,QCU,0.27,0.41,59.0,18,12,30,22,18,4,1.36,81.82,Difficile,Moyen,1,Plus Facile,Pas Adapte
3989,2018,Mathematique,3,La Derivation,3,Theroeme de Rolle et des Accroissements Finis,14,657,13,QCU,0.7,0.33,7.0,2,31,33,28,2,26,1.18,7.14,Facile,Difficile,-2,Beaucoup plus Difficile,Pas Adapte
5100,2019,Mathematique,3,La Derivation,3,Theroeme de Rolle et des Accroissements Finis,14,657,13,QCU,0.21,0.65,52.0,16,15,31,23,16,7,1.35,69.57,Facile,Moyen,-1,Plus Difficile,Pas Adapte
6211,2020,Mathematique,3,La Derivation,3,Theroeme de Rolle et des Accroissements Finis,14,657,13,QCU,0.28,0.48,45.0,14,17,31,17,14,3,1.82,82.35,Facile,Moyen,-1,Plus Difficile,Pas Adapte
657,2015,Mathematique,3,La Derivation,3,Theroeme de Rolle et des Accroissements Finis,14,658,14,QCM,0.59,0.16,29.0,13,33,46,43,13,30,1.07,30.23,Difficile,Difficile,0,Meme Difficulté,Pas Adapte
1768,2016,Mathematique,3,La Derivation,3,Theroeme de Rolle et des Accroissements Finis,14,658,14,QCM,0.77,0.15,2.0,1,45,46,16,1,15,2.88,6.25,Moyen,Difficile,-1,Plus Difficile,Pas Adapte
2879,2017,Mathematique,3,La Derivation,3,Theroeme de Rolle et des Accroissements Finis,14,658,14,QCM,0.51,0.29,20.0,9,36,45,34,9,25,1.32,26.47,Difficile,Difficile,0,Meme Difficulté,Pas Adapte
3990,2018,Mathematique,3,La Derivation,3,Theroeme de Rolle et des Accroissements Finis,14,658,14,QCM,0.3,0.66,44.0,21,27,48,28,21,7,1.71,75.0,Facile,Moyen,-1,Plus Difficile,Pas Adapte
5101,2019,Mathematique,3,La Derivation,3,Theroeme de Rolle et des Accroissements Finis,14,658,14,QCM,0.26,0.37,45.0,20,25,45,32,20,12,1.41,62.5,Facile,Moyen,-1,Plus Difficile,Pas Adapte
6212,2020,Mathematique,3,La Derivation,3,Theroeme de Rolle et des Accroissements Finis,14,658,14,QCM,0.43,0.6,49.0,24,25,49,28,24,4,1.75,85.71,Moyen,Moyen,0,Meme Difficulté,Pas Adapte
658,2015,Mathematique,3,La Derivation,4,La Fonction Exponentielle Complexe,8,659,1,QROC,0.8,0.21,12.0,10,76,86,63,10,53,1.37,15.87,Moyen,Difficile,-1,Plus Difficile,Pas Adapte
1769,2016,Mathematique,3,La Derivation,4,La Fonction Exponentielle Complexe,8,659,1,QROC,0.71,0.2,33.0,29,60,89,79,29,50,1.13,36.71,Moyen,Difficile,-1,Plus Difficile,Pas Adapte
2880,2017,Mathematique,3,La Derivation,4,La Fonction Exponentielle Complexe,8,659,1,QROC,0.83,0.11,9.0,8,77,85,63,8,55,1.35,12.7,Facile,Difficile,-2,Beaucoup plus Difficile,Pas Adapte
3991,2018,Mathematique,3,La Derivation,4,La Fonction Exponentielle Complexe,8,659,1,QROC,0.52,0.28,60.0,57,38,95,70,57,13,1.36,81.43,Moyen,Moyen,0,Meme Difficulté,Pas Adapte
5102,2019,Mathematique,3,La Derivation,4,La Fonction Exponentielle Complexe,8,659,1,QROC,0.28,0.27,43.0,45,60,105,98,45,53,1.07,45.92,Moyen,Moyen,0,Meme Difficulté,Pas Adapte
6213,2020,Mathematique,3,La Derivation,4,La Fonction Exponentielle Complexe,8,659,1,QROC,0.92,0.03,8.0,9,98,107,49,9,40,2.18,18.37,Difficile,Difficile,0,Meme Difficulté,Pas Adapte
659,2015,Mathematique,3,La Derivation,4,La Fonction Exponentielle Complexe,8,660,2,QCU,0.22,0.43,64.0,21,12,33,29,21,8,1.14,72.41,Facile,Moyen,-1,Plus Difficile,Pas Adapte
1770,2016,Mathematique,3,La Derivation,4,La Fonction Exponentielle Complexe,8,660,2,QCU,0.46,0.29,29.0,9,23,32,11,9,2,2.91,81.82,Difficile,Difficile,0,Meme Difficulté,Pas Adapte
2881,2017,Mathematique,3,La Derivation,4,La Fonction Exponentielle Complexe,8,660,2,QCU,0.35,0.5,64.0,17,10,27,24,17,7,1.12,70.83,Moyen,Moyen,0,Meme Difficulté,Pas Adapte
3992,2018,Mathematique,3,La Derivation,4,La Fonction Exponentielle Complexe,8,660,2,QCU,0.32,0.67,52.0,15,14,29,23,15,8,1.26,65.22,Difficile,Moyen,1,Plus Facile,Pas Adapte
5103,2019,Mathematique,3,La Derivation,4,La Fonction Exponentielle Complexe,8,660,2,QCU,0.71,0.33,6.0,2,30,32,28,2,26,1.14,7.14,Difficile,Difficile,0,Meme Difficulté,Pas Adapte
6214,2020,Mathematique,3,La Derivation,4,La Fonction Exponentielle Complexe,8,660,2,QCU,0.23,0.53,55.0,15,12,27,20,15,5,1.35,75.0,Moyen,Moyen,0,Meme Difficulté,Pas Adapte
660,2015,Mathematique,3,La Derivation,4,La Fonction Exponentielle Complexe,8,661,3,QO,0.87,0.09,11.0,9,73,82,69,9,60,1.19,13.04,Difficile,Difficile,0,Meme Difficulté,Pas Adapte
1771,2016,Mathematique,3,La Derivation,4,La Fonction Exponentielle Complexe,8,661,3,QO,0.31,0.2,46.0,42,50,92,58,42,16,1.59,72.41,Difficile,Moyen,1,Plus Facile,Pas Adapte
2882,2017,Mathematique,3,La Derivation,4,La Fonction Exponentielle Complexe,8,661,3,QO,0.93,0.11,31.0,32,72,104,93,32,61,1.12,34.41,Moyen,Difficile,-1,Plus Difficile,Pas Adapte
3993,2018,Mathematique,3,La Derivation,4,La Fonction Exponentielle Complexe,8,661,3,QROC,0.89,0.19,14.0,15,93,108,87,15,72,1.24,17.24,Difficile,Difficile,0,Meme Difficulté,Pas Adapte
5104,2019,Mathematique,3,La Derivation,4,La Fonction Exponentielle Complexe,8,661,3,QROC,0.75,0.07,34.0,32,63,95,59,32,27,1.61,54.24,Difficile,Difficile,0,Meme Difficulté,Pas Adapte
6215,2020,Mathematique,3,La Derivation,4,La Fonction Exponentielle Complexe,8,661,3,QO,0.99,0.09,2.0,2,83,85,55,2,53,1.55,3.64,Facile,Difficile,-2,Beaucoup plus Difficile,Pas Adapte
661,2015,Mathematique,3,La Derivation,4,La Fonction Exponentielle Complexe,8,662,4,QCU,0.29,0.53,64.0,45,26,71,46,45,1,1.54,97.83,Facile,Moyen,-1,Plus Difficile,Pas Adapte
1772,2016,Mathematique,3,La Derivation,4,La Fonction Exponentielle Complexe,8,662,4,QCU,0.34,0.5,48.0,32,35,67,50,32,18,1.34,64.0,Moyen,Moyen,0,Meme Difficulté,Pas Adapte
2883,2017,Mathematique,3,La Derivation,4,La Fonction Exponentielle Complexe,8,662,4,QCU,0.51,0.29,28.0,20,52,72,31,20,11,2.32,64.52,Difficile,Difficile,0,Meme Difficulté,Pas Adapte
3994,2018,Mathematique,3,La Derivation,4,La Fonction Exponentielle Complexe,8,662,4,QCU,0.42,0.21,3.0,2,66,68,50,2,48,1.36,4.0,Difficile,Difficile,0,Meme Difficulté,Pas Adapte
5105,2019,Mathematique,3,La Derivation,4,La Fonction Exponentielle Complexe,8,662,4,QCU,0.72,0.22,24.0,15,46,61,44,15,29,1.39,34.09,Facile,Difficile,-2,Beaucoup plus Difficile,Pas Adapte
6216,2020,Mathematique,3,La Derivation,4,La Fonction Exponentielle Complexe,8,662,4,QCU,0.29,0.51,62.0,40,24,64,45,40,5,1.42,88.89,Facile,Moyen,-1,Plus Difficile,Pas Adapte
662,2015,Mathematique,3,La Derivation,4,La Fonction Exponentielle Complexe,8,663,5,QCU,0.51,0.33,33.0,26,53,79,57,26,31,1.39,45.61,Difficile,Difficile,0,Meme Difficulté,Pas Adapte
1773,2016,Mathematique,3,La Derivation,4,La Fonction Exponentielle Complexe,8,663,5,QCU,0.51,0.3,24.0,18,55,73,46,18,28,1.59,39.13,Difficile,Difficile,0,Meme Difficulté,Pas Adapte
2884,2017,Mathematique,3,La Derivation,4,La Fonction Exponentielle Complexe,8,663,5,QCU,0.37,0.42,59.0,41,29,70,60,41,19,1.17,68.33,Facile,Moyen,-1,Plus Difficile,Pas Adapte
3995,2018,Mathematique,3,La Derivation,4,La Fonction Exponentielle Complexe,8,663,5,QCU,0.38,0.49,46.0,29,33,62,36,29,7,1.72,80.56,Facile,Moyen,-1,Plus Difficile,Pas Adapte
5106,2019,Mathematique,3,La Derivation,4,La Fonction Exponentielle Complexe,8,663,5,QCU,0.29,0.43,43.0,30,40,70,33,30,3,2.12,90.91,Moyen,Moyen,0,Meme Difficulté,Pas Adapte
6217,2020,Mathematique,3,La Derivation,4,La Fonction Exponentielle Complexe,8,663,5,QCU,0.38,0.6,41.0,26,38,64,62,26,36,1.03,41.94,Difficile,Moyen,1,Plus Facile,Pas Adapte
663,2015,Mathematique,3,La Derivation,4,La Fonction Exponentielle Complexe,8,664,6,QCU,0.59,0.31,25.0,7,20,27,26,7,19,1.04,26.92,Facile,Difficile,-2,Beaucoup plus Difficile,Pas Adapte
1774,2016,Mathematique,3,La Derivation,4,La Fonction Exponentielle Complexe,8,664,6,QCU,0.24,0.53,40.0,11,16,27,26,11,15,1.04,42.31,Difficile,Moyen,1,Plus Facile,Pas Adapte
2885,2017,Mathematique,3,La Derivation,4,La Fonction Exponentielle Complexe,8,664,6,QCM,0.24,0.66,57.0,16,12,28,22,16,6,1.27,72.73,Difficile,Moyen,1,Plus Facile,Pas Adapte
3996,2018,Mathematique,3,La Derivation,4,La Fonction Exponentielle Complexe,8,664,6,QCM,0.78,0.26,28.0,7,18,25,20,7,13,1.25,35.0,Moyen,Difficile,-1,Plus Difficile,Pas Adapte
5107,2019,Mathematique,3,La Derivation,4,La Fonction Exponentielle Complexe,8,664,6,QCU,0.27,0.56,60.0,16,10,26,21,16,5,1.24,76.19,Difficile,Moyen,1,Plus Facile,Pas Adapte
6218,2020,Mathematique,3,La Derivation,4,La Fonction Exponentielle Complexe,8,664,6,QROC,0.69,0.22,32.0,8,17,25,16,8,8,1.56,50.0,Facile,Difficile,-2,Beaucoup plus Difficile,Pas Adapte
664,2015,Mathematique,3,La Derivation,4,La Fonction Exponentielle Complexe,8,665,7,QCU,0.58,0.29,9.0,1,10,11,8,1,7,1.38,12.5,Moyen,Difficile,-1,Plus Difficile,Pas Adapte
1775,2016,Mathematique,3,La Derivation,4,La Fonction Exponentielle Complexe,8,665,7,QCU,0.36,0.71,51.0,5,4,9,7,5,2,1.29,71.43,Moyen,Moyen,0,Meme Difficulté,Pas Adapte
2886,2017,Mathematique,3,La Derivation,4,La Fonction Exponentielle Complexe,8,665,7,QCU,0.2,0.42,46.0,4,4,8,6,4,2,1.33,66.67,Moyen,Moyen,0,Meme Difficulté,Pas Adapte
3997,2018,Mathematique,3,La Derivation,4,La Fonction Exponentielle Complexe,8,665,7,QCU,0.56,0.28,6.0,1,8,9,3,1,2,3.0,33.33,Difficile,Difficile,0,Meme Difficulté,Pas Adapte
5108,2019,Mathematique,3,La Derivation,4,La Fonction Exponentielle Complexe,8,665,7,QCU,0.36,0.46,38.0,3,6,9,6,3,3,1.5,50.0,Moyen,Moyen,0,Meme Difficulté,Pas Adapte
6219,2020,Mathematique,3,La Derivation,4,La Fonction Exponentielle Complexe,8,665,7,QCU,0.4,0.68,57.0,5,3,8,6,5,1,1.33,83.33,Difficile,Moyen,1,Plus Facile,Pas Adapte
665,2015,Mathematique,3,La Derivation,4,La Fonction Exponentielle Complexe,8,666,8,QCU,0.39,0.43,59.0,42,30,72,68,42,26,1.06,61.76,Facile,Moyen,-1,Plus Difficile,Pas Adapte
1776,2016,Mathematique,3,La Derivation,4,La Fonction Exponentielle Complexe,8,666,8,QCU,0.69,0.22,13.0,10,69,79,34,10,24,2.32,29.41,Moyen,Difficile,-1,Plus Difficile,Pas Adapte
2887,2017,Mathematique,3,La Derivation,4,La Fonction Exponentielle Complexe,8,666,8,QCU,0.66,0.23,5.0,4,82,86,65,4,61,1.32,6.15,Difficile,Difficile,0,Meme Difficulté,Pas Adapte
3998,2018,Mathematique,3,La Derivation,4,La Fonction Exponentielle Complexe,8,666,8,QCU,0.53,0.31,26.0,23,64,87,40,23,17,2.17,57.5,Difficile,Difficile,0,Meme Difficulté,Pas Adapte
5109,2019,Mathematique,3,La Derivation,4,La Fonction Exponentielle Complexe,8,666,8,QCU,0.16,0.78,65.0,49,27,76,59,49,10,1.29,83.05,Difficile,Facile,2,Beaucoup plus Facile,Adapte
6220,2020,Mathematique,3,La Derivation,4,La Fonction Exponentielle Complexe,8,666,8,QCU,0.16,0.91,65.0,47,25,72,69,47,22,1.04,68.12,Facile,Facile,0,Meme Difficulté,Adapte
666,2015,Mathematique,3,La Derivation,5,Derivees d'Ordres Superieurs,1,667,1,QCM,0.29,0.43,53.0,47,41,88,61,47,14,1.44,77.05,Moyen,Moyen,0,Meme Difficulté,Pas Adapte
1777,2016,Mathematique,3,La Derivation,5,Derivees d'Ordres Superieurs,1,667,1,QCM,0.54,0.18,6.0,6,91,97,63,6,57,1.54,9.52,Facile,Difficile,-2,Beaucoup plus Difficile,Pas Adapte
2888,2017,Mathematique,3,La Derivation,5,Derivees d'Ordres Superieurs,1,667,1,QCM,0.36,0.66,36.0,35,61,96,61,35,26,1.57,57.38,Moyen,Moyen,0,Meme Difficulté,Pas Adapte
3999,2018,Mathematique,3,La Derivation,5,Derivees d'Ordres Superieurs,1,667,1,QCM,0.25,0.6,47.0,47,52,99,75,47,28,1.32,62.67,Difficile,Moyen,1,Plus Facile,Pas Adapte
5110,2019,Mathematique,3,La Derivation,5,Derivees d'Ordres Superieurs,1,667,1,QROC,0.78,0.0,7.0,6,83,89,48,6,42,1.85,12.5,Facile,Difficile,-2,Beaucoup plus Difficile,Pas Adapte
6221,2020,Mathematique,3,La Derivation,5,Derivees d'Ordres Superieurs,1,667,1,QO,0.52,0.28,52.0,40,36,76,62,40,22,1.23,64.52,Moyen,Moyen,0,Meme Difficulté,Pas Adapte
667,2015,Mathematique,3,La Derivation,6,Classe Cn par Morceaux,11,668,1,QCM,0.75,0.17,13.0,4,25,29,25,4,21,1.16,16.0,Difficile,Difficile,0,Meme Difficulté,Pas Adapte
1778,2016,Mathematique,3,La Derivation,6,Classe Cn par Morceaux,11,668,1,QCM,0.31,0.39,38.0,12,20,32,22,12,10,1.45,54.55,Difficile,Moyen,1,Plus Facile,Pas Adapte
2889,2017,Mathematique,3,La Derivation,6,Classe Cn par Morceaux,11,668,1,QCM,0.3,0.51,52.0,16,14,30,23,16,7,1.3,69.57,Difficile,Moyen,1,Plus Facile,Pas Adapte
4000,2018,Mathematique,3,La Derivation,6,Classe Cn par Morceaux,11,668,1,QCU,0.33,0.51,53.0,18,16,34,18,18,0,1.89,100.0,Moyen,Moyen,0,Meme Difficulté,Pas Adapte
5111,2019,Mathematique,3,La Derivation,6,Classe Cn par Morceaux,11,668,1,QCU,0.68,0.38,18.0,7,32,39,36,7,29,1.08,19.44,Moyen,Difficile,-1,Plus Difficile,Pas Adapte
6222,2020,Mathematique,3,La Derivation,6,Classe Cn par Morceaux,11,668,1,QCU,0.74,0.2,22.0,9,33,42,15,9,6,2.8,60.0,Moyen,Difficile,-1,Plus Difficile,Pas Adapte
668,2015,Mathematique,3,La Derivation,6,Classe Cn par Morceaux,11,669,2,QCM,0.36,0.5,44.0,41,53,94,72,41,31,1.31,56.94,Moyen,Moyen,0,Meme Difficulté,Pas Adapte
1779,2016,Mathematique,3,La Derivation,6,Classe Cn par Morceaux,11,669,2,QCM,0.66,0.24,4.0,3,84,87,24,3,21,3.62,12.5,Facile,Difficile,-2,Beaucoup plus Difficile,Pas Adapte
2890,2017,Mathematique,3,La Derivation,6,Classe Cn par Morceaux,11,669,2,QCM,0.29,0.5,50.0,38,38,76,39,38,1,1.95,97.44,Moyen,Moyen,0,Meme Difficulté,Pas Adapte
4001,2018,Mathematique,3,La Derivation,6,Classe Cn par Morceaux,11,669,2,QCM,0.39,0.36,54.0,46,39,85,72,46,26,1.18,63.89,Facile,Moyen,-1,Plus Difficile,Pas Adapte
5112,2019,Mathematique,3,La Derivation,6,Classe Cn par Morceaux,11,669,2,QCM,0.5,0.19,11.0,11,87,98,51,11,40,1.92,21.57,Moyen,Difficile,-1,Plus Difficile,Pas Adapte
6223,2020,Mathematique,3,La Derivation,6,Classe Cn par Morceaux,11,669,2,QCM,0.71,0.19,31.0,29,66,95,61,29,32,1.56,47.54,Facile,Difficile,-2,Beaucoup plus Difficile,Pas Adapte
669,2015,Mathematique,3,La Derivation,6,Classe Cn par Morceaux,11,670,3,QCU,0.71,0.4,1.0,1,95,96,77,1,76,1.25,1.3,Facile,Difficile,-2,Beaucoup plus Difficile,Pas Adapte
1780,2016,Mathematique,3,La Derivation,6,Classe Cn par Morceaux,11,670,3,QCU,0.41,0.35,2.0,2,101,103,60,2,58,1.72,3.33,Moyen,Difficile,-1,Plus Difficile,Pas Adapte
2891,2017,Mathematique,3,La Derivation,6,Classe Cn par Morceaux,11,670,3,QCU,0.66,0.37,8.0,9,108,117,86,9,77,1.36,10.47,Difficile,Difficile,0,Meme Difficulté,Pas Adapte
4002,2018,Mathematique,3,La Derivation,6,Classe Cn par Morceaux,11,670,3,QCU,0.74,0.22,19.0,21,88,109,83,21,62,1.31,25.3,Difficile,Difficile,0,Meme Difficulté,Pas Adapte
5113,2019,Mathematique,3,La Derivation,6,Classe Cn par Morceaux,11,670,3,QCU,0.47,0.39,33.0,39,79,118,57,39,18,2.07,68.42,Difficile,Difficile,0,Meme Difficulté,Pas Adapte
6224,2020,Mathematique,3,La Derivation,6,Classe Cn par Morceaux,11,670,3,QCU,0.29,0.58,64.0,85,48,133,109,85,24,1.22,77.98,Moyen,Moyen,0,Meme Difficulté,Pas Adapte
670,2015,Mathematique,3,La Derivation,6,Classe Cn par Morceaux,11,671,4,QROC,0.52,0.35,57.0,37,28,65,58,37,21,1.12,63.79,Facile,Moyen,-1,Plus Difficile,Pas Adapte
1781,2016,Mathematique,3,La Derivation,6,Classe Cn par Morceaux,11,671,4,QO,0.84,0.12,3.0,2,55,57,48,2,46,1.19,4.17,Difficile,Difficile,0,Meme Difficulté,Pas Adapte
2892,2017,Mathematique,3,La Derivation,6,Classe Cn par Morceaux,11,671,4,QO,0.66,0.17,58.0,33,24,57,54,33,21,1.06,61.11,Facile,Moyen,-1,Plus Difficile,Pas Adapte
4003,2018,Mathematique,3,La Derivation,6,Classe Cn par Morceaux,11,671,4,QO,0.81,0.07,11.0,7,57,64,35,7,28,1.83,20.0,Facile,Difficile,-2,Beaucoup plus Difficile,Pas Adapte
5114,2019,Mathematique,3,La Derivation,6,Classe Cn par Morceaux,11,671,4,QO,0.57,0.24,63.0,38,22,60,49,38,11,1.22,77.55,Difficile,Moyen,1,Plus Facile,Pas Adapte
6225,2020,Mathematique,3,La Derivation,6,Classe Cn par Morceaux,11,671,4,QO,0.11,0.4,70.0,43,19,62,55,43,12,1.13,78.18,Facile,Facile,0,Meme Difficulté,Adapte
671,2015,Mathematique,3,La Derivation,6,Classe Cn par Morceaux,11,672,5,QCM,0.42,0.55,43.0,22,29,51,24,22,2,2.12,91.67,Facile,Moyen,-1,Plus Difficile,Pas Adapte
1782,2016,Mathematique,3,La Derivation,6,Classe Cn par Morceaux,11,672,5,QCU,0.31,0.61,47.0,27,31,58,38,27,11,1.53,71.05,Difficile,Moyen,1,Plus Facile,Pas Adapte
2893,2017,Mathematique,3,La Derivation,6,Classe Cn par Morceaux,11,672,5,QCU,0.66,0.33,12.0,8,59,67,31,8,23,2.16,25.81,Moyen,Difficile,-1,Plus Difficile,Pas Adapte
4004,2018,Mathematique,3,La Derivation,6,Classe Cn par Morceaux,11,672,5,QCU,0.41,0.29,7.0,5,62,67,52,5,47,1.29,9.62,Facile,Difficile,-2,Beaucoup plus Difficile,Pas Adapte
5115,2019,Mathematique,3,La Derivation,6,Classe Cn par Morceaux,11,672,5,QCU,0.44,0.37,16.0,12,64,76,57,12,45,1.33,21.05,Facile,Difficile,-2,Beaucoup plus Difficile,Pas Adapte
6226,2020,Mathematique,3,La Derivation,6,Classe Cn par Morceaux,11,672,5,QCU,0.44,0.31,28.0,24,63,87,32,24,8,2.72,75.0,Difficile,Difficile,0,Meme Difficulté,Pas Adapte
672,2015,Mathematique,3,La Derivation,6,Classe Cn par Morceaux,11,673,6,QCM,0.67,0.3,33.0,24,50,74,33,24,9,2.24,72.73,Difficile,Difficile,0,Meme Difficulté,Pas Adapte
1783,2016,Mathematique,3,La Derivation,6,Classe Cn par Morceaux,11,673,6,QCM,0.59,0.22,7.0,6,73,79,32,6,26,2.47,18.75,Facile,Difficile,-2,Beaucoup plus Difficile,Pas Adapte
2894,2017,Mathematique,3,La Derivation,6,Classe Cn par Morceaux,11,673,6,QCM,0.66,0.28,8.0,6,72,78,38,6,32,2.05,15.79,Facile,Difficile,-2,Beaucoup plus Difficile,Pas Adapte
4005,2018,Mathematique,3,La Derivation,6,Classe Cn par Morceaux,11,673,6,QCM,0.74,0.16,16.0,13,66,79,28,13,15,2.82,46.43,Difficile,Difficile,0,Meme Difficulté,Pas Adapte
5116,2019,Mathematique,3,La Derivation,6,Classe Cn par Morceaux,11,673,6,QCM,0.56,0.28,6.0,5,82,87,81,5,76,1.07,6.17,Moyen,Difficile,-1,Plus Difficile,Pas Adapte
6227,2020,Mathematique,3,La Derivation,6,Classe Cn par Morceaux,11,673,6,QCM,0.23,0.65,60.0,55,37,92,89,55,34,1.03,61.8,Moyen,Moyen,0,Meme Difficulté,Pas Adapte
673,2015,Mathematique,3,La Derivation,6,Classe Cn par Morceaux,11,674,7,QROC,0.33,0.34,40.0,14,20,34,25,14,11,1.36,56.0,Difficile,Moyen,1,Plus Facile,Pas Adapte
1784,2016,Mathematique,3,La Derivation,6,Classe Cn par Morceaux,11,674,7,QROC,0.11,0.43,65.0,23,13,36,29,23,6,1.24,79.31,Difficile,Facile,2,Beaucoup plus Facile,Adapte
2895,2017,Mathematique,3,La Derivation,6,Classe Cn par Morceaux,11,674,7,QROC,0.2,0.93,65.0,23,13,36,33,23,10,1.09,69.7,Facile,Facile,0,Meme Difficulté,Adapte
4006,2018,Mathematique,3,La Derivation,6,Classe Cn par Morceaux,11,674,7,QROC,0.16,0.7,65.0,27,14,41,33,27,6,1.24,81.82,Facile,Facile,0,Meme Difficulté,Adapte
5117,2019,Mathematique,3,La Derivation,6,Classe Cn par Morceaux,11,674,7,QROC,0.16,0.87,65.0,29,16,45,35,29,6,1.29,82.86,Facile,Facile,0,Meme Difficulté,Adapte
6228,2020,Mathematique,3,La Derivation,6,Classe Cn par Morceaux,11,674,7,QO,0.11,0.54,65.0,32,18,50,47,32,15,1.06,68.09,Facile,Facile,0,Meme Difficulté,Adapte
674,2015,Mathematique,3,La Derivation,6,Classe Cn par Morceaux,11,675,8,QCU,0.31,0.46,64.0,36,21,57,49,36,13,1.16,73.47,Facile,Moyen,-1,Plus Difficile,Pas Adapte
1785,2016,Mathematique,3,La Derivation,6,Classe Cn par Morceaux,11,675,8,QCU,0.39,0.43,50.0,26,27,53,28,26,2,1.89,92.86,Moyen,Moyen,0,Meme Difficulté,Pas Adapte
2896,2017,Mathematique,3,La Derivation,6,Classe Cn par Morceaux,11,675,8,QCM,0.76,0.17,28.0,17,42,59,53,17,36,1.11,32.08,Facile,Difficile,-2,Beaucoup plus Difficile,Pas Adapte
4007,2018,Mathematique,3,La Derivation,6,Classe Cn par Morceaux,11,675,8,QCU,0.62,0.38,8.0,5,52,57,31,5,26,1.84,16.13,Difficile,Difficile,0,Meme Difficulté,Pas Adapte
5118,2019,Mathematique,3,La Derivation,6,Classe Cn par Morceaux,11,675,8,QCU,0.58,0.33,18.0,10,47,57,23,10,13,2.48,43.48,Difficile,Difficile,0,Meme Difficulté,Pas Adapte
6229,2020,Mathematique,3,La Derivation,6,Classe Cn par Morceaux,11,675,8,QCU,0.57,0.27,1.0,1,63,64,26,1,25,2.46,3.85,Difficile,Difficile,0,Meme Difficulté,Pas Adapte
675,2015,Mathematique,3,La Derivation,6,Classe Cn par Morceaux,11,676,9,QCM,0.35,0.53,58.0,43,31,74,69,43,26,1.07,62.32,Facile,Moyen,-1,Plus Difficile,Pas Adapte
1786,2016,Mathematique,3,La Derivation,6,Classe Cn par Morceaux,11,676,9,QCU,0.27,0.5,44.0,37,48,85,76,37,39,1.12,48.68,Facile,Moyen,-1,Plus Difficile,Pas Adapte
2897,2017,Mathematique,3,La Derivation,6,Classe Cn par Morceaux,11,676,9,QCU,0.46,0.26,10.0,8,73,81,33,8,25,2.45,24.24,Moyen,Difficile,-1,Plus Difficile,Pas Adapte
4008,2018,Mathematique,3,La Derivation,6,Classe Cn par Morceaux,11,676,9,QCU,0.39,0.69,49.0,45,47,92,86,45,41,1.07,52.33,Moyen,Moyen,0,Meme Difficulté,Pas Adapte
5119,2019,Mathematique,3,La Derivation,6,Classe Cn par Morceaux,11,676,9,QCU,0.09,0.93,66.0,55,29,84,82,55,27,1.02,67.07,Facile,Facile,0,Meme Difficulté,Adapte
6230,2020,Mathematique,3,La Derivation,6,Classe Cn par Morceaux,11,676,9,QCU,0.17,0.93,66.0,52,27,79,66,52,14,1.2,78.79,Facile,Facile,0,Meme Difficulté,Adapte
676,2015,Mathematique,3,La Derivation,6,Classe Cn par Morceaux,11,677,10,QCU,0.67,0.38,14.0,14,86,100,53,14,39,1.89,26.42,Difficile,Difficile,0,Meme Difficulté,Pas Adapte
1787,2016,Mathematique,3,La Derivation,6,Classe Cn par Morceaux,11,677,10,QCU,0.4,0.71,45.0,47,57,104,85,47,38,1.22,55.29,Moyen,Moyen,0,Meme Difficulté,Pas Adapte
2898,2017,Mathematique,3,La Derivation,6,Classe Cn par Morceaux,11,677,10,QCU,0.41,0.31,8.0,8,91,99,60,8,52,1.65,13.33,Difficile,Difficile,0,Meme Difficulté,Pas Adapte
4009,2018,Mathematique,3,La Derivation,6,Classe Cn par Morceaux,11,677,10,QCU,0.33,0.69,44.0,41,52,93,91,41,50,1.02,45.05,Facile,Moyen,-1,Plus Difficile,Pas Adapte
5120,2019,Mathematique,3,La Derivation,6,Classe Cn par Morceaux,11,677,10,QCU,0.31,0.6,54.0,51,44,95,54,51,3,1.76,94.44,Moyen,Moyen,0,Meme Difficulté,Pas Adapte
6231,2020,Mathematique,3,La Derivation,6,Classe Cn par Morceaux,11,677,10,QCU,0.59,0.25,7.0,7,96,103,93,7,86,1.11,7.53,Moyen,Difficile,-1,Plus Difficile,Pas Adapte
677,2015,Mathematique,3,La Derivation,6,Classe Cn par Morceaux,11,678,11,QCU,0.63,0.36,15.0,3,18,21,20,3,17,1.05,15.0,Facile,Difficile,-2,Beaucoup plus Difficile,Pas Adapte
1788,2016,Mathematique,3,La Derivation,6,Classe Cn par Morceaux,11,678,11,QCU,0.53,0.29,31.0,6,13,19,7,6,1,2.71,85.71,Facile,Difficile,-2,Beaucoup plus Difficile,Pas Adapte
2899,2017,Mathematique,3,La Derivation,6,Classe Cn par Morceaux,11,678,11,QCU,0.64,0.27,7.0,2,20,22,21,2,19,1.05,9.52,Facile,Difficile,-2,Beaucoup plus Difficile,Pas Adapte
4010,2018,Mathematique,3,La Derivation,6,Classe Cn par Morceaux,11,678,11,QCU,0.45,0.26,35.0,7,12,19,15,7,8,1.27,46.67,Facile,Difficile,-2,Beaucoup plus Difficile,Pas Adapte
5121,2019,Mathematique,3,La Derivation,6,Classe Cn par Morceaux,11,678,11,QCU,0.62,0.3,20.0,4,17,21,7,4,3,3.0,57.14,Facile,Difficile,-2,Beaucoup plus Difficile,Pas Adapte
6232,2020,Mathematique,3,La Derivation,6,Classe Cn par Morceaux,11,678,11,QCU,0.39,0.73,51.0,10,9,19,15,10,5,1.27,66.67,Facile,Moyen,-1,Plus Difficile,Pas Adapte
678,2015,Mathematique,3,La Derivation,7,Fonctions Reciproques,10,679,1,QO,0.31,0.3,47.0,22,24,46,43,22,21,1.07,51.16,Facile,Moyen,-1,Plus Difficile,Pas Adapte
1789,2016,Mathematique,3,La Derivation,7,Fonctions Reciproques,10,679,1,QO,0.29,0.22,59.0,25,18,43,39,25,14,1.1,64.1,Difficile,Moyen,1,Plus Facile,Pas Adapte
2900,2017,Mathematique,3,La Derivation,7,Fonctions Reciproques,10,679,1,QO,0.91,0.03,3.0,1,46,47,27,1,26,1.74,3.7,Facile,Difficile,-2,Beaucoup plus Difficile,Pas Adapte
4011,2018,Mathematique,3,La Derivation,7,Fonctions Reciproques,10,679,1,QO,0.21,0.23,56.0,25,20,45,41,25,16,1.1,60.98,Moyen,Moyen,0,Meme Difficulté,Pas Adapte
5122,2019,Mathematique,3,La Derivation,7,Fonctions Reciproques,10,679,1,QO,0.41,0.21,57.0,28,21,49,39,28,11,1.26,71.79,Facile,Moyen,-1,Plus Difficile,Pas Adapte
6233,2020,Mathematique,3,La Derivation,7,Fonctions Reciproques,10,679,1,QCM,0.77,0.21,13.0,6,40,46,28,6,22,1.64,21.43,Difficile,Difficile,0,Meme Difficulté,Pas Adapte
679,2015,Mathematique,3,La Derivation,7,Fonctions Reciproques,10,680,2,QCU,0.61,0.27,20.0,11,46,57,27,11,16,2.11,40.74,Facile,Difficile,-2,Beaucoup plus Difficile,Pas Adapte
1790,2016,Mathematique,3,La Derivation,7,Fonctions Reciproques,10,680,2,QCU,0.29,0.69,56.0,27,22,49,45,27,18,1.09,60.0,Facile,Moyen,-1,Plus Difficile,Pas Adapte
2901,2017,Mathematique,3,La Derivation,7,Fonctions Reciproques,10,680,2,QCU,0.63,0.38,17.0,9,44,53,37,9,28,1.43,24.32,Facile,Difficile,-2,Beaucoup plus Difficile,Pas Adapte
4012,2018,Mathematique,3,La Derivation,7,Fonctions Reciproques,10,680,2,QCU,0.63,0.24,28.0,16,40,56,50,16,34,1.12,32.0,Facile,Difficile,-2,Beaucoup plus Difficile,Pas Adapte
5123,2019,Mathematique,3,La Derivation,7,Fonctions Reciproques,10,680,2,QCM,0.68,0.2,27.0,17,47,64,36,17,19,1.78,47.22,Facile,Difficile,-2,Beaucoup plus Difficile,Pas Adapte
6234,2020,Mathematique,3,La Derivation,7,Fonctions Reciproques,10,680,2,QCM,0.73,0.2,3.0,2,59,61,25,2,23,2.44,8.0,Moyen,Difficile,-1,Plus Difficile,Pas Adapte
680,2015,Mathematique,3,La Derivation,7,Fonctions Reciproques,10,681,3,QROC,0.77,0.15,6.0,2,29,31,18,2,16,1.72,11.11,Difficile,Difficile,0,Meme Difficulté,Pas Adapte
1791,2016,Mathematique,3,La Derivation,7,Fonctions Reciproques,10,681,3,QROC,0.78,0.05,21.0,6,24,30,19,6,13,1.58,31.58,Difficile,Difficile,0,Meme Difficulté,Pas Adapte
2902,2017,Mathematique,3,La Derivation,7,Fonctions Reciproques,10,681,3,QROC,0.7,0.09,28.0,8,20,28,19,8,11,1.47,42.11,Difficile,Difficile,0,Meme Difficulté,Pas Adapte
4013,2018,Mathematique,3,La Derivation,7,Fonctions Reciproques,10,681,3,QROC,0.71,0.18,16.0,5,26,31,13,5,8,2.38,38.46,Moyen,Difficile,-1,Plus Difficile,Pas Adapte
5124,2019,Mathematique,3,La Derivation,7,Fonctions Reciproques,10,681,3,QROC,0.39,0.25,58.0,18,13,31,22,18,4,1.41,81.82,Difficile,Moyen,1,Plus Facile,Pas Adapte
6235,2020,Mathematique,3,La Derivation,7,Fonctions Reciproques,10,681,3,QROC,0.67,0.24,6.0,2,34,36,25,2,23,1.44,8.0,Difficile,Difficile,0,Meme Difficulté,Pas Adapte
681,2015,Mathematique,3,La Derivation,7,Fonctions Reciproques,10,682,4,QCU,0.56,0.37,16.0,14,74,88,75,14,61,1.17,18.67,Facile,Difficile,-2,Beaucoup plus Difficile,Pas Adapte
1792,2016,Mathematique,3,La Derivation,7,Fonctions Reciproques,10,682,4,QCU,0.35,0.68,43.0,35,46,81,65,35,30,1.25,53.85,Moyen,Moyen,0,Meme Difficulté,Pas Adapte
2903,2017,Mathematique,3,La Derivation,7,Fonctions Reciproques,10,682,4,QCU,0.48,0.36,8.0,7,85,92,53,7,46,1.74,13.21,Difficile,Difficile,0,Meme Difficulté,Pas Adapte
4014,2018,Mathematique,3,La Derivation,7,Fonctions Reciproques,10,682,4,QCU,0.33,0.71,39.0,34,54,88,65,34,31,1.35,52.31,Difficile,Moyen,1,Plus Facile,Pas Adapte
5125,2019,Mathematique,3,La Derivation,7,Fonctions Reciproques,10,682,4,QCU,0.58,0.33,3.0,3,86,89,48,3,45,1.85,6.25,Difficile,Difficile,0,Meme Difficulté,Pas Adapte
6236,2020,Mathematique,3,La Derivation,7,Fonctions Reciproques,10,682,4,QCU,0.71,0.39,7.0,5,73,78,72,5,67,1.08,6.94,Difficile,Difficile,0,Meme Difficulté,Pas Adapte
682,2015,Mathematique,3,La Derivation,7,Fonctions Reciproques,10,683,5,QCM,0.58,0.22,19.0,10,43,53,44,10,34,1.2,22.73,Facile,Difficile,-2,Beaucoup plus Difficile,Pas Adapte
1793,2016,Mathematique,3,La Derivation,7,Fonctions Reciproques,10,683,5,QCM,0.48,0.67,55.0,31,26,57,41,31,10,1.39,75.61,Moyen,Moyen,0,Meme Difficulté,Pas Adapte
2904,2017,Mathematique,3,La Derivation,7,Fonctions Reciproques,10,683,5,QCM,0.77,0.2,4.0,3,62,65,44,3,41,1.48,6.82,Facile,Difficile,-2,Beaucoup plus Difficile,Pas Adapte
4015,2018,Mathematique,3,La Derivation,7,Fonctions Reciproques,10,683,5,QCM,0.58,0.17,2.0,1,63,64,42,1,41,1.52,2.38,Facile,Difficile,-2,Beaucoup plus Difficile,Pas Adapte
5126,2019,Mathematique,3,La Derivation,7,Fonctions Reciproques,10,683,5,QCM,0.56,0.22,25.0,17,52,69,63,17,46,1.1,26.98,Facile,Difficile,-2,Beaucoup plus Difficile,Pas Adapte
6237,2020,Mathematique,3,La Derivation,7,Fonctions Reciproques,10,683,5,QCM,0.65,0.27,1.0,1,67,68,61,1,60,1.11,1.64,Moyen,Difficile,-1,Plus Difficile,Pas Adapte
683,2015,Mathematique,3,La Derivation,7,Fonctions Reciproques,10,684,6,QROC,0.25,0.34,41.0,7,9,16,12,7,5,1.33,58.33,Moyen,Moyen,0,Meme Difficulté,Pas Adapte
1794,2016,Mathematique,3,La Derivation,7,Fonctions Reciproques,10,684,6,QROC,0.94,0.0,33.0,6,11,17,7,6,1,2.43,85.71,Moyen,Difficile,-1,Plus Difficile,Pas Adapte
2905,2017,Mathematique,3,La Derivation,7,Fonctions Reciproques,10,684,6,QROC,0.9,0.03,30.0,6,14,20,10,6,4,2.0,60.0,Difficile,Difficile,0,Meme Difficulté,Pas Adapte
4016,2018,Mathematique,3,La Derivation,7,Fonctions Reciproques,10,684,6,QROC,0.36,0.25,38.0,7,12,19,9,7,2,2.11,77.78,Difficile,Moyen,1,Plus Facile,Pas Adapte
5127,2019,Mathematique,3,La Derivation,7,Fonctions Reciproques,10,684,6,QO,0.87,0.1,35.0,8,14,22,21,8,13,1.05,38.1,Facile,Difficile,-2,Beaucoup plus Difficile,Pas Adapte
6238,2020,Mathematique,3,La Derivation,7,Fonctions Reciproques,10,684,6,QCM,0.03,0.96,70.0,15,7,22,20,15,5,1.1,75.0,Moyen,Facile,1,Plus Facile,Adapte
684,2015,Mathematique,3,La Derivation,7,Fonctions Reciproques,10,685,7,QCU,0.51,0.23,23.0,14,48,62,62,14,48,1.0,22.58,Facile,Difficile,-2,Beaucoup plus Difficile,Pas Adapte
1795,2016,Mathematique,3,La Derivation,7,Fonctions Reciproques,10,685,7,QCU,0.35,0.62,36.0,21,36,57,53,21,32,1.08,39.62,Difficile,Moyen,1,Plus Facile,Pas Adapte
2906,2017,Mathematique,3,La Derivation,7,Fonctions Reciproques,10,685,7,QCU,0.5,0.34,28.0,18,46,64,49,18,31,1.31,36.73,Facile,Difficile,-2,Beaucoup plus Difficile,Pas Adapte
4017,2018,Mathematique,3,La Derivation,7,Fonctions Reciproques,10,685,7,QCU,0.09,0.86,67.0,39,19,58,43,39,4,1.35,90.7,Moyen,Facile,1,Plus Facile,Adapte
5128,2019,Mathematique,3,La Derivation,7,Fonctions Reciproques,10,685,7,QCU,0.1,0.99,67.0,34,16,50,35,34,1,1.43,97.14,Facile,Facile,0,Meme Difficulté,Adapte
6239,2020,Mathematique,3,La Derivation,7,Fonctions Reciproques,10,685,7,QCU,0.08,0.8,67.0,38,19,57,43,38,5,1.33,88.37,Facile,Facile,0,Meme Difficulté,Adapte
685,2015,Mathematique,3,La Derivation,7,Fonctions Reciproques,10,686,8,QCU,0.22,0.44,43.0,11,14,25,17,11,6,1.47,64.71,Difficile,Moyen,1,Plus Facile,Pas Adapte
1796,2016,Mathematique,3,La Derivation,7,Fonctions Reciproques,10,686,8,QCU,0.59,0.37,19.0,5,19,24,15,5,10,1.6,33.33,Difficile,Difficile,0,Meme Difficulté,Pas Adapte
2907,2017,Mathematique,3,La Derivation,7,Fonctions Reciproques,10,686,8,QCM,0.32,0.53,58.0,16,11,27,22,16,6,1.23,72.73,Difficile,Moyen,1,Plus Facile,Pas Adapte
4018,2018,Mathematique,3,La Derivation,7,Fonctions Reciproques,10,686,8,QCM,0.2,0.47,56.0,15,11,26,16,15,1,1.62,93.75,Facile,Moyen,-1,Plus Difficile,Pas Adapte
5129,2019,Mathematique,3,La Derivation,7,Fonctions Reciproques,10,686,8,QCM,0.28,0.69,39.0,9,15,24,19,9,10,1.26,47.37,Difficile,Moyen,1,Plus Facile,Pas Adapte
6240,2020,Mathematique,3,La Derivation,7,Fonctions Reciproques,10,686,8,QCM,0.15,0.75,65.0,17,9,26,25,17,8,1.04,68.0,Difficile,Facile,2,Beaucoup plus Facile,Adapte
686,2015,Mathematique,3,La Derivation,7,Fonctions Reciproques,10,687,9,QCM,0.22,0.38,47.0,47,53,100,69,47,22,1.45,68.12,Moyen,Moyen,0,Meme Difficulté,Pas Adapte
1797,2016,Mathematique,3,La Derivation,7,Fonctions Reciproques,10,687,9,QCM,0.5,0.21,25.0,28,84,112,100,28,72,1.12,28.0,Difficile,Difficile,0,Meme Difficulté,Pas Adapte
2908,2017,Mathematique,3,La Derivation,7,Fonctions Reciproques,10,687,9,QCM,0.26,0.63,44.0,44,55,99,87,44,43,1.14,50.57,Moyen,Moyen,0,Meme Difficulté,Pas Adapte
4019,2018,Mathematique,3,La Derivation,7,Fonctions Reciproques,10,687,9,QCU,0.17,0.93,69.0,65,29,94,80,65,15,1.18,81.25,Facile,Facile,0,Meme Difficulté,Adapte
5130,2019,Mathematique,3,La Derivation,7,Fonctions Reciproques,10,687,9,QCU,0.13,0.85,69.0,64,29,93,86,64,22,1.08,74.42,Facile,Facile,0,Meme Difficulté,Adapte
6241,2020,Mathematique,3,La Derivation,7,Fonctions Reciproques,10,687,9,QCU,0.19,0.97,69.0,57,25,82,63,57,6,1.3,90.48,Facile,Facile,0,Meme Difficulté,Adapte
687,2015,Mathematique,3,La Derivation,7,Fonctions Reciproques,10,688,10,QCU,0.28,0.65,36.0,10,17,27,23,10,13,1.17,43.48,Difficile,Moyen,1,Plus Facile,Pas Adapte
1798,2016,Mathematique,3,La Derivation,7,Fonctions Reciproques,10,688,10,QCU,0.4,0.7,59.0,15,11,26,19,15,4,1.37,78.95,Difficile,Moyen,1,Plus Facile,Pas Adapte
2909,2017,Mathematique,3,La Derivation,7,Fonctions Reciproques,10,688,10,QCU,0.16,0.9,65.0,17,9,26,24,17,7,1.08,70.83,Moyen,Facile,1,Plus Facile,Adapte
4020,2018,Mathematique,3,La Derivation,7,Fonctions Reciproques,10,688,10,QCU,0.12,0.86,65.0,20,10,30,29,20,9,1.03,68.97,Facile,Facile,0,Meme Difficulté,Adapte
5131,2019,Mathematique,3,La Derivation,7,Fonctions Reciproques,10,688,10,QCU,0.04,0.94,65.0,18,9,27,23,18,5,1.17,78.26,Facile,Facile,0,Meme Difficulté,Adapte
6242,2020,Mathematique,3,La Derivation,7,Fonctions Reciproques,10,688,10,QCU,0.07,0.89,65.0,20,11,31,24,20,4,1.29,83.33,Facile,Facile,0,Meme Difficulté,Adapte
688,2015,Mathematique,3,La Derivation,8,Quelques Techniques de Calcul,2,689,1,QO,0.9,0.08,10.0,1,7,8,5,1,4,1.6,20.0,Facile,Difficile,-2,Beaucoup plus Difficile,Pas Adapte
1799,2016,Mathematique,3,La Derivation,8,Quelques Techniques de Calcul,2,689,1,QO,0.95,0.08,29.0,2,6,8,4,2,2,2.0,50.0,Facile,Difficile,-2,Beaucoup plus Difficile,Pas Adapte
2910,2017,Mathematique,3,La Derivation,8,Quelques Techniques de Calcul,2,689,1,QROC,0.73,0.2,6.0,1,8,9,4,1,3,2.25,25.0,Moyen,Difficile,-1,Plus Difficile,Pas Adapte
4021,2018,Mathematique,3,La Derivation,8,Quelques Techniques de Calcul,2,689,1,QROC,0.41,0.36,61.0,6,4,10,7,6,1,1.43,85.71,Facile,Moyen,-1,Plus Difficile,Pas Adapte
5132,2019,Mathematique,3,La Derivation,8,Quelques Techniques de Calcul,2,689,1,QO,0.96,0.04,16.0,1,7,8,4,1,3,2.0,25.0,Facile,Difficile,-2,Beaucoup plus Difficile,Pas Adapte
6243,2020,Mathematique,3,La Derivation,8,Quelques Techniques de Calcul,2,689,1,QO,0.89,0.04,26.0,2,5,7,6,2,4,1.17,33.33,Facile,Difficile,-2,Beaucoup plus Difficile,Pas Adapte
689,2015,Mathematique,3,La Derivation,8,Quelques Techniques de Calcul,2,690,2,QCM,0.62,0.17,19.0,18,75,93,43,18,25,2.16,41.86,Difficile,Difficile,0,Meme Difficulté,Pas Adapte
1800,2016,Mathematique,3,La Derivation,8,Quelques Techniques de Calcul,2,690,2,QCM,0.7,0.25,30.0,28,67,95,35,28,7,2.71,80.0,Difficile,Difficile,0,Meme Difficulté,Pas Adapte
2911,2017,Mathematique,3,La Derivation,8,Quelques Techniques de Calcul,2,690,2,QCM,0.29,0.5,44.0,43,55,98,98,43,55,1.0,43.88,Facile,Moyen,-1,Plus Difficile,Pas Adapte
4022,2018,Mathematique,3,La Derivation,8,Quelques Techniques de Calcul,2,690,2,QCM,0.23,0.65,51.0,49,47,96,88,49,39,1.09,55.68,Difficile,Moyen,1,Plus Facile,Pas Adapte
5133,2019,Mathematique,3,La Derivation,8,Quelques Techniques de Calcul,2,690,2,QCM,0.62,0.18,11.0,11,88,99,38,11,27,2.61,28.95,Moyen,Difficile,-1,Plus Difficile,Pas Adapte
6244,2020,Mathematique,3,La Derivation,8,Quelques Techniques de Calcul,2,690,2,QCM,0.45,0.65,47.0,45,50,95,88,45,43,1.08,51.14,Facile,Moyen,-1,Plus Difficile,Pas Adapte
690,2015,Mathematique,4,Les Espaces Pre-Hilbertiens et Hilbertiens,1,Espaces Prehilbertiens Reel ou Complexes,14,691,1,QCM,0.47,0.48,54.0,31,27,58,56,31,25,1.04,55.36,Difficile,Moyen,1,Plus Facile,Pas Adapte
1801,2016,Mathematique,4,Les Espaces Pre-Hilbertiens et Hilbertiens,1,Espaces Prehilbertiens Reel ou Complexes,14,691,1,QCM,0.27,0.47,61.0,37,23,60,44,37,7,1.36,84.09,Facile,Moyen,-1,Plus Difficile,Pas Adapte
2912,2017,Mathematique,4,Les Espaces Pre-Hilbertiens et Hilbertiens,1,Espaces Prehilbertiens Reel ou Complexes,14,691,1,QCM,0.57,0.26,5.0,3,57,60,23,3,20,2.61,13.04,Facile,Difficile,-2,Beaucoup plus Difficile,Pas Adapte
4023,2018,Mathematique,4,Les Espaces Pre-Hilbertiens et Hilbertiens,1,Espaces Prehilbertiens Reel ou Complexes,14,691,1,QCM,0.65,0.19,30.0,20,47,67,65,20,45,1.03,30.77,Moyen,Difficile,-1,Plus Difficile,Pas Adapte
5134,2019,Mathematique,4,Les Espaces Pre-Hilbertiens et Hilbertiens,1,Espaces Prehilbertiens Reel ou Complexes,14,691,1,QCM,0.61,0.24,32.0,25,52,77,62,25,37,1.24,40.32,Moyen,Difficile,-1,Plus Difficile,Pas Adapte
6245,2020,Mathematique,4,Les Espaces Pre-Hilbertiens et Hilbertiens,1,Espaces Prehilbertiens Reel ou Complexes,14,691,1,QCM,0.74,0.22,27.0,20,54,74,68,20,48,1.09,29.41,Moyen,Difficile,-1,Plus Difficile,Pas Adapte
691,2015,Mathematique,4,Les Espaces Pre-Hilbertiens et Hilbertiens,1,Espaces Prehilbertiens Reel ou Complexes,14,692,2,QCU,0.37,0.52,56.0,41,33,74,54,41,13,1.37,75.93,Facile,Moyen,-1,Plus Difficile,Pas Adapte
1802,2016,Mathematique,4,Les Espaces Pre-Hilbertiens et Hilbertiens,1,Espaces Prehilbertiens Reel ou Complexes,14,692,2,QCM,0.69,0.24,32.0,21,45,66,41,21,20,1.61,51.22,Facile,Difficile,-2,Beaucoup plus Difficile,Pas Adapte
2913,2017,Mathematique,4,Les Espaces Pre-Hilbertiens et Hilbertiens,1,Espaces Prehilbertiens Reel ou Complexes,14,692,2,QCM,0.25,0.66,51.0,29,28,57,43,29,14,1.33,67.44,Difficile,Moyen,1,Plus Facile,Pas Adapte
4024,2018,Mathematique,4,Les Espaces Pre-Hilbertiens et Hilbertiens,1,Espaces Prehilbertiens Reel ou Complexes,14,692,2,QCM,0.32,0.69,56.0,28,22,50,35,28,7,1.43,80.0,Difficile,Moyen,1,Plus Facile,Pas Adapte
5135,2019,Mathematique,4,Les Espaces Pre-Hilbertiens et Hilbertiens,1,Espaces Prehilbertiens Reel ou Complexes,14,692,2,QCM,0.21,0.34,52.0,25,23,48,25,25,0,1.92,100.0,Difficile,Moyen,1,Plus Facile,Pas Adapte
6246,2020,Mathematique,4,Les Espaces Pre-Hilbertiens et Hilbertiens,1,Espaces Prehilbertiens Reel ou Complexes,14,692,2,QCM,0.33,0.42,42.0,21,29,50,28,21,7,1.79,75.0,Difficile,Moyen,1,Plus Facile,Pas Adapte
692,2015,Mathematique,4,Les Espaces Pre-Hilbertiens et Hilbertiens,1,Espaces Prehilbertiens Reel ou Complexes,14,693,3,QROC,0.49,0.31,41.0,29,42,71,34,29,5,2.09,85.29,Difficile,Moyen,1,Plus Facile,Pas Adapte
1803,2016,Mathematique,4,Les Espaces Pre-Hilbertiens et Hilbertiens,1,Espaces Prehilbertiens Reel ou Complexes,14,693,3,QROC,0.96,0.25,2.0,1,63,64,54,1,53,1.19,1.85,Facile,Difficile,-2,Beaucoup plus Difficile,Pas Adapte
2914,2017,Mathematique,4,Les Espaces Pre-Hilbertiens et Hilbertiens,1,Espaces Prehilbertiens Reel ou Complexes,14,693,3,QROC,0.33,0.25,42.0,30,41,71,41,30,11,1.73,73.17,Facile,Moyen,-1,Plus Difficile,Pas Adapte
4025,2018,Mathematique,4,Les Espaces Pre-Hilbertiens et Hilbertiens,1,Espaces Prehilbertiens Reel ou Complexes,14,693,3,QO,0.21,0.29,45.0,32,38,70,56,32,24,1.25,57.14,Difficile,Moyen,1,Plus Facile,Pas Adapte
5136,2019,Mathematique,4,Les Espaces Pre-Hilbertiens et Hilbertiens,1,Espaces Prehilbertiens Reel ou Complexes,14,693,3,QO,0.94,0.0,6.0,4,62,66,56,4,52,1.18,7.14,Difficile,Difficile,0,Meme Difficulté,Pas Adapte
6247,2020,Mathematique,4,Les Espaces Pre-Hilbertiens et Hilbertiens,1,Espaces Prehilbertiens Reel ou Complexes,14,693,3,QO,0.7,0.18,47.0,27,30,57,47,27,20,1.21,57.45,Difficile,Moyen,1,Plus Facile,Pas Adapte
693,2015,Mathematique,4,Les Espaces Pre-Hilbertiens et Hilbertiens,1,Espaces Prehilbertiens Reel ou Complexes,14,694,4,QCU,0.67,0.34,7.0,6,82,88,41,6,35,2.15,14.63,Facile,Difficile,-2,Beaucoup plus Difficile,Pas Adapte
1804,2016,Mathematique,4,Les Espaces Pre-Hilbertiens et Hilbertiens,1,Espaces Prehilbertiens Reel ou Complexes,14,694,4,QCU,0.63,0.39,34.0,32,63,95,48,32,16,1.98,66.67,Facile,Difficile,-2,Beaucoup plus Difficile,Pas Adapte
2915,2017,Mathematique,4,Les Espaces Pre-Hilbertiens et Hilbertiens,1,Espaces Prehilbertiens Reel ou Complexes,14,694,4,QCU,0.28,0.72,43.0,46,60,106,72,46,26,1.47,63.89,Difficile,Moyen,1,Plus Facile,Pas Adapte
4026,2018,Mathematique,4,Les Espaces Pre-Hilbertiens et Hilbertiens,1,Espaces Prehilbertiens Reel ou Complexes,14,694,4,QROC,0.99,0.0,5.0,5,101,106,59,5,54,1.8,8.47,Difficile,Difficile,0,Meme Difficulté,Pas Adapte
5137,2019,Mathematique,4,Les Espaces Pre-Hilbertiens et Hilbertiens,1,Espaces Prehilbertiens Reel ou Complexes,14,694,4,QROC,0.25,0.3,39.0,37,58,95,78,37,41,1.22,47.44,Moyen,Moyen,0,Meme Difficulté,Pas Adapte
6248,2020,Mathematique,4,Les Espaces Pre-Hilbertiens et Hilbertiens,1,Espaces Prehilbertiens Reel ou Complexes,14,694,4,QROC,0.63,0.22,27.0,24,64,88,55,24,31,1.6,43.64,Moyen,Difficile,-1,Plus Difficile,Pas Adapte
694,2015,Mathematique,4,Les Espaces Pre-Hilbertiens et Hilbertiens,1,Espaces Prehilbertiens Reel ou Complexes,14,695,5,QCM,0.56,0.17,31.0,10,21,31,16,10,6,1.94,62.5,Difficile,Difficile,0,Meme Difficulté,Pas Adapte
1805,2016,Mathematique,4,Les Espaces Pre-Hilbertiens et Hilbertiens,1,Espaces Prehilbertiens Reel ou Complexes,14,695,5,QCM,0.32,0.42,38.0,13,21,34,29,13,16,1.17,44.83,Difficile,Moyen,1,Plus Facile,Pas Adapte
2916,2017,Mathematique,4,Les Espaces Pre-Hilbertiens et Hilbertiens,1,Espaces Prehilbertiens Reel ou Complexes,14,695,5,QO,0.69,0.21,46.0,13,16,29,26,13,13,1.12,50.0,Moyen,Moyen,0,Meme Difficulté,Pas Adapte
4027,2018,Mathematique,4,Les Espaces Pre-Hilbertiens et Hilbertiens,1,Espaces Prehilbertiens Reel ou Complexes,14,695,5,QO,0.46,0.18,43.0,14,19,33,26,14,12,1.27,53.85,Moyen,Moyen,0,Meme Difficulté,Pas Adapte
5138,2019,Mathematique,4,Les Espaces Pre-Hilbertiens et Hilbertiens,1,Espaces Prehilbertiens Reel ou Complexes,14,695,5,QROC,0.98,0.2,27.0,9,25,34,25,9,16,1.36,36.0,Difficile,Difficile,0,Meme Difficulté,Pas Adapte
6249,2020,Mathematique,4,Les Espaces Pre-Hilbertiens et Hilbertiens,1,Espaces Prehilbertiens Reel ou Complexes,14,695,5,QROC,0.18,0.77,65.0,23,12,35,34,23,11,1.03,67.65,Facile,Facile,0,Meme Difficulté,Adapte
695,2015,Mathematique,4,Les Espaces Pre-Hilbertiens et Hilbertiens,1,Espaces Prehilbertiens Reel ou Complexes,14,696,6,QROC,0.83,0.03,7.0,4,58,62,54,4,50,1.15,7.41,Moyen,Difficile,-1,Plus Difficile,Pas Adapte
1806,2016,Mathematique,4,Les Espaces Pre-Hilbertiens et Hilbertiens,1,Espaces Prehilbertiens Reel ou Complexes,14,696,6,QROC,0.58,0.33,63.0,42,24,66,52,42,10,1.27,80.77,Moyen,Moyen,0,Meme Difficulté,Pas Adapte
2917,2017,Mathematique,4,Les Espaces Pre-Hilbertiens et Hilbertiens,1,Espaces Prehilbertiens Reel ou Complexes,14,696,6,QROC,0.31,0.36,39.0,29,46,75,58,29,29,1.29,50.0,Facile,Moyen,-1,Plus Difficile,Pas Adapte
4028,2018,Mathematique,4,Les Espaces Pre-Hilbertiens et Hilbertiens,1,Espaces Prehilbertiens Reel ou Complexes,14,696,6,QO,0.6,0.22,37.0,25,43,68,44,25,19,1.55,56.82,Moyen,Moyen,0,Meme Difficulté,Pas Adapte
5139,2019,Mathematique,4,Les Espaces Pre-Hilbertiens et Hilbertiens,1,Espaces Prehilbertiens Reel ou Complexes,14,696,6,QO,0.29,0.27,54.0,40,35,75,60,40,20,1.25,66.67,Moyen,Moyen,0,Meme Difficulté,Pas Adapte
6250,2020,Mathematique,4,Les Espaces Pre-Hilbertiens et Hilbertiens,1,Espaces Prehilbertiens Reel ou Complexes,14,696,6,QO,0.75,0.15,12.0,9,66,75,68,9,59,1.1,13.24,Difficile,Difficile,0,Meme Difficulté,Pas Adapte
696,2015,Mathematique,4,Les Espaces Pre-Hilbertiens et Hilbertiens,1,Espaces Prehilbertiens Reel ou Complexes,14,697,7,QROC,0.42,0.26,54.0,14,11,25,20,14,6,1.25,70.0,Moyen,Moyen,0,Meme Difficulté,Pas Adapte
1807,2016,Mathematique,4,Les Espaces Pre-Hilbertiens et Hilbertiens,1,Espaces Prehilbertiens Reel ou Complexes,14,697,7,QROC,0.59,0.29,44.0,10,13,23,20,10,10,1.15,50.0,Moyen,Moyen,0,Meme Difficulté,Pas Adapte
2918,2017,Mathematique,4,Les Espaces Pre-Hilbertiens et Hilbertiens,1,Espaces Prehilbertiens Reel ou Complexes,14,697,7,QROC,0.17,0.73,66.0,16,8,24,20,16,4,1.2,80.0,Facile,Facile,0,Meme Difficulté,Adapte
4029,2018,Mathematique,4,Les Espaces Pre-Hilbertiens et Hilbertiens,1,Espaces Prehilbertiens Reel ou Complexes,14,697,7,QROC,0.07,0.72,66.0,14,7,21,15,14,1,1.4,93.33,Facile,Facile,0,Meme Difficulté,Adapte
5140,2019,Mathematique,4,Les Espaces Pre-Hilbertiens et Hilbertiens,1,Espaces Prehilbertiens Reel ou Complexes,14,697,7,QROC,0.19,0.68,66.0,12,6,18,16,12,4,1.12,75.0,Facile,Facile,0,Meme Difficulté,Adapte
6251,2020,Mathematique,4,Les Espaces Pre-Hilbertiens et Hilbertiens,1,Espaces Prehilbertiens Reel ou Complexes,14,697,7,QCU,0.09,0.91,66.0,11,6,17,15,11,4,1.13,73.33,Facile,Facile,0,Meme Difficulté,Adapte
697,2015,Mathematique,4,Les Espaces Pre-Hilbertiens et Hilbertiens,1,Espaces Prehilbertiens Reel ou Complexes,14,698,8,QCM,0.64,0.24,30.0,8,19,27,11,8,3,2.45,72.73,Difficile,Difficile,0,Meme Difficulté,Pas Adapte
1808,2016,Mathematique,4,Les Espaces Pre-Hilbertiens et Hilbertiens,1,Espaces Prehilbertiens Reel ou Complexes,14,698,8,QCM,0.21,0.62,51.0,14,13,27,16,14,2,1.69,87.5,Moyen,Moyen,0,Meme Difficulté,Pas Adapte
2919,2017,Mathematique,4,Les Espaces Pre-Hilbertiens et Hilbertiens,1,Espaces Prehilbertiens Reel ou Complexes,14,698,8,QCM,0.22,0.64,64.0,17,9,26,19,17,2,1.37,89.47,Moyen,Moyen,0,Meme Difficulté,Pas Adapte
4030,2018,Mathematique,4,Les Espaces Pre-Hilbertiens et Hilbertiens,1,Espaces Prehilbertiens Reel ou Complexes,14,698,8,QCM,0.77,0.17,21.0,5,20,25,24,5,19,1.04,20.83,Moyen,Difficile,-1,Plus Difficile,Pas Adapte
5141,2019,Mathematique,4,Les Espaces Pre-Hilbertiens et Hilbertiens,1,Espaces Prehilbertiens Reel ou Complexes,14,698,8,QROC,0.68,0.07,32.0,8,16,24,12,8,4,2.0,66.67,Difficile,Difficile,0,Meme Difficulté,Pas Adapte
6252,2020,Mathematique,4,Les Espaces Pre-Hilbertiens et Hilbertiens,1,Espaces Prehilbertiens Reel ou Complexes,14,698,8,QROC,0.79,0.08,34.0,7,14,21,21,7,14,1.0,33.33,Moyen,Difficile,-1,Plus Difficile,Pas Adapte
698,2015,Mathematique,4,Les Espaces Pre-Hilbertiens et Hilbertiens,1,Espaces Prehilbertiens Reel ou Complexes,14,699,9,QROC,0.88,0.22,34.0,18,36,54,53,18,35,1.02,33.96,Difficile,Difficile,0,Meme Difficulté,Pas Adapte
1809,2016,Mathematique,4,Les Espaces Pre-Hilbertiens et Hilbertiens,1,Espaces Prehilbertiens Reel ou Complexes,14,699,9,QROC,0.23,0.37,47.0,22,25,47,31,22,9,1.52,70.97,Facile,Moyen,-1,Plus Difficile,Pas Adapte
2920,2017,Mathematique,4,Les Espaces Pre-Hilbertiens et Hilbertiens,1,Espaces Prehilbertiens Reel ou Complexes,14,699,9,QROC,0.81,0.22,20.0,8,34,42,41,8,33,1.02,19.51,Moyen,Difficile,-1,Plus Difficile,Pas Adapte
4031,2018,Mathematique,4,Les Espaces Pre-Hilbertiens et Hilbertiens,1,Espaces Prehilbertiens Reel ou Complexes,14,699,9,QROC,0.54,0.32,43.0,19,26,45,22,19,3,2.05,86.36,Facile,Moyen,-1,Plus Difficile,Pas Adapte
5142,2019,Mathematique,4,Les Espaces Pre-Hilbertiens et Hilbertiens,1,Espaces Prehilbertiens Reel ou Complexes,14,699,9,QCU,0.35,0.73,55.0,21,17,38,32,21,11,1.19,65.62,Facile,Moyen,-1,Plus Difficile,Pas Adapte
6253,2020,Mathematique,4,Les Espaces Pre-Hilbertiens et Hilbertiens,1,Espaces Prehilbertiens Reel ou Complexes,14,699,9,QCU,0.2,0.9,68.0,27,12,39,31,27,4,1.26,87.1,Facile,Facile,0,Meme Difficulté,Adapte
699,2015,Mathematique,4,Les Espaces Pre-Hilbertiens et Hilbertiens,1,Espaces Prehilbertiens Reel ou Complexes,14,700,10,QCM,0.59,0.25,27.0,23,62,85,71,23,48,1.2,32.39,Difficile,Difficile,0,Meme Difficulté,Pas Adapte
1810,2016,Mathematique,4,Les Espaces Pre-Hilbertiens et Hilbertiens,1,Espaces Prehilbertiens Reel ou Complexes,14,700,10,QCM,0.47,0.61,49.0,39,41,80,74,39,35,1.08,52.7,Facile,Moyen,-1,Plus Difficile,Pas Adapte
2921,2017,Mathematique,4,Les Espaces Pre-Hilbertiens et Hilbertiens,1,Espaces Prehilbertiens Reel ou Complexes,14,700,10,QCM,0.72,0.28,1.0,1,72,73,42,1,41,1.74,2.38,Difficile,Difficile,0,Meme Difficulté,Pas Adapte
4032,2018,Mathematique,4,Les Espaces Pre-Hilbertiens et Hilbertiens,1,Espaces Prehilbertiens Reel ou Complexes,14,700,10,QCM,0.63,0.3,18.0,14,61,75,29,14,15,2.59,48.28,Moyen,Difficile,-1,Plus Difficile,Pas Adapte
5143,2019,Mathematique,4,Les Espaces Pre-Hilbertiens et Hilbertiens,1,Espaces Prehilbertiens Reel ou Complexes,14,700,10,QCM,0.33,0.59,53.0,39,34,73,67,39,28,1.09,58.21,Moyen,Moyen,0,Meme Difficulté,Pas Adapte
6254,2020,Mathematique,4,Les Espaces Pre-Hilbertiens et Hilbertiens,1,Espaces Prehilbertiens Reel ou Complexes,14,700,10,QCM,0.25,0.52,64.0,47,27,74,61,47,14,1.21,77.05,Facile,Moyen,-1,Plus Difficile,Pas Adapte
700,2015,Mathematique,4,Les Espaces Pre-Hilbertiens et Hilbertiens,1,Espaces Prehilbertiens Reel ou Complexes,14,701,11,QCM,0.2,0.6,60.0,47,31,78,71,47,24,1.1,66.2,Facile,Moyen,-1,Plus Difficile,Pas Adapte
1811,2016,Mathematique,4,Les Espaces Pre-Hilbertiens et Hilbertiens,1,Espaces Prehilbertiens Reel ou Complexes,14,701,11,QCM,0.48,0.57,53.0,40,36,76,54,40,14,1.41,74.07,Moyen,Moyen,0,Meme Difficulté,Pas Adapte
2922,2017,Mathematique,4,Les Espaces Pre-Hilbertiens et Hilbertiens,1,Espaces Prehilbertiens Reel ou Complexes,14,701,11,QCM,0.06,0.85,66.0,55,28,83,58,55,3,1.43,94.83,Difficile,Facile,2,Beaucoup plus Facile,Adapte
4033,2018,Mathematique,4,Les Espaces Pre-Hilbertiens et Hilbertiens,1,Espaces Prehilbertiens Reel ou Complexes,14,701,11,QCM,0.03,0.83,66.0,57,30,87,79,57,22,1.1,72.15,Facile,Facile,0,Meme Difficulté,Adapte
5144,2019,Mathematique,4,Les Espaces Pre-Hilbertiens et Hilbertiens,1,Espaces Prehilbertiens Reel ou Complexes,14,701,11,QCU,0.08,0.85,66.0,53,27,80,72,53,19,1.11,73.61,Facile,Facile,0,Meme Difficulté,Adapte
6255,2020,Mathematique,4,Les Espaces Pre-Hilbertiens et Hilbertiens,1,Espaces Prehilbertiens Reel ou Complexes,14,701,11,QCU,0.09,0.89,66.0,59,30,89,88,59,29,1.01,67.05,Facile,Facile,0,Meme Difficulté,Adapte
701,2015,Mathematique,4,Les Espaces Pre-Hilbertiens et Hilbertiens,1,Espaces Prehilbertiens Reel ou Complexes,14,702,12,QCU,0.6,0.36,18.0,12,54,66,62,12,50,1.06,19.35,Facile,Difficile,-2,Beaucoup plus Difficile,Pas Adapte
1812,2016,Mathematique,4,Les Espaces Pre-Hilbertiens et Hilbertiens,1,Espaces Prehilbertiens Reel ou Complexes,14,702,12,QCU,0.41,0.39,33.0,25,50,75,69,25,44,1.09,36.23,Moyen,Difficile,-1,Plus Difficile,Pas Adapte
2923,2017,Mathematique,4,Les Espaces Pre-Hilbertiens et Hilbertiens,1,Espaces Prehilbertiens Reel ou Complexes,14,702,12,QCU,0.69,0.38,21.0,15,57,72,60,15,45,1.2,25.0,Difficile,Difficile,0,Meme Difficulté,Pas Adapte
4034,2018,Mathematique,4,Les Espaces Pre-Hilbertiens et Hilbertiens,1,Espaces Prehilbertiens Reel ou Complexes,14,702,12,QCU,0.35,0.58,38.0,28,47,75,62,28,34,1.21,45.16,Facile,Moyen,-1,Plus Difficile,Pas Adapte
5145,2019,Mathematique,4,Les Espaces Pre-Hilbertiens et Hilbertiens,1,Espaces Prehilbertiens Reel ou Complexes,14,702,12,QCU,0.31,0.56,58.0,44,32,76,57,44,13,1.33,77.19,Difficile,Moyen,1,Plus Facile,Pas Adapte
6256,2020,Mathematique,4,Les Espaces Pre-Hilbertiens et Hilbertiens,1,Espaces Prehilbertiens Reel ou Complexes,14,702,12,QROC,0.63,0.1,26.0,20,58,78,72,20,52,1.08,27.78,Difficile,Difficile,0,Meme Difficulté,Pas Adapte
702,2015,Mathematique,4,Les Espaces Pre-Hilbertiens et Hilbertiens,1,Espaces Prehilbertiens Reel ou Complexes,14,703,13,QCU,0.3,0.45,49.0,22,22,44,30,22,8,1.47,73.33,Moyen,Moyen,0,Meme Difficulté,Pas Adapte
1813,2016,Mathematique,4,Les Espaces Pre-Hilbertiens et Hilbertiens,1,Espaces Prehilbertiens Reel ou Complexes,14,703,13,QCU,0.0,0.78,65.0,30,16,46,31,30,1,1.48,96.77,Facile,Facile,0,Meme Difficulté,Adapte
2924,2017,Mathematique,4,Les Espaces Pre-Hilbertiens et Hilbertiens,1,Espaces Prehilbertiens Reel ou Complexes,14,703,13,QCU,0.11,0.97,65.0,30,16,46,32,30,2,1.44,93.75,Facile,Facile,0,Meme Difficulté,Adapte
4035,2018,Mathematique,4,Les Espaces Pre-Hilbertiens et Hilbertiens,1,Espaces Prehilbertiens Reel ou Complexes,14,703,13,QCM,0.15,0.98,65.0,32,18,50,45,32,13,1.11,71.11,Facile,Facile,0,Meme Difficulté,Adapte
5146,2019,Mathematique,4,Les Espaces Pre-Hilbertiens et Hilbertiens,1,Espaces Prehilbertiens Reel ou Complexes,14,703,13,QCM,0.17,0.83,65.0,29,16,45,39,29,10,1.15,74.36,Facile,Facile,0,Meme Difficulté,Adapte
6257,2020,Mathematique,4,Les Espaces Pre-Hilbertiens et Hilbertiens,1,Espaces Prehilbertiens Reel ou Complexes,14,703,13,QCM,0.02,0.93,65.0,34,18,52,35,34,1,1.49,97.14,Facile,Facile,0,Meme Difficulté,Adapte
703,2015,Mathematique,4,Les Espaces Pre-Hilbertiens et Hilbertiens,1,Espaces Prehilbertiens Reel ou Complexes,14,704,14,QCM,0.3,0.4,52.0,21,19,40,40,21,19,1.0,52.5,Facile,Moyen,-1,Plus Difficile,Pas Adapte
1814,2016,Mathematique,4,Les Espaces Pre-Hilbertiens et Hilbertiens,1,Espaces Prehilbertiens Reel ou Complexes,14,704,14,QO,0.24,0.28,55.0,24,20,44,27,24,3,1.63,88.89,Difficile,Moyen,1,Plus Facile,Pas Adapte
2925,2017,Mathematique,4,Les Espaces Pre-Hilbertiens et Hilbertiens,1,Espaces Prehilbertiens Reel ou Complexes,14,704,14,QCM,0.18,0.72,68.0,31,14,45,41,31,10,1.1,75.61,Facile,Facile,0,Meme Difficulté,Adapte
4036,2018,Mathematique,4,Les Espaces Pre-Hilbertiens et Hilbertiens,1,Espaces Prehilbertiens Reel ou Complexes,14,704,14,QCM,0.12,0.9,68.0,31,14,45,44,31,13,1.02,70.45,Facile,Facile,0,Meme Difficulté,Adapte
5147,2019,Mathematique,4,Les Espaces Pre-Hilbertiens et Hilbertiens,1,Espaces Prehilbertiens Reel ou Complexes,14,704,14,QCM,0.17,0.91,68.0,27,13,40,30,27,3,1.33,90.0,Facile,Facile,0,Meme Difficulté,Adapte
6258,2020,Mathematique,4,Les Espaces Pre-Hilbertiens et Hilbertiens,1,Espaces Prehilbertiens Reel ou Complexes,14,704,14,QCM,0.14,1.0,68.0,25,12,37,32,25,7,1.16,78.12,Facile,Facile,0,Meme Difficulté,Adapte
704,2015,Mathematique,4,Les Espaces Pre-Hilbertiens et Hilbertiens,2,Espaces Euclidiens,10,705,1,QCU,0.65,0.24,1.0,1,95,96,50,1,49,1.92,2.0,Facile,Difficile,-2,Beaucoup plus Difficile,Pas Adapte
1815,2016,Mathematique,4,Les Espaces Pre-Hilbertiens et Hilbertiens,2,Espaces Euclidiens,10,705,1,QCU,0.22,0.5,56.0,60,48,108,94,60,34,1.15,63.83,Moyen,Moyen,0,Meme Difficulté,Pas Adapte
2926,2017,Mathematique,4,Les Espaces Pre-Hilbertiens et Hilbertiens,2,Espaces Euclidiens,10,705,1,QCM,0.24,0.53,45.0,45,55,100,87,45,42,1.15,51.72,Facile,Moyen,-1,Plus Difficile,Pas Adapte
4037,2018,Mathematique,4,Les Espaces Pre-Hilbertiens et Hilbertiens,2,Espaces Euclidiens,10,705,1,QCM,0.4,0.35,63.0,55,33,88,81,55,26,1.09,67.9,Facile,Moyen,-1,Plus Difficile,Pas Adapte
5148,2019,Mathematique,4,Les Espaces Pre-Hilbertiens et Hilbertiens,2,Espaces Euclidiens,10,705,1,QCM,0.09,0.78,66.0,61,32,93,64,61,3,1.45,95.31,Moyen,Facile,1,Plus Facile,Adapte
6259,2020,Mathematique,4,Les Espaces Pre-Hilbertiens et Hilbertiens,2,Espaces Euclidiens,10,705,1,QCM,0.08,0.74,66.0,59,31,90,68,59,9,1.32,86.76,Facile,Facile,0,Meme Difficulté,Adapte
705,2015,Mathematique,4,Les Espaces Pre-Hilbertiens et Hilbertiens,2,Espaces Euclidiens,10,706,2,QCM,0.16,0.8,68.0,5,2,7,6,5,1,1.17,83.33,Facile,Facile,0,Meme Difficulté,Adapte
1816,2016,Mathematique,4,Les Espaces Pre-Hilbertiens et Hilbertiens,2,Espaces Euclidiens,10,706,2,QCM,0.17,0.79,68.0,4,2,6,5,4,1,1.2,80.0,Facile,Facile,0,Meme Difficulté,Adapte
2927,2017,Mathematique,4,Les Espaces Pre-Hilbertiens et Hilbertiens,2,Espaces Euclidiens,10,706,2,QCM,0.16,0.71,68.0,4,2,6,4,4,0,1.5,100.0,Facile,Facile,0,Meme Difficulté,Adapte
4038,2018,Mathematique,4,Les Espaces Pre-Hilbertiens et Hilbertiens,2,Espaces Euclidiens,10,706,2,QCU,0.08,0.78,68.0,4,2,6,5,4,1,1.2,80.0,Facile,Facile,0,Meme Difficulté,Adapte
5149,2019,Mathematique,4,Les Espaces Pre-Hilbertiens et Hilbertiens,2,Espaces Euclidiens,10,706,2,QCU,0.02,0.8,68.0,3,2,5,4,3,1,1.25,75.0,Facile,Facile,0,Meme Difficulté,Adapte
6260,2020,Mathematique,4,Les Espaces Pre-Hilbertiens et Hilbertiens,2,Espaces Euclidiens,10,706,2,QCU,0.07,0.89,68.0,4,2,6,5,4,1,1.2,80.0,Facile,Facile,0,Meme Difficulté,Adapte
706,2015,Mathematique,4,Les Espaces Pre-Hilbertiens et Hilbertiens,2,Espaces Euclidiens,10,707,3,QCU,0.17,0.82,68.0,48,23,71,59,48,11,1.2,81.36,Difficile,Facile,2,Beaucoup plus Facile,Adapte
1817,2016,Mathematique,4,Les Espaces Pre-Hilbertiens et Hilbertiens,2,Espaces Euclidiens,10,707,3,QCU,0.07,0.98,68.0,52,24,76,71,52,19,1.07,73.24,Facile,Facile,0,Meme Difficulté,Adapte
2928,2017,Mathematique,4,Les Espaces Pre-Hilbertiens et Hilbertiens,2,Espaces Euclidiens,10,707,3,QCU,0.0,0.75,68.0,50,23,73,56,50,6,1.3,89.29,Facile,Facile,0,Meme Difficulté,Adapte
4039,2018,Mathematique,4,Les Espaces Pre-Hilbertiens et Hilbertiens,2,Espaces Euclidiens,10,707,3,QCU,0.18,0.95,68.0,47,22,69,63,47,16,1.1,74.6,Facile,Facile,0,Meme Difficulté,Adapte
5150,2019,Mathematique,4,Les Espaces Pre-Hilbertiens et Hilbertiens,2,Espaces Euclidiens,10,707,3,QCU,0.1,0.93,68.0,54,25,79,79,54,25,1.0,68.35,Facile,Facile,0,Meme Difficulté,Adapte
6261,2020,Mathematique,4,Les Espaces Pre-Hilbertiens et Hilbertiens,2,Espaces Euclidiens,10,707,3,QCU,0.07,0.76,68.0,47,22,69,61,47,14,1.13,77.05,Facile,Facile,0,Meme Difficulté,Adapte
707,2015,Mathematique,4,Les Espaces Pre-Hilbertiens et Hilbertiens,2,Espaces Euclidiens,10,708,4,QCM,0.6,0.3,0.0,0,99,99,45,0,45,2.2,0.0,Difficile,Difficile,0,Meme Difficulté,Pas Adapte
1818,2016,Mathematique,4,Les Espaces Pre-Hilbertiens et Hilbertiens,2,Espaces Euclidiens,10,708,4,QCM,0.61,0.23,21.0,18,66,84,74,18,56,1.14,24.32,Difficile,Difficile,0,Meme Difficulté,Pas Adapte
2929,2017,Mathematique,4,Les Espaces Pre-Hilbertiens et Hilbertiens,2,Espaces Euclidiens,10,708,4,QCU,0.44,0.22,10.0,8,67,75,27,8,19,2.78,29.63,Difficile,Difficile,0,Meme Difficulté,Pas Adapte
4040,2018,Mathematique,4,Les Espaces Pre-Hilbertiens et Hilbertiens,2,Espaces Euclidiens,10,708,4,QCU,0.26,0.67,58.0,49,35,84,77,49,28,1.09,63.64,Difficile,Moyen,1,Plus Facile,Pas Adapte
5151,2019,Mathematique,4,Les Espaces Pre-Hilbertiens et Hilbertiens,2,Espaces Euclidiens,10,708,4,QCU,0.4,0.39,31.0,28,63,91,50,28,22,1.82,56.0,Moyen,Difficile,-1,Plus Difficile,Pas Adapte
6262,2020,Mathematique,4,Les Espaces Pre-Hilbertiens et Hilbertiens,2,Espaces Euclidiens,10,708,4,QCU,0.28,0.62,47.0,48,55,103,59,48,11,1.75,81.36,Difficile,Moyen,1,Plus Facile,Pas Adapte
708,2015,Mathematique,4,Les Espaces Pre-Hilbertiens et Hilbertiens,2,Espaces Euclidiens,10,709,5,QCU,0.45,0.32,30.0,28,67,95,87,28,59,1.09,32.18,Moyen,Difficile,-1,Plus Difficile,Pas Adapte
1819,2016,Mathematique,4,Les Espaces Pre-Hilbertiens et Hilbertiens,2,Espaces Euclidiens,10,709,5,QCU,0.27,0.51,44.0,36,45,81,65,36,29,1.25,55.38,Facile,Moyen,-1,Plus Difficile,Pas Adapte
2930,2017,Mathematique,4,Les Espaces Pre-Hilbertiens et Hilbertiens,2,Espaces Euclidiens,10,709,5,QCU,0.03,0.86,68.0,52,24,76,59,52,7,1.29,88.14,Facile,Facile,0,Meme Difficulté,Adapte
4041,2018,Mathematique,4,Les Espaces Pre-Hilbertiens et Hilbertiens,2,Espaces Euclidiens,10,709,5,QCU,0.03,0.78,68.0,50,23,73,70,50,20,1.04,71.43,Facile,Facile,0,Meme Difficulté,Adapte
5152,2019,Mathematique,4,Les Espaces Pre-Hilbertiens et Hilbertiens,2,Espaces Euclidiens,10,709,5,QCU,0.2,0.88,68.0,42,20,62,50,42,8,1.24,84.0,Facile,Facile,0,Meme Difficulté,Adapte
6263,2020,Mathematique,4,Les Espaces Pre-Hilbertiens et Hilbertiens,2,Espaces Euclidiens,10,709,5,QCU,0.14,0.89,68.0,37,17,54,45,37,8,1.2,82.22,Facile,Facile,0,Meme Difficulté,Adapte
709,2015,Mathematique,4,Les Espaces Pre-Hilbertiens et Hilbertiens,2,Espaces Euclidiens,10,710,6,QCM,0.28,0.41,36.0,10,17,27,25,10,15,1.08,40.0,Facile,Moyen,-1,Plus Difficile,Pas Adapte
1820,2016,Mathematique,4,Les Espaces Pre-Hilbertiens et Hilbertiens,2,Espaces Euclidiens,10,710,6,QCM,0.37,0.47,59.0,18,12,30,24,18,6,1.25,75.0,Moyen,Moyen,0,Meme Difficulté,Pas Adapte
2931,2017,Mathematique,4,Les Espaces Pre-Hilbertiens et Hilbertiens,2,Espaces Euclidiens,10,710,6,QCU,0.73,0.25,6.0,2,24,26,22,2,20,1.18,9.09,Facile,Difficile,-2,Beaucoup plus Difficile,Pas Adapte
4042,2018,Mathematique,4,Les Espaces Pre-Hilbertiens et Hilbertiens,2,Espaces Euclidiens,10,710,6,QCU,0.58,0.22,12.0,3,20,23,20,3,17,1.15,15.0,Difficile,Difficile,0,Meme Difficulté,Pas Adapte
5153,2019,Mathematique,4,Les Espaces Pre-Hilbertiens et Hilbertiens,2,Espaces Euclidiens,10,710,6,QCU,0.16,0.77,68.0,15,7,22,20,15,5,1.1,75.0,Difficile,Facile,2,Beaucoup plus Facile,Adapte
6264,2020,Mathematique,4,Les Espaces Pre-Hilbertiens et Hilbertiens,2,Espaces Euclidiens,10,710,6,QCU,0.03,0.78,68.0,13,6,19,16,13,3,1.19,81.25,Facile,Facile,0,Meme Difficulté,Adapte
710,2015,Mathematique,4,Les Espaces Pre-Hilbertiens et Hilbertiens,2,Espaces Euclidiens,10,711,7,QCU,0.55,0.2,9.0,8,83,91,47,8,39,1.94,17.02,Difficile,Difficile,0,Meme Difficulté,Pas Adapte
1821,2016,Mathematique,4,Les Espaces Pre-Hilbertiens et Hilbertiens,2,Espaces Euclidiens,10,711,7,QCU,0.55,0.29,23.0,21,69,90,87,21,66,1.03,24.14,Moyen,Difficile,-1,Plus Difficile,Pas Adapte
2932,2017,Mathematique,4,Les Espaces Pre-Hilbertiens et Hilbertiens,2,Espaces Euclidiens,10,711,7,QCU,0.52,0.31,32.0,26,54,80,64,26,38,1.25,40.62,Moyen,Difficile,-1,Plus Difficile,Pas Adapte
4043,2018,Mathematique,4,Les Espaces Pre-Hilbertiens et Hilbertiens,2,Espaces Euclidiens,10,711,7,QCU,0.65,0.36,9.0,8,82,90,63,8,55,1.43,12.7,Facile,Difficile,-2,Beaucoup plus Difficile,Pas Adapte
5154,2019,Mathematique,4,Les Espaces Pre-Hilbertiens et Hilbertiens,2,Espaces Euclidiens,10,711,7,QCU,0.23,0.58,56.0,45,35,80,59,45,14,1.36,76.27,Facile,Moyen,-1,Plus Difficile,Pas Adapte
6265,2020,Mathematique,4,Les Espaces Pre-Hilbertiens et Hilbertiens,2,Espaces Euclidiens,10,711,7,QCU,0.25,0.44,62.0,52,32,84,70,52,18,1.2,74.29,Difficile,Moyen,1,Plus Facile,Pas Adapte
711,2015,Mathematique,4,Les Espaces Pre-Hilbertiens et Hilbertiens,2,Espaces Euclidiens,10,712,8,QCU,0.49,0.27,10.0,7,62,69,50,7,43,1.38,14.0,Difficile,Difficile,0,Meme Difficulté,Pas Adapte
1822,2016,Mathematique,4,Les Espaces Pre-Hilbertiens et Hilbertiens,2,Espaces Euclidiens,10,712,8,QCU,0.31,0.66,58.0,44,32,76,48,44,4,1.58,91.67,Facile,Moyen,-1,Plus Difficile,Pas Adapte
2933,2017,Mathematique,4,Les Espaces Pre-Hilbertiens et Hilbertiens,2,Espaces Euclidiens,10,712,8,QCU,0.31,0.64,51.0,44,42,86,75,44,31,1.15,58.67,Difficile,Moyen,1,Plus Facile,Pas Adapte
4044,2018,Mathematique,4,Les Espaces Pre-Hilbertiens et Hilbertiens,2,Espaces Euclidiens,10,712,8,QCU,0.42,0.25,24.0,20,62,82,37,20,17,2.22,54.05,Difficile,Difficile,0,Meme Difficulté,Pas Adapte
5155,2019,Mathematique,4,Les Espaces Pre-Hilbertiens et Hilbertiens,2,Espaces Euclidiens,10,712,8,QCU,0.3,0.58,62.0,45,28,73,62,45,17,1.18,72.58,Facile,Moyen,-1,Plus Difficile,Pas Adapte
6266,2020,Mathematique,4,Les Espaces Pre-Hilbertiens et Hilbertiens,2,Espaces Euclidiens,10,712,8,QCU,0.41,0.4,1.0,1,73,74,38,1,37,1.95,2.63,Facile,Difficile,-2,Beaucoup plus Difficile,Pas Adapte
712,2015,Mathematique,4,Les Espaces Pre-Hilbertiens et Hilbertiens,2,Espaces Euclidiens,10,713,9,QROC,0.8,0.02,16.0,1,7,8,6,1,5,1.33,16.67,Moyen,Difficile,-1,Plus Difficile,Pas Adapte
1823,2016,Mathematique,4,Les Espaces Pre-Hilbertiens et Hilbertiens,2,Espaces Euclidiens,10,713,9,QROC,0.6,0.14,22.0,2,5,7,3,2,1,2.33,66.67,Facile,Difficile,-2,Beaucoup plus Difficile,Pas Adapte
2934,2017,Mathematique,4,Les Espaces Pre-Hilbertiens et Hilbertiens,2,Espaces Euclidiens,10,713,9,QROC,0.61,0.2,17.0,1,5,6,3,1,2,2.0,33.33,Moyen,Difficile,-1,Plus Difficile,Pas Adapte
4045,2018,Mathematique,4,Les Espaces Pre-Hilbertiens et Hilbertiens,2,Espaces Euclidiens,10,713,9,QROC,0.53,0.37,49.0,3,4,7,3,3,0,2.33,100.0,Difficile,Moyen,1,Plus Facile,Pas Adapte
5156,2019,Mathematique,4,Les Espaces Pre-Hilbertiens et Hilbertiens,2,Espaces Euclidiens,10,713,9,QROC,0.97,0.11,4.0,0,6,6,3,0,3,2.0,0.0,Facile,Difficile,-2,Beaucoup plus Difficile,Pas Adapte
6267,2020,Mathematique,4,Les Espaces Pre-Hilbertiens et Hilbertiens,2,Espaces Euclidiens,10,713,9,QROC,0.85,0.09,14.0,1,4,5,2,1,1,2.5,50.0,Facile,Difficile,-2,Beaucoup plus Difficile,Pas Adapte
713,2015,Mathematique,4,Les Espaces Pre-Hilbertiens et Hilbertiens,2,Espaces Euclidiens,10,714,10,QCM,0.08,0.76,67.0,67,33,100,99,67,32,1.01,67.68,Facile,Facile,0,Meme Difficulté,Adapte
1824,2016,Mathematique,4,Les Espaces Pre-Hilbertiens et Hilbertiens,2,Espaces Euclidiens,10,714,10,QCM,0.09,0.95,67.0,72,35,107,93,72,21,1.15,77.42,Facile,Facile,0,Meme Difficulté,Adapte
2935,2017,Mathematique,4,Les Espaces Pre-Hilbertiens et Hilbertiens,2,Espaces Euclidiens,10,714,10,QCM,0.01,0.87,67.0,68,33,101,100,68,32,1.01,68.0,Facile,Facile,0,Meme Difficulté,Adapte
4046,2018,Mathematique,4,Les Espaces Pre-Hilbertiens et Hilbertiens,2,Espaces Euclidiens,10,714,10,QCM,0.12,0.94,67.0,58,29,87,70,58,12,1.24,82.86,Facile,Facile,0,Meme Difficulté,Adapte
5157,2019,Mathematique,4,Les Espaces Pre-Hilbertiens et Hilbertiens,2,Espaces Euclidiens,10,714,10,QCM,0.09,0.86,67.0,54,27,81,77,54,23,1.05,70.13,Facile,Facile,0,Meme Difficulté,Adapte
6268,2020,Mathematique,4,Les Espaces Pre-Hilbertiens et Hilbertiens,2,Espaces Euclidiens,10,714,10,QCM,0.05,0.82,67.0,52,26,78,72,52,20,1.08,72.22,Facile,Facile,0,Meme Difficulté,Adapte
714,2015,Mathematique,4,Les Espaces Pre-Hilbertiens et Hilbertiens,3,Rappels et Complements sur le Groupe Orthogonal d'un Espace Euclidien,7,715,1,QCM,0.3,0.66,59.0,12,9,21,18,12,6,1.17,66.67,Moyen,Moyen,0,Meme Difficulté,Pas Adapte
1825,2016,Mathematique,4,Les Espaces Pre-Hilbertiens et Hilbertiens,3,Rappels et Complements sur le Groupe Orthogonal d'un Espace Euclidien,7,715,1,QCM,0.57,0.15,20.0,4,14,18,16,4,12,1.12,25.0,Facile,Difficile,-2,Beaucoup plus Difficile,Pas Adapte
2936,2017,Mathematique,4,Les Espaces Pre-Hilbertiens et Hilbertiens,3,Rappels et Complements sur le Groupe Orthogonal d'un Espace Euclidien,7,715,1,QCM,0.56,0.28,13.0,2,16,18,6,2,4,3.0,33.33,Moyen,Difficile,-1,Plus Difficile,Pas Adapte
4047,2018,Mathematique,4,Les Espaces Pre-Hilbertiens et Hilbertiens,3,Rappels et Complements sur le Groupe Orthogonal d'un Espace Euclidien,7,715,1,QCM,0.2,0.55,48.0,10,11,21,11,10,1,1.91,90.91,Moyen,Moyen,0,Meme Difficulté,Pas Adapte
5158,2019,Mathematique,4,Les Espaces Pre-Hilbertiens et Hilbertiens,3,Rappels et Complements sur le Groupe Orthogonal d'un Espace Euclidien,7,715,1,QCM,0.65,0.18,3.0,1,19,20,5,1,4,4.0,20.0,Difficile,Difficile,0,Meme Difficulté,Pas Adapte
6269,2020,Mathematique,4,Les Espaces Pre-Hilbertiens et Hilbertiens,3,Rappels et Complements sur le Groupe Orthogonal d'un Espace Euclidien,7,715,1,QCM,0.66,0.26,19.0,4,17,21,12,4,8,1.75,33.33,Moyen,Difficile,-1,Plus Difficile,Pas Adapte
715,2015,Mathematique,4,Les Espaces Pre-Hilbertiens et Hilbertiens,3,Rappels et Complements sur le Groupe Orthogonal d'un Espace Euclidien,7,716,2,QROC,0.65,0.05,31.0,15,33,48,45,15,30,1.07,33.33,Facile,Difficile,-2,Beaucoup plus Difficile,Pas Adapte
1826,2016,Mathematique,4,Les Espaces Pre-Hilbertiens et Hilbertiens,3,Rappels et Complements sur le Groupe Orthogonal d'un Espace Euclidien,7,716,2,QO,0.95,0.11,31.0,13,28,41,24,13,11,1.71,54.17,Moyen,Difficile,-1,Plus Difficile,Pas Adapte
2937,2017,Mathematique,4,Les Espaces Pre-Hilbertiens et Hilbertiens,3,Rappels et Complements sur le Groupe Orthogonal d'un Espace Euclidien,7,716,2,QO,0.25,0.28,48.0,17,18,35,28,17,11,1.25,60.71,Moyen,Moyen,0,Meme Difficulté,Pas Adapte
4048,2018,Mathematique,4,Les Espaces Pre-Hilbertiens et Hilbertiens,3,Rappels et Complements sur le Groupe Orthogonal d'un Espace Euclidien,7,716,2,QO,0.92,0.0,34.0,14,26,40,29,14,15,1.38,48.28,Facile,Difficile,-2,Beaucoup plus Difficile,Pas Adapte
5159,2019,Mathematique,4,Les Espaces Pre-Hilbertiens et Hilbertiens,3,Rappels et Complements sur le Groupe Orthogonal d'un Espace Euclidien,7,716,2,QO,0.95,0.12,8.0,4,42,46,27,4,23,1.7,14.81,Facile,Difficile,-2,Beaucoup plus Difficile,Pas Adapte
6270,2020,Mathematique,4,Les Espaces Pre-Hilbertiens et Hilbertiens,3,Rappels et Complements sur le Groupe Orthogonal d'un Espace Euclidien,7,716,2,QO,0.82,0.12,35.0,17,32,49,48,17,31,1.02,35.42,Facile,Difficile,-2,Beaucoup plus Difficile,Pas Adapte
716,2015,Mathematique,4,Les Espaces Pre-Hilbertiens et Hilbertiens,3,Rappels et Complements sur le Groupe Orthogonal d'un Espace Euclidien,7,717,3,QCM,0.68,0.21,11.0,7,53,60,60,7,53,1.0,11.67,Difficile,Difficile,0,Meme Difficulté,Pas Adapte
1827,2016,Mathematique,4,Les Espaces Pre-Hilbertiens et Hilbertiens,3,Rappels et Complements sur le Groupe Orthogonal d'un Espace Euclidien,7,717,3,QCM,0.41,0.54,52.0,27,25,52,30,27,3,1.73,90.0,Facile,Moyen,-1,Plus Difficile,Pas Adapte
2938,2017,Mathematique,4,Les Espaces Pre-Hilbertiens et Hilbertiens,3,Rappels et Complements sur le Groupe Orthogonal d'un Espace Euclidien,7,717,3,QROC,0.47,0.28,48.0,27,29,56,36,27,9,1.56,75.0,Moyen,Moyen,0,Meme Difficulté,Pas Adapte
4049,2018,Mathematique,4,Les Espaces Pre-Hilbertiens et Hilbertiens,3,Rappels et Complements sur le Groupe Orthogonal d'un Espace Euclidien,7,717,3,QROC,0.55,0.37,46.0,27,31,58,46,27,19,1.26,58.7,Difficile,Moyen,1,Plus Facile,Pas Adapte
5160,2019,Mathematique,4,Les Espaces Pre-Hilbertiens et Hilbertiens,3,Rappels et Complements sur le Groupe Orthogonal d'un Espace Euclidien,7,717,3,QROC,0.32,0.26,56.0,36,29,65,48,36,12,1.35,75.0,Difficile,Moyen,1,Plus Facile,Pas Adapte
6271,2020,Mathematique,4,Les Espaces Pre-Hilbertiens et Hilbertiens,3,Rappels et Complements sur le Groupe Orthogonal d'un Espace Euclidien,7,717,3,QROC,0.49,0.32,58.0,37,26,63,51,37,14,1.24,72.55,Difficile,Moyen,1,Plus Facile,Pas Adapte
717,2015,Mathematique,4,Les Espaces Pre-Hilbertiens et Hilbertiens,3,Rappels et Complements sur le Groupe Orthogonal d'un Espace Euclidien,7,718,4,QCM,0.66,0.21,20.0,14,56,70,69,14,55,1.01,20.29,Moyen,Difficile,-1,Plus Difficile,Pas Adapte
1828,2016,Mathematique,4,Les Espaces Pre-Hilbertiens et Hilbertiens,3,Rappels et Complements sur le Groupe Orthogonal d'un Espace Euclidien,7,718,4,QCM,0.33,0.62,37.0,26,43,69,28,26,2,2.46,92.86,Facile,Moyen,-1,Plus Difficile,Pas Adapte
2939,2017,Mathematique,4,Les Espaces Pre-Hilbertiens et Hilbertiens,3,Rappels et Complements sur le Groupe Orthogonal d'un Espace Euclidien,7,718,4,QCU,0.26,0.51,57.0,36,28,64,57,36,21,1.12,63.16,Difficile,Moyen,1,Plus Facile,Pas Adapte
4050,2018,Mathematique,4,Les Espaces Pre-Hilbertiens et Hilbertiens,3,Rappels et Complements sur le Groupe Orthogonal d'un Espace Euclidien,7,718,4,QCU,0.67,0.26,21.0,12,47,59,45,12,33,1.31,26.67,Facile,Difficile,-2,Beaucoup plus Difficile,Pas Adapte
5161,2019,Mathematique,4,Les Espaces Pre-Hilbertiens et Hilbertiens,3,Rappels et Complements sur le Groupe Orthogonal d'un Espace Euclidien,7,718,4,QCM,0.23,0.59,40.0,20,30,50,46,20,26,1.09,43.48,Facile,Moyen,-1,Plus Difficile,Pas Adapte
6272,2020,Mathematique,4,Les Espaces Pre-Hilbertiens et Hilbertiens,3,Rappels et Complements sur le Groupe Orthogonal d'un Espace Euclidien,7,718,4,QCM,0.47,0.7,41.0,20,28,48,34,20,14,1.41,58.82,Difficile,Moyen,1,Plus Facile,Pas Adapte
718,2015,Mathematique,4,Les Espaces Pre-Hilbertiens et Hilbertiens,3,Rappels et Complements sur le Groupe Orthogonal d'un Espace Euclidien,7,719,5,QCM,0.59,0.29,18.0,16,72,88,27,16,11,3.26,59.26,Moyen,Difficile,-1,Plus Difficile,Pas Adapte
1829,2016,Mathematique,4,Les Espaces Pre-Hilbertiens et Hilbertiens,3,Rappels et Complements sur le Groupe Orthogonal d'un Espace Euclidien,7,719,5,QO,0.85,0.06,3.0,3,96,99,75,3,72,1.32,4.0,Difficile,Difficile,0,Meme Difficulté,Pas Adapte
2940,2017,Mathematique,4,Les Espaces Pre-Hilbertiens et Hilbertiens,3,Rappels et Complements sur le Groupe Orthogonal d'un Espace Euclidien,7,719,5,QO,0.9,0.11,35.0,37,70,107,92,37,55,1.16,40.22,Difficile,Difficile,0,Meme Difficulté,Pas Adapte
4051,2018,Mathematique,4,Les Espaces Pre-Hilbertiens et Hilbertiens,3,Rappels et Complements sur le Groupe Orthogonal d'un Espace Euclidien,7,719,5,QROC,0.6,0.22,15.0,18,103,121,66,18,48,1.83,27.27,Facile,Difficile,-2,Beaucoup plus Difficile,Pas Adapte
5162,2019,Mathematique,4,Les Espaces Pre-Hilbertiens et Hilbertiens,3,Rappels et Complements sur le Groupe Orthogonal d'un Espace Euclidien,7,719,5,QROC,0.63,0.06,30.0,38,90,128,83,38,45,1.54,45.78,Difficile,Difficile,0,Meme Difficulté,Pas Adapte
6273,2020,Mathematique,4,Les Espaces Pre-Hilbertiens et Hilbertiens,3,Rappels et Complements sur le Groupe Orthogonal d'un Espace Euclidien,7,719,5,QROC,0.91,0.0,14.0,18,107,125,116,18,98,1.08,15.52,Difficile,Difficile,0,Meme Difficulté,Pas Adapte
719,2015,Mathematique,4,Les Espaces Pre-Hilbertiens et Hilbertiens,3,Rappels et Complements sur le Groupe Orthogonal d'un Espace Euclidien,7,720,6,QO,0.39,0.3,38.0,13,20,33,26,13,13,1.27,50.0,Difficile,Moyen,1,Plus Facile,Pas Adapte
1830,2016,Mathematique,4,Les Espaces Pre-Hilbertiens et Hilbertiens,3,Rappels et Complements sur le Groupe Orthogonal d'un Espace Euclidien,7,720,6,QROC,0.56,0.32,51.0,17,17,34,19,17,2,1.79,89.47,Moyen,Moyen,0,Meme Difficulté,Pas Adapte
2941,2017,Mathematique,4,Les Espaces Pre-Hilbertiens et Hilbertiens,3,Rappels et Complements sur le Groupe Orthogonal d'un Espace Euclidien,7,720,6,QROC,0.87,0.04,1.0,0,34,34,27,0,27,1.26,0.0,Facile,Difficile,-2,Beaucoup plus Difficile,Pas Adapte
4052,2018,Mathematique,4,Les Espaces Pre-Hilbertiens et Hilbertiens,3,Rappels et Complements sur le Groupe Orthogonal d'un Espace Euclidien,7,720,6,QROC,0.92,0.21,23.0,8,26,34,24,8,16,1.42,33.33,Moyen,Difficile,-1,Plus Difficile,Pas Adapte
5163,2019,Mathematique,4,Les Espaces Pre-Hilbertiens et Hilbertiens,3,Rappels et Complements sur le Groupe Orthogonal d'un Espace Euclidien,7,720,6,QROC,0.2,0.37,38.0,15,24,39,25,15,10,1.56,60.0,Facile,Moyen,-1,Plus Difficile,Pas Adapte
6274,2020,Mathematique,4,Les Espaces Pre-Hilbertiens et Hilbertiens,3,Rappels et Complements sur le Groupe Orthogonal d'un Espace Euclidien,7,720,6,QROC,0.95,0.11,13.0,6,39,45,40,6,34,1.12,15.0,Facile,Difficile,-2,Beaucoup plus Difficile,Pas Adapte
720,2015,Mathematique,4,Les Espaces Pre-Hilbertiens et Hilbertiens,3,Rappels et Complements sur le Groupe Orthogonal d'un Espace Euclidien,7,721,7,QCU,0.36,0.72,48.0,12,14,26,26,12,14,1.0,46.15,Facile,Moyen,-1,Plus Difficile,Pas Adapte
1831,2016,Mathematique,4,Les Espaces Pre-Hilbertiens et Hilbertiens,3,Rappels et Complements sur le Groupe Orthogonal d'un Espace Euclidien,7,721,7,QCU,0.25,0.67,42.0,10,14,24,21,10,11,1.14,47.62,Facile,Moyen,-1,Plus Difficile,Pas Adapte
2942,2017,Mathematique,4,Les Espaces Pre-Hilbertiens et Hilbertiens,3,Rappels et Complements sur le Groupe Orthogonal d'un Espace Euclidien,7,721,7,QCU,0.15,0.84,65.0,14,8,22,21,14,7,1.05,66.67,Difficile,Facile,2,Beaucoup plus Facile,Adapte
4053,2018,Mathematique,4,Les Espaces Pre-Hilbertiens et Hilbertiens,3,Rappels et Complements sur le Groupe Orthogonal d'un Espace Euclidien,7,721,7,QCU,0.06,0.83,65.0,13,7,20,14,13,1,1.43,92.86,Facile,Facile,0,Meme Difficulté,Adapte
5164,2019,Mathematique,4,Les Espaces Pre-Hilbertiens et Hilbertiens,3,Rappels et Complements sur le Groupe Orthogonal d'un Espace Euclidien,7,721,7,QCU,0.07,0.98,65.0,15,8,23,21,15,6,1.1,71.43,Facile,Facile,0,Meme Difficulté,Adapte
6275,2020,Mathematique,4,Les Espaces Pre-Hilbertiens et Hilbertiens,3,Rappels et Complements sur le Groupe Orthogonal d'un Espace Euclidien,7,721,7,QCU,0.1,0.89,65.0,14,7,21,18,14,4,1.17,77.78,Facile,Facile,0,Meme Difficulté,Adapte
721,2015,Mathematique,4,Les Espaces Pre-Hilbertiens et Hilbertiens,4,Complement sur les Endomorphismes Autoadjoints d'un Espace Euclidien et les Matrices Symetriques,1,722,1,QCU,0.16,0.76,65.0,57,30,87,58,57,1,1.5,98.28,Moyen,Facile,1,Plus Facile,Adapte
1832,2016,Mathematique,4,Les Espaces Pre-Hilbertiens et Hilbertiens,4,Complement sur les Endomorphismes Autoadjoints d'un Espace Euclidien et les Matrices Symetriques,1,722,1,QCU,0.13,0.81,65.0,65,35,100,87,65,22,1.15,74.71,Facile,Facile,0,Meme Difficulté,Adapte
2943,2017,Mathematique,4,Les Espaces Pre-Hilbertiens et Hilbertiens,4,Complement sur les Endomorphismes Autoadjoints d'un Espace Euclidien et les Matrices Symetriques,1,722,1,QCM,0.14,0.77,65.0,60,32,92,86,60,26,1.07,69.77,Facile,Facile,0,Meme Difficulté,Adapte
4054,2018,Mathematique,4,Les Espaces Pre-Hilbertiens et Hilbertiens,4,Complement sur les Endomorphismes Autoadjoints d'un Espace Euclidien et les Matrices Symetriques,1,722,1,QCM,0.03,0.99,65.0,60,33,93,84,60,24,1.11,71.43,Facile,Facile,0,Meme Difficulté,Adapte
5165,2019,Mathematique,4,Les Espaces Pre-Hilbertiens et Hilbertiens,4,Complement sur les Endomorphismes Autoadjoints d'un Espace Euclidien et les Matrices Symetriques,1,722,1,QCM,0.08,0.83,65.0,60,32,92,75,60,15,1.23,80.0,Facile,Facile,0,Meme Difficulté,Adapte
6276,2020,Mathematique,4,Les Espaces Pre-Hilbertiens et Hilbertiens,4,Complement sur les Endomorphismes Autoadjoints d'un Espace Euclidien et les Matrices Symetriques,1,722,1,QCM,0.08,0.92,65.0,55,29,84,74,55,19,1.14,74.32,Facile,Facile,0,Meme Difficulté,Adapte
722,2015,Mathematique,5,La Geometrie Analytique,1,Sur l'Utilisation de Maple,12,723,1,QCM,0.63,0.19,30.0,14,34,48,17,14,3,2.82,82.35,Moyen,Difficile,-1,Plus Difficile,Pas Adapte
1833,2016,Mathematique,5,La Geometrie Analytique,1,Sur l'Utilisation de Maple,12,723,1,QCM,0.25,0.37,47.0,21,24,45,23,21,2,1.96,91.3,Moyen,Moyen,0,Meme Difficulté,Pas Adapte
2944,2017,Mathematique,5,La Geometrie Analytique,1,Sur l'Utilisation de Maple,12,723,1,QCM,0.69,0.28,35.0,15,28,43,18,15,3,2.39,83.33,Moyen,Difficile,-1,Plus Difficile,Pas Adapte
4055,2018,Mathematique,5,La Geometrie Analytique,1,Sur l'Utilisation de Maple,12,723,1,QCM,0.67,0.22,14.0,7,41,48,26,7,19,1.85,26.92,Difficile,Difficile,0,Meme Difficulté,Pas Adapte
5166,2019,Mathematique,5,La Geometrie Analytique,1,Sur l'Utilisation de Maple,12,723,1,QCM,0.75,0.27,14.0,8,47,55,31,8,23,1.77,25.81,Moyen,Difficile,-1,Plus Difficile,Pas Adapte
6277,2020,Mathematique,5,La Geometrie Analytique,1,Sur l'Utilisation de Maple,12,723,1,QCU,0.45,0.38,27.0,15,42,57,33,15,18,1.73,45.45,Moyen,Difficile,-1,Plus Difficile,Pas Adapte
723,2015,Mathematique,5,La Geometrie Analytique,1,Sur l'Utilisation de Maple,12,724,2,QROC,0.26,0.32,53.0,11,9,20,11,11,0,1.82,100.0,Facile,Moyen,-1,Plus Difficile,Pas Adapte
1834,2016,Mathematique,5,La Geometrie Analytique,1,Sur l'Utilisation de Maple,12,724,2,QROC,0.95,0.0,34.0,7,14,21,14,7,7,1.5,50.0,Moyen,Difficile,-1,Plus Difficile,Pas Adapte
2945,2017,Mathematique,5,La Geometrie Analytique,1,Sur l'Utilisation de Maple,12,724,2,QROC,0.32,0.35,46.0,10,11,21,12,10,2,1.75,83.33,Difficile,Moyen,1,Plus Facile,Pas Adapte
4056,2018,Mathematique,5,La Geometrie Analytique,1,Sur l'Utilisation de Maple,12,724,2,QO,0.43,0.24,39.0,8,13,21,14,8,6,1.5,57.14,Moyen,Moyen,0,Meme Difficulté,Pas Adapte
5167,2019,Mathematique,5,La Geometrie Analytique,1,Sur l'Utilisation de Maple,12,724,2,QROC,0.03,0.6,68.0,14,6,20,19,14,5,1.05,73.68,Moyen,Facile,1,Plus Facile,Adapte
6278,2020,Mathematique,5,La Geometrie Analytique,1,Sur l'Utilisation de Maple,12,724,2,QROC,0.14,0.42,68.0,12,6,18,17,12,5,1.06,70.59,Facile,Facile,0,Meme Difficulté,Adapte
724,2015,Mathematique,5,La Geometrie Analytique,1,Sur l'Utilisation de Maple,12,725,3,QCU,0.22,0.68,37.0,6,11,17,6,6,0,2.83,100.0,Facile,Moyen,-1,Plus Difficile,Pas Adapte
1835,2016,Mathematique,5,La Geometrie Analytique,1,Sur l'Utilisation de Maple,12,725,3,QCU,0.58,0.39,16.0,3,15,18,11,3,8,1.64,27.27,Difficile,Difficile,0,Meme Difficulté,Pas Adapte
2946,2017,Mathematique,5,La Geometrie Analytique,1,Sur l'Utilisation de Maple,12,725,3,QCU,0.5,0.29,25.0,5,14,19,14,5,9,1.36,35.71,Difficile,Difficile,0,Meme Difficulté,Pas Adapte
4057,2018,Mathematique,5,La Geometrie Analytique,1,Sur l'Utilisation de Maple,12,725,3,QCU,0.01,0.83,67.0,12,6,18,17,12,5,1.06,70.59,Moyen,Facile,1,Plus Facile,Adapte
5168,2019,Mathematique,5,La Geometrie Analytique,1,Sur l'Utilisation de Maple,12,725,3,QCM,0.09,0.99,67.0,13,7,20,17,13,4,1.18,76.47,Facile,Facile,0,Meme Difficulté,Adapte
6279,2020,Mathematique,5,La Geometrie Analytique,1,Sur l'Utilisation de Maple,12,725,3,QCM,0.06,0.97,67.0,11,6,17,13,11,2,1.31,84.62,Facile,Facile,0,Meme Difficulté,Adapte
725,2015,Mathematique,5,La Geometrie Analytique,1,Sur l'Utilisation de Maple,12,726,4,QCM,0.79,0.22,27.0,19,51,70,29,19,10,2.41,65.52,Facile,Difficile,-2,Beaucoup plus Difficile,Pas Adapte
1836,2016,Mathematique,5,La Geometrie Analytique,1,Sur l'Utilisation de Maple,12,726,4,QROC,0.21,0.38,52.0,38,35,73,48,38,10,1.52,79.17,Difficile,Moyen,1,Plus Facile,Pas Adapte
2947,2017,Mathematique,5,La Geometrie Analytique,1,Sur l'Utilisation de Maple,12,726,4,QROC,0.52,0.36,43.0,31,41,72,48,31,17,1.5,64.58,Moyen,Moyen,0,Meme Difficulté,Pas Adapte
4058,2018,Mathematique,5,La Geometrie Analytique,1,Sur l'Utilisation de Maple,12,726,4,QROC,0.51,0.33,40.0,28,43,71,60,28,32,1.18,46.67,Difficile,Moyen,1,Plus Facile,Pas Adapte
5169,2019,Mathematique,5,La Geometrie Analytique,1,Sur l'Utilisation de Maple,12,726,4,QO,0.4,0.23,43.0,27,35,62,31,27,4,2.0,87.1,Difficile,Moyen,1,Plus Facile,Pas Adapte
6280,2020,Mathematique,5,La Geometrie Analytique,1,Sur l'Utilisation de Maple,12,726,4,QO,0.57,0.17,53.0,36,32,68,59,36,23,1.15,61.02,Difficile,Moyen,1,Plus Facile,Pas Adapte
726,2015,Mathematique,5,La Geometrie Analytique,1,Sur l'Utilisation de Maple,12,727,5,QCU,0.42,0.32,29.0,23,57,80,69,23,46,1.16,33.33,Facile,Difficile,-2,Beaucoup plus Difficile,Pas Adapte
1837,2016,Mathematique,5,La Geometrie Analytique,1,Sur l'Utilisation de Maple,12,727,5,QCU,0.37,0.62,64.0,47,27,74,68,47,21,1.09,69.12,Moyen,Moyen,0,Meme Difficulté,Pas Adapte
2948,2017,Mathematique,5,La Geometrie Analytique,1,Sur l'Utilisation de Maple,12,727,5,QCU,0.62,0.39,35.0,26,48,74,49,26,23,1.51,53.06,Difficile,Difficile,0,Meme Difficulté,Pas Adapte
4059,2018,Mathematique,5,La Geometrie Analytique,1,Sur l'Utilisation de Maple,12,727,5,QROC,0.77,0.23,17.0,11,52,63,37,11,26,1.7,29.73,Facile,Difficile,-2,Beaucoup plus Difficile,Pas Adapte
5170,2019,Mathematique,5,La Geometrie Analytique,1,Sur l'Utilisation de Maple,12,727,5,QROC,0.61,0.2,19.0,13,55,68,31,13,18,2.19,41.94,Facile,Difficile,-2,Beaucoup plus Difficile,Pas Adapte
6281,2020,Mathematique,5,La Geometrie Analytique,1,Sur l'Utilisation de Maple,12,727,5,QROC,0.47,0.34,44.0,29,36,65,62,29,33,1.05,46.77,Moyen,Moyen,0,Meme Difficulté,Pas Adapte
727,2015,Mathematique,5,La Geometrie Analytique,1,Sur l'Utilisation de Maple,12,728,6,QCU,0.25,0.75,40.0,37,55,92,56,37,19,1.64,66.07,Difficile,Moyen,1,Plus Facile,Pas Adapte
1838,2016,Mathematique,5,La Geometrie Analytique,1,Sur l'Utilisation de Maple,12,728,6,QCU,0.72,0.33,31.0,29,65,94,79,29,50,1.19,36.71,Moyen,Difficile,-1,Plus Difficile,Pas Adapte
2949,2017,Mathematique,5,La Geometrie Analytique,1,Sur l'Utilisation de Maple,12,728,6,QCU,0.28,0.45,40.0,33,50,83,54,33,21,1.54,61.11,Difficile,Moyen,1,Plus Facile,Pas Adapte
4060,2018,Mathematique,5,La Geometrie Analytique,1,Sur l'Utilisation de Maple,12,728,6,QCU,0.31,0.54,45.0,40,48,88,85,40,45,1.04,47.06,Facile,Moyen,-1,Plus Difficile,Pas Adapte
5171,2019,Mathematique,5,La Geometrie Analytique,1,Sur l'Utilisation de Maple,12,728,6,QCU,0.61,0.24,21.0,19,70,89,70,19,51,1.27,27.14,Difficile,Difficile,0,Meme Difficulté,Pas Adapte
6282,2020,Mathematique,5,La Geometrie Analytique,1,Sur l'Utilisation de Maple,12,728,6,QCU,0.38,0.55,42.0,35,49,84,50,35,15,1.68,70.0,Difficile,Moyen,1,Plus Facile,Pas Adapte
728,2015,Mathematique,5,La Geometrie Analytique,1,Sur l'Utilisation de Maple,12,729,7,QCU,0.71,0.39,33.0,19,38,57,51,19,32,1.12,37.25,Facile,Difficile,-2,Beaucoup plus Difficile,Pas Adapte
1839,2016,Mathematique,5,La Geometrie Analytique,1,Sur l'Utilisation de Maple,12,729,7,QCU,0.2,0.55,57.0,28,22,50,39,28,11,1.28,71.79,Moyen,Moyen,0,Meme Difficulté,Pas Adapte
2950,2017,Mathematique,5,La Geometrie Analytique,1,Sur l'Utilisation de Maple,12,729,7,QROC,0.01,0.73,65.0,27,15,42,39,27,12,1.08,69.23,Difficile,Facile,2,Beaucoup plus Facile,Adapte
4061,2018,Mathematique,5,La Geometrie Analytique,1,Sur l'Utilisation de Maple,12,729,7,QROC,0.14,0.51,65.0,25,14,39,35,25,10,1.11,71.43,Facile,Facile,0,Meme Difficulté,Adapte
5172,2019,Mathematique,5,La Geometrie Analytique,1,Sur l'Utilisation de Maple,12,729,7,QCM,0.13,0.78,65.0,27,14,41,32,27,5,1.28,84.38,Facile,Facile,0,Meme Difficulté,Adapte
6283,2020,Mathematique,5,La Geometrie Analytique,1,Sur l'Utilisation de Maple,12,729,7,QCM,0.09,0.84,65.0,31,16,47,41,31,10,1.15,75.61,Facile,Facile,0,Meme Difficulté,Adapte
729,2015,Mathematique,5,La Geometrie Analytique,1,Sur l'Utilisation de Maple,12,730,8,QROC,0.47,0.33,46.0,4,4,8,8,4,4,1.0,50.0,Moyen,Moyen,0,Meme Difficulté,Pas Adapte
1840,2016,Mathematique,5,La Geometrie Analytique,1,Sur l'Utilisation de Maple,12,730,8,QROC,0.64,0.03,21.0,2,7,9,7,2,5,1.29,28.57,Facile,Difficile,-2,Beaucoup plus Difficile,Pas Adapte
2951,2017,Mathematique,5,La Geometrie Analytique,1,Sur l'Utilisation de Maple,12,730,8,QROC,0.8,0.0,9.0,1,9,10,6,1,5,1.67,16.67,Facile,Difficile,-2,Beaucoup plus Difficile,Pas Adapte
4062,2018,Mathematique,5,La Geometrie Analytique,1,Sur l'Utilisation de Maple,12,730,8,QROC,0.92,0.2,10.0,1,9,10,5,1,4,2.0,20.0,Moyen,Difficile,-1,Plus Difficile,Pas Adapte
5173,2019,Mathematique,5,La Geometrie Analytique,1,Sur l'Utilisation de Maple,12,730,8,QROC,0.88,0.19,6.0,1,9,10,8,1,7,1.25,12.5,Difficile,Difficile,0,Meme Difficulté,Pas Adapte
6284,2020,Mathematique,5,La Geometrie Analytique,1,Sur l'Utilisation de Maple,12,730,8,QROC,0.41,0.33,56.0,6,4,10,9,6,3,1.11,66.67,Difficile,Moyen,1,Plus Facile,Pas Adapte
730,2015,Mathematique,5,La Geometrie Analytique,1,Sur l'Utilisation de Maple,12,731,9,QCM,0.32,0.54,61.0,51,32,83,74,51,23,1.12,68.92,Difficile,Moyen,1,Plus Facile,Pas Adapte
1841,2016,Mathematique,5,La Geometrie Analytique,1,Sur l'Utilisation de Maple,12,731,9,QCM,0.66,0.2,4.0,3,72,75,69,3,66,1.09,4.35,Difficile,Difficile,0,Meme Difficulté,Pas Adapte
2952,2017,Mathematique,5,La Geometrie Analytique,1,Sur l'Utilisation de Maple,12,731,9,QCM,0.67,0.2,24.0,18,57,75,58,18,40,1.29,31.03,Difficile,Difficile,0,Meme Difficulté,Pas Adapte
4063,2018,Mathematique,5,La Geometrie Analytique,1,Sur l'Utilisation de Maple,12,731,9,QCM,0.55,0.23,18.0,15,70,85,43,15,28,1.98,34.88,Moyen,Difficile,-1,Plus Difficile,Pas Adapte
5174,2019,Mathematique,5,La Geometrie Analytique,1,Sur l'Utilisation de Maple,12,731,9,QCM,0.79,0.29,0.0,0,96,96,29,0,29,3.31,0.0,Facile,Difficile,-2,Beaucoup plus Difficile,Pas Adapte
6285,2020,Mathematique,5,La Geometrie Analytique,1,Sur l'Utilisation de Maple,12,731,9,QO,0.94,0.0,8.0,7,81,88,63,7,56,1.4,11.11,Difficile,Difficile,0,Meme Difficulté,Pas Adapte
731,2015,Mathematique,5,La Geometrie Analytique,1,Sur l'Utilisation de Maple,12,732,10,QCU,0.2,0.84,70.0,65,28,93,81,65,16,1.15,80.25,Moyen,Facile,1,Plus Facile,Adapte
1842,2016,Mathematique,5,La Geometrie Analytique,1,Sur l'Utilisation de Maple,12,732,10,QCU,0.03,0.9,70.0,72,31,103,80,72,8,1.29,90.0,Facile,Facile,0,Meme Difficulté,Adapte
2953,2017,Mathematique,5,La Geometrie Analytique,1,Sur l'Utilisation de Maple,12,732,10,QCU,0.12,0.9,70.0,65,28,93,69,65,4,1.35,94.2,Facile,Facile,0,Meme Difficulté,Adapte
4064,2018,Mathematique,5,La Geometrie Analytique,1,Sur l'Utilisation de Maple,12,732,10,QCU,0.0,0.78,70.0,71,30,101,78,71,7,1.29,91.03,Facile,Facile,0,Meme Difficulté,Adapte
5175,2019,Mathematique,5,La Geometrie Analytique,1,Sur l'Utilisation de Maple,12,732,10,QCU,0.12,0.87,70.0,66,29,95,91,66,25,1.04,72.53,Facile,Facile,0,Meme Difficulté,Adapte
6286,2020,Mathematique,5,La Geometrie Analytique,1,Sur l'Utilisation de Maple,12,732,10,QCU,0.16,0.79,70.0,62,27,89,64,62,2,1.39,96.88,Facile,Facile,0,Meme Difficulté,Adapte
732,2015,Mathematique,5,La Geometrie Analytique,1,Sur l'Utilisation de Maple,12,733,11,QCU,0.52,0.28,28.0,15,40,55,54,15,39,1.02,27.78,Facile,Difficile,-2,Beaucoup plus Difficile,Pas Adapte
1843,2016,Mathematique,5,La Geometrie Analytique,1,Sur l'Utilisation de Maple,12,733,11,QCU,0.67,0.37,19.0,11,48,59,40,11,29,1.48,27.5,Facile,Difficile,-2,Beaucoup plus Difficile,Pas Adapte
2954,2017,Mathematique,5,La Geometrie Analytique,1,Sur l'Utilisation de Maple,12,733,11,QCU,0.27,0.66,43.0,27,35,62,55,27,28,1.13,49.09,Facile,Moyen,-1,Plus Difficile,Pas Adapte
4065,2018,Mathematique,5,La Geometrie Analytique,1,Sur l'Utilisation de Maple,12,733,11,QCU,0.17,0.87,65.0,40,21,61,43,40,3,1.42,93.02,Facile,Facile,0,Meme Difficulté,Adapte
5176,2019,Mathematique,5,La Geometrie Analytique,1,Sur l'Utilisation de Maple,12,733,11,QCU,0.18,0.77,65.0,45,24,69,59,45,14,1.17,76.27,Facile,Facile,0,Meme Difficulté,Adapte
6287,2020,Mathematique,5,La Geometrie Analytique,1,Sur l'Utilisation de Maple,12,733,11,QCU,0.14,0.8,65.0,47,25,72,55,47,8,1.31,85.45,Facile,Facile,0,Meme Difficulté,Adapte
733,2015,Mathematique,5,La Geometrie Analytique,1,Sur l'Utilisation de Maple,12,734,12,QROC,0.71,0.22,16.0,3,18,21,21,3,18,1.0,14.29,Facile,Difficile,-2,Beaucoup plus Difficile,Pas Adapte
1844,2016,Mathematique,5,La Geometrie Analytique,1,Sur l'Utilisation de Maple,12,734,12,QROC,0.92,0.09,11.0,2,18,20,11,2,9,1.82,18.18,Facile,Difficile,-2,Beaucoup plus Difficile,Pas Adapte
2955,2017,Mathematique,5,La Geometrie Analytique,1,Sur l'Utilisation de Maple,12,734,12,QROC,0.33,0.33,61.0,10,7,17,15,10,5,1.13,66.67,Facile,Moyen,-1,Plus Difficile,Pas Adapte
4066,2018,Mathematique,5,La Geometrie Analytique,1,Sur l'Utilisation de Maple,12,734,12,QROC,0.51,0.3,52.0,9,9,18,10,9,1,1.8,90.0,Facile,Moyen,-1,Plus Difficile,Pas Adapte
5177,2019,Mathematique,5,La Geometrie Analytique,1,Sur l'Utilisation de Maple,12,734,12,QROC,0.16,0.75,70.0,12,5,17,13,12,1,1.31,92.31,Facile,Facile,0,Meme Difficulté,Adapte
6288,2020,Mathematique,5,La Geometrie Analytique,1,Sur l'Utilisation de Maple,12,734,12,QROC,0.13,0.98,70.0,14,6,20,16,14,2,1.25,87.5,Facile,Facile,0,Meme Difficulté,Adapte
734,2015,Mathematique,5,La Geometrie Analytique,2,Methodes Generales pour aborder un probleme de Geometrie Analytique,1,735,1,QCM,0.59,0.21,1.0,1,68,69,50,1,49,1.38,2.0,Moyen,Difficile,-1,Plus Difficile,Pas Adapte
1845,2016,Mathematique,5,La Geometrie Analytique,2,Methodes Generales pour aborder un probleme de Geometrie Analytique,1,735,1,QCM,0.78,0.3,9.0,6,61,67,65,6,59,1.03,9.23,Difficile,Difficile,0,Meme Difficulté,Pas Adapte
2956,2017,Mathematique,5,La Geometrie Analytique,2,Methodes Generales pour aborder un probleme de Geometrie Analytique,1,735,1,QCM,0.2,0.64,47.0,32,37,69,64,32,32,1.08,50.0,Facile,Moyen,-1,Plus Difficile,Pas Adapte
4067,2018,Mathematique,5,La Geometrie Analytique,2,Methodes Generales pour aborder un probleme de Geometrie Analytique,1,735,1,QCM,0.61,0.17,7.0,5,69,74,31,5,26,2.39,16.13,Facile,Difficile,-2,Beaucoup plus Difficile,Pas Adapte
5178,2019,Mathematique,5,La Geometrie Analytique,2,Methodes Generales pour aborder un probleme de Geometrie Analytique,1,735,1,QCM,0.24,0.42,53.0,41,36,77,60,41,19,1.28,68.33,Difficile,Moyen,1,Plus Facile,Pas Adapte
6289,2020,Mathematique,5,La Geometrie Analytique,2,Methodes Generales pour aborder un probleme de Geometrie Analytique,1,735,1,QROC,0.29,0.39,53.0,47,42,89,59,47,12,1.51,79.66,Moyen,Moyen,0,Meme Difficulté,Pas Adapte
735,2015,Mathematique,5,La Geometrie Analytique,3,Geometrie Plane,9,736,1,QCM,0.56,0.29,7.0,4,48,52,19,4,15,2.74,21.05,Difficile,Difficile,0,Meme Difficulté,Pas Adapte
1846,2016,Mathematique,5,La Geometrie Analytique,3,Geometrie Plane,9,736,1,QCM,0.01,0.72,67.0,34,17,51,47,34,13,1.09,72.34,Difficile,Facile,2,Beaucoup plus Facile,Adapte
2957,2017,Mathematique,5,La Geometrie Analytique,3,Geometrie Plane,9,736,1,QCM,0.0,0.99,67.0,31,16,47,38,31,7,1.24,81.58,Facile,Facile,0,Meme Difficulté,Adapte
4068,2018,Mathematique,5,La Geometrie Analytique,3,Geometrie Plane,9,736,1,QCU,0.08,0.92,67.0,34,17,51,45,34,11,1.13,75.56,Facile,Facile,0,Meme Difficulté,Adapte
5179,2019,Mathematique,5,La Geometrie Analytique,3,Geometrie Plane,9,736,1,QCU,0.03,0.8,67.0,36,17,53,51,36,15,1.04,70.59,Facile,Facile,0,Meme Difficulté,Adapte
6290,2020,Mathematique,5,La Geometrie Analytique,3,Geometrie Plane,9,736,1,QCU,0.11,0.99,67.0,38,19,57,46,38,8,1.24,82.61,Facile,Facile,0,Meme Difficulté,Adapte
736,2015,Mathematique,5,La Geometrie Analytique,3,Geometrie Plane,9,737,2,QCM,0.28,0.44,62.0,34,21,55,41,34,7,1.34,82.93,Difficile,Moyen,1,Plus Facile,Pas Adapte
1847,2016,Mathematique,5,La Geometrie Analytique,3,Geometrie Plane,9,737,2,QCM,0.27,0.4,36.0,18,32,50,34,18,16,1.47,52.94,Difficile,Moyen,1,Plus Facile,Pas Adapte
2958,2017,Mathematique,5,La Geometrie Analytique,3,Geometrie Plane,9,737,2,QCU,0.32,0.5,56.0,26,21,47,28,26,2,1.68,92.86,Difficile,Moyen,1,Plus Facile,Pas Adapte
4069,2018,Mathematique,5,La Geometrie Analytique,3,Geometrie Plane,9,737,2,QCU,0.55,0.32,6.0,3,48,51,32,3,29,1.59,9.38,Facile,Difficile,-2,Beaucoup plus Difficile,Pas Adapte
5180,2019,Mathematique,5,La Geometrie Analytique,3,Geometrie Plane,9,737,2,QCU,0.06,0.77,68.0,32,15,47,43,32,11,1.09,74.42,Moyen,Facile,1,Plus Facile,Adapte
6291,2020,Mathematique,5,La Geometrie Analytique,3,Geometrie Plane,9,737,2,QCU,0.13,0.77,68.0,35,16,51,41,35,6,1.24,85.37,Facile,Facile,0,Meme Difficulté,Adapte
737,2015,Mathematique,5,La Geometrie Analytique,3,Geometrie Plane,9,738,3,QCU,0.37,0.41,51.0,47,46,93,82,47,35,1.13,57.32,Facile,Moyen,-1,Plus Difficile,Pas Adapte
1848,2016,Mathematique,5,La Geometrie Analytique,3,Geometrie Plane,9,738,3,QCM,0.21,0.64,41.0,43,62,105,88,43,45,1.19,48.86,Moyen,Moyen,0,Meme Difficulté,Pas Adapte
2959,2017,Mathematique,5,La Geometrie Analytique,3,Geometrie Plane,9,738,3,QCM,0.69,0.26,4.0,4,87,91,39,4,35,2.33,10.26,Moyen,Difficile,-1,Plus Difficile,Pas Adapte
4070,2018,Mathematique,5,La Geometrie Analytique,3,Geometrie Plane,9,738,3,QCM,0.21,0.4,59.0,56,39,95,64,56,8,1.48,87.5,Difficile,Moyen,1,Plus Facile,Pas Adapte
5181,2019,Mathematique,5,La Geometrie Analytique,3,Geometrie Plane,9,738,3,QCM,0.21,0.48,50.0,45,45,90,87,45,42,1.03,51.72,Difficile,Moyen,1,Plus Facile,Pas Adapte
6292,2020,Mathematique,5,La Geometrie Analytique,3,Geometrie Plane,9,738,3,QCM,0.01,0.88,66.0,53,28,81,69,53,16,1.17,76.81,Moyen,Facile,1,Plus Facile,Adapte
738,2015,Mathematique,5,La Geometrie Analytique,3,Geometrie Plane,9,739,4,QCU,0.09,0.94,69.0,60,27,87,63,60,3,1.38,95.24,Moyen,Facile,1,Plus Facile,Adapte
1849,2016,Mathematique,5,La Geometrie Analytique,3,Geometrie Plane,9,739,4,QCU,0.1,0.89,69.0,67,30,97,72,67,5,1.35,93.06,Facile,Facile,0,Meme Difficulté,Adapte
2960,2017,Mathematique,5,La Geometrie Analytique,3,Geometrie Plane,9,739,4,QCM,0.13,0.93,69.0,69,31,100,76,69,7,1.32,90.79,Facile,Facile,0,Meme Difficulté,Adapte
4071,2018,Mathematique,5,La Geometrie Analytique,3,Geometrie Plane,9,739,4,QCM,0.08,1.0,69.0,65,29,94,82,65,17,1.15,79.27,Facile,Facile,0,Meme Difficulté,Adapte
5182,2019,Mathematique,5,La Geometrie Analytique,3,Geometrie Plane,9,739,4,QCM,0.05,0.95,69.0,63,28,91,70,63,7,1.3,90.0,Facile,Facile,0,Meme Difficulté,Adapte
6293,2020,Mathematique,5,La Geometrie Analytique,3,Geometrie Plane,9,739,4,QCM,0.13,0.74,69.0,68,31,99,90,68,22,1.1,75.56,Facile,Facile,0,Meme Difficulté,Adapte
739,2015,Mathematique,5,La Geometrie Analytique,3,Geometrie Plane,9,740,5,QCM,0.39,0.4,60.0,56,37,93,80,56,24,1.16,70.0,Difficile,Moyen,1,Plus Facile,Pas Adapte
1850,2016,Mathematique,5,La Geometrie Analytique,3,Geometrie Plane,9,740,5,QCU,0.3,0.61,45.0,45,56,101,65,45,20,1.55,69.23,Facile,Moyen,-1,Plus Difficile,Pas Adapte
2961,2017,Mathematique,5,La Geometrie Analytique,3,Geometrie Plane,9,740,5,QCU,0.32,0.7,37.0,36,62,98,79,36,43,1.24,45.57,Difficile,Moyen,1,Plus Facile,Pas Adapte
4072,2018,Mathematique,5,La Geometrie Analytique,3,Geometrie Plane,9,740,5,QCU,0.62,0.28,21.0,17,66,83,80,17,63,1.04,21.25,Facile,Difficile,-2,Beaucoup plus Difficile,Pas Adapte
5183,2019,Mathematique,5,La Geometrie Analytique,3,Geometrie Plane,9,740,5,QCU,0.49,0.39,9.0,7,74,81,35,7,28,2.31,20.0,Difficile,Difficile,0,Meme Difficulté,Pas Adapte
6294,2020,Mathematique,5,La Geometrie Analytique,3,Geometrie Plane,9,740,5,QCU,0.71,0.36,30.0,26,59,85,76,26,50,1.12,34.21,Difficile,Difficile,0,Meme Difficulté,Pas Adapte
740,2015,Mathematique,5,La Geometrie Analytique,3,Geometrie Plane,9,741,6,QCU,0.39,0.74,58.0,50,36,86,74,50,24,1.16,67.57,Difficile,Moyen,1,Plus Facile,Pas Adapte
1851,2016,Mathematique,5,La Geometrie Analytique,3,Geometrie Plane,9,741,6,QCU,0.32,0.44,36.0,27,49,76,36,27,9,2.11,75.0,Difficile,Moyen,1,Plus Facile,Pas Adapte
2962,2017,Mathematique,5,La Geometrie Analytique,3,Geometrie Plane,9,741,6,QCU,0.39,0.62,48.0,33,36,69,56,33,23,1.23,58.93,Facile,Moyen,-1,Plus Difficile,Pas Adapte
4073,2018,Mathematique,5,La Geometrie Analytique,3,Geometrie Plane,9,741,6,QCU,0.43,0.39,31.0,24,54,78,59,24,35,1.32,40.68,Moyen,Difficile,-1,Plus Difficile,Pas Adapte
5184,2019,Mathematique,5,La Geometrie Analytique,3,Geometrie Plane,9,741,6,QCU,0.66,0.26,13.0,9,62,71,42,9,33,1.69,21.43,Moyen,Difficile,-1,Plus Difficile,Pas Adapte
6295,2020,Mathematique,5,La Geometrie Analytique,3,Geometrie Plane,9,741,6,QO,0.31,0.29,64.0,52,30,82,77,52,25,1.06,67.53,Difficile,Moyen,1,Plus Facile,Pas Adapte
741,2015,Mathematique,5,La Geometrie Analytique,3,Geometrie Plane,9,742,7,QCU,0.72,0.35,23.0,21,70,91,64,21,43,1.42,32.81,Facile,Difficile,-2,Beaucoup plus Difficile,Pas Adapte
1852,2016,Mathematique,5,La Geometrie Analytique,3,Geometrie Plane,9,742,7,QCU,0.47,0.21,12.0,11,82,93,53,11,42,1.75,20.75,Moyen,Difficile,-1,Plus Difficile,Pas Adapte
2963,2017,Mathematique,5,La Geometrie Analytique,3,Geometrie Plane,9,742,7,QCU,0.65,0.32,4.0,4,102,106,54,4,50,1.96,7.41,Facile,Difficile,-2,Beaucoup plus Difficile,Pas Adapte
4074,2018,Mathematique,5,La Geometrie Analytique,3,Geometrie Plane,9,742,7,QCU,0.16,0.92,70.0,76,32,108,90,76,14,1.2,84.44,Difficile,Facile,2,Beaucoup plus Facile,Adapte
5185,2019,Mathematique,5,La Geometrie Analytique,3,Geometrie Plane,9,742,7,QCU,0.09,0.98,70.0,71,31,102,101,71,30,1.01,70.3,Facile,Facile,0,Meme Difficulté,Adapte
6296,2020,Mathematique,5,La Geometrie Analytique,3,Geometrie Plane,9,742,7,QCU,0.17,0.99,70.0,71,30,101,75,71,4,1.35,94.67,Facile,Facile,0,Meme Difficulté,Adapte
742,2015,Mathematique,5,La Geometrie Analytique,3,Geometrie Plane,9,743,8,QCM,0.29,0.32,48.0,15,17,32,22,15,7,1.45,68.18,Difficile,Moyen,1,Plus Facile,Pas Adapte
1853,2016,Mathematique,5,La Geometrie Analytique,3,Geometrie Plane,9,743,8,QCM,0.52,0.2,23.0,8,27,35,33,8,25,1.06,24.24,Moyen,Difficile,-1,Plus Difficile,Pas Adapte
2964,2017,Mathematique,5,La Geometrie Analytique,3,Geometrie Plane,9,743,8,QCM,0.74,0.3,22.0,7,26,33,32,7,25,1.03,21.88,Difficile,Difficile,0,Meme Difficulté,Pas Adapte
4075,2018,Mathematique,5,La Geometrie Analytique,3,Geometrie Plane,9,743,8,QCM,0.31,0.44,49.0,15,16,31,17,15,2,1.82,88.24,Difficile,Moyen,1,Plus Facile,Pas Adapte
5186,2019,Mathematique,5,La Geometrie Analytique,3,Geometrie Plane,9,743,8,QCM,0.69,0.27,3.0,1,34,35,31,1,30,1.13,3.23,Difficile,Difficile,0,Meme Difficulté,Pas Adapte
6297,2020,Mathematique,5,La Geometrie Analytique,3,Geometrie Plane,9,743,8,QCM,0.07,0.81,65.0,20,11,31,30,20,10,1.03,66.67,Difficile,Facile,2,Beaucoup plus Facile,Adapte
743,2015,Mathematique,5,La Geometrie Analytique,3,Geometrie Plane,9,744,9,QCU,0.63,0.27,8.0,3,39,42,21,3,18,2.0,14.29,Difficile,Difficile,0,Meme Difficulté,Pas Adapte
1854,2016,Mathematique,5,La Geometrie Analytique,3,Geometrie Plane,9,744,9,QCU,0.26,0.75,46.0,21,24,45,32,21,11,1.41,65.62,Moyen,Moyen,0,Meme Difficulté,Pas Adapte
2965,2017,Mathematique,5,La Geometrie Analytique,3,Geometrie Plane,9,744,9,QCU,0.47,0.4,25.0,12,35,47,18,12,6,2.61,66.67,Difficile,Difficile,0,Meme Difficulté,Pas Adapte
4076,2018,Mathematique,5,La Geometrie Analytique,3,Geometrie Plane,9,744,9,QCU,0.62,0.3,16.0,7,37,44,21,7,14,2.1,33.33,Difficile,Difficile,0,Meme Difficulté,Pas Adapte
5187,2019,Mathematique,5,La Geometrie Analytique,3,Geometrie Plane,9,744,9,QCU,0.28,0.63,49.0,21,22,43,32,21,11,1.34,65.62,Difficile,Moyen,1,Plus Facile,Pas Adapte
6298,2020,Mathematique,5,La Geometrie Analytique,3,Geometrie Plane,9,744,9,QCU,0.05,0.99,69.0,29,13,42,32,29,3,1.31,90.62,Difficile,Facile,2,Beaucoup plus Facile,Adapte
744,2015,Philosophie,1,Introduction a la Philosophie,1,La Nature,12,745,1,QCU,0.06,0.98,66.93,54,27,81,62,54,8,1.31,87.1,Facile,Facile,0,Meme Difficulté,Adapte
1855,2016,Philosophie,1,Introduction a la Philosophie,1,La Nature,12,745,1,QCU,0.2,0.89,66.93,56,28,84,71,56,15,1.18,78.87,Facile,Facile,0,Meme Difficulté,Adapte
2966,2017,Philosophie,1,Introduction a la Philosophie,1,La Nature,12,745,1,QCU,0.03,0.85,66.93,62,30,92,64,62,2,1.44,96.88,Facile,Facile,0,Meme Difficulté,Adapte
4077,2018,Philosophie,1,Introduction a la Philosophie,1,La Nature,12,745,1,QCU,0.02,0.88,66.93,52,26,78,68,52,16,1.15,76.47,Facile,Facile,0,Meme Difficulté,Adapte
5188,2019,Philosophie,1,Introduction a la Philosophie,1,La Nature,12,745,1,QCU,0.07,0.92,66.93,46,23,69,54,46,8,1.28,85.19,Facile,Facile,0,Meme Difficulté,Adapte
6299,2020,Philosophie,1,Introduction a la Philosophie,1,La Nature,12,745,1,QCU,0.04,0.75,66.93,44,21,65,49,44,5,1.33,89.8,Facile,Facile,0,Meme Difficulté,Adapte
745,2015,Philosophie,1,Introduction a la Philosophie,1,La Nature,12,746,2,QCM,0.13,0.99,74.71,66,23,89,67,66,1,1.33,98.51,Facile,Facile,0,Meme Difficulté,Adapte
1856,2016,Philosophie,1,Introduction a la Philosophie,1,La Nature,12,746,2,QCM,0.18,0.78,74.71,61,21,82,72,61,11,1.14,84.72,Facile,Facile,0,Meme Difficulté,Adapte
2967,2017,Philosophie,1,Introduction a la Philosophie,1,La Nature,12,746,2,QCM,0.09,0.96,74.71,58,19,77,77,58,19,1.0,75.32,Facile,Facile,0,Meme Difficulté,Adapte
4078,2018,Philosophie,1,Introduction a la Philosophie,1,La Nature,12,746,2,QCM,0.1,0.9,74.71,60,20,80,69,60,9,1.16,86.96,Facile,Facile,0,Meme Difficulté,Adapte
5189,2019,Philosophie,1,Introduction a la Philosophie,1,La Nature,12,746,2,QCM,0.17,0.96,74.71,64,21,85,79,64,15,1.08,81.01,Facile,Facile,0,Meme Difficulté,Adapte
6300,2020,Philosophie,1,Introduction a la Philosophie,1,La Nature,12,746,2,QCM,0.05,0.73,74.71,69,24,93,89,69,20,1.04,77.53,Facile,Facile,0,Meme Difficulté,Adapte
746,2015,Philosophie,1,Introduction a la Philosophie,1,La Nature,12,747,3,QCU,0.28,0.43,36.13,25,45,70,29,25,4,2.41,86.21,Facile,Moyen,-1,Plus Difficile,Pas Adapte
1857,2016,Philosophie,1,Introduction a la Philosophie,1,La Nature,12,747,3,QCU,0.29,0.69,57.22,45,33,78,59,45,14,1.32,76.27,Difficile,Moyen,1,Plus Facile,Pas Adapte
2968,2017,Philosophie,1,Introduction a la Philosophie,1,La Nature,12,747,3,QCM,0.05,0.89,91.37,74,7,81,76,74,2,1.07,97.37,Moyen,Facile,1,Plus Facile,Pas Adapte
4079,2018,Philosophie,1,Introduction a la Philosophie,1,La Nature,12,747,3,QCM,0.04,0.9,66.51,57,28,85,78,57,21,1.09,73.08,Moyen,Facile,1,Plus Facile,Adapte
5190,2019,Philosophie,1,Introduction a la Philosophie,1,La Nature,12,747,3,QCM,0.18,0.85,66.51,64,32,96,82,64,18,1.17,78.05,Facile,Facile,0,Meme Difficulté,Adapte
6301,2020,Philosophie,1,Introduction a la Philosophie,1,La Nature,12,747,3,QCU,0.1,0.91,66.51,71,35,106,78,71,7,1.36,91.03,Facile,Facile,0,Meme Difficulté,Adapte
747,2015,Philosophie,1,Introduction a la Philosophie,1,La Nature,12,748,4,QROC,0.03,0.57,70.12,69,30,99,91,69,22,1.09,75.82,Moyen,Facile,1,Plus Facile,Adapte
1858,2016,Philosophie,1,Introduction a la Philosophie,1,La Nature,12,748,4,QROC,0.12,0.76,70.12,60,26,86,75,60,15,1.15,80.0,Facile,Facile,0,Meme Difficulté,Adapte
2969,2017,Philosophie,1,Introduction a la Philosophie,1,La Nature,12,748,4,QROC,0.08,0.75,70.12,61,26,87,86,61,25,1.01,70.93,Facile,Facile,0,Meme Difficulté,Adapte
4080,2018,Philosophie,1,Introduction a la Philosophie,1,La Nature,12,748,4,QROC,0.09,0.59,70.12,64,27,91,71,64,7,1.28,90.14,Facile,Facile,0,Meme Difficulté,Adapte
5191,2019,Philosophie,1,Introduction a la Philosophie,1,La Nature,12,748,4,QROC,0.11,0.79,70.12,60,26,86,67,60,7,1.28,89.55,Facile,Facile,0,Meme Difficulté,Adapte
6302,2020,Philosophie,1,Introduction a la Philosophie,1,La Nature,12,748,4,QROC,0.16,0.5,70.12,59,25,84,65,59,6,1.29,90.77,Facile,Facile,0,Meme Difficulté,Adapte
748,2015,Philosophie,1,Introduction a la Philosophie,1,La Nature,12,749,5,QCM,0.66,0.2,21.32,7,25,32,16,7,9,2.0,43.75,Facile,Difficile,-2,Beaucoup plus Difficile,Pas Adapte
1859,2016,Philosophie,1,Introduction a la Philosophie,1,La Nature,12,749,5,QCM,0.73,0.22,4.8,1,27,28,19,1,18,1.47,5.26,Difficile,Difficile,0,Meme Difficulté,Pas Adapte
2970,2017,Philosophie,1,Introduction a la Philosophie,1,La Nature,12,749,5,QCM,0.68,0.26,27.51,7,17,24,24,7,17,1.0,29.17,Facile,Difficile,-2,Beaucoup plus Difficile,Pas Adapte
4081,2018,Philosophie,1,Introduction a la Philosophie,1,La Nature,12,749,5,QCM,0.06,0.85,72.32,17,6,23,17,17,0,1.35,100.0,Difficile,Facile,2,Beaucoup plus Facile,Adapte
5192,2019,Philosophie,1,Introduction a la Philosophie,1,La Nature,12,749,5,QCM,0.05,0.89,72.32,19,7,26,21,19,2,1.24,90.48,Facile,Facile,0,Meme Difficulté,Adapte
6303,2020,Philosophie,1,Introduction a la Philosophie,1,La Nature,12,749,5,QCM,0.18,0.9,72.32,22,8,30,26,22,4,1.15,84.62,Facile,Facile,0,Meme Difficulté,Adapte
749,2015,Philosophie,1,Introduction a la Philosophie,1,La Nature,12,750,6,QCM,0.07,0.95,82.25,65,14,79,66,65,1,1.2,98.48,Moyen,Facile,1,Plus Facile,Pas Adapte
1860,2016,Philosophie,1,Introduction a la Philosophie,1,La Nature,12,750,6,QCM,0.09,0.75,72.58,58,22,80,69,58,11,1.16,84.06,Facile,Facile,0,Meme Difficulté,Adapte
2971,2017,Philosophie,1,Introduction a la Philosophie,1,La Nature,12,750,6,QCM,0.16,0.87,72.58,52,19,71,54,52,2,1.31,96.3,Facile,Facile,0,Meme Difficulté,Adapte
4082,2018,Philosophie,1,Introduction a la Philosophie,1,La Nature,12,750,6,QCM,0.09,0.8,72.58,49,19,68,52,49,3,1.31,94.23,Facile,Facile,0,Meme Difficulté,Adapte
5193,2019,Philosophie,1,Introduction a la Philosophie,1,La Nature,12,750,6,QCM,0.11,0.76,72.58,44,16,60,54,44,10,1.11,81.48,Facile,Facile,0,Meme Difficulté,Adapte
6304,2020,Philosophie,1,Introduction a la Philosophie,1,La Nature,12,750,6,QCU,0.16,0.77,72.58,38,15,53,46,38,8,1.15,82.61,Facile,Facile,0,Meme Difficulté,Adapte
750,2015,Philosophie,1,Introduction a la Philosophie,1,La Nature,12,751,7,QROC,0.01,0.48,94.87,70,4,74,71,70,1,1.04,98.59,Facile,Facile,0,Meme Difficulté,Pas Adapte
1861,2016,Philosophie,1,Introduction a la Philosophie,1,La Nature,12,751,7,QROC,0.39,0.34,47.26,35,39,74,64,35,29,1.16,54.69,Difficile,Moyen,1,Plus Facile,Pas Adapte
2972,2017,Philosophie,1,Introduction a la Philosophie,1,La Nature,12,751,7,QROC,0.13,0.7,66.05,44,23,67,59,44,15,1.14,74.58,Difficile,Facile,2,Beaucoup plus Facile,Adapte
4083,2018,Philosophie,1,Introduction a la Philosophie,1,La Nature,12,751,7,QROC,0.19,0.42,66.05,47,24,71,69,47,22,1.03,68.12,Facile,Facile,0,Meme Difficulté,Adapte
5194,2019,Philosophie,1,Introduction a la Philosophie,1,La Nature,12,751,7,QROC,0.11,0.49,66.05,41,21,62,61,41,20,1.02,67.21,Facile,Facile,0,Meme Difficulté,Adapte
6305,2020,Philosophie,1,Introduction a la Philosophie,1,La Nature,12,751,7,QROC,0.02,0.45,66.05,41,21,62,47,41,6,1.32,87.23,Facile,Facile,0,Meme Difficulté,Adapte
751,2015,Philosophie,1,Introduction a la Philosophie,1,La Nature,12,752,8,QCU,0.28,0.51,56.95,23,17,40,33,23,10,1.21,69.7,Difficile,Moyen,1,Plus Facile,Pas Adapte
1862,2016,Philosophie,1,Introduction a la Philosophie,1,La Nature,12,752,8,QCU,0.47,0.25,3.12,1,38,39,30,1,29,1.3,3.33,Moyen,Difficile,-1,Plus Difficile,Pas Adapte
2973,2017,Philosophie,1,Introduction a la Philosophie,1,La Nature,12,752,8,QCU,0.07,0.97,68.05,27,12,39,33,27,6,1.18,81.82,Facile,Facile,0,Meme Difficulté,Adapte
4084,2018,Philosophie,1,Introduction a la Philosophie,1,La Nature,12,752,8,QCU,0.11,0.98,68.05,24,12,36,30,24,6,1.2,80.0,Facile,Facile,0,Meme Difficulté,Adapte
5195,2019,Philosophie,1,Introduction a la Philosophie,1,La Nature,12,752,8,QCU,0.03,0.8,68.05,26,12,38,29,26,3,1.31,89.66,Facile,Facile,0,Meme Difficulté,Adapte
6306,2020,Philosophie,1,Introduction a la Philosophie,1,La Nature,12,752,8,QCU,0.0,0.9,68.05,28,13,41,38,28,10,1.08,73.68,Facile,Facile,0,Meme Difficulté,Adapte
752,2015,Philosophie,1,Introduction a la Philosophie,1,La Nature,12,753,9,QROC,0.11,0.44,72.34,38,15,53,38,38,0,1.39,100.0,Difficile,Facile,2,Beaucoup plus Facile,Adapte
1863,2016,Philosophie,1,Introduction a la Philosophie,1,La Nature,12,753,9,QO,0.03,0.57,72.34,39,15,54,43,39,4,1.26,90.7,Facile,Facile,0,Meme Difficulté,Adapte
2974,2017,Philosophie,1,Introduction a la Philosophie,1,La Nature,12,753,9,QO,0.08,0.67,72.34,42,16,58,49,42,7,1.18,85.71,Facile,Facile,0,Meme Difficulté,Adapte
4085,2018,Philosophie,1,Introduction a la Philosophie,1,La Nature,12,753,9,QO,0.0,0.94,72.34,38,15,53,50,38,12,1.06,76.0,Facile,Facile,0,Meme Difficulté,Adapte
5196,2019,Philosophie,1,Introduction a la Philosophie,1,La Nature,12,753,9,QO,0.07,0.71,72.34,39,15,54,49,39,10,1.1,79.59,Facile,Facile,0,Meme Difficulté,Adapte
6307,2020,Philosophie,1,Introduction a la Philosophie,1,La Nature,12,753,9,QO,0.07,0.49,72.34,33,13,46,35,33,2,1.31,94.29,Facile,Facile,0,Meme Difficulté,Adapte
753,2015,Philosophie,1,Introduction a la Philosophie,1,La Nature,12,754,10,QCM,0.72,0.18,15.19,12,66,78,32,12,20,2.44,37.5,Facile,Difficile,-2,Beaucoup plus Difficile,Pas Adapte
1864,2016,Philosophie,1,Introduction a la Philosophie,1,La Nature,12,754,10,QCM,0.52,0.25,18.89,13,56,69,51,13,38,1.35,25.49,Facile,Difficile,-2,Beaucoup plus Difficile,Pas Adapte
2975,2017,Philosophie,1,Introduction a la Philosophie,1,La Nature,12,754,10,QROC,0.18,0.66,85.61,65,11,76,65,65,0,1.17,100.0,Facile,Facile,0,Meme Difficulté,Pas Adapte
4086,2018,Philosophie,1,Introduction a la Philosophie,1,La Nature,12,754,10,QROC,0.29,0.34,50.69,40,38,78,60,40,20,1.3,66.67,Difficile,Moyen,1,Plus Facile,Pas Adapte
5197,2019,Philosophie,1,Introduction a la Philosophie,1,La Nature,12,754,10,QROC,0.72,0.02,16.25,12,64,76,71,12,59,1.07,16.9,Difficile,Difficile,0,Meme Difficulté,Pas Adapte
6308,2020,Philosophie,1,Introduction a la Philosophie,1,La Nature,12,754,10,QROC,0.28,0.3,55.22,41,34,75,45,41,4,1.67,91.11,Moyen,Moyen,0,Meme Difficulté,Pas Adapte
754,2015,Philosophie,1,Introduction a la Philosophie,1,La Nature,12,755,11,QCM,0.45,0.39,46.59,20,22,42,37,20,17,1.14,54.05,Difficile,Moyen,1,Plus Facile,Pas Adapte
1865,2016,Philosophie,1,Introduction a la Philosophie,1,La Nature,12,755,11,QCM,0.13,0.98,92.02,39,3,42,41,39,2,1.02,95.12,Facile,Facile,0,Meme Difficulté,Pas Adapte
2976,2017,Philosophie,1,Introduction a la Philosophie,1,La Nature,12,755,11,QCM,0.45,0.46,63.75,24,13,37,36,24,12,1.03,66.67,Facile,Moyen,-1,Plus Difficile,Pas Adapte
4087,2018,Philosophie,1,Introduction a la Philosophie,1,La Nature,12,755,11,QCM,0.57,0.29,13.16,5,34,39,24,5,19,1.62,20.83,Moyen,Difficile,-1,Plus Difficile,Pas Adapte
5198,2019,Philosophie,1,Introduction a la Philosophie,1,La Nature,12,755,11,QCU,0.64,0.37,13.11,4,29,33,19,4,15,1.74,21.05,Facile,Difficile,-2,Beaucoup plus Difficile,Pas Adapte
6309,2020,Philosophie,1,Introduction a la Philosophie,1,La Nature,12,755,11,QO,0.82,0.05,10.95,4,33,37,26,4,22,1.42,15.38,Moyen,Difficile,-1,Plus Difficile,Pas Adapte
755,2015,Philosophie,1,Introduction a la Philosophie,1,La Nature,12,756,12,QCU,0.45,0.36,25.34,11,32,43,31,11,20,1.39,35.48,Facile,Difficile,-2,Beaucoup plus Difficile,Pas Adapte
1866,2016,Philosophie,1,Introduction a la Philosophie,1,La Nature,12,756,12,QCU,0.72,0.35,9.75,5,42,47,46,5,41,1.02,10.87,Facile,Difficile,-2,Beaucoup plus Difficile,Pas Adapte
2977,2017,Philosophie,1,Introduction a la Philosophie,1,La Nature,12,756,12,QCU,0.01,0.81,83.32,44,9,53,49,44,5,1.08,89.8,Difficile,Facile,2,Beaucoup plus Facile,Pas Adapte
4088,2018,Philosophie,1,Introduction a la Philosophie,1,La Nature,12,756,12,QCU,0.69,0.25,11.85,6,48,54,22,6,16,2.45,27.27,Moyen,Difficile,-1,Plus Difficile,Pas Adapte
5199,2019,Philosophie,1,Introduction a la Philosophie,1,La Nature,12,756,12,QROC,0.59,0.25,50.44,29,29,58,34,29,5,1.71,85.29,Facile,Moyen,-1,Plus Difficile,Pas Adapte
6310,2020,Philosophie,1,Introduction a la Philosophie,1,La Nature,12,756,12,QCU,0.19,0.96,78.98,43,11,54,54,43,11,1.0,79.63,Difficile,Facile,2,Beaucoup plus Facile,Pas Adapte
756,2015,Philosophie,1,Introduction a la Philosophie,2,La Technique,12,757,1,QCU,0.04,0.77,72.8,68,25,93,70,68,2,1.33,97.14,Moyen,Facile,1,Plus Facile,Adapte
1867,2016,Philosophie,1,Introduction a la Philosophie,2,La Technique,12,757,1,QCU,0.04,0.78,72.8,69,26,95,83,69,14,1.14,83.13,Facile,Facile,0,Meme Difficulté,Adapte
2978,2017,Philosophie,1,Introduction a la Philosophie,2,La Technique,12,757,1,QCU,0.11,0.76,72.8,76,28,104,84,76,8,1.24,90.48,Facile,Facile,0,Meme Difficulté,Adapte
4089,2018,Philosophie,1,Introduction a la Philosophie,2,La Technique,12,757,1,QCU,0.19,0.79,72.8,81,30,111,100,81,19,1.11,81.0,Facile,Facile,0,Meme Difficulté,Adapte
5200,2019,Philosophie,1,Introduction a la Philosophie,2,La Technique,12,757,1,QCU,0.19,0.88,72.8,89,33,122,110,89,21,1.11,80.91,Facile,Facile,0,Meme Difficulté,Adapte
6311,2020,Philosophie,1,Introduction a la Philosophie,2,La Technique,12,757,1,QCU,0.18,0.97,72.8,95,35,130,119,95,24,1.09,79.83,Facile,Facile,0,Meme Difficulté,Adapte
757,2015,Philosophie,1,Introduction a la Philosophie,2,La Technique,12,758,2,QCM,0.17,0.75,83.72,82,16,98,86,82,4,1.14,95.35,Facile,Facile,0,Meme Difficulté,Pas Adapte
1868,2016,Philosophie,1,Introduction a la Philosophie,2,La Technique,12,758,2,QCM,0.54,0.27,5.18,5,96,101,31,5,26,3.26,16.13,Difficile,Difficile,0,Meme Difficulté,Pas Adapte
2979,2017,Philosophie,1,Introduction a la Philosophie,2,La Technique,12,758,2,QCM,0.5,0.23,23.16,23,77,100,100,23,77,1.0,23.0,Difficile,Difficile,0,Meme Difficulté,Pas Adapte
4090,2018,Philosophie,1,Introduction a la Philosophie,2,La Technique,12,758,2,QCU,0.39,0.59,52.73,47,43,90,69,47,22,1.3,68.12,Difficile,Moyen,1,Plus Facile,Pas Adapte
5201,2019,Philosophie,1,Introduction a la Philosophie,2,La Technique,12,758,2,QCM,0.31,0.51,35.95,33,58,91,42,33,9,2.17,78.57,Difficile,Moyen,1,Plus Facile,Pas Adapte
6312,2020,Philosophie,1,Introduction a la Philosophie,2,La Technique,12,758,2,QCM,0.52,0.27,2.72,3,89,92,24,3,21,3.83,12.5,Difficile,Difficile,0,Meme Difficulté,Pas Adapte
758,2015,Philosophie,1,Introduction a la Philosophie,2,La Technique,12,759,3,QO,0.79,0.11,20.8,6,24,30,16,6,10,1.88,37.5,Facile,Difficile,-2,Beaucoup plus Difficile,Pas Adapte
1869,2016,Philosophie,1,Introduction a la Philosophie,2,La Technique,12,759,3,QO,0.26,0.16,59.69,17,12,29,25,17,8,1.16,68.0,Facile,Moyen,-1,Plus Difficile,Pas Adapte
2980,2017,Philosophie,1,Introduction a la Philosophie,2,La Technique,12,759,3,QO,0.64,0.17,35.29,11,20,31,25,11,14,1.24,44.0,Facile,Moyen,-1,Plus Difficile,Pas Adapte
4091,2018,Philosophie,1,Introduction a la Philosophie,2,La Technique,12,759,3,QCM,0.51,0.16,7.29,2,24,26,18,2,16,1.44,11.11,Facile,Difficile,-2,Beaucoup plus Difficile,Pas Adapte
5202,2019,Philosophie,1,Introduction a la Philosophie,2,La Technique,12,759,3,QCM,0.78,0.28,6.62,2,24,26,20,2,18,1.3,10.0,Facile,Difficile,-2,Beaucoup plus Difficile,Pas Adapte
6313,2020,Philosophie,1,Introduction a la Philosophie,2,La Technique,12,759,3,QCM,0.44,0.51,51.08,13,12,25,22,13,9,1.14,59.09,Moyen,Moyen,0,Meme Difficulté,Pas Adapte
759,2015,Philosophie,1,Introduction a la Philosophie,2,La Technique,12,760,4,QCM,0.74,0.17,13.72,13,81,94,52,13,39,1.81,25.0,Facile,Difficile,-2,Beaucoup plus Difficile,Pas Adapte
1870,2016,Philosophie,1,Introduction a la Philosophie,2,La Technique,12,760,4,QCM,0.28,0.45,41.77,34,47,81,48,34,14,1.69,70.83,Difficile,Moyen,1,Plus Facile,Pas Adapte
2981,2017,Philosophie,1,Introduction a la Philosophie,2,La Technique,12,760,4,QCM,0.14,0.87,73.12,56,20,76,59,56,3,1.29,94.92,Difficile,Facile,2,Beaucoup plus Facile,Adapte
4092,2018,Philosophie,1,Introduction a la Philosophie,2,La Technique,12,760,4,QCM,0.16,0.81,73.12,53,19,72,69,53,16,1.04,76.81,Facile,Facile,0,Meme Difficulté,Adapte
5203,2019,Philosophie,1,Introduction a la Philosophie,2,La Technique,12,760,4,QCM,0.06,0.98,73.12,51,19,70,57,51,6,1.23,89.47,Facile,Facile,0,Meme Difficulté,Adapte
6314,2020,Philosophie,1,Introduction a la Philosophie,2,La Technique,12,760,4,QCM,0.12,0.71,73.12,56,21,77,73,56,17,1.05,76.71,Facile,Facile,0,Meme Difficulté,Adapte
760,2015,Philosophie,1,Introduction a la Philosophie,2,La Technique,12,761,5,QCU,0.58,0.3,26.73,16,44,60,51,16,35,1.18,31.37,Facile,Difficile,-2,Beaucoup plus Difficile,Pas Adapte
1871,2016,Philosophie,1,Introduction a la Philosophie,2,La Technique,12,761,5,QCU,0.07,0.87,69.44,45,20,65,52,45,7,1.25,86.54,Facile,Facile,0,Meme Difficulté,Adapte
2982,2017,Philosophie,1,Introduction a la Philosophie,2,La Technique,12,761,5,QCU,0.18,0.89,69.44,48,21,69,64,48,16,1.08,75.0,Facile,Facile,0,Meme Difficulté,Adapte
4093,2018,Philosophie,1,Introduction a la Philosophie,2,La Technique,12,761,5,QCU,0.05,0.85,69.44,47,20,67,51,47,4,1.31,92.16,Facile,Facile,0,Meme Difficulté,Adapte
5204,2019,Philosophie,1,Introduction a la Philosophie,2,La Technique,12,761,5,QCM,0.04,0.77,69.44,44,19,63,49,44,5,1.29,89.8,Facile,Facile,0,Meme Difficulté,Adapte
6315,2020,Philosophie,1,Introduction a la Philosophie,2,La Technique,12,761,5,QCM,0.09,0.87,69.44,49,22,71,70,49,21,1.01,70.0,Facile,Facile,0,Meme Difficulté,Adapte
761,2015,Philosophie,1,Introduction a la Philosophie,2,La Technique,12,762,6,QO,0.44,0.17,59.44,48,33,81,54,48,6,1.5,88.89,Facile,Moyen,-1,Plus Difficile,Pas Adapte
1872,2016,Philosophie,1,Introduction a la Philosophie,2,La Technique,12,762,6,QO,0.76,0.08,7.95,6,74,80,52,6,46,1.54,11.54,Moyen,Difficile,-1,Plus Difficile,Pas Adapte
2983,2017,Philosophie,1,Introduction a la Philosophie,2,La Technique,12,762,6,QO,0.93,0.05,13.69,10,61,71,45,10,35,1.58,22.22,Difficile,Difficile,0,Meme Difficulté,Pas Adapte
4094,2018,Philosophie,1,Introduction a la Philosophie,2,La Technique,12,762,6,QO,0.81,0.09,17.96,15,66,81,77,15,62,1.05,19.48,Difficile,Difficile,0,Meme Difficulté,Pas Adapte
5205,2019,Philosophie,1,Introduction a la Philosophie,2,La Technique,12,762,6,QO,0.27,0.25,55.47,52,41,93,84,52,32,1.11,61.9,Moyen,Moyen,0,Meme Difficulté,Pas Adapte
6316,2020,Philosophie,1,Introduction a la Philosophie,2,La Technique,12,762,6,QO,0.25,0.28,42.03,40,55,95,79,40,39,1.2,50.63,Facile,Moyen,-1,Plus Difficile,Pas Adapte
762,2015,Philosophie,1,Introduction a la Philosophie,2,La Technique,12,763,7,QCU,0.02,0.78,91.02,67,7,74,73,67,6,1.01,91.78,Moyen,Facile,1,Plus Facile,Pas Adapte
1873,2016,Philosophie,1,Introduction a la Philosophie,2,La Technique,12,763,7,QCU,0.01,0.89,73.44,57,21,78,63,57,6,1.24,90.48,Moyen,Facile,1,Plus Facile,Adapte
2984,2017,Philosophie,1,Introduction a la Philosophie,2,La Technique,12,763,7,QCU,0.14,1.0,73.44,48,18,66,55,48,7,1.2,87.27,Facile,Facile,0,Meme Difficulté,Adapte
4095,2018,Philosophie,1,Introduction a la Philosophie,2,La Technique,12,763,7,QCU,0.19,0.89,73.44,41,15,56,44,41,3,1.27,93.18,Facile,Facile,0,Meme Difficulté,Adapte
5206,2019,Philosophie,1,Introduction a la Philosophie,2,La Technique,12,763,7,QCU,0.16,0.76,73.44,39,14,53,45,39,6,1.18,86.67,Facile,Facile,0,Meme Difficulté,Adapte
6317,2020,Philosophie,1,Introduction a la Philosophie,2,La Technique,12,763,7,QCU,0.07,0.9,73.44,44,16,60,48,44,4,1.25,91.67,Facile,Facile,0,Meme Difficulté,Adapte
763,2015,Philosophie,1,Introduction a la Philosophie,2,La Technique,12,764,8,QCM,0.26,0.32,62.27,6,4,10,9,6,3,1.11,66.67,Facile,Moyen,-1,Plus Difficile,Pas Adapte
1874,2016,Philosophie,1,Introduction a la Philosophie,2,La Technique,12,764,8,QCM,0.36,0.41,56.62,7,5,12,11,7,4,1.09,63.64,Difficile,Moyen,1,Plus Facile,Pas Adapte
2985,2017,Philosophie,1,Introduction a la Philosophie,2,La Technique,12,764,8,QCM,0.64,0.22,2.35,0,10,10,3,0,3,3.33,0.0,Moyen,Difficile,-1,Plus Difficile,Pas Adapte
4096,2018,Philosophie,1,Introduction a la Philosophie,2,La Technique,12,764,8,QCM,0.78,0.25,0.65,0,8,8,4,0,4,2.0,0.0,Facile,Difficile,-2,Beaucoup plus Difficile,Pas Adapte
5207,2019,Philosophie,1,Introduction a la Philosophie,2,La Technique,12,764,8,QCM,0.53,0.27,19.92,2,7,9,5,2,3,1.8,40.0,Moyen,Difficile,-1,Plus Difficile,Pas Adapte
6318,2020,Philosophie,1,Introduction a la Philosophie,2,La Technique,12,764,8,QCM,0.39,0.56,48.49,4,5,9,8,4,4,1.12,50.0,Difficile,Moyen,1,Plus Facile,Pas Adapte
764,2015,Philosophie,1,Introduction a la Philosophie,2,La Technique,12,765,9,QCU,0.35,0.52,61.04,7,4,11,7,7,0,1.57,100.0,Facile,Moyen,-1,Plus Difficile,Pas Adapte
1875,2016,Philosophie,1,Introduction a la Philosophie,2,La Technique,12,765,9,QCU,0.02,0.78,90.6,11,1,12,12,11,1,1.0,91.67,Moyen,Facile,1,Plus Facile,Pas Adapte
2986,2017,Philosophie,1,Introduction a la Philosophie,2,La Technique,12,765,9,QCU,0.7,0.31,2.54,0,12,12,11,0,11,1.09,0.0,Facile,Difficile,-2,Beaucoup plus Difficile,Pas Adapte
4097,2018,Philosophie,1,Introduction a la Philosophie,2,La Technique,12,765,9,QCM,0.8,0.23,13.38,2,11,13,13,2,11,1.0,15.38,Facile,Difficile,-2,Beaucoup plus Difficile,Pas Adapte
5208,2019,Philosophie,1,Introduction a la Philosophie,2,La Technique,12,765,9,QCM,0.58,0.21,5.72,1,10,11,10,1,9,1.1,10.0,Facile,Difficile,-2,Beaucoup plus Difficile,Pas Adapte
6319,2020,Philosophie,1,Introduction a la Philosophie,2,La Technique,12,765,9,QCM,0.13,0.9,77.14,9,3,12,10,9,1,1.2,90.0,Difficile,Facile,2,Beaucoup plus Facile,Pas Adapte
765,2015,Philosophie,1,Introduction a la Philosophie,2,La Technique,12,766,10,QROC,0.64,0.17,23.81,19,59,78,52,19,33,1.5,36.54,Facile,Difficile,-2,Beaucoup plus Difficile,Pas Adapte
1876,2016,Philosophie,1,Introduction a la Philosophie,2,La Technique,12,766,10,QROC,0.38,0.34,51.45,40,38,78,69,40,29,1.13,57.97,Difficile,Moyen,1,Plus Facile,Pas Adapte
2987,2017,Philosophie,1,Introduction a la Philosophie,2,La Technique,12,766,10,QROC,0.63,0.21,23.76,19,61,80,78,19,59,1.03,24.36,Facile,Difficile,-2,Beaucoup plus Difficile,Pas Adapte
4098,2018,Philosophie,1,Introduction a la Philosophie,2,La Technique,12,766,10,QROC,0.84,0.12,9.71,8,76,84,71,8,63,1.18,11.27,Facile,Difficile,-2,Beaucoup plus Difficile,Pas Adapte
5209,2019,Philosophie,1,Introduction a la Philosophie,2,La Technique,12,766,10,QROC,0.88,0.01,3.35,2,72,74,34,2,32,2.18,5.88,Facile,Difficile,-2,Beaucoup plus Difficile,Pas Adapte
6320,2020,Philosophie,1,Introduction a la Philosophie,2,La Technique,12,766,10,QO,0.16,0.74,85.55,54,9,63,61,54,7,1.03,88.52,Moyen,Facile,1,Plus Facile,Pas Adapte
766,2015,Philosophie,1,Introduction a la Philosophie,2,La Technique,12,767,11,QCM,0.79,0.29,23.17,14,46,60,19,14,5,3.16,73.68,Moyen,Difficile,-1,Plus Difficile,Pas Adapte
1877,2016,Philosophie,1,Introduction a la Philosophie,2,La Technique,12,767,11,QCU,0.08,0.89,79.41,55,14,69,55,55,0,1.25,100.0,Facile,Facile,0,Meme Difficulté,Pas Adapte
2988,2017,Philosophie,1,Introduction a la Philosophie,2,La Technique,12,767,11,QCM,0.68,0.16,22.4,17,59,76,24,17,7,3.17,70.83,Difficile,Difficile,0,Meme Difficulté,Pas Adapte
4099,2018,Philosophie,1,Introduction a la Philosophie,2,La Technique,12,767,11,QCM,0.12,0.8,78.02,66,18,84,75,66,9,1.12,88.0,Facile,Facile,0,Meme Difficulté,Pas Adapte
5210,2019,Philosophie,1,Introduction a la Philosophie,2,La Technique,12,767,11,QCM,0.69,0.19,25.79,24,68,92,36,24,12,2.56,66.67,Difficile,Difficile,0,Meme Difficulté,Pas Adapte
6321,2020,Philosophie,1,Introduction a la Philosophie,2,La Technique,12,767,11,QCM,0.08,0.84,73.11,69,26,95,82,69,13,1.16,84.15,Facile,Facile,0,Meme Difficulté,Adapte
767,2015,Philosophie,1,Introduction a la Philosophie,2,La Technique,12,768,12,QCU,0.09,0.78,77.23,10,3,13,13,10,3,1.0,76.92,Moyen,Facile,1,Plus Facile,Pas Adapte
1878,2016,Philosophie,1,Introduction a la Philosophie,2,La Technique,12,768,12,QCU,0.12,0.82,73.84,8,3,11,9,8,1,1.22,88.89,Difficile,Facile,2,Beaucoup plus Facile,Adapte
2989,2017,Philosophie,1,Introduction a la Philosophie,2,La Technique,12,768,12,QCM,0.02,0.84,73.84,7,2,9,7,7,0,1.29,100.0,Facile,Facile,0,Meme Difficulté,Adapte
4100,2018,Philosophie,1,Introduction a la Philosophie,2,La Technique,12,768,12,QCM,0.08,0.89,73.84,6,2,8,7,6,1,1.14,85.71,Facile,Facile,0,Meme Difficulté,Adapte
5211,2019,Philosophie,1,Introduction a la Philosophie,2,La Technique,12,768,12,QCM,0.2,0.82,73.84,5,2,7,7,5,2,1.0,71.43,Facile,Facile,0,Meme Difficulté,Adapte
6322,2020,Philosophie,1,Introduction a la Philosophie,2,La Technique,12,768,12,QCM,0.14,0.82,73.84,5,2,7,6,5,1,1.17,83.33,Facile,Facile,0,Meme Difficulté,Adapte
768,2015,Philosophie,1,Introduction a la Philosophie,3,L'Oeuvre d'Art,5,769,1,QCU,0.21,0.45,48.72,21,23,44,32,21,11,1.38,65.62,Facile,Moyen,-1,Plus Difficile,Pas Adapte
1879,2016,Philosophie,1,Introduction a la Philosophie,3,L'Oeuvre d'Art,5,769,1,QCU,0.2,0.77,66.99,31,15,46,37,31,6,1.24,83.78,Difficile,Facile,2,Beaucoup plus Facile,Adapte
2990,2017,Philosophie,1,Introduction a la Philosophie,3,L'Oeuvre d'Art,5,769,1,QCU,0.19,0.84,66.99,30,15,45,42,30,12,1.07,71.43,Facile,Facile,0,Meme Difficulté,Adapte
4101,2018,Philosophie,1,Introduction a la Philosophie,3,L'Oeuvre d'Art,5,769,1,QCU,0.17,0.97,66.99,33,16,49,37,33,4,1.32,89.19,Facile,Facile,0,Meme Difficulté,Adapte
5212,2019,Philosophie,1,Introduction a la Philosophie,3,L'Oeuvre d'Art,5,769,1,QROC,0.09,0.86,66.99,35,17,52,46,35,11,1.13,76.09,Facile,Facile,0,Meme Difficulté,Adapte
6323,2020,Philosophie,1,Introduction a la Philosophie,3,L'Oeuvre d'Art,5,769,1,QROC,0.1,0.98,66.99,30,15,45,33,30,3,1.36,90.91,Facile,Facile,0,Meme Difficulté,Adapte
769,2015,Philosophie,1,Introduction a la Philosophie,3,L'Oeuvre d'Art,5,770,2,QROC,0.38,0.27,50.85,27,27,54,50,27,23,1.08,54.0,Difficile,Moyen,1,Plus Facile,Pas Adapte
1880,2016,Philosophie,1,Introduction a la Philosophie,3,L'Oeuvre d'Art,5,770,2,QROC,0.98,0.01,1.73,1,59,60,29,1,28,2.07,3.45,Difficile,Difficile,0,Meme Difficulté,Pas Adapte
2991,2017,Philosophie,1,Introduction a la Philosophie,3,L'Oeuvre d'Art,5,770,2,QROC,0.75,0.08,23.02,13,42,55,43,13,30,1.28,30.23,Moyen,Difficile,-1,Plus Difficile,Pas Adapte
4102,2018,Philosophie,1,Introduction a la Philosophie,3,L'Oeuvre d'Art,5,770,2,QO,0.02,0.45,84.2,51,10,61,56,51,5,1.09,91.07,Moyen,Facile,1,Plus Facile,Pas Adapte
5213,2019,Philosophie,1,Introduction a la Philosophie,3,L'Oeuvre d'Art,5,770,2,QO,0.77,0.03,2.58,1,52,53,51,1,50,1.04,1.96,Difficile,Difficile,0,Meme Difficulté,Pas Adapte
6324,2020,Philosophie,1,Introduction a la Philosophie,3,L'Oeuvre d'Art,5,770,2,QO,0.76,0.06,3.31,2,47,49,28,2,26,1.75,7.14,Facile,Difficile,-2,Beaucoup plus Difficile,Pas Adapte
770,2015,Philosophie,1,Introduction a la Philosophie,3,L'Oeuvre d'Art,5,771,3,QCU,0.52,0.33,31.05,13,29,42,40,13,27,1.05,32.5,Moyen,Difficile,-1,Plus Difficile,Pas Adapte
1881,2016,Philosophie,1,Introduction a la Philosophie,3,L'Oeuvre d'Art,5,771,3,QCU,0.62,0.38,10.94,4,35,39,26,4,22,1.5,15.38,Difficile,Difficile,0,Meme Difficulté,Pas Adapte
2992,2017,Philosophie,1,Introduction a la Philosophie,3,L'Oeuvre d'Art,5,771,3,QROC,0.11,0.96,90.45,37,4,41,38,37,1,1.08,97.37,Facile,Facile,0,Meme Difficulté,Pas Adapte
4103,2018,Philosophie,1,Introduction a la Philosophie,3,L'Oeuvre d'Art,5,771,3,QROC,0.79,0.24,34.72,12,23,35,31,12,19,1.13,38.71,Facile,Difficile,-2,Beaucoup plus Difficile,Pas Adapte
5214,2019,Philosophie,1,Introduction a la Philosophie,3,L'Oeuvre d'Art,5,771,3,QROC,0.08,0.94,74.77,28,9,37,35,28,7,1.06,80.0,Facile,Facile,0,Meme Difficulté,Adapte
6325,2020,Philosophie,1,Introduction a la Philosophie,3,L'Oeuvre d'Art,5,771,3,QROC,0.03,0.66,74.77,25,9,34,31,25,6,1.1,80.65,Facile,Facile,0,Meme Difficulté,Adapte
771,2015,Philosophie,1,Introduction a la Philosophie,3,L'Oeuvre d'Art,5,772,4,QROC,0.93,0.06,8.09,0,5,5,4,0,4,1.25,0.0,Facile,Difficile,-2,Beaucoup plus Difficile,Pas Adapte
1882,2016,Philosophie,1,Introduction a la Philosophie,3,L'Oeuvre d'Art,5,772,4,QROC,0.19,0.97,72.37,3,1,4,3,3,0,1.33,100.0,Difficile,Facile,2,Beaucoup plus Facile,Adapte
2993,2017,Philosophie,1,Introduction a la Philosophie,3,L'Oeuvre d'Art,5,772,4,QO,0.04,0.38,72.37,3,1,4,3,3,0,1.33,100.0,Facile,Facile,0,Meme Difficulté,Adapte
4104,2018,Philosophie,1,Introduction a la Philosophie,3,L'Oeuvre d'Art,5,772,4,QROC,0.18,0.51,72.37,2,1,3,2,2,0,1.5,100.0,Facile,Facile,0,Meme Difficulté,Adapte
5215,2019,Philosophie,1,Introduction a la Philosophie,3,L'Oeuvre d'Art,5,772,4,QO,0.03,0.93,72.37,2,1,3,3,2,1,1.0,66.67,Facile,Facile,0,Meme Difficulté,Adapte
6326,2020,Philosophie,1,Introduction a la Philosophie,3,L'Oeuvre d'Art,5,772,4,QO,0.01,0.59,72.37,2,1,3,2,2,0,1.5,100.0,Facile,Facile,0,Meme Difficulté,Adapte
772,2015,Philosophie,1,Introduction a la Philosophie,3,L'Oeuvre d'Art,5,773,5,QCU,0.44,0.39,26.67,12,33,45,28,12,16,1.61,42.86,Difficile,Difficile,0,Meme Difficulté,Pas Adapte
1883,2016,Philosophie,1,Introduction a la Philosophie,3,L'Oeuvre d'Art,5,773,5,QCU,0.15,0.77,71.25,36,14,50,47,36,11,1.06,76.6,Difficile,Facile,2,Beaucoup plus Facile,Adapte
2994,2017,Philosophie,1,Introduction a la Philosophie,3,L'Oeuvre d'Art,5,773,5,QCU,0.17,0.9,71.25,37,15,52,47,37,10,1.11,78.72,Facile,Facile,0,Meme Difficulté,Adapte
4105,2018,Philosophie,1,Introduction a la Philosophie,3,L'Oeuvre d'Art,5,773,5,QCU,0.17,0.92,71.25,41,16,57,44,41,3,1.3,93.18,Facile,Facile,0,Meme Difficulté,Adapte
5216,2019,Philosophie,1,Introduction a la Philosophie,3,L'Oeuvre d'Art,5,773,5,QCU,0.06,0.84,71.25,41,16,57,57,41,16,1.0,71.93,Facile,Facile,0,Meme Difficulté,Adapte
6327,2020,Philosophie,1,Introduction a la Philosophie,3,L'Oeuvre d'Art,5,773,5,QCU,0.12,0.77,71.25,45,18,63,60,45,15,1.05,75.0,Facile,Facile,0,Meme Difficulté,Adapte
773,2015,Philosophie,1,Introduction a la Philosophie,4,L'Histoire,9,774,1,QCM,0.58,0.26,22.61,7,25,32,9,7,2,3.56,77.78,Difficile,Difficile,0,Meme Difficulté,Pas Adapte
1884,2016,Philosophie,1,Introduction a la Philosophie,4,L'Histoire,9,774,1,QCM,0.27,0.51,49.47,15,16,31,26,15,11,1.19,57.69,Facile,Moyen,-1,Plus Difficile,Pas Adapte
2995,2017,Philosophie,1,Introduction a la Philosophie,4,L'Histoire,9,774,1,QCM,0.08,0.94,72.06,20,8,28,25,20,5,1.12,80.0,Moyen,Facile,1,Plus Facile,Adapte
4106,2018,Philosophie,1,Introduction a la Philosophie,4,L'Histoire,9,774,1,QCM,0.11,0.76,72.06,19,7,26,24,19,5,1.08,79.17,Facile,Facile,0,Meme Difficulté,Adapte
5217,2019,Philosophie,1,Introduction a la Philosophie,4,L'Histoire,9,774,1,QCM,0.04,0.87,72.06,18,7,25,22,18,4,1.14,81.82,Facile,Facile,0,Meme Difficulté,Adapte
6328,2020,Philosophie,1,Introduction a la Philosophie,4,L'Histoire,9,774,1,QCM,0.03,0.82,72.06,18,7,25,22,18,4,1.14,81.82,Facile,Facile,0,Meme Difficulté,Adapte
774,2015,Philosophie,1,Introduction a la Philosophie,4,L'Histoire,9,775,2,QCU,0.56,0.37,18.16,3,12,15,9,3,6,1.67,33.33,Moyen,Difficile,-1,Plus Difficile,Pas Adapte
1885,2016,Philosophie,1,Introduction a la Philosophie,4,L'Histoire,9,775,2,QCU,0.64,0.2,2.44,0,13,13,10,0,10,1.3,0.0,Difficile,Difficile,0,Meme Difficulté,Pas Adapte
2996,2017,Philosophie,1,Introduction a la Philosophie,4,L'Histoire,9,775,2,QCU,0.58,0.33,16.08,2,12,14,9,2,7,1.56,22.22,Difficile,Difficile,0,Meme Difficulté,Pas Adapte
4107,2018,Philosophie,1,Introduction a la Philosophie,4,L'Histoire,9,775,2,QCU,0.42,0.24,12.4,2,14,16,6,2,4,2.67,33.33,Moyen,Difficile,-1,Plus Difficile,Pas Adapte
5218,2019,Philosophie,1,Introduction a la Philosophie,4,L'Histoire,9,775,2,QCU,0.21,0.51,49.35,9,9,18,10,9,1,1.8,90.0,Moyen,Moyen,0,Meme Difficulté,Pas Adapte
6329,2020,Philosophie,1,Introduction a la Philosophie,4,L'Histoire,9,775,2,QCU,0.32,0.63,54.44,11,9,20,13,11,2,1.54,84.62,Moyen,Moyen,0,Meme Difficulté,Pas Adapte
775,2015,Philosophie,1,Introduction a la Philosophie,4,L'Histoire,9,776,3,QCM,0.52,0.21,4.19,1,34,35,35,1,34,1.0,2.86,Facile,Difficile,-2,Beaucoup plus Difficile,Pas Adapte
1886,2016,Philosophie,1,Introduction a la Philosophie,4,L'Histoire,9,776,3,QCM,0.02,0.93,79.99,30,7,37,36,30,6,1.03,83.33,Facile,Facile,0,Meme Difficulté,Pas Adapte
2997,2017,Philosophie,1,Introduction a la Philosophie,4,L'Histoire,9,776,3,QCM,0.31,0.41,46.69,16,19,35,21,16,5,1.67,76.19,Difficile,Moyen,1,Plus Facile,Pas Adapte
4108,2018,Philosophie,1,Introduction a la Philosophie,4,L'Histoire,9,776,3,QCM,0.13,0.77,90.52,32,3,35,35,32,3,1.0,91.43,Difficile,Facile,2,Beaucoup plus Facile,Pas Adapte
5219,2019,Philosophie,1,Introduction a la Philosophie,4,L'Histoire,9,776,3,QCM,0.65,0.28,0.17,0,39,39,17,0,17,2.29,0.0,Moyen,Difficile,-1,Plus Difficile,Pas Adapte
6330,2020,Philosophie,1,Introduction a la Philosophie,4,L'Histoire,9,776,3,QCM,0.61,0.2,0.3,0,45,45,43,0,43,1.05,0.0,Difficile,Difficile,0,Meme Difficulté,Pas Adapte
776,2015,Philosophie,1,Introduction a la Philosophie,4,L'Histoire,9,777,4,QCU,0.59,0.3,1.98,1,61,62,58,1,57,1.07,1.72,Difficile,Difficile,0,Meme Difficulté,Pas Adapte
1887,2016,Philosophie,1,Introduction a la Philosophie,4,L'Histoire,9,777,4,QCU,0.53,0.32,5.11,3,55,58,42,3,39,1.38,7.14,Facile,Difficile,-2,Beaucoup plus Difficile,Pas Adapte
2998,2017,Philosophie,1,Introduction a la Philosophie,4,L'Histoire,9,777,4,QROC,0.63,0.15,22.36,14,48,62,58,14,44,1.07,24.14,Facile,Difficile,-2,Beaucoup plus Difficile,Pas Adapte
4109,2018,Philosophie,1,Introduction a la Philosophie,4,L'Histoire,9,777,4,QROC,0.17,0.77,73.78,39,14,53,40,39,1,1.32,97.5,Moyen,Facile,1,Plus Facile,Adapte
5220,2019,Philosophie,1,Introduction a la Philosophie,4,L'Histoire,9,777,4,QROC,0.19,0.55,73.78,38,13,51,45,38,7,1.13,84.44,Facile,Facile,0,Meme Difficulté,Adapte
6331,2020,Philosophie,1,Introduction a la Philosophie,4,L'Histoire,9,777,4,QROC,0.12,0.72,73.78,36,13,49,43,36,7,1.14,83.72,Facile,Facile,0,Meme Difficulté,Adapte
777,2015,Philosophie,1,Introduction a la Philosophie,4,L'Histoire,9,778,5,QCU,0.48,0.4,28.21,23,58,81,68,23,45,1.19,33.82,Facile,Difficile,-2,Beaucoup plus Difficile,Pas Adapte
1888,2016,Philosophie,1,Introduction a la Philosophie,4,L'Histoire,9,778,5,QCU,0.34,0.64,45.56,39,47,86,55,39,16,1.56,70.91,Facile,Moyen,-1,Plus Difficile,Pas Adapte
2999,2017,Philosophie,1,Introduction a la Philosophie,4,L'Histoire,9,778,5,QCU,0.29,0.47,47.18,45,51,96,69,45,24,1.39,65.22,Difficile,Moyen,1,Plus Facile,Pas Adapte
4110,2018,Philosophie,1,Introduction a la Philosophie,4,L'Histoire,9,778,5,QCU,0.29,0.44,36.02,38,68,106,57,38,19,1.86,66.67,Difficile,Moyen,1,Plus Facile,Pas Adapte
5221,2019,Philosophie,1,Introduction a la Philosophie,4,L'Histoire,9,778,5,QCU,0.35,0.73,60.16,64,42,106,75,64,11,1.41,85.33,Moyen,Moyen,0,Meme Difficulté,Pas Adapte
6332,2020,Philosophie,1,Introduction a la Philosophie,4,L'Histoire,9,778,5,QCU,0.09,0.78,99.98,108,0,108,108,108,0,1.0,100.0,Difficile,Facile,2,Beaucoup plus Facile,Pas Adapte
778,2015,Philosophie,1,Introduction a la Philosophie,4,L'Histoire,9,779,6,QCM,0.04,0.7,74.36,4,2,6,6,4,2,1.0,66.67,Moyen,Facile,1,Plus Facile,Adapte
1889,2016,Philosophie,1,Introduction a la Philosophie,4,L'Histoire,9,779,6,QCU,0.14,0.94,74.36,5,2,7,6,5,1,1.17,83.33,Facile,Facile,0,Meme Difficulté,Adapte
3000,2017,Philosophie,1,Introduction a la Philosophie,4,L'Histoire,9,779,6,QCM,0.1,0.89,74.36,5,2,7,7,5,2,1.0,71.43,Facile,Facile,0,Meme Difficulté,Adapte
4111,2018,Philosophie,1,Introduction a la Philosophie,4,L'Histoire,9,779,6,QCM,0.14,0.94,74.36,4,2,6,4,4,0,1.5,100.0,Facile,Facile,0,Meme Difficulté,Adapte
5222,2019,Philosophie,1,Introduction a la Philosophie,4,L'Histoire,9,779,6,QCM,0.1,0.98,74.36,5,2,7,6,5,1,1.17,83.33,Facile,Facile,0,Meme Difficulté,Adapte
6333,2020,Philosophie,1,Introduction a la Philosophie,4,L'Histoire,9,779,6,QCM,0.14,0.74,74.36,4,2,6,5,4,1,1.2,80.0,Facile,Facile,0,Meme Difficulté,Adapte
779,2015,Philosophie,1,Introduction a la Philosophie,4,L'Histoire,9,780,7,QCU,0.15,0.8,78.94,53,14,67,66,53,13,1.02,80.3,Facile,Facile,0,Meme Difficulté,Pas Adapte
1890,2016,Philosophie,1,Introduction a la Philosophie,4,L'Histoire,9,780,7,QCU,0.08,0.87,79.11,54,14,68,60,54,6,1.13,90.0,Moyen,Facile,1,Plus Facile,Pas Adapte
3001,2017,Philosophie,1,Introduction a la Philosophie,4,L'Histoire,9,780,7,QCU,0.14,0.99,81.21,51,12,63,54,51,3,1.17,94.44,Difficile,Facile,2,Beaucoup plus Facile,Pas Adapte
4112,2018,Philosophie,1,Introduction a la Philosophie,4,L'Histoire,9,780,7,QCU,0.51,0.38,19.59,13,54,67,25,13,12,2.68,52.0,Facile,Difficile,-2,Beaucoup plus Difficile,Pas Adapte
5223,2019,Philosophie,1,Introduction a la Philosophie,4,L'Histoire,9,780,7,QCU,0.56,0.26,0.61,0,61,61,44,0,44,1.39,0.0,Moyen,Difficile,-1,Plus Difficile,Pas Adapte
6334,2020,Philosophie,1,Introduction a la Philosophie,4,L'Histoire,9,780,7,QCU,0.07,0.97,99.1,62,1,63,63,62,1,1.0,98.41,Difficile,Facile,2,Beaucoup plus Facile,Pas Adapte
780,2015,Philosophie,1,Introduction a la Philosophie,4,L'Histoire,9,781,8,QCU,0.38,0.59,38.02,13,20,33,17,13,4,1.94,76.47,Difficile,Moyen,1,Plus Facile,Pas Adapte
1891,2016,Philosophie,1,Introduction a la Philosophie,4,L'Histoire,9,781,8,QCU,0.12,0.78,87.14,32,5,37,34,32,2,1.09,94.12,Facile,Facile,0,Meme Difficulté,Pas Adapte
3002,2017,Philosophie,1,Introduction a la Philosophie,4,L'Histoire,9,781,8,QCU,0.27,0.46,43.13,16,21,37,25,16,9,1.48,64.0,Facile,Moyen,-1,Plus Difficile,Pas Adapte
4113,2018,Philosophie,1,Introduction a la Philosophie,4,L'Histoire,9,781,8,QCU,0.28,0.43,60.73,25,16,41,28,25,3,1.46,89.29,Difficile,Moyen,1,Plus Facile,Pas Adapte
5224,2019,Philosophie,1,Introduction a la Philosophie,4,L'Histoire,9,781,8,QCU,0.08,0.88,90.1,37,4,41,39,37,2,1.05,94.87,Moyen,Facile,1,Plus Facile,Pas Adapte
6335,2020,Philosophie,1,Introduction a la Philosophie,4,L'Histoire,9,781,8,QCU,0.17,0.76,78.1,35,10,45,39,35,4,1.15,89.74,Moyen,Facile,1,Plus Facile,Pas Adapte
781,2015,Philosophie,1,Introduction a la Philosophie,4,L'Histoire,9,782,9,QCM,0.26,0.47,43.29,14,18,32,23,14,9,1.39,60.87,Moyen,Moyen,0,Meme Difficulté,Pas Adapte
1892,2016,Philosophie,1,Introduction a la Philosophie,4,L'Histoire,9,782,9,QCM,0.39,0.53,64.21,24,13,37,35,24,11,1.06,68.57,Moyen,Moyen,0,Meme Difficulté,Pas Adapte
3003,2017,Philosophie,1,Introduction a la Philosophie,4,L'Histoire,9,782,9,QCU,0.2,0.98,73.16,23,8,31,26,23,3,1.19,88.46,Moyen,Facile,1,Plus Facile,Adapte
4114,2018,Philosophie,1,Introduction a la Philosophie,4,L'Histoire,9,782,9,QCU,0.01,0.81,73.16,21,8,29,22,21,1,1.32,95.45,Facile,Facile,0,Meme Difficulté,Adapte
5225,2019,Philosophie,1,Introduction a la Philosophie,4,L'Histoire,9,782,9,QCU,0.11,0.97,73.16,20,8,28,22,20,2,1.27,90.91,Facile,Facile,0,Meme Difficulté,Adapte
6336,2020,Philosophie,1,Introduction a la Philosophie,4,L'Histoire,9,782,9,QCU,0.05,0.81,73.16,23,8,31,29,23,6,1.07,79.31,Facile,Facile,0,Meme Difficulté,Adapte
782,2015,Philosophie,1,Introduction a la Philosophie,5,Le Droit,7,783,1,QCM,0.09,0.71,75.88,44,14,58,48,44,4,1.21,91.67,Facile,Facile,0,Meme Difficulté,Pas Adapte
1893,2016,Philosophie,1,Introduction a la Philosophie,5,Le Droit,7,783,1,QCM,0.46,0.68,60.59,32,20,52,43,32,11,1.21,74.42,Facile,Moyen,-1,Plus Difficile,Pas Adapte
3004,2017,Philosophie,1,Introduction a la Philosophie,5,Le Droit,7,783,1,QCM,0.61,0.21,13.4,7,48,55,29,7,22,1.9,24.14,Facile,Difficile,-2,Beaucoup plus Difficile,Pas Adapte
4115,2018,Philosophie,1,Introduction a la Philosophie,5,Le Droit,7,783,1,QCM,0.14,0.7,72.44,37,14,51,37,37,0,1.38,100.0,Difficile,Facile,2,Beaucoup plus Facile,Adapte
5226,2019,Philosophie,1,Introduction a la Philosophie,5,Le Droit,7,783,1,QCM,0.03,0.99,72.44,41,16,57,44,41,3,1.3,93.18,Facile,Facile,0,Meme Difficulté,Adapte
6337,2020,Philosophie,1,Introduction a la Philosophie,5,Le Droit,7,783,1,QCU,0.19,0.96,72.44,38,14,52,46,38,8,1.13,82.61,Facile,Facile,0,Meme Difficulté,Adapte
783,2015,Philosophie,1,Introduction a la Philosophie,5,Le Droit,7,784,2,QCU,0.08,0.95,94.07,8,1,9,8,8,0,1.12,100.0,Difficile,Facile,2,Beaucoup plus Facile,Pas Adapte
1894,2016,Philosophie,1,Introduction a la Philosophie,5,Le Droit,7,784,2,QCU,0.61,0.38,19.71,2,7,9,3,2,1,3.0,66.67,Facile,Difficile,-2,Beaucoup plus Difficile,Pas Adapte
3005,2017,Philosophie,1,Introduction a la Philosophie,5,Le Droit,7,784,2,QCU,0.21,0.5,59.31,5,4,9,6,5,1,1.5,83.33,Facile,Moyen,-1,Plus Difficile,Pas Adapte
4116,2018,Philosophie,1,Introduction a la Philosophie,5,Le Droit,7,784,2,QCU,0.12,0.76,95.65,8,0,8,8,8,0,1.0,100.0,Difficile,Facile,2,Beaucoup plus Facile,Pas Adapte
5227,2019,Philosophie,1,Introduction a la Philosophie,5,Le Droit,7,784,2,QCU,0.25,0.7,35.41,3,6,9,4,3,1,2.25,75.0,Difficile,Moyen,1,Plus Facile,Pas Adapte
6338,2020,Philosophie,1,Introduction a la Philosophie,5,Le Droit,7,784,2,QCU,0.2,0.84,91.97,9,1,10,10,9,1,1.0,90.0,Facile,Facile,0,Meme Difficulté,Pas Adapte
784,2015,Philosophie,1,Introduction a la Philosophie,5,Le Droit,7,785,3,QCU,0.3,0.71,43.58,5,7,12,9,5,4,1.33,55.56,Difficile,Moyen,1,Plus Facile,Pas Adapte
1895,2016,Philosophie,1,Introduction a la Philosophie,5,Le Droit,7,785,3,QCU,0.21,0.45,51.46,7,6,13,8,7,1,1.62,87.5,Difficile,Moyen,1,Plus Facile,Pas Adapte
3006,2017,Philosophie,1,Introduction a la Philosophie,5,Le Droit,7,785,3,QCM,0.69,0.22,21.58,3,12,15,11,3,8,1.36,27.27,Difficile,Difficile,0,Meme Difficulté,Pas Adapte
4117,2018,Philosophie,1,Introduction a la Philosophie,5,Le Droit,7,785,3,QCM,0.32,0.49,56.23,8,7,15,15,8,7,1.0,53.33,Facile,Moyen,-1,Plus Difficile,Pas Adapte
5228,2019,Philosophie,1,Introduction a la Philosophie,5,Le Droit,7,785,3,QCM,0.28,0.68,41.65,5,8,13,6,5,1,2.17,83.33,Facile,Moyen,-1,Plus Difficile,Pas Adapte
6339,2020,Philosophie,1,Introduction a la Philosophie,5,Le Droit,7,785,3,QCM,0.28,0.5,41.51,5,8,13,8,5,3,1.62,62.5,Moyen,Moyen,0,Meme Difficulté,Pas Adapte
785,2015,Philosophie,1,Introduction a la Philosophie,5,Le Droit,7,786,4,QROC,0.78,0.09,31.82,20,43,63,54,20,34,1.17,37.04,Moyen,Difficile,-1,Plus Difficile,Pas Adapte
1896,2016,Philosophie,1,Introduction a la Philosophie,5,Le Droit,7,786,4,QROC,0.47,0.27,63.43,36,20,56,39,36,3,1.44,92.31,Moyen,Moyen,0,Meme Difficulté,Pas Adapte
3007,2017,Philosophie,1,Introduction a la Philosophie,5,Le Droit,7,786,4,QROC,0.47,0.32,64.75,38,20,58,58,38,20,1.0,65.52,Difficile,Moyen,1,Plus Facile,Pas Adapte
4118,2018,Philosophie,1,Introduction a la Philosophie,5,Le Droit,7,786,4,QROC,0.06,0.56,84.12,51,10,61,57,51,6,1.07,89.47,Facile,Facile,0,Meme Difficulté,Pas Adapte
5229,2019,Philosophie,1,Introduction a la Philosophie,5,Le Droit,7,786,4,QO,0.8,0.05,30.36,21,47,68,63,21,42,1.08,33.33,Moyen,Difficile,-1,Plus Difficile,Pas Adapte
6340,2020,Philosophie,1,Introduction a la Philosophie,5,Le Droit,7,786,4,QO,0.74,0.2,64.13,43,24,67,60,43,17,1.12,71.67,Facile,Moyen,-1,Plus Difficile,Pas Adapte
786,2015,Philosophie,1,Introduction a la Philosophie,5,Le Droit,7,787,5,QCU,0.31,0.61,39.0,24,37,61,34,24,10,1.79,70.59,Facile,Moyen,-1,Plus Difficile,Pas Adapte
1897,2016,Philosophie,1,Introduction a la Philosophie,5,Le Droit,7,787,5,QCU,0.05,0.88,88.72,58,7,65,63,58,5,1.03,92.06,Facile,Facile,0,Meme Difficulté,Pas Adapte
3008,2017,Philosophie,1,Introduction a la Philosophie,5,Le Droit,7,787,5,QCU,0.48,0.3,25.08,17,52,69,54,17,37,1.28,31.48,Facile,Difficile,-2,Beaucoup plus Difficile,Pas Adapte
4119,2018,Philosophie,1,Introduction a la Philosophie,5,Le Droit,7,787,5,QCU,0.51,0.29,19.78,15,61,76,74,15,59,1.03,20.27,Difficile,Difficile,0,Meme Difficulté,Pas Adapte
5230,2019,Philosophie,1,Introduction a la Philosophie,5,Le Droit,7,787,5,QCU,0.58,0.23,11.08,8,62,70,50,8,42,1.4,16.0,Moyen,Difficile,-1,Plus Difficile,Pas Adapte
6341,2020,Philosophie,1,Introduction a la Philosophie,5,Le Droit,7,787,5,QCU,0.38,0.43,54.36,36,31,67,55,36,19,1.22,65.45,Facile,Moyen,-1,Plus Difficile,Pas Adapte
787,2015,Philosophie,1,Introduction a la Philosophie,5,Le Droit,7,788,6,QCU,0.27,0.54,47.67,2,3,5,2,2,0,2.5,100.0,Difficile,Moyen,1,Plus Facile,Pas Adapte
1898,2016,Philosophie,1,Introduction a la Philosophie,5,Le Droit,7,788,6,QCU,0.14,0.98,68.59,4,2,6,6,4,2,1.0,66.67,Difficile,Facile,2,Beaucoup plus Facile,Adapte
3009,2017,Philosophie,1,Introduction a la Philosophie,5,Le Droit,7,788,6,QCU,0.16,0.89,68.59,3,2,5,3,3,0,1.67,100.0,Facile,Facile,0,Meme Difficulté,Adapte
4120,2018,Philosophie,1,Introduction a la Philosophie,5,Le Droit,7,788,6,QCU,0.09,0.88,68.59,4,2,6,4,4,0,1.5,100.0,Facile,Facile,0,Meme Difficulté,Adapte
5231,2019,Philosophie,1,Introduction a la Philosophie,5,Le Droit,7,788,6,QCU,0.05,0.97,68.59,5,2,7,7,5,2,1.0,71.43,Facile,Facile,0,Meme Difficulté,Adapte
6342,2020,Philosophie,1,Introduction a la Philosophie,5,Le Droit,7,788,6,QCM,0.19,0.93,68.59,5,3,8,7,5,2,1.14,71.43,Facile,Facile,0,Meme Difficulté,Adapte
788,2015,Philosophie,1,Introduction a la Philosophie,5,Le Droit,7,789,7,QO,0.03,0.76,85.91,68,11,79,76,68,8,1.04,89.47,Moyen,Facile,1,Plus Facile,Pas Adapte
1899,2016,Philosophie,1,Introduction a la Philosophie,5,Le Droit,7,789,7,QO,0.75,0.06,12.83,11,75,86,48,11,37,1.79,22.92,Facile,Difficile,-2,Beaucoup plus Difficile,Pas Adapte
3010,2017,Philosophie,1,Introduction a la Philosophie,5,Le Droit,7,789,7,QO,0.19,0.98,79.63,73,19,92,91,73,18,1.01,80.22,Moyen,Facile,1,Plus Facile,Pas Adapte
4121,2018,Philosophie,1,Introduction a la Philosophie,5,Le Droit,7,789,7,QO,1.0,0.12,20.59,17,64,81,68,17,51,1.19,25.0,Difficile,Difficile,0,Meme Difficulté,Pas Adapte
5232,2019,Philosophie,1,Introduction a la Philosophie,5,Le Droit,7,789,7,QO,0.85,0.05,24.3,21,66,87,75,21,54,1.16,28.0,Facile,Difficile,-2,Beaucoup plus Difficile,Pas Adapte
6343,2020,Philosophie,1,Introduction a la Philosophie,5,Le Droit,7,789,7,QO,0.77,0.13,11.69,9,65,74,63,9,54,1.17,14.29,Moyen,Difficile,-1,Plus Difficile,Pas Adapte
789,2015,Philosophie,1,Introduction a la Philosophie,6,La Raison,7,790,1,QCU,0.33,0.48,42.64,9,11,20,13,9,4,1.54,69.23,Difficile,Moyen,1,Plus Facile,Pas Adapte
1900,2016,Philosophie,1,Introduction a la Philosophie,6,La Raison,7,790,1,QCU,0.06,0.89,82.74,17,4,21,17,17,0,1.24,100.0,Difficile,Facile,2,Beaucoup plus Facile,Pas Adapte
3011,2017,Philosophie,1,Introduction a la Philosophie,6,La Raison,7,790,1,QCU,0.23,0.72,43.83,8,10,18,13,8,5,1.38,61.54,Difficile,Moyen,1,Plus Facile,Pas Adapte
4122,2018,Philosophie,1,Introduction a la Philosophie,6,La Raison,7,790,1,QCU,0.57,0.37,5.51,1,15,16,15,1,14,1.07,6.67,Difficile,Difficile,0,Meme Difficulté,Pas Adapte
5233,2019,Philosophie,1,Introduction a la Philosophie,6,La Raison,7,790,1,QCU,0.01,0.84,65.5,9,5,14,10,9,1,1.4,90.0,Difficile,Facile,2,Beaucoup plus Facile,Adapte
6344,2020,Philosophie,1,Introduction a la Philosophie,6,La Raison,7,790,1,QCU,0.05,0.93,65.5,8,4,12,12,8,4,1.0,66.67,Facile,Facile,0,Meme Difficulté,Adapte
790,2015,Philosophie,1,Introduction a la Philosophie,6,La Raison,7,791,2,QCM,0.54,0.26,15.96,12,66,78,34,12,22,2.29,35.29,Difficile,Difficile,0,Meme Difficulté,Pas Adapte
1901,2016,Philosophie,1,Introduction a la Philosophie,6,La Raison,7,791,2,QCM,0.13,0.88,78.64,60,16,76,61,60,1,1.25,98.36,Difficile,Facile,2,Beaucoup plus Facile,Pas Adapte
3012,2017,Philosophie,1,Introduction a la Philosophie,6,La Raison,7,791,2,QCM,0.26,0.55,57.4,47,35,82,77,47,30,1.06,61.04,Difficile,Moyen,1,Plus Facile,Pas Adapte
4123,2018,Philosophie,1,Introduction a la Philosophie,6,La Raison,7,791,2,QCM,0.5,0.28,3.76,3,73,76,59,3,56,1.29,5.08,Difficile,Difficile,0,Meme Difficulté,Pas Adapte
5234,2019,Philosophie,1,Introduction a la Philosophie,6,La Raison,7,791,2,QCM,0.31,0.49,39.88,30,45,75,45,30,15,1.67,66.67,Moyen,Moyen,0,Meme Difficulté,Pas Adapte
6345,2020,Philosophie,1,Introduction a la Philosophie,6,La Raison,7,791,2,QCM,0.66,0.29,27.8,23,60,83,43,23,20,1.93,53.49,Difficile,Difficile,0,Meme Difficulté,Pas Adapte
791,2015,Philosophie,1,Introduction a la Philosophie,6,La Raison,7,792,3,QCU,0.38,0.47,35.6,30,54,84,63,30,33,1.33,47.62,Difficile,Moyen,1,Plus Facile,Pas Adapte
1902,2016,Philosophie,1,Introduction a la Philosophie,6,La Raison,7,792,3,QCM,0.3,0.57,43.95,39,50,89,49,39,10,1.82,79.59,Difficile,Moyen,1,Plus Facile,Pas Adapte
3013,2017,Philosophie,1,Introduction a la Philosophie,6,La Raison,7,792,3,QCM,0.2,0.34,49.13,49,50,99,91,49,42,1.09,53.85,Facile,Moyen,-1,Plus Difficile,Pas Adapte
4124,2018,Philosophie,1,Introduction a la Philosophie,6,La Raison,7,792,3,QCM,0.47,0.55,39.67,44,66,110,109,44,65,1.01,40.37,Difficile,Moyen,1,Plus Facile,Pas Adapte
5235,2019,Philosophie,1,Introduction a la Philosophie,6,La Raison,7,792,3,QCM,0.5,0.16,13.08,16,108,124,55,16,39,2.25,29.09,Facile,Difficile,-2,Beaucoup plus Difficile,Pas Adapte
6346,2020,Philosophie,1,Introduction a la Philosophie,6,La Raison,7,792,3,QCM,0.05,0.83,71.03,92,37,129,123,92,31,1.05,74.8,Moyen,Facile,1,Plus Facile,Adapte
792,2015,Philosophie,1,Introduction a la Philosophie,6,La Raison,7,793,4,QCU,0.25,0.63,56.77,48,37,85,71,48,23,1.2,67.61,Difficile,Moyen,1,Plus Facile,Pas Adapte
1903,2016,Philosophie,1,Introduction a la Philosophie,6,La Raison,7,793,4,QCM,0.37,0.35,49.48,46,47,93,91,46,45,1.02,50.55,Difficile,Moyen,1,Plus Facile,Pas Adapte
3014,2017,Philosophie,1,Introduction a la Philosophie,6,La Raison,7,793,4,QCM,0.05,0.82,68.45,57,26,83,63,57,6,1.32,90.48,Difficile,Facile,2,Beaucoup plus Facile,Adapte
4125,2018,Philosophie,1,Introduction a la Philosophie,6,La Raison,7,793,4,QCM,0.15,0.85,68.45,50,23,73,53,50,3,1.38,94.34,Facile,Facile,0,Meme Difficulté,Adapte
5236,2019,Philosophie,1,Introduction a la Philosophie,6,La Raison,7,793,4,QCM,0.07,0.84,68.45,56,26,82,67,56,11,1.22,83.58,Facile,Facile,0,Meme Difficulté,Adapte
6347,2020,Philosophie,1,Introduction a la Philosophie,6,La Raison,7,793,4,QCM,0.17,0.86,68.45,53,25,78,57,53,4,1.37,92.98,Facile,Facile,0,Meme Difficulté,Adapte
793,2015,Philosophie,1,Introduction a la Philosophie,6,La Raison,7,794,5,QCU,0.1,0.91,68.51,22,10,32,31,22,9,1.03,70.97,Difficile,Facile,2,Beaucoup plus Facile,Adapte
1904,2016,Philosophie,1,Introduction a la Philosophie,6,La Raison,7,794,5,QCU,0.12,0.87,68.51,23,11,34,32,23,9,1.06,71.88,Facile,Facile,0,Meme Difficulté,Adapte
3015,2017,Philosophie,1,Introduction a la Philosophie,6,La Raison,7,794,5,QCM,0.1,0.7,68.51,21,9,30,24,21,3,1.25,87.5,Facile,Facile,0,Meme Difficulté,Adapte
4126,2018,Philosophie,1,Introduction a la Philosophie,6,La Raison,7,794,5,QCM,0.1,0.76,68.51,22,10,32,31,22,9,1.03,70.97,Facile,Facile,0,Meme Difficulté,Adapte
5237,2019,Philosophie,1,Introduction a la Philosophie,6,La Raison,7,794,5,QCM,0.09,0.82,68.51,20,9,29,24,20,4,1.21,83.33,Facile,Facile,0,Meme Difficulté,Adapte
6348,2020,Philosophie,1,Introduction a la Philosophie,6,La Raison,7,794,5,QCM,0.18,0.88,68.51,18,8,26,20,18,2,1.3,90.0,Facile,Facile,0,Meme Difficulté,Adapte
794,2015,Philosophie,1,Introduction a la Philosophie,6,La Raison,7,795,6,QCU,0.44,0.25,3.79,0,12,12,6,0,6,2.0,0.0,Facile,Difficile,-2,Beaucoup plus Difficile,Pas Adapte
1905,2016,Philosophie,1,Introduction a la Philosophie,6,La Raison,7,795,6,QCU,0.35,0.58,64.15,9,5,14,13,9,4,1.08,69.23,Difficile,Moyen,1,Plus Facile,Pas Adapte
3016,2017,Philosophie,1,Introduction a la Philosophie,6,La Raison,7,795,6,QCM,0.79,0.25,3.16,0,15,15,14,0,14,1.07,0.0,Difficile,Difficile,0,Meme Difficulté,Pas Adapte
4127,2018,Philosophie,1,Introduction a la Philosophie,6,La Raison,7,795,6,QCM,0.09,0.73,98.53,16,0,16,16,16,0,1.0,100.0,Moyen,Facile,1,Plus Facile,Pas Adapte
5238,2019,Philosophie,1,Introduction a la Philosophie,6,La Raison,7,795,6,QCM,0.67,0.28,16.61,3,14,17,14,3,11,1.21,21.43,Facile,Difficile,-2,Beaucoup plus Difficile,Pas Adapte
6349,2020,Philosophie,1,Introduction a la Philosophie,6,La Raison,7,795,6,QCM,0.19,0.84,75.47,14,5,19,17,14,3,1.12,82.35,Difficile,Facile,2,Beaucoup plus Facile,Pas Adapte
795,2015,Philosophie,1,Introduction a la Philosophie,6,La Raison,7,796,7,QO,0.19,1.0,98.8,11,0,11,11,11,0,1.0,100.0,Difficile,Facile,2,Beaucoup plus Facile,Pas Adapte
1906,2016,Philosophie,1,Introduction a la Philosophie,6,La Raison,7,796,7,QO,0.05,0.56,99.7,10,0,10,10,10,0,1.0,100.0,Facile,Facile,0,Meme Difficulté,Pas Adapte
3017,2017,Philosophie,1,Introduction a la Philosophie,6,La Raison,7,796,7,QCU,0.19,0.91,71.07,7,3,10,7,7,0,1.43,100.0,Facile,Facile,0,Meme Difficulté,Adapte
4128,2018,Philosophie,1,Introduction a la Philosophie,6,La Raison,7,796,7,QCU,0.09,0.76,71.07,8,3,11,10,8,2,1.1,80.0,Facile,Facile,0,Meme Difficulté,Adapte
5239,2019,Philosophie,1,Introduction a la Philosophie,6,La Raison,7,796,7,QCU,0.15,0.91,71.07,7,3,10,8,7,1,1.25,87.5,Facile,Facile,0,Meme Difficulté,Adapte
6350,2020,Philosophie,1,Introduction a la Philosophie,6,La Raison,7,796,7,QCU,0.07,0.82,71.07,6,3,9,8,6,2,1.12,75.0,Facile,Facile,0,Meme Difficulté,Adapte
796,2015,Philosophie,1,Introduction a la Philosophie,7,La Verite,9,797,1,QCM,0.69,0.17,32.43,19,40,59,45,19,26,1.31,42.22,Facile,Difficile,-2,Beaucoup plus Difficile,Pas Adapte
1907,2016,Philosophie,1,Introduction a la Philosophie,7,La Verite,9,797,1,QCM,0.13,0.75,75.66,51,16,67,59,51,8,1.14,86.44,Facile,Facile,0,Meme Difficulté,Pas Adapte
3018,2017,Philosophie,1,Introduction a la Philosophie,7,La Verite,9,797,1,QCM,0.43,0.36,62.59,44,26,70,47,44,3,1.49,93.62,Difficile,Moyen,1,Plus Facile,Pas Adapte
4129,2018,Philosophie,1,Introduction a la Philosophie,7,La Verite,9,797,1,QCM,0.61,0.15,27.16,18,48,66,25,18,7,2.64,72.0,Difficile,Difficile,0,Meme Difficulté,Pas Adapte
5240,2019,Philosophie,1,Introduction a la Philosophie,7,La Verite,9,797,1,QCM,0.21,0.48,48.46,27,29,56,30,27,3,1.87,90.0,Moyen,Moyen,0,Meme Difficulté,Pas Adapte
6351,2020,Philosophie,1,Introduction a la Philosophie,7,La Verite,9,797,1,QCM,0.28,0.52,50.14,26,26,52,32,26,6,1.62,81.25,Facile,Moyen,-1,Plus Difficile,Pas Adapte
797,2015,Philosophie,1,Introduction a la Philosophie,7,La Verite,9,798,2,QO,0.14,0.66,96.56,93,3,96,94,93,1,1.02,98.94,Facile,Facile,0,Meme Difficulté,Pas Adapte
1908,2016,Philosophie,1,Introduction a la Philosophie,7,La Verite,9,798,2,QO,0.09,0.39,80.69,80,19,99,86,80,6,1.15,93.02,Facile,Facile,0,Meme Difficulté,Pas Adapte
3019,2017,Philosophie,1,Introduction a la Philosophie,7,La Verite,9,798,2,QO,0.84,0.08,30.45,28,64,92,63,28,35,1.46,44.44,Difficile,Difficile,0,Meme Difficulté,Pas Adapte
4130,2018,Philosophie,1,Introduction a la Philosophie,7,La Verite,9,798,2,QO,0.64,0.19,58.04,56,41,97,71,56,15,1.37,78.87,Moyen,Moyen,0,Meme Difficulté,Pas Adapte
5241,2019,Philosophie,1,Introduction a la Philosophie,7,La Verite,9,798,2,QO,0.83,0.13,34.36,32,62,94,64,32,32,1.47,50.0,Facile,Difficile,-2,Beaucoup plus Difficile,Pas Adapte
6352,2020,Philosophie,1,Introduction a la Philosophie,7,La Verite,9,798,2,QO,0.95,0.08,21.47,17,64,81,60,17,43,1.35,28.33,Difficile,Difficile,0,Meme Difficulté,Pas Adapte
798,2015,Philosophie,1,Introduction a la Philosophie,7,La Verite,9,799,3,QCM,0.57,0.28,32.04,7,16,23,16,7,9,1.44,43.75,Facile,Difficile,-2,Beaucoup plus Difficile,Pas Adapte
1909,2016,Philosophie,1,Introduction a la Philosophie,7,La Verite,9,799,3,QCM,0.55,0.18,9.48,2,21,23,8,2,6,2.88,25.0,Facile,Difficile,-2,Beaucoup plus Difficile,Pas Adapte
3020,2017,Philosophie,1,Introduction a la Philosophie,7,La Verite,9,799,3,QCM,0.36,0.66,64.76,14,8,22,15,14,1,1.47,93.33,Moyen,Moyen,0,Meme Difficulté,Pas Adapte
4131,2018,Philosophie,1,Introduction a la Philosophie,7,La Verite,9,799,3,QCM,0.02,0.94,77.82,16,5,21,16,16,0,1.31,100.0,Moyen,Facile,1,Plus Facile,Pas Adapte
5242,2019,Philosophie,1,Introduction a la Philosophie,7,La Verite,9,799,3,QCM,0.49,0.52,62.78,11,7,18,17,11,6,1.06,64.71,Difficile,Moyen,1,Plus Facile,Pas Adapte
6353,2020,Philosophie,1,Introduction a la Philosophie,7,La Verite,9,799,3,QCM,0.37,0.61,40.77,8,11,19,18,8,10,1.06,44.44,Difficile,Moyen,1,Plus Facile,Pas Adapte
799,2015,Philosophie,1,Introduction a la Philosophie,7,La Verite,9,800,4,QCM,0.53,0.27,10.46,7,64,71,37,7,30,1.92,18.92,Difficile,Difficile,0,Meme Difficulté,Pas Adapte
1910,2016,Philosophie,1,Introduction a la Philosophie,7,La Verite,9,800,4,QCM,0.66,0.21,8.6,6,64,70,60,6,54,1.17,10.0,Facile,Difficile,-2,Beaucoup plus Difficile,Pas Adapte
3021,2017,Philosophie,1,Introduction a la Philosophie,7,La Verite,9,800,4,QCM,0.34,0.39,37.33,29,49,78,65,29,36,1.2,44.62,Facile,Moyen,-1,Plus Difficile,Pas Adapte
4132,2018,Philosophie,1,Introduction a la Philosophie,7,La Verite,9,800,4,QCM,0.03,1.0,76.09,55,17,72,59,55,4,1.22,93.22,Difficile,Facile,2,Beaucoup plus Facile,Pas Adapte
5243,2019,Philosophie,1,Introduction a la Philosophie,7,La Verite,9,800,4,QCM,0.25,0.4,40.8,34,49,83,49,34,15,1.69,69.39,Difficile,Moyen,1,Plus Facile,Pas Adapte
6354,2020,Philosophie,1,Introduction a la Philosophie,7,La Verite,9,800,4,QROC,0.08,0.52,75.15,60,20,80,73,60,13,1.1,82.19,Facile,Facile,0,Meme Difficulté,Pas Adapte
800,2015,Philosophie,1,Introduction a la Philosophie,7,La Verite,9,801,5,QCU,0.07,0.84,70.32,22,9,31,28,22,6,1.11,78.57,Difficile,Facile,2,Beaucoup plus Facile,Adapte
1911,2016,Philosophie,1,Introduction a la Philosophie,7,La Verite,9,801,5,QCU,0.03,0.84,70.32,18,8,26,20,18,2,1.3,90.0,Facile,Facile,0,Meme Difficulté,Adapte
3022,2017,Philosophie,1,Introduction a la Philosophie,7,La Verite,9,801,5,QCU,0.16,0.78,70.32,16,7,23,20,16,4,1.15,80.0,Facile,Facile,0,Meme Difficulté,Adapte
4133,2018,Philosophie,1,Introduction a la Philosophie,7,La Verite,9,801,5,QCU,0.12,0.79,70.32,16,7,23,19,16,3,1.21,84.21,Facile,Facile,0,Meme Difficulté,Adapte
5244,2019,Philosophie,1,Introduction a la Philosophie,7,La Verite,9,801,5,QCU,0.13,0.98,70.32,17,7,24,23,17,6,1.04,73.91,Facile,Facile,0,Meme Difficulté,Adapte
6355,2020,Philosophie,1,Introduction a la Philosophie,7,La Verite,9,801,5,QCU,0.06,0.9,70.32,18,7,25,20,18,2,1.25,90.0,Facile,Facile,0,Meme Difficulté,Adapte
801,2015,Philosophie,1,Introduction a la Philosophie,7,La Verite,9,802,6,QCU,0.2,0.81,66.05,18,9,27,22,18,4,1.23,81.82,Facile,Facile,0,Meme Difficulté,Adapte
1912,2016,Philosophie,1,Introduction a la Philosophie,7,La Verite,9,802,6,QCU,0.18,0.75,66.05,17,8,25,21,17,4,1.19,80.95,Facile,Facile,0,Meme Difficulté,Adapte
3023,2017,Philosophie,1,Introduction a la Philosophie,7,La Verite,9,802,6,QCU,0.09,0.78,66.05,17,9,26,19,17,2,1.37,89.47,Facile,Facile,0,Meme Difficulté,Adapte
4134,2018,Philosophie,1,Introduction a la Philosophie,7,La Verite,9,802,6,QCU,0.2,0.83,66.05,15,8,23,20,15,5,1.15,75.0,Facile,Facile,0,Meme Difficulté,Adapte
5245,2019,Philosophie,1,Introduction a la Philosophie,7,La Verite,9,802,6,QCU,0.19,0.83,66.05,17,9,26,21,17,4,1.24,80.95,Facile,Facile,0,Meme Difficulté,Adapte
6356,2020,Philosophie,1,Introduction a la Philosophie,7,La Verite,9,802,6,QCU,0.03,0.95,66.05,20,10,30,25,20,5,1.2,80.0,Facile,Facile,0,Meme Difficulté,Adapte
802,2015,Philosophie,1,Introduction a la Philosophie,7,La Verite,9,803,7,QCM,0.65,0.28,19.9,3,11,14,13,3,10,1.08,23.08,Difficile,Difficile,0,Meme Difficulté,Pas Adapte
1913,2016,Philosophie,1,Introduction a la Philosophie,7,La Verite,9,803,7,QCM,0.05,0.93,66.32,8,4,12,10,8,2,1.2,80.0,Moyen,Facile,1,Plus Facile,Adapte
3024,2017,Philosophie,1,Introduction a la Philosophie,7,La Verite,9,803,7,QCM,0.1,0.72,66.32,9,5,14,13,9,4,1.08,69.23,Facile,Facile,0,Meme Difficulté,Adapte
4135,2018,Philosophie,1,Introduction a la Philosophie,7,La Verite,9,803,7,QCU,0.01,0.98,66.32,11,5,16,11,11,0,1.45,100.0,Facile,Facile,0,Meme Difficulté,Adapte
5246,2019,Philosophie,1,Introduction a la Philosophie,7,La Verite,9,803,7,QCU,0.04,0.88,66.32,12,6,18,16,12,4,1.12,75.0,Facile,Facile,0,Meme Difficulté,Adapte
6357,2020,Philosophie,1,Introduction a la Philosophie,7,La Verite,9,803,7,QCU,0.1,0.78,66.32,13,6,19,18,13,5,1.06,72.22,Facile,Facile,0,Meme Difficulté,Adapte
803,2015,Philosophie,1,Introduction a la Philosophie,7,La Verite,9,804,8,QCU,0.25,0.67,39.39,3,5,8,4,3,1,2.0,75.0,Facile,Moyen,-1,Plus Difficile,Pas Adapte
1914,2016,Philosophie,1,Introduction a la Philosophie,7,La Verite,9,804,8,QCU,0.62,0.26,8.03,1,6,7,6,1,5,1.17,16.67,Facile,Difficile,-2,Beaucoup plus Difficile,Pas Adapte
3025,2017,Philosophie,1,Introduction a la Philosophie,7,La Verite,9,804,8,QCU,0.25,0.59,61.0,4,3,7,6,4,2,1.17,66.67,Difficile,Moyen,1,Plus Facile,Pas Adapte
4136,2018,Philosophie,1,Introduction a la Philosophie,7,La Verite,9,804,8,QCU,0.19,1.0,70.7,4,2,6,5,4,1,1.2,80.0,Moyen,Facile,1,Plus Facile,Adapte
5247,2019,Philosophie,1,Introduction a la Philosophie,7,La Verite,9,804,8,QCU,0.02,0.93,70.7,5,2,7,6,5,1,1.17,83.33,Facile,Facile,0,Meme Difficulté,Adapte
6358,2020,Philosophie,1,Introduction a la Philosophie,7,La Verite,9,804,8,QCU,0.2,0.78,70.7,6,2,8,6,6,0,1.33,100.0,Facile,Facile,0,Meme Difficulté,Adapte
804,2015,Philosophie,1,Introduction a la Philosophie,7,La Verite,9,805,9,QCU,0.0,0.92,96.17,21,1,22,22,21,1,1.0,95.45,Facile,Facile,0,Meme Difficulté,Pas Adapte
1915,2016,Philosophie,1,Introduction a la Philosophie,7,La Verite,9,805,9,QCU,0.06,0.87,68.38,15,7,22,19,15,4,1.16,78.95,Moyen,Facile,1,Plus Facile,Adapte
3026,2017,Philosophie,1,Introduction a la Philosophie,7,La Verite,9,805,9,QCU,0.16,0.92,68.38,14,7,21,20,14,6,1.05,70.0,Facile,Facile,0,Meme Difficulté,Adapte
4137,2018,Philosophie,1,Introduction a la Philosophie,7,La Verite,9,805,9,QCU,0.04,0.97,68.38,16,7,23,20,16,4,1.15,80.0,Facile,Facile,0,Meme Difficulté,Adapte
5248,2019,Philosophie,1,Introduction a la Philosophie,7,La Verite,9,805,9,QCU,0.2,0.8,68.38,16,8,24,19,16,3,1.26,84.21,Facile,Facile,0,Meme Difficulté,Adapte
6359,2020,Philosophie,1,Introduction a la Philosophie,7,La Verite,9,805,9,QCM,0.18,0.82,68.38,15,7,22,22,15,7,1.0,68.18,Facile,Facile,0,Meme Difficulté,Adapte
805,2015,Philosophie,1,Introduction a la Philosophie,8,La Conscience,9,806,1,QCM,0.02,0.98,96.93,47,1,48,47,47,0,1.02,100.0,Facile,Facile,0,Meme Difficulté,Pas Adapte
1916,2016,Philosophie,1,Introduction a la Philosophie,8,La Conscience,9,806,1,QCM,0.27,0.44,37.29,19,32,51,39,19,20,1.31,48.72,Facile,Moyen,-1,Plus Difficile,Pas Adapte
3027,2017,Philosophie,1,Introduction a la Philosophie,8,La Conscience,9,806,1,QCM,0.67,0.3,26.95,12,31,43,36,12,24,1.19,33.33,Moyen,Difficile,-1,Plus Difficile,Pas Adapte
4138,2018,Philosophie,1,Introduction a la Philosophie,8,La Conscience,9,806,1,QCM,0.09,0.93,73.65,35,12,47,45,35,10,1.04,77.78,Difficile,Facile,2,Beaucoup plus Facile,Adapte
5249,2019,Philosophie,1,Introduction a la Philosophie,8,La Conscience,9,806,1,QCM,0.03,0.73,73.65,38,14,52,48,38,10,1.08,79.17,Facile,Facile,0,Meme Difficulté,Adapte
6360,2020,Philosophie,1,Introduction a la Philosophie,8,La Conscience,9,806,1,QCM,0.03,0.81,73.65,41,14,55,53,41,12,1.04,77.36,Facile,Facile,0,Meme Difficulté,Adapte
806,2015,Philosophie,1,Introduction a la Philosophie,8,La Conscience,9,807,2,QCU,0.02,0.9,87.26,45,7,52,46,45,1,1.13,97.83,Facile,Facile,0,Meme Difficulté,Pas Adapte
1917,2016,Philosophie,1,Introduction a la Philosophie,8,La Conscience,9,807,2,QCU,0.37,0.7,64.16,30,16,46,33,30,3,1.39,90.91,Difficile,Moyen,1,Plus Facile,Pas Adapte
3028,2017,Philosophie,1,Introduction a la Philosophie,8,La Conscience,9,807,2,QCU,0.0,0.81,99.24,42,0,42,42,42,0,1.0,100.0,Difficile,Facile,2,Beaucoup plus Facile,Pas Adapte
4139,2018,Philosophie,1,Introduction a la Philosophie,8,La Conscience,9,807,2,QCU,0.08,0.84,67.42,28,14,42,28,28,0,1.5,100.0,Facile,Facile,0,Meme Difficulté,Adapte
5250,2019,Philosophie,1,Introduction a la Philosophie,8,La Conscience,9,807,2,QCU,0.16,0.9,67.42,28,13,41,37,28,9,1.11,75.68,Facile,Facile,0,Meme Difficulté,Adapte
6361,2020,Philosophie,1,Introduction a la Philosophie,8,La Conscience,9,807,2,QCU,0.14,0.76,67.42,26,12,38,26,26,0,1.46,100.0,Facile,Facile,0,Meme Difficulté,Adapte
807,2015,Philosophie,1,Introduction a la Philosophie,8,La Conscience,9,808,3,QCU,0.65,0.36,28.28,10,25,35,34,10,24,1.03,29.41,Facile,Difficile,-2,Beaucoup plus Difficile,Pas Adapte
1918,2016,Philosophie,1,Introduction a la Philosophie,8,La Conscience,9,808,3,QO,0.67,0.18,45.29,14,16,30,15,14,1,2.0,93.33,Difficile,Moyen,1,Plus Facile,Pas Adapte
3029,2017,Philosophie,1,Introduction a la Philosophie,8,La Conscience,9,808,3,QO,0.67,0.29,43.35,11,15,26,24,11,13,1.08,45.83,Difficile,Moyen,1,Plus Facile,Pas Adapte
4140,2018,Philosophie,1,Introduction a la Philosophie,8,La Conscience,9,808,3,QO,0.84,0.03,18.88,5,21,26,18,5,13,1.44,27.78,Moyen,Difficile,-1,Plus Difficile,Pas Adapte
5251,2019,Philosophie,1,Introduction a la Philosophie,8,La Conscience,9,808,3,QO,0.24,0.3,53.26,12,11,23,14,12,2,1.64,85.71,Difficile,Moyen,1,Plus Facile,Pas Adapte
6362,2020,Philosophie,1,Introduction a la Philosophie,8,La Conscience,9,808,3,QO,0.97,0.03,2.18,1,24,25,19,1,18,1.32,5.26,Moyen,Difficile,-1,Plus Difficile,Pas Adapte
808,2015,Philosophie,1,Introduction a la Philosophie,8,La Conscience,9,809,4,QROC,0.46,0.4,43.85,34,44,78,38,34,4,2.05,89.47,Facile,Moyen,-1,Plus Difficile,Pas Adapte
1919,2016,Philosophie,1,Introduction a la Philosophie,8,La Conscience,9,809,4,QO,0.09,0.85,81.46,73,16,89,77,73,4,1.16,94.81,Facile,Facile,0,Meme Difficulté,Pas Adapte
3030,2017,Philosophie,1,Introduction a la Philosophie,8,La Conscience,9,809,4,QO,0.0,0.53,98.82,88,1,89,89,88,1,1.0,98.88,Difficile,Facile,2,Beaucoup plus Facile,Pas Adapte
4141,2018,Philosophie,1,Introduction a la Philosophie,8,La Conscience,9,809,4,QROC,0.8,0.03,7.89,6,74,80,49,6,43,1.63,12.24,Difficile,Difficile,0,Meme Difficulté,Pas Adapte
5252,2019,Philosophie,1,Introduction a la Philosophie,8,La Conscience,9,809,4,QROC,0.27,0.29,54.99,46,38,84,73,46,27,1.15,63.01,Facile,Moyen,-1,Plus Difficile,Pas Adapte
6363,2020,Philosophie,1,Introduction a la Philosophie,8,La Conscience,9,809,4,QO,0.38,0.25,43.62,38,49,87,80,38,42,1.09,47.5,Moyen,Moyen,0,Meme Difficulté,Pas Adapte
809,2015,Philosophie,1,Introduction a la Philosophie,8,La Conscience,9,810,5,QCU,0.71,0.29,12.27,3,21,24,10,3,7,2.4,30.0,Moyen,Difficile,-1,Plus Difficile,Pas Adapte
1920,2016,Philosophie,1,Introduction a la Philosophie,8,La Conscience,9,810,5,QCU,0.31,0.64,52.32,12,10,22,16,12,4,1.38,75.0,Facile,Moyen,-1,Plus Difficile,Pas Adapte
3031,2017,Philosophie,1,Introduction a la Philosophie,8,La Conscience,9,810,5,QCU,0.39,0.62,59.68,13,8,21,14,13,1,1.5,92.86,Moyen,Moyen,0,Meme Difficulté,Pas Adapte
4142,2018,Philosophie,1,Introduction a la Philosophie,8,La Conscience,9,810,5,QCU,0.18,0.9,95.51,23,1,24,24,23,1,1.0,95.83,Moyen,Facile,1,Plus Facile,Pas Adapte
5253,2019,Philosophie,1,Introduction a la Philosophie,8,La Conscience,9,810,5,QCU,0.06,0.83,75.98,17,5,22,19,17,2,1.16,89.47,Difficile,Facile,2,Beaucoup plus Facile,Pas Adapte
6364,2020,Philosophie,1,Introduction a la Philosophie,8,La Conscience,9,810,5,QCU,0.1,0.92,78.7,17,4,21,21,17,4,1.0,80.95,Difficile,Facile,2,Beaucoup plus Facile,Pas Adapte
810,2015,Philosophie,1,Introduction a la Philosophie,8,La Conscience,9,811,6,QROC,0.44,0.27,61.19,61,39,100,83,61,22,1.2,73.49,Difficile,Moyen,1,Plus Facile,Pas Adapte
1921,2016,Philosophie,1,Introduction a la Philosophie,8,La Conscience,9,811,6,QROC,0.28,0.4,63.98,70,40,110,98,70,28,1.12,71.43,Difficile,Moyen,1,Plus Facile,Pas Adapte
3032,2017,Philosophie,1,Introduction a la Philosophie,8,La Conscience,9,811,6,QROC,0.7,0.14,23.58,29,92,121,108,29,79,1.12,26.85,Facile,Difficile,-2,Beaucoup plus Difficile,Pas Adapte
4143,2018,Philosophie,1,Introduction a la Philosophie,8,La Conscience,9,811,6,QROC,0.05,0.73,90.3,109,12,121,116,109,7,1.04,93.97,Difficile,Facile,2,Beaucoup plus Facile,Pas Adapte
5254,2019,Philosophie,1,Introduction a la Philosophie,8,La Conscience,9,811,6,QROC,0.14,0.76,81.51,112,25,137,133,112,21,1.03,84.21,Difficile,Facile,2,Beaucoup plus Facile,Pas Adapte
6365,2020,Philosophie,1,Introduction a la Philosophie,8,La Conscience,9,811,6,QROC,0.77,0.12,21.03,26,99,125,54,26,28,2.31,48.15,Moyen,Difficile,-1,Plus Difficile,Pas Adapte
811,2015,Philosophie,1,Introduction a la Philosophie,8,La Conscience,9,812,7,QCM,0.24,0.63,39.33,34,52,86,81,34,47,1.06,41.98,Moyen,Moyen,0,Meme Difficulté,Pas Adapte
1922,2016,Philosophie,1,Introduction a la Philosophie,8,La Conscience,9,812,7,QCM,0.27,0.62,49.53,48,48,96,56,48,8,1.71,85.71,Difficile,Moyen,1,Plus Facile,Pas Adapte
3033,2017,Philosophie,1,Introduction a la Philosophie,8,La Conscience,9,812,7,QCM,0.28,0.6,49.95,46,46,92,47,46,1,1.96,97.87,Moyen,Moyen,0,Meme Difficulté,Pas Adapte
4144,2018,Philosophie,1,Introduction a la Philosophie,8,La Conscience,9,812,7,QCM,0.14,0.98,79.84,69,17,86,81,69,12,1.06,85.19,Difficile,Facile,2,Beaucoup plus Facile,Pas Adapte
5255,2019,Philosophie,1,Introduction a la Philosophie,8,La Conscience,9,812,7,QCM,0.39,0.68,37.56,31,51,82,56,31,25,1.46,55.36,Facile,Moyen,-1,Plus Difficile,Pas Adapte
6366,2020,Philosophie,1,Introduction a la Philosophie,8,La Conscience,9,812,7,QCU,0.44,0.39,13.61,13,79,92,62,13,49,1.48,20.97,Moyen,Difficile,-1,Plus Difficile,Pas Adapte
812,2015,Philosophie,1,Introduction a la Philosophie,8,La Conscience,9,813,8,QCM,0.68,0.28,26.84,7,20,27,26,7,19,1.04,26.92,Moyen,Difficile,-1,Plus Difficile,Pas Adapte
1923,2016,Philosophie,1,Introduction a la Philosophie,8,La Conscience,9,813,8,QCM,0.28,0.62,49.0,15,16,31,16,15,1,1.94,93.75,Facile,Moyen,-1,Plus Difficile,Pas Adapte
3034,2017,Philosophie,1,Introduction a la Philosophie,8,La Conscience,9,813,8,QCM,0.75,0.3,10.59,4,30,34,34,4,30,1.0,11.76,Facile,Difficile,-2,Beaucoup plus Difficile,Pas Adapte
4145,2018,Philosophie,1,Introduction a la Philosophie,8,La Conscience,9,813,8,QCU,0.09,0.94,95.95,28,1,29,29,28,1,1.0,96.55,Difficile,Facile,2,Beaucoup plus Facile,Pas Adapte
5256,2019,Philosophie,1,Introduction a la Philosophie,8,La Conscience,9,813,8,QCU,0.17,1.0,89.42,26,3,29,27,26,1,1.07,96.3,Difficile,Facile,2,Beaucoup plus Facile,Pas Adapte
6367,2020,Philosophie,1,Introduction a la Philosophie,8,La Conscience,9,813,8,QCU,0.75,0.27,16.51,5,28,33,29,5,24,1.14,17.24,Moyen,Difficile,-1,Plus Difficile,Pas Adapte
813,2015,Philosophie,1,Introduction a la Philosophie,8,La Conscience,9,814,9,QCM,0.18,0.92,97.28,37,1,38,38,37,1,1.0,97.37,Facile,Facile,0,Meme Difficulté,Pas Adapte
1924,2016,Philosophie,1,Introduction a la Philosophie,8,La Conscience,9,814,9,QCM,0.2,0.95,88.22,28,4,32,28,28,0,1.14,100.0,Facile,Facile,0,Meme Difficulté,Pas Adapte
3035,2017,Philosophie,1,Introduction a la Philosophie,8,La Conscience,9,814,9,QCU,0.38,0.63,47.25,15,16,31,24,15,9,1.29,62.5,Moyen,Moyen,0,Meme Difficulté,Pas Adapte
4146,2018,Philosophie,1,Introduction a la Philosophie,8,La Conscience,9,814,9,QCU,0.65,0.22,33.44,10,21,31,30,10,20,1.03,33.33,Difficile,Difficile,0,Meme Difficulté,Pas Adapte
5257,2019,Philosophie,1,Introduction a la Philosophie,8,La Conscience,9,814,9,QROC,0.26,0.31,49.95,13,14,27,22,13,9,1.23,59.09,Difficile,Moyen,1,Plus Facile,Pas Adapte
6368,2020,Philosophie,1,Introduction a la Philosophie,8,La Conscience,9,814,9,QROC,0.62,0.0,21.16,6,22,28,17,6,11,1.65,35.29,Difficile,Difficile,0,Meme Difficulté,Pas Adapte
814,2015,Philosophie,1,Introduction a la Philosophie,9,La Liberte,5,815,1,QCU,0.22,0.52,63.49,13,8,21,18,13,5,1.17,72.22,Facile,Moyen,-1,Plus Difficile,Pas Adapte
1925,2016,Philosophie,1,Introduction a la Philosophie,9,La Liberte,5,815,1,QCU,0.51,0.31,14.94,3,20,23,9,3,6,2.56,33.33,Difficile,Difficile,0,Meme Difficulté,Pas Adapte
3036,2017,Philosophie,1,Introduction a la Philosophie,9,La Liberte,5,815,1,QCU,0.03,0.77,81.58,16,4,20,18,16,2,1.11,88.89,Difficile,Facile,2,Beaucoup plus Facile,Pas Adapte
4147,2018,Philosophie,1,Introduction a la Philosophie,9,La Liberte,5,815,1,QCU,0.51,0.29,24.68,5,17,22,11,5,6,2.0,45.45,Difficile,Difficile,0,Meme Difficulté,Pas Adapte
5258,2019,Philosophie,1,Introduction a la Philosophie,9,La Liberte,5,815,1,QCU,0.32,0.64,57.94,14,10,24,24,14,10,1.0,58.33,Difficile,Moyen,1,Plus Facile,Pas Adapte
6369,2020,Philosophie,1,Introduction a la Philosophie,9,La Liberte,5,815,1,QCU,0.65,0.23,32.63,7,14,21,13,7,6,1.62,53.85,Moyen,Difficile,-1,Plus Difficile,Pas Adapte
815,2015,Philosophie,1,Introduction a la Philosophie,9,La Liberte,5,816,2,QCU,0.08,0.83,92.73,66,5,71,68,66,2,1.04,97.06,Facile,Facile,0,Meme Difficulté,Pas Adapte
1926,2016,Philosophie,1,Introduction a la Philosophie,9,La Liberte,5,816,2,QCU,0.58,0.33,17.62,13,59,72,41,13,28,1.76,31.71,Facile,Difficile,-2,Beaucoup plus Difficile,Pas Adapte
3037,2017,Philosophie,1,Introduction a la Philosophie,9,La Liberte,5,816,2,QCM,0.25,0.48,40.15,24,37,61,56,24,32,1.09,42.86,Moyen,Moyen,0,Meme Difficulté,Pas Adapte
4148,2018,Philosophie,1,Introduction a la Philosophie,9,La Liberte,5,816,2,QCM,0.25,0.52,43.09,27,36,63,43,27,16,1.47,62.79,Facile,Moyen,-1,Plus Difficile,Pas Adapte
5259,2019,Philosophie,1,Introduction a la Philosophie,9,La Liberte,5,816,2,QCM,0.2,0.54,51.31,37,35,72,42,37,5,1.71,88.1,Facile,Moyen,-1,Plus Difficile,Pas Adapte
6370,2020,Philosophie,1,Introduction a la Philosophie,9,La Liberte,5,816,2,QCM,0.41,0.44,64.03,44,24,68,66,44,22,1.03,66.67,Facile,Moyen,-1,Plus Difficile,Pas Adapte
816,2015,Philosophie,1,Introduction a la Philosophie,9,La Liberte,5,817,3,QCM,0.03,0.74,74.3,42,14,56,44,42,2,1.27,95.45,Difficile,Facile,2,Beaucoup plus Facile,Adapte
1927,2016,Philosophie,1,Introduction a la Philosophie,9,La Liberte,5,817,3,QCU,0.06,0.84,74.3,39,14,53,40,39,1,1.32,97.5,Facile,Facile,0,Meme Difficulté,Adapte
3038,2017,Philosophie,1,Introduction a la Philosophie,9,La Liberte,5,817,3,QCU,0.07,0.79,74.3,38,13,51,50,38,12,1.02,76.0,Facile,Facile,0,Meme Difficulté,Adapte
4149,2018,Philosophie,1,Introduction a la Philosophie,9,La Liberte,5,817,3,QCU,0.03,0.89,74.3,39,13,52,50,39,11,1.04,78.0,Facile,Facile,0,Meme Difficulté,Adapte
5260,2019,Philosophie,1,Introduction a la Philosophie,9,La Liberte,5,817,3,QCU,0.19,0.82,74.3,41,14,55,52,41,11,1.06,78.85,Facile,Facile,0,Meme Difficulté,Adapte
6371,2020,Philosophie,1,Introduction a la Philosophie,9,La Liberte,5,817,3,QCU,0.12,0.97,74.3,39,13,52,39,39,0,1.33,100.0,Facile,Facile,0,Meme Difficulté,Adapte
817,2015,Philosophie,1,Introduction a la Philosophie,9,La Liberte,5,818,4,QROC,0.2,0.28,51.81,42,40,82,59,42,17,1.39,71.19,Facile,Moyen,-1,Plus Difficile,Pas Adapte
1928,2016,Philosophie,1,Introduction a la Philosophie,9,La Liberte,5,818,4,QROC,0.11,0.66,70.66,66,28,94,73,66,7,1.29,90.41,Difficile,Facile,2,Beaucoup plus Facile,Adapte
3039,2017,Philosophie,1,Introduction a la Philosophie,9,La Liberte,5,818,4,QROC,0.14,0.64,70.66,69,29,98,94,69,25,1.04,73.4,Facile,Facile,0,Meme Difficulté,Adapte
4150,2018,Philosophie,1,Introduction a la Philosophie,9,La Liberte,5,818,4,QROC,0.15,0.9,70.66,78,32,110,105,78,27,1.05,74.29,Facile,Facile,0,Meme Difficulté,Adapte
5261,2019,Philosophie,1,Introduction a la Philosophie,9,La Liberte,5,818,4,QROC,0.08,0.84,70.66,73,30,103,89,73,16,1.16,82.02,Facile,Facile,0,Meme Difficulté,Adapte
6372,2020,Philosophie,1,Introduction a la Philosophie,9,La Liberte,5,818,4,QCM,0.11,0.78,70.66,63,26,89,88,63,25,1.01,71.59,Facile,Facile,0,Meme Difficulté,Adapte
818,2015,Philosophie,1,Introduction a la Philosophie,9,La Liberte,5,819,5,QROC,0.18,0.49,86.47,16,2,18,17,16,1,1.06,94.12,Difficile,Facile,2,Beaucoup plus Facile,Pas Adapte
1929,2016,Philosophie,1,Introduction a la Philosophie,9,La Liberte,5,819,5,QROC,0.48,0.32,59.3,12,8,20,18,12,6,1.11,66.67,Moyen,Moyen,0,Meme Difficulté,Pas Adapte
3040,2017,Philosophie,1,Introduction a la Philosophie,9,La Liberte,5,819,5,QROC,0.14,0.82,66.4,13,6,19,18,13,5,1.06,72.22,Moyen,Facile,1,Plus Facile,Adapte
4151,2018,Philosophie,1,Introduction a la Philosophie,9,La Liberte,5,819,5,QROC,0.01,0.7,66.4,11,6,17,16,11,5,1.06,68.75,Facile,Facile,0,Meme Difficulté,Adapte
5262,2019,Philosophie,1,Introduction a la Philosophie,9,La Liberte,5,819,5,QO,0.04,0.48,66.4,12,6,18,15,12,3,1.2,80.0,Facile,Facile,0,Meme Difficulté,Adapte
6373,2020,Philosophie,1,Introduction a la Philosophie,9,La Liberte,5,819,5,QCM,0.0,0.87,66.4,11,6,17,16,11,5,1.06,68.75,Facile,Facile,0,Meme Difficulté,Adapte
819,2015,Philosophie,2,La Notion de Logique,1,Les Lois Logiques,9,820,1,QCU,0.04,0.77,84.14,34,6,40,37,34,3,1.08,91.89,Facile,Facile,0,Meme Difficulté,Pas Adapte
1930,2016,Philosophie,2,La Notion de Logique,1,Les Lois Logiques,9,820,1,QCU,0.48,0.28,22.75,8,26,34,22,8,14,1.55,36.36,Moyen,Difficile,-1,Plus Difficile,Pas Adapte
3041,2017,Philosophie,2,La Notion de Logique,1,Les Lois Logiques,9,820,1,QCU,0.03,0.86,84.09,31,6,37,33,31,2,1.12,93.94,Facile,Facile,0,Meme Difficulté,Pas Adapte
4152,2018,Philosophie,2,La Notion de Logique,1,Les Lois Logiques,9,820,1,QCU,0.04,0.8,99.7,40,0,40,40,40,0,1.0,100.0,Difficile,Facile,2,Beaucoup plus Facile,Pas Adapte
5263,2019,Philosophie,2,La Notion de Logique,1,Les Lois Logiques,9,820,1,QCU,0.1,0.85,82.73,34,7,41,36,34,2,1.14,94.44,Moyen,Facile,1,Plus Facile,Pas Adapte
6374,2020,Philosophie,2,La Notion de Logique,1,Les Lois Logiques,9,820,1,QCU,0.05,0.78,97.28,35,1,36,36,35,1,1.0,97.22,Moyen,Facile,1,Plus Facile,Pas Adapte
820,2015,Philosophie,2,La Notion de Logique,1,Les Lois Logiques,9,821,2,QCU,0.08,0.81,81.63,34,8,42,40,34,6,1.05,85.0,Facile,Facile,0,Meme Difficulté,Pas Adapte
1931,2016,Philosophie,2,La Notion de Logique,1,Les Lois Logiques,9,821,2,QCU,0.18,0.8,85.07,40,7,47,46,40,6,1.02,86.96,Difficile,Facile,2,Beaucoup plus Facile,Pas Adapte
3042,2017,Philosophie,2,La Notion de Logique,1,Les Lois Logiques,9,821,2,QCU,0.45,0.39,11.38,6,48,54,51,6,45,1.06,11.76,Moyen,Difficile,-1,Plus Difficile,Pas Adapte
4153,2018,Philosophie,2,La Notion de Logique,1,Les Lois Logiques,9,821,2,QCU,0.17,0.9,84.35,44,8,52,46,44,2,1.13,95.65,Facile,Facile,0,Meme Difficulté,Pas Adapte
5264,2019,Philosophie,2,La Notion de Logique,1,Les Lois Logiques,9,821,2,QROC,0.85,0.13,21.77,11,38,49,26,11,15,1.88,42.31,Facile,Difficile,-2,Beaucoup plus Difficile,Pas Adapte
6375,2020,Philosophie,2,La Notion de Logique,1,Les Lois Logiques,9,821,2,QO,0.56,0.22,40.4,21,31,52,30,21,9,1.73,70.0,Difficile,Moyen,1,Plus Facile,Pas Adapte
821,2015,Philosophie,2,La Notion de Logique,1,Les Lois Logiques,9,822,3,QCM,0.58,0.18,29.48,24,58,82,58,24,34,1.41,41.38,Moyen,Difficile,-1,Plus Difficile,Pas Adapte
1932,2016,Philosophie,2,La Notion de Logique,1,Les Lois Logiques,9,822,3,QCM,0.3,0.39,38.8,32,50,82,48,32,16,1.71,66.67,Moyen,Moyen,0,Meme Difficulté,Pas Adapte
3043,2017,Philosophie,2,La Notion de Logique,1,Les Lois Logiques,9,822,3,QCM,0.08,0.73,91.99,72,6,78,72,72,0,1.08,100.0,Difficile,Facile,2,Beaucoup plus Facile,Pas Adapte
4154,2018,Philosophie,2,La Notion de Logique,1,Les Lois Logiques,9,822,3,QCM,0.51,0.27,13.78,10,65,75,43,10,33,1.74,23.26,Moyen,Difficile,-1,Plus Difficile,Pas Adapte
5265,2019,Philosophie,2,La Notion de Logique,1,Les Lois Logiques,9,822,3,QCM,0.14,0.79,71.85,58,23,81,63,58,5,1.29,92.06,Difficile,Facile,2,Beaucoup plus Facile,Adapte
6376,2020,Philosophie,2,La Notion de Logique,1,Les Lois Logiques,9,822,3,QCM,0.11,0.78,71.85,65,26,91,67,65,2,1.36,97.01,Facile,Facile,0,Meme Difficulté,Adapte
822,2015,Philosophie,2,La Notion de Logique,1,Les Lois Logiques,9,823,4,QCU,0.48,0.33,3.41,2,57,59,39,2,37,1.51,5.13,Facile,Difficile,-2,Beaucoup plus Difficile,Pas Adapte
1933,2016,Philosophie,2,La Notion de Logique,1,Les Lois Logiques,9,823,4,QCM,0.49,0.5,47.22,26,28,54,48,26,22,1.12,54.17,Facile,Moyen,-1,Plus Difficile,Pas Adapte
3044,2017,Philosophie,2,La Notion de Logique,1,Les Lois Logiques,9,823,4,QCM,0.13,0.78,66.1,37,19,56,52,37,15,1.08,71.15,Facile,Facile,0,Meme Difficulté,Adapte
4155,2018,Philosophie,2,La Notion de Logique,1,Les Lois Logiques,9,823,4,QCM,0.04,0.73,66.1,36,19,55,41,36,5,1.34,87.8,Facile,Facile,0,Meme Difficulté,Adapte
5266,2019,Philosophie,2,La Notion de Logique,1,Les Lois Logiques,9,823,4,QCM,0.17,0.95,66.1,40,21,61,47,40,7,1.3,85.11,Facile,Facile,0,Meme Difficulté,Adapte
6377,2020,Philosophie,2,La Notion de Logique,1,Les Lois Logiques,9,823,4,QROC,0.06,0.73,66.1,34,18,52,35,34,1,1.49,97.14,Facile,Facile,0,Meme Difficulté,Adapte
823,2015,Philosophie,2,La Notion de Logique,1,Les Lois Logiques,9,824,5,QROC,0.86,0.2,17.64,11,51,62,49,11,38,1.27,22.45,Moyen,Difficile,-1,Plus Difficile,Pas Adapte
1934,2016,Philosophie,2,La Notion de Logique,1,Les Lois Logiques,9,824,5,QROC,0.72,0.03,7.34,5,62,67,27,5,22,2.48,18.52,Difficile,Difficile,0,Meme Difficulté,Pas Adapte
3045,2017,Philosophie,2,La Notion de Logique,1,Les Lois Logiques,9,824,5,QO,0.84,0.06,16.54,12,62,74,52,12,40,1.42,23.08,Moyen,Difficile,-1,Plus Difficile,Pas Adapte
4156,2018,Philosophie,2,La Notion de Logique,1,Les Lois Logiques,9,824,5,QROC,0.1,0.59,76.61,48,15,63,51,48,3,1.24,94.12,Facile,Facile,0,Meme Difficulté,Pas Adapte
5267,2019,Philosophie,2,La Notion de Logique,1,Les Lois Logiques,9,824,5,QROC,0.63,0.1,29.35,16,40,56,23,16,7,2.43,69.57,Difficile,Difficile,0,Meme Difficulté,Pas Adapte
6378,2020,Philosophie,2,La Notion de Logique,1,Les Lois Logiques,9,824,5,QROC,0.12,0.93,74.97,46,16,62,56,46,10,1.11,82.14,Facile,Facile,0,Meme Difficulté,Adapte
824,2015,Philosophie,2,La Notion de Logique,1,Les Lois Logiques,9,825,6,QCM,0.57,0.24,32.61,23,46,69,50,23,27,1.38,46.0,Facile,Difficile,-2,Beaucoup plus Difficile,Pas Adapte
1935,2016,Philosophie,2,La Notion de Logique,1,Les Lois Logiques,9,825,6,QCM,0.61,0.3,2.11,1,65,66,22,1,21,3.0,4.55,Difficile,Difficile,0,Meme Difficulté,Pas Adapte
3046,2017,Philosophie,2,La Notion de Logique,1,Les Lois Logiques,9,825,6,QCM,0.37,0.51,50.07,28,28,56,47,28,19,1.19,59.57,Moyen,Moyen,0,Meme Difficulté,Pas Adapte
4157,2018,Philosophie,2,La Notion de Logique,1,Les Lois Logiques,9,825,6,QCU,0.28,0.72,58.44,32,23,55,40,32,8,1.38,80.0,Difficile,Moyen,1,Plus Facile,Pas Adapte
5268,2019,Philosophie,2,La Notion de Logique,1,Les Lois Logiques,9,825,6,QCU,0.13,0.83,78.72,44,12,56,51,44,7,1.1,86.27,Difficile,Facile,2,Beaucoup plus Facile,Pas Adapte
6379,2020,Philosophie,2,La Notion de Logique,1,Les Lois Logiques,9,825,6,QCM,0.77,0.22,26.45,15,40,55,39,15,24,1.41,38.46,Moyen,Difficile,-1,Plus Difficile,Pas Adapte
825,2015,Philosophie,2,La Notion de Logique,1,Les Lois Logiques,9,826,7,QCU,0.23,0.51,56.4,19,14,33,20,19,1,1.65,95.0,Facile,Moyen,-1,Plus Difficile,Pas Adapte
1936,2016,Philosophie,2,La Notion de Logique,1,Les Lois Logiques,9,826,7,QCU,0.09,0.97,68.18,25,12,37,32,25,7,1.16,78.12,Difficile,Facile,2,Beaucoup plus Facile,Adapte
3047,2017,Philosophie,2,La Notion de Logique,1,Les Lois Logiques,9,826,7,QCU,0.1,0.8,68.18,27,12,39,31,27,4,1.26,87.1,Facile,Facile,0,Meme Difficulté,Adapte
4158,2018,Philosophie,2,La Notion de Logique,1,Les Lois Logiques,9,826,7,QCU,0.06,0.85,68.18,24,11,35,26,24,2,1.35,92.31,Facile,Facile,0,Meme Difficulté,Adapte
5269,2019,Philosophie,2,La Notion de Logique,1,Les Lois Logiques,9,826,7,QCU,0.05,0.99,68.18,25,12,37,35,25,10,1.06,71.43,Facile,Facile,0,Meme Difficulté,Adapte
6380,2020,Philosophie,2,La Notion de Logique,1,Les Lois Logiques,9,826,7,QCU,0.17,0.77,68.18,23,11,34,25,23,2,1.36,92.0,Facile,Facile,0,Meme Difficulté,Adapte
826,2015,Philosophie,2,La Notion de Logique,1,Les Lois Logiques,9,827,8,QCM,0.57,0.19,7.45,1,6,7,5,1,4,1.4,20.0,Facile,Difficile,-2,Beaucoup plus Difficile,Pas Adapte
1937,2016,Philosophie,2,La Notion de Logique,1,Les Lois Logiques,9,827,8,QCU,0.75,0.29,26.5,2,4,6,5,2,3,1.2,40.0,Difficile,Difficile,0,Meme Difficulté,Pas Adapte
3048,2017,Philosophie,2,La Notion de Logique,1,Les Lois Logiques,9,827,8,QCU,0.55,0.26,26.36,1,4,5,4,1,3,1.25,25.0,Facile,Difficile,-2,Beaucoup plus Difficile,Pas Adapte
4159,2018,Philosophie,2,La Notion de Logique,1,Les Lois Logiques,9,827,8,QCU,0.03,0.97,95.53,4,0,4,4,4,0,1.0,100.0,Moyen,Facile,1,Plus Facile,Pas Adapte
5270,2019,Philosophie,2,La Notion de Logique,1,Les Lois Logiques,9,827,8,QCU,0.1,0.99,78.12,2,1,3,3,2,1,1.0,66.67,Moyen,Facile,1,Plus Facile,Pas Adapte
6381,2020,Philosophie,2,La Notion de Logique,1,Les Lois Logiques,9,827,8,QCU,0.36,0.7,53.41,2,1,3,2,2,0,1.5,100.0,Facile,Moyen,-1,Plus Difficile,Pas Adapte
827,2015,Philosophie,2,La Notion de Logique,1,Les Lois Logiques,9,828,9,QCU,0.55,0.22,6.78,1,11,12,8,1,7,1.5,12.5,Facile,Difficile,-2,Beaucoup plus Difficile,Pas Adapte
1938,2016,Philosophie,2,La Notion de Logique,1,Les Lois Logiques,9,828,9,QCU,0.72,0.2,1.32,0,13,13,12,0,12,1.08,0.0,Moyen,Difficile,-1,Plus Difficile,Pas Adapte
3049,2017,Philosophie,2,La Notion de Logique,1,Les Lois Logiques,9,828,9,QCU,0.29,0.65,57.59,7,5,12,7,7,0,1.71,100.0,Moyen,Moyen,0,Meme Difficulté,Pas Adapte
4160,2018,Philosophie,2,La Notion de Logique,1,Les Lois Logiques,9,828,9,QCU,0.74,0.27,6.81,1,13,14,14,1,13,1.0,7.14,Moyen,Difficile,-1,Plus Difficile,Pas Adapte
5271,2019,Philosophie,2,La Notion de Logique,1,Les Lois Logiques,9,828,9,QCU,0.17,0.77,90.32,12,1,13,12,12,0,1.08,100.0,Facile,Facile,0,Meme Difficulté,Pas Adapte
6382,2020,Philosophie,2,La Notion de Logique,1,Les Lois Logiques,9,828,9,QCU,0.39,0.49,39.04,4,7,11,6,4,2,1.83,66.67,Facile,Moyen,-1,Plus Difficile,Pas Adapte
828,2015,Philosophie,2,La Notion de Logique,2,Les Raisonnements Valides,11,829,1,QROC,0.92,0.23,29.69,22,53,75,36,22,14,2.08,61.11,Difficile,Difficile,0,Meme Difficulté,Pas Adapte
1939,2016,Philosophie,2,La Notion de Logique,2,Les Raisonnements Valides,11,829,1,QROC,0.95,0.11,19.76,14,55,69,49,14,35,1.41,28.57,Facile,Difficile,-2,Beaucoup plus Difficile,Pas Adapte
3050,2017,Philosophie,2,La Notion de Logique,2,Les Raisonnements Valides,11,829,1,QROC,0.98,0.08,12.6,8,56,64,48,8,40,1.33,16.67,Moyen,Difficile,-1,Plus Difficile,Pas Adapte
4161,2018,Philosophie,2,La Notion de Logique,2,Les Raisonnements Valides,11,829,1,QO,0.17,0.47,74.67,42,14,56,53,42,11,1.06,79.25,Difficile,Facile,2,Beaucoup plus Facile,Adapte
5272,2019,Philosophie,2,La Notion de Logique,2,Les Raisonnements Valides,11,829,1,QO,0.02,0.56,74.67,45,15,60,51,45,6,1.18,88.24,Facile,Facile,0,Meme Difficulté,Adapte
6383,2020,Philosophie,2,La Notion de Logique,2,Les Raisonnements Valides,11,829,1,QO,0.06,0.83,74.67,49,16,65,51,49,2,1.27,96.08,Facile,Facile,0,Meme Difficulté,Adapte
829,2015,Philosophie,2,La Notion de Logique,2,Les Raisonnements Valides,11,830,2,QROC,0.45,0.29,45.55,20,24,44,28,20,8,1.57,71.43,Difficile,Moyen,1,Plus Facile,Pas Adapte
1940,2016,Philosophie,2,La Notion de Logique,2,Les Raisonnements Valides,11,830,2,QROC,0.53,0.34,56.34,26,20,46,38,26,12,1.21,68.42,Moyen,Moyen,0,Meme Difficulté,Pas Adapte
3051,2017,Philosophie,2,La Notion de Logique,2,Les Raisonnements Valides,11,830,2,QROC,0.82,0.13,33.94,18,34,52,22,18,4,2.36,81.82,Difficile,Difficile,0,Meme Difficulté,Pas Adapte
4162,2018,Philosophie,2,La Notion de Logique,2,Les Raisonnements Valides,11,830,2,QROC,0.41,0.37,46.21,20,24,44,25,20,5,1.76,80.0,Facile,Moyen,-1,Plus Difficile,Pas Adapte
5273,2019,Philosophie,2,La Notion de Logique,2,Les Raisonnements Valides,11,830,2,QROC,0.71,0.04,10.03,5,42,47,30,5,25,1.57,16.67,Facile,Difficile,-2,Beaucoup plus Difficile,Pas Adapte
6384,2020,Philosophie,2,La Notion de Logique,2,Les Raisonnements Valides,11,830,2,QROC,0.97,0.24,1.06,0,45,45,28,0,28,1.61,0.0,Difficile,Difficile,0,Meme Difficulté,Pas Adapte
830,2015,Philosophie,2,La Notion de Logique,2,Les Raisonnements Valides,11,831,3,QCM,0.08,0.88,95.94,56,2,58,57,56,1,1.02,98.25,Facile,Facile,0,Meme Difficulté,Pas Adapte
1941,2016,Philosophie,2,La Notion de Logique,2,Les Raisonnements Valides,11,831,3,QCM,0.7,0.22,4.72,3,64,67,62,3,59,1.08,4.84,Difficile,Difficile,0,Meme Difficulté,Pas Adapte
3052,2017,Philosophie,2,La Notion de Logique,2,Les Raisonnements Valides,11,831,3,QCM,0.48,0.46,59.36,41,28,69,67,41,26,1.03,61.19,Moyen,Moyen,0,Meme Difficulté,Pas Adapte
4163,2018,Philosophie,2,La Notion de Logique,2,Les Raisonnements Valides,11,831,3,QCM,0.24,0.34,57.17,45,33,78,65,45,20,1.2,69.23,Moyen,Moyen,0,Meme Difficulté,Pas Adapte
5274,2019,Philosophie,2,La Notion de Logique,2,Les Raisonnements Valides,11,831,3,QCM,0.47,0.41,44.23,40,50,90,87,40,47,1.03,45.98,Difficile,Moyen,1,Plus Facile,Pas Adapte
6385,2020,Philosophie,2,La Notion de Logique,2,Les Raisonnements Valides,11,831,3,QCM,0.33,0.52,46.39,43,49,92,89,43,46,1.03,48.31,Moyen,Moyen,0,Meme Difficulté,Pas Adapte
831,2015,Philosophie,2,La Notion de Logique,2,Les Raisonnements Valides,11,832,4,QO,0.77,0.12,25.12,7,20,27,17,7,10,1.59,41.18,Facile,Difficile,-2,Beaucoup plus Difficile,Pas Adapte
1942,2016,Philosophie,2,La Notion de Logique,2,Les Raisonnements Valides,11,832,4,QO,0.3,0.18,53.81,16,14,30,23,16,7,1.3,69.57,Difficile,Moyen,1,Plus Facile,Pas Adapte
3053,2017,Philosophie,2,La Notion de Logique,2,Les Raisonnements Valides,11,832,4,QROC,0.37,0.38,57.8,17,12,29,21,17,4,1.38,80.95,Difficile,Moyen,1,Plus Facile,Pas Adapte
4164,2018,Philosophie,2,La Notion de Logique,2,Les Raisonnements Valides,11,832,4,QROC,0.14,0.91,65.55,17,9,26,22,17,5,1.18,77.27,Moyen,Facile,1,Plus Facile,Adapte
5275,2019,Philosophie,2,La Notion de Logique,2,Les Raisonnements Valides,11,832,4,QROC,0.14,0.93,65.55,18,9,27,26,18,8,1.04,69.23,Facile,Facile,0,Meme Difficulté,Adapte
6386,2020,Philosophie,2,La Notion de Logique,2,Les Raisonnements Valides,11,832,4,QROC,0.06,0.94,65.55,19,10,29,20,19,1,1.45,95.0,Facile,Facile,0,Meme Difficulté,Adapte
832,2015,Philosophie,2,La Notion de Logique,2,Les Raisonnements Valides,11,833,5,QROC,0.15,0.67,65.5,37,20,57,50,37,13,1.14,74.0,Difficile,Facile,2,Beaucoup plus Facile,Adapte
1943,2016,Philosophie,2,La Notion de Logique,2,Les Raisonnements Valides,11,833,5,QROC,0.09,0.8,65.5,39,21,60,54,39,15,1.11,72.22,Facile,Facile,0,Meme Difficulté,Adapte
3054,2017,Philosophie,2,La Notion de Logique,2,Les Raisonnements Valides,11,833,5,QROC,0.17,0.45,65.5,36,19,55,37,36,1,1.49,97.3,Facile,Facile,0,Meme Difficulté,Adapte
4165,2018,Philosophie,2,La Notion de Logique,2,Les Raisonnements Valides,11,833,5,QROC,0.01,0.53,65.5,33,18,51,49,33,16,1.04,67.35,Facile,Facile,0,Meme Difficulté,Adapte
5276,2019,Philosophie,2,La Notion de Logique,2,Les Raisonnements Valides,11,833,5,QROC,0.09,0.95,65.5,34,18,52,42,34,8,1.24,80.95,Facile,Facile,0,Meme Difficulté,Adapte
6387,2020,Philosophie,2,La Notion de Logique,2,Les Raisonnements Valides,11,833,5,QCM,0.1,0.94,65.5,31,17,48,32,31,1,1.5,96.88,Facile,Facile,0,Meme Difficulté,Adapte
833,2015,Philosophie,2,La Notion de Logique,2,Les Raisonnements Valides,11,834,6,QCM,0.2,0.83,76.93,22,7,29,25,22,3,1.16,88.0,Facile,Facile,0,Meme Difficulté,Pas Adapte
1944,2016,Philosophie,2,La Notion de Logique,2,Les Raisonnements Valides,11,834,6,QCM,0.3,0.69,55.03,15,13,28,23,15,8,1.22,65.22,Facile,Moyen,-1,Plus Difficile,Pas Adapte
3055,2017,Philosophie,2,La Notion de Logique,2,Les Raisonnements Valides,11,834,6,QCM,0.44,0.42,45.61,11,13,24,18,11,7,1.33,61.11,Difficile,Moyen,1,Plus Facile,Pas Adapte
4166,2018,Philosophie,2,La Notion de Logique,2,Les Raisonnements Valides,11,834,6,QCM,0.67,0.21,3.82,1,20,21,6,1,5,3.5,16.67,Moyen,Difficile,-1,Plus Difficile,Pas Adapte
5277,2019,Philosophie,2,La Notion de Logique,2,Les Raisonnements Valides,11,834,6,QCM,0.7,0.27,24.31,5,17,22,11,5,6,2.0,45.45,Facile,Difficile,-2,Beaucoup plus Difficile,Pas Adapte
6388,2020,Philosophie,2,La Notion de Logique,2,Les Raisonnements Valides,11,834,6,QCM,0.61,0.26,8.93,2,17,19,7,2,5,2.71,28.57,Difficile,Difficile,0,Meme Difficulté,Pas Adapte
834,2015,Philosophie,2,La Notion de Logique,2,Les Raisonnements Valides,11,835,7,QCM,0.22,0.54,37.14,27,47,74,50,27,23,1.48,54.0,Moyen,Moyen,0,Meme Difficulté,Pas Adapte
1945,2016,Philosophie,2,La Notion de Logique,2,Les Raisonnements Valides,11,835,7,QCM,0.11,0.82,79.56,62,16,78,68,62,6,1.15,91.18,Facile,Facile,0,Meme Difficulté,Pas Adapte
3056,2017,Philosophie,2,La Notion de Logique,2,Les Raisonnements Valides,11,835,7,QCM,0.07,0.98,99.55,72,0,72,72,72,0,1.0,100.0,Difficile,Facile,2,Beaucoup plus Facile,Pas Adapte
4167,2018,Philosophie,2,La Notion de Logique,2,Les Raisonnements Valides,11,835,7,QCM,0.09,0.97,77.13,56,16,72,70,56,14,1.03,80.0,Facile,Facile,0,Meme Difficulté,Pas Adapte
5278,2019,Philosophie,2,La Notion de Logique,2,Les Raisonnements Valides,11,835,7,QCU,0.75,0.36,10.63,8,66,74,31,8,23,2.39,25.81,Facile,Difficile,-2,Beaucoup plus Difficile,Pas Adapte
6389,2020,Philosophie,2,La Notion de Logique,2,Les Raisonnements Valides,11,835,7,QCU,0.18,0.98,80.21,59,14,73,59,59,0,1.24,100.0,Facile,Facile,0,Meme Difficulté,Pas Adapte
835,2015,Philosophie,2,La Notion de Logique,2,Les Raisonnements Valides,11,836,8,QCM,0.23,0.68,37.97,16,25,41,36,16,20,1.14,44.44,Difficile,Moyen,1,Plus Facile,Pas Adapte
1946,2016,Philosophie,2,La Notion de Logique,2,Les Raisonnements Valides,11,836,8,QCM,0.09,0.83,92.83,35,3,38,36,35,1,1.06,97.22,Moyen,Facile,1,Plus Facile,Pas Adapte
3057,2017,Philosophie,2,La Notion de Logique,2,Les Raisonnements Valides,11,836,8,QCU,0.18,0.77,75.52,29,9,38,33,29,4,1.15,87.88,Facile,Facile,0,Meme Difficulté,Pas Adapte
4168,2018,Philosophie,2,La Notion de Logique,2,Les Raisonnements Valides,11,836,8,QCU,0.69,0.24,31.88,11,22,33,19,11,8,1.74,57.89,Moyen,Difficile,-1,Plus Difficile,Pas Adapte
5279,2019,Philosophie,2,La Notion de Logique,2,Les Raisonnements Valides,11,836,8,QCU,0.17,0.79,66.65,23,11,34,26,23,3,1.31,88.46,Facile,Facile,0,Meme Difficulté,Adapte
6390,2020,Philosophie,2,La Notion de Logique,2,Les Raisonnements Valides,11,836,8,QCU,0.11,0.96,66.65,24,12,36,35,24,11,1.03,68.57,Facile,Facile,0,Meme Difficulté,Adapte
836,2015,Philosophie,2,La Notion de Logique,2,Les Raisonnements Valides,11,837,9,QCU,0.04,0.91,95.61,50,2,52,52,50,2,1.0,96.15,Difficile,Facile,2,Beaucoup plus Facile,Pas Adapte
1947,2016,Philosophie,2,La Notion de Logique,2,Les Raisonnements Valides,11,837,9,QCU,0.26,0.7,63.44,37,22,59,57,37,20,1.04,64.91,Moyen,Moyen,0,Meme Difficulté,Pas Adapte
3058,2017,Philosophie,2,La Notion de Logique,2,Les Raisonnements Valides,11,837,9,QCU,0.33,0.56,45.33,27,32,59,37,27,10,1.59,72.97,Difficile,Moyen,1,Plus Facile,Pas Adapte
4169,2018,Philosophie,2,La Notion de Logique,2,Les Raisonnements Valides,11,837,9,QCU,0.01,0.79,71.27,39,16,55,47,39,8,1.17,82.98,Difficile,Facile,2,Beaucoup plus Facile,Adapte
5280,2019,Philosophie,2,La Notion de Logique,2,Les Raisonnements Valides,11,837,9,QCU,0.17,0.89,71.27,34,14,48,43,34,9,1.12,79.07,Facile,Facile,0,Meme Difficulté,Adapte
6391,2020,Philosophie,2,La Notion de Logique,2,Les Raisonnements Valides,11,837,9,QCU,0.1,0.85,71.27,38,16,54,48,38,10,1.12,79.17,Facile,Facile,0,Meme Difficulté,Adapte
837,2015,Philosophie,2,La Notion de Logique,2,Les Raisonnements Valides,11,838,10,QCU,0.13,0.75,85.21,30,5,35,31,30,1,1.13,96.77,Facile,Facile,0,Meme Difficulté,Pas Adapte
1948,2016,Philosophie,2,La Notion de Logique,2,Les Raisonnements Valides,11,838,10,QCU,0.07,0.85,90.43,30,3,33,31,30,1,1.06,96.77,Facile,Facile,0,Meme Difficulté,Pas Adapte
3059,2017,Philosophie,2,La Notion de Logique,2,Les Raisonnements Valides,11,838,10,QCM,0.07,0.95,85.52,31,5,36,33,31,2,1.09,93.94,Moyen,Facile,1,Plus Facile,Pas Adapte
4170,2018,Philosophie,2,La Notion de Logique,2,Les Raisonnements Valides,11,838,10,QCM,0.31,0.55,38.19,15,25,40,38,15,23,1.05,39.47,Facile,Moyen,-1,Plus Difficile,Pas Adapte
5281,2019,Philosophie,2,La Notion de Logique,2,Les Raisonnements Valides,11,838,10,QCM,0.44,0.4,37.11,15,26,41,17,15,2,2.41,88.24,Moyen,Moyen,0,Meme Difficulté,Pas Adapte
6392,2020,Philosophie,2,La Notion de Logique,2,Les Raisonnements Valides,11,838,10,QCM,0.78,0.18,29.49,14,33,47,46,14,32,1.02,30.43,Facile,Difficile,-2,Beaucoup plus Difficile,Pas Adapte
838,2015,Philosophie,2,La Notion de Logique,2,Les Raisonnements Valides,11,839,11,QCU,0.16,0.95,76.39,18,5,23,19,18,1,1.21,94.74,Moyen,Facile,1,Plus Facile,Pas Adapte
1949,2016,Philosophie,2,La Notion de Logique,2,Les Raisonnements Valides,11,839,11,QCU,0.1,0.77,87.01,17,3,20,20,17,3,1.0,85.0,Moyen,Facile,1,Plus Facile,Pas Adapte
3060,2017,Philosophie,2,La Notion de Logique,2,Les Raisonnements Valides,11,839,11,QROC,0.11,0.56,99.99,20,0,20,20,20,0,1.0,100.0,Moyen,Facile,1,Plus Facile,Pas Adapte
4171,2018,Philosophie,2,La Notion de Logique,2,Les Raisonnements Valides,11,839,11,QROC,0.76,0.02,33.75,7,13,20,11,7,4,1.82,63.64,Facile,Difficile,-2,Beaucoup plus Difficile,Pas Adapte
5282,2019,Philosophie,2,La Notion de Logique,2,Les Raisonnements Valides,11,839,11,QROC,0.55,0.28,56.56,10,7,17,14,10,4,1.21,71.43,Moyen,Moyen,0,Meme Difficulté,Pas Adapte
6393,2020,Philosophie,2,La Notion de Logique,2,Les Raisonnements Valides,11,839,11,QROC,0.0,0.81,98.51,16,0,16,16,16,0,1.0,100.0,Moyen,Facile,1,Plus Facile,Pas Adapte
839,2015,Philosophie,2,La Notion de Logique,3,Les Paradoxes,10,840,1,QCU,0.51,0.34,1.59,0,23,23,16,0,16,1.44,0.0,Difficile,Difficile,0,Meme Difficulté,Pas Adapte
1950,2016,Philosophie,2,La Notion de Logique,3,Les Paradoxes,10,840,1,QCU,0.72,0.28,32.13,7,16,23,20,7,13,1.15,35.0,Moyen,Difficile,-1,Plus Difficile,Pas Adapte
3061,2017,Philosophie,2,La Notion de Logique,3,Les Paradoxes,10,840,1,QCU,0.09,0.85,83.77,18,3,21,20,18,2,1.05,90.0,Facile,Facile,0,Meme Difficulté,Pas Adapte
4172,2018,Philosophie,2,La Notion de Logique,3,Les Paradoxes,10,840,1,QCU,0.48,0.32,2.79,1,22,23,21,1,20,1.1,4.76,Difficile,Difficile,0,Meme Difficulté,Pas Adapte
5283,2019,Philosophie,2,La Notion de Logique,3,Les Paradoxes,10,840,1,QCU,0.01,0.8,75.14,17,6,23,17,17,0,1.35,100.0,Facile,Facile,0,Meme Difficulté,Pas Adapte
6394,2020,Philosophie,2,La Notion de Logique,3,Les Paradoxes,10,840,1,QCU,0.39,0.64,48.76,11,11,22,18,11,7,1.22,61.11,Moyen,Moyen,0,Meme Difficulté,Pas Adapte
840,2015,Philosophie,2,La Notion de Logique,3,Les Paradoxes,10,841,2,QCU,0.11,0.96,86.07,71,12,83,79,71,8,1.05,89.87,Moyen,Facile,1,Plus Facile,Pas Adapte
1951,2016,Philosophie,2,La Notion de Logique,3,Les Paradoxes,10,841,2,QCU,0.08,0.97,77.29,55,16,71,68,55,13,1.04,80.88,Difficile,Facile,2,Beaucoup plus Facile,Pas Adapte
3062,2017,Philosophie,2,La Notion de Logique,3,Les Paradoxes,10,841,2,QCM,0.6,0.18,27.16,18,48,66,42,18,24,1.57,42.86,Moyen,Difficile,-1,Plus Difficile,Pas Adapte
4173,2018,Philosophie,2,La Notion de Logique,3,Les Paradoxes,10,841,2,QCM,0.44,0.33,36.25,21,37,58,39,21,18,1.49,53.85,Moyen,Moyen,0,Meme Difficulté,Pas Adapte
5284,2019,Philosophie,2,La Notion de Logique,3,Les Paradoxes,10,841,2,QCM,0.72,0.3,9.79,7,60,67,54,7,47,1.24,12.96,Facile,Difficile,-2,Beaucoup plus Difficile,Pas Adapte
6395,2020,Philosophie,2,La Notion de Logique,3,Les Paradoxes,10,841,2,QCM,0.35,0.34,52.7,31,28,59,39,31,8,1.51,79.49,Moyen,Moyen,0,Meme Difficulté,Pas Adapte
841,2015,Philosophie,2,La Notion de Logique,3,Les Paradoxes,10,842,3,QCU,0.57,0.28,14.09,10,64,74,33,10,23,2.24,30.3,Facile,Difficile,-2,Beaucoup plus Difficile,Pas Adapte
1952,2016,Philosophie,2,La Notion de Logique,3,Les Paradoxes,10,842,3,QCM,0.27,0.34,53.32,36,32,68,59,36,23,1.15,61.02,Moyen,Moyen,0,Meme Difficulté,Pas Adapte
3063,2017,Philosophie,2,La Notion de Logique,3,Les Paradoxes,10,842,3,QCU,0.31,0.44,52.75,33,29,62,45,33,12,1.38,73.33,Facile,Moyen,-1,Plus Difficile,Pas Adapte
4174,2018,Philosophie,2,La Notion de Logique,3,Les Paradoxes,10,842,3,QCU,0.01,0.96,93.49,66,5,71,69,66,3,1.03,95.65,Difficile,Facile,2,Beaucoup plus Facile,Pas Adapte
5285,2019,Philosophie,2,La Notion de Logique,3,Les Paradoxes,10,842,3,QCU,0.65,0.36,13.41,9,58,67,43,9,34,1.56,20.93,Difficile,Difficile,0,Meme Difficulté,Pas Adapte
6396,2020,Philosophie,2,La Notion de Logique,3,Les Paradoxes,10,842,3,QCU,0.1,0.87,73.8,44,15,59,59,44,15,1.0,74.58,Facile,Facile,0,Meme Difficulté,Adapte
842,2015,Philosophie,2,La Notion de Logique,3,Les Paradoxes,10,843,4,QO,0.93,0.03,11.42,4,33,37,30,4,26,1.23,13.33,Difficile,Difficile,0,Meme Difficulté,Pas Adapte
1953,2016,Philosophie,2,La Notion de Logique,3,Les Paradoxes,10,843,4,QO,0.36,0.15,42.86,14,19,33,23,14,9,1.43,60.87,Difficile,Moyen,1,Plus Facile,Pas Adapte
3064,2017,Philosophie,2,La Notion de Logique,3,Les Paradoxes,10,843,4,QO,0.15,0.46,77.89,29,8,37,36,29,7,1.03,80.56,Facile,Facile,0,Meme Difficulté,Pas Adapte
4175,2018,Philosophie,2,La Notion de Logique,3,Les Paradoxes,10,843,4,QO,0.07,0.53,65.62,26,13,39,36,26,10,1.08,72.22,Facile,Facile,0,Meme Difficulté,Adapte
5286,2019,Philosophie,2,La Notion de Logique,3,Les Paradoxes,10,843,4,QROC,0.12,0.72,65.62,27,14,41,40,27,13,1.02,67.5,Facile,Facile,0,Meme Difficulté,Adapte
6397,2020,Philosophie,2,La Notion de Logique,3,Les Paradoxes,10,843,4,QCM,0.19,0.82,65.62,30,15,45,43,30,13,1.05,69.77,Facile,Facile,0,Meme Difficulté,Adapte
843,2015,Philosophie,2,La Notion de Logique,3,Les Paradoxes,10,844,5,QO,0.28,0.25,43.9,3,3,6,4,3,1,1.5,75.0,Difficile,Moyen,1,Plus Facile,Pas Adapte
1954,2016,Philosophie,2,La Notion de Logique,3,Les Paradoxes,10,844,5,QO,0.95,0.02,8.07,1,6,7,4,1,3,1.75,25.0,Facile,Difficile,-2,Beaucoup plus Difficile,Pas Adapte
3065,2017,Philosophie,2,La Notion de Logique,3,Les Paradoxes,10,844,5,QO,0.75,0.18,44.43,4,4,8,8,4,4,1.0,50.0,Facile,Moyen,-1,Plus Difficile,Pas Adapte
4176,2018,Philosophie,2,La Notion de Logique,3,Les Paradoxes,10,844,5,QO,0.77,0.13,10.19,1,6,7,4,1,3,1.75,25.0,Difficile,Difficile,0,Meme Difficulté,Pas Adapte
5287,2019,Philosophie,2,La Notion de Logique,3,Les Paradoxes,10,844,5,QROC,0.81,0.04,18.0,1,5,6,5,1,4,1.2,20.0,Facile,Difficile,-2,Beaucoup plus Difficile,Pas Adapte
6398,2020,Philosophie,2,La Notion de Logique,3,Les Paradoxes,10,844,5,QROC,0.75,0.04,3.98,0,6,6,5,0,5,1.2,0.0,Facile,Difficile,-2,Beaucoup plus Difficile,Pas Adapte
844,2015,Philosophie,2,La Notion de Logique,3,Les Paradoxes,10,845,6,QCM,0.04,0.9,88.53,45,6,51,48,45,3,1.06,93.75,Facile,Facile,0,Meme Difficulté,Pas Adapte
1955,2016,Philosophie,2,La Notion de Logique,3,Les Paradoxes,10,845,6,QCM,0.03,0.82,66.76,32,16,48,35,32,3,1.37,91.43,Facile,Facile,0,Meme Difficulté,Adapte
3066,2017,Philosophie,2,La Notion de Logique,3,Les Paradoxes,10,845,6,QCM,0.08,0.73,66.76,28,14,42,31,28,3,1.35,90.32,Facile,Facile,0,Meme Difficulté,Adapte
4177,2018,Philosophie,2,La Notion de Logique,3,Les Paradoxes,10,845,6,QCM,0.12,0.73,66.76,29,15,44,32,29,3,1.38,90.62,Facile,Facile,0,Meme Difficulté,Adapte
5288,2019,Philosophie,2,La Notion de Logique,3,Les Paradoxes,10,845,6,QCM,0.08,0.84,66.76,31,16,47,39,31,8,1.21,79.49,Facile,Facile,0,Meme Difficulté,Adapte
6399,2020,Philosophie,2,La Notion de Logique,3,Les Paradoxes,10,845,6,QCM,0.06,0.96,66.76,29,14,43,40,29,11,1.07,72.5,Facile,Facile,0,Meme Difficulté,Adapte
845,2015,Philosophie,2,La Notion de Logique,3,Les Paradoxes,10,846,7,QCU,0.16,0.84,67.07,5,3,8,8,5,3,1.0,62.5,Facile,Facile,0,Meme Difficulté,Adapte
1956,2016,Philosophie,2,La Notion de Logique,3,Les Paradoxes,10,846,7,QCU,0.04,0.82,67.07,5,3,8,5,5,0,1.6,100.0,Facile,Facile,0,Meme Difficulté,Adapte
3067,2017,Philosophie,2,La Notion de Logique,3,Les Paradoxes,10,846,7,QCU,0.07,0.77,67.07,6,3,9,8,6,2,1.12,75.0,Facile,Facile,0,Meme Difficulté,Adapte
4178,2018,Philosophie,2,La Notion de Logique,3,Les Paradoxes,10,846,7,QCU,0.03,0.84,67.07,7,3,10,7,7,0,1.43,100.0,Facile,Facile,0,Meme Difficulté,Adapte
5289,2019,Philosophie,2,La Notion de Logique,3,Les Paradoxes,10,846,7,QCM,0.18,0.99,67.07,8,4,12,10,8,2,1.2,80.0,Facile,Facile,0,Meme Difficulté,Adapte
6400,2020,Philosophie,2,La Notion de Logique,3,Les Paradoxes,10,846,7,QCM,0.11,0.71,67.07,9,4,13,9,9,0,1.44,100.0,Facile,Facile,0,Meme Difficulté,Adapte
846,2015,Philosophie,2,La Notion de Logique,3,Les Paradoxes,10,847,8,QCU,0.21,0.43,47.74,44,48,92,64,44,20,1.44,68.75,Moyen,Moyen,0,Meme Difficulté,Pas Adapte
1957,2016,Philosophie,2,La Notion de Logique,3,Les Paradoxes,10,847,8,QCU,0.34,0.61,51.44,55,51,106,67,55,12,1.58,82.09,Difficile,Moyen,1,Plus Facile,Pas Adapte
3068,2017,Philosophie,2,La Notion de Logique,3,Les Paradoxes,10,847,8,QCU,0.44,0.26,34.65,40,74,114,98,40,58,1.16,40.82,Difficile,Difficile,0,Meme Difficulté,Pas Adapte
4179,2018,Philosophie,2,La Notion de Logique,3,Les Paradoxes,10,847,8,QCU,0.16,0.82,89.54,92,11,103,102,92,10,1.01,90.2,Difficile,Facile,2,Beaucoup plus Facile,Pas Adapte
5290,2019,Philosophie,2,La Notion de Logique,3,Les Paradoxes,10,847,8,QCU,0.18,0.81,91.33,100,9,109,101,100,1,1.08,99.01,Difficile,Facile,2,Beaucoup plus Facile,Pas Adapte
6401,2020,Philosophie,2,La Notion de Logique,3,Les Paradoxes,10,847,8,QCM,0.79,0.26,17.07,20,98,118,111,20,91,1.06,18.02,Moyen,Difficile,-1,Plus Difficile,Pas Adapte
847,2015,Philosophie,2,La Notion de Logique,3,Les Paradoxes,10,848,9,QCM,0.35,0.5,48.33,34,36,70,53,34,19,1.32,64.15,Facile,Moyen,-1,Plus Difficile,Pas Adapte
1958,2016,Philosophie,2,La Notion de Logique,3,Les Paradoxes,10,848,9,QCM,0.4,0.48,55.88,44,34,78,59,44,15,1.32,74.58,Difficile,Moyen,1,Plus Facile,Pas Adapte
3069,2017,Philosophie,2,La Notion de Logique,3,Les Paradoxes,10,848,9,QCM,0.36,0.56,60.04,52,35,87,53,52,1,1.64,98.11,Moyen,Moyen,0,Meme Difficulté,Pas Adapte
4180,2018,Philosophie,2,La Notion de Logique,3,Les Paradoxes,10,848,9,QCM,0.04,0.88,90.11,68,7,75,74,68,6,1.01,91.89,Moyen,Facile,1,Plus Facile,Pas Adapte
5291,2019,Philosophie,2,La Notion de Logique,3,Les Paradoxes,10,848,9,QROC,0.7,0.1,24.95,21,65,86,66,21,45,1.3,31.82,Facile,Difficile,-2,Beaucoup plus Difficile,Pas Adapte
6402,2020,Philosophie,2,La Notion de Logique,3,Les Paradoxes,10,848,9,QROC,0.59,0.27,47.41,47,52,99,65,47,18,1.52,72.31,Difficile,Moyen,1,Plus Facile,Pas Adapte
848,2015,Philosophie,2,La Notion de Logique,3,Les Paradoxes,10,849,10,QCU,0.71,0.22,25.75,25,72,97,39,25,14,2.49,64.1,Facile,Difficile,-2,Beaucoup plus Difficile,Pas Adapte
1959,2016,Philosophie,2,La Notion de Logique,3,Les Paradoxes,10,849,10,QCU,0.22,0.48,63.7,61,34,95,93,61,32,1.02,65.59,Moyen,Moyen,0,Meme Difficulté,Pas Adapte
3070,2017,Philosophie,2,La Notion de Logique,3,Les Paradoxes,10,849,10,QCU,0.45,0.34,6.74,6,90,96,64,6,58,1.5,9.38,Moyen,Difficile,-1,Plus Difficile,Pas Adapte
4181,2018,Philosophie,2,La Notion de Logique,3,Les Paradoxes,10,849,10,QCU,0.18,0.78,75.97,71,23,94,78,71,7,1.21,91.03,Moyen,Facile,1,Plus Facile,Pas Adapte
5292,2019,Philosophie,2,La Notion de Logique,3,Les Paradoxes,10,849,10,QCU,0.48,0.38,18.7,20,85,105,73,20,53,1.44,27.4,Moyen,Difficile,-1,Plus Difficile,Pas Adapte
6403,2020,Philosophie,2,La Notion de Logique,3,Les Paradoxes,10,849,10,QROC,0.0,0.73,88.18,96,13,109,109,96,13,1.0,88.07,Difficile,Facile,2,Beaucoup plus Facile,Pas Adapte
849,2015,Philosophie,2,La Notion de Logique,4,La Notion du Modele,7,850,1,QROC,0.1,0.54,92.11,6,0,6,6,6,0,1.0,100.0,Facile,Facile,0,Meme Difficulté,Pas Adapte
1960,2016,Philosophie,2,La Notion de Logique,4,La Notion du Modele,7,850,1,QROC,0.05,0.94,77.26,5,2,7,6,5,1,1.17,83.33,Difficile,Facile,2,Beaucoup plus Facile,Pas Adapte
3071,2017,Philosophie,2,La Notion de Logique,4,La Notion du Modele,7,850,1,QROC,0.54,0.29,62.84,4,2,6,5,4,1,1.2,80.0,Facile,Moyen,-1,Plus Difficile,Pas Adapte
4182,2018,Philosophie,2,La Notion de Logique,4,La Notion du Modele,7,850,1,QROC,0.11,0.49,77.45,4,1,5,4,4,0,1.25,100.0,Moyen,Facile,1,Plus Facile,Pas Adapte
5293,2019,Philosophie,2,La Notion de Logique,4,La Notion du Modele,7,850,1,QROC,0.81,0.13,12.09,1,4,5,4,1,3,1.25,25.0,Moyen,Difficile,-1,Plus Difficile,Pas Adapte
6404,2020,Philosophie,2,La Notion de Logique,4,La Notion du Modele,7,850,1,QROC,0.23,0.28,43.29,3,3,6,6,3,3,1.0,50.0,Moyen,Moyen,0,Meme Difficulté,Pas Adapte
850,2015,Philosophie,2,La Notion de Logique,4,La Notion du Modele,7,851,2,QCM,0.05,0.81,65.58,12,7,19,16,12,4,1.19,75.0,Facile,Facile,0,Meme Difficulté,Adapte
1961,2016,Philosophie,2,La Notion de Logique,4,La Notion du Modele,7,851,2,QCM,0.07,0.88,65.58,11,6,17,15,11,4,1.13,73.33,Facile,Facile,0,Meme Difficulté,Adapte
3072,2017,Philosophie,2,La Notion de Logique,4,La Notion du Modele,7,851,2,QCU,0.19,0.9,65.58,9,5,14,9,9,0,1.56,100.0,Facile,Facile,0,Meme Difficulté,Adapte
4183,2018,Philosophie,2,La Notion de Logique,4,La Notion du Modele,7,851,2,QCU,0.03,0.93,65.58,10,5,15,10,10,0,1.5,100.0,Facile,Facile,0,Meme Difficulté,Adapte
5294,2019,Philosophie,2,La Notion de Logique,4,La Notion du Modele,7,851,2,QROC,0.2,0.61,65.58,9,4,13,12,9,3,1.08,75.0,Facile,Facile,0,Meme Difficulté,Adapte
6405,2020,Philosophie,2,La Notion de Logique,4,La Notion du Modele,7,851,2,QROC,0.09,0.58,65.58,8,4,12,11,8,3,1.09,72.73,Facile,Facile,0,Meme Difficulté,Adapte
851,2015,Philosophie,2,La Notion de Logique,4,La Notion du Modele,7,852,3,QCM,0.63,0.21,4.7,4,85,89,69,4,65,1.29,5.8,Facile,Difficile,-2,Beaucoup plus Difficile,Pas Adapte
1962,2016,Philosophie,2,La Notion de Logique,4,La Notion du Modele,7,852,3,QCU,0.24,0.73,49.33,46,48,94,90,46,44,1.04,51.11,Moyen,Moyen,0,Meme Difficulté,Pas Adapte
3073,2017,Philosophie,2,La Notion de Logique,4,La Notion du Modele,7,852,3,QCU,0.66,0.22,29.64,28,67,95,72,28,44,1.32,38.89,Difficile,Difficile,0,Meme Difficulté,Pas Adapte
4184,2018,Philosophie,2,La Notion de Logique,4,La Notion du Modele,7,852,3,QROC,0.49,0.37,56.02,59,46,105,100,59,41,1.05,59.0,Facile,Moyen,-1,Plus Difficile,Pas Adapte
5295,2019,Philosophie,2,La Notion de Logique,4,La Notion du Modele,7,852,3,QROC,0.43,0.34,52.17,48,44,92,69,48,21,1.33,69.57,Facile,Moyen,-1,Plus Difficile,Pas Adapte
6406,2020,Philosophie,2,La Notion de Logique,4,La Notion du Modele,7,852,3,QROC,0.65,0.07,21.17,17,61,78,55,17,38,1.42,30.91,Difficile,Difficile,0,Meme Difficulté,Pas Adapte
852,2015,Philosophie,2,La Notion de Logique,4,La Notion du Modele,7,853,4,QCM,0.03,0.71,86.85,30,5,35,35,30,5,1.0,85.71,Facile,Facile,0,Meme Difficulté,Pas Adapte
1963,2016,Philosophie,2,La Notion de Logique,4,La Notion du Modele,7,853,4,QCM,0.03,0.89,95.3,31,2,33,33,31,2,1.0,93.94,Facile,Facile,0,Meme Difficulté,Pas Adapte
3074,2017,Philosophie,2,La Notion de Logique,4,La Notion du Modele,7,853,4,QCM,0.36,0.37,60.15,22,15,37,35,22,13,1.06,62.86,Difficile,Moyen,1,Plus Facile,Pas Adapte
4185,2018,Philosophie,2,La Notion de Logique,4,La Notion du Modele,7,853,4,QROC,0.12,0.86,90.65,38,4,42,39,38,1,1.08,97.44,Moyen,Facile,1,Plus Facile,Pas Adapte
5296,2019,Philosophie,2,La Notion de Logique,4,La Notion du Modele,7,853,4,QROC,0.15,0.52,66.85,31,15,46,34,31,3,1.35,91.18,Difficile,Facile,2,Beaucoup plus Facile,Adapte
6407,2020,Philosophie,2,La Notion de Logique,4,La Notion du Modele,7,853,4,QROC,0.05,0.82,66.85,31,15,46,43,31,12,1.07,72.09,Facile,Facile,0,Meme Difficulté,Adapte
853,2015,Philosophie,2,La Notion de Logique,4,La Notion du Modele,7,854,5,QO,0.46,0.18,63.51,10,6,16,15,10,5,1.07,66.67,Moyen,Moyen,0,Meme Difficulté,Pas Adapte
1964,2016,Philosophie,2,La Notion de Logique,4,La Notion du Modele,7,854,5,QO,0.16,0.8,81.79,15,3,18,16,15,1,1.12,93.75,Difficile,Facile,2,Beaucoup plus Facile,Pas Adapte
3075,2017,Philosophie,2,La Notion de Logique,4,La Notion du Modele,7,854,5,QO,0.02,0.32,96.86,17,1,18,18,17,1,1.0,94.44,Moyen,Facile,1,Plus Facile,Pas Adapte
4186,2018,Philosophie,2,La Notion de Logique,4,La Notion du Modele,7,854,5,QCU,0.14,0.8,97.25,18,1,19,18,18,0,1.06,100.0,Moyen,Facile,1,Plus Facile,Pas Adapte
5297,2019,Philosophie,2,La Notion de Logique,4,La Notion du Modele,7,854,5,QCU,0.45,0.31,28.12,6,15,21,20,6,14,1.05,30.0,Facile,Difficile,-2,Beaucoup plus Difficile,Pas Adapte
6408,2020,Philosophie,2,La Notion de Logique,4,La Notion du Modele,7,854,5,QCU,0.12,0.84,96.24,18,1,19,19,18,1,1.0,94.74,Facile,Facile,0,Meme Difficulté,Pas Adapte
854,2015,Philosophie,2,La Notion de Logique,4,La Notion du Modele,7,855,6,QCM,0.44,0.63,37.46,9,15,24,19,9,10,1.26,47.37,Difficile,Moyen,1,Plus Facile,Pas Adapte
1965,2016,Philosophie,2,La Notion de Logique,4,La Notion du Modele,7,855,6,QCM,0.53,0.28,18.96,5,21,26,15,5,10,1.73,33.33,Facile,Difficile,-2,Beaucoup plus Difficile,Pas Adapte
3076,2017,Philosophie,2,La Notion de Logique,4,La Notion du Modele,7,855,6,QCM,0.73,0.15,8.68,2,24,26,21,2,19,1.24,9.52,Facile,Difficile,-2,Beaucoup plus Difficile,Pas Adapte
4187,2018,Philosophie,2,La Notion de Logique,4,La Notion du Modele,7,855,6,QROC,0.95,0.04,14.46,4,23,27,23,4,19,1.17,17.39,Difficile,Difficile,0,Meme Difficulté,Pas Adapte
5298,2019,Philosophie,2,La Notion de Logique,4,La Notion du Modele,7,855,6,QROC,0.5,0.36,51.77,13,13,26,19,13,6,1.37,68.42,Difficile,Moyen,1,Plus Facile,Pas Adapte
6409,2020,Philosophie,2,La Notion de Logique,4,La Notion du Modele,7,855,6,QROC,0.04,0.67,89.32,21,3,24,22,21,1,1.09,95.45,Moyen,Facile,1,Plus Facile,Pas Adapte
855,2015,Philosophie,2,La Notion de Logique,4,La Notion du Modele,7,856,7,QCU,0.62,0.29,19.09,13,54,67,41,13,28,1.63,31.71,Facile,Difficile,-2,Beaucoup plus Difficile,Pas Adapte
1966,2016,Philosophie,2,La Notion de Logique,4,La Notion du Modele,7,856,7,QCU,0.21,0.48,58.19,38,27,65,57,38,19,1.14,66.67,Moyen,Moyen,0,Meme Difficulté,Pas Adapte
3077,2017,Philosophie,2,La Notion de Logique,4,La Notion du Modele,7,856,7,QCU,0.24,0.56,36.96,24,42,66,54,24,30,1.22,44.44,Difficile,Moyen,1,Plus Facile,Pas Adapte
4188,2018,Philosophie,2,La Notion de Logique,4,La Notion du Modele,7,856,7,QO,0.41,0.17,43.51,28,36,64,43,28,15,1.49,65.12,Difficile,Moyen,1,Plus Facile,Pas Adapte
5299,2019,Philosophie,2,La Notion de Logique,4,La Notion du Modele,7,856,7,QO,0.18,0.37,89.47,53,6,59,55,53,2,1.07,96.36,Moyen,Facile,1,Plus Facile,Pas Adapte
6410,2020,Philosophie,2,La Notion de Logique,4,La Notion du Modele,7,856,7,QO,0.11,0.3,89.01,61,7,68,63,61,2,1.08,96.83,Facile,Facile,0,Meme Difficulté,Pas Adapte
856,2015,Philosophie,2,La Notion de Logique,5,Le Calcul des Sequents,12,857,1,QCM,0.08,0.81,79.86,36,9,45,42,36,6,1.07,85.71,Facile,Facile,0,Meme Difficulté,Pas Adapte
1967,2016,Philosophie,2,La Notion de Logique,5,Le Calcul des Sequents,12,857,1,QCM,0.77,0.2,0.82,0,46,46,19,0,19,2.42,0.0,Difficile,Difficile,0,Meme Difficulté,Pas Adapte
3078,2017,Philosophie,2,La Notion de Logique,5,Le Calcul des Sequents,12,857,1,QCM,0.76,0.17,26.29,12,35,47,18,12,6,2.61,66.67,Moyen,Difficile,-1,Plus Difficile,Pas Adapte
4189,2018,Philosophie,2,La Notion de Logique,5,Le Calcul des Sequents,12,857,1,QCU,0.27,0.72,55.05,25,21,46,43,25,18,1.07,58.14,Moyen,Moyen,0,Meme Difficulté,Pas Adapte
5300,2019,Philosophie,2,La Notion de Logique,5,Le Calcul des Sequents,12,857,1,QCM,0.71,0.28,17.33,9,42,51,35,9,26,1.46,25.71,Facile,Difficile,-2,Beaucoup plus Difficile,Pas Adapte
6411,2020,Philosophie,2,La Notion de Logique,5,Le Calcul des Sequents,12,857,1,QCM,0.22,0.56,55.99,32,25,57,36,32,4,1.58,88.89,Facile,Moyen,-1,Plus Difficile,Pas Adapte
857,2015,Philosophie,2,La Notion de Logique,5,Le Calcul des Sequents,12,858,2,QROC,0.81,0.18,14.6,3,17,20,13,3,10,1.54,23.08,Facile,Difficile,-2,Beaucoup plus Difficile,Pas Adapte
1968,2016,Philosophie,2,La Notion de Logique,5,Le Calcul des Sequents,12,858,2,QROC,0.09,0.86,65.93,13,6,19,18,13,5,1.06,72.22,Moyen,Facile,1,Plus Facile,Adapte
3079,2017,Philosophie,2,La Notion de Logique,5,Le Calcul des Sequents,12,858,2,QROC,0.0,0.98,65.93,11,6,17,12,11,1,1.42,91.67,Facile,Facile,0,Meme Difficulté,Adapte
4190,2018,Philosophie,2,La Notion de Logique,5,Le Calcul des Sequents,12,858,2,QROC,0.1,0.83,65.93,11,6,17,12,11,1,1.42,91.67,Facile,Facile,0,Meme Difficulté,Adapte
5301,2019,Philosophie,2,La Notion de Logique,5,Le Calcul des Sequents,12,858,2,QROC,0.17,0.96,65.93,13,6,19,19,13,6,1.0,68.42,Facile,Facile,0,Meme Difficulté,Adapte
6412,2020,Philosophie,2,La Notion de Logique,5,Le Calcul des Sequents,12,858,2,QROC,0.09,0.68,65.93,14,7,21,15,14,1,1.4,93.33,Facile,Facile,0,Meme Difficulté,Adapte
858,2015,Philosophie,2,La Notion de Logique,5,Le Calcul des Sequents,12,859,3,QCU,0.06,0.93,70.29,44,19,63,55,44,11,1.15,80.0,Moyen,Facile,1,Plus Facile,Adapte
1969,2016,Philosophie,2,La Notion de Logique,5,Le Calcul des Sequents,12,859,3,QCM,0.08,0.77,70.29,48,20,68,67,48,19,1.01,71.64,Facile,Facile,0,Meme Difficulté,Adapte
3080,2017,Philosophie,2,La Notion de Logique,5,Le Calcul des Sequents,12,859,3,QCU,0.1,0.9,70.29,53,23,76,57,53,4,1.33,92.98,Facile,Facile,0,Meme Difficulté,Adapte
4191,2018,Philosophie,2,La Notion de Logique,5,Le Calcul des Sequents,12,859,3,QCU,0.03,0.89,70.29,53,22,75,57,53,4,1.32,92.98,Facile,Facile,0,Meme Difficulté,Adapte
5302,2019,Philosophie,2,La Notion de Logique,5,Le Calcul des Sequents,12,859,3,QCM,0.01,0.95,70.29,59,25,84,67,59,8,1.25,88.06,Facile,Facile,0,Meme Difficulté,Adapte
6413,2020,Philosophie,2,La Notion de Logique,5,Le Calcul des Sequents,12,859,3,QCM,0.19,0.76,70.29,63,26,89,79,63,16,1.13,79.75,Facile,Facile,0,Meme Difficulté,Adapte
859,2015,Philosophie,2,La Notion de Logique,5,Le Calcul des Sequents,12,860,4,QROC,0.36,0.26,57.83,6,4,10,10,6,4,1.0,60.0,Moyen,Moyen,0,Meme Difficulté,Pas Adapte
1970,2016,Philosophie,2,La Notion de Logique,5,Le Calcul des Sequents,12,860,4,QROC,0.02,0.66,93.36,9,1,10,9,9,0,1.11,100.0,Difficile,Facile,2,Beaucoup plus Facile,Pas Adapte
3081,2017,Philosophie,2,La Notion de Logique,5,Le Calcul des Sequents,12,860,4,QROC,0.24,0.39,40.56,5,7,12,8,5,3,1.5,62.5,Facile,Moyen,-1,Plus Difficile,Pas Adapte
4192,2018,Philosophie,2,La Notion de Logique,5,Le Calcul des Sequents,12,860,4,QROC,0.67,0.12,2.42,0,12,12,7,0,7,1.71,0.0,Difficile,Difficile,0,Meme Difficulté,Pas Adapte
5303,2019,Philosophie,2,La Notion de Logique,5,Le Calcul des Sequents,12,860,4,QO,0.07,0.88,93.64,9,1,10,10,9,1,1.0,90.0,Moyen,Facile,1,Plus Facile,Pas Adapte
6414,2020,Philosophie,2,La Notion de Logique,5,Le Calcul des Sequents,12,860,4,QO,0.07,0.63,98.75,12,0,12,12,12,0,1.0,100.0,Facile,Facile,0,Meme Difficulté,Pas Adapte
860,2015,Philosophie,2,La Notion de Logique,5,Le Calcul des Sequents,12,861,5,QCM,0.73,0.19,24.08,20,64,84,68,20,48,1.24,29.41,Facile,Difficile,-2,Beaucoup plus Difficile,Pas Adapte
1971,2016,Philosophie,2,La Notion de Logique,5,Le Calcul des Sequents,12,861,5,QCM,0.26,0.36,57.66,41,30,71,62,41,21,1.15,66.13,Difficile,Moyen,1,Plus Facile,Pas Adapte
3082,2017,Philosophie,2,La Notion de Logique,5,Le Calcul des Sequents,12,861,5,QCM,0.15,0.99,96.79,62,2,64,63,62,1,1.02,98.41,Difficile,Facile,2,Beaucoup plus Facile,Pas Adapte
4193,2018,Philosophie,2,La Notion de Logique,5,Le Calcul des Sequents,12,861,5,QCM,0.19,0.78,71.89,47,18,65,47,47,0,1.38,100.0,Facile,Facile,0,Meme Difficulté,Adapte
5304,2019,Philosophie,2,La Notion de Logique,5,Le Calcul des Sequents,12,861,5,QCM,0.03,0.92,71.89,45,17,62,60,45,15,1.03,75.0,Facile,Facile,0,Meme Difficulté,Adapte
6415,2020,Philosophie,2,La Notion de Logique,5,Le Calcul des Sequents,12,861,5,QCM,0.04,0.85,71.89,47,19,66,61,47,14,1.08,77.05,Facile,Facile,0,Meme Difficulté,Adapte
861,2015,Philosophie,2,La Notion de Logique,5,Le Calcul des Sequents,12,862,6,QCU,0.14,0.92,81.82,41,9,50,44,41,3,1.14,93.18,Difficile,Facile,2,Beaucoup plus Facile,Pas Adapte
1972,2016,Philosophie,2,La Notion de Logique,5,Le Calcul des Sequents,12,862,6,QCM,0.14,0.72,81.27,46,11,57,49,46,3,1.16,93.88,Difficile,Facile,2,Beaucoup plus Facile,Pas Adapte
3083,2017,Philosophie,2,La Notion de Logique,5,Le Calcul des Sequents,12,862,6,QCM,0.01,0.82,87.5,44,6,50,49,44,5,1.02,89.8,Facile,Facile,0,Meme Difficulté,Pas Adapte
4194,2018,Philosophie,2,La Notion de Logique,5,Le Calcul des Sequents,12,862,6,QCM,0.43,0.38,38.86,21,32,53,49,21,28,1.08,42.86,Difficile,Moyen,1,Plus Facile,Pas Adapte
5305,2019,Philosophie,2,La Notion de Logique,5,Le Calcul des Sequents,12,862,6,QCM,0.58,0.25,18.47,11,48,59,29,11,18,2.03,37.93,Facile,Difficile,-2,Beaucoup plus Difficile,Pas Adapte
6416,2020,Philosophie,2,La Notion de Logique,5,Le Calcul des Sequents,12,862,6,QCM,0.75,0.15,13.17,7,46,53,47,7,40,1.13,14.89,Difficile,Difficile,0,Meme Difficulté,Pas Adapte
862,2015,Philosophie,2,La Notion de Logique,5,Le Calcul des Sequents,12,863,7,QCU,0.4,0.68,48.29,11,12,23,21,11,10,1.1,52.38,Moyen,Moyen,0,Meme Difficulté,Pas Adapte
1973,2016,Philosophie,2,La Notion de Logique,5,Le Calcul des Sequents,12,863,7,QCU,0.33,0.75,46.72,10,11,21,11,10,1,1.91,90.91,Difficile,Moyen,1,Plus Facile,Pas Adapte
3084,2017,Philosophie,2,La Notion de Logique,5,Le Calcul des Sequents,12,863,7,QROC,0.07,0.5,75.04,18,6,24,18,18,0,1.33,100.0,Moyen,Facile,1,Plus Facile,Pas Adapte
4195,2018,Philosophie,2,La Notion de Logique,5,Le Calcul des Sequents,12,863,7,QO,0.81,0.02,2.76,1,19,20,19,1,18,1.05,5.26,Difficile,Difficile,0,Meme Difficulté,Pas Adapte
5306,2019,Philosophie,2,La Notion de Logique,5,Le Calcul des Sequents,12,863,7,QO,0.35,0.16,58.56,12,8,20,17,12,5,1.18,70.59,Difficile,Moyen,1,Plus Facile,Pas Adapte
6417,2020,Philosophie,2,La Notion de Logique,5,Le Calcul des Sequents,12,863,7,QO,0.06,0.62,92.7,17,1,18,17,17,0,1.06,100.0,Moyen,Facile,1,Plus Facile,Pas Adapte
863,2015,Philosophie,2,La Notion de Logique,5,Le Calcul des Sequents,12,864,8,QCU,0.42,0.25,16.95,6,31,37,26,6,20,1.42,23.08,Moyen,Difficile,-1,Plus Difficile,Pas Adapte
1974,2016,Philosophie,2,La Notion de Logique,5,Le Calcul des Sequents,12,864,8,QCU,0.15,0.93,79.97,30,8,38,31,30,1,1.23,96.77,Moyen,Facile,1,Plus Facile,Pas Adapte
3085,2017,Philosophie,2,La Notion de Logique,5,Le Calcul des Sequents,12,864,8,QCM,0.7,0.3,11.16,5,39,44,14,5,9,3.14,35.71,Difficile,Difficile,0,Meme Difficulté,Pas Adapte
4196,2018,Philosophie,2,La Notion de Logique,5,Le Calcul des Sequents,12,864,8,QCM,0.26,0.67,55.29,28,22,50,37,28,9,1.35,75.68,Facile,Moyen,-1,Plus Difficile,Pas Adapte
5307,2019,Philosophie,2,La Notion de Logique,5,Le Calcul des Sequents,12,864,8,QCM,0.59,0.21,19.21,10,40,50,38,10,28,1.32,26.32,Difficile,Difficile,0,Meme Difficulté,Pas Adapte
6418,2020,Philosophie,2,La Notion de Logique,5,Le Calcul des Sequents,12,864,8,QCM,0.46,0.47,59.9,34,22,56,47,34,13,1.19,72.34,Moyen,Moyen,0,Meme Difficulté,Pas Adapte
864,2015,Philosophie,2,La Notion de Logique,5,Le Calcul des Sequents,12,865,9,QCU,0.02,0.81,77.44,60,18,78,64,60,4,1.22,93.75,Moyen,Facile,1,Plus Facile,Pas Adapte
1975,2016,Philosophie,2,La Notion de Logique,5,Le Calcul des Sequents,12,865,9,QCU,0.53,0.23,2.7,2,82,84,54,2,52,1.56,3.7,Difficile,Difficile,0,Meme Difficulté,Pas Adapte
3086,2017,Philosophie,2,La Notion de Logique,5,Le Calcul des Sequents,12,865,9,QCU,0.16,0.89,68.98,63,28,91,79,63,16,1.15,79.75,Difficile,Facile,2,Beaucoup plus Facile,Adapte
4197,2018,Philosophie,2,La Notion de Logique,5,Le Calcul des Sequents,12,865,9,QCU,0.15,0.86,68.98,60,27,87,81,60,21,1.07,74.07,Facile,Facile,0,Meme Difficulté,Adapte
5308,2019,Philosophie,2,La Notion de Logique,5,Le Calcul des Sequents,12,865,9,QCU,0.13,0.93,68.98,57,25,82,82,57,25,1.0,69.51,Facile,Facile,0,Meme Difficulté,Adapte
6419,2020,Philosophie,2,La Notion de Logique,5,Le Calcul des Sequents,12,865,9,QCU,0.1,0.89,68.98,63,29,92,79,63,16,1.16,79.75,Facile,Facile,0,Meme Difficulté,Adapte
865,2015,Philosophie,2,La Notion de Logique,5,Le Calcul des Sequents,12,866,10,QCM,0.61,0.29,16.2,2,8,10,3,2,1,3.33,66.67,Difficile,Difficile,0,Meme Difficulté,Pas Adapte
1976,2016,Philosophie,2,La Notion de Logique,5,Le Calcul des Sequents,12,866,10,QCM,0.41,0.36,64.45,6,4,10,9,6,3,1.11,66.67,Facile,Moyen,-1,Plus Difficile,Pas Adapte
3087,2017,Philosophie,2,La Notion de Logique,5,Le Calcul des Sequents,12,866,10,QCM,0.25,0.55,41.47,3,5,8,8,3,5,1.0,37.5,Moyen,Moyen,0,Meme Difficulté,Pas Adapte
4198,2018,Philosophie,2,La Notion de Logique,5,Le Calcul des Sequents,12,866,10,QCM,0.02,0.84,80.82,6,1,7,6,6,0,1.17,100.0,Difficile,Facile,2,Beaucoup plus Facile,Pas Adapte
5309,2019,Philosophie,2,La Notion de Logique,5,Le Calcul des Sequents,12,866,10,QCM,0.69,0.18,10.13,1,7,8,5,1,4,1.6,20.0,Difficile,Difficile,0,Meme Difficulté,Pas Adapte
6420,2020,Philosophie,2,La Notion de Logique,5,Le Calcul des Sequents,12,866,10,QCM,0.61,0.21,23.14,2,7,9,8,2,6,1.12,25.0,Moyen,Difficile,-1,Plus Difficile,Pas Adapte
866,2015,Philosophie,2,La Notion de Logique,5,Le Calcul des Sequents,12,867,11,QCU,0.66,0.27,24.07,22,70,92,34,22,12,2.71,64.71,Difficile,Difficile,0,Meme Difficulté,Pas Adapte
1977,2016,Philosophie,2,La Notion de Logique,5,Le Calcul des Sequents,12,867,11,QCU,0.41,0.34,15.39,15,84,99,99,15,84,1.0,15.15,Difficile,Difficile,0,Meme Difficulté,Pas Adapte
3088,2017,Philosophie,2,La Notion de Logique,5,Le Calcul des Sequents,12,867,11,QCU,0.35,0.47,43.74,49,63,112,101,49,52,1.11,48.51,Difficile,Moyen,1,Plus Facile,Pas Adapte
4199,2018,Philosophie,2,La Notion de Logique,5,Le Calcul des Sequents,12,867,11,QCU,0.08,0.87,89.77,90,10,100,98,90,8,1.02,91.84,Moyen,Facile,1,Plus Facile,Pas Adapte
5310,2019,Philosophie,2,La Notion de Logique,5,Le Calcul des Sequents,12,867,11,QCU,0.33,0.58,64.2,57,32,89,79,57,22,1.13,72.15,Difficile,Moyen,1,Plus Facile,Pas Adapte
6421,2020,Philosophie,2,La Notion de Logique,5,Le Calcul des Sequents,12,867,11,QCM,0.2,0.89,82.11,84,18,102,97,84,13,1.05,86.6,Moyen,Facile,1,Plus Facile,Pas Adapte
867,2015,Philosophie,2,La Notion de Logique,5,Le Calcul des Sequents,12,868,12,QCU,0.62,0.35,18.02,14,61,75,55,14,41,1.36,25.45,Difficile,Difficile,0,Meme Difficulté,Pas Adapte
1978,2016,Philosophie,2,La Notion de Logique,5,Le Calcul des Sequents,12,868,12,QCU,0.11,0.97,81.22,63,15,78,78,63,15,1.0,80.77,Difficile,Facile,2,Beaucoup plus Facile,Pas Adapte
3089,2017,Philosophie,2,La Notion de Logique,5,Le Calcul des Sequents,12,868,12,QCU,0.33,0.47,61.92,51,32,83,83,51,32,1.0,61.45,Moyen,Moyen,0,Meme Difficulté,Pas Adapte
4200,2018,Philosophie,2,La Notion de Logique,5,Le Calcul des Sequents,12,868,12,QCU,0.21,0.57,41.25,35,51,86,40,35,5,2.15,87.5,Difficile,Moyen,1,Plus Facile,Pas Adapte
5311,2019,Philosophie,2,La Notion de Logique,5,Le Calcul des Sequents,12,868,12,QCU,0.23,0.68,53.76,44,37,81,74,44,30,1.09,59.46,Moyen,Moyen,0,Meme Difficulté,Pas Adapte
6422,2020,Philosophie,2,La Notion de Logique,5,Le Calcul des Sequents,12,868,12,QCU,0.23,0.57,40.43,35,51,86,70,35,35,1.23,50.0,Moyen,Moyen,0,Meme Difficulté,Pas Adapte
868,2015,Philosophie,2,La Notion de Logique,6,Le Theoreme de Completude,9,869,1,QROC,0.44,0.26,56.74,26,19,45,31,26,5,1.45,83.87,Difficile,Moyen,1,Plus Facile,Pas Adapte
1979,2016,Philosophie,2,La Notion de Logique,6,Le Theoreme de Completude,9,869,1,QROC,0.72,0.09,32.42,13,27,40,37,13,24,1.08,35.14,Difficile,Difficile,0,Meme Difficulté,Pas Adapte
3090,2017,Philosophie,2,La Notion de Logique,6,Le Theoreme de Completude,9,869,1,QROC,0.41,0.37,63.56,27,15,42,33,27,6,1.27,81.82,Moyen,Moyen,0,Meme Difficulté,Pas Adapte
4201,2018,Philosophie,2,La Notion de Logique,6,Le Theoreme de Completude,9,869,1,QROC,0.69,0.15,34.48,13,26,39,24,13,11,1.62,54.17,Facile,Difficile,-2,Beaucoup plus Difficile,Pas Adapte
5312,2019,Philosophie,2,La Notion de Logique,6,Le Theoreme de Completude,9,869,1,QROC,0.89,0.15,1.41,1,38,39,34,1,33,1.15,2.94,Difficile,Difficile,0,Meme Difficulté,Pas Adapte
6423,2020,Philosophie,2,La Notion de Logique,6,Le Theoreme de Completude,9,869,1,QO,0.78,0.1,6.32,2,34,36,26,2,24,1.38,7.69,Difficile,Difficile,0,Meme Difficulté,Pas Adapte
869,2015,Philosophie,2,La Notion de Logique,6,Le Theoreme de Completude,9,870,2,QCM,0.68,0.25,15.11,14,79,93,58,14,44,1.6,24.14,Difficile,Difficile,0,Meme Difficulté,Pas Adapte
1980,2016,Philosophie,2,La Notion de Logique,6,Le Theoreme de Completude,9,870,2,QCM,0.25,0.4,53.81,46,40,86,67,46,21,1.28,68.66,Difficile,Moyen,1,Plus Facile,Pas Adapte
3091,2017,Philosophie,2,La Notion de Logique,6,Le Theoreme de Completude,9,870,2,QCM,0.09,0.79,76.79,62,19,81,71,62,9,1.14,87.32,Difficile,Facile,2,Beaucoup plus Facile,Pas Adapte
4202,2018,Philosophie,2,La Notion de Logique,6,Le Theoreme de Completude,9,870,2,QCM,0.17,0.75,89.5,66,8,74,69,66,3,1.07,95.65,Difficile,Facile,2,Beaucoup plus Facile,Pas Adapte
5313,2019,Philosophie,2,La Notion de Logique,6,Le Theoreme de Completude,9,870,2,QCM,0.33,0.37,37.84,31,52,83,79,31,48,1.05,39.24,Facile,Moyen,-1,Plus Difficile,Pas Adapte
6424,2020,Philosophie,2,La Notion de Logique,6,Le Theoreme de Completude,9,870,2,QCM,0.56,0.23,27.42,25,65,90,74,25,49,1.22,33.78,Facile,Difficile,-2,Beaucoup plus Difficile,Pas Adapte
870,2015,Philosophie,2,La Notion de Logique,6,Le Theoreme de Completude,9,871,3,QCM,0.61,0.22,25.07,21,61,82,69,21,48,1.19,30.43,Facile,Difficile,-2,Beaucoup plus Difficile,Pas Adapte
1981,2016,Philosophie,2,La Notion de Logique,6,Le Theoreme de Completude,9,871,3,QROC,0.46,0.26,42.05,33,45,78,63,33,30,1.24,52.38,Facile,Moyen,-1,Plus Difficile,Pas Adapte
3092,2017,Philosophie,2,La Notion de Logique,6,Le Theoreme de Completude,9,871,3,QCM,0.5,0.58,55.32,45,36,81,58,45,13,1.4,77.59,Moyen,Moyen,0,Meme Difficulté,Pas Adapte
4203,2018,Philosophie,2,La Notion de Logique,6,Le Theoreme de Completude,9,871,3,QCM,0.79,0.28,6.2,6,86,92,85,6,79,1.08,7.06,Difficile,Difficile,0,Meme Difficulté,Pas Adapte
5314,2019,Philosophie,2,La Notion de Logique,6,Le Theoreme de Completude,9,871,3,QCM,0.31,0.67,37.91,30,49,79,41,30,11,1.93,73.17,Moyen,Moyen,0,Meme Difficulté,Pas Adapte
6425,2020,Philosophie,2,La Notion de Logique,6,Le Theoreme de Completude,9,871,3,QCM,0.73,0.15,31.2,24,54,78,51,24,27,1.53,47.06,Difficile,Difficile,0,Meme Difficulté,Pas Adapte
871,2015,Philosophie,2,La Notion de Logique,6,Le Theoreme de Completude,9,872,4,QCM,0.01,0.78,83.72,6,1,7,7,6,1,1.0,85.71,Difficile,Facile,2,Beaucoup plus Facile,Pas Adapte
1982,2016,Philosophie,2,La Notion de Logique,6,Le Theoreme de Completude,9,872,4,QCM,0.59,0.17,25.74,2,4,6,3,2,1,2.0,66.67,Facile,Difficile,-2,Beaucoup plus Difficile,Pas Adapte
3093,2017,Philosophie,2,La Notion de Logique,6,Le Theoreme de Completude,9,872,4,QCM,0.14,0.84,81.56,4,1,5,5,4,1,1.0,80.0,Facile,Facile,0,Meme Difficulté,Pas Adapte
4204,2018,Philosophie,2,La Notion de Logique,6,Le Theoreme de Completude,9,872,4,QCM,0.65,0.17,29.83,1,3,4,2,1,1,2.0,50.0,Difficile,Difficile,0,Meme Difficulté,Pas Adapte
5315,2019,Philosophie,2,La Notion de Logique,6,Le Theoreme de Completude,9,872,4,QCM,0.03,0.84,82.28,3,1,4,3,3,0,1.33,100.0,Moyen,Facile,1,Plus Facile,Pas Adapte
6426,2020,Philosophie,2,La Notion de Logique,6,Le Theoreme de Completude,9,872,4,QCM,0.12,0.97,98.81,5,0,5,5,5,0,1.0,100.0,Moyen,Facile,1,Plus Facile,Pas Adapte
872,2015,Philosophie,2,La Notion de Logique,6,Le Theoreme de Completude,9,873,5,QCU,0.67,0.33,5.17,4,75,79,27,4,23,2.93,14.81,Moyen,Difficile,-1,Plus Difficile,Pas Adapte
1983,2016,Philosophie,2,La Notion de Logique,6,Le Theoreme de Completude,9,873,5,QCM,0.64,0.29,23.26,20,67,87,64,20,44,1.36,31.25,Facile,Difficile,-2,Beaucoup plus Difficile,Pas Adapte
3094,2017,Philosophie,2,La Notion de Logique,6,Le Theoreme de Completude,9,873,5,QCM,0.19,0.84,84.23,82,15,97,95,82,13,1.02,86.32,Difficile,Facile,2,Beaucoup plus Facile,Pas Adapte
4205,2018,Philosophie,2,La Notion de Logique,6,Le Theoreme de Completude,9,873,5,QCM,0.6,0.2,20.4,19,73,92,83,19,64,1.11,22.89,Difficile,Difficile,0,Meme Difficulté,Pas Adapte
5316,2019,Philosophie,2,La Notion de Logique,6,Le Theoreme de Completude,9,873,5,QCM,0.58,0.23,25.45,25,72,97,87,25,62,1.11,28.74,Moyen,Difficile,-1,Plus Difficile,Pas Adapte
6427,2020,Philosophie,2,La Notion de Logique,6,Le Theoreme de Completude,9,873,5,QCM,0.76,0.2,5.0,5,95,100,38,5,33,2.63,13.16,Facile,Difficile,-2,Beaucoup plus Difficile,Pas Adapte
873,2015,Philosophie,2,La Notion de Logique,6,Le Theoreme de Completude,9,874,6,QCU,0.11,0.92,97.38,64,2,66,65,64,1,1.02,98.46,Facile,Facile,0,Meme Difficulté,Pas Adapte
1984,2016,Philosophie,2,La Notion de Logique,6,Le Theoreme de Completude,9,874,6,QCU,0.23,0.55,36.89,27,45,72,51,27,24,1.41,52.94,Facile,Moyen,-1,Plus Difficile,Pas Adapte
3095,2017,Philosophie,2,La Notion de Logique,6,Le Theoreme de Completude,9,874,6,QCU,0.17,0.99,73.51,46,17,63,57,46,11,1.11,80.7,Difficile,Facile,2,Beaucoup plus Facile,Adapte
4206,2018,Philosophie,2,La Notion de Logique,6,Le Theoreme de Completude,9,874,6,QCU,0.15,0.93,73.51,49,18,67,63,49,14,1.06,77.78,Facile,Facile,0,Meme Difficulté,Adapte
5317,2019,Philosophie,2,La Notion de Logique,6,Le Theoreme de Completude,9,874,6,QCU,0.17,0.84,73.51,43,16,59,54,43,11,1.09,79.63,Facile,Facile,0,Meme Difficulté,Adapte
6428,2020,Philosophie,2,La Notion de Logique,6,Le Theoreme de Completude,9,874,6,QCM,0.17,0.82,73.51,40,15,55,46,40,6,1.2,86.96,Facile,Facile,0,Meme Difficulté,Adapte
874,2015,Philosophie,2,La Notion de Logique,6,Le Theoreme de Completude,9,875,7,QCU,0.63,0.27,31.0,5,11,16,15,5,10,1.07,33.33,Moyen,Difficile,-1,Plus Difficile,Pas Adapte
1985,2016,Philosophie,2,La Notion de Logique,6,Le Theoreme de Completude,9,875,7,QCU,0.35,0.52,55.73,10,8,18,15,10,5,1.2,66.67,Difficile,Moyen,1,Plus Facile,Pas Adapte
3096,2017,Philosophie,2,La Notion de Logique,6,Le Theoreme de Completude,9,875,7,QCU,0.22,0.47,49.49,9,9,18,16,9,7,1.12,56.25,Facile,Moyen,-1,Plus Difficile,Pas Adapte
4207,2018,Philosophie,2,La Notion de Logique,6,Le Theoreme de Completude,9,875,7,QCU,0.31,0.43,35.67,6,12,18,7,6,1,2.57,85.71,Facile,Moyen,-1,Plus Difficile,Pas Adapte
5318,2019,Philosophie,2,La Notion de Logique,6,Le Theoreme de Completude,9,875,7,QCU,0.31,0.7,60.91,10,7,17,12,10,2,1.42,83.33,Difficile,Moyen,1,Plus Facile,Pas Adapte
6429,2020,Philosophie,2,La Notion de Logique,6,Le Theoreme de Completude,9,875,7,QCU,0.15,0.96,82.95,14,3,17,16,14,2,1.06,87.5,Facile,Facile,0,Meme Difficulté,Pas Adapte
875,2015,Philosophie,2,La Notion de Logique,6,Le Theoreme de Completude,9,876,8,QCU,0.5,0.33,29.25,4,9,13,7,4,3,1.86,57.14,Difficile,Difficile,0,Meme Difficulté,Pas Adapte
1986,2016,Philosophie,2,La Notion de Logique,6,Le Theoreme de Completude,9,876,8,QCU,0.5,0.29,33.19,4,9,13,10,4,6,1.3,40.0,Facile,Difficile,-2,Beaucoup plus Difficile,Pas Adapte
3097,2017,Philosophie,2,La Notion de Logique,6,Le Theoreme de Completude,9,876,8,QCU,0.21,0.47,63.16,8,4,12,12,8,4,1.0,66.67,Difficile,Moyen,1,Plus Facile,Pas Adapte
4208,2018,Philosophie,2,La Notion de Logique,6,Le Theoreme de Completude,9,876,8,QCU,0.2,0.5,45.64,6,8,14,11,6,5,1.27,54.55,Moyen,Moyen,0,Meme Difficulté,Pas Adapte
5319,2019,Philosophie,2,La Notion de Logique,6,Le Theoreme de Completude,9,876,8,QCU,0.16,0.95,99.88,16,0,16,16,16,0,1.0,100.0,Facile,Facile,0,Meme Difficulté,Pas Adapte
6430,2020,Philosophie,2,La Notion de Logique,6,Le Theoreme de Completude,9,876,8,QCM,0.22,0.66,44.53,7,9,16,8,7,1,2.0,87.5,Moyen,Moyen,0,Meme Difficulté,Pas Adapte
876,2015,Philosophie,2,La Notion de Logique,6,Le Theoreme de Completude,9,877,9,QCU,0.17,0.92,80.04,24,6,30,27,24,3,1.11,88.89,Moyen,Facile,1,Plus Facile,Pas Adapte
1987,2016,Philosophie,2,La Notion de Logique,6,Le Theoreme de Completude,9,877,9,QCU,0.42,0.2,7.65,2,30,32,29,2,27,1.1,6.9,Moyen,Difficile,-1,Plus Difficile,Pas Adapte
3098,2017,Philosophie,2,La Notion de Logique,6,Le Theoreme de Completude,9,877,9,QCU,0.33,0.74,44.84,16,20,36,23,16,7,1.57,69.57,Facile,Moyen,-1,Plus Difficile,Pas Adapte
4209,2018,Philosophie,2,La Notion de Logique,6,Le Theoreme de Completude,9,877,9,QCU,0.72,0.3,25.08,8,25,33,29,8,21,1.14,27.59,Facile,Difficile,-2,Beaucoup plus Difficile,Pas Adapte
5320,2019,Philosophie,2,La Notion de Logique,6,Le Theoreme de Completude,9,877,9,QCU,0.45,0.32,8.15,3,29,32,26,3,23,1.23,11.54,Moyen,Difficile,-1,Plus Difficile,Pas Adapte
6431,2020,Philosophie,2,La Notion de Logique,6,Le Theoreme de Completude,9,877,9,QCM,0.42,0.57,53.17,20,17,37,27,20,7,1.37,74.07,Facile,Moyen,-1,Plus Difficile,Pas Adapte
877,2015,Philosophie,3,La Notion d'Ethique,1,La Recherche d'Ethique,9,878,1,QCM,0.69,0.2,18.37,8,38,46,13,8,5,3.54,61.54,Facile,Difficile,-2,Beaucoup plus Difficile,Pas Adapte
1988,2016,Philosophie,3,La Notion d'Ethique,1,La Recherche d'Ethique,9,878,1,QCM,0.09,0.97,77.11,33,10,43,40,33,7,1.07,82.5,Difficile,Facile,2,Beaucoup plus Facile,Pas Adapte
3099,2017,Philosophie,3,La Notion d'Ethique,1,La Recherche d'Ethique,9,878,1,QCM,0.13,0.77,77.5,29,8,37,29,29,0,1.28,100.0,Moyen,Facile,1,Plus Facile,Pas Adapte
4210,2018,Philosophie,3,La Notion d'Ethique,1,La Recherche d'Ethique,9,878,1,QCM,0.74,0.16,31.51,12,25,37,14,12,2,2.64,85.71,Difficile,Difficile,0,Meme Difficulté,Pas Adapte
5321,2019,Philosophie,3,La Notion d'Ethique,1,La Recherche d'Ethique,9,878,1,QCM,0.33,0.63,61.3,26,17,43,37,26,11,1.16,70.27,Facile,Moyen,-1,Plus Difficile,Pas Adapte
6432,2020,Philosophie,3,La Notion d'Ethique,1,La Recherche d'Ethique,9,878,1,QCU,0.26,0.4,55.15,24,19,43,38,24,14,1.13,63.16,Moyen,Moyen,0,Meme Difficulté,Pas Adapte
878,2015,Philosophie,3,La Notion d'Ethique,1,La Recherche d'Ethique,9,879,2,QCU,0.14,0.76,67.5,44,21,65,55,44,11,1.18,80.0,Difficile,Facile,2,Beaucoup plus Facile,Adapte
1989,2016,Philosophie,3,La Notion d'Ethique,1,La Recherche d'Ethique,9,879,2,QCU,0.19,0.96,67.5,49,24,73,69,49,20,1.06,71.01,Facile,Facile,0,Meme Difficulté,Adapte
3100,2017,Philosophie,3,La Notion d'Ethique,1,La Recherche d'Ethique,9,879,2,QCU,0.04,0.9,67.5,47,23,70,55,47,8,1.27,85.45,Facile,Facile,0,Meme Difficulté,Adapte
4211,2018,Philosophie,3,La Notion d'Ethique,1,La Recherche d'Ethique,9,879,2,QCM,0.0,0.83,67.5,53,25,78,55,53,2,1.42,96.36,Facile,Facile,0,Meme Difficulté,Adapte
5322,2019,Philosophie,3,La Notion d'Ethique,1,La Recherche d'Ethique,9,879,2,QCM,0.17,0.96,67.5,57,27,84,62,57,5,1.35,91.94,Facile,Facile,0,Meme Difficulté,Adapte
6433,2020,Philosophie,3,La Notion d'Ethique,1,La Recherche d'Ethique,9,879,2,QCU,0.05,0.76,67.5,65,32,97,73,65,8,1.33,89.04,Facile,Facile,0,Meme Difficulté,Adapte
879,2015,Philosophie,3,La Notion d'Ethique,1,La Recherche d'Ethique,9,880,3,QCM,0.15,0.8,72.98,55,21,76,68,55,13,1.12,80.88,Moyen,Facile,1,Plus Facile,Adapte
1990,2016,Philosophie,3,La Notion d'Ethique,1,La Recherche d'Ethique,9,880,3,QCM,0.19,0.81,72.98,55,21,76,56,55,1,1.36,98.21,Facile,Facile,0,Meme Difficulté,Adapte
3101,2017,Philosophie,3,La Notion d'Ethique,1,La Recherche d'Ethique,9,880,3,QCM,0.18,0.74,72.98,58,22,80,65,58,7,1.23,89.23,Facile,Facile,0,Meme Difficulté,Adapte
4212,2018,Philosophie,3,La Notion d'Ethique,1,La Recherche d'Ethique,9,880,3,QCM,0.17,0.74,72.98,50,19,69,58,50,8,1.19,86.21,Facile,Facile,0,Meme Difficulté,Adapte
5323,2019,Philosophie,3,La Notion d'Ethique,1,La Recherche d'Ethique,9,880,3,QCM,0.14,0.71,72.98,53,19,72,67,53,14,1.07,79.1,Facile,Facile,0,Meme Difficulté,Adapte
6434,2020,Philosophie,3,La Notion d'Ethique,1,La Recherche d'Ethique,9,880,3,QCM,0.02,0.96,72.98,47,17,64,53,47,6,1.21,88.68,Facile,Facile,0,Meme Difficulté,Adapte
880,2015,Philosophie,3,La Notion d'Ethique,1,La Recherche d'Ethique,9,881,4,QCM,0.12,0.78,88.26,55,7,62,60,55,5,1.03,91.67,Difficile,Facile,2,Beaucoup plus Facile,Pas Adapte
1991,2016,Philosophie,3,La Notion d'Ethique,1,La Recherche d'Ethique,9,881,4,QCM,0.51,0.29,13.76,7,47,54,24,7,17,2.25,29.17,Moyen,Difficile,-1,Plus Difficile,Pas Adapte
3102,2017,Philosophie,3,La Notion d'Ethique,1,La Recherche d'Ethique,9,881,4,QROC,0.02,0.67,96.0,48,2,50,48,48,0,1.04,100.0,Difficile,Facile,2,Beaucoup plus Facile,Pas Adapte
4213,2018,Philosophie,3,La Notion d'Ethique,1,La Recherche d'Ethique,9,881,4,QROC,0.29,0.31,43.66,23,29,52,34,23,11,1.53,67.65,Facile,Moyen,-1,Plus Difficile,Pas Adapte
5324,2019,Philosophie,3,La Notion d'Ethique,1,La Recherche d'Ethique,9,881,4,QROC,0.33,0.3,37.51,20,34,54,34,20,14,1.59,58.82,Difficile,Moyen,1,Plus Facile,Pas Adapte
6435,2020,Philosophie,3,La Notion d'Ethique,1,La Recherche d'Ethique,9,881,4,QO,0.81,0.14,6.56,3,47,50,25,3,22,2.0,12.0,Facile,Difficile,-2,Beaucoup plus Difficile,Pas Adapte
881,2015,Philosophie,3,La Notion d'Ethique,1,La Recherche d'Ethique,9,882,5,QCM,0.43,0.53,36.51,24,43,67,48,24,24,1.4,50.0,Moyen,Moyen,0,Meme Difficulté,Pas Adapte
1992,2016,Philosophie,3,La Notion d'Ethique,1,La Recherche d'Ethique,9,882,5,QCM,0.24,0.59,50.75,33,32,65,41,33,8,1.59,80.49,Difficile,Moyen,1,Plus Facile,Pas Adapte
3103,2017,Philosophie,3,La Notion d'Ethique,1,La Recherche d'Ethique,9,882,5,QCM,0.49,0.67,53.44,32,27,59,57,32,25,1.04,56.14,Facile,Moyen,-1,Plus Difficile,Pas Adapte
4214,2018,Philosophie,3,La Notion d'Ethique,1,La Recherche d'Ethique,9,882,5,QCU,0.45,0.24,33.03,21,43,64,28,21,7,2.29,75.0,Moyen,Difficile,-1,Plus Difficile,Pas Adapte
5325,2019,Philosophie,3,La Notion d'Ethique,1,La Recherche d'Ethique,9,882,5,QCU,0.15,0.89,82.67,56,12,68,65,56,9,1.05,86.15,Difficile,Facile,2,Beaucoup plus Facile,Pas Adapte
6436,2020,Philosophie,3,La Notion d'Ethique,1,La Recherche d'Ethique,9,882,5,QCU,0.08,0.93,69.38,44,19,63,51,44,7,1.24,86.27,Moyen,Facile,1,Plus Facile,Adapte
882,2015,Philosophie,3,La Notion d'Ethique,1,La Recherche d'Ethique,9,883,6,QCM,0.14,0.84,80.44,47,12,59,53,47,6,1.11,88.68,Moyen,Facile,1,Plus Facile,Pas Adapte
1993,2016,Philosophie,3,La Notion d'Ethique,1,La Recherche d'Ethique,9,883,6,QCM,0.72,0.27,34.82,23,44,67,53,23,30,1.26,43.4,Difficile,Difficile,0,Meme Difficulté,Pas Adapte
3104,2017,Philosophie,3,La Notion d'Ethique,1,La Recherche d'Ethique,9,883,6,QCM,0.53,0.22,20.94,13,49,62,25,13,12,2.48,52.0,Difficile,Difficile,0,Meme Difficulté,Pas Adapte
4215,2018,Philosophie,3,La Notion d'Ethique,1,La Recherche d'Ethique,9,883,6,QCM,0.14,0.76,98.29,57,1,58,58,57,1,1.0,98.28,Moyen,Facile,1,Plus Facile,Pas Adapte
5326,2019,Philosophie,3,La Notion d'Ethique,1,La Recherche d'Ethique,9,883,6,QCM,0.62,0.22,32.68,21,43,64,44,21,23,1.45,47.73,Moyen,Difficile,-1,Plus Difficile,Pas Adapte
6437,2020,Philosophie,3,La Notion d'Ethique,1,La Recherche d'Ethique,9,883,6,QCM,0.07,0.93,98.4,59,1,60,59,59,0,1.02,100.0,Moyen,Facile,1,Plus Facile,Pas Adapte
883,2015,Philosophie,3,La Notion d'Ethique,1,La Recherche d'Ethique,9,884,7,QCU,0.55,0.34,19.11,7,31,38,23,7,16,1.65,30.43,Moyen,Difficile,-1,Plus Difficile,Pas Adapte
1994,2016,Philosophie,3,La Notion d'Ethique,1,La Recherche d'Ethique,9,884,7,QCM,0.0,0.94,92.41,30,2,32,30,30,0,1.07,100.0,Difficile,Facile,2,Beaucoup plus Facile,Pas Adapte
3105,2017,Philosophie,3,La Notion d'Ethique,1,La Recherche d'Ethique,9,884,7,QCM,0.43,0.55,56.09,20,15,35,32,20,12,1.09,62.5,Moyen,Moyen,0,Meme Difficulté,Pas Adapte
4216,2018,Philosophie,3,La Notion d'Ethique,1,La Recherche d'Ethique,9,884,7,QCM,0.51,0.22,5.78,2,31,33,16,2,14,2.06,12.5,Facile,Difficile,-2,Beaucoup plus Difficile,Pas Adapte
5327,2019,Philosophie,3,La Notion d'Ethique,1,La Recherche d'Ethique,9,884,7,QCM,0.47,0.51,35.22,13,23,36,24,13,11,1.5,54.17,Moyen,Moyen,0,Meme Difficulté,Pas Adapte
6438,2020,Philosophie,3,La Notion d'Ethique,1,La Recherche d'Ethique,9,884,7,QCU,0.04,0.89,73.04,25,9,34,29,25,4,1.17,86.21,Facile,Facile,0,Meme Difficulté,Adapte
884,2015,Philosophie,3,La Notion d'Ethique,1,La Recherche d'Ethique,9,885,8,QROC,0.04,0.45,82.63,45,9,54,52,45,7,1.04,86.54,Facile,Facile,0,Meme Difficulté,Pas Adapte
1995,2016,Philosophie,3,La Notion d'Ethique,1,La Recherche d'Ethique,9,885,8,QROC,0.02,0.53,95.71,57,3,60,58,57,1,1.03,98.28,Difficile,Facile,2,Beaucoup plus Facile,Pas Adapte
3106,2017,Philosophie,3,La Notion d'Ethique,1,La Recherche d'Ethique,9,885,8,QROC,0.01,0.94,98.24,67,1,68,67,67,0,1.01,100.0,Facile,Facile,0,Meme Difficulté,Pas Adapte
4217,2018,Philosophie,3,La Notion d'Ethique,1,La Recherche d'Ethique,9,885,8,QROC,0.12,0.73,98.53,72,1,73,73,72,1,1.0,98.63,Facile,Facile,0,Meme Difficulté,Pas Adapte
5328,2019,Philosophie,3,La Notion d'Ethique,1,La Recherche d'Ethique,9,885,8,QROC,0.14,0.82,66.38,53,27,80,60,53,7,1.33,88.33,Moyen,Facile,1,Plus Facile,Adapte
6439,2020,Philosophie,3,La Notion d'Ethique,1,La Recherche d'Ethique,9,885,8,QROC,0.14,0.56,66.38,56,29,85,70,56,14,1.21,80.0,Facile,Facile,0,Meme Difficulté,Adapte
885,2015,Philosophie,3,La Notion d'Ethique,1,La Recherche d'Ethique,9,886,9,QCU,0.25,0.49,47.56,9,9,18,10,9,1,1.8,90.0,Moyen,Moyen,0,Meme Difficulté,Pas Adapte
1996,2016,Philosophie,3,La Notion d'Ethique,1,La Recherche d'Ethique,9,886,9,QCU,0.59,0.4,27.25,6,15,21,7,6,1,3.0,85.71,Difficile,Difficile,0,Meme Difficulté,Pas Adapte
3107,2017,Philosophie,3,La Notion d'Ethique,1,La Recherche d'Ethique,9,886,9,QCU,0.31,0.73,45.73,11,13,24,22,11,11,1.09,50.0,Difficile,Moyen,1,Plus Facile,Pas Adapte
4218,2018,Philosophie,3,La Notion d'Ethique,1,La Recherche d'Ethique,9,886,9,QCU,0.28,0.47,46.64,10,11,21,14,10,4,1.5,71.43,Difficile,Moyen,1,Plus Facile,Pas Adapte
5329,2019,Philosophie,3,La Notion d'Ethique,1,La Recherche d'Ethique,9,886,9,QCU,0.01,0.82,77.19,15,5,20,17,15,2,1.18,88.24,Facile,Facile,0,Meme Difficulté,Pas Adapte
6440,2020,Philosophie,3,La Notion d'Ethique,1,La Recherche d'Ethique,9,886,9,QCU,0.13,0.93,88.68,19,2,21,20,19,1,1.05,95.0,Moyen,Facile,1,Plus Facile,Pas Adapte
886,2015,Philosophie,3,La Notion d'Ethique,2,Libre Arbitre et Determinisme,4,887,1,QCU,0.31,0.62,61.82,47,29,76,64,47,17,1.19,73.44,Difficile,Moyen,1,Plus Facile,Pas Adapte
1997,2016,Philosophie,3,La Notion d'Ethique,2,Libre Arbitre et Determinisme,4,887,1,QCU,0.31,0.59,60.63,52,33,85,54,52,2,1.57,96.3,Difficile,Moyen,1,Plus Facile,Pas Adapte
3108,2017,Philosophie,3,La Notion d'Ethique,2,Libre Arbitre et Determinisme,4,887,1,QCU,0.21,0.71,36.15,29,51,80,41,29,12,1.95,70.73,Facile,Moyen,-1,Plus Difficile,Pas Adapte
4219,2018,Philosophie,3,La Notion d'Ethique,2,Libre Arbitre et Determinisme,4,887,1,QCU,0.41,0.39,22.79,18,59,77,36,18,18,2.14,50.0,Moyen,Difficile,-1,Plus Difficile,Pas Adapte
5330,2019,Philosophie,3,La Notion d'Ethique,2,Libre Arbitre et Determinisme,4,887,1,QCU,0.28,0.45,36.86,27,47,74,62,27,35,1.19,43.55,Facile,Moyen,-1,Plus Difficile,Pas Adapte
6441,2020,Philosophie,3,La Notion d'Ethique,2,Libre Arbitre et Determinisme,4,887,1,QCM,0.42,0.68,60.91,41,26,67,47,41,6,1.43,87.23,Facile,Moyen,-1,Plus Difficile,Pas Adapte
887,2015,Philosophie,3,La Notion d'Ethique,2,Libre Arbitre et Determinisme,4,888,2,QCU,0.34,0.45,42.86,29,38,67,46,29,17,1.46,63.04,Facile,Moyen,-1,Plus Difficile,Pas Adapte
1998,2016,Philosophie,3,La Notion d'Ethique,2,Libre Arbitre et Determinisme,4,888,2,QCM,0.26,0.7,55.55,37,29,66,51,37,14,1.29,72.55,Difficile,Moyen,1,Plus Facile,Pas Adapte
3109,2017,Philosophie,3,La Notion d'Ethique,2,Libre Arbitre et Determinisme,4,888,2,QCM,0.04,0.91,69.29,42,19,61,54,42,12,1.13,77.78,Difficile,Facile,2,Beaucoup plus Facile,Adapte
4220,2018,Philosophie,3,La Notion d'Ethique,2,Libre Arbitre et Determinisme,4,888,2,QCM,0.07,1.0,69.29,44,20,64,61,44,17,1.05,72.13,Facile,Facile,0,Meme Difficulté,Adapte
5331,2019,Philosophie,3,La Notion d'Ethique,2,Libre Arbitre et Determinisme,4,888,2,QCM,0.19,0.78,69.29,42,19,61,48,42,6,1.27,87.5,Facile,Facile,0,Meme Difficulté,Adapte
6442,2020,Philosophie,3,La Notion d'Ethique,2,Libre Arbitre et Determinisme,4,888,2,QCM,0.18,0.77,69.29,42,18,60,56,42,14,1.07,75.0,Facile,Facile,0,Meme Difficulté,Adapte
888,2015,Philosophie,3,La Notion d'Ethique,2,Libre Arbitre et Determinisme,4,889,3,QCM,0.13,0.75,75.21,47,16,63,47,47,0,1.34,100.0,Difficile,Facile,2,Beaucoup plus Facile,Pas Adapte
1999,2016,Philosophie,3,La Notion d'Ethique,2,Libre Arbitre et Determinisme,4,889,3,QCM,0.5,0.66,36.24,23,41,64,33,23,10,1.94,69.7,Facile,Moyen,-1,Plus Difficile,Pas Adapte
3110,2017,Philosophie,3,La Notion d'Ethique,2,Libre Arbitre et Determinisme,4,889,3,QCM,0.73,0.27,25.61,14,40,54,53,14,39,1.02,26.42,Difficile,Difficile,0,Meme Difficulté,Pas Adapte
4221,2018,Philosophie,3,La Notion d'Ethique,2,Libre Arbitre et Determinisme,4,889,3,QCM,0.38,0.33,54.75,28,24,52,47,28,19,1.11,59.57,Facile,Moyen,-1,Plus Difficile,Pas Adapte
5332,2019,Philosophie,3,La Notion d'Ethique,2,Libre Arbitre et Determinisme,4,889,3,QCU,0.31,0.63,40.18,22,32,54,25,22,3,2.16,88.0,Moyen,Moyen,0,Meme Difficulté,Pas Adapte
6443,2020,Philosophie,3,La Notion d'Ethique,2,Libre Arbitre et Determinisme,4,889,3,QCU,0.6,0.38,29.47,17,40,57,29,17,12,1.97,58.62,Facile,Difficile,-2,Beaucoup plus Difficile,Pas Adapte
889,2015,Philosophie,3,La Notion d'Ethique,2,Libre Arbitre et Determinisme,4,890,4,QROC,0.35,0.36,61.04,12,7,19,13,12,1,1.46,92.31,Facile,Moyen,-1,Plus Difficile,Pas Adapte
2000,2016,Philosophie,3,La Notion d'Ethique,2,Libre Arbitre et Determinisme,4,890,4,QROC,0.1,0.87,94.31,18,1,19,19,18,1,1.0,94.74,Moyen,Facile,1,Plus Facile,Pas Adapte
3111,2017,Philosophie,3,La Notion d'Ethique,2,Libre Arbitre et Determinisme,4,890,4,QROC,0.85,0.06,2.05,0,20,20,15,0,15,1.33,0.0,Difficile,Difficile,0,Meme Difficulté,Pas Adapte
4222,2018,Philosophie,3,La Notion d'Ethique,2,Libre Arbitre et Determinisme,4,890,4,QROC,0.18,0.52,68.12,16,7,23,19,16,3,1.21,84.21,Moyen,Facile,1,Plus Facile,Adapte
5333,2019,Philosophie,3,La Notion d'Ethique,2,Libre Arbitre et Determinisme,4,890,4,QROC,0.08,0.68,68.12,15,7,22,17,15,2,1.29,88.24,Facile,Facile,0,Meme Difficulté,Adapte
6444,2020,Philosophie,3,La Notion d'Ethique,2,Libre Arbitre et Determinisme,4,890,4,QCM,0.04,0.79,68.12,14,6,20,14,14,0,1.43,100.0,Facile,Facile,0,Meme Difficulté,Adapte
890,2015,Philosophie,3,La Notion d'Ethique,3,Ethique du Devoir et Ethique Religieuse,13,891,1,QCU,0.49,0.39,33.73,24,47,71,32,24,8,2.22,75.0,Facile,Difficile,-2,Beaucoup plus Difficile,Pas Adapte
2001,2016,Philosophie,3,La Notion d'Ethique,3,Ethique du Devoir et Ethique Religieuse,13,891,1,QCU,0.12,0.77,72.91,55,21,76,61,55,6,1.25,90.16,Facile,Facile,0,Meme Difficulté,Adapte
3112,2017,Philosophie,3,La Notion d'Ethique,3,Ethique du Devoir et Ethique Religieuse,13,891,1,QCU,0.16,0.95,72.91,51,19,70,59,51,8,1.19,86.44,Facile,Facile,0,Meme Difficulté,Adapte
4223,2018,Philosophie,3,La Notion d'Ethique,3,Ethique du Devoir et Ethique Religieuse,13,891,1,QCU,0.03,0.77,72.91,51,19,70,65,51,14,1.08,78.46,Facile,Facile,0,Meme Difficulté,Adapte
5334,2019,Philosophie,3,La Notion d'Ethique,3,Ethique du Devoir et Ethique Religieuse,13,891,1,QCU,0.03,0.97,72.91,51,19,70,62,51,11,1.13,82.26,Facile,Facile,0,Meme Difficulté,Adapte
6445,2020,Philosophie,3,La Notion d'Ethique,3,Ethique du Devoir et Ethique Religieuse,13,891,1,QCU,0.08,0.76,72.91,48,18,66,61,48,13,1.08,78.69,Facile,Facile,0,Meme Difficulté,Adapte
891,2015,Philosophie,3,La Notion d'Ethique,3,Ethique du Devoir et Ethique Religieuse,13,892,2,QCM,0.03,0.82,72.56,36,13,49,46,36,10,1.07,78.26,Moyen,Facile,1,Plus Facile,Adapte
2002,2016,Philosophie,3,La Notion d'Ethique,3,Ethique du Devoir et Ethique Religieuse,13,892,2,QCM,0.07,0.75,72.56,39,15,54,45,39,6,1.2,86.67,Facile,Facile,0,Meme Difficulté,Adapte
3113,2017,Philosophie,3,La Notion d'Ethique,3,Ethique du Devoir et Ethique Religieuse,13,892,2,QCM,0.02,0.86,72.56,33,13,46,39,33,6,1.18,84.62,Facile,Facile,0,Meme Difficulté,Adapte
4224,2018,Philosophie,3,La Notion d'Ethique,3,Ethique du Devoir et Ethique Religieuse,13,892,2,QCM,0.08,0.9,72.56,29,11,40,32,29,3,1.25,90.62,Facile,Facile,0,Meme Difficulté,Adapte
5335,2019,Philosophie,3,La Notion d'Ethique,3,Ethique du Devoir et Ethique Religieuse,13,892,2,QCM,0.01,0.89,72.56,26,10,36,35,26,9,1.03,74.29,Facile,Facile,0,Meme Difficulté,Adapte
6446,2020,Philosophie,3,La Notion d'Ethique,3,Ethique du Devoir et Ethique Religieuse,13,892,2,QCM,0.1,0.82,72.56,24,9,33,27,24,3,1.22,88.89,Facile,Facile,0,Meme Difficulté,Adapte
892,2015,Philosophie,3,La Notion d'Ethique,3,Ethique du Devoir et Ethique Religieuse,13,893,3,QCM,0.41,0.33,35.59,27,50,77,31,27,4,2.48,87.1,Difficile,Moyen,1,Plus Facile,Pas Adapte
2003,2016,Philosophie,3,La Notion d'Ethique,3,Ethique du Devoir et Ethique Religieuse,13,893,3,QCM,0.4,0.43,60.51,51,33,84,68,51,17,1.24,75.0,Difficile,Moyen,1,Plus Facile,Pas Adapte
3114,2017,Philosophie,3,La Notion d'Ethique,3,Ethique du Devoir et Ethique Religieuse,13,893,3,QCM,0.46,0.46,39.91,36,55,91,61,36,25,1.49,59.02,Facile,Moyen,-1,Plus Difficile,Pas Adapte
4225,2018,Philosophie,3,La Notion d'Ethique,3,Ethique du Devoir et Ethique Religieuse,13,893,3,QCM,0.1,0.9,67.92,66,31,97,91,66,25,1.07,72.53,Difficile,Facile,2,Beaucoup plus Facile,Adapte
5336,2019,Philosophie,3,La Notion d'Ethique,3,Ethique du Devoir et Ethique Religieuse,13,893,3,QCM,0.11,0.85,67.92,71,33,104,86,71,15,1.21,82.56,Facile,Facile,0,Meme Difficulté,Adapte
6447,2020,Philosophie,3,La Notion d'Ethique,3,Ethique du Devoir et Ethique Religieuse,13,893,3,QCM,0.16,0.71,67.92,81,38,119,95,81,14,1.25,85.26,Facile,Facile,0,Meme Difficulté,Adapte
893,2015,Philosophie,3,La Notion d'Ethique,3,Ethique du Devoir et Ethique Religieuse,13,894,4,QROC,0.01,0.86,75.51,15,5,20,15,15,0,1.33,100.0,Difficile,Facile,2,Beaucoup plus Facile,Pas Adapte
2004,2016,Philosophie,3,La Notion d'Ethique,3,Ethique du Devoir et Ethique Religieuse,13,894,4,QO,0.2,0.64,88.1,16,2,18,17,16,1,1.06,94.12,Moyen,Facile,1,Plus Facile,Pas Adapte
3115,2017,Philosophie,3,La Notion d'Ethique,3,Ethique du Devoir et Ethique Religieuse,13,894,4,QO,0.63,0.19,63.29,11,7,18,16,11,5,1.12,68.75,Facile,Moyen,-1,Plus Difficile,Pas Adapte
4226,2018,Philosophie,3,La Notion d'Ethique,3,Ethique du Devoir et Ethique Religieuse,13,894,4,QO,0.1,0.69,83.69,18,3,21,18,18,0,1.17,100.0,Facile,Facile,0,Meme Difficulté,Pas Adapte
5337,2019,Philosophie,3,La Notion d'Ethique,3,Ethique du Devoir et Ethique Religieuse,13,894,4,QROC,0.19,0.99,69.17,17,7,24,18,17,1,1.33,94.44,Facile,Facile,0,Meme Difficulté,Adapte
6448,2020,Philosophie,3,La Notion d'Ethique,3,Ethique du Devoir et Ethique Religieuse,13,894,4,QROC,0.14,1.0,69.17,14,6,20,18,14,4,1.11,77.78,Facile,Facile,0,Meme Difficulté,Adapte
894,2015,Philosophie,3,La Notion d'Ethique,3,Ethique du Devoir et Ethique Religieuse,13,895,5,QCU,0.07,0.84,73.34,10,3,13,12,10,2,1.08,83.33,Facile,Facile,0,Meme Difficulté,Adapte
2005,2016,Philosophie,3,La Notion d'Ethique,3,Ethique du Devoir et Ethique Religieuse,13,895,5,QCU,0.02,0.9,73.34,9,3,12,10,9,1,1.2,90.0,Facile,Facile,0,Meme Difficulté,Adapte
3116,2017,Philosophie,3,La Notion d'Ethique,3,Ethique du Devoir et Ethique Religieuse,13,895,5,QCU,0.08,0.84,73.34,10,4,14,11,10,1,1.27,90.91,Facile,Facile,0,Meme Difficulté,Adapte
4227,2018,Philosophie,3,La Notion d'Ethique,3,Ethique du Devoir et Ethique Religieuse,13,895,5,QROC,0.11,0.73,73.34,10,4,14,13,10,3,1.08,76.92,Facile,Facile,0,Meme Difficulté,Adapte
5338,2019,Philosophie,3,La Notion d'Ethique,3,Ethique du Devoir et Ethique Religieuse,13,895,5,QO,0.17,0.94,73.34,11,4,15,13,11,2,1.15,84.62,Facile,Facile,0,Meme Difficulté,Adapte
6449,2020,Philosophie,3,La Notion d'Ethique,3,Ethique du Devoir et Ethique Religieuse,13,895,5,QO,0.18,0.33,73.34,10,4,14,14,10,4,1.0,71.43,Facile,Facile,0,Meme Difficulté,Adapte
895,2015,Philosophie,3,La Notion d'Ethique,3,Ethique du Devoir et Ethique Religieuse,13,896,6,QO,1.0,0.13,21.19,8,32,40,23,8,15,1.74,34.78,Moyen,Difficile,-1,Plus Difficile,Pas Adapte
2006,2016,Philosophie,3,La Notion d'Ethique,3,Ethique du Devoir et Ethique Religieuse,13,896,6,QROC,0.73,0.08,25.58,11,32,43,35,11,24,1.23,31.43,Moyen,Difficile,-1,Plus Difficile,Pas Adapte
3117,2017,Philosophie,3,La Notion d'Ethique,3,Ethique du Devoir et Ethique Religieuse,13,896,6,QROC,0.02,0.58,85.24,39,7,46,42,39,3,1.1,92.86,Moyen,Facile,1,Plus Facile,Pas Adapte
4228,2018,Philosophie,3,La Notion d'Ethique,3,Ethique du Devoir et Ethique Religieuse,13,896,6,QO,0.81,0.06,28.59,15,38,53,49,15,34,1.08,30.61,Facile,Difficile,-2,Beaucoup plus Difficile,Pas Adapte
5339,2019,Philosophie,3,La Notion d'Ethique,3,Ethique du Devoir et Ethique Religieuse,13,896,6,QO,0.88,0.04,26.08,14,40,54,30,14,16,1.8,46.67,Difficile,Difficile,0,Meme Difficulté,Pas Adapte
6450,2020,Philosophie,3,La Notion d'Ethique,3,Ethique du Devoir et Ethique Religieuse,13,896,6,QROC,0.64,0.01,15.02,9,50,59,51,9,42,1.16,17.65,Moyen,Difficile,-1,Plus Difficile,Pas Adapte
896,2015,Philosophie,3,La Notion d'Ethique,3,Ethique du Devoir et Ethique Religieuse,13,897,7,QCU,0.35,0.61,57.38,22,16,38,32,22,10,1.19,68.75,Facile,Moyen,-1,Plus Difficile,Pas Adapte
2007,2016,Philosophie,3,La Notion d'Ethique,3,Ethique du Devoir et Ethique Religieuse,13,897,7,QCU,0.66,0.28,7.83,3,35,38,15,3,12,2.53,20.0,Difficile,Difficile,0,Meme Difficulté,Pas Adapte
3118,2017,Philosophie,3,La Notion d'Ethique,3,Ethique du Devoir et Ethique Religieuse,13,897,7,QCU,0.22,0.62,54.21,24,20,44,28,24,4,1.57,85.71,Moyen,Moyen,0,Meme Difficulté,Pas Adapte
4229,2018,Philosophie,3,La Notion d'Ethique,3,Ethique du Devoir et Ethique Religieuse,13,897,7,QCU,0.51,0.32,19.69,10,40,50,23,10,13,2.17,43.48,Moyen,Difficile,-1,Plus Difficile,Pas Adapte
5340,2019,Philosophie,3,La Notion d'Ethique,3,Ethique du Devoir et Ethique Religieuse,13,897,7,QCU,0.24,0.72,52.83,25,22,47,29,25,4,1.62,86.21,Facile,Moyen,-1,Plus Difficile,Pas Adapte
6451,2020,Philosophie,3,La Notion d'Ethique,3,Ethique du Devoir et Ethique Religieuse,13,897,7,QCU,0.45,0.31,0.71,0,51,51,29,0,29,1.76,0.0,Difficile,Difficile,0,Meme Difficulté,Pas Adapte
897,2015,Philosophie,3,La Notion d'Ethique,3,Ethique du Devoir et Ethique Religieuse,13,898,8,QCU,0.19,0.78,74.14,14,5,19,18,14,4,1.06,77.78,Facile,Facile,0,Meme Difficulté,Adapte
2008,2016,Philosophie,3,La Notion d'Ethique,3,Ethique du Devoir et Ethique Religieuse,13,898,8,QCU,0.12,0.88,74.14,13,5,18,16,13,3,1.12,81.25,Facile,Facile,0,Meme Difficulté,Adapte
3119,2017,Philosophie,3,La Notion d'Ethique,3,Ethique du Devoir et Ethique Religieuse,13,898,8,QCU,0.12,0.99,74.14,11,4,15,12,11,1,1.25,91.67,Facile,Facile,0,Meme Difficulté,Adapte
4230,2018,Philosophie,3,La Notion d'Ethique,3,Ethique du Devoir et Ethique Religieuse,13,898,8,QCU,0.19,0.87,74.14,10,4,14,12,10,2,1.17,83.33,Facile,Facile,0,Meme Difficulté,Adapte
5341,2019,Philosophie,3,La Notion d'Ethique,3,Ethique du Devoir et Ethique Religieuse,13,898,8,QCU,0.19,0.87,74.14,10,4,14,12,10,2,1.17,83.33,Facile,Facile,0,Meme Difficulté,Adapte
6452,2020,Philosophie,3,La Notion d'Ethique,3,Ethique du Devoir et Ethique Religieuse,13,898,8,QCU,0.17,0.75,74.14,10,3,13,11,10,1,1.18,90.91,Facile,Facile,0,Meme Difficulté,Adapte
898,2015,Philosophie,3,La Notion d'Ethique,3,Ethique du Devoir et Ethique Religieuse,13,899,9,QCM,0.75,0.24,7.04,7,88,95,62,7,55,1.53,11.29,Difficile,Difficile,0,Meme Difficulté,Pas Adapte
2009,2016,Philosophie,3,La Notion d'Ethique,3,Ethique du Devoir et Ethique Religieuse,13,899,9,QCM,0.28,0.57,51.97,46,42,88,64,46,18,1.38,71.88,Moyen,Moyen,0,Meme Difficulté,Pas Adapte
3120,2017,Philosophie,3,La Notion d'Ethique,3,Ethique du Devoir et Ethique Religieuse,13,899,9,QCM,0.51,0.24,26.05,20,55,75,66,20,46,1.14,30.3,Facile,Difficile,-2,Beaucoup plus Difficile,Pas Adapte
4231,2018,Philosophie,3,La Notion d'Ethique,3,Ethique du Devoir et Ethique Religieuse,13,899,9,QO,0.85,0.01,18.66,14,59,73,44,14,30,1.66,31.82,Moyen,Difficile,-1,Plus Difficile,Pas Adapte
5342,2019,Philosophie,3,La Notion d'Ethique,3,Ethique du Devoir et Ethique Religieuse,13,899,9,QO,0.83,0.04,6.03,4,65,69,58,4,54,1.19,6.9,Facile,Difficile,-2,Beaucoup plus Difficile,Pas Adapte
6453,2020,Philosophie,3,La Notion d'Ethique,3,Ethique du Devoir et Ethique Religieuse,13,899,9,QO,0.07,0.53,83.09,50,10,60,52,50,2,1.15,96.15,Difficile,Facile,2,Beaucoup plus Facile,Pas Adapte
899,2015,Philosophie,3,La Notion d'Ethique,3,Ethique du Devoir et Ethique Religieuse,13,900,10,QROC,0.93,0.13,29.96,18,41,59,54,18,36,1.09,33.33,Difficile,Difficile,0,Meme Difficulté,Pas Adapte
2010,2016,Philosophie,3,La Notion d'Ethique,3,Ethique du Devoir et Ethique Religieuse,13,900,10,QROC,0.08,0.52,80.94,53,12,65,59,53,6,1.1,89.83,Facile,Facile,0,Meme Difficulté,Pas Adapte
3121,2017,Philosophie,3,La Notion d'Ethique,3,Ethique du Devoir et Ethique Religieuse,13,900,10,QROC,0.97,0.13,5.89,4,70,74,53,4,49,1.4,7.55,Facile,Difficile,-2,Beaucoup plus Difficile,Pas Adapte
4232,2018,Philosophie,3,La Notion d'Ethique,3,Ethique du Devoir et Ethique Religieuse,13,900,10,QROC,0.54,0.33,59.3,47,32,79,59,47,12,1.34,79.66,Moyen,Moyen,0,Meme Difficulté,Pas Adapte
5343,2019,Philosophie,3,La Notion d'Ethique,3,Ethique du Devoir et Ethique Religieuse,13,900,10,QROC,0.33,0.33,51.55,41,39,80,49,41,8,1.63,83.67,Moyen,Moyen,0,Meme Difficulté,Pas Adapte
6454,2020,Philosophie,3,La Notion d'Ethique,3,Ethique du Devoir et Ethique Religieuse,13,900,10,QROC,0.57,0.26,52.86,38,34,72,70,38,32,1.03,54.29,Moyen,Moyen,0,Meme Difficulté,Pas Adapte
900,2015,Philosophie,3,La Notion d'Ethique,3,Ethique du Devoir et Ethique Religieuse,13,901,11,QCM,0.24,0.33,56.08,43,34,77,53,43,10,1.45,81.13,Facile,Moyen,-1,Plus Difficile,Pas Adapte
2011,2016,Philosophie,3,La Notion d'Ethique,3,Ethique du Devoir et Ethique Religieuse,13,901,11,QCU,0.12,0.9,66.51,47,24,71,50,47,3,1.42,94.0,Facile,Facile,0,Meme Difficulté,Adapte
3122,2017,Philosophie,3,La Notion d'Ethique,3,Ethique du Devoir et Ethique Religieuse,13,901,11,QCU,0.17,0.91,66.51,49,24,73,52,49,3,1.4,94.23,Facile,Facile,0,Meme Difficulté,Adapte
4233,2018,Philosophie,3,La Notion d'Ethique,3,Ethique du Devoir et Ethique Religieuse,13,901,11,QCU,0.0,0.89,66.51,43,22,65,54,43,11,1.2,79.63,Facile,Facile,0,Meme Difficulté,Adapte
5344,2019,Philosophie,3,La Notion d'Ethique,3,Ethique du Devoir et Ethique Religieuse,13,901,11,QCU,0.08,0.85,66.51,41,20,61,57,41,16,1.07,71.93,Facile,Facile,0,Meme Difficulté,Adapte
6455,2020,Philosophie,3,La Notion d'Ethique,3,Ethique du Devoir et Ethique Religieuse,13,901,11,QCU,0.15,0.79,66.51,39,19,58,52,39,13,1.12,75.0,Facile,Facile,0,Meme Difficulté,Adapte
901,2015,Philosophie,3,La Notion d'Ethique,3,Ethique du Devoir et Ethique Religieuse,13,902,12,QCU,0.26,0.65,64.93,8,4,12,12,8,4,1.0,66.67,Facile,Moyen,-1,Plus Difficile,Pas Adapte
2012,2016,Philosophie,3,La Notion d'Ethique,3,Ethique du Devoir et Ethique Religieuse,13,902,12,QCU,0.1,0.97,93.39,9,1,10,9,9,0,1.11,100.0,Facile,Facile,0,Meme Difficulté,Pas Adapte
3123,2017,Philosophie,3,La Notion d'Ethique,3,Ethique du Devoir et Ethique Religieuse,13,902,12,QCU,0.46,0.32,17.27,1,7,8,4,1,3,2.0,25.0,Difficile,Difficile,0,Meme Difficulté,Pas Adapte
4234,2018,Philosophie,3,La Notion d'Ethique,3,Ethique du Devoir et Ethique Religieuse,13,902,12,QCU,0.19,0.96,73.99,7,2,9,7,7,0,1.29,100.0,Moyen,Facile,1,Plus Facile,Adapte
5345,2019,Philosophie,3,La Notion d'Ethique,3,Ethique du Devoir et Ethique Religieuse,13,902,12,QROC,0.04,0.86,73.99,6,2,8,7,6,1,1.14,85.71,Facile,Facile,0,Meme Difficulté,Adapte
6456,2020,Philosophie,3,La Notion d'Ethique,3,Ethique du Devoir et Ethique Religieuse,13,902,12,QROC,0.1,0.97,73.99,7,2,9,8,7,1,1.12,87.5,Facile,Facile,0,Meme Difficulté,Adapte
902,2015,Philosophie,3,La Notion d'Ethique,3,Ethique du Devoir et Ethique Religieuse,13,903,13,QCM,0.27,0.54,48.11,24,26,50,46,24,22,1.09,52.17,Difficile,Moyen,1,Plus Facile,Pas Adapte
2013,2016,Philosophie,3,La Notion d'Ethique,3,Ethique du Devoir et Ethique Religieuse,13,903,13,QCM,0.63,0.3,3.06,2,49,51,35,2,33,1.46,5.71,Moyen,Difficile,-1,Plus Difficile,Pas Adapte
3124,2017,Philosophie,3,La Notion d'Ethique,3,Ethique du Devoir et Ethique Religieuse,13,903,13,QCM,0.04,0.86,80.15,36,9,45,43,36,7,1.05,83.72,Difficile,Facile,2,Beaucoup plus Facile,Pas Adapte
4235,2018,Philosophie,3,La Notion d'Ethique,3,Ethique du Devoir et Ethique Religieuse,13,903,13,QCM,0.76,0.16,34.29,17,34,51,24,17,7,2.12,70.83,Moyen,Difficile,-1,Plus Difficile,Pas Adapte
5346,2019,Philosophie,3,La Notion d'Ethique,3,Ethique du Devoir et Ethique Religieuse,13,903,13,QCM,0.72,0.29,0.35,0,46,46,36,0,36,1.28,0.0,Facile,Difficile,-2,Beaucoup plus Difficile,Pas Adapte
6457,2020,Philosophie,3,La Notion d'Ethique,3,Ethique du Devoir et Ethique Religieuse,13,903,13,QCM,0.05,0.99,77.15,31,9,40,32,31,1,1.25,96.88,Moyen,Facile,1,Plus Facile,Pas Adapte
903,2015,Philosophie,4,La Culture,1,Sentiments Croyance et Cultes Religieux,6,904,1,QCU,0.38,0.63,41.41,5,8,13,9,5,4,1.44,55.56,Facile,Moyen,-1,Plus Difficile,Pas Adapte
2014,2016,Philosophie,4,La Culture,1,Sentiments Croyance et Cultes Religieux,6,904,1,QCU,0.17,0.96,84.0,10,2,12,11,10,1,1.09,90.91,Moyen,Facile,1,Plus Facile,Pas Adapte
3125,2017,Philosophie,4,La Culture,1,Sentiments Croyance et Cultes Religieux,6,904,1,QCU,0.61,0.31,26.91,3,10,13,5,3,2,2.6,60.0,Moyen,Difficile,-1,Plus Difficile,Pas Adapte
4236,2018,Philosophie,4,La Culture,1,Sentiments Croyance et Cultes Religieux,6,904,1,QCU,0.52,0.28,30.98,4,8,12,9,4,5,1.33,44.44,Moyen,Difficile,-1,Plus Difficile,Pas Adapte
5347,2019,Philosophie,4,La Culture,1,Sentiments Croyance et Cultes Religieux,6,904,1,QCU,0.05,0.97,84.87,11,2,13,12,11,1,1.08,91.67,Moyen,Facile,1,Plus Facile,Pas Adapte
6458,2020,Philosophie,4,La Culture,1,Sentiments Croyance et Cultes Religieux,6,904,1,QCU,0.41,0.33,22.79,3,10,13,8,3,5,1.62,37.5,Moyen,Difficile,-1,Plus Difficile,Pas Adapte
904,2015,Philosophie,4,La Culture,1,Sentiments Croyance et Cultes Religieux,6,905,2,QCM,0.28,0.61,48.8,34,36,70,42,34,8,1.67,80.95,Difficile,Moyen,1,Plus Facile,Pas Adapte
2015,2016,Philosophie,4,La Culture,1,Sentiments Croyance et Cultes Religieux,6,905,2,QCM,0.53,0.18,27.22,18,49,67,22,18,4,3.05,81.82,Difficile,Difficile,0,Meme Difficulté,Pas Adapte
3126,2017,Philosophie,4,La Culture,1,Sentiments Croyance et Cultes Religieux,6,905,2,QCU,0.54,0.24,5.97,4,60,64,43,4,39,1.49,9.3,Difficile,Difficile,0,Meme Difficulté,Pas Adapte
4237,2018,Philosophie,4,La Culture,1,Sentiments Croyance et Cultes Religieux,6,905,2,QCU,0.56,0.25,27.48,15,39,54,34,15,19,1.59,44.12,Difficile,Difficile,0,Meme Difficulté,Pas Adapte
5348,2019,Philosophie,4,La Culture,1,Sentiments Croyance et Cultes Religieux,6,905,2,QCU,0.51,0.22,10.59,6,54,60,27,6,21,2.22,22.22,Facile,Difficile,-2,Beaucoup plus Difficile,Pas Adapte
6459,2020,Philosophie,4,La Culture,1,Sentiments Croyance et Cultes Religieux,6,905,2,QCU,0.66,0.28,14.01,7,44,51,35,7,28,1.46,20.0,Difficile,Difficile,0,Meme Difficulté,Pas Adapte
905,2015,Philosophie,4,La Culture,1,Sentiments Croyance et Cultes Religieux,6,906,3,QCM,0.6,0.2,15.74,11,57,68,66,11,55,1.03,16.67,Facile,Difficile,-2,Beaucoup plus Difficile,Pas Adapte
2016,2016,Philosophie,4,La Culture,1,Sentiments Croyance et Cultes Religieux,6,906,3,QCM,0.38,0.41,39.03,27,41,68,44,27,17,1.55,61.36,Facile,Moyen,-1,Plus Difficile,Pas Adapte
3127,2017,Philosophie,4,La Culture,1,Sentiments Croyance et Cultes Religieux,6,906,3,QCM,0.01,0.88,73.24,52,19,71,70,52,18,1.01,74.29,Difficile,Facile,2,Beaucoup plus Facile,Adapte
4238,2018,Philosophie,4,La Culture,1,Sentiments Croyance et Cultes Religieux,6,906,3,QCM,0.12,0.85,73.24,56,21,77,58,56,2,1.33,96.55,Facile,Facile,0,Meme Difficulté,Adapte
5349,2019,Philosophie,4,La Culture,1,Sentiments Croyance et Cultes Religieux,6,906,3,QCM,0.19,0.73,73.24,60,22,82,72,60,12,1.14,83.33,Facile,Facile,0,Meme Difficulté,Adapte
6460,2020,Philosophie,4,La Culture,1,Sentiments Croyance et Cultes Religieux,6,906,3,QCM,0.09,0.86,73.24,51,19,70,58,51,7,1.21,87.93,Facile,Facile,0,Meme Difficulté,Adapte
906,2015,Philosophie,4,La Culture,1,Sentiments Croyance et Cultes Religieux,6,907,4,QO,0.1,0.55,93.46,45,3,48,46,45,1,1.04,97.83,Difficile,Facile,2,Beaucoup plus Facile,Pas Adapte
2017,2016,Philosophie,4,La Culture,1,Sentiments Croyance et Cultes Religieux,6,907,4,QO,0.59,0.21,36.54,18,32,50,31,18,13,1.61,58.06,Facile,Moyen,-1,Plus Difficile,Pas Adapte
3128,2017,Philosophie,4,La Culture,1,Sentiments Croyance et Cultes Religieux,6,907,4,QO,0.17,0.48,78.75,43,11,54,45,43,2,1.2,95.56,Facile,Facile,0,Meme Difficulté,Pas Adapte
4239,2018,Philosophie,4,La Culture,1,Sentiments Croyance et Cultes Religieux,6,907,4,QO,0.65,0.27,58.66,36,25,61,52,36,16,1.17,69.23,Moyen,Moyen,0,Meme Difficulté,Pas Adapte
5350,2019,Philosophie,4,La Culture,1,Sentiments Croyance et Cultes Religieux,6,907,4,QO,0.08,0.85,86.15,55,9,64,57,55,2,1.12,96.49,Facile,Facile,0,Meme Difficulté,Pas Adapte
6461,2020,Philosophie,4,La Culture,1,Sentiments Croyance et Cultes Religieux,6,907,4,QO,0.89,0.04,30.31,22,51,73,72,22,50,1.01,30.56,Moyen,Difficile,-1,Plus Difficile,Pas Adapte
907,2015,Philosophie,4,La Culture,1,Sentiments Croyance et Cultes Religieux,6,908,5,QCM,0.64,0.29,3.17,0,15,15,9,0,9,1.67,0.0,Moyen,Difficile,-1,Plus Difficile,Pas Adapte
2018,2016,Philosophie,4,La Culture,1,Sentiments Croyance et Cultes Religieux,6,908,5,QCM,0.56,0.21,19.67,3,12,15,7,3,4,2.14,42.86,Facile,Difficile,-2,Beaucoup plus Difficile,Pas Adapte
3129,2017,Philosophie,4,La Culture,1,Sentiments Croyance et Cultes Religieux,6,908,5,QCM,0.39,0.55,44.84,8,9,17,14,8,6,1.21,57.14,Difficile,Moyen,1,Plus Facile,Pas Adapte
4240,2018,Philosophie,4,La Culture,1,Sentiments Croyance et Cultes Religieux,6,908,5,QCM,0.42,0.48,64.2,10,5,15,10,10,0,1.5,100.0,Facile,Moyen,-1,Plus Difficile,Pas Adapte
5351,2019,Philosophie,4,La Culture,1,Sentiments Croyance et Cultes Religieux,6,908,5,QCM,0.71,0.23,25.58,4,10,14,11,4,7,1.27,36.36,Facile,Difficile,-2,Beaucoup plus Difficile,Pas Adapte
6462,2020,Philosophie,4,La Culture,1,Sentiments Croyance et Cultes Religieux,6,908,5,QCU,0.25,0.64,50.23,6,6,12,10,6,4,1.2,60.0,Difficile,Moyen,1,Plus Facile,Pas Adapte
908,2015,Philosophie,4,La Culture,1,Sentiments Croyance et Cultes Religieux,6,909,6,QCM,0.44,0.61,62.2,58,36,94,64,58,6,1.47,90.62,Moyen,Moyen,0,Meme Difficulté,Pas Adapte
2019,2016,Philosophie,4,La Culture,1,Sentiments Croyance et Cultes Religieux,6,909,6,QCU,0.21,0.73,36.57,37,63,100,74,37,37,1.35,50.0,Facile,Moyen,-1,Plus Difficile,Pas Adapte
3130,2017,Philosophie,4,La Culture,1,Sentiments Croyance et Cultes Religieux,6,909,6,QCU,0.61,0.35,18.56,21,94,115,104,21,83,1.11,20.19,Difficile,Difficile,0,Meme Difficulté,Pas Adapte
4241,2018,Philosophie,4,La Culture,1,Sentiments Croyance et Cultes Religieux,6,909,6,QCU,0.23,0.52,48.34,63,67,130,110,63,47,1.18,57.27,Difficile,Moyen,1,Plus Facile,Pas Adapte
5352,2019,Philosophie,4,La Culture,1,Sentiments Croyance et Cultes Religieux,6,909,6,QCU,0.34,0.71,49.52,56,57,113,97,56,41,1.16,57.73,Moyen,Moyen,0,Meme Difficulté,Pas Adapte
6463,2020,Philosophie,4,La Culture,1,Sentiments Croyance et Cultes Religieux,6,909,6,QCU,0.26,0.56,39.69,49,74,123,60,49,11,2.05,81.67,Difficile,Moyen,1,Plus Facile,Pas Adapte
909,2015,Philosophie,4,La Culture,2,Croyances Religieuses et Verite,13,910,1,QCU,0.08,0.82,83.62,47,9,56,54,47,7,1.04,87.04,Difficile,Facile,2,Beaucoup plus Facile,Pas Adapte
2020,2016,Philosophie,4,La Culture,2,Croyances Religieuses et Verite,13,910,1,QCU,0.28,0.45,44.86,22,27,49,41,22,19,1.2,53.66,Facile,Moyen,-1,Plus Difficile,Pas Adapte
3131,2017,Philosophie,4,La Culture,2,Croyances Religieuses et Verite,13,910,1,QCM,0.69,0.26,15.54,7,38,45,45,7,38,1.0,15.56,Moyen,Difficile,-1,Plus Difficile,Pas Adapte
4242,2018,Philosophie,4,La Culture,2,Croyances Religieuses et Verite,13,910,1,QCM,0.08,0.88,98.28,47,1,48,47,47,0,1.02,100.0,Facile,Facile,0,Meme Difficulté,Pas Adapte
5353,2019,Philosophie,4,La Culture,2,Croyances Religieuses et Verite,13,910,1,QCU,0.56,0.32,14.86,8,43,51,25,8,17,2.04,32.0,Difficile,Difficile,0,Meme Difficulté,Pas Adapte
6464,2020,Philosophie,4,La Culture,2,Croyances Religieuses et Verite,13,910,1,QCU,0.32,0.61,47.78,23,25,48,37,23,14,1.3,62.16,Facile,Moyen,-1,Plus Difficile,Pas Adapte
910,2015,Philosophie,4,La Culture,2,Croyances Religieuses et Verite,13,911,2,QCU,0.06,0.78,88.72,80,10,90,88,80,8,1.02,90.91,Facile,Facile,0,Meme Difficulté,Pas Adapte
2021,2016,Philosophie,4,La Culture,2,Croyances Religieuses et Verite,13,911,2,QCU,0.24,0.74,40.34,38,55,93,86,38,48,1.08,44.19,Facile,Moyen,-1,Plus Difficile,Pas Adapte
3132,2017,Philosophie,4,La Culture,2,Croyances Religieuses et Verite,13,911,2,QCU,0.73,0.36,10.39,10,82,92,60,10,50,1.53,16.67,Facile,Difficile,-2,Beaucoup plus Difficile,Pas Adapte
4243,2018,Philosophie,4,La Culture,2,Croyances Religieuses et Verite,13,911,2,QCU,0.6,0.2,19.57,15,64,79,66,15,51,1.2,22.73,Moyen,Difficile,-1,Plus Difficile,Pas Adapte
5354,2019,Philosophie,4,La Culture,2,Croyances Religieuses et Verite,13,911,2,QCU,0.04,0.79,97.22,87,2,89,88,87,1,1.01,98.86,Moyen,Facile,1,Plus Facile,Pas Adapte
6465,2020,Philosophie,4,La Culture,2,Croyances Religieuses et Verite,13,911,2,QCU,0.6,0.37,15.42,15,80,95,70,15,55,1.36,21.43,Difficile,Difficile,0,Meme Difficulté,Pas Adapte
911,2015,Philosophie,4,La Culture,2,Croyances Religieuses et Verite,13,912,3,QCM,0.69,0.15,6.42,6,86,92,35,6,29,2.63,17.14,Moyen,Difficile,-1,Plus Difficile,Pas Adapte
2022,2016,Philosophie,4,La Culture,2,Croyances Religieuses et Verite,13,912,3,QCM,0.02,0.99,96.76,90,3,93,92,90,2,1.01,97.83,Difficile,Facile,2,Beaucoup plus Facile,Pas Adapte
3133,2017,Philosophie,4,La Culture,2,Croyances Religieuses et Verite,13,912,3,QCM,0.56,0.18,28.13,24,60,84,49,24,25,1.71,48.98,Moyen,Difficile,-1,Plus Difficile,Pas Adapte
4244,2018,Philosophie,4,La Culture,2,Croyances Religieuses et Verite,13,912,3,QCM,0.4,0.39,54.44,52,44,96,87,52,35,1.1,59.77,Facile,Moyen,-1,Plus Difficile,Pas Adapte
5355,2019,Philosophie,4,La Culture,2,Croyances Religieuses et Verite,13,912,3,QCM,0.38,0.57,51.24,50,47,97,90,50,40,1.08,55.56,Difficile,Moyen,1,Plus Facile,Pas Adapte
6466,2020,Philosophie,4,La Culture,2,Croyances Religieuses et Verite,13,912,3,QCM,0.15,0.92,66.61,62,31,93,84,62,22,1.11,73.81,Facile,Facile,0,Meme Difficulté,Adapte
912,2015,Philosophie,4,La Culture,2,Croyances Religieuses et Verite,13,913,4,QROC,0.62,0.17,13.21,8,49,57,46,8,38,1.24,17.39,Moyen,Difficile,-1,Plus Difficile,Pas Adapte
2023,2016,Philosophie,4,La Culture,2,Croyances Religieuses et Verite,13,913,4,QROC,0.84,0.14,8.39,5,54,59,36,5,31,1.64,13.89,Difficile,Difficile,0,Meme Difficulté,Pas Adapte
3134,2017,Philosophie,4,La Culture,2,Croyances Religieuses et Verite,13,913,4,QROC,0.82,0.24,23.6,14,46,60,39,14,25,1.54,35.9,Moyen,Difficile,-1,Plus Difficile,Pas Adapte
4245,2018,Philosophie,4,La Culture,2,Croyances Religieuses et Verite,13,913,4,QCU,0.37,0.72,40.97,23,32,55,45,23,22,1.22,51.11,Facile,Moyen,-1,Plus Difficile,Pas Adapte
5356,2019,Philosophie,4,La Culture,2,Croyances Religieuses et Verite,13,913,4,QROC,0.21,0.3,44.79,26,31,57,47,26,21,1.21,55.32,Difficile,Moyen,1,Plus Facile,Pas Adapte
6467,2020,Philosophie,4,La Culture,2,Croyances Religieuses et Verite,13,913,4,QROC,0.42,0.35,45.73,26,31,57,28,26,2,2.04,92.86,Moyen,Moyen,0,Meme Difficulté,Pas Adapte
913,2015,Philosophie,4,La Culture,2,Croyances Religieuses et Verite,13,914,5,QROC,0.85,0.12,30.13,13,29,42,26,13,13,1.62,50.0,Facile,Difficile,-2,Beaucoup plus Difficile,Pas Adapte
2024,2016,Philosophie,4,La Culture,2,Croyances Religieuses et Verite,13,914,5,QROC,0.61,0.04,3.3,1,41,42,30,1,29,1.4,3.33,Facile,Difficile,-2,Beaucoup plus Difficile,Pas Adapte
3135,2017,Philosophie,4,La Culture,2,Croyances Religieuses et Verite,13,914,5,QROC,0.45,0.27,52.27,25,23,48,33,25,8,1.45,75.76,Facile,Moyen,-1,Plus Difficile,Pas Adapte
4246,2018,Philosophie,4,La Culture,2,Croyances Religieuses et Verite,13,914,5,QROC,0.54,0.3,41.61,21,30,51,41,21,20,1.24,51.22,Moyen,Moyen,0,Meme Difficulté,Pas Adapte
5357,2019,Philosophie,4,La Culture,2,Croyances Religieuses et Verite,13,914,5,QROC,0.1,0.94,89.93,42,5,47,45,42,3,1.04,93.33,Facile,Facile,0,Meme Difficulté,Pas Adapte
6468,2020,Philosophie,4,La Culture,2,Croyances Religieuses et Verite,13,914,5,QROC,0.65,0.02,3.24,1,41,42,35,1,34,1.2,2.86,Moyen,Difficile,-1,Plus Difficile,Pas Adapte
914,2015,Philosophie,4,La Culture,2,Croyances Religieuses et Verite,13,915,6,QCM,0.02,0.84,67.9,61,29,90,68,61,7,1.32,89.71,Difficile,Facile,2,Beaucoup plus Facile,Adapte
2025,2016,Philosophie,4,La Culture,2,Croyances Religieuses et Verite,13,915,6,QCM,0.16,0.97,67.9,58,27,85,63,58,5,1.35,92.06,Facile,Facile,0,Meme Difficulté,Adapte
3136,2017,Philosophie,4,La Culture,2,Croyances Religieuses et Verite,13,915,6,QCU,0.1,0.92,67.9,50,23,73,65,50,15,1.12,76.92,Facile,Facile,0,Meme Difficulté,Adapte
4247,2018,Philosophie,4,La Culture,2,Croyances Religieuses et Verite,13,915,6,QCU,0.16,0.82,67.9,52,25,77,52,52,0,1.48,100.0,Facile,Facile,0,Meme Difficulté,Adapte
5358,2019,Philosophie,4,La Culture,2,Croyances Religieuses et Verite,13,915,6,QCM,0.19,0.93,67.9,60,29,89,63,60,3,1.41,95.24,Facile,Facile,0,Meme Difficulté,Adapte
6469,2020,Philosophie,4,La Culture,2,Croyances Religieuses et Verite,13,915,6,QCM,0.11,0.89,67.9,52,25,77,73,52,21,1.05,71.23,Facile,Facile,0,Meme Difficulté,Adapte
915,2015,Philosophie,4,La Culture,2,Croyances Religieuses et Verite,13,916,7,QCU,0.43,0.33,32.58,7,15,22,8,7,1,2.75,87.5,Facile,Difficile,-2,Beaucoup plus Difficile,Pas Adapte
2026,2016,Philosophie,4,La Culture,2,Croyances Religieuses et Verite,13,916,7,QCU,0.35,0.53,58.75,14,9,23,20,14,6,1.15,70.0,Moyen,Moyen,0,Meme Difficulté,Pas Adapte
3137,2017,Philosophie,4,La Culture,2,Croyances Religieuses et Verite,13,916,7,QCU,0.11,0.91,94.35,21,1,22,21,21,0,1.05,100.0,Facile,Facile,0,Meme Difficulté,Pas Adapte
4248,2018,Philosophie,4,La Culture,2,Croyances Religieuses et Verite,13,916,7,QCU,0.71,0.3,34.89,8,15,23,9,8,1,2.56,88.89,Difficile,Difficile,0,Meme Difficulté,Pas Adapte
5359,2019,Philosophie,4,La Culture,2,Croyances Religieuses et Verite,13,916,7,QCU,0.05,0.88,77.66,19,6,25,20,19,1,1.25,95.0,Moyen,Facile,1,Plus Facile,Pas Adapte
6470,2020,Philosophie,4,La Culture,2,Croyances Religieuses et Verite,13,916,7,QCU,0.17,0.87,83.34,23,4,27,24,23,1,1.12,95.83,Moyen,Facile,1,Plus Facile,Pas Adapte
916,2015,Philosophie,4,La Culture,2,Croyances Religieuses et Verite,13,917,8,QROC,0.55,0.39,49.5,30,30,60,38,30,8,1.58,78.95,Facile,Moyen,-1,Plus Difficile,Pas Adapte
2027,2016,Philosophie,4,La Culture,2,Croyances Religieuses et Verite,13,917,8,QROC,0.92,0.2,13.97,9,55,64,54,9,45,1.19,16.67,Difficile,Difficile,0,Meme Difficulté,Pas Adapte
3138,2017,Philosophie,4,La Culture,2,Croyances Religieuses et Verite,13,917,8,QO,0.69,0.19,38.57,29,45,74,52,29,23,1.42,55.77,Difficile,Moyen,1,Plus Facile,Pas Adapte
4249,2018,Philosophie,4,La Culture,2,Croyances Religieuses et Verite,13,917,8,QCM,0.27,0.53,36.56,24,42,66,25,24,1,2.64,96.0,Facile,Moyen,-1,Plus Difficile,Pas Adapte
5360,2019,Philosophie,4,La Culture,2,Croyances Religieuses et Verite,13,917,8,QCM,0.4,0.44,54.85,35,29,64,63,35,28,1.02,55.56,Moyen,Moyen,0,Meme Difficulté,Pas Adapte
6471,2020,Philosophie,4,La Culture,2,Croyances Religieuses et Verite,13,917,8,QCM,0.79,0.21,1.18,1,58,59,15,1,14,3.93,6.67,Difficile,Difficile,0,Meme Difficulté,Pas Adapte
917,2015,Philosophie,4,La Culture,2,Croyances Religieuses et Verite,13,918,9,QCU,0.07,0.9,75.44,28,9,37,34,28,6,1.09,82.35,Difficile,Facile,2,Beaucoup plus Facile,Pas Adapte
2028,2016,Philosophie,4,La Culture,2,Croyances Religieuses et Verite,13,918,9,QCU,0.65,0.3,29.2,12,30,42,30,12,18,1.4,40.0,Facile,Difficile,-2,Beaucoup plus Difficile,Pas Adapte
3139,2017,Philosophie,4,La Culture,2,Croyances Religieuses et Verite,13,918,9,QCU,0.24,0.49,42.75,16,22,38,28,16,12,1.36,57.14,Facile,Moyen,-1,Plus Difficile,Pas Adapte
4250,2018,Philosophie,4,La Culture,2,Croyances Religieuses et Verite,13,918,9,QCU,0.35,0.71,52.32,22,21,43,41,22,19,1.05,53.66,Facile,Moyen,-1,Plus Difficile,Pas Adapte
5361,2019,Philosophie,4,La Culture,2,Croyances Religieuses et Verite,13,918,9,QCU,0.06,0.95,98.73,48,1,49,48,48,0,1.02,100.0,Moyen,Facile,1,Plus Facile,Pas Adapte
6472,2020,Philosophie,4,La Culture,2,Croyances Religieuses et Verite,13,918,9,QCU,0.62,0.22,20.09,11,44,55,38,11,27,1.45,28.95,Facile,Difficile,-2,Beaucoup plus Difficile,Pas Adapte
918,2015,Philosophie,4,La Culture,2,Croyances Religieuses et Verite,13,919,10,QCM,0.19,0.76,70.91,48,20,68,65,48,17,1.05,73.85,Moyen,Facile,1,Plus Facile,Adapte
2029,2016,Philosophie,4,La Culture,2,Croyances Religieuses et Verite,13,919,10,QCU,0.06,0.96,70.91,48,19,67,65,48,17,1.03,73.85,Facile,Facile,0,Meme Difficulté,Adapte
3140,2017,Philosophie,4,La Culture,2,Croyances Religieuses et Verite,13,919,10,QCU,0.04,0.82,70.91,43,17,60,52,43,9,1.15,82.69,Facile,Facile,0,Meme Difficulté,Adapte
4251,2018,Philosophie,4,La Culture,2,Croyances Religieuses et Verite,13,919,10,QCU,0.09,0.97,70.91,46,19,65,48,46,2,1.35,95.83,Facile,Facile,0,Meme Difficulté,Adapte
5362,2019,Philosophie,4,La Culture,2,Croyances Religieuses et Verite,13,919,10,QCU,0.18,0.93,70.91,42,17,59,47,42,5,1.26,89.36,Facile,Facile,0,Meme Difficulté,Adapte
6473,2020,Philosophie,4,La Culture,2,Croyances Religieuses et Verite,13,919,10,QCM,0.1,0.89,70.91,40,16,56,51,40,11,1.1,78.43,Facile,Facile,0,Meme Difficulté,Adapte
919,2015,Philosophie,4,La Culture,2,Croyances Religieuses et Verite,13,920,11,QCM,0.5,0.33,54.37,45,37,82,64,45,19,1.28,70.31,Facile,Moyen,-1,Plus Difficile,Pas Adapte
2030,2016,Philosophie,4,La Culture,2,Croyances Religieuses et Verite,13,920,11,QCM,0.75,0.18,32.57,23,47,70,34,23,11,2.06,67.65,Difficile,Difficile,0,Meme Difficulté,Pas Adapte
3141,2017,Philosophie,4,La Culture,2,Croyances Religieuses et Verite,13,920,11,QCM,0.77,0.17,25.52,18,52,70,64,18,46,1.09,28.12,Facile,Difficile,-2,Beaucoup plus Difficile,Pas Adapte
4252,2018,Philosophie,4,La Culture,2,Croyances Religieuses et Verite,13,920,11,QCM,0.53,0.22,29.04,20,48,68,56,20,36,1.21,35.71,Facile,Difficile,-2,Beaucoup plus Difficile,Pas Adapte
5363,2019,Philosophie,4,La Culture,2,Croyances Religieuses et Verite,13,920,11,QCM,0.06,0.71,89.67,67,8,75,69,67,2,1.09,97.1,Facile,Facile,0,Meme Difficulté,Pas Adapte
6474,2020,Philosophie,4,La Culture,2,Croyances Religieuses et Verite,13,920,11,QCM,0.36,0.47,47.86,31,34,65,42,31,11,1.55,73.81,Facile,Moyen,-1,Plus Difficile,Pas Adapte
920,2015,Philosophie,4,La Culture,2,Croyances Religieuses et Verite,13,921,12,QCM,0.32,0.35,45.09,30,37,67,41,30,11,1.63,73.17,Moyen,Moyen,0,Meme Difficulté,Pas Adapte
2031,2016,Philosophie,4,La Culture,2,Croyances Religieuses et Verite,13,921,12,QCM,0.62,0.28,3.85,2,55,57,35,2,33,1.63,5.71,Difficile,Difficile,0,Meme Difficulté,Pas Adapte
3142,2017,Philosophie,4,La Culture,2,Croyances Religieuses et Verite,13,921,12,QCM,0.71,0.26,33.29,21,42,63,32,21,11,1.97,65.62,Moyen,Difficile,-1,Plus Difficile,Pas Adapte
4253,2018,Philosophie,4,La Culture,2,Croyances Religieuses et Verite,13,921,12,QCM,0.79,0.29,31.04,18,41,59,46,18,28,1.28,39.13,Moyen,Difficile,-1,Plus Difficile,Pas Adapte
5364,2019,Philosophie,4,La Culture,2,Croyances Religieuses et Verite,13,921,12,QCM,0.76,0.19,20.32,12,49,61,58,12,46,1.05,20.69,Moyen,Difficile,-1,Plus Difficile,Pas Adapte
6475,2020,Philosophie,4,La Culture,2,Croyances Religieuses et Verite,13,921,12,QROC,0.37,0.33,55.9,31,25,56,54,31,23,1.04,57.41,Difficile,Moyen,1,Plus Facile,Pas Adapte
921,2015,Philosophie,4,La Culture,2,Croyances Religieuses et Verite,13,922,13,QCU,0.01,0.9,89.02,51,6,57,54,51,3,1.06,94.44,Facile,Facile,0,Meme Difficulté,Pas Adapte
2032,2016,Philosophie,4,La Culture,2,Croyances Religieuses et Verite,13,922,13,QROC,0.79,0.1,28.82,16,39,55,36,16,20,1.53,44.44,Difficile,Difficile,0,Meme Difficulté,Pas Adapte
3143,2017,Philosophie,4,La Culture,2,Croyances Religieuses et Verite,13,922,13,QROC,0.56,0.28,61.5,34,21,55,51,34,17,1.08,66.67,Facile,Moyen,-1,Plus Difficile,Pas Adapte
4254,2018,Philosophie,4,La Culture,2,Croyances Religieuses et Verite,13,922,13,QROC,0.25,0.3,48.89,30,31,61,50,30,20,1.22,60.0,Difficile,Moyen,1,Plus Facile,Pas Adapte
5365,2019,Philosophie,4,La Culture,2,Croyances Religieuses et Verite,13,922,13,QROC,0.55,0.38,51.18,32,30,62,33,32,1,1.88,96.97,Facile,Moyen,-1,Plus Difficile,Pas Adapte
6476,2020,Philosophie,4,La Culture,2,Croyances Religieuses et Verite,13,922,13,QROC,0.19,0.9,94.85,62,3,65,62,62,0,1.05,100.0,Difficile,Facile,2,Beaucoup plus Facile,Pas Adapte
922,2015,Philosophie,4,La Culture,3,Religion et Morale,7,923,1,QROC,0.32,0.31,50.7,41,39,80,49,41,8,1.63,83.67,Moyen,Moyen,0,Meme Difficulté,Pas Adapte
2033,2016,Philosophie,4,La Culture,3,Religion et Morale,7,923,1,QROC,0.63,0.0,10.1,7,64,71,53,7,46,1.34,13.21,Difficile,Difficile,0,Meme Difficulté,Pas Adapte
3144,2017,Philosophie,4,La Culture,3,Religion et Morale,7,923,1,QROC,0.32,0.26,47.79,32,36,68,46,32,14,1.48,69.57,Facile,Moyen,-1,Plus Difficile,Pas Adapte
4255,2018,Philosophie,4,La Culture,3,Religion et Morale,7,923,1,QROC,0.31,0.25,62.04,45,28,73,48,45,3,1.52,93.75,Facile,Moyen,-1,Plus Difficile,Pas Adapte
5366,2019,Philosophie,4,La Culture,3,Religion et Morale,7,923,1,QROC,0.06,0.92,81.69,68,15,83,78,68,10,1.06,87.18,Facile,Facile,0,Meme Difficulté,Pas Adapte
6477,2020,Philosophie,4,La Culture,3,Religion et Morale,7,923,1,QROC,0.34,0.34,43.5,37,47,84,64,37,27,1.31,57.81,Facile,Moyen,-1,Plus Difficile,Pas Adapte
923,2015,Philosophie,4,La Culture,3,Religion et Morale,7,924,2,QROC,0.89,0.13,3.97,2,45,47,26,2,24,1.81,7.69,Difficile,Difficile,0,Meme Difficulté,Pas Adapte
2034,2016,Philosophie,4,La Culture,3,Religion et Morale,7,924,2,QROC,0.63,0.0,11.4,5,38,43,36,5,31,1.19,13.89,Difficile,Difficile,0,Meme Difficulté,Pas Adapte
3145,2017,Philosophie,4,La Culture,3,Religion et Morale,7,924,2,QCM,0.35,0.58,50.86,25,24,49,29,25,4,1.69,86.21,Moyen,Moyen,0,Meme Difficulté,Pas Adapte
4256,2018,Philosophie,4,La Culture,3,Religion et Morale,7,924,2,QCM,0.27,0.57,43.38,24,31,55,33,24,9,1.67,72.73,Moyen,Moyen,0,Meme Difficulté,Pas Adapte
5367,2019,Philosophie,4,La Culture,3,Religion et Morale,7,924,2,QCM,0.19,0.95,78.32,42,12,54,53,42,11,1.02,79.25,Facile,Facile,0,Meme Difficulté,Pas Adapte
6478,2020,Philosophie,4,La Culture,3,Religion et Morale,7,924,2,QCM,0.1,0.98,96.97,47,1,48,48,47,1,1.0,97.92,Difficile,Facile,2,Beaucoup plus Facile,Pas Adapte
924,2015,Philosophie,4,La Culture,3,Religion et Morale,7,925,3,QCU,0.55,0.35,13.36,10,68,78,78,10,68,1.0,12.82,Moyen,Difficile,-1,Plus Difficile,Pas Adapte
2035,2016,Philosophie,4,La Culture,3,Religion et Morale,7,925,3,QCU,0.29,0.45,56.39,42,33,75,74,42,32,1.01,56.76,Facile,Moyen,-1,Plus Difficile,Pas Adapte
3146,2017,Philosophie,4,La Culture,3,Religion et Morale,7,925,3,QCU,0.1,0.99,86.37,70,11,81,74,70,4,1.09,94.59,Facile,Facile,0,Meme Difficulté,Pas Adapte
4257,2018,Philosophie,4,La Culture,3,Religion et Morale,7,925,3,QROC,0.2,0.3,61.37,45,28,73,62,45,17,1.18,72.58,Difficile,Moyen,1,Plus Facile,Pas Adapte
5368,2019,Philosophie,4,La Culture,3,Religion et Morale,7,925,3,QROC,0.83,0.03,16.43,12,61,73,30,12,18,2.43,40.0,Difficile,Difficile,0,Meme Difficulté,Pas Adapte
6479,2020,Philosophie,4,La Culture,3,Religion et Morale,7,925,3,QCM,0.06,0.86,70.56,45,19,64,49,45,4,1.31,91.84,Facile,Facile,0,Meme Difficulté,Adapte
925,2015,Philosophie,4,La Culture,3,Religion et Morale,7,926,4,QCM,0.39,0.65,54.6,29,24,53,37,29,8,1.43,78.38,Facile,Moyen,-1,Plus Difficile,Pas Adapte
2036,2016,Philosophie,4,La Culture,3,Religion et Morale,7,926,4,QCM,0.7,0.18,10.07,5,41,46,42,5,37,1.1,11.9,Moyen,Difficile,-1,Plus Difficile,Pas Adapte
3147,2017,Philosophie,4,La Culture,3,Religion et Morale,7,926,4,QCM,0.23,0.36,51.37,25,23,48,32,25,7,1.5,78.12,Difficile,Moyen,1,Plus Facile,Pas Adapte
4258,2018,Philosophie,4,La Culture,3,Religion et Morale,7,926,4,QCM,0.77,0.24,23.92,13,40,53,17,13,4,3.12,76.47,Facile,Difficile,-2,Beaucoup plus Difficile,Pas Adapte
5369,2019,Philosophie,4,La Culture,3,Religion et Morale,7,926,4,QCM,0.5,0.29,3.91,2,50,52,49,2,47,1.06,4.08,Difficile,Difficile,0,Meme Difficulté,Pas Adapte
6480,2020,Philosophie,4,La Culture,3,Religion et Morale,7,926,4,QO,0.97,0.01,8.91,4,43,47,33,4,29,1.42,12.12,Facile,Difficile,-2,Beaucoup plus Difficile,Pas Adapte
926,2015,Philosophie,4,La Culture,3,Religion et Morale,7,927,5,QCM,0.3,0.47,52.28,50,46,96,91,50,41,1.05,54.95,Moyen,Moyen,0,Meme Difficulté,Pas Adapte
2037,2016,Philosophie,4,La Culture,3,Religion et Morale,7,927,5,QCM,0.17,0.8,81.39,72,17,89,83,72,11,1.07,86.75,Moyen,Facile,1,Plus Facile,Pas Adapte
3148,2017,Philosophie,4,La Culture,3,Religion et Morale,7,927,5,QCM,0.72,0.18,31.88,30,63,93,77,30,47,1.21,38.96,Moyen,Difficile,-1,Plus Difficile,Pas Adapte
4259,2018,Philosophie,4,La Culture,3,Religion et Morale,7,927,5,QCM,0.21,0.43,60.36,54,36,90,58,54,4,1.55,93.1,Facile,Moyen,-1,Plus Difficile,Pas Adapte
5370,2019,Philosophie,4,La Culture,3,Religion et Morale,7,927,5,QCM,0.66,0.2,8.88,8,78,86,27,8,19,3.19,29.63,Difficile,Difficile,0,Meme Difficulté,Pas Adapte
6481,2020,Philosophie,4,La Culture,3,Religion et Morale,7,927,5,QCM,0.12,0.74,76.01,69,22,91,85,69,16,1.07,81.18,Difficile,Facile,2,Beaucoup plus Facile,Pas Adapte
927,2015,Philosophie,4,La Culture,3,Religion et Morale,7,928,6,QCU,0.7,0.28,27.23,23,60,83,80,23,57,1.04,28.75,Difficile,Difficile,0,Meme Difficulté,Pas Adapte
2038,2016,Philosophie,4,La Culture,3,Religion et Morale,7,928,6,QO,0.93,0.13,23.34,20,65,85,72,20,52,1.18,27.78,Facile,Difficile,-2,Beaucoup plus Difficile,Pas Adapte
3149,2017,Philosophie,4,La Culture,3,Religion et Morale,7,928,6,QO,0.15,0.53,98.34,88,1,89,88,88,0,1.01,100.0,Moyen,Facile,1,Plus Facile,Pas Adapte
4260,2018,Philosophie,4,La Culture,3,Religion et Morale,7,928,6,QO,0.99,0.0,10.1,9,84,93,58,9,49,1.6,15.52,Difficile,Difficile,0,Meme Difficulté,Pas Adapte
5371,2019,Philosophie,4,La Culture,3,Religion et Morale,7,928,6,QO,0.81,0.11,17.87,19,85,104,74,19,55,1.41,25.68,Difficile,Difficile,0,Meme Difficulté,Pas Adapte
6482,2020,Philosophie,4,La Culture,3,Religion et Morale,7,928,6,QO,0.03,0.57,87.66,95,13,108,100,95,5,1.08,95.0,Facile,Facile,0,Meme Difficulté,Pas Adapte
928,2015,Philosophie,4,La Culture,3,Religion et Morale,7,929,7,QCM,0.46,0.35,63.14,36,21,57,51,36,15,1.12,70.59,Moyen,Moyen,0,Meme Difficulté,Pas Adapte
2039,2016,Philosophie,4,La Culture,3,Religion et Morale,7,929,7,QCM,0.54,0.16,13.43,9,57,66,27,9,18,2.44,33.33,Facile,Difficile,-2,Beaucoup plus Difficile,Pas Adapte
3150,2017,Philosophie,4,La Culture,3,Religion et Morale,7,929,7,QCM,0.37,0.41,54.79,34,28,62,54,34,20,1.15,62.96,Moyen,Moyen,0,Meme Difficulté,Pas Adapte
4261,2018,Philosophie,4,La Culture,3,Religion et Morale,7,929,7,QCM,0.53,0.17,5.3,3,58,61,54,3,51,1.13,5.56,Facile,Difficile,-2,Beaucoup plus Difficile,Pas Adapte
5372,2019,Philosophie,4,La Culture,3,Religion et Morale,7,929,7,QCM,0.14,0.96,92.26,60,5,65,63,60,3,1.03,95.24,Moyen,Facile,1,Plus Facile,Pas Adapte
6483,2020,Philosophie,4,La Culture,3,Religion et Morale,7,929,7,QCM,0.27,0.68,37.6,23,37,60,23,23,0,2.61,100.0,Moyen,Moyen,0,Meme Difficulté,Pas Adapte
929,2015,Sociologie,1,Les Differentes Approches de l'Economie,1,Comment l'Activite et la Science Economiques se detachent-elles de la Morale et de la Politique?,5,930,1,QCM,0.13,0.97,87.23,46,7,53,48,46,2,1.1,95.83,Moyen,Facile,1,Plus Facile,Pas Adapte
2040,2016,Sociologie,1,Les Differentes Approches de l'Economie,1,Comment l'Activite et la Science Economiques se detachent-elles de la Morale et de la Politique?,5,930,1,QCM,0.33,0.55,56.41,33,25,58,53,33,20,1.09,62.26,Facile,Moyen,-1,Plus Difficile,Pas Adapte
3151,2017,Sociologie,1,Les Differentes Approches de l'Economie,1,Comment l'Activite et la Science Economiques se detachent-elles de la Morale et de la Politique?,5,930,1,QCM,0.03,0.98,79.3,47,12,59,59,47,12,1.0,79.66,Moyen,Facile,1,Plus Facile,Pas Adapte
4262,2018,Sociologie,1,Les Differentes Approches de l'Economie,1,Comment l'Activite et la Science Economiques se detachent-elles de la Morale et de la Politique?,5,930,1,QCU,0.06,0.78,80.21,48,12,60,55,48,7,1.09,87.27,Facile,Facile,0,Meme Difficulté,Pas Adapte
5373,2019,Sociologie,1,Les Differentes Approches de l'Economie,1,Comment l'Activite et la Science Economiques se detachent-elles de la Morale et de la Politique?,5,930,1,QCU,0.32,0.45,60.11,39,26,65,50,39,11,1.3,78.0,Facile,Moyen,-1,Plus Difficile,Pas Adapte
6484,2020,Sociologie,1,Les Differentes Approches de l'Economie,1,Comment l'Activite et la Science Economiques se detachent-elles de la Morale et de la Politique?,5,930,1,QCU,0.1,0.82,93.19,55,4,59,57,55,2,1.04,96.49,Moyen,Facile,1,Plus Facile,Pas Adapte
930,2015,Sociologie,1,Les Differentes Approches de l'Economie,1,Comment l'Activite et la Science Economiques se detachent-elles de la Morale et de la Politique?,5,931,2,QCM,0.77,0.23,5.02,3,62,65,26,3,23,2.5,11.54,Facile,Difficile,-2,Beaucoup plus Difficile,Pas Adapte
2041,2016,Sociologie,1,Les Differentes Approches de l'Economie,1,Comment l'Activite et la Science Economiques se detachent-elles de la Morale et de la Politique?,5,931,2,QCM,0.34,0.52,35.86,23,41,64,43,23,20,1.49,53.49,Difficile,Moyen,1,Plus Facile,Pas Adapte
3152,2017,Sociologie,1,Les Differentes Approches de l'Economie,1,Comment l'Activite et la Science Economiques se detachent-elles de la Morale et de la Politique?,5,931,2,QCM,0.25,0.58,47.29,31,35,66,37,31,6,1.78,83.78,Facile,Moyen,-1,Plus Difficile,Pas Adapte
4263,2018,Sociologie,1,Les Differentes Approches de l'Economie,1,Comment l'Activite et la Science Economiques se detachent-elles de la Morale et de la Politique?,5,931,2,QCM,0.18,0.92,65.32,45,24,69,64,45,19,1.08,70.31,Moyen,Facile,1,Plus Facile,Adapte
5374,2019,Sociologie,1,Les Differentes Approches de l'Economie,1,Comment l'Activite et la Science Economiques se detachent-elles de la Morale et de la Politique?,5,931,2,QCM,0.17,0.99,65.32,39,21,60,54,39,15,1.11,72.22,Facile,Facile,0,Meme Difficulté,Adapte
6485,2020,Sociologie,1,Les Differentes Approches de l'Economie,1,Comment l'Activite et la Science Economiques se detachent-elles de la Morale et de la Politique?,5,931,2,QCM,0.04,0.78,65.32,40,21,61,57,40,17,1.07,70.18,Facile,Facile,0,Meme Difficulté,Adapte
931,2015,Sociologie,1,Les Differentes Approches de l'Economie,1,Comment l'Activite et la Science Economiques se detachent-elles de la Morale et de la Politique?,5,932,3,QO,0.02,0.68,68.77,61,27,88,62,61,1,1.42,98.39,Facile,Facile,0,Meme Difficulté,Adapte
2042,2016,Sociologie,1,Les Differentes Approches de l'Economie,1,Comment l'Activite et la Science Economiques se detachent-elles de la Morale et de la Politique?,5,932,3,QO,0.17,0.6,68.77,53,24,77,63,53,10,1.22,84.13,Facile,Facile,0,Meme Difficulté,Adapte
3153,2017,Sociologie,1,Les Differentes Approches de l'Economie,1,Comment l'Activite et la Science Economiques se detachent-elles de la Morale et de la Politique?,5,932,3,QO,0.1,0.43,68.77,58,27,85,60,58,2,1.42,96.67,Facile,Facile,0,Meme Difficulté,Adapte
4264,2018,Sociologie,1,Les Differentes Approches de l'Economie,1,Comment l'Activite et la Science Economiques se detachent-elles de la Morale et de la Politique?,5,932,3,QO,0.1,0.51,68.77,66,30,96,77,66,11,1.25,85.71,Facile,Facile,0,Meme Difficulté,Adapte
5375,2019,Sociologie,1,Les Differentes Approches de l'Economie,1,Comment l'Activite et la Science Economiques se detachent-elles de la Morale et de la Politique?,5,932,3,QO,0.18,0.97,68.77,58,27,85,62,58,4,1.37,93.55,Facile,Facile,0,Meme Difficulté,Adapte
6486,2020,Sociologie,1,Les Differentes Approches de l'Economie,1,Comment l'Activite et la Science Economiques se detachent-elles de la Morale et de la Politique?,5,932,3,QO,0.13,0.85,68.77,52,24,76,66,52,14,1.15,78.79,Facile,Facile,0,Meme Difficulté,Adapte
932,2015,Sociologie,1,Les Differentes Approches de l'Economie,1,Comment l'Activite et la Science Economiques se detachent-elles de la Morale et de la Politique?,5,933,4,QCM,0.4,0.65,63.75,43,25,68,51,43,8,1.33,84.31,Facile,Moyen,-1,Plus Difficile,Pas Adapte
2043,2016,Sociologie,1,Les Differentes Approches de l'Economie,1,Comment l'Activite et la Science Economiques se detachent-elles de la Morale et de la Politique?,5,933,4,QCM,0.07,0.82,82.93,51,10,61,56,51,5,1.09,91.07,Moyen,Facile,1,Plus Facile,Pas Adapte
3154,2017,Sociologie,1,Les Differentes Approches de l'Economie,1,Comment l'Activite et la Science Economiques se detachent-elles de la Morale et de la Politique?,5,933,4,QCM,0.57,0.26,2.48,1,58,59,33,1,32,1.79,3.03,Difficile,Difficile,0,Meme Difficulté,Pas Adapte
4265,2018,Sociologie,1,Les Differentes Approches de l'Economie,1,Comment l'Activite et la Science Economiques se detachent-elles de la Morale et de la Politique?,5,933,4,QCU,0.37,0.67,61.0,34,22,56,37,34,3,1.51,91.89,Moyen,Moyen,0,Meme Difficulté,Pas Adapte
5376,2019,Sociologie,1,Les Differentes Approches de l'Economie,1,Comment l'Activite et la Science Economiques se detachent-elles de la Morale et de la Politique?,5,933,4,QCU,0.48,0.22,14.21,7,43,50,34,7,27,1.47,20.59,Difficile,Difficile,0,Meme Difficulté,Pas Adapte
6487,2020,Sociologie,1,Les Differentes Approches de l'Economie,1,Comment l'Activite et la Science Economiques se detachent-elles de la Morale et de la Politique?,5,933,4,QCU,0.08,0.98,76.02,40,12,52,47,40,7,1.11,85.11,Facile,Facile,0,Meme Difficulté,Pas Adapte
933,2015,Sociologie,1,Les Differentes Approches de l'Economie,1,Comment l'Activite et la Science Economiques se detachent-elles de la Morale et de la Politique?,5,934,5,QCM,0.55,0.27,6.65,1,7,8,6,1,5,1.33,16.67,Facile,Difficile,-2,Beaucoup plus Difficile,Pas Adapte
2044,2016,Sociologie,1,Les Differentes Approches de l'Economie,1,Comment l'Activite et la Science Economiques se detachent-elles de la Morale et de la Politique?,5,934,5,QCM,0.66,0.27,34.11,3,5,8,8,3,5,1.0,37.5,Facile,Difficile,-2,Beaucoup plus Difficile,Pas Adapte
3155,2017,Sociologie,1,Les Differentes Approches de l'Economie,1,Comment l'Activite et la Science Economiques se detachent-elles de la Morale et de la Politique?,5,934,5,QCM,0.23,0.46,44.52,4,5,9,6,4,2,1.5,66.67,Moyen,Moyen,0,Meme Difficulté,Pas Adapte
4266,2018,Sociologie,1,Les Differentes Approches de l'Economie,1,Comment l'Activite et la Science Economiques se detachent-elles de la Morale et de la Politique?,5,934,5,QCU,0.57,0.3,29.67,3,7,10,8,3,5,1.25,37.5,Difficile,Difficile,0,Meme Difficulté,Pas Adapte
5377,2019,Sociologie,1,Les Differentes Approches de l'Economie,1,Comment l'Activite et la Science Economiques se detachent-elles de la Morale et de la Politique?,5,934,5,QCU,0.04,0.94,68.55,5,3,8,6,5,1,1.33,83.33,Facile,Facile,0,Meme Difficulté,Adapte
6488,2020,Sociologie,1,Les Differentes Approches de l'Economie,1,Comment l'Activite et la Science Economiques se detachent-elles de la Morale et de la Politique?,5,934,5,QCU,0.19,0.95,68.55,5,3,8,7,5,2,1.14,71.43,Facile,Facile,0,Meme Difficulté,Adapte
934,2015,Sociologie,1,Les Differentes Approches de l'Economie,2,Les Auteurs Classiques,10,935,1,QCU,0.56,0.27,8.37,8,84,92,57,8,49,1.61,14.04,Moyen,Difficile,-1,Plus Difficile,Pas Adapte
2045,2016,Sociologie,1,Les Differentes Approches de l'Economie,2,Les Auteurs Classiques,10,935,1,QCU,0.21,0.61,58.86,59,42,101,73,59,14,1.38,80.82,Difficile,Moyen,1,Plus Facile,Pas Adapte
3156,2017,Sociologie,1,Les Differentes Approches de l'Economie,2,Les Auteurs Classiques,10,935,1,QROC,0.17,0.61,66.09,57,30,87,78,57,21,1.12,73.08,Facile,Facile,0,Meme Difficulté,Adapte
4267,2018,Sociologie,1,Les Differentes Approches de l'Economie,2,Les Auteurs Classiques,10,935,1,QROC,0.06,0.68,66.09,50,25,75,52,50,2,1.44,96.15,Facile,Facile,0,Meme Difficulté,Adapte
5378,2019,Sociologie,1,Les Differentes Approches de l'Economie,2,Les Auteurs Classiques,10,935,1,QROC,0.17,0.73,66.09,54,28,82,71,54,17,1.15,76.06,Facile,Facile,0,Meme Difficulté,Adapte
6489,2020,Sociologie,1,Les Differentes Approches de l'Economie,2,Les Auteurs Classiques,10,935,1,QROC,0.07,0.42,66.09,52,26,78,58,52,6,1.34,89.66,Facile,Facile,0,Meme Difficulté,Adapte
935,2015,Sociologie,1,Les Differentes Approches de l'Economie,2,Les Auteurs Classiques,10,936,2,QCU,0.71,0.23,22.2,3,11,14,11,3,8,1.27,27.27,Moyen,Difficile,-1,Plus Difficile,Pas Adapte
2046,2016,Sociologie,1,Les Differentes Approches de l'Economie,2,Les Auteurs Classiques,10,936,2,QCU,0.37,0.52,57.15,9,6,15,11,9,2,1.36,81.82,Difficile,Moyen,1,Plus Facile,Pas Adapte
3157,2017,Sociologie,1,Les Differentes Approches de l'Economie,2,Les Auteurs Classiques,10,936,2,QCU,0.63,0.36,18.46,2,11,13,6,2,4,2.17,33.33,Difficile,Difficile,0,Meme Difficulté,Pas Adapte
4268,2018,Sociologie,1,Les Differentes Approches de l'Economie,2,Les Auteurs Classiques,10,936,2,QCU,0.36,0.46,35.82,4,7,11,9,4,5,1.22,44.44,Facile,Moyen,-1,Plus Difficile,Pas Adapte
5379,2019,Sociologie,1,Les Differentes Approches de l'Economie,2,Les Auteurs Classiques,10,936,2,QCU,0.14,1.0,72.82,9,4,13,10,9,1,1.3,90.0,Facile,Facile,0,Meme Difficulté,Adapte
6490,2020,Sociologie,1,Les Differentes Approches de l'Economie,2,Les Auteurs Classiques,10,936,2,QCU,0.18,0.81,72.82,9,4,13,12,9,3,1.08,75.0,Facile,Facile,0,Meme Difficulté,Adapte
936,2015,Sociologie,1,Les Differentes Approches de l'Economie,2,Les Auteurs Classiques,10,937,3,QCM,0.56,0.25,23.46,22,73,95,33,22,11,2.88,66.67,Difficile,Difficile,0,Meme Difficulté,Pas Adapte
2047,2016,Sociologie,1,Les Differentes Approches de l'Economie,2,Les Auteurs Classiques,10,937,3,QO,0.09,0.71,84.19,83,16,99,84,83,1,1.18,98.81,Facile,Facile,0,Meme Difficulté,Pas Adapte
3158,2017,Sociologie,1,Les Differentes Approches de l'Economie,2,Les Auteurs Classiques,10,937,3,QO,0.34,0.22,38.84,42,66,108,71,42,29,1.52,59.15,Moyen,Moyen,0,Meme Difficulté,Pas Adapte
4269,2018,Sociologie,1,Les Differentes Approches de l'Economie,2,Les Auteurs Classiques,10,937,3,QROC,0.79,0.1,13.36,14,89,103,71,14,57,1.45,19.72,Moyen,Difficile,-1,Plus Difficile,Pas Adapte
5380,2019,Sociologie,1,Les Differentes Approches de l'Economie,2,Les Auteurs Classiques,10,937,3,QROC,0.18,0.67,71.0,78,32,110,102,78,24,1.08,76.47,Facile,Facile,0,Meme Difficulté,Adapte
6491,2020,Sociologie,1,Les Differentes Approches de l'Economie,2,Les Auteurs Classiques,10,937,3,QROC,0.03,0.86,71.0,80,32,112,93,80,13,1.2,86.02,Facile,Facile,0,Meme Difficulté,Adapte
937,2015,Sociologie,1,Les Differentes Approches de l'Economie,2,Les Auteurs Classiques,10,938,4,QCU,0.37,0.5,48.47,31,32,63,51,31,20,1.24,60.78,Difficile,Moyen,1,Plus Facile,Pas Adapte
2048,2016,Sociologie,1,Les Differentes Approches de l'Economie,2,Les Auteurs Classiques,10,938,4,QCU,0.12,0.87,82.31,49,11,60,55,49,6,1.09,89.09,Moyen,Facile,1,Plus Facile,Pas Adapte
3159,2017,Sociologie,1,Les Differentes Approches de l'Economie,2,Les Auteurs Classiques,10,938,4,QCU,0.36,0.57,46.32,27,32,59,29,27,2,2.03,93.1,Difficile,Moyen,1,Plus Facile,Pas Adapte
4270,2018,Sociologie,1,Les Differentes Approches de l'Economie,2,Les Auteurs Classiques,10,938,4,QCM,0.04,0.93,84.61,56,10,66,64,56,8,1.03,87.5,Facile,Facile,0,Meme Difficulté,Pas Adapte
5381,2019,Sociologie,1,Les Differentes Approches de l'Economie,2,Les Auteurs Classiques,10,938,4,QCM,0.48,0.66,56.0,32,25,57,41,32,9,1.39,78.05,Facile,Moyen,-1,Plus Difficile,Pas Adapte
6492,2020,Sociologie,1,Les Differentes Approches de l'Economie,2,Les Auteurs Classiques,10,938,4,QCM,0.39,0.48,37.33,22,37,59,48,22,26,1.23,45.83,Difficile,Moyen,1,Plus Facile,Pas Adapte
938,2015,Sociologie,1,Les Differentes Approches de l'Economie,2,Les Auteurs Classiques,10,939,5,QROC,0.38,0.31,40.56,29,43,72,48,29,19,1.5,60.42,Moyen,Moyen,0,Meme Difficulté,Pas Adapte
2049,2016,Sociologie,1,Les Differentes Approches de l'Economie,2,Les Auteurs Classiques,10,939,5,QROC,0.12,0.59,92.3,59,5,64,60,59,1,1.07,98.33,Moyen,Facile,1,Plus Facile,Pas Adapte
3160,2017,Sociologie,1,Les Differentes Approches de l'Economie,2,Les Auteurs Classiques,10,939,5,QROC,0.14,0.67,76.23,46,14,60,59,46,13,1.02,77.97,Facile,Facile,0,Meme Difficulté,Pas Adapte
4271,2018,Sociologie,1,Les Differentes Approches de l'Economie,2,Les Auteurs Classiques,10,939,5,QROC,0.31,0.34,62.69,41,25,66,50,41,9,1.32,82.0,Moyen,Moyen,0,Meme Difficulté,Pas Adapte
5382,2019,Sociologie,1,Les Differentes Approches de l'Economie,2,Les Auteurs Classiques,10,939,5,QROC,0.56,0.32,61.96,36,22,58,56,36,20,1.04,64.29,Facile,Moyen,-1,Plus Difficile,Pas Adapte
6493,2020,Sociologie,1,Les Differentes Approches de l'Economie,2,Les Auteurs Classiques,10,939,5,QROC,0.03,0.4,78.64,51,14,65,55,51,4,1.18,92.73,Moyen,Facile,1,Plus Facile,Pas Adapte
939,2015,Sociologie,1,Les Differentes Approches de l'Economie,2,Les Auteurs Classiques,10,940,6,QCU,0.52,0.4,0.08,0,62,62,47,0,47,1.32,0.0,Difficile,Difficile,0,Meme Difficulté,Pas Adapte
2050,2016,Sociologie,1,Les Differentes Approches de l'Economie,2,Les Auteurs Classiques,10,940,6,QCU,0.59,0.28,1.25,1,55,56,23,1,22,2.43,4.35,Difficile,Difficile,0,Meme Difficulté,Pas Adapte
3161,2017,Sociologie,1,Les Differentes Approches de l'Economie,2,Les Auteurs Classiques,10,940,6,QCU,0.05,0.96,93.39,45,3,48,45,45,0,1.07,100.0,Facile,Facile,0,Meme Difficulté,Pas Adapte
4272,2018,Sociologie,1,Les Differentes Approches de l'Economie,2,Les Auteurs Classiques,10,940,6,QCU,0.22,0.65,50.9,21,21,42,23,21,2,1.83,91.3,Difficile,Moyen,1,Plus Facile,Pas Adapte
5383,2019,Sociologie,1,Les Differentes Approches de l'Economie,2,Les Auteurs Classiques,10,940,6,QCU,0.09,0.85,91.57,38,3,41,40,38,2,1.02,95.0,Difficile,Facile,2,Beaucoup plus Facile,Pas Adapte
6494,2020,Sociologie,1,Les Differentes Approches de l'Economie,2,Les Auteurs Classiques,10,940,6,QCU,0.63,0.38,33.59,12,23,35,35,12,23,1.0,34.29,Moyen,Difficile,-1,Plus Difficile,Pas Adapte
940,2015,Sociologie,1,Les Differentes Approches de l'Economie,2,Les Auteurs Classiques,10,941,7,QCU,0.49,0.31,3.17,2,57,59,45,2,43,1.31,4.44,Moyen,Difficile,-1,Plus Difficile,Pas Adapte
2051,2016,Sociologie,1,Les Differentes Approches de l'Economie,2,Les Auteurs Classiques,10,941,7,QROC,0.71,0.21,4.54,3,63,66,38,3,35,1.74,7.89,Facile,Difficile,-2,Beaucoup plus Difficile,Pas Adapte
3162,2017,Sociologie,1,Les Differentes Approches de l'Economie,2,Les Auteurs Classiques,10,941,7,QROC,0.39,0.32,46.27,34,39,73,69,34,35,1.06,49.28,Moyen,Moyen,0,Meme Difficulté,Pas Adapte
4273,2018,Sociologie,1,Les Differentes Approches de l'Economie,2,Les Auteurs Classiques,10,941,7,QCU,0.33,0.45,55.66,44,35,79,56,44,12,1.41,78.57,Facile,Moyen,-1,Plus Difficile,Pas Adapte
5384,2019,Sociologie,1,Les Differentes Approches de l'Economie,2,Les Auteurs Classiques,10,941,7,QCU,0.35,0.75,61.03,47,30,77,56,47,9,1.38,83.93,Facile,Moyen,-1,Plus Difficile,Pas Adapte
6495,2020,Sociologie,1,Les Differentes Approches de l'Economie,2,Les Auteurs Classiques,10,941,7,QCU,0.64,0.25,26.45,20,55,75,54,20,34,1.39,37.04,Facile,Difficile,-2,Beaucoup plus Difficile,Pas Adapte
941,2015,Sociologie,1,Les Differentes Approches de l'Economie,2,Les Auteurs Classiques,10,942,8,QROC,0.72,0.2,12.92,4,29,33,22,4,18,1.5,18.18,Facile,Difficile,-2,Beaucoup plus Difficile,Pas Adapte
2052,2016,Sociologie,1,Les Differentes Approches de l'Economie,2,Les Auteurs Classiques,10,942,8,QROC,0.16,0.91,74.46,23,8,31,25,23,2,1.24,92.0,Moyen,Facile,1,Plus Facile,Adapte
3163,2017,Sociologie,1,Les Differentes Approches de l'Economie,2,Les Auteurs Classiques,10,942,8,QROC,0.14,0.71,74.46,24,8,32,29,24,5,1.1,82.76,Facile,Facile,0,Meme Difficulté,Adapte
4274,2018,Sociologie,1,Les Differentes Approches de l'Economie,2,Les Auteurs Classiques,10,942,8,QROC,0.09,0.94,74.46,25,8,33,32,25,7,1.03,78.12,Facile,Facile,0,Meme Difficulté,Adapte
5385,2019,Sociologie,1,Les Differentes Approches de l'Economie,2,Les Auteurs Classiques,10,942,8,QROC,0.02,0.93,74.46,25,8,33,28,25,3,1.18,89.29,Facile,Facile,0,Meme Difficulté,Adapte
6496,2020,Sociologie,1,Les Differentes Approches de l'Economie,2,Les Auteurs Classiques,10,942,8,QROC,0.03,1.0,74.46,27,9,36,35,27,8,1.03,77.14,Facile,Facile,0,Meme Difficulté,Adapte
942,2015,Sociologie,1,Les Differentes Approches de l'Economie,2,Les Auteurs Classiques,10,943,9,QCU,0.34,0.5,58.89,52,37,89,80,52,28,1.11,65.0,Difficile,Moyen,1,Plus Facile,Pas Adapte
2053,2016,Sociologie,1,Les Differentes Approches de l'Economie,2,Les Auteurs Classiques,10,943,9,QCU,0.1,0.99,86.48,88,14,102,100,88,12,1.02,88.0,Difficile,Facile,2,Beaucoup plus Facile,Pas Adapte
3164,2017,Sociologie,1,Les Differentes Approches de l'Economie,2,Les Auteurs Classiques,10,943,9,QCU,0.45,0.37,18.59,20,86,106,97,20,77,1.09,20.62,Moyen,Difficile,-1,Plus Difficile,Pas Adapte
4275,2018,Sociologie,1,Les Differentes Approches de l'Economie,2,Les Auteurs Classiques,10,943,9,QCU,0.72,0.23,12.82,15,103,118,58,15,43,2.03,25.86,Facile,Difficile,-2,Beaucoup plus Difficile,Pas Adapte
5386,2019,Sociologie,1,Les Differentes Approches de l'Economie,2,Les Auteurs Classiques,10,943,9,QCU,0.11,0.99,70.2,81,34,115,104,81,23,1.11,77.88,Moyen,Facile,1,Plus Facile,Adapte
6497,2020,Sociologie,1,Les Differentes Approches de l'Economie,2,Les Auteurs Classiques,10,943,9,QCU,0.06,1.0,70.2,79,34,113,88,79,9,1.28,89.77,Facile,Facile,0,Meme Difficulté,Adapte
943,2015,Sociologie,1,Les Differentes Approches de l'Economie,2,Les Auteurs Classiques,10,944,10,QCU,0.01,0.8,74.48,43,15,58,50,43,7,1.16,86.0,Moyen,Facile,1,Plus Facile,Adapte
2054,2016,Sociologie,1,Les Differentes Approches de l'Economie,2,Les Auteurs Classiques,10,944,10,QCM,0.06,0.8,74.48,48,16,64,62,48,14,1.03,77.42,Facile,Facile,0,Meme Difficulté,Adapte
3165,2017,Sociologie,1,Les Differentes Approches de l'Economie,2,Les Auteurs Classiques,10,944,10,QCM,0.09,0.92,74.48,42,14,56,43,42,1,1.3,97.67,Facile,Facile,0,Meme Difficulté,Adapte
4276,2018,Sociologie,1,Les Differentes Approches de l'Economie,2,Les Auteurs Classiques,10,944,10,QCM,0.07,0.73,74.48,46,16,62,57,46,11,1.09,80.7,Facile,Facile,0,Meme Difficulté,Adapte
5387,2019,Sociologie,1,Les Differentes Approches de l'Economie,2,Les Auteurs Classiques,10,944,10,QCM,0.01,0.89,74.48,51,18,69,58,51,7,1.19,87.93,Facile,Facile,0,Meme Difficulté,Adapte
6498,2020,Sociologie,1,Les Differentes Approches de l'Economie,2,Les Auteurs Classiques,10,944,10,QCU,0.2,0.77,74.48,51,18,69,57,51,6,1.21,89.47,Facile,Facile,0,Meme Difficulté,Adapte
944,2015,Sociologie,1,Les Differentes Approches de l'Economie,3,Les Auteurs Neoclassiques,2,945,1,QROC,0.81,0.22,23.83,4,12,16,7,4,3,2.29,57.14,Moyen,Difficile,-1,Plus Difficile,Pas Adapte
2055,2016,Sociologie,1,Les Differentes Approches de l'Economie,3,Les Auteurs Neoclassiques,2,945,1,QROC,0.19,0.56,92.07,13,1,14,13,13,0,1.08,100.0,Moyen,Facile,1,Plus Facile,Pas Adapte
3166,2017,Sociologie,1,Les Differentes Approches de l'Economie,3,Les Auteurs Neoclassiques,2,945,1,QROC,0.12,0.41,81.03,13,3,16,14,13,1,1.14,92.86,Facile,Facile,0,Meme Difficulté,Pas Adapte
4277,2018,Sociologie,1,Les Differentes Approches de l'Economie,3,Les Auteurs Neoclassiques,2,945,1,QROC,0.06,0.59,94.1,16,1,17,16,16,0,1.06,100.0,Difficile,Facile,2,Beaucoup plus Facile,Pas Adapte
5388,2019,Sociologie,1,Les Differentes Approches de l'Economie,3,Les Auteurs Neoclassiques,2,945,1,QROC,0.17,0.72,80.22,16,4,20,16,16,0,1.25,100.0,Facile,Facile,0,Meme Difficulté,Pas Adapte
6499,2020,Sociologie,1,Les Differentes Approches de l'Economie,3,Les Auteurs Neoclassiques,2,945,1,QROC,0.0,0.89,86.47,20,3,23,23,20,3,1.0,86.96,Moyen,Facile,1,Plus Facile,Pas Adapte
945,2015,Sociologie,1,Les Differentes Approches de l'Economie,3,Les Auteurs Neoclassiques,2,946,2,QCM,0.68,0.2,8.75,3,28,31,30,3,27,1.03,10.0,Difficile,Difficile,0,Meme Difficulté,Pas Adapte
2056,2016,Sociologie,1,Les Differentes Approches de l'Economie,3,Les Auteurs Neoclassiques,2,946,2,QCM,0.37,0.31,39.59,11,17,28,24,11,13,1.17,45.83,Difficile,Moyen,1,Plus Facile,Pas Adapte
3167,2017,Sociologie,1,Les Differentes Approches de l'Economie,3,Les Auteurs Neoclassiques,2,946,2,QCU,0.64,0.35,26.03,7,20,27,11,7,4,2.45,63.64,Facile,Difficile,-2,Beaucoup plus Difficile,Pas Adapte
4278,2018,Sociologie,1,Les Differentes Approches de l'Economie,3,Les Auteurs Neoclassiques,2,946,2,QCU,0.3,0.67,48.03,14,16,30,21,14,7,1.43,66.67,Moyen,Moyen,0,Meme Difficulté,Pas Adapte
5389,2019,Sociologie,1,Les Differentes Approches de l'Economie,3,Les Auteurs Neoclassiques,2,946,2,QCU,0.31,0.44,52.08,15,14,29,25,15,10,1.16,60.0,Facile,Moyen,-1,Plus Difficile,Pas Adapte
6500,2020,Sociologie,1,Les Differentes Approches de l'Economie,3,Les Auteurs Neoclassiques,2,946,2,QCU,0.67,0.37,22.65,6,19,25,22,6,16,1.14,27.27,Facile,Difficile,-2,Beaucoup plus Difficile,Pas Adapte
946,2015,Sociologie,1,Les Differentes Approches de l'Economie,4,L'Analyse Marxiste,14,947,1,QCU,0.6,0.26,17.27,8,41,49,41,8,33,1.2,19.51,Moyen,Difficile,-1,Plus Difficile,Pas Adapte
2057,2016,Sociologie,1,Les Differentes Approches de l'Economie,4,L'Analyse Marxiste,14,947,1,QCU,0.52,0.3,31.41,16,35,51,25,16,9,2.04,64.0,Difficile,Difficile,0,Meme Difficulté,Pas Adapte
3168,2017,Sociologie,1,Les Differentes Approches de l'Economie,4,L'Analyse Marxiste,14,947,1,QCU,0.42,0.28,30.1,14,33,47,43,14,29,1.09,32.56,Difficile,Difficile,0,Meme Difficulté,Pas Adapte
4279,2018,Sociologie,1,Les Differentes Approches de l'Economie,4,L'Analyse Marxiste,14,947,1,QCU,0.55,0.25,30.05,12,28,40,34,12,22,1.18,35.29,Difficile,Difficile,0,Meme Difficulté,Pas Adapte
5390,2019,Sociologie,1,Les Differentes Approches de l'Economie,4,L'Analyse Marxiste,14,947,1,QCU,0.39,0.53,48.17,20,21,41,31,20,11,1.32,64.52,Moyen,Moyen,0,Meme Difficulté,Pas Adapte
6501,2020,Sociologie,1,Les Differentes Approches de l'Economie,4,L'Analyse Marxiste,14,947,1,QCU,0.29,0.72,47.16,17,18,35,27,17,10,1.3,62.96,Difficile,Moyen,1,Plus Facile,Pas Adapte
947,2015,Sociologie,1,Les Differentes Approches de l'Economie,4,L'Analyse Marxiste,14,948,2,QCU,0.23,0.59,48.06,42,45,87,69,42,27,1.26,60.87,Moyen,Moyen,0,Meme Difficulté,Pas Adapte
2058,2016,Sociologie,1,Les Differentes Approches de l'Economie,4,L'Analyse Marxiste,14,948,2,QCU,0.21,0.44,57.07,52,39,91,88,52,36,1.03,59.09,Difficile,Moyen,1,Plus Facile,Pas Adapte
3169,2017,Sociologie,1,Les Differentes Approches de l'Economie,4,L'Analyse Marxiste,14,948,2,QCU,0.06,0.84,88.34,82,11,93,86,82,4,1.08,95.35,Moyen,Facile,1,Plus Facile,Pas Adapte
4280,2018,Sociologie,1,Les Differentes Approches de l'Economie,4,L'Analyse Marxiste,14,948,2,QCU,0.22,0.74,49.32,39,41,80,41,39,2,1.95,95.12,Difficile,Moyen,1,Plus Facile,Pas Adapte
5391,2019,Sociologie,1,Les Differentes Approches de l'Economie,4,L'Analyse Marxiste,14,948,2,QCM,0.02,0.95,95.91,85,4,89,88,85,3,1.01,96.59,Moyen,Facile,1,Plus Facile,Pas Adapte
6502,2020,Sociologie,1,Les Differentes Approches de l'Economie,4,L'Analyse Marxiste,14,948,2,QCM,0.11,0.83,73.18,56,20,76,62,56,6,1.23,90.32,Difficile,Facile,2,Beaucoup plus Facile,Adapte
948,2015,Sociologie,1,Les Differentes Approches de l'Economie,4,L'Analyse Marxiste,14,949,3,QCM,0.02,0.77,68.17,39,18,57,41,39,2,1.39,95.12,Moyen,Facile,1,Plus Facile,Adapte
2059,2016,Sociologie,1,Les Differentes Approches de l'Economie,4,L'Analyse Marxiste,14,949,3,QCM,0.09,0.96,68.17,42,19,61,47,42,5,1.3,89.36,Facile,Facile,0,Meme Difficulté,Adapte
3170,2017,Sociologie,1,Les Differentes Approches de l'Economie,4,L'Analyse Marxiste,14,949,3,QCM,0.03,0.92,68.17,37,17,54,52,37,15,1.04,71.15,Facile,Facile,0,Meme Difficulté,Adapte
4281,2018,Sociologie,1,Les Differentes Approches de l'Economie,4,L'Analyse Marxiste,14,949,3,QCM,0.11,0.73,68.17,42,19,61,56,42,14,1.09,75.0,Facile,Facile,0,Meme Difficulté,Adapte
5392,2019,Sociologie,1,Les Differentes Approches de l'Economie,4,L'Analyse Marxiste,14,949,3,QCM,0.06,0.74,68.17,41,19,60,53,41,12,1.13,77.36,Facile,Facile,0,Meme Difficulté,Adapte
6503,2020,Sociologie,1,Les Differentes Approches de l'Economie,4,L'Analyse Marxiste,14,949,3,QCM,0.07,0.84,68.17,45,21,66,50,45,5,1.32,90.0,Facile,Facile,0,Meme Difficulté,Adapte
949,2015,Sociologie,1,Les Differentes Approches de l'Economie,4,L'Analyse Marxiste,14,950,4,QCM,0.73,0.17,9.52,6,57,63,50,6,44,1.26,12.0,Facile,Difficile,-2,Beaucoup plus Difficile,Pas Adapte
2060,2016,Sociologie,1,Les Differentes Approches de l'Economie,4,L'Analyse Marxiste,14,950,4,QCU,0.64,0.33,14.56,9,53,62,47,9,38,1.32,19.15,Facile,Difficile,-2,Beaucoup plus Difficile,Pas Adapte
3171,2017,Sociologie,1,Les Differentes Approches de l'Economie,4,L'Analyse Marxiste,14,950,4,QCU,0.05,0.92,86.21,50,8,58,52,50,2,1.12,96.15,Moyen,Facile,1,Plus Facile,Pas Adapte
4282,2018,Sociologie,1,Les Differentes Approches de l'Economie,4,L'Analyse Marxiste,14,950,4,QCM,0.6,0.26,5.57,3,57,60,20,3,17,3.0,15.0,Moyen,Difficile,-1,Plus Difficile,Pas Adapte
5393,2019,Sociologie,1,Les Differentes Approches de l'Economie,4,L'Analyse Marxiste,14,950,4,QCM,0.28,0.37,57.34,37,27,64,62,37,25,1.03,59.68,Facile,Moyen,-1,Plus Difficile,Pas Adapte
6504,2020,Sociologie,1,Les Differentes Approches de l'Economie,4,L'Analyse Marxiste,14,950,4,QCM,0.08,0.86,87.08,47,7,54,53,47,6,1.02,88.68,Difficile,Facile,2,Beaucoup plus Facile,Pas Adapte
950,2015,Sociologie,1,Les Differentes Approches de l'Economie,4,L'Analyse Marxiste,14,951,5,QCM,0.06,0.88,83.33,48,10,58,54,48,6,1.07,88.89,Moyen,Facile,1,Plus Facile,Pas Adapte
2061,2016,Sociologie,1,Les Differentes Approches de l'Economie,4,L'Analyse Marxiste,14,951,5,QCM,0.03,0.94,93.16,51,4,55,54,51,3,1.02,94.44,Moyen,Facile,1,Plus Facile,Pas Adapte
3172,2017,Sociologie,1,Les Differentes Approches de l'Economie,4,L'Analyse Marxiste,14,951,5,QCM,0.56,0.29,12.75,7,50,57,52,7,45,1.1,13.46,Facile,Difficile,-2,Beaucoup plus Difficile,Pas Adapte
4283,2018,Sociologie,1,Les Differentes Approches de l'Economie,4,L'Analyse Marxiste,14,951,5,QCU,0.12,0.81,91.0,44,4,48,48,44,4,1.0,91.67,Difficile,Facile,2,Beaucoup plus Facile,Pas Adapte
5394,2019,Sociologie,1,Les Differentes Approches de l'Economie,4,L'Analyse Marxiste,14,951,5,QCU,0.04,0.83,72.37,40,15,55,48,40,8,1.15,83.33,Moyen,Facile,1,Plus Facile,Adapte
6505,2020,Sociologie,1,Les Differentes Approches de l'Economie,4,L'Analyse Marxiste,14,951,5,QCU,0.09,0.86,72.37,35,14,49,47,35,12,1.04,74.47,Facile,Facile,0,Meme Difficulté,Adapte
951,2015,Sociologie,1,Les Differentes Approches de l'Economie,4,L'Analyse Marxiste,14,952,6,QCM,0.76,0.22,6.97,6,87,93,43,6,37,2.16,13.95,Difficile,Difficile,0,Meme Difficulté,Pas Adapte
2062,2016,Sociologie,1,Les Differentes Approches de l'Economie,4,L'Analyse Marxiste,14,952,6,QCM,0.52,0.26,26.48,26,74,100,43,26,17,2.33,60.47,Facile,Difficile,-2,Beaucoup plus Difficile,Pas Adapte
3173,2017,Sociologie,1,Les Differentes Approches de l'Economie,4,L'Analyse Marxiste,14,952,6,QCM,0.36,0.36,61.28,52,33,85,63,52,11,1.35,82.54,Facile,Moyen,-1,Plus Difficile,Pas Adapte
4284,2018,Sociologie,1,Les Differentes Approches de l'Economie,4,L'Analyse Marxiste,14,952,6,QCM,0.49,0.34,43.22,42,56,98,90,42,48,1.09,46.67,Difficile,Moyen,1,Plus Facile,Pas Adapte
5395,2019,Sociologie,1,Les Differentes Approches de l'Economie,4,L'Analyse Marxiste,14,952,6,QCM,0.15,0.99,65.42,54,29,83,77,54,23,1.08,70.13,Facile,Facile,0,Meme Difficulté,Adapte
6506,2020,Sociologie,1,Les Differentes Approches de l'Economie,4,L'Analyse Marxiste,14,952,6,QCM,0.01,0.91,65.42,55,29,84,80,55,25,1.05,68.75,Facile,Facile,0,Meme Difficulté,Adapte
952,2015,Sociologie,1,Les Differentes Approches de l'Economie,4,L'Analyse Marxiste,14,953,7,QROC,0.09,0.72,86.48,64,10,74,67,64,3,1.1,95.52,Facile,Facile,0,Meme Difficulté,Pas Adapte
2063,2016,Sociologie,1,Les Differentes Approches de l'Economie,4,L'Analyse Marxiste,14,953,7,QCM,0.74,0.2,22.68,16,56,72,29,16,13,2.48,55.17,Difficile,Difficile,0,Meme Difficulté,Pas Adapte
3174,2017,Sociologie,1,Les Differentes Approches de l'Economie,4,L'Analyse Marxiste,14,953,7,QCM,0.11,0.9,66.34,52,26,78,63,52,11,1.24,82.54,Moyen,Facile,1,Plus Facile,Adapte
4285,2018,Sociologie,1,Les Differentes Approches de l'Economie,4,L'Analyse Marxiste,14,953,7,QCM,0.12,0.79,66.34,56,29,85,77,56,21,1.1,72.73,Facile,Facile,0,Meme Difficulté,Adapte
5396,2019,Sociologie,1,Les Differentes Approches de l'Economie,4,L'Analyse Marxiste,14,953,7,QROC,0.02,0.88,66.34,59,30,89,62,59,3,1.44,95.16,Facile,Facile,0,Meme Difficulté,Adapte
6507,2020,Sociologie,1,Les Differentes Approches de l'Economie,4,L'Analyse Marxiste,14,953,7,QROC,0.13,0.69,66.34,58,29,87,81,58,23,1.07,71.6,Facile,Facile,0,Meme Difficulté,Adapte
953,2015,Sociologie,1,Les Differentes Approches de l'Economie,4,L'Analyse Marxiste,14,954,8,QCM,0.02,0.77,70.71,10,4,14,10,10,0,1.4,100.0,Difficile,Facile,2,Beaucoup plus Facile,Adapte
2064,2016,Sociologie,1,Les Differentes Approches de l'Economie,4,L'Analyse Marxiste,14,954,8,QCM,0.15,0.96,70.71,10,4,14,13,10,3,1.08,76.92,Facile,Facile,0,Meme Difficulté,Adapte
3175,2017,Sociologie,1,Les Differentes Approches de l'Economie,4,L'Analyse Marxiste,14,954,8,QCM,0.09,0.9,70.71,11,5,16,13,11,2,1.23,84.62,Facile,Facile,0,Meme Difficulté,Adapte
4286,2018,Sociologie,1,Les Differentes Approches de l'Economie,4,L'Analyse Marxiste,14,954,8,QCM,0.03,0.96,70.71,13,5,18,17,13,4,1.06,76.47,Facile,Facile,0,Meme Difficulté,Adapte
5397,2019,Sociologie,1,Les Differentes Approches de l'Economie,4,L'Analyse Marxiste,14,954,8,QCM,0.06,0.84,70.71,11,4,15,12,11,1,1.25,91.67,Facile,Facile,0,Meme Difficulté,Adapte
6508,2020,Sociologie,1,Les Differentes Approches de l'Economie,4,L'Analyse Marxiste,14,954,8,QCM,0.05,0.72,70.71,12,5,17,16,12,4,1.06,75.0,Facile,Facile,0,Meme Difficulté,Adapte
954,2015,Sociologie,1,Les Differentes Approches de l'Economie,4,L'Analyse Marxiste,14,955,9,QO,0.94,0.04,25.08,24,70,94,77,24,53,1.22,31.17,Difficile,Difficile,0,Meme Difficulté,Pas Adapte
2065,2016,Sociologie,1,Les Differentes Approches de l'Economie,4,L'Analyse Marxiste,14,955,9,QO,0.91,0.03,28.54,27,68,95,85,27,58,1.12,31.76,Facile,Difficile,-2,Beaucoup plus Difficile,Pas Adapte
3176,2017,Sociologie,1,Les Differentes Approches de l'Economie,4,L'Analyse Marxiste,14,955,9,QO,0.12,0.65,74.1,70,25,95,81,70,11,1.17,86.42,Difficile,Facile,2,Beaucoup plus Facile,Adapte
4287,2018,Sociologie,1,Les Differentes Approches de l'Economie,4,L'Analyse Marxiste,14,955,9,QROC,0.18,0.46,74.1,71,25,96,94,71,23,1.02,75.53,Facile,Facile,0,Meme Difficulté,Adapte
5398,2019,Sociologie,1,Les Differentes Approches de l'Economie,4,L'Analyse Marxiste,14,955,9,QROC,0.1,0.6,74.1,71,25,96,93,71,22,1.03,76.34,Facile,Facile,0,Meme Difficulté,Adapte
6509,2020,Sociologie,1,Les Differentes Approches de l'Economie,4,L'Analyse Marxiste,14,955,9,QROC,0.1,0.7,74.1,63,22,85,82,63,19,1.04,76.83,Facile,Facile,0,Meme Difficulté,Adapte
955,2015,Sociologie,1,Les Differentes Approches de l'Economie,4,L'Analyse Marxiste,14,956,10,QCM,0.44,0.58,48.73,8,9,17,13,8,5,1.31,61.54,Moyen,Moyen,0,Meme Difficulté,Pas Adapte
2066,2016,Sociologie,1,Les Differentes Approches de l'Economie,4,L'Analyse Marxiste,14,956,10,QCM,0.13,0.75,81.98,14,3,17,16,14,2,1.06,87.5,Facile,Facile,0,Meme Difficulté,Pas Adapte
3177,2017,Sociologie,1,Les Differentes Approches de l'Economie,4,L'Analyse Marxiste,14,956,10,QCM,0.16,0.95,97.71,16,0,16,16,16,0,1.0,100.0,Moyen,Facile,1,Plus Facile,Pas Adapte
4288,2018,Sociologie,1,Les Differentes Approches de l'Economie,4,L'Analyse Marxiste,14,956,10,QCM,0.03,0.91,83.57,12,2,14,13,12,1,1.08,92.31,Difficile,Facile,2,Beaucoup plus Facile,Pas Adapte
5399,2019,Sociologie,1,Les Differentes Approches de l'Economie,4,L'Analyse Marxiste,14,956,10,QCU,0.16,0.81,66.74,11,5,16,16,11,5,1.0,68.75,Facile,Facile,0,Meme Difficulté,Adapte
6510,2020,Sociologie,1,Les Differentes Approches de l'Economie,4,L'Analyse Marxiste,14,956,10,QCU,0.13,0.79,66.74,12,6,18,13,12,1,1.38,92.31,Facile,Facile,0,Meme Difficulté,Adapte
956,2015,Sociologie,1,Les Differentes Approches de l'Economie,4,L'Analyse Marxiste,14,957,11,QCM,0.41,0.51,49.85,26,26,52,48,26,22,1.08,54.17,Difficile,Moyen,1,Plus Facile,Pas Adapte
2067,2016,Sociologie,1,Les Differentes Approches de l'Economie,4,L'Analyse Marxiste,14,957,11,QCU,0.57,0.38,8.74,4,47,51,22,4,18,2.32,18.18,Difficile,Difficile,0,Meme Difficulté,Pas Adapte
3178,2017,Sociologie,1,Les Differentes Approches de l'Economie,4,L'Analyse Marxiste,14,957,11,QCU,0.18,0.79,74.36,33,12,45,42,33,9,1.07,78.57,Facile,Facile,0,Meme Difficulté,Adapte
4289,2018,Sociologie,1,Les Differentes Approches de l'Economie,4,L'Analyse Marxiste,14,957,11,QCU,0.09,0.92,74.36,34,12,46,35,34,1,1.31,97.14,Facile,Facile,0,Meme Difficulté,Adapte
5400,2019,Sociologie,1,Les Differentes Approches de l'Economie,4,L'Analyse Marxiste,14,957,11,QCU,0.04,0.85,74.36,37,13,50,38,37,1,1.32,97.37,Facile,Facile,0,Meme Difficulté,Adapte
6511,2020,Sociologie,1,Les Differentes Approches de l'Economie,4,L'Analyse Marxiste,14,957,11,QCU,0.14,0.85,74.36,34,12,46,40,34,6,1.15,85.0,Facile,Facile,0,Meme Difficulté,Adapte
957,2015,Sociologie,1,Les Differentes Approches de l'Economie,4,L'Analyse Marxiste,14,958,12,QCM,0.34,0.36,59.76,19,13,32,26,19,7,1.23,73.08,Moyen,Moyen,0,Meme Difficulté,Pas Adapte
2068,2016,Sociologie,1,Les Differentes Approches de l'Economie,4,L'Analyse Marxiste,14,958,12,QCM,0.63,0.28,16.66,5,26,31,28,5,23,1.11,17.86,Difficile,Difficile,0,Meme Difficulté,Pas Adapte
3179,2017,Sociologie,1,Les Differentes Approches de l'Economie,4,L'Analyse Marxiste,14,958,12,QCU,0.03,0.94,82.42,24,5,29,28,24,4,1.04,85.71,Moyen,Facile,1,Plus Facile,Pas Adapte
4290,2018,Sociologie,1,Les Differentes Approches de l'Economie,4,L'Analyse Marxiste,14,958,12,QCU,0.05,0.88,72.21,20,8,28,25,20,5,1.12,80.0,Moyen,Facile,1,Plus Facile,Adapte
5401,2019,Sociologie,1,Les Differentes Approches de l'Economie,4,L'Analyse Marxiste,14,958,12,QROC,0.1,0.5,72.21,22,9,31,30,22,8,1.03,73.33,Facile,Facile,0,Meme Difficulté,Adapte
6512,2020,Sociologie,1,Les Differentes Approches de l'Economie,4,L'Analyse Marxiste,14,958,12,QROC,0.16,0.92,72.21,22,9,31,30,22,8,1.03,73.33,Facile,Facile,0,Meme Difficulté,Adapte
958,2015,Sociologie,1,Les Differentes Approches de l'Economie,4,L'Analyse Marxiste,14,959,13,QO,0.99,0.12,13.49,9,56,65,42,9,33,1.55,21.43,Moyen,Difficile,-1,Plus Difficile,Pas Adapte
2069,2016,Sociologie,1,Les Differentes Approches de l'Economie,4,L'Analyse Marxiste,14,959,13,QO,0.91,0.07,1.41,1,63,64,57,1,56,1.12,1.75,Difficile,Difficile,0,Meme Difficulté,Pas Adapte
3180,2017,Sociologie,1,Les Differentes Approches de l'Economie,4,L'Analyse Marxiste,14,959,13,QO,0.07,0.94,82.38,44,10,54,46,44,2,1.17,95.65,Difficile,Facile,2,Beaucoup plus Facile,Pas Adapte
4291,2018,Sociologie,1,Les Differentes Approches de l'Economie,4,L'Analyse Marxiste,14,959,13,QCM,0.6,0.16,25.93,15,44,59,23,15,8,2.57,65.22,Facile,Difficile,-2,Beaucoup plus Difficile,Pas Adapte
5402,2019,Sociologie,1,Les Differentes Approches de l'Economie,4,L'Analyse Marxiste,14,959,13,QCU,0.14,0.76,89.41,47,6,53,49,47,2,1.08,95.92,Difficile,Facile,2,Beaucoup plus Facile,Pas Adapte
6513,2020,Sociologie,1,Les Differentes Approches de l'Economie,4,L'Analyse Marxiste,14,959,13,QCU,0.2,0.52,35.26,18,33,51,21,18,3,2.43,85.71,Difficile,Moyen,1,Plus Facile,Pas Adapte
959,2015,Sociologie,1,Les Differentes Approches de l'Economie,4,L'Analyse Marxiste,14,960,14,QCM,0.32,0.47,53.8,40,35,75,55,40,15,1.36,72.73,Facile,Moyen,-1,Plus Difficile,Pas Adapte
2070,2016,Sociologie,1,Les Differentes Approches de l'Economie,4,L'Analyse Marxiste,14,960,14,QCM,0.01,0.88,99.61,68,0,68,68,68,0,1.0,100.0,Difficile,Facile,2,Beaucoup plus Facile,Pas Adapte
3181,2017,Sociologie,1,Les Differentes Approches de l'Economie,4,L'Analyse Marxiste,14,960,14,QCM,0.5,0.3,28.19,16,42,58,42,16,26,1.38,38.1,Facile,Difficile,-2,Beaucoup plus Difficile,Pas Adapte
4292,2018,Sociologie,1,Les Differentes Approches de l'Economie,4,L'Analyse Marxiste,14,960,14,QCM,0.19,0.75,76.08,49,15,64,49,49,0,1.31,100.0,Facile,Facile,0,Meme Difficulté,Pas Adapte
5403,2019,Sociologie,1,Les Differentes Approches de l'Economie,4,L'Analyse Marxiste,14,960,14,QCM,0.57,0.22,7.39,5,68,73,27,5,22,2.7,18.52,Moyen,Difficile,-1,Plus Difficile,Pas Adapte
6514,2020,Sociologie,1,Les Differentes Approches de l'Economie,4,L'Analyse Marxiste,14,960,14,QCU,0.27,0.54,43.31,28,36,64,50,28,22,1.28,56.0,Difficile,Moyen,1,Plus Facile,Pas Adapte
960,2015,Sociologie,1,Les Differentes Approches de l'Economie,5,La Pensee Economique de Keynes,1,961,1,QCU,0.08,0.81,73.62,54,19,73,66,54,12,1.11,81.82,Difficile,Facile,2,Beaucoup plus Facile,Adapte
2071,2016,Sociologie,1,Les Differentes Approches de l'Economie,5,La Pensee Economique de Keynes,1,961,1,QCU,0.05,0.98,73.62,52,18,70,65,52,13,1.08,80.0,Facile,Facile,0,Meme Difficulté,Adapte
3182,2017,Sociologie,1,Les Differentes Approches de l'Economie,5,La Pensee Economique de Keynes,1,961,1,QCM,0.14,0.79,73.62,49,17,66,59,49,10,1.12,83.05,Facile,Facile,0,Meme Difficulté,Adapte
4293,2018,Sociologie,1,Les Differentes Approches de l'Economie,5,La Pensee Economique de Keynes,1,961,1,QCM,0.11,0.77,73.62,49,17,66,65,49,16,1.02,75.38,Facile,Facile,0,Meme Difficulté,Adapte
5404,2019,Sociologie,1,Les Differentes Approches de l'Economie,5,La Pensee Economique de Keynes,1,961,1,QCM,0.16,0.96,73.62,47,17,64,55,47,8,1.16,85.45,Facile,Facile,0,Meme Difficulté,Adapte
6515,2020,Sociologie,1,Les Differentes Approches de l'Economie,5,La Pensee Economique de Keynes,1,961,1,QCM,0.13,0.91,73.62,54,19,73,71,54,17,1.03,76.06,Facile,Facile,0,Meme Difficulté,Adapte
961,2015,Sociologie,1,Les Differentes Approches de l'Economie,6,Les Insuffisances d'une Pensee purement Economique,6,962,1,QCU,0.02,0.94,68.29,26,12,38,28,26,2,1.36,92.86,Difficile,Facile,2,Beaucoup plus Facile,Adapte
2072,2016,Sociologie,1,Les Differentes Approches de l'Economie,6,Les Insuffisances d'une Pensee purement Economique,6,962,1,QCU,0.13,0.94,68.29,25,11,36,32,25,7,1.12,78.12,Facile,Facile,0,Meme Difficulté,Adapte
3183,2017,Sociologie,1,Les Differentes Approches de l'Economie,6,Les Insuffisances d'une Pensee purement Economique,6,962,1,QCU,0.08,0.85,68.29,23,10,33,31,23,8,1.06,74.19,Facile,Facile,0,Meme Difficulté,Adapte
4294,2018,Sociologie,1,Les Differentes Approches de l'Economie,6,Les Insuffisances d'une Pensee purement Economique,6,962,1,QROC,0.15,0.58,68.29,20,9,29,21,20,1,1.38,95.24,Facile,Facile,0,Meme Difficulté,Adapte
5405,2019,Sociologie,1,Les Differentes Approches de l'Economie,6,Les Insuffisances d'une Pensee purement Economique,6,962,1,QROC,0.17,0.9,68.29,20,9,29,29,20,9,1.0,68.97,Facile,Facile,0,Meme Difficulté,Adapte
6516,2020,Sociologie,1,Les Differentes Approches de l'Economie,6,Les Insuffisances d'une Pensee purement Economique,6,962,1,QROC,0.01,0.73,68.29,18,9,27,25,18,7,1.08,72.0,Facile,Facile,0,Meme Difficulté,Adapte
962,2015,Sociologie,1,Les Differentes Approches de l'Economie,6,Les Insuffisances d'une Pensee purement Economique,6,963,2,QCU,0.05,0.97,95.66,48,2,50,49,48,1,1.02,97.96,Facile,Facile,0,Meme Difficulté,Pas Adapte
2073,2016,Sociologie,1,Les Differentes Approches de l'Economie,6,Les Insuffisances d'une Pensee purement Economique,6,963,2,QCU,0.28,0.69,37.37,21,36,57,26,21,5,2.19,80.77,Facile,Moyen,-1,Plus Difficile,Pas Adapte
3184,2017,Sociologie,1,Les Differentes Approches de l'Economie,6,Les Insuffisances d'une Pensee purement Economique,6,963,2,QCU,0.15,0.81,73.23,36,13,49,45,36,9,1.09,80.0,Facile,Facile,0,Meme Difficulté,Adapte
4295,2018,Sociologie,1,Les Differentes Approches de l'Economie,6,Les Insuffisances d'une Pensee purement Economique,6,963,2,QCU,0.04,0.91,73.23,32,12,44,38,32,6,1.16,84.21,Facile,Facile,0,Meme Difficulté,Adapte
5406,2019,Sociologie,1,Les Differentes Approches de l'Economie,6,Les Insuffisances d'une Pensee purement Economique,6,963,2,QCU,0.01,0.98,73.23,31,12,43,41,31,10,1.05,75.61,Facile,Facile,0,Meme Difficulté,Adapte
6517,2020,Sociologie,1,Les Differentes Approches de l'Economie,6,Les Insuffisances d'une Pensee purement Economique,6,963,2,QCU,0.12,0.99,73.23,35,13,48,35,35,0,1.37,100.0,Facile,Facile,0,Meme Difficulté,Adapte
963,2015,Sociologie,1,Les Differentes Approches de l'Economie,6,Les Insuffisances d'une Pensee purement Economique,6,964,3,QO,0.01,0.84,75.05,67,22,89,88,67,21,1.01,76.14,Moyen,Facile,1,Plus Facile,Pas Adapte
2074,2016,Sociologie,1,Les Differentes Approches de l'Economie,6,Les Insuffisances d'une Pensee purement Economique,6,964,3,QO,0.24,0.23,57.61,59,43,102,78,59,19,1.31,75.64,Facile,Moyen,-1,Plus Difficile,Pas Adapte
3185,2017,Sociologie,1,Les Differentes Approches de l'Economie,6,Les Insuffisances d'une Pensee purement Economique,6,964,3,QO,0.55,0.24,57.57,58,43,101,70,58,12,1.44,82.86,Difficile,Moyen,1,Plus Facile,Pas Adapte
4296,2018,Sociologie,1,Les Differentes Approches de l'Economie,6,Les Insuffisances d'une Pensee purement Economique,6,964,3,QO,0.75,0.12,14.68,16,94,110,56,16,40,1.96,28.57,Moyen,Difficile,-1,Plus Difficile,Pas Adapte
5407,2019,Sociologie,1,Les Differentes Approches de l'Economie,6,Les Insuffisances d'une Pensee purement Economique,6,964,3,QO,0.14,0.91,96.36,93,3,96,95,93,2,1.01,97.89,Moyen,Facile,1,Plus Facile,Pas Adapte
6518,2020,Sociologie,1,Les Differentes Approches de l'Economie,6,Les Insuffisances d'une Pensee purement Economique,6,964,3,QO,0.15,0.7,99.05,90,1,91,91,90,1,1.0,98.9,Facile,Facile,0,Meme Difficulté,Pas Adapte
964,2015,Sociologie,1,Les Differentes Approches de l'Economie,6,Les Insuffisances d'une Pensee purement Economique,6,965,4,QCU,0.23,0.54,41.1,16,22,38,24,16,8,1.58,66.67,Moyen,Moyen,0,Meme Difficulté,Pas Adapte
2075,2016,Sociologie,1,Les Differentes Approches de l'Economie,6,Les Insuffisances d'une Pensee purement Economique,6,965,4,QCU,0.19,0.98,82.7,31,7,38,35,31,4,1.09,88.57,Difficile,Facile,2,Beaucoup plus Facile,Pas Adapte
3186,2017,Sociologie,1,Les Differentes Approches de l'Economie,6,Les Insuffisances d'une Pensee purement Economique,6,965,4,QCU,0.16,1.0,71.63,28,11,39,39,28,11,1.0,71.79,Difficile,Facile,2,Beaucoup plus Facile,Adapte
4297,2018,Sociologie,1,Les Differentes Approches de l'Economie,6,Les Insuffisances d'une Pensee purement Economique,6,965,4,QCU,0.18,0.91,71.63,25,10,35,27,25,2,1.3,92.59,Facile,Facile,0,Meme Difficulté,Adapte
5408,2019,Sociologie,1,Les Differentes Approches de l'Economie,6,Les Insuffisances d'une Pensee purement Economique,6,965,4,QCU,0.03,0.94,71.63,23,9,32,32,23,9,1.0,71.88,Facile,Facile,0,Meme Difficulté,Adapte
6519,2020,Sociologie,1,Les Differentes Approches de l'Economie,6,Les Insuffisances d'une Pensee purement Economique,6,965,4,QCU,0.15,0.93,71.63,23,9,32,30,23,7,1.07,76.67,Facile,Facile,0,Meme Difficulté,Adapte
965,2015,Sociologie,1,Les Differentes Approches de l'Economie,6,Les Insuffisances d'une Pensee purement Economique,6,966,5,QCM,0.21,0.33,54.69,21,17,38,22,21,1,1.73,95.45,Moyen,Moyen,0,Meme Difficulté,Pas Adapte
2076,2016,Sociologie,1,Les Differentes Approches de l'Economie,6,Les Insuffisances d'une Pensee purement Economique,6,966,5,QCM,0.36,0.63,37.12,13,22,35,21,13,8,1.67,61.9,Difficile,Moyen,1,Plus Facile,Pas Adapte
3187,2017,Sociologie,1,Les Differentes Approches de l'Economie,6,Les Insuffisances d'une Pensee purement Economique,6,966,5,QCM,0.31,0.46,48.47,15,16,31,26,15,11,1.19,57.69,Facile,Moyen,-1,Plus Difficile,Pas Adapte
4298,2018,Sociologie,1,Les Differentes Approches de l'Economie,6,Les Insuffisances d'une Pensee purement Economique,6,966,5,QCM,0.17,0.82,65.11,21,11,32,21,21,0,1.52,100.0,Moyen,Facile,1,Plus Facile,Adapte
5409,2019,Sociologie,1,Les Differentes Approches de l'Economie,6,Les Insuffisances d'une Pensee purement Economique,6,966,5,QCM,0.04,0.94,65.11,18,10,28,26,18,8,1.08,69.23,Facile,Facile,0,Meme Difficulté,Adapte
6520,2020,Sociologie,1,Les Differentes Approches de l'Economie,6,Les Insuffisances d'une Pensee purement Economique,6,966,5,QCM,0.07,0.95,65.11,21,11,32,26,21,5,1.23,80.77,Facile,Facile,0,Meme Difficulté,Adapte
966,2015,Sociologie,1,Les Differentes Approches de l'Economie,6,Les Insuffisances d'une Pensee purement Economique,6,967,6,QROC,0.42,0.3,43.58,6,7,13,6,6,0,2.17,100.0,Moyen,Moyen,0,Meme Difficulté,Pas Adapte
2077,2016,Sociologie,1,Les Differentes Approches de l'Economie,6,Les Insuffisances d'une Pensee purement Economique,6,967,6,QO,0.04,0.76,75.52,9,3,12,9,9,0,1.33,100.0,Facile,Facile,0,Meme Difficulté,Pas Adapte
3188,2017,Sociologie,1,Les Differentes Approches de l'Economie,6,Les Insuffisances d'une Pensee purement Economique,6,967,6,QROC,0.44,0.26,61.26,8,5,13,11,8,3,1.18,72.73,Moyen,Moyen,0,Meme Difficulté,Pas Adapte
4299,2018,Sociologie,1,Les Differentes Approches de l'Economie,6,Les Insuffisances d'une Pensee purement Economique,6,967,6,QCM,0.76,0.27,16.82,3,12,15,10,3,7,1.5,30.0,Facile,Difficile,-2,Beaucoup plus Difficile,Pas Adapte
5410,2019,Sociologie,1,Les Differentes Approches de l'Economie,6,Les Insuffisances d'une Pensee purement Economique,6,967,6,QCM,0.62,0.23,33.05,5,10,15,9,5,4,1.67,55.56,Moyen,Difficile,-1,Plus Difficile,Pas Adapte
6521,2020,Sociologie,1,Les Differentes Approches de l'Economie,6,Les Insuffisances d'une Pensee purement Economique,6,967,6,QCM,0.05,0.95,83.71,12,2,14,13,12,1,1.08,92.31,Facile,Facile,0,Meme Difficulté,Pas Adapte
967,2015,Sociologie,2,Histoire de la Pensee Economique,1,Introduction,3,968,1,QCU,0.66,0.27,8.43,2,21,23,21,2,19,1.1,9.52,Difficile,Difficile,0,Meme Difficulté,Pas Adapte
2078,2016,Sociologie,2,Histoire de la Pensee Economique,1,Introduction,3,968,1,QCU,0.11,1.0,77.41,19,6,25,21,19,2,1.19,90.48,Difficile,Facile,2,Beaucoup plus Facile,Pas Adapte
3189,2017,Sociologie,2,Histoire de la Pensee Economique,1,Introduction,3,968,1,QROC,0.2,0.47,72.25,18,7,25,24,18,6,1.04,75.0,Difficile,Facile,2,Beaucoup plus Facile,Adapte
4300,2018,Sociologie,2,Histoire de la Pensee Economique,1,Introduction,3,968,1,QROC,0.1,0.92,72.25,17,6,23,23,17,6,1.0,73.91,Facile,Facile,0,Meme Difficulté,Adapte
5411,2019,Sociologie,2,Histoire de la Pensee Economique,1,Introduction,3,968,1,QROC,0.0,0.61,72.25,18,7,25,19,18,1,1.32,94.74,Facile,Facile,0,Meme Difficulté,Adapte
6522,2020,Sociologie,2,Histoire de la Pensee Economique,1,Introduction,3,968,1,QROC,0.13,0.59,72.25,20,8,28,22,20,2,1.27,90.91,Facile,Facile,0,Meme Difficulté,Adapte
968,2015,Sociologie,2,Histoire de la Pensee Economique,1,Introduction,3,969,2,QCM,0.45,0.35,48.17,41,44,85,58,41,17,1.47,70.69,Moyen,Moyen,0,Meme Difficulté,Pas Adapte
2079,2016,Sociologie,2,Histoire de la Pensee Economique,1,Introduction,3,969,2,QCU,0.63,0.22,27.36,25,65,90,38,25,13,2.37,65.79,Facile,Difficile,-2,Beaucoup plus Difficile,Pas Adapte
3190,2017,Sociologie,2,Histoire de la Pensee Economique,1,Introduction,3,969,2,QCU,0.19,0.81,91.59,73,7,80,77,73,4,1.04,94.81,Difficile,Facile,2,Beaucoup plus Facile,Pas Adapte
4301,2018,Sociologie,2,Histoire de la Pensee Economique,1,Introduction,3,969,2,QCU,0.02,0.91,81.84,68,15,83,72,68,4,1.15,94.44,Difficile,Facile,2,Beaucoup plus Facile,Pas Adapte
5412,2019,Sociologie,2,Histoire de la Pensee Economique,1,Introduction,3,969,2,QCU,0.31,0.75,35.59,26,47,73,62,26,36,1.18,41.94,Difficile,Moyen,1,Plus Facile,Pas Adapte
6523,2020,Sociologie,2,Histoire de la Pensee Economique,1,Introduction,3,969,2,QCU,0.21,0.65,55.52,44,35,79,47,44,3,1.68,93.62,Facile,Moyen,-1,Plus Difficile,Pas Adapte
969,2015,Sociologie,2,Histoire de la Pensee Economique,1,Introduction,3,970,3,QROC,0.97,0.24,19.44,13,54,67,64,13,51,1.05,20.31,Facile,Difficile,-2,Beaucoup plus Difficile,Pas Adapte
2080,2016,Sociologie,2,Histoire de la Pensee Economique,1,Introduction,3,970,3,QROC,0.18,0.73,95.55,70,3,73,73,70,3,1.0,95.89,Moyen,Facile,1,Plus Facile,Pas Adapte
3191,2017,Sociologie,2,Histoire de la Pensee Economique,1,Introduction,3,970,3,QCM,0.75,0.26,7.85,6,76,82,41,6,35,2.0,14.63,Moyen,Difficile,-1,Plus Difficile,Pas Adapte
4302,2018,Sociologie,2,Histoire de la Pensee Economique,1,Introduction,3,970,3,QCM,0.7,0.21,25.51,20,59,79,76,20,56,1.04,26.32,Difficile,Difficile,0,Meme Difficulté,Pas Adapte
5413,2019,Sociologie,2,Histoire de la Pensee Economique,1,Introduction,3,970,3,QCM,0.41,0.35,61.34,45,29,74,50,45,5,1.48,90.0,Facile,Moyen,-1,Plus Difficile,Pas Adapte
6524,2020,Sociologie,2,Histoire de la Pensee Economique,1,Introduction,3,970,3,QCM,0.29,0.4,45.59,30,35,65,30,30,0,2.17,100.0,Moyen,Moyen,0,Meme Difficulté,Pas Adapte
970,2015,Sociologie,2,Histoire de la Pensee Economique,2,La Formation de la Pensee Economique jusqu'a Adam Smith,7,971,1,QCU,0.59,0.28,17.36,4,20,24,20,4,16,1.2,20.0,Facile,Difficile,-2,Beaucoup plus Difficile,Pas Adapte
2081,2016,Sociologie,2,Histoire de la Pensee Economique,2,La Formation de la Pensee Economique jusqu'a Adam Smith,7,971,1,QCM,0.19,0.72,87.81,19,3,22,22,19,3,1.0,86.36,Facile,Facile,0,Meme Difficulté,Pas Adapte
3192,2017,Sociologie,2,Histoire de la Pensee Economique,2,La Formation de la Pensee Economique jusqu'a Adam Smith,7,971,1,QCM,0.36,0.47,42.81,9,12,21,14,9,5,1.5,64.29,Facile,Moyen,-1,Plus Difficile,Pas Adapte
4303,2018,Sociologie,2,Histoire de la Pensee Economique,2,La Formation de la Pensee Economique jusqu'a Adam Smith,7,971,1,QCM,0.18,0.97,96.5,23,1,24,23,23,0,1.04,100.0,Difficile,Facile,2,Beaucoup plus Facile,Pas Adapte
5414,2019,Sociologie,2,Histoire de la Pensee Economique,2,La Formation de la Pensee Economique jusqu'a Adam Smith,7,971,1,QCM,0.79,0.2,10.97,2,20,22,13,2,11,1.69,15.38,Difficile,Difficile,0,Meme Difficulté,Pas Adapte
6525,2020,Sociologie,2,Histoire de la Pensee Economique,2,La Formation de la Pensee Economique jusqu'a Adam Smith,7,971,1,QCM,0.1,0.86,90.41,19,2,21,20,19,1,1.05,95.0,Facile,Facile,0,Meme Difficulté,Pas Adapte
971,2015,Sociologie,2,Histoire de la Pensee Economique,2,La Formation de la Pensee Economique jusqu'a Adam Smith,7,972,2,QCU,0.1,0.76,88.94,51,6,57,57,51,6,1.0,89.47,Difficile,Facile,2,Beaucoup plus Facile,Pas Adapte
2082,2016,Sociologie,2,Histoire de la Pensee Economique,2,La Formation de la Pensee Economique jusqu'a Adam Smith,7,972,2,QCM,0.05,0.95,65.62,42,22,64,63,42,21,1.02,66.67,Moyen,Facile,1,Plus Facile,Adapte
3193,2017,Sociologie,2,Histoire de la Pensee Economique,2,La Formation de la Pensee Economique jusqu'a Adam Smith,7,972,2,QCM,0.09,0.92,65.62,41,21,62,62,41,21,1.0,66.13,Facile,Facile,0,Meme Difficulté,Adapte
4304,2018,Sociologie,2,Histoire de la Pensee Economique,2,La Formation de la Pensee Economique jusqu'a Adam Smith,7,972,2,QCM,0.08,0.77,65.62,39,21,60,57,39,18,1.05,68.42,Facile,Facile,0,Meme Difficulté,Adapte
5415,2019,Sociologie,2,Histoire de la Pensee Economique,2,La Formation de la Pensee Economique jusqu'a Adam Smith,7,972,2,QCM,0.08,0.88,65.62,37,19,56,38,37,1,1.47,97.37,Facile,Facile,0,Meme Difficulté,Adapte
6526,2020,Sociologie,2,Histoire de la Pensee Economique,2,La Formation de la Pensee Economique jusqu'a Adam Smith,7,972,2,QCM,0.05,0.87,65.62,42,22,64,45,42,3,1.42,93.33,Facile,Facile,0,Meme Difficulté,Adapte
972,2015,Sociologie,2,Histoire de la Pensee Economique,2,La Formation de la Pensee Economique jusqu'a Adam Smith,7,973,3,QROC,0.68,0.04,33.6,11,22,33,18,11,7,1.83,61.11,Facile,Difficile,-2,Beaucoup plus Difficile,Pas Adapte
2083,2016,Sociologie,2,Histoire de la Pensee Economique,2,La Formation de la Pensee Economique jusqu'a Adam Smith,7,973,3,QROC,0.17,0.73,97.64,33,1,34,33,33,0,1.03,100.0,Difficile,Facile,2,Beaucoup plus Facile,Pas Adapte
3194,2017,Sociologie,2,Histoire de la Pensee Economique,2,La Formation de la Pensee Economique jusqu'a Adam Smith,7,973,3,QROC,0.39,0.35,61.12,19,12,31,28,19,9,1.11,67.86,Facile,Moyen,-1,Plus Difficile,Pas Adapte
4305,2018,Sociologie,2,Histoire de la Pensee Economique,2,La Formation de la Pensee Economique jusqu'a Adam Smith,7,973,3,QCM,0.27,0.58,38.26,11,17,28,19,11,8,1.47,57.89,Moyen,Moyen,0,Meme Difficulté,Pas Adapte
5416,2019,Sociologie,2,Histoire de la Pensee Economique,2,La Formation de la Pensee Economique jusqu'a Adam Smith,7,973,3,QCM,0.64,0.19,1.82,1,29,30,26,1,25,1.15,3.85,Facile,Difficile,-2,Beaucoup plus Difficile,Pas Adapte
6527,2020,Sociologie,2,Histoire de la Pensee Economique,2,La Formation de la Pensee Economique jusqu'a Adam Smith,7,973,3,QCM,0.13,0.8,98.88,32,0,32,32,32,0,1.0,100.0,Moyen,Facile,1,Plus Facile,Pas Adapte
973,2015,Sociologie,2,Histoire de la Pensee Economique,2,La Formation de la Pensee Economique jusqu'a Adam Smith,7,974,4,QCM,0.77,0.29,18.25,9,42,51,50,9,41,1.02,18.0,Difficile,Difficile,0,Meme Difficulté,Pas Adapte
2084,2016,Sociologie,2,Histoire de la Pensee Economique,2,La Formation de la Pensee Economique jusqu'a Adam Smith,7,974,4,QCM,0.7,0.25,9.57,6,52,58,22,6,16,2.64,27.27,Facile,Difficile,-2,Beaucoup plus Difficile,Pas Adapte
3195,2017,Sociologie,2,Histoire de la Pensee Economique,2,La Formation de la Pensee Economique jusqu'a Adam Smith,7,974,4,QCM,0.77,0.26,4.49,3,57,60,27,3,24,2.22,11.11,Facile,Difficile,-2,Beaucoup plus Difficile,Pas Adapte
4306,2018,Sociologie,2,Histoire de la Pensee Economique,2,La Formation de la Pensee Economique jusqu'a Adam Smith,7,974,4,QCM,0.56,0.27,28.54,15,37,52,37,15,22,1.41,40.54,Moyen,Difficile,-1,Plus Difficile,Pas Adapte
5417,2019,Sociologie,2,Histoire de la Pensee Economique,2,La Formation de la Pensee Economique jusqu'a Adam Smith,7,974,4,QCM,0.19,0.75,86.35,48,8,56,55,48,7,1.02,87.27,Facile,Facile,0,Meme Difficulté,Pas Adapte
6528,2020,Sociologie,2,Histoire de la Pensee Economique,2,La Formation de la Pensee Economique jusqu'a Adam Smith,7,974,4,QCM,0.48,0.33,36.52,20,36,56,47,20,27,1.19,42.55,Difficile,Moyen,1,Plus Facile,Pas Adapte
974,2015,Sociologie,2,Histoire de la Pensee Economique,2,La Formation de la Pensee Economique jusqu'a Adam Smith,7,975,5,QCU,0.1,0.86,95.6,8,0,8,8,8,0,1.0,100.0,Facile,Facile,0,Meme Difficulté,Pas Adapte
2085,2016,Sociologie,2,Histoire de la Pensee Economique,2,La Formation de la Pensee Economique jusqu'a Adam Smith,7,975,5,QCU,0.17,0.8,66.59,5,2,7,6,5,1,1.17,83.33,Moyen,Facile,1,Plus Facile,Adapte
3196,2017,Sociologie,2,Histoire de la Pensee Economique,2,La Formation de la Pensee Economique jusqu'a Adam Smith,7,975,5,QCU,0.14,0.93,66.59,5,2,7,6,5,1,1.17,83.33,Facile,Facile,0,Meme Difficulté,Adapte
4307,2018,Sociologie,2,Histoire de la Pensee Economique,2,La Formation de la Pensee Economique jusqu'a Adam Smith,7,975,5,QCU,0.02,0.76,66.59,4,2,6,5,4,1,1.2,80.0,Facile,Facile,0,Meme Difficulté,Adapte
5418,2019,Sociologie,2,Histoire de la Pensee Economique,2,La Formation de la Pensee Economique jusqu'a Adam Smith,7,975,5,QCU,0.03,0.79,66.59,5,2,7,6,5,1,1.17,83.33,Facile,Facile,0,Meme Difficulté,Adapte
6529,2020,Sociologie,2,Histoire de la Pensee Economique,2,La Formation de la Pensee Economique jusqu'a Adam Smith,7,975,5,QCU,0.14,0.88,66.59,5,2,7,6,5,1,1.17,83.33,Facile,Facile,0,Meme Difficulté,Adapte
975,2015,Sociologie,2,Histoire de la Pensee Economique,2,La Formation de la Pensee Economique jusqu'a Adam Smith,7,976,6,QCU,0.21,0.54,43.79,21,27,48,29,21,8,1.66,72.41,Facile,Moyen,-1,Plus Difficile,Pas Adapte
2086,2016,Sociologie,2,Histoire de la Pensee Economique,2,La Formation de la Pensee Economique jusqu'a Adam Smith,7,976,6,QCM,0.06,0.98,65.57,31,16,47,36,31,5,1.31,86.11,Moyen,Facile,1,Plus Facile,Adapte
3197,2017,Sociologie,2,Histoire de la Pensee Economique,2,La Formation de la Pensee Economique jusqu'a Adam Smith,7,976,6,QCM,0.05,0.87,65.57,34,18,52,37,34,3,1.41,91.89,Facile,Facile,0,Meme Difficulté,Adapte
4308,2018,Sociologie,2,Histoire de la Pensee Economique,2,La Formation de la Pensee Economique jusqu'a Adam Smith,7,976,6,QCM,0.07,0.82,65.57,33,18,51,43,33,10,1.19,76.74,Facile,Facile,0,Meme Difficulté,Adapte
5419,2019,Sociologie,2,Histoire de la Pensee Economique,2,La Formation de la Pensee Economique jusqu'a Adam Smith,7,976,6,QCM,0.03,0.74,65.57,31,17,48,41,31,10,1.17,75.61,Facile,Facile,0,Meme Difficulté,Adapte
6530,2020,Sociologie,2,Histoire de la Pensee Economique,2,La Formation de la Pensee Economique jusqu'a Adam Smith,7,976,6,QCM,0.16,0.88,65.57,35,18,53,50,35,15,1.06,70.0,Facile,Facile,0,Meme Difficulté,Adapte
976,2015,Sociologie,2,Histoire de la Pensee Economique,2,La Formation de la Pensee Economique jusqu'a Adam Smith,7,977,7,QCU,0.28,0.65,56.57,7,6,13,11,7,4,1.18,63.64,Facile,Moyen,-1,Plus Difficile,Pas Adapte
2087,2016,Sociologie,2,Histoire de la Pensee Economique,2,La Formation de la Pensee Economique jusqu'a Adam Smith,7,977,7,QCU,0.26,0.46,54.49,8,6,14,13,8,5,1.08,61.54,Facile,Moyen,-1,Plus Difficile,Pas Adapte
3198,2017,Sociologie,2,Histoire de la Pensee Economique,2,La Formation de la Pensee Economique jusqu'a Adam Smith,7,977,7,QCU,0.58,0.25,25.86,4,10,14,5,4,1,2.8,80.0,Difficile,Difficile,0,Meme Difficulté,Pas Adapte
4309,2018,Sociologie,2,Histoire de la Pensee Economique,2,La Formation de la Pensee Economique jusqu'a Adam Smith,7,977,7,QCU,0.06,0.87,80.12,12,3,15,15,12,3,1.0,80.0,Facile,Facile,0,Meme Difficulté,Pas Adapte
5420,2019,Sociologie,2,Histoire de la Pensee Economique,2,La Formation de la Pensee Economique jusqu'a Adam Smith,7,977,7,QCU,0.07,0.79,88.7,13,2,15,15,13,2,1.0,86.67,Facile,Facile,0,Meme Difficulté,Pas Adapte
6531,2020,Sociologie,2,Histoire de la Pensee Economique,2,La Formation de la Pensee Economique jusqu'a Adam Smith,7,977,7,QCU,0.37,0.74,61.59,8,5,13,10,8,2,1.3,80.0,Difficile,Moyen,1,Plus Facile,Pas Adapte
977,2015,Sociologie,2,Histoire de la Pensee Economique,3,La Conception Liberale de l'Economie,9,978,1,QCU,0.57,0.23,21.16,18,66,84,67,18,49,1.25,26.87,Moyen,Difficile,-1,Plus Difficile,Pas Adapte
2088,2016,Sociologie,2,Histoire de la Pensee Economique,3,La Conception Liberale de l'Economie,9,978,1,QCU,0.38,0.46,48.98,47,48,95,55,47,8,1.73,85.45,Facile,Moyen,-1,Plus Difficile,Pas Adapte
3199,2017,Sociologie,2,Histoire de la Pensee Economique,3,La Conception Liberale de l'Economie,9,978,1,QCU,0.21,0.57,60.57,55,36,91,74,55,19,1.23,74.32,Facile,Moyen,-1,Plus Difficile,Pas Adapte
4310,2018,Sociologie,2,Histoire de la Pensee Economique,3,La Conception Liberale de l'Economie,9,978,1,QCU,0.02,0.75,84.4,71,13,84,79,71,8,1.06,89.87,Facile,Facile,0,Meme Difficulté,Pas Adapte
5421,2019,Sociologie,2,Histoire de la Pensee Economique,3,La Conception Liberale de l'Economie,9,978,1,QCU,0.21,0.53,46.48,45,51,96,83,45,38,1.16,54.22,Facile,Moyen,-1,Plus Difficile,Pas Adapte
6532,2020,Sociologie,2,Histoire de la Pensee Economique,3,La Conception Liberale de l'Economie,9,978,1,QCU,0.42,0.3,22.15,22,76,98,96,22,74,1.02,22.92,Facile,Difficile,-2,Beaucoup plus Difficile,Pas Adapte
978,2015,Sociologie,2,Histoire de la Pensee Economique,3,La Conception Liberale de l'Economie,9,979,2,QCM,0.79,0.15,32.56,13,26,39,30,13,17,1.3,43.33,Facile,Difficile,-2,Beaucoup plus Difficile,Pas Adapte
2089,2016,Sociologie,2,Histoire de la Pensee Economique,3,La Conception Liberale de l'Economie,9,979,2,QCM,0.13,0.98,95.05,36,2,38,37,36,1,1.03,97.3,Difficile,Facile,2,Beaucoup plus Facile,Pas Adapte
3200,2017,Sociologie,2,Histoire de la Pensee Economique,3,La Conception Liberale de l'Economie,9,979,2,QCM,0.63,0.29,12.19,5,33,38,18,5,13,2.11,27.78,Moyen,Difficile,-1,Plus Difficile,Pas Adapte
4311,2018,Sociologie,2,Histoire de la Pensee Economique,3,La Conception Liberale de l'Economie,9,979,2,QCU,0.09,0.77,93.05,35,3,38,37,35,2,1.03,94.59,Facile,Facile,0,Meme Difficulté,Pas Adapte
5422,2019,Sociologie,2,Histoire de la Pensee Economique,3,La Conception Liberale de l'Economie,9,979,2,QCU,0.08,0.84,96.68,37,1,38,37,37,0,1.03,100.0,Difficile,Facile,2,Beaucoup plus Facile,Pas Adapte
6533,2020,Sociologie,2,Histoire de la Pensee Economique,3,La Conception Liberale de l'Economie,9,979,2,QROC,0.64,0.01,22.63,9,30,39,19,9,10,2.05,47.37,Moyen,Difficile,-1,Plus Difficile,Pas Adapte
979,2015,Sociologie,2,Histoire de la Pensee Economique,3,La Conception Liberale de l'Economie,9,980,3,QCU,0.17,0.98,83.93,46,9,55,49,46,3,1.12,93.88,Moyen,Facile,1,Plus Facile,Pas Adapte
2090,2016,Sociologie,2,Histoire de la Pensee Economique,3,La Conception Liberale de l'Economie,9,980,3,QCU,0.43,0.4,15.86,8,42,50,34,8,26,1.47,23.53,Difficile,Difficile,0,Meme Difficulté,Pas Adapte
3201,2017,Sociologie,2,Histoire de la Pensee Economique,3,La Conception Liberale de l'Economie,9,980,3,QCU,0.51,0.39,25.39,13,40,53,45,13,32,1.18,28.89,Facile,Difficile,-2,Beaucoup plus Difficile,Pas Adapte
4312,2018,Sociologie,2,Histoire de la Pensee Economique,3,La Conception Liberale de l'Economie,9,980,3,QCU,0.48,0.22,27.8,13,32,45,25,13,12,1.8,52.0,Facile,Difficile,-2,Beaucoup plus Difficile,Pas Adapte
5423,2019,Sociologie,2,Histoire de la Pensee Economique,3,La Conception Liberale de l'Economie,9,980,3,QCU,0.03,0.83,86.22,41,7,48,45,41,4,1.07,91.11,Facile,Facile,0,Meme Difficulté,Pas Adapte
6534,2020,Sociologie,2,Histoire de la Pensee Economique,3,La Conception Liberale de l'Economie,9,980,3,QCU,0.38,0.42,60.79,30,19,49,34,30,4,1.44,88.24,Moyen,Moyen,0,Meme Difficulté,Pas Adapte
980,2015,Sociologie,2,Histoire de la Pensee Economique,3,La Conception Liberale de l'Economie,9,981,4,QCM,0.14,0.74,79.45,44,12,56,53,44,9,1.06,83.02,Moyen,Facile,1,Plus Facile,Pas Adapte
2091,2016,Sociologie,2,Histoire de la Pensee Economique,3,La Conception Liberale de l'Economie,9,981,4,QCM,0.05,0.74,90.31,52,6,58,56,52,4,1.04,92.86,Moyen,Facile,1,Plus Facile,Pas Adapte
3202,2017,Sociologie,2,Histoire de la Pensee Economique,3,La Conception Liberale de l'Economie,9,981,4,QCM,0.33,0.43,60.39,39,26,65,42,39,3,1.55,92.86,Facile,Moyen,-1,Plus Difficile,Pas Adapte
4313,2018,Sociologie,2,Histoire de la Pensee Economique,3,La Conception Liberale de l'Economie,9,981,4,QCM,0.33,0.37,44.15,31,39,70,42,31,11,1.67,73.81,Moyen,Moyen,0,Meme Difficulté,Pas Adapte
5424,2019,Sociologie,2,Histoire de la Pensee Economique,3,La Conception Liberale de l'Economie,9,981,4,QCM,0.12,0.93,67.05,47,23,70,55,47,8,1.27,85.45,Facile,Facile,0,Meme Difficulté,Adapte
6535,2020,Sociologie,2,Histoire de la Pensee Economique,3,La Conception Liberale de l'Economie,9,981,4,QCM,0.06,0.72,67.05,40,20,60,57,40,17,1.05,70.18,Facile,Facile,0,Meme Difficulté,Adapte
981,2015,Sociologie,2,Histoire de la Pensee Economique,3,La Conception Liberale de l'Economie,9,982,5,QCM,0.17,0.93,86.21,26,4,30,26,26,0,1.15,100.0,Moyen,Facile,1,Plus Facile,Pas Adapte
2092,2016,Sociologie,2,Histoire de la Pensee Economique,3,La Conception Liberale de l'Economie,9,982,5,QCM,0.05,0.77,67.97,23,11,34,30,23,7,1.13,76.67,Difficile,Facile,2,Beaucoup plus Facile,Adapte
3203,2017,Sociologie,2,Histoire de la Pensee Economique,3,La Conception Liberale de l'Economie,9,982,5,QROC,0.09,1.0,67.97,24,12,36,27,24,3,1.33,88.89,Facile,Facile,0,Meme Difficulté,Adapte
4314,2018,Sociologie,2,Histoire de la Pensee Economique,3,La Conception Liberale de l'Economie,9,982,5,QROC,0.05,0.98,67.97,28,13,41,34,28,6,1.21,82.35,Facile,Facile,0,Meme Difficulté,Adapte
5425,2019,Sociologie,2,Histoire de la Pensee Economique,3,La Conception Liberale de l'Economie,9,982,5,QROC,0.04,0.83,67.97,27,13,40,30,27,3,1.33,90.0,Facile,Facile,0,Meme Difficulté,Adapte
6536,2020,Sociologie,2,Histoire de la Pensee Economique,3,La Conception Liberale de l'Economie,9,982,5,QROC,0.16,0.53,67.97,23,11,34,25,23,2,1.36,92.0,Facile,Facile,0,Meme Difficulté,Adapte
982,2015,Sociologie,2,Histoire de la Pensee Economique,3,La Conception Liberale de l'Economie,9,983,6,QCM,0.43,0.57,36.88,18,31,49,38,18,20,1.29,47.37,Facile,Moyen,-1,Plus Difficile,Pas Adapte
2093,2016,Sociologie,2,Histoire de la Pensee Economique,3,La Conception Liberale de l'Economie,9,983,6,QCM,0.03,0.89,94.52,47,3,50,49,47,2,1.02,95.92,Moyen,Facile,1,Plus Facile,Pas Adapte
3204,2017,Sociologie,2,Histoire de la Pensee Economique,3,La Conception Liberale de l'Economie,9,983,6,QCM,0.09,0.84,88.84,44,5,49,46,44,2,1.07,95.65,Facile,Facile,0,Meme Difficulté,Pas Adapte
4315,2018,Sociologie,2,Histoire de la Pensee Economique,3,La Conception Liberale de l'Economie,9,983,6,QCM,0.17,0.88,91.09,51,5,56,55,51,4,1.02,92.73,Moyen,Facile,1,Plus Facile,Pas Adapte
5426,2019,Sociologie,2,Histoire de la Pensee Economique,3,La Conception Liberale de l'Economie,9,983,6,QCM,0.15,0.8,73.78,41,14,55,46,41,5,1.2,89.13,Moyen,Facile,1,Plus Facile,Adapte
6537,2020,Sociologie,2,Histoire de la Pensee Economique,3,La Conception Liberale de l'Economie,9,983,6,QCM,0.08,0.8,73.78,38,14,52,48,38,10,1.08,79.17,Facile,Facile,0,Meme Difficulté,Adapte
983,2015,Sociologie,2,Histoire de la Pensee Economique,3,La Conception Liberale de l'Economie,9,984,7,QCM,0.21,0.57,56.97,46,35,81,61,46,15,1.33,75.41,Facile,Moyen,-1,Plus Difficile,Pas Adapte
2094,2016,Sociologie,2,Histoire de la Pensee Economique,3,La Conception Liberale de l'Economie,9,984,7,QCM,0.44,0.36,64.59,49,27,76,58,49,9,1.31,84.48,Facile,Moyen,-1,Plus Difficile,Pas Adapte
3205,2017,Sociologie,2,Histoire de la Pensee Economique,3,La Conception Liberale de l'Economie,9,984,7,QCM,0.58,0.2,29.57,25,58,83,52,25,27,1.6,48.08,Facile,Difficile,-2,Beaucoup plus Difficile,Pas Adapte
4316,2018,Sociologie,2,Histoire de la Pensee Economique,3,La Conception Liberale de l'Economie,9,984,7,QCM,0.02,0.94,72.74,68,26,94,85,68,17,1.11,80.0,Difficile,Facile,2,Beaucoup plus Facile,Adapte
5427,2019,Sociologie,2,Histoire de la Pensee Economique,3,La Conception Liberale de l'Economie,9,984,7,QCU,0.02,0.91,72.74,65,24,89,67,65,2,1.33,97.01,Facile,Facile,0,Meme Difficulté,Adapte
6538,2020,Sociologie,2,Histoire de la Pensee Economique,3,La Conception Liberale de l'Economie,9,984,7,QCU,0.13,0.97,72.74,64,24,88,81,64,17,1.09,79.01,Facile,Facile,0,Meme Difficulté,Adapte
984,2015,Sociologie,2,Histoire de la Pensee Economique,3,La Conception Liberale de l'Economie,9,985,8,QCM,0.34,0.55,36.59,12,20,32,16,12,4,2.0,75.0,Moyen,Moyen,0,Meme Difficulté,Pas Adapte
2095,2016,Sociologie,2,Histoire de la Pensee Economique,3,La Conception Liberale de l'Economie,9,985,8,QCM,0.26,0.44,47.37,17,19,36,30,17,13,1.2,56.67,Facile,Moyen,-1,Plus Difficile,Pas Adapte
3206,2017,Sociologie,2,Histoire de la Pensee Economique,3,La Conception Liberale de l'Economie,9,985,8,QROC,0.93,0.05,20.87,8,30,38,17,8,9,2.24,47.06,Difficile,Difficile,0,Meme Difficulté,Pas Adapte
4317,2018,Sociologie,2,Histoire de la Pensee Economique,3,La Conception Liberale de l'Economie,9,985,8,QROC,0.38,0.3,55.66,24,19,43,25,24,1,1.72,96.0,Facile,Moyen,-1,Plus Difficile,Pas Adapte
5428,2019,Sociologie,2,Histoire de la Pensee Economique,3,La Conception Liberale de l'Economie,9,985,8,QROC,0.5,0.39,45.19,19,24,43,36,19,17,1.19,52.78,Moyen,Moyen,0,Meme Difficulté,Pas Adapte
6539,2020,Sociologie,2,Histoire de la Pensee Economique,3,La Conception Liberale de l'Economie,9,985,8,QROC,0.35,0.38,57.28,21,16,37,24,21,3,1.54,87.5,Difficile,Moyen,1,Plus Facile,Pas Adapte
985,2015,Sociologie,2,Histoire de la Pensee Economique,3,La Conception Liberale de l'Economie,9,986,9,QO,0.19,0.53,73.67,71,25,96,89,71,18,1.08,79.78,Difficile,Facile,2,Beaucoup plus Facile,Adapte
2096,2016,Sociologie,2,Histoire de la Pensee Economique,3,La Conception Liberale de l'Economie,9,986,9,QROC,0.07,0.9,73.67,72,26,98,88,72,16,1.11,81.82,Facile,Facile,0,Meme Difficulté,Adapte
3207,2017,Sociologie,2,Histoire de la Pensee Economique,3,La Conception Liberale de l'Economie,9,986,9,QROC,0.16,0.72,73.67,82,29,111,104,82,22,1.07,78.85,Facile,Facile,0,Meme Difficulté,Adapte
4318,2018,Sociologie,2,Histoire de la Pensee Economique,3,La Conception Liberale de l'Economie,9,986,9,QROC,0.07,0.48,73.67,90,32,122,104,90,14,1.17,86.54,Facile,Facile,0,Meme Difficulté,Adapte
5429,2019,Sociologie,2,Histoire de la Pensee Economique,3,La Conception Liberale de l'Economie,9,986,9,QROC,0.09,0.76,73.67,87,31,118,92,87,5,1.28,94.57,Facile,Facile,0,Meme Difficulté,Adapte
6540,2020,Sociologie,2,Histoire de la Pensee Economique,3,La Conception Liberale de l'Economie,9,986,9,QROC,0.01,0.61,73.67,99,36,135,109,99,10,1.24,90.83,Facile,Facile,0,Meme Difficulté,Adapte
986,2015,Sociologie,2,Histoire de la Pensee Economique,4,L'Analyse Marxiste,14,987,1,QCM,0.17,0.81,78.19,38,11,49,38,38,0,1.29,100.0,Facile,Facile,0,Meme Difficulté,Pas Adapte
2097,2016,Sociologie,2,Histoire de la Pensee Economique,4,L'Analyse Marxiste,14,987,1,QCM,0.18,0.77,68.73,35,16,51,45,35,10,1.13,77.78,Moyen,Facile,1,Plus Facile,Adapte
3208,2017,Sociologie,2,Histoire de la Pensee Economique,4,L'Analyse Marxiste,14,987,1,QCM,0.06,0.89,68.73,41,18,59,55,41,14,1.07,74.55,Facile,Facile,0,Meme Difficulté,Adapte
4319,2018,Sociologie,2,Histoire de la Pensee Economique,4,L'Analyse Marxiste,14,987,1,QCM,0.07,0.93,68.73,38,18,56,40,38,2,1.4,95.0,Facile,Facile,0,Meme Difficulté,Adapte
5430,2019,Sociologie,2,Histoire de la Pensee Economique,4,L'Analyse Marxiste,14,987,1,QCM,0.03,0.87,68.73,38,17,55,45,38,7,1.22,84.44,Facile,Facile,0,Meme Difficulté,Adapte
6541,2020,Sociologie,2,Histoire de la Pensee Economique,4,L'Analyse Marxiste,14,987,1,QCM,0.1,0.99,68.73,34,15,49,42,34,8,1.17,80.95,Facile,Facile,0,Meme Difficulté,Adapte
987,2015,Sociologie,2,Histoire de la Pensee Economique,4,L'Analyse Marxiste,14,988,2,QCM,0.36,0.44,51.63,24,22,46,27,24,3,1.7,88.89,Facile,Moyen,-1,Plus Difficile,Pas Adapte
2098,2016,Sociologie,2,Histoire de la Pensee Economique,4,L'Analyse Marxiste,14,988,2,QCM,0.14,0.97,75.98,33,10,43,37,33,4,1.16,89.19,Moyen,Facile,1,Plus Facile,Pas Adapte
3209,2017,Sociologie,2,Histoire de la Pensee Economique,4,L'Analyse Marxiste,14,988,2,QCU,0.02,0.93,66.73,27,13,40,35,27,8,1.14,77.14,Facile,Facile,0,Meme Difficulté,Adapte
4320,2018,Sociologie,2,Histoire de la Pensee Economique,4,L'Analyse Marxiste,14,988,2,QCU,0.09,0.83,66.73,27,14,41,28,27,1,1.46,96.43,Facile,Facile,0,Meme Difficulté,Adapte
5431,2019,Sociologie,2,Histoire de la Pensee Economique,4,L'Analyse Marxiste,14,988,2,QCU,0.06,0.93,66.73,27,14,41,39,27,12,1.05,69.23,Facile,Facile,0,Meme Difficulté,Adapte
6542,2020,Sociologie,2,Histoire de la Pensee Economique,4,L'Analyse Marxiste,14,988,2,QCU,0.06,0.92,66.73,29,14,43,41,29,12,1.05,70.73,Facile,Facile,0,Meme Difficulté,Adapte
988,2015,Sociologie,2,Histoire de la Pensee Economique,4,L'Analyse Marxiste,14,989,3,QCM,0.36,0.37,56.77,9,7,16,9,9,0,1.78,100.0,Moyen,Moyen,0,Meme Difficulté,Pas Adapte
2099,2016,Sociologie,2,Histoire de la Pensee Economique,4,L'Analyse Marxiste,14,989,3,QCU,0.62,0.4,33.23,6,11,17,9,6,3,1.89,66.67,Difficile,Difficile,0,Meme Difficulté,Pas Adapte
3210,2017,Sociologie,2,Histoire de la Pensee Economique,4,L'Analyse Marxiste,14,989,3,QCU,0.19,0.92,84.51,17,3,20,19,17,2,1.05,89.47,Moyen,Facile,1,Plus Facile,Pas Adapte
4321,2018,Sociologie,2,Histoire de la Pensee Economique,4,L'Analyse Marxiste,14,989,3,QCU,0.75,0.34,31.54,7,14,21,14,7,7,1.5,50.0,Moyen,Difficile,-1,Plus Difficile,Pas Adapte
5432,2019,Sociologie,2,Histoire de la Pensee Economique,4,L'Analyse Marxiste,14,989,3,QCM,0.51,0.18,28.29,6,16,22,19,6,13,1.16,31.58,Facile,Difficile,-2,Beaucoup plus Difficile,Pas Adapte
6543,2020,Sociologie,2,Histoire de la Pensee Economique,4,L'Analyse Marxiste,14,989,3,QCM,0.04,0.9,84.89,20,4,24,22,20,2,1.09,90.91,Moyen,Facile,1,Plus Facile,Pas Adapte
989,2015,Sociologie,2,Histoire de la Pensee Economique,4,L'Analyse Marxiste,14,990,4,QCU,0.32,0.41,59.0,53,37,90,86,53,33,1.05,61.63,Moyen,Moyen,0,Meme Difficulté,Pas Adapte
2100,2016,Sociologie,2,Histoire de la Pensee Economique,4,L'Analyse Marxiste,14,990,4,QCU,0.4,0.73,57.51,54,40,94,80,54,26,1.18,67.5,Moyen,Moyen,0,Meme Difficulté,Pas Adapte
3211,2017,Sociologie,2,Histoire de la Pensee Economique,4,L'Analyse Marxiste,14,990,4,QCU,0.29,0.59,59.16,62,42,104,63,62,1,1.65,98.41,Difficile,Moyen,1,Plus Facile,Pas Adapte
4322,2018,Sociologie,2,Histoire de la Pensee Economique,4,L'Analyse Marxiste,14,990,4,QCU,0.36,0.74,59.37,63,43,106,98,63,35,1.08,64.29,Moyen,Moyen,0,Meme Difficulté,Pas Adapte
5433,2019,Sociologie,2,Histoire de la Pensee Economique,4,L'Analyse Marxiste,14,990,4,QCU,0.56,0.23,34.36,41,79,120,107,41,66,1.12,38.32,Moyen,Difficile,-1,Plus Difficile,Pas Adapte
6544,2020,Sociologie,2,Histoire de la Pensee Economique,4,L'Analyse Marxiste,14,990,4,QCU,0.74,0.34,16.26,19,96,115,87,19,68,1.32,21.84,Difficile,Difficile,0,Meme Difficulté,Pas Adapte
990,2015,Sociologie,2,Histoire de la Pensee Economique,4,L'Analyse Marxiste,14,991,5,QCU,0.44,0.23,26.93,17,46,63,25,17,8,2.52,68.0,Difficile,Difficile,0,Meme Difficulté,Pas Adapte
2101,2016,Sociologie,2,Histoire de la Pensee Economique,4,L'Analyse Marxiste,14,991,5,QCU,0.14,0.86,95.81,56,2,58,56,56,0,1.04,100.0,Difficile,Facile,2,Beaucoup plus Facile,Pas Adapte
3212,2017,Sociologie,2,Histoire de la Pensee Economique,4,L'Analyse Marxiste,14,991,5,QCU,0.37,0.48,64.0,41,23,64,54,41,13,1.19,75.93,Moyen,Moyen,0,Meme Difficulté,Pas Adapte
4323,2018,Sociologie,2,Histoire de la Pensee Economique,4,L'Analyse Marxiste,14,991,5,QCU,0.41,0.2,15.74,11,56,67,24,11,13,2.79,45.83,Facile,Difficile,-2,Beaucoup plus Difficile,Pas Adapte
5434,2019,Sociologie,2,Histoire de la Pensee Economique,4,L'Analyse Marxiste,14,991,5,QCM,0.57,0.25,22.93,14,47,61,17,14,3,3.59,82.35,Difficile,Difficile,0,Meme Difficulté,Pas Adapte
6545,2020,Sociologie,2,Histoire de la Pensee Economique,4,L'Analyse Marxiste,14,991,5,QROC,0.11,0.78,70.16,38,16,54,40,38,2,1.35,95.0,Facile,Facile,0,Meme Difficulté,Adapte
991,2015,Sociologie,2,Histoire de la Pensee Economique,4,L'Analyse Marxiste,14,992,6,QCM,0.35,0.38,39.07,9,14,23,14,9,5,1.64,64.29,Moyen,Moyen,0,Meme Difficulté,Pas Adapte
2102,2016,Sociologie,2,Histoire de la Pensee Economique,4,L'Analyse Marxiste,14,992,6,QCM,0.3,0.45,57.72,13,10,23,22,13,9,1.05,59.09,Difficile,Moyen,1,Plus Facile,Pas Adapte
3213,2017,Sociologie,2,Histoire de la Pensee Economique,4,L'Analyse Marxiste,14,992,6,QCM,0.8,0.17,20.82,5,18,23,15,5,10,1.53,33.33,Difficile,Difficile,0,Meme Difficulté,Pas Adapte
4324,2018,Sociologie,2,Histoire de la Pensee Economique,4,L'Analyse Marxiste,14,992,6,QCM,0.17,0.99,92.88,23,2,25,25,23,2,1.0,92.0,Facile,Facile,0,Meme Difficulté,Pas Adapte
5435,2019,Sociologie,2,Histoire de la Pensee Economique,4,L'Analyse Marxiste,14,992,6,QCM,0.47,0.68,42.03,10,13,23,15,10,5,1.53,66.67,Facile,Moyen,-1,Plus Difficile,Pas Adapte
6546,2020,Sociologie,2,Histoire de la Pensee Economique,4,L'Analyse Marxiste,14,992,6,QCM,0.19,0.85,80.38,21,5,26,24,21,3,1.08,87.5,Difficile,Facile,2,Beaucoup plus Facile,Pas Adapte
992,2015,Sociologie,2,Histoire de la Pensee Economique,4,L'Analyse Marxiste,14,993,7,QCU,0.63,0.32,30.72,23,53,76,29,23,6,2.62,79.31,Difficile,Difficile,0,Meme Difficulté,Pas Adapte
2103,2016,Sociologie,2,Histoire de la Pensee Economique,4,L'Analyse Marxiste,14,993,7,QCM,0.13,0.88,93.59,65,4,69,68,65,3,1.01,95.59,Difficile,Facile,2,Beaucoup plus Facile,Pas Adapte
3214,2017,Sociologie,2,Histoire de la Pensee Economique,4,L'Analyse Marxiste,14,993,7,QCM,0.69,0.28,28.36,19,49,68,41,19,22,1.66,46.34,Facile,Difficile,-2,Beaucoup plus Difficile,Pas Adapte
4325,2018,Sociologie,2,Histoire de la Pensee Economique,4,L'Analyse Marxiste,14,993,7,QROC,0.06,0.73,93.62,68,5,73,71,68,3,1.03,95.77,Facile,Facile,0,Meme Difficulté,Pas Adapte
5436,2019,Sociologie,2,Histoire de la Pensee Economique,4,L'Analyse Marxiste,14,993,7,QROC,0.98,0.16,27.2,22,60,82,43,22,21,1.91,51.16,Difficile,Difficile,0,Meme Difficulté,Pas Adapte
6547,2020,Sociologie,2,Histoire de la Pensee Economique,4,L'Analyse Marxiste,14,993,7,QROC,0.96,0.03,13.93,10,64,74,69,10,59,1.07,14.49,Facile,Difficile,-2,Beaucoup plus Difficile,Pas Adapte
993,2015,Sociologie,2,Histoire de la Pensee Economique,4,L'Analyse Marxiste,14,994,8,QCU,0.02,0.96,87.69,58,8,66,60,58,2,1.1,96.67,Moyen,Facile,1,Plus Facile,Pas Adapte
2104,2016,Sociologie,2,Histoire de la Pensee Economique,4,L'Analyse Marxiste,14,994,8,QROC,0.67,0.19,24.67,14,44,58,57,14,43,1.02,24.56,Facile,Difficile,-2,Beaucoup plus Difficile,Pas Adapte
3215,2017,Sociologie,2,Histoire de la Pensee Economique,4,L'Analyse Marxiste,14,994,8,QROC,0.23,0.39,40.07,24,35,59,50,24,26,1.18,48.0,Moyen,Moyen,0,Meme Difficulté,Pas Adapte
4326,2018,Sociologie,2,Histoire de la Pensee Economique,4,L'Analyse Marxiste,14,994,8,QO,0.18,0.42,86.32,47,8,55,50,47,3,1.1,94.0,Facile,Facile,0,Meme Difficulté,Pas Adapte
5437,2019,Sociologie,2,Histoire de la Pensee Economique,4,L'Analyse Marxiste,14,994,8,QCM,0.78,0.27,12.94,8,51,59,46,8,38,1.28,17.39,Difficile,Difficile,0,Meme Difficulté,Pas Adapte
6548,2020,Sociologie,2,Histoire de la Pensee Economique,4,L'Analyse Marxiste,14,994,8,QCM,0.55,0.27,4.41,3,62,65,58,3,55,1.12,5.17,Moyen,Difficile,-1,Plus Difficile,Pas Adapte
994,2015,Sociologie,2,Histoire de la Pensee Economique,4,L'Analyse Marxiste,14,995,9,QROC,0.89,0.03,2.77,1,51,52,26,1,25,2.0,3.85,Moyen,Difficile,-1,Plus Difficile,Pas Adapte
2105,2016,Sociologie,2,Histoire de la Pensee Economique,4,L'Analyse Marxiste,14,995,9,QROC,0.91,0.04,25.08,15,43,58,24,15,9,2.42,62.5,Moyen,Difficile,-1,Plus Difficile,Pas Adapte
3216,2017,Sociologie,2,Histoire de la Pensee Economique,4,L'Analyse Marxiste,14,995,9,QCM,0.62,0.16,18.34,12,51,63,41,12,29,1.54,29.27,Moyen,Difficile,-1,Plus Difficile,Pas Adapte
4327,2018,Sociologie,2,Histoire de la Pensee Economique,4,L'Analyse Marxiste,14,995,9,QCM,0.16,0.79,96.42,53,2,55,55,53,2,1.0,96.36,Difficile,Facile,2,Beaucoup plus Facile,Pas Adapte
5438,2019,Sociologie,2,Histoire de la Pensee Economique,4,L'Analyse Marxiste,14,995,9,QCM,0.03,0.87,70.61,40,17,57,51,40,11,1.12,78.43,Moyen,Facile,1,Plus Facile,Adapte
6549,2020,Sociologie,2,Histoire de la Pensee Economique,4,L'Analyse Marxiste,14,995,9,QCM,0.1,0.71,70.61,35,14,49,45,35,10,1.09,77.78,Facile,Facile,0,Meme Difficulté,Adapte
995,2015,Sociologie,2,Histoire de la Pensee Economique,4,L'Analyse Marxiste,14,996,10,QCU,0.26,0.49,64.71,27,14,41,31,27,4,1.32,87.1,Difficile,Moyen,1,Plus Facile,Pas Adapte
2106,2016,Sociologie,2,Histoire de la Pensee Economique,4,L'Analyse Marxiste,14,996,10,QCU,0.61,0.38,10.19,4,38,42,17,4,13,2.47,23.53,Facile,Difficile,-2,Beaucoup plus Difficile,Pas Adapte
3217,2017,Sociologie,2,Histoire de la Pensee Economique,4,L'Analyse Marxiste,14,996,10,QCU,0.12,1.0,72.85,31,11,42,37,31,6,1.14,83.78,Moyen,Facile,1,Plus Facile,Adapte
4328,2018,Sociologie,2,Histoire de la Pensee Economique,4,L'Analyse Marxiste,14,996,10,QCU,0.07,0.92,72.85,29,11,40,33,29,4,1.21,87.88,Facile,Facile,0,Meme Difficulté,Adapte
5439,2019,Sociologie,2,Histoire de la Pensee Economique,4,L'Analyse Marxiste,14,996,10,QCU,0.08,0.93,72.85,31,11,42,34,31,3,1.24,91.18,Facile,Facile,0,Meme Difficulté,Adapte
6550,2020,Sociologie,2,Histoire de la Pensee Economique,4,L'Analyse Marxiste,14,996,10,QCU,0.12,0.9,72.85,27,10,37,30,27,3,1.23,90.0,Facile,Facile,0,Meme Difficulté,Adapte
996,2015,Sociologie,2,Histoire de la Pensee Economique,4,L'Analyse Marxiste,14,997,11,QCM,0.64,0.27,26.87,1,4,5,4,1,3,1.25,25.0,Difficile,Difficile,0,Meme Difficulté,Pas Adapte
2107,2016,Sociologie,2,Histoire de la Pensee Economique,4,L'Analyse Marxiste,14,997,11,QCM,0.04,0.83,90.31,5,1,6,6,5,1,1.0,83.33,Moyen,Facile,1,Plus Facile,Pas Adapte
3218,2017,Sociologie,2,Histoire de la Pensee Economique,4,L'Analyse Marxiste,14,997,11,QCM,0.23,0.6,50.91,3,3,6,4,3,1,1.5,75.0,Moyen,Moyen,0,Meme Difficulté,Pas Adapte
4329,2018,Sociologie,2,Histoire de la Pensee Economique,4,L'Analyse Marxiste,14,997,11,QROC,0.67,0.22,23.91,1,5,6,6,1,5,1.0,16.67,Facile,Difficile,-2,Beaucoup plus Difficile,Pas Adapte
5440,2019,Sociologie,2,Histoire de la Pensee Economique,4,L'Analyse Marxiste,14,997,11,QO,0.02,0.39,83.51,5,1,6,6,5,1,1.0,83.33,Difficile,Facile,2,Beaucoup plus Facile,Pas Adapte
6551,2020,Sociologie,2,Histoire de la Pensee Economique,4,L'Analyse Marxiste,14,997,11,QO,0.76,0.14,30.19,2,3,5,4,2,2,1.25,50.0,Difficile,Difficile,0,Meme Difficulté,Pas Adapte
997,2015,Sociologie,2,Histoire de la Pensee Economique,4,L'Analyse Marxiste,14,998,12,QCM,0.75,0.26,6.96,6,76,82,56,6,50,1.46,10.71,Moyen,Difficile,-1,Plus Difficile,Pas Adapte
2108,2016,Sociologie,2,Histoire de la Pensee Economique,4,L'Analyse Marxiste,14,998,12,QCM,0.06,0.78,77.02,59,18,77,63,59,4,1.22,93.65,Facile,Facile,0,Meme Difficulté,Pas Adapte
3219,2017,Sociologie,2,Histoire de la Pensee Economique,4,L'Analyse Marxiste,14,998,12,QCM,0.4,0.52,63.24,45,26,71,45,45,0,1.58,100.0,Difficile,Moyen,1,Plus Facile,Pas Adapte
4330,2018,Sociologie,2,Histoire de la Pensee Economique,4,L'Analyse Marxiste,14,998,12,QCM,0.78,0.17,21.17,15,55,70,23,15,8,3.04,65.22,Moyen,Difficile,-1,Plus Difficile,Pas Adapte
5441,2019,Sociologie,2,Histoire de la Pensee Economique,4,L'Analyse Marxiste,14,998,12,QCM,0.45,0.65,54.16,34,28,62,37,34,3,1.68,91.89,Moyen,Moyen,0,Meme Difficulté,Pas Adapte
6552,2020,Sociologie,2,Histoire de la Pensee Economique,4,L'Analyse Marxiste,14,998,12,QCM,0.49,0.69,55.42,35,28,63,51,35,16,1.24,68.63,Moyen,Moyen,0,Meme Difficulté,Pas Adapte
998,2015,Sociologie,2,Histoire de la Pensee Economique,4,L'Analyse Marxiste,14,999,13,QCU,0.09,0.8,99.27,15,0,15,15,15,0,1.0,100.0,Facile,Facile,0,Meme Difficulté,Pas Adapte
2109,2016,Sociologie,2,Histoire de la Pensee Economique,4,L'Analyse Marxiste,14,999,13,QCU,0.38,0.52,47.73,8,9,17,17,8,9,1.0,47.06,Difficile,Moyen,1,Plus Facile,Pas Adapte
3220,2017,Sociologie,2,Histoire de la Pensee Economique,4,L'Analyse Marxiste,14,999,13,QCU,0.38,0.56,46.56,7,9,16,10,7,3,1.6,70.0,Difficile,Moyen,1,Plus Facile,Pas Adapte
4331,2018,Sociologie,2,Histoire de la Pensee Economique,4,L'Analyse Marxiste,14,999,13,QCU,0.09,0.8,98.65,15,0,15,15,15,0,1.0,100.0,Facile,Facile,0,Meme Difficulté,Pas Adapte
5442,2019,Sociologie,2,Histoire de la Pensee Economique,4,L'Analyse Marxiste,14,999,13,QCU,0.52,0.27,20.03,3,11,14,6,3,3,2.33,50.0,Moyen,Difficile,-1,Plus Difficile,Pas Adapte
6553,2020,Sociologie,2,Histoire de la Pensee Economique,4,L'Analyse Marxiste,14,999,13,QCU,0.68,0.27,7.45,1,13,14,7,1,6,2.0,14.29,Moyen,Difficile,-1,Plus Difficile,Pas Adapte
999,2015,Sociologie,2,Histoire de la Pensee Economique,4,L'Analyse Marxiste,14,1000,14,QCU,0.35,0.7,40.0,30,46,76,34,30,4,2.24,88.24,Moyen,Moyen,0,Meme Difficulté,Pas Adapte
2110,2016,Sociologie,2,Histoire de la Pensee Economique,4,L'Analyse Marxiste,14,1000,14,QCU,0.57,0.28,10.56,9,72,81,78,9,69,1.04,11.54,Difficile,Difficile,0,Meme Difficulté,Pas Adapte
3221,2017,Sociologie,2,Histoire de la Pensee Economique,4,L'Analyse Marxiste,14,1000,14,QCU,0.41,0.3,3.36,3,80,83,35,3,32,2.37,8.57,Facile,Difficile,-2,Beaucoup plus Difficile,Pas Adapte
4332,2018,Sociologie,2,Histoire de la Pensee Economique,4,L'Analyse Marxiste,14,1000,14,QCU,0.37,0.48,39.65,32,48,80,67,32,35,1.19,47.76,Moyen,Moyen,0,Meme Difficulté,Pas Adapte
5443,2019,Sociologie,2,Histoire de la Pensee Economique,4,L'Analyse Marxiste,14,1000,14,QCU,0.26,0.71,41.71,31,44,75,36,31,5,2.08,86.11,Difficile,Moyen,1,Plus Facile,Pas Adapte
6554,2020,Sociologie,2,Histoire de la Pensee Economique,4,L'Analyse Marxiste,14,1000,14,QCU,0.37,0.68,57.4,47,35,82,62,47,15,1.32,75.81,Moyen,Moyen,0,Meme Difficulté,Pas Adapte
1000,2015,Sociologie,2,Histoire de la Pensee Economique,5,La Revolution Keynesienne,7,1001,1,QROC,0.11,0.96,85.94,40,7,47,42,40,2,1.12,95.24,Facile,Facile,0,Meme Difficulté,Pas Adapte
2111,2016,Sociologie,2,Histoire de la Pensee Economique,5,La Revolution Keynesienne,7,1001,1,QROC,0.72,0.1,6.44,3,46,49,44,3,41,1.11,6.82,Facile,Difficile,-2,Beaucoup plus Difficile,Pas Adapte
3222,2017,Sociologie,2,Histoire de la Pensee Economique,5,La Revolution Keynesienne,7,1001,1,QROC,0.11,0.66,86.89,43,6,49,46,43,3,1.07,93.48,Facile,Facile,0,Meme Difficulté,Pas Adapte
4333,2018,Sociologie,2,Histoire de la Pensee Economique,5,La Revolution Keynesienne,7,1001,1,QROC,0.07,0.58,93.22,45,3,48,46,45,1,1.04,97.83,Difficile,Facile,2,Beaucoup plus Facile,Pas Adapte
5444,2019,Sociologie,2,Histoire de la Pensee Economique,5,La Revolution Keynesienne,7,1001,1,QROC,0.21,0.35,58.1,30,22,52,37,30,7,1.41,81.08,Facile,Moyen,-1,Plus Difficile,Pas Adapte
6555,2020,Sociologie,2,Histoire de la Pensee Economique,5,La Revolution Keynesienne,7,1001,1,QROC,0.84,0.11,6.91,3,45,48,38,3,35,1.26,7.89,Difficile,Difficile,0,Meme Difficulté,Pas Adapte
1001,2015,Sociologie,2,Histoire de la Pensee Economique,5,La Revolution Keynesienne,7,1002,2,QROC,0.1,0.68,67.28,14,7,21,18,14,4,1.17,77.78,Difficile,Facile,2,Beaucoup plus Facile,Adapte
2112,2016,Sociologie,2,Histoire de la Pensee Economique,5,La Revolution Keynesienne,7,1002,2,QROC,0.11,0.76,67.28,12,6,18,17,12,5,1.06,70.59,Facile,Facile,0,Meme Difficulté,Adapte
3223,2017,Sociologie,2,Histoire de la Pensee Economique,5,La Revolution Keynesienne,7,1002,2,QCU,0.04,0.86,67.28,13,7,20,16,13,3,1.25,81.25,Facile,Facile,0,Meme Difficulté,Adapte
4334,2018,Sociologie,2,Histoire de la Pensee Economique,5,La Revolution Keynesienne,7,1002,2,QCU,0.07,0.79,67.28,15,7,22,16,15,1,1.38,93.75,Facile,Facile,0,Meme Difficulté,Adapte
5445,2019,Sociologie,2,Histoire de la Pensee Economique,5,La Revolution Keynesienne,7,1002,2,QCM,0.12,0.8,67.28,14,7,21,14,14,0,1.5,100.0,Facile,Facile,0,Meme Difficulté,Adapte
6556,2020,Sociologie,2,Histoire de la Pensee Economique,5,La Revolution Keynesienne,7,1002,2,QCM,0.01,0.97,67.28,15,7,22,18,15,3,1.22,83.33,Facile,Facile,0,Meme Difficulté,Adapte
1002,2015,Sociologie,2,Histoire de la Pensee Economique,5,La Revolution Keynesienne,7,1003,3,QO,0.85,0.15,33.98,5,9,14,10,5,5,1.4,50.0,Difficile,Difficile,0,Meme Difficulté,Pas Adapte
2113,2016,Sociologie,2,Histoire de la Pensee Economique,5,La Revolution Keynesienne,7,1003,3,QO,0.35,0.19,39.8,6,10,16,15,6,9,1.07,40.0,Difficile,Moyen,1,Plus Facile,Pas Adapte
3224,2017,Sociologie,2,Histoire de la Pensee Economique,5,La Revolution Keynesienne,7,1003,3,QO,0.93,0.11,22.9,4,12,16,12,4,8,1.33,33.33,Difficile,Difficile,0,Meme Difficulté,Pas Adapte
4335,2018,Sociologie,2,Histoire de la Pensee Economique,5,La Revolution Keynesienne,7,1003,3,QROC,0.1,0.67,68.13,10,4,14,13,10,3,1.08,76.92,Facile,Facile,0,Meme Difficulté,Adapte
5446,2019,Sociologie,2,Histoire de la Pensee Economique,5,La Revolution Keynesienne,7,1003,3,QROC,0.17,0.57,68.13,10,5,15,10,10,0,1.5,100.0,Facile,Facile,0,Meme Difficulté,Adapte
6557,2020,Sociologie,2,Histoire de la Pensee Economique,5,La Revolution Keynesienne,7,1003,3,QROC,0.17,0.76,68.13,11,5,16,15,11,4,1.07,73.33,Facile,Facile,0,Meme Difficulté,Adapte
1003,2015,Sociologie,2,Histoire de la Pensee Economique,5,La Revolution Keynesienne,7,1004,4,QCU,0.6,0.38,0.67,0,41,41,20,0,20,2.05,0.0,Difficile,Difficile,0,Meme Difficulté,Pas Adapte
2114,2016,Sociologie,2,Histoire de la Pensee Economique,5,La Revolution Keynesienne,7,1004,4,QCU,0.03,0.84,88.32,37,5,42,39,37,2,1.08,94.87,Facile,Facile,0,Meme Difficulté,Pas Adapte
3225,2017,Sociologie,2,Histoire de la Pensee Economique,5,La Revolution Keynesienne,7,1004,4,QCU,0.32,0.53,45.6,20,23,43,24,20,4,1.79,83.33,Difficile,Moyen,1,Plus Facile,Pas Adapte
4336,2018,Sociologie,2,Histoire de la Pensee Economique,5,La Revolution Keynesienne,7,1004,4,QCU,0.2,0.69,57.43,23,17,40,30,23,7,1.33,76.67,Moyen,Moyen,0,Meme Difficulté,Pas Adapte
5447,2019,Sociologie,2,Histoire de la Pensee Economique,5,La Revolution Keynesienne,7,1004,4,QCU,0.24,0.63,50.42,23,23,46,42,23,19,1.1,54.76,Moyen,Moyen,0,Meme Difficulté,Pas Adapte
6558,2020,Sociologie,2,Histoire de la Pensee Economique,5,La Revolution Keynesienne,7,1004,4,QCU,0.44,0.25,9.26,4,36,40,35,4,31,1.14,11.43,Facile,Difficile,-2,Beaucoup plus Difficile,Pas Adapte
1004,2015,Sociologie,2,Histoire de la Pensee Economique,5,La Revolution Keynesienne,7,1005,5,QCU,0.73,0.3,1.73,1,47,48,40,1,39,1.2,2.5,Moyen,Difficile,-1,Plus Difficile,Pas Adapte
2115,2016,Sociologie,2,Histoire de la Pensee Economique,5,La Revolution Keynesienne,7,1005,5,QCU,0.03,0.98,90.46,44,5,49,47,44,3,1.04,93.62,Moyen,Facile,1,Plus Facile,Pas Adapte
3226,2017,Sociologie,2,Histoire de la Pensee Economique,5,La Revolution Keynesienne,7,1005,5,QCU,0.54,0.27,25.42,12,35,47,27,12,15,1.74,44.44,Difficile,Difficile,0,Meme Difficulté,Pas Adapte
4337,2018,Sociologie,2,Histoire de la Pensee Economique,5,La Revolution Keynesienne,7,1005,5,QCU,0.61,0.24,5.06,3,47,50,28,3,25,1.79,10.71,Difficile,Difficile,0,Meme Difficulté,Pas Adapte
5448,2019,Sociologie,2,Histoire de la Pensee Economique,5,La Revolution Keynesienne,7,1005,5,QCU,0.1,0.92,87.19,44,6,50,44,44,0,1.14,100.0,Facile,Facile,0,Meme Difficulté,Pas Adapte
6559,2020,Sociologie,2,Histoire de la Pensee Economique,5,La Revolution Keynesienne,7,1005,5,QCU,0.15,0.86,89.9,50,6,56,52,50,2,1.08,96.15,Moyen,Facile,1,Plus Facile,Pas Adapte
1005,2015,Sociologie,2,Histoire de la Pensee Economique,5,La Revolution Keynesienne,7,1006,6,QCU,0.23,0.44,64.94,29,15,44,32,29,3,1.38,90.62,Moyen,Moyen,0,Meme Difficulté,Pas Adapte
2116,2016,Sociologie,2,Histoire de la Pensee Economique,5,La Revolution Keynesienne,7,1006,6,QCU,0.22,0.46,63.27,28,16,44,39,28,11,1.13,71.79,Facile,Moyen,-1,Plus Difficile,Pas Adapte
3227,2017,Sociologie,2,Histoire de la Pensee Economique,5,La Revolution Keynesienne,7,1006,6,QCU,0.14,0.81,99.63,42,0,42,42,42,0,1.0,100.0,Moyen,Facile,1,Plus Facile,Pas Adapte
4338,2018,Sociologie,2,Histoire de la Pensee Economique,5,La Revolution Keynesienne,7,1006,6,QCU,0.3,0.51,62.91,27,16,43,28,27,1,1.54,96.43,Difficile,Moyen,1,Plus Facile,Pas Adapte
5449,2019,Sociologie,2,Histoire de la Pensee Economique,5,La Revolution Keynesienne,7,1006,6,QCU,0.21,0.73,35.26,16,28,44,41,16,25,1.07,39.02,Difficile,Moyen,1,Plus Facile,Pas Adapte
6560,2020,Sociologie,2,Histoire de la Pensee Economique,5,La Revolution Keynesienne,7,1006,6,QCU,0.41,0.36,2.81,1,47,48,33,1,32,1.45,3.03,Difficile,Difficile,0,Meme Difficulté,Pas Adapte
1006,2015,Sociologie,2,Histoire de la Pensee Economique,5,La Revolution Keynesienne,7,1007,7,QCM,0.17,0.88,90.99,84,8,92,88,84,4,1.05,95.45,Moyen,Facile,1,Plus Facile,Pas Adapte
2117,2016,Sociologie,2,Histoire de la Pensee Economique,5,La Revolution Keynesienne,7,1007,7,QROC,0.87,0.24,3.38,3,85,88,42,3,39,2.1,7.14,Difficile,Difficile,0,Meme Difficulté,Pas Adapte
3228,2017,Sociologie,2,Histoire de la Pensee Economique,5,La Revolution Keynesienne,7,1007,7,QROC,0.72,0.12,16.66,15,75,90,80,15,65,1.12,18.75,Facile,Difficile,-2,Beaucoup plus Difficile,Pas Adapte
4339,2018,Sociologie,2,Histoire de la Pensee Economique,5,La Revolution Keynesienne,7,1007,7,QROC,0.1,0.65,91.48,92,9,101,99,92,7,1.02,92.93,Difficile,Facile,2,Beaucoup plus Facile,Pas Adapte
5450,2019,Sociologie,2,Histoire de la Pensee Economique,5,La Revolution Keynesienne,7,1007,7,QROC,0.98,0.01,21.87,24,88,112,91,24,67,1.23,26.37,Difficile,Difficile,0,Meme Difficulté,Pas Adapte
6561,2020,Sociologie,2,Histoire de la Pensee Economique,5,La Revolution Keynesienne,7,1007,7,QROC,0.97,0.13,3.15,4,123,127,63,4,59,2.02,6.35,Difficile,Difficile,0,Meme Difficulté,Pas Adapte
1007,2015,Sociologie,3,"Travail, Emploi, Chomage",1,Caracteristiques de l'Emploi et du Chomage,5,1008,1,QROC,0.05,0.58,67.04,4,2,6,6,4,2,1.0,66.67,Difficile,Facile,2,Beaucoup plus Facile,Adapte
2118,2016,Sociologie,3,"Travail, Emploi, Chomage",1,Caracteristiques de l'Emploi et du Chomage,5,1008,1,QROC,0.13,0.74,67.04,3,2,5,4,3,1,1.25,75.0,Facile,Facile,0,Meme Difficulté,Adapte
3229,2017,Sociologie,3,"Travail, Emploi, Chomage",1,Caracteristiques de l'Emploi et du Chomage,5,1008,1,QO,0.15,0.54,67.04,3,2,5,4,3,1,1.25,75.0,Facile,Facile,0,Meme Difficulté,Adapte
4340,2018,Sociologie,3,"Travail, Emploi, Chomage",1,Caracteristiques de l'Emploi et du Chomage,5,1008,1,QO,0.06,0.87,67.04,3,2,5,4,3,1,1.25,75.0,Facile,Facile,0,Meme Difficulté,Adapte
5451,2019,Sociologie,3,"Travail, Emploi, Chomage",1,Caracteristiques de l'Emploi et du Chomage,5,1008,1,QO,0.01,0.65,67.04,3,2,5,3,3,0,1.67,100.0,Facile,Facile,0,Meme Difficulté,Adapte
6562,2020,Sociologie,3,"Travail, Emploi, Chomage",1,Caracteristiques de l'Emploi et du Chomage,5,1008,1,QO,0.01,0.79,67.04,4,2,6,5,4,1,1.2,80.0,Facile,Facile,0,Meme Difficulté,Adapte
1008,2015,Sociologie,3,"Travail, Emploi, Chomage",1,Caracteristiques de l'Emploi et du Chomage,5,1009,2,QCU,0.34,0.7,48.9,25,27,52,49,25,24,1.06,51.02,Difficile,Moyen,1,Plus Facile,Pas Adapte
2119,2016,Sociologie,3,"Travail, Emploi, Chomage",1,Caracteristiques de l'Emploi et du Chomage,5,1009,2,QCU,0.58,0.23,26.97,14,39,53,24,14,10,2.21,58.33,Facile,Difficile,-2,Beaucoup plus Difficile,Pas Adapte
3230,2017,Sociologie,3,"Travail, Emploi, Chomage",1,Caracteristiques de l'Emploi et du Chomage,5,1009,2,QCU,0.32,0.66,52.05,28,26,54,32,28,4,1.69,87.5,Difficile,Moyen,1,Plus Facile,Pas Adapte
4341,2018,Sociologie,3,"Travail, Emploi, Chomage",1,Caracteristiques de l'Emploi et du Chomage,5,1009,2,QCU,0.49,0.28,9.41,6,54,60,22,6,16,2.73,27.27,Difficile,Difficile,0,Meme Difficulté,Pas Adapte
5452,2019,Sociologie,3,"Travail, Emploi, Chomage",1,Caracteristiques de l'Emploi et du Chomage,5,1009,2,QCU,0.13,0.81,79.98,46,12,58,51,46,5,1.14,90.2,Moyen,Facile,1,Plus Facile,Pas Adapte
6563,2020,Sociologie,3,"Travail, Emploi, Chomage",1,Caracteristiques de l'Emploi et du Chomage,5,1009,2,QROC,0.7,0.09,31.44,19,40,59,52,19,33,1.13,36.54,Difficile,Difficile,0,Meme Difficulté,Pas Adapte
1009,2015,Sociologie,3,"Travail, Emploi, Chomage",1,Caracteristiques de l'Emploi et du Chomage,5,1010,3,QCU,0.03,0.92,79.72,63,16,79,70,63,7,1.13,90.0,Difficile,Facile,2,Beaucoup plus Facile,Pas Adapte
2120,2016,Sociologie,3,"Travail, Emploi, Chomage",1,Caracteristiques de l'Emploi et du Chomage,5,1010,3,QCU,0.02,0.95,96.71,79,3,82,82,79,3,1.0,96.34,Difficile,Facile,2,Beaucoup plus Facile,Pas Adapte
3231,2017,Sociologie,3,"Travail, Emploi, Chomage",1,Caracteristiques de l'Emploi et du Chomage,5,1010,3,QCU,0.1,0.83,65.0,53,28,81,58,53,5,1.4,91.38,Facile,Facile,0,Meme Difficulté,Adapte
4342,2018,Sociologie,3,"Travail, Emploi, Chomage",1,Caracteristiques de l'Emploi et du Chomage,5,1010,3,QCM,0.12,0.94,65.0,59,31,90,76,59,17,1.18,77.63,Facile,Facile,0,Meme Difficulté,Adapte
5453,2019,Sociologie,3,"Travail, Emploi, Chomage",1,Caracteristiques de l'Emploi et du Chomage,5,1010,3,QCM,0.05,0.93,65.0,57,30,87,66,57,9,1.32,86.36,Facile,Facile,0,Meme Difficulté,Adapte
6564,2020,Sociologie,3,"Travail, Emploi, Chomage",1,Caracteristiques de l'Emploi et du Chomage,5,1010,3,QCM,0.03,0.96,65.0,58,31,89,72,58,14,1.24,80.56,Facile,Facile,0,Meme Difficulté,Adapte
1010,2015,Sociologie,3,"Travail, Emploi, Chomage",1,Caracteristiques de l'Emploi et du Chomage,5,1011,4,QCM,0.37,0.42,54.51,11,9,20,13,11,2,1.54,84.62,Moyen,Moyen,0,Meme Difficulté,Pas Adapte
2121,2016,Sociologie,3,"Travail, Emploi, Chomage",1,Caracteristiques de l'Emploi et du Chomage,5,1011,4,QCM,0.0,0.84,92.64,19,1,20,20,19,1,1.0,95.0,Moyen,Facile,1,Plus Facile,Pas Adapte
3232,2017,Sociologie,3,"Travail, Emploi, Chomage",1,Caracteristiques de l'Emploi et du Chomage,5,1011,4,QCM,0.37,0.62,61.07,13,9,22,14,13,1,1.57,92.86,Facile,Moyen,-1,Plus Difficile,Pas Adapte
4343,2018,Sociologie,3,"Travail, Emploi, Chomage",1,Caracteristiques de l'Emploi et du Chomage,5,1011,4,QCM,0.0,0.85,89.23,18,2,20,20,18,2,1.0,90.0,Difficile,Facile,2,Beaucoup plus Facile,Pas Adapte
5454,2019,Sociologie,3,"Travail, Emploi, Chomage",1,Caracteristiques de l'Emploi et du Chomage,5,1011,4,QCM,0.73,0.16,7.67,2,21,23,10,2,8,2.3,20.0,Facile,Difficile,-2,Beaucoup plus Difficile,Pas Adapte
6565,2020,Sociologie,3,"Travail, Emploi, Chomage",1,Caracteristiques de l'Emploi et du Chomage,5,1011,4,QCM,0.25,0.49,37.12,9,15,24,11,9,2,2.18,81.82,Difficile,Moyen,1,Plus Facile,Pas Adapte
1011,2015,Sociologie,3,"Travail, Emploi, Chomage",1,Caracteristiques de l'Emploi et du Chomage,5,1012,5,QROC,0.97,0.16,17.92,5,24,29,21,5,16,1.38,23.81,Moyen,Difficile,-1,Plus Difficile,Pas Adapte
2122,2016,Sociologie,3,"Travail, Emploi, Chomage",1,Caracteristiques de l'Emploi et du Chomage,5,1012,5,QO,0.68,0.28,61.63,19,12,31,20,19,1,1.55,95.0,Difficile,Moyen,1,Plus Facile,Pas Adapte
3233,2017,Sociologie,3,"Travail, Emploi, Chomage",1,Caracteristiques de l'Emploi et du Chomage,5,1012,5,QROC,0.64,0.21,0.67,0,26,26,19,0,19,1.37,0.0,Facile,Difficile,-2,Beaucoup plus Difficile,Pas Adapte
4344,2018,Sociologie,3,"Travail, Emploi, Chomage",1,Caracteristiques de l'Emploi et du Chomage,5,1012,5,QROC,0.59,0.27,53.16,14,12,26,15,14,1,1.73,93.33,Difficile,Moyen,1,Plus Facile,Pas Adapte
5455,2019,Sociologie,3,"Travail, Emploi, Chomage",1,Caracteristiques de l'Emploi et du Chomage,5,1012,5,QO,0.01,0.49,71.24,17,7,24,20,17,3,1.2,85.0,Moyen,Facile,1,Plus Facile,Adapte
6566,2020,Sociologie,3,"Travail, Emploi, Chomage",1,Caracteristiques de l'Emploi et du Chomage,5,1012,5,QO,0.02,0.75,71.24,15,6,21,18,15,3,1.17,83.33,Facile,Facile,0,Meme Difficulté,Adapte
1012,2015,Sociologie,3,"Travail, Emploi, Chomage",2,Fonctionnement du Marche du Chomage dans les Theories Economiques,8,1013,1,QCM,0.66,0.29,30.47,26,59,85,85,26,59,1.0,30.59,Facile,Difficile,-2,Beaucoup plus Difficile,Pas Adapte
2123,2016,Sociologie,3,"Travail, Emploi, Chomage",2,Fonctionnement du Marche du Chomage dans les Theories Economiques,8,1013,1,QCU,0.41,0.32,31.23,30,65,95,75,30,45,1.27,40.0,Facile,Difficile,-2,Beaucoup plus Difficile,Pas Adapte
3234,2017,Sociologie,3,"Travail, Emploi, Chomage",2,Fonctionnement du Marche du Chomage dans les Theories Economiques,8,1013,1,QCU,0.67,0.34,16.95,16,80,96,45,16,29,2.13,35.56,Difficile,Difficile,0,Meme Difficulté,Pas Adapte
4345,2018,Sociologie,3,"Travail, Emploi, Chomage",2,Fonctionnement du Marche du Chomage dans les Theories Economiques,8,1013,1,QCU,0.61,0.22,3.0,3,85,88,49,3,46,1.8,6.12,Difficile,Difficile,0,Meme Difficulté,Pas Adapte
5456,2019,Sociologie,3,"Travail, Emploi, Chomage",2,Fonctionnement du Marche du Chomage dans les Theories Economiques,8,1013,1,QCM,0.57,0.23,10.13,8,71,79,57,8,49,1.39,14.04,Facile,Difficile,-2,Beaucoup plus Difficile,Pas Adapte
6567,2020,Sociologie,3,"Travail, Emploi, Chomage",2,Fonctionnement du Marche du Chomage dans les Theories Economiques,8,1013,1,QCM,0.56,0.17,26.3,23,66,89,27,23,4,3.3,85.19,Difficile,Difficile,0,Meme Difficulté,Pas Adapte
1013,2015,Sociologie,3,"Travail, Emploi, Chomage",2,Fonctionnement du Marche du Chomage dans les Theories Economiques,8,1014,2,QCU,0.61,0.38,27.15,16,42,58,58,16,42,1.0,27.59,Difficile,Difficile,0,Meme Difficulté,Pas Adapte
2124,2016,Sociologie,3,"Travail, Emploi, Chomage",2,Fonctionnement du Marche du Chomage dans les Theories Economiques,8,1014,2,QCU,0.13,0.96,94.44,59,4,63,61,59,2,1.03,96.72,Facile,Facile,0,Meme Difficulté,Pas Adapte
3235,2017,Sociologie,3,"Travail, Emploi, Chomage",2,Fonctionnement du Marche du Chomage dans les Theories Economiques,8,1014,2,QCU,0.44,0.34,21.81,12,43,55,47,12,35,1.17,25.53,Difficile,Difficile,0,Meme Difficulté,Pas Adapte
4346,2018,Sociologie,3,"Travail, Emploi, Chomage",2,Fonctionnement du Marche du Chomage dans les Theories Economiques,8,1014,2,QCU,0.56,0.37,0.4,0,62,62,29,0,29,2.14,0.0,Difficile,Difficile,0,Meme Difficulté,Pas Adapte
5457,2019,Sociologie,3,"Travail, Emploi, Chomage",2,Fonctionnement du Marche du Chomage dans les Theories Economiques,8,1014,2,QCU,0.65,0.3,32.42,19,39,58,31,19,12,1.87,61.29,Difficile,Difficile,0,Meme Difficulté,Pas Adapte
6568,2020,Sociologie,3,"Travail, Emploi, Chomage",2,Fonctionnement du Marche du Chomage dans les Theories Economiques,8,1014,2,QCU,0.37,0.56,59.15,31,22,53,43,31,12,1.23,72.09,Facile,Moyen,-1,Plus Difficile,Pas Adapte
1014,2015,Sociologie,3,"Travail, Emploi, Chomage",2,Fonctionnement du Marche du Chomage dans les Theories Economiques,8,1015,3,QCM,0.77,0.16,16.47,3,15,18,6,3,3,3.0,50.0,Moyen,Difficile,-1,Plus Difficile,Pas Adapte
2125,2016,Sociologie,3,"Travail, Emploi, Chomage",2,Fonctionnement du Marche du Chomage dans les Theories Economiques,8,1015,3,QCM,0.73,0.22,5.13,1,15,16,9,1,8,1.78,11.11,Facile,Difficile,-2,Beaucoup plus Difficile,Pas Adapte
3236,2017,Sociologie,3,"Travail, Emploi, Chomage",2,Fonctionnement du Marche du Chomage dans les Theories Economiques,8,1015,3,QCM,0.07,0.76,80.19,14,3,17,14,14,0,1.21,100.0,Facile,Facile,0,Meme Difficulté,Pas Adapte
4347,2018,Sociologie,3,"Travail, Emploi, Chomage",2,Fonctionnement du Marche du Chomage dans les Theories Economiques,8,1015,3,QCM,0.04,0.75,75.96,11,3,14,13,11,2,1.08,84.62,Moyen,Facile,1,Plus Facile,Pas Adapte
5458,2019,Sociologie,3,"Travail, Emploi, Chomage",2,Fonctionnement du Marche du Chomage dans les Theories Economiques,8,1015,3,QCM,0.39,0.3,62.17,10,6,16,11,10,1,1.45,90.91,Facile,Moyen,-1,Plus Difficile,Pas Adapte
6569,2020,Sociologie,3,"Travail, Emploi, Chomage",2,Fonctionnement du Marche du Chomage dans les Theories Economiques,8,1015,3,QCM,0.58,0.18,26.78,5,13,18,12,5,7,1.5,41.67,Difficile,Difficile,0,Meme Difficulté,Pas Adapte
1015,2015,Sociologie,3,"Travail, Emploi, Chomage",2,Fonctionnement du Marche du Chomage dans les Theories Economiques,8,1016,4,QCM,0.14,0.7,93.94,79,5,84,80,79,1,1.05,98.75,Moyen,Facile,1,Plus Facile,Pas Adapte
2126,2016,Sociologie,3,"Travail, Emploi, Chomage",2,Fonctionnement du Marche du Chomage dans les Theories Economiques,8,1016,4,QCM,0.36,0.49,53.57,42,37,79,55,42,13,1.44,76.36,Facile,Moyen,-1,Plus Difficile,Pas Adapte
3237,2017,Sociologie,3,"Travail, Emploi, Chomage",2,Fonctionnement du Marche du Chomage dans les Theories Economiques,8,1016,4,QCM,0.09,0.91,65.27,48,26,74,60,48,12,1.23,80.0,Difficile,Facile,2,Beaucoup plus Facile,Adapte
4348,2018,Sociologie,3,"Travail, Emploi, Chomage",2,Fonctionnement du Marche du Chomage dans les Theories Economiques,8,1016,4,QCM,0.04,0.97,65.27,44,24,68,65,44,21,1.05,67.69,Facile,Facile,0,Meme Difficulté,Adapte
5459,2019,Sociologie,3,"Travail, Emploi, Chomage",2,Fonctionnement du Marche du Chomage dans les Theories Economiques,8,1016,4,QCM,0.11,0.74,65.27,40,21,61,41,40,1,1.49,97.56,Facile,Facile,0,Meme Difficulté,Adapte
6570,2020,Sociologie,3,"Travail, Emploi, Chomage",2,Fonctionnement du Marche du Chomage dans les Theories Economiques,8,1016,4,QCM,0.03,0.85,65.27,42,22,64,52,42,10,1.23,80.77,Facile,Facile,0,Meme Difficulté,Adapte
1016,2015,Sociologie,3,"Travail, Emploi, Chomage",2,Fonctionnement du Marche du Chomage dans les Theories Economiques,8,1017,5,QCM,0.79,0.3,27.3,8,21,29,13,8,5,2.23,61.54,Difficile,Difficile,0,Meme Difficulté,Pas Adapte
2127,2016,Sociologie,3,"Travail, Emploi, Chomage",2,Fonctionnement du Marche du Chomage dans les Theories Economiques,8,1017,5,QCM,0.04,0.94,87.03,27,4,31,28,27,1,1.11,96.43,Difficile,Facile,2,Beaucoup plus Facile,Pas Adapte
3238,2017,Sociologie,3,"Travail, Emploi, Chomage",2,Fonctionnement du Marche du Chomage dans les Theories Economiques,8,1017,5,QCU,0.19,0.87,66.18,18,9,27,19,18,1,1.42,94.74,Moyen,Facile,1,Plus Facile,Adapte
4349,2018,Sociologie,3,"Travail, Emploi, Chomage",2,Fonctionnement du Marche du Chomage dans les Theories Economiques,8,1017,5,QCU,0.15,0.84,66.18,19,9,28,19,19,0,1.47,100.0,Facile,Facile,0,Meme Difficulté,Adapte
5460,2019,Sociologie,3,"Travail, Emploi, Chomage",2,Fonctionnement du Marche du Chomage dans les Theories Economiques,8,1017,5,QCU,0.14,0.77,66.18,19,10,29,28,19,9,1.04,67.86,Facile,Facile,0,Meme Difficulté,Adapte
6571,2020,Sociologie,3,"Travail, Emploi, Chomage",2,Fonctionnement du Marche du Chomage dans les Theories Economiques,8,1017,5,QCU,0.04,0.78,66.18,18,9,27,26,18,8,1.04,69.23,Facile,Facile,0,Meme Difficulté,Adapte
1017,2015,Sociologie,3,"Travail, Emploi, Chomage",2,Fonctionnement du Marche du Chomage dans les Theories Economiques,8,1018,6,QCM,0.69,0.2,11.77,6,42,48,17,6,11,2.82,35.29,Difficile,Difficile,0,Meme Difficulté,Pas Adapte
2128,2016,Sociologie,3,"Travail, Emploi, Chomage",2,Fonctionnement du Marche du Chomage dans les Theories Economiques,8,1018,6,QCM,0.22,0.47,40.7,21,30,51,22,21,1,2.32,95.45,Moyen,Moyen,0,Meme Difficulté,Pas Adapte
3239,2017,Sociologie,3,"Travail, Emploi, Chomage",2,Fonctionnement du Marche du Chomage dans les Theories Economiques,8,1018,6,QCM,0.41,0.47,59.62,35,24,59,54,35,19,1.09,64.81,Difficile,Moyen,1,Plus Facile,Pas Adapte
4350,2018,Sociologie,3,"Travail, Emploi, Chomage",2,Fonctionnement du Marche du Chomage dans les Theories Economiques,8,1018,6,QCM,0.56,0.15,29.15,20,48,68,65,20,45,1.05,30.77,Moyen,Difficile,-1,Plus Difficile,Pas Adapte
5461,2019,Sociologie,3,"Travail, Emploi, Chomage",2,Fonctionnement du Marche du Chomage dans les Theories Economiques,8,1018,6,QCU,0.3,0.58,43.6,34,43,77,51,34,17,1.51,66.67,Moyen,Moyen,0,Meme Difficulté,Pas Adapte
6572,2020,Sociologie,3,"Travail, Emploi, Chomage",2,Fonctionnement du Marche du Chomage dans les Theories Economiques,8,1018,6,QCU,0.27,0.51,42.35,31,43,74,50,31,19,1.48,62.0,Facile,Moyen,-1,Plus Difficile,Pas Adapte
1018,2015,Sociologie,3,"Travail, Emploi, Chomage",2,Fonctionnement du Marche du Chomage dans les Theories Economiques,8,1019,7,QCM,0.47,0.44,39.41,9,13,22,16,9,7,1.38,56.25,Difficile,Moyen,1,Plus Facile,Pas Adapte
2129,2016,Sociologie,3,"Travail, Emploi, Chomage",2,Fonctionnement du Marche du Chomage dans les Theories Economiques,8,1019,7,QCM,0.01,0.7,72.06,14,6,20,20,14,6,1.0,70.0,Difficile,Facile,2,Beaucoup plus Facile,Adapte
3240,2017,Sociologie,3,"Travail, Emploi, Chomage",2,Fonctionnement du Marche du Chomage dans les Theories Economiques,8,1019,7,QCM,0.15,0.81,72.06,14,5,19,19,14,5,1.0,73.68,Facile,Facile,0,Meme Difficulté,Adapte
4351,2018,Sociologie,3,"Travail, Emploi, Chomage",2,Fonctionnement du Marche du Chomage dans les Theories Economiques,8,1019,7,QCM,0.19,0.8,72.06,13,5,18,17,13,4,1.06,76.47,Facile,Facile,0,Meme Difficulté,Adapte
5462,2019,Sociologie,3,"Travail, Emploi, Chomage",2,Fonctionnement du Marche du Chomage dans les Theories Economiques,8,1019,7,QCM,0.1,0.96,72.06,14,6,20,18,14,4,1.11,77.78,Facile,Facile,0,Meme Difficulté,Adapte
6573,2020,Sociologie,3,"Travail, Emploi, Chomage",2,Fonctionnement du Marche du Chomage dans les Theories Economiques,8,1019,7,QCM,0.15,0.71,72.06,15,6,21,17,15,2,1.24,88.24,Facile,Facile,0,Meme Difficulté,Adapte
1019,2015,Sociologie,3,"Travail, Emploi, Chomage",2,Fonctionnement du Marche du Chomage dans les Theories Economiques,8,1020,8,QROC,0.12,0.7,95.77,77,3,80,77,77,0,1.04,100.0,Facile,Facile,0,Meme Difficulté,Pas Adapte
2130,2016,Sociologie,3,"Travail, Emploi, Chomage",2,Fonctionnement du Marche du Chomage dans les Theories Economiques,8,1020,8,QCM,0.68,0.22,5.61,4,67,71,26,4,22,2.73,15.38,Moyen,Difficile,-1,Plus Difficile,Pas Adapte
3241,2017,Sociologie,3,"Travail, Emploi, Chomage",2,Fonctionnement du Marche du Chomage dans les Theories Economiques,8,1020,8,QCM,0.27,0.47,54.77,43,35,78,52,43,9,1.5,82.69,Facile,Moyen,-1,Plus Difficile,Pas Adapte
4352,2018,Sociologie,3,"Travail, Emploi, Chomage",2,Fonctionnement du Marche du Chomage dans les Theories Economiques,8,1020,8,QCM,0.3,0.54,37.99,29,48,77,54,29,25,1.43,53.7,Facile,Moyen,-1,Plus Difficile,Pas Adapte
5463,2019,Sociologie,3,"Travail, Emploi, Chomage",2,Fonctionnement du Marche du Chomage dans les Theories Economiques,8,1020,8,QCM,0.07,0.72,96.57,69,2,71,70,69,1,1.01,98.57,Difficile,Facile,2,Beaucoup plus Facile,Pas Adapte
6574,2020,Sociologie,3,"Travail, Emploi, Chomage",2,Fonctionnement du Marche du Chomage dans les Theories Economiques,8,1020,8,QCM,0.26,0.6,46.28,29,34,63,35,29,6,1.8,82.86,Facile,Moyen,-1,Plus Difficile,Pas Adapte
1020,2015,Sociologie,3,"Travail, Emploi, Chomage",3,Les Actions pour l'Emploi,9,1021,1,QCU,0.18,0.8,83.58,60,12,72,71,60,11,1.01,84.51,Moyen,Facile,1,Plus Facile,Pas Adapte
2131,2016,Sociologie,3,"Travail, Emploi, Chomage",3,Les Actions pour l'Emploi,9,1021,1,QCU,0.2,0.94,79.03,51,13,64,57,51,6,1.12,89.47,Difficile,Facile,2,Beaucoup plus Facile,Pas Adapte
3242,2017,Sociologie,3,"Travail, Emploi, Chomage",3,Les Actions pour l'Emploi,9,1021,1,QCU,0.65,0.22,16.01,9,47,56,26,9,17,2.15,34.62,Moyen,Difficile,-1,Plus Difficile,Pas Adapte
4353,2018,Sociologie,3,"Travail, Emploi, Chomage",3,Les Actions pour l'Emploi,9,1021,1,QCU,0.35,0.64,62.08,32,20,52,44,32,12,1.18,72.73,Facile,Moyen,-1,Plus Difficile,Pas Adapte
5464,2019,Sociologie,3,"Travail, Emploi, Chomage",3,Les Actions pour l'Emploi,9,1021,1,QCM,0.56,0.17,32.16,14,30,44,41,14,27,1.07,34.15,Moyen,Difficile,-1,Plus Difficile,Pas Adapte
6575,2020,Sociologie,3,"Travail, Emploi, Chomage",3,Les Actions pour l'Emploi,9,1021,1,QCM,0.03,0.99,71.26,32,13,45,37,32,5,1.22,86.49,Moyen,Facile,1,Plus Facile,Adapte
1021,2015,Sociologie,3,"Travail, Emploi, Chomage",3,Les Actions pour l'Emploi,9,1022,2,QROC,0.21,0.35,55.12,25,20,45,26,25,1,1.73,96.15,Moyen,Moyen,0,Meme Difficulté,Pas Adapte
2132,2016,Sociologie,3,"Travail, Emploi, Chomage",3,Les Actions pour l'Emploi,9,1022,2,QROC,0.29,0.39,60.59,23,15,38,34,23,11,1.12,67.65,Moyen,Moyen,0,Meme Difficulté,Pas Adapte
3243,2017,Sociologie,3,"Travail, Emploi, Chomage",3,Les Actions pour l'Emploi,9,1022,2,QROC,0.27,0.33,56.1,19,15,34,23,19,4,1.48,82.61,Moyen,Moyen,0,Meme Difficulté,Pas Adapte
4354,2018,Sociologie,3,"Travail, Emploi, Chomage",3,Les Actions pour l'Emploi,9,1022,2,QROC,0.71,0.18,18.07,7,32,39,38,7,31,1.03,18.42,Difficile,Difficile,0,Meme Difficulté,Pas Adapte
5465,2019,Sociologie,3,"Travail, Emploi, Chomage",3,Les Actions pour l'Emploi,9,1022,2,QROC,0.64,0.12,5.96,3,40,43,24,3,21,1.79,12.5,Moyen,Difficile,-1,Plus Difficile,Pas Adapte
6576,2020,Sociologie,3,"Travail, Emploi, Chomage",3,Les Actions pour l'Emploi,9,1022,2,QO,0.21,0.28,58.87,22,16,38,23,22,1,1.65,95.65,Moyen,Moyen,0,Meme Difficulté,Pas Adapte
1022,2015,Sociologie,3,"Travail, Emploi, Chomage",3,Les Actions pour l'Emploi,9,1023,3,QROC,0.68,0.23,25.37,20,60,80,52,20,32,1.54,38.46,Moyen,Difficile,-1,Plus Difficile,Pas Adapte
2133,2016,Sociologie,3,"Travail, Emploi, Chomage",3,Les Actions pour l'Emploi,9,1023,3,QROC,0.21,0.34,35.88,29,53,82,71,29,42,1.15,40.85,Difficile,Moyen,1,Plus Facile,Pas Adapte
3244,2017,Sociologie,3,"Travail, Emploi, Chomage",3,Les Actions pour l'Emploi,9,1023,3,QROC,0.67,0.07,13.58,13,81,94,75,13,62,1.25,17.33,Difficile,Difficile,0,Meme Difficulté,Pas Adapte
4355,2018,Sociologie,3,"Travail, Emploi, Chomage",3,Les Actions pour l'Emploi,9,1023,3,QROC,0.14,0.75,94.77,100,6,106,103,100,3,1.03,97.09,Moyen,Facile,1,Plus Facile,Pas Adapte
5466,2019,Sociologie,3,"Travail, Emploi, Chomage",3,Les Actions pour l'Emploi,9,1023,3,QROC,0.23,0.28,58.52,60,43,103,86,60,26,1.2,69.77,Facile,Moyen,-1,Plus Difficile,Pas Adapte
6577,2020,Sociologie,3,"Travail, Emploi, Chomage",3,Les Actions pour l'Emploi,9,1023,3,QROC,0.02,0.48,93.25,99,7,106,104,99,5,1.02,95.19,Moyen,Facile,1,Plus Facile,Pas Adapte
1023,2015,Sociologie,3,"Travail, Emploi, Chomage",3,Les Actions pour l'Emploi,9,1024,4,QROC,0.17,0.42,99.0,62,1,63,63,62,1,1.0,98.41,Difficile,Facile,2,Beaucoup plus Facile,Pas Adapte
2134,2016,Sociologie,3,"Travail, Emploi, Chomage",3,Les Actions pour l'Emploi,9,1024,4,QROC,0.36,0.38,49.64,34,35,69,66,34,32,1.05,51.52,Difficile,Moyen,1,Plus Facile,Pas Adapte
3245,2017,Sociologie,3,"Travail, Emploi, Chomage",3,Les Actions pour l'Emploi,9,1024,4,QROC,0.17,0.42,96.72,57,2,59,57,57,0,1.04,100.0,Moyen,Facile,1,Plus Facile,Pas Adapte
4356,2018,Sociologie,3,"Travail, Emploi, Chomage",3,Les Actions pour l'Emploi,9,1024,4,QROC,0.26,0.29,51.94,35,33,68,37,35,2,1.84,94.59,Difficile,Moyen,1,Plus Facile,Pas Adapte
5467,2019,Sociologie,3,"Travail, Emploi, Chomage",3,Les Actions pour l'Emploi,9,1024,4,QO,0.9,0.05,20.68,14,52,66,44,14,30,1.5,31.82,Facile,Difficile,-2,Beaucoup plus Difficile,Pas Adapte
6578,2020,Sociologie,3,"Travail, Emploi, Chomage",3,Les Actions pour l'Emploi,9,1024,4,QO,0.05,0.39,99.97,61,0,61,61,61,0,1.0,100.0,Difficile,Facile,2,Beaucoup plus Facile,Pas Adapte
1024,2015,Sociologie,3,"Travail, Emploi, Chomage",3,Les Actions pour l'Emploi,9,1025,5,QCU,0.7,0.21,12.55,10,68,78,56,10,46,1.39,17.86,Facile,Difficile,-2,Beaucoup plus Difficile,Pas Adapte
2135,2016,Sociologie,3,"Travail, Emploi, Chomage",3,Les Actions pour l'Emploi,9,1025,5,QCU,0.23,0.43,39.53,34,52,86,63,34,29,1.37,53.97,Facile,Moyen,-1,Plus Difficile,Pas Adapte
3246,2017,Sociologie,3,"Travail, Emploi, Chomage",3,Les Actions pour l'Emploi,9,1025,5,QCU,0.13,0.95,73.27,70,26,96,86,70,16,1.12,81.4,Difficile,Facile,2,Beaucoup plus Facile,Adapte
4357,2018,Sociologie,3,"Travail, Emploi, Chomage",3,Les Actions pour l'Emploi,9,1025,5,QCU,0.13,0.83,73.27,79,29,108,81,79,2,1.33,97.53,Facile,Facile,0,Meme Difficulté,Adapte
5468,2019,Sociologie,3,"Travail, Emploi, Chomage",3,Les Actions pour l'Emploi,9,1025,5,QCU,0.14,0.98,73.27,86,32,118,116,86,30,1.02,74.14,Facile,Facile,0,Meme Difficulté,Adapte
6579,2020,Sociologie,3,"Travail, Emploi, Chomage",3,Les Actions pour l'Emploi,9,1025,5,QCU,0.03,0.9,73.27,86,32,118,90,86,4,1.31,95.56,Facile,Facile,0,Meme Difficulté,Adapte
1025,2015,Sociologie,3,"Travail, Emploi, Chomage",3,Les Actions pour l'Emploi,9,1026,6,QCM,0.8,0.21,2.71,1,27,28,12,1,11,2.33,8.33,Facile,Difficile,-2,Beaucoup plus Difficile,Pas Adapte
2136,2016,Sociologie,3,"Travail, Emploi, Chomage",3,Les Actions pour l'Emploi,9,1026,6,QCU,0.26,0.63,56.6,16,12,28,23,16,7,1.22,69.57,Moyen,Moyen,0,Meme Difficulté,Pas Adapte
3247,2017,Sociologie,3,"Travail, Emploi, Chomage",3,Les Actions pour l'Emploi,9,1026,6,QCU,0.15,0.76,98.82,24,0,24,24,24,0,1.0,100.0,Moyen,Facile,1,Plus Facile,Pas Adapte
4358,2018,Sociologie,3,"Travail, Emploi, Chomage",3,Les Actions pour l'Emploi,9,1026,6,QCM,0.69,0.16,34.69,8,14,22,19,8,11,1.16,42.11,Facile,Difficile,-2,Beaucoup plus Difficile,Pas Adapte
5469,2019,Sociologie,3,"Travail, Emploi, Chomage",3,Les Actions pour l'Emploi,9,1026,6,QCM,0.72,0.27,34.53,7,14,21,20,7,13,1.05,35.0,Difficile,Difficile,0,Meme Difficulté,Pas Adapte
6580,2020,Sociologie,3,"Travail, Emploi, Chomage",3,Les Actions pour l'Emploi,9,1026,6,QCU,0.32,0.51,55.11,13,10,23,21,13,8,1.1,61.9,Moyen,Moyen,0,Meme Difficulté,Pas Adapte
1026,2015,Sociologie,3,"Travail, Emploi, Chomage",3,Les Actions pour l'Emploi,9,1027,7,QCM,0.28,0.41,52.24,34,31,65,43,34,9,1.51,79.07,Difficile,Moyen,1,Plus Facile,Pas Adapte
2137,2016,Sociologie,3,"Travail, Emploi, Chomage",3,Les Actions pour l'Emploi,9,1027,7,QCM,0.64,0.16,32.72,20,42,62,44,20,24,1.41,45.45,Difficile,Difficile,0,Meme Difficulté,Pas Adapte
3248,2017,Sociologie,3,"Travail, Emploi, Chomage",3,Les Actions pour l'Emploi,9,1027,7,QCM,0.05,0.7,70.18,39,17,56,52,39,13,1.08,75.0,Facile,Facile,0,Meme Difficulté,Adapte
4359,2018,Sociologie,3,"Travail, Emploi, Chomage",3,Les Actions pour l'Emploi,9,1027,7,QCM,0.07,0.91,70.18,43,18,61,52,43,9,1.17,82.69,Facile,Facile,0,Meme Difficulté,Adapte
5470,2019,Sociologie,3,"Travail, Emploi, Chomage",3,Les Actions pour l'Emploi,9,1027,7,QCM,0.06,0.96,70.18,39,16,55,53,39,14,1.04,73.58,Facile,Facile,0,Meme Difficulté,Adapte
6581,2020,Sociologie,3,"Travail, Emploi, Chomage",3,Les Actions pour l'Emploi,9,1027,7,QCM,0.07,0.73,70.18,36,15,51,49,36,13,1.04,73.47,Facile,Facile,0,Meme Difficulté,Adapte
1027,2015,Sociologie,3,"Travail, Emploi, Chomage",3,Les Actions pour l'Emploi,9,1028,8,QCM,0.02,0.94,91.18,7,1,8,7,7,0,1.14,100.0,Moyen,Facile,1,Plus Facile,Pas Adapte
2138,2016,Sociologie,3,"Travail, Emploi, Chomage",3,Les Actions pour l'Emploi,9,1028,8,QCM,0.53,0.21,1.84,0,8,8,6,0,6,1.33,0.0,Facile,Difficile,-2,Beaucoup plus Difficile,Pas Adapte
3249,2017,Sociologie,3,"Travail, Emploi, Chomage",3,Les Actions pour l'Emploi,9,1028,8,QCU,0.6,0.33,15.49,1,7,8,6,1,5,1.33,16.67,Difficile,Difficile,0,Meme Difficulté,Pas Adapte
4360,2018,Sociologie,3,"Travail, Emploi, Chomage",3,Les Actions pour l'Emploi,9,1028,8,QCU,0.12,0.77,76.84,6,2,8,7,6,1,1.14,85.71,Difficile,Facile,2,Beaucoup plus Facile,Pas Adapte
5471,2019,Sociologie,3,"Travail, Emploi, Chomage",3,Les Actions pour l'Emploi,9,1028,8,QCU,0.45,0.31,18.46,2,7,9,7,2,5,1.29,28.57,Moyen,Difficile,-1,Plus Difficile,Pas Adapte
6582,2020,Sociologie,3,"Travail, Emploi, Chomage",3,Les Actions pour l'Emploi,9,1028,8,QCU,0.27,0.5,46.24,4,4,8,6,4,2,1.33,66.67,Difficile,Moyen,1,Plus Facile,Pas Adapte
1028,2015,Sociologie,3,"Travail, Emploi, Chomage",3,Les Actions pour l'Emploi,9,1029,9,QCU,0.03,0.94,71.68,16,6,22,20,16,4,1.1,80.0,Facile,Facile,0,Meme Difficulté,Adapte
2139,2016,Sociologie,3,"Travail, Emploi, Chomage",3,Les Actions pour l'Emploi,9,1029,9,QCU,0.09,0.93,71.68,15,6,21,20,15,5,1.05,75.0,Facile,Facile,0,Meme Difficulté,Adapte
3250,2017,Sociologie,3,"Travail, Emploi, Chomage",3,Les Actions pour l'Emploi,9,1029,9,QCU,0.19,0.93,71.68,14,6,20,19,14,5,1.05,73.68,Facile,Facile,0,Meme Difficulté,Adapte
4361,2018,Sociologie,3,"Travail, Emploi, Chomage",3,Les Actions pour l'Emploi,9,1029,9,QCU,0.05,0.84,71.68,15,6,21,17,15,2,1.24,88.24,Facile,Facile,0,Meme Difficulté,Adapte
5472,2019,Sociologie,3,"Travail, Emploi, Chomage",3,Les Actions pour l'Emploi,9,1029,9,QCM,0.01,0.97,71.68,16,7,23,17,16,1,1.35,94.12,Facile,Facile,0,Meme Difficulté,Adapte
6583,2020,Sociologie,3,"Travail, Emploi, Chomage",3,Les Actions pour l'Emploi,9,1029,9,QCM,0.19,0.9,71.68,15,6,21,20,15,5,1.05,75.0,Facile,Facile,0,Meme Difficulté,Adapte
1029,2015,Sociologie,3,"Travail, Emploi, Chomage",4,La Question du Travail,8,1030,1,QCU,0.44,0.31,10.7,9,78,87,58,9,49,1.5,15.52,Difficile,Difficile,0,Meme Difficulté,Pas Adapte
2140,2016,Sociologie,3,"Travail, Emploi, Chomage",4,La Question du Travail,8,1030,1,QROC,0.86,0.09,26.04,20,58,78,33,20,13,2.36,60.61,Moyen,Difficile,-1,Plus Difficile,Pas Adapte
3251,2017,Sociologie,3,"Travail, Emploi, Chomage",4,La Question du Travail,8,1030,1,QROC,0.17,0.89,87.94,71,10,81,75,71,4,1.08,94.67,Moyen,Facile,1,Plus Facile,Pas Adapte
4362,2018,Sociologie,3,"Travail, Emploi, Chomage",4,La Question du Travail,8,1030,1,QROC,0.12,0.85,78.06,67,19,86,74,67,7,1.16,90.54,Facile,Facile,0,Meme Difficulté,Pas Adapte
5473,2019,Sociologie,3,"Travail, Emploi, Chomage",4,La Question du Travail,8,1030,1,QROC,0.77,0.23,7.91,8,91,99,67,8,59,1.48,11.94,Moyen,Difficile,-1,Plus Difficile,Pas Adapte
6584,2020,Sociologie,3,"Travail, Emploi, Chomage",4,La Question du Travail,8,1030,1,QROC,1.0,0.16,14.73,15,90,105,71,15,56,1.48,21.13,Moyen,Difficile,-1,Plus Difficile,Pas Adapte
1030,2015,Sociologie,3,"Travail, Emploi, Chomage",4,La Question du Travail,8,1031,2,QCU,0.6,0.24,34.11,9,17,26,22,9,13,1.18,40.91,Facile,Difficile,-2,Beaucoup plus Difficile,Pas Adapte
2141,2016,Sociologie,3,"Travail, Emploi, Chomage",4,La Question du Travail,8,1031,2,QCU,0.6,0.34,0.98,0,26,26,9,0,9,2.89,0.0,Facile,Difficile,-2,Beaucoup plus Difficile,Pas Adapte
3252,2017,Sociologie,3,"Travail, Emploi, Chomage",4,La Question du Travail,8,1031,2,QCM,0.41,0.59,39.19,11,17,28,16,11,5,1.75,68.75,Facile,Moyen,-1,Plus Difficile,Pas Adapte
4363,2018,Sociologie,3,"Travail, Emploi, Chomage",4,La Question du Travail,8,1031,2,QCM,0.15,0.85,98.87,26,0,26,26,26,0,1.0,100.0,Difficile,Facile,2,Beaucoup plus Facile,Pas Adapte
5474,2019,Sociologie,3,"Travail, Emploi, Chomage",4,La Question du Travail,8,1031,2,QCM,0.72,0.16,2.52,1,23,24,21,1,20,1.14,4.76,Moyen,Difficile,-1,Plus Difficile,Pas Adapte
6585,2020,Sociologie,3,"Travail, Emploi, Chomage",4,La Question du Travail,8,1031,2,QCM,0.77,0.17,10.84,2,20,22,19,2,17,1.16,10.53,Moyen,Difficile,-1,Plus Difficile,Pas Adapte
1031,2015,Sociologie,3,"Travail, Emploi, Chomage",4,La Question du Travail,8,1032,3,QCM,0.47,0.58,62.71,38,23,61,41,38,3,1.49,92.68,Facile,Moyen,-1,Plus Difficile,Pas Adapte
2142,2016,Sociologie,3,"Travail, Emploi, Chomage",4,La Question du Travail,8,1032,3,QCM,0.11,0.74,73.36,48,18,66,53,48,5,1.25,90.57,Moyen,Facile,1,Plus Facile,Adapte
3253,2017,Sociologie,3,"Travail, Emploi, Chomage",4,La Question du Travail,8,1032,3,QROC,0.18,0.41,73.36,46,17,63,60,46,14,1.05,76.67,Facile,Facile,0,Meme Difficulté,Adapte
4364,2018,Sociologie,3,"Travail, Emploi, Chomage",4,La Question du Travail,8,1032,3,QROC,0.19,0.86,73.36,45,16,61,47,45,2,1.3,95.74,Facile,Facile,0,Meme Difficulté,Adapte
5475,2019,Sociologie,3,"Travail, Emploi, Chomage",4,La Question du Travail,8,1032,3,QROC,0.15,0.95,73.36,50,18,68,55,50,5,1.24,90.91,Facile,Facile,0,Meme Difficulté,Adapte
6586,2020,Sociologie,3,"Travail, Emploi, Chomage",4,La Question du Travail,8,1032,3,QROC,0.07,0.98,73.36,50,18,68,54,50,4,1.26,92.59,Facile,Facile,0,Meme Difficulté,Adapte
1032,2015,Sociologie,3,"Travail, Emploi, Chomage",4,La Question du Travail,8,1033,4,QCU,0.63,0.3,27.16,6,17,23,8,6,2,2.88,75.0,Facile,Difficile,-2,Beaucoup plus Difficile,Pas Adapte
2143,2016,Sociologie,3,"Travail, Emploi, Chomage",4,La Question du Travail,8,1033,4,QCU,0.19,0.78,96.16,19,1,20,20,19,1,1.0,95.0,Facile,Facile,0,Meme Difficulté,Pas Adapte
3254,2017,Sociologie,3,"Travail, Emploi, Chomage",4,La Question du Travail,8,1033,4,QCU,0.36,0.68,55.28,11,8,19,13,11,2,1.46,84.62,Facile,Moyen,-1,Plus Difficile,Pas Adapte
4365,2018,Sociologie,3,"Travail, Emploi, Chomage",4,La Question du Travail,8,1033,4,QCU,0.16,0.97,91.94,16,1,17,17,16,1,1.0,94.12,Moyen,Facile,1,Plus Facile,Pas Adapte
5476,2019,Sociologie,3,"Travail, Emploi, Chomage",4,La Question du Travail,8,1033,4,QCU,0.0,0.82,86.59,15,2,17,15,15,0,1.13,100.0,Moyen,Facile,1,Plus Facile,Pas Adapte
6587,2020,Sociologie,3,"Travail, Emploi, Chomage",4,La Question du Travail,8,1033,4,QCU,0.53,0.29,5.29,1,17,18,15,1,14,1.2,6.67,Difficile,Difficile,0,Meme Difficulté,Pas Adapte
1033,2015,Sociologie,3,"Travail, Emploi, Chomage",4,La Question du Travail,8,1034,5,QCU,0.66,0.36,10.68,9,74,83,76,9,67,1.09,11.84,Difficile,Difficile,0,Meme Difficulté,Pas Adapte
2144,2016,Sociologie,3,"Travail, Emploi, Chomage",4,La Question du Travail,8,1034,5,QCU,0.7,0.25,11.24,9,71,80,49,9,40,1.63,18.37,Facile,Difficile,-2,Beaucoup plus Difficile,Pas Adapte
3255,2017,Sociologie,3,"Travail, Emploi, Chomage",4,La Question du Travail,8,1034,5,QCU,0.02,0.76,70.5,51,21,72,67,51,16,1.07,76.12,Difficile,Facile,2,Beaucoup plus Facile,Adapte
4366,2018,Sociologie,3,"Travail, Emploi, Chomage",4,La Question du Travail,8,1034,5,QCM,0.06,0.7,70.5,49,20,69,60,49,11,1.15,81.67,Facile,Facile,0,Meme Difficulté,Adapte
5477,2019,Sociologie,3,"Travail, Emploi, Chomage",4,La Question du Travail,8,1034,5,QROC,0.06,0.83,70.5,48,20,68,59,48,11,1.15,81.36,Facile,Facile,0,Meme Difficulté,Adapte
6588,2020,Sociologie,3,"Travail, Emploi, Chomage",4,La Question du Travail,8,1034,5,QROC,0.18,0.63,70.5,53,22,75,61,53,8,1.23,86.89,Facile,Facile,0,Meme Difficulté,Adapte
1034,2015,Sociologie,3,"Travail, Emploi, Chomage",4,La Question du Travail,8,1035,6,QCM,0.15,0.72,94.43,52,3,55,54,52,2,1.02,96.3,Difficile,Facile,2,Beaucoup plus Facile,Pas Adapte
2145,2016,Sociologie,3,"Travail, Emploi, Chomage",4,La Question du Travail,8,1035,6,QCM,0.75,0.26,6.84,4,50,54,28,4,24,1.93,14.29,Moyen,Difficile,-1,Plus Difficile,Pas Adapte
3256,2017,Sociologie,3,"Travail, Emploi, Chomage",4,La Question du Travail,8,1035,6,QCM,0.21,0.65,40.36,24,36,60,47,24,23,1.28,51.06,Difficile,Moyen,1,Plus Facile,Pas Adapte
4367,2018,Sociologie,3,"Travail, Emploi, Chomage",4,La Question du Travail,8,1035,6,QCM,0.58,0.29,23.24,13,44,57,15,13,2,3.8,86.67,Difficile,Difficile,0,Meme Difficulté,Pas Adapte
5478,2019,Sociologie,3,"Travail, Emploi, Chomage",4,La Question du Travail,8,1035,6,QCU,0.17,0.89,90.47,56,6,62,56,56,0,1.11,100.0,Difficile,Facile,2,Beaucoup plus Facile,Pas Adapte
6589,2020,Sociologie,3,"Travail, Emploi, Chomage",4,La Question du Travail,8,1035,6,QCU,0.42,0.26,21.2,13,49,62,28,13,15,2.21,46.43,Difficile,Difficile,0,Meme Difficulté,Pas Adapte
1035,2015,Sociologie,3,"Travail, Emploi, Chomage",4,La Question du Travail,8,1036,7,QCU,0.61,0.27,24.0,17,54,71,54,17,37,1.31,31.48,Difficile,Difficile,0,Meme Difficulté,Pas Adapte
2146,2016,Sociologie,3,"Travail, Emploi, Chomage",4,La Question du Travail,8,1036,7,QCU,0.62,0.25,19.66,15,60,75,33,15,18,2.27,45.45,Difficile,Difficile,0,Meme Difficulté,Pas Adapte
3257,2017,Sociologie,3,"Travail, Emploi, Chomage",4,La Question du Travail,8,1036,7,QCM,0.73,0.27,26.2,20,57,77,47,20,27,1.64,42.55,Facile,Difficile,-2,Beaucoup plus Difficile,Pas Adapte
4368,2018,Sociologie,3,"Travail, Emploi, Chomage",4,La Question du Travail,8,1036,7,QCM,0.02,0.79,88.64,62,8,70,64,62,2,1.09,96.88,Difficile,Facile,2,Beaucoup plus Facile,Pas Adapte
5479,2019,Sociologie,3,"Travail, Emploi, Chomage",4,La Question du Travail,8,1036,7,QCM,0.42,0.39,40.71,27,40,67,53,27,26,1.26,50.94,Moyen,Moyen,0,Meme Difficulté,Pas Adapte
6590,2020,Sociologie,3,"Travail, Emploi, Chomage",4,La Question du Travail,8,1036,7,QCM,0.34,0.52,61.12,42,26,68,43,42,1,1.58,97.67,Facile,Moyen,-1,Plus Difficile,Pas Adapte
1036,2015,Sociologie,3,"Travail, Emploi, Chomage",4,La Question du Travail,8,1037,8,QROC,0.14,0.97,87.95,6,1,7,7,6,1,1.0,85.71,Facile,Facile,0,Meme Difficulté,Pas Adapte
2147,2016,Sociologie,3,"Travail, Emploi, Chomage",4,La Question du Travail,8,1037,8,QROC,0.02,0.8,97.36,7,0,7,7,7,0,1.0,100.0,Facile,Facile,0,Meme Difficulté,Pas Adapte
3258,2017,Sociologie,3,"Travail, Emploi, Chomage",4,La Question du Travail,8,1037,8,QROC,0.18,0.51,89.3,5,1,6,5,5,0,1.2,100.0,Moyen,Facile,1,Plus Facile,Pas Adapte
4369,2018,Sociologie,3,"Travail, Emploi, Chomage",4,La Question du Travail,8,1037,8,QO,0.49,0.28,62.33,4,3,7,4,4,0,1.75,100.0,Moyen,Moyen,0,Meme Difficulté,Pas Adapte
5480,2019,Sociologie,3,"Travail, Emploi, Chomage",4,La Question du Travail,8,1037,8,QO,0.02,0.79,68.64,4,2,6,5,4,1,1.2,80.0,Facile,Facile,0,Meme Difficulté,Adapte
6591,2020,Sociologie,3,"Travail, Emploi, Chomage",4,La Question du Travail,8,1037,8,QO,0.19,0.68,68.64,4,2,6,5,4,1,1.2,80.0,Facile,Facile,0,Meme Difficulté,Adapte
1037,2015,Sociologie,4,Notions de Sociologie,1,Les Modernites,9,1038,1,QCU,0.1,0.82,93.27,66,5,71,70,66,4,1.01,94.29,Facile,Facile,0,Meme Difficulté,Pas Adapte
2148,2016,Sociologie,4,Notions de Sociologie,1,Les Modernites,9,1038,1,QCU,0.55,0.25,19.67,15,59,74,42,15,27,1.76,35.71,Moyen,Difficile,-1,Plus Difficile,Pas Adapte
3259,2017,Sociologie,4,Notions de Sociologie,1,Les Modernites,9,1038,1,QCU,0.17,0.87,86.35,62,10,72,67,62,5,1.07,92.54,Facile,Facile,0,Meme Difficulté,Pas Adapte
4370,2018,Sociologie,4,Notions de Sociologie,1,Les Modernites,9,1038,1,QCU,0.61,0.35,34.73,26,48,74,33,26,7,2.24,78.79,Moyen,Difficile,-1,Plus Difficile,Pas Adapte
5481,2019,Sociologie,4,Notions de Sociologie,1,Les Modernites,9,1038,1,QCU,0.13,0.84,88.53,61,8,69,69,61,8,1.0,88.41,Difficile,Facile,2,Beaucoup plus Facile,Pas Adapte
6592,2020,Sociologie,4,Notions de Sociologie,1,Les Modernites,9,1038,1,QCU,0.03,0.87,71.66,52,20,72,65,52,13,1.11,80.0,Difficile,Facile,2,Beaucoup plus Facile,Adapte
1038,2015,Sociologie,4,Notions de Sociologie,1,Les Modernites,9,1039,2,QCM,0.26,0.47,40.88,7,11,18,13,7,6,1.38,53.85,Moyen,Moyen,0,Meme Difficulté,Pas Adapte
2149,2016,Sociologie,4,Notions de Sociologie,1,Les Modernites,9,1039,2,QCM,0.34,0.33,64.69,10,5,15,13,10,3,1.15,76.92,Moyen,Moyen,0,Meme Difficulté,Pas Adapte
3260,2017,Sociologie,4,Notions de Sociologie,1,Les Modernites,9,1039,2,QCM,0.3,0.59,57.3,8,6,14,14,8,6,1.0,57.14,Facile,Moyen,-1,Plus Difficile,Pas Adapte
4371,2018,Sociologie,4,Notions de Sociologie,1,Les Modernites,9,1039,2,QCM,0.06,0.7,99.9,14,0,14,14,14,0,1.0,100.0,Difficile,Facile,2,Beaucoup plus Facile,Pas Adapte
5482,2019,Sociologie,4,Notions de Sociologie,1,Les Modernites,9,1039,2,QCM,0.16,0.98,87.27,12,2,14,14,12,2,1.0,85.71,Difficile,Facile,2,Beaucoup plus Facile,Pas Adapte
6593,2020,Sociologie,4,Notions de Sociologie,1,Les Modernites,9,1039,2,QCM,0.66,0.17,18.18,3,13,16,13,3,10,1.23,23.08,Facile,Difficile,-2,Beaucoup plus Difficile,Pas Adapte
1039,2015,Sociologie,4,Notions de Sociologie,1,Les Modernites,9,1040,3,QROC,0.18,0.75,87.51,59,8,67,60,59,1,1.12,98.33,Difficile,Facile,2,Beaucoup plus Facile,Pas Adapte
2150,2016,Sociologie,4,Notions de Sociologie,1,Les Modernites,9,1040,3,QROC,0.38,0.3,57.26,44,32,76,54,44,10,1.41,81.48,Moyen,Moyen,0,Meme Difficulté,Pas Adapte
3261,2017,Sociologie,4,Notions de Sociologie,1,Les Modernites,9,1040,3,QROC,0.94,0.15,13.33,10,67,77,76,10,66,1.01,13.16,Facile,Difficile,-2,Beaucoup plus Difficile,Pas Adapte
4372,2018,Sociologie,4,Notions de Sociologie,1,Les Modernites,9,1040,3,QROC,0.41,0.33,54.31,38,32,70,40,38,2,1.75,95.0,Difficile,Moyen,1,Plus Facile,Pas Adapte
5483,2019,Sociologie,4,Notions de Sociologie,1,Les Modernites,9,1040,3,QROC,0.51,0.4,57.8,35,26,61,42,35,7,1.45,83.33,Difficile,Moyen,1,Plus Facile,Pas Adapte
6594,2020,Sociologie,4,Notions de Sociologie,1,Les Modernites,9,1040,3,QROC,0.11,0.74,95.12,52,3,55,52,52,0,1.06,100.0,Moyen,Facile,1,Plus Facile,Pas Adapte
1040,2015,Sociologie,4,Notions de Sociologie,1,Les Modernites,9,1041,4,QCU,0.62,0.22,4.54,2,51,53,44,2,42,1.2,4.55,Difficile,Difficile,0,Meme Difficulté,Pas Adapte
2151,2016,Sociologie,4,Notions de Sociologie,1,Les Modernites,9,1041,4,QCU,0.58,0.26,14.42,8,48,56,50,8,42,1.12,16.0,Facile,Difficile,-2,Beaucoup plus Difficile,Pas Adapte
3262,2017,Sociologie,4,Notions de Sociologie,1,Les Modernites,9,1041,4,QCU,0.61,0.25,14.82,8,48,56,38,8,30,1.47,21.05,Facile,Difficile,-2,Beaucoup plus Difficile,Pas Adapte
4373,2018,Sociologie,4,Notions de Sociologie,1,Les Modernites,9,1041,4,QCM,0.14,0.77,68.54,38,17,55,40,38,2,1.38,95.0,Difficile,Facile,2,Beaucoup plus Facile,Adapte
5484,2019,Sociologie,4,Notions de Sociologie,1,Les Modernites,9,1041,4,QCM,0.11,0.83,68.54,38,18,56,42,38,4,1.33,90.48,Facile,Facile,0,Meme Difficulté,Adapte
6595,2020,Sociologie,4,Notions de Sociologie,1,Les Modernites,9,1041,4,QROC,0.16,0.44,68.54,33,15,48,34,33,1,1.41,97.06,Facile,Facile,0,Meme Difficulté,Adapte
1041,2015,Sociologie,4,Notions de Sociologie,1,Les Modernites,9,1042,5,QCM,0.39,0.43,35.24,32,60,92,36,32,4,2.56,88.89,Facile,Moyen,-1,Plus Difficile,Pas Adapte
2152,2016,Sociologie,4,Notions de Sociologie,1,Les Modernites,9,1042,5,QCM,0.46,0.67,45.52,42,50,92,45,42,3,2.04,93.33,Moyen,Moyen,0,Meme Difficulté,Pas Adapte
3263,2017,Sociologie,4,Notions de Sociologie,1,Les Modernites,9,1042,5,QCU,0.52,0.23,30.3,25,57,82,81,25,56,1.01,30.86,Moyen,Difficile,-1,Plus Difficile,Pas Adapte
4374,2018,Sociologie,4,Notions de Sociologie,1,Les Modernites,9,1042,5,QCU,0.31,0.72,62.07,52,31,83,77,52,25,1.08,67.53,Moyen,Moyen,0,Meme Difficulté,Pas Adapte
5485,2019,Sociologie,4,Notions de Sociologie,1,Les Modernites,9,1042,5,QCU,0.65,0.36,16.33,14,74,88,72,14,58,1.22,19.44,Moyen,Difficile,-1,Plus Difficile,Pas Adapte
6596,2020,Sociologie,4,Notions de Sociologie,1,Les Modernites,9,1042,5,QCU,0.24,0.7,36.01,30,52,82,63,30,33,1.3,47.62,Difficile,Moyen,1,Plus Facile,Pas Adapte
1042,2015,Sociologie,4,Notions de Sociologie,1,Les Modernites,9,1043,6,QROC,0.5,0.37,42.57,8,10,18,18,8,10,1.0,44.44,Moyen,Moyen,0,Meme Difficulté,Pas Adapte
2153,2016,Sociologie,4,Notions de Sociologie,1,Les Modernites,9,1043,6,QROC,0.05,0.96,93.28,16,1,17,16,16,0,1.06,100.0,Facile,Facile,0,Meme Difficulté,Pas Adapte
3264,2017,Sociologie,4,Notions de Sociologie,1,Les Modernites,9,1043,6,QROC,0.14,0.85,85.31,13,2,15,15,13,2,1.0,86.67,Moyen,Facile,1,Plus Facile,Pas Adapte
4375,2018,Sociologie,4,Notions de Sociologie,1,Les Modernites,9,1043,6,QROC,0.87,0.07,23.5,3,11,14,13,3,10,1.08,23.08,Moyen,Difficile,-1,Plus Difficile,Pas Adapte
5486,2019,Sociologie,4,Notions de Sociologie,1,Les Modernites,9,1043,6,QROC,0.49,0.3,62.81,8,4,12,10,8,2,1.2,80.0,Moyen,Moyen,0,Meme Difficulté,Pas Adapte
6597,2020,Sociologie,4,Notions de Sociologie,1,Les Modernites,9,1043,6,QROC,0.18,0.77,80.13,10,2,12,10,10,0,1.2,100.0,Moyen,Facile,1,Plus Facile,Pas Adapte
1043,2015,Sociologie,4,Notions de Sociologie,1,Les Modernites,9,1044,7,QROC,0.03,0.51,75.98,21,6,27,23,21,2,1.17,91.3,Moyen,Facile,1,Plus Facile,Pas Adapte
2154,2016,Sociologie,4,Notions de Sociologie,1,Les Modernites,9,1044,7,QROC,0.99,0.21,21.1,6,22,28,18,6,12,1.56,33.33,Moyen,Difficile,-1,Plus Difficile,Pas Adapte
3265,2017,Sociologie,4,Notions de Sociologie,1,Les Modernites,9,1044,7,QROC,0.74,0.11,10.15,3,27,30,23,3,20,1.3,13.04,Facile,Difficile,-2,Beaucoup plus Difficile,Pas Adapte
4376,2018,Sociologie,4,Notions de Sociologie,1,Les Modernites,9,1044,7,QO,0.44,0.16,40.45,14,20,34,28,14,14,1.21,50.0,Moyen,Moyen,0,Meme Difficulté,Pas Adapte
5487,2019,Sociologie,4,Notions de Sociologie,1,Les Modernites,9,1044,7,QO,0.26,0.23,42.09,16,21,37,27,16,11,1.37,59.26,Difficile,Moyen,1,Plus Facile,Pas Adapte
6598,2020,Sociologie,4,Notions de Sociologie,1,Les Modernites,9,1044,7,QROC,0.14,0.64,98.07,33,1,34,33,33,0,1.03,100.0,Moyen,Facile,1,Plus Facile,Pas Adapte
1044,2015,Sociologie,4,Notions de Sociologie,1,Les Modernites,9,1045,8,QCM,0.69,0.16,14.28,9,57,66,26,9,17,2.54,34.62,Moyen,Difficile,-1,Plus Difficile,Pas Adapte
2155,2016,Sociologie,4,Notions de Sociologie,1,Les Modernites,9,1045,8,QCM,0.76,0.21,21.17,16,58,74,25,16,9,2.96,64.0,Facile,Difficile,-2,Beaucoup plus Difficile,Pas Adapte
3266,2017,Sociologie,4,Notions de Sociologie,1,Les Modernites,9,1045,8,QCM,0.05,0.9,88.73,58,7,65,62,58,4,1.05,93.55,Difficile,Facile,2,Beaucoup plus Facile,Pas Adapte
4377,2018,Sociologie,4,Notions de Sociologie,1,Les Modernites,9,1045,8,QCU,0.24,0.57,63.25,44,26,70,46,44,2,1.52,95.65,Facile,Moyen,-1,Plus Difficile,Pas Adapte
5488,2019,Sociologie,4,Notions de Sociologie,1,Les Modernites,9,1045,8,QCU,0.12,0.88,85.8,54,9,63,62,54,8,1.02,87.1,Facile,Facile,0,Meme Difficulté,Pas Adapte
6599,2020,Sociologie,4,Notions de Sociologie,1,Les Modernites,9,1045,8,QCU,0.05,0.97,69.29,49,22,71,68,49,19,1.04,72.06,Facile,Facile,0,Meme Difficulté,Adapte
1045,2015,Sociologie,4,Notions de Sociologie,1,Les Modernites,9,1046,9,QCM,0.25,0.43,62.83,57,34,91,80,57,23,1.14,71.25,Facile,Moyen,-1,Plus Difficile,Pas Adapte
2156,2016,Sociologie,4,Notions de Sociologie,1,Les Modernites,9,1046,9,QCM,0.02,0.75,93.65,76,5,81,78,76,2,1.04,97.44,Moyen,Facile,1,Plus Facile,Pas Adapte
3267,2017,Sociologie,4,Notions de Sociologie,1,Les Modernites,9,1046,9,QCM,0.07,0.79,97.42,68,2,70,69,68,1,1.01,98.55,Moyen,Facile,1,Plus Facile,Pas Adapte
4378,2018,Sociologie,4,Notions de Sociologie,1,Les Modernites,9,1046,9,QCM,0.15,0.91,68.67,48,22,70,69,48,21,1.01,69.57,Moyen,Facile,1,Plus Facile,Adapte
5489,2019,Sociologie,4,Notions de Sociologie,1,Les Modernites,9,1046,9,QCU,0.02,0.84,68.67,46,21,67,58,46,12,1.16,79.31,Facile,Facile,0,Meme Difficulté,Adapte
6600,2020,Sociologie,4,Notions de Sociologie,1,Les Modernites,9,1046,9,QCU,0.09,0.87,68.67,53,24,77,62,53,9,1.24,85.48,Facile,Facile,0,Meme Difficulté,Adapte
1046,2015,Sociologie,4,Notions de Sociologie,2,Structure et Classes Sociales,6,1047,1,QROC,0.09,0.43,76.91,18,6,24,21,18,3,1.14,85.71,Facile,Facile,0,Meme Difficulté,Pas Adapte
2157,2016,Sociologie,4,Notions de Sociologie,2,Structure et Classes Sociales,6,1047,1,QROC,0.74,0.23,18.84,4,16,20,16,4,12,1.25,25.0,Facile,Difficile,-2,Beaucoup plus Difficile,Pas Adapte
3268,2017,Sociologie,4,Notions de Sociologie,2,Structure et Classes Sociales,6,1047,1,QROC,0.68,0.04,29.44,6,14,20,20,6,14,1.0,30.0,Difficile,Difficile,0,Meme Difficulté,Pas Adapte
4379,2018,Sociologie,4,Notions de Sociologie,2,Structure et Classes Sociales,6,1047,1,QROC,0.72,0.01,20.07,4,16,20,14,4,10,1.43,28.57,Moyen,Difficile,-1,Plus Difficile,Pas Adapte
5490,2019,Sociologie,4,Notions de Sociologie,2,Structure et Classes Sociales,6,1047,1,QO,0.89,0.04,6.24,1,19,20,10,1,9,2.0,10.0,Difficile,Difficile,0,Meme Difficulté,Pas Adapte
6601,2020,Sociologie,4,Notions de Sociologie,2,Structure et Classes Sociales,6,1047,1,QO,0.41,0.24,57.7,10,7,17,16,10,6,1.06,62.5,Facile,Moyen,-1,Plus Difficile,Pas Adapte
1047,2015,Sociologie,4,Notions de Sociologie,2,Structure et Classes Sociales,6,1048,2,QO,0.16,0.76,79.96,62,16,78,70,62,8,1.11,88.57,Difficile,Facile,2,Beaucoup plus Facile,Pas Adapte
2158,2016,Sociologie,4,Notions de Sociologie,2,Structure et Classes Sociales,6,1048,2,QO,0.43,0.16,55.93,48,37,85,57,48,9,1.49,84.21,Facile,Moyen,-1,Plus Difficile,Pas Adapte
3269,2017,Sociologie,4,Notions de Sociologie,2,Structure et Classes Sociales,6,1048,2,QO,0.76,0.06,28.35,22,54,76,61,22,39,1.25,36.07,Facile,Difficile,-2,Beaucoup plus Difficile,Pas Adapte
4380,2018,Sociologie,4,Notions de Sociologie,2,Structure et Classes Sociales,6,1048,2,QO,0.14,0.58,79.13,64,17,81,69,64,5,1.17,92.75,Facile,Facile,0,Meme Difficulté,Pas Adapte
5491,2019,Sociologie,4,Notions de Sociologie,2,Structure et Classes Sociales,6,1048,2,QROC,0.22,0.3,61.57,52,32,84,83,52,31,1.01,62.65,Moyen,Moyen,0,Meme Difficulté,Pas Adapte
6602,2020,Sociologie,4,Notions de Sociologie,2,Structure et Classes Sociales,6,1048,2,QROC,0.54,0.34,43.36,37,49,86,73,37,36,1.18,50.68,Moyen,Moyen,0,Meme Difficulté,Pas Adapte
1048,2015,Sociologie,4,Notions de Sociologie,2,Structure et Classes Sociales,6,1049,3,QCM,0.5,0.21,28.46,24,62,86,57,24,33,1.51,42.11,Moyen,Difficile,-1,Plus Difficile,Pas Adapte
2159,2016,Sociologie,4,Notions de Sociologie,2,Structure et Classes Sociales,6,1049,3,QCM,0.45,0.49,45.56,36,43,79,48,36,12,1.65,75.0,Difficile,Moyen,1,Plus Facile,Pas Adapte
3270,2017,Sociologie,4,Notions de Sociologie,2,Structure et Classes Sociales,6,1049,3,QCM,0.54,0.23,0.68,1,81,82,51,1,50,1.61,1.96,Facile,Difficile,-2,Beaucoup plus Difficile,Pas Adapte
4381,2018,Sociologie,4,Notions de Sociologie,2,Structure et Classes Sociales,6,1049,3,QCM,0.36,0.69,57.73,45,33,78,65,45,20,1.2,69.23,Difficile,Moyen,1,Plus Facile,Pas Adapte
5492,2019,Sociologie,4,Notions de Sociologie,2,Structure et Classes Sociales,6,1049,3,QCM,0.19,0.77,68.18,53,25,78,69,53,16,1.13,76.81,Facile,Facile,0,Meme Difficulté,Adapte
6603,2020,Sociologie,4,Notions de Sociologie,2,Structure et Classes Sociales,6,1049,3,QCM,0.1,1.0,68.18,57,27,84,75,57,18,1.12,76.0,Facile,Facile,0,Meme Difficulté,Adapte
1049,2015,Sociologie,4,Notions de Sociologie,2,Structure et Classes Sociales,6,1050,4,QCM,0.1,0.94,71.08,16,7,23,21,16,5,1.1,76.19,Facile,Facile,0,Meme Difficulté,Adapte
2160,2016,Sociologie,4,Notions de Sociologie,2,Structure et Classes Sociales,6,1050,4,QCM,0.1,0.89,71.08,17,7,24,19,17,2,1.26,89.47,Facile,Facile,0,Meme Difficulté,Adapte
3271,2017,Sociologie,4,Notions de Sociologie,2,Structure et Classes Sociales,6,1050,4,QCM,0.03,0.88,71.08,17,7,24,22,17,5,1.09,77.27,Facile,Facile,0,Meme Difficulté,Adapte
4382,2018,Sociologie,4,Notions de Sociologie,2,Structure et Classes Sociales,6,1050,4,QCM,0.05,0.95,71.08,16,6,22,19,16,3,1.16,84.21,Facile,Facile,0,Meme Difficulté,Adapte
5493,2019,Sociologie,4,Notions de Sociologie,2,Structure et Classes Sociales,6,1050,4,QCM,0.09,0.91,71.08,14,6,20,15,14,1,1.33,93.33,Facile,Facile,0,Meme Difficulté,Adapte
6604,2020,Sociologie,4,Notions de Sociologie,2,Structure et Classes Sociales,6,1050,4,QCM,0.17,0.9,71.08,16,7,23,17,16,1,1.35,94.12,Facile,Facile,0,Meme Difficulté,Adapte
1050,2015,Sociologie,4,Notions de Sociologie,2,Structure et Classes Sociales,6,1051,5,QCM,0.55,0.16,8.28,6,63,69,34,6,28,2.03,17.65,Moyen,Difficile,-1,Plus Difficile,Pas Adapte
2161,2016,Sociologie,4,Notions de Sociologie,2,Structure et Classes Sociales,6,1051,5,QCM,0.17,0.88,85.27,63,11,74,63,63,0,1.17,100.0,Facile,Facile,0,Meme Difficulté,Pas Adapte
3272,2017,Sociologie,4,Notions de Sociologie,2,Structure et Classes Sociales,6,1051,5,QCM,0.53,0.15,6.58,5,69,74,42,5,37,1.76,11.9,Moyen,Difficile,-1,Plus Difficile,Pas Adapte
4383,2018,Sociologie,4,Notions de Sociologie,2,Structure et Classes Sociales,6,1051,5,QCU,0.44,0.23,13.7,10,65,75,42,10,32,1.79,23.81,Difficile,Difficile,0,Meme Difficulté,Pas Adapte
5494,2019,Sociologie,4,Notions de Sociologie,2,Structure et Classes Sociales,6,1051,5,QCU,0.41,0.34,32.4,26,55,81,64,26,38,1.27,40.62,Moyen,Difficile,-1,Plus Difficile,Pas Adapte
6605,2020,Sociologie,4,Notions de Sociologie,2,Structure et Classes Sociales,6,1051,5,QCM,0.58,0.2,31.18,24,54,78,59,24,35,1.32,40.68,Facile,Difficile,-2,Beaucoup plus Difficile,Pas Adapte
1051,2015,Sociologie,4,Notions de Sociologie,2,Structure et Classes Sociales,6,1052,6,QCU,0.31,0.6,38.28,21,35,56,52,21,31,1.08,40.38,Moyen,Moyen,0,Meme Difficulté,Pas Adapte
2162,2016,Sociologie,4,Notions de Sociologie,2,Structure et Classes Sociales,6,1052,6,QCU,0.0,0.88,89.4,49,6,55,55,49,6,1.0,89.09,Facile,Facile,0,Meme Difficulté,Pas Adapte
3273,2017,Sociologie,4,Notions de Sociologie,2,Structure et Classes Sociales,6,1052,6,QCU,0.1,0.84,96.66,60,2,62,60,60,0,1.03,100.0,Facile,Facile,0,Meme Difficulté,Pas Adapte
4384,2018,Sociologie,4,Notions de Sociologie,2,Structure et Classes Sociales,6,1052,6,QCU,0.59,0.21,18.24,10,43,53,47,10,37,1.13,21.28,Difficile,Difficile,0,Meme Difficulté,Pas Adapte
5495,2019,Sociologie,4,Notions de Sociologie,2,Structure et Classes Sociales,6,1052,6,QCU,0.54,0.4,32.52,17,34,51,23,17,6,2.22,73.91,Difficile,Difficile,0,Meme Difficulté,Pas Adapte
6606,2020,Sociologie,4,Notions de Sociologie,2,Structure et Classes Sociales,6,1052,6,QCU,0.44,0.36,14.5,7,41,48,28,7,21,1.71,25.0,Difficile,Difficile,0,Meme Difficulté,Pas Adapte
1052,2015,Sociologie,4,Notions de Sociologie,3,Organisation et Institution,14,1053,1,QCU,0.59,0.28,0.66,0,31,31,12,0,12,2.58,0.0,Facile,Difficile,-2,Beaucoup plus Difficile,Pas Adapte
2163,2016,Sociologie,4,Notions de Sociologie,3,Organisation et Institution,14,1053,1,QO,0.95,0.11,18.72,5,23,28,17,5,12,1.65,29.41,Difficile,Difficile,0,Meme Difficulté,Pas Adapte
3274,2017,Sociologie,4,Notions de Sociologie,3,Organisation et Institution,14,1053,1,QO,0.81,0.13,1.92,1,27,28,22,1,21,1.27,4.55,Moyen,Difficile,-1,Plus Difficile,Pas Adapte
4385,2018,Sociologie,4,Notions de Sociologie,3,Organisation et Institution,14,1053,1,QO,0.09,0.66,82.59,25,5,30,27,25,2,1.11,92.59,Moyen,Facile,1,Plus Facile,Pas Adapte
5496,2019,Sociologie,4,Notions de Sociologie,3,Organisation et Institution,14,1053,1,QO,0.96,0.1,9.23,2,25,27,24,2,22,1.12,8.33,Facile,Difficile,-2,Beaucoup plus Difficile,Pas Adapte
6607,2020,Sociologie,4,Notions de Sociologie,3,Organisation et Institution,14,1053,1,QO,0.14,0.56,90.46,24,2,26,25,24,1,1.04,96.0,Difficile,Facile,2,Beaucoup plus Facile,Pas Adapte
1053,2015,Sociologie,4,Notions de Sociologie,3,Organisation et Institution,14,1054,2,QCU,0.45,0.31,12.97,7,46,53,35,7,28,1.51,20.0,Moyen,Difficile,-1,Plus Difficile,Pas Adapte
2164,2016,Sociologie,4,Notions de Sociologie,3,Organisation et Institution,14,1054,2,QCM,0.61,0.3,34.74,20,37,57,55,20,35,1.04,36.36,Moyen,Difficile,-1,Plus Difficile,Pas Adapte
3275,2017,Sociologie,4,Notions de Sociologie,3,Organisation et Institution,14,1054,2,QCM,0.75,0.21,19.16,10,41,51,36,10,26,1.42,27.78,Difficile,Difficile,0,Meme Difficulté,Pas Adapte
4386,2018,Sociologie,4,Notions de Sociologie,3,Organisation et Institution,14,1054,2,QCM,0.41,0.34,37.06,19,33,52,40,19,21,1.3,47.5,Moyen,Moyen,0,Meme Difficulté,Pas Adapte
5497,2019,Sociologie,4,Notions de Sociologie,3,Organisation et Institution,14,1054,2,QCM,0.19,0.94,98.77,56,1,57,56,56,0,1.02,100.0,Moyen,Facile,1,Plus Facile,Pas Adapte
6608,2020,Sociologie,4,Notions de Sociologie,3,Organisation et Institution,14,1054,2,QCM,0.15,0.71,66.62,37,18,55,47,37,10,1.17,78.72,Difficile,Facile,2,Beaucoup plus Facile,Adapte
1054,2015,Sociologie,4,Notions de Sociologie,3,Organisation et Institution,14,1055,3,QCM,0.24,0.45,40.14,22,34,56,54,22,32,1.04,40.74,Difficile,Moyen,1,Plus Facile,Pas Adapte
2165,2016,Sociologie,4,Notions de Sociologie,3,Organisation et Institution,14,1055,3,QCM,0.66,0.18,14.24,7,41,48,47,7,40,1.02,14.89,Moyen,Difficile,-1,Plus Difficile,Pas Adapte
3276,2017,Sociologie,4,Notions de Sociologie,3,Organisation et Institution,14,1055,3,QCM,0.52,0.28,22.74,10,35,45,36,10,26,1.25,27.78,Difficile,Difficile,0,Meme Difficulté,Pas Adapte
4387,2018,Sociologie,4,Notions de Sociologie,3,Organisation et Institution,14,1055,3,QCM,0.68,0.24,23.27,10,32,42,29,10,19,1.45,34.48,Difficile,Difficile,0,Meme Difficulté,Pas Adapte
5498,2019,Sociologie,4,Notions de Sociologie,3,Organisation et Institution,14,1055,3,QCU,0.32,0.45,62.05,24,15,39,36,24,12,1.08,66.67,Moyen,Moyen,0,Meme Difficulté,Pas Adapte
6609,2020,Sociologie,4,Notions de Sociologie,3,Organisation et Institution,14,1055,3,QCU,0.02,0.87,75.01,25,8,33,32,25,7,1.03,78.12,Facile,Facile,0,Meme Difficulté,Pas Adapte
1055,2015,Sociologie,4,Notions de Sociologie,3,Organisation et Institution,14,1056,4,QCM,0.17,0.84,88.84,40,5,45,40,40,0,1.12,100.0,Facile,Facile,0,Meme Difficulté,Pas Adapte
2166,2016,Sociologie,4,Notions de Sociologie,3,Organisation et Institution,14,1056,4,QCM,0.25,0.55,48.42,25,27,52,41,25,16,1.27,60.98,Moyen,Moyen,0,Meme Difficulté,Pas Adapte
3277,2017,Sociologie,4,Notions de Sociologie,3,Organisation et Institution,14,1056,4,QCM,0.2,0.8,72.11,35,14,49,45,35,10,1.09,77.78,Facile,Facile,0,Meme Difficulté,Adapte
4388,2018,Sociologie,4,Notions de Sociologie,3,Organisation et Institution,14,1056,4,QCM,0.15,0.97,72.11,32,12,44,41,32,9,1.07,78.05,Facile,Facile,0,Meme Difficulté,Adapte
5499,2019,Sociologie,4,Notions de Sociologie,3,Organisation et Institution,14,1056,4,QCM,0.0,0.92,72.11,27,11,38,34,27,7,1.12,79.41,Facile,Facile,0,Meme Difficulté,Adapte
6610,2020,Sociologie,4,Notions de Sociologie,3,Organisation et Institution,14,1056,4,QROC,0.13,0.48,72.11,32,12,44,44,32,12,1.0,72.73,Facile,Facile,0,Meme Difficulté,Adapte
1056,2015,Sociologie,4,Notions de Sociologie,3,Organisation et Institution,14,1057,5,QO,0.76,0.03,26.75,15,41,56,45,15,30,1.24,33.33,Difficile,Difficile,0,Meme Difficulté,Pas Adapte
2167,2016,Sociologie,4,Notions de Sociologie,3,Organisation et Institution,14,1057,5,QO,0.04,0.58,72.08,39,15,54,44,39,5,1.23,88.64,Facile,Facile,0,Meme Difficulté,Adapte
3278,2017,Sociologie,4,Notions de Sociologie,3,Organisation et Institution,14,1057,5,QO,0.15,0.99,72.08,43,16,59,55,43,12,1.07,78.18,Facile,Facile,0,Meme Difficulté,Adapte
4389,2018,Sociologie,4,Notions de Sociologie,3,Organisation et Institution,14,1057,5,QO,0.19,0.75,72.08,39,15,54,43,39,4,1.26,90.7,Facile,Facile,0,Meme Difficulté,Adapte
5500,2019,Sociologie,4,Notions de Sociologie,3,Organisation et Institution,14,1057,5,QO,0.08,0.63,72.08,36,14,50,49,36,13,1.02,73.47,Facile,Facile,0,Meme Difficulté,Adapte
6611,2020,Sociologie,4,Notions de Sociologie,3,Organisation et Institution,14,1057,5,QO,0.09,0.68,72.08,32,12,44,35,32,3,1.26,91.43,Facile,Facile,0,Meme Difficulté,Adapte
1057,2015,Sociologie,4,Notions de Sociologie,3,Organisation et Institution,14,1058,6,QROC,1.0,0.1,2.12,1,28,29,22,1,21,1.32,4.55,Difficile,Difficile,0,Meme Difficulté,Pas Adapte
2168,2016,Sociologie,4,Notions de Sociologie,3,Organisation et Institution,14,1058,6,QO,0.91,0.1,8.31,2,27,29,19,2,17,1.53,10.53,Moyen,Difficile,-1,Plus Difficile,Pas Adapte
3279,2017,Sociologie,4,Notions de Sociologie,3,Organisation et Institution,14,1058,6,QO,0.19,0.35,71.35,22,9,31,23,22,1,1.35,95.65,Facile,Facile,0,Meme Difficulté,Adapte
4390,2018,Sociologie,4,Notions de Sociologie,3,Organisation et Institution,14,1058,6,QO,0.15,0.94,71.35,21,8,29,24,21,3,1.21,87.5,Facile,Facile,0,Meme Difficulté,Adapte
5501,2019,Sociologie,4,Notions de Sociologie,3,Organisation et Institution,14,1058,6,QO,0.1,0.51,71.35,18,7,25,22,18,4,1.14,81.82,Facile,Facile,0,Meme Difficulté,Adapte
6612,2020,Sociologie,4,Notions de Sociologie,3,Organisation et Institution,14,1058,6,QO,0.13,0.53,71.35,19,7,26,24,19,5,1.08,79.17,Facile,Facile,0,Meme Difficulté,Adapte
1058,2015,Sociologie,4,Notions de Sociologie,3,Organisation et Institution,14,1059,7,QROC,0.35,0.26,60.74,16,10,26,19,16,3,1.37,84.21,Difficile,Moyen,1,Plus Facile,Pas Adapte
2169,2016,Sociologie,4,Notions de Sociologie,3,Organisation et Institution,14,1059,7,QROC,0.17,0.69,97.66,23,1,24,24,23,1,1.0,95.83,Moyen,Facile,1,Plus Facile,Pas Adapte
3280,2017,Sociologie,4,Notions de Sociologie,3,Organisation et Institution,14,1059,7,QROC,0.46,0.36,53.27,14,12,26,20,14,6,1.3,70.0,Moyen,Moyen,0,Meme Difficulté,Pas Adapte
4391,2018,Sociologie,4,Notions de Sociologie,3,Organisation et Institution,14,1059,7,QROC,0.29,0.3,64.07,14,8,22,18,14,4,1.22,77.78,Moyen,Moyen,0,Meme Difficulté,Pas Adapte
5502,2019,Sociologie,4,Notions de Sociologie,3,Organisation et Institution,14,1059,7,QROC,0.11,0.6,95.39,23,1,24,23,23,0,1.04,100.0,Difficile,Facile,2,Beaucoup plus Facile,Pas Adapte
6613,2020,Sociologie,4,Notions de Sociologie,3,Organisation et Institution,14,1059,7,QROC,0.52,0.37,59.13,14,9,23,14,14,0,1.64,100.0,Difficile,Moyen,1,Plus Facile,Pas Adapte
1059,2015,Sociologie,4,Notions de Sociologie,3,Organisation et Institution,14,1060,8,QCM,0.21,0.47,48.62,9,9,18,12,9,3,1.5,75.0,Facile,Moyen,-1,Plus Difficile,Pas Adapte
2170,2016,Sociologie,4,Notions de Sociologie,3,Organisation et Institution,14,1060,8,QCM,0.28,0.43,42.17,8,12,20,8,8,0,2.5,100.0,Moyen,Moyen,0,Meme Difficulté,Pas Adapte
3281,2017,Sociologie,4,Notions de Sociologie,3,Organisation et Institution,14,1060,8,QCM,0.2,0.7,66.27,13,6,19,17,13,4,1.12,76.47,Moyen,Facile,1,Plus Facile,Adapte
4392,2018,Sociologie,4,Notions de Sociologie,3,Organisation et Institution,14,1060,8,QCM,0.14,0.82,66.27,13,7,20,20,13,7,1.0,65.0,Facile,Facile,0,Meme Difficulté,Adapte
5503,2019,Sociologie,4,Notions de Sociologie,3,Organisation et Institution,14,1060,8,QCM,0.16,0.89,66.27,15,8,23,21,15,6,1.1,71.43,Facile,Facile,0,Meme Difficulté,Adapte
6614,2020,Sociologie,4,Notions de Sociologie,3,Organisation et Institution,14,1060,8,QCM,0.04,0.93,66.27,17,9,26,18,17,1,1.44,94.44,Facile,Facile,0,Meme Difficulté,Adapte
1060,2015,Sociologie,4,Notions de Sociologie,3,Organisation et Institution,14,1061,9,QROC,0.16,0.95,85.37,72,12,84,75,72,3,1.12,96.0,Moyen,Facile,1,Plus Facile,Pas Adapte
2171,2016,Sociologie,4,Notions de Sociologie,3,Organisation et Institution,14,1061,9,QROC,0.87,0.12,11.71,10,73,83,44,10,34,1.89,22.73,Moyen,Difficile,-1,Plus Difficile,Pas Adapte
3282,2017,Sociologie,4,Notions de Sociologie,3,Organisation et Institution,14,1061,9,QROC,0.05,0.72,93.88,70,5,75,74,70,4,1.01,94.59,Moyen,Facile,1,Plus Facile,Pas Adapte
4393,2018,Sociologie,4,Notions de Sociologie,3,Organisation et Institution,14,1061,9,QROC,0.97,0.06,13.02,11,75,86,69,11,58,1.25,15.94,Difficile,Difficile,0,Meme Difficulté,Pas Adapte
5504,2019,Sociologie,4,Notions de Sociologie,3,Organisation et Institution,14,1061,9,QROC,0.82,0.17,8.99,7,68,75,55,7,48,1.36,12.73,Difficile,Difficile,0,Meme Difficulté,Pas Adapte
6615,2020,Sociologie,4,Notions de Sociologie,3,Organisation et Institution,14,1061,9,QROC,0.48,0.35,49.86,40,41,81,67,40,27,1.21,59.7,Facile,Moyen,-1,Plus Difficile,Pas Adapte
1061,2015,Sociologie,4,Notions de Sociologie,3,Organisation et Institution,14,1062,10,QCM,0.4,0.48,59.53,12,8,20,20,12,8,1.0,60.0,Difficile,Moyen,1,Plus Facile,Pas Adapte
2172,2016,Sociologie,4,Notions de Sociologie,3,Organisation et Institution,14,1062,10,QROC,0.81,0.09,22.62,5,16,21,13,5,8,1.62,38.46,Facile,Difficile,-2,Beaucoup plus Difficile,Pas Adapte
3283,2017,Sociologie,4,Notions de Sociologie,3,Organisation et Institution,14,1062,10,QROC,0.18,0.89,83.48,18,4,22,21,18,3,1.05,85.71,Difficile,Facile,2,Beaucoup plus Facile,Pas Adapte
4394,2018,Sociologie,4,Notions de Sociologie,3,Organisation et Institution,14,1062,10,QROC,0.02,0.95,77.04,15,5,20,20,15,5,1.0,75.0,Facile,Facile,0,Meme Difficulté,Pas Adapte
5505,2019,Sociologie,4,Notions de Sociologie,3,Organisation et Institution,14,1062,10,QO,0.02,0.34,85.92,18,3,21,19,18,1,1.11,94.74,Moyen,Facile,1,Plus Facile,Pas Adapte
6616,2020,Sociologie,4,Notions de Sociologie,3,Organisation et Institution,14,1062,10,QROC,0.47,0.34,36.62,7,12,19,14,7,7,1.36,50.0,Facile,Moyen,-1,Plus Difficile,Pas Adapte
1062,2015,Sociologie,4,Notions de Sociologie,3,Organisation et Institution,14,1063,11,QCU,0.54,0.23,14.35,5,30,35,15,5,10,2.33,33.33,Facile,Difficile,-2,Beaucoup plus Difficile,Pas Adapte
2173,2016,Sociologie,4,Notions de Sociologie,3,Organisation et Institution,14,1063,11,QCU,0.53,0.3,4.37,2,35,37,20,2,18,1.85,10.0,Moyen,Difficile,-1,Plus Difficile,Pas Adapte
3284,2017,Sociologie,4,Notions de Sociologie,3,Organisation et Institution,14,1063,11,QCU,0.06,0.84,79.69,28,7,35,32,28,4,1.09,87.5,Moyen,Facile,1,Plus Facile,Pas Adapte
4395,2018,Sociologie,4,Notions de Sociologie,3,Organisation et Institution,14,1063,11,QCU,0.17,0.84,91.95,29,3,32,31,29,2,1.03,93.55,Moyen,Facile,1,Plus Facile,Pas Adapte
5506,2019,Sociologie,4,Notions de Sociologie,3,Organisation et Institution,14,1063,11,QCU,0.07,0.8,72.4,26,10,36,26,26,0,1.38,100.0,Difficile,Facile,2,Beaucoup plus Facile,Adapte
6617,2020,Sociologie,4,Notions de Sociologie,3,Organisation et Institution,14,1063,11,QCU,0.13,0.84,72.4,26,10,36,29,26,3,1.24,89.66,Facile,Facile,0,Meme Difficulté,Adapte
1063,2015,Sociologie,4,Notions de Sociologie,3,Organisation et Institution,14,1064,12,QCM,0.46,0.47,38.14,14,22,36,22,14,8,1.64,63.64,Difficile,Moyen,1,Plus Facile,Pas Adapte
2174,2016,Sociologie,4,Notions de Sociologie,3,Organisation et Institution,14,1064,12,QCM,0.1,0.74,80.32,32,8,40,38,32,6,1.05,84.21,Difficile,Facile,2,Beaucoup plus Facile,Pas Adapte
3285,2017,Sociologie,4,Notions de Sociologie,3,Organisation et Institution,14,1064,12,QCM,0.08,0.75,76.71,30,9,39,33,30,3,1.18,90.91,Difficile,Facile,2,Beaucoup plus Facile,Pas Adapte
4396,2018,Sociologie,4,Notions de Sociologie,3,Organisation et Institution,14,1064,12,QCM,0.07,0.8,91.41,34,3,37,36,34,2,1.03,94.44,Moyen,Facile,1,Plus Facile,Pas Adapte
5507,2019,Sociologie,4,Notions de Sociologie,3,Organisation et Institution,14,1064,12,QCM,0.09,0.85,65.48,24,13,37,25,24,1,1.48,96.0,Difficile,Facile,2,Beaucoup plus Facile,Adapte
6618,2020,Sociologie,4,Notions de Sociologie,3,Organisation et Institution,14,1064,12,QROC,0.05,0.4,65.48,21,11,32,30,21,9,1.07,70.0,Facile,Facile,0,Meme Difficulté,Adapte
1064,2015,Sociologie,4,Notions de Sociologie,3,Organisation et Institution,14,1065,13,QCU,0.17,0.9,70.38,53,22,75,73,53,20,1.03,72.6,Moyen,Facile,1,Plus Facile,Adapte
2175,2016,Sociologie,4,Notions de Sociologie,3,Organisation et Institution,14,1065,13,QCM,0.01,0.73,70.38,52,22,74,71,52,19,1.04,73.24,Facile,Facile,0,Meme Difficulté,Adapte
3286,2017,Sociologie,4,Notions de Sociologie,3,Organisation et Institution,14,1065,13,QCM,0.14,0.97,70.38,55,23,78,73,55,18,1.07,75.34,Facile,Facile,0,Meme Difficulté,Adapte
4397,2018,Sociologie,4,Notions de Sociologie,3,Organisation et Institution,14,1065,13,QROC,0.07,0.63,70.38,48,20,68,50,48,2,1.36,96.0,Facile,Facile,0,Meme Difficulté,Adapte
5508,2019,Sociologie,4,Notions de Sociologie,3,Organisation et Institution,14,1065,13,QROC,0.1,0.8,70.38,53,22,75,61,53,8,1.23,86.89,Facile,Facile,0,Meme Difficulté,Adapte
6619,2020,Sociologie,4,Notions de Sociologie,3,Organisation et Institution,14,1065,13,QROC,0.12,0.74,70.38,46,19,65,54,46,8,1.2,85.19,Facile,Facile,0,Meme Difficulté,Adapte
1065,2015,Sociologie,4,Notions de Sociologie,3,Organisation et Institution,14,1066,14,QCU,0.69,0.21,7.77,6,68,74,63,6,57,1.17,9.52,Difficile,Difficile,0,Meme Difficulté,Pas Adapte
2176,2016,Sociologie,4,Notions de Sociologie,3,Organisation et Institution,14,1066,14,QCU,0.09,0.9,89.84,66,8,74,73,66,7,1.01,90.41,Moyen,Facile,1,Plus Facile,Pas Adapte
3287,2017,Sociologie,4,Notions de Sociologie,3,Organisation et Institution,14,1066,14,QROC,0.25,0.36,59.1,47,33,80,47,47,0,1.7,100.0,Difficile,Moyen,1,Plus Facile,Pas Adapte
4398,2018,Sociologie,4,Notions de Sociologie,3,Organisation et Institution,14,1066,14,QO,0.75,0.06,1.5,1,84,85,67,1,66,1.27,1.49,Difficile,Difficile,0,Meme Difficulté,Pas Adapte
5509,2019,Sociologie,4,Notions de Sociologie,3,Organisation et Institution,14,1066,14,QO,0.75,0.09,33.42,29,59,88,84,29,55,1.05,34.52,Facile,Difficile,-2,Beaucoup plus Difficile,Pas Adapte
6620,2020,Sociologie,4,Notions de Sociologie,3,Organisation et Institution,14,1066,14,QO,0.65,0.26,61.27,53,34,87,71,53,18,1.23,74.65,Difficile,Moyen,1,Plus Facile,Pas Adapte
1066,2015,Sociologie,4,Notions de Sociologie,4,La Socialisation,7,1067,1,QCU,0.06,0.9,81.25,26,6,32,29,26,3,1.1,89.66,Facile,Facile,0,Meme Difficulté,Pas Adapte
2177,2016,Sociologie,4,Notions de Sociologie,4,La Socialisation,7,1067,1,QCU,0.1,0.97,93.08,29,2,31,31,29,2,1.0,93.55,Facile,Facile,0,Meme Difficulté,Pas Adapte
3288,2017,Sociologie,4,Notions de Sociologie,4,La Socialisation,7,1067,1,QCU,0.58,0.37,29.47,9,20,29,21,9,12,1.38,42.86,Difficile,Difficile,0,Meme Difficulté,Pas Adapte
4399,2018,Sociologie,4,Notions de Sociologie,4,La Socialisation,7,1067,1,QROC,0.35,0.29,51.75,17,15,32,22,17,5,1.45,77.27,Difficile,Moyen,1,Plus Facile,Pas Adapte
5510,2019,Sociologie,4,Notions de Sociologie,4,La Socialisation,7,1067,1,QROC,0.08,0.79,84.09,30,6,36,31,30,1,1.16,96.77,Moyen,Facile,1,Plus Facile,Pas Adapte
6621,2020,Sociologie,4,Notions de Sociologie,4,La Socialisation,7,1067,1,QO,0.98,0.06,10.68,4,31,35,22,4,18,1.59,18.18,Facile,Difficile,-2,Beaucoup plus Difficile,Pas Adapte
1067,2015,Sociologie,4,Notions de Sociologie,4,La Socialisation,7,1068,2,QCM,0.39,0.63,56.84,7,5,12,9,7,2,1.33,77.78,Moyen,Moyen,0,Meme Difficulté,Pas Adapte
2178,2016,Sociologie,4,Notions de Sociologie,4,La Socialisation,7,1068,2,QCM,0.45,0.33,41.67,5,7,12,10,5,5,1.2,50.0,Facile,Moyen,-1,Plus Difficile,Pas Adapte
3289,2017,Sociologie,4,Notions de Sociologie,4,La Socialisation,7,1068,2,QCM,0.21,0.53,40.01,5,8,13,12,5,7,1.08,41.67,Difficile,Moyen,1,Plus Facile,Pas Adapte
4400,2018,Sociologie,4,Notions de Sociologie,4,La Socialisation,7,1068,2,QCM,0.73,0.3,18.22,2,10,12,12,2,10,1.0,16.67,Facile,Difficile,-2,Beaucoup plus Difficile,Pas Adapte
5511,2019,Sociologie,4,Notions de Sociologie,4,La Socialisation,7,1068,2,QCM,0.14,0.91,73.0,10,4,14,14,10,4,1.0,71.43,Facile,Facile,0,Meme Difficulté,Adapte
6622,2020,Sociologie,4,Notions de Sociologie,4,La Socialisation,7,1068,2,QCM,0.08,0.89,73.0,9,3,12,11,9,2,1.09,81.82,Facile,Facile,0,Meme Difficulté,Adapte
1068,2015,Sociologie,4,Notions de Sociologie,4,La Socialisation,7,1069,3,QCM,0.64,0.25,13.54,2,12,14,14,2,12,1.0,14.29,Moyen,Difficile,-1,Plus Difficile,Pas Adapte
2179,2016,Sociologie,4,Notions de Sociologie,4,La Socialisation,7,1069,3,QCM,0.09,0.83,77.03,12,4,16,13,12,1,1.23,92.31,Difficile,Facile,2,Beaucoup plus Facile,Pas Adapte
3290,2017,Sociologie,4,Notions de Sociologie,4,La Socialisation,7,1069,3,QCM,0.58,0.25,21.95,4,12,16,9,4,5,1.78,44.44,Difficile,Difficile,0,Meme Difficulté,Pas Adapte
4401,2018,Sociologie,4,Notions de Sociologie,4,La Socialisation,7,1069,3,QO,0.84,0.11,21.3,3,12,15,8,3,5,1.88,37.5,Difficile,Difficile,0,Meme Difficulté,Pas Adapte
5512,2019,Sociologie,4,Notions de Sociologie,4,La Socialisation,7,1069,3,QO,0.95,0.14,31.24,5,10,15,12,5,7,1.25,41.67,Moyen,Difficile,-1,Plus Difficile,Pas Adapte
6623,2020,Sociologie,4,Notions de Sociologie,4,La Socialisation,7,1069,3,QO,0.45,0.28,41.99,6,9,15,11,6,5,1.36,54.55,Facile,Moyen,-1,Plus Difficile,Pas Adapte
1069,2015,Sociologie,4,Notions de Sociologie,4,La Socialisation,7,1070,4,QCU,0.64,0.2,13.85,2,13,15,5,2,3,3.0,40.0,Difficile,Difficile,0,Meme Difficulté,Pas Adapte
2180,2016,Sociologie,4,Notions de Sociologie,4,La Socialisation,7,1070,4,QCU,0.32,0.57,42.43,6,8,14,10,6,4,1.4,60.0,Difficile,Moyen,1,Plus Facile,Pas Adapte
3291,2017,Sociologie,4,Notions de Sociologie,4,La Socialisation,7,1070,4,QCU,0.45,0.27,17.28,2,10,12,10,2,8,1.2,20.0,Moyen,Difficile,-1,Plus Difficile,Pas Adapte
4402,2018,Sociologie,4,Notions de Sociologie,4,La Socialisation,7,1070,4,QCU,0.16,0.85,68.85,8,3,11,10,8,2,1.1,80.0,Difficile,Facile,2,Beaucoup plus Facile,Adapte
5513,2019,Sociologie,4,Notions de Sociologie,4,La Socialisation,7,1070,4,QCU,0.04,0.79,68.85,7,3,10,9,7,2,1.11,77.78,Facile,Facile,0,Meme Difficulté,Adapte
6624,2020,Sociologie,4,Notions de Sociologie,4,La Socialisation,7,1070,4,QCU,0.03,1.0,68.85,7,3,10,9,7,2,1.11,77.78,Facile,Facile,0,Meme Difficulté,Adapte
1070,2015,Sociologie,4,Notions de Sociologie,4,La Socialisation,7,1071,5,QO,0.91,0.02,17.56,16,75,91,70,16,54,1.3,22.86,Difficile,Difficile,0,Meme Difficulté,Pas Adapte
2181,2016,Sociologie,4,Notions de Sociologie,4,La Socialisation,7,1071,5,QO,0.08,0.43,77.67,60,17,77,71,60,11,1.08,84.51,Moyen,Facile,1,Plus Facile,Pas Adapte
3292,2017,Sociologie,4,Notions de Sociologie,4,La Socialisation,7,1071,5,QO,0.16,0.87,73.33,64,23,87,66,64,2,1.32,96.97,Moyen,Facile,1,Plus Facile,Adapte
4403,2018,Sociologie,4,Notions de Sociologie,4,La Socialisation,7,1071,5,QO,0.0,0.63,73.33,70,26,96,78,70,8,1.23,89.74,Facile,Facile,0,Meme Difficulté,Adapte
5514,2019,Sociologie,4,Notions de Sociologie,4,La Socialisation,7,1071,5,QO,0.15,0.67,73.33,60,22,82,77,60,17,1.06,77.92,Facile,Facile,0,Meme Difficulté,Adapte
6625,2020,Sociologie,4,Notions de Sociologie,4,La Socialisation,7,1071,5,QO,0.05,0.79,73.33,68,25,93,71,68,3,1.31,95.77,Facile,Facile,0,Meme Difficulté,Adapte
1071,2015,Sociologie,4,Notions de Sociologie,4,La Socialisation,7,1072,6,QCM,0.06,0.81,72.21,59,23,82,79,59,20,1.04,74.68,Facile,Facile,0,Meme Difficulté,Adapte
2182,2016,Sociologie,4,Notions de Sociologie,4,La Socialisation,7,1072,6,QO,0.0,0.84,72.21,67,26,93,92,67,25,1.01,72.83,Facile,Facile,0,Meme Difficulté,Adapte
3293,2017,Sociologie,4,Notions de Sociologie,4,La Socialisation,7,1072,6,QO,0.1,0.62,72.21,73,28,101,92,73,19,1.1,79.35,Facile,Facile,0,Meme Difficulté,Adapte
4404,2018,Sociologie,4,Notions de Sociologie,4,La Socialisation,7,1072,6,QO,0.19,0.55,72.21,83,32,115,113,83,30,1.02,73.45,Facile,Facile,0,Meme Difficulté,Adapte
5515,2019,Sociologie,4,Notions de Sociologie,4,La Socialisation,7,1072,6,QROC,0.15,0.45,72.21,92,35,127,117,92,25,1.09,78.63,Facile,Facile,0,Meme Difficulté,Adapte
6626,2020,Sociologie,4,Notions de Sociologie,4,La Socialisation,7,1072,6,QROC,0.01,0.7,72.21,100,38,138,135,100,35,1.02,74.07,Facile,Facile,0,Meme Difficulté,Adapte
1072,2015,Sociologie,4,Notions de Sociologie,4,La Socialisation,7,1073,7,QCM,0.62,0.16,23.87,2,7,9,7,2,5,1.29,28.57,Facile,Difficile,-2,Beaucoup plus Difficile,Pas Adapte
2183,2016,Sociologie,4,Notions de Sociologie,4,La Socialisation,7,1073,7,QCM,0.52,0.27,25.38,3,7,10,7,3,4,1.43,42.86,Difficile,Difficile,0,Meme Difficulté,Pas Adapte
3294,2017,Sociologie,4,Notions de Sociologie,4,La Socialisation,7,1073,7,QCM,0.05,0.96,67.65,8,4,12,12,8,4,1.0,66.67,Facile,Facile,0,Meme Difficulté,Adapte
4405,2018,Sociologie,4,Notions de Sociologie,4,La Socialisation,7,1073,7,QCM,0.18,0.91,67.65,9,4,13,11,9,2,1.18,81.82,Facile,Facile,0,Meme Difficulté,Adapte
5516,2019,Sociologie,4,Notions de Sociologie,4,La Socialisation,7,1073,7,QCM,0.04,0.97,67.65,9,4,13,10,9,1,1.3,90.0,Facile,Facile,0,Meme Difficulté,Adapte
6627,2020,Sociologie,4,Notions de Sociologie,4,La Socialisation,7,1073,7,QCM,0.14,0.74,67.65,10,5,15,12,10,2,1.25,83.33,Facile,Facile,0,Meme Difficulté,Adapte
1073,2015,Sociologie,4,Notions de Sociologie,5,Au-dela de l'Idee de Societe,8,1074,1,QCM,0.31,0.55,41.36,11,15,26,24,11,13,1.08,45.83,Difficile,Moyen,1,Plus Facile,Pas Adapte
2184,2016,Sociologie,4,Notions de Sociologie,5,Au-dela de l'Idee de Societe,8,1074,1,QCU,0.63,0.32,6.39,1,22,23,17,1,16,1.35,5.88,Difficile,Difficile,0,Meme Difficulté,Pas Adapte
3295,2017,Sociologie,4,Notions de Sociologie,5,Au-dela de l'Idee de Societe,8,1074,1,QCU,0.53,0.39,16.36,4,22,26,21,4,17,1.24,19.05,Difficile,Difficile,0,Meme Difficulté,Pas Adapte
4406,2018,Sociologie,4,Notions de Sociologie,5,Au-dela de l'Idee de Societe,8,1074,1,QCU,0.22,0.44,59.62,14,10,24,18,14,4,1.33,77.78,Difficile,Moyen,1,Plus Facile,Pas Adapte
5517,2019,Sociologie,4,Notions de Sociologie,5,Au-dela de l'Idee de Societe,8,1074,1,QCU,0.29,0.42,35.28,7,13,20,18,7,11,1.11,38.89,Difficile,Moyen,1,Plus Facile,Pas Adapte
6628,2020,Sociologie,4,Notions de Sociologie,5,Au-dela de l'Idee de Societe,8,1074,1,QROC,0.09,0.98,69.38,13,6,19,17,13,4,1.12,76.47,Moyen,Facile,1,Plus Facile,Adapte
1074,2015,Sociologie,4,Notions de Sociologie,5,Au-dela de l'Idee de Societe,8,1075,2,QCM,0.21,0.67,45.64,31,37,68,57,31,26,1.19,54.39,Facile,Moyen,-1,Plus Difficile,Pas Adapte
2185,2016,Sociologie,4,Notions de Sociologie,5,Au-dela de l'Idee de Societe,8,1075,2,QCM,0.17,0.77,67.94,39,19,58,42,39,3,1.38,92.86,Moyen,Facile,1,Plus Facile,Adapte
3296,2017,Sociologie,4,Notions de Sociologie,5,Au-dela de l'Idee de Societe,8,1075,2,QCM,0.17,0.72,67.94,33,16,49,33,33,0,1.48,100.0,Facile,Facile,0,Meme Difficulté,Adapte
4407,2018,Sociologie,4,Notions de Sociologie,5,Au-dela de l'Idee de Societe,8,1075,2,QCM,0.07,0.74,67.94,31,15,46,42,31,11,1.1,73.81,Facile,Facile,0,Meme Difficulté,Adapte
5518,2019,Sociologie,4,Notions de Sociologie,5,Au-dela de l'Idee de Societe,8,1075,2,QCM,0.06,0.98,67.94,31,15,46,39,31,8,1.18,79.49,Facile,Facile,0,Meme Difficulté,Adapte
6629,2020,Sociologie,4,Notions de Sociologie,5,Au-dela de l'Idee de Societe,8,1075,2,QCM,0.13,0.8,67.94,31,14,45,34,31,3,1.32,91.18,Facile,Facile,0,Meme Difficulté,Adapte
1075,2015,Sociologie,4,Notions de Sociologie,5,Au-dela de l'Idee de Societe,8,1076,3,QCM,0.27,0.47,63.43,25,15,40,27,25,2,1.48,92.59,Difficile,Moyen,1,Plus Facile,Pas Adapte
2186,2016,Sociologie,4,Notions de Sociologie,5,Au-dela de l'Idee de Societe,8,1076,3,QCM,0.73,0.18,22.19,8,28,36,36,8,28,1.0,22.22,Facile,Difficile,-2,Beaucoup plus Difficile,Pas Adapte
3297,2017,Sociologie,4,Notions de Sociologie,5,Au-dela de l'Idee de Societe,8,1076,3,QCM,0.62,0.22,22.29,7,24,31,27,7,20,1.15,25.93,Difficile,Difficile,0,Meme Difficulté,Pas Adapte
4408,2018,Sociologie,4,Notions de Sociologie,5,Au-dela de l'Idee de Societe,8,1076,3,QCM,0.6,0.26,29.59,9,20,29,24,9,15,1.21,37.5,Difficile,Difficile,0,Meme Difficulté,Pas Adapte
5519,2019,Sociologie,4,Notions de Sociologie,5,Au-dela de l'Idee de Societe,8,1076,3,QCM,0.15,0.71,71.92,18,7,25,24,18,6,1.04,75.0,Difficile,Facile,2,Beaucoup plus Facile,Adapte
6630,2020,Sociologie,4,Notions de Sociologie,5,Au-dela de l'Idee de Societe,8,1076,3,QCM,0.17,0.89,71.92,21,8,29,23,21,2,1.26,91.3,Facile,Facile,0,Meme Difficulté,Adapte
1076,2015,Sociologie,4,Notions de Sociologie,5,Au-dela de l'Idee de Societe,8,1077,4,QCU,0.23,0.53,53.59,54,46,100,82,54,28,1.22,65.85,Moyen,Moyen,0,Meme Difficulté,Pas Adapte
2187,2016,Sociologie,4,Notions de Sociologie,5,Au-dela de l'Idee de Societe,8,1077,4,QCU,0.6,0.29,34.38,32,62,94,64,32,32,1.47,50.0,Moyen,Difficile,-1,Plus Difficile,Pas Adapte
3298,2017,Sociologie,4,Notions de Sociologie,5,Au-dela de l'Idee de Societe,8,1077,4,QCU,0.1,0.97,98.05,78,2,80,78,78,0,1.03,100.0,Moyen,Facile,1,Plus Facile,Pas Adapte
4409,2018,Sociologie,4,Notions de Sociologie,5,Au-dela de l'Idee de Societe,8,1077,4,QCU,0.48,0.3,20.51,18,68,86,50,18,32,1.72,36.0,Facile,Difficile,-2,Beaucoup plus Difficile,Pas Adapte
5520,2019,Sociologie,4,Notions de Sociologie,5,Au-dela de l'Idee de Societe,8,1077,4,QCM,0.56,0.27,24.36,22,67,89,71,22,49,1.25,30.99,Difficile,Difficile,0,Meme Difficulté,Pas Adapte
6631,2020,Sociologie,4,Notions de Sociologie,5,Au-dela de l'Idee de Societe,8,1077,4,QCM,0.19,0.88,76.2,77,24,101,84,77,7,1.2,91.67,Difficile,Facile,2,Beaucoup plus Facile,Pas Adapte
1077,2015,Sociologie,4,Notions de Sociologie,5,Au-dela de l'Idee de Societe,8,1078,5,QCM,0.74,0.28,30.69,30,69,99,98,30,68,1.01,30.61,Difficile,Difficile,0,Meme Difficulté,Pas Adapte
2188,2016,Sociologie,4,Notions de Sociologie,5,Au-dela de l'Idee de Societe,8,1078,5,QCM,0.05,1.0,66.75,64,32,96,76,64,12,1.26,84.21,Facile,Facile,0,Meme Difficulté,Adapte
3299,2017,Sociologie,4,Notions de Sociologie,5,Au-dela de l'Idee de Societe,8,1078,5,QCM,0.17,0.92,66.75,67,34,101,67,67,0,1.51,100.0,Facile,Facile,0,Meme Difficulté,Adapte
4410,2018,Sociologie,4,Notions de Sociologie,5,Au-dela de l'Idee de Societe,8,1078,5,QCM,0.16,0.72,66.75,61,31,92,68,61,7,1.35,89.71,Facile,Facile,0,Meme Difficulté,Adapte
5521,2019,Sociologie,4,Notions de Sociologie,5,Au-dela de l'Idee de Societe,8,1078,5,QCM,0.06,0.88,66.75,58,29,87,64,58,6,1.36,90.62,Facile,Facile,0,Meme Difficulté,Adapte
6632,2020,Sociologie,4,Notions de Sociologie,5,Au-dela de l'Idee de Societe,8,1078,5,QCM,0.08,0.79,66.75,61,30,91,69,61,8,1.32,88.41,Facile,Facile,0,Meme Difficulté,Adapte
1078,2015,Sociologie,4,Notions de Sociologie,5,Au-dela de l'Idee de Societe,8,1079,6,QCM,0.71,0.17,29.09,26,64,90,47,26,21,1.91,55.32,Facile,Difficile,-2,Beaucoup plus Difficile,Pas Adapte
2189,2016,Sociologie,4,Notions de Sociologie,5,Au-dela de l'Idee de Societe,8,1079,6,QCM,0.02,0.85,66.46,55,28,83,59,55,4,1.41,93.22,Difficile,Facile,2,Beaucoup plus Facile,Adapte
3300,2017,Sociologie,4,Notions de Sociologie,5,Au-dela de l'Idee de Societe,8,1079,6,QCM,0.06,0.8,66.46,53,26,79,74,53,21,1.07,71.62,Facile,Facile,0,Meme Difficulté,Adapte
4411,2018,Sociologie,4,Notions de Sociologie,5,Au-dela de l'Idee de Societe,8,1079,6,QCM,0.2,0.79,66.46,47,23,70,63,47,16,1.11,74.6,Facile,Facile,0,Meme Difficulté,Adapte
5522,2019,Sociologie,4,Notions de Sociologie,5,Au-dela de l'Idee de Societe,8,1079,6,QCU,0.03,0.88,66.46,47,24,71,52,47,5,1.37,90.38,Facile,Facile,0,Meme Difficulté,Adapte
6633,2020,Sociologie,4,Notions de Sociologie,5,Au-dela de l'Idee de Societe,8,1079,6,QROC,0.17,0.7,66.46,43,21,64,46,43,3,1.39,93.48,Facile,Facile,0,Meme Difficulté,Adapte
1079,2015,Sociologie,4,Notions de Sociologie,5,Au-dela de l'Idee de Societe,8,1080,7,QCM,0.51,0.21,24.63,7,22,29,28,7,21,1.04,25.0,Difficile,Difficile,0,Meme Difficulté,Pas Adapte
2190,2016,Sociologie,4,Notions de Sociologie,5,Au-dela de l'Idee de Societe,8,1080,7,QCM,0.69,0.23,22.13,6,23,29,9,6,3,3.22,66.67,Facile,Difficile,-2,Beaucoup plus Difficile,Pas Adapte
3301,2017,Sociologie,4,Notions de Sociologie,5,Au-dela de l'Idee de Societe,8,1080,7,QCM,0.25,0.54,35.39,11,20,31,19,11,8,1.63,57.89,Facile,Moyen,-1,Plus Difficile,Pas Adapte
4412,2018,Sociologie,4,Notions de Sociologie,5,Au-dela de l'Idee de Societe,8,1080,7,QCU,0.35,0.65,39.31,11,18,29,18,11,7,1.61,61.11,Moyen,Moyen,0,Meme Difficulté,Pas Adapte
5523,2019,Sociologie,4,Notions de Sociologie,5,Au-dela de l'Idee de Societe,8,1080,7,QCM,0.52,0.24,3.54,1,24,25,14,1,13,1.79,7.14,Facile,Difficile,-2,Beaucoup plus Difficile,Pas Adapte
6634,2020,Sociologie,4,Notions de Sociologie,5,Au-dela de l'Idee de Societe,8,1080,7,QROC,0.54,0.34,39.02,9,14,23,17,9,8,1.35,52.94,Difficile,Moyen,1,Plus Facile,Pas Adapte
1080,2015,Sociologie,4,Notions de Sociologie,5,Au-dela de l'Idee de Societe,8,1081,8,QCM,0.74,0.29,31.85,18,39,57,55,18,37,1.04,32.73,Difficile,Difficile,0,Meme Difficulté,Pas Adapte
2191,2016,Sociologie,4,Notions de Sociologie,5,Au-dela de l'Idee de Societe,8,1081,8,QCM,0.18,0.87,84.25,44,8,52,50,44,6,1.04,88.0,Difficile,Facile,2,Beaucoup plus Facile,Pas Adapte
3302,2017,Sociologie,4,Notions de Sociologie,5,Au-dela de l'Idee de Societe,8,1081,8,QCM,0.28,0.58,48.26,26,28,54,49,26,23,1.1,53.06,Facile,Moyen,-1,Plus Difficile,Pas Adapte
4413,2018,Sociologie,4,Notions de Sociologie,5,Au-dela de l'Idee de Societe,8,1081,8,QCM,0.68,0.27,20.01,11,46,57,52,11,41,1.1,21.15,Moyen,Difficile,-1,Plus Difficile,Pas Adapte
5524,2019,Sociologie,4,Notions de Sociologie,5,Au-dela de l'Idee de Societe,8,1081,8,QCM,0.42,0.38,63.57,40,23,63,43,40,3,1.47,93.02,Difficile,Moyen,1,Plus Facile,Pas Adapte
6635,2020,Sociologie,4,Notions de Sociologie,5,Au-dela de l'Idee de Societe,8,1081,8,QCM,0.21,0.52,36.6,25,42,67,26,25,1,2.58,96.15,Moyen,Moyen,0,Meme Difficulté,Pas Adapte
1081,2015,Sociologie,5,Sociologie Generale,1,"Le Sociologue, la Sociologie et la Vie Sociale",9,1082,1,QCU,0.18,0.87,92.63,17,1,18,18,17,1,1.0,94.44,Moyen,Facile,1,Plus Facile,Pas Adapte
2192,2016,Sociologie,5,Sociologie Generale,1,"Le Sociologue, la Sociologie et la Vie Sociale",9,1082,1,QCU,0.7,0.25,15.36,3,17,20,17,3,14,1.18,17.65,Difficile,Difficile,0,Meme Difficulté,Pas Adapte
3303,2017,Sociologie,5,Sociologie Generale,1,"Le Sociologue, la Sociologie et la Vie Sociale",9,1082,1,QCU,0.64,0.25,15.65,4,19,23,20,4,16,1.15,20.0,Difficile,Difficile,0,Meme Difficulté,Pas Adapte
4414,2018,Sociologie,5,Sociologie Generale,1,"Le Sociologue, la Sociologie et la Vie Sociale",9,1082,1,QCU,0.2,0.89,87.55,20,3,23,23,20,3,1.0,86.96,Moyen,Facile,1,Plus Facile,Pas Adapte
5525,2019,Sociologie,5,Sociologie Generale,1,"Le Sociologue, la Sociologie et la Vie Sociale",9,1082,1,QCU,0.3,0.46,42.57,10,13,23,12,10,2,1.92,83.33,Difficile,Moyen,1,Plus Facile,Pas Adapte
6636,2020,Sociologie,5,Sociologie Generale,1,"Le Sociologue, la Sociologie et la Vie Sociale",9,1082,1,QCU,0.12,0.77,73.44,16,6,22,18,16,2,1.22,88.89,Difficile,Facile,2,Beaucoup plus Facile,Adapte
1082,2015,Sociologie,5,Sociologie Generale,1,"Le Sociologue, la Sociologie et la Vie Sociale",9,1083,2,QO,0.86,0.14,31.7,9,20,29,23,9,14,1.26,39.13,Facile,Difficile,-2,Beaucoup plus Difficile,Pas Adapte
2193,2016,Sociologie,5,Sociologie Generale,1,"Le Sociologue, la Sociologie et la Vie Sociale",9,1083,2,QO,0.77,0.01,19.59,6,24,30,19,6,13,1.58,31.58,Difficile,Difficile,0,Meme Difficulté,Pas Adapte
3304,2017,Sociologie,5,Sociologie Generale,1,"Le Sociologue, la Sociologie et la Vie Sociale",9,1083,2,QO,0.58,0.29,45.52,13,15,28,26,13,13,1.08,50.0,Difficile,Moyen,1,Plus Facile,Pas Adapte
4415,2018,Sociologie,5,Sociologie Generale,1,"Le Sociologue, la Sociologie et la Vie Sociale",9,1083,2,QO,0.84,0.1,33.48,10,19,29,23,10,13,1.26,43.48,Facile,Difficile,-2,Beaucoup plus Difficile,Pas Adapte
5526,2019,Sociologie,5,Sociologie Generale,1,"Le Sociologue, la Sociologie et la Vie Sociale",9,1083,2,QO,0.12,0.48,87.2,22,3,25,24,22,2,1.04,91.67,Difficile,Facile,2,Beaucoup plus Facile,Pas Adapte
6637,2020,Sociologie,5,Sociologie Generale,1,"Le Sociologue, la Sociologie et la Vie Sociale",9,1083,2,QO,0.17,0.6,70.31,20,8,28,26,20,6,1.08,76.92,Facile,Facile,0,Meme Difficulté,Adapte
1083,2015,Sociologie,5,Sociologie Generale,1,"Le Sociologue, la Sociologie et la Vie Sociale",9,1084,3,QCM,0.15,0.95,92.06,27,2,29,27,27,0,1.07,100.0,Difficile,Facile,2,Beaucoup plus Facile,Pas Adapte
2194,2016,Sociologie,5,Sociologie Generale,1,"Le Sociologue, la Sociologie et la Vie Sociale",9,1084,3,QCM,0.47,0.31,45.28,13,16,29,18,13,5,1.61,72.22,Difficile,Moyen,1,Plus Facile,Pas Adapte
3305,2017,Sociologie,5,Sociologie Generale,1,"Le Sociologue, la Sociologie et la Vie Sociale",9,1084,3,QCM,0.38,0.34,44.33,14,17,31,26,14,12,1.19,53.85,Moyen,Moyen,0,Meme Difficulté,Pas Adapte
4416,2018,Sociologie,5,Sociologie Generale,1,"Le Sociologue, la Sociologie et la Vie Sociale",9,1084,3,QROC,0.41,0.3,60.73,17,11,28,23,17,6,1.22,73.91,Moyen,Moyen,0,Meme Difficulté,Pas Adapte
5527,2019,Sociologie,5,Sociologie Generale,1,"Le Sociologue, la Sociologie et la Vie Sociale",9,1084,3,QROC,0.05,0.99,92.17,22,2,24,24,22,2,1.0,91.67,Moyen,Facile,1,Plus Facile,Pas Adapte
6638,2020,Sociologie,5,Sociologie Generale,1,"Le Sociologue, la Sociologie et la Vie Sociale",9,1084,3,QROC,0.09,1.0,74.95,16,5,21,21,16,5,1.0,76.19,Moyen,Facile,1,Plus Facile,Adapte
1084,2015,Sociologie,5,Sociologie Generale,1,"Le Sociologue, la Sociologie et la Vie Sociale",9,1085,4,QCU,0.27,0.55,60.1,50,34,84,63,50,13,1.33,79.37,Facile,Moyen,-1,Plus Difficile,Pas Adapte
2195,2016,Sociologie,5,Sociologie Generale,1,"Le Sociologue, la Sociologie et la Vie Sociale",9,1085,4,QO,0.14,0.64,67.68,62,29,91,69,62,7,1.32,89.86,Difficile,Facile,2,Beaucoup plus Facile,Adapte
3306,2017,Sociologie,5,Sociologie Generale,1,"Le Sociologue, la Sociologie et la Vie Sociale",9,1085,4,QROC,0.12,0.67,67.68,66,31,97,90,66,24,1.08,73.33,Facile,Facile,0,Meme Difficulté,Adapte
4417,2018,Sociologie,5,Sociologie Generale,1,"Le Sociologue, la Sociologie et la Vie Sociale",9,1085,4,QROC,0.14,0.53,67.68,58,28,86,80,58,22,1.07,72.5,Facile,Facile,0,Meme Difficulté,Adapte
5528,2019,Sociologie,5,Sociologie Generale,1,"Le Sociologue, la Sociologie et la Vie Sociale",9,1085,4,QROC,0.02,0.42,67.68,66,31,97,70,66,4,1.39,94.29,Facile,Facile,0,Meme Difficulté,Adapte
6639,2020,Sociologie,5,Sociologie Generale,1,"Le Sociologue, la Sociologie et la Vie Sociale",9,1085,4,QROC,0.17,0.65,67.68,59,28,87,73,59,14,1.19,80.82,Facile,Facile,0,Meme Difficulté,Adapte
1085,2015,Sociologie,5,Sociologie Generale,1,"Le Sociologue, la Sociologie et la Vie Sociale",9,1086,5,QCU,0.58,0.36,14.46,12,71,83,64,12,52,1.3,18.75,Facile,Difficile,-2,Beaucoup plus Difficile,Pas Adapte
2196,2016,Sociologie,5,Sociologie Generale,1,"Le Sociologue, la Sociologie et la Vie Sociale",9,1086,5,QCU,0.53,0.25,19.27,14,57,71,53,14,39,1.34,26.42,Facile,Difficile,-2,Beaucoup plus Difficile,Pas Adapte
3307,2017,Sociologie,5,Sociologie Generale,1,"Le Sociologue, la Sociologie et la Vie Sociale",9,1086,5,QCU,0.21,0.54,55.35,37,29,66,65,37,28,1.02,56.92,Moyen,Moyen,0,Meme Difficulté,Pas Adapte
4418,2018,Sociologie,5,Sociologie Generale,1,"Le Sociologue, la Sociologie et la Vie Sociale",9,1086,5,QCU,0.38,0.44,39.95,25,37,62,28,25,3,2.21,89.29,Moyen,Moyen,0,Meme Difficulté,Pas Adapte
5529,2019,Sociologie,5,Sociologie Generale,1,"Le Sociologue, la Sociologie et la Vie Sociale",9,1086,5,QROC,0.08,0.85,89.57,48,6,54,49,48,1,1.1,97.96,Difficile,Facile,2,Beaucoup plus Facile,Pas Adapte
6640,2020,Sociologie,5,Sociologie Generale,1,"Le Sociologue, la Sociologie et la Vie Sociale",9,1086,5,QO,0.51,0.17,51.34,31,29,60,45,31,14,1.33,68.89,Moyen,Moyen,0,Meme Difficulté,Pas Adapte
1086,2015,Sociologie,5,Sociologie Generale,1,"Le Sociologue, la Sociologie et la Vie Sociale",9,1087,6,QCM,0.71,0.25,14.6,5,26,31,17,5,12,1.82,29.41,Difficile,Difficile,0,Meme Difficulté,Pas Adapte
2197,2016,Sociologie,5,Sociologie Generale,1,"Le Sociologue, la Sociologie et la Vie Sociale",9,1087,6,QCM,0.76,0.16,28.57,7,19,26,14,7,7,1.86,50.0,Facile,Difficile,-2,Beaucoup plus Difficile,Pas Adapte
3308,2017,Sociologie,5,Sociologie Generale,1,"Le Sociologue, la Sociologie et la Vie Sociale",9,1087,6,QCM,0.68,0.21,31.41,8,17,25,23,8,15,1.09,34.78,Moyen,Difficile,-1,Plus Difficile,Pas Adapte
4419,2018,Sociologie,5,Sociologie Generale,1,"Le Sociologue, la Sociologie et la Vie Sociale",9,1087,6,QCM,0.69,0.18,9.46,2,21,23,11,2,9,2.09,18.18,Facile,Difficile,-2,Beaucoup plus Difficile,Pas Adapte
5530,2019,Sociologie,5,Sociologie Generale,1,"Le Sociologue, la Sociologie et la Vie Sociale",9,1087,6,QCU,0.59,0.31,22.05,5,16,21,9,5,4,2.33,55.56,Moyen,Difficile,-1,Plus Difficile,Pas Adapte
6641,2020,Sociologie,5,Sociologie Generale,1,"Le Sociologue, la Sociologie et la Vie Sociale",9,1087,6,QCU,0.52,0.29,17.73,4,20,24,10,4,6,2.4,40.0,Moyen,Difficile,-1,Plus Difficile,Pas Adapte
1087,2015,Sociologie,5,Sociologie Generale,1,"Le Sociologue, la Sociologie et la Vie Sociale",9,1088,7,QCM,0.14,0.8,66.96,54,27,81,62,54,8,1.31,87.1,Facile,Facile,0,Meme Difficulté,Adapte
2198,2016,Sociologie,5,Sociologie Generale,1,"Le Sociologue, la Sociologie et la Vie Sociale",9,1088,7,QCM,0.15,0.76,66.96,58,28,86,84,58,26,1.02,69.05,Facile,Facile,0,Meme Difficulté,Adapte
3309,2017,Sociologie,5,Sociologie Generale,1,"Le Sociologue, la Sociologie et la Vie Sociale",9,1088,7,QCM,0.05,0.85,66.96,65,32,97,66,65,1,1.47,98.48,Facile,Facile,0,Meme Difficulté,Adapte
4420,2018,Sociologie,5,Sociologie Generale,1,"Le Sociologue, la Sociologie et la Vie Sociale",9,1088,7,QCM,0.16,0.94,66.96,56,27,83,62,56,6,1.34,90.32,Facile,Facile,0,Meme Difficulté,Adapte
5531,2019,Sociologie,5,Sociologie Generale,1,"Le Sociologue, la Sociologie et la Vie Sociale",9,1088,7,QCM,0.14,0.7,66.96,61,30,91,72,61,11,1.26,84.72,Facile,Facile,0,Meme Difficulté,Adapte
6642,2020,Sociologie,5,Sociologie Generale,1,"Le Sociologue, la Sociologie et la Vie Sociale",9,1088,7,QCM,0.01,0.91,66.96,60,30,90,63,60,3,1.43,95.24,Facile,Facile,0,Meme Difficulté,Adapte
1088,2015,Sociologie,5,Sociologie Generale,1,"Le Sociologue, la Sociologie et la Vie Sociale",9,1089,8,QROC,0.2,0.87,70.95,57,24,81,73,57,16,1.11,78.08,Facile,Facile,0,Meme Difficulté,Adapte
2199,2016,Sociologie,5,Sociologie Generale,1,"Le Sociologue, la Sociologie et la Vie Sociale",9,1089,8,QCM,0.1,0.83,70.95,60,25,85,69,60,9,1.23,86.96,Facile,Facile,0,Meme Difficulté,Adapte
3310,2017,Sociologie,5,Sociologie Generale,1,"Le Sociologue, la Sociologie et la Vie Sociale",9,1089,8,QCM,0.08,0.72,70.95,65,27,92,73,65,8,1.26,89.04,Facile,Facile,0,Meme Difficulté,Adapte
4421,2018,Sociologie,5,Sociologie Generale,1,"Le Sociologue, la Sociologie et la Vie Sociale",9,1089,8,QCM,0.14,0.76,70.95,57,23,80,66,57,9,1.21,86.36,Facile,Facile,0,Meme Difficulté,Adapte
5532,2019,Sociologie,5,Sociologie Generale,1,"Le Sociologue, la Sociologie et la Vie Sociale",9,1089,8,QCM,0.01,0.97,70.95,64,26,90,76,64,12,1.18,84.21,Facile,Facile,0,Meme Difficulté,Adapte
6643,2020,Sociologie,5,Sociologie Generale,1,"Le Sociologue, la Sociologie et la Vie Sociale",9,1089,8,QCM,0.18,0.7,70.95,69,28,97,81,69,12,1.2,85.19,Facile,Facile,0,Meme Difficulté,Adapte
1089,2015,Sociologie,5,Sociologie Generale,1,"Le Sociologue, la Sociologie et la Vie Sociale",9,1090,9,QCU,0.02,0.85,73.67,62,22,84,65,62,3,1.29,95.38,Difficile,Facile,2,Beaucoup plus Facile,Adapte
2200,2016,Sociologie,5,Sociologie Generale,1,"Le Sociologue, la Sociologie et la Vie Sociale",9,1090,9,QCU,0.19,0.82,73.67,60,21,81,72,60,12,1.12,83.33,Facile,Facile,0,Meme Difficulté,Adapte
3311,2017,Sociologie,5,Sociologie Generale,1,"Le Sociologue, la Sociologie et la Vie Sociale",9,1090,9,QCU,0.17,0.98,73.67,60,22,82,75,60,15,1.09,80.0,Facile,Facile,0,Meme Difficulté,Adapte
4422,2018,Sociologie,5,Sociologie Generale,1,"Le Sociologue, la Sociologie et la Vie Sociale",9,1090,9,QROC,0.1,0.98,73.67,57,20,77,63,57,6,1.22,90.48,Facile,Facile,0,Meme Difficulté,Adapte
5533,2019,Sociologie,5,Sociologie Generale,1,"Le Sociologue, la Sociologie et la Vie Sociale",9,1090,9,QROC,0.04,0.71,73.67,61,22,83,70,61,9,1.19,87.14,Facile,Facile,0,Meme Difficulté,Adapte
6644,2020,Sociologie,5,Sociologie Generale,1,"Le Sociologue, la Sociologie et la Vie Sociale",9,1090,9,QO,0.07,0.42,73.67,55,19,74,66,55,11,1.12,83.33,Facile,Facile,0,Meme Difficulté,Adapte
1090,2015,Sociologie,5,Sociologie Generale,2,La Theorie Sociologique,6,1091,1,QCM,0.1,0.77,89.25,30,4,34,33,30,3,1.03,90.91,Difficile,Facile,2,Beaucoup plus Facile,Pas Adapte
2201,2016,Sociologie,5,Sociologie Generale,2,La Theorie Sociologique,6,1091,1,QCM,0.14,0.88,84.5,29,5,34,33,29,4,1.03,87.88,Moyen,Facile,1,Plus Facile,Pas Adapte
3312,2017,Sociologie,5,Sociologie Generale,2,La Theorie Sociologique,6,1091,1,QCM,0.28,0.54,42.22,13,18,31,15,13,2,2.07,86.67,Difficile,Moyen,1,Plus Facile,Pas Adapte
4423,2018,Sociologie,5,Sociologie Generale,2,La Theorie Sociologique,6,1091,1,QCM,0.11,0.94,98.46,35,1,36,35,35,0,1.03,100.0,Difficile,Facile,2,Beaucoup plus Facile,Pas Adapte
5534,2019,Sociologie,5,Sociologie Generale,2,La Theorie Sociologique,6,1091,1,QCM,0.62,0.25,32.76,13,26,39,29,13,16,1.34,44.83,Difficile,Difficile,0,Meme Difficulté,Pas Adapte
6645,2020,Sociologie,5,Sociologie Generale,2,La Theorie Sociologique,6,1091,1,QCM,0.13,0.92,79.48,31,8,39,33,31,2,1.18,93.94,Moyen,Facile,1,Plus Facile,Pas Adapte
1091,2015,Sociologie,5,Sociologie Generale,2,La Theorie Sociologique,6,1092,2,QROC,0.79,0.17,19.08,3,14,17,15,3,12,1.13,20.0,Moyen,Difficile,-1,Plus Difficile,Pas Adapte
2202,2016,Sociologie,5,Sociologie Generale,2,La Theorie Sociologique,6,1092,2,QROC,0.08,0.48,66.35,9,5,14,10,9,1,1.4,90.0,Difficile,Facile,2,Beaucoup plus Facile,Adapte
3313,2017,Sociologie,5,Sociologie Generale,2,La Theorie Sociologique,6,1092,2,QROC,0.06,0.42,66.35,9,4,13,12,9,3,1.08,75.0,Facile,Facile,0,Meme Difficulté,Adapte
4424,2018,Sociologie,5,Sociologie Generale,2,La Theorie Sociologique,6,1092,2,QROC,0.08,0.82,66.35,9,5,14,10,9,1,1.4,90.0,Facile,Facile,0,Meme Difficulté,Adapte
5535,2019,Sociologie,5,Sociologie Generale,2,La Theorie Sociologique,6,1092,2,QROC,0.17,0.79,66.35,10,5,15,10,10,0,1.5,100.0,Facile,Facile,0,Meme Difficulté,Adapte
6646,2020,Sociologie,5,Sociologie Generale,2,La Theorie Sociologique,6,1092,2,QROC,0.12,0.42,66.35,9,5,14,11,9,2,1.27,81.82,Facile,Facile,0,Meme Difficulté,Adapte
1092,2015,Sociologie,5,Sociologie Generale,2,La Theorie Sociologique,6,1093,3,QROC,0.16,0.92,78.51,4,1,5,5,4,1,1.0,80.0,Difficile,Facile,2,Beaucoup plus Facile,Pas Adapte
2203,2016,Sociologie,5,Sociologie Generale,2,La Theorie Sociologique,6,1093,3,QROC,0.14,0.49,95.27,6,0,6,6,6,0,1.0,100.0,Facile,Facile,0,Meme Difficulté,Pas Adapte
3314,2017,Sociologie,5,Sociologie Generale,2,La Theorie Sociologique,6,1093,3,QROC,0.91,0.01,4.77,0,6,6,5,0,5,1.2,0.0,Difficile,Difficile,0,Meme Difficulté,Pas Adapte
4425,2018,Sociologie,5,Sociologie Generale,2,La Theorie Sociologique,6,1093,3,QO,0.87,0.08,34.19,2,3,5,5,2,3,1.0,40.0,Moyen,Difficile,-1,Plus Difficile,Pas Adapte
5536,2019,Sociologie,5,Sociologie Generale,2,La Theorie Sociologique,6,1093,3,QO,0.85,0.01,18.03,1,5,6,3,1,2,2.0,33.33,Facile,Difficile,-2,Beaucoup plus Difficile,Pas Adapte
6647,2020,Sociologie,5,Sociologie Generale,2,La Theorie Sociologique,6,1093,3,QO,0.85,0.1,3.03,0,5,5,4,0,4,1.25,0.0,Facile,Difficile,-2,Beaucoup plus Difficile,Pas Adapte
1093,2015,Sociologie,5,Sociologie Generale,2,La Theorie Sociologique,6,1094,4,QCU,0.03,0.92,79.0,40,10,50,46,40,6,1.09,86.96,Facile,Facile,0,Meme Difficulté,Pas Adapte
2204,2016,Sociologie,5,Sociologie Generale,2,La Theorie Sociologique,6,1094,4,QCU,0.7,0.23,16.33,7,36,43,36,7,29,1.19,19.44,Moyen,Difficile,-1,Plus Difficile,Pas Adapte
3315,2017,Sociologie,5,Sociologie Generale,2,La Theorie Sociologique,6,1094,4,QCU,0.12,0.76,87.53,43,6,49,46,43,3,1.07,93.48,Moyen,Facile,1,Plus Facile,Pas Adapte
4426,2018,Sociologie,5,Sociologie Generale,2,La Theorie Sociologique,6,1094,4,QCU,0.36,0.71,64.41,30,17,47,35,30,5,1.34,85.71,Moyen,Moyen,0,Meme Difficulté,Pas Adapte
5537,2019,Sociologie,5,Sociologie Generale,2,La Theorie Sociologique,6,1094,4,QCU,0.58,0.22,8.81,4,37,41,21,4,17,1.95,19.05,Facile,Difficile,-2,Beaucoup plus Difficile,Pas Adapte
6648,2020,Sociologie,5,Sociologie Generale,2,La Theorie Sociologique,6,1094,4,QCU,0.34,0.43,56.01,24,19,43,36,24,12,1.19,66.67,Moyen,Moyen,0,Meme Difficulté,Pas Adapte
1094,2015,Sociologie,5,Sociologie Generale,2,La Theorie Sociologique,6,1095,5,QCM,0.53,0.18,20.54,9,34,43,31,9,22,1.39,29.03,Difficile,Difficile,0,Meme Difficulté,Pas Adapte
2205,2016,Sociologie,5,Sociologie Generale,2,La Theorie Sociologique,6,1095,5,QCM,0.13,0.98,93.66,41,3,44,43,41,2,1.02,95.35,Difficile,Facile,2,Beaucoup plus Facile,Pas Adapte
3316,2017,Sociologie,5,Sociologie Generale,2,La Theorie Sociologique,6,1095,5,QCU,0.72,0.37,28.85,14,36,50,34,14,20,1.47,41.18,Facile,Difficile,-2,Beaucoup plus Difficile,Pas Adapte
4427,2018,Sociologie,5,Sociologie Generale,2,La Theorie Sociologique,6,1095,5,QCU,0.54,0.29,16.91,9,46,55,25,9,16,2.2,36.0,Difficile,Difficile,0,Meme Difficulté,Pas Adapte
5538,2019,Sociologie,5,Sociologie Generale,2,La Theorie Sociologique,6,1095,5,QCU,0.2,0.71,44.86,25,31,56,34,25,9,1.65,73.53,Difficile,Moyen,1,Plus Facile,Pas Adapte
6649,2020,Sociologie,5,Sociologie Generale,2,La Theorie Sociologique,6,1095,5,QCU,0.42,0.21,33.5,18,37,55,38,18,20,1.45,47.37,Difficile,Difficile,0,Meme Difficulté,Pas Adapte
1095,2015,Sociologie,5,Sociologie Generale,2,La Theorie Sociologique,6,1096,6,QCU,0.19,0.96,97.83,52,1,53,53,52,1,1.0,98.11,Moyen,Facile,1,Plus Facile,Pas Adapte
2206,2016,Sociologie,5,Sociologie Generale,2,La Theorie Sociologique,6,1096,6,QCU,0.07,0.75,76.41,40,12,52,45,40,5,1.16,88.89,Moyen,Facile,1,Plus Facile,Pas Adapte
3317,2017,Sociologie,5,Sociologie Generale,2,La Theorie Sociologique,6,1096,6,QCU,0.38,0.55,37.03,21,36,57,51,21,30,1.12,41.18,Facile,Moyen,-1,Plus Difficile,Pas Adapte
4428,2018,Sociologie,5,Sociologie Generale,2,La Theorie Sociologique,6,1096,6,QCU,0.06,0.81,98.48,59,1,60,59,59,0,1.02,100.0,Facile,Facile,0,Meme Difficulté,Pas Adapte
5539,2019,Sociologie,5,Sociologie Generale,2,La Theorie Sociologique,6,1096,6,QCU,0.03,0.94,92.61,57,5,62,58,57,1,1.07,98.28,Facile,Facile,0,Meme Difficulté,Pas Adapte
6650,2020,Sociologie,5,Sociologie Generale,2,La Theorie Sociologique,6,1096,6,QCM,0.48,0.37,51.22,32,31,63,52,32,20,1.21,61.54,Difficile,Moyen,1,Plus Facile,Pas Adapte
1096,2015,Sociologie,5,Sociologie Generale,3,La Condition Moderne,5,1097,1,QROC,0.17,0.46,82.47,75,16,91,91,75,16,1.0,82.42,Moyen,Facile,1,Plus Facile,Pas Adapte
2207,2016,Sociologie,5,Sociologie Generale,3,La Condition Moderne,5,1097,1,QROC,0.65,0.15,7.85,7,83,90,73,7,66,1.23,9.59,Moyen,Difficile,-1,Plus Difficile,Pas Adapte
3318,2017,Sociologie,5,Sociologie Generale,3,La Condition Moderne,5,1097,1,QROC,0.73,0.23,22.47,19,67,86,38,19,19,2.26,50.0,Facile,Difficile,-2,Beaucoup plus Difficile,Pas Adapte
4429,2018,Sociologie,5,Sociologie Generale,3,La Condition Moderne,5,1097,1,QROC,0.57,0.3,64.02,50,28,78,77,50,27,1.01,64.94,Facile,Moyen,-1,Plus Difficile,Pas Adapte
5540,2019,Sociologie,5,Sociologie Generale,3,La Condition Moderne,5,1097,1,QROC,0.06,0.78,97.16,72,2,74,72,72,0,1.03,100.0,Moyen,Facile,1,Plus Facile,Pas Adapte
6651,2020,Sociologie,5,Sociologie Generale,3,La Condition Moderne,5,1097,1,QROC,0.17,0.96,78.48,53,15,68,68,53,15,1.0,77.94,Moyen,Facile,1,Plus Facile,Pas Adapte
1097,2015,Sociologie,5,Sociologie Generale,3,La Condition Moderne,5,1098,2,QCM,0.29,0.4,58.21,24,17,41,40,24,16,1.02,60.0,Facile,Moyen,-1,Plus Difficile,Pas Adapte
2208,2016,Sociologie,5,Sociologie Generale,3,La Condition Moderne,5,1098,2,QCM,0.68,0.22,26.11,10,29,39,23,10,13,1.7,43.48,Facile,Difficile,-2,Beaucoup plus Difficile,Pas Adapte
3319,2017,Sociologie,5,Sociologie Generale,3,La Condition Moderne,5,1098,2,QCM,0.53,0.21,31.51,11,23,34,11,11,0,3.09,100.0,Facile,Difficile,-2,Beaucoup plus Difficile,Pas Adapte
4430,2018,Sociologie,5,Sociologie Generale,3,La Condition Moderne,5,1098,2,QCM,0.65,0.16,26.83,10,29,39,34,10,24,1.15,29.41,Difficile,Difficile,0,Meme Difficulté,Pas Adapte
5541,2019,Sociologie,5,Sociologie Generale,3,La Condition Moderne,5,1098,2,QCM,0.2,0.82,69.48,24,10,34,29,24,5,1.17,82.76,Moyen,Facile,1,Plus Facile,Adapte
6652,2020,Sociologie,5,Sociologie Generale,3,La Condition Moderne,5,1098,2,QCM,0.01,0.86,69.48,25,11,36,29,25,4,1.24,86.21,Facile,Facile,0,Meme Difficulté,Adapte
1098,2015,Sociologie,5,Sociologie Generale,3,La Condition Moderne,5,1099,3,QROC,0.99,0.15,33.1,25,52,77,39,25,14,1.97,64.1,Facile,Difficile,-2,Beaucoup plus Difficile,Pas Adapte
2209,2016,Sociologie,5,Sociologie Generale,3,La Condition Moderne,5,1099,3,QROC,0.17,0.48,94.21,78,5,83,78,78,0,1.06,100.0,Facile,Facile,0,Meme Difficulté,Pas Adapte
3320,2017,Sociologie,5,Sociologie Generale,3,La Condition Moderne,5,1099,3,QROC,0.05,0.68,65.18,50,27,77,61,50,11,1.26,81.97,Moyen,Facile,1,Plus Facile,Adapte
4431,2018,Sociologie,5,Sociologie Generale,3,La Condition Moderne,5,1099,3,QO,0.13,0.91,65.18,44,23,67,61,44,17,1.1,72.13,Facile,Facile,0,Meme Difficulté,Adapte
5542,2019,Sociologie,5,Sociologie Generale,3,La Condition Moderne,5,1099,3,QO,0.08,0.53,65.18,48,26,74,62,48,14,1.19,77.42,Facile,Facile,0,Meme Difficulté,Adapte
6653,2020,Sociologie,5,Sociologie Generale,3,La Condition Moderne,5,1099,3,QCM,0.05,0.85,65.18,48,26,74,55,48,7,1.35,87.27,Facile,Facile,0,Meme Difficulté,Adapte
1099,2015,Sociologie,5,Sociologie Generale,3,La Condition Moderne,5,1100,4,QCU,0.44,0.27,1.77,2,86,88,43,2,41,2.05,4.65,Difficile,Difficile,0,Meme Difficulté,Pas Adapte
2210,2016,Sociologie,5,Sociologie Generale,3,La Condition Moderne,5,1100,4,QCU,0.03,0.96,90.4,75,8,83,81,75,6,1.02,92.59,Moyen,Facile,1,Plus Facile,Pas Adapte
3321,2017,Sociologie,5,Sociologie Generale,3,La Condition Moderne,5,1100,4,QCU,0.15,0.92,71.67,53,21,74,64,53,11,1.16,82.81,Difficile,Facile,2,Beaucoup plus Facile,Adapte
4432,2018,Sociologie,5,Sociologie Generale,3,La Condition Moderne,5,1100,4,QCU,0.0,0.99,71.67,58,23,81,70,58,12,1.16,82.86,Facile,Facile,0,Meme Difficulté,Adapte
5543,2019,Sociologie,5,Sociologie Generale,3,La Condition Moderne,5,1100,4,QCU,0.07,0.86,71.67,65,26,91,79,65,14,1.15,82.28,Facile,Facile,0,Meme Difficulté,Adapte
6654,2020,Sociologie,5,Sociologie Generale,3,La Condition Moderne,5,1100,4,QCU,0.15,0.84,71.67,66,26,92,79,66,13,1.16,83.54,Facile,Facile,0,Meme Difficulté,Adapte
1100,2015,Sociologie,5,Sociologie Generale,3,La Condition Moderne,5,1101,5,QCM,0.26,0.49,48.33,9,9,18,13,9,4,1.38,69.23,Facile,Moyen,-1,Plus Difficile,Pas Adapte
2211,2016,Sociologie,5,Sociologie Generale,3,La Condition Moderne,5,1101,5,QCM,0.06,0.8,83.94,17,3,20,18,17,1,1.11,94.44,Facile,Facile,0,Meme Difficulté,Pas Adapte
3322,2017,Sociologie,5,Sociologie Generale,3,La Condition Moderne,5,1101,5,QO,0.12,0.92,67.95,16,7,23,18,16,2,1.28,88.89,Facile,Facile,0,Meme Difficulté,Adapte
4433,2018,Sociologie,5,Sociologie Generale,3,La Condition Moderne,5,1101,5,QO,0.16,0.73,67.95,18,8,26,18,18,0,1.44,100.0,Facile,Facile,0,Meme Difficulté,Adapte
5544,2019,Sociologie,5,Sociologie Generale,3,La Condition Moderne,5,1101,5,QO,0.0,0.56,67.95,20,10,30,24,20,4,1.25,83.33,Facile,Facile,0,Meme Difficulté,Adapte
6655,2020,Sociologie,5,Sociologie Generale,3,La Condition Moderne,5,1101,5,QO,0.15,0.68,67.95,22,10,32,31,22,9,1.03,70.97,Facile,Facile,0,Meme Difficulté,Adapte
1101,2015,Sociologie,5,Sociologie Generale,4,Les Debats Sociologiques Contemporains,10,1102,1,QO,0.99,0.09,21.37,1,6,7,7,1,6,1.0,14.29,Facile,Difficile,-2,Beaucoup plus Difficile,Pas Adapte
2212,2016,Sociologie,5,Sociologie Generale,4,Les Debats Sociologiques Contemporains,10,1102,1,QO,0.96,0.03,34.41,2,4,6,3,2,1,2.0,66.67,Facile,Difficile,-2,Beaucoup plus Difficile,Pas Adapte
3323,2017,Sociologie,5,Sociologie Generale,4,Les Debats Sociologiques Contemporains,10,1102,1,QO,0.99,0.02,13.45,1,6,7,6,1,5,1.17,16.67,Moyen,Difficile,-1,Plus Difficile,Pas Adapte
4434,2018,Sociologie,5,Sociologie Generale,4,Les Debats Sociologiques Contemporains,10,1102,1,QO,0.82,0.04,1.67,0,7,7,5,0,5,1.4,0.0,Difficile,Difficile,0,Meme Difficulté,Pas Adapte
5545,2019,Sociologie,5,Sociologie Generale,4,Les Debats Sociologiques Contemporains,10,1102,1,QO,0.28,0.19,60.88,4,3,7,5,4,1,1.4,80.0,Difficile,Moyen,1,Plus Facile,Pas Adapte
6656,2020,Sociologie,5,Sociologie Generale,4,Les Debats Sociologiques Contemporains,10,1102,1,QO,0.15,0.71,91.7,7,1,8,7,7,0,1.14,100.0,Difficile,Facile,2,Beaucoup plus Facile,Pas Adapte
1102,2015,Sociologie,5,Sociologie Generale,4,Les Debats Sociologiques Contemporains,10,1103,2,QCM,0.66,0.17,15.61,5,26,31,24,5,19,1.29,20.83,Moyen,Difficile,-1,Plus Difficile,Pas Adapte
2213,2016,Sociologie,5,Sociologie Generale,4,Les Debats Sociologiques Contemporains,10,1103,2,QCM,0.09,0.76,91.52,31,3,34,32,31,1,1.06,96.88,Difficile,Facile,2,Beaucoup plus Facile,Pas Adapte
3324,2017,Sociologie,5,Sociologie Generale,4,Les Debats Sociologiques Contemporains,10,1103,2,QCM,0.54,0.24,26.63,10,27,37,16,10,6,2.31,62.5,Facile,Difficile,-2,Beaucoup plus Difficile,Pas Adapte
4435,2018,Sociologie,5,Sociologie Generale,4,Les Debats Sociologiques Contemporains,10,1103,2,QCM,0.51,0.23,11.4,4,35,39,31,4,27,1.26,12.9,Moyen,Difficile,-1,Plus Difficile,Pas Adapte
5546,2019,Sociologie,5,Sociologie Generale,4,Les Debats Sociologiques Contemporains,10,1103,2,QCM,0.08,0.92,94.32,36,2,38,37,36,1,1.03,97.3,Moyen,Facile,1,Plus Facile,Pas Adapte
6657,2020,Sociologie,5,Sociologie Generale,4,Les Debats Sociologiques Contemporains,10,1103,2,QCM,0.08,0.96,67.76,22,10,32,25,22,3,1.28,88.0,Moyen,Facile,1,Plus Facile,Adapte
1103,2015,Sociologie,5,Sociologie Generale,4,Les Debats Sociologiques Contemporains,10,1104,3,QCM,0.17,0.98,94.61,57,3,60,58,57,1,1.03,98.28,Difficile,Facile,2,Beaucoup plus Facile,Pas Adapte
2214,2016,Sociologie,5,Sociologie Generale,4,Les Debats Sociologiques Contemporains,10,1104,3,QCM,0.6,0.24,31.91,19,41,60,45,19,26,1.33,42.22,Moyen,Difficile,-1,Plus Difficile,Pas Adapte
3325,2017,Sociologie,5,Sociologie Generale,4,Les Debats Sociologiques Contemporains,10,1104,3,QCM,0.16,0.74,98.53,64,1,65,65,64,1,1.0,98.46,Facile,Facile,0,Meme Difficulté,Pas Adapte
4436,2018,Sociologie,5,Sociologie Generale,4,Les Debats Sociologiques Contemporains,10,1104,3,QCM,0.8,0.24,24.18,17,53,70,45,17,28,1.56,37.78,Moyen,Difficile,-1,Plus Difficile,Pas Adapte
5547,2019,Sociologie,5,Sociologie Generale,4,Les Debats Sociologiques Contemporains,10,1104,3,QCM,0.53,0.2,25.21,16,48,64,61,16,45,1.05,26.23,Facile,Difficile,-2,Beaucoup plus Difficile,Pas Adapte
6658,2020,Sociologie,5,Sociologie Generale,4,Les Debats Sociologiques Contemporains,10,1104,3,QCU,0.09,0.82,96.38,67,2,69,67,67,0,1.03,100.0,Facile,Facile,0,Meme Difficulté,Pas Adapte
1104,2015,Sociologie,5,Sociologie Generale,4,Les Debats Sociologiques Contemporains,10,1105,4,QCM,0.71,0.19,2.86,2,83,85,37,2,35,2.3,5.41,Difficile,Difficile,0,Meme Difficulté,Pas Adapte
2215,2016,Sociologie,5,Sociologie Generale,4,Les Debats Sociologiques Contemporains,10,1105,4,QCM,0.19,0.88,78.14,75,21,96,86,75,11,1.12,87.21,Facile,Facile,0,Meme Difficulté,Pas Adapte
3326,2017,Sociologie,5,Sociologie Generale,4,Les Debats Sociologiques Contemporains,10,1105,4,QCU,0.64,0.29,3.3,3,87,90,89,3,86,1.01,3.37,Moyen,Difficile,-1,Plus Difficile,Pas Adapte
4437,2018,Sociologie,5,Sociologie Generale,4,Les Debats Sociologiques Contemporains,10,1105,4,QCU,0.5,0.2,8.19,8,93,101,57,8,49,1.77,14.04,Difficile,Difficile,0,Meme Difficulté,Pas Adapte
5548,2019,Sociologie,5,Sociologie Generale,4,Les Debats Sociologiques Contemporains,10,1105,4,QCU,0.54,0.31,34.48,31,59,90,53,31,22,1.7,58.49,Facile,Difficile,-2,Beaucoup plus Difficile,Pas Adapte
6659,2020,Sociologie,5,Sociologie Generale,4,Les Debats Sociologiques Contemporains,10,1105,4,QCU,0.52,0.21,28.94,29,71,100,75,29,46,1.33,38.67,Moyen,Difficile,-1,Plus Difficile,Pas Adapte
1105,2015,Sociologie,5,Sociologie Generale,4,Les Debats Sociologiques Contemporains,10,1106,5,QROC,0.82,0.16,27.64,23,61,84,65,23,42,1.29,35.38,Moyen,Difficile,-1,Plus Difficile,Pas Adapte
2216,2016,Sociologie,5,Sociologie Generale,4,Les Debats Sociologiques Contemporains,10,1106,5,QROC,0.8,0.15,16.36,13,69,82,64,13,51,1.28,20.31,Facile,Difficile,-2,Beaucoup plus Difficile,Pas Adapte
3327,2017,Sociologie,5,Sociologie Generale,4,Les Debats Sociologiques Contemporains,10,1106,5,QO,0.29,0.16,38.87,27,43,70,70,27,43,1.0,38.57,Facile,Moyen,-1,Plus Difficile,Pas Adapte
4438,2018,Sociologie,5,Sociologie Generale,4,Les Debats Sociologiques Contemporains,10,1106,5,QO,0.02,0.57,76.48,59,18,77,73,59,14,1.05,80.82,Difficile,Facile,2,Beaucoup plus Facile,Pas Adapte
5549,2019,Sociologie,5,Sociologie Generale,4,Les Debats Sociologiques Contemporains,10,1106,5,QO,0.7,0.27,57.5,47,35,82,48,47,1,1.71,97.92,Facile,Moyen,-1,Plus Difficile,Pas Adapte
6660,2020,Sociologie,5,Sociologie Generale,4,Les Debats Sociologiques Contemporains,10,1106,5,QO,0.83,0.03,7.72,5,65,70,58,5,53,1.21,8.62,Moyen,Difficile,-1,Plus Difficile,Pas Adapte
1106,2015,Sociologie,5,Sociologie Generale,4,Les Debats Sociologiques Contemporains,10,1107,6,QCU,0.04,0.78,69.28,57,25,82,62,57,5,1.32,91.94,Facile,Facile,0,Meme Difficulté,Adapte
2217,2016,Sociologie,5,Sociologie Generale,4,Les Debats Sociologiques Contemporains,10,1107,6,QCU,0.13,0.94,69.28,51,23,74,57,51,6,1.3,89.47,Facile,Facile,0,Meme Difficulté,Adapte
3328,2017,Sociologie,5,Sociologie Generale,4,Les Debats Sociologiques Contemporains,10,1107,6,QCU,0.2,0.81,69.28,54,24,78,61,54,7,1.28,88.52,Facile,Facile,0,Meme Difficulté,Adapte
4439,2018,Sociologie,5,Sociologie Generale,4,Les Debats Sociologiques Contemporains,10,1107,6,QCM,0.01,0.73,69.28,55,25,80,70,55,15,1.14,78.57,Facile,Facile,0,Meme Difficulté,Adapte
5550,2019,Sociologie,5,Sociologie Generale,4,Les Debats Sociologiques Contemporains,10,1107,6,QROC,0.16,0.51,69.28,50,22,72,59,50,9,1.22,84.75,Facile,Facile,0,Meme Difficulté,Adapte
6661,2020,Sociologie,5,Sociologie Generale,4,Les Debats Sociologiques Contemporains,10,1107,6,QROC,0.05,0.77,69.28,51,23,74,56,51,5,1.32,91.07,Facile,Facile,0,Meme Difficulté,Adapte
1107,2015,Sociologie,5,Sociologie Generale,4,Les Debats Sociologiques Contemporains,10,1108,7,QO,0.65,0.24,55.36,39,32,71,71,39,32,1.0,54.93,Facile,Moyen,-1,Plus Difficile,Pas Adapte
2218,2016,Sociologie,5,Sociologie Generale,4,Les Debats Sociologiques Contemporains,10,1108,7,QO,0.62,0.29,52.38,32,30,62,32,32,0,1.94,100.0,Facile,Moyen,-1,Plus Difficile,Pas Adapte
3329,2017,Sociologie,5,Sociologie Generale,4,Les Debats Sociologiques Contemporains,10,1108,7,QO,0.62,0.23,62.37,34,20,54,45,34,11,1.2,75.56,Moyen,Moyen,0,Meme Difficulté,Pas Adapte
4440,2018,Sociologie,5,Sociologie Generale,4,Les Debats Sociologiques Contemporains,10,1108,7,QO,0.05,0.39,97.96,51,1,52,52,51,1,1.0,98.08,Facile,Facile,0,Meme Difficulté,Pas Adapte
5551,2019,Sociologie,5,Sociologie Generale,4,Les Debats Sociologiques Contemporains,10,1108,7,QO,0.8,0.01,14.48,9,51,60,45,9,36,1.33,20.0,Facile,Difficile,-2,Beaucoup plus Difficile,Pas Adapte
6662,2020,Sociologie,5,Sociologie Generale,4,Les Debats Sociologiques Contemporains,10,1108,7,QO,0.18,0.67,84.42,57,10,67,61,57,4,1.1,93.44,Moyen,Facile,1,Plus Facile,Pas Adapte
1108,2015,Sociologie,5,Sociologie Generale,4,Les Debats Sociologiques Contemporains,10,1109,8,QCU,0.2,0.93,79.67,13,3,16,15,13,2,1.07,86.67,Difficile,Facile,2,Beaucoup plus Facile,Pas Adapte
2219,2016,Sociologie,5,Sociologie Generale,4,Les Debats Sociologiques Contemporains,10,1109,8,QCM,0.76,0.16,7.27,1,13,14,4,1,3,3.5,25.0,Difficile,Difficile,0,Meme Difficulté,Pas Adapte
3330,2017,Sociologie,5,Sociologie Generale,4,Les Debats Sociologiques Contemporains,10,1109,8,QCM,0.15,0.87,78.1,11,3,14,13,11,2,1.08,84.62,Difficile,Facile,2,Beaucoup plus Facile,Pas Adapte
4441,2018,Sociologie,5,Sociologie Generale,4,Les Debats Sociologiques Contemporains,10,1109,8,QCM,0.11,0.74,96.12,13,1,14,14,13,1,1.0,92.86,Difficile,Facile,2,Beaucoup plus Facile,Pas Adapte
5552,2019,Sociologie,5,Sociologie Generale,4,Les Debats Sociologiques Contemporains,10,1109,8,QCM,0.14,0.8,72.71,12,4,16,15,12,3,1.07,80.0,Difficile,Facile,2,Beaucoup plus Facile,Adapte
6663,2020,Sociologie,5,Sociologie Generale,4,Les Debats Sociologiques Contemporains,10,1109,8,QCM,0.18,0.95,72.71,13,5,18,16,13,3,1.12,81.25,Facile,Facile,0,Meme Difficulté,Adapte
1109,2015,Sociologie,5,Sociologie Generale,4,Les Debats Sociologiques Contemporains,10,1110,9,QROC,0.04,0.78,97.01,61,2,63,62,61,1,1.02,98.39,Moyen,Facile,1,Plus Facile,Pas Adapte
2220,2016,Sociologie,5,Sociologie Generale,4,Les Debats Sociologiques Contemporains,10,1110,9,QROC,0.96,0.16,32.63,21,42,63,50,21,29,1.26,42.0,Difficile,Difficile,0,Meme Difficulté,Pas Adapte
3331,2017,Sociologie,5,Sociologie Generale,4,Les Debats Sociologiques Contemporains,10,1110,9,QROC,0.88,0.21,29.36,18,44,62,58,18,40,1.07,31.03,Difficile,Difficile,0,Meme Difficulté,Pas Adapte
4442,2018,Sociologie,5,Sociologie Generale,4,Les Debats Sociologiques Contemporains,10,1110,9,QROC,0.57,0.39,45.38,25,31,56,40,25,15,1.4,62.5,Moyen,Moyen,0,Meme Difficulté,Pas Adapte
5553,2019,Sociologie,5,Sociologie Generale,4,Les Debats Sociologiques Contemporains,10,1110,9,QROC,0.19,0.42,75.88,43,14,57,51,43,8,1.12,84.31,Moyen,Facile,1,Plus Facile,Pas Adapte
6664,2020,Sociologie,5,Sociologie Generale,4,Les Debats Sociologiques Contemporains,10,1110,9,QROC,0.2,0.38,48.67,24,26,50,37,24,13,1.35,64.86,Difficile,Moyen,1,Plus Facile,Pas Adapte
1110,2015,Sociologie,5,Sociologie Generale,4,Les Debats Sociologiques Contemporains,10,1111,10,QCU,0.18,0.98,90.11,20,2,22,22,20,2,1.0,90.91,Facile,Facile,0,Meme Difficulté,Pas Adapte
2221,2016,Sociologie,5,Sociologie Generale,4,Les Debats Sociologiques Contemporains,10,1111,10,QCU,0.65,0.22,32.14,7,16,23,15,7,8,1.53,46.67,Moyen,Difficile,-1,Plus Difficile,Pas Adapte
3332,2017,Sociologie,5,Sociologie Generale,4,Les Debats Sociologiques Contemporains,10,1111,10,QCU,0.15,0.79,68.43,17,8,25,22,17,5,1.14,77.27,Facile,Facile,0,Meme Difficulté,Adapte
4443,2018,Sociologie,5,Sociologie Generale,4,Les Debats Sociologiques Contemporains,10,1111,10,QCU,0.13,0.92,68.43,19,9,28,21,19,2,1.33,90.48,Facile,Facile,0,Meme Difficulté,Adapte
5554,2019,Sociologie,5,Sociologie Generale,4,Les Debats Sociologiques Contemporains,10,1111,10,QCU,0.07,0.97,68.43,22,10,32,27,22,5,1.19,81.48,Facile,Facile,0,Meme Difficulté,Adapte
6665,2020,Sociologie,5,Sociologie Generale,4,Les Debats Sociologiques Contemporains,10,1111,10,QCU,0.18,0.82,68.43,21,9,30,29,21,8,1.03,72.41,Facile,Facile,0,Meme Difficulté,Adapte
