,Course_ID,Year,Course_Duration,Course_Duration_Digit,Course_Duration_Present,Digit_Ratio,Digit_Percentage,Total_Courses_perYear,Duration_Video,Duration_Quiz,Duration_Exam,Number_Video,Number_Quiz,Number_Exam,Number_Ressources,Number_Video_1H,Number_Video_2H,Number_Video_3H,Number_Video_4H,Number_Quiz_1H,Number_Quiz_2H,Number_Exam_1H,Number_Exam_2H,Number_Exam_3H,Number_Exam_4H
0,1,2013,33,21,12,0.64,64,1014,14,7,0,10,4,0,14,8,0,2,0,1,3,0,0,0,0
1,2,2013,15,2,13,0.15,15,1014,1,1,0,1,1,0,2,1,0,0,0,1,0,0,0,0,0
2,3,2013,28,23,5,0.83,83,1014,9,12,2,8,6,2,16,7,1,0,0,0,6,2,0,0,0
3,4,2013,40,36,4,0.91,91,1014,19,16,1,14,12,1,27,11,1,2,0,8,4,1,0,0,0
4,5,2013,33,23,10,0.7,70,1014,7,13,3,3,12,1,16,1,1,0,1,11,1,0,0,1,0
5,6,2013,41,39,2,0.95,95,1014,15,22,2,15,17,2,34,15,0,0,0,12,5,2,0,0,0
6,7,2013,55,38,17,0.69,69,1014,24,12,2,17,11,2,30,13,1,3,0,10,1,2,0,0,0
7,8,2013,38,8,30,0.22,22,1014,2,4,2,2,3,1,6,2,0,0,0,2,1,0,1,0,0
8,9,2013,28,1,27,0.05,5,1014,0,1,0,0,1,0,1,0,0,0,0,1,0,0,0,0,0
9,10,2013,12,7,5,0.62,62,1014,3,3,1,3,3,1,7,3,0,0,0,3,0,1,0,0,0
10,11,2013,49,5,44,0.11,11,1014,2,2,1,2,1,1,4,2,0,0,0,0,1,1,0,0,0
11,12,2013,34,0,34,0.0,0,1014,0,0,0,0,0,0,0,0,0,0,0,0,0,0,0,0,0
12,13,2013,6,3,3,0.51,51,1014,1,2,0,1,1,0,2,1,0,0,0,0,1,0,0,0,0
13,14,2013,32,0,32,0.01,1,1014,0,0,0,0,0,0,0,0,0,0,0,0,0,0,0,0,0
14,15,2013,7,5,2,0.65,65,1014,1,3,1,1,3,1,5,1,0,0,0,3,0,1,0,0,0
15,16,2013,47,26,21,0.55,55,1014,15,9,2,14,8,1,23,13,1,0,0,7,1,0,1,0,0
16,17,2013,13,7,6,0.57,56,1014,3,3,1,3,2,1,6,3,0,0,0,1,1,1,0,0,0
17,18,2013,40,39,1,0.98,98,1014,24,14,1,16,8,1,25,9,6,1,0,2,6,1,0,0,0
18,19,2013,10,0,10,0.05,5,1014,0,0,0,0,0,0,0,0,0,0,0,0,0,0,0,0,0
19,20,2013,9,4,5,0.46,46,1014,3,1,0,2,1,0,3,1,1,0,0,1,0,0,0,0,0
20,21,2013,52,7,45,0.14,14,1014,2,4,1,1,3,1,5,0,1,0,0,2,1,1,0,0,0
21,22,2013,5,3,2,0.69,69,1014,2,1,0,1,1,0,2,0,1,0,0,1,0,0,0,0,0
22,23,2013,34,13,21,0.37,37,1014,9,3,1,3,2,1,6,0,0,3,0,1,1,1,0,0,0
23,24,2013,37,16,21,0.43,43,1014,8,6,2,5,6,2,13,4,0,0,1,6,0,2,0,0,0
24,25,2013,36,32,4,0.89,89,1014,22,9,1,12,5,1,18,6,2,4,0,1,4,1,0,0,0
25,26,2013,33,25,8,0.75,75,1014,12,11,2,6,10,2,18,3,1,1,1,9,1,2,0,0,0
26,27,2013,27,5,22,0.17,17,1014,1,3,1,1,3,1,5,1,0,0,0,3,0,1,0,0,0
27,28,2013,27,15,12,0.57,56,1014,7,6,2,5,4,1,10,3,2,0,0,2,2,0,1,0,0
28,29,2013,8,0,8,0.05,5,1014,0,0,0,0,0,0,0,0,0,0,0,0,0,0,0,0,0
29,30,2013,59,50,9,0.84,84,1014,19,29,2,17,15,1,33,15,2,0,0,1,14,0,1,0,0
30,31,2013,60,7,53,0.12,12,1014,3,4,0,3,4,0,7,3,0,0,0,4,0,0,0,0,0
31,32,2013,10,7,3,0.71,71,1014,2,4,1,1,3,1,5,0,1,0,0,2,1,1,0,0,0
32,33,2013,28,12,16,0.42,42,1014,8,4,0,6,3,0,9,4,2,0,0,2,1,0,0,0,0
33,34,2013,10,2,8,0.2,20,1014,1,1,0,1,1,0,2,1,0,0,0,1,0,0,0,0,0
34,35,2013,52,43,9,0.82,82,1014,18,24,1,18,21,1,40,18,0,0,0,18,3,1,0,0,0
35,36,2013,58,43,15,0.74,74,1014,28,15,0,19,9,0,28,11,7,1,0,3,6,0,0,0,0
36,37,2013,53,41,12,0.77,77,1014,25,16,0,9,8,0,17,1,4,0,4,0,8,0,0,0,0
37,38,2013,19,10,9,0.53,53,1014,4,4,2,3,3,1,7,2,1,0,0,2,1,0,1,0,0
38,39,2013,16,1,15,0.08,8,1014,0,1,0,0,1,0,1,0,0,0,0,1,0,0,0,0,0
39,40,2013,8,8,0,0.95,95,1014,6,2,0,3,1,0,4,0,3,0,0,0,1,0,0,0,0
40,41,2013,24,11,13,0.44,44,1014,5,5,1,5,5,1,11,5,0,0,0,5,0,1,0,0,0
41,42,2013,8,0,8,0.02,2,1014,0,0,0,0,0,0,0,0,0,0,0,0,0,0,0,0,0
42,43,2013,40,19,21,0.48,48,1014,9,6,4,9,5,3,17,9,0,0,0,4,1,2,1,0,0
43,44,2013,29,24,5,0.84,84,1014,15,5,4,13,5,4,22,12,0,1,0,5,0,4,0,0,0
44,45,2013,42,2,40,0.05,5,1014,1,1,0,1,1,0,2,1,0,0,0,1,0,0,0,0,0
45,46,2013,53,52,1,0.99,99,1014,38,12,2,15,8,2,25,0,8,6,1,4,4,2,0,0,0
46,47,2013,37,35,2,0.95,95,1014,10,21,4,4,13,2,19,2,0,0,2,5,8,1,0,1,0
47,48,2013,24,18,6,0.76,76,1014,9,7,2,3,4,1,8,0,1,1,1,1,3,0,1,0,0
48,49,2013,60,26,34,0.44,44,1014,19,5,2,12,3,2,17,7,3,2,0,1,2,2,0,0,0
49,50,2013,17,8,9,0.5,50,1014,2,4,2,2,4,2,8,2,0,0,0,4,0,2,0,0,0
50,51,2013,18,6,12,0.34,34,1014,4,2,0,2,2,0,4,0,2,0,0,2,0,0,0,0,0
51,52,2013,34,7,27,0.22,22,1014,4,2,1,2,1,1,4,1,0,1,0,0,1,1,0,0,0
52,53,2013,25,2,23,0.06,6,1014,1,1,0,1,1,0,2,1,0,0,0,1,0,0,0,0,0
53,54,2013,26,9,17,0.33,33,1014,2,5,2,1,3,2,6,0,1,0,0,1,2,2,0,0,0
54,55,2013,31,30,1,0.98,98,1014,13,15,2,9,8,1,18,5,4,0,0,1,7,0,1,0,0
55,56,2013,25,21,4,0.85,85,1014,15,5,1,6,3,1,10,1,2,2,1,1,2,1,0,0,0
56,57,2013,11,10,1,0.94,94,1014,4,6,0,4,5,0,9,4,0,0,0,4,1,0,0,0,0
57,58,2013,33,15,18,0.46,46,1014,8,5,2,5,3,1,9,2,3,0,0,1,2,0,1,0,0
58,59,2013,7,5,2,0.66,66,1014,4,1,0,4,1,0,5,4,0,0,0,1,0,0,0,0,0
59,60,2013,5,1,4,0.22,22,1014,0,1,0,0,1,0,1,0,0,0,0,1,0,0,0,0,0
60,61,2013,23,9,14,0.39,39,1014,3,5,1,1,3,1,5,0,0,1,0,1,2,1,0,0,0
61,62,2013,47,23,24,0.48,48,1014,14,7,2,9,5,2,16,6,1,2,0,3,2,2,0,0,0
62,63,2013,7,1,6,0.18,18,1014,0,1,0,0,1,0,1,0,0,0,0,1,0,0,0,0,0
63,64,2013,39,21,18,0.54,54,1014,10,10,1,10,6,1,17,10,0,0,0,2,4,1,0,0,0
64,65,2013,47,12,35,0.25,25,1014,6,5,1,6,5,1,12,6,0,0,0,5,0,1,0,0,0
65,66,2013,23,12,11,0.5,50,1014,5,7,0,2,7,0,9,1,0,0,1,7,0,0,0,0,0
66,67,2013,7,1,6,0.15,15,1014,0,1,0,0,1,0,1,0,0,0,0,1,0,0,0,0,0
67,68,2013,36,28,8,0.77,77,1014,14,11,3,9,11,3,23,7,0,1,1,11,0,3,0,0,0
68,69,2013,44,5,39,0.11,11,1014,1,3,1,1,2,1,4,1,0,0,0,1,1,1,0,0,0
69,70,2013,50,20,30,0.4,40,1014,14,5,1,6,5,1,12,0,5,0,1,5,0,1,0,0,0
70,71,2013,14,3,11,0.19,19,1014,2,1,0,1,1,0,2,0,1,0,0,1,0,0,0,0,0
71,72,2013,34,12,22,0.36,36,1014,7,3,2,6,2,2,10,5,1,0,0,1,1,2,0,0,0
72,73,2013,50,3,47,0.06,6,1014,2,1,0,2,1,0,3,2,0,0,0,1,0,0,0,0,0
73,74,2013,40,38,2,0.96,96,1014,20,15,3,17,8,2,27,15,1,1,0,1,7,1,1,0,0
74,75,2013,34,12,22,0.35,35,1014,8,4,0,5,4,0,9,3,1,1,0,4,0,0,0,0,0
75,76,2013,43,19,24,0.45,45,1014,11,6,2,8,6,1,15,5,3,0,0,6,0,0,1,0,0
76,77,2013,13,4,9,0.31,31,1014,1,2,1,1,2,1,4,1,0,0,0,2,0,1,0,0,0
77,78,2013,15,9,6,0.6,60,1014,4,4,1,3,4,1,8,2,1,0,0,4,0,1,0,0,0
78,79,2013,19,7,12,0.37,37,1014,3,3,1,2,3,1,6,1,1,0,0,3,0,1,0,0,0
79,80,2013,43,26,17,0.61,61,1014,10,15,1,5,8,1,14,3,0,1,1,1,7,1,0,0,0
80,81,2013,55,29,26,0.53,53,1014,13,15,1,9,13,1,23,7,0,2,0,11,2,1,0,0,0
81,82,2013,23,22,1,0.95,95,1014,9,12,1,6,10,1,17,3,3,0,0,8,2,1,0,0,0
82,83,2013,9,3,6,0.36,36,1014,2,1,0,1,1,0,2,0,1,0,0,1,0,0,0,0,0
83,84,2013,31,30,1,0.98,98,1014,22,7,1,18,5,1,24,14,4,0,0,3,2,1,0,0,0
84,85,2013,6,3,3,0.54,54,1014,2,1,0,2,1,0,3,2,0,0,0,1,0,0,0,0,0
85,86,2013,53,26,27,0.49,49,1014,19,6,1,11,3,1,15,7,2,0,2,0,3,1,0,0,0
86,87,2013,27,22,5,0.83,83,1014,10,11,1,4,7,1,12,2,0,0,2,3,4,1,0,0,0
87,88,2013,19,5,14,0.25,25,1014,3,2,0,2,2,0,4,1,1,0,0,2,0,0,0,0,0
88,89,2013,29,21,8,0.73,73,1014,8,12,1,4,6,1,11,0,4,0,0,0,6,1,0,0,0
89,90,2013,15,7,8,0.49,49,1014,3,3,1,3,3,1,7,3,0,0,0,3,0,1,0,0,0
90,91,2013,57,39,18,0.69,69,1014,19,17,3,15,11,2,28,12,2,1,0,5,6,1,1,0,0
91,92,2013,40,37,3,0.92,92,1014,16,19,2,14,10,1,25,13,0,1,0,1,9,0,1,0,0
92,93,2013,26,5,21,0.2,20,1014,2,2,1,2,1,1,4,2,0,0,0,0,1,1,0,0,0
93,94,2013,21,10,11,0.48,48,1014,5,3,2,3,2,1,6,1,2,0,0,1,1,0,1,0,0
94,95,2013,39,23,16,0.58,57,1014,15,8,0,13,7,0,20,11,2,0,0,6,1,0,0,0,0
95,96,2013,12,7,5,0.62,62,1014,4,2,1,1,2,1,4,0,0,0,1,2,0,1,0,0,0
96,97,2013,28,22,6,0.77,77,1014,13,9,0,8,8,0,16,6,0,1,1,7,1,0,0,0,0
97,98,2013,60,21,39,0.35,35,1014,13,8,0,5,7,0,12,1,1,2,1,6,1,0,0,0,0
98,99,2013,56,16,40,0.29,28,1014,8,5,3,5,4,3,12,3,1,1,0,3,1,3,0,0,0
99,100,2013,27,1,26,0.04,4,1014,0,1,0,0,1,0,1,0,0,0,0,1,0,0,0,0,0
100,101,2013,31,31,0,0.99,99,1014,13,16,2,10,13,1,24,7,3,0,0,10,3,0,1,0,0
101,102,2013,10,6,4,0.57,56,1014,3,2,1,3,1,1,5,3,0,0,0,0,1,1,0,0,0
102,103,2013,29,3,26,0.11,11,1014,2,1,0,1,1,0,2,0,1,0,0,1,0,0,0,0,0
103,104,2013,57,10,47,0.18,18,1014,7,2,1,5,2,1,8,3,2,0,0,2,0,1,0,0,0
104,105,2013,15,5,10,0.36,36,1014,3,2,0,1,1,0,2,0,0,1,0,0,1,0,0,0,0
105,106,2013,7,3,4,0.42,42,1014,2,1,0,2,1,0,3,2,0,0,0,1,0,0,0,0,0
106,107,2013,8,7,1,0.82,82,1014,3,4,0,1,2,0,3,0,0,1,0,0,2,0,0,0,0
107,108,2013,24,10,14,0.43,43,1014,4,4,2,4,3,1,8,4,0,0,0,2,1,0,1,0,0
108,109,2013,16,6,10,0.38,38,1014,2,3,1,1,2,1,4,0,1,0,0,1,1,1,0,0,0
109,110,2013,19,6,13,0.29,28,1014,3,2,1,1,2,1,4,0,0,1,0,2,0,1,0,0,0
110,111,2013,41,19,22,0.47,47,1014,6,10,3,6,6,2,14,6,0,0,0,2,4,1,1,0,0
111,112,2013,14,0,14,0.01,1,1014,0,0,0,0,0,0,0,0,0,0,0,0,0,0,0,0,0
112,113,2013,7,5,2,0.74,74,1014,4,1,0,2,1,0,3,0,2,0,0,1,0,0,0,0,0
113,114,2013,18,13,5,0.72,72,1014,5,6,2,3,3,1,7,2,0,1,0,0,3,0,1,0,0
114,115,2013,5,1,4,0.28,28,1014,0,1,0,0,1,0,1,0,0,0,0,1,0,0,0,0,0
115,116,2013,42,3,39,0.08,8,1014,2,1,0,1,1,0,2,0,1,0,0,1,0,0,0,0,0
116,117,2013,8,5,3,0.59,59,1014,3,2,0,3,1,0,4,3,0,0,0,0,1,0,0,0,0
117,118,2013,15,4,11,0.24,24,1014,1,2,1,1,2,1,4,1,0,0,0,2,0,1,0,0,0
118,119,2013,14,2,12,0.11,11,1014,1,1,0,1,1,0,2,1,0,0,0,1,0,0,0,0,0
119,120,2013,32,30,2,0.94,94,1014,16,13,1,8,13,1,22,3,3,1,1,13,0,1,0,0,0
120,121,2013,32,13,19,0.41,41,1014,7,4,2,4,2,1,7,1,3,0,0,0,2,0,1,0,0
121,122,2013,6,3,3,0.44,44,1014,2,1,0,1,1,0,2,0,1,0,0,1,0,0,0,0,0
122,123,2013,20,11,9,0.56,56,1014,5,5,1,2,3,1,6,1,0,0,1,1,2,1,0,0,0
123,124,2013,40,36,4,0.91,91,1014,17,17,2,10,14,1,25,3,7,0,0,11,3,0,1,0,0
124,125,2013,48,34,14,0.71,71,1014,24,9,1,10,7,1,18,1,4,5,0,5,2,1,0,0,0
125,126,2013,55,10,45,0.18,18,1014,6,3,1,6,2,1,9,6,0,0,0,1,1,1,0,0,0
126,127,2013,15,2,13,0.13,13,1014,1,1,0,1,1,0,2,1,0,0,0,1,0,0,0,0,0
127,128,2013,11,8,3,0.73,73,1014,5,2,1,2,1,1,4,0,1,1,0,0,1,1,0,0,0
128,129,2013,58,53,5,0.91,91,1014,22,27,4,10,18,2,30,5,1,1,3,9,9,1,0,1,0
129,130,2013,15,9,6,0.61,61,1014,6,2,1,3,1,1,5,2,0,0,1,0,1,1,0,0,0
130,131,2013,52,23,29,0.45,45,1014,11,9,3,3,6,3,12,0,0,1,2,3,3,3,0,0,0
131,132,2013,28,13,15,0.48,48,1014,8,4,1,6,2,1,9,5,0,1,0,0,2,1,0,0,0
132,133,2013,57,6,51,0.11,11,1014,3,3,0,2,3,0,5,1,1,0,0,3,0,0,0,0,0
133,134,2013,26,10,16,0.4,40,1014,4,4,2,2,4,1,7,0,2,0,0,4,0,0,1,0,0
134,135,2013,42,32,10,0.76,76,1014,21,10,1,9,8,1,18,4,1,1,3,6,2,1,0,0,0
135,136,2013,9,5,4,0.57,56,1014,3,2,0,3,1,0,4,3,0,0,0,0,1,0,0,0,0
136,137,2013,23,2,21,0.1,10,1014,1,1,0,1,1,0,2,1,0,0,0,1,0,0,0,0,0
137,138,2013,19,17,2,0.87,87,1014,9,7,1,9,7,1,17,9,0,0,0,7,0,1,0,0,0
138,139,2013,42,36,6,0.86,86,1014,26,8,2,16,7,1,24,8,7,0,1,6,1,0,1,0,0
139,140,2013,29,4,25,0.14,14,1014,2,2,0,1,1,0,2,0,1,0,0,0,1,0,0,0,0
140,141,2013,12,12,0,0.98,98,1014,3,6,3,1,5,1,7,0,0,1,0,4,1,0,0,1,0
141,142,2013,7,2,5,0.32,32,1014,1,1,0,1,1,0,2,1,0,0,0,1,0,0,0,0,0
142,143,2013,7,5,2,0.71,71,1014,2,2,1,2,1,1,4,2,0,0,0,0,1,1,0,0,0
143,144,2013,6,3,3,0.48,48,1014,2,1,0,2,1,0,3,2,0,0,0,1,0,0,0,0,0
144,145,2013,15,13,2,0.84,84,1014,8,3,2,8,2,1,11,8,0,0,0,1,1,0,1,0,0
145,146,2013,29,11,18,0.37,37,1014,7,4,0,7,4,0,11,7,0,0,0,4,0,0,0,0,0
146,147,2013,22,2,20,0.08,8,1014,1,1,0,1,1,0,2,1,0,0,0,1,0,0,0,0,0
147,148,2013,19,10,9,0.53,53,1014,7,3,0,7,3,0,10,7,0,0,0,3,0,0,0,0,0
148,149,2013,32,13,19,0.42,42,1014,8,4,1,4,3,1,8,2,0,2,0,2,1,1,0,0,0
149,150,2013,33,30,3,0.92,92,1014,22,5,3,21,5,2,28,20,1,0,0,5,0,1,1,0,0
150,151,2013,16,4,12,0.25,25,1014,2,2,0,2,2,0,4,2,0,0,0,2,0,0,0,0,0
151,152,2013,6,0,6,0.07,7,1014,0,0,0,0,0,0,0,0,0,0,0,0,0,0,0,0,0
152,153,2013,31,27,4,0.86,86,1014,14,12,1,7,8,1,16,4,1,0,2,4,4,1,0,0,0
153,154,2013,32,3,29,0.1,10,1014,2,1,0,1,1,0,2,0,1,0,0,1,0,0,0,0,0
154,155,2013,27,15,12,0.54,54,1014,4,8,3,1,6,3,10,0,0,0,1,4,2,3,0,0,0
155,156,2013,30,10,20,0.33,33,1014,7,2,1,4,2,1,7,2,1,1,0,2,0,1,0,0,0
156,157,2013,22,18,4,0.83,83,1014,9,6,3,9,6,3,18,9,0,0,0,6,0,3,0,0,0
157,158,2013,26,11,15,0.42,42,1014,5,5,1,5,4,1,10,5,0,0,0,3,1,1,0,0,0
158,159,2013,7,4,3,0.53,53,1014,1,2,1,1,1,1,3,1,0,0,0,0,1,1,0,0,0
159,160,2013,21,15,6,0.7,70,1014,6,5,4,4,3,1,8,3,0,1,0,1,2,0,0,0,1
160,161,2013,34,3,31,0.09,9,1014,1,2,0,1,2,0,3,1,0,0,0,2,0,0,0,0,0
161,162,2013,31,9,22,0.28,28,1014,5,4,0,4,4,0,8,3,1,0,0,4,0,0,0,0,0
162,163,2013,54,14,40,0.26,26,1014,8,5,1,7,4,1,12,6,1,0,0,3,1,1,0,0,0
163,164,2013,5,3,2,0.58,57,1014,1,2,0,1,2,0,3,1,0,0,0,2,0,0,0,0,0
164,165,2013,15,4,11,0.27,27,1014,1,2,1,1,1,1,3,1,0,0,0,0,1,1,0,0,0
165,166,2013,30,12,18,0.39,39,1014,5,7,0,3,4,0,7,2,0,1,0,1,3,0,0,0,0
166,167,2013,15,0,15,0.01,1,1014,0,0,0,0,0,0,0,0,0,0,0,0,0,0,0,0,0
167,168,2013,48,41,7,0.86,86,1014,25,13,3,13,9,1,23,6,3,3,1,5,4,0,0,1,0
168,169,2013,45,8,37,0.18,18,1014,4,4,0,1,4,0,5,0,0,0,1,4,0,0,0,0,0
169,170,2013,26,24,2,0.91,91,1014,13,9,2,4,7,2,13,0,1,1,2,5,2,2,0,0,0
170,171,2013,13,3,10,0.23,23,1014,1,2,0,1,2,0,3,1,0,0,0,2,0,0,0,0,0
171,172,2013,40,1,39,0.02,2,1014,0,1,0,0,1,0,1,0,0,0,0,1,0,0,0,0,0
172,173,2013,39,8,31,0.21,21,1014,4,3,1,2,2,1,5,1,0,1,0,1,1,1,0,0,0
173,174,2013,38,17,21,0.45,45,1014,11,4,2,11,2,2,15,11,0,0,0,0,2,2,0,0,0
174,175,2013,39,21,18,0.55,55,1014,8,10,3,7,10,2,19,6,1,0,0,10,0,1,1,0,0
175,176,2013,14,13,1,0.95,95,1014,3,7,3,2,7,1,10,1,1,0,0,7,0,0,0,1,0
176,177,2013,17,15,2,0.89,89,1014,10,4,1,4,4,1,9,0,2,2,0,4,0,1,0,0,0
177,178,2013,14,9,5,0.62,62,1014,6,2,1,5,1,1,7,4,1,0,0,0,1,1,0,0,0
178,179,2013,30,2,28,0.08,8,1014,1,1,0,1,1,0,2,1,0,0,0,1,0,0,0,0,0
179,180,2013,51,8,43,0.16,16,1014,3,4,1,1,4,1,6,0,0,1,0,4,0,1,0,0,0
180,181,2013,26,7,19,0.26,26,1014,2,3,2,2,3,2,7,2,0,0,0,3,0,2,0,0,0
181,182,2013,33,26,7,0.8,80,1014,9,13,4,9,8,1,18,9,0,0,0,3,5,0,0,0,1
182,183,2013,32,4,28,0.12,12,1014,3,1,0,2,1,0,3,1,1,0,0,1,0,0,0,0,0
183,184,2013,40,18,22,0.46,46,1014,13,3,2,5,2,1,8,1,2,0,2,1,1,0,1,0,0
184,185,2013,7,5,2,0.68,68,1014,1,3,1,1,3,1,5,1,0,0,0,3,0,1,0,0,0
185,186,2013,14,7,7,0.52,52,1014,5,2,0,2,1,0,3,1,0,0,1,0,1,0,0,0,0
186,187,2013,22,20,2,0.89,89,1014,11,6,3,11,4,1,16,11,0,0,0,2,2,0,0,1,0
187,188,2013,19,11,8,0.56,56,1014,6,5,0,3,4,0,7,1,1,1,0,3,1,0,0,0,0
188,189,2013,16,15,1,0.91,91,1014,7,6,2,5,5,2,12,4,0,1,0,4,1,2,0,0,0
189,190,2013,33,33,0,0.99,99,1014,16,16,1,8,11,1,20,2,5,0,1,6,5,1,0,0,0
190,191,2013,13,7,6,0.53,53,1014,3,3,1,1,2,1,4,0,0,1,0,1,1,1,0,0,0
191,192,2013,7,4,3,0.6,60,1014,1,2,1,1,1,1,3,1,0,0,0,0,1,1,0,0,0
192,193,2013,39,28,11,0.71,71,1014,11,15,2,11,13,1,25,11,0,0,0,11,2,0,1,0,0
193,194,2013,40,36,4,0.89,89,1014,25,10,1,18,5,1,24,12,5,1,0,0,5,1,0,0,0
194,195,2013,34,11,23,0.32,32,1014,6,4,1,6,2,1,9,6,0,0,0,0,2,1,0,0,0
195,196,2013,19,12,7,0.61,61,1014,7,3,2,2,2,2,6,0,0,1,1,1,1,2,0,0,0
196,197,2013,8,3,5,0.33,33,1014,1,2,0,1,2,0,3,1,0,0,0,2,0,0,0,0,0
197,198,2013,30,4,26,0.13,13,1014,2,2,0,1,2,0,3,0,1,0,0,2,0,0,0,0,0
198,199,2013,6,2,4,0.35,35,1014,1,1,0,1,1,0,2,1,0,0,0,1,0,0,0,0,0
199,200,2013,54,20,34,0.37,37,1014,5,11,4,4,7,2,13,3,1,0,0,3,4,1,0,1,0
200,201,2013,46,38,8,0.82,82,1014,25,13,0,16,9,0,25,10,3,3,0,5,4,0,0,0,0
201,202,2013,35,2,33,0.05,5,1014,1,1,0,1,1,0,2,1,0,0,0,1,0,0,0,0,0
202,203,2013,25,2,23,0.1,10,1014,1,1,0,1,1,0,2,1,0,0,0,1,0,0,0,0,0
203,204,2013,38,16,22,0.41,41,1014,10,5,1,7,3,1,11,4,3,0,0,1,2,1,0,0,0
204,205,2013,27,23,4,0.86,86,1014,13,8,2,7,7,2,16,2,4,1,0,6,1,2,0,0,0
205,206,2013,31,24,7,0.77,77,1014,14,7,3,12,6,2,20,10,2,0,0,5,1,1,1,0,0
206,207,2013,6,4,2,0.74,74,1014,2,2,0,2,2,0,4,2,0,0,0,2,0,0,0,0,0
207,208,2013,36,31,5,0.85,85,1014,16,15,0,11,9,0,20,9,0,1,1,3,6,0,0,0,0
208,209,2013,32,0,32,0.0,0,1014,0,0,0,0,0,0,0,0,0,0,0,0,0,0,0,0,0
209,210,2013,34,4,30,0.12,12,1014,1,2,1,1,2,1,4,1,0,0,0,2,0,1,0,0,0
210,211,2013,31,26,5,0.83,83,1014,14,11,1,6,11,1,18,3,0,1,2,11,0,1,0,0,0
211,212,2013,35,22,13,0.64,64,1014,13,9,0,12,7,0,19,11,1,0,0,5,2,0,0,0,0
212,213,2013,10,0,10,0.04,4,1014,0,0,0,0,0,0,0,0,0,0,0,0,0,0,0,0,0
213,214,2013,18,17,1,0.95,95,1014,13,3,1,4,3,1,8,1,0,0,3,3,0,1,0,0,0
214,215,2013,5,4,1,0.7,70,1014,1,2,1,1,2,1,4,1,0,0,0,2,0,1,0,0,0
215,216,2013,26,12,14,0.47,47,1014,4,6,2,2,5,2,9,1,0,1,0,4,1,2,0,0,0
216,217,2013,36,17,19,0.48,48,1014,6,8,3,3,6,3,12,2,0,0,1,4,2,3,0,0,0
217,218,2013,39,27,12,0.68,68,1014,11,14,2,7,13,2,22,5,0,2,0,12,1,2,0,0,0
218,219,2013,48,31,17,0.64,64,1014,17,11,3,13,11,1,25,11,0,2,0,11,0,0,0,1,0
219,220,2013,44,11,33,0.25,25,1014,4,5,2,3,3,1,7,2,1,0,0,1,2,0,1,0,0
220,221,2013,37,23,14,0.61,61,1014,9,12,2,3,12,2,17,1,0,0,2,12,0,2,0,0,0
221,222,2013,15,3,12,0.21,21,1014,1,2,0,1,1,0,2,1,0,0,0,0,1,0,0,0,0
222,223,2013,50,46,4,0.91,91,1014,21,23,2,6,13,2,21,0,0,3,3,3,10,2,0,0,0
223,224,2013,21,10,11,0.47,47,1014,3,4,3,1,4,1,6,0,0,1,0,4,0,0,0,1,0
224,225,2013,16,16,0,0.97,97,1014,4,9,3,4,8,2,14,4,0,0,0,7,1,1,1,0,0
225,226,2013,7,5,2,0.74,74,1014,1,3,1,1,2,1,4,1,0,0,0,1,1,1,0,0,0
226,227,2013,17,10,7,0.58,57,1014,3,5,2,1,3,2,6,0,0,1,0,1,2,2,0,0,0
227,228,2013,11,2,9,0.2,20,1014,1,1,0,1,1,0,2,1,0,0,0,1,0,0,0,0,0
228,229,2013,14,9,5,0.66,66,1014,5,3,1,4,3,1,8,3,1,0,0,3,0,1,0,0,0
229,230,2013,22,5,17,0.23,23,1014,2,2,1,1,1,1,3,0,1,0,0,0,1,1,0,0,0
230,231,2013,17,8,9,0.47,47,1014,3,3,2,2,3,2,7,1,1,0,0,3,0,2,0,0,0
231,232,2013,30,16,14,0.55,55,1014,9,6,1,8,3,1,12,7,1,0,0,0,3,1,0,0,0
232,233,2013,16,3,13,0.17,17,1014,2,1,0,2,1,0,3,2,0,0,0,1,0,0,0,0,0
233,234,2013,24,1,23,0.04,4,1014,0,1,0,0,1,0,1,0,0,0,0,1,0,0,0,0,0
234,235,2013,22,22,0,0.99,99,1014,9,12,1,6,10,1,17,3,3,0,0,8,2,1,0,0,0
235,236,2013,14,5,9,0.34,34,1014,1,3,1,1,3,1,5,1,0,0,0,3,0,1,0,0,0
236,237,2013,42,2,40,0.04,4,1014,1,1,0,1,1,0,2,1,0,0,0,1,0,0,0,0,0
237,238,2013,17,11,6,0.63,63,1014,7,3,1,7,3,1,11,7,0,0,0,3,0,1,0,0,0
238,239,2013,12,0,12,0.03,3,1014,0,0,0,0,0,0,0,0,0,0,0,0,0,0,0,0,0
239,240,2013,28,13,15,0.45,45,1014,4,6,3,4,6,1,11,4,0,0,0,6,0,0,0,1,0
240,241,2013,18,13,5,0.71,71,1014,3,7,3,3,5,2,10,3,0,0,0,3,2,1,1,0,0
241,242,2013,55,40,15,0.73,73,1014,24,14,2,20,9,2,31,16,4,0,0,4,5,2,0,0,0
242,243,2013,22,6,16,0.26,26,1014,3,3,0,1,3,0,4,0,0,1,0,3,0,0,0,0,0
243,244,2013,53,29,24,0.55,55,1014,18,7,4,17,7,4,28,16,1,0,0,7,0,4,0,0,0
244,245,2013,46,17,29,0.37,37,1014,9,5,3,4,4,3,11,1,2,0,1,3,1,3,0,0,0
245,246,2013,30,28,2,0.92,92,1014,18,10,0,13,10,0,23,9,3,1,0,10,0,0,0,0,0
246,247,2013,39,9,30,0.22,22,1014,6,2,1,5,1,1,7,4,1,0,0,0,1,1,0,0,0
247,248,2013,15,10,5,0.64,64,1014,3,5,2,3,4,2,9,3,0,0,0,3,1,2,0,0,0
248,249,2013,13,8,5,0.6,60,1014,4,4,0,2,4,0,6,1,0,1,0,4,0,0,0,0,0
249,250,2013,46,14,32,0.3,30,1014,6,5,3,4,4,1,9,2,2,0,0,3,1,0,0,1,0
250,251,2013,51,13,38,0.25,25,1014,8,3,2,4,3,1,8,0,4,0,0,3,0,0,1,0,0
251,252,2013,11,5,6,0.43,43,1014,2,2,1,2,1,1,4,2,0,0,0,0,1,1,0,0,0
252,253,2013,57,31,26,0.54,54,1014,21,9,1,17,5,1,23,15,0,2,0,1,4,1,0,0,0
253,254,2013,30,13,17,0.44,44,1014,6,6,1,2,5,1,8,0,0,2,0,4,1,1,0,0,0
254,255,2013,35,18,17,0.52,52,1014,8,6,4,5,6,2,13,4,0,0,1,6,0,0,2,0,0
255,256,2013,34,3,31,0.08,8,1014,1,2,0,1,2,0,3,1,0,0,0,2,0,0,0,0,0
256,257,2013,15,14,1,0.91,91,1014,7,7,0,4,4,0,8,1,3,0,0,1,3,0,0,0,0
257,258,2013,37,14,23,0.38,38,1014,3,8,3,2,6,2,10,1,1,0,0,4,2,1,1,0,0
258,259,2013,14,0,14,0.03,3,1014,0,0,0,0,0,0,0,0,0,0,0,0,0,0,0,0,0
259,260,2013,56,15,41,0.27,27,1014,6,9,0,2,9,0,11,0,0,2,0,9,0,0,0,0,0
260,261,2013,7,3,4,0.43,43,1014,2,1,0,2,1,0,3,2,0,0,0,1,0,0,0,0,0
261,262,2013,30,5,25,0.18,18,1014,2,3,0,1,3,0,4,0,1,0,0,3,0,0,0,0,0
262,263,2013,29,26,3,0.89,89,1014,16,7,3,13,6,1,20,12,0,0,1,5,1,0,0,1,0
263,264,2013,25,20,5,0.81,81,1014,10,9,1,8,7,1,16,7,0,1,0,5,2,1,0,0,0
264,265,2013,23,11,12,0.48,48,1014,3,5,3,3,5,3,11,3,0,0,0,5,0,3,0,0,0
265,266,2013,25,9,16,0.35,35,1014,5,3,1,3,2,1,6,1,2,0,0,1,1,1,0,0,0
266,267,2013,12,11,1,0.95,95,1014,3,5,3,3,5,3,11,3,0,0,0,5,0,3,0,0,0
267,268,2013,19,10,9,0.52,52,1014,4,4,2,2,2,2,6,0,2,0,0,0,2,2,0,0,0
268,269,2013,32,1,31,0.02,2,1014,0,1,0,0,1,0,1,0,0,0,0,1,0,0,0,0,0
269,270,2013,35,28,7,0.79,79,1014,15,13,0,11,7,0,18,7,4,0,0,1,6,0,0,0,0
270,271,2013,30,24,6,0.79,79,1014,15,8,1,9,8,1,18,3,6,0,0,8,0,1,0,0,0
271,272,2013,46,37,9,0.81,81,1014,21,15,1,14,13,1,28,7,7,0,0,11,2,1,0,0,0
272,273,2013,14,13,1,0.92,92,1014,7,6,0,2,5,0,7,0,0,1,1,4,1,0,0,0,0
273,274,2013,19,13,6,0.68,68,1014,9,3,1,8,3,1,12,7,1,0,0,3,0,1,0,0,0
274,275,2013,11,1,10,0.11,11,1014,0,1,0,0,1,0,1,0,0,0,0,1,0,0,0,0,0
275,276,2013,31,21,10,0.67,67,1014,13,6,2,10,6,2,18,7,3,0,0,6,0,2,0,0,0
276,277,2013,28,22,6,0.77,77,1014,6,13,3,5,13,1,19,4,1,0,0,13,0,0,0,1,0
277,278,2013,31,26,5,0.83,83,1014,15,8,3,4,4,1,9,0,0,1,3,0,4,0,0,1,0
278,279,2013,21,4,17,0.19,19,1014,1,2,1,1,2,1,4,1,0,0,0,2,0,1,0,0,0
279,280,2013,15,12,3,0.77,77,1014,5,6,1,3,3,1,7,2,0,1,0,0,3,1,0,0,0
280,281,2013,39,21,18,0.55,55,1014,12,9,0,3,9,0,12,0,0,0,3,9,0,0,0,0,0
281,282,2013,49,12,37,0.25,25,1014,5,4,3,2,4,2,8,1,0,0,1,4,0,1,1,0,0
282,283,2013,20,1,19,0.03,3,1014,0,1,0,0,1,0,1,0,0,0,0,1,0,0,0,0,0
283,284,2013,11,1,10,0.05,5,1014,0,1,0,0,1,0,1,0,0,0,0,1,0,0,0,0,0
284,285,2013,48,22,26,0.45,45,1014,10,9,3,3,8,3,14,0,1,0,2,7,1,3,0,0,0
285,286,2013,28,2,26,0.07,7,1014,1,1,0,1,1,0,2,1,0,0,0,1,0,0,0,0,0
286,287,2013,15,13,2,0.86,86,1014,7,5,1,5,5,1,11,4,0,1,0,5,0,1,0,0,0
287,288,2013,37,12,25,0.33,33,1014,4,6,2,2,5,1,8,0,2,0,0,4,1,0,1,0,0
288,289,2013,20,9,11,0.46,46,1014,5,4,0,2,3,0,5,0,1,1,0,2,1,0,0,0,0
289,290,2013,22,12,10,0.54,54,1014,4,7,1,4,6,1,11,4,0,0,0,5,1,1,0,0,0
290,291,2013,39,37,2,0.94,94,1014,26,7,4,13,6,1,20,7,1,3,2,5,1,0,0,0,1
291,292,2013,15,10,5,0.7,70,1014,6,3,1,3,2,1,6,0,3,0,0,1,1,1,0,0,0
292,293,2013,20,18,2,0.88,88,1014,13,4,1,13,2,1,16,13,0,0,0,0,2,1,0,0,0
293,294,2013,22,13,9,0.57,56,1014,6,4,3,6,4,1,11,6,0,0,0,4,0,0,0,1,0
294,295,2013,49,10,39,0.2,20,1014,6,4,0,6,2,0,8,6,0,0,0,0,2,0,0,0,0
295,296,2013,18,0,18,0.02,2,1014,0,0,0,0,0,0,0,0,0,0,0,0,0,0,0,0,0
296,297,2013,35,8,27,0.24,24,1014,4,3,1,4,3,1,8,4,0,0,0,3,0,1,0,0,0
297,298,2013,44,31,13,0.7,70,1014,13,16,2,5,13,1,19,0,3,1,1,10,3,0,1,0,0
298,299,2013,33,21,12,0.63,63,1014,8,12,1,4,12,1,17,0,4,0,0,12,0,1,0,0,0
299,300,2013,25,8,17,0.31,31,1014,5,3,0,2,3,0,5,0,1,1,0,3,0,0,0,0,0
300,301,2013,30,15,15,0.49,49,1014,6,7,2,5,5,2,12,4,1,0,0,3,2,2,0,0,0
301,302,2013,29,10,19,0.34,34,1014,3,4,3,1,3,1,5,0,0,1,0,2,1,0,0,1,0
302,303,2013,56,53,3,0.94,94,1014,29,21,3,24,15,1,40,22,0,1,1,9,6,0,0,1,0
303,304,2013,47,11,36,0.23,23,1014,7,3,1,4,2,1,7,1,3,0,0,1,1,1,0,0,0
304,305,2013,18,9,9,0.52,52,1014,5,4,0,3,4,0,7,1,2,0,0,4,0,0,0,0,0
305,306,2013,49,32,17,0.65,65,1014,17,12,3,16,7,3,26,15,1,0,0,2,5,3,0,0,0
306,307,2013,35,20,15,0.57,56,1014,12,5,3,12,3,3,18,12,0,0,0,1,2,3,0,0,0
307,308,2013,13,8,5,0.62,62,1014,2,5,1,2,5,1,8,2,0,0,0,5,0,1,0,0,0
308,309,2013,10,4,6,0.42,42,1014,3,1,0,2,1,0,3,1,1,0,0,1,0,0,0,0,0
309,310,2013,37,0,37,0.0,0,1014,0,0,0,0,0,0,0,0,0,0,0,0,0,0,0,0,0
310,311,2013,30,28,2,0.95,95,1014,20,7,1,5,6,1,12,0,0,0,5,5,1,1,0,0,0
311,312,2013,11,5,6,0.49,49,1014,1,3,1,1,3,1,5,1,0,0,0,3,0,1,0,0,0
312,313,2013,60,41,19,0.68,68,1014,19,19,3,6,13,2,21,0,1,3,2,7,6,1,1,0,0
313,314,2013,9,7,2,0.83,83,1014,4,2,1,4,1,1,6,4,0,0,0,0,1,1,0,0,0
314,315,2013,54,51,3,0.94,94,1014,24,26,1,23,18,1,42,22,1,0,0,10,8,1,0,0,0
315,316,2013,15,14,1,0.93,93,1014,5,8,1,2,7,1,10,0,1,1,0,6,1,1,0,0,0
316,317,2013,41,25,16,0.62,62,1014,16,5,4,12,3,4,19,10,1,0,1,1,2,4,0,0,0
317,318,2013,26,17,9,0.65,65,1014,6,10,1,2,5,1,8,0,0,2,0,0,5,1,0,0,0
318,319,2013,7,7,0,0.99,99,1014,3,3,1,2,2,1,5,1,1,0,0,1,1,1,0,0,0
319,320,2013,28,8,20,0.29,28,1014,2,5,1,2,3,1,6,2,0,0,0,1,2,1,0,0,0
320,321,2013,5,4,1,0.7,70,1014,2,2,0,1,1,0,2,0,1,0,0,0,1,0,0,0,0
321,322,2013,14,7,7,0.48,48,1014,4,2,1,2,1,1,4,0,2,0,0,0,1,1,0,0,0
322,323,2013,57,16,41,0.28,28,1014,5,10,1,4,9,1,14,3,1,0,0,8,1,1,0,0,0
323,324,2013,26,5,21,0.19,19,1014,1,3,1,1,2,1,4,1,0,0,0,1,1,1,0,0,0
324,325,2013,25,24,1,0.97,97,1014,11,12,1,9,7,1,17,7,2,0,0,2,5,1,0,0,0
325,326,2013,27,8,19,0.29,28,1014,3,5,0,1,5,0,6,0,0,1,0,5,0,0,0,0,0
326,327,2013,52,33,19,0.63,63,1014,23,8,2,23,8,2,33,23,0,0,0,8,0,2,0,0,0
327,328,2013,9,3,6,0.37,37,1014,2,1,0,1,1,0,2,0,1,0,0,1,0,0,0,0,0
328,329,2013,25,24,1,0.96,96,1014,8,14,2,4,11,2,17,2,0,2,0,8,3,2,0,0,0
329,330,2013,30,8,22,0.26,26,1014,5,2,1,2,2,1,5,0,1,1,0,2,0,1,0,0,0
330,331,2013,59,46,13,0.78,78,1014,19,25,2,5,25,1,31,0,0,1,4,25,0,0,1,0,0
331,332,2013,43,3,40,0.06,6,1014,2,1,0,2,1,0,3,2,0,0,0,1,0,0,0,0,0
332,333,2013,27,4,23,0.14,14,1014,3,1,0,2,1,0,3,1,1,0,0,1,0,0,0,0,0
333,334,2013,24,9,15,0.38,38,1014,3,4,2,3,3,1,7,3,0,0,0,2,1,0,1,0,0
334,335,2013,58,36,22,0.62,62,1014,15,20,1,7,14,1,22,3,1,2,1,8,6,1,0,0,0
335,336,2013,40,19,21,0.48,48,1014,10,5,4,5,3,4,12,3,0,1,1,1,2,4,0,0,0
336,337,2013,31,8,23,0.25,25,1014,2,4,2,1,4,2,7,0,1,0,0,4,0,2,0,0,0
337,338,2013,15,9,6,0.6,60,1014,3,4,2,3,3,1,7,3,0,0,0,2,1,0,1,0,0
338,339,2013,23,12,11,0.51,51,1014,3,6,3,2,3,2,7,1,1,0,0,0,3,1,1,0,0
339,340,2013,38,29,9,0.76,76,1014,11,16,2,9,15,2,26,7,2,0,0,14,1,2,0,0,0
340,341,2013,27,19,8,0.7,70,1014,8,8,3,7,6,2,15,6,1,0,0,4,2,1,1,0,0
341,342,2013,8,2,6,0.29,28,1014,1,1,0,1,1,0,2,1,0,0,0,1,0,0,0,0,0
342,343,2013,50,24,26,0.49,49,1014,13,11,0,6,6,0,12,0,5,1,0,1,5,0,0,0,0
343,344,2013,23,21,2,0.93,93,1014,13,6,2,13,4,2,19,13,0,0,0,2,2,2,0,0,0
344,345,2013,40,26,14,0.66,66,1014,15,11,0,5,9,0,14,1,0,2,2,7,2,0,0,0,0
345,346,2013,48,35,13,0.73,73,1014,16,16,3,4,11,1,16,0,0,0,4,6,5,0,0,1,0
346,347,2013,21,17,4,0.82,82,1014,9,7,1,4,7,1,12,0,3,1,0,7,0,1,0,0,0
347,348,2013,38,34,4,0.9,90,1014,16,16,2,8,11,1,20,4,2,0,2,6,5,0,1,0,0
348,349,2013,24,23,1,0.97,97,1014,16,4,3,15,4,2,21,14,1,0,0,4,0,1,1,0,0
349,350,2013,39,33,6,0.84,84,1014,19,13,1,5,8,1,14,0,0,1,4,3,5,1,0,0,0
350,351,2013,29,3,26,0.11,11,1014,1,2,0,1,1,0,2,1,0,0,0,0,1,0,0,0,0
351,352,2013,36,19,17,0.53,53,1014,10,5,4,5,5,4,14,2,2,0,1,5,0,4,0,0,0
352,353,2013,39,34,5,0.87,87,1014,15,17,2,13,12,1,26,12,0,1,0,7,5,0,1,0,0
353,354,2013,15,3,12,0.2,20,1014,2,1,0,1,1,0,2,0,1,0,0,1,0,0,0,0,0
354,355,2013,22,20,2,0.89,89,1014,8,11,1,5,6,1,12,2,3,0,0,1,5,1,0,0,0
355,356,2013,31,17,14,0.55,55,1014,9,7,1,7,4,1,12,6,0,1,0,1,3,1,0,0,0
356,357,2013,26,5,21,0.2,20,1014,3,2,0,1,2,0,3,0,0,1,0,2,0,0,0,0,0
357,358,2013,49,0,49,0.01,1,1014,0,0,0,0,0,0,0,0,0,0,0,0,0,0,0,0,0
358,359,2013,36,12,24,0.34,34,1014,7,4,1,7,3,1,11,7,0,0,0,2,1,1,0,0,0
359,360,2013,37,20,17,0.55,55,1014,13,7,0,9,5,0,14,7,0,2,0,3,2,0,0,0,0
360,361,2013,27,4,23,0.13,13,1014,2,2,0,1,1,0,2,0,1,0,0,0,1,0,0,0,0
361,362,2013,18,4,14,0.22,22,1014,1,2,1,1,1,1,3,1,0,0,0,0,1,1,0,0,0
362,363,2013,34,24,10,0.72,72,1014,15,9,0,4,6,0,10,0,0,1,3,3,3,0,0,0,0
363,364,2013,35,22,13,0.64,64,1014,10,11,1,7,8,1,16,4,3,0,0,5,3,1,0,0,0
364,365,2013,25,8,17,0.34,34,1014,5,2,1,5,1,1,7,5,0,0,0,0,1,1,0,0,0
365,366,2013,9,2,7,0.24,24,1014,1,1,0,1,1,0,2,1,0,0,0,1,0,0,0,0,0
366,367,2013,12,6,6,0.52,52,1014,2,3,1,2,2,1,5,2,0,0,0,1,1,1,0,0,0
367,368,2013,58,7,51,0.12,12,1014,5,2,0,2,2,0,4,1,0,0,1,2,0,0,0,0,0
368,369,2013,51,24,27,0.47,47,1014,10,12,2,3,7,2,12,0,0,2,1,2,5,2,0,0,0
369,370,2013,28,1,27,0.03,3,1014,0,1,0,0,1,0,1,0,0,0,0,1,0,0,0,0,0
370,371,2013,15,8,7,0.56,56,1014,2,4,2,1,4,1,6,0,1,0,0,4,0,0,1,0,0
371,372,2013,6,0,6,0.06,6,1014,0,0,0,0,0,0,0,0,0,0,0,0,0,0,0,0,0
372,373,2013,16,10,6,0.65,65,1014,6,4,0,2,3,0,5,0,1,0,1,2,1,0,0,0,0
373,374,2013,16,14,2,0.9,90,1014,6,7,1,4,4,1,9,3,0,1,0,1,3,1,0,0,0
374,375,2013,33,1,32,0.03,3,1014,0,1,0,0,1,0,1,0,0,0,0,1,0,0,0,0,0
375,376,2013,36,5,31,0.13,13,1014,2,3,0,2,2,0,4,2,0,0,0,1,1,0,0,0,0
376,377,2013,9,9,0,0.97,97,1014,2,5,2,1,3,2,6,0,1,0,0,1,2,2,0,0,0
377,378,2013,14,9,5,0.65,65,1014,4,3,2,4,3,2,9,4,0,0,0,3,0,2,0,0,0
378,379,2013,43,37,6,0.85,85,1014,27,10,0,12,5,0,17,5,2,2,3,0,5,0,0,0,0
379,380,2013,42,8,34,0.18,18,1014,4,3,1,4,2,1,7,4,0,0,0,1,1,1,0,0,0
380,381,2013,31,22,9,0.71,71,1014,11,10,1,5,10,1,16,0,4,1,0,10,0,1,0,0,0
381,382,2013,40,29,11,0.72,72,1014,19,7,3,18,4,1,23,17,1,0,0,1,3,0,0,1,0
382,383,2013,20,12,8,0.58,57,1014,6,4,2,6,3,1,10,6,0,0,0,2,1,0,1,0,0
383,384,2013,42,22,20,0.52,52,1014,13,6,3,9,5,1,15,5,4,0,0,4,1,0,0,1,0
384,385,2013,18,12,6,0.66,66,1014,4,6,2,1,4,2,7,0,0,0,1,2,2,2,0,0,0
385,386,2013,56,23,33,0.41,41,1014,10,11,2,5,8,1,14,1,3,1,0,5,3,0,1,0,0
386,387,2013,58,29,29,0.5,50,1014,19,10,0,5,5,0,10,0,0,1,4,0,5,0,0,0,0
387,388,2013,32,15,17,0.48,48,1014,10,4,1,9,2,1,12,8,1,0,0,0,2,1,0,0,0
388,389,2013,50,9,41,0.18,18,1014,2,5,2,2,3,1,6,2,0,0,0,1,2,0,1,0,0
389,390,2013,34,6,28,0.18,18,1014,3,2,1,2,1,1,4,1,1,0,0,0,1,1,0,0,0
390,391,2013,39,21,18,0.55,55,1014,16,4,1,7,4,1,12,0,5,2,0,4,0,1,0,0,0
391,392,2013,15,3,12,0.2,20,1014,1,2,0,1,2,0,3,1,0,0,0,2,0,0,0,0,0
392,393,2013,9,7,2,0.74,74,1014,4,2,1,1,2,1,4,0,0,0,1,2,0,1,0,0,0
393,394,2013,31,1,30,0.03,3,1014,0,1,0,0,1,0,1,0,0,0,0,1,0,0,0,0,0
394,395,2013,11,10,1,0.89,89,1014,3,4,3,3,3,2,8,3,0,0,0,2,1,1,1,0,0
395,396,2013,31,28,3,0.91,91,1014,18,7,3,14,5,1,20,12,0,2,0,3,2,0,0,1,0
396,397,2013,53,18,35,0.34,34,1014,10,8,0,8,6,0,14,6,2,0,0,4,2,0,0,0,0
397,398,2013,15,14,1,0.93,93,1014,10,3,1,10,3,1,14,10,0,0,0,3,0,1,0,0,0
398,399,2013,36,35,1,0.96,96,1014,23,11,1,6,11,1,18,0,0,1,5,11,0,1,0,0,0
399,400,2013,25,10,15,0.4,40,1014,5,3,2,5,2,2,9,5,0,0,0,1,1,2,0,0,0
400,401,2013,22,19,3,0.87,87,1014,12,6,1,12,6,1,19,12,0,0,0,6,0,1,0,0,0
401,402,2013,57,55,2,0.96,96,1014,28,25,2,27,25,2,54,26,1,0,0,25,0,2,0,0,0
402,403,2013,28,22,6,0.8,80,1014,14,5,3,11,5,3,19,10,0,0,1,5,0,3,0,0,0
403,404,2013,9,6,3,0.67,67,1014,2,4,0,2,4,0,6,2,0,0,0,4,0,0,0,0,0
404,405,2013,57,24,33,0.42,42,1014,13,9,2,7,6,2,15,3,3,0,1,3,3,2,0,0,0
405,406,2013,39,18,21,0.46,46,1014,11,4,3,8,3,3,14,6,1,1,0,2,1,3,0,0,0
406,407,2013,9,1,8,0.16,16,1014,0,1,0,0,1,0,1,0,0,0,0,1,0,0,0,0,0
407,408,2013,39,25,14,0.64,64,1014,14,10,1,12,5,1,18,11,0,1,0,0,5,1,0,0,0
408,409,2013,16,16,0,0.99,99,1014,5,8,3,3,8,3,14,1,2,0,0,8,0,3,0,0,0
409,410,2013,52,27,25,0.51,51,1014,13,10,4,13,8,3,24,13,0,0,0,6,2,2,1,0,0
410,411,2013,52,23,29,0.45,45,1014,12,10,1,10,5,1,16,9,0,1,0,0,5,1,0,0,0
411,412,2013,55,32,23,0.58,57,1014,17,14,1,8,11,1,20,1,6,0,1,8,3,1,0,0,0
412,413,2013,9,7,2,0.79,79,1014,3,3,1,3,3,1,7,3,0,0,0,3,0,1,0,0,0
413,414,2013,9,7,2,0.81,81,1014,4,2,1,4,1,1,6,4,0,0,0,0,1,1,0,0,0
414,415,2013,8,5,3,0.57,56,1014,3,2,0,3,1,0,4,3,0,0,0,0,1,0,0,0,0
415,416,2013,26,0,26,0.01,1,1014,0,0,0,0,0,0,0,0,0,0,0,0,0,0,0,0,0
416,417,2013,48,29,19,0.6,60,1014,19,8,2,14,5,2,21,10,3,1,0,2,3,2,0,0,0
417,418,2013,28,1,27,0.05,5,1014,0,1,0,0,1,0,1,0,0,0,0,1,0,0,0,0,0
418,419,2013,20,7,13,0.34,34,1014,4,2,1,3,1,1,5,2,1,0,0,0,1,1,0,0,0
419,420,2013,14,11,3,0.77,77,1014,4,6,1,1,5,1,7,0,0,0,1,4,1,1,0,0,0
420,421,2013,16,9,7,0.56,56,1014,2,5,2,2,3,2,7,2,0,0,0,1,2,2,0,0,0
421,422,2013,15,4,11,0.3,30,1014,2,2,0,2,2,0,4,2,0,0,0,2,0,0,0,0,0
422,423,2013,13,4,9,0.3,30,1014,1,2,1,1,1,1,3,1,0,0,0,0,1,1,0,0,0
423,424,2013,27,3,24,0.1,10,1014,2,1,0,1,1,0,2,0,1,0,0,1,0,0,0,0,0
424,425,2013,20,3,17,0.14,14,1014,2,1,0,1,1,0,2,0,1,0,0,1,0,0,0,0,0
425,426,2013,44,10,34,0.23,23,1014,3,4,3,3,3,1,7,3,0,0,0,2,1,0,0,1,0
426,427,2013,19,10,9,0.53,53,1014,3,4,3,2,2,2,6,1,1,0,0,0,2,1,1,0,0
427,428,2013,33,1,32,0.04,4,1014,0,1,0,0,1,0,1,0,0,0,0,1,0,0,0,0,0
428,429,2013,8,1,7,0.13,13,1014,0,1,0,0,1,0,1,0,0,0,0,1,0,0,0,0,0
429,430,2013,11,6,5,0.5,50,1014,4,2,0,4,2,0,6,4,0,0,0,2,0,0,0,0,0
430,431,2013,55,12,43,0.21,21,1014,4,5,3,4,3,1,8,4,0,0,0,1,2,0,0,1,0
431,432,2013,36,18,18,0.49,49,1014,8,9,1,2,6,1,9,0,0,0,2,3,3,1,0,0,0
432,433,2013,19,13,6,0.68,68,1014,4,8,1,2,4,1,7,1,0,1,0,0,4,1,0,0,0
433,434,2013,14,9,5,0.63,63,1014,4,5,0,3,5,0,8,2,1,0,0,5,0,0,0,0,0
434,435,2013,17,16,1,0.94,94,1014,7,9,0,2,9,0,11,0,0,1,1,9,0,0,0,0,0
435,436,2013,40,15,25,0.37,37,1014,7,8,0,2,6,0,8,0,0,1,1,4,2,0,0,0,0
436,437,2013,11,7,4,0.62,62,1014,3,3,1,1,3,1,5,0,0,1,0,3,0,1,0,0,0
437,438,2013,9,9,0,0.96,96,1014,4,4,1,1,4,1,6,0,0,0,1,4,0,1,0,0,0
438,439,2013,30,2,28,0.06,6,1014,1,1,0,1,1,0,2,1,0,0,0,1,0,0,0,0,0
439,440,2013,31,28,3,0.9,90,1014,18,10,0,17,6,0,23,16,1,0,0,2,4,0,0,0,0
440,441,2013,6,0,6,0.01,1,1014,0,0,0,0,0,0,0,0,0,0,0,0,0,0,0,0,0
441,442,2013,36,29,7,0.8,80,1014,14,13,2,6,7,2,15,0,4,2,0,1,6,2,0,0,0
442,443,2013,52,25,27,0.49,49,1014,18,4,3,9,3,3,15,4,2,2,1,2,1,3,0,0,0
443,444,2013,40,10,30,0.26,26,1014,3,6,1,3,4,1,8,3,0,0,0,2,2,1,0,0,0
444,445,2013,6,3,3,0.57,56,1014,1,2,0,1,1,0,2,1,0,0,0,0,1,0,0,0,0
445,446,2013,40,4,36,0.1,10,1014,1,2,1,1,1,1,3,1,0,0,0,0,1,1,0,0,0
446,447,2013,28,9,19,0.33,33,1014,4,4,1,4,4,1,9,4,0,0,0,4,0,1,0,0,0
447,448,2013,31,8,23,0.27,27,1014,3,4,1,3,3,1,7,3,0,0,0,2,1,1,0,0,0
448,449,2013,22,13,9,0.57,56,1014,5,5,3,4,3,2,9,3,1,0,0,1,2,1,1,0,0
449,450,2013,11,10,1,0.93,93,1014,4,5,1,2,5,1,8,0,2,0,0,5,0,1,0,0,0
450,451,2013,20,10,10,0.51,51,1014,3,4,3,2,3,2,7,1,1,0,0,2,1,1,1,0,0
451,452,2013,39,2,37,0.04,4,1014,1,1,0,1,1,0,2,1,0,0,0,1,0,0,0,0,0
452,453,2013,37,28,9,0.75,75,1014,20,7,1,11,7,1,19,3,7,1,0,7,0,1,0,0,0
453,454,2013,55,37,18,0.67,67,1014,24,9,4,11,6,3,20,4,3,2,2,3,3,2,1,0,0
454,455,2013,20,8,12,0.38,38,1014,4,3,1,4,3,1,8,4,0,0,0,3,0,1,0,0,0
455,456,2013,31,22,9,0.7,70,1014,10,12,0,5,9,0,14,1,3,1,0,6,3,0,0,0,0
456,457,2013,19,12,7,0.63,63,1014,3,7,2,1,6,2,9,0,0,1,0,5,1,2,0,0,0
457,458,2013,37,31,6,0.83,83,1014,18,12,1,16,9,1,26,15,0,1,0,6,3,1,0,0,0
458,459,2013,40,31,9,0.78,78,1014,18,10,3,13,10,1,24,10,2,0,1,10,0,0,0,1,0
459,460,2013,44,29,15,0.66,66,1014,11,14,4,3,10,3,16,0,0,1,2,6,4,2,1,0,0
460,461,2013,5,2,3,0.46,46,1014,1,1,0,1,1,0,2,1,0,0,0,1,0,0,0,0,0
461,462,2013,25,14,11,0.57,56,1014,8,5,1,2,4,1,7,0,0,0,2,3,1,1,0,0,0
462,463,2013,13,5,8,0.39,39,1014,1,3,1,1,3,1,5,1,0,0,0,3,0,1,0,0,0
463,464,2013,26,10,16,0.4,40,1014,7,3,0,5,2,0,7,4,0,1,0,1,1,0,0,0,0
464,465,2013,24,4,20,0.18,18,1014,2,2,0,1,1,0,2,0,1,0,0,0,1,0,0,0,0
465,466,2013,11,0,11,0.0,0,1014,0,0,0,0,0,0,0,0,0,0,0,0,0,0,0,0,0
466,467,2013,11,4,7,0.38,38,1014,1,2,1,1,2,1,4,1,0,0,0,2,0,1,0,0,0
467,468,2013,7,0,7,0.07,7,1014,0,0,0,0,0,0,0,0,0,0,0,0,0,0,0,0,0
468,469,2013,34,26,8,0.76,76,1014,12,11,3,5,8,1,14,0,4,0,1,5,3,0,0,1,0
469,470,2013,33,12,21,0.37,37,1014,3,6,3,1,3,2,6,0,0,1,0,0,3,1,1,0,0
470,471,2013,36,7,29,0.2,20,1014,2,3,2,2,2,2,6,2,0,0,0,1,1,2,0,0,0
471,472,2013,31,18,13,0.57,56,1014,8,10,0,6,7,0,13,5,0,1,0,4,3,0,0,0,0
472,473,2013,48,17,31,0.35,35,1014,7,8,2,4,6,2,12,2,1,1,0,4,2,2,0,0,0
473,474,2013,21,18,3,0.85,85,1014,13,5,0,13,4,0,17,13,0,0,0,3,1,0,0,0,0
474,475,2013,19,2,17,0.08,8,1014,1,1,0,1,1,0,2,1,0,0,0,1,0,0,0,0,0
475,476,2013,20,2,18,0.12,12,1014,1,1,0,1,1,0,2,1,0,0,0,1,0,0,0,0,0
476,477,2013,21,0,21,0.01,1,1014,0,0,0,0,0,0,0,0,0,0,0,0,0,0,0,0,0
477,478,2013,30,10,20,0.35,35,1014,7,2,1,2,2,1,5,0,0,1,1,2,0,1,0,0,0
478,479,2013,7,7,0,0.93,93,1014,4,2,1,2,2,1,5,1,0,1,0,2,0,1,0,0,0
479,480,2013,45,34,11,0.76,76,1014,15,15,4,6,11,3,20,3,0,0,3,7,4,2,1,0,0
480,481,2013,51,37,14,0.73,73,1014,24,11,2,16,10,1,27,9,6,1,0,9,1,0,1,0,0
481,482,2013,10,2,8,0.21,21,1014,1,1,0,1,1,0,2,1,0,0,0,1,0,0,0,0,0
482,483,2013,30,19,11,0.63,63,1014,5,11,3,3,8,2,13,2,0,1,0,5,3,1,1,0,0
483,484,2013,9,3,6,0.37,37,1014,2,1,0,2,1,0,3,2,0,0,0,1,0,0,0,0,0
484,485,2013,24,4,20,0.17,17,1014,2,2,0,1,2,0,3,0,1,0,0,2,0,0,0,0,0
485,486,2013,22,0,22,0.02,2,1014,0,0,0,0,0,0,0,0,0,0,0,0,0,0,0,0,0
486,487,2013,31,28,3,0.91,91,1014,14,12,2,7,9,2,18,3,1,3,0,6,3,2,0,0,0
487,488,2013,8,7,1,0.85,85,1014,3,4,0,3,3,0,6,3,0,0,0,2,1,0,0,0,0
488,489,2013,25,7,18,0.28,28,1014,4,2,1,2,1,1,4,0,2,0,0,0,1,1,0,0,0
489,490,2013,33,12,21,0.37,37,1014,7,5,0,3,5,0,8,1,0,2,0,5,0,0,0,0,0
490,491,2013,5,0,5,0.05,5,1014,0,0,0,0,0,0,0,0,0,0,0,0,0,0,0,0,0
491,492,2013,7,5,2,0.71,71,1014,2,2,1,1,2,1,4,0,1,0,0,2,0,1,0,0,0
492,493,2013,10,6,4,0.65,65,1014,3,3,0,3,2,0,5,3,0,0,0,1,1,0,0,0,0
493,494,2013,9,3,6,0.35,35,1014,2,1,0,2,1,0,3,2,0,0,0,1,0,0,0,0,0
494,495,2013,13,4,9,0.31,31,1014,1,2,1,1,1,1,3,1,0,0,0,0,1,1,0,0,0
495,496,2013,50,38,12,0.77,77,1014,24,10,4,18,5,1,24,13,4,1,0,0,5,0,0,0,1
496,497,2013,31,23,8,0.75,75,1014,11,11,1,11,6,1,18,11,0,0,0,1,5,1,0,0,0
497,498,2013,27,24,3,0.88,88,1014,10,12,2,9,9,2,20,8,1,0,0,6,3,2,0,0,0
498,499,2013,49,34,15,0.7,70,1014,12,18,4,9,15,3,27,6,3,0,0,12,3,2,1,0,0
499,500,2013,40,7,33,0.18,18,1014,3,3,1,1,3,1,5,0,0,1,0,3,0,1,0,0,0
500,501,2013,8,4,4,0.48,48,1014,1,2,1,1,1,1,3,1,0,0,0,0,1,1,0,0,0
501,502,2013,7,2,5,0.25,25,1014,1,1,0,1,1,0,2,1,0,0,0,1,0,0,0,0,0
502,503,2013,13,5,8,0.4,40,1014,2,2,1,2,2,1,5,2,0,0,0,2,0,1,0,0,0
503,504,2013,35,35,0,0.99,99,1014,19,13,3,16,13,2,31,13,3,0,0,13,0,1,1,0,0
504,505,2013,46,37,9,0.81,81,1014,18,16,3,17,13,3,33,16,1,0,0,10,3,3,0,0,0
505,506,2013,45,11,34,0.24,24,1014,5,4,2,3,2,1,6,1,2,0,0,0,2,0,1,0,0
506,507,2013,55,19,36,0.34,34,1014,8,9,2,8,8,1,17,8,0,0,0,7,1,0,1,0,0
507,508,2013,11,6,5,0.55,55,1014,2,3,1,2,3,1,6,2,0,0,0,3,0,1,0,0,0
508,509,2013,14,7,7,0.52,52,1014,3,4,0,3,2,0,5,3,0,0,0,0,2,0,0,0,0
509,510,2013,16,8,8,0.48,48,1014,5,2,1,4,1,1,6,3,1,0,0,0,1,1,0,0,0
510,511,2013,11,2,9,0.17,17,1014,1,1,0,1,1,0,2,1,0,0,0,1,0,0,0,0,0
511,512,2013,32,12,20,0.39,39,1014,5,6,1,5,5,1,11,5,0,0,0,4,1,1,0,0,0
512,513,2013,8,0,8,0.06,6,1014,0,0,0,0,0,0,0,0,0,0,0,0,0,0,0,0,0
513,514,2013,42,20,22,0.47,47,1014,8,11,1,8,10,1,19,8,0,0,0,9,1,1,0,0,0
514,515,2013,26,22,4,0.84,84,1014,9,10,3,6,6,1,13,4,1,1,0,2,4,0,0,1,0
515,516,2013,29,10,19,0.35,35,1014,6,4,0,2,3,0,5,0,0,2,0,2,1,0,0,0,0
516,517,2013,17,7,10,0.44,44,1014,2,4,1,1,2,1,4,0,1,0,0,0,2,1,0,0,0
517,518,2013,39,28,11,0.72,72,1014,11,16,1,5,9,1,15,3,0,0,2,2,7,1,0,0,0
518,519,2013,27,8,19,0.3,30,1014,4,4,0,1,4,0,5,0,0,0,1,4,0,0,0,0,0
519,520,2013,51,22,29,0.43,43,1014,8,11,3,7,10,1,18,6,1,0,0,9,1,0,0,1,0
520,521,2013,36,30,6,0.82,82,1014,22,6,2,16,6,1,23,10,6,0,0,6,0,0,1,0,0
521,522,2013,19,5,14,0.27,27,1014,2,2,1,1,2,1,4,0,1,0,0,2,0,1,0,0,0
522,523,2013,22,21,1,0.96,96,1014,14,5,2,13,4,2,19,12,1,0,0,3,1,2,0,0,0
523,524,2013,32,19,13,0.59,59,1014,9,7,3,5,4,3,12,1,4,0,0,1,3,3,0,0,0
524,525,2013,54,29,25,0.53,53,1014,21,8,0,19,8,0,27,18,0,1,0,8,0,0,0,0,0
525,526,2013,25,25,0,0.99,99,1014,9,12,4,4,12,1,17,1,2,0,1,12,0,0,0,0,1
526,527,2013,56,35,21,0.63,63,1014,23,9,3,20,7,1,28,19,0,0,1,5,2,0,0,1,0
527,528,2013,17,4,13,0.24,24,1014,3,1,0,1,1,0,2,0,0,1,0,1,0,0,0,0,0
528,529,2013,6,1,5,0.09,9,1014,0,1,0,0,1,0,1,0,0,0,0,1,0,0,0,0,0
529,530,2013,38,6,32,0.17,17,1014,3,2,1,1,1,1,3,0,0,1,0,0,1,1,0,0,0
530,531,2013,15,2,13,0.11,11,1014,1,1,0,1,1,0,2,1,0,0,0,1,0,0,0,0,0
531,532,2013,18,7,11,0.4,40,1014,5,2,0,5,2,0,7,5,0,0,0,2,0,0,0,0,0
532,533,2013,42,14,28,0.34,34,1014,7,6,1,2,5,1,8,0,0,1,1,4,1,1,0,0,0
533,534,2013,42,21,21,0.5,50,1014,9,12,0,8,12,0,20,7,1,0,0,12,0,0,0,0,0
534,535,2013,9,0,9,0.01,1,1014,0,0,0,0,0,0,0,0,0,0,0,0,0,0,0,0,0
535,536,2013,31,7,24,0.24,24,1014,4,3,0,3,2,0,5,2,1,0,0,1,1,0,0,0,0
536,537,2013,32,5,27,0.15,15,1014,2,3,0,2,2,0,4,2,0,0,0,1,1,0,0,0,0
537,538,2013,12,8,4,0.64,64,1014,3,4,1,2,3,1,6,1,1,0,0,2,1,1,0,0,0
538,539,2013,8,5,3,0.67,67,1014,3,2,0,1,1,0,2,0,0,1,0,0,1,0,0,0,0
539,540,2013,24,2,22,0.1,10,1014,1,1,0,1,1,0,2,1,0,0,0,1,0,0,0,0,0
540,541,2013,39,8,31,0.2,20,1014,5,3,0,2,3,0,5,0,1,1,0,3,0,0,0,0,0
541,542,2013,51,40,11,0.78,78,1014,24,16,0,9,16,0,25,2,1,4,2,16,0,0,0,0,0
542,543,2013,22,4,18,0.19,19,1014,2,2,0,1,2,0,3,0,1,0,0,2,0,0,0,0,0
543,544,2013,13,1,12,0.04,4,1014,0,1,0,0,1,0,1,0,0,0,0,1,0,0,0,0,0
544,545,2013,32,28,4,0.88,88,1014,12,14,2,6,10,2,18,3,1,1,1,6,4,2,0,0,0
545,546,2013,54,19,35,0.35,35,1014,14,4,1,10,4,1,15,7,2,1,0,4,0,1,0,0,0
546,547,2013,52,36,16,0.69,69,1014,16,16,4,7,14,2,23,3,0,3,1,12,2,0,2,0,0
547,548,2013,40,36,4,0.91,91,1014,25,8,3,17,7,3,27,12,3,1,1,6,1,3,0,0,0
548,549,2013,23,20,3,0.89,89,1014,10,9,1,9,9,1,19,8,1,0,0,9,0,1,0,0,0
549,550,2013,22,20,2,0.89,89,1014,12,8,0,5,6,0,11,1,2,1,1,4,2,0,0,0,0
550,551,2013,11,6,5,0.58,57,1014,3,2,1,3,2,1,6,3,0,0,0,2,0,1,0,0,0
551,552,2013,39,3,36,0.08,8,1014,2,1,0,1,1,0,2,0,1,0,0,1,0,0,0,0,0
552,553,2013,46,4,42,0.09,9,1014,2,2,0,2,2,0,4,2,0,0,0,2,0,0,0,0,0
553,554,2013,40,18,22,0.46,46,1014,7,10,1,2,8,1,11,0,0,1,1,6,2,1,0,0,0
554,555,2013,16,14,2,0.87,87,1014,5,8,1,2,4,1,7,1,0,0,1,0,4,1,0,0,0
555,556,2013,10,10,0,0.98,98,1014,5,4,1,3,3,1,7,1,2,0,0,2,1,1,0,0,0
556,557,2013,56,44,12,0.78,78,1014,25,18,1,20,16,1,37,17,1,2,0,14,2,1,0,0,0
557,558,2013,38,26,12,0.69,69,1014,18,5,3,12,5,2,19,9,1,1,1,5,0,1,1,0,0
558,559,2013,45,23,22,0.52,52,1014,16,4,3,4,3,1,8,0,0,0,4,2,1,0,0,1,0
559,560,2013,37,30,7,0.8,80,1014,20,6,4,8,5,3,16,4,0,0,4,4,1,2,1,0,0
560,561,2013,16,16,0,1.0,100,1014,6,7,3,6,5,3,14,6,0,0,0,3,2,3,0,0,0
561,562,2013,27,9,18,0.35,35,1014,3,4,2,2,3,1,6,1,1,0,0,2,1,0,1,0,0
562,563,2013,36,10,26,0.27,27,1014,4,5,1,4,5,1,10,4,0,0,0,5,0,1,0,0,0
563,564,2013,60,29,31,0.49,49,1014,21,5,3,12,3,2,17,5,6,0,1,1,2,1,1,0,0
564,565,2013,9,1,8,0.13,13,1014,0,1,0,0,1,0,1,0,0,0,0,1,0,0,0,0,0
565,566,2013,16,4,12,0.25,25,1014,2,2,0,1,1,0,2,0,1,0,0,0,1,0,0,0,0
566,567,2013,32,1,31,0.04,4,1014,0,1,0,0,1,0,1,0,0,0,0,1,0,0,0,0,0
567,568,2013,12,6,6,0.48,48,1014,3,2,1,1,2,1,4,0,0,1,0,2,0,1,0,0,0
568,569,2013,41,40,1,0.98,98,1014,28,9,3,7,8,2,17,0,0,0,7,7,1,1,1,0,0
569,570,2013,47,34,13,0.72,72,1014,20,12,2,10,6,1,17,0,10,0,0,0,6,0,1,0,0
570,571,2013,6,0,6,0.02,2,1014,0,0,0,0,0,0,0,0,0,0,0,0,0,0,0,0,0
571,572,2013,11,5,6,0.46,46,1014,1,3,1,1,2,1,4,1,0,0,0,1,1,1,0,0,0
572,573,2013,35,20,15,0.57,56,1014,10,9,1,6,6,1,13,4,0,2,0,3,3,1,0,0,0
573,574,2013,27,22,5,0.82,82,1014,15,5,2,6,5,2,13,1,1,4,0,5,0,2,0,0,0
574,575,2013,26,23,3,0.9,90,1014,13,8,2,8,6,1,15,5,2,0,1,4,2,0,1,0,0
575,576,2013,42,41,1,0.97,97,1014,19,19,3,15,13,2,30,13,0,2,0,7,6,1,1,0,0
576,577,2013,12,1,11,0.09,9,1014,0,1,0,0,1,0,1,0,0,0,0,1,0,0,0,0,0
577,578,2013,13,0,13,0.02,2,1014,0,0,0,0,0,0,0,0,0,0,0,0,0,0,0,0,0
578,579,2013,34,12,22,0.35,35,1014,7,3,2,5,2,2,9,4,0,1,0,1,1,2,0,0,0
579,580,2013,19,10,9,0.55,55,1014,4,4,2,3,2,1,6,2,1,0,0,0,2,0,1,0,0
580,581,2013,9,8,1,0.87,87,1014,3,4,1,2,3,1,6,1,1,0,0,2,1,1,0,0,0
581,582,2013,33,16,17,0.5,50,1014,8,5,3,5,4,2,11,3,1,1,0,3,1,1,1,0,0
582,583,2013,10,4,6,0.36,36,1014,2,2,0,2,1,0,3,2,0,0,0,0,1,0,0,0,0
583,584,2013,38,21,17,0.55,55,1014,10,7,4,5,4,4,13,0,5,0,0,1,3,4,0,0,0
584,585,2013,14,2,12,0.17,17,1014,1,1,0,1,1,0,2,1,0,0,0,1,0,0,0,0,0
585,586,2013,34,7,27,0.2,20,1014,4,2,1,2,1,1,4,0,2,0,0,0,1,1,0,0,0
586,587,2013,17,16,1,0.97,97,1014,9,6,1,7,4,1,12,6,0,1,0,2,2,1,0,0,0
587,588,2013,27,23,4,0.84,84,1014,10,9,4,6,6,3,15,2,4,0,0,3,3,2,1,0,0
588,589,2013,43,41,2,0.96,96,1014,18,23,0,17,14,0,31,16,1,0,0,5,9,0,0,0,0
589,590,2013,24,14,10,0.57,56,1014,4,7,3,3,4,1,8,2,1,0,0,1,3,0,0,1,0
590,591,2013,15,13,2,0.87,87,1014,7,4,2,4,2,1,7,3,0,0,1,0,2,0,1,0,0
591,592,2013,5,3,2,0.58,57,1014,2,1,0,1,1,0,2,0,1,0,0,1,0,0,0,0,0
592,593,2013,8,7,1,0.82,82,1014,4,3,0,4,2,0,6,4,0,0,0,1,1,0,0,0,0
593,594,2013,55,23,32,0.42,42,1014,9,11,3,7,9,2,18,6,0,1,0,7,2,1,1,0,0
594,595,2013,20,3,17,0.14,14,1014,2,1,0,2,1,0,3,2,0,0,0,1,0,0,0,0,0
595,596,2013,12,8,4,0.65,65,1014,5,2,1,2,2,1,5,1,0,0,1,2,0,1,0,0,0
596,597,2013,29,1,28,0.05,5,1014,0,1,0,0,1,0,1,0,0,0,0,1,0,0,0,0,0
597,598,2013,12,4,8,0.34,34,1014,1,2,1,1,2,1,4,1,0,0,0,2,0,1,0,0,0
598,599,2013,17,5,12,0.31,31,1014,1,3,1,1,2,1,4,1,0,0,0,1,1,1,0,0,0
599,600,2013,16,7,9,0.42,42,1014,4,3,0,3,3,0,6,2,1,0,0,3,0,0,0,0,0
600,601,2013,28,12,16,0.44,44,1014,6,6,0,3,4,0,7,0,3,0,0,2,2,0,0,0,0
601,602,2013,8,6,2,0.73,73,1014,2,3,1,1,3,1,5,0,1,0,0,3,0,1,0,0,0
602,603,2013,59,48,11,0.82,82,1014,20,25,3,19,18,2,39,18,1,0,0,11,7,1,1,0,0
603,604,2013,44,24,20,0.55,55,1014,10,10,4,10,5,1,16,10,0,0,0,0,5,0,0,0,1
604,605,2013,48,5,43,0.11,11,1014,1,3,1,1,3,1,5,1,0,0,0,3,0,1,0,0,0
605,606,2013,35,23,12,0.67,67,1014,14,8,1,13,6,1,20,12,1,0,0,4,2,1,0,0,0
606,607,2013,40,17,23,0.42,42,1014,12,3,2,12,2,1,15,12,0,0,0,1,1,0,1,0,0
607,608,2013,6,2,4,0.39,39,1014,1,1,0,1,1,0,2,1,0,0,0,1,0,0,0,0,0
608,609,2013,15,9,6,0.57,56,1014,4,4,1,4,3,1,8,4,0,0,0,2,1,1,0,0,0
609,610,2013,9,0,9,0.05,5,1014,0,0,0,0,0,0,0,0,0,0,0,0,0,0,0,0,0
610,611,2013,48,6,42,0.12,12,1014,2,3,1,2,2,1,5,2,0,0,0,1,1,1,0,0,0
611,612,2013,12,9,3,0.78,78,1014,5,3,1,4,2,1,7,3,1,0,0,1,1,1,0,0,0
612,613,2013,12,6,6,0.53,53,1014,3,2,1,2,1,1,4,1,1,0,0,0,1,1,0,0,0
613,614,2013,6,6,0,0.94,94,1014,3,2,1,1,1,1,3,0,0,1,0,0,1,1,0,0,0
614,615,2013,27,25,2,0.94,94,1014,18,4,3,5,2,1,8,0,1,0,4,0,2,0,0,1,0
615,616,2013,30,3,27,0.11,11,1014,2,1,0,2,1,0,3,2,0,0,0,1,0,0,0,0,0
616,617,2013,14,10,4,0.71,71,1014,3,6,1,1,4,1,6,0,0,1,0,2,2,1,0,0,0
617,618,2013,6,4,2,0.63,63,1014,2,2,0,2,2,0,4,2,0,0,0,2,0,0,0,0,0
618,619,2013,17,1,16,0.05,5,1014,0,1,0,0,1,0,1,0,0,0,0,1,0,0,0,0,0
619,620,2013,18,16,2,0.91,91,1014,4,8,4,1,7,3,11,0,0,0,1,6,1,2,1,0,0
620,621,2013,9,8,1,0.92,92,1014,5,3,0,3,3,0,6,1,2,0,0,3,0,0,0,0,0
621,622,2013,32,1,31,0.02,2,1014,0,1,0,0,1,0,1,0,0,0,0,1,0,0,0,0,0
622,623,2013,52,15,37,0.29,28,1014,5,8,2,2,5,2,9,0,1,1,0,2,3,2,0,0,0
623,624,2013,20,16,4,0.81,81,1014,11,3,2,4,2,2,8,1,0,2,1,1,1,2,0,0,0
624,625,2013,33,30,3,0.91,91,1014,21,6,3,15,6,3,24,11,2,2,0,6,0,3,0,0,0
625,626,2013,13,8,5,0.63,63,1014,3,3,2,1,2,1,4,0,0,1,0,1,1,0,1,0,0
626,627,2013,17,14,3,0.85,85,1014,7,5,2,4,3,1,8,2,1,1,0,1,2,0,1,0,0
627,628,2013,13,13,0,1.0,100,1014,8,4,1,3,3,1,7,0,2,0,1,2,1,1,0,0,0
628,629,2013,33,22,11,0.68,68,1014,13,9,0,13,6,0,19,13,0,0,0,3,3,0,0,0,0
629,630,2013,15,4,11,0.28,28,1014,2,2,0,1,1,0,2,0,1,0,0,0,1,0,0,0,0
630,631,2013,58,25,33,0.43,43,1014,15,8,2,4,4,1,9,0,0,1,3,0,4,0,1,0,0
631,632,2013,9,4,5,0.46,46,1014,2,2,0,2,2,0,4,2,0,0,0,2,0,0,0,0,0
632,633,2013,9,4,5,0.47,47,1014,1,2,1,1,1,1,3,1,0,0,0,0,1,1,0,0,0
633,634,2013,6,3,3,0.58,57,1014,1,2,0,1,2,0,3,1,0,0,0,2,0,0,0,0,0
634,635,2013,24,16,8,0.66,66,1014,4,9,3,1,5,2,8,0,0,0,1,1,4,1,1,0,0
635,636,2013,15,2,13,0.12,12,1014,1,1,0,1,1,0,2,1,0,0,0,1,0,0,0,0,0
636,637,2013,23,21,2,0.93,93,1014,7,11,3,2,10,3,15,0,0,1,1,9,1,3,0,0,0
637,638,2013,29,22,7,0.76,76,1014,14,6,2,7,3,1,11,4,1,0,2,0,3,0,1,0,0
638,639,2013,7,2,5,0.23,23,1014,1,1,0,1,1,0,2,1,0,0,0,1,0,0,0,0,0
639,640,2013,13,6,7,0.45,45,1014,4,2,0,1,2,0,3,0,0,0,1,2,0,0,0,0,0
640,641,2013,6,2,4,0.39,39,1014,1,1,0,1,1,0,2,1,0,0,0,1,0,0,0,0,0
641,642,2013,28,28,0,0.99,99,1014,20,6,2,19,3,1,23,18,1,0,0,0,3,0,1,0,0
642,643,2013,56,21,35,0.37,37,1014,7,10,4,3,6,4,13,0,2,1,0,2,4,4,0,0,0
643,644,2013,11,8,3,0.75,75,1014,4,3,1,1,3,1,5,0,0,0,1,3,0,1,0,0,0
644,645,2013,23,8,15,0.34,34,1014,3,3,2,2,3,2,7,1,1,0,0,3,0,2,0,0,0
645,646,2013,58,2,56,0.04,4,1014,1,1,0,1,1,0,2,1,0,0,0,1,0,0,0,0,0
646,647,2013,32,5,27,0.16,16,1014,2,2,1,2,2,1,5,2,0,0,0,2,0,1,0,0,0
647,648,2013,34,14,20,0.4,40,1014,10,3,1,10,2,1,13,10,0,0,0,1,1,1,0,0,0
648,649,2013,27,25,2,0.93,93,1014,12,12,1,8,8,1,17,6,1,0,1,4,4,1,0,0,0
649,650,2013,37,36,1,0.98,98,1014,25,8,3,24,7,3,34,23,1,0,0,6,1,3,0,0,0
650,651,2013,26,4,22,0.17,17,1014,2,2,0,2,2,0,4,2,0,0,0,2,0,0,0,0,0
651,652,2013,40,19,21,0.47,47,1014,12,6,1,3,4,1,8,0,0,0,3,2,2,1,0,0,0
652,653,2013,14,11,3,0.8,80,1014,6,3,2,3,3,1,7,2,0,0,1,3,0,0,1,0,0
653,654,2013,40,8,32,0.19,19,1014,5,2,1,4,2,1,7,3,1,0,0,2,0,1,0,0,0
654,655,2013,50,48,2,0.97,97,1014,23,22,3,20,15,2,37,19,0,0,1,8,7,1,1,0,0
655,656,2013,47,43,4,0.91,91,1014,30,10,3,24,9,1,34,21,0,3,0,8,1,0,0,1,0
656,657,2013,32,27,5,0.84,84,1014,9,16,2,9,12,1,22,9,0,0,0,8,4,0,1,0,0
657,658,2013,12,2,10,0.15,15,1014,1,1,0,1,1,0,2,1,0,0,0,1,0,0,0,0,0
658,659,2013,38,30,8,0.78,78,1014,11,16,3,5,14,1,20,2,1,1,1,12,2,0,0,1,0
659,660,2013,21,6,15,0.27,27,1014,2,3,1,1,2,1,4,0,1,0,0,1,1,1,0,0,0
660,661,2013,37,19,18,0.51,51,1014,9,7,3,8,7,2,17,7,1,0,0,7,0,1,1,0,0
661,662,2013,29,27,2,0.94,94,1014,13,12,2,11,6,2,19,9,2,0,0,0,6,2,0,0,0
662,663,2013,39,7,32,0.18,18,1014,2,4,1,2,2,1,5,2,0,0,0,0,2,1,0,0,0
663,664,2013,45,1,44,0.03,3,1014,0,1,0,0,1,0,1,0,0,0,0,1,0,0,0,0,0
664,665,2013,28,16,12,0.58,57,1014,6,7,3,2,7,3,12,0,0,2,0,7,0,3,0,0,0
665,666,2013,24,4,20,0.15,15,1014,1,2,1,1,1,1,3,1,0,0,0,0,1,1,0,0,0
666,667,2013,30,5,25,0.17,17,1014,3,2,0,2,1,0,3,1,1,0,0,0,1,0,0,0,0
667,668,2013,38,19,19,0.5,50,1014,8,8,3,3,5,3,11,0,1,2,0,2,3,3,0,0,0
668,669,2013,42,10,32,0.25,25,1014,7,2,1,4,1,1,6,3,0,0,1,0,1,1,0,0,0
669,670,2013,14,9,5,0.66,66,1014,3,5,1,2,3,1,6,1,1,0,0,1,2,1,0,0,0
670,671,2013,47,42,5,0.9,90,1014,23,17,2,20,10,2,32,17,3,0,0,3,7,2,0,0,0
671,672,2013,41,14,27,0.33,33,1014,10,3,1,4,3,1,8,2,0,0,2,3,0,1,0,0,0
672,673,2013,14,5,9,0.38,38,1014,2,2,1,1,2,1,4,0,1,0,0,2,0,1,0,0,0
673,674,2013,24,17,7,0.69,69,1014,7,7,3,6,4,3,13,5,1,0,0,1,3,3,0,0,0
674,675,2013,9,9,0,0.96,96,1014,5,3,1,3,3,1,7,1,2,0,0,3,0,1,0,0,0
675,676,2013,19,17,2,0.91,91,1014,11,5,1,3,3,1,7,0,0,1,2,1,2,1,0,0,0
676,677,2013,11,6,5,0.58,57,1014,2,3,1,1,3,1,5,0,1,0,0,3,0,1,0,0,0
677,678,2013,26,22,4,0.83,83,1014,6,13,3,5,7,3,15,4,1,0,0,1,6,3,0,0,0
678,679,2013,22,20,2,0.92,92,1014,8,11,1,7,7,1,15,6,1,0,0,3,4,1,0,0,0
679,680,2013,25,0,25,0.02,2,1014,0,0,0,0,0,0,0,0,0,0,0,0,0,0,0,0,0
680,681,2013,40,40,0,1.0,100,1014,16,21,3,10,18,1,29,7,0,3,0,15,3,0,0,1,0
681,682,2013,38,35,3,0.92,92,1014,13,19,3,13,15,1,29,13,0,0,0,11,4,0,0,1,0
682,683,2013,5,3,2,0.6,60,1014,1,2,0,1,2,0,3,1,0,0,0,2,0,0,0,0,0
683,684,2013,27,12,15,0.44,44,1014,4,7,1,2,5,1,8,1,0,1,0,3,2,1,0,0,0
684,685,2013,14,7,7,0.48,48,1014,3,3,1,1,2,1,4,0,0,1,0,1,1,1,0,0,0
685,686,2013,26,7,19,0.27,27,1014,3,3,1,2,3,1,6,1,1,0,0,3,0,1,0,0,0
686,687,2013,20,13,7,0.66,66,1014,9,4,0,3,2,0,5,0,1,1,1,0,2,0,0,0,0
687,688,2013,13,1,12,0.09,9,1014,0,1,0,0,1,0,1,0,0,0,0,1,0,0,0,0,0
688,689,2013,46,31,15,0.68,68,1014,22,9,0,13,9,0,22,8,1,4,0,9,0,0,0,0,0
689,690,2013,46,33,13,0.72,72,1014,21,11,1,13,10,1,24,8,3,1,1,9,1,1,0,0,0
690,691,2013,31,2,29,0.07,7,1014,1,1,0,1,1,0,2,1,0,0,0,1,0,0,0,0,0
691,692,2013,28,14,14,0.49,49,1014,7,4,3,5,4,3,12,3,2,0,0,4,0,3,0,0,0
692,693,2013,15,15,0,1.0,100,1014,10,3,2,9,3,1,13,8,1,0,0,3,0,0,1,0,0
693,694,2013,55,49,6,0.89,89,1014,25,23,1,22,18,1,41,19,3,0,0,13,5,1,0,0,0
694,695,2013,36,11,25,0.3,30,1014,7,3,1,7,3,1,11,7,0,0,0,3,0,1,0,0,0
695,696,2013,27,2,25,0.07,7,1014,1,1,0,1,1,0,2,1,0,0,0,1,0,0,0,0,0
696,697,2013,31,14,17,0.46,46,1014,4,8,2,3,8,2,13,2,1,0,0,8,0,2,0,0,0
697,698,2013,44,27,17,0.61,61,1014,14,11,2,11,9,1,21,9,1,1,0,7,2,0,1,0,0
698,699,2013,34,32,2,0.93,93,1014,15,14,3,9,14,2,25,5,2,2,0,14,0,1,1,0,0
699,700,2013,40,17,23,0.42,42,1014,6,9,2,2,6,1,9,0,0,2,0,3,3,0,1,0,0
700,701,2013,31,24,7,0.77,77,1014,17,4,3,6,3,2,11,1,0,4,1,2,1,1,1,0,0
701,702,2013,44,29,15,0.65,65,1014,18,8,3,5,8,1,14,0,0,2,3,8,0,0,0,1,0
702,703,2013,34,23,11,0.68,68,1014,14,8,1,11,5,1,17,10,0,0,1,2,3,1,0,0,0
703,704,2013,32,3,29,0.08,8,1014,1,2,0,1,1,0,2,1,0,0,0,0,1,0,0,0,0
704,705,2013,6,2,4,0.29,28,1014,1,1,0,1,1,0,2,1,0,0,0,1,0,0,0,0,0
705,706,2013,17,1,16,0.06,6,1014,0,1,0,0,1,0,1,0,0,0,0,1,0,0,0,0,0
706,707,2013,29,23,6,0.78,78,1014,11,11,1,10,10,1,21,9,1,0,0,9,1,1,0,0,0
707,708,2013,39,22,17,0.57,56,1014,13,7,2,4,6,1,11,0,0,3,1,5,1,0,1,0,0
708,709,2013,42,26,16,0.62,62,1014,9,13,4,8,8,3,19,7,1,0,0,3,5,2,1,0,0
709,710,2013,20,4,16,0.21,21,1014,2,2,0,1,2,0,3,0,1,0,0,2,0,0,0,0,0
710,711,2013,5,3,2,0.56,56,1014,1,2,0,1,1,0,2,1,0,0,0,0,1,0,0,0,0
711,712,2013,48,26,22,0.54,54,1014,19,6,1,8,4,1,13,3,1,2,2,2,2,1,0,0,0
712,713,2013,24,10,14,0.43,43,1014,6,3,1,3,3,1,7,0,3,0,0,3,0,1,0,0,0
713,714,2013,30,20,10,0.68,68,1014,14,5,1,13,3,1,17,12,1,0,0,1,2,1,0,0,0
714,715,2013,47,9,38,0.19,19,1014,5,3,1,5,2,1,8,5,0,0,0,1,1,1,0,0,0
715,716,2013,34,25,9,0.73,73,1014,12,10,3,8,7,3,18,6,0,2,0,4,3,3,0,0,0
716,717,2013,32,24,8,0.75,75,1014,10,13,1,4,11,1,16,0,3,0,1,9,2,1,0,0,0
717,718,2013,35,22,13,0.62,62,1014,10,12,0,4,11,0,15,0,3,0,1,10,1,0,0,0,0
718,719,2013,39,29,10,0.75,75,1014,12,16,1,4,16,1,21,0,0,4,0,16,0,1,0,0,0
719,720,2013,7,1,6,0.13,13,1014,0,1,0,0,1,0,1,0,0,0,0,1,0,0,0,0,0
720,721,2013,38,24,14,0.63,63,1014,10,11,3,3,9,1,13,0,0,2,1,7,2,0,0,1,0
721,722,2013,24,12,12,0.5,50,1014,3,7,2,1,4,1,6,0,0,1,0,1,3,0,1,0,0
722,723,2013,8,3,5,0.35,35,1014,1,2,0,1,2,0,3,1,0,0,0,2,0,0,0,0,0
723,724,2013,24,8,16,0.33,33,1014,4,3,1,2,2,1,5,1,0,1,0,1,1,1,0,0,0
724,725,2013,26,5,21,0.21,21,1014,2,2,1,2,2,1,5,2,0,0,0,2,0,1,0,0,0
725,726,2013,28,22,6,0.79,79,1014,11,8,3,6,4,1,11,1,5,0,0,0,4,0,0,1,0
726,727,2013,24,17,7,0.7,70,1014,4,10,3,1,6,1,8,0,0,0,1,2,4,0,0,1,0
727,728,2013,28,13,15,0.48,48,1014,7,5,1,2,4,1,7,0,0,1,1,3,1,1,0,0,0
728,729,2013,24,15,9,0.64,64,1014,5,7,3,3,4,3,10,1,2,0,0,1,3,3,0,0,0
729,730,2013,30,2,28,0.05,5,1014,1,1,0,1,1,0,2,1,0,0,0,1,0,0,0,0,0
730,731,2013,51,37,14,0.73,73,1014,11,22,4,11,11,3,25,11,0,0,0,0,11,2,1,0,0
731,732,2013,9,7,2,0.79,79,1014,3,3,1,1,3,1,5,0,0,1,0,3,0,1,0,0,0
732,733,2013,10,8,2,0.77,77,1014,3,4,1,3,4,1,8,3,0,0,0,4,0,1,0,0,0
733,734,2013,34,19,15,0.55,55,1014,10,8,1,5,4,1,10,2,1,2,0,0,4,1,0,0,0
734,735,2013,18,10,8,0.56,56,1014,3,5,2,3,5,2,10,3,0,0,0,5,0,2,0,0,0
735,736,2013,31,13,18,0.42,42,1014,7,5,1,6,4,1,11,5,1,0,0,3,1,1,0,0,0
736,737,2013,49,31,18,0.64,64,1014,10,17,4,8,12,3,23,6,2,0,0,7,5,2,1,0,0
737,738,2013,31,16,15,0.5,50,1014,4,8,4,1,4,1,6,0,0,0,1,0,4,0,0,0,1
738,739,2013,36,30,6,0.82,82,1014,21,9,0,16,6,0,22,11,5,0,0,3,3,0,0,0,0
739,740,2013,46,46,0,0.99,99,1014,23,22,1,12,13,1,26,4,5,3,0,4,9,1,0,0,0
740,741,2013,15,4,11,0.29,28,1014,1,2,1,1,1,1,3,1,0,0,0,0,1,1,0,0,0
741,742,2013,46,26,20,0.56,56,1014,10,12,4,10,8,4,22,10,0,0,0,4,4,4,0,0,0
742,743,2013,47,4,43,0.08,8,1014,2,2,0,1,1,0,2,0,1,0,0,0,1,0,0,0,0
743,744,2013,16,5,11,0.29,28,1014,2,2,1,2,1,1,4,2,0,0,0,0,1,1,0,0,0
744,745,2013,36,10,26,0.28,28,1014,2,6,2,1,5,2,8,0,1,0,0,4,1,2,0,0,0
745,746,2013,31,16,15,0.5,50,1014,6,6,4,6,6,3,15,6,0,0,0,6,0,2,1,0,0
746,747,2013,8,7,1,0.93,93,1014,2,3,2,2,2,1,5,2,0,0,0,1,1,0,1,0,0
747,748,2013,32,25,7,0.79,79,1014,10,14,1,5,10,1,16,2,2,0,1,6,4,1,0,0,0
748,749,2013,7,6,1,0.92,92,1014,3,2,1,1,2,1,4,0,0,1,0,2,0,1,0,0,0
749,750,2013,36,33,3,0.91,91,1014,10,19,4,8,16,1,25,6,2,0,0,13,3,0,0,0,1
750,751,2013,31,2,29,0.06,6,1014,1,1,0,1,1,0,2,1,0,0,0,1,0,0,0,0,0
751,752,2013,20,6,14,0.28,28,1014,3,2,1,1,1,1,3,0,0,1,0,0,1,1,0,0,0
752,753,2013,21,8,13,0.37,37,1014,2,4,2,1,3,1,5,0,1,0,0,2,1,0,1,0,0
753,754,2013,6,1,5,0.11,11,1014,0,1,0,0,1,0,1,0,0,0,0,1,0,0,0,0,0
754,755,2013,30,4,26,0.13,13,1014,2,2,0,2,2,0,4,2,0,0,0,2,0,0,0,0,0
755,756,2013,25,16,9,0.62,62,1014,11,5,0,4,4,0,8,0,1,3,0,3,1,0,0,0,0
756,757,2013,38,34,4,0.9,90,1014,20,14,0,9,10,0,19,0,8,0,1,6,4,0,0,0,0
757,758,2013,43,12,31,0.28,28,1014,5,5,2,2,4,1,7,0,1,1,0,3,1,0,1,0,0
758,759,2013,27,13,14,0.48,48,1014,3,7,3,3,4,3,10,3,0,0,0,1,3,3,0,0,0
759,760,2013,16,2,14,0.13,13,1014,1,1,0,1,1,0,2,1,0,0,0,1,0,0,0,0,0
760,761,2013,15,10,5,0.67,67,1014,5,3,2,3,2,2,7,1,2,0,0,1,1,2,0,0,0
761,762,2013,43,10,33,0.24,24,1014,4,6,0,1,4,0,5,0,0,0,1,2,2,0,0,0,0
762,763,2013,52,35,17,0.68,68,1014,12,21,2,3,13,1,17,0,0,0,3,5,8,0,1,0,0
763,764,2013,28,3,25,0.09,9,1014,2,1,0,2,1,0,3,2,0,0,0,1,0,0,0,0,0
764,765,2013,36,8,28,0.21,21,1014,2,4,2,1,2,2,5,0,1,0,0,0,2,2,0,0,0
765,766,2013,15,9,6,0.62,62,1014,3,4,2,1,2,2,5,0,0,1,0,0,2,2,0,0,0
766,767,2013,34,8,26,0.23,23,1014,2,4,2,1,4,1,6,0,1,0,0,4,0,0,1,0,0
767,768,2013,7,4,3,0.59,59,1014,2,2,0,2,2,0,4,2,0,0,0,2,0,0,0,0,0
768,769,2013,20,14,6,0.69,69,1014,8,4,2,5,2,1,8,2,3,0,0,0,2,0,1,0,0
769,770,2013,40,1,39,0.02,2,1014,0,1,0,0,1,0,1,0,0,0,0,1,0,0,0,0,0
770,771,2013,40,12,28,0.3,30,1014,5,4,3,3,3,3,9,1,2,0,0,2,1,3,0,0,0
771,772,2013,18,0,18,0.02,2,1014,0,0,0,0,0,0,0,0,0,0,0,0,0,0,0,0,0
772,773,2013,39,6,33,0.16,16,1014,3,3,0,1,2,0,3,0,0,1,0,1,1,0,0,0,0
773,774,2013,10,4,6,0.45,45,1014,1,2,1,1,2,1,4,1,0,0,0,2,0,1,0,0,0
774,775,2013,6,0,6,0.03,3,1014,0,0,0,0,0,0,0,0,0,0,0,0,0,0,0,0,0
775,776,2013,18,5,13,0.29,28,1014,2,3,0,1,3,0,4,0,1,0,0,3,0,0,0,0,0
776,777,2013,13,13,0,0.99,99,1014,7,6,0,5,3,0,8,4,0,1,0,0,3,0,0,0,0
777,778,2013,50,11,39,0.22,22,1014,6,4,1,4,2,1,7,2,2,0,0,0,2,1,0,0,0
778,779,2013,55,30,25,0.54,54,1014,15,12,3,11,6,3,20,9,0,2,0,0,6,3,0,0,0
779,780,2013,34,22,12,0.65,65,1014,8,11,3,7,11,3,21,6,1,0,0,11,0,3,0,0,0
780,781,2013,25,14,11,0.56,56,1014,8,4,2,7,3,1,11,6,1,0,0,2,1,0,1,0,0
781,782,2013,49,44,5,0.89,89,1014,19,25,0,19,20,0,39,19,0,0,0,15,5,0,0,0,0
782,783,2013,17,14,3,0.82,82,1014,10,3,1,9,3,1,13,8,1,0,0,3,0,1,0,0,0
783,784,2013,47,28,19,0.59,59,1014,10,14,4,4,7,4,15,1,0,3,0,0,7,4,0,0,0
784,785,2013,6,0,6,0.01,1,1014,0,0,0,0,0,0,0,0,0,0,0,0,0,0,0,0,0
785,786,2013,39,36,3,0.92,92,1014,12,21,3,6,20,3,29,2,3,0,1,19,1,3,0,0,0
786,787,2013,37,33,4,0.89,89,1014,24,8,1,17,6,1,24,12,4,0,1,4,2,1,0,0,0
787,788,2013,30,15,15,0.49,49,1014,11,4,0,4,3,0,7,0,2,1,1,2,1,0,0,0,0
788,789,2013,23,6,17,0.27,27,1014,4,2,0,2,1,0,3,0,2,0,0,0,1,0,0,0,0
789,790,2013,35,9,26,0.27,27,1014,2,5,2,1,4,1,6,0,1,0,0,3,1,0,1,0,0
790,791,2013,18,9,9,0.49,49,1014,4,4,1,4,4,1,9,4,0,0,0,4,0,1,0,0,0
791,792,2013,40,35,5,0.88,88,1014,23,11,1,17,8,1,26,14,0,3,0,5,3,1,0,0,0
792,793,2013,16,11,5,0.67,67,1014,3,6,2,2,4,2,8,1,1,0,0,2,2,2,0,0,0
793,794,2013,8,6,2,0.73,73,1014,2,3,1,1,2,1,4,0,1,0,0,1,1,1,0,0,0
794,795,2013,33,10,23,0.29,28,1014,6,3,1,3,3,1,7,2,0,0,1,3,0,1,0,0,0
795,796,2013,14,7,7,0.52,52,1014,2,3,2,2,3,2,7,2,0,0,0,3,0,2,0,0,0
796,797,2013,55,3,52,0.06,6,1014,2,1,0,1,1,0,2,0,1,0,0,1,0,0,0,0,0
797,798,2013,24,20,4,0.84,84,1014,10,8,2,10,5,2,17,10,0,0,0,2,3,2,0,0,0
798,799,2013,36,11,25,0.3,30,1014,4,4,3,2,2,1,5,0,2,0,0,0,2,0,0,1,0
799,800,2013,30,10,20,0.34,34,1014,4,4,2,1,4,2,7,0,0,0,1,4,0,2,0,0,0
800,801,2013,38,6,32,0.15,15,1014,3,2,1,2,2,1,5,1,1,0,0,2,0,1,0,0,0
801,802,2013,38,31,7,0.81,81,1014,15,13,3,11,13,3,27,9,1,0,1,13,0,3,0,0,0
802,803,2013,36,25,11,0.7,70,1014,13,11,1,8,7,1,16,5,2,0,1,3,4,1,0,0,0
803,804,2013,35,30,5,0.86,86,1014,20,6,4,13,5,1,19,8,3,2,0,4,1,0,0,0,1
804,805,2013,59,32,27,0.54,54,1014,15,17,0,7,12,0,19,1,5,0,1,7,5,0,0,0,0
805,806,2013,12,0,12,0.03,3,1014,0,0,0,0,0,0,0,0,0,0,0,0,0,0,0,0,0
806,807,2013,28,17,11,0.61,61,1014,7,8,2,3,7,1,11,0,2,1,0,6,1,0,1,0,0
807,808,2013,22,0,22,0.01,1,1014,0,0,0,0,0,0,0,0,0,0,0,0,0,0,0,0,0
808,809,2013,34,13,21,0.37,37,1014,5,6,2,2,6,2,10,1,0,0,1,6,0,2,0,0,0
809,810,2013,38,27,11,0.71,71,1014,20,5,2,8,3,2,13,1,4,1,2,1,2,2,0,0,0
810,811,2013,14,1,13,0.09,9,1014,0,1,0,0,1,0,1,0,0,0,0,1,0,0,0,0,0
811,812,2013,40,1,39,0.02,2,1014,0,1,0,0,1,0,1,0,0,0,0,1,0,0,0,0,0
812,813,2013,52,37,15,0.72,72,1014,18,17,2,8,16,1,25,3,2,1,2,15,1,0,1,0,0
813,814,2013,59,6,53,0.1,10,1014,2,3,1,2,2,1,5,2,0,0,0,1,1,1,0,0,0
814,815,2013,30,23,7,0.76,76,1014,16,5,2,5,3,1,9,0,0,4,1,1,2,0,1,0,0
815,816,2013,37,22,15,0.6,60,1014,12,9,1,11,6,1,18,10,1,0,0,3,3,1,0,0,0
816,817,2013,24,2,22,0.08,8,1014,1,1,0,1,1,0,2,1,0,0,0,1,0,0,0,0,0
817,818,2013,22,20,2,0.93,93,1014,11,7,2,4,6,2,12,0,1,3,0,5,1,2,0,0,0
818,819,2013,22,8,14,0.37,37,1014,3,5,0,1,5,0,6,0,0,1,0,5,0,0,0,0,0
819,820,2013,41,40,1,0.97,97,1014,18,22,0,7,15,0,22,2,2,0,3,8,7,0,0,0,0
820,821,2013,17,15,2,0.87,87,1014,10,4,1,7,3,1,11,6,0,0,1,2,1,1,0,0,0
821,822,2013,44,20,24,0.45,45,1014,9,9,2,4,5,2,11,1,1,2,0,1,4,2,0,0,0
822,823,2013,6,3,3,0.52,52,1014,2,1,0,2,1,0,3,2,0,0,0,1,0,0,0,0,0
823,824,2013,23,6,17,0.28,28,1014,2,3,1,2,3,1,6,2,0,0,0,3,0,1,0,0,0
824,825,2013,47,27,20,0.57,56,1014,9,16,2,7,10,1,18,6,0,1,0,4,6,0,1,0,0
825,826,2013,13,6,7,0.47,47,1014,3,2,1,2,1,1,4,1,1,0,0,0,1,1,0,0,0
826,827,2013,16,1,15,0.06,6,1014,0,1,0,0,1,0,1,0,0,0,0,1,0,0,0,0,0
827,828,2013,28,12,16,0.44,44,1014,7,3,2,3,3,2,8,0,2,1,0,3,0,2,0,0,0
828,829,2013,58,56,2,0.97,97,1014,21,33,2,7,25,1,33,0,3,1,3,17,8,0,1,0,0
829,830,2013,19,9,10,0.47,47,1014,3,5,1,1,4,1,6,0,0,1,0,3,1,1,0,0,0
830,831,2013,35,6,29,0.18,18,1014,1,4,1,1,4,1,6,1,0,0,0,4,0,1,0,0,0
831,832,2013,23,19,4,0.81,81,1014,5,11,3,3,6,1,10,2,0,1,0,1,5,0,0,1,0
832,833,2013,15,10,5,0.67,67,1014,7,3,0,2,3,0,5,0,0,1,1,3,0,0,0,0,0
833,834,2013,8,4,4,0.48,48,1014,2,2,0,1,2,0,3,0,1,0,0,2,0,0,0,0,0
834,835,2013,12,10,2,0.82,82,1014,5,5,0,3,5,0,8,1,2,0,0,5,0,0,0,0,0
835,836,2013,16,12,4,0.72,72,1014,6,6,0,5,4,0,9,4,1,0,0,2,2,0,0,0,0
836,837,2013,47,24,23,0.51,51,1014,8,14,2,8,9,1,18,8,0,0,0,4,5,0,1,0,0
837,838,2013,15,13,2,0.88,88,1014,4,6,3,1,3,3,7,0,0,0,1,0,3,3,0,0,0
838,839,2013,39,9,30,0.22,22,1014,4,3,2,1,2,2,5,0,0,0,1,1,1,2,0,0,0
839,840,2013,25,16,9,0.62,62,1014,9,5,2,9,5,1,15,9,0,0,0,5,0,0,1,0,0
840,841,2013,10,2,8,0.22,22,1014,1,1,0,1,1,0,2,1,0,0,0,1,0,0,0,0,0
841,842,2013,22,6,16,0.25,25,1014,3,2,1,2,1,1,4,1,1,0,0,0,1,1,0,0,0
842,843,2013,9,2,7,0.21,21,1014,1,1,0,1,1,0,2,1,0,0,0,1,0,0,0,0,0
843,844,2013,38,28,10,0.74,74,1014,9,16,3,8,11,3,22,7,1,0,0,6,5,3,0,0,0
844,845,2013,32,20,12,0.61,61,1014,8,12,0,5,9,0,14,4,0,0,1,6,3,0,0,0,0
845,846,2013,20,8,12,0.39,39,1014,2,4,2,1,2,2,5,0,1,0,0,0,2,2,0,0,0
846,847,2013,35,14,21,0.39,39,1014,7,6,1,5,3,1,9,3,2,0,0,0,3,1,0,0,0
847,848,2013,29,16,13,0.56,56,1014,4,9,3,3,8,1,12,2,1,0,0,7,1,0,0,1,0
848,849,2013,14,2,12,0.17,17,1014,1,1,0,1,1,0,2,1,0,0,0,1,0,0,0,0,0
849,850,2013,34,17,17,0.51,51,1014,5,10,2,4,8,1,13,3,1,0,0,6,2,0,1,0,0
850,851,2013,35,28,7,0.8,80,1014,20,6,2,14,5,1,20,11,1,1,1,4,1,0,1,0,0
851,852,2013,55,23,32,0.41,41,1014,11,10,2,7,10,2,19,4,2,1,0,10,0,2,0,0,0
852,853,2013,26,3,23,0.1,10,1014,1,2,0,1,2,0,3,1,0,0,0,2,0,0,0,0,0
853,854,2013,53,16,37,0.31,31,1014,7,6,3,3,3,2,8,1,1,0,1,0,3,1,1,0,0
854,855,2013,49,37,12,0.76,76,1014,21,15,1,17,10,1,28,15,1,0,1,5,5,1,0,0,0
855,856,2013,23,12,11,0.53,53,1014,8,3,1,5,3,1,9,2,3,0,0,3,0,1,0,0,0
856,857,2013,21,20,1,0.94,94,1014,15,3,2,13,2,1,16,12,0,1,0,1,1,0,1,0,0
857,858,2013,23,15,8,0.65,65,1014,10,4,1,4,2,1,7,1,0,3,0,0,2,1,0,0,0
858,859,2013,38,17,21,0.45,45,1014,9,7,1,6,4,1,11,3,3,0,0,1,3,1,0,0,0
859,860,2013,35,29,6,0.84,84,1014,8,17,4,8,9,2,19,8,0,0,0,1,8,0,2,0,0
860,861,2013,20,6,14,0.28,28,1014,2,3,1,1,3,1,5,0,1,0,0,3,0,1,0,0,0
861,862,2013,28,26,2,0.94,94,1014,10,14,2,3,9,2,14,0,1,0,2,4,5,2,0,0,0
862,863,2013,7,4,3,0.52,52,1014,1,2,1,1,1,1,3,1,0,0,0,0,1,1,0,0,0
863,864,2013,46,12,34,0.27,27,1014,6,6,0,5,5,0,10,4,1,0,0,4,1,0,0,0,0
864,865,2013,15,6,9,0.4,40,1014,3,2,1,3,2,1,6,3,0,0,0,2,0,1,0,0,0
865,866,2013,58,4,54,0.07,7,1014,1,2,1,1,1,1,3,1,0,0,0,0,1,1,0,0,0
866,867,2013,29,13,16,0.45,45,1014,5,5,3,3,3,1,7,2,0,1,0,1,2,0,0,1,0
867,868,2013,34,8,26,0.23,23,1014,5,2,1,2,1,1,4,1,0,0,1,0,1,1,0,0,0
868,869,2013,15,0,15,0.01,1,1014,0,0,0,0,0,0,0,0,0,0,0,0,0,0,0,0,0
869,870,2013,35,2,33,0.06,6,1014,1,1,0,1,1,0,2,1,0,0,0,1,0,0,0,0,0
870,871,2013,11,10,1,0.92,92,1014,4,4,2,1,3,2,6,0,0,0,1,2,1,2,0,0,0
871,872,2013,37,36,1,0.97,97,1014,16,18,2,15,18,2,35,14,1,0,0,18,0,2,0,0,0
872,873,2013,31,17,14,0.56,56,1014,5,9,3,2,8,3,13,1,0,0,1,7,1,3,0,0,0
873,874,2013,38,34,4,0.9,90,1014,20,10,4,20,5,2,27,20,0,0,0,0,5,1,0,1,0
874,875,2013,9,6,3,0.63,63,1014,2,3,1,2,2,1,5,2,0,0,0,1,1,1,0,0,0
875,876,2013,39,24,15,0.62,62,1014,13,9,2,12,8,2,22,11,1,0,0,7,1,2,0,0,0
876,877,2013,52,7,45,0.14,14,1014,2,4,1,2,3,1,6,2,0,0,0,2,1,1,0,0,0
877,878,2013,37,1,36,0.02,2,1014,0,1,0,0,1,0,1,0,0,0,0,1,0,0,0,0,0
878,879,2013,16,14,2,0.86,86,1014,6,7,1,6,6,1,13,6,0,0,0,5,1,1,0,0,0
879,880,2013,20,7,13,0.37,37,1014,2,3,2,2,3,1,6,2,0,0,0,3,0,0,1,0,0
880,881,2013,7,6,1,0.81,81,1014,3,2,1,3,1,1,5,3,0,0,0,0,1,1,0,0,0
881,882,2013,60,7,53,0.11,11,1014,2,3,2,2,2,2,6,2,0,0,0,1,1,2,0,0,0
882,883,2013,10,6,4,0.61,61,1014,4,2,0,1,2,0,3,0,0,0,1,2,0,0,0,0,0
883,884,2013,8,1,7,0.13,13,1014,0,1,0,0,1,0,1,0,0,0,0,1,0,0,0,0,0
884,885,2013,34,1,33,0.03,3,1014,0,1,0,0,1,0,1,0,0,0,0,1,0,0,0,0,0
885,886,2013,26,23,3,0.9,90,1014,9,11,3,8,7,1,16,7,1,0,0,3,4,0,0,1,0
886,887,2013,12,10,2,0.85,85,1014,7,2,1,4,1,1,6,2,1,1,0,0,1,1,0,0,0
887,888,2013,15,9,6,0.57,56,1014,5,3,1,3,3,1,7,2,0,1,0,3,0,1,0,0,0
888,889,2013,26,20,6,0.75,75,1014,13,4,3,12,4,1,17,11,1,0,0,4,0,0,0,1,0
889,890,2013,12,4,8,0.3,30,1014,1,2,1,1,2,1,4,1,0,0,0,2,0,1,0,0,0
890,891,2013,60,34,26,0.57,56,1014,23,10,1,18,9,1,28,13,5,0,0,8,1,1,0,0,0
891,892,2013,21,18,3,0.84,84,1014,9,6,3,5,5,1,11,3,1,0,1,4,1,0,0,1,0
892,893,2013,18,1,17,0.08,8,1014,0,1,0,0,1,0,1,0,0,0,0,1,0,0,0,0,0
893,894,2013,13,9,4,0.68,68,1014,4,4,1,2,4,1,7,0,2,0,0,4,0,1,0,0,0
894,895,2013,41,12,29,0.3,30,1014,7,4,1,2,3,1,6,0,0,1,1,2,1,1,0,0,0
895,896,2013,14,1,13,0.09,9,1014,0,1,0,0,1,0,1,0,0,0,0,1,0,0,0,0,0
896,897,2013,47,28,19,0.59,59,1014,17,9,2,13,6,2,21,9,4,0,0,3,3,2,0,0,0
897,898,2013,28,26,2,0.92,92,1014,18,7,1,8,4,1,13,3,0,5,0,1,3,1,0,0,0
898,899,2013,29,27,2,0.93,93,1014,15,11,1,10,9,1,20,6,3,1,0,7,2,1,0,0,0
899,900,2013,22,11,11,0.48,48,1014,6,5,0,6,5,0,11,6,0,0,0,5,0,0,0,0,0
900,901,2013,34,18,16,0.53,53,1014,12,4,2,5,3,1,9,1,2,1,1,2,1,0,1,0,0
901,902,2013,16,13,3,0.83,83,1014,3,7,3,2,7,2,11,1,1,0,0,7,0,1,1,0,0
902,903,2013,26,14,12,0.52,52,1014,5,5,4,5,4,1,10,5,0,0,0,3,1,0,0,0,1
903,904,2013,10,1,9,0.06,6,1014,0,1,0,0,1,0,1,0,0,0,0,1,0,0,0,0,0
904,905,2013,14,1,13,0.07,7,1014,0,1,0,0,1,0,1,0,0,0,0,1,0,0,0,0,0
905,906,2013,12,3,9,0.22,22,1014,2,1,0,2,1,0,3,2,0,0,0,1,0,0,0,0,0
906,907,2013,42,6,36,0.15,15,1014,2,3,1,1,2,1,4,0,1,0,0,1,1,1,0,0,0
907,908,2013,20,4,16,0.19,19,1014,2,2,0,1,2,0,3,0,1,0,0,2,0,0,0,0,0
908,909,2013,40,36,4,0.9,90,1014,20,14,2,12,8,1,21,8,1,2,1,2,6,0,1,0,0
909,910,2013,16,13,3,0.81,81,1014,5,8,0,2,7,0,9,0,1,1,0,6,1,0,0,0,0
910,911,2013,57,52,5,0.92,92,1014,33,17,2,26,16,1,43,20,5,1,0,15,1,0,1,0,0
911,912,2013,10,0,10,0.01,1,1014,0,0,0,0,0,0,0,0,0,0,0,0,0,0,0,0,0
912,913,2013,27,5,22,0.18,18,1014,1,3,1,1,3,1,5,1,0,0,0,3,0,1,0,0,0
913,914,2013,33,14,19,0.42,42,1014,8,4,2,6,2,1,9,4,2,0,0,0,2,0,1,0,0
914,915,2013,26,9,17,0.35,35,1014,3,4,2,1,3,2,6,0,0,1,0,2,1,2,0,0,0
915,916,2013,37,13,24,0.36,36,1014,5,5,3,2,5,3,10,0,1,1,0,5,0,3,0,0,0
916,917,2013,25,10,15,0.38,38,1014,3,6,1,3,6,1,10,3,0,0,0,6,0,1,0,0,0
917,918,2013,12,5,7,0.42,42,1014,1,3,1,1,3,1,5,1,0,0,0,3,0,1,0,0,0
918,919,2013,41,27,14,0.66,66,1014,18,8,1,11,6,1,18,7,1,3,0,4,2,1,0,0,0
919,920,2013,11,9,2,0.85,85,1014,4,5,0,3,5,0,8,2,1,0,0,5,0,0,0,0,0
920,921,2013,26,22,4,0.84,84,1014,10,11,1,4,8,1,13,1,0,3,0,5,3,1,0,0,0
921,922,2013,12,5,7,0.43,43,1014,3,2,0,3,1,0,4,3,0,0,0,0,1,0,0,0,0
922,923,2013,41,36,5,0.89,89,1014,16,20,0,12,16,0,28,10,0,2,0,12,4,0,0,0,0
923,924,2013,15,8,7,0.56,56,1014,3,4,1,3,4,1,8,3,0,0,0,4,0,1,0,0,0
924,925,2013,25,12,13,0.48,48,1014,7,4,1,7,4,1,12,7,0,0,0,4,0,1,0,0,0
925,926,2013,27,2,25,0.07,7,1014,1,1,0,1,1,0,2,1,0,0,0,1,0,0,0,0,0
926,927,2013,27,21,6,0.78,78,1014,13,6,2,10,6,1,17,8,1,1,0,6,0,0,1,0,0
927,928,2013,38,26,12,0.68,68,1014,13,12,1,11,12,1,24,10,0,1,0,12,0,1,0,0,0
928,929,2013,9,7,2,0.75,75,1014,4,3,0,1,3,0,4,0,0,0,1,3,0,0,0,0,0
929,930,2013,47,23,24,0.49,49,1014,15,7,1,5,5,1,11,0,2,1,2,3,2,1,0,0,0
930,931,2013,26,24,2,0.93,93,1014,13,9,2,5,7,1,13,1,2,0,2,5,2,0,1,0,0
931,932,2013,29,25,4,0.86,86,1014,9,13,3,7,10,3,20,6,0,1,0,7,3,3,0,0,0
932,933,2013,39,3,36,0.08,8,1014,2,1,0,2,1,0,3,2,0,0,0,1,0,0,0,0,0
933,934,2013,25,6,19,0.22,22,1014,4,2,0,4,1,0,5,4,0,0,0,0,1,0,0,0,0
934,935,2013,22,8,14,0.36,36,1014,3,4,1,3,4,1,8,3,0,0,0,4,0,1,0,0,0
935,936,2013,31,21,10,0.68,68,1014,15,6,0,9,5,0,14,3,6,0,0,4,1,0,0,0,0
936,937,2013,10,1,9,0.08,8,1014,0,1,0,0,1,0,1,0,0,0,0,1,0,0,0,0,0
937,938,2013,31,5,26,0.17,17,1014,2,2,1,1,1,1,3,0,1,0,0,0,1,1,0,0,0
938,939,2013,14,10,4,0.74,74,1014,5,4,1,2,2,1,5,0,1,1,0,0,2,1,0,0,0
939,940,2013,60,25,35,0.41,41,1014,14,11,0,6,7,0,13,3,0,1,2,3,4,0,0,0,0
940,941,2013,27,11,16,0.39,39,1014,5,5,1,2,3,1,6,0,1,1,0,1,2,1,0,0,0
941,942,2013,17,15,2,0.9,90,1014,7,5,3,7,4,2,13,7,0,0,0,3,1,1,1,0,0
942,943,2013,48,27,21,0.56,56,1014,11,14,2,11,10,2,23,11,0,0,0,6,4,2,0,0,0
943,944,2013,18,7,11,0.38,38,1014,3,3,1,1,2,1,4,0,0,1,0,1,1,1,0,0,0
944,945,2013,26,14,12,0.52,52,1014,7,6,1,5,6,1,12,4,0,1,0,6,0,1,0,0,0
945,946,2013,24,13,11,0.54,54,1014,7,5,1,6,5,1,12,5,1,0,0,5,0,1,0,0,0
946,947,2013,36,0,36,0.01,1,1014,0,0,0,0,0,0,0,0,0,0,0,0,0,0,0,0,0
947,948,2013,20,2,18,0.09,9,1014,1,1,0,1,1,0,2,1,0,0,0,1,0,0,0,0,0
948,949,2013,26,22,4,0.84,84,1014,12,8,2,6,8,1,15,2,2,2,0,8,0,0,1,0,0
949,950,2013,35,8,27,0.23,23,1014,4,3,1,1,2,1,4,0,0,0,1,1,1,1,0,0,0
950,951,2013,29,13,16,0.46,46,1014,8,3,2,6,3,1,10,5,0,1,0,3,0,0,1,0,0
951,952,2013,15,4,11,0.28,28,1014,1,2,1,1,1,1,3,1,0,0,0,0,1,1,0,0,0
952,953,2013,54,1,53,0.01,1,1014,0,1,0,0,1,0,1,0,0,0,0,1,0,0,0,0,0
953,954,2013,21,16,5,0.76,76,1014,9,7,0,3,6,0,9,0,0,3,0,5,1,0,0,0,0
954,955,2013,23,23,0,0.99,99,1014,15,7,1,4,5,1,10,0,0,1,3,3,2,1,0,0,0
955,956,2013,40,6,34,0.14,14,1014,2,3,1,2,2,1,5,2,0,0,0,1,1,1,0,0,0
956,957,2013,23,3,20,0.12,12,1014,2,1,0,1,1,0,2,0,1,0,0,1,0,0,0,0,0
957,958,2013,20,4,16,0.2,20,1014,1,2,1,1,2,1,4,1,0,0,0,2,0,1,0,0,0
958,959,2013,22,12,10,0.56,56,1014,5,7,0,4,6,0,10,3,1,0,0,5,1,0,0,0,0
959,960,2013,6,4,2,0.7,70,1014,3,1,0,3,1,0,4,3,0,0,0,1,0,0,0,0,0
960,961,2013,22,3,19,0.14,14,1014,2,1,0,1,1,0,2,0,1,0,0,1,0,0,0,0,0
961,962,2013,34,18,16,0.52,52,1014,10,5,3,8,5,1,14,6,2,0,0,5,0,0,0,1,0
962,963,2013,15,4,11,0.27,27,1014,1,2,1,1,2,1,4,1,0,0,0,2,0,1,0,0,0
963,964,2013,28,20,8,0.71,71,1014,10,8,2,4,4,2,10,2,0,0,2,0,4,2,0,0,0
964,965,2013,16,7,9,0.43,43,1014,5,2,0,4,1,0,5,3,1,0,0,0,1,0,0,0,0
965,966,2013,12,2,10,0.13,13,1014,1,1,0,1,1,0,2,1,0,0,0,1,0,0,0,0,0
966,967,2013,23,21,2,0.93,93,1014,12,7,2,3,5,1,9,0,0,0,3,3,2,0,1,0,0
967,968,2013,31,26,5,0.85,85,1014,13,10,3,9,6,1,16,5,4,0,0,2,4,0,0,1,0
968,969,2013,41,30,11,0.72,72,1014,16,11,3,9,6,3,18,6,1,0,2,1,5,3,0,0,0
969,970,2013,5,1,4,0.23,23,1014,0,1,0,0,1,0,1,0,0,0,0,1,0,0,0,0,0
970,971,2013,52,32,20,0.62,62,1014,22,8,2,10,7,2,19,2,4,4,0,6,1,2,0,0,0
971,972,2013,7,1,6,0.1,10,1014,0,1,0,0,1,0,1,0,0,0,0,1,0,0,0,0,0
972,973,2013,10,5,5,0.48,48,1014,3,2,0,2,2,0,4,1,1,0,0,2,0,0,0,0,0
973,974,2013,23,14,9,0.63,63,1014,7,6,1,3,6,1,10,0,2,1,0,6,0,1,0,0,0
974,975,2013,46,21,25,0.45,45,1014,8,12,1,3,6,1,10,0,2,0,1,0,6,1,0,0,0
975,976,2013,9,0,9,0.05,5,1014,0,0,0,0,0,0,0,0,0,0,0,0,0,0,0,0,0
976,977,2013,55,20,35,0.37,37,1014,9,10,1,4,6,1,11,2,0,1,1,2,4,1,0,0,0
977,978,2013,35,5,30,0.15,15,1014,3,2,0,1,1,0,2,0,0,1,0,0,1,0,0,0,0
978,979,2013,50,32,18,0.64,64,1014,23,7,2,18,4,2,24,16,0,1,1,1,3,2,0,0,0
979,980,2013,14,7,7,0.51,51,1014,4,2,1,3,2,1,6,2,1,0,0,2,0,1,0,0,0
980,981,2013,52,49,3,0.95,95,1014,33,16,0,17,16,0,33,1,16,0,0,16,0,0,0,0,0
981,982,2013,38,17,21,0.45,45,1014,8,7,2,4,5,2,11,2,0,2,0,3,2,2,0,0,0
982,983,2013,40,23,17,0.57,56,1014,16,5,2,5,3,1,9,0,0,4,1,1,2,0,1,0,0
983,984,2013,31,3,28,0.09,9,1014,2,1,0,1,1,0,2,0,1,0,0,1,0,0,0,0,0
984,985,2013,35,30,5,0.86,86,1014,16,13,1,16,9,1,26,16,0,0,0,5,4,1,0,0,0
985,986,2013,39,32,7,0.81,81,1014,17,13,2,12,9,1,22,9,1,2,0,5,4,0,1,0,0
986,987,2013,16,0,16,0.0,0,1014,0,0,0,0,0,0,0,0,0,0,0,0,0,0,0,0,0
987,988,2013,18,8,10,0.45,45,1014,5,2,1,5,1,1,7,5,0,0,0,0,1,1,0,0,0
988,989,2013,26,15,11,0.57,56,1014,8,6,1,3,3,1,7,0,1,2,0,0,3,1,0,0,0
989,990,2013,19,6,13,0.32,32,1014,4,2,0,3,1,0,4,2,1,0,0,0,1,0,0,0,0
990,991,2013,11,3,8,0.28,28,1014,2,1,0,2,1,0,3,2,0,0,0,1,0,0,0,0,0
991,992,2013,17,11,6,0.64,64,1014,7,3,1,3,2,1,6,0,2,1,0,1,1,1,0,0,0
992,993,2013,28,1,27,0.05,5,1014,0,1,0,0,1,0,1,0,0,0,0,1,0,0,0,0,0
993,994,2013,26,9,17,0.34,34,1014,4,4,1,1,4,1,6,0,0,0,1,4,0,1,0,0,0
994,995,2013,33,32,1,0.96,96,1014,13,18,1,6,10,1,17,0,5,1,0,2,8,1,0,0,0
995,996,2013,15,9,6,0.61,61,1014,3,4,2,3,3,2,8,3,0,0,0,2,1,2,0,0,0
996,997,2013,13,11,2,0.85,85,1014,6,5,0,2,3,0,5,0,1,0,1,1,2,0,0,0,0
997,998,2013,11,9,2,0.79,79,1014,6,3,0,4,2,0,6,3,0,1,0,1,1,0,0,0,0
998,999,2013,29,19,10,0.65,65,1014,11,7,1,11,6,1,18,11,0,0,0,5,1,1,0,0,0
999,1000,2013,22,8,14,0.37,37,1014,2,4,2,1,2,2,5,0,1,0,0,0,2,2,0,0,0
1000,1001,2013,22,3,19,0.12,12,1014,2,1,0,2,1,0,3,2,0,0,0,1,0,0,0,0,0
1001,1002,2013,60,58,2,0.96,96,1014,31,25,2,27,17,1,45,25,1,0,1,9,8,0,1,0,0
1002,1003,2013,16,7,9,0.42,42,1014,4,3,0,2,2,0,4,1,0,1,0,1,1,0,0,0,0
1003,1004,2013,27,23,4,0.84,84,1014,12,10,1,9,9,1,19,6,3,0,0,8,1,1,0,0,0
1004,1005,2013,46,21,25,0.45,45,1014,11,7,3,11,4,1,16,11,0,0,0,1,3,0,0,1,0
1005,1006,2013,19,6,13,0.32,32,1014,4,2,0,4,2,0,6,4,0,0,0,2,0,0,0,0,0
1006,1007,2013,38,18,20,0.47,47,1014,6,10,2,4,9,1,14,3,0,1,0,8,1,0,1,0,0
1007,1008,2013,48,0,48,0.0,0,1014,0,0,0,0,0,0,0,0,0,0,0,0,0,0,0,0,0
1008,1009,2013,17,7,10,0.41,41,1014,4,3,0,4,2,0,6,4,0,0,0,1,1,0,0,0,0
1009,1010,2013,27,10,17,0.37,37,1014,4,5,1,2,3,1,6,1,0,1,0,1,2,1,0,0,0
1010,1011,2013,16,9,7,0.56,56,1014,3,5,1,2,4,1,7,1,1,0,0,3,1,1,0,0,0
1011,1012,2013,26,9,17,0.36,36,1014,2,5,2,2,5,2,9,2,0,0,0,5,0,2,0,0,0
1012,1013,2013,52,5,47,0.09,9,1014,2,2,1,1,2,1,4,0,1,0,0,2,0,1,0,0,0
1013,1014,2013,33,14,19,0.41,41,1014,4,7,3,4,6,3,13,4,0,0,0,5,1,3,0,0,0
1014,1,2014,33,27,6,0.82,81,912,14,11,2,12,7,1,20,10,2,0,0,3,4,0,1,0,0
1015,2,2014,15,3,12,0.17,16,912,2,1,0,2,1,0,3,2,0,0,0,1,0,0,0,0,0
1016,3,2014,28,26,2,0.95,94,912,19,7,0,9,4,0,13,3,4,0,2,1,3,0,0,0,0
1017,4,2014,40,38,2,0.95,94,912,25,11,2,13,9,2,24,3,9,0,1,7,2,2,0,0,0
1018,5,2014,33,24,9,0.71,71,912,8,12,4,4,6,3,13,2,1,0,1,0,6,2,1,0,0
1019,6,2014,41,41,0,0.99,98,912,29,10,2,12,10,2,24,3,4,2,3,10,0,2,0,0,0
1020,7,2014,55,49,6,0.88,88,912,18,28,3,15,27,2,44,13,1,1,0,26,1,1,1,0,0
1021,8,2014,38,10,28,0.26,26,912,6,3,1,5,3,1,9,4,1,0,0,3,0,1,0,0,0
1022,9,2014,28,2,26,0.06,5,912,1,1,0,1,1,0,2,1,0,0,0,1,0,0,0,0,0
1023,10,2014,12,8,4,0.66,66,912,2,4,2,2,3,2,7,2,0,0,0,2,1,2,0,0,0
1024,11,2014,49,6,43,0.11,11,912,3,2,1,2,1,1,4,1,1,0,0,0,1,1,0,0,0
1025,12,2014,34,0,34,0.0,0,912,0,0,0,0,0,0,0,0,0,0,0,0,0,0,0,0,0
1026,13,2014,6,4,2,0.63,63,912,1,2,1,1,2,1,4,1,0,0,0,2,0,1,0,0,0
1027,14,2014,32,0,32,0.01,1,912,0,0,0,0,0,0,0,0,0,0,0,0,0,0,0,0,0
1028,15,2014,7,5,2,0.75,74,912,3,2,0,2,2,0,4,1,1,0,0,2,0,0,0,0,0
1029,16,2014,47,27,20,0.58,58,912,11,13,3,5,9,1,15,3,0,0,2,5,4,0,0,1,0
1030,17,2014,13,8,5,0.61,60,912,5,2,1,3,1,1,5,1,2,0,0,0,1,1,0,0,0
1031,18,2014,40,40,0,0.99,98,912,28,9,3,24,6,2,32,22,1,0,1,3,3,1,1,0,0
1032,19,2014,10,1,9,0.05,5,912,0,1,0,0,1,0,1,0,0,0,0,1,0,0,0,0,0
1033,20,2014,9,5,4,0.61,60,912,3,2,0,1,1,0,2,0,0,1,0,0,1,0,0,0,0
1034,21,2014,52,11,41,0.2,20,912,4,4,3,1,2,1,4,0,0,0,1,0,2,0,0,1,0
1035,22,2014,5,4,1,0.76,75,912,1,2,1,1,2,1,4,1,0,0,0,2,0,1,0,0,0
1036,23,2014,34,17,17,0.51,50,912,4,9,4,2,5,3,10,0,2,0,0,1,4,2,1,0,0
1037,24,2014,37,23,14,0.63,63,912,11,10,2,9,9,2,20,7,2,0,0,8,1,2,0,0,0
1038,25,2014,36,32,4,0.9,89,912,20,12,0,14,11,0,25,12,0,0,2,10,1,0,0,0,0
1039,26,2014,33,31,2,0.94,93,912,12,16,3,4,9,1,14,0,0,4,0,2,7,0,0,1,0
1040,27,2014,27,5,22,0.2,20,912,2,2,1,1,2,1,4,0,1,0,0,2,0,1,0,0,0
1041,28,2014,27,18,9,0.65,64,912,6,11,1,5,11,1,17,4,1,0,0,11,0,1,0,0,0
1042,29,2014,8,1,7,0.07,7,912,0,1,0,0,1,0,1,0,0,0,0,1,0,0,0,0,0
1043,30,2014,59,55,4,0.92,92,912,33,22,0,20,20,0,40,14,2,1,3,18,2,0,0,0,0
1044,31,2014,60,10,50,0.17,17,912,5,4,1,3,3,1,7,1,2,0,0,2,1,1,0,0,0
1045,32,2014,10,10,0,0.95,95,912,4,4,2,2,2,1,5,1,0,1,0,0,2,0,1,0,0
1046,33,2014,28,15,13,0.52,52,912,5,7,3,5,6,1,12,5,0,0,0,5,1,0,0,1,0
1047,34,2014,10,3,7,0.27,27,912,2,1,0,1,1,0,2,0,1,0,0,1,0,0,0,0,0
1048,35,2014,52,47,5,0.9,90,912,16,27,4,5,23,2,30,1,0,1,3,19,4,1,0,1,0
1049,36,2014,58,50,8,0.86,85,912,26,23,1,13,23,1,37,5,4,3,1,23,0,1,0,0,0
1050,37,2014,53,43,10,0.81,80,912,30,12,1,16,10,1,27,8,2,6,0,8,2,1,0,0,0
1051,38,2014,19,14,5,0.75,75,912,5,7,2,4,7,2,13,3,1,0,0,7,0,2,0,0,0
1052,39,2014,16,1,15,0.08,8,912,0,1,0,0,1,0,1,0,0,0,0,1,0,0,0,0,0
1053,40,2014,8,8,0,0.99,98,912,3,4,1,2,4,1,7,1,1,0,0,4,0,1,0,0,0
1054,41,2014,24,11,13,0.47,46,912,4,6,1,4,6,1,11,4,0,0,0,6,0,1,0,0,0
1055,42,2014,8,0,8,0.02,2,912,0,0,0,0,0,0,0,0,0,0,0,0,0,0,0,0,0
1056,43,2014,40,22,18,0.55,55,912,9,11,2,6,11,2,19,5,0,0,1,11,0,2,0,0,0
1057,44,2014,29,25,4,0.85,84,912,8,14,3,8,7,3,18,8,0,0,0,0,7,3,0,0,0
1058,45,2014,42,3,39,0.07,6,912,2,1,0,2,1,0,3,2,0,0,0,1,0,0,0,0,0
1059,46,2014,53,53,0,1.0,99,912,34,17,2,13,11,2,26,5,0,3,5,5,6,2,0,0,0
1060,47,2014,37,37,0,1.0,99,912,13,22,2,11,14,2,27,10,0,1,0,6,8,2,0,0,0
1061,48,2014,24,22,2,0.92,91,912,16,4,2,4,4,1,9,0,0,0,4,4,0,0,1,0,0
1062,49,2014,60,33,27,0.55,55,912,14,15,4,14,15,4,33,14,0,0,0,15,0,4,0,0,0
1063,50,2014,17,9,8,0.53,53,912,2,5,2,2,3,1,6,2,0,0,0,1,2,0,1,0,0
1064,51,2014,18,8,10,0.46,45,912,5,3,0,2,3,0,5,0,1,1,0,3,0,0,0,0,0
1065,52,2014,34,9,25,0.26,26,912,5,3,1,3,2,1,6,1,2,0,0,1,1,1,0,0,0
1066,53,2014,25,2,23,0.08,7,912,1,1,0,1,1,0,2,1,0,0,0,1,0,0,0,0,0
1067,54,2014,26,11,15,0.41,40,912,6,5,0,4,5,0,9,2,2,0,0,5,0,0,0,0,0
1068,55,2014,31,31,0,1.0,99,912,16,14,1,6,14,1,21,0,4,0,2,14,0,1,0,0,0
1069,56,2014,25,23,2,0.93,92,912,10,12,1,4,11,1,16,1,0,3,0,10,1,1,0,0,0
1070,57,2014,11,10,1,0.95,94,912,7,3,0,5,2,0,7,4,0,1,0,1,1,0,0,0,0
1071,58,2014,33,15,18,0.46,46,912,6,7,2,6,7,1,14,6,0,0,0,7,0,0,1,0,0
1072,59,2014,7,5,2,0.77,76,912,2,2,1,1,1,1,3,0,1,0,0,0,1,1,0,0,0
1073,60,2014,5,1,4,0.23,22,912,0,1,0,0,1,0,1,0,0,0,0,1,0,0,0,0,0
1074,61,2014,23,13,10,0.55,54,912,6,4,3,3,3,1,7,2,0,0,1,2,1,0,0,1,0
1075,62,2014,47,27,20,0.57,56,912,19,5,3,16,5,1,22,14,1,1,0,5,0,0,0,1,0
1076,63,2014,7,1,6,0.2,19,912,0,1,0,0,1,0,1,0,0,0,0,1,0,0,0,0,0
1077,64,2014,39,30,9,0.78,77,912,16,11,3,8,7,2,17,4,1,2,1,3,4,1,1,0,0
1078,65,2014,47,13,34,0.28,27,912,4,7,2,4,6,1,11,4,0,0,0,5,1,0,1,0,0
1079,66,2014,23,15,8,0.67,67,912,6,6,3,3,3,2,8,2,0,0,1,0,3,1,1,0,0
1080,67,2014,7,1,6,0.21,21,912,0,1,0,0,1,0,1,0,0,0,0,1,0,0,0,0,0
1081,68,2014,36,33,3,0.91,90,912,23,8,2,7,7,1,15,0,2,1,4,6,1,0,1,0,0
1082,69,2014,44,6,38,0.13,12,912,2,3,1,1,2,1,4,0,1,0,0,1,1,1,0,0,0
1083,70,2014,50,24,26,0.48,48,912,17,5,2,16,4,1,21,15,1,0,0,3,1,0,1,0,0
1084,71,2014,14,3,11,0.2,20,912,2,1,0,1,1,0,2,0,1,0,0,1,0,0,0,0,0
1085,72,2014,34,15,19,0.43,42,912,9,4,2,4,2,2,8,0,3,1,0,0,2,2,0,0,0
1086,73,2014,50,3,47,0.07,6,912,2,1,0,2,1,0,3,2,0,0,0,1,0,0,0,0,0
1087,74,2014,40,40,0,1.0,99,912,18,18,4,13,11,3,27,10,1,2,0,4,7,2,1,0,0
1088,75,2014,34,16,18,0.47,46,912,8,5,3,2,4,1,7,0,0,0,2,3,1,0,0,1,0
1089,76,2014,43,29,14,0.67,67,912,16,9,4,6,8,3,17,0,3,2,1,7,1,2,1,0,0
1090,77,2014,13,4,9,0.31,31,912,1,2,1,1,2,1,4,1,0,0,0,2,0,1,0,0,0
1091,78,2014,15,13,2,0.88,88,912,4,7,2,3,6,1,10,2,1,0,0,5,1,0,1,0,0
1092,79,2014,19,9,10,0.46,45,912,5,4,0,4,3,0,7,3,1,0,0,2,1,0,0,0,0
1093,80,2014,43,29,14,0.68,67,912,18,9,2,11,9,2,22,6,3,2,0,9,0,2,0,0,0
1094,81,2014,55,36,19,0.65,65,912,16,19,1,11,11,1,23,9,0,1,1,3,8,1,0,0,0
1095,82,2014,23,22,1,0.97,96,912,8,11,3,3,11,1,15,1,0,1,1,11,0,0,0,1,0
1096,83,2014,9,4,5,0.43,43,912,1,2,1,1,1,1,3,1,0,0,0,0,1,1,0,0,0
1097,84,2014,31,31,0,1.0,99,912,12,15,4,12,10,1,23,12,0,0,0,5,5,0,0,0,1
1098,85,2014,6,4,2,0.63,63,912,2,2,0,1,2,0,3,0,1,0,0,2,0,0,0,0,0
1099,86,2014,53,32,21,0.61,60,912,15,17,0,14,14,0,28,13,1,0,0,11,3,0,0,0,0
1100,87,2014,27,23,4,0.85,85,912,11,9,3,10,8,1,19,9,1,0,0,7,1,0,0,1,0
1101,88,2014,19,5,14,0.28,28,912,3,2,0,2,2,0,4,1,1,0,0,2,0,0,0,0,0
1102,89,2014,29,23,6,0.81,81,912,7,13,3,5,11,1,17,4,0,1,0,9,2,0,0,1,0
1103,90,2014,15,8,7,0.51,50,912,4,3,1,2,3,1,6,0,2,0,0,3,0,1,0,0,0
1104,91,2014,57,46,11,0.81,80,912,23,21,2,11,19,1,31,4,2,5,0,17,2,0,1,0,0
1105,92,2014,40,38,2,0.95,94,912,27,11,0,13,11,0,24,8,0,1,4,11,0,0,0,0,0
1106,93,2014,26,7,19,0.25,25,912,4,2,1,2,2,1,5,1,0,1,0,2,0,1,0,0,0
1107,94,2014,21,13,8,0.61,60,912,6,5,2,5,5,2,12,4,1,0,0,5,0,2,0,0,0
1108,95,2014,39,33,6,0.85,84,912,19,12,2,15,6,2,23,12,2,1,0,0,6,2,0,0,0
1109,96,2014,12,8,4,0.68,68,912,3,5,0,3,3,0,6,3,0,0,0,1,2,0,0,0,0
1110,97,2014,28,22,6,0.78,77,912,6,12,4,5,10,3,18,4,1,0,0,8,2,2,1,0,0
1111,98,2014,60,30,30,0.51,50,912,12,14,4,4,13,3,20,0,1,2,1,12,1,2,1,0,0
1112,99,2014,56,17,39,0.31,30,912,5,8,4,3,7,1,11,2,0,1,0,6,1,0,0,0,1
1113,100,2014,27,1,26,0.04,4,912,0,1,0,0,1,0,1,0,0,0,0,1,0,0,0,0,0
1114,101,2014,31,31,0,1.0,99,912,19,11,1,5,10,1,16,0,0,1,4,9,1,1,0,0,0
1115,102,2014,10,7,3,0.73,72,912,2,3,2,1,3,2,6,0,1,0,0,3,0,2,0,0,0
1116,103,2014,29,4,25,0.13,12,912,1,2,1,1,1,1,3,1,0,0,0,0,1,1,0,0,0
1117,104,2014,57,11,46,0.2,19,912,7,3,1,5,2,1,8,4,0,1,0,1,1,1,0,0,0
1118,105,2014,15,6,9,0.42,42,912,1,4,1,1,2,1,4,1,0,0,0,0,2,1,0,0,0
1119,106,2014,7,3,4,0.48,47,912,1,2,0,1,2,0,3,1,0,0,0,2,0,0,0,0,0
1120,107,2014,8,8,0,0.97,96,912,5,3,0,5,3,0,8,5,0,0,0,3,0,0,0,0,0
1121,108,2014,24,12,12,0.52,51,912,4,7,1,3,7,1,11,2,1,0,0,7,0,1,0,0,0
1122,109,2014,16,8,8,0.49,49,912,3,3,2,3,3,2,8,3,0,0,0,3,0,2,0,0,0
1123,110,2014,19,8,11,0.41,40,912,3,4,1,1,3,1,5,0,0,1,0,2,1,1,0,0,0
1124,111,2014,41,27,14,0.67,66,912,19,7,1,8,5,1,14,1,3,4,0,3,2,1,0,0,0
1125,112,2014,14,0,14,0.01,1,912,0,0,0,0,0,0,0,0,0,0,0,0,0,0,0,0,0
1126,113,2014,7,6,1,0.85,85,912,2,3,1,2,3,1,6,2,0,0,0,3,0,1,0,0,0
1127,114,2014,18,16,2,0.86,86,912,11,3,2,11,2,1,14,11,0,0,0,1,1,0,1,0,0
1128,115,2014,5,2,3,0.34,33,912,1,1,0,1,1,0,2,1,0,0,0,1,0,0,0,0,0
1129,116,2014,42,4,38,0.09,9,912,1,2,1,1,2,1,4,1,0,0,0,2,0,1,0,0,0
1130,117,2014,8,5,3,0.65,64,912,2,3,0,2,2,0,4,2,0,0,0,1,1,0,0,0,0
1131,118,2014,15,4,11,0.28,27,912,2,2,0,2,2,0,4,2,0,0,0,2,0,0,0,0,0
1132,119,2014,14,2,12,0.14,14,912,1,1,0,1,1,0,2,1,0,0,0,1,0,0,0,0,0
1133,120,2014,32,32,0,1.0,99,912,16,15,1,4,13,1,18,0,0,0,4,11,2,1,0,0,0
1134,121,2014,32,14,18,0.44,43,912,8,4,2,4,2,1,7,0,4,0,0,0,2,0,1,0,0
1135,122,2014,6,3,3,0.47,47,912,2,1,0,2,1,0,3,2,0,0,0,1,0,0,0,0,0
1136,123,2014,20,16,4,0.81,81,912,5,8,3,3,5,1,9,2,0,1,0,2,3,0,0,1,0
1137,124,2014,40,39,1,0.98,98,912,13,22,4,7,17,1,25,3,2,2,0,12,5,0,0,0,1
1138,125,2014,48,42,6,0.87,87,912,28,14,0,25,9,0,34,24,0,0,1,4,5,0,0,0,0
1139,126,2014,55,14,41,0.26,25,912,8,4,2,5,3,1,9,4,0,0,1,2,1,0,1,0,0
1140,127,2014,15,3,12,0.19,18,912,2,1,0,2,1,0,3,2,0,0,0,1,0,0,0,0,0
1141,128,2014,11,10,1,0.91,90,912,3,4,3,2,2,3,7,1,1,0,0,0,2,3,0,0,0
1142,129,2014,58,54,4,0.94,93,912,36,16,2,29,9,1,39,26,0,2,1,2,7,0,1,0,0
1143,130,2014,15,13,2,0.86,86,912,4,7,2,2,4,1,7,1,0,1,0,1,3,0,1,0,0
1144,131,2014,52,33,19,0.64,63,912,14,19,0,12,17,0,29,10,2,0,0,15,2,0,0,0,0
1145,132,2014,28,16,12,0.58,57,912,4,9,3,4,6,2,12,4,0,0,0,3,3,1,1,0,0
1146,133,2014,57,8,49,0.14,13,912,5,3,0,3,3,0,6,1,2,0,0,3,0,0,0,0,0
1147,134,2014,26,11,15,0.41,41,912,4,5,2,4,3,1,8,4,0,0,0,1,2,0,1,0,0
1148,135,2014,42,37,5,0.87,87,912,23,12,2,7,7,2,16,0,2,1,4,2,5,2,0,0,0
1149,136,2014,9,7,2,0.74,73,912,4,3,0,3,3,0,6,2,1,0,0,3,0,0,0,0,0
1150,137,2014,23,3,20,0.13,13,912,1,2,0,1,2,0,3,1,0,0,0,2,0,0,0,0,0
1151,138,2014,19,18,1,0.93,93,912,11,7,0,7,4,0,11,4,2,1,0,1,3,0,0,0,0
1152,139,2014,42,39,3,0.92,92,912,16,21,2,10,16,2,28,7,0,3,0,11,5,2,0,0,0
1153,140,2014,29,4,25,0.15,15,912,3,1,0,3,1,0,4,3,0,0,0,1,0,0,0,0,0
1154,141,2014,12,12,0,1.0,99,912,5,6,1,4,3,1,8,3,1,0,0,0,3,1,0,0,0
1155,142,2014,7,3,4,0.44,43,912,2,1,0,2,1,0,3,2,0,0,0,1,0,0,0,0,0
1156,143,2014,7,6,1,0.84,84,912,3,2,1,3,1,1,5,3,0,0,0,0,1,1,0,0,0
1157,144,2014,6,3,3,0.56,55,912,2,1,0,1,1,0,2,0,1,0,0,1,0,0,0,0,0
1158,145,2014,15,15,0,1.0,99,912,11,3,1,7,2,1,10,3,4,0,0,1,1,1,0,0,0
1159,146,2014,29,11,18,0.37,37,912,4,4,3,2,4,3,9,1,0,1,0,4,0,3,0,0,0
1160,147,2014,22,2,20,0.09,9,912,1,1,0,1,1,0,2,1,0,0,0,1,0,0,0,0,0
1161,148,2014,19,10,9,0.55,54,912,6,3,1,3,2,1,6,1,1,1,0,1,1,1,0,0,0
1162,149,2014,32,20,12,0.63,63,912,8,10,2,2,8,2,12,0,0,0,2,6,2,2,0,0,0
1163,150,2014,33,30,3,0.92,92,912,10,17,3,5,14,2,21,1,3,1,0,11,3,1,1,0,0
1164,151,2014,16,5,11,0.33,32,912,2,2,1,2,1,1,4,2,0,0,0,0,1,1,0,0,0
1165,152,2014,6,1,5,0.1,9,912,0,1,0,0,1,0,1,0,0,0,0,1,0,0,0,0,0
1166,153,2014,31,28,3,0.91,91,912,16,9,3,6,5,1,12,2,0,2,2,1,4,0,0,1,0
1167,154,2014,32,5,27,0.15,14,912,2,2,1,1,1,1,3,0,1,0,0,0,1,1,0,0,0
1168,155,2014,27,19,8,0.7,70,912,13,6,0,8,3,0,11,3,5,0,0,0,3,0,0,0,0
1169,156,2014,30,12,18,0.39,38,912,4,6,2,2,6,1,9,1,0,1,0,6,0,0,1,0,0
1170,157,2014,22,18,4,0.83,83,912,7,9,2,3,7,2,12,1,1,0,1,5,2,2,0,0,0
1171,158,2014,26,12,14,0.45,44,912,9,2,1,9,1,1,11,9,0,0,0,0,1,1,0,0,0
1172,159,2014,7,4,3,0.61,61,912,1,2,1,1,1,1,3,1,0,0,0,0,1,1,0,0,0
1173,160,2014,21,18,3,0.87,86,912,9,8,1,8,8,1,17,7,1,0,0,8,0,1,0,0,0
1174,161,2014,34,4,30,0.11,11,912,2,2,0,2,1,0,3,2,0,0,0,0,1,0,0,0,0
1175,162,2014,31,10,21,0.31,31,912,4,4,2,3,3,2,8,2,1,0,0,2,1,2,0,0,0
1176,163,2014,54,16,38,0.3,29,912,5,8,3,5,7,1,13,5,0,0,0,6,1,0,0,1,0
1177,164,2014,5,3,2,0.67,66,912,1,2,0,1,1,0,2,1,0,0,0,0,1,0,0,0,0
1178,165,2014,15,4,11,0.29,29,912,2,2,0,2,2,0,4,2,0,0,0,2,0,0,0,0,0
1179,166,2014,30,16,14,0.53,53,912,7,5,4,2,4,1,7,0,0,1,1,3,1,0,0,0,1
1180,167,2014,15,0,15,0.01,1,912,0,0,0,0,0,0,0,0,0,0,0,0,0,0,0,0,0
1181,168,2014,48,42,6,0.88,87,912,26,16,0,15,9,0,24,5,9,1,0,2,7,0,0,0,0
1182,169,2014,45,11,34,0.25,24,912,4,6,1,2,5,1,8,1,0,1,0,4,1,1,0,0,0
1183,170,2014,26,24,2,0.94,93,912,11,11,2,8,9,2,19,6,1,1,0,7,2,2,0,0,0
1184,171,2014,13,3,10,0.24,24,912,2,1,0,1,1,0,2,0,1,0,0,1,0,0,0,0,0
1185,172,2014,40,1,39,0.03,2,912,0,1,0,0,1,0,1,0,0,0,0,1,0,0,0,0,0
1186,173,2014,39,12,27,0.3,29,912,6,4,2,2,2,2,6,0,1,0,1,0,2,2,0,0,0
1187,174,2014,38,19,19,0.51,50,912,12,5,2,7,3,1,11,2,5,0,0,1,2,0,1,0,0
1188,175,2014,39,24,15,0.63,62,912,12,10,2,4,9,1,14,0,1,2,1,8,1,0,1,0,0
1189,176,2014,14,14,0,0.97,96,912,9,3,2,8,3,1,12,7,1,0,0,3,0,0,1,0,0
1190,177,2014,17,16,1,0.93,93,912,7,6,3,4,3,2,9,2,1,1,0,0,3,1,1,0,0
1191,178,2014,14,13,1,0.91,91,912,7,5,1,5,3,1,9,3,2,0,0,1,2,1,0,0,0
1192,179,2014,30,3,27,0.1,10,912,1,2,0,1,1,0,2,1,0,0,0,0,1,0,0,0,0
1193,180,2014,51,11,40,0.22,21,912,8,2,1,6,2,1,9,5,0,1,0,2,0,1,0,0,0
1194,181,2014,26,10,16,0.38,38,912,7,3,0,6,3,0,9,5,1,0,0,3,0,0,0,0,0
1195,182,2014,33,31,2,0.93,92,912,13,14,4,9,14,2,25,7,1,0,1,14,0,1,0,1,0
1196,183,2014,32,5,27,0.15,15,912,2,2,1,2,2,1,5,2,0,0,0,2,0,1,0,0,0
1197,184,2014,40,19,21,0.47,46,912,9,7,3,7,7,2,16,5,2,0,0,7,0,1,1,0,0
1198,185,2014,7,5,2,0.7,70,912,2,2,1,2,1,1,4,2,0,0,0,0,1,1,0,0,0
1199,186,2014,14,7,7,0.53,53,912,3,3,1,2,2,1,5,1,1,0,0,1,1,1,0,0,0
1200,187,2014,22,21,1,0.94,94,912,14,6,1,12,5,1,18,10,2,0,0,4,1,1,0,0,0
1201,188,2014,19,11,8,0.56,56,912,3,6,2,3,4,1,8,3,0,0,0,2,2,0,1,0,0
1202,189,2014,16,15,1,0.96,96,912,4,8,3,3,6,3,12,2,1,0,0,4,2,3,0,0,0
1203,190,2014,33,33,0,1.0,99,912,12,18,3,7,15,3,25,4,1,2,0,12,3,3,0,0,0
1204,191,2014,13,10,3,0.77,77,912,5,5,0,5,5,0,10,5,0,0,0,5,0,0,0,0,0
1205,192,2014,7,5,2,0.65,64,912,2,2,1,2,1,1,4,2,0,0,0,0,1,1,0,0,0
1206,193,2014,39,34,5,0.88,88,912,21,12,1,11,6,1,18,5,2,4,0,0,6,1,0,0,0
1207,194,2014,40,39,1,0.98,97,912,21,17,1,10,10,1,21,5,0,4,1,3,7,1,0,0,0
1208,195,2014,34,13,21,0.37,37,912,7,5,1,2,3,1,6,0,0,1,1,1,2,1,0,0,0
1209,196,2014,19,15,4,0.81,81,912,8,6,1,5,5,1,11,4,0,0,1,4,1,1,0,0,0
1210,197,2014,8,3,5,0.42,41,912,2,1,0,2,1,0,3,2,0,0,0,1,0,0,0,0,0
1211,198,2014,30,4,26,0.14,14,912,2,2,0,2,2,0,4,2,0,0,0,2,0,0,0,0,0
1212,199,2014,6,2,4,0.4,40,912,1,1,0,1,1,0,2,1,0,0,0,1,0,0,0,0,0
1213,200,2014,54,22,32,0.4,40,912,10,10,2,9,9,1,19,8,1,0,0,8,1,0,1,0,0
1214,201,2014,46,38,8,0.83,82,912,21,16,1,15,14,1,30,9,6,0,0,12,2,1,0,0,0
1215,202,2014,35,2,33,0.06,5,912,1,1,0,1,1,0,2,1,0,0,0,1,0,0,0,0,0
1216,203,2014,25,3,22,0.13,13,912,2,1,0,2,1,0,3,2,0,0,0,1,0,0,0,0,0
1217,204,2014,38,22,16,0.57,56,912,15,6,1,5,6,1,12,0,1,3,1,6,0,1,0,0,0
1218,205,2014,27,24,3,0.89,89,912,15,7,2,9,5,1,15,5,3,0,1,3,2,0,1,0,0
1219,206,2014,31,30,1,0.96,96,912,21,9,0,12,8,0,20,6,3,3,0,7,1,0,0,0,0
1220,207,2014,6,5,1,0.81,81,912,1,3,1,1,3,1,5,1,0,0,0,3,0,1,0,0,0
1221,208,2014,36,36,0,0.99,99,912,26,7,3,21,4,2,27,17,3,1,0,1,3,1,1,0,0
1222,209,2014,32,0,32,0.0,0,912,0,0,0,0,0,0,0,0,0,0,0,0,0,0,0,0,0
1223,210,2014,34,5,29,0.14,14,912,3,2,0,1,1,0,2,0,0,1,0,0,1,0,0,0,0
1224,211,2014,31,31,0,1.0,99,912,18,11,2,6,7,1,14,1,0,3,2,3,4,0,1,0,0
1225,212,2014,35,27,8,0.77,77,912,19,5,3,7,5,1,13,0,2,5,0,5,0,0,0,1,0
1226,213,2014,10,1,9,0.05,5,912,0,1,0,0,1,0,1,0,0,0,0,1,0,0,0,0,0
1227,214,2014,18,18,0,1.0,99,912,13,5,0,9,5,0,14,6,2,1,0,5,0,0,0,0,0
1228,215,2014,5,4,1,0.88,87,912,1,2,1,1,1,1,3,1,0,0,0,0,1,1,0,0,0
1229,216,2014,26,17,9,0.66,66,912,6,8,3,6,6,1,13,6,0,0,0,4,2,0,0,1,0
1230,217,2014,36,19,17,0.53,52,912,6,10,3,3,6,2,11,1,1,1,0,2,4,1,1,0,0
1231,218,2014,39,35,4,0.9,90,912,20,12,3,8,10,1,19,1,2,5,0,8,2,0,0,1,0
1232,219,2014,48,33,15,0.7,69,912,12,17,4,5,16,4,25,2,0,2,1,15,1,4,0,0,0
1233,220,2014,44,13,31,0.29,29,912,8,3,2,2,2,2,6,0,0,0,2,1,1,2,0,0,0
1234,221,2014,37,26,11,0.7,69,912,13,10,3,9,10,1,20,7,0,2,0,10,0,0,0,1,0
1235,222,2014,15,4,11,0.25,24,912,1,2,1,1,1,1,3,1,0,0,0,0,1,1,0,0,0
1236,223,2014,50,49,1,0.97,97,912,32,13,4,30,13,3,46,28,2,0,0,13,0,2,1,0,0
1237,224,2014,21,13,8,0.6,59,912,5,6,2,2,5,2,9,1,0,0,1,4,1,2,0,0,0
1238,225,2014,16,16,0,1.0,99,912,9,4,3,3,4,2,9,0,1,1,1,4,0,1,1,0,0
1239,226,2014,7,6,1,0.88,88,912,2,3,1,1,3,1,5,0,1,0,0,3,0,1,0,0,0
1240,227,2014,17,12,5,0.73,73,912,7,5,0,5,4,0,9,3,2,0,0,3,1,0,0,0,0
1241,228,2014,11,3,8,0.28,28,912,2,1,0,2,1,0,3,2,0,0,0,1,0,0,0,0,0
1242,229,2014,14,12,2,0.85,85,912,5,4,3,5,4,2,11,5,0,0,0,4,0,1,1,0,0
1243,230,2014,22,7,15,0.31,30,912,2,3,2,2,3,1,6,2,0,0,0,3,0,0,1,0,0
1244,231,2014,17,8,9,0.49,49,912,2,4,2,2,4,2,8,2,0,0,0,4,0,2,0,0,0
1245,232,2014,30,22,8,0.73,72,912,8,13,1,6,11,1,18,4,2,0,0,9,2,1,0,0,0
1246,233,2014,16,4,12,0.25,25,912,1,2,1,1,2,1,4,1,0,0,0,2,0,1,0,0,0
1247,234,2014,24,1,23,0.04,4,912,0,1,0,0,1,0,1,0,0,0,0,1,0,0,0,0,0
1248,235,2014,22,22,0,1.0,99,912,15,6,1,7,5,1,13,3,1,2,1,4,1,1,0,0,0
1249,236,2014,14,6,8,0.44,43,912,3,2,1,3,2,1,6,3,0,0,0,2,0,1,0,0,0
1250,237,2014,42,2,40,0.04,4,912,1,1,0,1,1,0,2,1,0,0,0,1,0,0,0,0,0
1251,238,2014,17,13,4,0.77,77,912,6,4,3,5,3,1,9,4,1,0,0,2,1,0,0,1,0
1252,239,2014,12,1,11,0.04,4,912,0,1,0,0,1,0,1,0,0,0,0,1,0,0,0,0,0
1253,240,2014,28,18,10,0.63,62,912,10,5,3,4,4,1,9,1,0,3,0,3,1,0,0,1,0
1254,241,2014,18,14,4,0.78,78,912,8,5,1,2,4,1,7,0,0,0,2,3,1,1,0,0,0
1255,242,2014,55,51,4,0.93,92,912,25,22,4,15,22,2,39,7,7,0,1,22,0,0,2,0,0
1256,243,2014,22,9,13,0.39,38,912,4,5,0,4,4,0,8,4,0,0,0,3,1,0,0,0,0
1257,244,2014,53,31,22,0.59,59,912,13,16,2,11,13,2,26,9,2,0,0,10,3,2,0,0,0
1258,245,2014,46,25,21,0.54,54,912,17,7,1,16,4,1,21,15,1,0,0,1,3,1,0,0,0
1259,246,2014,30,28,2,0.94,93,912,16,11,1,10,10,1,21,8,0,0,2,9,1,1,0,0,0
1260,247,2014,39,12,27,0.32,31,912,7,5,0,3,5,0,8,0,2,1,0,5,0,0,0,0,0
1261,248,2014,15,12,3,0.81,80,912,4,6,2,4,3,1,8,4,0,0,0,0,3,0,1,0,0
1262,249,2014,13,9,4,0.7,69,912,6,2,1,2,1,1,4,0,1,0,1,0,1,1,0,0,0
1263,250,2014,46,17,29,0.37,37,912,11,5,1,4,5,1,10,0,1,3,0,5,0,1,0,0,0
1264,251,2014,51,17,34,0.34,34,912,8,7,2,6,7,2,15,5,0,1,0,7,0,2,0,0,0
1265,252,2014,11,5,6,0.43,43,912,3,2,0,3,1,0,4,3,0,0,0,0,1,0,0,0,0
1266,253,2014,57,38,19,0.66,65,912,19,16,3,15,10,3,28,13,1,0,1,4,6,3,0,0,0
1267,254,2014,30,17,13,0.57,56,912,9,7,1,6,6,1,13,3,3,0,0,5,1,1,0,0,0
1268,255,2014,35,19,16,0.54,54,912,4,11,4,4,6,3,13,4,0,0,0,1,5,2,1,0,0
1269,256,2014,34,3,31,0.08,8,912,2,1,0,1,1,0,2,0,1,0,0,1,0,0,0,0,0
1270,257,2014,15,15,0,0.98,98,912,7,7,1,6,4,1,11,5,1,0,0,1,3,1,0,0,0
1271,258,2014,37,14,23,0.38,38,912,10,4,0,9,3,0,12,8,1,0,0,2,1,0,0,0,0
1272,259,2014,14,1,13,0.04,3,912,0,1,0,0,1,0,1,0,0,0,0,1,0,0,0,0,0
1273,260,2014,56,20,36,0.35,35,912,11,7,2,3,6,1,10,0,0,1,2,5,1,0,1,0,0
1274,261,2014,7,4,3,0.61,61,912,2,2,0,2,2,0,4,2,0,0,0,2,0,0,0,0,0
1275,262,2014,30,7,23,0.24,23,912,2,4,1,1,2,1,4,0,1,0,0,0,2,1,0,0,0
1276,263,2014,29,27,2,0.92,91,912,16,7,4,7,4,3,14,1,4,1,1,1,3,2,1,0,0
1277,264,2014,25,20,5,0.82,81,912,11,7,2,7,7,2,16,4,2,1,0,7,0,2,0,0,0
1278,265,2014,23,16,7,0.7,70,912,9,5,2,6,3,1,10,3,3,0,0,1,2,0,1,0,0
1279,266,2014,25,9,16,0.36,35,912,6,2,1,6,1,1,8,6,0,0,0,0,1,1,0,0,0
1280,267,2014,12,11,1,0.95,95,912,3,6,2,1,6,1,8,0,0,1,0,6,0,0,1,0,0
1281,268,2014,19,15,4,0.76,76,912,6,7,2,6,4,1,11,6,0,0,0,1,3,0,1,0,0
1282,269,2014,32,1,31,0.02,2,912,0,1,0,0,1,0,1,0,0,0,0,1,0,0,0,0,0
1283,270,2014,35,32,3,0.92,91,912,12,17,3,6,13,2,21,2,3,0,1,9,4,1,1,0,0
1284,271,2014,30,25,5,0.84,83,912,9,14,2,3,10,1,14,1,0,0,2,6,4,0,1,0,0
1285,272,2014,46,44,2,0.96,96,912,24,16,4,12,15,4,31,5,4,1,2,14,1,4,0,0,0
1286,273,2014,14,13,1,0.96,95,912,7,4,2,3,2,2,7,1,0,2,0,0,2,2,0,0,0
1287,274,2014,19,19,0,0.99,99,912,9,8,2,9,4,1,14,9,0,0,0,0,4,0,1,0,0
1288,275,2014,11,2,9,0.16,16,912,1,1,0,1,1,0,2,1,0,0,0,1,0,0,0,0,0
1289,276,2014,31,24,7,0.77,77,912,8,13,3,6,13,2,21,4,2,0,0,13,0,1,1,0,0
1290,277,2014,28,27,1,0.95,95,912,13,11,3,5,7,1,13,0,2,3,0,3,4,0,0,1,0
1291,278,2014,31,27,4,0.87,87,912,14,12,1,13,12,1,26,12,1,0,0,12,0,1,0,0,0
1292,279,2014,21,5,16,0.23,22,912,2,3,0,1,3,0,4,0,1,0,0,3,0,0,0,0,0
1293,280,2014,15,12,3,0.79,78,912,7,3,2,2,2,2,6,0,0,1,1,1,1,2,0,0,0
1294,281,2014,39,24,15,0.61,60,912,8,12,4,3,9,1,13,0,1,2,0,6,3,0,0,0,1
1295,282,2014,49,16,33,0.32,32,912,6,9,1,2,8,1,11,0,0,2,0,7,1,1,0,0,0
1296,283,2014,20,1,19,0.04,3,912,0,1,0,0,1,0,1,0,0,0,0,1,0,0,0,0,0
1297,284,2014,11,1,10,0.07,7,912,0,1,0,0,1,0,1,0,0,0,0,1,0,0,0,0,0
1298,285,2014,48,32,16,0.67,66,912,15,13,4,8,13,1,22,4,2,1,1,13,0,0,0,0,1
1299,286,2014,28,3,25,0.09,9,912,1,2,0,1,1,0,2,1,0,0,0,0,1,0,0,0,0
1300,287,2014,15,13,2,0.89,88,912,5,5,3,4,5,2,11,3,1,0,0,5,0,1,1,0,0
1301,288,2014,37,15,22,0.4,40,912,10,3,2,10,2,1,13,10,0,0,0,1,1,0,1,0,0
1302,289,2014,20,10,10,0.49,49,912,6,4,0,2,2,0,4,0,0,2,0,0,2,0,0,0,0
1303,290,2014,22,13,9,0.6,60,912,7,6,0,4,4,0,8,1,3,0,0,2,2,0,0,0,0
1304,291,2014,39,38,1,0.99,98,912,21,17,0,7,15,0,22,1,0,4,2,13,2,0,0,0,0
1305,292,2014,15,15,0,0.99,99,912,11,4,0,11,4,0,15,11,0,0,0,4,0,0,0,0,0
1306,293,2014,20,19,1,0.95,95,912,6,11,2,5,7,2,14,4,1,0,0,3,4,2,0,0,0
1307,294,2014,22,13,9,0.6,60,912,5,6,2,2,3,1,6,1,0,0,1,0,3,0,1,0,0
1308,295,2014,49,10,39,0.2,20,912,4,6,0,1,3,0,4,0,0,0,1,0,3,0,0,0,0
1309,296,2014,18,0,18,0.02,2,912,0,0,0,0,0,0,0,0,0,0,0,0,0,0,0,0,0
1310,297,2014,35,12,23,0.34,33,912,3,7,2,1,6,1,8,0,0,1,0,5,1,0,1,0,0
1311,298,2014,44,40,4,0.92,91,912,15,23,2,4,22,2,28,0,0,1,3,21,1,2,0,0,0
1312,299,2014,33,26,7,0.8,80,912,12,10,4,7,6,2,15,3,3,1,0,2,4,0,2,0,0
1313,300,2014,25,11,14,0.46,45,912,6,4,1,4,4,1,9,2,2,0,0,4,0,1,0,0,0
1314,301,2014,30,20,10,0.66,66,912,10,8,2,6,7,2,15,3,2,1,0,6,1,2,0,0,0
1315,302,2014,29,14,15,0.47,46,912,10,3,1,6,3,1,10,4,1,0,1,3,0,1,0,0,0
1316,303,2014,56,54,2,0.96,95,912,25,27,2,10,19,2,31,2,2,5,1,11,8,2,0,0,0
1317,304,2014,47,11,36,0.24,24,912,4,5,2,4,3,1,8,4,0,0,0,1,2,0,1,0,0
1318,305,2014,18,14,4,0.76,76,912,5,6,3,3,3,3,9,1,2,0,0,0,3,3,0,0,0
1319,306,2014,49,41,8,0.84,84,912,30,11,0,9,7,0,16,1,1,1,6,3,4,0,0,0,0
1320,307,2014,35,23,12,0.65,64,912,8,13,2,5,10,2,17,2,3,0,0,7,3,2,0,0,0
1321,308,2014,13,10,3,0.78,77,912,4,5,1,2,4,1,7,1,0,1,0,3,1,1,0,0,0
1322,309,2014,10,5,5,0.53,53,912,2,2,1,1,1,1,3,0,1,0,0,0,1,1,0,0,0
1323,310,2014,37,0,37,0.0,0,912,0,0,0,0,0,0,0,0,0,0,0,0,0,0,0,0,0
1324,311,2014,30,29,1,0.97,96,912,13,14,2,8,8,2,18,4,3,1,0,2,6,2,0,0,0
1325,312,2014,11,7,4,0.61,61,912,5,2,0,3,1,0,4,1,2,0,0,0,1,0,0,0,0
1326,313,2014,60,42,18,0.71,70,912,28,12,2,9,9,1,19,0,3,2,4,6,3,0,1,0,0
1327,314,2014,9,8,1,0.9,89,912,6,2,0,6,1,0,7,6,0,0,0,0,1,0,0,0,0
1328,315,2014,54,52,2,0.97,96,912,29,20,3,13,15,1,29,3,4,6,0,10,5,0,0,1,0
1329,316,2014,15,14,1,0.96,95,912,5,8,1,3,6,1,10,2,0,1,0,4,2,1,0,0,0
1330,317,2014,41,26,15,0.64,63,912,11,14,1,5,8,1,14,1,2,2,0,2,6,1,0,0,0
1331,318,2014,26,21,5,0.8,79,912,12,7,2,6,6,2,14,0,6,0,0,5,1,2,0,0,0
1332,319,2014,7,7,0,1.0,99,912,2,3,2,1,2,2,5,0,1,0,0,1,1,2,0,0,0
1333,320,2014,28,10,18,0.36,35,912,3,4,3,2,4,1,7,1,1,0,0,4,0,0,0,1,0
1334,321,2014,5,5,0,0.92,92,912,2,2,1,2,2,1,5,2,0,0,0,2,0,1,0,0,0
1335,322,2014,14,10,4,0.7,70,912,3,4,3,3,4,1,8,3,0,0,0,4,0,0,0,1,0
1336,323,2014,57,21,36,0.37,36,912,14,6,1,10,5,1,16,7,2,1,0,4,1,1,0,0,0
1337,324,2014,26,6,20,0.24,23,912,2,3,1,2,2,1,5,2,0,0,0,1,1,1,0,0,0
1338,325,2014,25,25,0,1.0,99,912,9,15,1,5,13,1,19,1,4,0,0,11,2,1,0,0,0
1339,326,2014,27,10,17,0.38,38,912,3,4,3,1,2,3,6,0,0,1,0,0,2,3,0,0,0
1340,327,2014,52,48,4,0.92,91,912,22,25,1,18,21,1,40,16,0,2,0,17,4,1,0,0,0
1341,328,2014,9,5,4,0.51,51,912,2,2,1,1,1,1,3,0,1,0,0,0,1,1,0,0,0
1342,329,2014,25,24,1,0.97,96,912,12,9,3,7,5,3,15,2,5,0,0,1,4,3,0,0,0
1343,330,2014,30,11,19,0.37,36,912,5,4,2,4,3,2,9,3,1,0,0,2,1,2,0,0,0
1344,331,2014,59,52,7,0.87,87,912,23,27,2,13,23,2,38,8,1,3,1,19,4,2,0,0,0
1345,332,2014,43,3,40,0.08,7,912,2,1,0,2,1,0,3,2,0,0,0,1,0,0,0,0,0
1346,333,2014,27,4,23,0.16,16,912,1,2,1,1,1,1,3,1,0,0,0,0,1,1,0,0,0
1347,334,2014,24,10,14,0.42,42,912,3,4,3,1,4,3,8,0,0,1,0,4,0,3,0,0,0
1348,335,2014,58,40,18,0.68,68,912,26,12,2,12,7,1,20,3,6,1,2,2,5,0,1,0,0
1349,336,2014,40,26,14,0.64,63,912,12,12,2,11,10,2,23,10,1,0,0,8,2,2,0,0,0
1350,337,2014,31,9,22,0.29,29,912,7,2,0,6,2,0,8,5,1,0,0,2,0,0,0,0,0
1351,338,2014,15,9,6,0.62,61,912,6,2,1,4,1,1,6,2,2,0,0,0,1,1,0,0,0
1352,339,2014,23,14,9,0.63,62,912,8,4,2,2,4,2,8,0,0,0,2,4,0,2,0,0,0
1353,340,2014,38,36,2,0.94,94,912,23,10,3,13,9,2,24,8,2,1,2,8,1,1,1,0,0
1354,341,2014,27,26,1,0.98,98,912,16,7,3,7,7,3,17,2,3,0,2,7,0,3,0,0,0
1355,342,2014,8,3,5,0.39,38,912,1,2,0,1,2,0,3,1,0,0,0,2,0,0,0,0,0
1356,343,2014,50,26,24,0.51,51,912,15,8,3,12,4,2,18,9,3,0,0,0,4,1,1,0,0
1357,344,2014,23,22,1,0.94,93,912,6,13,3,4,12,2,18,3,0,1,0,11,1,1,1,0,0
1358,345,2014,40,39,1,0.96,96,912,20,17,2,12,13,1,26,6,4,2,0,9,4,0,1,0,0
1359,346,2014,48,46,2,0.96,96,912,25,18,3,20,16,3,39,17,1,2,0,14,2,3,0,0,0
1360,347,2014,21,19,2,0.9,90,912,11,6,2,9,5,2,16,8,0,1,0,4,1,2,0,0,0
1361,348,2014,38,34,4,0.9,90,912,14,19,1,14,10,1,25,14,0,0,0,1,9,1,0,0,0
1362,349,2014,24,23,1,0.97,97,912,15,5,3,8,3,2,13,3,4,0,1,1,2,1,1,0,0
1363,350,2014,39,37,2,0.94,94,912,23,12,2,19,8,2,29,16,2,1,0,4,4,2,0,0,0
1364,351,2014,29,5,24,0.16,16,912,2,3,0,2,2,0,4,2,0,0,0,1,1,0,0,0,0
1365,352,2014,36,25,11,0.69,69,912,13,10,2,4,5,2,11,0,0,3,1,0,5,2,0,0,0
1366,353,2014,39,37,2,0.96,95,912,21,14,2,7,14,2,23,0,2,3,2,14,0,2,0,0,0
1367,354,2014,15,4,11,0.27,26,912,1,2,1,1,2,1,4,1,0,0,0,2,0,1,0,0,0
1368,355,2014,22,22,0,0.99,98,912,9,9,4,5,7,2,14,2,2,1,0,5,2,1,0,1,0
1369,356,2014,31,17,14,0.55,55,912,7,8,2,2,8,2,12,0,0,1,1,8,0,2,0,0,0
1370,357,2014,26,8,18,0.3,30,912,3,3,2,1,3,2,6,0,0,1,0,3,0,2,0,0,0
1371,358,2014,49,1,48,0.01,1,912,0,1,0,0,1,0,1,0,0,0,0,1,0,0,0,0,0
1372,359,2014,36,18,18,0.49,48,912,12,5,1,11,5,1,17,10,1,0,0,5,0,1,0,0,0
1373,360,2014,37,23,14,0.63,63,912,12,10,1,9,5,1,15,6,3,0,0,0,5,1,0,0,0
1374,361,2014,27,5,22,0.18,17,912,2,3,0,1,3,0,4,0,1,0,0,3,0,0,0,0,0
1375,362,2014,18,5,13,0.3,30,912,2,2,1,2,1,1,4,2,0,0,0,0,1,1,0,0,0
1376,363,2014,34,34,0,0.99,99,912,15,17,2,6,14,1,21,1,3,0,2,11,3,0,1,0,0
1377,364,2014,35,25,10,0.72,71,912,11,13,1,5,8,1,14,1,3,0,1,3,5,1,0,0,0
1378,365,2014,25,10,15,0.39,39,912,3,4,3,3,4,3,10,3,0,0,0,4,0,3,0,0,0
1379,366,2014,9,3,6,0.3,30,912,2,1,0,1,1,0,2,0,1,0,0,1,0,0,0,0,0
1380,367,2014,12,7,5,0.58,57,912,3,3,1,2,3,1,6,1,1,0,0,3,0,1,0,0,0
1381,368,2014,58,8,50,0.14,14,912,3,4,1,2,3,1,6,1,1,0,0,2,1,1,0,0,0
1382,369,2014,51,33,18,0.64,63,912,21,10,2,15,7,2,24,12,0,3,0,4,3,2,0,0,0
1383,370,2014,28,1,27,0.04,4,912,0,1,0,0,1,0,1,0,0,0,0,1,0,0,0,0,0
1384,371,2014,15,12,3,0.77,76,912,5,6,1,2,4,1,7,1,0,0,1,2,2,1,0,0,0
1385,372,2014,6,0,6,0.06,6,912,0,0,0,0,0,0,0,0,0,0,0,0,0,0,0,0,0
1386,373,2014,16,12,4,0.73,72,912,6,4,2,2,4,2,8,0,1,0,1,4,0,2,0,0,0
1387,374,2014,16,15,1,0.93,92,912,6,6,3,2,5,1,8,0,1,0,1,4,1,0,0,1,0
1388,375,2014,33,1,32,0.04,4,912,0,1,0,0,1,0,1,0,0,0,0,1,0,0,0,0,0
1389,376,2014,36,5,31,0.14,13,912,2,2,1,1,2,1,4,0,1,0,0,2,0,1,0,0,0
1390,377,2014,9,9,0,0.98,97,912,3,4,2,2,2,2,6,1,1,0,0,0,2,2,0,0,0
1391,378,2014,14,13,1,0.94,94,912,5,5,3,3,3,1,7,2,0,1,0,1,2,0,0,1,0
1392,379,2014,43,37,6,0.86,85,912,27,9,1,17,9,1,27,10,4,3,0,9,0,1,0,0,0
1393,380,2014,42,10,32,0.23,23,912,5,3,2,4,2,1,7,3,1,0,0,1,1,0,1,0,0
1394,381,2014,31,26,5,0.85,85,912,19,4,3,13,2,2,17,10,0,3,0,0,2,1,1,0,0
1395,382,2014,40,38,2,0.95,95,912,22,13,3,6,7,2,15,0,0,2,4,1,6,1,1,0,0
1396,383,2014,20,16,4,0.79,79,912,11,4,1,7,2,1,10,5,1,0,1,0,2,1,0,0,0
1397,384,2014,42,28,14,0.67,67,912,10,14,4,3,13,4,20,0,1,0,2,12,1,4,0,0,0
1398,385,2014,18,15,3,0.84,83,912,4,8,3,3,5,3,11,2,1,0,0,2,3,3,0,0,0
1399,386,2014,56,29,27,0.51,51,912,16,13,0,16,8,0,24,16,0,0,0,3,5,0,0,0,0
1400,387,2014,58,40,18,0.7,69,912,28,9,3,14,5,3,22,3,9,1,1,1,4,3,0,0,0
1401,388,2014,32,21,11,0.65,64,912,12,9,0,10,9,0,19,9,0,1,0,9,0,0,0,0,0
1402,389,2014,50,13,37,0.25,25,912,6,5,2,6,5,1,12,6,0,0,0,5,0,0,1,0,0
1403,390,2014,34,7,27,0.19,19,912,3,3,1,1,3,1,5,0,0,1,0,3,0,1,0,0,0
1404,391,2014,39,32,7,0.81,80,912,17,13,2,16,13,1,30,15,1,0,0,13,0,0,1,0,0
1405,392,2014,15,3,12,0.21,20,912,2,1,0,2,1,0,3,2,0,0,0,1,0,0,0,0,0
1406,393,2014,9,7,2,0.77,76,912,4,2,1,2,2,1,5,0,2,0,0,2,0,1,0,0,0
1407,394,2014,31,1,30,0.04,3,912,0,1,0,0,1,0,1,0,0,0,0,1,0,0,0,0,0
1408,395,2014,11,10,1,0.95,95,912,3,5,2,3,5,2,10,3,0,0,0,5,0,2,0,0,0
1409,396,2014,31,30,1,0.96,95,912,8,18,4,8,10,1,19,8,0,0,0,2,8,0,0,0,1
1410,397,2014,53,20,33,0.38,38,912,13,6,1,9,6,1,16,7,1,0,1,6,0,1,0,0,0
1411,398,2014,15,14,1,0.94,93,912,6,5,3,3,4,3,10,2,0,0,1,3,1,3,0,0,0
1412,399,2014,36,36,0,1.0,99,912,21,13,2,8,13,1,22,0,4,3,1,13,0,0,1,0,0
1413,400,2014,25,14,11,0.56,55,912,4,7,3,4,4,1,9,4,0,0,0,1,3,0,0,1,0
1414,401,2014,22,20,2,0.91,91,912,11,8,1,9,6,1,16,7,2,0,0,4,2,1,0,0,0
1415,402,2014,57,55,2,0.96,96,912,31,21,3,30,11,3,44,29,1,0,0,1,10,3,0,0,0
1416,403,2014,28,25,3,0.89,88,912,10,12,3,3,6,2,11,0,0,2,1,0,6,1,1,0,0
1417,404,2014,9,8,1,0.93,93,912,4,3,1,3,3,1,7,2,1,0,0,3,0,1,0,0,0
1418,405,2014,57,30,27,0.53,52,912,12,17,1,9,11,1,21,6,3,0,0,5,6,1,0,0,0
1419,406,2014,39,25,14,0.63,63,912,9,13,3,9,7,1,17,9,0,0,0,1,6,0,0,1,0
1420,407,2014,9,2,7,0.22,21,912,1,1,0,1,1,0,2,1,0,0,0,1,0,0,0,0,0
1421,408,2014,39,36,3,0.92,92,912,22,10,4,20,6,1,27,19,0,1,0,2,4,0,0,0,1
1422,409,2014,16,16,0,0.99,99,912,8,7,1,8,5,1,14,8,0,0,0,3,2,1,0,0,0
1423,410,2014,52,29,23,0.56,56,912,16,9,4,14,8,1,23,12,2,0,0,7,1,0,0,0,1
1424,411,2014,52,30,22,0.57,57,912,19,7,4,12,6,3,21,8,1,3,0,5,1,2,1,0,0
1425,412,2014,55,47,8,0.85,84,912,25,18,4,16,9,4,29,10,4,1,1,0,9,4,0,0,0
1426,413,2014,9,7,2,0.83,82,912,2,3,2,1,3,2,6,0,1,0,0,3,0,2,0,0,0
1427,414,2014,9,9,0,0.96,95,912,6,3,0,3,3,0,6,0,3,0,0,3,0,0,0,0,0
1428,415,2014,8,5,3,0.65,64,912,2,2,1,2,1,1,4,2,0,0,0,0,1,1,0,0,0
1429,416,2014,26,0,26,0.01,1,912,0,0,0,0,0,0,0,0,0,0,0,0,0,0,0,0,0
1430,417,2014,48,34,14,0.71,70,912,16,17,1,11,13,1,25,7,3,1,0,9,4,1,0,0,0
1431,418,2014,28,2,26,0.07,6,912,1,1,0,1,1,0,2,1,0,0,0,1,0,0,0,0,0
1432,419,2014,20,9,11,0.44,43,912,6,2,1,5,2,1,8,4,1,0,0,2,0,1,0,0,0
1433,420,2014,14,13,1,0.96,96,912,5,7,1,2,6,1,9,0,1,1,0,5,1,1,0,0,0
1434,421,2014,16,10,6,0.64,63,912,3,4,3,3,3,2,8,3,0,0,0,2,1,1,1,0,0
1435,422,2014,15,5,10,0.33,32,912,2,2,1,2,1,1,4,2,0,0,0,0,1,1,0,0,0
1436,423,2014,13,5,8,0.4,39,912,3,2,0,3,2,0,5,3,0,0,0,2,0,0,0,0,0
1437,424,2014,27,4,23,0.15,14,912,2,2,0,1,2,0,3,0,1,0,0,2,0,0,0,0,0
1438,425,2014,20,4,16,0.19,19,912,1,2,1,1,1,1,3,1,0,0,0,0,1,1,0,0,0
1439,426,2014,44,13,31,0.3,30,912,4,6,3,2,4,2,8,1,0,1,0,2,2,1,1,0,0
1440,427,2014,19,12,7,0.62,62,912,4,5,3,3,3,3,9,2,1,0,0,1,2,3,0,0,0
1441,428,2014,33,2,31,0.05,4,912,1,1,0,1,1,0,2,1,0,0,0,1,0,0,0,0,0
1442,429,2014,8,1,7,0.17,16,912,0,1,0,0,1,0,1,0,0,0,0,1,0,0,0,0,0
1443,430,2014,11,8,3,0.69,68,912,6,2,0,2,1,0,3,0,0,2,0,0,1,0,0,0,0
1444,431,2014,55,13,42,0.24,23,912,10,2,1,10,1,1,12,10,0,0,0,0,1,1,0,0,0
1445,432,2014,36,26,10,0.71,71,912,17,8,1,8,7,1,16,3,3,0,2,6,1,1,0,0,0
1446,433,2014,19,14,5,0.74,74,912,9,3,2,5,3,1,9,3,0,2,0,3,0,0,1,0,0
1447,434,2014,14,12,2,0.85,85,912,3,6,3,3,6,1,10,3,0,0,0,6,0,0,0,1,0
1448,435,2014,17,16,1,0.96,95,912,7,6,3,4,6,3,13,3,0,0,1,6,0,3,0,0,0
1449,436,2014,40,21,19,0.51,51,912,12,7,2,10,6,2,18,9,0,1,0,5,1,2,0,0,0
1450,437,2014,11,10,1,0.92,91,912,4,5,1,1,3,1,5,0,0,0,1,1,2,1,0,0,0
1451,438,2014,9,9,0,0.98,97,912,6,2,1,3,1,1,5,2,0,0,1,0,1,1,0,0,0
1452,439,2014,30,2,28,0.07,7,912,1,1,0,1,1,0,2,1,0,0,0,1,0,0,0,0,0
1453,440,2014,31,30,1,0.95,95,912,12,16,2,3,8,2,13,0,0,0,3,0,8,2,0,0,0
1454,441,2014,6,0,6,0.01,1,912,0,0,0,0,0,0,0,0,0,0,0,0,0,0,0,0,0
1455,442,2014,36,30,6,0.82,82,912,12,15,3,7,14,1,22,5,0,1,1,13,1,0,0,1,0
1456,443,2014,52,29,23,0.56,55,912,15,14,0,11,7,0,18,9,0,2,0,0,7,0,0,0,0
1457,444,2014,40,12,28,0.29,29,912,6,4,2,4,2,1,7,2,2,0,0,0,2,0,1,0,0
1458,445,2014,6,4,2,0.63,63,912,2,2,0,1,1,0,2,0,1,0,0,0,1,0,0,0,0
1459,446,2014,40,5,35,0.12,12,912,4,1,0,1,1,0,2,0,0,0,1,1,0,0,0,0,0
1460,447,2014,28,10,18,0.37,36,912,5,5,0,2,3,0,5,1,0,0,1,1,2,0,0,0,0
1461,448,2014,31,9,22,0.3,29,912,4,4,1,4,2,1,7,4,0,0,0,0,2,1,0,0,0
1462,449,2014,22,13,9,0.61,60,912,6,7,0,5,7,0,12,4,1,0,0,7,0,0,0,0,0
1463,450,2014,11,11,0,0.98,97,912,3,5,3,2,5,2,9,1,1,0,0,5,0,1,1,0,0
1464,451,2014,20,11,9,0.56,55,912,4,6,1,1,4,1,6,0,0,0,1,2,2,1,0,0,0
1465,452,2014,39,2,37,0.05,5,912,1,1,0,1,1,0,2,1,0,0,0,1,0,0,0,0,0
1466,453,2014,37,32,5,0.85,85,912,15,14,3,12,14,1,27,11,0,0,1,14,0,0,0,1,0
1467,454,2014,55,55,0,1.0,99,912,38,17,0,26,10,0,36,20,2,2,2,3,7,0,0,0,0
1468,455,2014,20,9,11,0.45,44,912,4,3,2,3,3,1,7,2,1,0,0,3,0,0,1,0,0
1469,456,2014,31,28,3,0.89,88,912,16,11,1,12,11,1,24,10,1,0,1,11,0,1,0,0,0
1470,457,2014,19,17,2,0.9,90,912,13,3,1,9,3,1,13,7,1,0,1,3,0,1,0,0,0
1471,458,2014,37,33,4,0.9,90,912,24,6,3,21,5,1,27,19,1,1,0,4,1,0,0,1,0
1472,459,2014,40,37,3,0.93,92,912,15,21,1,14,12,1,27,13,1,0,0,3,9,1,0,0,0
1473,460,2014,44,30,14,0.67,67,912,18,10,2,10,9,1,20,2,8,0,0,8,1,0,1,0,0
1474,461,2014,5,3,2,0.66,65,912,1,2,0,1,2,0,3,1,0,0,0,2,0,0,0,0,0
1475,462,2014,25,20,5,0.8,80,912,9,8,3,9,6,2,17,9,0,0,0,4,2,1,1,0,0
1476,463,2014,13,7,6,0.5,50,912,3,3,1,2,2,1,5,1,1,0,0,1,1,1,0,0,0
1477,464,2014,26,13,13,0.48,48,912,4,5,4,4,3,3,10,4,0,0,0,1,2,2,1,0,0
1478,465,2014,24,6,18,0.24,23,912,1,4,1,1,4,1,6,1,0,0,0,4,0,1,0,0,0
1479,466,2014,11,0,11,0.0,0,912,0,0,0,0,0,0,0,0,0,0,0,0,0,0,0,0,0
1480,467,2014,11,5,6,0.46,45,912,2,2,1,2,1,1,4,2,0,0,0,0,1,1,0,0,0
1481,468,2014,7,1,6,0.08,8,912,0,1,0,0,1,0,1,0,0,0,0,1,0,0,0,0,0
1482,469,2014,34,32,2,0.95,95,912,16,14,2,9,13,2,24,6,1,0,2,12,1,2,0,0,0
1483,470,2014,33,13,20,0.38,38,912,8,4,1,2,2,1,5,0,0,0,2,0,2,1,0,0,0
1484,471,2014,36,9,27,0.25,25,912,4,4,1,2,2,1,5,0,2,0,0,0,2,1,0,0,0
1485,472,2014,31,27,4,0.85,85,912,18,8,1,15,4,1,20,13,1,1,0,0,4,1,0,0,0
1486,473,2014,48,18,30,0.37,37,912,8,7,3,4,5,1,10,2,0,2,0,3,2,0,0,1,0
1487,474,2014,21,20,1,0.94,94,912,13,5,2,12,4,2,18,11,1,0,0,3,1,2,0,0,0
1488,475,2014,19,2,17,0.11,11,912,1,1,0,1,1,0,2,1,0,0,0,1,0,0,0,0,0
1489,476,2014,20,3,17,0.15,14,912,2,1,0,2,1,0,3,2,0,0,0,1,0,0,0,0,0
1490,477,2014,21,0,21,0.01,1,912,0,0,0,0,0,0,0,0,0,0,0,0,0,0,0,0,0
1491,478,2014,30,16,14,0.52,52,912,6,8,2,2,8,1,11,0,1,0,1,8,0,0,1,0,0
1492,479,2014,7,7,0,0.98,97,912,3,4,0,3,2,0,5,3,0,0,0,0,2,0,0,0,0
1493,480,2014,45,40,5,0.88,88,912,20,19,1,7,17,1,25,2,1,0,4,15,2,1,0,0,0
1494,481,2014,51,39,12,0.77,77,912,17,20,2,16,14,2,32,15,1,0,0,8,6,2,0,0,0
1495,482,2014,10,2,8,0.24,23,912,1,1,0,1,1,0,2,1,0,0,0,1,0,0,0,0,0
1496,483,2014,30,27,3,0.89,88,912,19,6,2,18,6,2,26,17,1,0,0,6,0,2,0,0,0
1497,484,2014,9,4,5,0.49,48,912,1,2,1,1,2,1,4,1,0,0,0,2,0,1,0,0,0
1498,485,2014,24,5,19,0.19,19,912,1,3,1,1,2,1,4,1,0,0,0,1,1,1,0,0,0
1499,486,2014,22,1,21,0.03,2,912,0,1,0,0,1,0,1,0,0,0,0,1,0,0,0,0,0
1500,487,2014,31,28,3,0.91,91,912,11,14,3,5,7,1,13,2,0,3,0,0,7,0,0,1,0
1501,488,2014,8,8,0,0.96,96,912,5,2,1,3,2,1,6,1,2,0,0,2,0,1,0,0,0
1502,489,2014,25,11,14,0.42,42,912,5,5,1,2,5,1,8,0,1,1,0,5,0,1,0,0,0
1503,490,2014,33,14,19,0.42,42,912,10,3,1,8,3,1,12,6,2,0,0,3,0,1,0,0,0
1504,491,2014,5,0,5,0.06,5,912,0,0,0,0,0,0,0,0,0,0,0,0,0,0,0,0,0
1505,492,2014,7,5,2,0.77,77,912,2,3,0,1,3,0,4,0,1,0,0,3,0,0,0,0,0
1506,493,2014,10,8,2,0.77,76,912,5,3,0,5,2,0,7,5,0,0,0,1,1,0,0,0,0
1507,494,2014,9,4,5,0.43,42,912,1,2,1,1,2,1,4,1,0,0,0,2,0,1,0,0,0
1508,495,2014,13,6,7,0.45,44,912,3,3,0,1,2,0,3,0,0,1,0,1,1,0,0,0,0
1509,496,2014,50,49,1,0.97,97,912,34,14,1,31,14,1,46,29,1,1,0,14,0,1,0,0,0
1510,497,2014,31,25,6,0.8,80,912,11,12,2,5,7,2,14,1,3,0,1,2,5,2,0,0,0
1511,498,2014,27,25,2,0.94,94,912,18,5,2,17,3,2,22,16,1,0,0,1,2,2,0,0,0
1512,499,2014,49,47,2,0.95,95,912,22,25,0,18,20,0,38,15,2,1,0,15,5,0,0,0,0
1513,500,2014,40,8,32,0.21,21,912,3,4,1,2,2,1,5,1,1,0,0,0,2,1,0,0,0
1514,501,2014,8,4,4,0.5,49,912,2,2,0,2,1,0,3,2,0,0,0,0,1,0,0,0,0
1515,502,2014,7,2,5,0.29,28,912,1,1,0,1,1,0,2,1,0,0,0,1,0,0,0,0,0
1516,503,2014,13,6,7,0.49,49,912,3,2,1,1,1,1,3,0,0,1,0,0,1,1,0,0,0
1517,504,2014,35,35,0,0.99,99,912,26,9,0,23,8,0,31,22,0,0,1,7,1,0,0,0,0
1518,505,2014,46,39,7,0.85,85,912,18,20,1,11,14,1,26,5,5,1,0,8,6,1,0,0,0
1519,506,2014,45,11,34,0.24,24,912,6,5,0,2,4,0,6,0,0,2,0,3,1,0,0,0,0
1520,507,2014,55,25,30,0.46,45,912,12,12,1,11,10,1,22,10,1,0,0,8,2,1,0,0,0
1521,508,2014,11,8,3,0.76,75,912,2,4,2,1,2,1,4,0,1,0,0,0,2,0,1,0,0
1522,509,2014,14,9,5,0.62,61,912,4,4,1,3,4,1,8,2,1,0,0,4,0,1,0,0,0
1523,510,2014,16,10,6,0.6,60,912,5,4,1,4,3,1,8,3,1,0,0,2,1,1,0,0,0
1524,511,2014,11,2,9,0.2,19,912,1,1,0,1,1,0,2,1,0,0,0,1,0,0,0,0,0
1525,512,2014,32,15,17,0.46,45,912,8,6,1,5,3,1,9,3,1,1,0,0,3,1,0,0,0
1526,513,2014,8,1,7,0.07,7,912,0,1,0,0,1,0,1,0,0,0,0,1,0,0,0,0,0
1527,514,2014,42,28,14,0.67,67,912,18,9,1,8,5,1,14,2,4,0,2,1,4,1,0,0,0
1528,515,2014,26,25,1,0.97,97,912,7,14,4,3,13,4,20,1,0,2,0,12,1,4,0,0,0
1529,516,2014,29,11,18,0.36,36,912,5,4,2,2,2,2,6,0,1,1,0,0,2,2,0,0,0
1530,517,2014,17,9,8,0.53,52,912,5,4,0,5,3,0,8,5,0,0,0,2,1,0,0,0,0
1531,518,2014,39,35,4,0.91,90,912,14,17,4,5,9,1,15,1,0,3,1,1,8,0,0,0,1
1532,519,2014,27,11,16,0.4,39,912,5,6,0,3,4,0,7,2,0,1,0,2,2,0,0,0,0
1533,520,2014,51,24,27,0.47,46,912,12,12,0,7,7,0,14,3,3,1,0,2,5,0,0,0,0
1534,521,2014,36,31,5,0.87,86,912,20,11,0,11,9,0,20,6,2,2,1,7,2,0,0,0,0
1535,522,2014,19,6,13,0.33,32,912,2,3,1,1,2,1,4,0,1,0,0,1,1,1,0,0,0
1536,523,2014,22,22,0,0.99,98,912,12,9,1,6,9,1,16,2,2,2,0,9,0,1,0,0,0
1537,524,2014,32,23,9,0.73,72,912,15,7,1,4,5,1,10,0,0,1,3,3,2,1,0,0,0
1538,525,2014,54,37,17,0.68,67,912,24,11,2,19,9,1,29,16,2,0,1,7,2,0,1,0,0
1539,526,2014,25,25,0,1.0,99,912,15,7,3,7,5,3,15,0,6,1,0,3,2,3,0,0,0
1540,527,2014,56,39,17,0.7,69,912,17,21,1,5,14,1,20,1,0,0,4,7,7,1,0,0,0
1541,528,2014,17,5,12,0.27,26,912,1,3,1,1,3,1,5,1,0,0,0,3,0,1,0,0,0
1542,529,2014,6,1,5,0.1,9,912,0,1,0,0,1,0,1,0,0,0,0,1,0,0,0,0,0
1543,530,2014,38,9,29,0.24,23,912,6,2,1,4,2,1,7,3,0,1,0,2,0,1,0,0,0
1544,531,2014,15,2,13,0.12,11,912,1,1,0,1,1,0,2,1,0,0,0,1,0,0,0,0,0
1545,532,2014,18,10,8,0.53,52,912,5,5,0,2,3,0,5,0,1,1,0,1,2,0,0,0,0
1546,533,2014,42,15,27,0.35,34,912,7,5,3,5,4,3,12,3,2,0,0,3,1,3,0,0,0
1547,534,2014,42,24,18,0.57,57,912,8,13,3,7,12,2,21,6,1,0,0,11,1,1,1,0,0
1548,535,2014,9,0,9,0.01,1,912,0,0,0,0,0,0,0,0,0,0,0,0,0,0,0,0,0
1549,536,2014,31,10,21,0.31,31,912,5,3,2,3,3,2,8,2,0,1,0,3,0,2,0,0,0
1550,537,2014,32,6,26,0.18,18,912,3,3,0,3,2,0,5,3,0,0,0,1,1,0,0,0,0
1551,538,2014,12,8,4,0.7,69,912,3,3,2,1,2,1,4,0,0,1,0,1,1,0,1,0,0
1552,539,2014,8,7,1,0.86,86,912,4,2,1,2,2,1,5,0,2,0,0,2,0,1,0,0,0
1553,540,2014,24,3,21,0.15,14,912,2,1,0,2,1,0,3,2,0,0,0,1,0,0,0,0,0
1554,541,2014,39,8,31,0.22,21,912,3,4,1,3,4,1,8,3,0,0,0,4,0,1,0,0,0
1555,542,2014,51,44,7,0.87,86,912,16,25,3,12,23,1,36,8,4,0,0,21,2,0,0,1,0
1556,543,2014,22,6,16,0.27,27,912,3,2,1,2,1,1,4,1,1,0,0,0,1,1,0,0,0
1557,544,2014,13,1,12,0.05,5,912,0,1,0,0,1,0,1,0,0,0,0,1,0,0,0,0,0
1558,545,2014,32,30,2,0.94,94,912,21,7,2,11,7,2,20,3,7,0,1,7,0,2,0,0,0
1559,546,2014,54,20,34,0.37,37,912,10,8,2,7,6,1,14,4,3,0,0,4,2,0,1,0,0
1560,547,2014,52,47,5,0.9,90,912,33,12,2,31,12,1,44,30,0,1,0,12,0,0,1,0,0
1561,548,2014,40,40,0,0.99,99,912,20,17,3,10,17,3,30,5,1,3,1,17,0,3,0,0,0
1562,549,2014,23,22,1,0.96,96,912,14,5,3,14,3,3,20,14,0,0,0,1,2,3,0,0,0
1563,550,2014,22,22,0,0.99,98,912,8,12,2,8,8,2,18,8,0,0,0,4,4,2,0,0,0
1564,551,2014,11,8,3,0.73,73,912,2,4,2,1,2,1,4,0,1,0,0,0,2,0,1,0,0
1565,552,2014,39,4,35,0.09,9,912,2,2,0,1,2,0,3,0,1,0,0,2,0,0,0,0,0
1566,553,2014,46,5,41,0.11,10,912,2,2,1,1,1,1,3,0,1,0,0,0,1,1,0,0,0
1567,554,2014,40,19,21,0.47,47,912,10,5,4,10,5,3,18,10,0,0,0,5,0,2,1,0,0
1568,555,2014,16,15,1,0.94,93,912,10,5,0,4,3,0,7,0,3,0,1,1,2,0,0,0,0
1569,556,2014,10,10,0,0.99,98,912,6,4,0,3,3,0,6,0,3,0,0,2,1,0,0,0,0
1570,557,2014,56,52,4,0.92,92,912,23,26,3,12,16,3,31,6,1,5,0,6,10,3,0,0,0
1571,558,2014,38,31,7,0.81,80,912,19,9,3,5,8,1,14,0,0,1,4,7,1,0,0,1,0
1572,559,2014,45,30,15,0.68,67,912,9,17,4,4,16,2,22,1,1,2,0,15,1,1,0,1,0
1573,560,2014,37,34,3,0.92,92,912,22,11,1,12,11,1,24,8,0,2,2,11,0,1,0,0,0
1574,561,2014,16,16,0,1.0,100,912,9,5,2,9,4,2,15,9,0,0,0,3,1,2,0,0,0
1575,562,2014,27,13,14,0.5,49,912,5,7,1,5,5,1,11,5,0,0,0,3,2,1,0,0,0
1576,563,2014,36,12,24,0.34,34,912,7,4,1,3,2,1,6,0,2,1,0,0,2,1,0,0,0
1577,564,2014,60,33,27,0.55,55,912,25,7,1,25,5,1,31,25,0,0,0,3,2,1,0,0,0
1578,565,2014,9,1,8,0.14,14,912,0,1,0,0,1,0,1,0,0,0,0,1,0,0,0,0,0
1579,566,2014,16,5,11,0.32,32,912,3,2,0,1,2,0,3,0,0,1,0,2,0,0,0,0,0
1580,567,2014,32,2,30,0.05,5,912,1,1,0,1,1,0,2,1,0,0,0,1,0,0,0,0,0
1581,568,2014,12,9,3,0.72,71,912,5,4,0,2,2,0,4,1,0,0,1,0,2,0,0,0,0
1582,569,2014,41,41,0,0.99,98,912,19,19,3,10,17,3,30,5,2,2,1,15,2,3,0,0,0
1583,570,2014,47,47,0,0.99,99,912,21,26,0,6,26,0,32,0,1,1,4,26,0,0,0,0,0
1584,571,2014,6,0,6,0.02,2,912,0,0,0,0,0,0,0,0,0,0,0,0,0,0,0,0,0
1585,572,2014,11,7,4,0.62,61,912,3,4,0,2,3,0,5,1,1,0,0,2,1,0,0,0,0
1586,573,2014,35,29,6,0.83,83,912,12,14,3,9,10,2,21,7,1,1,0,6,4,1,1,0,0
1587,574,2014,27,22,5,0.82,82,912,10,11,1,6,7,1,14,4,0,2,0,3,4,1,0,0,0
1588,575,2014,26,25,1,0.96,96,912,11,11,3,10,10,3,23,9,1,0,0,9,1,3,0,0,0
1589,576,2014,42,41,1,0.98,97,912,25,12,4,15,8,4,27,5,10,0,0,4,4,4,0,0,0
1590,577,2014,12,1,11,0.11,10,912,0,1,0,0,1,0,1,0,0,0,0,1,0,0,0,0,0
1591,578,2014,13,0,13,0.03,2,912,0,0,0,0,0,0,0,0,0,0,0,0,0,0,0,0,0
1592,579,2014,34,17,17,0.49,49,912,6,10,1,5,5,1,11,4,1,0,0,0,5,1,0,0,0
1593,580,2014,19,14,5,0.74,74,912,5,8,1,5,7,1,13,5,0,0,0,6,1,1,0,0,0
1594,581,2014,9,8,1,0.93,93,912,4,3,1,2,2,1,5,0,2,0,0,1,1,1,0,0,0
1595,582,2014,33,22,11,0.67,66,912,12,10,0,7,9,0,16,3,3,1,0,8,1,0,0,0,0
1596,583,2014,10,5,5,0.53,52,912,2,3,0,1,2,0,3,0,1,0,0,1,1,0,0,0,0
1597,584,2014,38,22,16,0.59,58,912,9,11,2,8,10,2,20,7,1,0,0,9,1,2,0,0,0
1598,585,2014,14,3,11,0.23,22,912,1,2,0,1,2,0,3,1,0,0,0,2,0,0,0,0,0
1599,586,2014,34,10,24,0.29,29,912,7,3,0,5,2,0,7,4,0,1,0,1,1,0,0,0,0
1600,587,2014,17,17,0,0.99,98,912,8,5,4,7,4,3,14,6,1,0,0,3,1,2,1,0,0
1601,588,2014,27,24,3,0.89,89,912,16,5,3,11,5,3,19,9,0,1,1,5,0,3,0,0,0
1602,589,2014,43,43,0,1.0,99,912,22,18,3,11,9,2,22,1,9,1,0,0,9,1,1,0,0
1603,590,2014,24,16,8,0.66,66,912,11,4,1,8,2,1,11,6,1,1,0,0,2,1,0,0,0
1604,591,2014,15,14,1,0.97,96,912,9,4,1,9,2,1,12,9,0,0,0,0,2,1,0,0,0
1605,592,2014,5,4,1,0.77,77,912,2,2,0,2,2,0,4,2,0,0,0,2,0,0,0,0,0
1606,593,2014,8,7,1,0.92,91,912,2,4,1,2,2,1,5,2,0,0,0,0,2,1,0,0,0
1607,594,2014,55,30,25,0.54,53,912,10,17,3,9,13,1,23,8,1,0,0,9,4,0,0,1,0
1608,595,2014,20,4,16,0.2,19,912,2,2,0,1,2,0,3,0,1,0,0,2,0,0,0,0,0
1609,596,2014,12,11,1,0.9,90,912,5,4,2,3,3,2,8,1,2,0,0,2,1,2,0,0,0
1610,597,2014,29,2,27,0.05,5,912,1,1,0,1,1,0,2,1,0,0,0,1,0,0,0,0,0
1611,598,2014,12,6,6,0.51,50,912,3,3,0,1,3,0,4,0,0,1,0,3,0,0,0,0,0
1612,599,2014,17,7,10,0.39,39,912,3,4,0,3,2,0,5,3,0,0,0,0,2,0,0,0,0
1613,600,2014,16,9,7,0.59,58,912,5,3,1,4,3,1,8,3,1,0,0,3,0,1,0,0,0
1614,601,2014,28,17,11,0.6,60,912,11,6,0,7,3,0,10,3,4,0,0,0,3,0,0,0,0
1615,602,2014,8,6,2,0.73,73,912,2,3,1,2,2,1,5,2,0,0,0,1,1,1,0,0,0
1616,603,2014,59,57,2,0.97,96,912,23,32,2,20,29,1,50,18,1,1,0,26,3,0,1,0,0
1617,604,2014,44,29,15,0.67,66,912,16,11,2,15,9,1,25,14,1,0,0,7,2,0,1,0,0
1618,605,2014,48,7,41,0.16,15,912,3,3,1,2,3,1,6,1,1,0,0,3,0,1,0,0,0
1619,606,2014,35,28,7,0.8,80,912,20,7,1,8,5,1,14,0,4,4,0,3,2,1,0,0,0
1620,607,2014,40,18,22,0.44,44,912,13,3,2,12,2,1,15,11,1,0,0,1,1,0,1,0,0
1621,608,2014,6,3,3,0.42,41,912,1,2,0,1,1,0,2,1,0,0,0,0,1,0,0,0,0
1622,609,2014,15,10,5,0.66,66,912,5,3,2,2,3,1,6,1,0,0,1,3,0,0,1,0,0
1623,610,2014,9,1,8,0.07,6,912,0,1,0,0,1,0,1,0,0,0,0,1,0,0,0,0,0
1624,611,2014,48,7,41,0.15,14,912,3,3,1,1,2,1,4,0,0,1,0,1,1,1,0,0,0
1625,612,2014,12,10,2,0.83,83,912,5,4,1,3,4,1,8,1,2,0,0,4,0,1,0,0,0
1626,613,2014,12,8,4,0.68,68,912,3,3,2,2,3,2,7,1,1,0,0,3,0,2,0,0,0
1627,614,2014,6,6,0,1.0,99,912,3,2,1,1,2,1,4,0,0,1,0,2,0,1,0,0,0
1628,615,2014,27,26,1,0.95,94,912,16,6,4,8,6,4,18,4,2,0,2,6,0,4,0,0,0
1629,616,2014,30,4,26,0.14,14,912,2,2,0,2,2,0,4,2,0,0,0,2,0,0,0,0,0
1630,617,2014,14,13,1,0.89,89,912,6,6,1,4,5,1,10,3,0,1,0,4,1,1,0,0,0
1631,618,2014,6,5,1,0.76,76,912,2,2,1,1,1,1,3,0,1,0,0,0,1,1,0,0,0
1632,619,2014,17,1,16,0.05,5,912,0,1,0,0,1,0,1,0,0,0,0,1,0,0,0,0,0
1633,620,2014,18,17,1,0.93,92,912,7,8,2,6,4,2,12,5,1,0,0,0,4,2,0,0,0
1634,621,2014,9,9,0,0.97,96,912,4,5,0,1,5,0,6,0,0,0,1,5,0,0,0,0,0
1635,622,2014,32,1,31,0.03,2,912,0,1,0,0,1,0,1,0,0,0,0,1,0,0,0,0,0
1636,623,2014,52,17,35,0.32,32,912,7,10,0,5,7,0,12,4,0,1,0,4,3,0,0,0,0
1637,624,2014,20,17,3,0.84,84,912,12,3,2,10,3,1,14,9,0,1,0,3,0,0,1,0,0
1638,625,2014,33,30,3,0.92,91,912,18,11,1,18,8,1,27,18,0,0,0,5,3,1,0,0,0
1639,626,2014,13,12,1,0.91,91,912,7,3,2,6,3,1,10,5,1,0,0,3,0,0,1,0,0
1640,627,2014,17,15,2,0.9,90,912,5,7,3,4,4,2,10,3,1,0,0,1,3,1,1,0,0
1641,628,2014,13,13,0,1.0,100,912,4,5,4,1,3,1,5,0,0,0,1,1,2,0,0,0,1
1642,629,2014,33,28,5,0.86,86,912,14,14,0,8,12,0,20,5,1,1,1,10,2,0,0,0,0
1643,630,2014,15,4,11,0.29,29,912,2,2,0,2,1,0,3,2,0,0,0,0,1,0,0,0,0
1644,631,2014,58,28,30,0.48,47,912,13,14,1,10,10,1,21,7,3,0,0,6,4,1,0,0,0
1645,632,2014,9,6,3,0.67,67,912,2,3,1,1,3,1,5,0,1,0,0,3,0,1,0,0,0
1646,633,2014,9,5,4,0.53,52,912,1,3,1,1,3,1,5,1,0,0,0,3,0,1,0,0,0
1647,634,2014,6,4,2,0.61,60,912,2,2,0,2,1,0,3,2,0,0,0,0,1,0,0,0,0
1648,635,2014,24,18,6,0.73,73,912,12,5,1,8,5,1,14,6,0,2,0,5,0,1,0,0,0
1649,636,2014,15,2,13,0.15,14,912,1,1,0,1,1,0,2,1,0,0,0,1,0,0,0,0,0
1650,637,2014,23,22,1,0.98,97,912,11,7,4,6,6,1,13,4,0,1,1,5,1,0,0,0,1
1651,638,2014,29,24,5,0.84,84,912,11,9,4,5,8,2,15,1,2,2,0,7,1,0,2,0,0
1652,639,2014,7,2,5,0.31,30,912,1,1,0,1,1,0,2,1,0,0,0,1,0,0,0,0,0
1653,640,2014,13,7,6,0.53,53,912,5,2,0,5,1,0,6,5,0,0,0,0,1,0,0,0,0
1654,641,2014,6,3,3,0.49,49,912,2,1,0,2,1,0,3,2,0,0,0,1,0,0,0,0,0
1655,642,2014,28,28,0,0.99,99,912,12,16,0,8,14,0,22,6,0,2,0,12,2,0,0,0,0
1656,643,2014,56,21,35,0.38,37,912,13,6,2,7,5,1,13,1,6,0,0,4,1,0,1,0,0
1657,644,2014,11,11,0,0.96,96,912,6,4,1,5,3,1,9,4,1,0,0,2,1,1,0,0,0
1658,645,2014,23,11,12,0.48,48,912,8,2,1,5,2,1,8,4,0,0,1,2,0,1,0,0,0
1659,646,2014,58,3,55,0.05,5,912,2,1,0,2,1,0,3,2,0,0,0,1,0,0,0,0,0
1660,647,2014,32,8,24,0.24,24,912,5,2,1,4,2,1,7,3,1,0,0,2,0,1,0,0,0
1661,648,2014,34,18,16,0.54,54,912,9,8,1,5,8,1,14,1,4,0,0,8,0,1,0,0,0
1662,649,2014,27,26,1,0.95,94,912,18,6,2,14,5,2,21,12,0,2,0,4,1,2,0,0,0
1663,650,2014,37,37,0,1.0,99,912,24,9,4,16,6,4,26,10,5,0,1,3,3,4,0,0,0
1664,651,2014,26,6,20,0.22,22,912,2,3,1,1,3,1,5,0,1,0,0,3,0,1,0,0,0
1665,652,2014,40,27,13,0.66,66,912,8,16,3,3,8,3,14,1,0,1,1,0,8,3,0,0,0
1666,653,2014,14,13,1,0.94,94,912,7,4,2,6,4,1,11,5,1,0,0,4,0,0,1,0,0
1667,654,2014,40,10,30,0.24,24,912,4,5,1,1,5,1,7,0,0,0,1,5,0,1,0,0,0
1668,655,2014,50,49,1,0.98,97,912,29,17,3,27,17,2,46,26,0,1,0,17,0,1,1,0,0
1669,656,2014,47,45,2,0.96,95,912,17,25,3,15,17,2,34,14,0,1,0,9,8,1,1,0,0
1670,657,2014,32,29,3,0.9,89,912,18,9,2,10,7,1,18,7,0,1,2,5,2,0,1,0,0
1671,658,2014,12,3,9,0.21,21,912,1,2,0,1,2,0,3,1,0,0,0,2,0,0,0,0,0
1672,659,2014,38,34,4,0.9,90,912,23,10,1,22,5,1,28,21,1,0,0,0,5,1,0,0,0
1673,660,2014,21,8,13,0.4,39,912,2,5,1,2,5,1,8,2,0,0,0,5,0,1,0,0,0
1674,661,2014,37,26,11,0.71,71,912,16,7,3,11,7,2,20,9,0,1,1,7,0,1,1,0,0
1675,662,2014,29,28,1,0.95,94,912,9,15,4,3,9,3,15,0,0,3,0,3,6,2,1,0,0
1676,663,2014,39,8,31,0.21,21,912,3,4,1,3,2,1,6,3,0,0,0,0,2,1,0,0,0
1677,664,2014,45,1,44,0.03,3,912,0,1,0,0,1,0,1,0,0,0,0,1,0,0,0,0,0
1678,665,2014,28,21,7,0.75,75,912,14,4,3,14,4,3,21,14,0,0,0,4,0,3,0,0,0
1679,666,2014,24,5,19,0.21,21,912,2,2,1,2,1,1,4,2,0,0,0,0,1,1,0,0,0
1680,667,2014,30,7,23,0.23,23,912,4,2,1,4,2,1,7,4,0,0,0,2,0,1,0,0,0
1681,668,2014,38,25,13,0.65,64,912,17,6,2,10,5,1,16,7,0,2,1,4,1,0,1,0,0
1682,669,2014,42,11,31,0.26,25,912,7,3,1,5,3,1,9,3,2,0,0,3,0,1,0,0,0
1683,670,2014,14,10,4,0.71,70,912,4,5,1,1,5,1,7,0,0,0,1,5,0,1,0,0,0
1684,671,2014,47,42,5,0.9,90,912,16,23,3,16,17,3,36,16,0,0,0,11,6,3,0,0,0
1685,672,2014,41,16,25,0.38,38,912,10,4,2,3,2,2,7,0,1,0,2,0,2,2,0,0,0
1686,673,2014,14,5,9,0.38,38,912,2,2,1,2,1,1,4,2,0,0,0,0,1,1,0,0,0
1687,674,2014,24,19,5,0.79,78,912,7,11,1,7,7,1,15,7,0,0,0,3,4,1,0,0,0
1688,675,2014,9,9,0,0.99,98,912,6,3,0,2,3,0,5,0,1,0,1,3,0,0,0,0,0
1689,676,2014,19,18,1,0.96,96,912,11,4,3,7,4,3,14,4,2,1,0,4,0,3,0,0,0
1690,677,2014,11,7,4,0.59,59,912,3,3,1,3,3,1,7,3,0,0,0,3,0,1,0,0,0
1691,678,2014,26,25,1,0.96,96,912,17,6,2,7,5,2,14,1,4,0,2,4,1,2,0,0,0
1692,679,2014,22,21,1,0.96,95,912,13,7,1,10,4,1,15,7,3,0,0,1,3,1,0,0,0
1693,680,2014,25,1,24,0.02,2,912,0,1,0,0,1,0,1,0,0,0,0,1,0,0,0,0,0
1694,681,2014,40,40,0,1.0,100,912,23,14,3,22,10,2,34,21,1,0,0,6,4,1,1,0,0
1695,682,2014,38,37,1,0.97,96,912,26,9,2,9,7,2,18,1,1,5,2,5,2,2,0,0,0
1696,683,2014,5,3,2,0.67,66,912,2,1,0,1,1,0,2,0,1,0,0,1,0,0,0,0,0
1697,684,2014,27,17,10,0.64,64,912,9,8,0,8,4,0,12,7,1,0,0,0,4,0,0,0,0
1698,685,2014,14,8,6,0.59,58,912,3,4,1,3,3,1,7,3,0,0,0,2,1,1,0,0,0
1699,686,2014,26,9,17,0.35,34,912,6,2,1,6,1,1,8,6,0,0,0,0,1,1,0,0,0
1700,687,2014,20,14,6,0.68,67,912,3,8,3,1,7,3,11,0,0,1,0,6,1,3,0,0,0
1701,688,2014,13,1,12,0.1,9,912,0,1,0,0,1,0,1,0,0,0,0,1,0,0,0,0,0
1702,689,2014,46,38,8,0.83,82,912,25,10,3,9,7,2,18,2,0,5,2,4,3,1,1,0,0
1703,690,2014,46,41,5,0.89,88,912,29,11,1,26,6,1,33,24,1,1,0,1,5,1,0,0,0
1704,691,2014,31,2,29,0.08,7,912,1,1,0,1,1,0,2,1,0,0,0,1,0,0,0,0,0
1705,692,2014,28,17,11,0.6,59,912,9,5,3,6,5,3,14,3,3,0,0,5,0,3,0,0,0
1706,693,2014,15,15,0,1.0,100,912,5,8,2,2,8,1,11,1,0,0,1,8,0,0,1,0,0
1707,694,2014,55,52,3,0.94,94,912,27,23,2,22,15,2,39,20,0,1,1,7,8,2,0,0,0
1708,695,2014,36,11,25,0.31,30,912,6,4,1,6,4,1,11,6,0,0,0,4,0,1,0,0,0
1709,696,2014,27,2,25,0.09,8,912,1,1,0,1,1,0,2,1,0,0,0,1,0,0,0,0,0
1710,697,2014,31,19,12,0.6,59,912,12,5,2,11,4,2,17,10,1,0,0,3,1,2,0,0,0
1711,698,2014,44,40,4,0.91,90,912,23,14,3,14,7,2,23,10,0,3,1,0,7,1,1,0,0
1712,699,2014,34,32,2,0.94,93,912,14,15,3,9,9,1,19,4,5,0,0,3,6,0,0,1,0
1713,700,2014,40,22,18,0.55,54,912,12,10,0,5,10,0,15,0,4,0,1,10,0,0,0,0,0
1714,701,2014,31,29,2,0.94,93,912,11,16,2,11,9,1,21,11,0,0,0,2,7,0,1,0,0
1715,702,2014,44,31,13,0.7,70,912,16,13,2,5,10,1,16,0,1,2,2,7,3,0,1,0,0
1716,703,2014,34,34,0,0.99,99,912,22,9,3,18,5,2,25,16,1,0,1,1,4,1,1,0,0
1717,704,2014,32,4,28,0.12,11,912,2,2,0,2,1,0,3,2,0,0,0,0,1,0,0,0,0
1718,705,2014,6,2,4,0.41,40,912,1,1,0,1,1,0,2,1,0,0,0,1,0,0,0,0,0
1719,706,2014,17,1,16,0.08,7,912,0,1,0,0,1,0,1,0,0,0,0,1,0,0,0,0,0
1720,707,2014,29,27,2,0.93,92,912,18,6,3,9,4,2,15,3,3,3,0,2,2,1,1,0,0
1721,708,2014,39,26,13,0.66,66,912,16,7,3,15,5,2,22,14,1,0,0,3,2,1,1,0,0
1722,709,2014,42,27,15,0.64,64,912,11,13,3,6,8,1,15,3,2,0,1,3,5,0,0,1,0
1723,710,2014,20,6,14,0.29,28,912,4,2,0,2,2,0,4,0,2,0,0,2,0,0,0,0,0
1724,711,2014,5,3,2,0.62,62,912,2,1,0,2,1,0,3,2,0,0,0,1,0,0,0,0,0
1725,712,2014,48,34,14,0.71,71,912,14,16,4,14,10,1,25,14,0,0,0,4,6,0,0,0,1
1726,713,2014,24,13,11,0.53,52,912,5,7,1,2,4,1,7,1,0,0,1,1,3,1,0,0,0
1727,714,2014,30,24,6,0.79,78,912,8,14,2,2,14,1,17,0,0,0,2,14,0,0,1,0,0
1728,715,2014,47,11,36,0.24,23,912,3,6,2,3,5,1,9,3,0,0,0,4,1,0,1,0,0
1729,716,2014,34,26,8,0.76,75,912,16,8,2,5,4,2,11,0,1,2,2,0,4,2,0,0,0
1730,717,2014,32,27,5,0.83,83,912,15,12,0,7,11,0,18,4,0,1,2,10,1,0,0,0,0
1731,718,2014,35,27,8,0.78,77,912,18,5,4,17,3,4,24,16,1,0,0,1,2,4,0,0,0
1732,719,2014,39,30,9,0.76,75,912,14,15,1,6,12,1,19,2,1,2,1,9,3,1,0,0,0
1733,720,2014,7,1,6,0.15,14,912,0,1,0,0,1,0,1,0,0,0,0,1,0,0,0,0,0
1734,721,2014,38,31,7,0.81,80,912,22,7,2,21,5,1,27,20,1,0,0,3,2,0,1,0,0
1735,722,2014,24,16,8,0.66,66,912,9,5,2,7,4,2,13,6,0,1,0,3,1,2,0,0,0
1736,723,2014,8,3,5,0.42,42,912,1,2,0,1,2,0,3,1,0,0,0,2,0,0,0,0,0
1737,724,2014,24,9,15,0.38,38,912,5,3,1,4,3,1,8,3,1,0,0,3,0,1,0,0,0
1738,725,2014,26,6,20,0.22,22,912,3,2,1,2,2,1,5,1,1,0,0,2,0,1,0,0,0
1739,726,2014,28,27,1,0.98,97,912,13,13,1,9,9,1,19,6,2,1,0,5,4,1,0,0,0
1740,727,2014,24,19,5,0.78,78,912,10,8,1,9,8,1,18,8,1,0,0,8,0,1,0,0,0
1741,728,2014,28,16,12,0.58,57,912,8,7,1,6,5,1,12,4,2,0,0,3,2,1,0,0,0
1742,729,2014,24,16,8,0.67,67,912,7,8,1,7,5,1,13,7,0,0,0,2,3,1,0,0,0
1743,730,2014,30,2,28,0.05,5,912,1,1,0,1,1,0,2,1,0,0,0,1,0,0,0,0,0
1744,731,2014,51,38,13,0.74,74,912,12,23,3,10,13,1,24,9,0,1,0,3,10,0,0,1,0
1745,732,2014,9,7,2,0.82,82,912,2,3,2,1,2,2,5,0,1,0,0,1,1,2,0,0,0
1746,733,2014,10,9,1,0.92,92,912,5,3,1,3,2,1,6,2,0,1,0,1,1,1,0,0,0
1747,734,2014,34,20,14,0.59,59,912,10,8,2,3,5,2,10,0,1,0,2,2,3,2,0,0,0
1748,735,2014,18,12,6,0.65,64,912,4,5,3,2,3,1,6,0,2,0,0,1,2,0,0,1,0
1749,736,2014,31,15,16,0.47,47,912,8,6,1,7,5,1,13,6,1,0,0,4,1,1,0,0,0
1750,737,2014,49,35,14,0.72,72,912,26,7,2,16,5,2,23,7,8,1,0,3,2,2,0,0,0
1751,738,2014,31,23,8,0.74,74,912,13,9,1,8,6,1,15,5,1,2,0,3,3,1,0,0,0
1752,739,2014,36,31,5,0.86,86,912,23,6,2,22,5,2,29,21,1,0,0,4,1,2,0,0,0
1753,740,2014,46,46,0,1.0,99,912,33,13,0,28,10,0,38,23,5,0,0,7,3,0,0,0,0
1754,741,2014,15,5,10,0.32,32,912,1,3,1,1,3,1,5,1,0,0,0,3,0,1,0,0,0
1755,742,2014,46,33,13,0.73,72,912,15,16,2,12,14,1,27,11,0,0,1,12,2,0,1,0,0
1756,743,2014,47,5,42,0.1,9,912,1,3,1,1,2,1,4,1,0,0,0,1,1,1,0,0,0
1757,744,2014,16,7,9,0.42,42,912,2,3,2,1,3,2,6,0,1,0,0,3,0,2,0,0,0
1758,745,2014,36,11,25,0.29,29,912,8,2,1,6,1,1,8,5,0,1,0,0,1,1,0,0,0
1759,746,2014,31,21,10,0.69,69,912,8,12,1,5,12,1,18,3,1,1,0,12,0,1,0,0,0
1760,747,2014,8,8,0,0.98,97,912,5,2,1,2,1,1,4,0,1,1,0,0,1,1,0,0,0
1761,748,2014,32,27,5,0.85,84,912,19,7,1,14,6,1,21,12,0,1,1,5,1,1,0,0,0
1762,749,2014,7,7,0,0.98,97,912,2,4,1,2,4,1,7,2,0,0,0,4,0,1,0,0,0
1763,750,2014,36,33,3,0.92,91,912,19,11,3,18,10,2,30,17,1,0,0,9,1,1,1,0,0
1764,751,2014,31,2,29,0.07,6,912,1,1,0,1,1,0,2,1,0,0,0,1,0,0,0,0,0
1765,752,2014,20,6,14,0.31,31,912,4,2,0,3,1,0,4,2,1,0,0,0,1,0,0,0,0
1766,753,2014,21,8,13,0.38,37,912,2,4,2,2,2,1,5,2,0,0,0,0,2,0,1,0,0
1767,754,2014,6,1,5,0.14,13,912,0,1,0,0,1,0,1,0,0,0,0,1,0,0,0,0,0
1768,755,2014,30,5,25,0.17,16,912,2,3,0,1,2,0,3,0,1,0,0,1,1,0,0,0,0
1769,756,2014,25,16,9,0.64,63,912,7,7,2,6,7,1,14,5,1,0,0,7,0,0,1,0,0
1770,757,2014,38,37,1,0.98,98,912,20,15,2,11,14,1,26,4,5,2,0,13,1,0,1,0,0
1771,758,2014,43,16,27,0.38,37,912,11,5,0,8,4,0,12,7,0,0,1,3,1,0,0,0,0
1772,759,2014,27,15,12,0.54,54,912,8,7,0,8,6,0,14,8,0,0,0,5,1,0,0,0,0
1773,760,2014,16,3,13,0.18,18,912,2,1,0,1,1,0,2,0,1,0,0,1,0,0,0,0,0
1774,761,2014,15,11,4,0.74,73,912,8,2,1,2,2,1,5,0,0,0,2,2,0,1,0,0,0
1775,762,2014,43,12,31,0.29,28,912,5,6,1,5,5,1,11,5,0,0,0,4,1,1,0,0,0
1776,763,2014,52,45,7,0.86,85,912,20,22,3,8,21,3,32,1,2,5,0,20,1,3,0,0,0
1777,764,2014,28,3,25,0.09,9,912,2,1,0,2,1,0,3,2,0,0,0,1,0,0,0,0,0
1778,765,2014,36,11,25,0.3,29,912,4,4,3,2,4,3,9,1,0,1,0,4,0,3,0,0,0
1779,766,2014,15,9,6,0.63,63,912,4,3,2,1,3,1,5,0,0,0,1,3,0,0,1,0,0
1780,767,2014,34,10,24,0.28,28,912,7,2,1,2,2,1,5,0,0,1,1,2,0,1,0,0,0
1781,768,2014,7,4,3,0.62,61,912,2,2,0,2,2,0,4,2,0,0,0,2,0,0,0,0,0
1782,769,2014,20,19,1,0.95,95,912,7,9,3,4,5,1,10,2,1,1,0,1,4,0,0,1,0
1783,770,2014,40,1,39,0.03,2,912,0,1,0,0,1,0,1,0,0,0,0,1,0,0,0,0,0
1784,771,2014,40,13,27,0.33,32,912,5,5,3,3,3,1,7,1,2,0,0,1,2,0,0,1,0
1785,772,2014,18,0,18,0.03,2,912,0,0,0,0,0,0,0,0,0,0,0,0,0,0,0,0,0
1786,773,2014,39,7,32,0.19,18,912,2,3,2,1,2,1,4,0,1,0,0,1,1,0,1,0,0
1787,774,2014,10,6,4,0.64,64,912,1,4,1,1,2,1,4,1,0,0,0,0,2,1,0,0,0
1788,775,2014,6,0,6,0.04,4,912,0,0,0,0,0,0,0,0,0,0,0,0,0,0,0,0,0
1789,776,2014,18,6,12,0.32,31,912,3,2,1,3,1,1,5,3,0,0,0,0,1,1,0,0,0
1790,777,2014,13,13,0,0.99,99,912,4,6,3,4,5,1,10,4,0,0,0,4,1,0,0,1,0
1791,778,2014,50,14,36,0.28,28,912,5,8,1,3,5,1,9,1,2,0,0,2,3,1,0,0,0
1792,779,2014,55,34,21,0.62,62,912,24,7,3,22,7,1,30,20,2,0,0,7,0,0,0,1,0
1793,780,2014,34,27,7,0.79,79,912,15,9,3,13,6,2,21,11,2,0,0,3,3,1,1,0,0
1794,781,2014,25,19,6,0.77,77,912,7,11,1,4,8,1,13,2,1,1,0,5,3,1,0,0,0
1795,782,2014,49,46,3,0.93,93,912,20,26,0,17,14,0,31,15,1,1,0,2,12,0,0,0,0
1796,783,2014,17,15,2,0.86,86,912,7,6,2,4,4,2,10,3,0,0,1,2,2,2,0,0,0
1797,784,2014,47,30,17,0.64,64,912,14,13,3,6,8,2,16,2,0,4,0,3,5,1,1,0,0
1798,785,2014,6,0,6,0.01,1,912,0,0,0,0,0,0,0,0,0,0,0,0,0,0,0,0,0
1799,786,2014,39,37,2,0.95,94,912,26,8,3,20,4,2,26,16,2,2,0,0,4,1,1,0,0
1800,787,2014,37,34,3,0.93,92,912,15,19,0,4,19,0,23,0,0,1,3,19,0,0,0,0,0
1801,788,2014,30,20,10,0.65,65,912,7,11,2,6,8,2,16,5,1,0,0,5,3,2,0,0,0
1802,789,2014,23,6,17,0.27,27,912,2,3,1,2,2,1,5,2,0,0,0,1,1,1,0,0,0
1803,790,2014,35,11,24,0.31,30,912,7,4,0,6,3,0,9,5,1,0,0,2,1,0,0,0,0
1804,791,2014,18,11,7,0.59,58,912,8,2,1,3,2,1,6,1,0,1,1,2,0,1,0,0,0
1805,792,2014,40,37,3,0.93,93,912,26,9,2,17,5,1,23,10,6,0,1,1,4,0,1,0,0
1806,793,2014,16,13,3,0.84,83,912,5,7,1,4,7,1,12,3,1,0,0,7,0,1,0,0,0
1807,794,2014,8,7,1,0.84,83,912,3,3,1,3,2,1,6,3,0,0,0,1,1,1,0,0,0
1808,795,2014,33,13,20,0.4,40,912,9,3,1,6,2,1,9,3,3,0,0,1,1,1,0,0,0
1809,796,2014,14,9,5,0.66,66,912,4,5,0,1,4,0,5,0,0,0,1,3,1,0,0,0,0
1810,797,2014,55,4,51,0.07,6,912,3,1,0,1,1,0,2,0,0,1,0,1,0,0,0,0,0
1811,798,2014,24,23,1,0.97,96,912,13,6,4,6,6,1,13,1,4,0,1,6,0,0,0,0,1
1812,799,2014,36,12,24,0.33,32,912,6,5,1,3,3,1,7,0,3,0,0,1,2,1,0,0,0
1813,800,2014,30,15,15,0.51,50,912,10,4,1,8,4,1,13,6,2,0,0,4,0,1,0,0,0
1814,801,2014,38,8,30,0.22,22,912,2,4,2,2,2,2,6,2,0,0,0,0,2,2,0,0,0
1815,802,2014,38,38,0,0.99,98,912,12,22,4,8,18,1,27,6,1,0,1,14,4,0,0,0,1
1816,803,2014,36,32,4,0.88,87,912,21,10,1,18,8,1,27,15,3,0,0,6,2,1,0,0,0
1817,804,2014,35,33,2,0.93,92,912,24,9,0,19,6,0,25,17,0,1,1,3,3,0,0,0,0
1818,805,2014,59,34,25,0.57,57,912,18,14,2,10,12,2,24,4,5,0,1,10,2,2,0,0,0
1819,806,2014,12,0,12,0.03,3,912,0,0,0,0,0,0,0,0,0,0,0,0,0,0,0,0,0
1820,807,2014,28,18,10,0.63,62,912,10,8,0,8,7,0,15,6,2,0,0,6,1,0,0,0,0
1821,808,2014,22,0,22,0.01,1,912,0,0,0,0,0,0,0,0,0,0,0,0,0,0,0,0,0
1822,809,2014,34,14,20,0.4,40,912,8,5,1,8,5,1,14,8,0,0,0,5,0,1,0,0,0
1823,810,2014,38,38,0,0.99,98,912,24,13,1,18,7,1,26,13,4,1,0,1,6,1,0,0,0
1824,811,2014,14,2,12,0.12,11,912,1,1,0,1,1,0,2,1,0,0,0,1,0,0,0,0,0
1825,812,2014,40,1,39,0.02,2,912,0,1,0,0,1,0,1,0,0,0,0,1,0,0,0,0,0
1826,813,2014,52,44,8,0.84,84,912,18,23,3,14,14,1,29,12,1,0,1,5,9,0,0,1,0
1827,814,2014,59,7,52,0.11,11,912,3,3,1,2,3,1,6,1,1,0,0,3,0,1,0,0,0
1828,815,2014,30,29,1,0.96,95,912,16,10,3,7,10,1,18,2,1,4,0,10,0,0,0,1,0
1829,816,2014,37,30,7,0.8,79,912,20,6,4,17,5,1,23,14,3,0,0,4,1,0,0,0,1
1830,817,2014,24,2,22,0.09,8,912,1,1,0,1,1,0,2,1,0,0,0,1,0,0,0,0,0
1831,818,2014,22,21,1,0.94,93,912,9,11,1,7,7,1,15,5,2,0,0,3,4,1,0,0,0
1832,819,2014,22,11,11,0.5,49,912,8,2,1,4,1,1,6,2,1,0,1,0,1,1,0,0,0
1833,820,2014,41,40,1,0.98,97,912,20,17,3,18,12,2,32,17,0,1,0,7,5,1,1,0,0
1834,821,2014,17,17,0,0.98,98,912,12,4,1,7,3,1,11,4,1,2,0,2,1,1,0,0,0
1835,822,2014,44,24,20,0.54,54,912,8,13,3,8,9,1,18,8,0,0,0,5,4,0,0,1,0
1836,823,2014,6,4,2,0.66,66,912,1,2,1,1,1,1,3,1,0,0,0,0,1,1,0,0,0
1837,824,2014,23,8,15,0.36,36,912,4,4,0,4,3,0,7,4,0,0,0,2,1,0,0,0,0
1838,825,2014,47,32,15,0.68,68,912,18,14,0,14,7,0,21,12,1,0,1,0,7,0,0,0,0
1839,826,2014,13,8,5,0.63,62,912,5,3,0,2,2,0,4,0,1,1,0,1,1,0,0,0,0
1840,827,2014,16,1,15,0.08,7,912,0,1,0,0,1,0,1,0,0,0,0,1,0,0,0,0,0
1841,828,2014,28,17,11,0.6,59,912,10,4,3,5,3,2,10,2,1,2,0,2,1,1,1,0,0
1842,829,2014,58,57,1,0.98,97,912,37,17,3,30,13,1,44,26,2,1,1,9,4,0,0,1,0
1843,830,2014,19,13,6,0.66,66,912,4,8,1,2,5,1,8,1,0,1,0,2,3,1,0,0,0
1844,831,2014,35,7,28,0.21,20,912,2,4,1,1,3,1,5,0,1,0,0,2,1,1,0,0,0
1845,832,2014,23,20,3,0.89,89,912,13,6,1,10,6,1,17,8,1,1,0,6,0,1,0,0,0
1846,833,2014,15,13,2,0.88,88,912,8,4,1,7,2,1,10,6,1,0,0,0,2,1,0,0,0
1847,834,2014,8,4,4,0.52,51,912,1,2,1,1,1,1,3,1,0,0,0,0,1,1,0,0,0
1848,835,2014,12,12,0,0.98,98,912,6,6,0,3,3,0,6,0,3,0,0,0,3,0,0,0,0
1849,836,2014,16,14,2,0.86,85,912,4,8,2,3,4,2,9,2,1,0,0,0,4,2,0,0,0
1850,837,2014,47,35,12,0.73,73,912,22,11,2,19,11,1,31,18,0,0,1,11,0,0,1,0,0
1851,838,2014,15,14,1,0.92,92,912,3,8,3,2,5,2,9,1,1,0,0,2,3,1,1,0,0
1852,839,2014,39,12,27,0.3,29,912,8,4,0,4,4,0,8,2,1,0,1,4,0,0,0,0,0
1853,840,2014,25,23,2,0.91,90,912,10,12,1,9,11,1,21,8,1,0,0,10,1,1,0,0,0
1854,841,2014,10,3,7,0.27,27,912,1,2,0,1,2,0,3,1,0,0,0,2,0,0,0,0,0
1855,842,2014,22,7,15,0.34,33,912,4,3,0,1,2,0,3,0,0,0,1,1,1,0,0,0,0
1856,843,2014,9,3,6,0.31,30,912,2,1,0,1,1,0,2,0,1,0,0,1,0,0,0,0,0
1857,844,2014,38,31,7,0.81,80,912,22,5,4,22,5,4,31,22,0,0,0,5,0,4,0,0,0
1858,845,2014,32,22,10,0.7,69,912,7,13,2,6,13,1,20,5,1,0,0,13,0,0,1,0,0
1859,846,2014,20,9,11,0.44,44,912,4,3,2,3,3,2,8,2,1,0,0,3,0,2,0,0,0
1860,847,2014,35,14,21,0.41,40,912,9,3,2,5,2,2,9,3,1,0,1,1,1,2,0,0,0
1861,848,2014,29,20,9,0.69,69,912,4,12,4,1,7,3,11,0,0,0,1,2,5,2,1,0,0
1862,849,2014,14,3,11,0.24,23,912,2,1,0,2,1,0,3,2,0,0,0,1,0,0,0,0,0
1863,850,2014,34,24,10,0.69,69,912,7,14,3,4,10,1,15,2,1,1,0,6,4,0,0,1,0
1864,851,2014,35,32,3,0.93,92,912,12,18,2,3,12,1,16,0,0,0,3,6,6,0,1,0,0
1865,852,2014,55,31,24,0.56,55,912,17,11,3,9,11,1,21,4,2,3,0,11,0,0,0,1,0
1866,853,2014,26,4,22,0.14,13,912,1,2,1,1,1,1,3,1,0,0,0,0,1,1,0,0,0
1867,854,2014,53,24,29,0.45,45,912,6,14,4,2,13,4,19,0,1,0,1,12,1,4,0,0,0
1868,855,2014,49,42,7,0.85,85,912,25,16,1,22,15,1,38,21,0,0,1,14,1,1,0,0,0
1869,856,2014,23,18,5,0.78,78,912,6,10,2,2,9,1,12,0,0,2,0,8,1,0,1,0,0
1870,857,2014,21,20,1,0.96,95,912,7,10,3,3,6,1,10,0,2,1,0,2,4,0,0,1,0
1871,858,2014,23,22,1,0.98,97,912,11,10,1,5,7,1,13,1,3,0,1,4,3,1,0,0,0
1872,859,2014,38,22,16,0.58,58,912,7,13,2,5,9,2,16,4,0,1,0,5,4,2,0,0,0
1873,860,2014,35,33,2,0.95,94,912,14,17,2,6,11,1,18,2,2,0,2,5,6,0,1,0,0
1874,861,2014,20,8,12,0.42,42,912,3,3,2,1,2,2,5,0,0,1,0,1,1,2,0,0,0
1875,862,2014,28,27,1,0.96,95,912,19,6,2,17,6,1,24,15,2,0,0,6,0,0,1,0,0
1876,863,2014,7,4,3,0.57,57,912,3,1,0,2,1,0,3,1,1,0,0,1,0,0,0,0,0
1877,864,2014,46,17,29,0.37,36,912,6,8,3,2,7,3,12,0,1,0,1,6,1,3,0,0,0
1878,865,2014,15,9,6,0.6,59,912,5,4,0,5,4,0,9,5,0,0,0,4,0,0,0,0,0
1879,866,2014,58,6,52,0.1,9,912,3,3,0,1,2,0,3,0,0,1,0,1,1,0,0,0,0
1880,867,2014,29,16,13,0.54,54,912,5,8,3,4,7,1,12,3,1,0,0,6,1,0,0,1,0
1881,868,2014,34,9,25,0.26,26,912,6,3,0,4,3,0,7,3,0,1,0,3,0,0,0,0,0
1882,869,2014,15,0,15,0.01,1,912,0,0,0,0,0,0,0,0,0,0,0,0,0,0,0,0,0
1883,870,2014,35,3,32,0.08,7,912,2,1,0,2,1,0,3,2,0,0,0,1,0,0,0,0,0
1884,871,2014,11,11,0,0.99,99,912,3,5,3,1,5,1,7,0,0,1,0,5,0,0,0,1,0
1885,872,2014,37,37,0,0.99,98,912,20,15,2,16,8,1,25,14,1,0,1,1,7,0,1,0,0
1886,873,2014,31,20,11,0.66,65,912,11,6,3,11,4,3,18,11,0,0,0,2,2,3,0,0,0
1887,874,2014,38,35,3,0.93,92,912,17,17,1,7,17,1,25,1,4,0,2,17,0,1,0,0,0
1888,875,2014,9,8,1,0.84,83,912,5,3,0,2,3,0,5,0,1,1,0,3,0,0,0,0,0
1889,876,2014,39,28,11,0.71,70,912,14,12,2,12,12,1,25,11,0,1,0,12,0,0,1,0,0
1890,877,2014,52,9,43,0.17,16,912,4,3,2,3,2,1,6,2,1,0,0,1,1,0,1,0,0
1891,878,2014,37,1,36,0.03,2,912,0,1,0,0,1,0,1,0,0,0,0,1,0,0,0,0,0
1892,879,2014,16,15,1,0.95,95,912,6,8,1,6,7,1,14,6,0,0,0,6,1,1,0,0,0
1893,880,2014,20,8,12,0.4,39,912,2,4,2,2,3,2,7,2,0,0,0,2,1,2,0,0,0
1894,881,2014,7,7,0,0.94,93,912,3,3,1,3,3,1,7,3,0,0,0,3,0,1,0,0,0
1895,882,2014,60,7,53,0.11,11,912,3,4,0,1,2,0,3,0,0,1,0,0,2,0,0,0,0
1896,883,2014,10,8,2,0.77,76,912,2,4,2,2,2,2,6,2,0,0,0,0,2,2,0,0,0
1897,884,2014,8,1,7,0.16,15,912,0,1,0,0,1,0,1,0,0,0,0,1,0,0,0,0,0
1898,885,2014,34,1,33,0.04,3,912,0,1,0,0,1,0,1,0,0,0,0,1,0,0,0,0,0
1899,886,2014,26,26,0,1.0,99,912,17,7,2,16,6,1,23,15,1,0,0,5,1,0,1,0,0
1900,887,2014,12,10,2,0.86,85,912,7,3,0,2,3,0,5,0,0,1,1,3,0,0,0,0,0
1901,888,2014,15,12,3,0.81,80,912,5,4,3,5,2,3,10,5,0,0,0,0,2,3,0,0,0
1902,889,2014,26,25,1,0.95,94,912,11,11,3,9,6,2,17,7,2,0,0,1,5,1,1,0,0
1903,890,2014,12,4,8,0.31,31,912,1,2,1,1,1,1,3,1,0,0,0,0,1,1,0,0,0
1904,891,2014,60,51,9,0.85,85,912,26,22,3,21,13,3,37,18,2,0,1,4,9,3,0,0,0
1905,892,2014,21,20,1,0.97,96,912,13,4,3,9,2,2,13,7,0,2,0,0,2,1,1,0,0
1906,893,2014,18,2,16,0.1,9,912,1,1,0,1,1,0,2,1,0,0,0,1,0,0,0,0,0
1907,894,2014,13,10,3,0.8,79,912,3,4,3,2,4,2,8,1,1,0,0,4,0,1,1,0,0
1908,895,2014,41,14,27,0.34,34,912,4,8,2,2,7,2,11,1,0,1,0,6,1,2,0,0,0
1909,896,2014,14,2,12,0.12,12,912,1,1,0,1,1,0,2,1,0,0,0,1,0,0,0,0,0
1910,897,2014,47,31,16,0.65,64,912,18,13,0,17,12,0,29,16,1,0,0,11,1,0,0,0,0
1911,898,2014,28,26,2,0.93,92,912,10,15,1,5,9,1,15,0,5,0,0,3,6,1,0,0,0
1912,899,2014,29,28,1,0.95,94,912,14,14,0,14,14,0,28,14,0,0,0,14,0,0,0,0,0
1913,900,2014,22,13,9,0.58,58,912,5,6,2,2,4,1,7,0,1,1,0,2,2,0,1,0,0
1914,901,2014,34,22,12,0.65,64,912,12,7,3,9,7,1,17,8,0,0,1,7,0,0,0,1,0
1915,902,2014,16,14,2,0.85,84,912,7,7,0,6,4,0,10,5,1,0,0,1,3,0,0,0,0
1916,903,2014,26,17,9,0.66,65,912,10,5,2,3,5,2,10,0,1,0,2,5,0,2,0,0,0
1917,904,2014,10,1,9,0.08,8,912,0,1,0,0,1,0,1,0,0,0,0,1,0,0,0,0,0
1918,905,2014,14,1,13,0.1,10,912,0,1,0,0,1,0,1,0,0,0,0,1,0,0,0,0,0
1919,906,2014,12,3,9,0.24,23,912,2,1,0,1,1,0,2,0,1,0,0,1,0,0,0,0,0
1920,907,2014,42,7,35,0.17,17,912,4,2,1,4,2,1,7,4,0,0,0,2,0,1,0,0,0
1921,908,2014,20,6,14,0.28,28,912,3,2,1,3,1,1,5,3,0,0,0,0,1,1,0,0,0
1922,909,2014,40,37,3,0.92,91,912,16,18,3,15,16,2,33,14,1,0,0,14,2,1,1,0,0
1923,910,2014,16,16,0,0.99,98,912,11,4,1,6,2,1,9,2,3,1,0,0,2,1,0,0,0
1924,911,2014,57,54,3,0.95,94,912,35,17,2,34,10,2,46,33,1,0,0,3,7,2,0,0,0
1925,912,2014,10,0,10,0.01,1,912,0,0,0,0,0,0,0,0,0,0,0,0,0,0,0,0,0
1926,1,2015,33,30,3,0.91,91,1096,14,14,2,13,10,1,24,12,1,0,0,6,4,0,1,0,0
1927,2,2015,15,3,12,0.19,19,1096,1,2,0,1,2,0,3,1,0,0,0,2,0,0,0,0,0
1928,3,2015,28,27,1,0.98,97,1096,11,13,3,5,12,2,19,2,0,3,0,11,1,1,1,0,0
1929,4,2015,40,40,0,1.0,99,1096,28,12,0,8,8,0,16,1,0,1,6,4,4,0,0,0,0
1930,5,2015,33,33,0,0.99,99,1096,23,9,1,11,5,1,17,3,6,0,2,1,4,1,0,0,0
1931,6,2015,41,41,0,0.99,99,1096,21,18,2,9,14,2,25,1,5,2,1,10,4,2,0,0,0
1932,7,2015,55,53,2,0.96,95,1096,34,16,3,18,9,1,28,9,5,1,3,2,7,0,0,1,0
1933,8,2015,38,11,27,0.28,27,1096,7,3,1,2,3,1,6,0,0,1,1,3,0,1,0,0,0
1934,9,2015,28,2,26,0.07,6,1096,1,1,0,1,1,0,2,1,0,0,0,1,0,0,0,0,0
1935,10,2015,12,8,4,0.67,67,1096,5,2,1,2,1,1,4,0,1,1,0,0,1,1,0,0,0
1936,11,2015,49,6,43,0.12,11,1096,2,3,1,2,2,1,5,2,0,0,0,1,1,1,0,0,0
1937,12,2015,34,0,34,0.0,0,1096,0,0,0,0,0,0,0,0,0,0,0,0,0,0,0,0,0
1938,13,2015,6,4,2,0.71,70,1096,1,2,1,1,1,1,3,1,0,0,0,0,1,1,0,0,0
1939,14,2015,32,0,32,0.01,1,1096,0,0,0,0,0,0,0,0,0,0,0,0,0,0,0,0,0
1940,15,2015,7,6,1,0.82,81,1096,2,3,1,1,3,1,5,0,1,0,0,3,0,1,0,0,0
1941,16,2015,47,28,19,0.6,60,1096,19,8,1,14,4,1,19,12,0,1,1,0,4,1,0,0,0
1942,17,2015,13,12,1,0.89,89,1096,4,7,1,1,7,1,9,0,0,0,1,7,0,1,0,0,0
1943,18,2015,40,40,0,1.0,99,1096,27,13,0,25,7,0,32,23,2,0,0,1,6,0,0,0,0
1944,19,2015,10,1,9,0.07,6,1096,0,1,0,0,1,0,1,0,0,0,0,1,0,0,0,0,0
1945,20,2015,9,7,2,0.76,76,1096,3,4,0,1,2,0,3,0,0,1,0,0,2,0,0,0,0
1946,21,2015,52,11,41,0.22,21,1096,7,4,0,7,4,0,11,7,0,0,0,4,0,0,0,0,0
1947,22,2015,5,4,1,0.8,79,1096,1,2,1,1,1,1,3,1,0,0,0,0,1,1,0,0,0
1948,23,2015,34,25,9,0.75,74,1096,13,9,3,4,9,3,16,1,0,0,3,9,0,3,0,0,0
1949,24,2015,37,28,9,0.75,74,1096,19,5,4,5,4,2,11,0,0,1,4,3,1,1,0,1,0
1950,25,2015,36,35,1,0.96,96,1096,18,16,1,11,13,1,25,8,0,2,1,10,3,1,0,0,0
1951,26,2015,33,32,1,0.98,97,1096,19,12,1,9,12,1,22,4,0,5,0,12,0,1,0,0,0
1952,27,2015,27,7,20,0.26,25,1096,2,4,1,1,3,1,5,0,1,0,0,2,1,1,0,0,0
1953,28,2015,27,20,7,0.75,75,1096,10,9,1,8,9,1,18,6,2,0,0,9,0,1,0,0,0
1954,29,2015,8,1,7,0.09,8,1096,0,1,0,0,1,0,1,0,0,0,0,1,0,0,0,0,0
1955,30,2015,59,56,3,0.96,95,1096,24,31,1,23,22,1,46,22,1,0,0,13,9,1,0,0,0
1956,31,2015,60,13,47,0.22,21,1096,5,6,2,4,3,1,8,3,1,0,0,0,3,0,1,0,0
1957,32,2015,10,10,0,0.98,97,1096,4,4,2,2,3,1,6,1,0,1,0,2,1,0,1,0,0
1958,33,2015,28,16,12,0.56,56,1096,8,6,2,5,4,1,10,2,3,0,0,2,2,0,1,0,0
1959,34,2015,10,3,7,0.3,30,1096,1,2,0,1,2,0,3,1,0,0,0,2,0,0,0,0,0
1960,35,2015,52,49,3,0.95,94,1096,23,23,3,22,18,3,43,21,1,0,0,13,5,3,0,0,0
1961,36,2015,58,55,3,0.95,95,1096,22,30,3,18,16,2,36,16,1,0,1,2,14,1,1,0,0
1962,37,2015,53,45,8,0.85,85,1096,31,14,0,19,10,0,29,13,2,2,2,6,4,0,0,0,0
1963,38,2015,19,16,3,0.85,84,1096,7,6,3,2,3,2,7,0,0,1,1,0,3,1,1,0,0
1964,39,2015,16,1,15,0.09,8,1096,0,1,0,0,1,0,1,0,0,0,0,1,0,0,0,0,0
1965,40,2015,8,8,0,0.99,99,1096,3,3,2,1,2,1,4,0,0,1,0,1,1,0,1,0,0
1966,41,2015,24,13,11,0.52,52,1096,7,4,2,6,4,1,11,5,1,0,0,4,0,0,1,0,0
1967,42,2015,8,0,8,0.02,2,1096,0,0,0,0,0,0,0,0,0,0,0,0,0,0,0,0,0
1968,43,2015,40,24,16,0.61,61,1096,8,14,2,4,8,2,14,2,1,0,1,2,6,2,0,0,0
1969,44,2015,29,26,3,0.89,89,1096,16,8,2,4,8,2,14,0,0,0,4,8,0,2,0,0,0
1970,45,2015,42,3,39,0.08,7,1096,2,1,0,2,1,0,3,2,0,0,0,1,0,0,0,0,0
1971,46,2015,53,53,0,1.0,100,1096,32,21,0,31,19,0,50,30,1,0,0,17,2,0,0,0,0
1972,47,2015,37,37,0,1.0,100,1096,27,6,4,22,4,2,28,19,1,2,0,2,2,1,0,1,0
1973,48,2015,24,23,1,0.94,93,1096,5,14,4,3,7,3,13,1,2,0,0,0,7,2,1,0,0
1974,49,2015,60,47,13,0.78,78,1096,18,26,3,16,20,2,38,14,2,0,0,14,6,1,1,0,0
1975,50,2015,17,10,7,0.61,60,1096,5,4,1,2,2,1,5,0,1,1,0,0,2,1,0,0,0
1976,51,2015,18,10,8,0.53,52,1096,5,3,2,4,3,2,9,3,1,0,0,3,0,2,0,0,0
1977,52,2015,34,12,22,0.36,35,1096,7,3,2,4,2,2,8,2,1,1,0,1,1,2,0,0,0
1978,53,2015,25,3,22,0.1,10,1096,2,1,0,1,1,0,2,0,1,0,0,1,0,0,0,0,0
1979,54,2015,26,15,11,0.57,57,1096,6,8,1,4,4,1,9,3,0,1,0,0,4,1,0,0,0
1980,55,2015,31,31,0,1.0,100,1096,14,14,3,5,14,2,21,0,2,2,1,14,0,1,1,0,0
1981,56,2015,25,25,0,1.0,99,1096,15,9,1,7,7,1,15,4,0,1,2,5,2,1,0,0,0
1982,57,2015,11,11,0,0.98,97,1096,6,3,2,3,2,1,6,1,1,1,0,1,1,0,1,0,0
1983,58,2015,33,21,12,0.65,64,1096,12,9,0,4,5,0,9,1,0,1,2,1,4,0,0,0,0
1984,59,2015,7,6,1,0.85,85,1096,1,4,1,1,3,1,5,1,0,0,0,2,1,1,0,0,0
1985,60,2015,5,1,4,0.23,23,1096,0,1,0,0,1,0,1,0,0,0,0,1,0,0,0,0,0
1986,61,2015,23,16,7,0.71,70,1096,8,8,0,7,8,0,15,6,1,0,0,8,0,0,0,0,0
1987,62,2015,47,39,8,0.83,82,1096,24,14,1,20,14,1,35,17,2,1,0,14,0,1,0,0,0
1988,63,2015,7,2,5,0.29,28,1096,1,1,0,1,1,0,2,1,0,0,0,1,0,0,0,0,0
1989,64,2015,39,30,9,0.78,78,1096,13,14,3,10,13,1,24,7,3,0,0,12,1,0,0,1,0
1990,65,2015,47,16,31,0.34,33,1096,5,8,3,3,4,2,9,2,0,1,0,0,4,1,1,0,0
1991,66,2015,23,22,1,0.96,96,1096,16,6,0,15,6,0,21,14,1,0,0,6,0,0,0,0,0
1992,67,2015,7,2,5,0.27,26,1096,1,1,0,1,1,0,2,1,0,0,0,1,0,0,0,0,0
1993,68,2015,36,36,0,0.99,99,1096,26,10,0,22,5,0,27,20,0,2,0,0,5,0,0,0,0
1994,69,2015,44,7,37,0.15,15,1096,4,2,1,3,2,1,6,2,1,0,0,2,0,1,0,0,0
1995,70,2015,50,27,23,0.55,54,1096,20,6,1,15,3,1,19,13,0,1,1,0,3,1,0,0,0
1996,71,2015,14,4,10,0.26,25,1096,2,2,0,1,2,0,3,0,1,0,0,2,0,0,0,0,0
1997,72,2015,34,19,15,0.56,56,1096,12,5,2,4,5,2,11,0,2,0,2,5,0,2,0,0,0
1998,73,2015,50,4,46,0.09,8,1096,1,2,1,1,2,1,4,1,0,0,0,2,0,1,0,0,0
1999,74,2015,40,40,0,1.0,100,1096,19,21,0,9,20,0,29,2,4,3,0,19,1,0,0,0,0
2000,75,2015,34,21,13,0.61,60,1096,7,12,2,3,6,1,10,1,1,0,1,0,6,0,1,0,0
2001,76,2015,43,31,12,0.72,71,1096,22,7,2,22,5,2,29,22,0,0,0,3,2,2,0,0,0
2002,77,2015,13,6,7,0.43,42,1096,4,2,0,2,2,0,4,0,2,0,0,2,0,0,0,0,0
2003,78,2015,15,14,1,0.96,95,1096,9,5,0,8,4,0,12,7,1,0,0,3,1,0,0,0,0
2004,79,2015,19,10,9,0.51,51,1096,7,3,0,7,2,0,9,7,0,0,0,1,1,0,0,0,0
2005,80,2015,43,39,4,0.92,91,1096,23,12,4,11,6,3,20,4,3,3,1,0,6,2,1,0,0
2006,81,2015,55,44,11,0.8,79,1096,26,16,2,8,10,1,19,2,0,0,6,4,6,0,1,0,0
2007,82,2015,23,23,0,0.99,98,1096,7,12,4,4,10,1,15,1,3,0,0,8,2,0,0,0,1
2008,83,2015,9,6,3,0.63,62,1096,2,3,1,1,2,1,4,0,1,0,0,1,1,1,0,0,0
2009,84,2015,31,31,0,1.0,100,1096,20,10,1,20,9,1,30,20,0,0,0,8,1,1,0,0,0
2010,85,2015,6,4,2,0.72,72,1096,2,2,0,2,1,0,3,2,0,0,0,0,1,0,0,0,0
2011,86,2015,53,44,9,0.82,82,1096,14,26,4,13,24,3,40,12,1,0,0,22,2,2,1,0,0
2012,87,2015,27,24,3,0.88,88,1096,13,8,3,4,5,2,11,1,0,0,3,2,3,1,1,0,0
2013,88,2015,19,7,12,0.38,38,1096,2,3,2,2,2,2,6,2,0,0,0,1,1,2,0,0,0
2014,89,2015,29,28,1,0.98,98,1096,11,16,1,5,8,1,14,0,4,1,0,0,8,1,0,0,0
2015,90,2015,15,8,7,0.55,55,1096,2,5,1,1,4,1,6,0,1,0,0,3,1,1,0,0,0
2016,91,2015,57,48,9,0.83,83,1096,23,24,1,6,22,1,29,0,0,1,5,20,2,1,0,0,0
2017,92,2015,40,39,1,0.98,97,1096,23,14,2,20,10,1,31,19,0,0,1,6,4,0,1,0,0
2018,93,2015,26,9,17,0.34,34,1096,4,3,2,4,3,2,9,4,0,0,0,3,0,2,0,0,0
2019,94,2015,21,18,3,0.87,86,1096,13,5,0,7,3,0,10,5,0,0,2,1,2,0,0,0,0
2020,95,2015,39,38,1,0.97,96,1096,27,9,2,10,6,2,18,2,3,1,4,3,3,2,0,0,0
2021,96,2015,12,10,2,0.8,80,1096,4,5,1,2,5,1,8,0,2,0,0,5,0,1,0,0,0
2022,97,2015,28,27,1,0.97,96,1096,17,9,1,13,8,1,22,11,1,0,1,7,1,1,0,0,0
2023,98,2015,60,37,23,0.62,61,1096,26,8,3,22,5,2,29,19,2,1,0,2,3,1,1,0,0
2024,99,2015,56,19,37,0.34,33,1096,11,8,0,10,4,0,14,9,1,0,0,0,4,0,0,0,0
2025,100,2015,27,1,26,0.05,4,1096,0,1,0,0,1,0,1,0,0,0,0,1,0,0,0,0,0
2026,101,2015,31,31,0,1.0,100,1096,18,10,3,16,6,1,23,15,0,1,0,2,4,0,0,1,0
2027,102,2015,10,10,0,0.96,96,1096,4,5,1,1,3,1,5,0,0,0,1,1,2,1,0,0,0
2028,103,2015,29,4,25,0.14,14,1096,3,1,0,2,1,0,3,1,1,0,0,1,0,0,0,0,0
2029,104,2015,57,14,43,0.24,24,1096,9,4,1,3,3,1,7,0,0,3,0,2,1,1,0,0,0
2030,105,2015,15,9,6,0.62,62,1096,6,2,1,5,2,1,8,4,1,0,0,2,0,1,0,0,0
2031,106,2015,7,4,3,0.52,52,1096,3,1,0,2,1,0,3,1,1,0,0,1,0,0,0,0,0
2032,107,2015,8,8,0,0.99,98,1096,5,2,1,2,2,1,5,0,1,1,0,2,0,1,0,0,0
2033,108,2015,24,16,8,0.66,66,1096,10,5,1,4,4,1,9,1,0,3,0,3,1,1,0,0,0
2034,109,2015,16,11,5,0.68,67,1096,6,3,2,2,3,1,6,0,1,0,1,3,0,0,1,0,0
2035,110,2015,19,10,9,0.54,54,1096,7,2,1,7,2,1,10,7,0,0,0,2,0,1,0,0,0
2036,111,2015,41,32,9,0.78,77,1096,10,19,3,8,12,2,22,6,2,0,0,5,7,1,1,0,0
2037,112,2015,14,0,14,0.01,1,1096,0,0,0,0,0,0,0,0,0,0,0,0,0,0,0,0,0
2038,113,2015,7,7,0,0.99,98,1096,2,3,2,2,2,2,6,2,0,0,0,1,1,2,0,0,0
2039,114,2015,18,16,2,0.87,86,1096,10,4,2,7,2,2,11,5,1,1,0,0,2,2,0,0,0
2040,115,2015,5,2,3,0.38,38,1096,1,1,0,1,1,0,2,1,0,0,0,1,0,0,0,0,0
2041,116,2015,42,5,37,0.11,10,1096,3,2,0,2,2,0,4,1,1,0,0,2,0,0,0,0,0
2042,117,2015,8,7,1,0.92,92,1096,2,4,1,1,2,1,4,0,1,0,0,0,2,1,0,0,0
2043,118,2015,15,6,9,0.41,40,1096,2,3,1,1,3,1,5,0,1,0,0,3,0,1,0,0,0
2044,119,2015,14,3,11,0.2,20,1096,2,1,0,2,1,0,3,2,0,0,0,1,0,0,0,0,0
2045,120,2015,32,32,0,1.0,100,1096,22,7,3,12,4,1,17,3,8,1,0,1,3,0,0,1,0
2046,121,2015,32,15,17,0.47,46,1096,4,7,4,4,6,2,12,4,0,0,0,5,1,0,2,0,0
2047,122,2015,6,4,2,0.61,60,1096,1,2,1,1,2,1,4,1,0,0,0,2,0,1,0,0,0
2048,123,2015,20,20,0,0.98,98,1096,12,7,1,11,6,1,18,10,1,0,0,5,1,1,0,0,0
2049,124,2015,40,40,0,1.0,99,1096,19,18,3,7,15,3,25,3,0,0,4,12,3,3,0,0,0
2050,125,2015,48,43,5,0.9,89,1096,25,17,1,18,13,1,32,15,0,2,1,9,4,1,0,0,0
2051,126,2015,55,16,39,0.3,29,1096,8,7,1,2,4,1,7,0,0,0,2,1,3,1,0,0,0
2052,127,2015,15,3,12,0.2,20,1096,1,2,0,1,2,0,3,1,0,0,0,2,0,0,0,0,0
2053,128,2015,11,11,0,0.97,97,1096,8,2,1,8,1,1,10,8,0,0,0,0,1,1,0,0,0
2054,129,2015,58,58,0,1.0,99,1096,27,29,2,10,29,2,41,2,2,3,3,29,0,2,0,0,0
2055,130,2015,15,14,1,0.92,92,1096,6,5,3,5,3,1,9,4,1,0,0,1,2,0,0,1,0
2056,131,2015,52,50,2,0.95,95,1096,35,12,3,9,7,1,17,0,0,1,8,2,5,0,0,1,0
2057,132,2015,28,18,10,0.64,64,1096,11,4,3,5,3,1,9,3,0,0,2,2,1,0,0,1,0
2058,133,2015,57,11,46,0.2,20,1096,5,4,2,5,4,1,10,5,0,0,0,4,0,0,1,0,0
2059,134,2015,26,11,15,0.44,43,1096,4,6,1,1,5,1,7,0,0,0,1,4,1,1,0,0,0
2060,135,2015,42,39,3,0.94,93,1096,29,8,2,29,8,2,39,29,0,0,0,8,0,2,0,0,0
2061,136,2015,9,8,1,0.87,86,1096,2,4,2,2,2,2,6,2,0,0,0,0,2,2,0,0,0
2062,137,2015,23,3,20,0.13,13,1096,2,1,0,1,1,0,2,0,1,0,0,1,0,0,0,0,0
2063,138,2015,19,18,1,0.94,93,1096,13,4,1,5,2,1,8,0,3,1,1,0,2,1,0,0,0
2064,139,2015,42,41,1,0.97,96,1096,29,11,1,25,6,1,32,22,2,1,0,1,5,1,0,0,0
2065,140,2015,29,6,23,0.2,20,1096,3,2,1,1,2,1,4,0,0,1,0,2,0,1,0,0,0
2066,141,2015,12,12,0,1.0,100,1096,6,4,2,4,4,2,10,3,0,1,0,4,0,2,0,0,0
2067,142,2015,7,4,3,0.52,51,1096,1,2,1,1,2,1,4,1,0,0,0,2,0,1,0,0,0
2068,143,2015,7,6,1,0.87,86,1096,3,3,0,1,2,0,3,0,0,1,0,1,1,0,0,0,0
2069,144,2015,6,4,2,0.65,64,1096,1,2,1,1,1,1,3,1,0,0,0,0,1,1,0,0,0
2070,145,2015,15,15,0,1.0,100,1096,6,6,3,4,3,3,10,3,0,1,0,0,3,3,0,0,0
2071,146,2015,29,12,17,0.4,39,1096,7,4,1,7,2,1,10,7,0,0,0,0,2,1,0,0,0
2072,147,2015,22,3,19,0.13,12,1096,2,1,0,2,1,0,3,2,0,0,0,1,0,0,0,0,0
2073,148,2015,19,14,5,0.76,75,1096,9,4,1,6,4,1,11,3,3,0,0,4,0,1,0,0,0
2074,149,2015,32,24,8,0.76,76,1096,10,11,3,3,10,1,14,0,1,0,2,9,1,0,0,1,0
2075,150,2015,33,31,2,0.95,94,1096,21,7,3,11,4,3,18,1,10,0,0,1,3,3,0,0,0
2076,151,2015,16,7,9,0.46,45,1096,4,3,0,1,3,0,4,0,0,0,1,3,0,0,0,0,0
2077,152,2015,6,1,5,0.12,12,1096,0,1,0,0,1,0,1,0,0,0,0,1,0,0,0,0,0
2078,153,2015,31,28,3,0.91,91,1096,9,17,2,7,9,2,18,6,0,1,0,1,8,2,0,0,0
2079,154,2015,32,6,26,0.18,17,1096,3,2,1,3,1,1,5,3,0,0,0,0,1,1,0,0,0
2080,155,2015,27,26,1,0.98,98,1096,8,15,3,3,12,3,18,0,2,0,1,9,3,3,0,0,0
2081,156,2015,30,12,18,0.41,41,1096,5,5,2,3,3,2,8,1,2,0,0,1,2,2,0,0,0
2082,157,2015,22,21,1,0.95,94,1096,11,9,1,11,8,1,20,11,0,0,0,7,1,1,0,0,0
2083,158,2015,26,14,12,0.55,55,1096,3,8,3,3,5,2,10,3,0,0,0,2,3,1,1,0,0
2084,159,2015,7,6,1,0.9,90,1096,2,3,1,2,2,1,5,2,0,0,0,1,1,1,0,0,0
2085,160,2015,21,20,1,0.97,96,1096,14,6,0,11,6,0,17,9,1,1,0,6,0,0,0,0,0
2086,161,2015,34,4,30,0.13,12,1096,3,1,0,1,1,0,2,0,0,1,0,1,0,0,0,0,0
2087,162,2015,31,11,20,0.37,36,1096,5,4,2,2,4,2,8,1,0,0,1,4,0,2,0,0,0
2088,163,2015,54,21,33,0.4,39,1096,10,8,3,7,5,3,15,4,3,0,0,2,3,3,0,0,0
2089,164,2015,5,5,0,0.98,98,1096,2,2,1,1,1,1,3,0,1,0,0,0,1,1,0,0,0
2090,165,2015,15,5,10,0.36,35,1096,1,3,1,1,3,1,5,1,0,0,0,3,0,1,0,0,0
2091,166,2015,30,19,11,0.64,63,1096,10,7,2,7,5,2,14,5,1,1,0,3,2,2,0,0,0
2092,167,2015,15,0,15,0.01,1,1096,0,0,0,0,0,0,0,0,0,0,0,0,0,0,0,0,0
2093,168,2015,48,47,1,0.98,97,1096,19,25,3,16,17,2,35,15,0,0,1,9,8,1,1,0,0
2094,169,2015,45,13,32,0.29,28,1096,5,7,1,3,7,1,11,2,0,1,0,7,0,1,0,0,0
2095,170,2015,26,26,0,0.99,98,1096,8,15,3,4,11,1,16,2,1,0,1,7,4,0,0,1,0
2096,171,2015,13,3,10,0.26,25,1096,2,1,0,1,1,0,2,0,1,0,0,1,0,0,0,0,0
2097,172,2015,40,2,38,0.04,4,1096,1,1,0,1,1,0,2,1,0,0,0,1,0,0,0,0,0
2098,173,2015,39,16,23,0.41,41,1096,9,4,3,5,4,3,12,3,1,0,1,4,0,3,0,0,0
2099,174,2015,38,24,14,0.64,63,1096,14,6,4,12,3,3,18,11,0,1,0,0,3,2,1,0,0
2100,175,2015,39,31,8,0.81,80,1096,13,18,0,9,10,0,19,7,1,0,1,2,8,0,0,0,0
2101,176,2015,14,14,0,1.0,99,1096,7,6,1,7,3,1,11,7,0,0,0,0,3,1,0,0,0
2102,177,2015,17,17,0,0.98,97,1096,9,7,1,4,5,1,10,1,1,2,0,3,2,1,0,0,0
2103,178,2015,14,13,1,0.94,93,1096,4,6,3,2,6,3,11,1,0,1,0,6,0,3,0,0,0
2104,179,2015,30,4,26,0.13,12,1096,1,2,1,1,2,1,4,1,0,0,0,2,0,1,0,0,0
2105,180,2015,51,16,35,0.32,32,1096,9,6,1,8,4,1,13,7,1,0,0,2,2,1,0,0,0
2106,181,2015,26,13,13,0.52,51,1096,4,6,3,1,6,2,9,0,0,0,1,6,0,1,1,0,0
2107,182,2015,33,32,1,0.97,96,1096,10,19,3,6,15,2,23,4,1,0,1,11,4,1,1,0,0
2108,183,2015,32,7,25,0.21,21,1096,2,4,1,2,2,1,5,2,0,0,0,0,2,1,0,0,0
2109,184,2015,40,24,16,0.59,59,1096,12,11,1,12,11,1,24,12,0,0,0,11,0,1,0,0,0
2110,185,2015,7,5,2,0.73,72,1096,4,1,0,2,1,0,3,1,0,1,0,1,0,0,0,0,0
2111,186,2015,14,10,4,0.74,74,1096,4,5,1,3,5,1,9,2,1,0,0,5,0,1,0,0,0
2112,187,2015,22,21,1,0.96,95,1096,14,7,0,9,4,0,13,5,3,1,0,1,3,0,0,0,0
2113,188,2015,19,14,5,0.72,71,1096,6,6,2,6,6,2,14,6,0,0,0,6,0,2,0,0,0
2114,189,2015,16,16,0,0.97,96,1096,6,7,3,4,6,1,11,2,2,0,0,5,1,0,0,1,0
2115,190,2015,33,33,0,1.0,100,1096,18,12,3,18,6,2,26,18,0,0,0,0,6,1,1,0,0
2116,191,2015,13,13,0,0.99,99,1096,4,6,3,3,5,3,11,2,1,0,0,4,1,3,0,0,0
2117,192,2015,7,6,1,0.87,87,1096,2,3,1,2,3,1,6,2,0,0,0,3,0,1,0,0,0
2118,193,2015,39,37,2,0.94,94,1096,18,19,0,6,12,0,18,0,0,6,0,5,7,0,0,0,0
2119,194,2015,40,40,0,1.0,99,1096,16,23,1,11,23,1,35,8,1,2,0,23,0,1,0,0,0
2120,195,2015,34,13,21,0.37,37,1096,4,7,2,3,7,2,12,2,1,0,0,7,0,2,0,0,0
2121,196,2015,19,18,1,0.97,97,1096,5,10,3,3,10,1,14,1,2,0,0,10,0,0,0,1,0
2122,197,2015,8,3,5,0.42,42,1096,1,2,0,1,1,0,2,1,0,0,0,0,1,0,0,0,0
2123,198,2015,30,5,25,0.16,15,1096,2,2,1,1,2,1,4,0,1,0,0,2,0,1,0,0,0
2124,199,2015,6,3,3,0.54,53,1096,2,1,0,1,1,0,2,0,1,0,0,1,0,0,0,0,0
2125,200,2015,54,24,30,0.44,43,1096,13,8,3,4,7,2,13,0,0,3,1,6,1,1,1,0,0
2126,201,2015,46,42,4,0.9,90,1096,30,8,4,23,6,2,31,19,1,3,0,4,2,1,0,1,0
2127,202,2015,35,2,33,0.07,7,1096,1,1,0,1,1,0,2,1,0,0,0,1,0,0,0,0,0
2128,203,2015,25,3,22,0.14,13,1096,1,2,0,1,2,0,3,1,0,0,0,2,0,0,0,0,0
2129,204,2015,38,32,6,0.85,84,1096,13,17,2,8,15,1,24,5,2,0,1,13,2,0,1,0,0
2130,205,2015,27,25,2,0.93,93,1096,13,11,1,13,8,1,22,13,0,0,0,5,3,1,0,0,0
2131,206,2015,31,31,0,1.0,99,1096,10,18,3,8,15,1,24,6,2,0,0,12,3,0,0,1,0
2132,207,2015,6,6,0,0.99,98,1096,2,3,1,1,3,1,5,0,1,0,0,3,0,1,0,0,0
2133,208,2015,36,36,0,1.0,99,1096,27,6,3,22,6,1,29,19,1,2,0,6,0,0,0,1,0
2134,209,2015,32,0,32,0.0,0,1096,0,0,0,0,0,0,0,0,0,0,0,0,0,0,0,0,0
2135,210,2015,34,7,27,0.21,20,1096,4,2,1,2,2,1,5,1,0,1,0,2,0,1,0,0,0
2136,211,2015,31,31,0,1.0,100,1096,13,15,3,7,12,2,21,4,1,1,1,9,3,1,1,0,0
2137,212,2015,35,33,2,0.95,95,1096,21,10,2,12,6,1,19,7,2,2,1,2,4,0,1,0,0
2138,213,2015,10,1,9,0.06,5,1096,0,1,0,0,1,0,1,0,0,0,0,1,0,0,0,0,0
2139,214,2015,18,18,0,1.0,100,1096,6,10,2,6,8,2,16,6,0,0,0,6,2,2,0,0,0
2140,215,2015,5,5,0,0.95,95,1096,3,2,0,3,1,0,4,3,0,0,0,0,1,0,0,0,0
2141,216,2015,26,25,1,0.97,97,1096,17,7,1,16,6,1,23,15,1,0,0,5,1,1,0,0,0
2142,217,2015,36,22,14,0.61,61,1096,7,12,3,3,10,2,15,1,1,0,1,8,2,1,1,0,0
2143,218,2015,39,35,4,0.91,90,1096,18,15,2,13,13,1,27,9,3,1,0,11,2,0,1,0,0
2144,219,2015,48,47,1,0.97,97,1096,22,23,2,10,18,1,29,1,7,1,1,13,5,0,1,0,0
2145,220,2015,44,18,26,0.42,41,1096,13,4,1,6,2,1,9,3,0,2,1,0,2,1,0,0,0
2146,221,2015,37,27,10,0.72,72,1096,18,7,2,8,6,2,16,0,7,0,1,5,1,2,0,0,0
2147,222,2015,15,4,11,0.3,29,1096,2,2,0,1,1,0,2,0,1,0,0,0,1,0,0,0,0
2148,223,2015,50,49,1,0.98,97,1096,33,16,0,17,10,0,27,4,11,1,1,4,6,0,0,0,0
2149,224,2015,21,18,3,0.87,87,1096,9,7,2,6,5,1,12,4,1,1,0,3,2,0,1,0,0
2150,225,2015,16,16,0,1.0,100,1096,7,6,3,5,6,2,13,4,0,1,0,6,0,1,1,0,0
2151,226,2015,7,6,1,0.88,88,1096,3,2,1,1,1,1,3,0,0,1,0,0,1,1,0,0,0
2152,227,2015,17,13,4,0.77,77,1096,6,5,2,3,5,2,10,1,1,1,0,5,0,2,0,0,0
2153,228,2015,11,3,8,0.31,31,1096,1,2,0,1,1,0,2,1,0,0,0,0,1,0,0,0,0
2154,229,2015,14,13,1,0.96,96,1096,7,6,0,4,6,0,10,3,0,0,1,6,0,0,0,0,0
2155,230,2015,22,9,13,0.42,41,1096,4,3,2,4,3,2,9,4,0,0,0,3,0,2,0,0,0
2156,231,2015,17,10,7,0.6,60,1096,4,4,2,2,3,2,7,1,0,1,0,2,1,2,0,0,0
2157,232,2015,30,24,6,0.79,78,1096,9,13,2,7,7,1,15,5,2,0,0,1,6,0,1,0,0
2158,233,2015,16,5,11,0.33,33,1096,2,2,1,1,2,1,4,0,1,0,0,2,0,1,0,0,0
2159,234,2015,24,1,23,0.06,5,1096,0,1,0,0,1,0,1,0,0,0,0,1,0,0,0,0,0
2160,235,2015,22,22,0,1.0,100,1096,13,5,4,9,5,1,15,6,2,1,0,5,0,0,0,0,1
2161,236,2015,14,8,6,0.6,60,1096,4,3,1,2,3,1,6,0,2,0,0,3,0,1,0,0,0
2162,237,2015,42,3,39,0.06,5,1096,2,1,0,1,1,0,2,0,1,0,0,1,0,0,0,0,0
2163,238,2015,17,15,2,0.87,87,1096,6,5,4,5,4,1,10,4,1,0,0,3,1,0,0,0,1
2164,239,2015,12,1,11,0.05,5,1096,0,1,0,0,1,0,1,0,0,0,0,1,0,0,0,0,0
2165,240,2015,28,25,3,0.89,89,1096,17,7,1,8,6,1,15,3,3,0,2,5,1,1,0,0,0
2166,241,2015,18,14,4,0.8,79,1096,8,4,2,4,3,1,8,1,2,1,0,2,1,0,1,0,0
2167,242,2015,55,53,2,0.96,95,1096,32,21,0,16,17,0,33,9,0,5,2,13,4,0,0,0,0
2168,243,2015,22,12,10,0.53,53,1096,3,6,3,2,3,1,6,1,1,0,0,0,3,0,0,1,0
2169,244,2015,53,40,13,0.76,76,1096,28,9,3,18,5,1,24,13,0,5,0,1,4,0,0,1,0
2170,245,2015,46,32,14,0.7,70,1096,16,13,3,7,8,1,16,2,2,2,1,3,5,0,0,1,0
2171,246,2015,30,30,0,1.0,99,1096,19,8,3,19,6,1,26,19,0,0,0,4,2,0,0,1,0
2172,247,2015,39,14,25,0.36,35,1096,9,5,0,5,5,0,10,3,0,2,0,5,0,0,0,0,0
2173,248,2015,15,15,0,1.0,99,1096,6,7,2,6,7,2,15,6,0,0,0,7,0,2,0,0,0
2174,249,2015,13,10,3,0.78,77,1096,3,4,3,1,2,2,5,0,0,1,0,0,2,1,1,0,0
2175,250,2015,46,23,23,0.49,49,1096,13,9,1,13,5,1,19,13,0,0,0,1,4,1,0,0,0
2176,251,2015,51,20,31,0.39,38,1096,11,9,0,7,9,0,16,5,0,2,0,9,0,0,0,0,0
2177,252,2015,11,5,6,0.44,44,1096,3,2,0,3,1,0,4,3,0,0,0,0,1,0,0,0,0
2178,253,2015,57,50,7,0.88,88,1096,25,23,2,7,20,2,29,0,1,1,5,17,3,2,0,0,0
2179,254,2015,30,23,7,0.76,75,1096,11,11,1,10,9,1,20,9,1,0,0,7,2,1,0,0,0
2180,255,2015,35,24,11,0.69,68,1096,11,11,2,9,10,1,20,7,2,0,0,9,1,0,1,0,0
2181,256,2015,34,3,31,0.1,9,1096,2,1,0,2,1,0,3,2,0,0,0,1,0,0,0,0,0
2182,257,2015,15,15,0,1.0,99,1096,8,7,0,3,5,0,8,1,0,1,1,3,2,0,0,0,0
2183,258,2015,37,21,16,0.55,55,1096,15,5,1,7,4,1,12,2,2,3,0,3,1,1,0,0,0
2184,259,2015,14,1,13,0.05,5,1096,0,1,0,0,1,0,1,0,0,0,0,1,0,0,0,0,0
2185,260,2015,56,23,33,0.4,40,1096,11,12,0,7,8,0,15,5,1,0,1,4,4,0,0,0,0
2186,261,2015,7,5,2,0.73,72,1096,2,2,1,2,2,1,5,2,0,0,0,2,0,1,0,0,0
2187,262,2015,30,9,21,0.3,29,1096,6,3,0,4,3,0,7,2,2,0,0,3,0,0,0,0,0
2188,263,2015,29,27,2,0.94,93,1096,12,15,0,5,14,0,19,0,3,2,0,13,1,0,0,0,0
2189,264,2015,25,23,2,0.9,90,1096,12,8,3,6,8,1,15,2,3,0,1,8,0,0,0,1,0
2190,265,2015,23,19,4,0.82,81,1096,11,5,3,4,4,2,10,0,2,1,1,3,1,1,1,0,0
2191,266,2015,25,12,13,0.47,47,1096,7,5,0,4,4,0,8,3,0,0,1,3,1,0,0,0,0
2192,267,2015,12,12,0,0.96,95,1096,6,5,1,5,4,1,10,4,1,0,0,3,1,1,0,0,0
2193,268,2015,19,18,1,0.97,96,1096,10,6,2,3,4,2,9,0,0,2,1,2,2,2,0,0,0
2194,269,2015,32,1,31,0.02,2,1096,0,1,0,0,1,0,1,0,0,0,0,1,0,0,0,0,0
2195,270,2015,35,33,2,0.95,94,1096,23,8,2,16,5,1,22,13,0,2,1,2,3,0,1,0,0
2196,271,2015,30,29,1,0.97,97,1096,20,6,3,13,6,2,21,8,3,2,0,6,0,1,1,0,0
2197,272,2015,46,45,1,0.97,96,1096,20,22,3,9,22,2,33,4,1,2,2,22,0,1,1,0,0
2198,273,2015,14,14,0,0.99,98,1096,6,5,3,6,4,1,11,6,0,0,0,3,1,0,0,1,0
2199,274,2015,19,19,0,0.99,99,1096,10,9,0,8,6,0,14,6,2,0,0,3,3,0,0,0,0
2200,275,2015,11,2,9,0.2,19,1096,1,1,0,1,1,0,2,1,0,0,0,1,0,0,0,0,0
2201,276,2015,31,29,2,0.93,93,1096,20,8,1,17,8,1,26,16,0,0,1,8,0,1,0,0,0
2202,277,2015,28,27,1,0.98,97,1096,15,9,3,5,7,3,15,1,0,2,2,5,2,3,0,0,0
2203,278,2015,31,28,3,0.9,89,1096,17,9,2,8,8,2,18,5,0,0,3,7,1,2,0,0,0
2204,279,2015,21,7,14,0.35,34,1096,3,3,1,1,3,1,5,0,0,1,0,3,0,1,0,0,0
2205,280,2015,15,14,1,0.93,93,1096,5,7,2,5,4,2,11,5,0,0,0,1,3,2,0,0,0
2206,281,2015,39,28,11,0.72,71,1096,17,9,2,6,7,2,15,1,1,2,2,5,2,2,0,0,0
2207,282,2015,49,21,28,0.43,43,1096,7,11,3,4,6,3,13,1,3,0,0,1,5,3,0,0,0
2208,283,2015,20,1,19,0.06,5,1096,0,1,0,0,1,0,1,0,0,0,0,1,0,0,0,0,0
2209,284,2015,11,1,10,0.07,7,1096,0,1,0,0,1,0,1,0,0,0,0,1,0,0,0,0,0
2210,285,2015,48,43,5,0.9,90,1096,28,15,0,24,10,0,34,20,4,0,0,5,5,0,0,0,0
2211,286,2015,28,3,25,0.12,11,1096,2,1,0,1,1,0,2,0,1,0,0,1,0,0,0,0,0
2212,287,2015,15,14,1,0.95,95,1096,9,3,2,4,3,2,9,1,1,2,0,3,0,2,0,0,0
2213,288,2015,37,20,17,0.55,54,1096,7,9,4,2,7,4,13,0,0,1,1,5,2,4,0,0,0
2214,289,2015,20,12,8,0.58,58,1096,4,5,3,4,4,3,11,4,0,0,0,3,1,3,0,0,0
2215,290,2015,22,14,8,0.65,64,1096,7,7,0,4,5,0,9,2,1,1,0,3,2,0,0,0,0
2216,291,2015,39,39,0,1.0,99,1096,27,8,4,24,4,3,31,21,3,0,0,0,4,2,1,0,0
2217,292,2015,15,15,0,0.99,99,1096,10,3,2,7,2,1,10,6,0,0,1,1,1,0,1,0,0
2218,293,2015,20,19,1,0.97,96,1096,12,4,3,7,3,3,13,4,1,2,0,2,1,3,0,0,0
2219,294,2015,22,19,3,0.87,87,1096,10,8,1,6,4,1,11,3,2,1,0,0,4,1,0,0,0
2220,295,2015,49,11,38,0.22,22,1096,4,4,3,2,4,2,8,1,0,1,0,4,0,1,1,0,0
2221,296,2015,18,0,18,0.02,2,1096,0,0,0,0,0,0,0,0,0,0,0,0,0,0,0,0,0
2222,297,2015,35,14,21,0.41,40,1096,7,5,2,5,3,1,9,3,2,0,0,1,2,0,1,0,0
2223,298,2015,44,41,3,0.93,92,1096,17,21,3,5,13,3,21,0,0,3,2,5,8,3,0,0,0
2224,299,2015,33,33,0,0.99,99,1096,20,11,2,11,11,1,23,6,2,2,1,11,0,0,1,0,0
2225,300,2015,25,13,12,0.52,51,1096,3,7,3,3,6,2,11,3,0,0,0,5,1,1,1,0,0
2226,301,2015,30,26,4,0.87,87,1096,15,10,1,9,8,1,18,5,2,2,0,6,2,1,0,0,0
2227,302,2015,29,16,13,0.55,54,1096,10,4,2,8,2,2,12,7,0,1,0,0,2,2,0,0,0
2228,303,2015,56,56,0,1.0,99,1096,28,24,4,15,17,3,35,10,0,2,3,10,7,2,1,0,0
2229,304,2015,47,12,35,0.26,26,1096,6,5,1,2,4,1,7,0,0,2,0,3,1,1,0,0,0
2230,305,2015,18,15,3,0.84,83,1096,10,5,0,9,3,0,12,8,1,0,0,1,2,0,0,0,0
2231,306,2015,49,46,3,0.94,94,1096,25,20,1,10,20,1,31,1,4,4,1,20,0,1,0,0,0
2232,307,2015,35,28,7,0.8,79,1096,17,8,3,17,5,1,23,17,0,0,0,2,3,0,0,1,0
2233,308,2015,13,12,1,0.9,90,1096,9,3,0,3,2,0,5,0,0,3,0,1,1,0,0,0,0
2234,309,2015,10,6,4,0.6,59,1096,3,2,1,2,1,1,4,1,1,0,0,0,1,1,0,0,0
2235,310,2015,37,0,37,0.0,0,1096,0,0,0,0,0,0,0,0,0,0,0,0,0,0,0,0,0
2236,311,2015,30,29,1,0.97,97,1096,21,6,2,11,4,1,16,2,8,1,0,2,2,0,1,0,0
2237,312,2015,11,7,4,0.64,64,1096,2,3,2,2,3,2,7,2,0,0,0,3,0,2,0,0,0
2238,313,2015,60,48,12,0.8,79,1096,30,17,1,14,15,1,30,6,3,2,3,13,2,1,0,0,0
2239,314,2015,9,9,0,1.0,99,1096,6,2,1,4,1,1,6,2,2,0,0,0,1,1,0,0,0
2240,315,2015,54,52,2,0.97,97,1096,19,29,4,18,21,4,43,17,1,0,0,13,8,4,0,0,0
2241,316,2015,15,15,0,0.98,97,1096,6,5,4,6,5,2,13,6,0,0,0,5,0,0,2,0,0
2242,317,2015,41,33,8,0.8,80,1096,19,11,3,11,9,1,21,6,3,1,1,7,2,0,0,1,0
2243,318,2015,26,26,0,0.98,98,1096,16,10,0,6,10,0,16,0,3,2,1,10,0,0,0,0,0
2244,319,2015,7,7,0,1.0,100,1096,4,2,1,4,2,1,7,4,0,0,0,2,0,1,0,0,0
2245,320,2015,28,15,13,0.52,52,1096,8,6,1,4,4,1,9,2,0,2,0,2,2,1,0,0,0
2246,321,2015,5,5,0,0.99,99,1096,2,2,1,1,1,1,3,0,1,0,0,0,1,1,0,0,0
2247,322,2015,14,12,2,0.88,88,1096,3,7,2,3,4,2,9,3,0,0,0,1,3,2,0,0,0
2248,323,2015,57,29,28,0.5,50,1096,11,15,3,6,10,1,17,3,1,2,0,5,5,0,0,1,0
2249,324,2015,26,8,18,0.31,31,1096,5,2,1,2,1,1,4,0,1,1,0,0,1,1,0,0,0
2250,325,2015,25,25,0,1.0,100,1096,14,9,2,6,7,2,15,2,2,0,2,5,2,2,0,0,0
2251,326,2015,27,11,16,0.41,40,1096,3,6,2,2,5,1,8,1,1,0,0,4,1,0,1,0,0
2252,327,2015,52,50,2,0.96,95,1096,31,19,0,31,15,0,46,31,0,0,0,11,4,0,0,0,0
2253,328,2015,9,5,4,0.59,59,1096,1,3,1,1,3,1,5,1,0,0,0,3,0,1,0,0,0
2254,329,2015,25,25,0,1.0,99,1096,13,9,3,8,9,1,18,5,1,2,0,9,0,0,0,1,0
2255,330,2015,30,15,15,0.51,51,1096,4,7,4,4,5,2,11,4,0,0,0,3,2,0,2,0,0
2256,331,2015,59,53,6,0.9,89,1096,26,24,3,26,24,3,53,26,0,0,0,24,0,3,0,0,0
2257,332,2015,43,5,38,0.12,11,1096,4,1,0,1,1,0,2,0,0,0,1,1,0,0,0,0,0
2258,333,2015,27,5,22,0.19,18,1096,2,2,1,1,2,1,4,0,1,0,0,2,0,1,0,0,0
2259,334,2015,24,13,11,0.53,53,1096,5,7,1,4,6,1,11,3,1,0,0,5,1,1,0,0,0
2260,335,2015,58,52,6,0.9,89,1096,26,26,0,15,19,0,34,9,3,1,2,12,7,0,0,0,0
2261,336,2015,40,38,2,0.95,94,1096,23,11,4,14,11,4,29,9,2,2,1,11,0,4,0,0,0
2262,337,2015,31,9,22,0.29,28,1096,5,3,1,2,3,1,6,0,1,1,0,3,0,1,0,0,0
2263,338,2015,15,9,6,0.63,63,1096,4,4,1,1,3,1,5,0,0,0,1,2,1,1,0,0,0
2264,339,2015,23,18,5,0.79,78,1096,12,4,2,4,4,1,9,1,0,1,2,4,0,0,1,0,0
2265,340,2015,38,36,2,0.95,94,1096,18,14,4,5,7,3,15,0,0,2,3,0,7,2,1,0,0
2266,341,2015,27,27,0,0.99,98,1096,16,9,2,15,8,2,25,14,1,0,0,7,1,2,0,0,0
2267,342,2015,8,3,5,0.39,39,1096,2,1,0,1,1,0,2,0,1,0,0,1,0,0,0,0,0
2268,343,2015,50,29,21,0.58,58,1096,16,11,2,7,9,1,17,3,0,3,1,7,2,0,1,0,0
2269,344,2015,23,22,1,0.97,96,1096,11,10,1,4,8,1,13,0,1,3,0,6,2,1,0,0,0
2270,345,2015,40,40,0,0.99,98,1096,22,16,2,6,9,1,16,0,0,2,4,2,7,0,1,0,0
2271,346,2015,48,48,0,1.0,99,1096,32,15,1,15,13,1,29,2,9,4,0,11,2,1,0,0,0
2272,347,2015,21,19,2,0.92,91,1096,10,5,4,6,3,3,12,3,2,1,0,1,2,2,1,0,0
2273,348,2015,38,37,1,0.97,97,1096,15,20,2,14,12,1,27,13,1,0,0,4,8,0,1,0,0
2274,349,2015,24,24,0,0.99,98,1096,14,8,2,8,5,2,15,5,1,1,1,2,3,2,0,0,0
2275,350,2015,39,37,2,0.95,94,1096,20,14,3,8,11,2,21,2,2,2,2,8,3,1,1,0,0
2276,351,2015,29,7,22,0.23,23,1096,2,4,1,1,2,1,4,0,1,0,0,0,2,1,0,0,0
2277,352,2015,36,34,2,0.94,93,1096,13,18,3,11,16,1,28,10,0,1,0,14,2,0,0,1,0
2278,353,2015,39,38,1,0.98,97,1096,27,8,3,18,4,2,24,12,3,3,0,0,4,1,1,0,0
2279,354,2015,15,6,9,0.38,37,1096,3,2,1,2,2,1,5,1,1,0,0,2,0,1,0,0,0
2280,355,2015,22,22,0,0.99,99,1096,14,7,1,11,4,1,16,10,0,0,1,1,3,1,0,0,0
2281,356,2015,31,24,7,0.76,76,1096,12,10,2,8,9,1,18,6,0,2,0,8,1,0,1,0,0
2282,357,2015,26,11,15,0.41,41,1096,4,6,1,2,6,1,9,1,0,1,0,6,0,1,0,0,0
2283,358,2015,49,1,48,0.01,1,1096,0,1,0,0,1,0,1,0,0,0,0,1,0,0,0,0,0
2284,359,2015,36,19,17,0.54,53,1096,8,11,0,6,9,0,15,4,2,0,0,7,2,0,0,0,0
2285,360,2015,37,30,7,0.82,81,1096,12,18,0,5,13,0,18,0,3,2,0,8,5,0,0,0,0
2286,361,2015,27,6,21,0.21,20,1096,4,2,0,3,1,0,4,2,1,0,0,0,1,0,0,0,0
2287,362,2015,18,5,13,0.3,30,1096,4,1,0,3,1,0,4,2,1,0,0,1,0,0,0,0,0
2288,363,2015,34,34,0,1.0,99,1096,25,8,1,22,5,1,28,21,0,0,1,2,3,1,0,0,0
2289,364,2015,35,28,7,0.8,79,1096,13,14,1,4,7,1,12,0,0,3,1,0,7,1,0,0,0
2290,365,2015,25,13,12,0.51,51,1096,6,4,3,2,3,3,8,0,1,0,1,2,1,3,0,0,0
2291,366,2015,9,3,6,0.38,38,1096,1,2,0,1,1,0,2,1,0,0,0,0,1,0,0,0,0
2292,367,2015,12,8,4,0.64,64,1096,5,3,0,4,2,0,6,3,1,0,0,1,1,0,0,0,0
2293,368,2015,58,12,46,0.2,20,1096,7,4,1,3,4,1,8,1,1,0,1,4,0,1,0,0,0
2294,369,2015,51,33,18,0.65,64,1096,18,14,1,13,14,1,28,11,0,1,1,14,0,1,0,0,0
2295,370,2015,28,1,27,0.05,5,1096,0,1,0,0,1,0,1,0,0,0,0,1,0,0,0,0,0
2296,371,2015,15,13,2,0.87,87,1096,4,6,3,2,4,2,8,1,0,1,0,2,2,1,1,0,0
2297,372,2015,6,1,5,0.09,8,1096,0,1,0,0,1,0,1,0,0,0,0,1,0,0,0,0,0
2298,373,2015,16,14,2,0.88,88,1096,5,7,2,3,4,1,8,2,0,1,0,1,3,0,1,0,0
2299,374,2015,16,15,1,0.93,93,1096,10,3,2,6,2,1,9,3,2,1,0,1,1,0,1,0,0
2300,375,2015,33,2,31,0.06,5,1096,1,1,0,1,1,0,2,1,0,0,0,1,0,0,0,0,0
2301,376,2015,36,7,29,0.18,18,1096,2,4,1,1,3,1,5,0,1,0,0,2,1,1,0,0,0
2302,377,2015,9,9,0,0.98,98,1096,2,5,2,1,4,1,6,0,1,0,0,3,1,0,1,0,0
2303,378,2015,14,14,0,0.99,98,1096,8,4,2,3,2,1,6,0,1,2,0,0,2,0,1,0,0
2304,379,2015,43,40,3,0.92,92,1096,24,16,0,16,11,0,27,8,8,0,0,6,5,0,0,0,0
2305,380,2015,42,12,30,0.29,28,1096,3,7,2,2,5,1,8,1,1,0,0,3,2,0,1,0,0
2306,381,2015,31,29,2,0.93,92,1096,14,14,1,10,14,1,25,6,4,0,0,14,0,1,0,0,0
2307,382,2015,40,38,2,0.95,95,1096,23,12,3,13,10,3,26,8,2,1,2,8,2,3,0,0,0
2308,383,2015,20,16,4,0.81,80,1096,9,5,2,8,5,1,14,7,1,0,0,5,0,0,1,0,0
2309,384,2015,42,38,4,0.9,89,1096,23,11,4,17,6,3,26,13,3,0,1,1,5,2,1,0,0
2310,385,2015,18,17,1,0.96,95,1096,12,4,1,8,3,1,12,4,4,0,0,2,1,1,0,0,0
2311,386,2015,56,30,26,0.54,53,1096,22,7,1,21,4,1,26,20,1,0,0,1,3,1,0,0,0
2312,387,2015,58,41,17,0.71,71,1096,26,13,2,12,9,1,22,4,4,2,2,5,4,0,1,0,0
2313,388,2015,32,27,5,0.84,83,1096,18,6,3,17,4,1,22,16,1,0,0,2,2,0,0,1,0
2314,389,2015,50,16,34,0.32,32,1096,10,6,0,4,4,0,8,2,0,0,2,2,2,0,0,0,0
2315,390,2015,34,7,27,0.21,21,1096,4,2,1,3,1,1,5,2,1,0,0,0,1,1,0,0,0
2316,391,2015,39,36,3,0.92,91,1096,11,21,4,4,18,4,26,0,2,1,1,15,3,4,0,0,0
2317,392,2015,15,5,10,0.31,31,1096,3,2,0,1,1,0,2,0,0,1,0,0,1,0,0,0,0
2318,393,2015,9,7,2,0.83,83,1096,2,4,1,1,4,1,6,0,1,0,0,4,0,1,0,0,0
2319,394,2015,31,2,29,0.05,5,1096,1,1,0,1,1,0,2,1,0,0,0,1,0,0,0,0,0
2320,395,2015,11,11,0,0.98,97,1096,3,7,1,1,6,1,8,0,0,1,0,5,1,1,0,0,0
2321,396,2015,31,31,0,1.0,99,1096,12,17,2,10,12,2,24,8,2,0,0,7,5,2,0,0,0
2322,397,2015,53,29,24,0.55,55,1096,17,11,1,11,8,1,20,7,3,0,1,5,3,1,0,0,0
2323,398,2015,15,15,0,0.99,98,1096,7,8,0,7,5,0,12,7,0,0,0,2,3,0,0,0,0
2324,399,2015,36,36,0,1.0,100,1096,13,20,3,13,15,1,29,13,0,0,0,10,5,0,0,1,0
2325,400,2015,25,17,8,0.68,67,1096,5,8,4,4,6,3,13,3,1,0,0,4,2,2,1,0,0
2326,401,2015,22,21,1,0.94,93,1096,8,11,2,8,6,1,15,8,0,0,0,1,5,0,1,0,0
2327,402,2015,57,56,1,0.99,98,1096,25,29,2,15,16,2,33,9,2,4,0,3,13,2,0,0,0
2328,403,2015,28,26,2,0.93,92,1096,18,6,2,18,4,1,23,18,0,0,0,2,2,0,1,0,0
2329,404,2015,9,9,0,1.0,99,1096,2,5,2,1,5,1,7,0,1,0,0,5,0,0,1,0,0
2330,405,2015,57,42,15,0.73,73,1096,27,14,1,17,9,1,27,9,7,0,1,4,5,1,0,0,0
2331,406,2015,39,31,8,0.81,80,1096,11,17,3,5,13,1,19,2,1,1,1,9,4,0,0,1,0
2332,407,2015,9,2,7,0.28,27,1096,1,1,0,1,1,0,2,1,0,0,0,1,0,0,0,0,0
2333,408,2015,39,36,3,0.93,92,1096,21,13,2,7,8,2,17,0,2,3,2,3,5,2,0,0,0
2334,409,2015,16,16,0,1.0,99,1096,4,9,3,1,8,2,11,0,0,0,1,7,1,1,1,0,0
2335,410,2015,52,33,19,0.64,64,1096,18,13,2,6,9,1,16,0,2,2,2,5,4,0,1,0,0
2336,411,2015,52,33,19,0.64,63,1096,24,8,1,24,4,1,29,24,0,0,0,0,4,1,0,0,0
2337,412,2015,55,53,2,0.96,96,1096,21,30,2,13,18,2,33,6,6,1,0,6,12,2,0,0,0
2338,413,2015,9,9,0,0.99,98,1096,6,2,1,6,2,1,9,6,0,0,0,2,0,1,0,0,0
2339,414,2015,9,9,0,0.96,96,1096,3,4,2,1,2,1,4,0,0,1,0,0,2,0,1,0,0
2340,415,2015,8,6,2,0.71,70,1096,1,4,1,1,3,1,5,1,0,0,0,2,1,1,0,0,0
2341,416,2015,26,0,26,0.01,1,1096,0,0,0,0,0,0,0,0,0,0,0,0,0,0,0,0,0
2342,417,2015,48,41,7,0.84,84,1096,26,14,1,25,12,1,38,24,1,0,0,10,2,1,0,0,0
2343,418,2015,28,3,25,0.09,9,1096,2,1,0,1,1,0,2,0,1,0,0,1,0,0,0,0,0
2344,419,2015,20,11,9,0.57,56,1096,8,2,1,6,2,1,9,4,2,0,0,2,0,1,0,0,0
2345,420,2015,14,14,0,0.98,97,1096,3,8,3,1,5,2,8,0,0,1,0,2,3,1,1,0,0
2346,421,2015,16,14,2,0.9,90,1096,10,4,0,3,4,0,7,0,0,2,1,4,0,0,0,0,0
2347,422,2015,15,6,9,0.39,38,1096,3,2,1,2,2,1,5,1,1,0,0,2,0,1,0,0,0
2348,423,2015,13,5,8,0.41,40,1096,3,2,0,2,1,0,3,1,1,0,0,0,1,0,0,0,0
2349,424,2015,27,5,22,0.18,18,1096,3,2,0,2,1,0,3,1,1,0,0,0,1,0,0,0,0
2350,425,2015,20,5,15,0.23,22,1096,2,2,1,2,1,1,4,2,0,0,0,0,1,1,0,0,0
2351,426,2015,44,19,25,0.43,42,1096,8,8,3,7,8,1,16,6,1,0,0,8,0,0,0,1,0
2352,427,2015,19,15,4,0.79,79,1096,9,4,2,5,4,2,11,1,4,0,0,4,0,2,0,0,0
2353,428,2015,33,2,31,0.06,6,1096,1,1,0,1,1,0,2,1,0,0,0,1,0,0,0,0,0
2354,429,2015,8,2,6,0.23,22,1096,1,1,0,1,1,0,2,1,0,0,0,1,0,0,0,0,0
2355,430,2015,11,9,2,0.79,79,1096,2,5,2,2,4,1,7,2,0,0,0,3,1,0,1,0,0
2356,431,2015,55,16,39,0.28,28,1096,6,8,2,2,4,2,8,0,1,0,1,0,4,2,0,0,0
2357,432,2015,36,31,5,0.87,87,1096,17,12,2,16,7,2,25,15,1,0,0,2,5,2,0,0,0
2358,433,2015,19,17,2,0.9,90,1096,8,7,2,2,4,2,8,0,0,0,2,1,3,2,0,0,0
2359,434,2015,14,14,0,0.99,98,1096,5,8,1,2,7,1,10,1,0,0,1,6,1,1,0,0,0
2360,435,2015,17,17,0,0.98,97,1096,6,9,2,3,6,2,11,1,1,1,0,3,3,2,0,0,0
2361,436,2015,40,25,15,0.63,62,1096,14,10,1,12,9,1,22,11,0,1,0,8,1,1,0,0,0
2362,437,2015,11,10,1,0.95,94,1096,3,4,3,1,4,2,7,0,0,1,0,4,0,1,1,0,0
2363,438,2015,9,9,0,0.98,98,1096,6,2,1,3,2,1,6,0,3,0,0,2,0,1,0,0,0
2364,439,2015,30,2,28,0.07,7,1096,1,1,0,1,1,0,2,1,0,0,0,1,0,0,0,0,0
2365,440,2015,31,31,0,1.0,99,1096,13,15,3,11,8,2,21,9,2,0,0,1,7,1,1,0,0
2366,441,2015,6,0,6,0.01,1,1096,0,0,0,0,0,0,0,0,0,0,0,0,0,0,0,0,0
2367,442,2015,36,30,6,0.83,82,1096,17,11,2,10,11,2,23,6,1,3,0,11,0,2,0,0,0
2368,443,2015,52,36,16,0.7,70,1096,19,14,3,16,13,3,32,13,3,0,0,12,1,3,0,0,0
2369,444,2015,40,17,23,0.42,42,1096,5,8,4,3,5,1,9,2,0,1,0,2,3,0,0,0,1
2370,445,2015,6,4,2,0.73,73,1096,1,2,1,1,1,1,3,1,0,0,0,0,1,1,0,0,0
2371,446,2015,40,6,34,0.14,13,1096,3,3,0,2,3,0,5,1,1,0,0,3,0,0,0,0,0
2372,447,2015,28,12,16,0.44,44,1096,4,5,3,1,5,2,8,0,0,0,1,5,0,1,1,0,0
2373,448,2015,31,10,21,0.32,31,1096,7,2,1,3,1,1,5,1,1,0,1,0,1,1,0,0,0
2374,449,2015,22,20,2,0.89,89,1096,12,5,3,4,4,1,9,0,1,2,1,3,1,0,0,1,0
2375,450,2015,11,11,0,1.0,99,1096,4,4,3,1,2,2,5,0,0,0,1,0,2,1,1,0,0
2376,451,2015,20,12,8,0.58,57,1096,4,6,2,2,6,1,9,1,0,1,0,6,0,0,1,0,0
2377,452,2015,39,3,36,0.08,7,1096,2,1,0,2,1,0,3,2,0,0,0,1,0,0,0,0,0
2378,453,2015,37,32,5,0.88,87,1096,22,6,4,11,3,4,18,5,3,1,2,0,3,4,0,0,0
2379,454,2015,55,55,0,1.0,100,1096,25,28,2,14,26,2,42,4,9,1,0,24,2,2,0,0,0
2380,455,2015,20,12,8,0.61,61,1096,8,3,1,4,2,1,7,2,0,2,0,1,1,1,0,0,0
2381,456,2015,31,30,1,0.97,97,1096,19,10,1,14,8,1,23,9,5,0,0,6,2,1,0,0,0
2382,457,2015,19,19,0,1.0,99,1096,6,10,3,4,5,3,12,2,2,0,0,0,5,3,0,0,0
2383,458,2015,37,37,0,0.99,99,1096,25,10,2,13,10,1,24,6,4,1,2,10,0,0,1,0,0
2384,459,2015,40,38,2,0.96,95,1096,19,19,0,10,10,0,20,1,9,0,0,1,9,0,0,0,0
2385,460,2015,44,30,14,0.68,68,1096,9,17,4,3,10,4,17,0,1,1,1,3,7,4,0,0,0
2386,461,2015,5,4,1,0.88,87,1096,2,2,0,1,1,0,2,0,1,0,0,0,1,0,0,0,0
2387,462,2015,25,25,0,0.98,98,1096,14,10,1,10,9,1,20,8,1,0,1,8,1,1,0,0,0
2388,463,2015,13,9,4,0.7,70,1096,4,3,2,2,3,1,6,1,0,1,0,3,0,0,1,0,0
2389,464,2015,26,18,8,0.69,68,1096,12,5,1,7,3,1,11,2,5,0,0,1,2,1,0,0,0
2390,465,2015,24,7,17,0.29,29,1096,3,3,1,2,2,1,5,1,1,0,0,1,1,1,0,0,0
2391,466,2015,11,0,11,0.0,0,1096,0,0,0,0,0,0,0,0,0,0,0,0,0,0,0,0,0
2392,467,2015,11,6,5,0.58,57,1096,2,3,1,2,2,1,5,2,0,0,0,1,1,1,0,0,0
2393,468,2015,7,1,6,0.09,9,1096,0,1,0,0,1,0,1,0,0,0,0,1,0,0,0,0,0
2394,469,2015,34,34,0,0.99,98,1096,18,12,4,18,6,3,27,18,0,0,0,0,6,2,1,0,0
2395,470,2015,33,17,16,0.53,52,1096,6,8,3,3,6,3,12,0,3,0,0,4,2,3,0,0,0
2396,471,2015,36,11,25,0.3,30,1096,8,3,0,5,2,0,7,4,0,0,1,1,1,0,0,0,0
2397,472,2015,31,30,1,0.96,96,1096,17,12,1,13,6,1,20,11,0,2,0,0,6,1,0,0,0
2398,473,2015,48,26,22,0.55,55,1096,14,10,2,11,5,2,18,10,0,0,1,0,5,2,0,0,0
2399,474,2015,21,20,1,0.95,94,1096,10,8,2,7,5,2,14,6,0,0,1,2,3,2,0,0,0
2400,475,2015,19,3,16,0.14,14,1096,1,2,0,1,2,0,3,1,0,0,0,2,0,0,0,0,0
2401,476,2015,20,4,16,0.19,18,1096,1,2,1,1,2,1,4,1,0,0,0,2,0,1,0,0,0
2402,477,2015,21,0,21,0.01,1,1096,0,0,0,0,0,0,0,0,0,0,0,0,0,0,0,0,0
2403,478,2015,30,20,10,0.67,66,1096,9,10,1,8,6,1,15,7,1,0,0,2,4,1,0,0,0
2404,479,2015,7,7,0,0.99,98,1096,3,3,1,3,2,1,6,3,0,0,0,1,1,1,0,0,0
2405,480,2015,45,40,5,0.89,88,1096,18,18,4,11,15,3,29,4,7,0,0,12,3,2,1,0,0
2406,481,2015,51,50,1,0.98,97,1096,21,27,2,10,21,2,33,4,2,3,1,15,6,2,0,0,0
2407,482,2015,10,3,7,0.27,26,1096,2,1,0,2,1,0,3,2,0,0,0,1,0,0,0,0,0
2408,483,2015,30,27,3,0.9,89,1096,11,14,2,3,10,1,14,0,0,1,2,6,4,0,1,0,0
2409,484,2015,9,5,4,0.6,60,1096,2,3,0,2,3,0,5,2,0,0,0,3,0,0,0,0,0
2410,485,2015,24,6,18,0.26,25,1096,3,2,1,3,2,1,6,3,0,0,0,2,0,1,0,0,0
2411,486,2015,22,1,21,0.04,4,1096,0,1,0,0,1,0,1,0,0,0,0,1,0,0,0,0,0
2412,487,2015,31,29,2,0.94,93,1096,20,6,3,12,4,2,18,6,5,0,1,2,2,1,1,0,0
2413,488,2015,8,8,0,0.98,97,1096,2,4,2,1,3,1,5,0,1,0,0,2,1,0,1,0,0
2414,489,2015,25,11,14,0.45,44,1096,5,4,2,5,3,1,9,5,0,0,0,2,1,0,1,0,0
2415,490,2015,33,16,17,0.47,47,1096,7,6,3,3,6,3,12,1,1,0,1,6,0,3,0,0,0
2416,491,2015,5,0,5,0.07,7,1096,0,0,0,0,0,0,0,0,0,0,0,0,0,0,0,0,0
2417,492,2015,7,6,1,0.89,89,1096,2,3,1,2,2,1,5,2,0,0,0,1,1,1,0,0,0
2418,493,2015,10,9,1,0.95,94,1096,4,4,1,3,4,1,8,2,1,0,0,4,0,1,0,0,0
2419,494,2015,9,4,5,0.49,48,1096,1,2,1,1,1,1,3,1,0,0,0,0,1,1,0,0,0
2420,495,2015,13,8,5,0.62,61,1096,3,4,1,3,3,1,7,3,0,0,0,2,1,1,0,0,0
2421,496,2015,50,50,0,1.0,99,1096,20,28,2,9,27,1,37,3,1,5,0,26,1,0,1,0,0
2422,497,2015,31,30,1,0.96,96,1096,9,17,4,3,14,2,19,0,1,1,1,11,3,1,0,1,0
2423,498,2015,27,26,1,0.95,94,1096,16,7,3,15,5,1,21,14,1,0,0,3,2,0,0,1,0
2424,499,2015,49,47,2,0.97,96,1096,21,22,4,18,12,4,34,17,0,0,1,2,10,4,0,0,0
2425,500,2015,40,10,30,0.25,24,1096,5,3,2,2,2,2,6,1,0,0,1,1,1,2,0,0,0
2426,501,2015,8,4,4,0.55,54,1096,1,2,1,1,2,1,4,1,0,0,0,2,0,1,0,0,0
2427,502,2015,7,2,5,0.3,29,1096,1,1,0,1,1,0,2,1,0,0,0,1,0,0,0,0,0
2428,503,2015,13,7,6,0.56,55,1096,4,2,1,3,1,1,5,2,1,0,0,0,1,1,0,0,0
2429,504,2015,35,35,0,0.99,99,1096,17,16,2,9,16,1,26,5,2,0,2,16,0,0,1,0,0
2430,505,2015,46,43,3,0.94,94,1096,31,12,0,18,9,0,27,12,2,1,3,6,3,0,0,0,0
2431,506,2015,45,16,29,0.36,35,1096,8,7,1,4,6,1,11,2,0,2,0,5,1,1,0,0,0
2432,507,2015,55,37,18,0.67,67,1096,23,12,2,8,9,1,18,1,3,0,4,6,3,0,1,0,0
2433,508,2015,11,10,1,0.94,94,1096,3,5,2,1,3,2,6,0,0,1,0,1,2,2,0,0,0
2434,509,2015,14,10,4,0.69,68,1096,2,6,2,1,4,1,6,0,1,0,0,2,2,0,1,0,0
2435,510,2015,16,14,2,0.86,85,1096,5,7,2,4,7,2,13,3,1,0,0,7,0,2,0,0,0
2436,511,2015,11,2,9,0.23,22,1096,1,1,0,1,1,0,2,1,0,0,0,1,0,0,0,0,0
2437,512,2015,32,17,15,0.53,52,1096,4,10,3,2,7,2,11,1,0,1,0,4,3,1,1,0,0
2438,513,2015,8,1,7,0.09,8,1096,0,1,0,0,1,0,1,0,0,0,0,1,0,0,0,0,0
2439,514,2015,42,37,5,0.89,89,1096,27,10,0,23,5,0,28,20,2,1,0,0,5,0,0,0,0
2440,515,2015,26,25,1,0.98,97,1096,17,5,3,8,3,3,14,3,1,4,0,1,2,3,0,0,0
2441,516,2015,29,14,15,0.49,49,1096,3,8,3,1,6,3,10,0,0,1,0,4,2,3,0,0,0
2442,517,2015,17,13,4,0.76,75,1096,8,4,1,2,3,1,6,0,0,0,2,2,1,1,0,0,0
2443,518,2015,39,37,2,0.96,95,1096,25,9,3,10,5,3,18,1,4,4,1,1,4,3,0,0,0
2444,519,2015,27,16,11,0.59,58,1096,7,9,0,3,8,0,11,1,0,2,0,7,1,0,0,0,0
2445,520,2015,51,24,27,0.48,47,1096,18,5,1,7,5,1,13,1,2,3,1,5,0,1,0,0,0
2446,521,2015,36,33,3,0.9,90,1096,19,11,3,10,10,3,23,5,1,4,0,9,1,3,0,0,0
2447,522,2015,19,7,12,0.36,35,1096,3,3,1,3,3,1,7,3,0,0,0,3,0,1,0,0,0
2448,523,2015,22,22,0,1.0,99,1096,13,9,0,4,9,0,13,0,0,3,1,9,0,0,0,0,0
2449,524,2015,32,28,4,0.89,89,1096,13,12,3,8,6,3,17,4,3,1,0,0,6,3,0,0,0
2450,525,2015,54,45,9,0.84,83,1096,28,14,3,20,7,2,29,13,6,1,0,0,7,1,1,0,0
2451,526,2015,25,25,0,1.0,100,1096,14,8,3,11,7,2,20,8,3,0,0,6,1,1,1,0,0
2452,527,2015,56,53,3,0.94,93,1096,36,16,1,30,8,1,39,26,3,0,1,0,8,1,0,0,0
2453,528,2015,17,7,10,0.39,38,1096,3,3,1,2,3,1,6,1,1,0,0,3,0,1,0,0,0
2454,529,2015,6,1,5,0.13,13,1096,0,1,0,0,1,0,1,0,0,0,0,1,0,0,0,0,0
2455,530,2015,38,13,25,0.33,33,1096,8,3,2,2,3,2,7,0,0,0,2,3,0,2,0,0,0
2456,531,2015,15,3,12,0.18,17,1096,1,2,0,1,1,0,2,1,0,0,0,0,1,0,0,0,0
2457,532,2015,18,11,7,0.6,60,1096,6,5,0,6,5,0,11,6,0,0,0,5,0,0,0,0,0
2458,533,2015,42,19,23,0.45,44,1096,13,4,2,9,4,1,14,5,4,0,0,4,0,0,1,0,0
2459,534,2015,42,28,14,0.66,65,1096,13,11,4,12,10,3,25,11,1,0,0,9,1,2,1,0,0
2460,535,2015,9,0,9,0.01,1,1096,0,0,0,0,0,0,0,0,0,0,0,0,0,0,0,0,0
2461,536,2015,31,14,17,0.45,45,1096,5,6,3,2,4,1,7,1,0,0,1,2,2,0,0,1,0
2462,537,2015,32,7,25,0.23,23,1096,4,3,0,1,2,0,3,0,0,0,1,1,1,0,0,0,0
2463,538,2015,12,11,1,0.91,90,1096,8,2,1,4,1,1,6,2,1,0,1,0,1,1,0,0,0
2464,539,2015,8,7,1,0.87,86,1096,2,4,1,2,4,1,7,2,0,0,0,4,0,1,0,0,0
2465,540,2015,24,4,20,0.16,16,1096,2,2,0,1,2,0,3,0,1,0,0,2,0,0,0,0,0
2466,541,2015,39,11,28,0.29,29,1096,5,4,2,5,4,2,11,5,0,0,0,4,0,2,0,0,0
2467,542,2015,51,48,3,0.94,93,1096,16,29,3,8,27,1,36,2,5,0,1,25,2,0,0,1,0
2468,543,2015,22,8,14,0.39,38,1096,2,5,1,1,5,1,7,0,1,0,0,5,0,1,0,0,0
2469,544,2015,13,1,12,0.05,5,1096,0,1,0,0,1,0,1,0,0,0,0,1,0,0,0,0,0
2470,545,2015,32,30,2,0.95,94,1096,17,12,1,13,12,1,26,9,4,0,0,12,0,1,0,0,0
2471,546,2015,54,29,25,0.54,54,1096,19,8,2,13,4,2,19,9,2,2,0,0,4,2,0,0,0
2472,547,2015,52,47,5,0.91,90,1096,35,9,3,31,9,3,43,29,1,0,1,9,0,3,0,0,0
2473,548,2015,40,40,0,0.99,99,1096,25,15,0,10,10,0,20,1,5,2,2,5,5,0,0,0,0
2474,549,2015,23,23,0,1.0,99,1096,16,7,0,10,6,0,16,8,0,0,2,5,1,0,0,0,0
2475,550,2015,22,22,0,1.0,99,1096,11,8,3,8,6,2,16,7,0,0,1,4,2,1,1,0,0
2476,551,2015,11,10,1,0.92,91,1096,3,4,3,1,3,3,7,0,0,1,0,2,1,3,0,0,0
2477,552,2015,39,4,35,0.11,10,1096,1,2,1,1,1,1,3,1,0,0,0,0,1,1,0,0,0
2478,553,2015,46,6,40,0.12,11,1096,2,3,1,1,2,1,4,0,1,0,0,1,1,1,0,0,0
2479,554,2015,40,23,17,0.57,57,1096,17,5,1,8,4,1,13,2,3,3,0,3,1,1,0,0,0
2480,555,2015,16,15,1,0.95,94,1096,9,4,2,5,4,1,10,3,1,0,1,4,0,0,1,0,0
2481,556,2015,10,10,0,1.0,99,1096,7,2,1,7,2,1,10,7,0,0,0,2,0,1,0,0,0
2482,557,2015,56,53,3,0.94,93,1096,25,25,3,23,14,1,38,21,2,0,0,3,11,0,0,1,0
2483,558,2015,38,38,0,1.0,99,1096,22,14,2,14,13,2,29,8,5,0,1,12,1,2,0,0,0
2484,559,2015,45,45,0,1.0,99,1096,32,11,2,21,10,1,32,13,5,3,0,9,1,0,1,0,0
2485,560,2015,37,35,2,0.96,95,1096,17,14,4,14,9,4,27,11,3,0,0,4,5,4,0,0,0
2486,561,2015,16,16,0,1.0,100,1096,6,7,3,4,7,1,12,2,2,0,0,7,0,0,0,1,0
2487,562,2015,27,15,12,0.55,55,1096,5,7,3,3,4,1,8,1,2,0,0,1,3,0,0,1,0
2488,563,2015,36,17,19,0.48,48,1096,9,5,3,9,5,3,17,9,0,0,0,5,0,3,0,0,0
2489,564,2015,60,49,11,0.82,81,1096,34,15,0,34,15,0,49,34,0,0,0,15,0,0,0,0,0
2490,565,2015,9,2,7,0.19,19,1096,1,1,0,1,1,0,2,1,0,0,0,1,0,0,0,0,0
2491,566,2015,16,7,9,0.46,46,1096,4,2,1,1,2,1,4,0,0,0,1,2,0,1,0,0,0
2492,567,2015,32,2,30,0.06,5,1096,1,1,0,1,1,0,2,1,0,0,0,1,0,0,0,0,0
2493,568,2015,12,11,1,0.95,95,1096,6,4,1,3,4,1,8,2,0,0,1,4,0,1,0,0,0
2494,569,2015,41,41,0,0.99,99,1096,17,21,3,8,11,1,20,2,4,1,1,1,10,0,0,1,0
2495,570,2015,47,47,0,1.0,99,1096,22,25,0,21,16,0,37,20,1,0,0,7,9,0,0,0,0
2496,571,2015,6,0,6,0.03,2,1096,0,0,0,0,0,0,0,0,0,0,0,0,0,0,0,0,0
2497,572,2015,11,10,1,0.89,89,1096,7,3,0,7,3,0,10,7,0,0,0,3,0,0,0,0,0
2498,573,2015,35,33,2,0.94,93,1096,19,12,2,15,7,2,24,13,1,0,1,2,5,2,0,0,0
2499,574,2015,27,23,4,0.87,86,1096,10,13,0,10,10,0,20,10,0,0,0,7,3,0,0,0,0
2500,575,2015,26,25,1,0.97,96,1096,9,14,2,8,11,2,21,7,1,0,0,8,3,2,0,0,0
2501,576,2015,42,42,0,0.99,98,1096,28,13,1,11,11,1,23,2,1,8,0,9,2,1,0,0,0
2502,577,2015,12,1,11,0.11,11,1096,0,1,0,0,1,0,1,0,0,0,0,1,0,0,0,0,0
2503,578,2015,13,0,13,0.03,3,1096,0,0,0,0,0,0,0,0,0,0,0,0,0,0,0,0,0
2504,579,2015,34,23,11,0.68,67,1096,15,5,3,9,4,1,14,4,4,1,0,3,1,0,0,1,0
2505,580,2015,19,14,5,0.74,74,1096,3,8,3,1,5,1,7,0,0,1,0,2,3,0,0,1,0
2506,581,2015,9,9,0,0.99,98,1096,3,5,1,1,3,1,5,0,0,1,0,1,2,1,0,0,0
2507,582,2015,33,27,6,0.82,82,1096,11,13,3,9,12,3,24,8,0,1,0,11,1,3,0,0,0
2508,583,2015,10,5,5,0.54,53,1096,2,2,1,1,2,1,4,0,1,0,0,2,0,1,0,0,0
2509,584,2015,38,28,10,0.74,74,1096,13,12,3,12,8,3,23,11,1,0,0,4,4,3,0,0,0
2510,585,2015,14,4,10,0.29,28,1096,1,2,1,1,1,1,3,1,0,0,0,0,1,1,0,0,0
2511,586,2015,34,11,23,0.33,33,1096,8,2,1,4,1,1,6,0,4,0,0,0,1,1,0,0,0
2512,587,2015,17,17,0,1.0,99,1096,8,5,4,8,4,3,15,8,0,0,0,3,1,2,1,0,0
2513,588,2015,27,27,0,0.99,98,1096,8,15,4,7,9,1,17,6,1,0,0,3,6,0,0,0,1
2514,589,2015,43,43,0,1.0,100,1096,31,12,0,11,9,0,20,0,2,9,0,6,3,0,0,0,0
2515,590,2015,24,16,8,0.67,67,1096,7,9,0,6,8,0,14,5,1,0,0,7,1,0,0,0,0
2516,591,2015,15,15,0,1.0,99,1096,6,5,4,4,3,4,11,3,0,1,0,1,2,4,0,0,0
2517,592,2015,5,4,1,0.88,87,1096,1,2,1,1,2,1,4,1,0,0,0,2,0,1,0,0,0
2518,593,2015,8,8,0,0.94,93,1096,5,3,0,5,2,0,7,5,0,0,0,1,1,0,0,0,0
2519,594,2015,55,42,13,0.77,77,1096,26,13,3,8,13,3,24,0,2,2,4,13,0,3,0,0,0
2520,595,2015,20,6,14,0.29,28,1096,2,3,1,1,2,1,4,0,1,0,0,1,1,1,0,0,0
2521,596,2015,12,11,1,0.91,90,1096,8,2,1,2,1,1,4,0,0,0,2,0,1,1,0,0,0
2522,597,2015,29,2,27,0.05,5,1096,1,1,0,1,1,0,2,1,0,0,0,1,0,0,0,0,0
2523,598,2015,12,9,3,0.75,75,1096,4,4,1,1,2,1,4,0,0,0,1,0,2,1,0,0,0
2524,599,2015,17,7,10,0.4,40,1096,2,3,2,2,3,2,7,2,0,0,0,3,0,2,0,0,0
2525,600,2015,16,11,5,0.7,70,1096,6,3,2,5,2,1,8,4,1,0,0,1,1,0,1,0,0
2526,601,2015,28,22,6,0.79,79,1096,7,11,4,4,11,4,19,1,3,0,0,11,0,4,0,0,0
2527,602,2015,8,7,1,0.85,85,1096,3,4,0,1,4,0,5,0,0,1,0,4,0,0,0,0,0
2528,603,2015,59,58,1,0.98,97,1096,39,17,2,31,11,1,43,26,3,1,1,5,6,0,1,0,0
2529,604,2015,44,32,12,0.74,73,1096,9,19,4,9,15,1,25,9,0,0,0,11,4,0,0,0,1
2530,605,2015,48,9,39,0.19,19,1096,4,3,2,2,3,1,6,1,0,1,0,3,0,0,1,0,0
2531,606,2015,35,32,3,0.9,90,1096,15,15,2,4,15,2,21,0,0,1,3,15,0,2,0,0,0
2532,607,2015,40,22,18,0.55,55,1096,12,7,3,5,6,2,13,1,1,3,0,5,1,1,1,0,0
2533,608,2015,6,3,3,0.43,43,1096,1,2,0,1,1,0,2,1,0,0,0,0,1,0,0,0,0
2534,609,2015,15,15,0,0.98,97,1096,11,3,1,6,3,1,10,4,0,1,1,3,0,1,0,0,0
2535,610,2015,9,1,8,0.08,8,1096,0,1,0,0,1,0,1,0,0,0,0,1,0,0,0,0,0
2536,611,2015,48,10,38,0.2,20,1096,7,2,1,5,2,1,8,4,0,1,0,2,0,1,0,0,0
2537,612,2015,12,11,1,0.95,94,1096,6,4,1,2,3,1,6,0,1,0,1,2,1,1,0,0,0
2538,613,2015,12,10,2,0.81,80,1096,2,6,2,1,5,1,7,0,1,0,0,4,1,0,1,0,0
2539,614,2015,6,6,0,1.0,100,1096,2,3,1,1,3,1,5,0,1,0,0,3,0,1,0,0,0
2540,615,2015,27,27,0,0.99,98,1096,12,12,3,6,12,2,20,1,4,1,0,12,0,1,1,0,0
2541,616,2015,30,6,24,0.19,18,1096,4,2,0,4,1,0,5,4,0,0,0,0,1,0,0,0,0
2542,617,2015,14,13,1,0.93,93,1096,4,6,3,1,6,1,8,0,0,0,1,6,0,0,0,1,0
2543,618,2015,6,5,1,0.9,89,1096,3,2,0,1,2,0,3,0,0,1,0,2,0,0,0,0,0
2544,619,2015,17,1,16,0.05,5,1096,0,1,0,0,1,0,1,0,0,0,0,1,0,0,0,0,0
2545,620,2015,18,17,1,0.96,95,1096,12,4,1,4,2,1,7,0,0,4,0,0,2,1,0,0,0
2546,621,2015,9,9,0,1.0,99,1096,3,5,1,3,5,1,9,3,0,0,0,5,0,1,0,0,0
2547,622,2015,32,1,31,0.04,4,1096,0,1,0,0,1,0,1,0,0,0,0,1,0,0,0,0,0
2548,623,2015,52,24,28,0.46,45,1096,15,6,3,4,3,3,10,0,0,1,3,0,3,3,0,0,0
2549,624,2015,20,17,3,0.87,86,1096,7,8,2,2,7,2,11,0,0,1,1,6,1,2,0,0,0
2550,625,2015,33,32,1,0.98,98,1096,12,19,1,5,19,1,25,1,2,1,1,19,0,1,0,0,0
2551,626,2015,13,13,0,0.99,99,1096,3,7,3,1,6,2,9,0,0,1,0,5,1,1,1,0,0
2552,627,2015,17,16,1,0.95,95,1096,8,5,3,2,5,2,9,0,0,0,2,5,0,1,1,0,0
2553,628,2015,13,13,0,1.0,100,1096,5,7,1,2,5,1,8,0,1,1,0,3,2,1,0,0,0
2554,629,2015,33,33,0,1.0,99,1096,22,10,1,11,6,1,18,6,1,2,2,2,4,1,0,0,0
2555,630,2015,15,5,10,0.36,36,1096,2,2,1,1,2,1,4,0,1,0,0,2,0,1,0,0,0
2556,631,2015,58,40,18,0.68,68,1096,22,15,3,8,10,1,19,1,1,5,1,5,5,0,0,1,0
2557,632,2015,9,8,1,0.86,86,1096,5,2,1,2,2,1,5,0,1,1,0,2,0,1,0,0,0
2558,633,2015,9,6,3,0.72,71,1096,3,2,1,2,1,1,4,1,1,0,0,0,1,1,0,0,0
2559,634,2015,6,4,2,0.66,65,1096,2,2,0,2,2,0,4,2,0,0,0,2,0,0,0,0,0
2560,635,2015,24,19,5,0.78,78,1096,10,6,3,5,3,1,9,2,1,2,0,0,3,0,0,1,0
2561,636,2015,15,3,12,0.21,20,1096,2,1,0,2,1,0,3,2,0,0,0,1,0,0,0,0,0
2562,637,2015,23,23,0,1.0,99,1096,10,12,1,5,11,1,17,3,0,1,1,10,1,1,0,0,0
2563,638,2015,29,28,1,0.96,95,1096,19,8,1,9,6,1,16,0,8,1,0,4,2,1,0,0,0
2564,639,2015,7,3,4,0.39,39,1096,1,2,0,1,1,0,2,1,0,0,0,0,1,0,0,0,0
2565,640,2015,13,7,6,0.57,57,1096,3,3,1,2,3,1,6,1,1,0,0,3,0,1,0,0,0
2566,641,2015,6,3,3,0.55,54,1096,1,2,0,1,2,0,3,1,0,0,0,2,0,0,0,0,0
2567,642,2015,28,28,0,1.0,99,1096,18,8,2,5,5,2,12,0,0,2,3,2,3,2,0,0,0
2568,643,2015,56,24,32,0.42,42,1096,8,13,3,5,12,3,20,2,3,0,0,11,1,3,0,0,0
2569,644,2015,11,11,0,0.99,98,1096,3,5,3,1,3,3,7,0,0,1,0,1,2,3,0,0,0
2570,645,2015,23,15,8,0.63,63,1096,8,7,0,3,4,0,7,0,2,0,1,1,3,0,0,0,0
2571,646,2015,58,3,55,0.05,5,1096,1,2,0,1,2,0,3,1,0,0,0,2,0,0,0,0,0
2572,647,2015,32,9,23,0.28,27,1096,2,5,2,1,3,2,6,0,1,0,0,1,2,2,0,0,0
2573,648,2015,34,22,12,0.64,63,1096,12,10,0,5,7,0,12,2,1,0,2,4,3,0,0,0,0
2574,649,2015,27,27,0,0.99,98,1096,19,7,1,9,5,1,15,2,5,1,1,3,2,1,0,0,0
2575,650,2015,37,37,0,1.0,100,1096,27,6,4,23,3,2,28,21,1,0,1,0,3,0,2,0,0
2576,651,2015,26,8,18,0.32,32,1096,3,4,1,2,3,1,6,1,1,0,0,2,1,1,0,0,0
2577,652,2015,40,32,8,0.8,79,1096,12,19,1,10,14,1,25,9,0,1,0,9,5,1,0,0,0
2578,653,2015,14,13,1,0.94,94,1096,8,3,2,5,3,1,9,3,1,1,0,3,0,0,1,0,0
2579,654,2015,40,14,26,0.35,35,1096,8,5,1,8,4,1,13,8,0,0,0,3,1,1,0,0,0
2580,655,2015,50,49,1,0.99,98,1096,24,22,3,14,11,3,28,7,5,1,1,0,11,3,0,0,0
2581,656,2015,47,46,1,0.98,97,1096,26,16,4,24,10,1,35,22,2,0,0,4,6,0,0,0,1
2582,657,2015,32,32,0,0.99,99,1096,12,17,3,11,10,2,23,10,1,0,0,3,7,1,1,0,0
2583,658,2015,12,3,9,0.25,25,1096,1,2,0,1,2,0,3,1,0,0,0,2,0,0,0,0,0
2584,659,2015,38,36,2,0.94,93,1096,26,9,1,10,5,1,16,2,4,0,4,1,4,1,0,0,0
2585,660,2015,21,11,10,0.53,53,1096,3,5,3,2,4,3,9,1,1,0,0,3,1,3,0,0,0
2586,661,2015,37,26,11,0.71,71,1096,15,8,3,14,7,1,22,13,1,0,0,6,1,0,0,1,0
2587,662,2015,29,28,1,0.96,95,1096,14,11,3,5,8,3,16,1,0,3,1,5,3,3,0,0,0
2588,663,2015,39,11,28,0.29,28,1096,4,4,3,1,4,3,8,0,0,0,1,4,0,3,0,0,0
2589,664,2015,45,2,43,0.03,3,1096,1,1,0,1,1,0,2,1,0,0,0,1,0,0,0,0,0
2590,665,2015,28,24,4,0.85,84,1096,14,7,3,14,5,1,20,14,0,0,0,3,2,0,0,1,0
2591,666,2015,24,6,18,0.25,24,1096,2,3,1,1,3,1,5,0,1,0,0,3,0,1,0,0,0
2592,667,2015,30,10,20,0.34,33,1096,3,4,3,3,3,3,9,3,0,0,0,2,1,3,0,0,0
2593,668,2015,38,29,9,0.75,75,1096,20,5,4,17,4,2,23,15,1,1,0,3,1,0,2,0,0
2594,669,2015,42,14,28,0.32,32,1096,9,3,2,3,3,2,8,0,0,3,0,3,0,2,0,0,0
2595,670,2015,14,11,3,0.78,78,1096,3,6,2,3,6,2,11,3,0,0,0,6,0,2,0,0,0
2596,671,2015,47,47,0,1.0,99,1096,34,12,1,14,6,1,21,2,8,0,4,0,6,1,0,0,0
2597,672,2015,41,18,23,0.44,44,1096,13,4,1,13,4,1,18,13,0,0,0,4,0,1,0,0,0
2598,673,2015,14,6,8,0.44,44,1096,4,2,0,3,2,0,5,2,1,0,0,2,0,0,0,0,0
2599,674,2015,24,22,2,0.91,90,1096,13,7,2,13,6,2,21,13,0,0,0,5,1,2,0,0,0
2600,675,2015,9,9,0,1.0,99,1096,4,3,2,1,3,1,5,0,0,0,1,3,0,0,1,0,0
2601,676,2015,19,18,1,0.96,96,1096,4,11,3,2,11,3,16,1,0,1,0,11,0,3,0,0,0
2602,677,2015,11,9,2,0.84,84,1096,3,4,2,1,4,2,7,0,0,1,0,4,0,2,0,0,0
2603,678,2015,26,26,0,1.0,99,1096,19,6,1,10,4,1,15,2,7,1,0,2,2,1,0,0,0
2604,679,2015,22,22,0,0.99,98,1096,12,8,2,8,7,1,16,6,0,2,0,6,1,0,1,0,0
2605,680,2015,25,1,24,0.03,2,1096,0,1,0,0,1,0,1,0,0,0,0,1,0,0,0,0,0
2606,681,2015,40,40,0,1.0,100,1096,27,12,1,24,8,1,33,22,1,1,0,4,4,1,0,0,0
2607,682,2015,38,38,0,1.0,99,1096,23,13,2,6,8,1,15,0,0,1,5,3,5,0,1,0,0
2608,683,2015,5,4,1,0.87,87,1096,1,2,1,1,2,1,4,1,0,0,0,2,0,1,0,0,0
2609,684,2015,27,20,7,0.76,75,1096,11,7,2,11,6,2,19,11,0,0,0,5,1,2,0,0,0
2610,685,2015,14,9,5,0.66,66,1096,6,2,1,5,2,1,8,4,1,0,0,2,0,1,0,0,0
2611,686,2015,26,12,14,0.44,44,1096,7,4,1,4,2,1,7,3,0,0,1,0,2,1,0,0,0
2612,687,2015,20,19,1,0.93,93,1096,9,6,4,6,5,1,12,5,0,0,1,4,1,0,0,0,1
2613,688,2015,13,2,11,0.15,14,1096,1,1,0,1,1,0,2,1,0,0,0,1,0,0,0,0,0
2614,689,2015,46,45,1,0.98,97,1096,28,16,1,25,11,1,37,23,1,1,0,6,5,1,0,0,0
2615,690,2015,46,42,4,0.92,91,1096,22,19,1,8,12,1,21,0,2,6,0,5,7,1,0,0,0
2616,691,2015,31,2,29,0.08,8,1096,1,1,0,1,1,0,2,1,0,0,0,1,0,0,0,0,0
2617,692,2015,28,24,4,0.85,85,1096,18,4,2,5,2,2,9,0,1,0,4,0,2,2,0,0,0
2618,693,2015,15,15,0,1.0,100,1096,6,7,2,5,7,1,13,4,1,0,0,7,0,0,1,0,0
2619,694,2015,55,52,3,0.95,94,1096,33,18,1,14,15,1,30,5,3,2,4,12,3,1,0,0,0
2620,695,2015,36,15,21,0.4,40,1096,6,6,3,2,3,3,8,0,1,0,1,0,3,3,0,0,0
2621,696,2015,27,3,24,0.09,9,1096,2,1,0,2,1,0,3,2,0,0,0,1,0,0,0,0,0
2622,697,2015,31,23,8,0.73,73,1096,16,4,3,15,4,1,20,14,1,0,0,4,0,0,0,1,0
2623,698,2015,44,41,3,0.93,92,1096,30,9,2,23,8,1,32,16,7,0,0,7,1,0,1,0,0
2624,699,2015,34,33,1,0.98,97,1096,21,12,0,21,8,0,29,21,0,0,0,4,4,0,0,0,0
2625,700,2015,40,28,12,0.71,70,1096,14,13,1,5,12,1,18,0,3,0,2,11,1,1,0,0,0
2626,701,2015,31,30,1,0.98,97,1096,11,18,1,5,14,1,20,2,1,1,1,10,4,1,0,0,0
2627,702,2015,44,38,6,0.85,85,1096,28,7,3,19,6,2,27,15,1,1,2,5,1,1,1,0,0
2628,703,2015,34,34,0,1.0,99,1096,24,8,2,22,7,1,30,20,2,0,0,6,1,0,1,0,0
2629,704,2015,32,6,26,0.18,17,1096,3,2,1,3,2,1,6,3,0,0,0,2,0,1,0,0,0
2630,705,2015,6,3,3,0.44,43,1096,1,2,0,1,1,0,2,1,0,0,0,0,1,0,0,0,0
2631,706,2015,17,2,15,0.1,10,1096,1,1,0,1,1,0,2,1,0,0,0,1,0,0,0,0,0
2632,707,2015,29,27,2,0.94,93,1096,15,8,4,8,4,3,15,5,1,0,2,0,4,2,1,0,0
2633,708,2015,39,28,11,0.72,71,1096,9,16,3,6,15,2,23,3,3,0,0,14,1,1,1,0,0
2634,709,2015,42,30,12,0.72,72,1096,18,12,0,11,7,0,18,7,1,3,0,2,5,0,0,0,0
2635,710,2015,20,6,14,0.3,29,1096,3,2,1,3,2,1,6,3,0,0,0,2,0,1,0,0,0
2636,711,2015,5,4,1,0.75,75,1096,1,2,1,1,2,1,4,1,0,0,0,2,0,1,0,0,0
2637,712,2015,48,41,7,0.84,84,1096,26,12,3,17,9,2,28,13,1,1,2,6,3,1,1,0,0
2638,713,2015,24,17,7,0.69,69,1096,12,3,2,12,3,2,17,12,0,0,0,3,0,2,0,0,0
2639,714,2015,30,24,6,0.81,80,1096,15,6,3,5,6,3,14,0,2,1,2,6,0,3,0,0,0
2640,715,2015,47,12,35,0.25,25,1096,7,4,1,7,2,1,10,7,0,0,0,0,2,1,0,0,0
2641,716,2015,34,29,5,0.85,85,1096,19,8,2,16,4,1,21,15,0,0,1,0,4,0,1,0,0
2642,717,2015,32,30,2,0.94,93,1096,11,17,2,7,10,1,18,5,1,0,1,3,7,0,1,0,0
2643,718,2015,35,31,4,0.88,88,1096,12,16,3,9,13,2,24,8,0,0,1,10,3,1,1,0,0
2644,719,2015,39,31,8,0.81,80,1096,15,13,3,6,12,1,19,1,3,0,2,11,1,0,0,1,0
2645,720,2015,7,2,5,0.22,22,1096,1,1,0,1,1,0,2,1,0,0,0,1,0,0,0,0,0
2646,721,2015,38,37,1,0.97,97,1096,21,12,4,7,9,1,17,0,1,5,1,6,3,0,0,0,1
2647,722,2015,24,18,6,0.73,73,1096,6,9,3,3,6,3,12,1,1,1,0,3,3,3,0,0,0
2648,723,2015,8,5,3,0.59,58,1096,1,3,1,1,3,1,5,1,0,0,0,3,0,1,0,0,0
2649,724,2015,24,13,11,0.56,56,1096,7,5,1,3,3,1,7,1,1,0,1,1,2,1,0,0,0
2650,725,2015,26,9,17,0.33,33,1096,3,4,2,3,4,2,9,3,0,0,0,4,0,2,0,0,0
2651,726,2015,28,28,0,1.0,99,1096,19,9,0,16,9,0,25,15,0,0,1,9,0,0,0,0,0
2652,727,2015,24,22,2,0.91,91,1096,11,7,4,3,6,2,11,0,0,1,2,5,1,0,2,0,0
2653,728,2015,28,20,8,0.72,72,1096,9,9,2,6,8,2,16,3,3,0,0,7,1,2,0,0,0
2654,729,2015,24,20,4,0.83,83,1096,13,7,0,12,7,0,19,11,1,0,0,7,0,0,0,0,0
2655,730,2015,30,2,28,0.07,6,1096,1,1,0,1,1,0,2,1,0,0,0,1,0,0,0,0,0
2656,731,2015,51,38,13,0.75,75,1096,26,8,4,19,7,3,29,16,1,0,2,6,1,2,1,0,0
2657,732,2015,9,8,1,0.89,88,1096,3,3,2,3,3,1,7,3,0,0,0,3,0,0,1,0,0
2658,733,2015,10,10,0,0.99,99,1096,3,5,2,2,4,1,7,1,1,0,0,3,1,0,1,0,0
2659,734,2015,34,23,11,0.67,67,1096,12,8,3,5,6,1,12,1,2,1,1,4,2,0,0,1,0
2660,735,2015,18,13,5,0.72,71,1096,6,4,3,2,2,2,6,0,0,2,0,0,2,1,1,0,0
2661,736,2015,31,18,13,0.58,57,1096,10,7,1,8,6,1,15,7,0,1,0,5,1,1,0,0,0
2662,737,2015,49,46,3,0.94,93,1096,21,23,2,16,13,2,31,14,0,1,1,3,10,2,0,0,0
2663,738,2015,31,27,4,0.87,86,1096,16,10,1,14,8,1,23,12,2,0,0,6,2,1,0,0,0
2664,739,2015,36,32,4,0.88,87,1096,18,13,1,11,11,1,23,8,1,0,2,9,2,1,0,0,0
2665,740,2015,46,46,0,1.0,100,1096,32,12,2,12,7,2,21,0,6,4,2,2,5,2,0,0,0
2666,741,2015,15,6,9,0.42,41,1096,3,3,0,3,2,0,5,3,0,0,0,1,1,0,0,0,0
2667,742,2015,46,42,4,0.91,91,1096,23,18,1,7,17,1,25,0,2,1,4,16,1,1,0,0,0
2668,743,2015,47,5,42,0.11,11,1096,3,2,0,3,1,0,4,3,0,0,0,0,1,0,0,0,0
2669,744,2015,16,10,6,0.63,62,1096,3,5,2,1,4,1,6,0,0,1,0,3,1,0,1,0,0
2670,745,2015,36,12,24,0.34,33,1096,8,3,1,5,3,1,9,4,0,0,1,3,0,1,0,0,0
2671,746,2015,31,25,6,0.81,81,1096,15,9,1,10,8,1,19,7,1,2,0,7,1,1,0,0,0
2672,747,2015,8,8,0,1.0,99,1096,4,3,1,4,3,1,8,4,0,0,0,3,0,1,0,0,0
2673,748,2015,32,31,1,0.96,96,1096,12,17,2,6,17,2,25,2,3,0,1,17,0,2,0,0,0
2674,749,2015,7,7,0,0.99,98,1096,4,3,0,3,2,0,5,2,1,0,0,1,1,0,0,0,0
2675,750,2015,36,35,1,0.97,96,1096,20,14,1,16,7,1,24,14,1,0,1,0,7,1,0,0,0
2676,751,2015,31,2,29,0.08,7,1096,1,1,0,1,1,0,2,1,0,0,0,1,0,0,0,0,0
2677,752,2015,20,8,12,0.38,38,1096,4,3,1,2,2,1,5,1,0,1,0,1,1,1,0,0,0
2678,753,2015,21,12,9,0.57,56,1096,6,5,1,4,4,1,9,3,0,1,0,3,1,1,0,0,0
2679,754,2015,6,1,5,0.19,18,1096,0,1,0,0,1,0,1,0,0,0,0,1,0,0,0,0,0
2680,755,2015,30,6,24,0.21,20,1096,3,2,1,2,1,1,4,1,1,0,0,0,1,1,0,0,0
2681,756,2015,25,22,3,0.88,88,1096,10,9,3,3,8,3,14,0,1,0,2,7,1,3,0,0,0
2682,757,2015,38,37,1,0.98,98,1096,28,8,1,22,7,1,30,20,0,0,2,6,1,1,0,0,0
2683,758,2015,43,17,26,0.4,40,1096,7,7,3,2,7,1,10,0,0,1,1,7,0,0,0,1,0
2684,759,2015,27,16,11,0.59,59,1096,11,5,0,3,4,0,7,0,0,1,2,3,1,0,0,0,0
2685,760,2015,16,4,12,0.25,24,1096,1,2,1,1,1,1,3,1,0,0,0,0,1,1,0,0,0
2686,761,2015,15,14,1,0.94,93,1096,9,3,2,7,2,1,10,6,0,1,0,1,1,0,1,0,0
2687,762,2015,43,18,25,0.43,42,1096,12,5,1,7,4,1,12,4,1,2,0,3,1,1,0,0,0
2688,763,2015,52,51,1,0.98,98,1096,33,14,4,14,8,2,24,6,1,3,4,2,6,1,0,1,0
2689,764,2015,28,3,25,0.1,9,1096,2,1,0,2,1,0,3,2,0,0,0,1,0,0,0,0,0
2690,765,2015,36,14,22,0.38,38,1096,6,6,2,4,4,2,10,2,2,0,0,2,2,2,0,0,0
2691,766,2015,15,11,4,0.75,74,1096,6,3,2,3,3,1,7,0,3,0,0,3,0,0,1,0,0
2692,767,2015,34,13,21,0.38,37,1096,7,4,2,4,2,1,7,3,0,0,1,0,2,0,1,0,0
2693,768,2015,7,5,2,0.68,68,1096,4,1,0,2,1,0,3,0,2,0,0,1,0,0,0,0,0
2694,769,2015,20,19,1,0.95,95,1096,10,7,2,6,6,1,13,2,4,0,0,5,1,0,1,0,0
2695,770,2015,40,1,39,0.03,3,1096,0,1,0,0,1,0,1,0,0,0,0,1,0,0,0,0,0
2696,771,2015,40,14,26,0.34,34,1096,4,8,2,3,8,1,12,2,1,0,0,8,0,0,1,0,0
2697,772,2015,18,1,17,0.03,3,1096,0,1,0,0,1,0,1,0,0,0,0,1,0,0,0,0,0
2698,773,2015,39,8,31,0.21,20,1096,4,3,1,1,2,1,4,0,0,0,1,1,1,1,0,0,0
2699,774,2015,10,8,2,0.77,77,1096,5,3,0,3,3,0,6,1,2,0,0,3,0,0,0,0,0
2700,775,2015,6,0,6,0.06,5,1096,0,0,0,0,0,0,0,0,0,0,0,0,0,0,0,0,0
2701,776,2015,18,8,10,0.45,45,1096,5,3,0,4,2,0,6,3,1,0,0,1,1,0,0,0,0
2702,777,2015,13,13,0,1.0,99,1096,6,4,3,6,3,3,12,6,0,0,0,2,1,3,0,0,0
2703,778,2015,50,19,31,0.38,37,1096,10,5,4,8,5,4,17,6,2,0,0,5,0,4,0,0,0
2704,779,2015,55,41,14,0.75,75,1096,15,22,4,10,12,4,26,7,2,0,1,2,10,4,0,0,0
2705,780,2015,34,30,4,0.87,86,1096,15,13,2,4,8,1,13,0,0,1,3,3,5,0,1,0,0
2706,781,2015,25,21,4,0.82,82,1096,15,5,1,8,5,1,14,3,3,2,0,5,0,1,0,0,0
2707,782,2015,49,49,0,1.0,99,1096,24,22,3,9,14,2,25,2,1,4,2,6,8,1,1,0,0
2708,783,2015,17,15,2,0.88,87,1096,5,7,3,5,7,3,15,5,0,0,0,7,0,3,0,0,0
2709,784,2015,47,39,8,0.82,81,1096,26,11,2,8,8,2,18,2,0,0,6,5,3,2,0,0,0
2710,785,2015,6,0,6,0.01,1,1096,0,0,0,0,0,0,0,0,0,0,0,0,0,0,0,0,0
2711,786,2015,39,38,1,0.97,96,1096,28,7,3,16,4,3,23,10,2,2,2,1,3,3,0,0,0
2712,787,2015,37,35,2,0.95,94,1096,24,9,2,18,8,2,28,14,2,2,0,7,1,2,0,0,0
2713,788,2015,30,22,8,0.72,72,1096,13,6,3,11,3,1,15,10,0,1,0,0,3,0,0,1,0
2714,789,2015,23,7,16,0.29,28,1096,3,3,1,2,2,1,5,1,1,0,0,1,1,1,0,0,0
2715,790,2015,35,15,20,0.43,43,1096,10,4,1,8,3,1,12,7,0,1,0,2,1,1,0,0,0
2716,791,2015,18,16,2,0.87,87,1096,9,6,1,3,6,1,10,1,0,0,2,6,0,1,0,0,0
2717,792,2015,40,40,0,1.0,99,1096,14,23,3,5,21,3,29,1,1,1,2,19,2,3,0,0,0
2718,793,2015,16,14,2,0.85,84,1096,8,6,0,3,3,0,6,0,2,0,1,0,3,0,0,0,0
2719,794,2015,8,7,1,0.86,85,1096,3,3,1,1,2,1,4,0,0,1,0,1,1,1,0,0,0
2720,795,2015,33,17,16,0.52,51,1096,8,7,2,5,7,1,13,2,3,0,0,7,0,0,1,0,0
2721,796,2015,14,12,2,0.87,87,1096,3,6,3,2,5,2,9,1,1,0,0,4,1,1,1,0,0
2722,797,2015,55,5,50,0.1,9,1096,2,2,1,2,1,1,4,2,0,0,0,0,1,1,0,0,0
2723,798,2015,24,23,1,0.97,97,1096,15,8,0,5,8,0,13,0,0,5,0,8,0,0,0,0,0
2724,799,2015,36,16,20,0.44,44,1096,9,4,3,4,4,3,11,2,0,1,1,4,0,3,0,0,0
2725,800,2015,30,18,12,0.6,59,1096,11,7,0,8,4,0,12,5,3,0,0,1,3,0,0,0,0
2726,801,2015,38,9,29,0.23,23,1096,3,5,1,2,4,1,7,1,1,0,0,3,1,1,0,0,0
2727,802,2015,38,38,0,1.0,99,1096,17,18,3,9,9,2,20,3,4,2,0,0,9,1,1,0,0
2728,803,2015,36,36,0,0.99,99,1096,14,20,2,5,18,2,25,0,2,2,1,16,2,2,0,0,0
2729,804,2015,35,33,2,0.94,93,1096,24,7,2,18,5,1,24,12,6,0,0,3,2,0,1,0,0
2730,805,2015,59,47,12,0.79,79,1096,30,16,1,14,10,1,25,4,4,6,0,4,6,1,0,0,0
2731,806,2015,12,0,12,0.03,3,1096,0,0,0,0,0,0,0,0,0,0,0,0,0,0,0,0,0
2732,807,2015,28,22,6,0.8,80,1096,10,9,3,8,9,1,18,6,2,0,0,9,0,0,0,1,0
2733,808,2015,22,0,22,0.01,1,1096,0,0,0,0,0,0,0,0,0,0,0,0,0,0,0,0,0
2734,809,2015,34,18,16,0.52,52,1096,8,9,1,7,6,1,14,6,1,0,0,3,3,1,0,0,0
2735,810,2015,38,38,0,1.0,99,1096,25,11,2,25,11,2,38,25,0,0,0,11,0,2,0,0,0
2736,811,2015,14,2,12,0.16,15,1096,1,1,0,1,1,0,2,1,0,0,0,1,0,0,0,0,0
2737,812,2015,40,1,39,0.03,2,1096,0,1,0,0,1,0,1,0,0,0,0,1,0,0,0,0,0
2738,813,2015,52,48,4,0.92,91,1096,18,27,3,17,24,1,42,16,1,0,0,21,3,0,0,1,0
2739,814,2015,59,8,51,0.14,13,1096,5,2,1,5,2,1,8,5,0,0,0,2,0,1,0,0,0
2740,815,2015,30,29,1,0.98,97,1096,20,8,1,20,8,1,29,20,0,0,0,8,0,1,0,0,0
2741,816,2015,37,36,1,0.97,96,1096,23,10,3,7,5,3,15,0,0,5,2,0,5,3,0,0,0
2742,817,2015,24,3,21,0.12,11,1096,1,2,0,1,2,0,3,1,0,0,0,2,0,0,0,0,0
2743,818,2015,22,21,1,0.94,94,1096,14,4,3,6,3,1,10,0,5,0,1,2,1,0,0,1,0
2744,819,2015,22,12,10,0.53,52,1096,4,5,3,3,5,1,9,2,1,0,0,5,0,0,0,1,0
2745,820,2015,41,41,0,0.99,98,1096,27,13,1,7,13,1,21,0,0,1,6,13,0,1,0,0,0
2746,821,2015,17,17,0,1.0,99,1096,6,10,1,2,8,1,11,0,1,0,1,6,2,1,0,0,0
2747,822,2015,44,35,9,0.79,79,1096,20,12,3,15,8,1,24,12,2,0,1,4,4,0,0,1,0
2748,823,2015,6,5,1,0.91,91,1096,2,3,0,1,2,0,3,0,1,0,0,1,1,0,0,0,0
2749,824,2015,23,11,12,0.46,46,1096,4,4,3,3,2,2,7,2,1,0,0,0,2,1,1,0,0
2750,825,2015,47,38,9,0.81,80,1096,16,21,1,14,14,1,29,13,0,1,0,7,7,1,0,0,0
2751,826,2015,13,9,4,0.67,66,1096,6,3,0,5,3,0,8,4,1,0,0,3,0,0,0,0,0
2752,827,2015,16,1,15,0.09,9,1096,0,1,0,0,1,0,1,0,0,0,0,1,0,0,0,0,0
2753,828,2015,28,18,10,0.65,64,1096,5,10,3,3,5,3,11,1,2,0,0,0,5,3,0,0,0
2754,829,2015,58,57,1,0.99,98,1096,22,33,2,21,31,2,54,20,1,0,0,29,2,2,0,0,0
2755,830,2015,19,18,1,0.92,92,1096,7,9,2,4,8,2,14,3,0,0,1,7,1,2,0,0,0
2756,831,2015,35,9,26,0.25,25,1096,3,4,2,3,4,1,8,3,0,0,0,4,0,0,1,0,0
2757,832,2015,23,23,0,0.99,98,1096,13,8,2,10,8,2,20,7,3,0,0,8,0,2,0,0,0
2758,833,2015,15,15,0,0.99,99,1096,4,8,3,2,7,3,12,1,0,1,0,6,1,3,0,0,0
2759,834,2015,8,6,2,0.72,72,1096,2,3,1,1,3,1,5,0,1,0,0,3,0,1,0,0,0
2760,835,2015,12,12,0,1.0,99,1096,5,4,3,3,2,1,6,1,2,0,0,0,2,0,0,1,0
2761,836,2015,16,14,2,0.86,86,1096,6,5,3,6,5,2,13,6,0,0,0,5,0,1,1,0,0
2762,837,2015,47,44,3,0.93,93,1096,20,20,4,20,18,2,40,20,0,0,0,16,2,0,2,0,0
2763,838,2015,15,14,1,0.94,93,1096,5,6,3,2,3,1,6,1,0,0,1,0,3,0,0,1,0
2764,839,2015,39,17,22,0.43,42,1096,5,8,4,3,6,1,10,2,0,1,0,4,2,0,0,0,1
2765,840,2015,25,25,0,0.99,99,1096,17,5,3,16,4,3,23,15,1,0,0,3,1,3,0,0,0
2766,841,2015,10,3,7,0.29,29,1096,2,1,0,1,1,0,2,0,1,0,0,1,0,0,0,0,0
2767,842,2015,22,9,13,0.43,42,1096,6,2,1,4,1,1,6,2,2,0,0,0,1,1,0,0,0
2768,843,2015,9,4,5,0.4,40,1096,1,2,1,1,1,1,3,1,0,0,0,0,1,1,0,0,0
2769,844,2015,38,38,0,1.0,99,1096,25,10,3,25,7,2,34,25,0,0,0,4,3,1,1,0,0
2770,845,2015,32,31,1,0.96,95,1096,16,12,3,15,10,2,27,14,1,0,0,8,2,1,1,0,0
2771,846,2015,20,11,9,0.57,57,1096,2,7,2,1,6,1,8,0,1,0,0,5,1,0,1,0,0
2772,847,2015,35,19,16,0.53,52,1096,9,7,3,9,4,1,14,9,0,0,0,1,3,0,0,1,0
2773,848,2015,29,26,3,0.91,91,1096,19,6,1,5,5,1,11,0,0,1,4,4,1,1,0,0,0
2774,849,2015,14,5,9,0.33,32,1096,2,2,1,2,1,1,4,2,0,0,0,0,1,1,0,0,0
2775,850,2015,34,26,8,0.75,75,1096,18,8,0,15,5,0,20,13,1,1,0,2,3,0,0,0,0
2776,851,2015,35,34,1,0.97,96,1096,21,12,1,6,6,1,13,1,0,0,5,0,6,1,0,0,0
2777,852,2015,55,45,10,0.81,81,1096,27,15,3,24,13,2,39,21,3,0,0,11,2,1,1,0,0
2778,853,2015,26,4,22,0.16,16,1096,2,2,0,2,1,0,3,2,0,0,0,0,1,0,0,0,0
2779,854,2015,53,28,25,0.52,52,1096,13,13,2,10,13,2,25,8,1,1,0,13,0,2,0,0,0
2780,855,2015,49,47,2,0.95,95,1096,24,19,4,9,11,2,22,0,5,2,2,3,8,0,2,0,0
2781,856,2015,23,22,1,0.96,95,1096,12,9,1,12,8,1,21,12,0,0,0,7,1,1,0,0,0
2782,857,2015,21,21,0,0.98,97,1096,11,8,2,5,6,1,12,1,3,0,1,4,2,0,1,0,0
2783,858,2015,23,23,0,0.99,98,1096,6,14,3,6,14,2,22,6,0,0,0,14,0,1,1,0,0
2784,859,2015,38,30,8,0.8,80,1096,20,6,4,6,5,1,12,0,1,2,3,4,1,0,0,0,1
2785,860,2015,35,34,1,0.97,96,1096,17,15,2,12,14,2,28,10,0,1,1,13,1,2,0,0,0
2786,861,2015,20,11,9,0.57,57,1096,6,3,2,5,2,2,9,4,1,0,0,1,1,2,0,0,0
2787,862,2015,28,27,1,0.98,97,1096,13,12,2,12,9,2,23,11,1,0,0,6,3,2,0,0,0
2788,863,2015,7,6,1,0.81,80,1096,3,3,0,3,3,0,6,3,0,0,0,3,0,0,0,0,0
2789,864,2015,46,17,29,0.37,37,1096,4,10,3,3,7,3,13,2,1,0,0,4,3,3,0,0,0
2790,865,2015,15,13,2,0.89,89,1096,8,4,1,8,4,1,13,8,0,0,0,4,0,1,0,0,0
2791,866,2015,58,7,51,0.12,12,1096,2,4,1,1,2,1,4,0,1,0,0,0,2,1,0,0,0
2792,867,2015,29,22,7,0.76,76,1096,14,7,1,13,6,1,20,12,1,0,0,5,1,1,0,0,0
2793,868,2015,34,9,25,0.27,26,1096,7,2,0,7,2,0,9,7,0,0,0,2,0,0,0,0,0
2794,869,2015,15,0,15,0.01,1,1096,0,0,0,0,0,0,0,0,0,0,0,0,0,0,0,0,0
2795,870,2015,35,4,31,0.11,11,1096,1,2,1,1,1,1,3,1,0,0,0,0,1,1,0,0,0
2796,871,2015,11,11,0,0.99,99,1096,5,6,0,5,4,0,9,5,0,0,0,2,2,0,0,0,0
2797,872,2015,37,37,0,1.0,99,1096,20,16,1,18,12,1,31,16,2,0,0,8,4,1,0,0,0
2798,873,2015,31,29,2,0.94,93,1096,21,5,3,7,3,1,11,0,0,7,0,1,2,0,0,1,0
2799,874,2015,38,36,2,0.94,93,1096,17,16,3,16,8,2,26,15,1,0,0,0,8,1,1,0,0
2800,875,2015,9,8,1,0.87,86,1096,4,4,0,4,3,0,7,4,0,0,0,2,1,0,0,0,0
2801,876,2015,39,30,9,0.77,76,1096,22,6,2,8,4,1,13,1,3,1,3,2,2,0,1,0,0
2802,877,2015,52,12,40,0.22,22,1096,5,7,0,2,4,0,6,1,0,0,1,1,3,0,0,0,0
2803,878,2015,37,2,35,0.04,4,1096,1,1,0,1,1,0,2,1,0,0,0,1,0,0,0,0,0
2804,879,2015,16,16,0,0.98,97,1096,12,3,1,5,3,1,9,0,4,0,1,3,0,1,0,0,0
2805,880,2015,20,10,10,0.48,47,1096,6,3,1,6,3,1,10,6,0,0,0,3,0,1,0,0,0
2806,881,2015,7,7,0,1.0,99,1096,4,3,0,4,3,0,7,4,0,0,0,3,0,0,0,0,0
2807,882,2015,60,7,53,0.12,12,1096,3,3,1,3,2,1,6,3,0,0,0,1,1,1,0,0,0
2808,883,2015,10,9,1,0.87,87,1096,5,3,1,5,3,1,9,5,0,0,0,3,0,1,0,0,0
2809,884,2015,8,2,6,0.23,23,1096,1,1,0,1,1,0,2,1,0,0,0,1,0,0,0,0,0
2810,885,2015,34,2,32,0.05,4,1096,1,1,0,1,1,0,2,1,0,0,0,1,0,0,0,0,0
2811,886,2015,26,26,0,1.0,100,1096,8,15,3,6,11,2,19,4,2,0,0,7,4,1,1,0,0
2812,887,2015,12,11,1,0.92,92,1096,4,5,2,4,5,2,11,4,0,0,0,5,0,2,0,0,0
2813,888,2015,15,14,1,0.94,93,1096,5,6,3,3,6,1,10,1,2,0,0,6,0,0,0,1,0
2814,889,2015,26,25,1,0.98,97,1096,11,10,4,5,10,2,17,1,2,2,0,10,0,1,0,1,0
2815,890,2015,12,4,8,0.37,36,1096,3,1,0,3,1,0,4,3,0,0,0,1,0,0,0,0,0
2816,891,2015,60,53,7,0.88,88,1096,39,11,3,39,10,3,52,39,0,0,0,9,1,3,0,0,0
2817,892,2015,21,20,1,0.97,97,1096,10,7,3,6,4,3,13,3,2,1,0,1,3,3,0,0,0
2818,893,2015,18,2,16,0.12,12,1096,1,1,0,1,1,0,2,1,0,0,0,1,0,0,0,0,0
2819,894,2015,13,12,1,0.94,93,1096,7,3,2,3,3,1,7,1,0,2,0,3,0,0,1,0,0
2820,895,2015,41,16,25,0.4,39,1096,4,9,3,4,6,2,12,4,0,0,0,3,3,1,1,0,0
2821,896,2015,14,2,12,0.16,15,1096,1,1,0,1,1,0,2,1,0,0,0,1,0,0,0,0,0
2822,897,2015,47,37,10,0.78,78,1096,18,18,1,12,10,1,23,8,3,0,1,2,8,1,0,0,0
2823,898,2015,28,28,0,0.99,98,1096,15,13,0,7,12,0,19,2,2,3,0,11,1,0,0,0,0
2824,899,2015,29,28,1,0.96,95,1096,14,13,1,5,8,1,14,1,0,3,1,3,5,1,0,0,0
2825,900,2015,22,18,4,0.82,82,1096,8,6,4,5,5,2,12,3,1,1,0,4,1,0,2,0,0
2826,901,2015,34,29,5,0.86,85,1096,15,12,2,13,8,1,22,11,2,0,0,4,4,0,1,0,0
2827,902,2015,16,14,2,0.87,86,1096,4,8,2,2,4,2,8,1,0,1,0,0,4,2,0,0,0
2828,903,2015,26,20,6,0.77,76,1096,8,10,2,4,5,2,11,1,2,1,0,0,5,2,0,0,0
2829,904,2015,10,1,9,0.08,8,1096,0,1,0,0,1,0,1,0,0,0,0,1,0,0,0,0,0
2830,905,2015,14,2,12,0.12,11,1096,1,1,0,1,1,0,2,1,0,0,0,1,0,0,0,0,0
2831,906,2015,12,3,9,0.29,28,1096,2,1,0,1,1,0,2,0,1,0,0,1,0,0,0,0,0
2832,907,2015,42,9,33,0.21,21,1096,3,4,2,2,3,2,7,1,1,0,0,2,1,2,0,0,0
2833,908,2015,20,6,14,0.31,30,1096,2,3,1,1,2,1,4,0,1,0,0,1,1,1,0,0,0
2834,909,2015,40,39,1,0.98,98,1096,21,15,3,16,9,2,27,13,2,0,1,3,6,1,1,0,0
2835,910,2015,16,16,0,1.0,99,1096,7,8,1,7,8,1,16,7,0,0,0,8,0,1,0,0,0
2836,911,2015,57,55,2,0.96,95,1096,27,26,2,17,20,1,38,12,0,5,0,14,6,0,1,0,0
2837,912,2015,10,0,10,0.01,1,1096,0,0,0,0,0,0,0,0,0,0,0,0,0,0,0,0,0
2838,913,2015,27,6,21,0.24,23,1096,2,3,1,2,2,1,5,2,0,0,0,1,1,1,0,0,0
2839,914,2015,33,18,15,0.54,54,1096,13,5,0,4,5,0,9,0,1,1,2,5,0,0,0,0,0
2840,915,2015,26,11,15,0.44,43,1096,8,3,0,4,2,0,6,2,0,2,0,1,1,0,0,0,0
2841,916,2015,37,18,19,0.48,47,1096,10,8,0,6,5,0,11,4,0,2,0,2,3,0,0,0,0
2842,917,2015,25,14,11,0.57,57,1096,5,7,2,5,6,1,12,5,0,0,0,5,1,0,1,0,0
2843,918,2015,12,7,5,0.58,57,1096,4,2,1,2,2,1,5,0,2,0,0,2,0,1,0,0,0
2844,919,2015,41,38,3,0.93,93,1096,20,17,1,14,10,1,25,9,4,1,0,3,7,1,0,0,0
2845,920,2015,11,10,1,0.89,89,1096,3,6,1,1,4,1,6,0,0,1,0,2,2,1,0,0,0
2846,921,2015,26,23,3,0.9,89,1096,16,5,2,11,5,2,18,6,5,0,0,5,0,2,0,0,0
2847,922,2015,12,7,5,0.58,57,1096,4,2,1,1,1,1,3,0,0,0,1,0,1,1,0,0,0
2848,923,2015,41,38,3,0.93,93,1096,18,18,2,15,9,2,26,12,3,0,0,0,9,2,0,0,0
2849,924,2015,15,9,6,0.61,61,1096,3,5,1,3,4,1,8,3,0,0,0,3,1,1,0,0,0
2850,925,2015,25,17,8,0.67,67,1096,7,9,1,2,7,1,10,0,0,1,1,5,2,1,0,0,0
2851,926,2015,27,3,24,0.1,9,1096,2,1,0,2,1,0,3,2,0,0,0,1,0,0,0,0,0
2852,927,2015,27,24,3,0.88,88,1096,9,14,1,7,14,1,22,5,2,0,0,14,0,1,0,0,0
2853,928,2015,38,38,0,0.99,99,1096,19,16,3,19,8,1,28,19,0,0,0,0,8,0,0,1,0
2854,929,2015,9,7,2,0.76,75,1096,4,3,0,1,2,0,3,0,0,0,1,1,1,0,0,0,0
2855,930,2015,47,32,15,0.68,68,1096,13,17,2,12,16,1,29,11,1,0,0,15,1,0,1,0,0
2856,931,2015,26,24,2,0.94,93,1096,16,7,1,8,7,1,16,5,0,1,2,7,0,1,0,0,0
2857,932,2015,29,26,3,0.89,88,1096,19,5,2,15,3,1,19,13,0,2,0,1,2,0,1,0,0
2858,933,2015,39,5,34,0.12,11,1096,2,3,0,2,3,0,5,2,0,0,0,3,0,0,0,0,0
2859,934,2015,25,6,19,0.24,23,1096,3,2,1,1,1,1,3,0,0,1,0,0,1,1,0,0,0
2860,935,2015,22,11,11,0.52,52,1096,8,3,0,8,2,0,10,8,0,0,0,1,1,0,0,0,0
2861,936,2015,31,25,6,0.81,80,1096,17,7,1,7,6,1,14,3,0,2,2,5,1,1,0,0,0
2862,937,2015,10,1,9,0.1,10,1096,0,1,0,0,1,0,1,0,0,0,0,1,0,0,0,0,0
2863,938,2015,31,7,24,0.22,22,1096,2,3,2,2,3,1,6,2,0,0,0,3,0,0,1,0,0
2864,939,2015,14,11,3,0.81,80,1096,8,3,0,8,2,0,10,8,0,0,0,1,1,0,0,0,0
2865,940,2015,60,27,33,0.46,45,1096,20,5,2,19,5,1,25,18,1,0,0,5,0,0,1,0,0
2866,941,2015,27,13,14,0.46,46,1096,7,6,0,7,3,0,10,7,0,0,0,0,3,0,0,0,0
2867,942,2015,17,16,1,0.96,96,1096,7,9,0,4,7,0,11,1,3,0,0,5,2,0,0,0,0
2868,943,2015,48,32,16,0.66,66,1096,22,7,3,19,5,3,27,18,0,0,1,3,2,3,0,0,0
2869,944,2015,18,7,11,0.38,38,1096,4,2,1,1,1,1,3,0,0,0,1,0,1,1,0,0,0
2870,945,2015,26,15,11,0.58,58,1096,4,8,3,3,6,1,10,2,1,0,0,4,2,0,0,1,0
2871,946,2015,24,18,6,0.76,75,1096,7,8,3,4,8,3,15,2,1,1,0,8,0,3,0,0,0
2872,947,2015,36,0,36,0.01,1,1096,0,0,0,0,0,0,0,0,0,0,0,0,0,0,0,0,0
2873,948,2015,20,2,18,0.09,9,1096,1,1,0,1,1,0,2,1,0,0,0,1,0,0,0,0,0
2874,949,2015,26,26,0,0.98,98,1096,12,12,2,6,11,2,19,0,6,0,0,10,1,2,0,0,0
2875,950,2015,35,12,23,0.33,33,1096,6,4,2,5,4,1,10,4,1,0,0,4,0,0,1,0,0
2876,951,2015,29,16,13,0.54,54,1096,9,4,3,6,2,2,10,4,1,1,0,0,2,1,1,0,0
2877,952,2015,15,6,9,0.4,40,1096,3,3,0,1,3,0,4,0,0,1,0,3,0,0,0,0,0
2878,953,2015,54,1,53,0.01,1,1096,0,1,0,0,1,0,1,0,0,0,0,1,0,0,0,0,0
2879,954,2015,21,20,1,0.97,96,1096,13,6,1,4,4,1,9,0,1,1,2,2,2,1,0,0,0
2880,955,2015,23,23,0,1.0,99,1096,9,13,1,8,11,1,20,7,1,0,0,9,2,1,0,0,0
2881,956,2015,40,8,32,0.19,18,1096,3,4,1,1,2,1,4,0,0,1,0,0,2,1,0,0,0
2882,957,2015,23,4,19,0.17,16,1096,1,2,1,1,1,1,3,1,0,0,0,0,1,1,0,0,0
2883,958,2015,20,5,15,0.26,26,1096,2,3,0,2,3,0,5,2,0,0,0,3,0,0,0,0,0
2884,959,2015,22,18,4,0.83,83,1096,8,7,3,6,7,2,15,4,2,0,0,7,0,1,1,0,0
2885,960,2015,6,6,0,0.97,96,1096,1,4,1,1,3,1,5,1,0,0,0,2,1,1,0,0,0
2886,961,2015,22,4,18,0.2,19,1096,1,2,1,1,1,1,3,1,0,0,0,0,1,1,0,0,0
2887,962,2015,34,22,12,0.63,63,1096,16,5,1,4,4,1,9,0,0,0,4,3,1,1,0,0,0
2888,963,2015,15,5,10,0.35,34,1096,2,2,1,2,2,1,5,2,0,0,0,2,0,1,0,0,0
2889,964,2015,28,28,0,0.99,98,1096,19,9,0,15,6,0,21,11,4,0,0,3,3,0,0,0,0
2890,965,2015,16,10,6,0.61,60,1096,3,4,3,2,2,1,5,1,1,0,0,0,2,0,0,1,0
2891,966,2015,12,2,10,0.19,19,1096,1,1,0,1,1,0,2,1,0,0,0,1,0,0,0,0,0
2892,967,2015,23,22,1,0.95,94,1096,15,5,2,8,3,1,12,5,1,0,2,1,2,0,1,0,0
2893,968,2015,31,26,5,0.85,85,1096,12,12,2,3,10,1,14,0,0,0,3,8,2,0,1,0,0
2894,969,2015,41,37,4,0.89,89,1096,25,11,1,10,8,1,19,3,0,6,1,5,3,1,0,0,0
2895,970,2015,5,2,3,0.31,30,1096,1,1,0,1,1,0,2,1,0,0,0,1,0,0,0,0,0
2896,971,2015,52,40,12,0.77,76,1096,24,12,4,23,6,2,31,22,1,0,0,0,6,0,2,0,0
2897,972,2015,7,1,6,0.15,14,1096,0,1,0,0,1,0,1,0,0,0,0,1,0,0,0,0,0
2898,973,2015,10,5,5,0.52,51,1096,4,1,0,1,1,0,2,0,0,0,1,1,0,0,0,0,0
2899,974,2015,23,17,6,0.73,73,1096,7,10,0,5,9,0,14,3,2,0,0,8,1,0,0,0,0
2900,975,2015,46,24,22,0.52,52,1096,17,4,3,7,3,2,12,2,0,5,0,2,1,1,1,0,0
2901,976,2015,9,1,8,0.07,6,1096,0,1,0,0,1,0,1,0,0,0,0,1,0,0,0,0,0
2902,977,2015,55,24,31,0.44,44,1096,15,8,1,10,4,1,15,7,2,0,1,0,4,1,0,0,0
2903,978,2015,35,7,28,0.21,21,1096,3,3,1,3,2,1,6,3,0,0,0,1,1,1,0,0,0
2904,979,2015,50,47,3,0.95,94,1096,19,24,4,9,23,4,36,3,3,2,1,22,1,4,0,0,0
2905,980,2015,14,9,5,0.65,65,1096,4,3,2,3,2,2,7,2,1,0,0,1,1,2,0,0,0
2906,981,2015,52,52,0,1.0,99,1096,35,15,2,27,11,1,39,22,3,1,1,7,4,0,1,0,0
2907,982,2015,38,18,20,0.49,48,1096,11,6,1,6,5,1,12,1,5,0,0,4,1,1,0,0,0
2908,983,2015,40,26,14,0.64,64,1096,16,8,2,16,7,2,25,16,0,0,0,6,1,2,0,0,0
2909,984,2015,31,3,28,0.1,9,1096,2,1,0,2,1,0,3,2,0,0,0,1,0,0,0,0,0
2910,985,2015,35,34,1,0.96,96,1096,21,12,1,18,12,1,31,17,0,0,1,12,0,1,0,0,0
2911,986,2015,39,35,4,0.9,89,1096,17,17,1,9,14,1,24,2,6,1,0,11,3,1,0,0,0
2912,987,2015,16,0,16,0.0,0,1096,0,0,0,0,0,0,0,0,0,0,0,0,0,0,0,0,0
2913,988,2015,18,8,10,0.45,45,1096,5,2,1,4,1,1,6,3,1,0,0,0,1,1,0,0,0
2914,989,2015,26,18,8,0.7,69,1096,10,7,1,5,6,1,12,2,1,2,0,5,1,1,0,0,0
2915,990,2015,19,8,11,0.4,40,1096,3,4,1,3,2,1,6,3,0,0,0,0,2,1,0,0,0
2916,991,2015,11,4,7,0.39,38,1096,1,2,1,1,1,1,3,1,0,0,0,0,1,1,0,0,0
2917,992,2015,17,12,5,0.72,71,1096,5,7,0,4,4,0,8,3,1,0,0,1,3,0,0,0,0
2918,993,2015,28,2,26,0.07,6,1096,1,1,0,1,1,0,2,1,0,0,0,1,0,0,0,0,0
2919,994,2015,26,10,16,0.4,40,1096,3,4,3,2,4,3,9,1,1,0,0,4,0,3,0,0,0
2920,995,2015,33,33,0,0.99,98,1096,24,6,3,6,5,2,13,0,0,0,6,4,1,1,1,0,0
2921,996,2015,15,9,6,0.62,62,1096,6,2,1,2,1,1,4,0,0,2,0,0,1,1,0,0,0
2922,997,2015,13,12,1,0.92,91,1096,8,3,1,8,3,1,12,8,0,0,0,3,0,1,0,0,0
2923,998,2015,11,9,2,0.85,85,1096,6,3,0,2,2,0,4,0,1,0,1,1,1,0,0,0,0
2924,999,2015,29,26,3,0.91,91,1096,14,11,1,10,10,1,21,7,2,1,0,9,1,1,0,0,0
2925,1000,2015,22,10,12,0.43,43,1096,5,5,0,3,3,0,6,2,0,1,0,1,2,0,0,0,0
2926,1001,2015,22,4,18,0.17,17,1096,2,2,0,1,2,0,3,0,1,0,0,2,0,0,0,0,0
2927,1002,2015,60,60,0,1.0,99,1096,23,36,1,11,22,1,34,3,4,4,0,8,14,1,0,0,0
2928,1003,2015,16,7,9,0.44,43,1096,4,2,1,1,1,1,3,0,0,0,1,0,1,1,0,0,0
2929,1004,2015,27,25,2,0.92,92,1096,8,15,2,5,14,1,20,2,3,0,0,13,1,0,1,0,0
2930,1005,2015,46,31,15,0.67,66,1096,20,10,1,9,7,1,17,3,2,3,1,4,3,1,0,0,0
2931,1006,2015,19,8,11,0.42,41,1096,5,2,1,2,2,1,5,1,0,0,1,2,0,1,0,0,0
2932,1007,2015,38,23,15,0.62,61,1096,7,13,3,7,12,3,22,7,0,0,0,11,1,3,0,0,0
2933,1008,2015,48,0,48,0.0,0,1096,0,0,0,0,0,0,0,0,0,0,0,0,0,0,0,0,0
2934,1009,2015,17,10,7,0.57,57,1096,7,3,0,5,3,0,8,4,0,1,0,3,0,0,0,0,0
2935,1010,2015,27,14,13,0.51,51,1096,5,6,3,4,6,3,13,3,1,0,0,6,0,3,0,0,0
2936,1011,2015,16,13,3,0.82,81,1096,7,5,1,3,5,1,9,1,0,2,0,5,0,1,0,0,0
2937,1012,2015,26,12,14,0.45,44,1096,4,6,2,3,3,1,7,2,1,0,0,0,3,0,1,0,0
2938,1013,2015,52,5,47,0.11,10,1096,4,1,0,2,1,0,3,0,2,0,0,1,0,0,0,0,0
2939,1014,2015,33,17,16,0.51,50,1096,8,8,1,8,7,1,16,8,0,0,0,6,1,1,0,0,0
2940,1015,2015,40,9,31,0.23,23,1096,2,5,2,1,5,1,7,0,1,0,0,5,0,0,1,0,0
2941,1016,2015,26,9,17,0.33,33,1096,6,2,1,4,2,1,7,2,2,0,0,2,0,1,0,0,0
2942,1017,2015,22,13,9,0.61,61,1096,6,4,3,3,4,3,10,2,0,0,1,4,0,3,0,0,0
2943,1018,2015,40,13,27,0.32,32,1096,9,3,1,4,3,1,8,1,2,0,1,3,0,1,0,0,0
2944,1019,2015,45,20,25,0.44,44,1096,7,11,2,4,11,1,16,2,1,1,0,11,0,0,1,0,0
2945,1020,2015,28,27,1,0.98,98,1096,19,5,3,12,4,3,19,5,7,0,0,3,1,3,0,0,0
2946,1021,2015,27,17,10,0.63,63,1096,9,8,0,8,6,0,14,7,1,0,0,4,2,0,0,0,0
2947,1022,2015,41,20,21,0.49,49,1096,10,7,3,10,5,2,17,10,0,0,0,3,2,1,1,0,0
2948,1023,2015,53,28,25,0.53,53,1096,21,4,3,21,2,2,25,21,0,0,0,0,2,1,1,0,0
2949,1024,2015,8,6,2,0.79,79,1096,3,2,1,3,2,1,6,3,0,0,0,2,0,1,0,0,0
2950,1025,2015,13,7,6,0.53,53,1096,5,2,0,2,2,0,4,1,0,0,1,2,0,0,0,0,0
2951,1026,2015,35,0,35,0.01,1,1096,0,0,0,0,0,0,0,0,0,0,0,0,0,0,0,0,0
2952,1027,2015,42,11,31,0.26,26,1096,4,4,3,2,2,3,7,0,2,0,0,0,2,3,0,0,0
2953,1028,2015,5,4,1,0.89,89,1096,1,2,1,1,1,1,3,1,0,0,0,0,1,1,0,0,0
2954,1029,2015,6,6,0,0.99,99,1096,3,2,1,1,1,1,3,0,0,1,0,0,1,1,0,0,0
2955,1030,2015,27,14,13,0.51,51,1096,4,8,2,3,4,2,9,2,1,0,0,0,4,2,0,0,0
2956,1031,2015,39,16,23,0.42,42,1096,7,9,0,4,8,0,12,1,3,0,0,7,1,0,0,0,0
2957,1032,2015,16,13,3,0.83,83,1096,6,4,3,3,2,3,8,1,1,1,0,0,2,3,0,0,0
2958,1033,2015,56,8,48,0.15,15,1096,2,4,2,2,3,2,7,2,0,0,0,2,1,2,0,0,0
2959,1034,2015,12,10,2,0.83,83,1096,3,5,2,1,5,1,7,0,0,1,0,5,0,0,1,0,0
2960,1035,2015,31,23,8,0.73,73,1096,13,9,1,6,8,1,15,2,1,3,0,7,1,1,0,0,0
2961,1036,2015,55,30,25,0.55,55,1096,10,18,2,4,17,2,23,2,0,0,2,16,1,2,0,0,0
2962,1037,2015,27,17,10,0.63,63,1096,10,4,3,10,2,1,13,10,0,0,0,0,2,0,0,1,0
2963,1038,2015,21,10,11,0.47,47,1096,6,4,0,6,4,0,10,6,0,0,0,4,0,0,0,0,0
2964,1039,2015,33,9,24,0.28,28,1096,4,4,1,4,4,1,9,4,0,0,0,4,0,1,0,0,0
2965,1040,2015,34,23,11,0.69,69,1096,9,10,4,9,10,3,22,9,0,0,0,10,0,2,1,0,0
2966,1041,2015,31,11,20,0.37,37,1096,5,4,2,2,3,1,6,0,1,1,0,2,1,0,1,0,0
2967,1042,2015,25,17,8,0.69,69,1096,9,6,2,5,5,2,12,1,4,0,0,4,1,2,0,0,0
2968,1043,2015,26,25,1,0.98,98,1096,14,9,2,11,5,1,17,8,3,0,0,1,4,0,1,0,0
2969,1044,2015,54,20,34,0.37,37,1096,10,6,4,10,6,1,17,10,0,0,0,6,0,0,0,0,1
2970,1045,2015,60,8,52,0.13,13,1096,4,3,1,2,3,1,6,1,0,1,0,3,0,1,0,0,0
2971,1046,2015,54,17,37,0.31,31,1096,9,6,2,6,5,2,13,5,0,0,1,4,1,2,0,0,0
2972,1047,2015,30,11,19,0.38,38,1096,3,5,3,2,5,2,9,1,1,0,0,5,0,1,1,0,0
2973,1048,2015,28,25,3,0.91,91,1096,14,9,2,14,7,1,22,14,0,0,0,5,2,0,1,0,0
2974,1049,2015,33,17,16,0.51,51,1096,10,6,1,10,5,1,16,10,0,0,0,4,1,1,0,0,0
2975,1050,2015,45,5,40,0.11,11,1096,2,2,1,1,1,1,3,0,1,0,0,0,1,1,0,0,0
2976,1051,2015,41,11,30,0.28,28,1096,8,3,0,2,3,0,5,0,0,0,2,3,0,0,0,0,0
2977,1052,2015,5,3,2,0.58,57,1096,1,2,0,1,2,0,3,1,0,0,0,2,0,0,0,0,0
2978,1053,2015,46,45,1,0.97,97,1096,17,27,1,9,27,1,37,2,6,1,0,27,0,1,0,0,0
2979,1054,2015,14,2,12,0.13,13,1096,1,1,0,1,1,0,2,1,0,0,0,1,0,0,0,0,0
2980,1055,2015,33,15,18,0.44,44,1096,4,8,3,2,7,3,12,0,2,0,0,6,1,3,0,0,0
2981,1056,2015,29,28,1,0.97,97,1096,19,6,3,18,5,2,25,17,1,0,0,4,1,1,1,0,0
2982,1057,2015,47,14,33,0.3,30,1096,6,6,2,6,4,2,12,6,0,0,0,2,2,2,0,0,0
2983,1058,2015,22,15,7,0.67,67,1096,4,8,3,1,7,2,10,0,0,0,1,6,1,1,1,0,0
2984,1059,2015,8,8,0,0.94,94,1096,5,3,0,3,2,0,5,2,0,1,0,1,1,0,0,0,0
2985,1060,2015,15,13,2,0.87,87,1096,10,3,0,10,3,0,13,10,0,0,0,3,0,0,0,0,0
2986,1061,2015,5,4,1,0.85,85,1096,1,2,1,1,1,1,3,1,0,0,0,0,1,1,0,0,0
2987,1062,2015,50,35,15,0.7,70,1096,16,17,2,13,9,1,23,11,1,1,0,1,8,0,1,0,0
2988,1063,2015,33,11,22,0.34,34,1096,6,3,2,4,3,2,9,2,2,0,0,3,0,2,0,0,0
2989,1064,2015,23,15,8,0.67,67,1096,8,4,3,7,4,3,14,6,1,0,0,4,0,3,0,0,0
2990,1065,2015,30,30,0,1.0,100,1096,18,10,2,7,7,2,16,1,3,1,2,4,3,2,0,0,0
2991,1066,2015,25,4,21,0.15,15,1096,2,2,0,1,1,0,2,0,1,0,0,0,1,0,0,0,0
2992,1067,2015,48,10,38,0.21,21,1096,7,2,1,5,2,1,8,3,2,0,0,2,0,1,0,0,0
2993,1068,2015,27,25,2,0.92,92,1096,16,7,2,6,5,1,12,1,1,3,1,3,2,0,1,0,0
2994,1069,2015,8,1,7,0.12,12,1096,0,1,0,0,1,0,1,0,0,0,0,1,0,0,0,0,0
2995,1070,2015,38,11,27,0.28,28,1096,8,2,1,8,2,1,11,8,0,0,0,2,0,1,0,0,0
2996,1071,2015,38,17,21,0.45,45,1096,7,10,0,6,6,0,12,5,1,0,0,2,4,0,0,0,0
2997,1072,2015,22,21,1,0.96,96,1096,10,11,0,6,7,0,13,4,1,0,1,3,4,0,0,0,0
2998,1073,2015,43,21,22,0.48,48,1096,9,11,1,3,10,1,14,1,0,0,2,9,1,1,0,0,0
2999,1074,2015,35,6,29,0.17,17,1096,3,2,1,2,1,1,4,1,1,0,0,0,1,1,0,0,0
3000,1075,2015,58,31,27,0.54,54,1096,19,12,0,7,8,0,15,1,3,0,3,4,4,0,0,0,0
3001,1076,2015,43,2,41,0.05,5,1096,1,1,0,1,1,0,2,1,0,0,0,1,0,0,0,0,0
3002,1077,2015,31,31,0,1.0,100,1096,15,12,4,7,6,3,16,4,0,1,2,0,6,2,1,0,0
3003,1078,2015,22,11,11,0.52,52,1096,6,4,1,6,3,1,10,6,0,0,0,2,1,1,0,0,0
3004,1079,2015,15,13,2,0.88,88,1096,6,7,0,6,6,0,12,6,0,0,0,5,1,0,0,0,0
3005,1080,2015,21,1,20,0.05,5,1096,0,1,0,0,1,0,1,0,0,0,0,1,0,0,0,0,0
3006,1081,2015,20,14,6,0.69,69,1096,4,7,3,3,6,3,12,2,1,0,0,5,1,3,0,0,0
3007,1082,2015,47,42,5,0.9,90,1096,17,23,2,17,20,2,39,17,0,0,0,17,3,2,0,0,0
3008,1083,2015,27,1,26,0.04,4,1096,0,1,0,0,1,0,1,0,0,0,0,1,0,0,0,0,0
3009,1084,2015,30,29,1,0.96,96,1096,21,8,0,8,6,0,14,1,2,4,1,4,2,0,0,0,0
3010,1085,2015,32,22,10,0.7,70,1096,13,6,3,10,4,1,15,9,0,0,1,2,2,0,0,1,0
3011,1086,2015,30,4,26,0.13,13,1096,2,2,0,2,1,0,3,2,0,0,0,0,1,0,0,0,0
3012,1087,2015,13,1,12,0.09,9,1096,0,1,0,0,1,0,1,0,0,0,0,1,0,0,0,0,0
3013,1088,2015,37,34,3,0.93,93,1096,23,7,4,13,5,4,22,8,2,1,2,3,2,4,0,0,0
3014,1089,2015,8,3,5,0.32,32,1096,2,1,0,2,1,0,3,2,0,0,0,1,0,0,0,0,0
3015,1090,2015,40,12,28,0.29,28,1096,7,5,0,6,4,0,10,5,1,0,0,3,1,0,0,0,0
3016,1091,2015,31,27,4,0.87,87,1096,20,5,2,17,5,2,24,14,3,0,0,5,0,2,0,0,0
3017,1092,2015,35,35,0,1.0,100,1096,21,13,1,8,9,1,18,1,4,0,3,5,4,1,0,0,0
3018,1093,2015,31,15,16,0.48,48,1096,7,8,0,6,7,0,13,5,1,0,0,6,1,0,0,0,0
3019,1094,2015,25,11,14,0.44,44,1096,4,4,3,1,3,1,5,0,0,0,1,2,1,0,0,1,0
3020,1095,2015,28,6,22,0.2,20,1096,2,3,1,1,3,1,5,0,1,0,0,3,0,1,0,0,0
3021,1096,2015,35,32,3,0.9,90,1096,20,11,1,15,9,1,25,12,2,0,1,7,2,1,0,0,0
3022,1,2016,33,33,0,0.99,99,1021,22,8,3,14,6,2,22,10,0,4,0,4,2,1,1,0,0
3023,2,2016,15,3,12,0.2,19,1021,1,2,0,1,1,0,2,1,0,0,0,0,1,0,0,0,0
3024,3,2016,28,28,0,1.0,99,1021,16,10,2,13,8,1,22,11,1,1,0,6,2,0,1,0,0
3025,4,2016,40,40,0,1.0,100,1021,16,21,3,9,12,1,22,4,3,2,0,3,9,0,0,1,0
3026,5,2016,33,33,0,1.0,99,1021,12,17,4,3,12,3,18,0,0,0,3,7,5,2,1,0,0
3027,6,2016,41,41,0,1.0,99,1021,20,18,3,17,9,3,29,14,3,0,0,0,9,3,0,0,0
3028,7,2016,55,54,1,0.98,97,1021,23,28,3,18,15,3,36,16,0,1,1,2,13,3,0,0,0
3029,8,2016,38,13,25,0.35,35,1021,5,7,1,3,7,1,11,2,0,1,0,7,0,1,0,0,0
3030,9,2016,28,2,26,0.07,7,1021,1,1,0,1,1,0,2,1,0,0,0,1,0,0,0,0,0
3031,10,2016,12,10,2,0.83,83,1021,7,3,0,7,3,0,10,7,0,0,0,3,0,0,0,0,0
3032,11,2016,49,8,41,0.17,17,1021,4,3,1,1,2,1,4,0,0,0,1,1,1,1,0,0,0
3033,12,2016,34,0,34,0.0,0,1021,0,0,0,0,0,0,0,0,0,0,0,0,0,0,0,0,0
3034,13,2016,6,6,0,0.95,95,1021,3,2,1,1,2,1,4,0,0,1,0,2,0,1,0,0,0
3035,14,2016,32,0,32,0.01,1,1021,0,0,0,0,0,0,0,0,0,0,0,0,0,0,0,0,0
3036,15,2016,7,6,1,0.87,86,1021,3,2,1,3,1,1,5,3,0,0,0,0,1,1,0,0,0
3037,16,2016,47,32,15,0.69,69,1021,18,12,2,17,9,2,28,16,1,0,0,6,3,2,0,0,0
3038,17,2016,13,13,0,0.98,97,1021,5,6,2,3,4,1,8,1,2,0,0,2,2,0,1,0,0
3039,18,2016,40,40,0,1.0,100,1021,22,15,3,19,13,3,35,16,3,0,0,11,2,3,0,0,0
3040,19,2016,10,1,9,0.08,8,1021,0,1,0,0,1,0,1,0,0,0,0,1,0,0,0,0,0
3041,20,2016,9,7,2,0.81,80,1021,4,2,1,2,2,1,5,0,2,0,0,2,0,1,0,0,0
3042,21,2016,52,13,39,0.26,25,1021,7,6,0,6,4,0,10,5,1,0,0,2,2,0,0,0,0
3043,22,2016,5,4,1,0.83,83,1021,1,2,1,1,1,1,3,1,0,0,0,0,1,1,0,0,0
3044,23,2016,34,27,7,0.8,80,1021,11,14,2,6,13,1,20,3,1,2,0,12,1,0,1,0,0
3045,24,2016,37,32,5,0.85,85,1021,15,15,2,14,11,2,27,13,1,0,0,7,4,2,0,0,0
3046,25,2016,36,35,1,0.98,97,1021,14,17,4,10,10,2,22,7,2,1,0,3,7,0,2,0,0
3047,26,2016,33,33,0,1.0,99,1021,14,15,4,4,13,3,20,0,1,0,3,11,2,2,1,0,0
3048,27,2016,27,9,18,0.34,33,1021,4,3,2,2,3,1,6,1,0,1,0,3,0,0,1,0,0
3049,28,2016,27,25,2,0.91,90,1021,16,8,1,6,4,1,11,0,2,4,0,0,4,1,0,0,0
3050,29,2016,8,1,7,0.11,10,1021,0,1,0,0,1,0,1,0,0,0,0,1,0,0,0,0,0
3051,30,2016,59,58,1,0.98,97,1021,42,12,4,23,6,1,30,11,8,1,3,0,6,0,0,0,1
3052,31,2016,60,19,41,0.32,31,1021,10,9,0,7,6,0,13,4,3,0,0,3,3,0,0,0,0
3053,32,2016,10,10,0,1.0,99,1021,5,5,0,4,3,0,7,3,1,0,0,1,2,0,0,0,0
3054,33,2016,28,20,8,0.72,72,1021,7,11,2,7,7,1,15,7,0,0,0,3,4,0,1,0,0
3055,34,2016,10,4,6,0.42,42,1021,1,2,1,1,2,1,4,1,0,0,0,2,0,1,0,0,0
3056,35,2016,52,49,3,0.95,95,1021,22,27,0,6,15,0,21,0,1,0,5,3,12,0,0,0,0
3057,36,2016,58,55,3,0.95,95,1021,27,25,3,23,13,2,38,21,1,0,1,1,12,1,1,0,0
3058,37,2016,53,50,3,0.94,94,1021,29,20,1,28,17,1,46,27,1,0,0,14,3,1,0,0,0
3059,38,2016,19,16,3,0.87,86,1021,6,7,3,3,4,2,9,0,3,0,0,1,3,1,1,0,0
3060,39,2016,16,2,14,0.13,12,1021,1,1,0,1,1,0,2,1,0,0,0,1,0,0,0,0,0
3061,40,2016,8,8,0,1.0,99,1021,3,3,2,2,2,2,6,1,1,0,0,1,1,2,0,0,0
3062,41,2016,24,18,6,0.76,75,1021,10,5,3,3,5,2,10,0,1,0,2,5,0,1,1,0,0
3063,42,2016,8,0,8,0.03,2,1021,0,0,0,0,0,0,0,0,0,0,0,0,0,0,0,0,0
3064,43,2016,40,27,13,0.66,66,1021,19,6,2,12,6,1,19,7,3,2,0,6,0,0,1,0,0
3065,44,2016,29,27,2,0.92,91,1021,17,8,2,9,6,2,17,6,0,1,2,4,2,2,0,0,0
3066,45,2016,42,4,38,0.1,10,1021,2,2,0,1,2,0,3,0,1,0,0,2,0,0,0,0,0
3067,46,2016,53,53,0,1.0,100,1021,39,12,2,37,9,1,47,35,2,0,0,6,3,0,1,0,0
3068,47,2016,37,37,0,1.0,100,1021,18,18,1,13,13,1,27,10,1,2,0,8,5,1,0,0,0
3069,48,2016,24,23,1,0.94,94,1021,8,11,4,2,8,3,13,0,0,0,2,5,3,2,1,0,0
3070,49,2016,60,51,9,0.84,84,1021,24,26,1,16,23,1,40,10,5,0,1,20,3,1,0,0,0
3071,50,2016,17,12,5,0.72,71,1021,5,5,2,3,5,2,10,2,0,1,0,5,0,2,0,0,0
3072,51,2016,18,10,8,0.54,53,1021,3,5,2,2,5,1,8,1,1,0,0,5,0,0,1,0,0
3073,52,2016,34,18,16,0.52,52,1021,8,8,2,6,6,2,14,5,0,1,0,4,2,2,0,0,0
3074,53,2016,25,4,21,0.15,14,1021,3,1,0,3,1,0,4,3,0,0,0,1,0,0,0,0,0
3075,54,2016,26,20,6,0.79,78,1021,10,9,1,4,7,1,12,0,2,2,0,5,2,1,0,0,0
3076,55,2016,31,31,0,1.0,100,1021,17,14,0,10,7,0,17,5,4,0,1,0,7,0,0,0,0
3077,56,2016,25,25,0,1.0,100,1021,9,13,3,4,11,3,18,1,2,0,1,9,2,3,0,0,0
3078,57,2016,11,11,0,0.99,98,1021,6,4,1,4,3,1,8,2,2,0,0,2,1,1,0,0,0
3079,58,2016,33,27,6,0.83,82,1021,13,13,1,7,8,1,16,4,1,1,1,3,5,1,0,0,0
3080,59,2016,7,7,0,0.99,98,1021,5,2,0,4,1,0,5,3,1,0,0,0,1,0,0,0,0
3081,60,2016,5,2,3,0.33,33,1021,1,1,0,1,1,0,2,1,0,0,0,1,0,0,0,0,0
3082,61,2016,23,22,1,0.97,97,1021,10,8,4,9,5,2,16,8,1,0,0,2,3,1,0,1,0
3083,62,2016,47,41,6,0.86,86,1021,20,17,4,16,11,1,28,12,4,0,0,5,6,0,0,0,1
3084,63,2016,7,3,4,0.41,41,1021,2,1,0,2,1,0,3,2,0,0,0,1,0,0,0,0,0
3085,64,2016,39,31,8,0.79,78,1021,21,9,1,18,7,1,26,15,3,0,0,5,2,1,0,0,0
3086,65,2016,47,18,29,0.38,38,1021,9,9,0,4,9,0,13,1,1,2,0,9,0,0,0,0,0
3087,66,2016,23,23,0,0.99,98,1021,11,11,1,6,10,1,17,3,2,0,1,9,1,1,0,0,0
3088,67,2016,7,2,5,0.31,30,1021,1,1,0,1,1,0,2,1,0,0,0,1,0,0,0,0,0
3089,68,2016,36,36,0,1.0,99,1021,25,11,0,8,9,0,17,0,0,7,1,7,2,0,0,0,0
3090,69,2016,44,7,37,0.17,16,1021,3,4,0,3,2,0,5,3,0,0,0,0,2,0,0,0,0
3091,70,2016,50,31,19,0.63,62,1021,23,5,3,13,3,3,19,4,8,1,0,1,2,3,0,0,0
3092,71,2016,14,4,10,0.27,27,1021,2,2,0,1,2,0,3,0,1,0,0,2,0,0,0,0,0
3093,72,2016,34,19,15,0.57,56,1021,11,8,0,7,4,0,11,5,0,2,0,0,4,0,0,0,0
3094,73,2016,50,5,45,0.11,10,1021,3,2,0,2,2,0,4,1,1,0,0,2,0,0,0,0,0
3095,74,2016,40,40,0,1.0,100,1021,26,11,3,13,8,2,23,4,7,0,2,5,3,1,1,0,0
3096,75,2016,34,26,8,0.77,76,1021,10,14,2,10,12,1,23,10,0,0,0,10,2,0,1,0,0
3097,76,2016,43,35,8,0.82,82,1021,17,15,3,17,11,2,30,17,0,0,0,7,4,1,1,0,0
3098,77,2016,13,7,6,0.52,52,1021,4,3,0,2,2,0,4,1,0,1,0,1,1,0,0,0,0
3099,78,2016,15,15,0,0.97,96,1021,10,4,1,9,4,1,14,8,1,0,0,4,0,1,0,0,0
3100,79,2016,19,12,7,0.65,64,1021,7,5,0,6,5,0,11,5,1,0,0,5,0,0,0,0,0
3101,80,2016,43,40,3,0.93,92,1021,19,20,1,11,18,1,30,8,0,1,2,16,2,1,0,0,0
3102,81,2016,55,50,5,0.9,90,1021,23,26,1,18,15,1,34,16,0,1,1,4,11,1,0,0,0
3103,82,2016,23,23,0,0.99,99,1021,16,5,2,9,4,2,15,5,1,3,0,3,1,2,0,0,0
3104,83,2016,9,6,3,0.66,65,1021,2,4,0,1,2,0,3,0,1,0,0,0,2,0,0,0,0
3105,84,2016,31,31,0,1.0,100,1021,22,7,2,10,4,2,16,4,1,4,1,1,3,2,0,0,0
3106,85,2016,6,6,0,0.97,97,1021,4,2,0,1,1,0,2,0,0,0,1,0,1,0,0,0,0
3107,86,2016,53,51,2,0.96,95,1021,37,10,4,37,8,3,48,37,0,0,0,6,2,2,1,0,0
3108,87,2016,27,24,3,0.91,90,1021,15,7,2,10,6,1,17,7,1,2,0,5,1,0,1,0,0
3109,88,2016,19,9,10,0.46,45,1021,4,3,2,1,3,1,5,0,0,0,1,3,0,0,1,0,0
3110,89,2016,29,28,1,0.98,98,1021,19,8,1,7,6,1,14,2,0,3,2,4,2,1,0,0,0
3111,90,2016,15,11,4,0.73,72,1021,8,3,0,2,3,0,5,0,0,0,2,3,0,0,0,0,0
3112,91,2016,57,54,3,0.95,95,1021,39,15,0,32,14,0,46,29,1,0,2,13,1,0,0,0,0
3113,92,2016,40,40,0,1.0,99,1021,15,21,4,10,15,2,27,7,1,2,0,9,6,0,2,0,0
3114,93,2016,26,11,15,0.41,41,1021,5,5,1,5,5,1,11,5,0,0,0,5,0,1,0,0,0
3115,94,2016,21,21,0,0.99,99,1021,9,12,0,8,9,0,17,7,1,0,0,6,3,0,0,0,0
3116,95,2016,39,39,0,0.99,98,1021,29,7,3,20,4,2,26,16,0,3,1,1,3,1,1,0,0
3117,96,2016,12,10,2,0.85,84,1021,5,4,1,4,3,1,8,3,1,0,0,2,1,1,0,0,0
3118,97,2016,28,27,1,0.98,97,1021,20,6,1,10,3,1,14,1,8,1,0,0,3,1,0,0,0
3119,98,2016,60,42,18,0.71,70,1021,18,24,0,16,12,0,28,14,2,0,0,0,12,0,0,0,0
3120,99,2016,56,27,29,0.49,48,1021,15,8,4,8,4,4,16,5,1,0,2,0,4,4,0,0,0
3121,100,2016,27,1,26,0.05,5,1021,0,1,0,0,1,0,1,0,0,0,0,1,0,0,0,0,0
3122,101,2016,31,31,0,1.0,100,1021,20,8,3,14,6,2,22,12,0,0,2,4,2,1,1,0,0
3123,102,2016,10,10,0,0.98,97,1021,3,5,2,2,5,1,8,1,1,0,0,5,0,0,1,0,0
3124,103,2016,29,5,24,0.17,16,1021,4,1,0,2,1,0,3,1,0,1,0,1,0,0,0,0,0
3125,104,2016,57,14,43,0.25,24,1021,6,8,0,6,5,0,11,6,0,0,0,2,3,0,0,0,0
3126,105,2016,15,13,2,0.84,83,1021,6,4,3,4,4,2,10,3,0,1,0,4,0,1,1,0,0
3127,106,2016,7,4,3,0.62,61,1021,3,1,0,1,1,0,2,0,0,1,0,1,0,0,0,0,0
3128,107,2016,8,8,0,1.0,99,1021,4,4,0,4,3,0,7,4,0,0,0,2,1,0,0,0,0
3129,108,2016,24,22,2,0.92,91,1021,15,5,2,12,4,1,17,9,3,0,0,3,1,0,1,0,0
3130,109,2016,16,12,4,0.72,72,1021,7,3,2,4,2,2,8,2,1,1,0,1,1,2,0,0,0
3131,110,2016,19,12,7,0.65,64,1021,6,5,1,3,4,1,8,0,3,0,0,3,1,1,0,0,0
3132,111,2016,41,40,1,0.97,96,1021,14,23,3,9,12,2,23,4,5,0,0,1,11,1,1,0,0
3133,112,2016,14,0,14,0.01,1,1021,0,0,0,0,0,0,0,0,0,0,0,0,0,0,0,0,0
3134,113,2016,7,7,0,1.0,99,1021,2,3,2,1,3,1,5,0,1,0,0,3,0,0,1,0,0
3135,114,2016,18,17,1,0.96,95,1021,7,8,2,6,8,2,16,5,1,0,0,8,0,2,0,0,0
3136,115,2016,5,2,3,0.45,44,1021,1,1,0,1,1,0,2,1,0,0,0,1,0,0,0,0,0
3137,116,2016,42,5,37,0.11,11,1021,3,2,0,1,2,0,3,0,0,1,0,2,0,0,0,0,0
3138,117,2016,8,8,0,0.98,97,1021,5,2,1,5,1,1,7,5,0,0,0,0,1,1,0,0,0
3139,118,2016,15,9,6,0.59,59,1021,6,3,0,6,2,0,8,6,0,0,0,1,1,0,0,0,0
3140,119,2016,14,3,11,0.24,24,1021,2,1,0,1,1,0,2,0,1,0,0,1,0,0,0,0,0
3141,120,2016,32,32,0,1.0,100,1021,21,10,1,7,10,1,18,1,0,4,2,10,0,1,0,0,0
3142,121,2016,32,22,10,0.68,67,1021,9,11,2,5,11,1,17,3,0,2,0,11,0,0,1,0,0
3143,122,2016,6,5,1,0.78,78,1021,1,3,1,1,3,1,5,1,0,0,0,3,0,1,0,0,0
3144,123,2016,20,20,0,0.98,98,1021,11,8,1,11,4,1,16,11,0,0,0,0,4,1,0,0,0
3145,124,2016,40,40,0,1.0,100,1021,26,13,1,12,7,1,20,2,7,2,1,1,6,1,0,0,0
3146,125,2016,48,46,2,0.96,96,1021,30,13,3,17,13,3,33,5,11,1,0,13,0,3,0,0,0
3147,126,2016,55,20,35,0.36,35,1021,13,7,0,8,7,0,15,5,2,0,1,7,0,0,0,0,0
3148,127,2016,15,4,11,0.26,25,1021,3,1,0,3,1,0,4,3,0,0,0,1,0,0,0,0,0
3149,128,2016,11,11,0,0.98,97,1021,5,6,0,2,4,0,6,1,0,0,1,2,2,0,0,0,0
3150,129,2016,58,58,0,1.0,100,1021,35,21,2,9,17,2,28,0,0,1,8,13,4,2,0,0,0
3151,130,2016,15,14,1,0.95,94,1021,4,7,3,2,5,2,9,1,0,1,0,3,2,1,1,0,0
3152,131,2016,52,50,2,0.96,95,1021,31,16,3,15,13,1,29,3,9,2,1,10,3,0,0,1,0
3153,132,2016,28,18,10,0.64,64,1021,6,9,3,2,5,3,10,0,0,2,0,1,4,3,0,0,0
3154,133,2016,57,15,42,0.26,26,1021,9,4,2,7,2,1,10,5,2,0,0,0,2,0,1,0,0
3155,134,2016,26,13,13,0.48,48,1021,7,5,1,2,5,1,8,0,0,1,1,5,0,1,0,0,0
3156,135,2016,42,42,0,1.0,99,1021,27,12,3,8,10,2,20,1,0,2,5,8,2,1,1,0,0
3157,136,2016,9,8,1,0.91,91,1021,4,3,1,3,2,1,6,2,1,0,0,1,1,1,0,0,0
3158,137,2016,23,4,19,0.2,19,1021,1,2,1,1,2,1,4,1,0,0,0,2,0,1,0,0,0
3159,138,2016,19,18,1,0.95,94,1021,10,5,3,5,4,1,10,3,0,1,1,3,1,0,0,1,0
3160,139,2016,42,42,0,1.0,99,1021,21,20,1,8,19,1,28,0,5,1,2,18,1,1,0,0,0
3161,140,2016,29,8,21,0.27,26,1021,3,4,1,2,2,1,5,1,1,0,0,0,2,1,0,0,0
3162,141,2016,12,12,0,1.0,100,1021,7,4,1,4,4,1,9,3,0,0,1,4,0,1,0,0,0
3163,142,2016,7,5,2,0.77,77,1021,2,2,1,1,1,1,3,0,1,0,0,0,1,1,0,0,0
3164,143,2016,7,6,1,0.92,92,1021,2,3,1,2,2,1,5,2,0,0,0,1,1,1,0,0,0
3165,144,2016,6,4,2,0.74,74,1021,1,2,1,1,2,1,4,1,0,0,0,2,0,1,0,0,0
3166,145,2016,15,15,0,1.0,100,1021,7,6,2,6,4,1,11,5,1,0,0,2,2,0,1,0,0
3167,146,2016,29,16,13,0.57,56,1021,8,5,3,3,4,3,10,0,1,2,0,3,1,3,0,0,0
3168,147,2016,22,3,19,0.15,15,1021,2,1,0,1,1,0,2,0,1,0,0,1,0,0,0,0,0
3169,148,2016,19,17,2,0.92,91,1021,7,8,2,5,7,2,14,4,0,1,0,6,1,2,0,0,0
3170,149,2016,32,26,6,0.8,79,1021,16,8,2,6,8,1,15,2,0,2,2,8,0,0,1,0,0
3171,150,2016,33,31,2,0.95,95,1021,13,15,3,8,15,1,24,4,3,1,0,15,0,0,0,1,0
3172,151,2016,16,10,6,0.61,61,1021,7,2,1,7,1,1,9,7,0,0,0,0,1,1,0,0,0
3173,152,2016,6,1,5,0.16,16,1021,0,1,0,0,1,0,1,0,0,0,0,1,0,0,0,0,0
3174,153,2016,31,29,2,0.94,93,1021,16,13,0,12,12,0,24,10,0,2,0,11,1,0,0,0,0
3175,154,2016,32,6,26,0.19,19,1021,3,2,1,2,2,1,5,1,1,0,0,2,0,1,0,0,0
3176,155,2016,27,27,0,1.0,99,1021,14,11,2,12,8,2,22,11,0,1,0,5,3,2,0,0,0
3177,156,2016,30,13,17,0.44,44,1021,5,5,3,2,5,3,10,1,0,0,1,5,0,3,0,0,0
3178,157,2016,22,22,0,0.98,97,1021,10,11,1,5,6,1,12,2,2,0,1,1,5,1,0,0,0
3179,158,2016,26,18,8,0.7,69,1021,10,5,3,10,5,2,17,10,0,0,0,5,0,1,1,0,0
3180,159,2016,7,6,1,0.91,90,1021,2,3,1,2,3,1,6,2,0,0,0,3,0,1,0,0,0
3181,160,2016,21,21,0,0.99,98,1021,11,9,1,6,5,1,12,1,5,0,0,1,4,1,0,0,0
3182,161,2016,34,5,29,0.15,15,1021,4,1,0,4,1,0,5,4,0,0,0,1,0,0,0,0,0
3183,162,2016,31,15,16,0.48,48,1021,7,8,0,3,8,0,11,1,1,0,1,8,0,0,0,0,0
3184,163,2016,54,23,31,0.43,42,1021,14,8,1,14,8,1,23,14,0,0,0,8,0,1,0,0,0
3185,164,2016,5,5,0,1.0,99,1021,1,3,1,1,2,1,4,1,0,0,0,1,1,1,0,0,0
3186,165,2016,15,8,7,0.52,51,1021,3,4,1,2,2,1,5,1,1,0,0,0,2,1,0,0,0
3187,166,2016,30,26,4,0.86,86,1021,19,6,1,16,5,1,22,13,3,0,0,4,1,1,0,0,0
3188,167,2016,15,0,15,0.01,1,1021,0,0,0,0,0,0,0,0,0,0,0,0,0,0,0,0,0
3189,168,2016,48,48,0,0.99,98,1021,22,26,0,11,20,0,31,5,3,1,2,14,6,0,0,0,0
3190,169,2016,45,19,26,0.43,42,1021,10,9,0,7,6,0,13,5,1,1,0,3,3,0,0,0,0
3191,170,2016,26,26,0,1.0,99,1021,15,7,4,5,6,2,13,1,0,2,2,5,1,0,2,0,0
3192,171,2016,13,4,9,0.32,32,1021,1,2,1,1,1,1,3,1,0,0,0,0,1,1,0,0,0
3193,172,2016,40,2,38,0.05,4,1021,1,1,0,1,1,0,2,1,0,0,0,1,0,0,0,0,0
3194,173,2016,39,22,17,0.56,55,1021,16,4,2,16,4,2,22,16,0,0,0,4,0,2,0,0,0
3195,174,2016,38,32,6,0.84,84,1021,21,8,3,7,8,2,17,1,2,0,4,8,0,1,1,0,0
3196,175,2016,39,34,5,0.88,88,1021,16,16,2,8,12,1,21,2,5,0,1,8,4,0,1,0,0
3197,176,2016,14,14,0,1.0,100,1021,10,3,1,10,2,1,13,10,0,0,0,1,1,1,0,0,0
3198,177,2016,17,17,0,0.99,98,1021,10,4,3,8,4,1,13,7,0,1,0,4,0,0,0,1,0
3199,178,2016,14,14,0,0.98,97,1021,10,3,1,10,3,1,14,10,0,0,0,3,0,1,0,0,0
3200,179,2016,30,4,26,0.15,14,1021,2,2,0,2,1,0,3,2,0,0,0,0,1,0,0,0,0
3201,180,2016,51,18,33,0.36,35,1021,12,6,0,9,4,0,13,6,3,0,0,2,2,0,0,0,0
3202,181,2016,26,18,8,0.71,70,1021,10,6,2,5,3,2,10,3,0,1,1,0,3,2,0,0,0
3203,182,2016,33,32,1,0.98,97,1021,20,10,2,13,8,2,23,8,3,2,0,6,2,2,0,0,0
3204,183,2016,32,8,24,0.25,24,1021,2,4,2,1,2,1,4,0,1,0,0,0,2,0,1,0,0
3205,184,2016,40,34,6,0.86,85,1021,12,19,3,4,12,2,18,0,0,4,0,5,7,1,1,0,0
3206,185,2016,7,6,1,0.87,86,1021,2,3,1,1,3,1,5,0,1,0,0,3,0,1,0,0,0
3207,186,2016,14,12,2,0.89,88,1021,4,5,3,1,5,2,8,0,0,0,1,5,0,1,1,0,0
3208,187,2016,22,22,0,0.98,97,1021,15,5,2,12,4,1,17,10,1,1,0,3,1,0,1,0,0
3209,188,2016,19,18,1,0.94,93,1021,7,10,1,2,9,1,12,0,0,1,1,8,1,1,0,0,0
3210,189,2016,16,16,0,1.0,99,1021,6,8,2,5,6,1,12,4,1,0,0,4,2,0,1,0,0
3211,190,2016,33,33,0,1.0,100,1021,18,12,3,16,11,1,28,14,2,0,0,10,1,0,0,1,0
3212,191,2016,13,13,0,0.99,99,1021,3,7,3,3,6,2,11,3,0,0,0,5,1,1,1,0,0
3213,192,2016,7,6,1,0.9,89,1021,2,3,1,1,3,1,5,0,1,0,0,3,0,1,0,0,0
3214,193,2016,39,37,2,0.95,94,1021,12,22,3,9,22,2,33,6,3,0,0,22,0,1,1,0,0
3215,194,2016,40,40,0,1.0,100,1021,18,21,1,17,11,1,29,16,1,0,0,1,10,1,0,0,0
3216,195,2016,34,14,20,0.4,39,1021,5,8,1,5,5,1,11,5,0,0,0,2,3,1,0,0,0
3217,196,2016,19,19,0,1.0,99,1021,9,6,4,9,5,4,18,9,0,0,0,4,1,4,0,0,0
3218,197,2016,8,4,4,0.54,53,1021,1,2,1,1,1,1,3,1,0,0,0,0,1,1,0,0,0
3219,198,2016,30,7,23,0.24,23,1021,4,3,0,2,3,0,5,0,2,0,0,3,0,0,0,0,0
3220,199,2016,6,4,2,0.7,69,1021,1,2,1,1,2,1,4,1,0,0,0,2,0,1,0,0,0
3221,200,2016,54,25,29,0.46,45,1021,15,9,1,6,8,1,15,0,3,3,0,7,1,1,0,0,0
3222,201,2016,46,43,3,0.93,92,1021,28,14,1,27,11,1,39,26,1,0,0,8,3,1,0,0,0
3223,202,2016,35,4,31,0.1,10,1021,2,2,0,2,2,0,4,2,0,0,0,2,0,0,0,0,0
3224,203,2016,25,4,21,0.17,17,1021,1,2,1,1,1,1,3,1,0,0,0,0,1,1,0,0,0
3225,204,2016,38,34,4,0.89,89,1021,15,17,2,10,17,1,28,7,1,2,0,17,0,0,1,0,0
3226,205,2016,27,26,1,0.96,95,1021,9,14,3,6,11,2,19,4,1,1,0,8,3,1,1,0,0
3227,206,2016,31,31,0,1.0,100,1021,19,12,0,17,8,0,25,15,2,0,0,4,4,0,0,0,0
3228,207,2016,6,6,0,1.0,99,1021,4,2,0,3,2,0,5,2,1,0,0,2,0,0,0,0,0
3229,208,2016,36,36,0,1.0,100,1021,16,16,4,8,9,3,20,3,3,1,1,2,7,2,1,0,0
3230,209,2016,32,0,32,0.0,0,1021,0,0,0,0,0,0,0,0,0,0,0,0,0,0,0,0,0
3231,210,2016,34,9,25,0.28,27,1021,4,4,1,2,4,1,7,0,2,0,0,4,0,1,0,0,0
3232,211,2016,31,31,0,1.0,100,1021,22,8,1,19,6,1,26,16,3,0,0,4,2,1,0,0,0
3233,212,2016,35,35,0,1.0,99,1021,22,12,1,8,9,1,18,1,2,3,2,6,3,1,0,0,0
3234,213,2016,10,1,9,0.06,6,1021,0,1,0,0,1,0,1,0,0,0,0,1,0,0,0,0,0
3235,214,2016,18,18,0,1.0,100,1021,13,3,2,13,3,1,17,13,0,0,0,3,0,0,1,0,0
3236,215,2016,5,5,0,1.0,99,1021,2,2,1,2,2,1,5,2,0,0,0,2,0,1,0,0,0
3237,216,2016,26,26,0,1.0,99,1021,10,15,1,4,11,1,16,0,3,0,1,7,4,1,0,0,0
3238,217,2016,36,25,11,0.68,68,1021,16,8,1,9,4,1,14,5,1,3,0,0,4,1,0,0,0
3239,218,2016,39,38,1,0.96,96,1021,18,18,2,15,15,2,32,14,0,0,1,12,3,2,0,0,0
3240,219,2016,48,48,0,1.0,99,1021,19,28,1,7,24,1,32,2,1,1,3,20,4,1,0,0,0
3241,220,2016,44,23,21,0.52,52,1021,11,9,3,4,8,3,15,0,2,1,1,7,1,3,0,0,0
3242,221,2016,37,30,7,0.81,80,1021,21,6,3,7,6,1,14,0,0,7,0,6,0,0,0,1,0
3243,222,2016,15,5,10,0.33,32,1021,4,1,0,3,1,0,4,2,1,0,0,1,0,0,0,0,0
3244,223,2016,50,50,0,1.0,99,1021,37,10,3,26,5,3,34,21,2,0,3,0,5,3,0,0,0
3245,224,2016,21,20,1,0.94,93,1021,9,10,1,8,7,1,16,7,1,0,0,4,3,1,0,0,0
3246,225,2016,16,16,0,1.0,100,1021,11,5,0,8,4,0,12,6,1,1,0,3,1,0,0,0,0
3247,226,2016,7,6,1,0.89,88,1021,3,2,1,2,2,1,5,1,1,0,0,2,0,1,0,0,0
3248,227,2016,17,14,3,0.8,80,1021,4,7,3,2,7,3,12,1,0,1,0,7,0,3,0,0,0
3249,228,2016,11,5,6,0.41,41,1021,1,3,1,1,3,1,5,1,0,0,0,3,0,1,0,0,0
3250,229,2016,14,13,1,0.96,96,1021,3,7,3,3,4,2,9,3,0,0,0,1,3,1,1,0,0
3251,230,2016,22,14,8,0.62,62,1021,6,7,1,3,4,1,8,1,1,1,0,1,3,1,0,0,0
3252,231,2016,17,14,3,0.8,80,1021,5,8,1,2,7,1,10,0,1,1,0,6,1,1,0,0,0
3253,232,2016,30,25,5,0.83,82,1021,15,10,0,8,5,0,13,3,3,2,0,0,5,0,0,0,0
3254,233,2016,16,7,9,0.42,41,1021,2,3,2,1,2,1,4,0,1,0,0,1,1,0,1,0,0
3255,234,2016,24,2,22,0.07,6,1021,1,1,0,1,1,0,2,1,0,0,0,1,0,0,0,0,0
3256,235,2016,22,22,0,1.0,100,1021,7,13,2,2,8,2,12,0,0,1,1,3,5,2,0,0,0
3257,236,2016,14,10,4,0.72,72,1021,2,6,2,2,3,1,6,2,0,0,0,0,3,0,1,0,0
3258,237,2016,42,3,39,0.07,7,1021,2,1,0,2,1,0,3,2,0,0,0,1,0,0,0,0,0
3259,238,2016,17,16,1,0.92,92,1021,7,8,1,6,7,1,14,5,1,0,0,6,1,1,0,0,0
3260,239,2016,12,1,11,0.06,5,1021,0,1,0,0,1,0,1,0,0,0,0,1,0,0,0,0,0
3261,240,2016,28,27,1,0.95,95,1021,16,10,1,9,10,1,20,5,2,1,1,10,0,1,0,0,0
3262,241,2016,18,17,1,0.94,94,1021,5,9,3,5,9,3,17,5,0,0,0,9,0,3,0,0,0
3263,242,2016,55,54,1,0.99,98,1021,26,25,3,25,13,1,39,24,1,0,0,1,12,0,0,1,0
3264,243,2016,22,14,8,0.64,64,1021,3,8,3,2,7,2,11,1,1,0,0,6,1,1,1,0,0
3265,244,2016,53,43,10,0.81,81,1021,26,16,1,24,9,1,34,23,0,1,0,2,7,1,0,0,0
3266,245,2016,46,36,10,0.78,77,1021,21,12,3,15,7,3,25,10,4,1,0,2,5,3,0,0,0
3267,246,2016,30,30,0,1.0,100,1021,16,13,1,4,11,1,16,0,0,0,4,9,2,1,0,0,0
3268,247,2016,39,14,25,0.37,36,1021,9,3,2,5,3,2,10,3,1,0,1,3,0,2,0,0,0
3269,248,2016,15,15,0,1.0,100,1021,9,5,1,6,4,1,11,3,3,0,0,3,1,1,0,0,0
3270,249,2016,13,12,1,0.94,93,1021,5,4,3,3,3,1,7,2,0,1,0,2,1,0,0,1,0
3271,250,2016,46,30,16,0.66,65,1021,15,13,2,11,8,2,21,9,1,0,1,3,5,2,0,0,0
3272,251,2016,51,26,25,0.51,51,1021,8,15,3,3,9,1,13,1,0,1,1,3,6,0,0,1,0
3273,252,2016,11,6,5,0.5,50,1021,3,3,0,1,2,0,3,0,0,1,0,1,1,0,0,0,0
3274,253,2016,57,51,6,0.9,89,1021,21,27,3,9,21,1,31,4,1,1,3,15,6,0,0,1,0
3275,254,2016,30,28,2,0.92,91,1021,19,9,0,8,9,0,17,3,2,0,3,9,0,0,0,0,0
3276,255,2016,35,29,6,0.82,82,1021,16,12,1,6,6,1,13,0,3,2,1,0,6,1,0,0,0
3277,256,2016,34,4,30,0.12,12,1021,1,2,1,1,1,1,3,1,0,0,0,0,1,1,0,0,0
3278,257,2016,15,15,0,1.0,100,1021,8,6,1,5,3,1,9,3,1,1,0,0,3,1,0,0,0
3279,258,2016,37,26,11,0.69,69,1021,14,10,2,7,10,2,19,0,7,0,0,10,0,2,0,0,0
3280,259,2016,14,1,13,0.07,7,1021,0,1,0,0,1,0,1,0,0,0,0,1,0,0,0,0,0
3281,260,2016,56,26,30,0.46,46,1021,11,13,2,5,7,2,14,2,1,1,1,1,6,2,0,0,0
3282,261,2016,7,6,1,0.87,86,1021,2,3,1,1,3,1,5,0,1,0,0,3,0,1,0,0,0
3283,262,2016,30,9,21,0.32,31,1021,2,5,2,1,4,1,6,0,1,0,0,3,1,0,1,0,0
3284,263,2016,29,28,1,0.97,96,1021,14,12,2,13,6,2,21,12,1,0,0,0,6,2,0,0,0
3285,264,2016,25,23,2,0.92,91,1021,13,7,3,8,4,2,14,3,5,0,0,1,3,1,1,0,0
3286,265,2016,23,22,1,0.98,97,1021,14,7,1,7,5,1,13,2,4,0,1,3,2,1,0,0,0
3287,266,2016,25,12,13,0.48,48,1021,6,5,1,3,3,1,7,1,1,1,0,1,2,1,0,0,0
3288,267,2016,12,12,0,0.97,96,1021,5,4,3,3,4,1,8,2,0,1,0,4,0,0,0,1,0
3289,268,2016,19,19,0,0.98,97,1021,13,6,0,12,6,0,18,11,1,0,0,6,0,0,0,0,0
3290,269,2016,32,1,31,0.02,2,1021,0,1,0,0,1,0,1,0,0,0,0,1,0,0,0,0,0
3291,270,2016,35,34,1,0.96,95,1021,25,6,3,18,4,2,24,15,1,0,2,2,2,1,1,0,0
3292,271,2016,30,30,0,1.0,99,1021,22,6,2,16,5,2,23,13,0,3,0,4,1,2,0,0,0
3293,272,2016,46,45,1,0.97,97,1021,19,24,2,16,15,2,33,15,0,0,1,6,9,2,0,0,0
3294,273,2016,14,14,0,0.99,99,1021,4,7,3,2,7,3,12,1,0,1,0,7,0,3,0,0,0
3295,274,2016,19,19,0,1.0,99,1021,9,9,1,7,5,1,13,5,2,0,0,1,4,1,0,0,0
3296,275,2016,11,3,8,0.28,27,1021,2,1,0,1,1,0,2,0,1,0,0,1,0,0,0,0,0
3297,276,2016,31,29,2,0.95,94,1021,16,12,1,16,6,1,23,16,0,0,0,0,6,1,0,0,0
3298,277,2016,28,28,0,0.99,98,1021,17,10,1,14,5,1,20,13,0,0,1,0,5,1,0,0,0
3299,278,2016,31,28,3,0.9,90,1021,11,16,1,10,10,1,21,9,1,0,0,4,6,1,0,0,0
3300,279,2016,21,8,13,0.36,36,1021,3,3,2,1,2,2,5,0,0,1,0,1,1,2,0,0,0
3301,280,2016,15,15,0,0.97,96,1021,4,9,2,1,5,2,8,0,0,0,1,1,4,2,0,0,0
3302,281,2016,39,34,5,0.86,86,1021,22,9,3,12,5,3,20,6,2,4,0,1,4,3,0,0,0
3303,282,2016,49,24,25,0.49,48,1021,10,11,3,5,6,1,12,2,2,0,1,1,5,0,0,1,0
3304,283,2016,20,1,19,0.07,7,1021,0,1,0,0,1,0,1,0,0,0,0,1,0,0,0,0,0
3305,284,2016,11,1,10,0.09,9,1021,0,1,0,0,1,0,1,0,0,0,0,1,0,0,0,0,0
3306,285,2016,48,46,2,0.96,96,1021,30,14,2,29,8,1,38,28,1,0,0,2,6,0,1,0,0
3307,286,2016,28,4,24,0.16,15,1021,2,2,0,1,2,0,3,0,1,0,0,2,0,0,0,0,0
3308,287,2016,15,15,0,0.97,96,1021,8,5,2,5,3,1,9,2,3,0,0,1,2,0,1,0,0
3309,288,2016,37,27,10,0.72,72,1021,15,8,4,13,5,4,22,11,2,0,0,2,3,4,0,0,0
3310,289,2016,20,13,7,0.63,63,1021,3,7,3,2,7,1,10,1,1,0,0,7,0,0,0,1,0
3311,290,2016,22,18,4,0.82,81,1021,12,4,2,10,2,1,13,8,2,0,0,0,2,0,1,0,0
3312,291,2016,39,39,0,1.0,100,1021,17,22,0,6,22,0,28,0,1,5,0,22,0,0,0,0,0
3313,292,2016,15,15,0,1.0,99,1021,10,5,0,5,3,0,8,1,3,1,0,1,2,0,0,0,0
3314,293,2016,20,20,0,1.0,99,1021,8,11,1,6,8,1,15,4,2,0,0,5,3,1,0,0,0
3315,294,2016,22,20,2,0.93,93,1021,7,11,2,3,10,1,14,1,1,0,1,9,1,0,1,0,0
3316,295,2016,49,15,34,0.31,31,1021,6,5,4,5,4,2,11,4,1,0,0,3,1,0,2,0,0
3317,296,2016,18,0,18,0.02,2,1021,0,0,0,0,0,0,0,0,0,0,0,0,0,0,0,0,0
3318,297,2016,35,18,17,0.5,50,1021,6,8,4,3,8,4,15,2,0,0,1,8,0,4,0,0,0
3319,298,2016,44,42,2,0.96,95,1021,21,19,2,8,17,2,27,3,0,2,3,15,2,2,0,0,0
3320,299,2016,33,33,0,1.0,99,1021,21,10,2,17,10,1,28,14,2,1,0,10,0,0,1,0,0
3321,300,2016,25,15,10,0.61,60,1021,9,4,2,5,2,2,9,2,2,1,0,0,2,2,0,0,0
3322,301,2016,30,26,4,0.88,87,1021,13,13,0,11,10,0,21,10,0,1,0,7,3,0,0,0,0
3323,302,2016,29,22,7,0.75,74,1021,13,9,0,11,7,0,18,10,0,1,0,5,2,0,0,0,0
3324,303,2016,56,56,0,1.0,100,1021,21,32,3,8,19,2,29,2,0,5,1,6,13,1,1,0,0
3325,304,2016,47,13,34,0.27,27,1021,3,7,3,1,5,2,8,0,0,1,0,3,2,1,1,0,0
3326,305,2016,18,18,0,0.98,98,1021,5,11,2,2,10,2,14,0,1,1,0,9,1,2,0,0,0
3327,306,2016,49,48,1,0.99,98,1021,20,25,3,14,18,1,33,10,2,2,0,11,7,0,0,1,0
3328,307,2016,35,31,4,0.89,88,1021,12,15,4,8,14,3,25,6,1,0,1,13,1,2,1,0,0
3329,308,2016,13,12,1,0.92,91,1021,6,5,1,5,5,1,11,4,1,0,0,5,0,1,0,0,0
3330,309,2016,10,8,2,0.79,79,1021,5,2,1,3,1,1,5,2,0,1,0,0,1,1,0,0,0
3331,310,2016,37,0,37,0.0,0,1021,0,0,0,0,0,0,0,0,0,0,0,0,0,0,0,0,0
3332,311,2016,30,30,0,1.0,99,1021,13,15,2,8,15,1,24,5,2,0,1,15,0,0,1,0,0
3333,312,2016,11,10,1,0.9,89,1021,6,3,1,6,3,1,10,6,0,0,0,3,0,1,0,0,0
3334,313,2016,60,58,2,0.97,96,1021,34,22,2,18,18,2,38,8,6,2,2,14,4,2,0,0,0
3335,314,2016,9,9,0,1.0,100,1021,5,3,1,5,3,1,9,5,0,0,0,3,0,1,0,0,0
3336,315,2016,54,54,0,1.0,99,1021,20,32,2,7,27,2,36,1,0,5,1,22,5,2,0,0,0
3337,316,2016,15,15,0,1.0,99,1021,6,6,3,5,4,3,12,4,1,0,0,2,2,3,0,0,0
3338,317,2016,41,40,1,0.98,97,1021,16,24,0,7,18,0,25,3,1,1,2,12,6,0,0,0,0
3339,318,2016,26,25,1,0.98,98,1021,9,12,4,5,9,3,17,3,0,2,0,6,3,2,1,0,0
3340,319,2016,7,7,0,1.0,100,1021,2,4,1,2,2,1,5,2,0,0,0,0,2,1,0,0,0
3341,320,2016,28,20,8,0.7,69,1021,11,9,0,8,6,0,14,5,3,0,0,3,3,0,0,0,0
3342,321,2016,5,5,0,1.0,99,1021,2,2,1,1,1,1,3,0,1,0,0,0,1,1,0,0,0
3343,322,2016,14,13,1,0.9,89,1021,4,6,3,4,4,2,10,4,0,0,0,2,2,1,1,0,0
3344,323,2016,57,39,18,0.69,68,1021,15,22,2,11,14,1,26,9,0,2,0,6,8,0,1,0,0
3345,324,2016,26,11,15,0.42,41,1021,7,3,1,6,3,1,10,5,1,0,0,3,0,1,0,0,0
3346,325,2016,25,25,0,1.0,100,1021,15,9,1,6,7,1,14,1,2,2,1,5,2,1,0,0,0
3347,326,2016,27,16,11,0.59,59,1021,7,9,0,6,7,0,13,5,1,0,0,5,2,0,0,0,0
3348,327,2016,52,50,2,0.97,96,1021,33,15,2,16,15,2,33,3,9,4,0,15,0,2,0,0,0
3349,328,2016,9,8,1,0.86,86,1021,6,2,0,4,2,0,6,3,0,1,0,2,0,0,0,0,0
3350,329,2016,25,25,0,1.0,100,1021,9,12,4,6,6,2,14,3,3,0,0,0,6,1,0,1,0
3351,330,2016,30,20,10,0.66,66,1021,11,8,1,11,6,1,18,11,0,0,0,4,2,1,0,0,0
3352,331,2016,59,57,2,0.97,97,1021,32,25,0,12,16,0,28,1,3,7,1,7,9,0,0,0,0
3353,332,2016,43,7,36,0.16,16,1021,2,3,2,2,2,1,5,2,0,0,0,1,1,0,1,0,0
3354,333,2016,27,6,21,0.21,20,1021,3,2,1,3,1,1,5,3,0,0,0,0,1,1,0,0,0
3355,334,2016,24,15,9,0.63,62,1021,9,6,0,8,5,0,13,7,1,0,0,4,1,0,0,0,0
3356,335,2016,58,57,1,0.99,99,1021,28,27,2,14,20,1,35,3,9,1,1,13,7,0,1,0,0
3357,336,2016,40,39,1,0.98,97,1021,20,15,4,6,12,2,20,0,0,4,2,9,3,1,0,1,0
3358,337,2016,31,11,20,0.35,34,1021,3,5,3,1,5,2,8,0,0,1,0,5,0,1,1,0,0
3359,338,2016,15,13,2,0.85,85,1021,6,6,1,4,4,1,9,2,2,0,0,2,2,1,0,0,0
3360,339,2016,23,21,2,0.93,93,1021,12,9,0,9,5,0,14,7,1,1,0,1,4,0,0,0,0
3361,340,2016,38,37,1,0.97,96,1021,12,21,4,3,19,1,23,0,0,0,3,17,2,0,0,0,1
3362,341,2016,27,27,0,1.0,99,1021,14,11,2,8,7,2,17,5,1,1,1,3,4,2,0,0,0
3363,342,2016,8,4,4,0.55,55,1021,2,2,0,2,2,0,4,2,0,0,0,2,0,0,0,0,0
3364,343,2016,50,41,9,0.82,81,1021,27,13,1,17,7,1,25,12,2,1,2,1,6,1,0,0,0
3365,344,2016,23,23,0,1.0,99,1021,11,12,0,4,12,0,16,0,2,1,1,12,0,0,0,0,0
3366,345,2016,40,40,0,0.99,99,1021,16,22,2,15,22,1,38,14,1,0,0,22,0,0,1,0,0
3367,346,2016,48,48,0,1.0,100,1021,22,26,0,9,18,0,27,4,0,2,3,10,8,0,0,0,0
3368,347,2016,21,21,0,0.99,99,1021,12,8,1,7,8,1,16,2,5,0,0,8,0,1,0,0,0
3369,348,2016,38,37,1,0.98,97,1021,23,13,1,21,13,1,35,20,0,1,0,13,0,1,0,0,0
3370,349,2016,24,24,0,0.99,99,1021,9,11,4,8,6,3,17,7,1,0,0,1,5,2,1,0,0
3371,350,2016,39,38,1,0.97,96,1021,27,10,1,13,8,1,22,6,3,1,3,6,2,1,0,0,0
3372,351,2016,29,7,22,0.23,23,1021,3,4,0,1,2,0,3,0,0,1,0,0,2,0,0,0,0
3373,352,2016,36,35,1,0.97,96,1021,24,8,3,11,4,2,17,0,10,0,1,0,4,1,1,0,0
3374,353,2016,39,38,1,0.98,98,1021,23,14,1,23,11,1,35,23,0,0,0,8,3,1,0,0,0
3375,354,2016,15,6,9,0.39,38,1021,2,3,1,1,2,1,4,0,1,0,0,1,1,1,0,0,0
3376,355,2016,22,22,0,0.99,99,1021,14,8,0,6,4,0,10,0,5,0,1,0,4,0,0,0,0
3377,356,2016,31,30,1,0.98,98,1021,14,14,2,7,7,2,16,3,2,1,1,0,7,2,0,0,0
3378,357,2016,26,12,14,0.46,46,1021,5,5,2,2,5,1,8,1,0,0,1,5,0,0,1,0,0
3379,358,2016,49,1,48,0.01,1,1021,0,1,0,0,1,0,1,0,0,0,0,1,0,0,0,0,0
3380,359,2016,36,23,13,0.64,63,1021,15,8,0,11,4,0,15,7,4,0,0,0,4,0,0,0,0
3381,360,2016,37,31,6,0.84,84,1021,10,17,4,3,15,2,20,0,0,2,1,13,2,1,0,1,0
3382,361,2016,27,7,20,0.24,24,1021,3,4,0,2,2,0,4,1,1,0,0,0,2,0,0,0,0
3383,362,2016,18,7,11,0.38,38,1021,2,4,1,1,4,1,6,0,1,0,0,4,0,1,0,0,0
3384,363,2016,34,34,0,1.0,100,1021,14,18,2,5,15,2,22,1,0,3,1,12,3,2,0,0,0
3385,364,2016,35,35,0,0.99,99,1021,17,16,2,8,10,2,20,2,3,3,0,4,6,2,0,0,0
3386,365,2016,25,17,8,0.67,66,1021,7,10,0,4,5,0,9,3,0,0,1,0,5,0,0,0,0
3387,366,2016,9,4,5,0.4,39,1021,2,2,0,1,2,0,3,0,1,0,0,2,0,0,0,0,0
3388,367,2016,12,10,2,0.83,82,1021,4,5,1,3,4,1,8,2,1,0,0,3,1,1,0,0,0
3389,368,2016,58,16,42,0.27,26,1021,8,7,1,4,6,1,11,0,4,0,0,5,1,1,0,0,0
3390,369,2016,51,47,4,0.92,91,1021,18,25,4,14,24,4,42,12,1,0,1,23,1,4,0,0,0
3391,370,2016,28,2,26,0.06,5,1021,1,1,0,1,1,0,2,1,0,0,0,1,0,0,0,0,0
3392,371,2016,15,14,1,0.93,93,1021,4,7,3,3,7,2,12,2,1,0,0,7,0,1,1,0,0
3393,372,2016,6,1,5,0.13,12,1021,0,1,0,0,1,0,1,0,0,0,0,1,0,0,0,0,0
3394,373,2016,16,15,1,0.93,93,1021,7,5,3,3,5,1,9,0,2,1,0,5,0,0,0,1,0
3395,374,2016,16,16,0,0.98,97,1021,7,6,3,5,6,2,13,4,0,1,0,6,0,1,1,0,0
3396,375,2016,33,2,31,0.07,6,1021,1,1,0,1,1,0,2,1,0,0,0,1,0,0,0,0,0
3397,376,2016,36,9,27,0.24,24,1021,4,5,0,3,5,0,8,2,1,0,0,5,0,0,0,0,0
3398,377,2016,9,9,0,0.99,98,1021,3,5,1,1,5,1,7,0,0,1,0,5,0,1,0,0,0
3399,378,2016,14,14,0,1.0,99,1021,6,6,2,2,3,2,7,0,0,2,0,0,3,2,0,0,0
3400,379,2016,43,42,1,0.97,96,1021,18,23,1,17,12,1,30,16,1,0,0,1,11,1,0,0,0
3401,380,2016,42,17,25,0.41,41,1021,4,9,4,4,8,4,16,4,0,0,0,7,1,4,0,0,0
3402,381,2016,31,30,1,0.98,97,1021,17,9,4,10,5,3,18,6,2,1,1,1,4,2,1,0,0
3403,382,2016,40,38,2,0.95,95,1021,27,9,2,15,5,1,21,8,4,1,2,1,4,0,1,0,0
3404,383,2016,20,19,1,0.96,95,1021,8,8,3,5,6,3,14,3,1,1,0,4,2,3,0,0,0
3405,384,2016,42,39,3,0.94,93,1021,19,19,1,9,11,1,21,2,4,3,0,3,8,1,0,0,0
3406,385,2016,18,18,0,0.99,98,1021,7,9,2,5,5,2,12,3,2,0,0,1,4,2,0,0,0
3407,386,2016,56,36,20,0.64,63,1021,25,9,2,13,7,1,21,5,4,4,0,5,2,0,1,0,0
3408,387,2016,58,44,14,0.75,75,1021,29,14,1,22,13,1,36,17,3,2,0,12,1,1,0,0,0
3409,388,2016,32,27,5,0.86,85,1021,19,6,2,18,6,1,25,17,1,0,0,6,0,0,1,0,0
3410,389,2016,50,24,26,0.48,47,1021,14,7,3,14,4,2,20,14,0,0,0,1,3,1,1,0,0
3411,390,2016,34,10,24,0.28,28,1021,5,4,1,5,3,1,9,5,0,0,0,2,1,1,0,0,0
3412,391,2016,39,37,2,0.94,93,1021,25,10,2,7,6,2,15,0,1,1,5,2,4,2,0,0,0
3413,392,2016,15,7,8,0.46,45,1021,2,4,1,1,4,1,6,0,1,0,0,4,0,1,0,0,0
3414,393,2016,9,8,1,0.85,85,1021,4,3,1,4,2,1,7,4,0,0,0,1,1,1,0,0,0
3415,394,2016,31,2,29,0.07,7,1021,1,1,0,1,1,0,2,1,0,0,0,1,0,0,0,0,0
3416,395,2016,11,11,0,0.99,98,1021,4,6,1,4,6,1,11,4,0,0,0,6,0,1,0,0,0
3417,396,2016,31,31,0,1.0,100,1021,23,7,1,13,4,1,18,7,2,4,0,1,3,1,0,0,0
3418,397,2016,53,36,17,0.67,67,1021,22,14,0,22,11,0,33,22,0,0,0,8,3,0,0,0,0
3419,398,2016,15,15,0,0.99,99,1021,7,7,1,2,6,1,9,0,0,1,1,5,1,1,0,0,0
3420,399,2016,36,36,0,1.0,100,1021,14,21,1,14,16,1,31,14,0,0,0,11,5,1,0,0,0
3421,400,2016,25,23,2,0.94,93,1021,17,6,0,5,4,0,9,1,0,0,4,2,2,0,0,0,0
3422,401,2016,22,22,0,0.98,97,1021,8,12,2,8,9,2,19,8,0,0,0,6,3,2,0,0,0
3423,402,2016,57,57,0,1.0,99,1021,26,29,2,7,15,1,23,0,0,2,5,1,14,0,1,0,0
3424,403,2016,28,27,1,0.98,97,1021,17,7,3,10,6,2,18,7,0,2,1,5,1,1,1,0,0
3425,404,2016,9,9,0,1.0,100,1021,4,4,1,4,2,1,7,4,0,0,0,0,2,1,0,0,0
3426,405,2016,57,45,12,0.79,78,1021,23,22,0,9,14,0,23,3,0,4,2,6,8,0,0,0,0
3427,406,2016,39,35,4,0.89,89,1021,21,12,2,13,11,2,26,10,0,1,2,10,1,2,0,0,0
3428,407,2016,9,3,6,0.36,35,1021,2,1,0,1,1,0,2,0,1,0,0,1,0,0,0,0,0
3429,408,2016,39,39,0,1.0,99,1021,20,17,2,12,17,1,30,4,8,0,0,17,0,0,1,0,0
3430,409,2016,16,16,0,1.0,100,1021,7,6,3,4,6,3,13,2,1,1,0,6,0,3,0,0,0
3431,410,2016,52,41,11,0.79,79,1021,23,18,0,16,10,0,26,12,1,3,0,2,8,0,0,0,0
3432,411,2016,52,49,3,0.93,93,1021,23,25,1,9,17,1,27,0,5,3,1,9,8,1,0,0,0
3433,412,2016,55,54,1,0.99,98,1021,23,28,3,23,24,1,48,23,0,0,0,20,4,0,0,1,0
3434,413,2016,9,9,0,1.0,99,1021,7,2,0,6,1,0,7,5,1,0,0,0,1,0,0,0,0
3435,414,2016,9,9,0,0.98,97,1021,4,4,1,4,4,1,9,4,0,0,0,4,0,1,0,0,0
3436,415,2016,8,6,2,0.73,73,1021,3,2,1,2,2,1,5,1,1,0,0,2,0,1,0,0,0
3437,416,2016,26,0,26,0.01,1,1021,0,0,0,0,0,0,0,0,0,0,0,0,0,0,0,0,0
3438,417,2016,48,46,2,0.95,94,1021,16,26,4,8,19,3,30,2,4,2,0,12,7,2,1,0,0
3439,418,2016,28,3,25,0.12,12,1021,2,1,0,1,1,0,2,0,1,0,0,1,0,0,0,0,0
3440,419,2016,20,12,8,0.61,60,1021,6,4,2,4,3,2,9,3,0,1,0,2,1,2,0,0,0
3441,420,2016,14,14,0,0.99,98,1021,8,5,1,8,5,1,14,8,0,0,0,5,0,1,0,0,0
3442,421,2016,16,15,1,0.91,90,1021,9,4,2,9,3,2,14,9,0,0,0,2,1,2,0,0,0
3443,422,2016,15,8,7,0.5,50,1021,3,4,1,2,3,1,6,1,1,0,0,2,1,1,0,0,0
3444,423,2016,13,7,6,0.54,53,1021,4,2,1,4,1,1,6,4,0,0,0,0,1,1,0,0,0
3445,424,2016,27,7,20,0.27,26,1021,3,3,1,1,2,1,4,0,0,1,0,1,1,1,0,0,0
3446,425,2016,20,5,15,0.25,25,1021,4,1,0,2,1,0,3,1,0,1,0,1,0,0,0,0,0
3447,426,2016,44,28,16,0.63,62,1021,14,11,3,7,10,3,20,2,3,2,0,9,1,3,0,0,0
3448,427,2016,19,17,2,0.89,89,1021,4,9,4,4,7,1,12,4,0,0,0,5,2,0,0,0,1
3449,428,2016,33,2,31,0.07,7,1021,1,1,0,1,1,0,2,1,0,0,0,1,0,0,0,0,0
3450,429,2016,8,2,6,0.31,31,1021,1,1,0,1,1,0,2,1,0,0,0,1,0,0,0,0,0
3451,430,2016,11,9,2,0.81,80,1021,3,5,1,2,3,1,6,1,1,0,0,1,2,1,0,0,0
3452,431,2016,55,16,39,0.29,28,1021,7,8,1,2,7,1,10,0,0,1,1,6,1,1,0,0,0
3453,432,2016,36,33,3,0.9,90,1021,17,14,2,9,12,1,22,4,3,1,1,10,2,0,1,0,0
3454,433,2016,19,18,1,0.95,94,1021,6,10,2,2,9,1,12,0,0,2,0,8,1,0,1,0,0
3455,434,2016,14,14,0,1.0,99,1021,4,8,2,4,8,2,14,4,0,0,0,8,0,2,0,0,0
3456,435,2016,17,17,0,0.98,98,1021,9,6,2,7,6,2,15,6,0,1,0,6,0,2,0,0,0
3457,436,2016,40,36,4,0.91,90,1021,26,9,1,8,5,1,14,2,0,0,6,1,4,1,0,0,0
3458,437,2016,11,11,0,0.97,96,1021,3,5,3,3,3,2,8,3,0,0,0,1,2,1,1,0,0
3459,438,2016,9,9,0,0.98,98,1021,5,3,1,2,3,1,6,1,0,0,1,3,0,1,0,0,0
3460,439,2016,30,3,27,0.1,9,1021,2,1,0,1,1,0,2,0,1,0,0,1,0,0,0,0,0
3461,440,2016,31,31,0,1.0,100,1021,11,17,3,7,15,3,25,3,4,0,0,13,2,3,0,0,0
3462,441,2016,6,0,6,0.01,1,1021,0,0,0,0,0,0,0,0,0,0,0,0,0,0,0,0,0
3463,442,2016,36,31,5,0.85,85,1021,13,17,1,11,12,1,24,9,2,0,0,7,5,1,0,0,0
3464,443,2016,52,40,12,0.77,76,1021,28,9,3,23,7,2,32,21,0,1,1,5,2,1,1,0,0
3465,444,2016,40,25,15,0.62,61,1021,12,11,2,3,6,2,11,0,0,0,3,1,5,2,0,0,0
3466,445,2016,6,5,1,0.86,86,1021,2,2,1,2,1,1,4,2,0,0,0,0,1,1,0,0,0
3467,446,2016,40,8,32,0.21,20,1021,4,3,1,1,2,1,4,0,0,0,1,1,1,1,0,0,0
3468,447,2016,28,13,15,0.48,47,1021,6,5,2,5,5,1,11,4,1,0,0,5,0,0,1,0,0
3469,448,2016,31,12,19,0.37,37,1021,7,3,2,2,3,1,6,0,0,1,1,3,0,0,1,0,0
3470,449,2016,22,21,1,0.94,94,1021,13,6,2,12,3,2,17,11,1,0,0,0,3,2,0,0,0
3471,450,2016,11,11,0,1.0,100,1021,4,5,2,4,3,2,9,4,0,0,0,1,2,2,0,0,0
3472,451,2016,20,14,6,0.68,68,1021,5,8,1,5,6,1,12,5,0,0,0,4,2,1,0,0,0
3473,452,2016,39,4,35,0.1,10,1021,1,2,1,1,1,1,3,1,0,0,0,0,1,1,0,0,0
3474,453,2016,37,34,3,0.92,92,1021,21,10,3,19,5,1,25,17,2,0,0,0,5,0,0,1,0
3475,454,2016,55,55,0,1.0,100,1021,37,18,0,22,15,0,37,12,6,3,1,12,3,0,0,0,0
3476,455,2016,20,13,7,0.63,63,1021,3,7,3,3,6,2,11,3,0,0,0,5,1,1,1,0,0
3477,456,2016,31,31,0,1.0,99,1021,17,12,2,7,12,1,20,0,4,3,0,12,0,0,1,0,0
3478,457,2016,19,19,0,1.0,100,1021,6,11,2,6,7,1,14,6,0,0,0,3,4,0,1,0,0
3479,458,2016,37,37,0,0.99,99,1021,20,16,1,11,9,1,21,6,3,0,2,2,7,1,0,0,0
3480,459,2016,40,40,0,1.0,99,1021,13,23,4,7,12,4,23,4,0,3,0,1,11,4,0,0,0
3481,460,2016,44,33,11,0.74,74,1021,24,6,3,16,6,3,25,12,2,0,2,6,0,3,0,0,0
3482,461,2016,5,5,0,0.92,91,1021,2,2,1,1,2,1,4,0,1,0,0,2,0,1,0,0,0
3483,462,2016,25,25,0,1.0,99,1021,10,11,4,5,8,2,15,1,3,1,0,5,3,1,0,1,0
3484,463,2016,13,13,0,0.97,97,1021,8,3,2,2,3,1,6,0,0,0,2,3,0,0,1,0,0
3485,464,2016,26,19,7,0.72,72,1021,9,7,3,3,7,2,12,0,1,1,1,7,0,1,1,0,0
3486,465,2016,24,10,14,0.42,42,1021,7,3,0,5,3,0,8,3,2,0,0,3,0,0,0,0,0
3487,466,2016,11,0,11,0.0,0,1021,0,0,0,0,0,0,0,0,0,0,0,0,0,0,0,0,0
3488,467,2016,11,7,4,0.66,65,1021,2,4,1,2,4,1,7,2,0,0,0,4,0,1,0,0,0
3489,468,2016,7,1,6,0.11,11,1021,0,1,0,0,1,0,1,0,0,0,0,1,0,0,0,0,0
3490,469,2016,34,34,0,0.99,99,1021,16,18,0,4,15,0,19,0,0,0,4,12,3,0,0,0,0
3491,470,2016,33,18,15,0.55,54,1021,6,9,3,5,7,1,13,4,1,0,0,5,2,0,0,1,0
3492,471,2016,36,11,25,0.32,31,1021,6,4,1,4,4,1,9,3,0,1,0,4,0,1,0,0,0
3493,472,2016,31,31,0,0.99,98,1021,18,11,2,8,10,2,20,3,0,5,0,9,1,2,0,0,0
3494,473,2016,48,38,10,0.79,79,1021,27,9,2,25,7,2,34,24,0,1,0,5,2,2,0,0,0
3495,474,2016,21,20,1,0.97,96,1021,9,8,3,6,5,2,13,5,0,0,1,2,3,1,1,0,0
3496,475,2016,19,3,16,0.16,16,1021,2,1,0,1,1,0,2,0,1,0,0,1,0,0,0,0,0
3497,476,2016,20,4,16,0.19,19,1021,3,1,0,2,1,0,3,1,1,0,0,1,0,0,0,0,0
3498,477,2016,21,0,21,0.01,1,1021,0,0,0,0,0,0,0,0,0,0,0,0,0,0,0,0,0
3499,478,2016,30,29,1,0.96,95,1021,15,12,2,5,8,1,14,1,0,2,2,4,4,0,1,0,0
3500,479,2016,7,7,0,0.99,99,1021,5,2,0,4,2,0,6,3,1,0,0,2,0,0,0,0,0
3501,480,2016,45,43,2,0.95,95,1021,23,19,1,16,11,1,28,9,7,0,0,3,8,1,0,0,0
3502,481,2016,51,50,1,0.98,98,1021,33,15,2,20,15,1,36,15,0,2,3,15,0,0,1,0,0
3503,482,2016,10,3,7,0.32,32,1021,2,1,0,2,1,0,3,2,0,0,0,1,0,0,0,0,0
3504,483,2016,30,29,1,0.95,95,1021,15,13,1,10,12,1,23,5,5,0,0,11,1,1,0,0,0
3505,484,2016,9,7,2,0.83,82,1021,4,2,1,3,1,1,5,2,1,0,0,0,1,1,0,0,0
3506,485,2016,24,9,15,0.37,36,1021,4,3,2,1,3,2,6,0,0,0,1,3,0,2,0,0,0
3507,486,2016,22,1,21,0.04,4,1021,0,1,0,0,1,0,1,0,0,0,0,1,0,0,0,0,0
3508,487,2016,31,31,0,1.0,99,1021,12,18,1,7,17,1,25,4,1,2,0,16,1,1,0,0,0
3509,488,2016,8,8,0,1.0,99,1021,5,2,1,3,1,1,5,2,0,1,0,0,1,1,0,0,0
3510,489,2016,25,13,12,0.5,50,1021,6,5,2,6,4,2,12,6,0,0,0,3,1,2,0,0,0
3511,490,2016,33,18,15,0.55,54,1021,10,7,1,10,6,1,17,10,0,0,0,5,1,1,0,0,0
3512,491,2016,5,0,5,0.08,8,1021,0,0,0,0,0,0,0,0,0,0,0,0,0,0,0,0,0
3513,492,2016,7,7,0,0.99,98,1021,2,3,2,2,3,2,7,2,0,0,0,3,0,2,0,0,0
3514,493,2016,10,10,0,0.96,95,1021,5,3,2,3,3,2,8,2,0,1,0,3,0,2,0,0,0
3515,494,2016,9,5,4,0.58,57,1021,3,2,0,1,1,0,2,0,0,1,0,0,1,0,0,0,0
3516,495,2016,13,11,2,0.85,84,1021,6,3,2,3,3,2,8,1,1,1,0,3,0,2,0,0,0
3517,496,2016,50,50,0,1.0,100,1021,25,24,1,18,17,1,36,15,0,2,1,10,7,1,0,0,0
3518,497,2016,31,30,1,0.98,97,1021,18,11,1,17,10,1,28,16,1,0,0,9,1,1,0,0,0
3519,498,2016,27,26,1,0.95,95,1021,15,10,1,7,5,1,13,2,2,3,0,0,5,1,0,0,0
3520,499,2016,49,48,1,0.98,97,1021,28,17,3,28,13,2,43,28,0,0,0,9,4,1,1,0,0
3521,500,2016,40,12,28,0.31,30,1021,5,4,3,5,3,1,9,5,0,0,0,2,1,0,0,1,0
3522,501,2016,8,6,2,0.74,73,1021,3,2,1,3,2,1,6,3,0,0,0,2,0,1,0,0,0
3523,502,2016,7,3,4,0.4,39,1021,2,1,0,1,1,0,2,0,1,0,0,1,0,0,0,0,0
3524,503,2016,13,11,2,0.83,82,1021,6,4,1,6,4,1,11,6,0,0,0,4,0,1,0,0,0
3525,504,2016,35,35,0,1.0,99,1021,22,10,3,9,6,1,16,0,7,0,2,2,4,0,0,1,0
3526,505,2016,46,44,2,0.96,95,1021,33,9,2,33,8,1,42,33,0,0,0,7,1,0,1,0,0
3527,506,2016,45,19,26,0.43,42,1021,9,9,1,4,9,1,14,1,1,2,0,9,0,1,0,0,0
3528,507,2016,55,46,9,0.84,84,1021,28,17,1,20,11,1,32,17,0,1,2,5,6,1,0,0,0
3529,508,2016,11,11,0,0.96,95,1021,4,4,3,3,4,3,10,2,1,0,0,4,0,3,0,0,0
3530,509,2016,14,14,0,0.99,98,1021,3,8,3,2,5,2,9,1,1,0,0,2,3,1,1,0,0
3531,510,2016,16,14,2,0.9,90,1021,7,5,2,2,4,1,7,0,0,1,1,3,1,0,1,0,0
3532,511,2016,11,3,8,0.32,31,1021,2,1,0,1,1,0,2,0,1,0,0,1,0,0,0,0,0
3533,512,2016,32,23,9,0.72,71,1021,9,12,2,3,10,1,14,0,0,3,0,8,2,0,1,0,0
3534,513,2016,8,1,7,0.1,10,1021,0,1,0,0,1,0,1,0,0,0,0,1,0,0,0,0,0
3535,514,2016,42,37,5,0.89,89,1021,23,10,4,14,7,4,25,7,5,2,0,4,3,4,0,0,0
3536,515,2016,26,26,0,0.99,98,1021,11,12,3,9,6,2,17,7,2,0,0,0,6,1,1,0,0
3537,516,2016,29,16,13,0.55,54,1021,11,3,2,3,2,1,6,0,0,1,2,1,1,0,1,0,0
3538,517,2016,17,17,0,1.0,99,1021,5,10,2,4,8,2,14,3,1,0,0,6,2,2,0,0,0
3539,518,2016,39,38,1,0.98,97,1021,20,16,2,5,12,1,18,0,0,0,5,8,4,0,1,0,0
3540,519,2016,27,21,6,0.76,76,1021,14,4,3,8,2,2,12,4,3,0,1,0,2,1,1,0,0
3541,520,2016,51,27,24,0.52,52,1021,9,15,3,3,14,3,20,1,0,0,2,13,1,3,0,0,0
3542,521,2016,36,33,3,0.92,91,1021,15,18,0,14,15,0,29,13,1,0,0,12,3,0,0,0,0
3543,522,2016,19,7,12,0.36,36,1021,2,4,1,1,4,1,6,0,1,0,0,4,0,1,0,0,0
3544,523,2016,22,22,0,1.0,100,1021,6,13,3,2,10,3,15,0,0,2,0,7,3,3,0,0,0
3545,524,2016,32,28,4,0.89,89,1021,11,15,2,6,12,1,19,4,0,1,1,9,3,0,1,0,0
3546,525,2016,54,52,2,0.96,95,1021,24,26,2,8,13,2,23,0,1,6,1,0,13,2,0,0,0
3547,526,2016,25,25,0,1.0,100,1021,7,14,4,7,7,2,16,7,0,0,0,0,7,0,2,0,0
3548,527,2016,56,55,1,0.99,98,1021,37,14,4,28,12,2,42,22,3,3,0,10,2,1,0,1,0
3549,528,2016,17,7,10,0.4,39,1021,4,3,0,1,3,0,4,0,0,0,1,3,0,0,0,0,0
3550,529,2016,6,1,5,0.15,14,1021,0,1,0,0,1,0,1,0,0,0,0,1,0,0,0,0,0
3551,530,2016,38,16,22,0.42,42,1021,3,10,3,2,5,2,9,1,1,0,0,0,5,1,1,0,0
3552,531,2016,15,4,11,0.26,26,1021,2,2,0,2,1,0,3,2,0,0,0,0,1,0,0,0,0
3553,532,2016,18,15,3,0.82,82,1021,5,8,2,4,4,1,9,3,1,0,0,0,4,0,1,0,0
3554,533,2016,42,23,19,0.55,54,1021,16,6,1,12,3,1,16,9,2,1,0,0,3,1,0,0,0
3555,534,2016,42,34,8,0.8,79,1021,15,16,3,12,10,1,23,10,1,1,0,4,6,0,0,1,0
3556,535,2016,9,0,9,0.01,1,1021,0,0,0,0,0,0,0,0,0,0,0,0,0,0,0,0,0
3557,536,2016,31,14,17,0.45,45,1021,5,7,2,5,5,2,12,5,0,0,0,3,2,2,0,0,0
3558,537,2016,32,9,23,0.27,27,1021,4,4,1,4,2,1,7,4,0,0,0,0,2,1,0,0,0
3559,538,2016,12,11,1,0.95,94,1021,7,3,1,4,2,1,7,2,1,1,0,1,1,1,0,0,0
3560,539,2016,8,7,1,0.87,87,1021,2,3,2,1,3,2,6,0,1,0,0,3,0,2,0,0,0
3561,540,2016,24,4,20,0.19,18,1021,2,2,0,1,2,0,3,0,1,0,0,2,0,0,0,0,0
3562,541,2016,39,15,24,0.38,37,1021,10,3,2,10,2,1,13,10,0,0,0,1,1,0,1,0,0
3563,542,2016,51,51,0,1.0,99,1021,29,21,1,14,19,1,34,4,6,3,1,17,2,1,0,0,0
3564,543,2016,22,11,11,0.51,51,1021,5,5,1,5,4,1,10,5,0,0,0,3,1,1,0,0,0
3565,544,2016,13,1,12,0.05,5,1021,0,1,0,0,1,0,1,0,0,0,0,1,0,0,0,0,0
3566,545,2016,32,31,1,0.97,96,1021,21,6,4,9,5,1,15,3,3,0,3,4,1,0,0,0,1
3567,546,2016,54,30,24,0.56,56,1021,15,11,4,12,10,4,26,9,3,0,0,9,1,4,0,0,0
3568,547,2016,52,48,4,0.93,92,1021,27,19,2,17,16,1,34,10,5,1,1,13,3,0,1,0,0
3569,548,2016,40,40,0,0.99,99,1021,22,17,1,15,11,1,27,12,0,2,1,5,6,1,0,0,0
3570,549,2016,23,23,0,1.0,100,1021,13,6,4,13,4,4,21,13,0,0,0,2,2,4,0,0,0
3571,550,2016,22,22,0,1.0,100,1021,13,5,4,7,3,3,13,2,4,1,0,1,2,2,1,0,0
3572,551,2016,11,10,1,0.93,92,1021,5,4,1,2,3,1,6,1,0,0,1,2,1,1,0,0,0
3573,552,2016,39,6,33,0.16,15,1021,3,3,0,1,2,0,3,0,0,1,0,1,1,0,0,0,0
3574,553,2016,46,6,40,0.13,12,1021,3,2,1,2,2,1,5,1,1,0,0,2,0,1,0,0,0
3575,554,2016,40,32,8,0.81,80,1021,16,13,3,12,7,3,22,8,4,0,0,1,6,3,0,0,0
3576,555,2016,16,16,0,0.97,96,1021,9,4,3,6,3,3,12,4,1,1,0,2,1,3,0,0,0
3577,556,2016,10,10,0,1.0,100,1021,2,6,2,2,5,2,9,2,0,0,0,4,1,2,0,0,0
3578,557,2016,56,54,2,0.96,95,1021,40,14,0,30,13,0,43,26,0,2,2,12,1,0,0,0,0
3579,558,2016,38,38,0,1.0,100,1021,26,9,3,10,8,1,19,1,5,1,3,7,1,0,0,1,0
3580,559,2016,45,45,0,1.0,100,1021,31,13,1,21,11,1,33,16,2,1,2,9,2,1,0,0,0
3581,560,2016,37,36,1,0.98,97,1021,21,12,3,14,6,3,23,9,4,0,1,0,6,3,0,0,0
3582,561,2016,16,16,0,1.0,100,1021,11,3,2,10,2,1,13,9,1,0,0,1,1,0,1,0,0
3583,562,2016,27,16,11,0.58,57,1021,10,5,1,6,3,1,10,2,4,0,0,1,2,1,0,0,0
3584,563,2016,36,21,15,0.59,59,1021,13,5,3,12,4,2,18,11,1,0,0,3,1,1,1,0,0
3585,564,2016,60,55,5,0.92,91,1021,37,15,3,35,15,2,52,34,0,1,0,15,0,1,1,0,0
3586,565,2016,9,2,7,0.25,25,1021,1,1,0,1,1,0,2,1,0,0,0,1,0,0,0,0,0
3587,566,2016,16,10,6,0.64,63,1021,6,3,1,3,2,1,6,1,1,1,0,1,1,1,0,0,0
3588,567,2016,32,2,30,0.06,6,1021,1,1,0,1,1,0,2,1,0,0,0,1,0,0,0,0,0
3589,568,2016,12,12,0,0.98,97,1021,7,3,2,2,2,2,6,0,0,1,1,1,1,2,0,0,0
3590,569,2016,41,41,0,1.0,99,1021,19,18,4,5,11,4,20,0,0,1,4,4,7,4,0,0,0
3591,570,2016,47,47,0,1.0,100,1021,32,13,2,23,13,1,37,18,1,4,0,13,0,0,1,0,0
3592,571,2016,6,0,6,0.04,3,1021,0,0,0,0,0,0,0,0,0,0,0,0,0,0,0,0,0
3593,572,2016,11,10,1,0.92,91,1021,7,2,1,5,1,1,7,3,2,0,0,0,1,1,0,0,0
3594,573,2016,35,34,1,0.97,96,1021,11,20,3,10,12,1,23,9,1,0,0,4,8,0,0,1,0
3595,574,2016,27,26,1,0.97,97,1021,9,15,2,8,15,2,25,7,1,0,0,15,0,2,0,0,0
3596,575,2016,26,25,1,0.97,97,1021,8,14,3,8,10,2,20,8,0,0,0,6,4,1,1,0,0
3597,576,2016,42,42,0,1.0,99,1021,27,11,4,10,8,3,21,1,1,8,0,5,3,2,1,0,0
3598,577,2016,12,1,11,0.12,11,1021,0,1,0,0,1,0,1,0,0,0,0,1,0,0,0,0,0
3599,578,2016,13,0,13,0.03,3,1021,0,0,0,0,0,0,0,0,0,0,0,0,0,0,0,0,0
3600,579,2016,34,31,3,0.9,90,1021,23,6,2,6,3,2,11,0,0,1,5,0,3,2,0,0,0
3601,580,2016,19,15,4,0.79,79,1021,10,5,0,4,3,0,7,0,3,0,1,1,2,0,0,0,0
3602,581,2016,9,9,0,1.0,99,1021,3,5,1,3,3,1,7,3,0,0,0,1,2,1,0,0,0
3603,582,2016,33,32,1,0.97,96,1021,19,10,3,10,10,2,22,1,9,0,0,10,0,1,1,0,0
3604,583,2016,10,6,4,0.6,59,1021,2,3,1,1,3,1,5,0,1,0,0,3,0,1,0,0,0
3605,584,2016,38,29,9,0.77,76,1021,21,8,0,14,7,0,21,10,1,3,0,6,1,0,0,0,0
3606,585,2016,14,5,9,0.33,32,1021,1,3,1,1,3,1,5,1,0,0,0,3,0,1,0,0,0
3607,586,2016,34,12,22,0.37,36,1021,6,5,1,6,3,1,10,6,0,0,0,1,2,1,0,0,0
3608,587,2016,17,17,0,1.0,100,1021,8,6,3,5,3,3,11,2,3,0,0,0,3,3,0,0,0
3609,588,2016,27,27,0,1.0,99,1021,19,7,1,18,7,1,26,17,1,0,0,7,0,1,0,0,0
3610,589,2016,43,43,0,1.0,100,1021,16,23,4,4,20,3,27,0,0,0,4,17,3,2,1,0,0
3611,590,2016,24,17,7,0.7,70,1021,10,7,0,6,5,0,11,4,1,0,1,3,2,0,0,0,0
3612,591,2016,15,15,0,1.0,100,1021,9,4,2,8,3,1,12,7,1,0,0,2,1,0,1,0,0
3613,592,2016,5,5,0,0.95,95,1021,2,3,0,2,2,0,4,2,0,0,0,1,1,0,0,0,0
3614,593,2016,8,8,0,1.0,99,1021,5,2,1,4,1,1,6,3,1,0,0,0,1,1,0,0,0
3615,594,2016,55,54,1,0.99,98,1021,30,24,0,26,12,0,38,23,2,1,0,0,12,0,0,0,0
3616,595,2016,20,7,13,0.35,34,1021,2,3,2,1,2,2,5,0,1,0,0,1,1,2,0,0,0
3617,596,2016,12,12,0,0.96,96,1021,3,6,3,3,6,3,12,3,0,0,0,6,0,3,0,0,0
3618,597,2016,29,2,27,0.06,6,1021,1,1,0,1,1,0,2,1,0,0,0,1,0,0,0,0,0
3619,598,2016,12,11,1,0.93,93,1021,8,2,1,2,2,1,5,0,0,0,2,2,0,1,0,0,0
3620,599,2016,17,10,7,0.57,56,1021,3,4,3,1,4,2,7,0,0,1,0,4,0,1,1,0,0
3621,600,2016,16,13,3,0.8,79,1021,4,5,4,3,5,4,12,2,1,0,0,5,0,4,0,0,0
3622,601,2016,28,22,6,0.8,79,1021,16,4,2,12,4,2,18,9,2,1,0,4,0,2,0,0,0
3623,602,2016,8,8,0,0.97,96,1021,3,3,2,3,2,2,7,3,0,0,0,1,1,2,0,0,0
3624,603,2016,59,58,1,0.99,98,1021,33,24,1,15,12,1,28,6,3,3,3,0,12,1,0,0,0
3625,604,2016,44,40,4,0.91,91,1021,21,18,1,8,18,1,27,2,1,3,2,18,0,1,0,0,0
3626,605,2016,48,10,38,0.2,19,1021,5,4,1,5,4,1,10,5,0,0,0,4,0,1,0,0,0
3627,606,2016,35,32,3,0.92,91,1021,15,16,1,11,11,1,23,9,1,0,1,6,5,1,0,0,0
3628,607,2016,40,25,15,0.63,63,1021,10,15,0,5,8,0,13,1,3,1,0,1,7,0,0,0,0
3629,608,2016,6,3,3,0.52,51,1021,2,1,0,2,1,0,3,2,0,0,0,1,0,0,0,0,0
3630,609,2016,15,15,0,0.99,98,1021,7,7,1,3,7,1,11,1,0,2,0,7,0,1,0,0,0
3631,610,2016,9,1,8,0.11,10,1021,0,1,0,0,1,0,1,0,0,0,0,1,0,0,0,0,0
3632,611,2016,48,12,36,0.25,25,1021,5,4,3,3,2,3,8,2,0,1,0,0,2,3,0,0,0
3633,612,2016,12,12,0,0.98,97,1021,7,5,0,6,5,0,11,5,1,0,0,5,0,0,0,0,0
3634,613,2016,12,12,0,0.97,97,1021,3,6,3,2,3,3,8,1,1,0,0,0,3,3,0,0,0
3635,614,2016,6,6,0,1.0,100,1021,4,2,0,3,1,0,4,2,1,0,0,0,1,0,0,0,0
3636,615,2016,27,27,0,1.0,99,1021,18,5,4,17,4,2,23,16,1,0,0,3,1,1,0,1,0
3637,616,2016,30,6,24,0.2,20,1021,3,2,1,1,1,1,3,0,0,1,0,0,1,1,0,0,0
3638,617,2016,14,14,0,0.98,97,1021,8,5,1,4,5,1,10,1,2,1,0,5,0,1,0,0,0
3639,618,2016,6,6,0,0.93,92,1021,3,3,0,2,3,0,5,1,1,0,0,3,0,0,0,0,0
3640,619,2016,17,1,16,0.07,6,1021,0,1,0,0,1,0,1,0,0,0,0,1,0,0,0,0,0
3641,620,2016,18,17,1,0.96,96,1021,9,5,3,9,5,2,16,9,0,0,0,5,0,1,1,0,0
3642,621,2016,9,9,0,1.0,100,1021,5,3,1,3,2,1,6,2,0,1,0,1,1,1,0,0,0
3643,622,2016,32,1,31,0.05,4,1021,0,1,0,0,1,0,1,0,0,0,0,1,0,0,0,0,0
3644,623,2016,52,29,23,0.55,55,1021,15,13,1,13,7,1,21,11,2,0,0,1,6,1,0,0,0
3645,624,2016,20,19,1,0.94,93,1021,8,8,3,6,7,2,15,5,0,1,0,6,1,1,1,0,0
3646,625,2016,33,32,1,0.98,98,1021,11,19,2,5,13,1,19,0,4,1,0,7,6,0,1,0,0
3647,626,2016,13,13,0,1.0,99,1021,7,4,2,3,3,2,8,1,1,0,1,2,1,2,0,0,0
3648,627,2016,17,17,0,1.0,99,1021,10,4,3,9,2,1,12,8,1,0,0,0,2,0,0,1,0
3649,628,2016,13,13,0,1.0,100,1021,6,7,0,2,5,0,7,0,1,0,1,3,2,0,0,0,0
3650,629,2016,33,33,0,1.0,100,1021,15,15,3,11,11,2,24,7,4,0,0,7,4,1,1,0,0
3651,630,2016,15,7,8,0.44,43,1021,2,3,2,1,2,1,4,0,1,0,0,1,1,0,1,0,0
3652,631,2016,58,42,16,0.73,72,1021,20,22,0,9,11,0,20,1,5,3,0,0,11,0,0,0,0
3653,632,2016,9,9,0,0.96,96,1021,5,3,1,2,3,1,6,1,0,0,1,3,0,1,0,0,0
3654,633,2016,9,7,2,0.82,82,1021,4,2,1,1,1,1,3,0,0,0,1,0,1,1,0,0,0
3655,634,2016,6,5,1,0.79,79,1021,4,1,0,2,1,0,3,0,2,0,0,1,0,0,0,0,0
3656,635,2016,24,19,5,0.8,79,1021,5,11,3,4,7,1,12,3,1,0,0,3,4,0,0,1,0
3657,636,2016,15,3,12,0.21,21,1021,2,1,0,2,1,0,3,2,0,0,0,1,0,0,0,0,0
3658,637,2016,23,23,0,1.0,100,1021,14,6,3,13,3,1,17,12,1,0,0,0,3,0,0,1,0
3659,638,2016,29,28,1,0.98,97,1021,9,16,3,7,14,2,23,5,2,0,0,12,2,1,1,0,0
3660,639,2016,7,3,4,0.41,40,1021,2,1,0,1,1,0,2,0,1,0,0,1,0,0,0,0,0
3661,640,2016,13,10,3,0.74,74,1021,7,3,0,7,2,0,9,7,0,0,0,1,1,0,0,0,0
3662,641,2016,6,4,2,0.59,59,1021,1,2,1,1,1,1,3,1,0,0,0,0,1,1,0,0,0
3663,642,2016,28,28,0,1.0,100,1021,16,8,4,9,4,2,15,5,2,1,1,0,4,0,2,0,0
3664,643,2016,56,35,21,0.62,61,1021,14,20,1,6,14,1,21,0,5,0,1,8,6,1,0,0,0
3665,644,2016,11,11,0,1.0,99,1021,5,4,2,2,3,2,7,1,0,0,1,2,1,2,0,0,0
3666,645,2016,23,21,2,0.9,90,1021,10,8,3,10,8,1,19,10,0,0,0,8,0,0,0,1,0
3667,646,2016,58,3,55,0.06,5,1021,2,1,0,2,1,0,3,2,0,0,0,1,0,0,0,0,0
3668,647,2016,32,12,20,0.36,36,1021,7,4,1,4,3,1,8,2,1,1,0,2,1,1,0,0,0
3669,648,2016,34,22,12,0.66,65,1021,7,11,4,2,6,1,9,0,0,1,1,1,5,0,0,0,1
3670,649,2016,27,27,0,1.0,99,1021,15,12,0,4,10,0,14,0,0,1,3,8,2,0,0,0,0
3671,650,2016,37,37,0,1.0,100,1021,25,11,1,25,11,1,37,25,0,0,0,11,0,1,0,0,0
3672,651,2016,26,11,15,0.41,40,1021,6,3,2,3,3,1,7,1,1,1,0,3,0,0,1,0,0
3673,652,2016,40,40,0,0.99,99,1021,14,24,2,9,16,1,26,6,1,2,0,8,8,0,1,0,0
3674,653,2016,14,14,0,0.99,98,1021,4,7,3,1,6,3,10,0,0,0,1,5,1,3,0,0,0
3675,654,2016,40,18,22,0.45,45,1021,13,4,1,7,4,1,12,4,1,1,1,4,0,1,0,0,0
3676,655,2016,50,50,0,1.0,99,1021,35,14,1,21,9,1,31,13,5,0,3,4,5,1,0,0,0
3677,656,2016,47,47,0,1.0,99,1021,31,15,1,20,12,1,33,13,4,2,1,9,3,1,0,0,0
3678,657,2016,32,32,0,0.99,99,1021,14,14,4,14,7,2,23,14,0,0,0,0,7,0,2,0,0
3679,658,2016,12,3,9,0.26,26,1021,1,2,0,1,1,0,2,1,0,0,0,0,1,0,0,0,0
3680,659,2016,38,37,1,0.98,97,1021,16,19,2,10,12,2,24,6,2,2,0,5,7,2,0,0,0
3681,660,2016,21,16,5,0.76,75,1021,5,7,4,2,4,1,7,1,0,0,1,1,3,0,0,0,1
3682,661,2016,37,32,5,0.87,86,1021,20,10,2,11,6,1,18,6,2,2,1,2,4,0,1,0,0
3683,662,2016,29,28,1,0.98,97,1021,10,16,2,5,10,2,17,3,0,1,1,4,6,2,0,0,0
3684,663,2016,39,12,27,0.31,31,1021,9,2,1,7,1,1,9,6,0,1,0,0,1,1,0,0,0
3685,664,2016,45,1,44,0.03,3,1021,0,1,0,0,1,0,1,0,0,0,0,1,0,0,0,0,0
3686,665,2016,28,25,3,0.88,88,1021,16,8,1,16,6,1,23,16,0,0,0,4,2,1,0,0,0
3687,666,2016,24,6,18,0.27,26,1021,3,2,1,3,2,1,6,3,0,0,0,2,0,1,0,0,0
3688,667,2016,30,12,18,0.41,41,1021,5,7,0,2,7,0,9,0,1,1,0,7,0,0,0,0,0
3689,668,2016,38,31,7,0.82,81,1021,12,16,3,8,13,2,23,4,4,0,0,10,3,1,1,0,0
3690,669,2016,42,14,28,0.32,32,1021,4,6,4,3,5,1,9,2,1,0,0,4,1,0,0,0,1
3691,670,2016,14,13,1,0.91,91,1021,10,2,1,10,1,1,12,10,0,0,0,0,1,1,0,0,0
3692,671,2016,47,47,0,1.0,100,1021,26,20,1,13,18,1,32,4,5,4,0,16,2,1,0,0,0
3693,672,2016,41,22,19,0.54,54,1021,8,10,4,4,9,3,16,1,2,1,0,8,1,2,1,0,0
3694,673,2016,14,6,8,0.45,45,1021,3,2,1,1,2,1,4,0,0,1,0,2,0,1,0,0,0
3695,674,2016,24,23,1,0.96,95,1021,9,12,2,5,9,2,16,2,2,1,0,6,3,2,0,0,0
3696,675,2016,9,9,0,1.0,100,1021,6,2,1,6,1,1,8,6,0,0,0,0,1,1,0,0,0
3697,676,2016,19,18,1,0.97,96,1021,7,8,3,4,5,1,10,1,3,0,0,2,3,0,0,1,0
3698,677,2016,11,11,0,0.96,95,1021,8,2,1,2,1,1,4,0,0,0,2,0,1,1,0,0,0
3699,678,2016,26,26,0,1.0,100,1021,18,6,2,18,3,2,23,18,0,0,0,0,3,2,0,0,0
3700,679,2016,22,22,0,1.0,99,1021,9,11,2,9,10,2,21,9,0,0,0,9,1,2,0,0,0
3701,680,2016,25,1,24,0.03,3,1021,0,1,0,0,1,0,1,0,0,0,0,1,0,0,0,0,0
3702,681,2016,40,40,0,1.0,100,1021,29,9,2,20,7,1,28,11,9,0,0,5,2,0,1,0,0
3703,682,2016,38,38,0,1.0,100,1021,27,9,2,8,5,1,14,0,2,1,5,1,4,0,1,0,0
3704,683,2016,5,5,0,0.98,98,1021,2,2,1,2,2,1,5,2,0,0,0,2,0,1,0,0,0
3705,684,2016,27,25,2,0.92,91,1021,13,9,3,4,5,1,10,0,0,3,1,1,4,0,0,1,0
3706,685,2016,14,11,3,0.79,79,1021,6,3,2,3,3,1,7,0,3,0,0,3,0,0,1,0,0
3707,686,2016,26,12,14,0.45,45,1021,5,4,3,2,3,2,7,1,0,0,1,2,1,1,1,0,0
3708,687,2016,20,19,1,0.94,93,1021,7,11,1,2,7,1,10,0,0,1,1,3,4,1,0,0,0
3709,688,2016,13,3,10,0.21,21,1021,2,1,0,2,1,0,3,2,0,0,0,1,0,0,0,0,0
3710,689,2016,46,46,0,0.99,98,1021,18,26,2,7,24,2,33,1,1,5,0,22,2,2,0,0,0
3711,690,2016,46,44,2,0.95,94,1021,27,16,1,12,13,1,26,5,1,4,2,10,3,1,0,0,0
3712,691,2016,31,3,28,0.1,9,1021,2,1,0,1,1,0,2,0,1,0,0,1,0,0,0,0,0
3713,692,2016,28,25,3,0.9,90,1021,16,8,1,12,5,1,18,10,0,2,0,2,3,1,0,0,0
3714,693,2016,15,15,0,1.0,100,1021,9,5,1,7,5,1,13,6,0,1,0,5,0,1,0,0,0
3715,694,2016,55,53,2,0.97,96,1021,30,20,3,15,18,3,36,5,7,1,2,16,2,3,0,0,0
3716,695,2016,36,15,21,0.41,40,1021,9,5,1,7,5,1,13,5,2,0,0,5,0,1,0,0,0
3717,696,2016,27,3,24,0.1,9,1021,2,1,0,1,1,0,2,0,1,0,0,1,0,0,0,0,0
3718,697,2016,31,27,4,0.88,87,1021,9,15,3,9,10,3,22,9,0,0,0,5,5,3,0,0,0
3719,698,2016,44,43,1,0.98,97,1021,29,12,2,17,7,2,26,10,3,3,1,2,5,2,0,0,0
3720,699,2016,34,34,0,0.99,98,1021,13,20,1,8,18,1,27,5,2,0,1,16,2,1,0,0,0
3721,700,2016,40,34,6,0.86,85,1021,18,15,1,15,10,1,26,12,3,0,0,5,5,1,0,0,0
3722,701,2016,31,31,0,1.0,99,1021,21,7,3,14,6,2,22,7,7,0,0,5,1,1,1,0,0
3723,702,2016,44,41,3,0.93,92,1021,26,14,1,15,8,1,24,8,5,0,2,2,6,1,0,0,0
3724,703,2016,34,34,0,1.0,100,1021,25,8,1,9,4,1,14,0,3,5,1,0,4,1,0,0,0
3725,704,2016,32,8,24,0.26,26,1021,3,4,1,2,4,1,7,1,1,0,0,4,0,1,0,0,0
3726,705,2016,6,4,2,0.62,61,1021,2,2,0,1,1,0,2,0,1,0,0,0,1,0,0,0,0
3727,706,2016,17,2,15,0.15,14,1021,1,1,0,1,1,0,2,1,0,0,0,1,0,0,0,0,0
3728,707,2016,29,28,1,0.98,97,1021,18,8,2,7,8,1,16,2,0,4,1,8,0,0,1,0,0
3729,708,2016,39,38,1,0.99,98,1021,25,12,1,15,6,1,22,9,4,0,2,0,6,1,0,0,0
3730,709,2016,42,34,8,0.82,82,1021,24,9,1,7,8,1,16,0,2,0,5,7,1,1,0,0,0
3731,710,2016,20,6,14,0.3,30,1021,3,2,1,3,2,1,6,3,0,0,0,2,0,1,0,0,0
3732,711,2016,5,5,0,1.0,99,1021,2,2,1,1,2,1,4,0,1,0,0,2,0,1,0,0,0
3733,712,2016,48,44,4,0.92,92,1021,18,22,4,6,14,4,24,1,0,3,2,6,8,4,0,0,0
3734,713,2016,24,20,4,0.84,84,1021,9,8,3,3,8,3,14,0,1,1,1,8,0,3,0,0,0
3735,714,2016,30,27,3,0.89,89,1021,16,7,4,5,7,1,13,1,0,1,3,7,0,0,0,0,1
3736,715,2016,47,15,32,0.33,32,1021,7,8,0,7,5,0,12,7,0,0,0,2,3,0,0,0,0
3737,716,2016,34,34,0,0.99,99,1021,12,20,2,12,20,1,33,12,0,0,0,20,0,0,1,0,0
3738,717,2016,32,31,1,0.97,96,1021,21,6,4,9,3,2,14,2,4,1,2,0,3,1,0,1,0
3739,718,2016,35,35,0,0.99,99,1021,17,14,4,11,10,2,23,7,2,2,0,6,4,0,2,0,0
3740,719,2016,39,38,1,0.96,96,1021,27,9,2,8,6,1,15,1,1,0,6,3,3,0,1,0,0
3741,720,2016,7,2,5,0.25,25,1021,1,1,0,1,1,0,2,1,0,0,0,1,0,0,0,0,0
3742,721,2016,38,37,1,0.98,97,1021,25,9,3,11,6,2,19,1,7,2,1,3,3,1,1,0,0
3743,722,2016,24,20,4,0.82,81,1021,15,4,1,5,3,1,9,1,0,2,2,2,1,1,0,0,0
3744,723,2016,8,7,1,0.83,83,1021,3,4,0,1,4,0,5,0,0,1,0,4,0,0,0,0,0
3745,724,2016,24,17,7,0.71,71,1021,7,8,2,6,4,2,12,5,1,0,0,0,4,2,0,0,0
3746,725,2016,26,12,14,0.46,46,1021,9,2,1,4,2,1,7,2,0,1,1,2,0,1,0,0,0
3747,726,2016,28,28,0,1.0,100,1021,13,11,4,10,11,4,25,7,3,0,0,11,0,4,0,0,0
3748,727,2016,24,22,2,0.93,92,1021,11,9,2,4,6,1,11,0,1,3,0,3,3,0,1,0,0
3749,728,2016,28,21,7,0.75,74,1021,9,10,2,5,10,2,17,3,0,2,0,10,0,2,0,0,0
3750,729,2016,24,22,2,0.91,91,1021,15,4,3,7,4,3,14,4,0,1,2,4,0,3,0,0,0
3751,730,2016,30,2,28,0.08,7,1021,1,1,0,1,1,0,2,1,0,0,0,1,0,0,0,0,0
3752,731,2016,51,51,0,1.0,99,1021,25,26,0,13,24,0,37,2,10,1,0,22,2,0,0,0,0
3753,732,2016,9,8,1,0.91,90,1021,6,2,0,5,2,0,7,4,1,0,0,2,0,0,0,0,0
3754,733,2016,10,10,0,1.0,99,1021,4,5,1,2,3,1,6,0,2,0,0,1,2,1,0,0,0
3755,734,2016,34,28,6,0.84,83,1021,12,15,1,5,15,1,21,1,2,1,1,15,0,1,0,0,0
3756,735,2016,18,16,2,0.89,88,1021,10,5,1,7,5,1,13,5,1,1,0,5,0,1,0,0,0
3757,736,2016,31,21,10,0.69,69,1021,8,12,1,3,6,1,10,0,1,2,0,0,6,1,0,0,0
3758,737,2016,49,47,2,0.95,94,1021,32,11,4,17,6,1,24,9,4,1,3,1,5,0,0,0,1
3759,738,2016,31,29,2,0.95,94,1021,21,5,3,12,5,3,20,7,1,4,0,5,0,3,0,0,0
3760,739,2016,36,35,1,0.96,95,1021,22,12,1,10,9,1,20,3,4,1,2,6,3,1,0,0,0
3761,740,2016,46,46,0,1.0,100,1021,34,9,3,20,7,3,30,8,10,2,0,5,2,3,0,0,0
3762,741,2016,15,6,9,0.42,42,1021,3,2,1,2,2,1,5,1,1,0,0,2,0,1,0,0,0
3763,742,2016,46,46,0,0.99,99,1021,30,13,3,13,9,3,25,3,5,3,2,5,4,3,0,0,0
3764,743,2016,47,8,39,0.17,16,1021,5,3,0,2,3,0,5,0,1,1,0,3,0,0,0,0,0
3765,744,2016,16,12,4,0.76,76,1021,5,6,1,3,3,1,7,1,2,0,0,0,3,1,0,0,0
3766,745,2016,36,13,23,0.36,36,1021,4,8,1,2,7,1,10,1,0,1,0,6,1,1,0,0,0
3767,746,2016,31,27,4,0.86,85,1021,18,6,3,7,5,1,13,2,1,2,2,4,1,0,0,1,0
3768,747,2016,8,8,0,1.0,100,1021,2,4,2,1,3,2,6,0,1,0,0,2,1,2,0,0,0
3769,748,2016,32,32,0,1.0,99,1021,17,14,1,15,13,1,29,14,0,1,0,12,1,1,0,0,0
3770,749,2016,7,7,0,1.0,99,1021,3,3,1,3,2,1,6,3,0,0,0,1,1,1,0,0,0
3771,750,2016,36,36,0,0.99,98,1021,17,18,1,12,11,1,24,7,5,0,0,4,7,1,0,0,0
3772,751,2016,31,3,28,0.09,8,1021,1,2,0,1,1,0,2,1,0,0,0,0,1,0,0,0,0
3773,752,2016,20,11,9,0.57,56,1021,3,6,2,3,3,2,8,3,0,0,0,0,3,2,0,0,0
3774,753,2016,21,15,6,0.74,73,1021,10,3,2,9,3,1,13,8,1,0,0,3,0,0,1,0,0
3775,754,2016,6,2,4,0.27,26,1021,1,1,0,1,1,0,2,1,0,0,0,1,0,0,0,0,0
3776,755,2016,30,8,22,0.25,25,1021,4,4,0,2,4,0,6,0,2,0,0,4,0,0,0,0,0
3777,756,2016,25,22,3,0.89,88,1021,12,10,0,3,5,0,8,0,0,0,3,0,5,0,0,0,0
3778,757,2016,38,38,0,0.99,98,1021,20,18,0,16,10,0,26,13,2,1,0,2,8,0,0,0,0
3779,758,2016,43,21,22,0.49,48,1021,8,12,1,3,11,1,15,0,2,0,1,10,1,1,0,0,0
3780,759,2016,27,22,5,0.8,79,1021,7,11,4,4,7,4,15,2,1,1,0,3,4,4,0,0,0
3781,760,2016,16,5,11,0.34,34,1021,2,2,1,2,1,1,4,2,0,0,0,0,1,1,0,0,0
3782,761,2016,15,14,1,0.96,95,1021,8,4,2,5,3,2,10,2,3,0,0,2,1,2,0,0,0
3783,762,2016,43,21,22,0.49,49,1021,9,11,1,8,9,1,18,7,1,0,0,7,2,1,0,0,0
3784,763,2016,52,51,1,0.99,98,1021,30,21,0,23,17,0,40,19,1,3,0,13,4,0,0,0,0
3785,764,2016,28,3,25,0.12,12,1021,2,1,0,1,1,0,2,0,1,0,0,1,0,0,0,0,0
3786,765,2016,36,17,19,0.47,47,1021,9,6,2,4,6,1,11,1,2,0,1,6,0,0,1,0,0
3787,766,2016,15,13,2,0.87,87,1021,9,3,1,5,3,1,9,1,4,0,0,3,0,1,0,0,0
3788,767,2016,34,13,21,0.39,38,1021,8,5,0,5,3,0,8,4,0,0,1,1,2,0,0,0,0
3789,768,2016,7,5,2,0.73,72,1021,2,2,1,1,1,1,3,0,1,0,0,0,1,1,0,0,0
3790,769,2016,20,20,0,1.0,99,1021,8,10,2,7,5,1,13,6,1,0,0,0,5,0,1,0,0
3791,770,2016,40,1,39,0.03,3,1021,0,1,0,0,1,0,1,0,0,0,0,1,0,0,0,0,0
3792,771,2016,40,16,24,0.4,40,1021,7,6,3,2,5,1,8,0,0,1,1,4,1,0,0,1,0
3793,772,2016,18,1,17,0.04,3,1021,0,1,0,0,1,0,1,0,0,0,0,1,0,0,0,0,0
3794,773,2016,39,9,30,0.22,21,1021,3,5,1,2,3,1,6,1,1,0,0,1,2,1,0,0,0
3795,774,2016,10,9,1,0.9,90,1021,3,4,2,3,4,2,9,3,0,0,0,4,0,2,0,0,0
3796,775,2016,6,0,6,0.06,6,1021,0,0,0,0,0,0,0,0,0,0,0,0,0,0,0,0,0
3797,776,2016,18,10,8,0.57,56,1021,3,6,1,1,6,1,8,0,0,1,0,6,0,1,0,0,0
3798,777,2016,13,13,0,1.0,100,1021,5,6,2,2,4,1,7,0,1,1,0,2,2,0,1,0,0
3799,778,2016,50,20,30,0.4,39,1021,12,8,0,3,7,0,10,0,0,0,3,6,1,0,0,0,0
3800,779,2016,55,54,1,0.98,98,1021,31,20,3,13,10,1,24,5,2,2,4,0,10,0,0,1,0
3801,780,2016,34,30,4,0.88,87,1021,19,8,3,9,8,2,19,3,3,2,1,8,0,1,1,0,0
3802,781,2016,25,22,3,0.89,89,1021,7,13,2,5,10,1,16,3,2,0,0,7,3,0,1,0,0
3803,782,2016,49,49,0,1.0,100,1021,20,28,1,12,23,1,36,5,6,1,0,18,5,1,0,0,0
3804,783,2016,17,17,0,0.99,98,1021,11,5,1,10,3,1,14,9,1,0,0,1,2,1,0,0,0
3805,784,2016,47,45,2,0.96,95,1021,27,18,0,12,17,0,29,3,6,0,3,16,1,0,0,0,0
3806,785,2016,6,0,6,0.01,1,1021,0,0,0,0,0,0,0,0,0,0,0,0,0,0,0,0,0
3807,786,2016,39,39,0,1.0,99,1021,23,13,3,13,13,3,29,8,2,1,2,13,0,3,0,0,0
3808,787,2016,37,36,1,0.98,97,1021,19,14,3,5,13,2,20,0,0,1,4,12,1,1,1,0,0
3809,788,2016,30,28,2,0.92,92,1021,16,10,2,16,8,1,25,16,0,0,0,6,2,0,1,0,0
3810,789,2016,23,9,14,0.37,37,1021,4,3,2,2,2,1,5,1,0,1,0,1,1,0,1,0,0
3811,790,2016,35,16,19,0.46,46,1021,8,6,2,7,4,1,12,6,1,0,0,2,2,0,1,0,0
3812,791,2016,18,17,1,0.94,93,1021,9,6,2,4,6,2,12,1,1,2,0,6,0,2,0,0,0
3813,792,2016,40,40,0,1.0,100,1021,23,14,3,17,9,2,28,13,3,0,1,4,5,1,1,0,0
3814,793,2016,16,15,1,0.96,96,1021,6,6,3,3,4,1,8,0,3,0,0,2,2,0,0,1,0
3815,794,2016,8,7,1,0.93,92,1021,2,4,1,2,2,1,5,2,0,0,0,0,2,1,0,0,0
3816,795,2016,33,21,12,0.64,63,1021,15,4,2,4,4,1,9,0,0,1,3,4,0,0,1,0,0
3817,796,2016,14,14,0,0.97,96,1021,6,7,1,3,7,1,11,2,0,0,1,7,0,1,0,0,0
3818,797,2016,55,8,47,0.15,14,1021,4,4,0,2,2,0,4,0,2,0,0,0,2,0,0,0,0
3819,798,2016,24,24,0,0.99,98,1021,9,14,1,3,13,1,17,0,1,1,1,12,1,1,0,0,0
3820,799,2016,36,24,12,0.66,66,1021,15,8,1,7,5,1,13,3,0,4,0,2,3,1,0,0,0
3821,800,2016,30,21,9,0.71,71,1021,15,5,1,9,3,1,13,5,3,0,1,1,2,1,0,0,0
3822,801,2016,38,9,29,0.25,24,1021,3,4,2,2,3,2,7,1,1,0,0,2,1,2,0,0,0
3823,802,2016,38,38,0,1.0,100,1021,19,15,4,7,9,4,20,0,4,1,2,3,6,4,0,0,0
3824,803,2016,36,36,0,1.0,99,1021,16,17,3,12,10,3,25,10,1,0,1,3,7,3,0,0,0
3825,804,2016,35,35,0,1.0,99,1021,21,13,1,11,7,1,19,6,0,5,0,1,6,1,0,0,0
3826,805,2016,59,59,0,1.0,99,1021,39,20,0,11,13,0,24,0,0,5,6,6,7,0,0,0,0
3827,806,2016,12,0,12,0.03,3,1021,0,0,0,0,0,0,0,0,0,0,0,0,0,0,0,0,0
3828,807,2016,28,26,2,0.94,93,1021,18,6,2,8,4,2,14,4,1,0,3,2,2,2,0,0,0
3829,808,2016,22,0,22,0.01,1,1021,0,0,0,0,0,0,0,0,0,0,0,0,0,0,0,0,0
3830,809,2016,34,24,10,0.69,69,1021,13,11,0,4,10,0,14,0,0,3,1,9,1,0,0,0,0
3831,810,2016,38,38,0,1.0,100,1021,27,10,1,24,6,1,31,22,1,1,0,2,4,1,0,0,0
3832,811,2016,14,3,11,0.21,21,1021,2,1,0,2,1,0,3,2,0,0,0,1,0,0,0,0,0
3833,812,2016,40,1,39,0.04,3,1021,0,1,0,0,1,0,1,0,0,0,0,1,0,0,0,0,0
3834,813,2016,52,48,4,0.93,92,1021,30,15,3,26,11,3,40,24,1,0,1,7,4,3,0,0,0
3835,814,2016,59,10,49,0.17,16,1021,3,4,3,2,3,1,6,1,1,0,0,2,1,0,0,1,0
3836,815,2016,30,30,0,1.0,99,1021,18,8,4,7,5,2,14,0,4,2,1,2,3,1,0,1,0
3837,816,2016,37,37,0,0.99,98,1021,22,14,1,14,10,1,25,9,3,1,1,6,4,1,0,0,0
3838,817,2016,24,3,21,0.13,13,1021,2,1,0,1,1,0,2,0,1,0,0,1,0,0,0,0,0
3839,818,2016,22,22,0,0.98,97,1021,13,7,2,8,5,1,14,5,1,2,0,3,2,0,1,0,0
3840,819,2016,22,16,6,0.75,74,1021,5,8,3,3,6,3,12,2,0,1,0,4,2,3,0,0,0
3841,820,2016,41,41,0,1.0,99,1021,30,8,3,16,6,1,23,6,7,2,1,4,2,0,0,1,0
3842,821,2016,17,17,0,1.0,100,1021,7,7,3,4,5,3,12,2,1,1,0,3,2,3,0,0,0
3843,822,2016,44,38,6,0.85,85,1021,28,8,2,15,8,2,25,5,7,3,0,8,0,2,0,0,0
3844,823,2016,6,6,0,0.98,98,1021,4,2,0,1,1,0,2,0,0,0,1,0,1,0,0,0,0
3845,824,2016,23,13,10,0.55,54,1021,5,5,3,3,3,2,8,1,2,0,0,1,2,1,1,0,0
3846,825,2016,47,44,3,0.94,93,1021,19,21,4,11,14,3,28,5,5,0,1,7,7,2,1,0,0
3847,826,2016,13,11,2,0.88,88,1021,5,5,1,5,5,1,11,5,0,0,0,5,0,1,0,0,0
3848,827,2016,16,2,14,0.12,11,1021,1,1,0,1,1,0,2,1,0,0,0,1,0,0,0,0,0
3849,828,2016,28,27,1,0.96,95,1021,12,12,3,7,11,1,19,3,3,1,0,10,1,0,0,1,0
3850,829,2016,58,58,0,1.0,99,1021,23,31,4,17,28,3,48,13,3,0,1,25,3,2,1,0,0
3851,830,2016,19,18,1,0.94,93,1021,12,4,2,12,3,2,17,12,0,0,0,2,1,2,0,0,0
3852,831,2016,35,10,25,0.3,29,1021,5,3,2,4,2,2,8,3,1,0,0,1,1,2,0,0,0
3853,832,2016,23,23,0,1.0,99,1021,12,11,0,10,6,0,16,9,0,1,0,1,5,0,0,0,0
3854,833,2016,15,15,0,1.0,99,1021,7,8,0,3,7,0,10,1,0,2,0,6,1,0,0,0,0
3855,834,2016,8,6,2,0.76,76,1021,3,3,0,2,3,0,5,1,1,0,0,3,0,0,0,0,0
3856,835,2016,12,12,0,1.0,100,1021,8,3,1,4,2,1,7,0,4,0,0,1,1,1,0,0,0
3857,836,2016,16,15,1,0.91,91,1021,6,6,3,4,4,2,10,3,0,1,0,2,2,1,1,0,0
3858,837,2016,47,46,1,0.98,97,1021,20,24,2,15,21,1,37,11,3,1,0,18,3,0,1,0,0
3859,838,2016,15,15,0,0.99,98,1021,9,4,2,7,3,1,11,6,0,1,0,2,1,0,1,0,0
3860,839,2016,39,18,21,0.46,45,1021,9,8,1,7,6,1,14,6,0,1,0,4,2,1,0,0,0
3861,840,2016,25,25,0,0.99,99,1021,9,13,3,4,9,2,15,1,2,0,1,5,4,1,1,0,0
3862,841,2016,10,3,7,0.32,32,1021,2,1,0,1,1,0,2,0,1,0,0,1,0,0,0,0,0
3863,842,2016,22,11,11,0.5,49,1021,8,2,1,8,1,1,10,8,0,0,0,0,1,1,0,0,0
3864,843,2016,9,5,4,0.58,57,1021,2,3,0,1,3,0,4,0,1,0,0,3,0,0,0,0,0
3865,844,2016,38,38,0,1.0,100,1021,14,22,2,9,19,2,30,5,3,1,0,16,3,2,0,0,0
3866,845,2016,32,32,0,1.0,99,1021,15,15,2,7,12,1,20,1,4,2,0,9,3,0,1,0,0
3867,846,2016,20,13,7,0.64,64,1021,4,7,2,4,4,1,9,4,0,0,0,1,3,0,1,0,0
3868,847,2016,35,24,11,0.68,67,1021,15,7,2,6,6,1,13,1,3,0,2,5,1,0,1,0,0
3869,848,2016,29,27,2,0.92,91,1021,13,13,1,12,12,1,25,11,1,0,0,11,1,1,0,0,0
3870,849,2016,14,6,8,0.43,42,1021,2,3,1,1,3,1,5,0,1,0,0,3,0,1,0,0,0
3871,850,2016,34,30,4,0.87,87,1021,17,9,4,16,7,4,27,15,1,0,0,5,2,4,0,0,0
3872,851,2016,35,35,0,0.99,98,1021,25,6,4,23,3,1,27,21,2,0,0,0,3,0,0,0,1
3873,852,2016,55,49,6,0.9,89,1021,32,16,1,31,15,1,47,30,1,0,0,14,1,1,0,0,0
3874,853,2016,26,4,22,0.17,16,1021,1,2,1,1,2,1,4,1,0,0,0,2,0,1,0,0,0
3875,854,2016,53,30,23,0.57,57,1021,11,18,1,9,13,1,23,8,0,1,0,8,5,1,0,0,0
3876,855,2016,49,49,0,1.0,99,1021,30,15,4,11,11,3,25,1,1,9,0,7,4,2,1,0,0
3877,856,2016,23,23,0,0.98,97,1021,6,13,4,2,12,1,15,0,0,2,0,11,1,0,0,0,1
3878,857,2016,21,21,0,1.0,99,1021,6,11,4,5,6,2,13,4,1,0,0,1,5,1,0,1,0
3879,858,2016,23,23,0,1.0,99,1021,12,10,1,3,5,1,9,0,0,0,3,0,5,1,0,0,0
3880,859,2016,38,36,2,0.95,95,1021,27,8,1,17,5,1,23,12,2,1,2,2,3,1,0,0,0
3881,860,2016,35,35,0,1.0,99,1021,20,14,1,5,11,1,17,0,0,0,5,8,3,1,0,0,0
3882,861,2016,20,12,8,0.59,59,1021,6,6,0,2,5,0,7,0,0,2,0,4,1,0,0,0,0
3883,862,2016,28,28,0,1.0,99,1021,10,15,3,10,13,1,24,10,0,0,0,11,2,0,0,1,0
3884,863,2016,7,7,0,0.96,96,1021,3,3,1,1,2,1,4,0,0,1,0,1,1,1,0,0,0
3885,864,2016,46,20,26,0.44,44,1021,8,10,2,3,5,2,10,0,2,0,1,0,5,2,0,0,0
3886,865,2016,15,14,1,0.91,90,1021,8,6,0,5,4,0,9,4,0,0,1,2,2,0,0,0,0
3887,866,2016,58,9,49,0.16,15,1021,5,3,1,3,2,1,6,2,0,1,0,1,1,1,0,0,0
3888,867,2016,29,27,2,0.92,91,1021,18,5,4,8,5,4,17,4,0,2,2,5,0,4,0,0,0
3889,868,2016,34,10,24,0.3,29,1021,7,2,1,6,2,1,9,5,1,0,0,2,0,1,0,0,0
3890,869,2016,15,0,15,0.01,1,1021,0,0,0,0,0,0,0,0,0,0,0,0,0,0,0,0,0
3891,870,2016,35,4,31,0.12,11,1021,1,2,1,1,2,1,4,1,0,0,0,2,0,1,0,0,0
3892,871,2016,11,11,0,1.0,99,1021,3,7,1,2,4,1,7,1,1,0,0,1,3,1,0,0,0
3893,872,2016,37,37,0,1.0,100,1021,21,15,1,10,12,1,23,6,0,1,3,9,3,1,0,0,0
3894,873,2016,31,30,1,0.97,96,1021,13,17,0,7,13,0,20,5,0,0,2,9,4,0,0,0,0
3895,874,2016,38,38,0,1.0,99,1021,18,16,4,6,10,3,19,1,0,3,2,4,6,2,1,0,0
3896,875,2016,9,8,1,0.88,87,1021,3,4,1,2,3,1,6,1,1,0,0,2,1,1,0,0,0
3897,876,2016,39,31,8,0.79,79,1021,21,6,4,7,5,2,14,0,2,3,2,4,1,1,0,1,0
3898,877,2016,52,17,35,0.33,33,1021,9,6,2,7,5,2,14,5,2,0,0,4,1,2,0,0,0
3899,878,2016,37,2,35,0.05,5,1021,1,1,0,1,1,0,2,1,0,0,0,1,0,0,0,0,0
3900,879,2016,16,16,0,0.99,98,1021,7,9,0,2,5,0,7,0,0,1,1,1,4,0,0,0,0
3901,880,2016,20,12,8,0.58,58,1021,8,4,0,7,3,0,10,6,1,0,0,2,1,0,0,0,0
3902,881,2016,7,7,0,1.0,100,1021,2,4,1,1,4,1,6,0,1,0,0,4,0,1,0,0,0
3903,882,2016,60,9,51,0.16,15,1021,6,3,0,4,3,0,7,2,2,0,0,3,0,0,0,0,0
3904,883,2016,10,10,0,0.99,99,1021,5,4,1,3,3,1,7,2,0,1,0,2,1,1,0,0,0
3905,884,2016,8,2,6,0.25,24,1021,1,1,0,1,1,0,2,1,0,0,0,1,0,0,0,0,0
3906,885,2016,34,2,32,0.07,7,1021,1,1,0,1,1,0,2,1,0,0,0,1,0,0,0,0,0
3907,886,2016,26,26,0,1.0,100,1021,13,11,2,11,6,1,18,9,2,0,0,1,5,0,1,0,0
3908,887,2016,12,11,1,0.95,94,1021,3,5,3,2,5,3,10,1,1,0,0,5,0,3,0,0,0
3909,888,2016,15,14,1,0.95,94,1021,6,6,2,2,5,2,9,0,0,2,0,4,1,2,0,0,0
3910,889,2016,26,25,1,0.98,98,1021,12,11,2,6,6,2,14,2,2,2,0,1,5,2,0,0,0
3911,890,2016,12,5,7,0.41,41,1021,1,3,1,1,3,1,5,1,0,0,0,3,0,1,0,0,0
3912,891,2016,60,56,4,0.93,93,1021,36,19,1,26,19,1,46,22,1,0,3,19,0,1,0,0,0
3913,892,2016,21,21,0,1.0,99,1021,14,5,2,5,4,2,11,0,3,0,2,3,1,2,0,0,0
3914,893,2016,18,2,16,0.13,13,1021,1,1,0,1,1,0,2,1,0,0,0,1,0,0,0,0,0
3915,894,2016,13,12,1,0.94,94,1021,5,4,3,3,2,3,8,1,2,0,0,0,2,3,0,0,0
3916,895,2016,41,17,24,0.4,40,1021,6,9,2,4,9,1,14,3,0,1,0,9,0,0,1,0,0
3917,896,2016,14,3,11,0.18,18,1021,2,1,0,2,1,0,3,2,0,0,0,1,0,0,0,0,0
3918,897,2016,47,42,5,0.9,89,1021,24,17,1,12,16,1,29,4,6,0,2,15,1,1,0,0,0
3919,898,2016,28,28,0,1.0,99,1021,13,12,3,10,7,1,18,9,0,0,1,2,5,0,0,1,0
3920,899,2016,29,28,1,0.97,96,1021,15,10,3,10,6,2,18,8,0,1,1,2,4,1,1,0,0
3921,900,2016,22,21,1,0.98,97,1021,14,5,2,6,4,1,11,1,3,1,1,3,1,0,1,0,0
3922,901,2016,34,30,4,0.87,86,1021,12,17,1,4,13,1,18,1,0,1,2,9,4,1,0,0,0
3923,902,2016,16,14,2,0.9,89,1021,4,8,2,2,8,2,12,0,2,0,0,8,0,2,0,0,0
3924,903,2016,26,20,6,0.79,78,1021,9,7,4,4,4,1,9,1,1,2,0,1,3,0,0,0,1
3925,904,2016,10,1,9,0.1,10,1021,0,1,0,0,1,0,1,0,0,0,0,1,0,0,0,0,0
3926,905,2016,14,2,12,0.17,17,1021,1,1,0,1,1,0,2,1,0,0,0,1,0,0,0,0,0
3927,906,2016,12,5,7,0.38,38,1021,1,3,1,1,2,1,4,1,0,0,0,1,1,1,0,0,0
3928,907,2016,42,9,33,0.22,22,1021,4,3,2,2,2,1,5,1,0,1,0,1,1,0,1,0,0
3929,908,2016,20,8,12,0.42,41,1021,4,4,0,3,4,0,7,2,1,0,0,4,0,0,0,0,0
3930,909,2016,40,40,0,0.99,98,1021,16,20,4,16,18,3,37,16,0,0,0,16,2,2,1,0,0
3931,910,2016,16,16,0,1.0,100,1021,10,5,1,10,3,1,14,10,0,0,0,1,2,1,0,0,0
3932,911,2016,57,57,0,1.0,99,1021,39,15,3,17,12,3,32,7,2,4,4,9,3,3,0,0,0
3933,912,2016,10,0,10,0.01,1,1021,0,0,0,0,0,0,0,0,0,0,0,0,0,0,0,0,0
3934,913,2016,27,7,20,0.27,26,1021,2,4,1,2,4,1,7,2,0,0,0,4,0,1,0,0,0
3935,914,2016,33,18,15,0.55,55,1021,9,7,2,7,5,2,14,5,2,0,0,3,2,2,0,0,0
3936,915,2016,26,16,10,0.63,63,1021,8,7,1,7,5,1,13,6,1,0,0,3,2,1,0,0,0
3937,916,2016,37,18,19,0.48,48,1021,8,9,1,8,9,1,18,8,0,0,0,9,0,1,0,0,0
3938,917,2016,25,18,7,0.73,72,1021,10,6,2,5,4,1,10,2,2,0,1,2,2,0,1,0,0
3939,918,2016,12,10,2,0.81,80,1021,4,4,2,3,2,2,7,2,1,0,0,0,2,2,0,0,0
3940,919,2016,41,39,2,0.95,94,1021,14,22,3,10,12,1,23,7,2,1,0,2,10,0,0,1,0
3941,920,2016,11,10,1,0.93,93,1021,6,3,1,4,3,1,8,2,2,0,0,3,0,1,0,0,0
3942,921,2016,26,25,1,0.95,95,1021,16,6,3,12,4,2,18,9,2,1,0,2,2,1,1,0,0
3943,922,2016,12,7,5,0.61,60,1021,3,3,1,2,2,1,5,1,1,0,0,1,1,1,0,0,0
3944,923,2016,41,40,1,0.98,97,1021,29,9,2,28,5,2,35,27,1,0,0,1,4,2,0,0,0
3945,924,2016,15,10,5,0.67,67,1021,7,2,1,2,1,1,4,0,0,1,1,0,1,1,0,0,0
3946,925,2016,25,21,4,0.84,83,1021,10,10,1,9,8,1,18,8,1,0,0,6,2,1,0,0,0
3947,926,2016,27,3,24,0.11,11,1021,2,1,0,2,1,0,3,2,0,0,0,1,0,0,0,0,0
3948,927,2016,27,26,1,0.95,95,1021,10,14,2,5,9,2,16,2,1,2,0,4,5,2,0,0,0
3949,928,2016,38,38,0,1.0,99,1021,22,12,4,12,10,1,23,6,2,4,0,8,2,0,0,0,1
3950,929,2016,9,7,2,0.79,79,1021,3,3,1,1,2,1,4,0,0,1,0,1,1,1,0,0,0
3951,930,2016,47,35,12,0.74,74,1021,25,9,1,19,8,1,28,16,0,3,0,7,1,1,0,0,0
3952,931,2016,26,25,1,0.98,97,1021,14,8,3,8,7,1,16,5,1,1,1,6,1,0,0,1,0
3953,932,2016,29,29,0,0.99,98,1021,13,16,0,12,15,0,27,11,1,0,0,14,1,0,0,0,0
3954,933,2016,39,6,33,0.16,15,1021,2,3,1,2,3,1,6,2,0,0,0,3,0,1,0,0,0
3955,934,2016,25,7,18,0.3,29,1021,4,3,0,1,3,0,4,0,0,0,1,3,0,0,0,0,0
3956,935,2016,22,13,9,0.57,57,1021,5,5,3,5,5,3,13,5,0,0,0,5,0,3,0,0,0
3957,936,2016,31,28,3,0.92,91,1021,10,16,2,8,14,2,24,6,2,0,0,12,2,2,0,0,0
3958,937,2016,10,1,9,0.13,13,1021,0,1,0,0,1,0,1,0,0,0,0,1,0,0,0,0,0
3959,938,2016,31,10,21,0.32,31,1021,3,4,3,3,3,3,9,3,0,0,0,2,1,3,0,0,0
3960,939,2016,14,12,2,0.84,84,1021,3,6,3,2,5,3,10,1,1,0,0,4,1,3,0,0,0
3961,940,2016,60,39,21,0.65,65,1021,28,10,1,18,8,1,27,14,1,0,3,6,2,1,0,0,0
3962,941,2016,27,19,8,0.69,68,1021,4,11,4,4,10,3,17,4,0,0,0,9,1,2,1,0,0
3963,942,2016,17,16,1,0.97,96,1021,9,4,3,3,2,1,6,0,1,1,1,0,2,0,0,1,0
3964,943,2016,48,37,11,0.77,76,1021,14,21,2,12,21,1,34,10,2,0,0,21,0,0,1,0,0
3965,944,2016,18,9,9,0.48,47,1021,4,4,1,4,3,1,8,4,0,0,0,2,1,1,0,0,0
3966,945,2016,26,16,10,0.6,60,1021,5,9,2,4,7,1,12,3,1,0,0,5,2,0,1,0,0
3967,946,2016,24,19,5,0.81,80,1021,6,10,3,6,8,2,16,6,0,0,0,6,2,1,1,0,0
3968,947,2016,36,1,35,0.01,1,1021,0,1,0,0,1,0,1,0,0,0,0,1,0,0,0,0,0
3969,948,2016,20,3,17,0.14,13,1021,2,1,0,2,1,0,3,2,0,0,0,1,0,0,0,0,0
3970,949,2016,26,26,0,1.0,99,1021,19,5,2,8,4,1,13,2,2,3,1,3,1,0,1,0,0
3971,950,2016,35,12,23,0.33,33,1021,6,6,0,3,6,0,9,2,0,0,1,6,0,0,0,0,0
3972,951,2016,29,20,9,0.68,68,1021,7,9,4,3,8,4,15,1,1,0,1,7,1,4,0,0,0
3973,952,2016,15,8,7,0.53,53,1021,5,3,0,3,2,0,5,1,2,0,0,1,1,0,0,0,0
3974,953,2016,54,1,53,0.01,1,1021,0,1,0,0,1,0,1,0,0,0,0,1,0,0,0,0,0
3975,954,2016,21,21,0,0.99,98,1021,8,11,2,3,10,1,14,1,0,1,1,9,1,0,1,0,0
3976,955,2016,23,23,0,1.0,100,1021,11,11,1,8,6,1,15,7,0,0,1,1,5,1,0,0,0
3977,956,2016,40,10,30,0.25,25,1021,6,4,0,5,4,0,9,4,1,0,0,4,0,0,0,0,0
3978,957,2016,23,5,18,0.23,22,1021,4,1,0,4,1,0,5,4,0,0,0,1,0,0,0,0,0
3979,958,2016,20,6,14,0.31,30,1021,2,3,1,2,2,1,5,2,0,0,0,1,1,1,0,0,0
3980,959,2016,22,18,4,0.84,83,1021,10,7,1,4,5,1,10,0,2,2,0,3,2,1,0,0,0
3981,960,2016,6,6,0,1.0,99,1021,3,2,1,2,2,1,5,1,1,0,0,2,0,1,0,0,0
3982,961,2016,22,5,17,0.21,21,1021,3,2,0,2,2,0,4,1,1,0,0,2,0,0,0,0,0
3983,962,2016,34,25,9,0.74,73,1021,7,15,3,5,8,2,15,3,2,0,0,1,7,1,1,0,0
3984,963,2016,15,7,8,0.47,46,1021,2,3,2,1,2,1,4,0,1,0,0,1,1,0,1,0,0
3985,964,2016,28,28,0,1.0,99,1021,18,6,4,10,5,2,17,6,2,0,2,4,1,1,0,1,0
3986,965,2016,16,10,6,0.63,62,1021,6,3,1,5,3,1,9,4,1,0,0,3,0,1,0,0,0
3987,966,2016,12,3,9,0.27,26,1021,2,1,0,1,1,0,2,0,1,0,0,1,0,0,0,0,0
3988,967,2016,23,23,0,1.0,99,1021,14,6,3,7,3,1,11,2,4,0,1,0,3,0,0,1,0
3989,968,2016,31,28,3,0.9,90,1021,19,8,1,19,6,1,26,19,0,0,0,4,2,1,0,0,0
3990,969,2016,41,41,0,0.99,98,1021,17,23,1,15,12,1,28,14,0,1,0,1,11,1,0,0,0
3991,970,2016,5,2,3,0.44,43,1021,1,1,0,1,1,0,2,1,0,0,0,1,0,0,0,0,0
3992,971,2016,52,51,1,0.99,98,1021,34,13,4,28,8,2,38,25,1,1,1,3,5,1,0,1,0
3993,972,2016,7,1,6,0.19,19,1021,0,1,0,0,1,0,1,0,0,0,0,1,0,0,0,0,0
3994,973,2016,10,6,4,0.56,56,1021,3,2,1,2,2,1,5,1,1,0,0,2,0,1,0,0,0
3995,974,2016,23,21,2,0.92,91,1021,14,4,3,6,2,2,10,1,2,3,0,0,2,1,1,0,0
3996,975,2016,46,35,11,0.75,75,1021,26,8,1,25,6,1,32,24,1,0,0,4,2,1,0,0,0
3997,976,2016,9,1,8,0.07,7,1021,0,1,0,0,1,0,1,0,0,0,0,1,0,0,0,0,0
3998,977,2016,55,25,30,0.46,45,1021,18,4,3,14,3,1,18,12,1,0,1,2,1,0,0,1,0
3999,978,2016,35,8,27,0.23,23,1021,3,4,1,1,4,1,6,0,0,1,0,4,0,1,0,0,0
4000,979,2016,50,50,0,1.0,99,1021,30,19,1,25,14,1,40,21,3,1,0,9,5,1,0,0,0
4001,980,2016,14,13,1,0.96,96,1021,6,5,2,4,5,2,11,3,0,1,0,5,0,2,0,0,0
4002,981,2016,52,52,0,1.0,100,1021,21,31,0,13,20,0,33,8,3,1,1,9,11,0,0,0,0
4003,982,2016,38,20,18,0.53,53,1021,10,9,1,4,6,1,11,2,0,0,2,3,3,1,0,0,0
4004,983,2016,40,31,9,0.79,78,1021,18,13,0,5,8,0,13,0,1,0,4,3,5,0,0,0,0
4005,984,2016,31,4,27,0.15,14,1021,3,1,0,2,1,0,3,1,1,0,0,1,0,0,0,0,0
4006,985,2016,35,35,0,1.0,99,1021,24,10,1,10,5,1,16,0,8,0,2,0,5,1,0,0,0
4007,986,2016,39,38,1,0.98,98,1021,20,18,0,14,14,0,28,11,0,3,0,10,4,0,0,0,0
4008,987,2016,16,0,16,0.0,0,1021,0,0,0,0,0,0,0,0,0,0,0,0,0,0,0,0,0
4009,988,2016,18,9,9,0.48,48,1021,4,3,2,1,3,2,6,0,0,0,1,3,0,2,0,0,0
4010,989,2016,26,21,5,0.79,79,1021,13,5,3,4,4,1,9,1,0,0,3,3,1,0,0,1,0
4011,990,2016,19,8,11,0.43,42,1021,2,4,2,1,4,1,6,0,1,0,0,4,0,0,1,0,0
4012,991,2016,11,5,6,0.49,48,1021,3,2,0,2,2,0,4,1,1,0,0,2,0,0,0,0,0
4013,992,2016,17,13,4,0.79,79,1021,7,4,2,4,2,2,8,3,0,0,1,0,2,2,0,0,0
4014,993,2016,28,2,26,0.07,7,1021,1,1,0,1,1,0,2,1,0,0,0,1,0,0,0,0,0
4015,994,2016,26,11,15,0.42,42,1021,6,5,0,6,5,0,11,6,0,0,0,5,0,0,0,0,0
4016,995,2016,33,33,0,0.99,99,1021,22,8,3,16,7,2,25,14,0,0,2,6,1,1,1,0,0
4017,996,2016,15,10,5,0.68,68,1021,7,2,1,2,2,1,5,0,0,1,1,2,0,1,0,0,0
4018,997,2016,13,12,1,0.93,92,1021,6,5,1,4,4,1,9,2,2,0,0,3,1,1,0,0,0
4019,998,2016,11,10,1,0.89,89,1021,5,5,0,3,4,0,7,2,0,1,0,3,1,0,0,0,0
4020,999,2016,29,27,2,0.94,93,1021,13,14,0,4,9,0,13,1,0,0,3,4,5,0,0,0,0
4021,1000,2016,22,14,8,0.64,63,1021,5,7,2,5,5,2,12,5,0,0,0,3,2,2,0,0,0
4022,1001,2016,22,4,18,0.2,19,1021,3,1,0,3,1,0,4,3,0,0,0,1,0,0,0,0,0
4023,1002,2016,60,60,0,1.0,100,1021,44,15,1,18,9,1,28,2,8,6,2,3,6,1,0,0,0
4024,1003,2016,16,10,6,0.62,61,1021,6,4,0,5,2,0,7,4,1,0,0,0,2,0,0,0,0
4025,1004,2016,27,27,0,0.99,99,1021,19,7,1,15,5,1,21,13,0,2,0,3,2,1,0,0,0
4026,1005,2016,46,45,1,0.97,97,1021,22,22,1,6,18,1,25,0,1,0,5,14,4,1,0,0,0
4027,1006,2016,19,8,11,0.43,42,1021,5,3,0,4,2,0,6,3,1,0,0,1,1,0,0,0,0
4028,1007,2016,38,29,9,0.76,75,1021,11,16,2,7,14,2,23,5,1,0,1,12,2,2,0,0,0
4029,1008,2016,48,0,48,0.0,0,1021,0,0,0,0,0,0,0,0,0,0,0,0,0,0,0,0,0
4030,1009,2016,17,11,6,0.64,63,1021,8,2,1,6,1,1,8,5,0,1,0,0,1,1,0,0,0
4031,1010,2016,27,20,7,0.74,73,1021,9,7,4,6,5,2,13,4,1,1,0,3,2,1,0,1,0
4032,1011,2016,16,16,0,0.98,98,1021,9,5,2,7,5,2,14,6,0,1,0,5,0,2,0,0,0
4033,1012,2016,26,17,9,0.65,64,1021,7,7,3,2,5,2,9,0,0,1,1,3,2,1,1,0,0
4034,1013,2016,52,6,46,0.12,11,1021,4,2,0,2,1,0,3,0,2,0,0,0,1,0,0,0,0
4035,1014,2016,33,25,8,0.74,74,1021,11,11,3,8,6,3,17,7,0,0,1,1,5,3,0,0,0
4036,1015,2016,40,13,27,0.32,32,1021,3,7,3,3,7,1,11,3,0,0,0,7,0,0,0,1,0
4037,1016,2016,26,13,13,0.49,49,1021,4,6,3,4,5,1,10,4,0,0,0,4,1,0,0,1,0
4038,1017,2016,22,14,8,0.64,64,1021,5,5,4,2,4,4,10,1,0,0,1,3,1,4,0,0,0
4039,1018,2016,40,14,26,0.36,36,1021,8,4,2,5,3,2,10,4,0,0,1,2,1,2,0,0,0
4040,1019,2016,45,24,21,0.54,54,1021,17,6,1,12,6,1,19,8,3,1,0,6,0,1,0,0,0
4041,1020,2016,28,28,0,1.0,99,1021,13,12,3,11,7,3,21,10,0,1,0,2,5,3,0,0,0
4042,1021,2016,27,24,3,0.91,90,1021,16,6,2,14,5,2,21,12,2,0,0,4,1,2,0,0,0
4043,1,2017,33,33,0,0.99,99,1096,10,19,4,3,15,3,21,0,0,2,1,11,4,2,1,0,0
4044,2,2017,15,4,11,0.28,28,1096,1,2,1,1,1,1,3,1,0,0,0,0,1,1,0,0,0
4045,3,2017,28,28,0,1.0,100,1096,17,10,1,12,5,1,18,7,5,0,0,0,5,1,0,0,0
4046,4,2017,40,40,0,1.0,100,1096,16,20,4,16,12,2,30,16,0,0,0,4,8,1,0,1,0
4047,5,2017,33,33,0,1.0,100,1096,18,14,1,13,10,1,24,10,2,0,1,6,4,1,0,0,0
4048,6,2017,41,41,0,1.0,100,1096,20,18,3,13,18,3,34,6,7,0,0,18,0,3,0,0,0
4049,7,2017,55,54,1,0.99,98,1096,27,25,2,12,15,2,29,3,6,0,3,5,10,2,0,0,0
4050,8,2017,38,14,24,0.36,35,1096,5,5,4,5,3,4,12,5,0,0,0,1,2,4,0,0,0
4051,9,2017,28,3,25,0.1,9,1096,2,1,0,2,1,0,3,2,0,0,0,1,0,0,0,0,0
4052,10,2017,12,12,0,0.98,97,1096,7,3,2,4,2,2,8,3,0,0,1,1,1,2,0,0,0
4053,11,2017,49,11,38,0.23,23,1096,4,6,1,1,5,1,7,0,0,0,1,4,1,1,0,0,0
4054,12,2017,34,0,34,0.0,0,1096,0,0,0,0,0,0,0,0,0,0,0,0,0,0,0,0,0
4055,13,2017,6,6,0,0.96,95,1096,2,3,1,2,2,1,5,2,0,0,0,1,1,1,0,0,0
4056,14,2017,32,0,32,0.01,1,1096,0,0,0,0,0,0,0,0,0,0,0,0,0,0,0,0,0
4057,15,2017,7,7,0,0.97,96,1096,4,2,1,4,2,1,7,4,0,0,0,2,0,1,0,0,0
4058,16,2017,47,36,11,0.77,77,1096,19,15,2,19,15,1,35,19,0,0,0,15,0,0,1,0,0
4059,17,2017,13,13,0,0.98,98,1096,6,7,0,2,4,0,6,0,0,2,0,1,3,0,0,0,0
4060,18,2017,40,40,0,1.0,100,1096,25,13,2,25,12,1,38,25,0,0,0,11,1,0,1,0,0
4061,19,2017,10,1,9,0.09,8,1096,0,1,0,0,1,0,1,0,0,0,0,1,0,0,0,0,0
4062,20,2017,9,8,1,0.9,89,1096,6,2,0,3,1,0,4,2,0,0,1,0,1,0,0,0,0
4063,21,2017,52,16,36,0.32,31,1096,9,5,2,7,5,1,13,5,2,0,0,5,0,0,1,0,0
4064,22,2017,5,4,1,0.85,84,1096,1,2,1,1,1,1,3,1,0,0,0,0,1,1,0,0,0
4065,23,2017,34,32,2,0.94,93,1096,18,14,0,9,9,0,18,3,4,1,1,4,5,0,0,0,0
4066,24,2017,37,32,5,0.87,86,1096,16,15,1,9,14,1,24,3,5,1,0,13,1,1,0,0,0
4067,25,2017,36,36,0,0.99,98,1096,19,16,1,10,12,1,23,4,4,1,1,8,4,1,0,0,0
4068,26,2017,33,33,0,1.0,100,1096,11,18,4,6,10,2,18,4,0,1,1,2,8,1,0,1,0
4069,27,2017,27,10,17,0.37,37,1096,5,4,1,3,3,1,7,1,2,0,0,2,1,1,0,0,0
4070,28,2017,27,26,1,0.97,97,1096,9,14,3,6,11,1,18,3,3,0,0,8,3,0,0,1,0
4071,29,2017,8,1,7,0.15,14,1096,0,1,0,0,1,0,1,0,0,0,0,1,0,0,0,0,0
4072,30,2017,59,58,1,0.99,98,1096,22,34,2,6,32,1,39,0,0,2,4,30,2,0,1,0,0
4073,31,2017,60,20,40,0.33,32,1096,10,8,2,7,5,2,14,5,1,1,0,2,3,2,0,0,0
4074,32,2017,10,10,0,1.0,100,1096,6,3,1,5,3,1,9,4,1,0,0,3,0,1,0,0,0
4075,33,2017,28,26,2,0.94,94,1096,10,13,3,4,8,3,15,0,2,2,0,3,5,3,0,0,0
4076,34,2017,10,4,6,0.43,43,1096,1,2,1,1,1,1,3,1,0,0,0,0,1,1,0,0,0
4077,35,2017,52,51,1,0.98,97,1096,28,23,0,20,12,0,32,16,2,0,2,1,11,0,0,0,0
4078,36,2017,58,56,2,0.97,96,1096,35,18,3,27,11,3,41,22,2,3,0,4,7,3,0,0,0
4079,37,2017,53,51,2,0.96,95,1096,30,19,2,18,12,2,32,12,1,4,1,5,7,2,0,0,0
4080,38,2017,19,17,2,0.89,88,1096,9,6,2,5,6,2,13,3,0,2,0,6,0,2,0,0,0
4081,39,2017,16,3,13,0.16,16,1096,2,1,0,1,1,0,2,0,1,0,0,1,0,0,0,0,0
4082,40,2017,8,8,0,1.0,100,1096,4,4,0,2,3,0,5,0,2,0,0,2,1,0,0,0,0
4083,41,2017,24,21,3,0.87,86,1096,11,7,3,9,7,1,17,8,0,1,0,7,0,0,0,1,0
4084,42,2017,8,0,8,0.03,3,1096,0,0,0,0,0,0,0,0,0,0,0,0,0,0,0,0,0
4085,43,2017,40,31,9,0.79,78,1096,15,14,2,5,11,1,17,0,0,5,0,8,3,0,1,0,0
4086,44,2017,29,27,2,0.95,94,1096,20,6,1,10,3,1,14,4,3,2,1,0,3,1,0,0,0
4087,45,2017,42,6,36,0.13,13,1096,3,2,1,2,1,1,4,1,1,0,0,0,1,1,0,0,0
4088,46,2017,53,53,0,1.0,100,1096,22,27,4,19,16,2,37,18,0,0,1,5,11,0,2,0,0
4089,47,2017,37,37,0,1.0,100,1096,15,19,3,6,19,1,26,1,1,4,0,19,0,0,0,1,0
4090,48,2017,24,24,0,1.0,99,1096,12,9,3,4,7,3,14,0,0,4,0,5,2,3,0,0,0
4091,49,2017,60,54,6,0.91,90,1096,25,27,2,25,22,2,49,25,0,0,0,17,5,2,0,0,0
4092,50,2017,17,13,4,0.75,74,1096,7,5,1,3,3,1,7,0,2,1,0,1,2,1,0,0,0
4093,51,2017,18,14,4,0.77,77,1096,6,5,3,4,3,3,10,2,2,0,0,1,2,3,0,0,0
4094,52,2017,34,25,9,0.74,73,1096,14,7,4,6,7,4,17,1,3,1,1,7,0,4,0,0,0
4095,53,2017,25,4,21,0.17,17,1096,1,2,1,1,2,1,4,1,0,0,0,2,0,1,0,0,0
4096,54,2017,26,21,5,0.79,79,1096,9,11,1,5,7,1,13,2,2,1,0,3,4,1,0,0,0
4097,55,2017,31,31,0,1.0,100,1096,17,12,2,5,12,1,18,0,1,1,3,12,0,0,1,0,0
4098,56,2017,25,25,0,1.0,100,1096,17,7,1,17,5,1,23,17,0,0,0,3,2,1,0,0,0
4099,57,2017,11,11,0,0.99,99,1096,5,6,0,3,6,0,9,1,2,0,0,6,0,0,0,0,0
4100,58,2017,33,29,4,0.89,88,1096,15,12,2,9,9,2,20,5,2,2,0,6,3,2,0,0,0
4101,59,2017,7,7,0,1.0,99,1096,4,3,0,3,2,0,5,2,1,0,0,1,1,0,0,0,0
4102,60,2017,5,2,3,0.49,48,1096,1,1,0,1,1,0,2,1,0,0,0,1,0,0,0,0,0
4103,61,2017,23,23,0,0.98,97,1096,16,6,1,8,4,1,13,3,3,1,1,2,2,1,0,0,0
4104,62,2017,47,44,3,0.95,94,1096,30,14,0,26,10,0,36,23,2,1,0,6,4,0,0,0,0
4105,63,2017,7,3,4,0.49,49,1096,2,1,0,1,1,0,2,0,1,0,0,1,0,0,0,0,0
4106,64,2017,39,38,1,0.98,97,1096,24,13,1,13,11,1,25,5,6,1,1,9,2,1,0,0,0
4107,65,2017,47,26,21,0.54,54,1096,12,12,2,8,11,1,20,6,0,2,0,10,1,0,1,0,0
4108,66,2017,23,23,0,1.0,99,1096,7,13,3,6,9,1,16,5,1,0,0,5,4,0,0,1,0
4109,67,2017,7,3,4,0.41,41,1096,2,1,0,2,1,0,3,2,0,0,0,1,0,0,0,0,0
4110,68,2017,36,36,0,1.0,100,1096,16,17,3,4,9,2,15,0,0,0,4,1,8,1,1,0,0
4111,69,2017,44,10,34,0.23,22,1096,3,5,2,1,4,1,6,0,0,1,0,3,1,0,1,0,0
4112,70,2017,50,45,5,0.9,90,1096,29,15,1,14,10,1,25,7,1,4,2,5,5,1,0,0,0
4113,71,2017,14,4,10,0.29,29,1096,2,2,0,1,1,0,2,0,1,0,0,0,1,0,0,0,0
4114,72,2017,34,26,8,0.76,76,1096,10,13,3,10,9,3,22,10,0,0,0,5,4,3,0,0,0
4115,73,2017,50,6,44,0.13,12,1096,2,3,1,2,3,1,6,2,0,0,0,3,0,1,0,0,0
4116,74,2017,40,40,0,1.0,100,1096,16,21,3,13,19,2,34,10,3,0,0,17,2,1,1,0,0
4117,75,2017,34,28,6,0.82,82,1096,12,12,4,9,12,4,25,6,3,0,0,12,0,4,0,0,0
4118,76,2017,43,39,4,0.92,91,1096,19,19,1,10,18,1,29,5,2,2,1,17,1,1,0,0,0
4119,77,2017,13,9,4,0.66,65,1096,6,2,1,3,2,1,6,1,1,1,0,2,0,1,0,0,0
4120,78,2017,15,15,0,0.97,97,1096,6,8,1,3,8,1,12,0,3,0,0,8,0,1,0,0,0
4121,79,2017,19,13,6,0.66,66,1096,8,4,1,8,2,1,11,8,0,0,0,0,2,1,0,0,0
4122,80,2017,43,40,3,0.93,93,1096,25,12,3,8,12,1,21,0,3,1,4,12,0,0,0,1,0
4123,81,2017,55,50,5,0.92,91,1096,22,28,0,14,15,0,29,10,0,4,0,2,13,0,0,0,0
4124,82,2017,23,23,0,1.0,99,1096,12,10,1,3,10,1,14,0,0,0,3,10,0,1,0,0,0
4125,83,2017,9,9,0,0.96,96,1096,6,2,1,5,2,1,8,4,1,0,0,2,0,1,0,0,0
4126,84,2017,31,31,0,1.0,100,1096,18,12,1,9,6,1,16,5,0,3,1,0,6,1,0,0,0
4127,85,2017,6,6,0,1.0,99,1096,2,3,1,2,2,1,5,2,0,0,0,1,1,1,0,0,0
4128,86,2017,53,52,1,0.99,98,1096,38,11,3,19,10,3,32,6,7,6,0,9,1,3,0,0,0
4129,87,2017,27,27,0,0.99,99,1096,10,16,1,10,10,1,21,10,0,0,0,4,6,1,0,0,0
4130,88,2017,19,13,6,0.66,66,1096,6,7,0,2,5,0,7,0,0,2,0,3,2,0,0,0,0
4131,89,2017,29,29,0,1.0,99,1096,16,11,2,7,9,2,18,2,1,4,0,7,2,2,0,0,0
4132,90,2017,15,15,0,0.97,97,1096,9,4,2,7,4,1,12,6,0,1,0,4,0,0,1,0,0
4133,91,2017,57,55,2,0.96,95,1096,36,18,1,27,10,1,38,22,1,4,0,2,8,1,0,0,0
4134,92,2017,40,40,0,1.0,100,1096,16,23,1,5,13,1,19,0,1,2,2,3,10,1,0,0,0
4135,93,2017,26,12,14,0.44,44,1096,6,4,2,5,3,2,10,4,1,0,0,2,1,2,0,0,0
4136,94,2017,21,21,0,1.0,99,1096,9,10,2,7,5,2,14,6,0,1,0,0,5,2,0,0,0
4137,95,2017,39,39,0,1.0,99,1096,25,13,1,17,9,1,27,12,2,3,0,5,4,1,0,0,0
4138,96,2017,12,12,0,0.98,97,1096,5,6,1,2,3,1,6,1,0,0,1,0,3,1,0,0,0
4139,97,2017,28,28,0,0.99,98,1096,9,16,3,3,10,1,14,0,1,1,1,4,6,0,0,1,0
4140,98,2017,60,57,3,0.95,95,1096,24,30,3,16,24,2,42,10,4,2,0,18,6,1,1,0,0
4141,99,2017,56,40,16,0.72,71,1096,14,22,4,8,18,3,29,4,3,0,1,14,4,2,1,0,0
4142,100,2017,27,2,25,0.06,5,1096,1,1,0,1,1,0,2,1,0,0,0,1,0,0,0,0,0
4143,101,2017,31,31,0,1.0,100,1096,23,7,1,16,6,1,23,12,2,1,1,5,1,1,0,0,0
4144,102,2017,10,10,0,1.0,99,1096,5,3,2,5,3,1,9,5,0,0,0,3,0,0,1,0,0
4145,103,2017,29,7,22,0.25,25,1096,2,3,2,2,3,1,6,2,0,0,0,3,0,0,1,0,0
4146,104,2017,57,21,36,0.37,37,1096,14,5,2,9,5,1,15,6,2,0,1,5,0,0,1,0,0
4147,105,2017,15,14,1,0.94,94,1096,9,4,1,4,4,1,9,0,3,1,0,4,0,1,0,0,0
4148,106,2017,7,5,2,0.77,76,1096,1,3,1,1,3,1,5,1,0,0,0,3,0,1,0,0,0
4149,107,2017,8,8,0,1.0,100,1096,2,4,2,1,3,1,5,0,1,0,0,2,1,0,1,0,0
4150,108,2017,24,24,0,0.98,98,1096,12,9,3,6,9,2,17,2,2,2,0,9,0,1,1,0,0
4151,109,2017,16,15,1,0.96,95,1096,4,8,3,2,7,2,11,0,2,0,0,6,1,1,1,0,0
4152,110,2017,19,18,1,0.94,94,1096,6,10,2,6,8,2,16,6,0,0,0,6,2,2,0,0,0
4153,111,2017,41,41,0,1.0,99,1096,31,10,0,11,9,0,20,2,2,3,4,8,1,0,0,0,0
4154,112,2017,14,0,14,0.01,1,1096,0,0,0,0,0,0,0,0,0,0,0,0,0,0,0,0,0
4155,113,2017,7,7,0,1.0,100,1096,3,3,1,2,2,1,5,1,1,0,0,1,1,1,0,0,0
4156,114,2017,18,17,1,0.97,96,1096,9,6,2,8,6,1,15,7,1,0,0,6,0,0,1,0,0
4157,115,2017,5,3,2,0.61,61,1096,2,1,0,1,1,0,2,0,1,0,0,1,0,0,0,0,0
4158,116,2017,42,5,37,0.13,12,1096,2,2,1,1,1,1,3,0,1,0,0,0,1,1,0,0,0
4159,117,2017,8,8,0,1.0,99,1096,3,4,1,2,3,1,6,1,1,0,0,2,1,1,0,0,0
4160,118,2017,15,12,3,0.8,80,1096,3,7,2,2,4,1,7,1,1,0,0,1,3,0,1,0,0
4161,119,2017,14,4,10,0.29,28,1096,1,2,1,1,2,1,4,1,0,0,0,2,0,1,0,0,0
4162,120,2017,32,32,0,1.0,100,1096,13,16,3,11,8,2,21,9,2,0,0,0,8,1,1,0,0
4163,121,2017,32,24,8,0.75,75,1096,18,6,0,13,5,0,18,9,3,1,0,4,1,0,0,0,0
4164,122,2017,6,5,1,0.9,89,1096,4,1,0,1,1,0,2,0,0,0,1,1,0,0,0,0,0
4165,123,2017,20,20,0,0.99,98,1096,10,8,2,9,4,1,14,8,1,0,0,0,4,0,1,0,0
4166,124,2017,40,40,0,1.0,100,1096,16,23,1,14,17,1,32,12,2,0,0,11,6,1,0,0,0
4167,125,2017,48,47,1,0.97,96,1096,33,10,4,29,8,2,39,27,0,2,0,6,2,1,0,1,0
4168,126,2017,55,26,29,0.46,46,1096,15,10,1,9,6,1,16,3,6,0,0,2,4,1,0,0,0
4169,127,2017,15,5,10,0.31,30,1096,3,2,0,3,2,0,5,3,0,0,0,2,0,0,0,0,0
4170,128,2017,11,11,0,0.99,98,1096,7,3,1,6,3,1,10,5,1,0,0,3,0,1,0,0,0
4171,129,2017,58,58,0,1.0,100,1096,31,24,3,27,23,2,52,24,2,1,0,22,1,1,1,0,0
4172,130,2017,15,15,0,1.0,99,1096,9,5,1,4,3,1,8,2,0,1,1,1,2,1,0,0,0
4173,131,2017,52,50,2,0.97,96,1096,25,25,0,8,14,0,22,1,0,4,3,3,11,0,0,0,0
4174,132,2017,28,20,8,0.7,70,1096,11,5,4,3,3,1,7,0,0,1,2,1,2,0,0,0,1
4175,133,2017,57,22,35,0.38,38,1096,10,9,3,4,6,2,12,2,0,0,2,3,3,1,1,0,0
4176,134,2017,26,13,13,0.49,49,1096,5,6,2,4,6,1,11,3,1,0,0,6,0,0,1,0,0
4177,135,2017,42,42,0,1.0,100,1096,20,19,3,11,16,2,29,5,3,3,0,13,3,1,1,0,0
4178,136,2017,9,9,0,0.95,94,1096,3,4,2,2,4,1,7,1,1,0,0,4,0,0,1,0,0
4179,137,2017,23,6,17,0.27,26,1096,4,2,0,4,2,0,6,4,0,0,0,2,0,0,0,0,0
4180,138,2017,19,19,0,1.0,99,1096,9,6,4,8,6,1,15,7,1,0,0,6,0,0,0,0,1
4181,139,2017,42,42,0,1.0,100,1096,18,23,1,8,18,1,27,0,7,0,1,13,5,1,0,0,0
4182,140,2017,29,11,18,0.39,38,1096,3,5,3,1,4,3,8,0,0,1,0,3,1,3,0,0,0
4183,141,2017,12,12,0,1.0,100,1096,7,3,2,7,3,2,12,7,0,0,0,3,0,2,0,0,0
4184,142,2017,7,7,0,0.96,96,1096,2,4,1,1,2,1,4,0,1,0,0,0,2,1,0,0,0
4185,143,2017,7,7,0,0.93,92,1096,4,3,0,1,2,0,3,0,0,0,1,1,1,0,0,0,0
4186,144,2017,6,5,1,0.81,80,1096,1,3,1,1,2,1,4,1,0,0,0,1,1,1,0,0,0
4187,145,2017,15,15,0,1.0,100,1096,7,6,2,7,6,2,15,7,0,0,0,6,0,2,0,0,0
4188,146,2017,29,18,11,0.6,60,1096,9,7,2,7,4,1,12,5,2,0,0,1,3,0,1,0,0
4189,147,2017,22,4,18,0.16,16,1096,2,2,0,1,2,0,3,0,1,0,0,2,0,0,0,0,0
4190,148,2017,19,18,1,0.97,96,1096,10,6,2,4,5,1,10,0,2,2,0,4,1,0,1,0,0
4191,149,2017,32,32,0,0.99,99,1096,13,16,3,10,14,3,27,9,0,0,1,12,2,3,0,0,0
4192,150,2017,33,32,1,0.96,95,1096,23,8,1,8,6,1,15,1,2,2,3,4,2,1,0,0,0
4193,151,2017,16,10,6,0.63,63,1096,5,4,1,3,4,1,8,1,2,0,0,4,0,1,0,0,0
4194,152,2017,6,1,5,0.23,22,1096,0,1,0,0,1,0,1,0,0,0,0,1,0,0,0,0,0
4195,153,2017,31,31,0,1.0,99,1096,9,18,4,6,15,4,25,4,1,1,0,12,3,4,0,0,0
4196,154,2017,32,9,23,0.27,26,1096,4,4,1,2,4,1,7,1,0,1,0,4,0,1,0,0,0
4197,155,2017,27,27,0,1.0,100,1096,17,7,3,5,6,1,12,0,0,3,2,5,1,0,0,1,0
4198,156,2017,30,15,15,0.51,51,1096,6,8,1,2,5,1,8,0,1,0,1,2,3,1,0,0,0
4199,157,2017,22,22,0,1.0,99,1096,11,9,2,6,6,1,13,3,2,0,1,3,3,0,1,0,0
4200,158,2017,26,21,5,0.81,81,1096,8,9,4,8,9,1,18,8,0,0,0,9,0,0,0,0,1
4201,159,2017,7,7,0,0.97,97,1096,3,4,0,1,4,0,5,0,0,1,0,4,0,0,0,0,0
4202,160,2017,21,21,0,0.99,99,1096,9,12,0,8,12,0,20,7,1,0,0,12,0,0,0,0,0
4203,161,2017,34,6,28,0.18,17,1096,3,3,0,2,3,0,5,1,1,0,0,3,0,0,0,0,0
4204,162,2017,31,17,14,0.54,53,1096,9,7,1,6,4,1,11,3,3,0,0,1,3,1,0,0,0
4205,163,2017,54,34,20,0.64,63,1096,24,7,3,24,4,3,31,24,0,0,0,1,3,3,0,0,0
4206,164,2017,5,5,0,1.0,100,1096,2,2,1,2,2,1,5,2,0,0,0,2,0,1,0,0,0
4207,165,2017,15,11,4,0.73,72,1096,5,6,0,4,4,0,8,3,1,0,0,2,2,0,0,0,0
4208,166,2017,30,28,2,0.92,92,1096,11,16,1,4,14,1,19,0,1,3,0,12,2,1,0,0,0
4209,167,2017,15,0,15,0.01,1,1096,0,0,0,0,0,0,0,0,0,0,0,0,0,0,0,0,0
4210,168,2017,48,48,0,0.99,99,1096,28,17,3,25,11,3,39,24,0,0,1,5,6,3,0,0,0
4211,169,2017,45,26,19,0.58,58,1096,12,14,0,4,10,0,14,0,0,4,0,6,4,0,0,0,0
4212,170,2017,26,26,0,1.0,100,1096,9,14,3,4,12,1,17,2,0,1,1,10,2,0,0,1,0
4213,171,2017,13,5,8,0.41,41,1096,2,2,1,2,1,1,4,2,0,0,0,0,1,1,0,0,0
4214,172,2017,40,3,37,0.06,6,1096,2,1,0,1,1,0,2,0,1,0,0,1,0,0,0,0,0
4215,173,2017,39,25,14,0.65,64,1096,13,12,0,8,8,0,16,4,3,1,0,4,4,0,0,0,0
4216,174,2017,38,33,5,0.87,86,1096,17,15,1,6,15,1,22,0,1,5,0,15,0,1,0,0,0
4217,175,2017,39,35,4,0.89,88,1096,19,15,1,10,10,1,21,6,0,3,1,5,5,1,0,0,0
4218,176,2017,14,14,0,1.0,100,1096,4,7,3,2,7,3,12,0,2,0,0,7,0,3,0,0,0
4219,177,2017,17,17,0,1.0,99,1096,12,3,2,10,2,2,14,8,2,0,0,1,1,2,0,0,0
4220,178,2017,14,14,0,0.99,98,1096,5,6,3,3,6,3,12,1,2,0,0,6,0,3,0,0,0
4221,179,2017,30,7,23,0.22,21,1096,4,3,0,2,3,0,5,0,2,0,0,3,0,0,0,0,0
4222,180,2017,51,21,30,0.41,41,1096,10,8,3,8,5,2,15,6,2,0,0,2,3,1,1,0,0
4223,181,2017,26,26,0,0.99,98,1096,18,5,3,10,5,2,17,6,1,2,1,5,0,1,1,0,0
4224,182,2017,33,32,1,0.98,98,1096,13,16,3,12,10,2,24,11,1,0,0,4,6,1,1,0,0
4225,183,2017,32,10,22,0.32,32,1096,4,5,1,3,3,1,7,2,1,0,0,1,2,1,0,0,0
4226,184,2017,40,39,1,0.97,97,1096,20,16,3,16,11,3,30,14,1,0,1,6,5,3,0,0,0
4227,185,2017,7,7,0,0.93,93,1096,2,4,1,1,3,1,5,0,1,0,0,2,1,1,0,0,0
4228,186,2017,14,14,0,0.99,98,1096,4,6,4,4,6,2,12,4,0,0,0,6,0,0,2,0,0
4229,187,2017,22,22,0,1.0,99,1096,15,4,3,11,4,2,17,7,4,0,0,4,0,1,1,0,0
4230,188,2017,19,19,0,1.0,99,1096,12,4,3,3,2,2,7,0,0,0,3,0,2,1,1,0,0
4231,189,2017,16,16,0,1.0,100,1096,10,4,2,9,3,2,14,8,1,0,0,2,1,2,0,0,0
4232,190,2017,33,33,0,1.0,100,1096,11,18,4,11,18,1,30,11,0,0,0,18,0,0,0,0,1
4233,191,2017,13,13,0,1.0,99,1096,4,7,2,3,7,2,12,2,1,0,0,7,0,2,0,0,0
4234,192,2017,7,6,1,0.91,90,1096,2,3,1,1,3,1,5,0,1,0,0,3,0,1,0,0,0
4235,193,2017,39,37,2,0.96,95,1096,19,18,0,10,11,0,21,5,1,4,0,4,7,0,0,0,0
4236,194,2017,40,40,0,1.0,100,1096,29,9,2,28,9,2,39,27,1,0,0,9,0,2,0,0,0
4237,195,2017,34,15,19,0.43,42,1096,6,6,3,2,5,3,10,0,1,0,1,4,1,3,0,0,0
4238,196,2017,19,19,0,1.0,100,1096,12,6,1,7,4,1,12,4,2,0,1,2,2,1,0,0,0
4239,197,2017,8,4,4,0.56,56,1096,2,2,0,2,2,0,4,2,0,0,0,2,0,0,0,0,0
4240,198,2017,30,10,20,0.32,32,1096,7,2,1,5,1,1,7,3,2,0,0,0,1,1,0,0,0
4241,199,2017,6,5,1,0.87,86,1096,3,2,0,3,1,0,4,3,0,0,0,0,1,0,0,0,0
4242,200,2017,54,33,21,0.61,60,1096,13,17,3,6,13,3,22,1,4,0,1,9,4,3,0,0,0
4243,201,2017,46,43,3,0.94,93,1096,19,23,1,19,22,1,42,19,0,0,0,21,1,1,0,0,0
4244,202,2017,35,4,31,0.11,11,1096,1,2,1,1,1,1,3,1,0,0,0,0,1,1,0,0,0
4245,203,2017,25,6,19,0.25,24,1096,3,3,0,1,2,0,3,0,0,1,0,1,1,0,0,0,0
4246,204,2017,38,38,0,1.0,99,1096,23,13,2,11,7,2,20,5,0,6,0,1,6,2,0,0,0
4247,205,2017,27,27,0,0.99,98,1096,14,10,3,10,6,2,18,8,1,0,1,2,4,1,1,0,0
4248,206,2017,31,31,0,1.0,100,1096,19,11,1,16,9,1,26,13,3,0,0,7,2,1,0,0,0
4249,207,2017,6,6,0,1.0,100,1096,3,2,1,2,2,1,5,1,1,0,0,2,0,1,0,0,0
4250,208,2017,36,36,0,1.0,100,1096,24,12,0,8,7,0,15,1,1,3,3,2,5,0,0,0,0
4251,209,2017,32,0,32,0.0,0,1096,0,0,0,0,0,0,0,0,0,0,0,0,0,0,0,0,0
4252,210,2017,34,12,22,0.35,34,1096,6,5,1,3,4,1,8,1,1,1,0,3,1,1,0,0,0
4253,211,2017,31,31,0,1.0,100,1096,22,5,4,17,3,3,23,15,0,1,1,1,2,2,1,0,0
4254,212,2017,35,35,0,1.0,100,1096,25,9,1,23,9,1,33,22,0,1,0,9,0,1,0,0,0
4255,213,2017,10,1,9,0.06,6,1096,0,1,0,0,1,0,1,0,0,0,0,1,0,0,0,0,0
4256,214,2017,18,18,0,1.0,100,1096,6,9,3,3,7,2,12,1,1,1,0,5,2,1,1,0,0
4257,215,2017,5,5,0,1.0,100,1096,2,2,1,2,2,1,5,2,0,0,0,2,0,1,0,0,0
4258,216,2017,26,26,0,1.0,100,1096,11,14,1,9,8,1,18,8,0,1,0,2,6,1,0,0,0
4259,217,2017,36,36,0,1.0,99,1096,21,14,1,7,7,1,15,0,0,7,0,0,7,1,0,0,0
4260,218,2017,39,38,1,0.97,96,1096,22,14,2,21,9,2,32,20,1,0,0,4,5,2,0,0,0
4261,219,2017,48,48,0,1.0,100,1096,27,20,1,24,18,1,43,23,0,0,1,16,2,1,0,0,0
4262,220,2017,44,28,16,0.63,63,1096,12,16,0,7,12,0,19,5,0,1,1,8,4,0,0,0,0
4263,221,2017,37,31,6,0.83,82,1096,12,16,3,9,10,1,20,6,3,0,0,4,6,0,0,1,0
4264,222,2017,15,6,9,0.4,39,1096,3,2,1,2,2,1,5,1,1,0,0,2,0,1,0,0,0
4265,223,2017,50,50,0,1.0,100,1096,24,23,3,20,23,3,46,18,0,2,0,23,0,3,0,0,0
4266,224,2017,21,20,1,0.96,95,1096,12,5,3,4,3,1,8,0,1,2,1,1,2,0,0,1,0
4267,225,2017,16,16,0,1.0,100,1096,7,7,2,2,7,1,10,0,0,1,1,7,0,0,1,0,0
4268,226,2017,7,6,1,0.93,92,1096,4,2,0,4,1,0,5,4,0,0,0,0,1,0,0,0,0
4269,227,2017,17,16,1,0.94,93,1096,7,7,2,7,4,1,12,7,0,0,0,1,3,0,1,0,0
4270,228,2017,11,6,5,0.54,54,1096,3,3,0,2,3,0,5,1,1,0,0,3,0,0,0,0,0
4271,229,2017,14,14,0,0.99,98,1096,10,3,1,10,3,1,14,10,0,0,0,3,0,1,0,0,0
4272,230,2017,22,18,4,0.82,82,1096,5,10,3,3,10,1,14,1,2,0,0,10,0,0,0,1,0
4273,231,2017,17,14,3,0.82,81,1096,7,4,3,6,4,3,13,5,1,0,0,4,0,3,0,0,0
4274,232,2017,30,27,3,0.9,89,1096,18,7,2,12,7,1,20,6,6,0,0,7,0,0,1,0,0
4275,233,2017,16,7,9,0.47,46,1096,2,3,2,1,3,2,6,0,1,0,0,3,0,2,0,0,0
4276,234,2017,24,2,22,0.08,7,1096,1,1,0,1,1,0,2,1,0,0,0,1,0,0,0,0,0
4277,235,2017,22,22,0,1.0,100,1096,14,5,3,6,4,2,12,0,4,2,0,3,1,1,1,0,0
4278,236,2017,14,13,1,0.94,94,1096,3,7,3,2,7,2,11,1,1,0,0,7,0,1,1,0,0
4279,237,2017,42,3,39,0.08,7,1096,2,1,0,2,1,0,3,2,0,0,0,1,0,0,0,0,0
4280,238,2017,17,16,1,0.92,92,1096,10,5,1,4,3,1,8,0,3,0,1,1,2,1,0,0,0
4281,239,2017,12,1,11,0.06,6,1096,0,1,0,0,1,0,1,0,0,0,0,1,0,0,0,0,0
4282,240,2017,28,28,0,0.99,98,1096,21,6,1,6,6,1,13,1,0,0,5,6,0,1,0,0,0
4283,241,2017,18,18,0,1.0,99,1096,10,7,1,6,7,1,14,4,0,2,0,7,0,1,0,0,0
4284,242,2017,55,55,0,1.0,99,1096,28,26,1,9,24,1,34,0,0,8,1,22,2,1,0,0,0
4285,243,2017,22,16,6,0.72,72,1096,11,4,1,11,3,1,15,11,0,0,0,2,1,1,0,0,0
4286,244,2017,53,49,4,0.92,92,1096,24,23,2,18,12,1,31,15,0,3,0,1,11,0,1,0,0
4287,245,2017,46,45,1,0.98,98,1096,22,22,1,13,18,1,32,9,0,3,1,14,4,1,0,0,0
4288,246,2017,30,30,0,1.0,100,1096,11,16,3,10,13,1,24,9,1,0,0,10,3,0,0,1,0
4289,247,2017,39,22,17,0.55,55,1096,11,10,1,5,6,1,12,1,2,2,0,2,4,1,0,0,0
4290,248,2017,15,15,0,1.0,100,1096,7,5,3,4,3,2,9,1,3,0,0,1,2,1,1,0,0
4291,249,2017,13,13,0,0.97,96,1096,9,4,0,4,3,0,7,0,3,1,0,2,1,0,0,0,0
4292,250,2017,46,32,14,0.7,69,1096,18,13,1,5,9,1,15,0,0,2,3,5,4,1,0,0,0
4293,251,2017,51,34,17,0.66,66,1096,24,8,2,7,5,2,14,1,0,1,5,2,3,2,0,0,0
4294,252,2017,11,6,5,0.57,57,1096,2,3,1,1,2,1,4,0,1,0,0,1,1,1,0,0,0
4295,253,2017,57,55,2,0.97,97,1096,31,22,2,19,14,2,35,13,0,6,0,6,8,2,0,0,0
4296,254,2017,30,29,1,0.96,95,1096,9,17,3,7,14,1,22,6,0,1,0,11,3,0,0,1,0
4297,255,2017,35,33,2,0.95,95,1096,14,15,4,12,10,4,26,10,2,0,0,5,5,4,0,0,0
4298,256,2017,34,4,30,0.13,12,1096,2,2,0,2,1,0,3,2,0,0,0,0,1,0,0,0,0
4299,257,2017,15,15,0,1.0,100,1096,6,5,4,2,5,2,9,0,0,2,0,5,0,0,2,0,0
4300,258,2017,37,29,8,0.79,78,1096,13,13,3,4,10,1,15,1,0,0,3,7,3,0,0,1,0
4301,259,2017,14,1,13,0.1,9,1096,0,1,0,0,1,0,1,0,0,0,0,1,0,0,0,0,0
4302,260,2017,56,36,20,0.64,64,1096,21,14,1,17,11,1,29,15,0,2,0,8,3,1,0,0,0
4303,261,2017,7,6,1,0.9,89,1096,3,2,1,1,2,1,4,0,0,1,0,2,0,1,0,0,0
4304,262,2017,30,14,16,0.48,47,1096,5,8,1,3,4,1,8,1,2,0,0,0,4,1,0,0,0
4305,263,2017,29,29,0,0.99,98,1096,14,14,1,4,8,1,13,0,1,0,3,2,6,1,0,0,0
4306,264,2017,25,25,0,0.99,99,1096,16,5,4,10,4,4,18,6,3,0,1,3,1,4,0,0,0
4307,265,2017,23,23,0,1.0,99,1096,11,12,0,10,6,0,16,9,1,0,0,0,6,0,0,0,0
4308,266,2017,25,16,9,0.66,65,1096,9,4,3,6,2,3,11,3,3,0,0,0,2,3,0,0,0
4309,267,2017,12,12,0,0.98,97,1096,5,6,1,2,4,1,7,0,1,1,0,2,2,1,0,0,0
4310,268,2017,19,19,0,1.0,99,1096,12,6,1,3,6,1,10,0,0,0,3,6,0,1,0,0,0
4311,269,2017,32,1,31,0.02,2,1096,0,1,0,0,1,0,1,0,0,0,0,1,0,0,0,0,0
4312,270,2017,35,34,1,0.97,96,1096,14,20,0,4,18,0,22,0,0,2,2,16,2,0,0,0,0
4313,271,2017,30,30,0,1.0,100,1096,18,10,2,13,5,1,19,8,5,0,0,0,5,0,1,0,0
4314,272,2017,46,46,0,0.99,98,1096,18,27,1,15,15,1,31,13,1,1,0,3,12,1,0,0,0
4315,273,2017,14,14,0,1.0,99,1096,10,3,1,6,3,1,10,3,2,1,0,3,0,1,0,0,0
4316,274,2017,19,19,0,1.0,100,1096,9,9,1,8,8,1,17,7,1,0,0,7,1,1,0,0,0
4317,275,2017,11,4,7,0.37,36,1096,1,2,1,1,2,1,4,1,0,0,0,2,0,1,0,0,0
4318,276,2017,31,29,2,0.95,95,1096,15,10,4,8,10,3,21,2,5,1,0,10,0,2,1,0,0
4319,277,2017,28,28,0,1.0,99,1096,18,8,2,13,8,1,22,9,3,1,0,8,0,0,1,0,0
4320,278,2017,31,30,1,0.95,95,1096,18,11,1,9,8,1,18,4,3,0,2,5,3,1,0,0,0
4321,279,2017,21,10,11,0.48,48,1096,6,3,1,2,3,1,6,0,1,0,1,3,0,1,0,0,0
4322,280,2017,15,15,0,1.0,99,1096,10,5,0,9,3,0,12,8,1,0,0,1,2,0,0,0,0
4323,281,2017,39,39,0,0.99,98,1096,29,7,3,24,7,1,32,21,2,0,1,7,0,0,0,1,0
4324,282,2017,49,34,15,0.7,70,1096,19,14,1,14,14,1,29,11,1,2,0,14,0,1,0,0,0
4325,283,2017,20,2,18,0.08,7,1096,1,1,0,1,1,0,2,1,0,0,0,1,0,0,0,0,0
4326,284,2017,11,1,10,0.09,9,1096,0,1,0,0,1,0,1,0,0,0,0,1,0,0,0,0,0
4327,285,2017,48,47,1,0.99,98,1096,28,19,0,9,15,0,24,2,1,0,6,11,4,0,0,0,0
4328,286,2017,28,5,23,0.17,16,1096,2,2,1,1,2,1,4,0,1,0,0,2,0,1,0,0,0
4329,287,2017,15,15,0,0.97,97,1096,5,9,1,3,7,1,11,1,2,0,0,5,2,1,0,0,0
4330,288,2017,37,34,3,0.91,90,1096,23,9,2,13,9,1,23,5,6,2,0,9,0,0,1,0,0
4331,289,2017,20,18,2,0.89,88,1096,9,8,1,9,7,1,17,9,0,0,0,6,1,1,0,0,0
4332,290,2017,22,22,0,0.99,99,1096,16,4,2,6,2,2,10,1,0,5,0,0,2,2,0,0,0
4333,291,2017,39,39,0,1.0,100,1096,28,9,2,27,6,1,34,26,1,0,0,3,3,0,1,0,0
4334,292,2017,15,15,0,1.0,100,1096,5,7,3,2,6,2,10,0,1,1,0,5,1,1,1,0,0
4335,293,2017,20,20,0,1.0,100,1096,14,4,2,12,2,2,16,11,0,1,0,0,2,2,0,0,0
4336,294,2017,22,21,1,0.98,97,1096,14,6,1,12,5,1,18,10,2,0,0,4,1,1,0,0,0
4337,295,2017,49,16,33,0.33,33,1096,8,5,3,2,4,1,7,0,0,0,2,3,1,0,0,1,0
4338,296,2017,18,0,18,0.02,2,1096,0,0,0,0,0,0,0,0,0,0,0,0,0,0,0,0,0
4339,297,2017,35,23,12,0.67,66,1096,12,9,2,9,5,1,15,8,0,0,1,1,4,0,1,0,0
4340,298,2017,44,42,2,0.96,96,1096,30,9,3,8,7,3,18,0,1,0,7,5,2,3,0,0,0
4341,299,2017,33,33,0,1.0,100,1096,23,8,2,21,5,1,27,19,2,0,0,2,3,0,1,0,0
4342,300,2017,25,22,3,0.88,88,1096,16,6,0,12,4,0,16,8,4,0,0,2,2,0,0,0,0
4343,301,2017,30,30,0,0.99,98,1096,14,14,2,8,13,1,22,2,6,0,0,12,1,0,1,0,0
4344,302,2017,29,25,4,0.85,85,1096,17,6,2,11,4,1,16,7,3,0,1,2,2,0,1,0,0
4345,303,2017,56,56,0,1.0,100,1096,28,24,4,13,20,2,35,6,2,2,3,16,4,1,0,1,0
4346,304,2017,47,17,30,0.36,36,1096,11,4,2,9,3,2,14,8,0,1,0,2,1,2,0,0,0
4347,305,2017,18,18,0,0.98,98,1096,9,7,2,8,7,2,17,7,1,0,0,7,0,2,0,0,0
4348,306,2017,49,49,0,1.0,99,1096,20,26,3,19,24,3,46,18,1,0,0,22,2,3,0,0,0
4349,307,2017,35,31,4,0.89,89,1096,16,14,1,12,12,1,25,9,2,1,0,10,2,1,0,0,0
4350,308,2017,13,13,0,0.99,99,1096,4,5,4,4,5,2,11,4,0,0,0,5,0,1,0,1,0
4351,309,2017,10,8,2,0.83,82,1096,3,3,2,3,3,1,7,3,0,0,0,3,0,0,1,0,0
4352,310,2017,37,0,37,0.0,0,1096,0,0,0,0,0,0,0,0,0,0,0,0,0,0,0,0,0
4353,311,2017,30,30,0,1.0,100,1096,22,5,3,12,5,3,20,5,5,1,1,5,0,3,0,0,0
4354,312,2017,11,10,1,0.93,92,1096,7,3,0,5,3,0,8,4,0,1,0,3,0,0,0,0,0
4355,313,2017,60,60,0,1.0,99,1096,35,21,4,13,12,1,26,3,4,0,6,3,9,0,0,0,1
4356,314,2017,9,9,0,1.0,100,1096,4,4,1,3,2,1,6,2,1,0,0,0,2,1,0,0,0
4357,315,2017,54,54,0,1.0,100,1096,20,31,3,14,24,3,41,10,3,0,1,17,7,3,0,0,0
4358,316,2017,15,15,0,1.0,100,1096,5,6,4,2,5,2,9,0,1,1,0,4,1,1,0,1,0
4359,317,2017,41,41,0,0.99,98,1096,29,10,2,28,5,2,35,27,1,0,0,0,5,2,0,0,0
4360,318,2017,26,26,0,1.0,99,1096,10,15,1,3,11,1,15,0,0,2,1,7,4,1,0,0,0
4361,319,2017,7,7,0,1.0,100,1096,2,3,2,1,3,2,6,0,1,0,0,3,0,2,0,0,0
4362,320,2017,28,24,4,0.85,84,1096,7,14,3,2,10,3,15,0,0,1,1,6,4,3,0,0,0
4363,321,2017,5,5,0,1.0,100,1096,2,2,1,2,1,1,4,2,0,0,0,0,1,1,0,0,0
4364,322,2017,14,14,0,0.99,99,1096,5,7,2,5,5,2,12,5,0,0,0,3,2,2,0,0,0
4365,323,2017,57,45,12,0.79,78,1096,27,15,3,26,13,3,42,25,1,0,0,11,2,3,0,0,0
4366,324,2017,26,14,12,0.53,52,1096,7,6,1,5,4,1,10,4,0,1,0,2,2,1,0,0,0
4367,325,2017,25,25,0,1.0,100,1096,16,6,3,15,3,3,21,14,1,0,0,0,3,3,0,0,0
4368,326,2017,27,23,4,0.85,84,1096,14,5,4,9,4,4,17,5,3,1,0,3,1,4,0,0,0
4369,327,2017,52,50,2,0.97,97,1096,25,21,4,10,17,2,29,3,0,6,1,13,4,0,2,0,0
4370,328,2017,9,8,1,0.87,86,1096,2,4,2,2,2,1,5,2,0,0,0,0,2,0,1,0,0
4371,329,2017,25,25,0,1.0,100,1096,18,5,2,11,5,2,18,7,2,1,1,5,0,2,0,0,0
4372,330,2017,30,29,1,0.95,95,1096,11,16,2,11,12,1,24,11,0,0,0,8,4,0,1,0,0
4373,331,2017,59,58,1,0.99,98,1096,32,22,4,28,15,4,47,26,0,2,0,8,7,4,0,0,0
4374,332,2017,43,9,34,0.22,21,1096,6,2,1,6,2,1,9,6,0,0,0,2,0,1,0,0,0
4375,333,2017,27,6,21,0.24,23,1096,4,2,0,1,1,0,2,0,0,0,1,0,1,0,0,0,0
4376,334,2017,24,18,6,0.74,73,1096,9,5,4,3,4,3,10,0,1,1,1,3,1,2,1,0,0
4377,335,2017,58,58,0,1.0,99,1096,39,18,1,17,14,1,32,5,3,8,1,10,4,1,0,0,0
4378,336,2017,40,40,0,1.0,99,1096,24,16,0,24,10,0,34,24,0,0,0,4,6,0,0,0,0
4379,337,2017,31,12,19,0.38,38,1096,3,6,3,3,6,3,12,3,0,0,0,6,0,3,0,0,0
4380,338,2017,15,15,0,0.99,98,1096,7,6,2,6,5,1,12,5,1,0,0,4,1,0,1,0,0
4381,339,2017,23,22,1,0.98,97,1096,15,4,3,10,2,1,13,5,5,0,0,0,2,0,0,1,0
4382,340,2017,38,38,0,1.0,99,1096,15,21,2,4,17,1,22,0,0,1,3,13,4,0,1,0,0
4383,341,2017,27,27,0,1.0,100,1096,11,15,1,9,15,1,25,8,0,1,0,15,0,1,0,0,0
4384,342,2017,8,5,3,0.66,66,1096,2,3,0,1,3,0,4,0,1,0,0,3,0,0,0,0,0
4385,343,2017,50,47,3,0.94,94,1096,25,22,0,11,14,0,25,3,2,6,0,6,8,0,0,0,0
4386,344,2017,23,23,0,1.0,100,1096,11,9,3,11,9,3,23,11,0,0,0,9,0,3,0,0,0
4387,345,2017,40,40,0,1.0,99,1096,25,13,2,11,7,1,19,2,4,5,0,1,6,0,1,0,0
4388,346,2017,48,48,0,1.0,100,1096,32,14,2,12,11,1,24,0,7,2,3,8,3,0,1,0,0
4389,347,2017,21,21,0,1.0,99,1096,8,12,1,8,12,1,21,8,0,0,0,12,0,1,0,0,0
4390,348,2017,38,37,1,0.98,98,1096,16,20,1,7,13,1,21,1,4,1,1,6,7,1,0,0,0
4391,349,2017,24,24,0,1.0,99,1096,16,7,1,8,5,1,14,0,8,0,0,3,2,1,0,0,0
4392,350,2017,39,38,1,0.98,97,1096,25,10,3,9,9,3,21,1,1,6,1,8,1,3,0,0,0
4393,351,2017,29,8,21,0.28,28,1096,3,3,2,1,2,2,5,0,0,1,0,1,1,2,0,0,0
4394,352,2017,36,36,0,1.0,99,1096,20,14,2,17,9,2,28,15,1,1,0,4,5,2,0,0,0
4395,353,2017,39,39,0,1.0,99,1096,22,16,1,16,9,1,26,13,0,3,0,2,7,1,0,0,0
4396,354,2017,15,6,9,0.41,40,1096,3,3,0,1,2,0,3,0,0,1,0,1,1,0,0,0,0
4397,355,2017,22,22,0,1.0,99,1096,11,10,1,6,9,1,16,3,2,0,1,8,1,1,0,0,0
4398,356,2017,31,31,0,0.99,98,1096,15,13,3,7,10,2,19,4,0,1,2,7,3,1,1,0,0
4399,357,2017,26,15,11,0.57,56,1096,10,3,2,3,3,2,8,0,0,2,1,3,0,2,0,0,0
4400,358,2017,49,1,48,0.01,1,1096,0,1,0,0,1,0,1,0,0,0,0,1,0,0,0,0,0
4401,359,2017,36,27,9,0.74,74,1096,12,13,2,7,9,2,18,5,0,1,1,5,4,2,0,0,0
4402,360,2017,37,34,3,0.91,90,1096,24,8,2,14,4,2,20,10,0,2,2,0,4,2,0,0,0
4403,361,2017,27,9,18,0.34,33,1096,3,4,2,3,3,1,7,3,0,0,0,2,1,0,1,0,0
4404,362,2017,18,8,10,0.42,42,1096,2,4,2,1,3,2,6,0,1,0,0,2,1,2,0,0,0
4405,363,2017,34,34,0,1.0,100,1096,22,11,1,11,7,1,19,6,0,4,1,3,4,1,0,0,0
4406,364,2017,35,35,0,0.99,99,1096,24,10,1,6,10,1,17,0,0,0,6,10,0,1,0,0,0
4407,365,2017,25,24,1,0.95,95,1096,10,10,4,3,5,4,12,0,0,2,1,0,5,4,0,0,0
4408,366,2017,9,5,4,0.54,53,1096,2,2,1,1,1,1,3,0,1,0,0,0,1,1,0,0,0
4409,367,2017,12,12,0,0.96,96,1096,5,6,1,5,3,1,9,5,0,0,0,0,3,1,0,0,0
4410,368,2017,58,20,38,0.34,33,1096,14,4,2,5,4,2,11,2,0,0,3,4,0,2,0,0,0
4411,369,2017,51,49,2,0.97,96,1096,34,13,2,18,9,1,28,11,2,1,4,5,4,0,1,0,0
4412,370,2017,28,2,26,0.09,8,1096,1,1,0,1,1,0,2,1,0,0,0,1,0,0,0,0,0
4413,371,2017,15,15,0,0.97,96,1096,8,5,2,3,5,1,9,0,1,2,0,5,0,0,1,0,0
4414,372,2017,6,1,5,0.14,13,1096,0,1,0,0,1,0,1,0,0,0,0,1,0,0,0,0,0
4415,373,2017,16,15,1,0.94,93,1096,11,3,1,9,2,1,12,7,2,0,0,1,1,1,0,0,0
4416,374,2017,16,16,0,0.99,98,1096,8,6,2,2,6,2,10,0,0,0,2,6,0,2,0,0,0
4417,375,2017,33,3,30,0.1,10,1096,2,1,0,1,1,0,2,0,1,0,0,1,0,0,0,0,0
4418,376,2017,36,12,24,0.33,32,1096,5,5,2,2,4,2,8,0,1,1,0,3,1,2,0,0,0
4419,377,2017,9,9,0,1.0,99,1096,4,3,2,4,2,1,7,4,0,0,0,1,1,0,1,0,0
4420,378,2017,14,14,0,1.0,100,1096,8,4,2,8,3,1,12,8,0,0,0,2,1,0,1,0,0
4421,379,2017,43,42,1,0.98,97,1096,21,19,2,8,16,1,25,1,2,4,1,13,3,0,1,0,0
4422,380,2017,42,23,19,0.56,55,1096,16,5,2,7,4,2,13,2,3,0,2,3,1,2,0,0,0
4423,381,2017,31,31,0,0.99,98,1096,14,16,1,14,13,1,28,14,0,0,0,10,3,1,0,0,0
4424,382,2017,40,40,0,0.99,98,1096,15,23,2,9,18,1,28,6,0,3,0,13,5,0,1,0,0
4425,383,2017,20,19,1,0.96,96,1096,8,9,2,6,5,1,12,4,2,0,0,1,4,0,1,0,0
4426,384,2017,42,41,1,0.97,96,1096,20,18,3,12,13,1,26,8,0,4,0,8,5,0,0,1,0
4427,385,2017,18,18,0,1.0,99,1096,12,5,1,3,5,1,9,0,0,0,3,5,0,1,0,0,0
4428,386,2017,56,42,14,0.74,74,1096,15,24,3,10,19,1,30,7,2,0,1,14,5,0,0,1,0
4429,387,2017,58,44,14,0.77,76,1096,30,14,0,12,9,0,21,3,1,7,1,4,5,0,0,0,0
4430,388,2017,32,28,4,0.88,87,1096,8,16,4,4,14,2,20,2,1,0,1,12,2,0,2,0,0
4431,389,2017,50,28,22,0.56,56,1096,14,11,3,9,8,3,20,6,1,2,0,5,3,3,0,0,0
4432,390,2017,34,12,22,0.35,35,1096,8,4,0,3,2,0,5,0,2,0,1,0,2,0,0,0,0
4433,391,2017,39,38,1,0.97,96,1096,17,21,0,15,14,0,29,13,2,0,0,7,7,0,0,0,0
4434,392,2017,15,8,7,0.52,51,1096,2,4,2,2,3,1,6,2,0,0,0,2,1,0,1,0,0
4435,393,2017,9,9,0,0.98,97,1096,3,4,2,3,3,2,8,3,0,0,0,2,1,2,0,0,0
4436,394,2017,31,3,28,0.09,8,1096,2,1,0,1,1,0,2,0,1,0,0,1,0,0,0,0,0
4437,395,2017,11,11,0,1.0,99,1096,5,5,1,5,5,1,11,5,0,0,0,5,0,1,0,0,0
4438,396,2017,31,31,0,1.0,100,1096,20,9,2,12,6,2,20,8,2,0,2,3,3,2,0,0,0
4439,397,2017,53,49,4,0.92,92,1096,20,29,0,14,20,0,34,10,2,2,0,11,9,0,0,0,0
4440,398,2017,15,15,0,1.0,99,1096,10,4,1,6,3,1,10,4,0,2,0,2,1,1,0,0,0
4441,399,2017,36,36,0,1.0,100,1096,14,20,2,14,12,2,28,14,0,0,0,4,8,2,0,0,0
4442,400,2017,25,24,1,0.94,94,1096,10,13,1,10,11,1,22,10,0,0,0,9,2,1,0,0,0
4443,401,2017,22,22,0,1.0,99,1096,10,9,3,10,5,2,17,10,0,0,0,1,4,1,1,0,0
4444,402,2017,57,57,0,1.0,100,1096,38,18,1,32,15,1,48,28,3,0,1,12,3,1,0,0,0
4445,403,2017,28,27,1,0.98,98,1096,16,9,2,9,6,2,17,5,2,1,1,3,3,2,0,0,0
4446,404,2017,9,9,0,1.0,100,1096,4,5,0,2,4,0,6,1,0,1,0,3,1,0,0,0,0
4447,405,2017,57,53,4,0.92,92,1096,24,29,0,14,15,0,29,9,1,3,1,1,14,0,0,0,0
4448,406,2017,39,36,3,0.92,91,1096,18,17,1,5,14,1,20,0,1,0,4,11,3,1,0,0,0
4449,407,2017,9,5,4,0.51,51,1096,3,2,0,1,2,0,3,0,0,1,0,2,0,0,0,0,0
4450,408,2017,39,39,0,1.0,100,1096,29,7,3,18,5,1,24,11,3,4,0,3,2,0,0,1,0
4451,409,2017,16,16,0,1.0,100,1096,4,9,3,4,5,3,12,4,0,0,0,1,4,3,0,0,0
4452,410,2017,52,48,4,0.92,92,1096,20,26,2,12,20,2,34,8,2,0,2,14,6,2,0,0,0
4453,411,2017,52,48,4,0.93,93,1096,30,17,1,19,13,1,33,9,9,1,0,9,4,1,0,0,0
4454,412,2017,55,55,0,1.0,99,1096,29,24,2,21,24,1,46,15,5,0,1,24,0,0,1,0,0
4455,413,2017,9,9,0,1.0,100,1096,5,3,1,2,3,1,6,0,1,1,0,3,0,1,0,0,0
4456,414,2017,9,9,0,1.0,99,1096,6,2,1,6,2,1,9,6,0,0,0,2,0,1,0,0,0
4457,415,2017,8,6,2,0.74,73,1096,3,2,1,3,2,1,6,3,0,0,0,2,0,1,0,0,0
4458,416,2017,26,0,26,0.01,1,1096,0,0,0,0,0,0,0,0,0,0,0,0,0,0,0,0,0
4459,417,2017,48,46,2,0.96,95,1096,26,19,1,12,10,1,23,0,11,0,1,1,9,1,0,0,0
4460,418,2017,28,5,23,0.17,17,1096,2,3,0,2,3,0,5,2,0,0,0,3,0,0,0,0,0
4461,419,2017,20,14,6,0.68,68,1096,3,8,3,3,6,1,10,3,0,0,0,4,2,0,0,1,0
4462,420,2017,14,14,0,1.0,99,1096,6,6,2,3,4,2,9,1,1,1,0,2,2,2,0,0,0
4463,421,2017,16,16,0,0.97,97,1096,8,8,0,7,5,0,12,6,1,0,0,2,3,0,0,0,0
4464,422,2017,15,8,7,0.54,54,1096,3,4,1,2,4,1,7,1,1,0,0,4,0,1,0,0,0
4465,423,2017,13,10,3,0.75,75,1096,3,6,1,1,3,1,5,0,0,1,0,0,3,1,0,0,0
4466,424,2017,27,8,19,0.3,29,1096,5,2,1,4,1,1,6,3,1,0,0,0,1,1,0,0,0
4467,425,2017,20,6,14,0.32,32,1096,4,2,0,2,1,0,3,0,2,0,0,0,1,0,0,0,0
4468,426,2017,44,32,12,0.73,73,1096,17,12,3,9,7,3,19,2,6,1,0,2,5,3,0,0,0
4469,427,2017,19,18,1,0.95,95,1096,9,7,2,8,4,1,13,7,1,0,0,1,3,0,1,0,0
4470,428,2017,33,3,30,0.1,10,1096,1,2,0,1,2,0,3,1,0,0,0,2,0,0,0,0,0
4471,429,2017,8,3,5,0.41,40,1096,2,1,0,2,1,0,3,2,0,0,0,1,0,0,0,0,0
4472,430,2017,11,11,0,0.96,96,1096,5,6,0,3,3,0,6,1,2,0,0,0,3,0,0,0,0
4473,431,2017,55,20,35,0.36,36,1096,12,7,1,4,4,1,9,0,1,2,1,1,3,1,0,0,0
4474,432,2017,36,35,1,0.98,98,1096,25,10,0,12,5,0,17,1,10,0,1,0,5,0,0,0,0
4475,433,2017,19,18,1,0.95,95,1096,12,5,1,4,5,1,10,0,1,2,1,5,0,1,0,0,0
4476,434,2017,14,14,0,1.0,100,1096,9,5,0,7,3,0,10,6,0,1,0,1,2,0,0,0,0
4477,435,2017,17,17,0,1.0,99,1096,5,9,3,4,5,3,12,3,1,0,0,1,4,3,0,0,0
4478,436,2017,40,37,3,0.93,92,1096,17,17,3,16,11,1,28,15,1,0,0,5,6,0,0,1,0
4479,437,2017,11,11,0,0.99,98,1096,5,5,1,5,4,1,10,5,0,0,0,3,1,1,0,0,0
4480,438,2017,9,9,0,1.0,99,1096,4,3,2,3,2,1,6,2,1,0,0,1,1,0,1,0,0
4481,439,2017,30,4,26,0.13,13,1096,3,1,0,2,1,0,3,1,1,0,0,1,0,0,0,0,0
4482,440,2017,31,31,0,1.0,100,1096,16,14,1,6,14,1,21,1,1,3,1,14,0,1,0,0,0
4483,441,2017,6,0,6,0.01,1,1096,0,0,0,0,0,0,0,0,0,0,0,0,0,0,0,0,0
4484,442,2017,36,34,2,0.94,94,1096,13,19,2,6,11,2,19,1,4,0,1,3,8,2,0,0,0
4485,443,2017,52,42,10,0.81,80,1096,18,22,2,16,19,2,37,14,2,0,0,16,3,2,0,0,0
4486,444,2017,40,32,8,0.79,79,1096,15,17,0,13,11,0,24,11,2,0,0,5,6,0,0,0,0
4487,445,2017,6,6,0,0.97,97,1096,3,2,1,2,2,1,5,1,1,0,0,2,0,1,0,0,0
4488,446,2017,40,10,30,0.24,24,1096,6,4,0,4,4,0,8,2,2,0,0,4,0,0,0,0,0
4489,447,2017,28,19,9,0.68,68,1096,13,5,1,4,3,1,8,0,0,3,1,1,2,1,0,0,0
4490,448,2017,31,15,16,0.5,49,1096,7,6,2,2,5,1,8,0,0,1,1,4,1,0,1,0,0
4491,449,2017,22,22,0,0.99,98,1096,16,4,2,7,4,1,12,1,3,3,0,4,0,0,1,0,0
4492,450,2017,11,11,0,1.0,100,1096,6,3,2,3,3,2,8,2,0,0,1,3,0,2,0,0,0
4493,451,2017,20,14,6,0.72,72,1096,7,6,1,7,3,1,11,7,0,0,0,0,3,1,0,0,0
4494,452,2017,39,5,34,0.14,14,1096,3,2,0,1,2,0,3,0,0,1,0,2,0,0,0,0,0
4495,453,2017,37,36,1,0.97,96,1096,25,10,1,10,9,1,20,1,5,2,2,8,1,1,0,0,0
4496,454,2017,55,55,0,1.0,100,1096,35,18,2,29,18,2,49,24,4,1,0,18,0,2,0,0,0
4497,455,2017,20,17,3,0.83,83,1096,7,9,1,2,5,1,8,0,0,1,1,1,4,1,0,0,0
4498,456,2017,31,31,0,1.0,100,1096,21,7,3,6,7,1,14,1,0,0,5,7,0,0,0,1,0
4499,457,2017,19,19,0,1.0,100,1096,11,7,1,8,6,1,15,5,3,0,0,5,1,1,0,0,0
4500,458,2017,37,37,0,0.99,99,1096,23,13,1,20,13,1,34,18,1,1,0,13,0,1,0,0,0
4501,459,2017,40,40,0,1.0,100,1096,19,18,3,15,17,1,33,13,0,2,0,16,1,0,0,1,0
4502,460,2017,44,41,3,0.93,92,1096,18,19,4,7,19,4,30,2,0,4,1,19,0,4,0,0,0
4503,461,2017,5,5,0,0.98,97,1096,1,3,1,1,3,1,5,1,0,0,0,3,0,1,0,0,0
4504,462,2017,25,25,0,1.0,100,1096,9,15,1,5,10,1,16,3,0,2,0,5,5,1,0,0,0
4505,463,2017,13,13,0,0.99,98,1096,9,4,0,9,4,0,13,9,0,0,0,4,0,0,0,0,0
4506,464,2017,26,24,2,0.94,93,1096,15,8,1,15,8,1,24,15,0,0,0,8,0,1,0,0,0
4507,465,2017,24,10,14,0.42,42,1096,5,3,2,4,2,2,8,3,1,0,0,1,1,2,0,0,0
4508,466,2017,11,0,11,0.0,0,1096,0,0,0,0,0,0,0,0,0,0,0,0,0,0,0,0,0
4509,467,2017,11,9,2,0.85,85,1096,2,5,2,2,4,2,8,2,0,0,0,3,1,2,0,0,0
4510,468,2017,7,1,6,0.16,15,1096,0,1,0,0,1,0,1,0,0,0,0,1,0,0,0,0,0
4511,469,2017,34,34,0,0.99,99,1096,15,17,2,13,15,1,29,11,2,0,0,13,2,0,1,0,0
4512,470,2017,33,21,12,0.63,62,1096,14,6,1,11,3,1,15,9,1,1,0,0,3,1,0,0,0
4513,471,2017,36,14,22,0.39,39,1096,6,5,3,4,3,1,8,3,0,1,0,1,2,0,0,1,0
4514,472,2017,31,31,0,0.99,99,1096,16,13,2,12,7,1,20,10,1,0,1,1,6,0,1,0,0
4515,473,2017,48,44,4,0.92,91,1096,25,19,0,14,13,0,27,4,9,1,0,7,6,0,0,0,0
4516,474,2017,21,21,0,1.0,99,1096,8,10,3,6,9,3,18,4,2,0,0,8,1,3,0,0,0
4517,475,2017,19,3,16,0.18,17,1096,2,1,0,1,1,0,2,0,1,0,0,1,0,0,0,0,0
4518,476,2017,20,5,15,0.25,25,1096,2,2,1,1,2,1,4,0,1,0,0,2,0,1,0,0,0
4519,477,2017,21,0,21,0.01,1,1096,0,0,0,0,0,0,0,0,0,0,0,0,0,0,0,0,0
4520,478,2017,30,29,1,0.96,96,1096,12,15,2,11,13,1,25,10,1,0,0,11,2,0,1,0,0
4521,479,2017,7,7,0,1.0,99,1096,3,3,1,2,2,1,5,1,1,0,0,1,1,1,0,0,0
4522,480,2017,45,44,1,0.97,96,1096,17,25,2,12,24,1,37,9,1,2,0,23,1,0,1,0,0
4523,481,2017,51,51,0,1.0,99,1096,24,26,1,15,22,1,38,6,9,0,0,18,4,1,0,0,0
4524,482,2017,10,3,7,0.34,33,1096,2,1,0,1,1,0,2,0,1,0,0,1,0,0,0,0,0
4525,483,2017,30,29,1,0.98,97,1096,12,16,1,5,16,1,22,1,1,3,0,16,0,1,0,0,0
4526,484,2017,9,9,0,0.96,96,1096,3,4,2,3,4,1,8,3,0,0,0,4,0,0,1,0,0
4527,485,2017,24,10,14,0.43,42,1096,6,4,0,5,4,0,9,4,1,0,0,4,0,0,0,0,0
4528,486,2017,22,1,21,0.06,5,1096,0,1,0,0,1,0,1,0,0,0,0,1,0,0,0,0,0
4529,487,2017,31,31,0,1.0,100,1096,14,13,4,4,8,3,15,0,0,2,2,3,5,2,1,0,0
4530,488,2017,8,8,0,1.0,100,1096,4,3,1,2,3,1,6,0,2,0,0,3,0,1,0,0,0
4531,489,2017,25,16,9,0.63,63,1096,12,3,1,9,2,1,12,6,3,0,0,1,1,1,0,0,0
4532,490,2017,33,19,14,0.57,57,1096,7,11,1,5,10,1,16,3,2,0,0,9,1,1,0,0,0
4533,491,2017,5,1,4,0.11,10,1096,0,1,0,0,1,0,1,0,0,0,0,1,0,0,0,0,0
4534,492,2017,7,7,0,1.0,99,1096,3,3,1,1,2,1,4,0,0,1,0,1,1,1,0,0,0
4535,493,2017,10,10,0,0.99,98,1096,6,3,1,3,3,1,7,0,3,0,0,3,0,1,0,0,0
4536,494,2017,9,7,2,0.78,77,1096,2,4,1,2,4,1,7,2,0,0,0,4,0,1,0,0,0
4537,495,2017,13,11,2,0.88,87,1096,4,5,2,2,5,1,8,1,0,1,0,5,0,0,1,0,0
4538,496,2017,50,50,0,1.0,100,1096,24,25,1,19,22,1,42,16,2,0,1,19,3,1,0,0,0
4539,497,2017,31,30,1,0.98,98,1096,19,8,3,8,5,2,15,1,5,0,2,2,3,1,1,0,0
4540,498,2017,27,26,1,0.98,97,1096,19,6,1,5,4,1,10,0,0,1,4,2,2,1,0,0,0
4541,499,2017,49,49,0,1.0,99,1096,34,12,3,13,8,3,24,2,2,8,1,4,4,3,0,0,0
4542,500,2017,40,17,23,0.44,43,1096,8,9,0,3,7,0,10,0,1,2,0,5,2,0,0,0,0
4543,501,2017,8,8,0,1.0,99,1096,2,5,1,1,5,1,7,0,1,0,0,5,0,1,0,0,0
4544,502,2017,7,3,4,0.44,44,1096,2,1,0,2,1,0,3,2,0,0,0,1,0,0,0,0,0
4545,503,2017,13,12,1,0.93,92,1096,5,5,2,3,4,1,8,2,0,1,0,3,1,0,1,0,0
4546,504,2017,35,35,0,1.0,100,1096,16,18,1,6,9,1,16,2,1,0,3,0,9,1,0,0,0
4547,505,2017,46,46,0,1.0,99,1096,32,13,1,31,10,1,42,30,1,0,0,7,3,1,0,0,0
4548,506,2017,45,29,16,0.64,63,1096,9,17,3,3,10,3,16,0,0,3,0,3,7,3,0,0,0
4549,507,2017,55,47,8,0.85,84,1096,34,11,2,13,11,2,26,5,0,3,5,11,0,2,0,0,0
4550,508,2017,11,11,0,0.96,96,1096,7,3,1,4,3,1,8,3,0,0,1,3,0,1,0,0,0
4551,509,2017,14,14,0,1.0,99,1096,7,4,3,2,4,2,8,0,0,1,1,4,0,1,1,0,0
4552,510,2017,16,15,1,0.94,93,1096,10,3,2,7,3,2,12,6,0,0,1,3,0,2,0,0,0
4553,511,2017,11,4,7,0.36,36,1096,1,2,1,1,2,1,4,1,0,0,0,2,0,1,0,0,0
4554,512,2017,32,29,3,0.9,89,1096,17,9,3,12,6,3,21,9,1,2,0,3,3,3,0,0,0
4555,513,2017,8,1,7,0.1,10,1096,0,1,0,0,1,0,1,0,0,0,0,1,0,0,0,0,0
4556,514,2017,42,39,3,0.93,93,1096,19,18,2,9,15,1,25,2,4,3,0,12,3,0,1,0,0
4557,515,2017,26,26,0,0.99,99,1096,18,8,0,9,4,0,13,5,1,1,2,0,4,0,0,0,0
4558,516,2017,29,16,13,0.57,56,1096,6,9,1,5,8,1,14,4,1,0,0,7,1,1,0,0,0
4559,517,2017,17,17,0,1.0,100,1096,8,6,3,7,3,1,11,6,1,0,0,0,3,0,0,1,0
4560,518,2017,39,39,0,1.0,99,1096,14,22,3,4,20,1,25,0,1,0,3,18,2,0,0,1,0
4561,519,2017,27,23,4,0.84,84,1096,8,14,1,5,7,1,13,3,1,1,0,0,7,1,0,0,0
4562,520,2017,51,30,21,0.6,59,1096,13,16,1,10,10,1,21,8,1,1,0,4,6,1,0,0,0
4563,521,2017,36,35,1,0.98,97,1096,14,19,2,14,17,2,33,14,0,0,0,15,2,2,0,0,0
4564,522,2017,19,9,10,0.46,46,1096,2,5,2,1,3,1,5,0,1,0,0,1,2,0,1,0,0
4565,523,2017,22,22,0,1.0,100,1096,9,11,2,6,8,2,16,3,3,0,0,5,3,2,0,0,0
4566,524,2017,32,32,0,1.0,99,1096,17,15,0,17,10,0,27,17,0,0,0,5,5,0,0,0,0
4567,525,2017,54,53,1,0.98,97,1096,19,31,3,11,28,1,40,7,0,4,0,25,3,0,0,1,0
4568,526,2017,25,25,0,1.0,100,1096,14,10,1,14,10,1,25,14,0,0,0,10,0,1,0,0,0
4569,527,2017,56,56,0,1.0,99,1096,30,24,2,11,21,1,33,1,2,7,1,18,3,0,1,0,0
4570,528,2017,17,9,8,0.52,51,1096,4,4,1,3,3,1,7,2,1,0,0,2,1,1,0,0,0
4571,529,2017,6,1,5,0.16,16,1096,0,1,0,0,1,0,1,0,0,0,0,1,0,0,0,0,0
4572,530,2017,38,20,18,0.54,53,1096,12,8,0,10,5,0,15,8,2,0,0,2,3,0,0,0,0
4573,531,2017,15,5,10,0.31,30,1096,2,2,1,1,2,1,4,0,1,0,0,2,0,1,0,0,0
4574,532,2017,18,17,1,0.95,95,1096,8,9,0,3,8,0,11,1,0,1,1,7,1,0,0,0,0
4575,533,2017,42,33,9,0.78,77,1096,16,15,2,4,11,2,17,0,0,0,4,7,4,2,0,0,0
4576,534,2017,42,35,7,0.82,82,1096,20,15,0,6,12,0,18,0,2,0,4,9,3,0,0,0,0
4577,535,2017,9,0,9,0.01,1,1096,0,0,0,0,0,0,0,0,0,0,0,0,0,0,0,0,0
4578,536,2017,31,15,16,0.49,49,1096,10,4,1,4,4,1,9,2,0,0,2,4,0,1,0,0,0
4579,537,2017,32,12,20,0.37,36,1096,5,4,3,4,3,1,8,3,1,0,0,2,1,0,0,1,0
4580,538,2017,12,12,0,0.97,96,1096,3,6,3,3,4,1,8,3,0,0,0,2,2,0,0,1,0
4581,539,2017,8,8,0,0.99,99,1096,5,2,1,2,1,1,4,1,0,0,1,0,1,1,0,0,0
4582,540,2017,24,5,19,0.21,21,1096,2,2,1,2,2,1,5,2,0,0,0,2,0,1,0,0,0
4583,541,2017,39,15,24,0.39,39,1096,10,4,1,10,4,1,15,10,0,0,0,4,0,1,0,0,0
4584,542,2017,51,51,0,1.0,100,1096,23,26,2,11,18,2,31,1,9,0,1,10,8,2,0,0,0
4585,543,2017,22,12,10,0.57,56,1096,3,7,2,1,5,2,8,0,0,1,0,3,2,2,0,0,0
4586,544,2017,13,1,12,0.06,6,1096,0,1,0,0,1,0,1,0,0,0,0,1,0,0,0,0,0
4587,545,2017,32,31,1,0.98,97,1096,16,13,2,4,11,2,17,0,0,0,4,9,2,2,0,0,0
4588,546,2017,54,37,17,0.69,69,1096,24,10,3,13,8,1,22,6,3,4,0,6,2,0,0,1,0
4589,547,2017,52,51,1,0.99,98,1096,29,19,3,9,11,3,23,1,1,2,5,3,8,3,0,0,0
4590,548,2017,40,40,0,0.99,99,1096,17,21,2,11,19,1,31,6,4,1,0,17,2,0,1,0,0
4591,549,2017,23,23,0,1.0,100,1096,11,11,1,11,6,1,18,11,0,0,0,1,5,1,0,0,0
4592,550,2017,22,22,0,1.0,100,1096,10,10,2,9,5,1,15,8,1,0,0,0,5,0,1,0,0
4593,551,2017,11,11,0,0.98,97,1096,6,3,2,4,2,1,7,2,2,0,0,1,1,0,1,0,0
4594,552,2017,39,8,31,0.21,20,1096,5,2,1,3,1,1,5,1,2,0,0,0,1,1,0,0,0
4595,553,2017,46,6,40,0.13,13,1096,4,2,0,2,2,0,4,0,2,0,0,2,0,0,0,0,0
4596,554,2017,40,38,2,0.95,94,1096,24,12,2,20,11,2,33,18,1,0,1,10,1,2,0,0,0
4597,555,2017,16,16,0,0.99,98,1096,7,8,1,6,6,1,13,5,1,0,0,4,2,1,0,0,0
4598,556,2017,10,10,0,1.0,100,1096,7,2,1,6,1,1,8,5,1,0,0,0,1,1,0,0,0
4599,557,2017,56,54,2,0.96,96,1096,22,30,2,10,30,1,41,4,2,2,2,30,0,0,1,0,0
4600,558,2017,38,38,0,1.0,100,1096,18,19,1,6,17,1,24,1,1,1,3,15,2,1,0,0,0
4601,559,2017,45,45,0,1.0,100,1096,29,13,3,17,13,1,31,8,6,3,0,13,0,0,0,1,0
4602,560,2017,37,37,0,1.0,99,1096,13,20,4,7,16,4,27,3,3,0,1,12,4,4,0,0,0
4603,561,2017,16,16,0,1.0,100,1096,9,4,3,3,3,1,7,0,0,3,0,2,1,0,0,1,0
4604,562,2017,27,21,6,0.79,78,1096,11,7,3,6,5,2,13,3,1,2,0,3,2,1,1,0,0
4605,563,2017,36,22,14,0.6,60,1096,12,7,3,5,4,3,12,0,4,0,1,1,3,3,0,0,0
4606,564,2017,60,56,4,0.94,93,1096,34,21,1,17,15,1,33,7,5,3,2,9,6,1,0,0,0
4607,565,2017,9,3,6,0.37,37,1096,2,1,0,1,1,0,2,0,1,0,0,1,0,0,0,0,0
4608,566,2017,16,11,5,0.67,66,1096,3,7,1,2,7,1,10,1,1,0,0,7,0,1,0,0,0
4609,567,2017,32,2,30,0.06,6,1096,1,1,0,1,1,0,2,1,0,0,0,1,0,0,0,0,0
4610,568,2017,12,12,0,1.0,99,1096,6,5,1,5,3,1,9,4,1,0,0,1,2,1,0,0,0
4611,569,2017,41,41,0,1.0,100,1096,18,22,1,11,13,1,25,7,1,3,0,4,9,1,0,0,0
4612,570,2017,47,47,0,1.0,100,1096,22,21,4,12,12,1,25,2,10,0,0,3,9,0,0,0,1
4613,571,2017,6,0,6,0.05,4,1096,0,0,0,0,0,0,0,0,0,0,0,0,0,0,0,0,0
4614,572,2017,11,11,0,0.98,98,1096,6,3,2,3,2,2,7,0,3,0,0,1,1,2,0,0,0
4615,573,2017,35,35,0,0.99,98,1096,24,10,1,11,10,1,22,4,2,4,1,10,0,1,0,0,0
4616,574,2017,27,27,0,1.0,99,1096,17,10,0,16,10,0,26,15,1,0,0,10,0,0,0,0,0
4617,575,2017,26,26,0,1.0,99,1096,7,15,4,3,15,3,21,0,2,1,0,15,0,2,1,0,0
4618,576,2017,42,42,0,1.0,100,1096,28,12,2,27,10,2,39,26,1,0,0,8,2,2,0,0,0
4619,577,2017,12,2,10,0.16,16,1096,1,1,0,1,1,0,2,1,0,0,0,1,0,0,0,0,0
4620,578,2017,13,1,12,0.04,4,1096,0,1,0,0,1,0,1,0,0,0,0,1,0,0,0,0,0
4621,579,2017,34,33,1,0.98,98,1096,17,13,3,14,7,3,24,11,3,0,0,1,6,3,0,0,0
4622,580,2017,19,18,1,0.94,94,1096,9,8,1,5,6,1,12,3,0,2,0,4,2,1,0,0,0
4623,581,2017,9,9,0,1.0,100,1096,5,4,0,2,4,0,6,1,0,0,1,4,0,0,0,0,0
4624,582,2017,33,33,0,1.0,99,1096,17,13,3,9,8,2,19,6,0,1,2,3,5,1,1,0,0
4625,583,2017,10,7,3,0.71,71,1096,4,3,0,1,3,0,4,0,0,0,1,3,0,0,0,0,0
4626,584,2017,38,36,2,0.95,95,1096,21,14,1,21,13,1,35,21,0,0,0,12,1,1,0,0,0
4627,585,2017,14,5,9,0.36,35,1096,2,2,1,2,2,1,5,2,0,0,0,2,0,1,0,0,0
4628,586,2017,34,13,21,0.37,37,1096,6,6,1,4,3,1,8,2,2,0,0,0,3,1,0,0,0
4629,587,2017,17,17,0,1.0,100,1096,11,5,1,6,3,1,10,3,2,0,1,1,2,1,0,0,0
4630,588,2017,27,27,0,1.0,100,1096,10,14,3,3,12,3,18,0,1,0,2,10,2,3,0,0,0
4631,589,2017,43,43,0,1.0,100,1096,28,12,3,24,12,3,39,22,1,0,1,12,0,3,0,0,0
4632,590,2017,24,20,4,0.85,85,1096,7,10,3,6,10,3,19,5,1,0,0,10,0,3,0,0,0
4633,591,2017,15,15,0,1.0,100,1096,5,8,2,2,8,1,11,0,1,1,0,8,0,0,1,0,0
4634,592,2017,5,5,0,1.0,99,1096,3,2,0,2,2,0,4,1,1,0,0,2,0,0,0,0,0
4635,593,2017,8,8,0,1.0,100,1096,4,3,1,4,2,1,7,4,0,0,0,1,1,1,0,0,0
4636,594,2017,55,55,0,1.0,99,1096,33,20,2,14,12,2,28,1,7,6,0,4,8,2,0,0,0
4637,595,2017,20,10,10,0.5,50,1096,5,3,2,3,3,1,7,1,2,0,0,3,0,0,1,0,0
4638,596,2017,12,12,0,1.0,99,1096,7,5,0,2,4,0,6,0,0,1,1,3,1,0,0,0,0
4639,597,2017,29,2,27,0.08,7,1096,1,1,0,1,1,0,2,1,0,0,0,1,0,0,0,0,0
4640,598,2017,12,11,1,0.94,93,1096,4,4,3,2,4,2,8,0,2,0,0,4,0,1,1,0,0
4641,599,2017,17,13,4,0.76,75,1096,8,5,0,5,4,0,9,3,1,1,0,3,1,0,0,0,0
4642,600,2017,16,15,1,0.95,95,1096,9,5,1,9,4,1,14,9,0,0,0,3,1,1,0,0,0
4643,601,2017,28,25,3,0.9,90,1096,11,11,3,10,11,3,24,9,1,0,0,11,0,3,0,0,0
4644,602,2017,8,8,0,0.97,97,1096,5,2,1,3,2,1,6,2,0,1,0,2,0,1,0,0,0
4645,603,2017,59,59,0,1.0,99,1096,41,16,2,33,8,2,43,29,0,4,0,0,8,2,0,0,0
4646,604,2017,44,42,2,0.96,95,1096,23,16,3,21,12,1,34,19,2,0,0,8,4,0,0,1,0
4647,605,2017,48,12,36,0.26,25,1096,6,4,2,4,3,2,9,2,2,0,0,2,1,2,0,0,0
4648,606,2017,35,34,1,0.97,96,1096,13,20,1,12,16,1,29,11,1,0,0,12,4,1,0,0,0
4649,607,2017,40,26,14,0.65,64,1096,11,15,0,3,12,0,15,0,0,1,2,9,3,0,0,0,0
4650,608,2017,6,5,1,0.77,76,1096,4,1,0,2,1,0,3,1,0,1,0,1,0,0,0,0,0
4651,609,2017,15,15,0,0.99,99,1096,4,8,3,1,7,3,11,0,0,0,1,6,1,3,0,0,0
4652,610,2017,9,1,8,0.13,12,1096,0,1,0,0,1,0,1,0,0,0,0,1,0,0,0,0,0
4653,611,2017,48,17,31,0.36,35,1096,9,7,1,8,5,1,14,7,1,0,0,3,2,1,0,0,0
4654,612,2017,12,12,0,0.99,98,1096,5,4,3,4,3,3,10,3,1,0,0,2,1,3,0,0,0
4655,613,2017,12,12,0,0.98,97,1096,5,5,2,4,4,1,9,3,1,0,0,3,1,0,1,0,0
4656,614,2017,6,6,0,1.0,100,1096,3,2,1,3,2,1,6,3,0,0,0,2,0,1,0,0,0
4657,615,2017,27,27,0,1.0,100,1096,12,13,2,7,8,1,16,4,2,0,1,3,5,0,1,0,0
4658,616,2017,30,7,23,0.22,22,1096,5,2,0,3,2,0,5,2,0,1,0,2,0,0,0,0,0
4659,617,2017,14,14,0,1.0,99,1096,4,8,2,2,8,1,11,0,2,0,0,8,0,0,1,0,0
4660,618,2017,6,6,0,1.0,99,1096,3,2,1,3,1,1,5,3,0,0,0,0,1,1,0,0,0
4661,619,2017,17,2,15,0.1,10,1096,1,1,0,1,1,0,2,1,0,0,0,1,0,0,0,0,0
4662,620,2017,18,17,1,0.97,96,1096,5,10,2,5,9,2,16,5,0,0,0,8,1,2,0,0,0
4663,621,2017,9,9,0,1.0,100,1096,4,3,2,3,2,2,7,2,1,0,0,1,1,2,0,0,0
4664,622,2017,32,2,30,0.06,5,1096,1,1,0,1,1,0,2,1,0,0,0,1,0,0,0,0,0
4665,623,2017,52,36,16,0.69,68,1096,25,7,4,13,4,4,21,3,9,0,1,1,3,4,0,0,0
4666,624,2017,20,19,1,0.96,95,1096,6,11,2,6,9,2,17,6,0,0,0,7,2,2,0,0,0
4667,625,2017,33,33,0,1.0,99,1096,12,20,1,7,17,1,25,2,5,0,0,14,3,1,0,0,0
4668,626,2017,13,13,0,1.0,100,1096,7,5,1,7,4,1,12,7,0,0,0,3,1,1,0,0,0
4669,627,2017,17,17,0,1.0,100,1096,7,9,1,4,7,1,12,1,3,0,0,5,2,1,0,0,0
4670,628,2017,13,13,0,1.0,100,1096,6,5,2,2,3,2,7,0,1,0,1,1,2,2,0,0,0
4671,629,2017,33,33,0,1.0,100,1096,15,16,2,10,11,2,23,7,2,0,1,6,5,2,0,0,0
4672,630,2017,15,10,5,0.64,63,1096,4,4,2,4,4,2,10,4,0,0,0,4,0,2,0,0,0
4673,631,2017,58,47,11,0.82,81,1096,34,11,2,15,10,1,26,0,11,4,0,9,1,0,1,0,0
4674,632,2017,9,9,0,1.0,99,1096,3,5,1,3,4,1,8,3,0,0,0,3,1,1,0,0,0
4675,633,2017,9,8,1,0.9,90,1096,2,4,2,2,4,2,8,2,0,0,0,4,0,2,0,0,0
4676,634,2017,6,6,0,0.96,95,1096,2,3,1,2,2,1,5,2,0,0,0,1,1,1,0,0,0
4677,635,2017,24,21,3,0.86,85,1096,9,9,3,3,7,1,11,0,1,1,1,5,2,0,0,1,0
4678,636,2017,15,4,11,0.25,24,1096,1,2,1,1,1,1,3,1,0,0,0,0,1,1,0,0,0
4679,637,2017,23,23,0,1.0,100,1096,16,7,0,9,4,0,13,6,1,0,2,1,3,0,0,0,0
4680,638,2017,29,29,0,0.99,98,1096,12,17,0,4,12,0,16,0,2,0,2,7,5,0,0,0,0
4681,639,2017,7,4,3,0.5,50,1096,2,2,0,1,2,0,3,0,1,0,0,2,0,0,0,0,0
4682,640,2017,13,11,2,0.81,81,1096,8,2,1,6,1,1,8,4,2,0,0,0,1,1,0,0,0
4683,641,2017,6,5,1,0.88,87,1096,2,2,1,1,2,1,4,0,1,0,0,2,0,1,0,0,0
4684,642,2017,28,28,0,1.0,100,1096,21,6,1,13,5,1,19,7,4,2,0,4,1,1,0,0,0
4685,643,2017,56,52,4,0.92,92,1096,26,25,1,21,21,1,43,16,5,0,0,17,4,1,0,0,0
4686,644,2017,11,11,0,1.0,100,1096,5,6,0,2,4,0,6,0,1,1,0,2,2,0,0,0,0
4687,645,2017,23,23,0,0.98,98,1096,17,4,2,17,4,1,22,17,0,0,0,4,0,0,1,0,0
4688,646,2017,58,4,54,0.07,7,1096,3,1,0,3,1,0,4,3,0,0,0,1,0,0,0,0,0
4689,647,2017,32,12,20,0.37,37,1096,5,4,3,5,3,1,9,5,0,0,0,2,1,0,0,1,0
4690,648,2017,34,28,6,0.83,82,1096,10,16,2,5,13,1,19,0,5,0,0,10,3,0,1,0,0
4691,649,2017,27,27,0,1.0,100,1096,15,9,3,9,8,3,20,7,0,0,2,7,1,3,0,0,0
4692,650,2017,37,37,0,1.0,100,1096,15,22,0,8,16,0,24,2,5,1,0,10,6,0,0,0,0
4693,651,2017,26,15,11,0.58,57,1096,9,6,0,9,5,0,14,9,0,0,0,4,1,0,0,0,0
4694,652,2017,40,40,0,1.0,99,1096,25,12,3,16,8,1,25,12,0,3,1,4,4,0,0,1,0
4695,653,2017,14,14,0,1.0,99,1096,4,8,2,1,7,2,10,0,0,0,1,6,1,2,0,0,0
4696,654,2017,40,24,16,0.6,60,1096,17,7,0,12,7,0,19,9,2,0,1,7,0,0,0,0,0
4697,655,2017,50,50,0,1.0,100,1096,35,15,0,21,13,0,34,11,6,4,0,11,2,0,0,0,0
4698,656,2017,47,47,0,1.0,100,1096,18,28,1,5,16,1,22,0,0,2,3,4,12,1,0,0,0
4699,657,2017,32,32,0,1.0,99,1096,20,11,1,9,8,1,18,4,2,0,3,5,3,1,0,0,0
4700,658,2017,12,4,8,0.33,32,1096,1,2,1,1,1,1,3,1,0,0,0,0,1,1,0,0,0
4701,659,2017,38,38,0,0.99,98,1096,15,20,3,7,14,3,24,3,1,2,1,8,6,3,0,0,0
4702,660,2017,21,16,5,0.78,77,1096,7,9,0,6,6,0,12,5,1,0,0,3,3,0,0,0,0
4703,661,2017,37,33,4,0.89,88,1096,14,17,2,8,14,1,23,6,0,0,2,11,3,0,1,0,0
4704,662,2017,29,29,0,1.0,99,1096,13,15,1,10,10,1,21,8,1,1,0,5,5,1,0,0,0
4705,663,2017,39,14,25,0.35,35,1096,4,8,2,2,6,1,9,0,2,0,0,4,2,0,1,0,0
4706,664,2017,45,2,43,0.04,4,1096,1,1,0,1,1,0,2,1,0,0,0,1,0,0,0,0,0
4707,665,2017,28,27,1,0.97,96,1096,12,14,1,7,7,1,15,3,3,1,0,0,7,1,0,0,0
4708,666,2017,24,8,16,0.32,31,1096,4,4,0,3,3,0,6,2,1,0,0,2,1,0,0,0,0
4709,667,2017,30,13,17,0.44,44,1096,4,5,4,3,4,2,9,2,1,0,0,3,1,1,0,1,0
4710,668,2017,38,37,1,0.98,97,1096,19,18,0,9,14,0,23,4,1,3,1,10,4,0,0,0,0
4711,669,2017,42,19,23,0.44,44,1096,7,10,2,4,7,2,13,2,1,1,0,4,3,2,0,0,0
4712,670,2017,14,14,0,0.99,99,1096,3,8,3,3,8,1,12,3,0,0,0,8,0,0,0,1,0
4713,671,2017,47,47,0,1.0,100,1096,18,27,2,17,21,2,40,16,1,0,0,15,6,2,0,0,0
4714,672,2017,41,29,12,0.7,69,1096,12,16,1,11,16,1,28,10,1,0,0,16,0,1,0,0,0
4715,673,2017,14,9,5,0.64,64,1096,5,4,0,4,4,0,8,3,1,0,0,4,0,0,0,0,0
4716,674,2017,24,24,0,0.98,97,1096,17,4,3,6,3,1,10,0,3,1,2,2,1,0,0,1,0
4717,675,2017,9,9,0,1.0,100,1096,3,5,1,3,3,1,7,3,0,0,0,1,2,1,0,0,0
4718,676,2017,19,18,1,0.97,97,1096,9,9,0,3,7,0,10,0,0,3,0,5,2,0,0,0,0
4719,677,2017,11,11,0,0.98,97,1096,3,6,2,3,5,2,10,3,0,0,0,4,1,2,0,0,0
4720,678,2017,26,26,0,1.0,100,1096,19,4,3,15,4,2,21,13,1,0,1,4,0,1,1,0,0
4721,679,2017,22,22,0,1.0,100,1096,13,9,0,12,8,0,20,11,1,0,0,7,1,0,0,0,0
4722,680,2017,25,1,24,0.04,4,1096,0,1,0,0,1,0,1,0,0,0,0,1,0,0,0,0,0
4723,681,2017,40,40,0,1.0,100,1096,25,13,2,16,7,2,25,12,0,3,1,1,6,2,0,0,0
4724,682,2017,38,38,0,1.0,100,1096,13,21,4,5,13,2,20,1,1,2,1,5,8,1,0,1,0
4725,683,2017,5,5,0,0.99,98,1096,2,3,0,1,3,0,4,0,1,0,0,3,0,0,0,0,0
4726,684,2017,27,26,1,0.96,95,1096,11,14,1,10,11,1,22,9,1,0,0,8,3,1,0,0,0
4727,685,2017,14,13,1,0.91,90,1096,6,4,3,4,3,3,10,3,0,1,0,2,1,3,0,0,0
4728,686,2017,26,14,12,0.55,54,1096,7,6,1,4,5,1,10,3,0,0,1,4,1,1,0,0,0
4729,687,2017,20,20,0,0.98,97,1096,8,8,4,6,6,3,15,5,0,1,0,4,2,2,1,0,0
4730,688,2017,13,4,9,0.32,31,1096,1,2,1,1,2,1,4,1,0,0,0,2,0,1,0,0,0
4731,689,2017,46,46,0,1.0,99,1096,28,15,3,18,15,3,36,8,10,0,0,15,0,3,0,0,0
4732,690,2017,46,45,1,0.99,98,1096,32,10,3,21,6,3,30,14,3,4,0,2,4,3,0,0,0
4733,691,2017,31,3,28,0.11,11,1096,2,1,0,1,1,0,2,0,1,0,0,1,0,0,0,0,0
4734,692,2017,28,25,3,0.91,90,1096,11,14,0,7,9,0,16,4,2,1,0,4,5,0,0,0,0
4735,693,2017,15,15,0,1.0,100,1096,8,7,0,6,7,0,13,4,2,0,0,7,0,0,0,0,0
4736,694,2017,55,53,2,0.97,97,1096,30,19,4,29,14,2,45,28,1,0,0,9,5,0,2,0,0
4737,695,2017,36,19,17,0.52,52,1096,9,7,3,7,6,1,14,5,2,0,0,5,1,0,0,1,0
4738,696,2017,27,4,23,0.13,13,1096,2,2,0,2,1,0,3,2,0,0,0,0,1,0,0,0,0
4739,697,2017,31,29,2,0.95,95,1096,21,8,0,10,7,0,17,5,0,4,1,6,1,0,0,0,0
4740,698,2017,44,44,0,1.0,99,1096,21,23,0,8,23,0,31,1,4,0,3,23,0,0,0,0,0
4741,699,2017,34,34,0,1.0,99,1096,15,17,2,15,9,2,26,15,0,0,0,1,8,2,0,0,0
4742,700,2017,40,35,5,0.88,87,1096,13,20,2,6,11,2,19,1,4,0,1,2,9,2,0,0,0
4743,701,2017,31,31,0,1.0,100,1096,22,5,4,9,5,2,16,0,6,2,1,5,0,0,2,0,0
4744,702,2017,44,42,2,0.95,94,1096,18,23,1,7,12,1,20,0,4,2,1,1,11,1,0,0,0
4745,703,2017,34,34,0,1.0,100,1096,12,20,2,5,14,2,21,1,2,1,1,8,6,2,0,0,0
4746,704,2017,32,11,21,0.33,33,1096,6,3,2,6,2,2,10,6,0,0,0,1,1,2,0,0,0
4747,705,2017,6,5,1,0.89,88,1096,3,2,0,3,2,0,5,3,0,0,0,2,0,0,0,0,0
4748,706,2017,17,3,14,0.18,18,1096,2,1,0,1,1,0,2,0,1,0,0,1,0,0,0,0,0
4749,707,2017,29,29,0,0.99,98,1096,16,9,4,6,8,4,18,2,0,2,2,7,1,4,0,0,0
4750,708,2017,39,39,0,1.0,99,1096,27,8,4,15,8,4,27,9,0,6,0,8,0,4,0,0,0
4751,709,2017,42,37,5,0.87,86,1096,21,14,2,14,14,1,29,9,3,2,0,14,0,0,1,0,0
4752,710,2017,20,7,13,0.33,33,1096,3,4,0,2,2,0,4,1,1,0,0,0,2,0,0,0,0
4753,711,2017,5,5,0,1.0,100,1096,2,3,0,1,3,0,4,0,1,0,0,3,0,0,0,0,0
4754,712,2017,48,45,3,0.95,94,1096,22,22,1,22,13,1,36,22,0,0,0,4,9,1,0,0,0
4755,713,2017,24,20,4,0.84,84,1096,12,7,1,9,4,1,14,6,3,0,0,1,3,1,0,0,0
4756,714,2017,30,30,0,0.99,98,1096,19,9,2,9,5,2,16,4,1,3,1,1,4,2,0,0,0
4757,715,2017,47,16,31,0.34,33,1096,10,5,1,7,5,1,13,5,1,1,0,5,0,1,0,0,0
4758,716,2017,34,34,0,1.0,99,1096,22,9,3,13,8,1,22,6,6,0,1,7,1,0,0,1,0
4759,717,2017,32,31,1,0.98,97,1096,19,10,2,11,7,1,19,5,4,2,0,4,3,0,1,0,0
4760,718,2017,35,35,0,1.0,99,1096,26,6,3,19,4,2,25,14,4,0,1,2,2,1,1,0,0
4761,719,2017,39,39,0,0.99,98,1096,21,15,3,15,12,3,30,10,4,1,0,9,3,3,0,0,0
4762,720,2017,7,2,5,0.27,26,1096,1,1,0,1,1,0,2,1,0,0,0,1,0,0,0,0,0
4763,721,2017,38,38,0,0.99,98,1096,27,9,2,12,9,2,23,2,6,3,1,9,0,2,0,0,0
4764,722,2017,24,21,3,0.89,88,1096,12,8,1,5,5,1,11,2,0,2,1,2,3,1,0,0,0
4765,723,2017,8,8,0,0.98,97,1096,3,4,1,1,4,1,6,0,0,1,0,4,0,1,0,0,0
4766,724,2017,24,19,5,0.8,79,1096,13,4,2,10,3,2,15,7,3,0,0,2,1,2,0,0,0
4767,725,2017,26,14,12,0.56,55,1096,4,8,2,4,4,2,10,4,0,0,0,0,4,2,0,0,0
4768,726,2017,28,28,0,1.0,100,1096,16,9,3,5,8,2,15,1,0,1,3,7,1,1,1,0,0
4769,727,2017,24,23,1,0.95,94,1096,13,9,1,13,7,1,21,13,0,0,0,5,2,1,0,0,0
4770,728,2017,28,28,0,0.98,98,1096,20,6,2,11,5,2,18,5,3,3,0,4,1,2,0,0,0
4771,729,2017,24,22,2,0.91,91,1096,15,7,0,8,7,0,15,4,2,1,1,7,0,0,0,0,0
4772,730,2017,30,3,27,0.1,10,1096,1,2,0,1,1,0,2,1,0,0,0,0,1,0,0,0,0
4773,731,2017,51,51,0,1.0,100,1096,22,26,3,16,19,1,36,13,1,1,1,12,7,0,0,1,0
4774,732,2017,9,8,1,0.93,92,1096,5,3,0,3,2,0,5,1,2,0,0,1,1,0,0,0,0
4775,733,2017,10,10,0,1.0,100,1096,5,4,1,4,4,1,9,3,1,0,0,4,0,1,0,0,0
4776,734,2017,34,31,3,0.92,91,1096,15,14,2,6,12,2,20,1,1,4,0,10,2,2,0,0,0
4777,735,2017,18,17,1,0.96,96,1096,5,10,2,4,7,1,12,3,1,0,0,4,3,0,1,0,0
4778,736,2017,31,25,6,0.81,81,1096,18,6,1,6,4,1,11,0,3,0,3,2,2,1,0,0,0
4779,737,2017,49,47,2,0.97,96,1096,29,16,2,25,8,2,35,23,1,0,1,0,8,2,0,0,0
4780,738,2017,31,31,0,1.0,99,1096,15,15,1,4,9,1,14,0,0,1,3,3,6,1,0,0,0
4781,739,2017,36,35,1,0.97,96,1096,15,17,3,13,14,3,30,11,2,0,0,11,3,3,0,0,0
4782,740,2017,46,46,0,1.0,100,1096,22,24,0,18,13,0,31,16,1,0,1,2,11,0,0,0,0
4783,741,2017,15,7,8,0.49,48,1096,3,3,1,3,2,1,6,3,0,0,0,1,1,1,0,0,0
4784,742,2017,46,46,0,0.99,99,1096,24,22,0,13,21,0,34,9,0,1,3,20,1,0,0,0,0
4785,743,2017,47,9,38,0.2,19,1096,6,3,0,6,2,0,8,6,0,0,0,1,1,0,0,0,0
4786,744,2017,16,13,3,0.82,82,1096,4,7,2,2,4,1,7,1,0,1,0,1,3,0,1,0,0
4787,745,2017,36,16,20,0.46,45,1096,7,6,3,3,4,1,8,0,2,1,0,2,2,0,0,1,0
4788,746,2017,31,27,4,0.88,87,1096,17,10,0,11,10,0,21,8,0,3,0,10,0,0,0,0,0
4789,747,2017,8,8,0,1.0,100,1096,3,3,2,2,2,1,5,1,1,0,0,1,1,0,1,0,0
4790,748,2017,32,32,0,1.0,100,1096,13,16,3,5,13,2,20,0,2,3,0,10,3,1,1,0,0
4791,749,2017,7,7,0,1.0,100,1096,2,4,1,1,4,1,6,0,1,0,0,4,0,1,0,0,0
4792,750,2017,36,36,0,0.99,99,1096,23,9,4,20,7,2,29,19,0,0,1,5,2,1,0,1,0
4793,751,2017,31,3,28,0.1,10,1096,2,1,0,2,1,0,3,2,0,0,0,1,0,0,0,0,0
4794,752,2017,20,17,3,0.85,84,1096,11,4,2,4,3,1,8,0,1,3,0,2,1,0,1,0,0
4795,753,2017,21,18,3,0.87,86,1096,13,4,1,7,4,1,12,3,3,0,1,4,0,1,0,0,0
4796,754,2017,6,2,4,0.34,34,1096,1,1,0,1,1,0,2,1,0,0,0,1,0,0,0,0,0
4797,755,2017,30,10,20,0.34,34,1096,5,4,1,4,4,1,9,3,1,0,0,4,0,1,0,0,0
4798,756,2017,25,24,1,0.95,95,1096,15,5,4,13,5,2,20,11,2,0,0,5,0,1,0,1,0
4799,757,2017,38,38,0,1.0,99,1096,17,18,3,6,15,3,24,0,3,1,2,12,3,3,0,0,0
4800,758,2017,43,22,21,0.51,50,1096,13,6,3,12,6,1,19,11,1,0,0,6,0,0,0,1,0
4801,759,2017,27,27,0,0.98,98,1096,13,13,1,10,13,1,24,7,3,0,0,13,0,1,0,0,0
4802,760,2017,16,8,8,0.5,49,1096,5,2,1,4,1,1,6,3,1,0,0,0,1,1,0,0,0
4803,761,2017,15,15,0,1.0,99,1096,5,9,1,2,9,1,12,0,1,1,0,9,0,1,0,0,0
4804,762,2017,43,23,20,0.52,52,1096,12,11,0,11,7,0,18,10,1,0,0,3,4,0,0,0,0
4805,763,2017,52,51,1,0.99,99,1096,36,14,1,29,11,1,41,23,5,1,0,8,3,1,0,0,0
4806,764,2017,28,4,24,0.14,13,1096,1,2,1,1,2,1,4,1,0,0,0,2,0,1,0,0,0
4807,765,2017,36,23,13,0.65,64,1096,8,12,3,3,12,2,17,0,2,0,1,12,0,1,1,0,0
4808,766,2017,15,13,2,0.88,87,1096,7,5,1,2,3,1,6,0,0,1,1,1,2,1,0,0,0
4809,767,2017,34,19,15,0.56,55,1096,14,4,1,8,2,1,11,5,0,3,0,0,2,1,0,0,0
4810,768,2017,7,7,0,0.97,97,1096,4,2,1,2,2,1,5,0,2,0,0,2,0,1,0,0,0
4811,769,2017,20,20,0,1.0,100,1096,11,6,3,5,3,1,9,2,0,3,0,0,3,0,0,1,0
4812,770,2017,40,2,38,0.04,4,1096,1,1,0,1,1,0,2,1,0,0,0,1,0,0,0,0,0
4813,771,2017,40,17,23,0.42,42,1096,7,7,3,3,4,3,10,1,0,2,0,1,3,3,0,0,0
4814,772,2017,18,1,17,0.04,4,1096,0,1,0,0,1,0,1,0,0,0,0,1,0,0,0,0,0
4815,773,2017,39,10,29,0.26,25,1096,5,4,1,5,4,1,10,5,0,0,0,4,0,1,0,0,0
4816,774,2017,10,9,1,0.92,91,1096,4,3,2,3,3,1,7,2,1,0,0,3,0,0,1,0,0
4817,775,2017,6,0,6,0.06,6,1096,0,0,0,0,0,0,0,0,0,0,0,0,0,0,0,0,0
4818,776,2017,18,14,4,0.78,78,1096,9,4,1,4,4,1,9,2,0,1,1,4,0,1,0,0,0
4819,777,2017,13,13,0,1.0,100,1096,7,4,2,5,2,2,9,4,0,1,0,0,2,2,0,0,0
4820,778,2017,50,25,25,0.49,49,1096,19,5,1,10,3,1,14,7,0,0,3,1,2,1,0,0,0
4821,779,2017,55,54,1,0.99,98,1096,38,13,3,35,12,3,50,32,3,0,0,11,1,3,0,0,0
4822,780,2017,34,34,0,0.99,99,1096,18,13,3,14,13,3,30,12,1,0,1,13,0,3,0,0,0
4823,781,2017,25,25,0,0.99,98,1096,16,8,1,5,8,1,14,0,1,2,2,8,0,1,0,0,0
4824,782,2017,49,49,0,1.0,100,1096,31,18,0,12,9,0,21,3,1,6,2,0,9,0,0,0,0
4825,783,2017,17,17,0,1.0,99,1096,11,4,2,11,4,2,17,11,0,0,0,4,0,2,0,0,0
4826,784,2017,47,46,1,0.98,97,1096,26,20,0,8,12,0,20,2,0,0,6,4,8,0,0,0,0
4827,785,2017,6,0,6,0.01,1,1096,0,0,0,0,0,0,0,0,0,0,0,0,0,0,0,0,0
4828,786,2017,39,39,0,1.0,100,1096,16,19,4,10,15,2,27,5,4,1,0,11,4,1,0,1,0
4829,787,2017,37,37,0,1.0,99,1096,20,14,3,6,11,3,20,1,0,1,4,8,3,3,0,0,0
4830,788,2017,30,29,1,0.96,95,1096,17,10,2,5,8,2,15,0,1,1,3,6,2,2,0,0,0
4831,789,2017,23,13,10,0.55,54,1096,6,7,0,6,5,0,11,6,0,0,0,3,2,0,0,0,0
4832,790,2017,35,19,16,0.55,54,1096,14,4,1,9,4,1,14,7,0,1,1,4,0,1,0,0,0
4833,791,2017,18,18,0,0.99,98,1096,6,10,2,3,6,1,10,0,3,0,0,2,4,0,1,0,0
4834,792,2017,40,40,0,1.0,100,1096,18,18,4,15,9,2,26,14,0,0,1,0,9,1,0,1,0
4835,793,2017,16,16,0,0.99,98,1096,8,7,1,5,7,1,13,3,1,1,0,7,0,1,0,0,0
4836,794,2017,8,8,0,0.99,98,1096,2,4,2,1,2,1,4,0,1,0,0,0,2,0,1,0,0
4837,795,2017,33,24,9,0.72,71,1096,8,12,4,4,8,1,13,0,4,0,0,4,4,0,0,0,1
4838,796,2017,14,14,0,1.0,99,1096,5,7,2,5,5,2,12,5,0,0,0,3,2,2,0,0,0
4839,797,2017,55,8,47,0.15,15,1096,3,3,2,2,3,1,6,1,1,0,0,3,0,0,1,0,0
4840,798,2017,24,24,0,1.0,99,1096,13,9,2,6,8,2,16,3,0,2,1,7,1,2,0,0,0
4841,799,2017,36,32,4,0.89,89,1096,21,11,0,11,6,0,17,3,6,2,0,1,5,0,0,0,0
4842,800,2017,30,29,1,0.98,97,1096,10,17,2,10,16,1,27,10,0,0,0,15,1,0,1,0,0
4843,801,2017,38,12,26,0.32,32,1096,8,3,1,4,2,1,7,0,4,0,0,1,1,1,0,0,0
4844,802,2017,38,38,0,1.0,100,1096,23,13,2,22,8,1,31,21,1,0,0,3,5,0,1,0,0
4845,803,2017,36,36,0,1.0,100,1096,19,15,2,9,11,2,22,5,1,0,3,7,4,2,0,0,0
4846,804,2017,35,35,0,1.0,100,1096,14,19,2,14,19,2,35,14,0,0,0,19,0,2,0,0,0
4847,805,2017,59,59,0,1.0,100,1096,33,24,2,26,17,1,44,22,1,3,0,10,7,0,1,0,0
4848,806,2017,12,0,12,0.03,3,1096,0,0,0,0,0,0,0,0,0,0,0,0,0,0,0,0,0
4849,807,2017,28,27,1,0.96,95,1096,11,12,4,6,7,4,17,3,2,0,1,2,5,4,0,0,0
4850,808,2017,22,0,22,0.01,1,1096,0,0,0,0,0,0,0,0,0,0,0,0,0,0,0,0,0
4851,809,2017,34,30,4,0.88,88,1096,18,10,2,13,5,2,20,8,5,0,0,0,5,2,0,0,0
4852,810,2017,38,38,0,1.0,100,1096,20,18,0,18,12,0,30,17,0,1,0,6,6,0,0,0,0
4853,811,2017,14,3,11,0.25,24,1096,1,2,0,1,2,0,3,1,0,0,0,2,0,0,0,0,0
4854,812,2017,40,2,38,0.04,4,1096,1,1,0,1,1,0,2,1,0,0,0,1,0,0,0,0,0
4855,813,2017,52,52,0,1.0,99,1096,28,23,1,12,15,1,28,4,1,6,1,7,8,1,0,0,0
4856,814,2017,59,14,45,0.24,23,1096,7,4,3,6,3,3,12,5,1,0,0,2,1,3,0,0,0
4857,815,2017,30,30,0,1.0,100,1096,15,13,2,14,9,1,24,13,1,0,0,5,4,0,1,0,0
4858,816,2017,37,37,0,0.99,99,1096,14,20,3,10,15,1,26,7,2,1,0,10,5,0,0,1,0
4859,817,2017,24,4,20,0.18,18,1096,2,2,0,1,2,0,3,0,1,0,0,2,0,0,0,0,0
4860,818,2017,22,22,0,0.99,98,1096,5,13,4,2,8,1,11,1,0,0,1,3,5,0,0,0,1
4861,819,2017,22,17,5,0.79,78,1096,5,9,3,2,9,1,12,0,1,1,0,9,0,0,0,1,0
4862,820,2017,41,41,0,1.0,100,1096,25,13,3,11,13,2,26,4,2,3,2,13,0,1,1,0,0
4863,821,2017,17,17,0,1.0,100,1096,7,7,3,5,6,2,13,4,0,1,0,5,1,1,1,0,0
4864,822,2017,44,42,2,0.94,94,1096,24,17,1,19,12,1,32,15,3,1,0,7,5,1,0,0,0
4865,823,2017,6,6,0,0.99,98,1096,3,2,1,1,2,1,4,0,0,1,0,2,0,1,0,0,0
4866,824,2017,23,16,7,0.69,68,1096,8,7,1,5,7,1,13,3,1,1,0,7,0,1,0,0,0
4867,825,2017,47,46,1,0.98,97,1096,20,23,3,20,20,3,43,20,0,0,0,17,3,3,0,0,0
4868,826,2017,13,13,0,0.97,96,1096,7,5,1,5,4,1,10,3,2,0,0,3,1,1,0,0,0
4869,827,2017,16,2,14,0.14,13,1096,1,1,0,1,1,0,2,1,0,0,0,1,0,0,0,0,0
4870,828,2017,28,27,1,0.97,96,1096,15,11,1,8,8,1,17,4,2,1,1,5,3,1,0,0,0
4871,829,2017,58,58,0,1.0,100,1096,32,22,4,26,14,1,41,21,4,1,0,6,8,0,0,0,1
4872,830,2017,19,19,0,0.98,97,1096,7,8,4,7,7,1,15,7,0,0,0,6,1,0,0,0,1
4873,831,2017,35,12,23,0.36,35,1096,7,3,2,3,3,2,8,0,2,1,0,3,0,2,0,0,0
4874,832,2017,23,23,0,1.0,100,1096,8,11,4,6,11,1,18,4,2,0,0,11,0,0,0,0,1
4875,833,2017,15,15,0,1.0,100,1096,6,5,4,5,3,1,9,4,1,0,0,1,2,0,0,0,1
4876,834,2017,8,7,1,0.9,89,1096,2,4,1,1,4,1,6,0,1,0,0,4,0,1,0,0,0
4877,835,2017,12,12,0,1.0,100,1096,6,5,1,4,3,1,8,2,2,0,0,1,2,1,0,0,0
4878,836,2017,16,15,1,0.91,91,1096,5,7,3,2,6,2,10,1,0,0,1,5,1,1,1,0,0
4879,837,2017,47,47,0,1.0,99,1096,35,12,0,9,7,0,16,0,0,1,8,2,5,0,0,0,0
4880,838,2017,15,15,0,1.0,99,1096,7,5,3,6,4,1,11,5,1,0,0,3,1,0,0,1,0
4881,839,2017,39,22,17,0.56,55,1096,7,12,3,2,7,3,12,0,0,1,1,2,5,3,0,0,0
4882,840,2017,25,25,0,1.0,99,1096,12,12,1,12,9,1,22,12,0,0,0,6,3,1,0,0,0
4883,841,2017,10,4,6,0.37,36,1096,1,2,1,1,1,1,3,1,0,0,0,0,1,1,0,0,0
4884,842,2017,22,13,9,0.57,57,1096,8,3,2,3,3,2,8,1,0,1,1,3,0,2,0,0,0
4885,843,2017,9,6,3,0.68,67,1096,3,3,0,2,3,0,5,1,1,0,0,3,0,0,0,0,0
4886,844,2017,38,38,0,1.0,100,1096,27,8,3,13,5,3,21,5,3,4,1,2,3,3,0,0,0
4887,845,2017,32,32,0,1.0,100,1096,19,10,3,6,6,2,14,1,1,0,4,2,4,1,1,0,0
4888,846,2017,20,17,3,0.87,87,1096,9,5,3,5,4,2,11,1,4,0,0,3,1,1,1,0,0
4889,847,2017,35,29,6,0.83,82,1096,13,15,1,11,13,1,25,10,0,1,0,11,2,1,0,0,0
4890,848,2017,29,27,2,0.94,93,1096,17,6,4,15,4,2,21,14,0,1,0,2,2,1,0,1,0
4891,849,2017,14,6,8,0.46,46,1096,3,3,0,2,2,0,4,1,1,0,0,1,1,0,0,0,0
4892,850,2017,34,32,2,0.93,93,1096,13,17,2,8,12,2,22,5,2,0,1,7,5,2,0,0,0
4893,851,2017,35,35,0,1.0,99,1096,14,19,2,7,11,2,20,0,7,0,0,3,8,2,0,0,0
4894,852,2017,55,54,1,0.99,99,1096,31,22,1,17,15,1,33,10,1,5,1,8,7,1,0,0,0
4895,853,2017,26,5,21,0.2,20,1096,2,2,1,2,2,1,5,2,0,0,0,2,0,1,0,0,0
4896,854,2017,53,34,19,0.64,63,1096,25,6,3,19,4,3,26,15,2,2,0,2,2,3,0,0,0
4897,855,2017,49,49,0,1.0,100,1096,35,11,3,26,6,3,35,20,4,1,1,1,5,3,0,0,0
4898,856,2017,23,23,0,1.0,99,1096,9,13,1,4,10,1,15,1,1,2,0,7,3,1,0,0,0
4899,857,2017,21,21,0,1.0,100,1096,7,11,3,2,7,3,12,0,0,1,1,3,4,3,0,0,0
4900,858,2017,23,23,0,1.0,100,1096,8,12,3,5,7,2,14,3,1,1,0,2,5,1,1,0,0
4901,859,2017,38,38,0,1.0,99,1096,24,10,4,6,6,3,15,0,0,0,6,2,4,2,1,0,0
4902,860,2017,35,35,0,1.0,100,1096,22,12,1,18,8,1,27,15,2,1,0,4,4,1,0,0,0
4903,861,2017,20,16,4,0.8,79,1096,9,5,2,9,5,1,15,9,0,0,0,5,0,0,1,0,0
4904,862,2017,28,28,0,1.0,100,1096,14,10,4,10,9,4,23,8,1,0,1,8,1,4,0,0,0
4905,863,2017,7,7,0,1.0,99,1096,4,2,1,2,1,1,4,1,0,1,0,0,1,1,0,0,0
4906,864,2017,46,23,23,0.49,49,1096,8,12,3,7,9,3,19,6,1,0,0,6,3,3,0,0,0
4907,865,2017,15,14,1,0.93,92,1096,5,5,4,4,3,1,8,3,1,0,0,1,2,0,0,0,1
4908,866,2017,58,14,44,0.23,23,1096,8,5,1,3,4,1,8,0,2,0,1,3,1,1,0,0,0
4909,867,2017,29,28,1,0.97,96,1096,13,12,3,6,7,2,15,3,0,2,1,2,5,1,1,0,0
4910,868,2017,34,13,21,0.39,38,1096,4,8,1,3,8,1,12,2,1,0,0,8,0,1,0,0,0
4911,869,2017,15,0,15,0.01,1,1096,0,0,0,0,0,0,0,0,0,0,0,0,0,0,0,0,0
4912,870,2017,35,6,29,0.17,17,1096,2,3,1,2,3,1,6,2,0,0,0,3,0,1,0,0,0
4913,871,2017,11,11,0,1.0,100,1096,5,5,1,4,5,1,10,3,1,0,0,5,0,1,0,0,0
4914,872,2017,37,37,0,1.0,100,1096,14,22,1,12,22,1,35,10,2,0,0,22,0,1,0,0,0
4915,873,2017,31,30,1,0.98,97,1096,10,17,3,4,16,3,23,0,2,2,0,15,1,3,0,0,0
4916,874,2017,38,38,0,1.0,100,1096,23,14,1,10,13,1,24,3,4,0,3,12,1,1,0,0,0
4917,875,2017,9,8,1,0.92,91,1096,3,3,2,3,3,2,8,3,0,0,0,3,0,2,0,0,0
4918,876,2017,39,34,5,0.88,87,1096,23,9,2,16,8,1,25,11,4,0,1,7,1,0,1,0,0
4919,877,2017,52,24,28,0.47,46,1096,9,13,2,6,8,1,15,4,1,1,0,3,5,0,1,0,0
4920,878,2017,37,3,34,0.07,7,1096,2,1,0,2,1,0,3,2,0,0,0,1,0,0,0,0,0
4921,879,2017,16,16,0,1.0,99,1096,5,9,2,5,6,1,12,5,0,0,0,3,3,0,1,0,0
4922,880,2017,20,17,3,0.86,85,1096,7,6,4,3,4,3,10,0,2,1,0,2,2,2,1,0,0
4923,881,2017,7,7,0,1.0,100,1096,4,2,1,4,2,1,7,4,0,0,0,2,0,1,0,0,0
4924,882,2017,60,11,49,0.18,17,1096,3,6,2,2,4,2,8,1,1,0,0,2,2,2,0,0,0
4925,883,2017,10,10,0,1.0,99,1096,5,4,1,3,4,1,8,2,0,1,0,4,0,1,0,0,0
4926,884,2017,8,2,6,0.31,30,1096,1,1,0,1,1,0,2,1,0,0,0,1,0,0,0,0,0
4927,885,2017,34,3,31,0.08,7,1096,1,2,0,1,2,0,3,1,0,0,0,2,0,0,0,0,0
4928,886,2017,26,26,0,1.0,100,1096,16,6,4,7,5,3,15,1,4,1,1,4,1,2,1,0,0
4929,887,2017,12,11,1,0.95,95,1096,7,4,0,4,2,0,6,2,1,1,0,0,2,0,0,0,0
4930,888,2017,15,15,0,1.0,99,1096,3,9,3,2,5,2,9,1,1,0,0,1,4,1,1,0,0
4931,889,2017,26,26,0,1.0,99,1096,12,11,3,9,7,1,17,7,1,1,0,3,4,0,0,1,0
4932,890,2017,12,6,6,0.53,52,1096,2,3,1,1,3,1,5,0,1,0,0,3,0,1,0,0,0
4933,891,2017,60,60,0,1.0,99,1096,39,17,4,15,9,4,28,3,1,10,1,1,8,4,0,0,0
4934,892,2017,21,21,0,1.0,100,1096,13,6,2,9,5,1,15,6,2,1,0,4,1,0,1,0,0
4935,893,2017,18,2,16,0.14,13,1096,1,1,0,1,1,0,2,1,0,0,0,1,0,0,0,0,0
4936,894,2017,13,12,1,0.95,94,1096,5,5,2,5,5,1,11,5,0,0,0,5,0,0,1,0,0
4937,895,2017,41,22,19,0.54,54,1096,11,10,1,10,8,1,19,9,1,0,0,6,2,1,0,0,0
4938,896,2017,14,3,11,0.19,19,1096,2,1,0,2,1,0,3,2,0,0,0,1,0,0,0,0,0
4939,897,2017,47,45,2,0.96,96,1096,20,23,2,13,18,1,32,10,0,2,1,13,5,0,1,0,0
4940,898,2017,28,28,0,1.0,100,1096,17,11,0,14,9,0,23,12,1,1,0,7,2,0,0,0,0
4941,899,2017,29,28,1,0.98,97,1096,16,9,3,10,9,1,20,6,3,0,1,9,0,0,0,1,0
4942,900,2017,22,22,0,0.99,98,1096,10,11,1,10,8,1,19,10,0,0,0,5,3,1,0,0,0
4943,901,2017,34,31,3,0.9,90,1096,14,17,0,13,9,0,22,12,1,0,0,1,8,0,0,0,0
4944,902,2017,16,16,0,0.97,97,1096,6,9,1,4,8,1,13,3,0,1,0,7,1,1,0,0,0
4945,903,2017,26,24,2,0.93,93,1096,11,11,2,11,10,1,22,11,0,0,0,9,1,0,1,0,0
4946,904,2017,10,1,9,0.11,10,1096,0,1,0,0,1,0,1,0,0,0,0,1,0,0,0,0,0
4947,905,2017,14,3,11,0.24,23,1096,1,2,0,1,1,0,2,1,0,0,0,0,1,0,0,0,0
4948,906,2017,12,5,7,0.4,39,1096,3,2,0,1,1,0,2,0,0,1,0,0,1,0,0,0,0
4949,907,2017,42,11,31,0.26,25,1096,6,4,1,2,4,1,7,0,0,2,0,4,0,1,0,0,0
4950,908,2017,20,10,10,0.53,52,1096,5,5,0,3,5,0,8,2,0,1,0,5,0,0,0,0,0
4951,909,2017,40,40,0,1.0,99,1096,26,12,2,9,11,2,22,2,0,4,3,10,1,2,0,0,0
4952,910,2017,16,16,0,1.0,100,1096,6,8,2,2,5,1,8,0,0,2,0,2,3,0,1,0,0
4953,911,2017,57,57,0,1.0,100,1096,28,26,3,10,22,2,34,1,1,7,1,18,4,1,1,0,0
4954,912,2017,10,0,10,0.01,1,1096,0,0,0,0,0,0,0,0,0,0,0,0,0,0,0,0,0
4955,913,2017,27,8,19,0.31,31,1096,3,3,2,3,2,1,6,3,0,0,0,1,1,0,1,0,0
4956,914,2017,33,22,11,0.68,67,1096,13,8,1,4,6,1,11,0,0,3,1,4,2,1,0,0,0
4957,915,2017,26,19,7,0.72,72,1096,5,11,3,4,10,3,17,3,1,0,0,9,1,3,0,0,0
4958,916,2017,37,24,13,0.65,64,1096,8,13,3,4,8,2,14,1,2,1,0,3,5,1,1,0,0
4959,917,2017,25,24,1,0.96,95,1096,14,8,2,11,5,2,18,10,0,0,1,2,3,2,0,0,0
4960,918,2017,12,10,2,0.87,86,1096,6,3,1,4,2,1,7,2,2,0,0,1,1,1,0,0,0
4961,919,2017,41,39,2,0.96,95,1096,24,13,2,20,8,2,30,17,2,1,0,3,5,2,0,0,0
4962,920,2017,11,10,1,0.95,94,1096,5,3,2,4,2,1,7,3,1,0,0,1,1,0,1,0,0
4963,921,2017,26,25,1,0.98,97,1096,8,15,2,4,12,2,18,1,2,1,0,9,3,2,0,0,0
4964,922,2017,12,10,2,0.85,84,1096,7,3,0,4,3,0,7,2,1,1,0,3,0,0,0,0,0
4965,923,2017,41,41,0,0.99,98,1096,14,24,3,7,18,1,26,3,1,3,0,12,6,0,0,1,0
4966,924,2017,15,15,0,0.99,99,1096,7,8,0,3,8,0,11,1,1,0,1,8,0,0,0,0,0
4967,925,2017,25,21,4,0.86,85,1096,10,8,3,3,6,2,11,0,1,0,2,4,2,1,1,0,0
4968,926,2017,27,4,23,0.15,14,1096,2,2,0,1,2,0,3,0,1,0,0,2,0,0,0,0,0
4969,927,2017,27,27,0,0.99,98,1096,19,7,1,16,7,1,24,15,0,0,1,7,0,1,0,0,0
4970,928,2017,38,38,0,1.0,100,1096,14,22,2,9,21,2,32,6,2,0,1,20,1,2,0,0,0
4971,929,2017,9,7,2,0.83,82,1096,2,3,2,1,2,2,5,0,1,0,0,1,1,2,0,0,0
4972,930,2017,47,45,2,0.95,95,1096,27,15,3,10,15,3,28,1,4,2,3,15,0,3,0,0,0
4973,931,2017,26,26,0,0.99,98,1096,18,5,3,11,4,1,16,7,2,1,1,3,1,0,0,1,0
4974,932,2017,29,29,0,1.0,99,1096,13,12,4,10,12,3,25,7,3,0,0,12,0,2,1,0,0
4975,933,2017,39,9,30,0.23,23,1096,4,5,0,4,5,0,9,4,0,0,0,5,0,0,0,0,0
4976,934,2017,25,9,16,0.37,37,1096,4,3,2,2,2,1,5,0,2,0,0,1,1,0,1,0,0
4977,935,2017,22,15,7,0.66,66,1096,6,6,3,3,5,1,9,2,0,0,1,4,1,0,0,1,0
4978,936,2017,31,31,0,0.98,98,1096,23,7,1,8,6,1,15,0,1,7,0,5,1,1,0,0,0
4979,937,2017,10,1,9,0.15,14,1096,0,1,0,0,1,0,1,0,0,0,0,1,0,0,0,0,0
4980,938,2017,31,12,19,0.37,37,1096,3,6,3,3,6,1,10,3,0,0,0,6,0,0,0,1,0
4981,939,2017,14,12,2,0.87,86,1096,7,4,1,2,3,1,6,0,0,1,1,2,1,1,0,0,0
4982,940,2017,60,40,20,0.66,66,1096,22,17,1,12,17,1,30,4,6,2,0,17,0,1,0,0,0
4983,941,2017,27,20,7,0.73,73,1096,12,6,2,3,3,2,8,0,0,0,3,0,3,2,0,0,0
4984,942,2017,17,17,0,0.99,98,1096,5,8,4,5,4,4,13,5,0,0,0,0,4,4,0,0,0
4985,943,2017,48,41,7,0.86,86,1096,24,17,0,8,9,0,17,2,0,2,4,1,8,0,0,0,0
4986,944,2017,18,10,8,0.56,56,1096,5,3,2,5,3,2,10,5,0,0,0,3,0,2,0,0,0
4987,945,2017,26,18,8,0.69,69,1096,13,3,2,7,3,1,11,4,0,3,0,3,0,0,1,0,0
4988,946,2017,24,24,0,1.0,99,1096,9,13,2,3,13,2,18,0,1,1,1,13,0,2,0,0,0
4989,947,2017,36,0,36,0.01,1,1096,0,0,0,0,0,0,0,0,0,0,0,0,0,0,0,0,0
4990,948,2017,20,4,16,0.18,18,1096,1,2,1,1,1,1,3,1,0,0,0,0,1,1,0,0,0
4991,949,2017,26,26,0,1.0,100,1096,9,13,4,7,13,3,23,6,0,1,0,13,0,2,1,0,0
4992,950,2017,35,14,21,0.41,40,1096,8,4,2,6,2,2,10,4,2,0,0,0,2,2,0,0,0
4993,951,2017,29,27,2,0.92,91,1096,17,9,1,11,5,1,17,7,3,0,1,1,4,1,0,0,0
4994,952,2017,15,8,7,0.56,56,1096,4,4,0,4,2,0,6,4,0,0,0,0,2,0,0,0,0
4995,953,2017,54,1,53,0.01,1,1096,0,1,0,0,1,0,1,0,0,0,0,1,0,0,0,0,0
4996,954,2017,21,21,0,0.99,99,1096,6,12,3,6,6,1,13,6,0,0,0,0,6,0,0,1,0
4997,955,2017,23,23,0,1.0,100,1096,9,10,4,7,6,3,16,6,0,1,0,2,4,2,1,0,0
4998,956,2017,40,15,25,0.37,36,1096,5,8,2,2,4,2,8,0,1,1,0,0,4,2,0,0,0
4999,957,2017,23,6,17,0.26,25,1096,2,3,1,1,3,1,5,0,1,0,0,3,0,1,0,0,0
5000,958,2017,20,9,11,0.44,44,1096,5,4,0,2,3,0,5,1,0,0,1,2,1,0,0,0,0
5001,959,2017,22,21,1,0.93,93,1096,15,5,1,8,4,1,13,5,0,2,1,3,1,1,0,0,0
5002,960,2017,6,6,0,1.0,100,1096,4,2,0,2,2,0,4,1,0,1,0,2,0,0,0,0,0
5003,961,2017,22,6,16,0.25,25,1096,3,3,0,3,2,0,5,3,0,0,0,1,1,0,0,0,0
5004,962,2017,34,29,5,0.86,85,1096,13,13,3,13,13,3,29,13,0,0,0,13,0,3,0,0,0
5005,963,2017,15,9,6,0.59,58,1096,4,4,1,4,3,1,8,4,0,0,0,2,1,1,0,0,0
5006,964,2017,28,28,0,1.0,100,1096,16,10,2,8,5,1,14,4,1,2,1,0,5,0,1,0,0
5007,965,2017,16,10,6,0.66,65,1096,5,3,2,5,3,2,10,5,0,0,0,3,0,2,0,0,0
5008,966,2017,12,3,9,0.28,28,1096,1,2,0,1,2,0,3,1,0,0,0,2,0,0,0,0,0
5009,967,2017,23,23,0,1.0,100,1096,13,8,2,4,7,1,12,1,0,0,3,6,1,0,1,0,0
5010,968,2017,31,29,2,0.94,93,1096,17,8,4,16,5,4,25,15,1,0,0,2,3,4,0,0,0
5011,969,2017,41,41,0,1.0,99,1096,28,13,0,11,7,0,18,1,4,5,1,1,6,0,0,0,0
5012,970,2017,5,2,3,0.47,46,1096,1,1,0,1,1,0,2,1,0,0,0,1,0,0,0,0,0
5013,971,2017,52,51,1,0.99,99,1096,37,11,3,35,9,1,45,33,2,0,0,7,2,0,0,1,0
5014,972,2017,7,2,5,0.24,23,1096,1,1,0,1,1,0,2,1,0,0,0,1,0,0,0,0,0
5015,973,2017,10,8,2,0.84,84,1096,3,3,2,1,2,1,4,0,0,1,0,1,1,0,1,0,0
5016,974,2017,23,23,0,0.99,99,1096,17,5,1,10,4,1,15,4,5,1,0,3,1,1,0,0,0
5017,975,2017,46,38,8,0.82,82,1096,22,14,2,11,8,2,21,4,3,4,0,2,6,2,0,0,0
5018,976,2017,9,1,8,0.08,7,1096,0,1,0,0,1,0,1,0,0,0,0,1,0,0,0,0,0
5019,977,2017,55,36,19,0.66,65,1096,23,12,1,7,7,1,15,0,2,1,4,2,5,1,0,0,0
5020,978,2017,35,10,25,0.29,28,1096,5,3,2,5,3,2,10,5,0,0,0,3,0,2,0,0,0
5021,979,2017,50,50,0,1.0,100,1096,31,18,1,12,15,1,28,1,7,0,4,12,3,1,0,0,0
5022,980,2017,14,14,0,0.97,96,1096,6,7,1,2,7,1,10,0,1,0,1,7,0,1,0,0,0
5023,981,2017,52,52,0,1.0,100,1096,29,22,1,20,11,1,32,11,9,0,0,0,11,1,0,0,0
5024,982,2017,38,28,10,0.74,73,1096,17,11,0,14,6,0,20,12,1,1,0,1,5,0,0,0,0
5025,983,2017,40,39,1,0.98,97,1096,23,13,3,8,9,2,19,3,0,0,5,5,4,1,1,0,0
5026,984,2017,31,6,25,0.2,19,1096,2,3,1,2,3,1,6,2,0,0,0,3,0,1,0,0,0
5027,985,2017,35,35,0,1.0,100,1096,25,10,0,19,9,0,28,14,4,1,0,8,1,0,0,0,0
5028,986,2017,39,39,0,0.99,98,1096,14,23,2,14,15,2,31,14,0,0,0,7,8,2,0,0,0
5029,987,2017,16,0,16,0.0,0,1096,0,0,0,0,0,0,0,0,0,0,0,0,0,0,0,0,0
5030,988,2017,18,10,8,0.53,53,1096,5,3,2,2,3,2,7,1,0,0,1,3,0,2,0,0,0
5031,989,2017,26,23,3,0.88,88,1096,11,9,3,10,8,2,20,9,1,0,0,7,1,1,1,0,0
5032,990,2017,19,9,10,0.49,49,1096,4,5,0,4,5,0,9,4,0,0,0,5,0,0,0,0,0
5033,991,2017,11,7,4,0.62,61,1096,5,2,0,3,2,0,5,1,2,0,0,2,0,0,0,0,0
5034,992,2017,17,15,2,0.89,89,1096,8,4,3,3,2,2,7,0,1,2,0,0,2,1,1,0,0
5035,993,2017,28,2,26,0.07,7,1096,1,1,0,1,1,0,2,1,0,0,0,1,0,0,0,0,0
5036,994,2017,26,11,15,0.44,44,1096,8,2,1,5,1,1,7,2,3,0,0,0,1,1,0,0,0
5037,995,2017,33,33,0,1.0,99,1096,19,12,2,13,7,2,22,10,0,3,0,2,5,2,0,0,0
5038,996,2017,15,14,1,0.96,95,1096,6,6,2,3,6,2,11,0,3,0,0,6,0,2,0,0,0
5039,997,2017,13,12,1,0.94,93,1096,9,2,1,4,2,1,7,1,2,0,1,2,0,1,0,0,0
5040,998,2017,11,10,1,0.94,94,1096,7,3,0,5,2,0,7,4,0,1,0,1,1,0,0,0,0
5041,999,2017,29,28,1,0.95,94,1096,18,8,2,13,5,2,20,8,5,0,0,2,3,2,0,0,0
5042,1000,2017,22,14,8,0.64,64,1096,9,3,2,6,3,2,11,5,0,0,1,3,0,2,0,0,0
5043,1001,2017,22,6,16,0.27,27,1096,3,3,0,1,3,0,4,0,0,1,0,3,0,0,0,0,0
5044,1002,2017,60,60,0,1.0,100,1096,32,26,2,26,13,1,40,23,0,3,0,0,13,0,1,0,0
5045,1003,2017,16,14,2,0.87,87,1096,9,5,0,6,3,0,9,4,1,1,0,1,2,0,0,0,0
5046,1004,2017,27,27,0,1.0,99,1096,16,10,1,5,5,1,11,0,1,2,2,0,5,1,0,0,0
5047,1005,2017,46,45,1,0.98,97,1096,28,14,3,15,9,1,25,10,0,2,3,4,5,0,0,1,0
5048,1006,2017,19,10,9,0.52,52,1096,4,5,1,2,4,1,7,1,0,1,0,3,1,1,0,0,0
5049,1007,2017,38,38,0,1.0,99,1096,28,7,3,12,6,2,20,5,1,3,3,5,1,1,1,0,0
5050,1008,2017,48,0,48,0.0,0,1096,0,0,0,0,0,0,0,0,0,0,0,0,0,0,0,0,0
5051,1009,2017,17,11,6,0.65,64,1096,6,5,0,6,5,0,11,6,0,0,0,5,0,0,0,0,0
5052,1010,2017,27,27,0,0.99,99,1096,18,7,2,8,4,2,14,2,2,4,0,1,3,2,0,0,0
5053,1011,2017,16,16,0,1.0,99,1096,8,7,1,5,5,1,11,4,0,0,1,3,2,1,0,0,0
5054,1012,2017,26,22,4,0.83,83,1096,12,6,4,11,5,3,19,10,1,0,0,4,1,2,1,0,0
5055,1013,2017,52,8,44,0.16,16,1096,3,4,1,1,4,1,6,0,0,1,0,4,0,1,0,0,0
5056,1014,2017,33,30,3,0.91,91,1096,13,16,1,7,8,1,16,5,0,0,2,0,8,1,0,0,0
5057,1015,2017,40,17,23,0.41,41,1096,6,8,3,5,4,2,11,4,1,0,0,0,4,1,1,0,0
5058,1016,2017,26,14,12,0.52,51,1096,9,3,2,7,3,2,12,5,2,0,0,3,0,2,0,0,0
5059,1017,2017,22,20,2,0.9,89,1096,14,4,2,6,4,1,11,1,3,1,1,4,0,0,1,0,0
5060,1018,2017,40,16,24,0.41,40,1096,5,8,3,3,5,3,11,1,2,0,0,2,3,3,0,0,0
5061,1019,2017,45,34,11,0.76,75,1096,19,13,2,17,9,2,28,16,0,1,0,5,4,2,0,0,0
5062,1020,2017,28,28,0,1.0,100,1096,13,11,4,11,8,1,20,9,2,0,0,5,3,0,0,0,1
5063,1021,2017,27,25,2,0.94,93,1096,7,14,4,7,7,1,15,7,0,0,0,0,7,0,0,0,1
5064,1022,2017,41,26,15,0.63,63,1096,18,6,2,12,5,1,18,8,2,2,0,4,1,0,1,0,0
5065,1023,2017,53,33,20,0.61,61,1096,20,9,4,18,5,2,25,16,2,0,0,1,4,1,0,1,0
5066,1024,2017,8,7,1,0.81,81,1096,4,2,1,1,2,1,4,0,0,0,1,2,0,1,0,0,0
5067,1025,2017,13,8,5,0.62,62,1096,6,2,0,4,2,0,6,3,0,1,0,2,0,0,0,0,0
5068,1026,2017,35,0,35,0.01,1,1096,0,0,0,0,0,0,0,0,0,0,0,0,0,0,0,0,0
5069,1027,2017,42,11,31,0.27,27,1096,7,4,0,2,2,0,4,0,0,1,1,0,2,0,0,0,0
5070,1028,2017,5,5,0,0.93,92,1096,2,2,1,1,2,1,4,0,1,0,0,2,0,1,0,0,0
5071,1029,2017,6,6,0,1.0,99,1096,3,2,1,3,1,1,5,3,0,0,0,0,1,1,0,0,0
5072,1030,2017,27,16,11,0.61,60,1096,7,9,0,5,7,0,12,4,0,1,0,5,2,0,0,0,0
5073,1031,2017,39,21,18,0.54,54,1096,11,9,1,4,8,1,13,0,2,1,1,7,1,1,0,0,0
5074,1032,2017,16,14,2,0.89,88,1096,9,4,1,6,2,1,9,4,1,1,0,0,2,1,0,0,0
5075,1033,2017,56,12,44,0.22,21,1096,3,7,2,3,5,1,9,3,0,0,0,3,2,0,1,0,0
5076,1034,2017,12,10,2,0.84,83,1096,4,4,2,3,2,2,7,2,1,0,0,0,2,2,0,0,0
5077,1035,2017,31,29,2,0.92,91,1096,13,13,3,9,11,3,23,6,2,1,0,9,2,3,0,0,0
5078,1036,2017,55,41,14,0.74,73,1096,24,15,2,14,10,1,25,9,1,3,1,5,5,0,1,0,0
5079,1037,2017,27,23,4,0.84,84,1096,9,11,3,3,9,3,15,0,1,1,1,7,2,3,0,0,0
5080,1038,2017,21,11,10,0.53,53,1096,4,6,1,1,4,1,6,0,0,0,1,2,2,1,0,0,0
5081,1039,2017,33,10,23,0.29,29,1096,6,3,1,4,2,1,7,2,2,0,0,1,1,1,0,0,0
5082,1040,2017,34,31,3,0.92,92,1096,22,8,1,15,7,1,23,11,2,1,1,6,1,1,0,0,0
5083,1041,2017,31,16,15,0.52,52,1096,7,8,1,2,8,1,11,0,0,1,1,8,0,1,0,0,0
5084,1042,2017,25,18,7,0.72,71,1096,11,7,0,7,5,0,12,4,2,1,0,3,2,0,0,0,0
5085,1043,2017,26,25,1,0.98,98,1096,14,10,1,9,9,1,19,7,0,1,1,8,1,1,0,0,0
5086,1044,2017,54,27,27,0.5,49,1096,15,10,2,13,5,1,19,11,2,0,0,0,5,0,1,0,0
5087,1045,2017,60,11,49,0.19,19,1096,5,5,1,4,3,1,8,3,1,0,0,1,2,1,0,0,0
5088,1046,2017,54,18,36,0.33,32,1096,13,5,0,9,5,0,14,7,0,2,0,5,0,0,0,0,0
5089,1047,2017,30,14,16,0.46,46,1096,6,5,3,5,5,2,12,4,1,0,0,5,0,1,1,0,0
5090,1048,2017,28,26,2,0.95,94,1096,13,9,4,13,7,4,24,13,0,0,0,5,2,4,0,0,0
5091,1049,2017,33,24,9,0.74,73,1096,13,9,2,12,6,1,19,11,1,0,0,3,3,0,1,0,0
5092,1050,2017,45,7,38,0.15,14,1096,4,3,0,3,3,0,6,2,1,0,0,3,0,0,0,0,0
5093,1051,2017,41,15,26,0.36,36,1096,8,6,1,4,5,1,10,1,2,1,0,4,1,1,0,0,0
5094,1052,2017,5,4,1,0.82,82,1096,1,2,1,1,1,1,3,1,0,0,0,0,1,1,0,0,0
5095,1053,2017,46,45,1,0.97,97,1096,21,23,1,10,13,1,24,1,7,2,0,3,10,1,0,0,0
5096,1054,2017,14,3,11,0.2,19,1096,2,1,0,1,1,0,2,0,1,0,0,1,0,0,0,0,0
5097,1055,2017,33,17,16,0.52,52,1096,11,5,1,5,5,1,11,2,1,1,1,5,0,1,0,0,0
5098,1056,2017,29,29,0,0.99,98,1096,10,16,3,8,10,3,21,6,2,0,0,4,6,3,0,0,0
5099,1057,2017,47,15,32,0.32,32,1096,4,8,3,2,4,2,8,1,0,1,0,0,4,1,1,0,0
5100,1058,2017,22,22,0,0.98,97,1096,8,12,2,3,10,1,14,1,0,1,1,8,2,0,1,0,0
5101,1059,2017,8,8,0,0.94,94,1096,5,2,1,4,1,1,6,3,1,0,0,0,1,1,0,0,0
5102,1060,2017,15,13,2,0.89,88,1096,4,6,3,3,3,3,9,2,1,0,0,0,3,3,0,0,0
5103,1061,2017,5,4,1,0.86,85,1096,2,2,0,2,2,0,4,2,0,0,0,2,0,0,0,0,0
5104,1062,2017,50,47,3,0.94,93,1096,33,11,3,30,8,3,41,27,3,0,0,5,3,3,0,0,0
5105,1063,2017,33,13,20,0.4,40,1096,4,6,3,3,3,3,9,2,1,0,0,0,3,3,0,0,0
5106,1064,2017,23,17,6,0.73,73,1096,7,9,1,6,6,1,13,5,1,0,0,3,3,1,0,0,0
5107,1065,2017,30,30,0,1.0,100,1096,20,7,3,14,5,3,22,11,0,3,0,3,2,3,0,0,0
5108,1066,2017,25,5,20,0.2,20,1096,4,1,0,4,1,0,5,4,0,0,0,1,0,0,0,0,0
5109,1067,2017,48,13,35,0.27,27,1096,5,6,2,4,5,1,10,3,1,0,0,4,1,0,1,0,0
5110,1068,2017,27,26,1,0.95,94,1096,17,7,2,6,7,2,15,1,1,2,2,7,0,2,0,0,0
5111,1069,2017,8,1,7,0.12,12,1096,0,1,0,0,1,0,1,0,0,0,0,1,0,0,0,0,0
5112,1070,2017,38,12,26,0.32,31,1096,4,7,1,2,4,1,7,0,2,0,0,1,3,1,0,0,0
5113,1071,2017,38,23,15,0.59,59,1096,7,14,2,6,14,2,22,5,1,0,0,14,0,2,0,0,0
5114,1072,2017,22,22,0,0.99,98,1096,11,7,4,10,6,4,20,9,1,0,0,5,1,4,0,0,0
5115,1073,2017,43,23,20,0.53,53,1096,13,8,2,9,6,2,17,5,4,0,0,4,2,2,0,0,0
5116,1074,2017,35,8,27,0.24,24,1096,4,3,1,1,3,1,5,0,0,0,1,3,0,1,0,0,0
5117,1075,2017,58,37,21,0.64,64,1096,15,18,4,8,15,1,24,4,2,1,1,12,3,0,0,0,1
5118,1076,2017,43,3,40,0.06,6,1096,2,1,0,1,1,0,2,0,1,0,0,1,0,0,0,0,0
5119,1077,2017,31,31,0,1.0,100,1096,11,17,3,11,15,3,29,11,0,0,0,13,2,3,0,0,0
5120,1078,2017,22,12,10,0.55,55,1096,5,4,3,4,3,1,8,3,1,0,0,2,1,0,0,1,0
5121,1079,2017,15,14,1,0.92,91,1096,4,8,2,4,4,1,9,4,0,0,0,0,4,0,1,0,0
5122,1080,2017,21,1,20,0.05,5,1096,0,1,0,0,1,0,1,0,0,0,0,1,0,0,0,0,0
5123,1081,2017,20,15,5,0.74,73,1096,4,7,4,2,6,1,9,1,0,1,0,5,1,0,0,0,1
5124,1082,2017,47,47,0,0.99,99,1096,17,28,2,6,24,2,32,0,3,1,2,20,4,2,0,0,0
5125,1083,2017,27,1,26,0.05,5,1096,0,1,0,0,1,0,1,0,0,0,0,1,0,0,0,0,0
5126,1084,2017,30,29,1,0.97,96,1096,13,16,0,10,11,0,21,7,3,0,0,6,5,0,0,0,0
5127,1085,2017,32,23,9,0.71,70,1096,11,10,2,9,6,1,16,7,2,0,0,2,4,0,1,0,0
5128,1086,2017,30,4,26,0.14,14,1096,3,1,0,3,1,0,4,3,0,0,0,1,0,0,0,0,0
5129,1087,2017,13,2,11,0.12,12,1096,1,1,0,1,1,0,2,1,0,0,0,1,0,0,0,0,0
5130,1088,2017,37,35,2,0.95,94,1096,24,8,3,19,5,2,26,14,5,0,0,2,3,1,1,0,0
5131,1089,2017,8,3,5,0.43,42,1096,2,1,0,1,1,0,2,0,1,0,0,1,0,0,0,0,0
5132,1090,2017,40,12,28,0.31,30,1096,5,6,1,5,4,1,10,5,0,0,0,2,2,1,0,0,0
5133,1091,2017,31,27,4,0.87,87,1096,18,9,0,18,5,0,23,18,0,0,0,1,4,0,0,0,0
5134,1092,2017,35,35,0,1.0,100,1096,18,15,2,14,11,1,26,11,2,1,0,7,4,0,1,0,0
5135,1093,2017,31,18,13,0.58,58,1096,9,5,4,7,5,4,16,6,0,1,0,5,0,4,0,0,0
5136,1094,2017,25,13,12,0.53,52,1096,3,8,2,3,6,2,11,3,0,0,0,4,2,2,0,0,0
5137,1095,2017,28,7,21,0.24,23,1096,4,3,0,3,3,0,6,2,1,0,0,3,0,0,0,0,0
5138,1096,2017,35,34,1,0.98,98,1096,13,19,2,11,12,1,24,9,2,0,0,5,7,0,1,0,0
5139,1,2018,33,33,0,0.99,99,1095,18,12,3,13,8,3,24,8,5,0,0,4,4,3,0,0,0
5140,2,2018,15,6,9,0.39,38,1095,3,2,1,2,1,1,4,1,1,0,0,0,1,1,0,0,0
5141,3,2018,28,28,0,1.0,100,1095,8,16,4,4,12,4,20,0,4,0,0,8,4,4,0,0,0
5142,4,2018,40,40,0,1.0,100,1095,22,17,1,16,17,1,34,12,2,2,0,17,0,1,0,0,0
5143,5,2018,33,33,0,1.0,100,1095,16,14,3,11,8,2,21,9,0,1,1,2,6,1,1,0,0
5144,6,2018,41,41,0,1.0,100,1095,22,18,1,12,9,1,22,6,2,4,0,0,9,1,0,0,0
5145,7,2018,55,55,0,1.0,99,1095,27,24,4,20,21,3,44,17,1,0,2,18,3,2,1,0,0
5146,8,2018,38,15,23,0.39,38,1095,7,6,2,7,3,2,12,7,0,0,0,0,3,2,0,0,0
5147,9,2018,28,3,25,0.12,12,1095,2,1,0,2,1,0,3,2,0,0,0,1,0,0,0,0,0
5148,10,2018,12,12,0,1.0,99,1095,4,5,3,1,3,2,6,0,0,0,1,1,2,1,1,0,0
5149,11,2018,49,14,35,0.29,29,1095,10,3,1,6,3,1,10,2,4,0,0,3,0,1,0,0,0
5150,12,2018,34,0,34,0.0,0,1095,0,0,0,0,0,0,0,0,0,0,0,0,0,0,0,0,0
5151,13,2018,6,6,0,0.97,96,1095,3,2,1,3,2,1,6,3,0,0,0,2,0,1,0,0,0
5152,14,2018,32,0,32,0.01,1,1095,0,0,0,0,0,0,0,0,0,0,0,0,0,0,0,0,0
5153,15,2018,7,7,0,0.98,97,1095,3,3,1,3,2,1,6,3,0,0,0,1,1,1,0,0,0
5154,16,2018,47,47,0,0.99,99,1095,29,16,2,26,11,1,38,25,0,0,1,6,5,0,1,0,0
5155,17,2018,13,13,0,0.99,98,1095,4,6,3,4,4,3,11,4,0,0,0,2,2,3,0,0,0
5156,18,2018,40,40,0,1.0,100,1095,26,13,1,17,10,1,28,12,3,0,2,7,3,1,0,0,0
5157,19,2018,10,1,9,0.1,10,1095,0,1,0,0,1,0,1,0,0,0,0,1,0,0,0,0,0
5158,20,2018,9,9,0,0.99,99,1095,4,3,2,3,2,2,7,2,1,0,0,1,1,2,0,0,0
5159,21,2018,52,21,31,0.41,41,1095,12,5,4,6,4,4,14,3,0,3,0,3,1,4,0,0,0
5160,22,2018,5,5,0,0.93,93,1095,3,2,0,2,2,0,4,1,1,0,0,2,0,0,0,0,0
5161,23,2018,34,34,0,1.0,99,1095,19,13,2,15,13,1,29,12,2,1,0,13,0,0,1,0,0
5162,24,2018,37,36,1,0.98,98,1095,14,21,1,4,13,1,18,0,1,0,3,5,8,1,0,0,0
5163,25,2018,36,36,0,1.0,99,1095,24,8,4,10,8,4,22,2,4,2,2,8,0,4,0,0,0
5164,26,2018,33,33,0,1.0,100,1095,21,10,2,20,10,1,31,19,1,0,0,10,0,0,1,0,0
5165,27,2018,27,13,14,0.48,48,1095,6,4,3,5,3,2,10,4,1,0,0,2,1,1,1,0,0
5166,28,2018,27,27,0,0.99,98,1095,11,15,1,11,8,1,20,11,0,0,0,1,7,1,0,0,0
5167,29,2018,8,1,7,0.16,16,1095,0,1,0,0,1,0,1,0,0,0,0,1,0,0,0,0,0
5168,30,2018,59,59,0,1.0,99,1095,27,30,2,21,15,1,37,17,2,2,0,0,15,0,1,0,0
5169,31,2018,60,28,32,0.47,47,1095,19,9,0,8,5,0,13,2,1,5,0,1,4,0,0,0,0
5170,32,2018,10,10,0,1.0,100,1095,5,5,0,3,3,0,6,1,2,0,0,1,2,0,0,0,0
5171,33,2018,28,27,1,0.98,97,1095,16,7,4,14,7,4,25,12,2,0,0,7,0,4,0,0,0
5172,34,2018,10,6,4,0.64,64,1095,2,3,1,1,2,1,4,0,1,0,0,1,1,1,0,0,0
5173,35,2018,52,52,0,1.0,99,1095,24,26,2,7,15,2,24,0,2,0,5,4,11,2,0,0,0
5174,36,2018,58,57,1,0.99,98,1095,27,30,0,10,30,0,40,2,0,7,1,30,0,0,0,0,0
5175,37,2018,53,52,1,0.99,98,1095,37,11,4,23,8,3,34,13,6,4,0,5,3,2,1,0,0
5176,38,2018,19,18,1,0.97,97,1095,10,7,1,10,4,1,15,10,0,0,0,1,3,1,0,0,0
5177,39,2018,16,4,12,0.22,21,1095,1,2,1,1,1,1,3,1,0,0,0,0,1,1,0,0,0
5178,40,2018,8,8,0,1.0,100,1095,5,2,1,5,2,1,8,5,0,0,0,2,0,1,0,0,0
5179,41,2018,24,22,2,0.9,89,1095,13,6,3,9,6,1,16,7,1,0,1,6,0,0,0,1,0
5180,42,2018,8,0,8,0.03,3,1095,0,0,0,0,0,0,0,0,0,0,0,0,0,0,0,0,0
5181,43,2018,40,37,3,0.92,91,1095,19,17,1,18,17,1,36,17,1,0,0,17,0,1,0,0,0
5182,44,2018,29,28,1,0.96,95,1095,13,12,3,11,9,1,21,10,0,1,0,6,3,0,0,1,0
5183,45,2018,42,7,35,0.17,17,1095,2,4,1,1,3,1,5,0,1,0,0,2,1,1,0,0,0
5184,46,2018,53,53,0,1.0,100,1095,25,27,1,19,26,1,46,17,0,0,2,25,1,1,0,0,0
5185,47,2018,37,37,0,1.0,100,1095,18,17,2,11,11,2,24,4,7,0,0,5,6,2,0,0,0
5186,48,2018,24,24,0,1.0,100,1095,18,5,1,13,5,1,19,9,3,1,0,5,0,1,0,0,0
5187,49,2018,60,55,5,0.92,91,1095,30,24,1,28,21,1,50,27,0,1,0,18,3,1,0,0,0
5188,50,2018,17,17,0,0.97,97,1095,7,6,4,3,6,4,13,1,1,0,1,6,0,4,0,0,0
5189,51,2018,18,18,0,0.99,99,1095,12,5,1,3,5,1,9,0,0,0,3,5,0,1,0,0,0
5190,52,2018,34,30,4,0.89,88,1095,14,13,3,8,12,1,21,4,2,2,0,11,1,0,0,1,0
5191,53,2018,25,6,19,0.22,22,1095,3,3,0,2,3,0,5,1,1,0,0,3,0,0,0,0,0
5192,54,2018,26,24,2,0.92,92,1095,14,7,3,5,6,1,12,1,0,3,1,5,1,0,0,1,0
5193,55,2018,31,31,0,1.0,100,1095,16,12,3,5,11,1,17,0,0,4,1,10,1,0,0,1,0
5194,56,2018,25,25,0,1.0,100,1095,8,15,2,5,8,1,14,2,3,0,0,1,7,0,1,0,0
5195,57,2018,11,11,0,1.0,99,1095,6,3,2,3,3,2,8,2,0,0,1,3,0,2,0,0,0
5196,58,2018,33,33,0,1.0,99,1095,17,15,1,12,14,1,27,9,2,0,1,13,1,1,0,0,0
5197,59,2018,7,7,0,1.0,100,1095,4,2,1,2,1,1,4,0,2,0,0,0,1,1,0,0,0
5198,60,2018,5,4,1,0.73,73,1095,1,2,1,1,1,1,3,1,0,0,0,0,1,1,0,0,0
5199,61,2018,23,23,0,1.0,99,1095,12,10,1,8,7,1,16,5,2,1,0,4,3,1,0,0,0
5200,62,2018,47,46,1,0.98,97,1095,33,10,3,31,10,3,44,29,2,0,0,10,0,3,0,0,0
5201,63,2018,7,4,3,0.51,51,1095,2,2,0,1,2,0,3,0,1,0,0,2,0,0,0,0,0
5202,64,2018,39,38,1,0.98,98,1095,13,22,3,4,20,2,26,0,0,3,1,18,2,1,1,0,0
5203,65,2018,47,34,13,0.72,72,1095,23,9,2,12,8,2,22,6,3,1,2,7,1,2,0,0,0
5204,66,2018,23,23,0,1.0,100,1095,9,10,4,4,8,2,14,0,3,1,0,6,2,1,0,1,0
5205,67,2018,7,3,4,0.46,45,1095,2,1,0,2,1,0,3,2,0,0,0,1,0,0,0,0,0
5206,68,2018,36,36,0,1.0,100,1095,24,8,4,19,6,1,26,14,5,0,0,4,2,0,0,0,1
5207,69,2018,44,11,33,0.25,24,1095,6,3,2,2,3,1,6,0,1,0,1,3,0,0,1,0,0
5208,70,2018,50,47,3,0.94,93,1095,31,15,1,29,10,1,40,28,0,1,0,5,5,1,0,0,0
5209,71,2018,14,6,8,0.43,42,1095,3,3,0,3,3,0,6,3,0,0,0,3,0,0,0,0,0
5210,72,2018,34,33,1,0.98,98,1095,12,18,3,11,18,1,30,10,1,0,0,18,0,0,0,1,0
5211,73,2018,50,7,43,0.14,14,1095,2,4,1,1,3,1,5,0,1,0,0,2,1,1,0,0,0
5212,74,2018,40,40,0,1.0,100,1095,22,15,3,20,11,3,34,18,2,0,0,7,4,3,0,0,0
5213,75,2018,34,31,3,0.9,90,1095,15,14,2,6,8,1,15,1,3,0,2,2,6,0,1,0,0
5214,76,2018,43,42,1,0.98,98,1095,25,15,2,16,11,2,29,10,3,3,0,7,4,2,0,0,0
5215,77,2018,13,11,2,0.86,86,1095,8,2,1,7,1,1,9,6,1,0,0,0,1,1,0,0,0
5216,78,2018,15,15,0,1.0,99,1095,7,5,3,2,5,2,9,0,0,1,1,5,0,1,1,0,0
5217,79,2018,19,14,5,0.75,74,1095,10,4,0,3,2,0,5,0,1,0,2,0,2,0,0,0,0
5218,80,2018,43,42,1,0.97,96,1095,19,23,0,5,18,0,23,0,0,1,4,13,5,0,0,0,0
5219,81,2018,55,54,1,0.98,97,1095,19,31,4,13,21,4,38,11,0,0,2,11,10,4,0,0,0
5220,82,2018,23,23,0,1.0,100,1095,17,6,0,7,3,0,10,0,4,3,0,0,3,0,0,0,0
5221,83,2018,9,9,0,0.98,97,1095,5,3,1,5,3,1,9,5,0,0,0,3,0,1,0,0,0
5222,84,2018,31,31,0,1.0,100,1095,16,14,1,14,10,1,25,13,0,1,0,6,4,1,0,0,0
5223,85,2018,6,6,0,1.0,100,1095,3,3,0,2,2,0,4,1,1,0,0,1,1,0,0,0,0
5224,86,2018,53,53,0,1.0,99,1095,31,21,1,20,21,1,42,15,2,0,3,21,0,1,0,0,0
5225,87,2018,27,27,0,1.0,99,1095,14,11,2,8,7,2,17,3,4,1,0,3,4,2,0,0,0
5226,88,2018,19,15,4,0.8,79,1095,8,6,1,3,3,1,7,1,0,1,1,0,3,1,0,0,0
5227,89,2018,29,29,0,1.0,100,1095,16,10,3,13,8,1,22,10,3,0,0,6,2,0,0,1,0
5228,90,2018,15,15,0,1.0,99,1095,10,5,0,4,4,0,8,0,2,2,0,3,1,0,0,0,0
5229,91,2018,57,55,2,0.97,96,1095,25,28,2,22,16,1,39,19,3,0,0,4,12,0,1,0,0
5230,92,2018,40,40,0,1.0,100,1095,28,10,2,26,8,1,35,25,0,1,0,6,2,0,1,0,0
5231,93,2018,26,17,9,0.66,65,1095,10,6,1,4,6,1,11,0,3,0,1,6,0,1,0,0,0
5232,94,2018,21,21,0,1.0,100,1095,12,8,1,11,6,1,18,10,1,0,0,4,2,1,0,0,0
5233,95,2018,39,39,0,1.0,100,1095,21,18,0,20,17,0,37,19,1,0,0,16,1,0,0,0,0
5234,96,2018,12,12,0,0.99,98,1095,5,6,1,3,4,1,8,1,2,0,0,2,2,1,0,0,0
5235,97,2018,28,28,0,1.0,99,1095,17,11,0,13,7,0,20,10,2,1,0,3,4,0,0,0,0
5236,98,2018,60,58,2,0.96,95,1095,39,18,1,10,13,1,24,0,0,1,9,8,5,1,0,0,0
5237,99,2018,56,54,2,0.96,96,1095,25,28,1,9,24,1,34,0,3,5,1,20,4,1,0,0,0
5238,100,2018,27,2,25,0.06,6,1095,1,1,0,1,1,0,2,1,0,0,0,1,0,0,0,0,0
5239,101,2018,31,31,0,1.0,100,1095,12,17,2,5,15,1,21,1,2,1,1,13,2,0,1,0,0
5240,102,2018,10,10,0,1.0,100,1095,4,6,0,2,6,0,8,1,0,1,0,6,0,0,0,0,0
5241,103,2018,29,8,21,0.28,27,1095,4,4,0,2,2,0,4,0,2,0,0,0,2,0,0,0,0
5242,104,2018,57,24,33,0.42,42,1095,9,13,2,6,13,1,20,3,3,0,0,13,0,0,1,0,0
5243,105,2018,15,14,1,0.96,95,1095,10,4,0,9,2,0,11,8,1,0,0,0,2,0,0,0,0
5244,106,2018,7,7,0,0.94,93,1095,4,2,1,2,1,1,4,0,2,0,0,0,1,1,0,0,0
5245,107,2018,8,8,0,1.0,100,1095,3,4,1,2,3,1,6,1,1,0,0,2,1,1,0,0,0
5246,108,2018,24,24,0,0.98,98,1095,15,8,1,7,8,1,16,3,1,2,1,8,0,1,0,0,0
5247,109,2018,16,16,0,0.99,98,1095,10,4,2,9,3,1,13,8,1,0,0,2,1,0,1,0,0
5248,110,2018,19,19,0,0.98,97,1095,14,3,2,7,2,1,10,4,1,0,2,1,1,0,1,0,0
5249,111,2018,41,41,0,1.0,100,1095,16,24,1,13,12,1,26,11,1,1,0,0,12,1,0,0,0
5250,112,2018,14,0,14,0.01,1,1095,0,0,0,0,0,0,0,0,0,0,0,0,0,0,0,0,0
5251,113,2018,7,7,0,1.0,100,1095,4,3,0,2,2,0,4,1,0,1,0,1,1,0,0,0,0
5252,114,2018,18,17,1,0.97,97,1095,6,8,3,4,5,2,11,3,0,1,0,2,3,1,1,0,0
5253,115,2018,5,4,1,0.83,82,1095,3,1,0,1,1,0,2,0,0,1,0,1,0,0,0,0,0
5254,116,2018,42,5,37,0.13,13,1095,1,3,1,1,2,1,4,1,0,0,0,1,1,1,0,0,0
5255,117,2018,8,8,0,1.0,100,1095,5,2,1,3,2,1,6,2,0,1,0,2,0,1,0,0,0
5256,118,2018,15,13,2,0.88,88,1095,5,6,2,2,4,1,7,0,1,1,0,2,2,0,1,0,0
5257,119,2018,14,4,10,0.3,29,1095,2,2,0,1,1,0,2,0,1,0,0,0,1,0,0,0,0
5258,120,2018,32,32,0,1.0,100,1095,22,10,0,11,6,0,17,4,4,2,1,2,4,0,0,0,0
5259,121,2018,32,24,8,0.77,76,1095,6,14,4,6,8,3,17,6,0,0,0,2,6,2,1,0,0
5260,122,2018,6,6,0,0.96,96,1095,2,3,1,2,2,1,5,2,0,0,0,1,1,1,0,0,0
5261,123,2018,20,20,0,1.0,99,1095,14,4,2,4,3,1,8,0,1,0,3,2,1,0,1,0,0
5262,124,2018,40,40,0,1.0,100,1095,19,21,0,11,19,0,30,7,0,4,0,17,2,0,0,0,0
5263,125,2018,48,47,1,0.98,97,1095,21,24,2,19,22,2,43,17,2,0,0,20,2,2,0,0,0
5264,126,2018,55,29,26,0.52,51,1095,20,6,3,12,6,2,20,8,0,4,0,6,0,1,1,0,0
5265,127,2018,15,6,9,0.38,38,1095,3,2,1,2,2,1,5,1,1,0,0,2,0,1,0,0,0
5266,128,2018,11,11,0,1.0,99,1095,3,5,3,2,4,2,8,1,1,0,0,3,1,1,1,0,0
5267,129,2018,58,58,0,1.0,100,1095,39,19,0,16,15,0,31,3,7,2,4,11,4,0,0,0,0
5268,130,2018,15,15,0,1.0,100,1095,6,7,2,6,5,1,12,6,0,0,0,3,2,0,1,0,0
5269,131,2018,52,51,1,0.99,98,1095,27,22,2,27,17,2,46,27,0,0,0,12,5,2,0,0,0
5270,132,2018,28,20,8,0.71,70,1095,9,9,2,4,5,2,11,1,1,2,0,1,4,2,0,0,0
5271,133,2018,57,27,30,0.47,47,1095,16,11,0,12,6,0,18,9,2,1,0,1,5,0,0,0,0
5272,134,2018,26,17,9,0.66,66,1095,6,7,4,6,4,4,14,6,0,0,0,1,3,4,0,0,0
5273,135,2018,42,42,0,1.0,100,1095,20,19,3,17,15,1,33,14,3,0,0,11,4,0,0,1,0
5274,136,2018,9,9,0,0.97,96,1095,5,3,1,3,3,1,7,2,0,1,0,3,0,1,0,0,0
5275,137,2018,23,8,15,0.33,33,1095,5,3,0,3,3,0,6,2,0,1,0,3,0,0,0,0,0
5276,138,2018,19,19,0,1.0,100,1095,5,11,3,3,10,2,15,1,2,0,0,9,1,1,1,0,0
5277,139,2018,42,42,0,1.0,100,1095,17,23,2,17,22,2,41,17,0,0,0,21,1,2,0,0,0
5278,140,2018,29,16,13,0.55,54,1095,11,4,1,5,4,1,10,2,0,3,0,4,0,1,0,0,0
5279,141,2018,12,12,0,1.0,100,1095,6,6,0,3,6,0,9,1,1,1,0,6,0,0,0,0,0
5280,142,2018,7,7,0,0.99,98,1095,2,3,2,2,3,1,6,2,0,0,0,3,0,0,1,0,0
5281,143,2018,7,7,0,0.98,97,1095,2,3,2,2,2,2,6,2,0,0,0,1,1,2,0,0,0
5282,144,2018,6,5,1,0.89,89,1095,1,3,1,1,3,1,5,1,0,0,0,3,0,1,0,0,0
5283,145,2018,15,15,0,1.0,100,1095,10,5,0,7,4,0,11,4,3,0,0,3,1,0,0,0,0
5284,146,2018,29,20,9,0.7,69,1095,9,10,1,9,5,1,15,9,0,0,0,0,5,1,0,0,0
5285,147,2018,22,4,18,0.18,18,1095,1,2,1,1,1,1,3,1,0,0,0,0,1,1,0,0,0
5286,148,2018,19,18,1,0.97,97,1095,7,10,1,7,7,1,15,7,0,0,0,4,3,1,0,0,0
5287,149,2018,32,32,0,1.0,99,1095,13,16,3,11,16,1,28,10,0,1,0,16,0,0,0,1,0
5288,150,2018,33,33,0,1.0,99,1095,12,18,3,7,14,1,22,2,5,0,0,10,4,0,0,1,0
5289,151,2018,16,15,1,0.92,91,1095,11,3,1,7,2,1,10,4,2,1,0,1,1,1,0,0,0
5290,152,2018,6,2,4,0.34,34,1095,1,1,0,1,1,0,2,1,0,0,0,1,0,0,0,0,0
5291,153,2018,31,31,0,1.0,100,1095,13,16,2,12,13,1,26,11,1,0,0,10,3,0,1,0,0
5292,154,2018,32,12,20,0.36,36,1095,5,6,1,4,4,1,9,3,1,0,0,2,2,1,0,0,0
5293,155,2018,27,27,0,1.0,100,1095,18,8,1,13,5,1,19,9,3,1,0,2,3,1,0,0,0
5294,156,2018,30,17,13,0.56,55,1095,8,9,0,4,9,0,13,2,0,2,0,9,0,0,0,0,0
5295,157,2018,22,22,0,1.0,100,1095,15,6,1,12,3,1,16,9,3,0,0,0,3,1,0,0,0
5296,158,2018,26,21,5,0.81,81,1095,10,7,4,6,6,2,14,3,2,1,0,5,1,1,0,1,0
5297,159,2018,7,7,0,0.99,98,1095,3,4,0,2,3,0,5,1,1,0,0,2,1,0,0,0,0
5298,160,2018,21,21,0,1.0,99,1095,10,7,4,3,6,3,12,0,0,2,1,5,1,2,1,0,0
5299,161,2018,34,7,27,0.2,19,1095,2,3,2,2,2,2,6,2,0,0,0,1,1,2,0,0,0
5300,162,2018,31,19,12,0.62,61,1095,10,6,3,8,3,2,13,7,0,1,0,0,3,1,1,0,0
5301,163,2018,54,49,5,0.9,90,1095,35,13,1,13,11,1,25,0,6,5,2,9,2,1,0,0,0
5302,164,2018,5,5,0,1.0,100,1095,3,2,0,3,1,0,4,3,0,0,0,0,1,0,0,0,0
5303,165,2018,15,15,0,0.98,97,1095,9,5,1,8,5,1,14,7,1,0,0,5,0,1,0,0,0
5304,166,2018,30,30,0,0.98,98,1095,20,10,0,19,10,0,29,18,1,0,0,10,0,0,0,0,0
5305,167,2018,15,0,15,0.01,1,1095,0,0,0,0,0,0,0,0,0,0,0,0,0,0,0,0,0
5306,168,2018,48,48,0,0.99,99,1095,36,11,1,33,7,1,41,30,3,0,0,3,4,1,0,0,0
5307,169,2018,45,28,17,0.61,61,1095,17,8,3,16,8,1,25,15,1,0,0,8,0,0,0,1,0
5308,170,2018,26,26,0,1.0,100,1095,9,14,3,3,12,1,16,1,0,0,2,10,2,0,0,1,0
5309,171,2018,13,6,7,0.44,43,1095,3,2,1,1,2,1,4,0,0,1,0,2,0,1,0,0,0
5310,172,2018,40,3,37,0.07,6,1095,2,1,0,1,1,0,2,0,1,0,0,1,0,0,0,0,0
5311,173,2018,39,36,3,0.92,92,1095,25,10,1,19,10,1,30,15,3,0,1,10,0,1,0,0,0
5312,174,2018,38,33,5,0.88,87,1095,12,19,2,6,10,2,18,3,0,3,0,1,9,2,0,0,0
5313,175,2018,39,37,2,0.95,95,1095,22,13,2,10,8,1,19,5,1,1,3,3,5,0,1,0,0
5314,176,2018,14,14,0,1.0,100,1095,6,6,2,6,3,2,11,6,0,0,0,0,3,2,0,0,0
5315,177,2018,17,17,0,1.0,100,1095,12,4,1,8,4,1,13,5,2,1,0,4,0,1,0,0,0
5316,178,2018,14,14,0,1.0,99,1095,5,7,2,2,7,2,11,1,0,0,1,7,0,2,0,0,0
5317,179,2018,30,9,21,0.29,29,1095,5,3,1,2,2,1,5,1,0,0,1,1,1,1,0,0,0
5318,180,2018,51,24,27,0.48,47,1095,17,4,3,14,4,3,21,13,0,0,1,4,0,3,0,0,0
5319,181,2018,26,26,0,1.0,99,1095,15,9,2,5,7,2,14,0,0,5,0,5,2,2,0,0,0
5320,182,2018,33,32,1,0.98,98,1095,11,18,3,8,13,3,24,7,0,0,1,8,5,3,0,0,0
5321,183,2018,32,13,19,0.41,40,1095,5,5,3,5,3,2,10,5,0,0,0,1,2,1,1,0,0
5322,184,2018,40,39,1,0.98,97,1095,18,20,1,13,17,1,31,11,0,1,1,14,3,1,0,0,0
5323,185,2018,7,7,0,0.95,94,1095,5,2,0,4,2,0,6,3,1,0,0,2,0,0,0,0,0
5324,186,2018,14,14,0,1.0,99,1095,6,7,1,5,4,1,10,4,1,0,0,1,3,1,0,0,0
5325,187,2018,22,22,0,1.0,100,1095,12,9,1,6,8,1,15,0,6,0,0,7,1,1,0,0,0
5326,188,2018,19,19,0,1.0,100,1095,5,10,4,3,8,3,14,2,0,1,0,6,2,2,1,0,0
5327,189,2018,16,16,0,1.0,100,1095,10,5,1,3,3,1,7,0,0,2,1,1,2,1,0,0,0
5328,190,2018,33,33,0,1.0,100,1095,19,11,3,13,9,3,25,11,0,0,2,7,2,3,0,0,0
5329,191,2018,13,13,0,1.0,100,1095,4,6,3,3,3,2,8,2,1,0,0,0,3,1,1,0,0
5330,192,2018,7,6,1,0.92,91,1095,3,2,1,1,2,1,4,0,0,1,0,2,0,1,0,0,0
5331,193,2018,39,39,0,0.99,98,1095,26,9,4,13,8,1,22,8,0,2,3,7,1,0,0,0,1
5332,194,2018,40,40,0,1.0,100,1095,26,12,2,15,6,2,23,6,8,0,1,0,6,2,0,0,0
5333,195,2018,34,17,17,0.51,51,1095,10,4,3,9,4,2,15,8,1,0,0,4,0,1,1,0,0
5334,196,2018,19,19,0,1.0,100,1095,9,10,0,6,6,0,12,4,1,1,0,2,4,0,0,0,0
5335,197,2018,8,7,1,0.82,82,1095,5,2,0,4,2,0,6,3,1,0,0,2,0,0,0,0,0
5336,198,2018,30,12,18,0.39,38,1095,5,4,3,4,2,1,7,3,1,0,0,0,2,0,0,1,0
5337,199,2018,6,5,1,0.9,90,1095,2,2,1,1,2,1,4,0,1,0,0,2,0,1,0,0,0
5338,200,2018,54,47,7,0.87,87,1095,33,12,2,32,10,1,43,31,1,0,0,8,2,0,1,0,0
5339,201,2018,46,45,1,0.97,96,1095,31,13,1,16,10,1,27,6,5,5,0,7,3,1,0,0,0
5340,202,2018,35,5,30,0.14,13,1095,2,2,1,2,2,1,5,2,0,0,0,2,0,1,0,0,0
5341,203,2018,25,6,19,0.25,25,1095,3,2,1,3,1,1,5,3,0,0,0,0,1,1,0,0,0
5342,204,2018,38,38,0,1.0,100,1095,13,22,3,8,12,1,21,5,2,0,1,2,10,0,0,1,0
5343,205,2018,27,27,0,1.0,99,1095,15,10,2,15,8,2,25,15,0,0,0,6,2,2,0,0,0
5344,206,2018,31,31,0,1.0,100,1095,18,11,2,17,8,1,26,16,1,0,0,5,3,0,1,0,0
5345,207,2018,6,6,0,1.0,100,1095,3,2,1,2,1,1,4,1,1,0,0,0,1,1,0,0,0
5346,208,2018,36,36,0,1.0,100,1095,25,11,0,7,6,0,13,0,0,3,4,1,5,0,0,0,0
5347,209,2018,32,0,32,0.0,0,1095,0,0,0,0,0,0,0,0,0,0,0,0,0,0,0,0,0
5348,210,2018,34,16,18,0.48,47,1095,7,5,4,5,3,4,12,3,2,0,0,1,2,4,0,0,0
5349,211,2018,31,31,0,1.0,100,1095,17,13,1,14,12,1,27,12,1,1,0,11,1,1,0,0,0
5350,212,2018,35,35,0,1.0,100,1095,25,10,0,25,9,0,34,25,0,0,0,8,1,0,0,0,0
5351,213,2018,10,1,9,0.08,7,1095,0,1,0,0,1,0,1,0,0,0,0,1,0,0,0,0,0
5352,214,2018,18,18,0,1.0,100,1095,9,7,2,5,6,2,13,3,0,2,0,5,1,2,0,0,0
5353,215,2018,5,5,0,1.0,100,1095,1,3,1,1,3,1,5,1,0,0,0,3,0,1,0,0,0
5354,216,2018,26,26,0,1.0,100,1095,15,8,3,13,5,2,20,12,0,1,0,2,3,1,1,0,0
5355,217,2018,36,36,0,1.0,100,1095,22,14,0,18,7,0,25,16,0,2,0,0,7,0,0,0,0
5356,218,2018,39,39,0,0.99,98,1095,20,18,1,17,15,1,33,16,0,0,1,12,3,1,0,0,0
5357,219,2018,48,48,0,1.0,100,1095,28,19,1,13,18,1,32,8,0,0,5,17,1,1,0,0,0
5358,220,2018,44,32,12,0.72,72,1095,18,12,2,6,8,2,16,0,1,4,1,4,4,2,0,0,0
5359,221,2018,37,32,5,0.86,86,1095,21,8,3,16,7,3,26,11,5,0,0,6,1,3,0,0,0
5360,222,2018,15,6,9,0.42,42,1095,2,3,1,2,3,1,6,2,0,0,0,3,0,1,0,0,0
5361,223,2018,50,50,0,1.0,100,1095,24,23,3,7,21,2,30,0,2,0,5,19,2,1,1,0,0
5362,224,2018,21,21,0,1.0,99,1095,8,11,2,4,11,1,16,2,0,2,0,11,0,0,1,0,0
5363,225,2018,16,16,0,1.0,100,1095,7,7,2,6,4,1,11,5,1,0,0,1,3,0,1,0,0
5364,226,2018,7,7,0,0.95,94,1095,2,3,2,1,3,1,5,0,1,0,0,3,0,0,1,0,0
5365,227,2018,17,17,0,0.99,98,1095,8,9,0,2,7,0,9,0,0,0,2,5,2,0,0,0,0
5366,228,2018,11,8,3,0.71,70,1095,3,3,2,1,2,1,4,0,0,1,0,1,1,0,1,0,0
5367,229,2018,14,14,0,1.0,99,1095,7,4,3,4,2,2,8,1,3,0,0,0,2,1,1,0,0
5368,230,2018,22,20,2,0.89,89,1095,14,5,1,7,5,1,13,0,7,0,0,5,0,1,0,0,0
5369,231,2018,17,14,3,0.84,84,1095,6,6,2,2,6,1,9,0,0,2,0,6,0,0,1,0,0
5370,232,2018,30,28,2,0.93,92,1095,20,6,2,19,4,2,25,18,1,0,0,2,2,2,0,0,0
5371,233,2018,16,9,7,0.58,58,1095,6,2,1,5,1,1,7,4,1,0,0,0,1,1,0,0,0
5372,234,2018,24,3,21,0.12,11,1095,1,2,0,1,2,0,3,1,0,0,0,2,0,0,0,0,0
5373,235,2018,22,22,0,1.0,100,1095,11,11,0,8,6,0,14,5,3,0,0,1,5,0,0,0,0
5374,236,2018,14,14,0,0.98,97,1095,6,5,3,5,5,2,12,4,1,0,0,5,0,1,1,0,0
5375,237,2018,42,5,37,0.11,10,1095,1,3,1,1,2,1,4,1,0,0,0,1,1,1,0,0,0
5376,238,2018,17,16,1,0.93,92,1095,11,4,1,11,4,1,16,11,0,0,0,4,0,1,0,0,0
5377,239,2018,12,1,11,0.08,7,1095,0,1,0,0,1,0,1,0,0,0,0,1,0,0,0,0,0
5378,240,2018,28,28,0,0.99,99,1095,8,16,4,2,14,2,18,0,0,0,2,12,2,0,2,0,0
5379,241,2018,18,18,0,1.0,100,1095,9,8,1,7,4,1,12,6,0,1,0,0,4,1,0,0,0
5380,242,2018,55,55,0,1.0,100,1095,36,17,2,18,13,2,33,8,5,2,3,9,4,2,0,0,0
5381,243,2018,22,16,6,0.73,72,1095,11,4,1,7,3,1,11,3,4,0,0,2,1,1,0,0,0
5382,244,2018,53,52,1,0.98,97,1095,23,28,1,8,18,1,27,3,0,0,5,8,10,1,0,0,0
5383,245,2018,46,46,0,0.99,98,1095,20,24,2,6,20,1,27,0,2,0,4,16,4,0,1,0,0
5384,246,2018,30,30,0,1.0,100,1095,17,9,4,12,9,2,23,9,1,2,0,9,0,0,2,0,0
5385,247,2018,39,27,12,0.69,69,1095,11,15,1,9,15,1,25,8,0,1,0,15,0,1,0,0,0
5386,248,2018,15,15,0,1.0,100,1095,11,4,0,7,4,0,11,3,4,0,0,4,0,0,0,0,0
5387,249,2018,13,13,0,1.0,99,1095,4,7,2,2,7,2,11,1,0,1,0,7,0,2,0,0,0
5388,250,2018,46,45,1,0.97,97,1095,32,10,3,22,6,3,31,18,0,2,2,2,4,3,0,0,0
5389,251,2018,51,42,9,0.83,83,1095,28,14,0,15,11,0,26,7,5,1,2,8,3,0,0,0,0
5390,252,2018,11,7,4,0.68,67,1095,3,3,1,3,3,1,7,3,0,0,0,3,0,1,0,0,0
5391,253,2018,57,55,2,0.97,97,1095,33,19,3,19,19,1,39,7,10,2,0,19,0,0,0,1,0
5392,254,2018,30,30,0,1.0,99,1095,21,7,2,7,7,2,16,1,0,4,2,7,0,2,0,0,0
5393,255,2018,35,35,0,1.0,99,1095,23,11,1,15,8,1,24,9,4,2,0,5,3,1,0,0,0
5394,256,2018,34,7,27,0.19,19,1095,3,4,0,2,2,0,4,1,1,0,0,0,2,0,0,0,0
5395,257,2018,15,15,0,1.0,100,1095,7,6,2,3,6,2,11,1,1,0,1,6,0,2,0,0,0
5396,258,2018,37,33,4,0.89,89,1095,19,13,1,16,11,1,28,14,1,1,0,9,2,1,0,0,0
5397,259,2018,14,1,13,0.1,10,1095,0,1,0,0,1,0,1,0,0,0,0,1,0,0,0,0,0
5398,260,2018,56,36,20,0.65,64,1095,21,15,0,6,15,0,21,0,1,1,4,15,0,0,0,0,0
5399,261,2018,7,7,0,0.97,97,1095,4,2,1,4,2,1,7,4,0,0,0,2,0,1,0,0,0
5400,262,2018,30,21,9,0.71,70,1095,13,7,1,8,4,1,13,3,5,0,0,1,3,1,0,0,0
5401,263,2018,29,29,0,0.99,99,1095,16,10,3,8,5,2,15,5,0,1,2,0,5,1,1,0,0
5402,264,2018,25,25,0,1.0,99,1095,12,11,2,7,6,2,15,4,1,2,0,1,5,2,0,0,0
5403,265,2018,23,23,0,1.0,100,1095,15,7,1,11,5,1,17,8,2,1,0,3,2,1,0,0,0
5404,266,2018,25,19,6,0.77,76,1095,12,5,2,9,3,2,14,8,0,0,1,1,2,2,0,0,0
5405,267,2018,12,12,0,0.99,98,1095,4,5,3,4,4,3,11,4,0,0,0,3,1,3,0,0,0
5406,268,2018,19,19,0,1.0,100,1095,12,7,0,3,7,0,10,0,0,0,3,7,0,0,0,0,0
5407,269,2018,32,1,31,0.02,2,1095,0,1,0,0,1,0,1,0,0,0,0,1,0,0,0,0,0
5408,270,2018,35,34,1,0.98,97,1095,23,9,2,9,9,1,19,3,0,4,2,9,0,0,1,0,0
5409,271,2018,30,30,0,1.0,100,1095,11,18,1,10,9,1,20,9,1,0,0,0,9,1,0,0,0
5410,272,2018,46,46,0,1.0,99,1095,31,12,3,10,6,3,19,1,3,0,6,0,6,3,0,0,0
5411,273,2018,14,14,0,1.0,100,1095,7,4,3,4,4,3,11,2,1,1,0,4,0,3,0,0,0
5412,274,2018,19,19,0,1.0,100,1095,10,7,2,5,7,2,14,2,1,2,0,7,0,2,0,0,0
5413,275,2018,11,5,6,0.44,43,1095,2,2,1,2,2,1,5,2,0,0,0,2,0,1,0,0,0
5414,276,2018,31,30,1,0.98,97,1095,22,7,1,20,4,1,25,19,0,1,0,1,3,1,0,0,0
5415,277,2018,28,28,0,1.0,100,1095,12,14,2,12,11,1,24,12,0,0,0,8,3,0,1,0,0
5416,278,2018,31,30,1,0.96,95,1095,11,18,1,4,9,1,14,0,2,1,1,0,9,1,0,0,0
5417,279,2018,21,12,9,0.56,56,1095,3,6,3,3,5,2,10,3,0,0,0,4,1,1,1,0,0
5418,280,2018,15,15,0,1.0,100,1095,6,7,2,2,5,2,9,0,1,0,1,3,2,2,0,0,0
5419,281,2018,39,39,0,1.0,99,1095,16,19,4,5,17,4,26,0,2,0,3,15,2,4,0,0,0
5420,282,2018,49,46,3,0.93,93,1095,32,13,1,27,13,1,41,23,3,1,0,13,0,1,0,0,0
5421,283,2018,20,2,18,0.11,10,1095,1,1,0,1,1,0,2,1,0,0,0,1,0,0,0,0,0
5422,284,2018,11,1,10,0.09,9,1095,0,1,0,0,1,0,1,0,0,0,0,1,0,0,0,0,0
5423,285,2018,48,48,0,1.0,99,1095,25,22,1,22,16,1,39,20,1,1,0,10,6,1,0,0,0
5424,286,2018,28,6,22,0.21,20,1095,2,3,1,2,3,1,6,2,0,0,0,3,0,1,0,0,0
5425,287,2018,15,15,0,0.97,97,1095,7,5,3,3,3,3,9,1,1,0,1,1,2,3,0,0,0
5426,288,2018,37,34,3,0.92,91,1095,19,11,4,11,7,1,19,5,4,2,0,3,4,0,0,0,1
5427,289,2018,20,19,1,0.93,93,1095,11,6,2,6,3,1,10,4,0,1,1,0,3,0,1,0,0
5428,290,2018,22,22,0,1.0,99,1095,11,9,2,4,6,1,11,1,0,2,1,3,3,0,1,0,0
5429,291,2018,39,39,0,1.0,100,1095,17,21,1,9,20,1,30,3,5,0,1,19,1,1,0,0,0
5430,292,2018,15,15,0,1.0,100,1095,7,6,2,5,3,1,9,4,0,1,0,0,3,0,1,0,0
5431,293,2018,20,20,0,1.0,100,1095,4,12,4,2,8,3,13,0,2,0,0,4,4,2,1,0,0
5432,294,2018,22,22,0,0.99,98,1095,16,4,2,8,2,1,11,4,1,2,1,0,2,0,1,0,0
5433,295,2018,49,21,28,0.42,41,1095,5,12,4,2,7,4,13,1,0,0,1,2,5,4,0,0,0
5434,296,2018,18,0,18,0.03,2,1095,0,0,0,0,0,0,0,0,0,0,0,0,0,0,0,0,0
5435,297,2018,35,31,4,0.89,89,1095,14,16,1,13,14,1,28,12,1,0,0,12,2,1,0,0,0
5436,298,2018,44,42,2,0.96,96,1095,24,16,2,9,14,2,25,2,1,4,2,12,2,2,0,0,0
5437,299,2018,33,33,0,1.0,100,1095,19,10,4,11,6,2,19,7,1,2,1,2,4,1,0,1,0
5438,300,2018,25,24,1,0.94,94,1095,14,8,2,8,6,1,15,4,3,0,1,4,2,0,1,0,0
5439,301,2018,30,30,0,1.0,99,1095,12,16,2,6,12,2,20,2,2,2,0,8,4,2,0,0,0
5440,302,2018,29,27,2,0.94,94,1095,16,10,1,7,8,1,16,3,0,3,1,6,2,1,0,0,0
5441,303,2018,56,56,0,1.0,100,1095,30,24,2,25,20,2,47,23,0,1,1,16,4,2,0,0,0
5442,304,2018,47,20,27,0.44,43,1095,13,5,2,8,5,2,15,5,1,2,0,5,0,2,0,0,0
5443,305,2018,18,18,0,0.98,98,1095,9,8,1,3,8,1,12,1,0,0,2,8,0,1,0,0,0
5444,306,2018,49,49,0,1.0,100,1095,30,19,0,9,18,0,27,1,1,1,6,17,1,0,0,0,0
5445,307,2018,35,35,0,1.0,99,1095,21,13,1,14,11,1,26,10,2,1,1,9,2,1,0,0,0
5446,308,2018,13,13,0,1.0,99,1095,4,5,4,1,5,3,9,0,0,0,1,5,0,2,1,0,0
5447,309,2018,10,9,1,0.9,89,1095,4,3,2,4,3,2,9,4,0,0,0,3,0,2,0,0,0
5448,310,2018,37,0,37,0.0,0,1095,0,0,0,0,0,0,0,0,0,0,0,0,0,0,0,0,0
5449,311,2018,30,30,0,1.0,100,1095,15,13,2,14,9,2,25,13,1,0,0,5,4,2,0,0,0
5450,312,2018,11,11,0,0.99,98,1095,3,5,3,3,3,3,9,3,0,0,0,1,2,3,0,0,0
5451,313,2018,60,60,0,1.0,100,1095,40,17,3,14,16,3,33,2,0,10,2,15,1,3,0,0,0
5452,314,2018,9,9,0,1.0,100,1095,2,5,2,2,3,1,6,2,0,0,0,1,2,0,1,0,0
5453,315,2018,54,54,0,1.0,100,1095,33,20,1,18,14,1,33,7,8,2,1,8,6,1,0,0,0
5454,316,2018,15,15,0,1.0,100,1095,7,5,3,5,4,1,10,3,2,0,0,3,1,0,0,1,0
5455,317,2018,41,41,0,1.0,99,1095,18,20,3,18,14,3,35,18,0,0,0,8,6,3,0,0,0
5456,318,2018,26,26,0,1.0,100,1095,18,5,3,15,4,1,20,14,0,0,1,3,1,0,0,1,0
5457,319,2018,7,7,0,1.0,100,1095,3,3,1,1,2,1,4,0,0,1,0,1,1,1,0,0,0
5458,320,2018,28,27,1,0.98,97,1095,13,12,2,13,6,2,21,13,0,0,0,0,6,2,0,0,0
5459,321,2018,5,5,0,1.0,100,1095,1,3,1,1,2,1,4,1,0,0,0,1,1,1,0,0,0
5460,322,2018,14,14,0,0.99,99,1095,10,4,0,3,3,0,6,0,1,0,2,2,1,0,0,0,0
5461,323,2018,57,51,6,0.89,89,1095,26,23,2,19,12,1,32,15,2,1,1,1,11,0,1,0,0
5462,324,2018,26,19,7,0.74,74,1095,7,10,2,4,9,2,15,1,3,0,0,8,1,2,0,0,0
5463,325,2018,25,25,0,1.0,100,1095,12,11,2,3,9,2,14,0,0,0,3,7,2,2,0,0,0
5464,326,2018,27,26,1,0.98,97,1095,10,12,4,7,11,4,22,4,3,0,0,10,1,4,0,0,0
5465,327,2018,52,52,0,1.0,99,1095,25,25,2,19,22,2,43,17,0,0,2,19,3,2,0,0,0
5466,328,2018,9,8,1,0.9,89,1095,4,4,0,1,2,0,3,0,0,0,1,0,2,0,0,0,0
5467,329,2018,25,25,0,1.0,100,1095,14,10,1,10,5,1,16,7,2,1,0,0,5,1,0,0,0
5468,330,2018,30,29,1,0.97,96,1095,18,10,1,11,5,1,17,7,2,1,1,0,5,1,0,0,0
5469,331,2018,59,59,0,1.0,99,1095,24,33,2,20,33,2,55,18,0,2,0,33,0,2,0,0,0
5470,332,2018,43,13,30,0.31,30,1095,5,5,3,2,3,1,6,1,0,0,1,1,2,0,0,1,0
5471,333,2018,27,8,19,0.31,31,1095,5,2,1,4,2,1,7,3,1,0,0,2,0,1,0,0,0
5472,334,2018,24,21,3,0.88,88,1095,11,7,3,11,5,1,17,11,0,0,0,3,2,0,0,1,0
5473,335,2018,58,58,0,1.0,100,1095,34,21,3,28,18,2,48,24,2,2,0,15,3,1,1,0,0
5474,336,2018,40,40,0,1.0,100,1095,20,16,4,20,13,4,37,20,0,0,0,10,3,4,0,0,0
5475,337,2018,31,17,14,0.55,54,1095,5,9,3,4,9,3,16,3,1,0,0,9,0,3,0,0,0
5476,338,2018,15,15,0,0.99,99,1095,7,6,2,7,6,2,15,7,0,0,0,6,0,2,0,0,0
5477,339,2018,23,23,0,0.99,98,1095,6,13,4,2,11,4,17,0,0,2,0,9,2,4,0,0,0
5478,340,2018,38,38,0,1.0,100,1095,17,18,3,9,10,1,20,5,0,4,0,2,8,0,0,1,0
5479,341,2018,27,27,0,1.0,100,1095,8,15,4,7,15,1,23,6,1,0,0,15,0,0,0,0,1
5480,342,2018,8,8,0,0.94,94,1095,2,4,2,1,3,1,5,0,1,0,0,2,1,0,1,0,0
5481,343,2018,50,47,3,0.95,94,1095,30,15,2,27,10,1,38,26,0,0,1,5,5,0,1,0,0
5482,344,2018,23,23,0,1.0,100,1095,12,10,1,6,7,1,14,4,0,0,2,4,3,1,0,0,0
5483,345,2018,40,40,0,1.0,100,1095,14,22,4,7,18,1,26,3,2,1,1,14,4,0,0,0,1
5484,346,2018,48,48,0,1.0,100,1095,17,28,3,12,26,1,39,8,3,1,0,24,2,0,0,1,0
5485,347,2018,21,21,0,1.0,100,1095,13,7,1,12,5,1,18,11,1,0,0,3,2,1,0,0,0
5486,348,2018,38,38,0,0.99,98,1095,25,10,3,22,5,2,29,20,1,1,0,0,5,1,1,0,0
5487,349,2018,24,24,0,1.0,100,1095,15,8,1,10,6,1,17,6,3,1,0,4,2,1,0,0,0
5488,350,2018,39,39,0,1.0,99,1095,21,18,0,14,10,0,24,11,1,0,2,2,8,0,0,0,0
5489,351,2018,29,12,17,0.41,40,1095,9,2,1,8,2,1,11,7,1,0,0,2,0,1,0,0,0
5490,352,2018,36,36,0,1.0,100,1095,22,10,4,17,7,4,28,12,5,0,0,4,3,4,0,0,0
5491,353,2018,39,39,0,1.0,100,1095,15,23,1,13,20,1,34,11,2,0,0,17,3,1,0,0,0
5492,354,2018,15,8,7,0.53,53,1095,4,4,0,2,2,0,4,1,0,1,0,0,2,0,0,0,0
5493,355,2018,22,22,0,1.0,100,1095,16,6,0,13,3,0,16,11,1,1,0,0,3,0,0,0,0
5494,356,2018,31,31,0,0.99,99,1095,15,16,0,7,12,0,19,0,6,1,0,8,4,0,0,0,0
5495,357,2018,26,22,4,0.84,84,1095,9,9,4,5,6,2,13,1,4,0,0,3,3,0,2,0,0
5496,358,2018,49,0,49,0.01,1,1095,0,0,0,0,0,0,0,0,0,0,0,0,0,0,0,0,0
5497,359,2018,36,31,5,0.87,87,1095,20,9,2,20,8,2,30,20,0,0,0,7,1,2,0,0,0
5498,360,2018,37,34,3,0.91,91,1095,22,11,1,9,8,1,18,4,0,2,3,5,3,1,0,0,0
5499,361,2018,27,10,17,0.38,37,1095,3,5,2,1,5,1,7,0,0,1,0,5,0,0,1,0,0
5500,362,2018,18,10,8,0.55,54,1095,5,4,1,5,2,1,8,5,0,0,0,0,2,1,0,0,0
5501,363,2018,34,34,0,1.0,100,1095,23,10,1,19,5,1,25,17,0,2,0,0,5,1,0,0,0
5502,364,2018,35,35,0,0.99,99,1095,20,14,1,19,12,1,32,18,1,0,0,10,2,1,0,0,0
5503,365,2018,25,25,0,1.0,99,1095,14,8,3,6,6,1,13,2,1,2,1,4,2,0,0,1,0
5504,366,2018,9,5,4,0.57,56,1095,2,2,1,2,2,1,5,2,0,0,0,2,0,1,0,0,0
5505,367,2018,12,12,0,1.0,99,1095,6,6,0,4,5,0,9,2,2,0,0,4,1,0,0,0,0
5506,368,2018,58,25,33,0.43,42,1095,14,9,2,14,7,1,22,14,0,0,0,5,2,0,1,0,0
5507,369,2018,51,50,1,0.99,98,1095,24,25,1,22,16,1,39,20,2,0,0,7,9,1,0,0,0
5508,370,2018,28,3,25,0.09,9,1095,2,1,0,1,1,0,2,0,1,0,0,1,0,0,0,0,0
5509,371,2018,15,15,0,1.0,99,1095,8,4,3,4,4,1,9,2,1,0,1,4,0,0,0,1,0
5510,372,2018,6,1,5,0.14,14,1095,0,1,0,0,1,0,1,0,0,0,0,1,0,0,0,0,0
5511,373,2018,16,15,1,0.95,94,1095,9,5,1,8,4,1,13,7,1,0,0,3,1,1,0,0,0
5512,374,2018,16,16,0,1.0,99,1095,5,9,2,2,5,1,8,1,0,0,1,1,4,0,1,0,0
5513,375,2018,33,4,29,0.12,12,1095,1,2,1,1,2,1,4,1,0,0,0,2,0,1,0,0,0
5514,376,2018,36,14,22,0.39,39,1095,9,4,1,6,3,1,10,4,1,1,0,2,1,1,0,0,0
5515,377,2018,9,9,0,1.0,100,1095,3,4,2,1,2,1,4,0,0,1,0,0,2,0,1,0,0
5516,378,2018,14,14,0,1.0,100,1095,9,3,2,4,3,2,9,2,0,1,1,3,0,2,0,0,0
5517,379,2018,43,42,1,0.98,98,1095,18,20,4,14,13,3,30,12,0,2,0,6,7,2,1,0,0
5518,380,2018,42,31,11,0.73,73,1095,13,14,4,5,10,2,17,0,2,3,0,6,4,0,2,0,0
5519,381,2018,31,31,0,0.99,99,1095,20,10,1,19,9,1,29,18,1,0,0,8,1,1,0,0,0
5520,382,2018,40,40,0,0.99,99,1095,24,14,2,17,11,2,30,13,1,3,0,8,3,2,0,0,0
5521,383,2018,20,20,0,0.98,97,1095,9,10,1,7,7,1,15,5,2,0,0,4,3,1,0,0,0
5522,384,2018,42,41,1,0.98,97,1095,20,20,1,14,17,1,32,10,3,0,1,14,3,1,0,0,0
5523,385,2018,18,18,0,1.0,100,1095,6,10,2,3,6,1,10,2,0,0,1,2,4,0,1,0,0
5524,386,2018,56,45,11,0.8,79,1095,33,10,2,18,6,2,26,7,9,0,2,2,4,2,0,0,0
5525,387,2018,58,48,10,0.82,82,1095,28,19,1,28,17,1,46,28,0,0,0,15,2,1,0,0,0
5526,388,2018,32,28,4,0.88,88,1095,13,12,3,11,6,2,19,9,2,0,0,0,6,1,1,0,0
5527,389,2018,50,38,12,0.77,76,1095,22,13,3,18,10,3,31,16,0,2,0,7,3,3,0,0,0
5528,390,2018,34,13,21,0.38,38,1095,8,4,1,8,3,1,12,8,0,0,0,2,1,1,0,0,0
5529,391,2018,39,39,0,1.0,99,1095,23,15,1,22,13,1,36,21,1,0,0,11,2,1,0,0,0
5530,392,2018,15,9,6,0.63,62,1095,6,2,1,4,1,1,6,3,0,1,0,0,1,1,0,0,0
5531,393,2018,9,9,0,0.98,98,1095,4,4,1,4,2,1,7,4,0,0,0,0,2,1,0,0,0
5532,394,2018,31,4,27,0.13,12,1095,1,2,1,1,2,1,4,1,0,0,0,2,0,1,0,0,0
5533,395,2018,11,11,0,1.0,100,1095,6,3,2,3,3,2,8,0,3,0,0,3,0,2,0,0,0
5534,396,2018,31,31,0,1.0,100,1095,18,9,4,14,8,2,24,12,0,2,0,7,1,1,0,1,0
5535,397,2018,53,52,1,0.98,98,1095,22,28,2,13,25,2,40,10,0,0,3,22,3,2,0,0,0
5536,398,2018,15,15,0,1.0,100,1095,11,3,1,10,3,1,14,9,1,0,0,3,0,1,0,0,0
5537,399,2018,36,36,0,1.0,100,1095,26,7,3,26,4,3,33,26,0,0,0,1,3,3,0,0,0
5538,400,2018,25,24,1,0.94,94,1095,11,10,3,11,10,3,24,11,0,0,0,10,0,3,0,0,0
5539,401,2018,22,22,0,1.0,100,1095,7,12,3,2,10,2,14,0,0,1,1,8,2,1,1,0,0
5540,402,2018,57,57,0,1.0,100,1095,35,19,3,9,10,1,20,0,0,1,8,1,9,0,0,1,0
5541,403,2018,28,28,0,0.99,98,1095,15,10,3,4,9,1,14,0,0,1,3,8,1,0,0,1,0
5542,404,2018,9,9,0,1.0,100,1095,5,4,0,3,4,0,7,2,0,1,0,4,0,0,0,0,0
5543,405,2018,57,52,5,0.92,92,1095,25,26,1,8,26,1,35,1,1,2,4,26,0,1,0,0,0
5544,406,2018,39,38,1,0.98,98,1095,13,22,3,9,21,2,32,6,2,1,0,20,1,1,1,0,0
5545,407,2018,9,5,4,0.52,51,1095,3,2,0,2,2,0,4,1,1,0,0,2,0,0,0,0,0
5546,408,2018,39,39,0,1.0,100,1095,21,15,3,20,10,1,31,19,1,0,0,5,5,0,0,1,0
5547,409,2018,16,16,0,1.0,100,1095,8,8,0,7,8,0,15,6,1,0,0,8,0,0,0,0,0
5548,410,2018,52,51,1,0.98,98,1095,35,15,1,35,15,1,51,35,0,0,0,15,0,1,0,0,0
5549,411,2018,52,52,0,1.0,99,1095,24,26,2,6,18,1,25,0,0,0,6,10,8,0,1,0,0
5550,412,2018,55,55,0,1.0,100,1095,31,23,1,15,16,1,32,6,3,5,1,9,7,1,0,0,0
5551,413,2018,9,9,0,1.0,100,1095,3,5,1,2,3,1,6,1,1,0,0,1,2,1,0,0,0
5552,414,2018,9,9,0,1.0,100,1095,6,2,1,4,1,1,6,3,0,1,0,0,1,1,0,0,0
5553,415,2018,8,7,1,0.87,86,1095,3,3,1,3,3,1,7,3,0,0,0,3,0,1,0,0,0
5554,416,2018,26,0,26,0.01,1,1095,0,0,0,0,0,0,0,0,0,0,0,0,0,0,0,0,0
5555,417,2018,48,47,1,0.98,97,1095,33,10,4,27,5,2,34,22,4,1,0,0,5,0,2,0,0
5556,418,2018,28,6,22,0.2,20,1095,3,3,0,2,3,0,5,1,1,0,0,3,0,0,0,0,0
5557,419,2018,20,18,2,0.89,89,1095,11,5,2,4,5,2,11,0,1,3,0,5,0,2,0,0,0
5558,420,2018,14,14,0,1.0,100,1095,10,3,1,8,2,1,11,6,2,0,0,1,1,1,0,0,0
5559,421,2018,16,16,0,0.98,97,1095,10,5,1,7,5,1,13,5,1,1,0,5,0,1,0,0,0
5560,422,2018,15,9,6,0.59,58,1095,3,4,2,1,4,1,6,0,0,1,0,4,0,0,1,0,0
5561,423,2018,13,12,1,0.89,89,1095,5,6,1,5,5,1,11,5,0,0,0,4,1,1,0,0,0
5562,424,2018,27,10,17,0.37,36,1095,4,4,2,4,3,2,9,4,0,0,0,2,1,2,0,0,0
5563,425,2018,20,9,11,0.44,43,1095,3,5,1,3,5,1,9,3,0,0,0,5,0,1,0,0,0
5564,426,2018,44,43,1,0.97,97,1095,19,24,0,13,12,0,25,10,1,1,1,0,12,0,0,0,0
5565,427,2018,19,18,1,0.96,95,1095,13,3,2,9,3,1,13,6,2,1,0,3,0,0,1,0,0
5566,428,2018,33,4,29,0.13,12,1095,1,2,1,1,2,1,4,1,0,0,0,2,0,1,0,0,0
5567,429,2018,8,4,4,0.46,45,1095,1,2,1,1,2,1,4,1,0,0,0,2,0,1,0,0,0
5568,430,2018,11,11,0,0.98,97,1095,7,3,1,5,3,1,9,4,0,1,0,3,0,1,0,0,0
5569,431,2018,55,29,26,0.53,53,1095,20,8,1,11,5,1,17,6,1,4,0,2,3,1,0,0,0
5570,432,2018,36,36,0,0.99,98,1095,21,11,4,12,6,1,19,8,1,1,2,1,5,0,0,0,1
5571,433,2018,19,18,1,0.96,95,1095,13,4,1,10,2,1,13,9,0,0,1,0,2,1,0,0,0
5572,434,2018,14,14,0,1.0,100,1095,6,5,3,3,3,1,7,1,1,1,0,1,2,0,0,1,0
5573,435,2018,17,17,0,1.0,100,1095,9,5,3,7,5,1,13,5,2,0,0,5,0,0,0,1,0
5574,436,2018,40,39,1,0.99,98,1095,25,13,1,10,8,1,19,3,2,2,3,3,5,1,0,0,0
5575,437,2018,11,11,0,1.0,99,1095,4,6,1,4,3,1,8,4,0,0,0,0,3,1,0,0,0
5576,438,2018,9,9,0,1.0,100,1095,4,4,1,3,2,1,6,2,1,0,0,0,2,1,0,0,0
5577,439,2018,30,5,25,0.17,16,1095,2,2,1,1,2,1,4,0,1,0,0,2,0,1,0,0,0
5578,440,2018,31,31,0,1.0,100,1095,12,18,1,5,12,1,18,1,2,1,1,6,6,1,0,0,0
5579,441,2018,6,0,6,0.01,1,1095,0,0,0,0,0,0,0,0,0,0,0,0,0,0,0,0,0
5580,442,2018,36,35,1,0.98,97,1095,20,14,1,16,9,1,26,14,0,2,0,4,5,1,0,0,0
5581,443,2018,52,48,4,0.92,91,1095,18,27,3,10,18,2,30,6,0,4,0,9,9,1,1,0,0
5582,444,2018,40,36,4,0.9,90,1095,17,18,1,9,14,1,24,2,6,1,0,10,4,1,0,0,0
5583,445,2018,6,6,0,0.99,98,1095,3,2,1,1,1,1,3,0,0,1,0,0,1,1,0,0,0
5584,446,2018,40,12,28,0.29,28,1095,9,2,1,7,1,1,9,6,0,1,0,0,1,1,0,0,0
5585,447,2018,28,25,3,0.88,87,1095,18,6,1,13,6,1,20,11,0,1,1,6,0,1,0,0,0
5586,448,2018,31,19,12,0.62,62,1095,9,7,3,3,4,1,8,0,0,3,0,1,3,0,0,1,0
5587,449,2018,22,22,0,1.0,99,1095,15,6,1,15,5,1,21,15,0,0,0,4,1,1,0,0,0
5588,450,2018,11,11,0,1.0,100,1095,4,4,3,4,3,2,9,4,0,0,0,2,1,1,1,0,0
5589,451,2018,20,15,5,0.73,72,1095,3,9,3,2,7,3,12,1,1,0,0,5,2,3,0,0,0
5590,452,2018,39,6,33,0.17,16,1095,2,3,1,2,2,1,5,2,0,0,0,1,1,1,0,0,0
5591,453,2018,37,36,1,0.98,97,1095,27,6,3,21,6,1,28,18,1,1,1,6,0,0,0,1,0
5592,454,2018,55,55,0,1.0,100,1095,36,16,3,18,16,1,35,6,8,2,2,16,0,0,0,1,0
5593,455,2018,20,18,2,0.88,87,1095,8,10,0,5,8,0,13,4,0,0,1,6,2,0,0,0,0
5594,456,2018,31,31,0,1.0,100,1095,18,13,0,8,12,0,20,0,6,2,0,11,1,0,0,0,0
5595,457,2018,19,19,0,1.0,100,1095,10,6,3,4,6,2,12,0,3,0,1,6,0,1,1,0,0
5596,458,2018,37,37,0,1.0,99,1095,26,8,3,14,7,2,23,3,10,1,0,6,1,1,1,0,0
5597,459,2018,40,40,0,1.0,100,1095,27,10,3,19,6,3,28,14,2,3,0,2,4,3,0,0,0
5598,460,2018,44,43,1,0.99,98,1095,23,20,0,8,11,0,19,0,3,3,2,2,9,0,0,0,0
5599,461,2018,5,5,0,0.98,98,1095,3,2,0,3,2,0,5,3,0,0,0,2,0,0,0,0,0
5600,462,2018,25,25,0,1.0,100,1095,15,7,3,4,5,2,11,0,0,1,3,3,2,1,1,0,0
5601,463,2018,13,13,0,1.0,99,1095,4,8,1,1,7,1,9,0,0,0,1,6,1,1,0,0,0
5602,464,2018,26,26,0,0.99,98,1095,16,9,1,13,9,1,23,11,1,1,0,9,0,1,0,0,0
5603,465,2018,24,13,11,0.55,54,1095,6,5,2,5,3,2,10,4,1,0,0,1,2,2,0,0,0
5604,466,2018,11,0,11,0.0,0,1095,0,0,0,0,0,0,0,0,0,0,0,0,0,0,0,0,0
5605,467,2018,11,9,2,0.86,85,1095,3,4,2,1,2,1,4,0,0,1,0,0,2,0,1,0,0
5606,468,2018,7,2,5,0.23,23,1095,1,1,0,1,1,0,2,1,0,0,0,1,0,0,0,0,0
5607,469,2018,34,34,0,1.0,99,1095,22,8,4,13,8,3,24,6,6,0,1,8,0,2,1,0,0
5608,470,2018,33,28,5,0.86,85,1095,20,6,2,9,4,1,14,0,7,2,0,2,2,0,1,0,0
5609,471,2018,36,20,16,0.54,54,1095,11,7,2,11,7,2,20,11,0,0,0,7,0,2,0,0,0
5610,472,2018,31,31,0,0.99,99,1095,19,11,1,7,9,1,17,2,1,1,3,7,2,1,0,0,0
5611,473,2018,48,46,2,0.96,95,1095,19,24,3,8,14,3,25,2,3,1,2,4,10,3,0,0,0
5612,474,2018,21,21,0,1.0,100,1095,8,9,4,7,6,2,15,6,1,0,0,3,3,0,2,0,0
5613,475,2018,19,4,15,0.2,19,1095,1,2,1,1,1,1,3,1,0,0,0,0,1,1,0,0,0
5614,476,2018,20,5,15,0.26,25,1095,4,1,0,2,1,0,3,0,2,0,0,1,0,0,0,0,0
5615,477,2018,21,0,21,0.01,1,1095,0,0,0,0,0,0,0,0,0,0,0,0,0,0,0,0,0
5616,478,2018,30,29,1,0.97,96,1095,15,13,1,6,7,1,14,2,0,3,1,1,6,1,0,0,0
5617,479,2018,7,7,0,1.0,100,1095,4,3,0,2,3,0,5,0,2,0,0,3,0,0,0,0,0
5618,480,2018,45,45,0,1.0,99,1095,32,9,4,19,5,2,26,11,5,1,2,1,4,1,0,1,0
5619,481,2018,51,51,0,1.0,100,1095,20,28,3,7,20,3,30,0,4,0,3,12,8,3,0,0,0
5620,482,2018,10,4,6,0.38,38,1095,2,2,0,1,2,0,3,0,1,0,0,2,0,0,0,0,0
5621,483,2018,30,30,0,1.0,99,1095,16,11,3,10,9,2,21,5,4,1,0,7,2,1,1,0,0
5622,484,2018,9,9,0,0.98,97,1095,4,3,2,4,3,2,9,4,0,0,0,3,0,2,0,0,0
5623,485,2018,24,15,9,0.64,64,1095,8,7,0,6,6,0,12,5,0,1,0,5,1,0,0,0,0
5624,486,2018,22,2,20,0.08,8,1095,1,1,0,1,1,0,2,1,0,0,0,1,0,0,0,0,0
5625,487,2018,31,31,0,1.0,100,1095,12,18,1,4,14,1,19,0,1,2,1,10,4,1,0,0,0
5626,488,2018,8,8,0,1.0,100,1095,5,3,0,2,2,0,4,0,1,1,0,1,1,0,0,0,0
5627,489,2018,25,23,2,0.92,91,1095,8,11,4,3,10,3,16,1,0,1,1,9,1,2,1,0,0
5628,490,2018,33,21,12,0.63,63,1095,7,11,3,3,8,1,12,1,1,0,1,5,3,0,0,1,0
5629,491,2018,5,1,4,0.12,11,1095,0,1,0,0,1,0,1,0,0,0,0,1,0,0,0,0,0
5630,492,2018,7,7,0,1.0,100,1095,2,3,2,1,2,1,4,0,1,0,0,1,1,0,1,0,0
5631,493,2018,10,10,0,0.99,99,1095,3,6,1,1,4,1,6,0,0,1,0,2,2,1,0,0,0
5632,494,2018,9,8,1,0.85,85,1095,4,3,1,3,3,1,7,2,1,0,0,3,0,1,0,0,0
5633,495,2018,13,12,1,0.91,90,1095,6,6,0,4,5,0,9,2,2,0,0,4,1,0,0,0,0
5634,496,2018,50,50,0,1.0,100,1095,28,19,3,26,19,3,48,24,2,0,0,19,0,3,0,0,0
5635,497,2018,31,31,0,0.99,98,1095,23,7,1,12,6,1,19,3,8,0,1,5,1,1,0,0,0
5636,498,2018,27,27,0,1.0,99,1095,16,10,1,6,7,1,14,2,0,2,2,4,3,1,0,0,0
5637,499,2018,49,49,0,1.0,100,1095,30,17,2,18,13,1,32,8,9,0,1,9,4,0,1,0,0
5638,500,2018,40,21,19,0.54,53,1095,12,6,3,8,4,3,15,5,2,1,0,2,2,3,0,0,0
5639,501,2018,8,8,0,1.0,100,1095,5,2,1,2,1,1,4,0,1,1,0,0,1,1,0,0,0
5640,502,2018,7,4,3,0.61,60,1095,3,1,0,2,1,0,3,1,1,0,0,1,0,0,0,0,0
5641,503,2018,13,13,0,0.98,97,1095,5,7,1,5,6,1,12,5,0,0,0,5,1,1,0,0,0
5642,504,2018,35,35,0,1.0,100,1095,15,16,4,12,16,2,30,11,0,0,1,16,0,1,0,1,0
5643,505,2018,46,46,0,1.0,100,1095,32,12,2,26,12,1,39,23,1,1,1,12,0,0,1,0,0
5644,506,2018,45,31,14,0.68,68,1095,18,9,4,17,6,1,24,16,1,0,0,3,3,0,0,0,1
5645,507,2018,55,52,3,0.95,95,1095,26,25,1,17,14,1,32,11,4,1,1,3,11,1,0,0,0
5646,508,2018,11,11,0,0.98,97,1095,4,4,3,3,2,1,6,2,1,0,0,0,2,0,0,1,0
5647,509,2018,14,14,0,1.0,100,1095,9,5,0,8,3,0,11,7,1,0,0,1,2,0,0,0,0
5648,510,2018,16,15,1,0.97,96,1095,5,7,3,3,5,3,11,2,0,1,0,3,2,3,0,0,0
5649,511,2018,11,5,6,0.46,45,1095,2,2,1,2,1,1,4,2,0,0,0,0,1,1,0,0,0
5650,512,2018,32,29,3,0.91,90,1095,14,11,4,14,9,3,26,14,0,0,0,7,2,2,1,0,0
5651,513,2018,8,1,7,0.14,14,1095,0,1,0,0,1,0,1,0,0,0,0,1,0,0,0,0,0
5652,514,2018,42,41,1,0.97,96,1095,16,22,3,8,18,2,28,1,6,1,0,14,4,1,1,0,0
5653,515,2018,26,26,0,1.0,99,1095,17,7,2,17,6,2,25,17,0,0,0,5,1,2,0,0,0
5654,516,2018,29,23,6,0.8,80,1095,14,7,2,11,5,2,18,8,3,0,0,3,2,2,0,0,0
5655,517,2018,17,17,0,1.0,100,1095,6,10,1,2,7,1,10,0,0,2,0,4,3,1,0,0,0
5656,518,2018,39,39,0,1.0,100,1095,16,20,3,10,19,2,31,6,3,0,1,18,1,1,1,0,0
5657,519,2018,27,23,4,0.87,86,1095,13,6,4,9,5,1,15,5,4,0,0,4,1,0,0,0,1
5658,520,2018,51,33,18,0.64,64,1095,15,15,3,14,8,2,24,13,1,0,0,1,7,1,1,0,0
5659,521,2018,36,36,0,1.0,99,1095,20,14,2,17,13,1,31,14,3,0,0,12,1,0,1,0,0
5660,522,2018,19,9,10,0.48,48,1095,3,4,2,2,3,2,7,1,1,0,0,2,1,2,0,0,0
5661,523,2018,22,22,0,1.0,100,1095,13,7,2,8,7,2,17,5,1,2,0,7,0,2,0,0,0
5662,524,2018,32,32,0,1.0,100,1095,11,18,3,5,14,2,21,1,3,0,1,10,4,1,1,0,0
5663,525,2018,54,54,0,1.0,99,1095,24,30,0,19,23,0,42,14,5,0,0,16,7,0,0,0,0
5664,526,2018,25,25,0,1.0,100,1095,7,14,4,3,10,3,16,1,1,0,1,6,4,2,1,0,0
5665,527,2018,56,56,0,1.0,100,1095,26,28,2,25,23,2,50,24,1,0,0,18,5,2,0,0,0
5666,528,2018,17,10,7,0.6,60,1095,7,2,1,5,1,1,7,3,2,0,0,0,1,1,0,0,0
5667,529,2018,6,1,5,0.16,16,1095,0,1,0,0,1,0,1,0,0,0,0,1,0,0,0,0,0
5668,530,2018,38,27,11,0.71,71,1095,17,9,1,17,6,1,24,17,0,0,0,3,3,1,0,0,0
5669,531,2018,15,6,9,0.43,43,1095,3,2,1,2,2,1,5,1,1,0,0,2,0,1,0,0,0
5670,532,2018,18,17,1,0.97,96,1095,12,3,2,11,3,2,16,10,1,0,0,3,0,2,0,0,0
5671,533,2018,42,35,7,0.83,82,1095,23,10,2,18,7,2,27,15,2,0,1,4,3,2,0,0,0
5672,534,2018,42,39,3,0.93,93,1095,28,9,2,23,8,1,32,20,1,2,0,7,1,0,1,0,0
5673,535,2018,9,0,9,0.01,1,1095,0,0,0,0,0,0,0,0,0,0,0,0,0,0,0,0,0
5674,536,2018,31,18,13,0.57,57,1095,9,6,3,4,3,3,10,2,0,1,1,0,3,3,0,0,0
5675,537,2018,32,16,16,0.48,48,1095,11,4,1,8,4,1,13,5,3,0,0,4,0,1,0,0,0
5676,538,2018,12,12,0,0.99,98,1095,4,6,2,4,3,1,8,4,0,0,0,0,3,0,1,0,0
5677,539,2018,8,8,0,1.0,99,1095,4,3,1,1,2,1,4,0,0,0,1,1,1,1,0,0,0
5678,540,2018,24,7,17,0.3,30,1095,3,3,1,3,2,1,6,3,0,0,0,1,1,1,0,0,0
5679,541,2018,39,23,16,0.58,58,1095,11,12,0,5,8,0,13,1,3,0,1,4,4,0,0,0,0
5680,542,2018,51,51,0,1.0,100,1095,29,19,3,25,17,2,44,22,2,1,0,15,2,1,1,0,0
5681,543,2018,22,16,6,0.71,71,1095,11,4,1,9,2,1,12,8,0,1,0,0,2,1,0,0,0
5682,544,2018,13,1,12,0.08,8,1095,0,1,0,0,1,0,1,0,0,0,0,1,0,0,0,0,0
5683,545,2018,32,31,1,0.98,98,1095,18,11,2,7,10,2,19,2,0,4,1,9,1,2,0,0,0
5684,546,2018,54,45,9,0.83,83,1095,18,27,0,15,21,0,36,14,0,0,1,15,6,0,0,0,0
5685,547,2018,52,52,0,1.0,99,1095,37,14,1,13,12,1,26,0,7,1,5,10,2,1,0,0,0
5686,548,2018,40,40,0,0.99,99,1095,26,13,1,13,10,1,24,4,5,4,0,7,3,1,0,0,0
5687,549,2018,23,23,0,1.0,100,1095,9,13,1,7,7,1,15,5,2,0,0,1,6,1,0,0,0
5688,550,2018,22,22,0,1.0,100,1095,8,13,1,7,9,1,17,6,1,0,0,5,4,1,0,0,0
5689,551,2018,11,11,0,1.0,99,1095,4,5,2,3,3,2,8,2,1,0,0,1,2,2,0,0,0
5690,552,2018,39,10,29,0.25,25,1095,3,6,1,1,3,1,5,0,0,1,0,0,3,1,0,0,0
5691,553,2018,46,8,38,0.17,17,1095,3,4,1,1,2,1,4,0,0,1,0,0,2,1,0,0,0
5692,554,2018,40,40,0,0.99,98,1095,24,13,3,18,12,3,33,15,0,3,0,11,1,3,0,0,0
5693,555,2018,16,16,0,1.0,99,1095,6,6,4,4,3,4,11,3,0,1,0,0,3,4,0,0,0
5694,556,2018,10,10,0,1.0,100,1095,7,2,1,2,1,1,4,0,0,1,1,0,1,1,0,0,0
5695,557,2018,56,55,1,0.99,98,1095,34,20,1,12,14,1,27,1,3,5,3,8,6,1,0,0,0
5696,558,2018,38,38,0,1.0,100,1095,26,10,2,20,5,1,26,17,1,1,1,0,5,0,1,0,0
5697,559,2018,45,45,0,1.0,100,1095,25,16,4,7,14,2,23,0,0,3,4,12,2,0,2,0,0
5698,560,2018,37,37,0,1.0,100,1095,16,19,2,10,10,2,22,7,1,1,1,1,9,2,0,0,0
5699,561,2018,16,16,0,1.0,100,1095,5,8,3,3,5,1,9,2,0,1,0,2,3,0,0,1,0
5700,562,2018,27,23,4,0.87,86,1095,9,12,2,8,11,1,20,7,1,0,0,10,1,0,1,0,0
5701,563,2018,36,32,4,0.88,88,1095,22,10,0,14,6,0,20,9,2,3,0,2,4,0,0,0,0
5702,564,2018,60,58,2,0.97,96,1095,37,20,1,26,15,1,42,19,4,2,1,10,5,1,0,0,0
5703,565,2018,9,5,4,0.53,53,1095,2,3,0,2,2,0,4,2,0,0,0,1,1,0,0,0,0
5704,566,2018,16,16,0,0.98,98,1095,9,4,3,9,3,2,14,9,0,0,0,2,1,1,1,0,0
5705,567,2018,32,2,30,0.06,6,1095,1,1,0,1,1,0,2,1,0,0,0,1,0,0,0,0,0
5706,568,2018,12,12,0,1.0,100,1095,6,5,1,3,3,1,7,1,1,1,0,1,2,1,0,0,0
5707,569,2018,41,41,0,1.0,100,1095,16,24,1,13,15,1,29,12,0,0,1,6,9,1,0,0,0
5708,570,2018,47,47,0,1.0,100,1095,30,14,3,23,8,1,32,19,1,3,0,2,6,0,0,1,0
5709,571,2018,6,0,6,0.06,5,1095,0,0,0,0,0,0,0,0,0,0,0,0,0,0,0,0,0
5710,572,2018,11,11,0,0.98,98,1095,4,4,3,1,2,2,5,0,0,0,1,0,2,1,1,0,0
5711,573,2018,35,35,0,0.99,99,1095,14,18,3,4,16,3,23,0,1,0,3,14,2,3,0,0,0
5712,574,2018,27,27,0,1.0,100,1095,12,14,1,11,9,1,21,10,1,0,0,4,5,1,0,0,0
5713,575,2018,26,26,0,1.0,100,1095,18,6,2,17,3,1,21,16,1,0,0,0,3,0,1,0,0
5714,576,2018,42,42,0,1.0,100,1095,19,20,3,13,12,3,28,11,0,0,2,4,8,3,0,0,0
5715,577,2018,12,3,9,0.22,22,1095,2,1,0,1,1,0,2,0,1,0,0,1,0,0,0,0,0
5716,578,2018,13,1,12,0.05,5,1095,0,1,0,0,1,0,1,0,0,0,0,1,0,0,0,0,0
5717,579,2018,34,34,0,1.0,99,1095,24,9,1,9,8,1,18,0,5,2,2,7,1,1,0,0,0
5718,580,2018,19,18,1,0.95,94,1095,6,9,3,3,6,2,11,2,0,0,1,3,3,1,1,0,0
5719,581,2018,9,9,0,1.0,100,1095,3,5,1,2,3,1,6,1,1,0,0,1,2,1,0,0,0
5720,582,2018,33,33,0,1.0,100,1095,20,9,4,16,9,2,27,14,0,2,0,9,0,1,0,1,0
5721,583,2018,10,7,3,0.72,71,1095,4,2,1,4,1,1,6,4,0,0,0,0,1,1,0,0,0
5722,584,2018,38,36,2,0.96,95,1095,14,21,1,11,11,1,23,9,1,1,0,1,10,1,0,0,0
5723,585,2018,14,7,7,0.46,46,1095,2,3,2,2,2,1,5,2,0,0,0,1,1,0,1,0,0
5724,586,2018,34,18,16,0.53,52,1095,10,8,0,7,8,0,15,5,1,1,0,8,0,0,0,0,0
5725,587,2018,17,17,0,1.0,100,1095,9,5,3,4,5,3,12,2,0,1,1,5,0,3,0,0,0
5726,588,2018,27,27,0,1.0,100,1095,14,11,2,13,10,1,24,12,1,0,0,9,1,0,1,0,0
5727,589,2018,43,43,0,1.0,100,1095,32,9,2,14,6,1,21,2,9,0,3,3,3,0,1,0,0
5728,590,2018,24,22,2,0.93,92,1095,12,10,0,6,7,0,13,3,1,1,1,4,3,0,0,0,0
5729,591,2018,15,15,0,1.0,100,1095,4,9,2,2,7,2,11,0,2,0,0,5,2,2,0,0,0
5730,592,2018,5,5,0,1.0,100,1095,2,2,1,1,2,1,4,0,1,0,0,2,0,1,0,0,0
5731,593,2018,8,8,0,1.0,100,1095,5,2,1,3,2,1,6,1,2,0,0,2,0,1,0,0,0
5732,594,2018,55,55,0,1.0,100,1095,31,21,3,14,18,3,35,3,7,2,2,15,3,3,0,0,0
5733,595,2018,20,14,6,0.68,68,1095,7,4,3,4,2,2,8,2,1,1,0,0,2,1,1,0,0
5734,596,2018,12,12,0,1.0,100,1095,6,4,2,6,3,1,10,6,0,0,0,2,1,0,1,0,0
5735,597,2018,29,2,27,0.08,8,1095,1,1,0,1,1,0,2,1,0,0,0,1,0,0,0,0,0
5736,598,2018,12,12,0,0.98,97,1095,4,7,1,1,7,1,9,0,0,0,1,7,0,1,0,0,0
5737,599,2018,17,15,2,0.9,90,1095,4,8,3,4,6,3,13,4,0,0,0,4,2,3,0,0,0
5738,600,2018,16,16,0,0.97,96,1095,8,8,0,5,8,0,13,4,0,0,1,8,0,0,0,0,0
5739,601,2018,28,27,1,0.97,97,1095,14,13,0,4,7,0,11,0,0,2,2,1,6,0,0,0,0
5740,602,2018,8,8,0,0.98,97,1095,3,3,2,3,3,1,7,3,0,0,0,3,0,0,1,0,0
5741,603,2018,59,59,0,1.0,100,1095,37,19,3,32,18,3,53,29,2,0,1,17,1,3,0,0,0
5742,604,2018,44,42,2,0.96,96,1095,31,9,2,12,5,2,19,5,0,2,5,1,4,2,0,0,0
5743,605,2018,48,16,32,0.33,33,1095,8,7,1,3,4,1,8,0,1,2,0,1,3,1,0,0,0
5744,606,2018,35,34,1,0.98,97,1095,17,14,3,11,8,1,20,8,0,3,0,2,6,0,0,1,0
5745,607,2018,40,34,6,0.84,84,1095,25,8,1,14,6,1,21,8,3,1,2,4,2,1,0,0,0
5746,608,2018,6,5,1,0.81,80,1095,4,1,0,3,1,0,4,2,1,0,0,1,0,0,0,0,0
5747,609,2018,15,15,0,0.99,99,1095,7,6,2,4,3,2,9,2,1,1,0,0,3,2,0,0,0
5748,610,2018,9,2,7,0.19,19,1095,1,1,0,1,1,0,2,1,0,0,0,1,0,0,0,0,0
5749,611,2018,48,20,28,0.42,41,1095,9,10,1,5,10,1,16,2,2,1,0,10,0,1,0,0,0
5750,612,2018,12,12,0,1.0,99,1095,8,3,1,7,3,1,11,6,1,0,0,3,0,1,0,0,0
5751,613,2018,12,12,0,1.0,99,1095,9,2,1,6,1,1,8,5,0,0,1,0,1,1,0,0,0
5752,614,2018,6,6,0,1.0,100,1095,2,3,1,2,2,1,5,2,0,0,0,1,1,1,0,0,0
5753,615,2018,27,27,0,1.0,100,1095,14,11,2,8,6,1,15,5,1,1,1,1,5,0,1,0,0
5754,616,2018,30,9,21,0.29,29,1095,6,3,0,5,2,0,7,4,1,0,0,1,1,0,0,0,0
5755,617,2018,14,14,0,1.0,100,1095,6,8,0,5,8,0,13,4,1,0,0,8,0,0,0,0,0
5756,618,2018,6,6,0,1.0,100,1095,3,2,1,1,1,1,3,0,0,1,0,0,1,1,0,0,0
5757,619,2018,17,2,15,0.1,10,1095,1,1,0,1,1,0,2,1,0,0,0,1,0,0,0,0,0
5758,620,2018,18,18,0,1.0,99,1095,7,8,3,7,8,1,16,7,0,0,0,8,0,0,0,1,0
5759,621,2018,9,9,0,1.0,100,1095,3,4,2,2,3,2,7,1,1,0,0,2,1,2,0,0,0
5760,622,2018,32,3,29,0.08,8,1095,2,1,0,1,1,0,2,0,1,0,0,1,0,0,0,0,0
5761,623,2018,52,48,4,0.92,92,1095,22,25,1,15,15,1,31,12,0,2,1,5,10,1,0,0,0
5762,624,2018,20,19,1,0.96,96,1095,12,5,2,4,4,1,9,1,0,1,2,3,1,0,1,0,0
5763,625,2018,33,33,0,1.0,100,1095,23,9,1,17,9,1,27,11,6,0,0,9,0,1,0,0,0
5764,626,2018,13,13,0,1.0,100,1095,5,7,1,3,6,1,10,2,0,1,0,5,1,1,0,0,0
5765,627,2018,17,17,0,1.0,100,1095,7,8,2,5,4,2,11,3,2,0,0,0,4,2,0,0,0
5766,628,2018,13,13,0,1.0,100,1095,8,3,2,5,3,2,10,3,1,1,0,3,0,2,0,0,0
5767,629,2018,33,33,0,1.0,100,1095,20,11,2,16,9,1,26,12,4,0,0,7,2,0,1,0,0
5768,630,2018,15,10,5,0.65,64,1095,2,6,2,1,6,1,8,0,1,0,0,6,0,0,1,0,0
5769,631,2018,58,51,7,0.88,87,1095,35,13,3,19,8,3,30,7,8,4,0,3,5,3,0,0,0
5770,632,2018,9,9,0,1.0,100,1095,5,3,1,5,2,1,8,5,0,0,0,1,1,1,0,0,0
5771,633,2018,9,9,0,0.95,94,1095,6,3,0,3,3,0,6,2,0,0,1,3,0,0,0,0,0
5772,634,2018,6,6,0,0.97,96,1095,4,2,0,1,1,0,2,0,0,0,1,0,1,0,0,0,0
5773,635,2018,24,24,0,1.0,99,1095,12,12,0,6,9,0,15,3,1,1,1,6,3,0,0,0,0
5774,636,2018,15,5,10,0.33,32,1095,1,3,1,1,3,1,5,1,0,0,0,3,0,1,0,0,0
5775,637,2018,23,23,0,1.0,100,1095,13,8,2,4,6,1,11,0,0,3,1,4,2,0,1,0,0
5776,638,2018,29,29,0,1.0,99,1095,19,10,0,18,5,0,23,17,1,0,0,0,5,0,0,0,0
5777,639,2018,7,4,3,0.54,54,1095,1,2,1,1,2,1,4,1,0,0,0,2,0,1,0,0,0
5778,640,2018,13,11,2,0.83,83,1095,7,3,1,5,2,1,8,4,0,1,0,1,1,1,0,0,0
5779,641,2018,6,6,0,0.93,93,1095,4,2,0,4,2,0,6,4,0,0,0,2,0,0,0,0,0
5780,642,2018,28,28,0,1.0,100,1095,12,16,0,7,14,0,21,2,5,0,0,12,2,0,0,0,0
5781,643,2018,56,56,0,0.99,99,1095,38,17,1,36,12,1,49,34,2,0,0,7,5,1,0,0,0
5782,644,2018,11,11,0,1.0,100,1095,8,2,1,2,2,1,5,0,0,0,2,2,0,1,0,0,0
5783,645,2018,23,23,0,0.99,98,1095,8,11,4,4,9,3,16,1,2,1,0,7,2,2,1,0,0
5784,646,2018,58,5,53,0.08,8,1095,2,3,0,2,3,0,5,2,0,0,0,3,0,0,0,0,0
5785,647,2018,32,16,16,0.51,50,1095,6,7,3,6,6,1,13,6,0,0,0,5,1,0,0,1,0
5786,648,2018,34,34,0,1.0,99,1095,14,20,0,9,10,0,19,5,3,1,0,0,10,0,0,0,0
5787,649,2018,27,27,0,1.0,100,1095,12,13,2,8,9,1,18,4,4,0,0,5,4,0,1,0,0
5788,650,2018,37,37,0,1.0,100,1095,27,7,3,17,7,1,25,12,0,5,0,7,0,0,0,1,0
5789,651,2018,26,16,10,0.63,63,1095,9,7,0,6,6,0,12,3,3,0,0,5,1,0,0,0,0
5790,652,2018,40,40,0,1.0,100,1095,21,16,3,11,15,2,28,1,10,0,0,14,1,1,1,0,0
5791,653,2018,14,14,0,1.0,100,1095,8,6,0,6,4,0,10,4,2,0,0,2,2,0,0,0,0
5792,654,2018,40,27,13,0.67,66,1095,12,12,3,10,7,2,19,9,0,1,0,2,5,1,1,0,0
5793,655,2018,50,50,0,1.0,100,1095,26,22,2,13,19,2,34,0,13,0,0,16,3,2,0,0,0
5794,656,2018,47,47,0,1.0,100,1095,30,13,4,17,11,3,31,9,3,5,0,9,2,2,1,0,0
5795,657,2018,32,32,0,1.0,100,1095,19,12,1,19,10,1,30,19,0,0,0,8,2,1,0,0,0
5796,658,2018,12,4,8,0.33,33,1095,1,2,1,1,1,1,3,1,0,0,0,0,1,1,0,0,0
5797,659,2018,38,38,0,1.0,99,1095,27,10,1,15,6,1,22,8,4,1,2,2,4,1,0,0,0
5798,660,2018,21,17,4,0.83,82,1095,11,6,0,11,3,0,14,11,0,0,0,0,3,0,0,0,0
5799,661,2018,37,34,3,0.91,90,1095,16,17,1,16,16,1,33,16,0,0,0,15,1,1,0,0,0
5800,662,2018,29,29,0,1.0,100,1095,10,16,3,7,12,2,21,5,1,1,0,8,4,1,1,0,0
5801,663,2018,39,17,22,0.43,42,1095,7,7,3,2,5,1,8,0,0,1,1,3,2,0,0,1,0
5802,664,2018,45,3,42,0.06,5,1095,1,2,0,1,1,0,2,1,0,0,0,0,1,0,0,0,0
5803,665,2018,28,28,0,1.0,99,1095,20,5,3,12,4,3,19,7,2,3,0,3,1,3,0,0,0
5804,666,2018,24,11,13,0.45,45,1095,5,4,2,2,3,2,7,1,0,0,1,2,1,2,0,0,0
5805,667,2018,30,19,11,0.64,63,1095,5,11,3,3,11,2,16,2,0,1,0,11,0,1,1,0,0
5806,668,2018,38,38,0,0.99,98,1095,15,21,2,11,15,2,28,9,0,2,0,9,6,2,0,0,0
5807,669,2018,42,24,18,0.56,56,1095,10,13,1,4,13,1,18,1,0,3,0,13,0,1,0,0,0
5808,670,2018,14,14,0,0.99,99,1095,4,8,2,4,5,1,10,4,0,0,0,2,3,0,1,0,0
5809,671,2018,47,47,0,1.0,100,1095,34,11,2,23,8,2,33,15,6,1,1,5,3,2,0,0,0
5810,672,2018,41,39,2,0.95,95,1095,15,21,3,6,20,1,27,0,4,1,1,19,1,0,0,1,0
5811,673,2018,14,10,4,0.74,73,1095,7,3,0,3,2,0,5,1,1,0,1,1,1,0,0,0,0
5812,674,2018,24,24,0,0.99,98,1095,11,12,1,4,6,1,11,0,1,3,0,0,6,1,0,0,0
5813,675,2018,9,9,0,1.0,100,1095,4,5,0,3,4,0,7,2,1,0,0,3,1,0,0,0,0
5814,676,2018,19,19,0,0.99,98,1095,6,9,4,2,8,3,13,0,1,0,1,7,1,2,1,0,0
5815,677,2018,11,11,0,1.0,99,1095,8,3,0,6,3,0,9,4,2,0,0,3,0,0,0,0,0
5816,678,2018,26,26,0,1.0,100,1095,15,8,3,6,7,3,16,2,0,3,1,6,1,3,0,0,0
5817,679,2018,22,22,0,1.0,100,1095,7,11,4,7,8,4,19,7,0,0,0,5,3,4,0,0,0
5818,680,2018,25,1,24,0.06,5,1095,0,1,0,0,1,0,1,0,0,0,0,1,0,0,0,0,0
5819,681,2018,40,40,0,1.0,100,1095,26,13,1,10,11,1,22,1,5,1,3,9,2,1,0,0,0
5820,682,2018,38,38,0,1.0,100,1095,20,17,1,10,11,1,22,1,8,1,0,5,6,1,0,0,0
5821,683,2018,5,5,0,1.0,99,1095,3,2,0,3,1,0,4,3,0,0,0,0,1,0,0,0,0
5822,684,2018,27,26,1,0.97,96,1095,16,10,0,15,7,0,22,14,1,0,0,4,3,0,0,0,0
5823,685,2018,14,13,1,0.96,95,1095,6,7,0,2,5,0,7,0,0,2,0,3,2,0,0,0,0
5824,686,2018,26,20,6,0.78,77,1095,13,7,0,4,7,0,11,0,0,3,1,7,0,0,0,0,0
5825,687,2018,20,20,0,1.0,99,1095,7,12,1,6,7,1,14,5,1,0,0,2,5,1,0,0,0
5826,688,2018,13,5,8,0.38,38,1095,2,3,0,2,2,0,4,2,0,0,0,1,1,0,0,0,0
5827,689,2018,46,46,0,1.0,100,1095,18,25,3,9,14,3,26,3,4,1,1,3,11,3,0,0,0
5828,690,2018,46,46,0,1.0,99,1095,22,20,4,11,11,1,23,7,0,1,3,2,9,0,0,0,1
5829,691,2018,31,5,26,0.15,14,1095,2,2,1,2,2,1,5,2,0,0,0,2,0,1,0,0,0
5830,692,2018,28,27,1,0.97,97,1095,10,16,1,3,10,1,14,0,0,2,1,4,6,1,0,0,0
5831,693,2018,15,15,0,1.0,100,1095,6,7,2,3,5,1,9,1,1,1,0,3,2,0,1,0,0
5832,694,2018,55,54,1,0.99,98,1095,30,21,3,13,18,3,34,2,6,4,1,15,3,3,0,0,0
5833,695,2018,36,22,14,0.6,59,1095,13,5,4,12,4,4,20,11,1,0,0,3,1,4,0,0,0
5834,696,2018,27,4,23,0.16,16,1095,2,2,0,2,1,0,3,2,0,0,0,0,1,0,0,0,0
5835,697,2018,31,31,0,0.99,98,1095,16,14,1,9,8,1,18,5,2,1,1,2,6,1,0,0,0
5836,698,2018,44,44,0,1.0,100,1095,22,20,2,12,12,1,25,6,3,2,1,4,8,0,1,0,0
5837,699,2018,34,34,0,1.0,100,1095,16,17,1,9,12,1,22,2,7,0,0,7,5,1,0,0,0
5838,700,2018,40,39,1,0.97,96,1095,18,21,0,9,21,0,30,5,1,1,2,21,0,0,0,0,0
5839,701,2018,31,31,0,1.0,100,1095,19,10,2,13,6,2,21,10,1,1,1,2,4,2,0,0,0
5840,702,2018,44,43,1,0.97,96,1095,24,17,2,15,9,1,25,8,5,2,0,1,8,0,1,0,0
5841,703,2018,34,34,0,1.0,100,1095,13,18,3,6,18,3,27,3,0,2,1,18,0,3,0,0,0
5842,704,2018,32,15,17,0.48,48,1095,9,5,1,7,3,1,11,5,2,0,0,1,2,1,0,0,0
5843,705,2018,6,6,0,0.93,92,1095,2,3,1,2,3,1,6,2,0,0,0,3,0,1,0,0,0
5844,706,2018,17,4,13,0.21,20,1095,1,2,1,1,1,1,3,1,0,0,0,0,1,1,0,0,0
5845,707,2018,29,29,0,1.0,99,1095,18,7,4,11,4,2,17,8,0,2,1,1,3,1,0,1,0
5846,708,2018,39,39,0,1.0,100,1095,17,21,1,12,17,1,30,7,5,0,0,13,4,1,0,0,0
5847,709,2018,42,39,3,0.93,93,1095,22,16,1,16,11,1,28,14,0,0,2,6,5,1,0,0,0
5848,710,2018,20,9,11,0.47,47,1095,4,3,2,4,3,2,9,4,0,0,0,3,0,2,0,0,0
5849,711,2018,5,5,0,1.0,100,1095,2,2,1,2,2,1,5,2,0,0,0,2,0,1,0,0,0
5850,712,2018,48,47,1,0.99,98,1095,21,24,2,18,24,2,44,15,3,0,0,24,0,2,0,0,0
5851,713,2018,24,21,3,0.88,88,1095,14,6,1,5,4,1,10,2,0,0,3,2,2,1,0,0,0
5852,714,2018,30,30,0,1.0,99,1095,11,17,2,6,17,1,24,4,0,1,1,17,0,0,1,0,0
5853,715,2018,47,16,31,0.34,34,1095,7,7,2,3,6,1,10,1,0,2,0,5,1,0,1,0,0
5854,716,2018,34,34,0,1.0,100,1095,13,20,1,9,10,1,20,7,0,2,0,0,10,1,0,0,0
5855,717,2018,32,32,0,1.0,99,1095,16,14,2,11,9,1,21,9,0,1,1,4,5,0,1,0,0
5856,718,2018,35,35,0,1.0,100,1095,17,18,0,9,13,0,22,3,4,2,0,8,5,0,0,0,0
5857,719,2018,39,39,0,1.0,99,1095,15,21,3,10,16,3,29,7,1,2,0,11,5,3,0,0,0
5858,720,2018,7,3,4,0.37,37,1095,2,1,0,1,1,0,2,0,1,0,0,1,0,0,0,0,0
5859,721,2018,38,38,0,0.99,99,1095,27,8,3,26,5,1,32,25,1,0,0,2,3,0,0,1,0
5860,722,2018,24,22,2,0.93,92,1095,13,9,0,7,5,0,12,3,2,2,0,1,4,0,0,0,0
5861,723,2018,8,8,0,0.99,98,1095,5,2,1,2,1,1,4,0,1,1,0,0,1,1,0,0,0
5862,724,2018,24,22,2,0.93,92,1095,12,9,1,8,7,1,16,5,2,1,0,5,2,1,0,0,0
5863,725,2018,26,20,6,0.78,77,1095,8,12,0,8,8,0,16,8,0,0,0,4,4,0,0,0,0
5864,726,2018,28,28,0,1.0,100,1095,17,9,2,16,5,2,23,15,1,0,0,1,4,2,0,0,0
5865,727,2018,24,23,1,0.95,95,1095,11,12,0,10,6,0,16,9,1,0,0,0,6,0,0,0,0
5866,728,2018,28,28,0,0.99,98,1095,18,9,1,9,8,1,18,2,5,2,0,7,1,1,0,0,0
5867,729,2018,24,23,1,0.96,96,1095,15,7,1,15,4,1,20,15,0,0,0,1,3,1,0,0,0
5868,730,2018,30,3,27,0.11,10,1095,2,1,0,1,1,0,2,0,1,0,0,1,0,0,0,0,0
5869,731,2018,51,51,0,1.0,100,1095,29,20,2,15,14,2,31,3,11,0,1,8,6,2,0,0,0
5870,732,2018,9,9,0,0.96,95,1095,3,4,2,2,3,2,7,1,1,0,0,2,1,2,0,0,0
5871,733,2018,10,10,0,1.0,100,1095,4,5,1,1,5,1,7,0,0,0,1,5,0,1,0,0,0
5872,734,2018,34,32,2,0.95,94,1095,15,15,2,8,15,2,25,1,7,0,0,15,0,2,0,0,0
5873,735,2018,18,18,0,0.99,98,1095,8,10,0,5,7,0,12,4,0,0,1,4,3,0,0,0,0
5874,736,2018,31,30,1,0.96,95,1095,19,9,2,9,6,2,17,1,7,0,1,3,3,2,0,0,0
5875,737,2018,49,48,1,0.97,97,1095,28,18,2,15,11,2,28,6,7,0,2,4,7,2,0,0,0
5876,738,2018,31,31,0,1.0,100,1095,21,7,3,21,7,1,29,21,0,0,0,7,0,0,0,1,0
5877,739,2018,36,35,1,0.98,97,1095,12,20,3,12,13,2,27,12,0,0,0,6,7,1,1,0,0
5878,740,2018,46,46,0,1.0,100,1095,24,20,2,19,18,2,39,16,1,2,0,16,2,2,0,0,0
5879,741,2018,15,10,5,0.65,64,1095,3,6,1,3,5,1,9,3,0,0,0,4,1,1,0,0,0
5880,742,2018,46,46,0,1.0,99,1095,34,8,4,27,6,3,36,23,2,1,1,4,2,2,1,0,0
5881,743,2018,47,11,36,0.23,22,1095,6,4,1,6,3,1,10,6,0,0,0,2,1,1,0,0,0
5882,744,2018,16,13,3,0.83,82,1095,6,6,1,3,6,1,10,2,0,0,1,6,0,1,0,0,0
5883,745,2018,36,22,14,0.62,62,1095,11,9,2,8,8,2,18,6,1,1,0,7,1,2,0,0,0
5884,746,2018,31,30,1,0.97,96,1095,14,12,4,10,10,1,21,8,1,0,1,8,2,0,0,0,1
5885,747,2018,8,8,0,1.0,100,1095,2,4,2,2,4,2,8,2,0,0,0,4,0,2,0,0,0
5886,748,2018,32,32,0,1.0,100,1095,16,13,3,15,12,2,29,14,1,0,0,11,1,1,1,0,0
5887,749,2018,7,7,0,1.0,100,1095,3,3,1,3,2,1,6,3,0,0,0,1,1,1,0,0,0
5888,750,2018,36,36,0,1.0,99,1095,13,20,3,4,16,1,21,1,0,0,3,12,4,0,0,1,0
5889,751,2018,31,4,27,0.13,12,1095,1,2,1,1,1,1,3,1,0,0,0,0,1,1,0,0,0
5890,752,2018,20,19,1,0.93,92,1095,11,6,2,6,3,2,11,2,3,1,0,0,3,2,0,0,0
5891,753,2018,21,20,1,0.94,93,1095,14,4,2,6,4,2,12,1,3,1,1,4,0,2,0,0,0
5892,754,2018,6,3,3,0.46,46,1095,2,1,0,1,1,0,2,0,1,0,0,1,0,0,0,0,0
5893,755,2018,30,15,15,0.5,49,1095,3,9,3,1,7,2,10,0,0,1,0,5,2,1,1,0,0
5894,756,2018,25,24,1,0.96,95,1095,17,6,1,6,5,1,12,0,3,1,2,4,1,1,0,0,0
5895,757,2018,38,38,0,1.0,100,1095,25,12,1,18,9,1,28,13,4,0,1,6,3,1,0,0,0
5896,758,2018,43,30,13,0.7,70,1095,16,11,3,14,8,1,23,13,0,1,0,5,3,0,0,1,0
5897,759,2018,27,26,1,0.98,98,1095,11,15,0,7,9,0,16,3,4,0,0,3,6,0,0,0,0
5898,760,2018,16,9,7,0.56,56,1095,3,5,1,2,3,1,6,1,1,0,0,1,2,1,0,0,0
5899,761,2018,15,15,0,1.0,100,1095,7,7,1,5,6,1,12,3,2,0,0,5,1,1,0,0,0
5900,762,2018,43,24,19,0.55,55,1095,14,8,2,11,6,1,18,9,1,1,0,4,2,0,1,0,0
5901,763,2018,52,52,0,1.0,99,1095,25,26,1,15,20,1,36,8,4,3,0,14,6,1,0,0,0
5902,764,2018,28,5,23,0.16,16,1095,2,2,1,2,1,1,4,2,0,0,0,0,1,1,0,0,0
5903,765,2018,36,33,3,0.92,92,1095,15,15,3,13,15,2,30,11,2,0,0,15,0,1,1,0,0
5904,766,2018,15,14,1,0.92,91,1095,7,6,1,7,4,1,12,7,0,0,0,2,2,1,0,0,0
5905,767,2018,34,26,8,0.77,77,1095,15,8,3,13,5,1,19,11,2,0,0,2,3,0,0,1,0
5906,768,2018,7,7,0,0.98,97,1095,3,3,1,1,3,1,5,0,0,1,0,3,0,1,0,0,0
5907,769,2018,20,20,0,1.0,100,1095,13,4,3,9,2,3,14,7,0,2,0,0,2,3,0,0,0
5908,770,2018,40,2,38,0.04,4,1095,1,1,0,1,1,0,2,1,0,0,0,1,0,0,0,0,0
5909,771,2018,40,18,22,0.45,44,1095,9,6,3,7,5,1,13,6,0,1,0,4,1,0,0,1,0
5910,772,2018,18,1,17,0.04,4,1095,0,1,0,0,1,0,1,0,0,0,0,1,0,0,0,0,0
5911,773,2018,39,11,28,0.29,28,1095,4,4,3,2,3,2,7,1,0,1,0,2,1,1,1,0,0
5912,774,2018,10,9,1,0.95,94,1095,3,5,1,2,5,1,8,1,1,0,0,5,0,1,0,0,0
5913,775,2018,6,1,5,0.08,8,1095,0,1,0,0,1,0,1,0,0,0,0,1,0,0,0,0,0
5914,776,2018,18,15,3,0.85,85,1095,8,6,1,5,4,1,10,2,3,0,0,2,2,1,0,0,0
5915,777,2018,13,13,0,1.0,100,1095,4,6,3,1,4,1,6,0,0,0,1,2,2,0,0,1,0
5916,778,2018,50,30,20,0.6,59,1095,17,10,3,13,6,2,21,11,0,2,0,2,4,1,1,0,0
5917,779,2018,55,54,1,0.99,99,1095,37,15,2,24,10,1,35,17,3,2,2,5,5,0,1,0,0
5918,780,2018,34,34,0,0.99,99,1095,15,16,3,8,10,3,21,4,2,1,1,4,6,3,0,0,0
5919,781,2018,25,25,0,1.0,99,1095,11,13,1,11,7,1,19,11,0,0,0,1,6,1,0,0,0
5920,782,2018,49,49,0,1.0,100,1095,23,23,3,21,15,1,37,19,2,0,0,7,8,0,0,1,0
5921,783,2018,17,17,0,1.0,100,1095,9,5,3,6,3,1,10,3,3,0,0,1,2,0,0,1,0
5922,784,2018,47,47,0,1.0,99,1095,32,11,4,26,8,4,38,20,6,0,0,5,3,4,0,0,0
5923,785,2018,6,0,6,0.01,1,1095,0,0,0,0,0,0,0,0,0,0,0,0,0,0,0,0,0
5924,786,2018,39,39,0,1.0,100,1095,13,22,4,13,13,3,29,13,0,0,0,4,9,2,1,0,0
5925,787,2018,37,37,0,1.0,100,1095,27,10,0,12,10,0,22,0,9,3,0,10,0,0,0,0,0
5926,788,2018,30,29,1,0.97,96,1095,13,14,2,5,14,2,21,1,2,0,2,14,0,2,0,0,0
5927,789,2018,23,18,5,0.78,77,1095,9,7,2,6,7,2,15,5,0,0,1,7,0,2,0,0,0
5928,790,2018,35,22,13,0.62,61,1095,12,8,2,3,8,2,13,0,0,0,3,8,0,2,0,0,0
5929,791,2018,18,18,0,0.99,99,1095,7,11,0,3,8,0,11,1,1,0,1,5,3,0,0,0,0
5930,792,2018,40,40,0,1.0,100,1095,29,9,2,23,6,2,31,19,2,2,0,3,3,2,0,0,0
5931,793,2018,16,16,0,1.0,99,1095,11,4,1,3,2,1,6,0,0,1,2,0,2,1,0,0,0
5932,794,2018,8,8,0,0.99,99,1095,5,2,1,3,2,1,6,2,0,1,0,2,0,1,0,0,0
5933,795,2018,33,27,6,0.81,81,1095,16,8,3,5,8,2,15,0,0,4,1,8,0,1,1,0,0
5934,796,2018,14,14,0,1.0,100,1095,5,6,3,5,5,2,12,5,0,0,0,4,1,1,1,0,0
5935,797,2018,55,9,46,0.17,17,1095,5,3,1,5,3,1,9,5,0,0,0,3,0,1,0,0,0
5936,798,2018,24,24,0,1.0,100,1095,16,6,2,7,4,1,12,2,2,2,1,2,2,0,1,0,0
5937,799,2018,36,34,2,0.93,93,1095,15,18,1,13,15,1,29,12,0,1,0,12,3,1,0,0,0
5938,800,2018,30,30,0,0.99,98,1095,20,6,4,6,4,2,12,0,1,2,3,2,2,0,2,0,0
5939,801,2018,38,13,25,0.35,34,1095,7,4,2,2,2,1,5,0,0,1,1,0,2,0,1,0,0
5940,802,2018,38,38,0,1.0,100,1095,23,14,1,7,8,1,16,0,1,3,3,2,6,1,0,0,0
5941,803,2018,36,36,0,1.0,100,1095,12,21,3,11,14,2,27,10,1,0,0,7,7,1,1,0,0
5942,804,2018,35,35,0,1.0,100,1095,21,11,3,20,9,1,30,19,1,0,0,7,2,0,0,1,0
5943,805,2018,59,59,0,1.0,100,1095,26,29,4,14,19,1,34,3,10,1,0,9,10,0,0,0,1
5944,806,2018,12,0,12,0.04,4,1095,0,0,0,0,0,0,0,0,0,0,0,0,0,0,0,0,0
5945,807,2018,28,27,1,0.98,97,1095,20,5,2,10,3,2,15,4,3,2,1,1,2,2,0,0,0
5946,808,2018,22,0,22,0.01,1,1095,0,0,0,0,0,0,0,0,0,0,0,0,0,0,0,0,0
5947,809,2018,34,31,3,0.9,89,1095,17,13,1,10,12,1,23,4,5,1,0,11,1,1,0,0,0
5948,810,2018,38,38,0,1.0,100,1095,14,21,3,6,17,3,26,0,4,2,0,13,4,3,0,0,0
5949,811,2018,14,4,10,0.29,29,1095,3,1,0,3,1,0,4,3,0,0,0,1,0,0,0,0,0
5950,812,2018,40,2,38,0.06,5,1095,1,1,0,1,1,0,2,1,0,0,0,1,0,0,0,0,0
5951,813,2018,52,52,0,1.0,100,1095,34,15,3,15,9,2,26,5,2,7,1,3,6,1,1,0,0
5952,814,2018,59,19,40,0.33,32,1095,14,4,1,4,3,1,8,0,1,0,3,2,1,1,0,0,0
5953,815,2018,30,30,0,1.0,100,1095,13,15,2,9,9,1,19,5,4,0,0,3,6,0,1,0,0
5954,816,2018,37,37,0,0.99,99,1095,26,8,3,21,8,2,31,16,5,0,0,8,0,1,1,0,0
5955,817,2018,24,5,19,0.22,22,1095,1,3,1,1,2,1,4,1,0,0,0,1,1,1,0,0,0
5956,818,2018,22,22,0,1.0,99,1095,11,8,3,6,8,2,16,3,1,2,0,8,0,1,1,0,0
5957,819,2018,22,19,3,0.86,86,1095,6,10,3,6,9,2,17,6,0,0,0,8,1,1,1,0,0
5958,820,2018,41,41,0,1.0,100,1095,26,14,1,8,10,1,19,0,1,4,3,6,4,1,0,0,0
5959,821,2018,17,17,0,1.0,100,1095,12,5,0,8,5,0,13,4,4,0,0,5,0,0,0,0,0
5960,822,2018,44,41,3,0.94,94,1095,17,22,2,14,19,2,35,12,1,1,0,16,3,2,0,0,0
5961,823,2018,6,6,0,1.0,99,1095,4,2,0,3,2,0,5,2,1,0,0,2,0,0,0,0,0
5962,824,2018,23,20,3,0.88,88,1095,9,11,0,8,6,0,14,7,1,0,0,1,5,0,0,0,0
5963,825,2018,47,47,0,0.99,98,1095,28,17,2,15,9,2,26,2,13,0,0,1,8,2,0,0,0
5964,826,2018,13,13,0,0.98,97,1095,5,5,3,5,3,1,9,5,0,0,0,1,2,0,0,1,0
5965,827,2018,16,3,13,0.17,16,1095,1,2,0,1,1,0,2,1,0,0,0,0,1,0,0,0,0
5966,828,2018,28,28,0,0.99,98,1095,11,16,1,4,14,1,19,0,1,3,0,12,2,1,0,0,0
5967,829,2018,58,58,0,1.0,100,1095,24,31,3,19,19,3,41,15,3,1,0,7,12,3,0,0,0
5968,830,2018,19,19,0,0.99,98,1095,10,8,1,4,5,1,10,1,0,3,0,2,3,1,0,0,0
5969,831,2018,35,15,20,0.44,43,1095,7,8,0,6,5,0,11,5,1,0,0,2,3,0,0,0,0
5970,832,2018,23,23,0,1.0,100,1095,15,6,2,4,6,1,11,0,0,1,3,6,0,0,1,0,0
5971,833,2018,15,15,0,1.0,100,1095,9,4,2,7,2,1,10,5,2,0,0,0,2,0,1,0,0
5972,834,2018,8,8,0,0.97,97,1095,4,4,0,1,3,0,4,0,0,0,1,2,1,0,0,0,0
5973,835,2018,12,12,0,1.0,100,1095,5,4,3,2,2,3,7,1,0,0,1,0,2,3,0,0,0
5974,836,2018,16,15,1,0.92,91,1095,4,9,2,3,7,1,11,2,1,0,0,5,2,0,1,0,0
5975,837,2018,47,47,0,1.0,100,1095,30,15,2,27,10,1,38,24,3,0,0,5,5,0,1,0,0
5976,838,2018,15,15,0,1.0,100,1095,8,4,3,4,3,3,10,2,1,0,1,2,1,3,0,0,0
5977,839,2018,39,26,13,0.67,66,1095,14,11,1,11,10,1,22,8,3,0,0,9,1,1,0,0,0
5978,840,2018,25,25,0,1.0,100,1095,9,14,2,6,13,1,20,4,1,1,0,12,1,0,1,0,0
5979,841,2018,10,5,5,0.52,52,1095,2,3,0,2,2,0,4,2,0,0,0,1,1,0,0,0,0
5980,842,2018,22,16,6,0.75,74,1095,7,5,4,2,3,4,9,0,0,1,1,1,2,4,0,0,0
5981,843,2018,9,7,2,0.73,72,1095,4,2,1,1,1,1,3,0,0,0,1,0,1,1,0,0,0
5982,844,2018,38,38,0,1.0,100,1095,26,10,2,14,9,1,24,5,6,3,0,8,1,0,1,0,0
5983,845,2018,32,32,0,1.0,100,1095,23,6,3,19,5,2,26,15,4,0,0,4,1,1,1,0,0
5984,846,2018,20,18,2,0.92,92,1095,13,3,2,6,2,2,10,0,5,1,0,1,1,2,0,0,0
5985,847,2018,35,31,4,0.9,89,1095,23,7,1,8,6,1,15,1,3,0,4,5,1,1,0,0,0
5986,848,2018,29,28,1,0.97,96,1095,18,8,2,17,4,2,23,16,1,0,0,0,4,2,0,0,0
5987,849,2018,14,8,6,0.58,58,1095,4,3,1,1,2,1,4,0,0,0,1,1,1,1,0,0,0
5988,850,2018,34,34,0,0.99,98,1095,22,9,3,7,7,1,15,1,1,1,4,5,2,0,0,1,0
5989,851,2018,35,35,0,1.0,100,1095,14,19,2,10,10,1,21,7,2,1,0,1,9,0,1,0,0
5990,852,2018,55,55,0,1.0,99,1095,21,33,1,18,22,1,41,15,3,0,0,11,11,1,0,0,0
5991,853,2018,26,7,19,0.28,27,1095,4,2,1,3,2,1,6,2,1,0,0,2,0,1,0,0,0
5992,854,2018,53,48,5,0.91,90,1095,24,23,1,15,14,1,30,12,0,0,3,5,9,1,0,0,0
5993,855,2018,49,49,0,1.0,100,1095,30,17,2,22,14,1,37,16,5,0,1,11,3,0,1,0,0
5994,856,2018,23,23,0,1.0,100,1095,16,4,3,9,4,3,16,6,1,0,2,4,0,3,0,0,0
5995,857,2018,21,21,0,1.0,100,1095,8,11,2,3,11,1,15,0,1,2,0,11,0,0,1,0,0
5996,858,2018,23,23,0,1.0,100,1095,10,13,0,3,10,0,13,0,0,2,1,7,3,0,0,0,0
5997,859,2018,38,38,0,1.0,100,1095,13,21,4,5,12,4,21,1,1,2,1,3,9,4,0,0,0
5998,860,2018,35,35,0,1.0,100,1095,11,21,3,10,17,2,29,9,1,0,0,13,4,1,1,0,0
5999,861,2018,20,20,0,0.98,98,1095,10,7,3,5,7,1,13,0,5,0,0,7,0,0,0,1,0
6000,862,2018,28,28,0,1.0,100,1095,18,9,1,5,6,1,12,0,1,0,4,3,3,1,0,0,0
6001,863,2018,7,7,0,1.0,100,1095,4,2,1,3,2,1,6,2,1,0,0,2,0,1,0,0,0
6002,864,2018,46,26,20,0.56,55,1095,13,10,3,8,7,2,17,5,1,2,0,4,3,1,1,0,0
6003,865,2018,15,15,0,0.98,97,1095,9,4,2,5,4,1,10,2,2,1,0,4,0,0,1,0,0
6004,866,2018,58,19,39,0.32,31,1095,7,8,4,3,4,2,9,1,1,0,1,0,4,1,0,1,0
6005,867,2018,29,28,1,0.97,97,1095,18,6,4,18,4,2,24,18,0,0,0,2,2,1,0,1,0
6006,868,2018,34,17,17,0.5,49,1095,7,8,2,5,6,2,13,3,2,0,0,4,2,2,0,0,0
6007,869,2018,15,0,15,0.01,1,1095,0,0,0,0,0,0,0,0,0,0,0,0,0,0,0,0,0
6008,870,2018,35,8,27,0.23,22,1095,6,2,0,3,2,0,5,1,1,1,0,2,0,0,0,0,0
6009,871,2018,11,11,0,1.0,100,1095,8,2,1,8,1,1,10,8,0,0,0,0,1,1,0,0,0
6010,872,2018,37,37,0,1.0,100,1095,25,8,4,10,6,1,17,2,2,5,1,4,2,0,0,0,1
6011,873,2018,31,30,1,0.98,98,1095,17,10,3,14,5,1,20,11,3,0,0,0,5,0,0,1,0
6012,874,2018,38,38,0,1.0,100,1095,20,17,1,11,9,1,21,8,0,0,3,1,8,1,0,0,0
6013,875,2018,9,9,0,0.98,98,1095,6,2,1,2,2,1,5,0,0,2,0,2,0,1,0,0,0
6014,876,2018,39,37,2,0.94,94,1095,19,17,1,15,17,1,33,13,0,2,0,17,0,1,0,0,0
6015,877,2018,52,32,20,0.61,61,1095,23,8,1,17,4,1,22,13,2,2,0,0,4,1,0,0,0
6016,878,2018,37,3,34,0.09,8,1095,2,1,0,1,1,0,2,0,1,0,0,1,0,0,0,0,0
6017,879,2018,16,16,0,1.0,100,1095,9,4,3,9,4,2,15,9,0,0,0,4,0,1,1,0,0
6018,880,2018,20,18,2,0.9,90,1095,8,7,3,5,6,2,13,4,0,0,1,5,1,1,1,0,0
6019,881,2018,7,7,0,1.0,100,1095,4,2,1,3,1,1,5,2,1,0,0,0,1,1,0,0,0
6020,882,2018,60,13,47,0.21,20,1095,6,5,2,6,5,2,13,6,0,0,0,5,0,2,0,0,0
6021,883,2018,10,10,0,1.0,100,1095,5,4,1,5,4,1,10,5,0,0,0,4,0,1,0,0,0
6022,884,2018,8,3,5,0.39,39,1095,2,1,0,2,1,0,3,2,0,0,0,1,0,0,0,0,0
6023,885,2018,34,3,31,0.09,8,1095,2,1,0,2,1,0,3,2,0,0,0,1,0,0,0,0,0
6024,886,2018,26,26,0,1.0,100,1095,14,10,2,7,5,2,14,3,2,1,1,0,5,2,0,0,0
6025,887,2018,12,12,0,0.96,95,1095,8,4,0,3,2,0,5,1,0,1,1,0,2,0,0,0,0
6026,888,2018,15,15,0,1.0,100,1095,9,5,1,3,3,1,7,0,1,1,1,1,2,1,0,0,0
6027,889,2018,26,26,0,1.0,100,1095,14,12,0,7,11,0,18,3,2,1,1,10,1,0,0,0,0
6028,890,2018,12,8,4,0.7,69,1095,2,4,2,2,3,2,7,2,0,0,0,2,1,2,0,0,0
6029,891,2018,60,60,0,1.0,100,1095,45,13,2,35,13,2,50,31,1,0,3,13,0,2,0,0,0
6030,892,2018,21,21,0,1.0,100,1095,11,6,4,3,3,1,7,0,0,1,2,0,3,0,0,0,1
6031,893,2018,18,3,15,0.18,17,1095,1,2,0,1,1,0,2,1,0,0,0,0,1,0,0,0,0
6032,894,2018,13,12,1,0.96,95,1095,5,4,3,5,3,2,10,5,0,0,0,2,1,1,1,0,0
6033,895,2018,41,26,15,0.63,62,1095,17,7,2,9,4,2,15,4,3,1,1,1,3,2,0,0,0
6034,896,2018,14,3,11,0.23,22,1095,1,2,0,1,2,0,3,1,0,0,0,2,0,0,0,0,0
6035,897,2018,47,45,2,0.96,96,1095,25,19,1,7,12,1,20,0,0,3,4,5,7,1,0,0,0
6036,898,2018,28,28,0,1.0,100,1095,13,14,1,6,11,1,18,2,1,3,0,8,3,1,0,0,0
6037,899,2018,29,29,0,0.99,98,1095,17,8,4,8,8,2,18,3,2,2,1,8,0,0,2,0,0
6038,900,2018,22,22,0,0.99,99,1095,8,13,1,5,11,1,17,3,1,1,0,9,2,1,0,0,0
6039,901,2018,34,33,1,0.96,96,1095,23,9,1,11,7,1,19,3,4,4,0,5,2,1,0,0,0
6040,902,2018,16,16,0,1.0,99,1095,6,6,4,2,4,3,9,0,1,0,1,2,2,2,1,0,0
6041,903,2018,26,25,1,0.95,94,1095,10,13,2,5,12,2,19,2,2,0,1,11,1,2,0,0,0
6042,904,2018,10,1,9,0.14,14,1095,0,1,0,0,1,0,1,0,0,0,0,1,0,0,0,0,0
6043,905,2018,14,4,10,0.29,29,1095,2,2,0,2,1,0,3,2,0,0,0,0,1,0,0,0,0
6044,906,2018,12,7,5,0.58,57,1095,2,3,2,1,3,1,5,0,1,0,0,3,0,0,1,0,0
6045,907,2018,42,13,29,0.3,29,1095,7,6,0,3,6,0,9,0,2,1,0,6,0,0,0,0,0
6046,908,2018,20,15,5,0.76,76,1095,7,5,3,6,3,2,11,5,1,0,0,1,2,1,1,0,0
6047,909,2018,40,40,0,1.0,100,1095,16,21,3,5,13,1,19,0,2,0,3,5,8,0,0,1,0
6048,910,2018,16,16,0,1.0,100,1095,12,3,1,7,2,1,10,4,2,0,1,1,1,1,0,0,0
6049,911,2018,57,57,0,1.0,100,1095,30,25,2,9,24,2,35,0,0,6,3,23,1,2,0,0,0
6050,912,2018,10,0,10,0.01,1,1095,0,0,0,0,0,0,0,0,0,0,0,0,0,0,0,0,0
6051,913,2018,27,12,15,0.45,45,1095,6,4,2,2,4,1,7,0,1,0,1,4,0,0,1,0,0
6052,914,2018,33,24,9,0.71,71,1095,9,11,4,5,10,2,17,3,1,0,1,9,1,1,0,1,0
6053,915,2018,26,24,2,0.91,90,1095,17,4,3,6,2,2,10,1,0,4,1,0,2,1,1,0,0
6054,916,2018,37,31,6,0.84,84,1095,21,7,3,13,6,3,22,9,1,2,1,5,1,3,0,0,0
6055,917,2018,25,24,1,0.97,96,1095,10,11,3,5,7,2,14,3,0,1,1,3,4,1,1,0,0
6056,918,2018,12,11,1,0.92,92,1095,6,5,0,3,3,0,6,2,0,0,1,1,2,0,0,0,0
6057,919,2018,41,40,1,0.98,97,1095,18,20,2,11,19,1,31,8,0,2,1,18,1,0,1,0,0
6058,920,2018,11,11,0,0.97,96,1095,4,5,2,4,3,2,9,4,0,0,0,1,2,2,0,0,0
6059,921,2018,26,25,1,0.98,98,1095,10,13,2,7,12,2,21,4,3,0,0,11,1,2,0,0,0
6060,922,2018,12,10,2,0.85,85,1095,3,5,2,3,4,1,8,3,0,0,0,3,1,0,1,0,0
6061,923,2018,41,41,0,0.99,99,1095,20,19,2,8,12,2,22,3,0,3,2,5,7,2,0,0,0
6062,924,2018,15,15,0,1.0,99,1095,7,6,2,5,3,2,10,3,2,0,0,0,3,2,0,0,0
6063,925,2018,25,23,2,0.92,92,1095,10,10,3,10,7,2,19,10,0,0,0,4,3,1,1,0,0
6064,926,2018,27,6,21,0.21,21,1095,3,3,0,1,3,0,4,0,0,1,0,3,0,0,0,0,0
6065,927,2018,27,27,0,0.99,99,1095,17,10,0,13,5,0,18,11,1,0,1,0,5,0,0,0,0
6066,928,2018,38,38,0,1.0,100,1095,17,18,3,8,15,2,25,3,3,0,2,12,3,1,1,0,0
6067,929,2018,9,9,0,0.96,96,1095,4,4,1,4,2,1,7,4,0,0,0,0,2,1,0,0,0
6068,930,2018,47,47,0,1.0,99,1095,31,12,4,15,9,1,25,7,0,8,0,6,3,0,0,0,1
6069,931,2018,26,26,0,1.0,99,1095,8,15,3,6,14,3,23,5,0,1,0,13,1,3,0,0,0
6070,932,2018,29,29,0,1.0,100,1095,16,11,2,11,6,1,18,8,1,2,0,1,5,0,1,0,0
6071,933,2018,39,11,28,0.28,28,1095,8,2,1,2,1,1,4,0,0,0,2,0,1,1,0,0,0
6072,934,2018,25,10,15,0.38,38,1095,4,4,2,2,3,2,7,1,0,1,0,2,1,2,0,0,0
6073,935,2018,22,17,5,0.75,75,1095,8,6,3,7,5,1,13,6,1,0,0,4,1,0,0,1,0
6074,936,2018,31,30,1,0.98,98,1095,21,5,4,10,5,2,17,4,3,1,2,5,0,1,0,1,0
6075,937,2018,10,2,8,0.17,17,1095,1,1,0,1,1,0,2,1,0,0,0,1,0,0,0,0,0
6076,938,2018,31,15,16,0.47,46,1095,5,8,2,3,6,2,11,2,0,1,0,4,2,2,0,0,0
6077,939,2018,14,14,0,0.99,99,1095,7,5,2,2,5,1,8,0,0,1,1,5,0,0,1,0,0
6078,940,2018,60,58,2,0.96,96,1095,39,17,2,38,15,1,54,37,1,0,0,13,2,0,1,0,0
6079,941,2018,27,24,3,0.88,87,1095,12,11,1,6,10,1,17,1,4,1,0,9,1,1,0,0,0
6080,942,2018,17,17,0,1.0,99,1095,11,5,1,9,5,1,15,8,0,1,0,5,0,1,0,0,0
6081,943,2018,48,45,3,0.93,92,1095,30,13,2,19,10,2,31,9,9,1,0,7,3,2,0,0,0
6082,944,2018,18,13,5,0.73,72,1095,8,3,2,6,2,1,9,4,2,0,0,1,1,0,1,0,0
6083,945,2018,26,25,1,0.95,95,1095,13,12,0,12,9,0,21,11,1,0,0,6,3,0,0,0,0
6084,946,2018,24,24,0,1.0,100,1095,17,6,1,12,5,1,18,8,3,1,0,4,1,1,0,0,0
6085,947,2018,36,0,36,0.01,1,1095,0,0,0,0,0,0,0,0,0,0,0,0,0,0,0,0,0
6086,948,2018,20,5,15,0.26,25,1095,1,3,1,1,3,1,5,1,0,0,0,3,0,1,0,0,0
6087,949,2018,26,26,0,1.0,100,1095,11,13,2,3,9,1,13,0,0,1,2,5,4,0,1,0,0
6088,950,2018,35,16,19,0.46,46,1095,7,6,3,3,3,1,7,1,1,0,1,0,3,0,0,1,0
6089,951,2018,29,27,2,0.95,94,1095,15,12,0,5,12,0,17,1,1,0,3,12,0,0,0,0,0
6090,952,2018,15,12,3,0.78,77,1095,8,3,1,6,2,1,9,5,0,1,0,1,1,1,0,0,0
6091,953,2018,54,1,53,0.01,1,1095,0,1,0,0,1,0,1,0,0,0,0,1,0,0,0,0,0
6092,954,2018,21,21,0,1.0,99,1095,15,6,0,9,6,0,15,5,3,0,1,6,0,0,0,0,0
6093,955,2018,23,23,0,1.0,100,1095,7,13,3,7,10,1,18,7,0,0,0,7,3,0,0,1,0
6094,956,2018,40,15,25,0.38,37,1095,4,8,3,4,4,1,9,4,0,0,0,0,4,0,0,1,0
6095,957,2018,23,7,16,0.31,30,1095,4,2,1,4,1,1,6,4,0,0,0,0,1,1,0,0,0
6096,958,2018,20,10,10,0.5,50,1095,3,4,3,2,2,2,6,1,1,0,0,0,2,1,1,0,0
6097,959,2018,22,21,1,0.95,94,1095,10,11,0,7,8,0,15,6,0,0,1,5,3,0,0,0,0
6098,960,2018,6,6,0,1.0,100,1095,2,3,1,1,2,1,4,0,1,0,0,1,1,1,0,0,0
6099,961,2018,22,7,15,0.32,32,1095,3,3,1,3,2,1,6,3,0,0,0,1,1,1,0,0,0
6100,962,2018,34,30,4,0.89,88,1095,20,9,1,5,6,1,12,0,0,0,5,3,3,1,0,0,0
6101,963,2018,15,9,6,0.61,60,1095,3,5,1,3,5,1,9,3,0,0,0,5,0,1,0,0,0
6102,964,2018,28,28,0,1.0,100,1095,14,10,4,7,10,4,21,1,5,1,0,10,0,4,0,0,0
6103,965,2018,16,14,2,0.88,87,1095,6,5,3,2,3,2,7,0,0,2,0,1,2,1,1,0,0
6104,966,2018,12,4,8,0.37,37,1095,1,2,1,1,1,1,3,1,0,0,0,0,1,1,0,0,0
6105,967,2018,23,23,0,1.0,100,1095,9,14,0,4,8,0,12,1,2,0,1,2,6,0,0,0,0
6106,968,2018,31,30,1,0.96,95,1095,21,8,1,6,5,1,12,0,0,3,3,2,3,1,0,0,0
6107,969,2018,41,41,0,1.0,100,1095,29,9,3,22,8,1,31,16,5,1,0,7,1,0,0,1,0
6108,970,2018,5,3,2,0.65,65,1095,1,2,0,1,1,0,2,1,0,0,0,0,1,0,0,0,0
6109,971,2018,52,52,0,1.0,99,1095,30,20,2,19,11,2,32,10,8,0,1,2,9,2,0,0,0
6110,972,2018,7,2,5,0.36,35,1095,1,1,0,1,1,0,2,1,0,0,0,1,0,0,0,0,0
6111,973,2018,10,9,1,0.9,89,1095,2,5,2,2,4,1,7,2,0,0,0,3,1,0,1,0,0
6112,974,2018,23,23,0,1.0,99,1095,6,13,4,6,13,2,21,6,0,0,0,13,0,0,2,0,0
6113,975,2018,46,39,7,0.84,84,1095,14,22,3,7,17,2,26,3,2,1,1,12,5,1,1,0,0
6114,976,2018,9,1,8,0.11,11,1095,0,1,0,0,1,0,1,0,0,0,0,1,0,0,0,0,0
6115,977,2018,55,41,14,0.74,73,1095,18,22,1,10,13,1,24,2,8,0,0,4,9,1,0,0,0
6116,978,2018,35,13,22,0.37,36,1095,5,7,1,4,4,1,9,3,1,0,0,1,3,1,0,0,0
6117,979,2018,50,50,0,1.0,100,1095,19,29,2,10,19,1,30,4,3,3,0,9,10,0,1,0,0
6118,980,2018,14,14,0,0.98,97,1095,4,6,4,4,5,1,10,4,0,0,0,4,1,0,0,0,1
6119,981,2018,52,52,0,1.0,100,1095,31,18,3,16,13,3,32,8,2,5,1,8,5,3,0,0,0
6120,982,2018,38,37,1,0.98,98,1095,13,22,2,10,19,2,31,9,0,0,1,16,3,2,0,0,0
6121,983,2018,40,40,0,0.99,98,1095,21,18,1,17,15,1,33,13,4,0,0,12,3,1,0,0,0
6122,984,2018,31,9,22,0.29,29,1095,5,3,1,4,3,1,8,3,1,0,0,3,0,1,0,0,0
6123,985,2018,35,35,0,1.0,100,1095,25,9,1,23,9,1,33,22,0,1,0,9,0,1,0,0,0
6124,986,2018,39,39,0,1.0,99,1095,17,21,1,10,15,1,26,7,0,2,1,9,6,1,0,0,0
6125,987,2018,16,0,16,0.0,0,1095,0,0,0,0,0,0,0,0,0,0,0,0,0,0,0,0,0
6126,988,2018,18,12,6,0.68,67,1095,4,5,3,3,4,3,10,2,1,0,0,3,1,3,0,0,0
6127,989,2018,26,26,0,0.99,98,1095,8,15,3,3,9,1,13,0,2,0,1,3,6,0,0,1,0
6128,990,2018,19,13,6,0.68,67,1095,8,3,2,5,2,1,8,4,0,0,1,1,1,0,1,0,0
6129,991,2018,11,10,1,0.89,89,1095,4,4,2,3,3,2,8,2,1,0,0,2,1,2,0,0,0
6130,992,2018,17,16,1,0.93,92,1095,6,7,3,6,6,2,14,6,0,0,0,5,1,1,1,0,0
6131,993,2018,28,2,26,0.08,7,1095,1,1,0,1,1,0,2,1,0,0,0,1,0,0,0,0,0
6132,994,2018,26,15,11,0.57,56,1095,6,7,2,4,4,2,10,3,0,1,0,1,3,2,0,0,0
6133,995,2018,33,33,0,1.0,100,1095,13,18,2,8,14,1,23,3,5,0,0,10,4,0,1,0,0
6134,996,2018,15,15,0,1.0,99,1095,11,3,1,6,3,1,10,4,0,1,1,3,0,1,0,0,0
6135,997,2018,13,13,0,1.0,99,1095,8,3,2,8,2,2,12,8,0,0,0,1,1,2,0,0,0
6136,998,2018,11,10,1,0.95,94,1095,7,2,1,2,2,1,5,0,0,1,1,2,0,1,0,0,0
6137,999,2018,29,28,1,0.97,96,1095,17,7,4,7,7,2,16,1,4,0,2,7,0,0,2,0,0
6138,1000,2018,22,19,3,0.88,88,1095,10,7,2,9,4,1,14,8,1,0,0,1,3,0,1,0,0
6139,1001,2018,22,7,15,0.32,31,1095,2,3,2,2,2,1,5,2,0,0,0,1,1,0,1,0,0
6140,1002,2018,60,60,0,1.0,100,1095,24,32,4,10,17,2,29,4,0,4,2,2,15,1,0,1,0
6141,1003,2018,16,15,1,0.97,96,1095,7,7,1,7,4,1,12,7,0,0,0,1,3,1,0,0,0
6142,1004,2018,27,27,0,1.0,100,1095,15,9,3,10,6,1,17,8,0,1,1,3,3,0,0,1,0
6143,1005,2018,46,46,0,0.99,98,1095,20,26,0,17,26,0,43,15,1,1,0,26,0,0,0,0,0
6144,1006,2018,19,11,8,0.59,59,1095,5,6,0,3,6,0,9,1,2,0,0,6,0,0,0,0,0
6145,1007,2018,38,38,0,1.0,100,1095,23,15,0,19,13,0,32,15,4,0,0,11,2,0,0,0,0
6146,1008,2018,48,0,48,0.0,0,1095,0,0,0,0,0,0,0,0,0,0,0,0,0,0,0,0,0
6147,1009,2018,17,16,1,0.94,93,1095,10,5,1,4,5,1,10,0,2,2,0,5,0,1,0,0,0
6148,1010,2018,27,27,0,1.0,99,1095,14,13,0,12,9,0,21,11,0,1,0,5,4,0,0,0,0
6149,1011,2018,16,16,0,1.0,100,1095,6,7,3,6,6,2,14,6,0,0,0,5,1,1,1,0,0
6150,1012,2018,26,25,1,0.97,97,1095,8,15,2,3,12,1,16,1,0,1,1,9,3,0,1,0,0
6151,1013,2018,52,11,41,0.22,21,1095,5,4,2,5,3,1,9,5,0,0,0,2,1,0,1,0,0
6152,1014,2018,33,32,1,0.96,95,1095,17,13,2,9,9,1,19,5,1,2,1,5,4,0,1,0,0
6153,1015,2018,40,23,17,0.57,57,1095,10,11,2,5,6,2,13,2,1,2,0,1,5,2,0,0,0
6154,1016,2018,26,18,8,0.69,69,1095,8,8,2,8,5,1,14,8,0,0,0,2,3,0,1,0,0
6155,1017,2018,22,21,1,0.97,97,1095,11,9,1,11,8,1,20,11,0,0,0,7,1,1,0,0,0
6156,1018,2018,40,22,18,0.55,54,1095,10,9,3,7,6,2,15,4,3,0,0,3,3,1,1,0,0
6157,1019,2018,45,41,4,0.91,91,1095,24,16,1,19,9,1,29,16,1,2,0,2,7,1,0,0,0
6158,1020,2018,28,28,0,1.0,100,1095,19,7,2,19,7,1,27,19,0,0,0,7,0,0,1,0,0
6159,1021,2018,27,26,1,0.95,94,1095,13,12,1,8,10,1,19,5,1,2,0,8,2,1,0,0,0
6160,1022,2018,41,32,9,0.77,76,1095,21,8,3,13,8,1,22,9,0,4,0,8,0,0,0,1,0
6161,1023,2018,53,44,9,0.83,82,1095,27,13,4,12,8,3,23,1,9,0,2,3,5,2,1,0,0
6162,1024,2018,8,8,0,0.95,94,1095,2,4,2,1,2,2,5,0,1,0,0,0,2,2,0,0,0
6163,1025,2018,13,9,4,0.7,70,1095,6,3,0,2,3,0,5,0,1,0,1,3,0,0,0,0,0
6164,1026,2018,35,1,34,0.01,1,1095,0,1,0,0,1,0,1,0,0,0,0,1,0,0,0,0,0
6165,1027,2018,42,17,25,0.39,39,1095,8,6,3,8,5,1,14,8,0,0,0,4,1,0,0,1,0
6166,1028,2018,5,5,0,0.95,94,1095,2,3,0,2,2,0,4,2,0,0,0,1,1,0,0,0,0
6167,1029,2018,6,6,0,1.0,100,1095,3,3,0,2,2,0,4,1,1,0,0,1,1,0,0,0,0
6168,1030,2018,27,22,5,0.82,81,1095,14,6,2,9,4,1,14,6,2,0,1,2,2,0,1,0,0
6169,1031,2018,39,31,8,0.79,78,1095,18,12,1,8,11,1,20,3,0,5,0,10,1,1,0,0,0
6170,1032,2018,16,16,0,0.98,97,1095,5,9,2,5,6,2,13,5,0,0,0,3,3,2,0,0,0
6171,1033,2018,56,15,41,0.26,26,1095,11,3,1,4,3,1,8,1,1,0,2,3,0,1,0,0,0
6172,1034,2018,12,10,2,0.84,84,1095,7,2,1,6,2,1,9,5,1,0,0,2,0,1,0,0,0
6173,1035,2018,31,29,2,0.95,94,1095,12,15,2,8,11,2,21,5,2,1,0,7,4,2,0,0,0
6174,1036,2018,55,49,6,0.89,88,1095,19,29,1,13,17,1,31,10,1,1,1,5,12,1,0,0,0
6175,1037,2018,27,25,2,0.93,93,1095,12,13,0,9,13,0,22,6,3,0,0,13,0,0,0,0,0
6176,1038,2018,21,16,5,0.76,76,1095,9,6,1,3,3,1,7,0,1,1,1,0,3,1,0,0,0
6177,1039,2018,33,11,22,0.34,33,1095,7,3,1,4,2,1,7,3,0,0,1,1,1,1,0,0,0
6178,1040,2018,34,33,1,0.98,97,1095,12,18,3,6,12,2,20,0,6,0,0,6,6,1,1,0,0
6179,1041,2018,31,22,9,0.7,70,1095,12,10,0,4,7,0,11,1,0,1,2,4,3,0,0,0,0
6180,1042,2018,25,24,1,0.96,95,1095,13,10,1,12,7,1,20,11,1,0,0,4,3,1,0,0,0
6181,1043,2018,26,26,0,0.99,98,1095,19,7,0,8,7,0,15,3,2,0,3,7,0,0,0,0,0
6182,1044,2018,54,40,14,0.74,74,1095,20,17,3,8,14,1,23,2,2,2,2,11,3,0,0,1,0
6183,1045,2018,60,14,46,0.24,24,1095,4,7,3,4,7,1,12,4,0,0,0,7,0,0,0,1,0
6184,1046,2018,54,25,29,0.47,46,1095,9,13,3,4,9,1,14,1,1,2,0,5,4,0,0,1,0
6185,1047,2018,30,18,12,0.61,60,1095,9,6,3,5,3,1,9,2,2,1,0,0,3,0,0,1,0
6186,1048,2018,28,27,1,0.98,97,1095,17,6,4,11,6,1,18,7,3,0,1,6,0,0,0,0,1
6187,1049,2018,33,25,8,0.77,76,1095,18,7,0,11,5,0,16,6,4,0,1,3,2,0,0,0,0
6188,1050,2018,45,8,37,0.18,18,1095,4,4,0,1,4,0,5,0,0,0,1,4,0,0,0,0,0
6189,1051,2018,41,15,26,0.37,36,1095,10,3,2,3,2,2,7,0,1,0,2,1,1,2,0,0,0
6190,1052,2018,5,4,1,0.85,85,1095,1,2,1,1,1,1,3,1,0,0,0,0,1,1,0,0,0
6191,1053,2018,46,46,0,0.99,98,1095,31,14,1,9,10,1,20,0,1,3,5,6,4,1,0,0,0
6192,1054,2018,14,3,11,0.22,21,1095,2,1,0,1,1,0,2,0,1,0,0,1,0,0,0,0,0
6193,1055,2018,33,18,15,0.55,55,1095,8,10,0,6,9,0,15,4,2,0,0,8,1,0,0,0,0
6194,1056,2018,29,29,0,1.0,99,1095,16,13,0,6,12,0,18,0,4,0,2,11,1,0,0,0,0
6195,1057,2018,47,21,26,0.45,45,1095,12,7,2,3,4,1,8,0,0,0,3,1,3,0,1,0,0
6196,1058,2018,22,22,0,0.99,98,1095,14,6,2,12,4,1,17,11,0,1,0,2,2,0,1,0,0
6197,1059,2018,8,8,0,0.97,96,1095,5,3,0,2,3,0,5,0,1,1,0,3,0,0,0,0,0
6198,1060,2018,15,14,1,0.94,94,1095,5,7,2,3,6,1,10,2,0,1,0,5,1,0,1,0,0
6199,1061,2018,5,4,1,0.88,87,1095,2,2,0,2,1,0,3,2,0,0,0,0,1,0,0,0,0
6200,1062,2018,50,48,2,0.97,96,1095,30,18,0,29,13,0,42,28,1,0,0,8,5,0,0,0,0
6201,1063,2018,33,14,19,0.43,43,1095,3,8,3,3,4,3,10,3,0,0,0,0,4,3,0,0,0
6202,1064,2018,23,18,5,0.8,80,1095,12,4,2,12,2,1,15,12,0,0,0,0,2,0,1,0,0
6203,1065,2018,30,30,0,1.0,100,1095,18,9,3,15,5,1,21,14,0,0,1,1,4,0,0,1,0
6204,1066,2018,25,7,18,0.26,26,1095,2,3,2,1,3,2,6,0,1,0,0,3,0,2,0,0,0
6205,1067,2018,48,16,32,0.33,32,1095,12,3,1,5,3,1,9,1,2,1,1,3,0,1,0,0,0
6206,1068,2018,27,27,0,0.99,98,1095,15,10,2,4,7,1,12,0,0,1,3,4,3,0,1,0,0
6207,1069,2018,8,1,7,0.17,17,1095,0,1,0,0,1,0,1,0,0,0,0,1,0,0,0,0,0
6208,1070,2018,38,13,25,0.35,34,1095,7,6,0,6,6,0,12,5,1,0,0,6,0,0,0,0,0
6209,1071,2018,38,33,5,0.86,85,1095,16,17,0,9,9,0,18,2,7,0,0,1,8,0,0,0,0
6210,1072,2018,22,22,0,0.99,99,1095,12,10,0,5,9,0,14,0,4,0,1,8,1,0,0,0,0
6211,1073,2018,43,32,11,0.75,75,1095,9,19,4,8,17,3,28,7,1,0,0,15,2,2,1,0,0
6212,1074,2018,35,9,26,0.27,27,1095,5,4,0,4,2,0,6,3,1,0,0,0,2,0,0,0,0
6213,1075,2018,58,54,4,0.93,92,1095,31,22,1,8,13,1,22,0,0,1,7,4,9,1,0,0,0
6214,1076,2018,43,4,39,0.08,8,1095,3,1,0,1,1,0,2,0,0,1,0,1,0,0,0,0,0
6215,1077,2018,31,31,0,1.0,100,1095,17,11,3,6,7,2,15,1,2,0,3,3,4,1,1,0,0
6216,1078,2018,22,13,9,0.6,59,1095,6,4,3,2,2,3,7,0,0,2,0,0,2,3,0,0,0
6217,1079,2018,15,15,0,0.99,99,1095,10,3,2,9,2,2,13,8,1,0,0,1,1,2,0,0,0
6218,1080,2018,21,1,20,0.06,6,1095,0,1,0,0,1,0,1,0,0,0,0,1,0,0,0,0,0
6219,1081,2018,20,20,0,1.0,99,1095,7,11,2,3,10,1,14,1,1,0,1,9,1,0,1,0,0
6220,1082,2018,47,47,0,1.0,99,1095,24,20,3,6,13,1,20,0,0,0,6,6,7,0,0,1,0
6221,1083,2018,27,2,25,0.06,5,1095,1,1,0,1,1,0,2,1,0,0,0,1,0,0,0,0,0
6222,1084,2018,30,30,0,0.99,98,1095,16,10,4,7,10,4,21,3,1,1,2,10,0,4,0,0,0
6223,1085,2018,32,30,2,0.92,92,1095,13,14,3,12,10,3,25,11,1,0,0,6,4,3,0,0,0
6224,1086,2018,30,6,24,0.19,18,1095,3,2,1,1,1,1,3,0,0,1,0,0,1,1,0,0,0
6225,1087,2018,13,2,11,0.17,16,1095,1,1,0,1,1,0,2,1,0,0,0,1,0,0,0,0,0
6226,1088,2018,37,36,1,0.97,96,1095,22,12,2,9,6,2,17,1,3,5,0,0,6,2,0,0,0
6227,1089,2018,8,5,3,0.63,63,1095,3,2,0,1,2,0,3,0,0,1,0,2,0,0,0,0,0
6228,1090,2018,40,17,23,0.42,41,1095,5,8,4,5,6,2,13,5,0,0,0,4,2,1,0,1,0
6229,1091,2018,31,29,2,0.92,92,1095,19,6,4,17,4,1,22,15,2,0,0,2,2,0,0,0,1
6230,1092,2018,35,35,0,1.0,100,1095,26,8,1,16,4,1,21,6,10,0,0,0,4,1,0,0,0
6231,1093,2018,31,19,12,0.61,60,1095,7,11,1,7,7,1,15,7,0,0,0,3,4,1,0,0,0
6232,1094,2018,25,15,10,0.6,59,1095,10,4,1,3,4,1,8,0,0,2,1,4,0,1,0,0,0
6233,1095,2018,28,7,21,0.25,25,1095,2,4,1,2,3,1,6,2,0,0,0,2,1,1,0,0,0
6234,1,2019,33,33,0,1.0,99,965,18,14,1,10,7,1,18,6,2,0,2,0,7,1,0,0,0
6235,2,2019,15,6,9,0.4,40,965,3,2,1,3,1,1,5,3,0,0,0,0,1,1,0,0,0
6236,3,2019,28,28,0,1.0,100,965,10,17,1,8,14,1,23,7,0,1,0,11,3,1,0,0,0
6237,4,2019,40,40,0,1.0,100,965,28,8,4,11,4,2,17,4,0,4,3,0,4,0,2,0,0
6238,5,2019,33,33,0,1.0,100,965,17,13,3,16,9,1,26,15,1,0,0,5,4,0,0,1,0
6239,6,2019,41,41,0,1.0,100,965,14,24,3,7,15,1,23,2,4,0,1,6,9,0,0,1,0
6240,7,2019,55,55,0,1.0,100,965,25,29,1,12,23,1,36,4,5,1,2,17,6,1,0,0,0
6241,8,2019,38,17,21,0.45,44,965,8,8,1,8,5,1,14,8,0,0,0,2,3,1,0,0,0
6242,9,2019,28,4,24,0.13,13,965,1,2,1,1,2,1,4,1,0,0,0,2,0,1,0,0,0
6243,10,2019,12,12,0,1.0,100,965,5,6,1,5,5,1,11,5,0,0,0,4,1,1,0,0,0
6244,11,2019,49,21,28,0.43,42,965,13,6,2,6,6,2,14,2,1,3,0,6,0,2,0,0,0
6245,12,2019,34,0,34,0.0,0,965,0,0,0,0,0,0,0,0,0,0,0,0,0,0,0,0,0
6246,13,2019,6,6,0,0.99,98,965,2,3,1,1,3,1,5,0,1,0,0,3,0,1,0,0,0
6247,14,2019,32,0,32,0.01,1,965,0,0,0,0,0,0,0,0,0,0,0,0,0,0,0,0,0
6248,15,2019,7,7,0,0.98,98,965,5,2,0,3,2,0,5,1,2,0,0,2,0,0,0,0,0
6249,16,2019,47,47,0,1.0,99,965,30,14,3,9,14,1,24,0,3,0,6,14,0,0,0,1,0
6250,17,2019,13,13,0,1.0,99,965,6,4,3,4,4,2,10,3,0,1,0,4,0,1,1,0,0
6251,18,2019,40,40,0,1.0,100,965,21,19,0,11,19,0,30,7,1,0,3,19,0,0,0,0,0
6252,19,2019,10,1,9,0.11,10,965,0,1,0,0,1,0,1,0,0,0,0,1,0,0,0,0,0
6253,20,2019,9,9,0,1.0,99,965,2,5,2,1,3,1,5,0,1,0,0,1,2,0,1,0,0
6254,21,2019,52,31,21,0.6,59,965,20,9,2,9,9,2,20,5,0,1,3,9,0,2,0,0,0
6255,22,2019,5,5,0,0.93,93,965,3,2,0,1,1,0,2,0,0,1,0,0,1,0,0,0,0
6256,23,2019,34,34,0,1.0,100,965,13,19,2,10,15,1,26,8,1,1,0,11,4,0,1,0,0
6257,24,2019,37,37,0,0.99,98,965,15,21,1,13,21,1,35,12,0,1,0,21,0,1,0,0,0
6258,25,2019,36,36,0,1.0,100,965,16,18,2,14,13,2,29,12,2,0,0,8,5,2,0,0,0
6259,26,2019,33,33,0,1.0,100,965,19,13,1,13,9,1,23,8,4,1,0,5,4,1,0,0,0
6260,27,2019,27,15,12,0.54,54,965,4,7,4,4,5,1,10,4,0,0,0,3,2,0,0,0,1
6261,28,2019,27,27,0,0.99,99,965,11,13,3,8,7,2,17,7,0,0,1,1,6,1,1,0,0
6262,29,2019,8,2,6,0.24,23,965,1,1,0,1,1,0,2,1,0,0,0,1,0,0,0,0,0
6263,30,2019,59,59,0,1.0,100,965,30,28,1,17,15,1,33,10,2,4,1,2,13,1,0,0,0
6264,31,2019,60,33,27,0.55,55,965,16,16,1,16,13,1,30,16,0,0,0,10,3,1,0,0,0
6265,32,2019,10,10,0,1.0,100,965,5,5,0,5,5,0,10,5,0,0,0,5,0,0,0,0,0
6266,33,2019,28,28,0,1.0,99,965,18,7,3,6,6,2,14,1,1,1,3,5,1,1,1,0,0
6267,34,2019,10,8,2,0.76,75,965,5,3,0,4,3,0,7,3,1,0,0,3,0,0,0,0,0
6268,35,2019,52,52,0,1.0,100,965,21,29,2,11,19,2,32,5,2,4,0,9,10,2,0,0,0
6269,36,2019,58,57,1,0.99,99,965,22,32,3,17,22,1,40,12,5,0,0,12,10,0,0,1,0
6270,37,2019,53,53,0,1.0,99,965,32,18,3,31,13,1,45,30,1,0,0,8,5,0,0,1,0
6271,38,2019,19,19,0,1.0,99,965,10,6,3,7,5,1,13,4,3,0,0,4,1,0,0,1,0
6272,39,2019,16,4,12,0.25,24,965,1,2,1,1,2,1,4,1,0,0,0,2,0,1,0,0,0
6273,40,2019,8,8,0,1.0,100,965,4,3,1,1,2,1,4,0,0,0,1,1,1,1,0,0,0
6274,41,2019,24,23,1,0.97,97,965,12,10,1,6,9,1,16,2,2,2,0,8,1,1,0,0,0
6275,42,2019,8,0,8,0.03,3,965,0,0,0,0,0,0,0,0,0,0,0,0,0,0,0,0,0
6276,43,2019,40,39,1,0.98,98,965,26,13,0,21,8,0,29,19,0,1,1,3,5,0,0,0,0
6277,44,2019,29,28,1,0.98,97,965,15,12,1,15,10,1,26,15,0,0,0,8,2,1,0,0,0
6278,45,2019,42,10,32,0.25,24,965,5,3,2,4,3,2,9,3,1,0,0,3,0,2,0,0,0
6279,46,2019,53,53,0,1.0,100,965,34,17,2,18,13,2,33,8,5,4,1,9,4,2,0,0,0
6280,47,2019,37,37,0,1.0,100,965,22,12,3,13,11,1,25,4,9,0,0,10,1,0,0,1,0
6281,48,2019,24,24,0,1.0,100,965,14,9,1,10,6,1,17,8,1,0,1,3,3,1,0,0,0
6282,49,2019,60,59,1,0.98,98,965,33,24,2,27,15,2,44,25,0,0,2,6,9,2,0,0,0
6283,50,2019,17,17,0,0.99,98,965,10,4,3,4,4,1,9,1,0,3,0,4,0,0,0,1,0
6284,51,2019,18,18,0,1.0,99,965,11,5,2,5,4,1,10,1,3,0,1,3,1,0,1,0,0
6285,52,2019,34,31,3,0.92,91,965,21,8,2,7,7,1,15,0,0,7,0,6,1,0,1,0,0
6286,53,2019,25,7,18,0.29,29,965,2,3,2,1,2,2,5,0,1,0,0,1,1,2,0,0,0
6287,54,2019,26,26,0,0.98,98,965,16,10,0,12,5,0,17,10,0,2,0,0,5,0,0,0,0
6288,55,2019,31,31,0,1.0,100,965,19,9,3,13,5,1,19,7,6,0,0,1,4,0,0,1,0
6289,56,2019,25,25,0,1.0,100,965,16,5,4,10,4,1,15,6,2,2,0,3,1,0,0,0,1
6290,57,2019,11,11,0,1.0,100,965,6,4,1,3,4,1,8,2,0,0,1,4,0,1,0,0,0
6291,58,2019,33,33,0,1.0,100,965,21,8,4,13,8,3,24,7,4,2,0,8,0,2,1,0,0
6292,59,2019,7,7,0,1.0,100,965,4,3,0,3,3,0,6,2,1,0,0,3,0,0,0,0,0
6293,60,2019,5,4,1,0.74,74,965,1,2,1,1,2,1,4,1,0,0,0,2,0,1,0,0,0
6294,61,2019,23,23,0,1.0,100,965,16,7,0,8,6,0,14,4,0,4,0,5,1,0,0,0,0
6295,62,2019,47,47,0,0.99,98,965,33,10,4,25,8,4,37,21,1,2,1,6,2,4,0,0,0
6296,63,2019,7,5,2,0.65,65,965,2,2,1,1,1,1,3,0,1,0,0,0,1,1,0,0,0
6297,64,2019,39,39,0,0.99,98,965,28,9,2,9,9,1,19,0,0,8,1,9,0,0,1,0,0
6298,65,2019,47,43,4,0.91,90,965,25,16,2,9,14,1,24,3,0,2,4,12,2,0,1,0,0
6299,66,2019,23,23,0,1.0,100,965,14,8,1,11,4,1,16,10,0,0,1,0,4,1,0,0,0
6300,67,2019,7,4,3,0.53,52,965,1,2,1,1,1,1,3,1,0,0,0,0,1,1,0,0,0
6301,68,2019,36,36,0,1.0,100,965,14,19,3,14,10,3,27,14,0,0,0,1,9,3,0,0,0
6302,69,2019,44,15,29,0.34,34,965,6,8,1,2,6,1,9,0,1,0,1,4,2,1,0,0,0
6303,70,2019,50,48,2,0.96,95,965,26,20,2,26,18,2,46,26,0,0,0,16,2,2,0,0,0
6304,71,2019,14,8,6,0.6,59,965,4,3,1,1,3,1,5,0,0,0,1,3,0,1,0,0,0
6305,72,2019,34,34,0,1.0,99,965,23,9,2,14,6,2,22,7,6,0,1,3,3,2,0,0,0
6306,73,2019,50,9,41,0.18,18,965,6,2,1,5,1,1,7,4,1,0,0,0,1,1,0,0,0
6307,74,2019,40,40,0,1.0,100,965,27,10,3,27,6,1,34,27,0,0,0,2,4,0,0,1,0
6308,75,2019,34,32,2,0.93,92,965,20,11,1,11,8,1,20,5,4,1,1,5,3,1,0,0,0
6309,76,2019,43,42,1,0.98,98,965,23,18,1,12,18,1,31,6,1,5,0,18,0,1,0,0,0
6310,77,2019,13,13,0,0.99,98,965,9,4,0,7,3,0,10,6,0,1,0,2,1,0,0,0,0
6311,78,2019,15,15,0,1.0,100,965,3,9,3,1,8,2,11,0,0,1,0,7,1,1,1,0,0
6312,79,2019,19,19,0,0.98,98,965,10,5,4,10,5,1,16,10,0,0,0,5,0,0,0,0,1
6313,80,2019,43,43,0,0.99,98,965,29,11,3,9,6,1,16,0,2,3,4,1,5,0,0,1,0
6314,81,2019,55,54,1,0.98,98,965,23,28,3,12,27,3,42,2,9,1,0,26,1,3,0,0,0
6315,82,2019,23,23,0,1.0,100,965,12,7,4,10,6,3,19,8,2,0,0,5,1,2,1,0,0
6316,83,2019,9,9,0,0.99,98,965,2,5,2,1,3,1,5,0,1,0,0,1,2,0,1,0,0
6317,84,2019,31,31,0,1.0,100,965,17,12,2,6,10,1,17,0,3,1,2,8,2,0,1,0,0
6318,85,2019,6,6,0,1.0,100,965,4,2,0,4,1,0,5,4,0,0,0,0,1,0,0,0,0
6319,86,2019,53,53,0,1.0,100,965,36,15,2,23,15,1,39,12,9,2,0,15,0,0,1,0,0
6320,87,2019,27,27,0,1.0,100,965,20,5,2,11,4,2,17,4,5,2,0,3,1,2,0,0,0
6321,88,2019,19,18,1,0.95,95,965,5,11,2,4,7,1,12,3,1,0,0,3,4,0,1,0,0
6322,89,2019,29,29,0,1.0,100,965,14,12,3,9,12,3,24,5,3,1,0,12,0,3,0,0,0
6323,90,2019,15,15,0,1.0,100,965,6,7,2,6,4,1,11,6,0,0,0,1,3,0,1,0,0
6324,91,2019,57,56,1,0.99,98,965,29,26,1,18,14,1,33,12,1,5,0,2,12,1,0,0,0
6325,92,2019,40,40,0,1.0,100,965,26,14,0,26,9,0,35,26,0,0,0,4,5,0,0,0,0
6326,93,2019,26,21,5,0.81,80,965,16,4,1,5,2,1,8,0,0,4,1,0,2,1,0,0,0
6327,94,2019,21,21,0,1.0,100,965,10,9,2,3,9,1,13,0,0,2,1,9,0,0,1,0,0
6328,95,2019,39,39,0,1.0,100,965,24,11,4,12,7,1,20,1,10,1,0,3,4,0,0,0,1
6329,96,2019,12,12,0,0.99,99,965,5,6,1,5,5,1,11,5,0,0,0,4,1,1,0,0,0
6330,97,2019,28,28,0,1.0,100,965,10,14,4,9,13,3,25,8,1,0,0,12,1,2,1,0,0
6331,98,2019,60,59,1,0.99,98,965,34,24,1,34,14,1,49,34,0,0,0,4,10,1,0,0,0
6332,99,2019,56,55,1,0.98,97,965,31,20,4,26,17,4,47,24,0,1,1,14,3,4,0,0,0
6333,100,2019,27,2,25,0.07,6,965,1,1,0,1,1,0,2,1,0,0,0,1,0,0,0,0,0
6334,101,2019,31,31,0,1.0,100,965,20,11,0,9,10,0,19,0,8,0,1,9,1,0,0,0,0
6335,102,2019,10,10,0,1.0,100,965,5,4,1,4,4,1,9,3,1,0,0,4,0,1,0,0,0
6336,103,2019,29,11,18,0.38,38,965,8,2,1,2,1,1,4,0,0,0,2,0,1,1,0,0,0
6337,104,2019,57,27,30,0.47,47,965,16,10,1,9,10,1,20,4,4,0,1,10,0,1,0,0,0
6338,105,2019,15,15,0,0.99,98,965,5,8,2,5,4,2,11,5,0,0,0,0,4,2,0,0,0
6339,106,2019,7,7,0,0.99,98,965,2,3,2,2,3,1,6,2,0,0,0,3,0,0,1,0,0
6340,107,2019,8,8,0,1.0,100,965,4,3,1,2,3,1,6,1,0,1,0,3,0,1,0,0,0
6341,108,2019,24,24,0,0.99,98,965,7,13,4,3,12,1,16,1,0,2,0,11,1,0,0,0,1
6342,109,2019,16,16,0,1.0,99,965,5,9,2,5,8,1,14,5,0,0,0,7,1,0,1,0,0
6343,110,2019,19,19,0,1.0,99,965,8,8,3,4,8,2,14,0,4,0,0,8,0,1,1,0,0
6344,111,2019,41,41,0,1.0,100,965,17,23,1,5,20,1,26,1,0,0,4,17,3,1,0,0,0
6345,112,2019,14,0,14,0.01,1,965,0,0,0,0,0,0,0,0,0,0,0,0,0,0,0,0,0
6346,113,2019,7,7,0,1.0,100,965,2,3,2,1,3,1,5,0,1,0,0,3,0,0,1,0,0
6347,114,2019,18,17,1,0.97,97,965,11,5,1,5,5,1,11,1,2,2,0,5,0,1,0,0,0
6348,115,2019,5,5,0,0.93,92,965,2,2,1,2,2,1,5,2,0,0,0,2,0,1,0,0,0
6349,116,2019,42,6,36,0.14,14,965,3,3,0,3,2,0,5,3,0,0,0,1,1,0,0,0,0
6350,117,2019,8,8,0,1.0,100,965,5,3,0,4,2,0,6,3,1,0,0,1,1,0,0,0,0
6351,118,2019,15,14,1,0.91,90,965,7,4,3,5,4,1,10,4,0,1,0,4,0,0,0,1,0
6352,119,2019,14,5,9,0.35,35,965,1,3,1,1,2,1,4,1,0,0,0,1,1,1,0,0,0
6353,120,2019,32,32,0,1.0,100,965,19,11,2,11,11,2,24,5,4,2,0,11,0,2,0,0,0
6354,121,2019,32,31,1,0.95,95,965,12,18,1,5,11,1,17,2,0,2,1,4,7,1,0,0,0
6355,122,2019,6,6,0,0.96,96,965,4,2,0,2,1,0,3,0,2,0,0,0,1,0,0,0,0
6356,123,2019,20,20,0,1.0,100,965,13,7,0,6,7,0,13,1,3,2,0,7,0,0,0,0,0
6357,124,2019,40,40,0,1.0,100,965,16,21,3,12,11,2,25,10,1,0,1,1,10,1,1,0,0
6358,125,2019,48,48,0,0.99,98,965,20,24,4,9,22,2,33,1,6,1,1,20,2,1,0,1,0
6359,126,2019,55,31,24,0.57,57,965,11,17,3,6,12,3,21,4,0,1,1,7,5,3,0,0,0
6360,127,2019,15,7,8,0.44,44,965,3,3,1,2,2,1,5,1,1,0,0,1,1,1,0,0,0
6361,128,2019,11,11,0,1.0,100,965,3,5,3,1,3,2,6,0,0,1,0,1,2,1,1,0,0
6362,129,2019,58,58,0,1.0,100,965,37,18,3,16,16,3,35,8,1,1,6,14,2,3,0,0,0
6363,130,2019,15,15,0,1.0,100,965,7,6,2,6,5,2,13,5,1,0,0,4,1,2,0,0,0
6364,131,2019,52,52,0,1.0,99,965,24,26,2,11,19,2,32,5,1,3,2,12,7,2,0,0,0
6365,132,2019,28,20,8,0.73,73,965,8,8,4,2,7,4,13,0,0,0,2,6,1,4,0,0,0
6366,133,2019,57,31,26,0.54,53,965,23,6,2,21,6,2,29,19,2,0,0,6,0,2,0,0,0
6367,134,2019,26,18,8,0.69,69,965,12,4,2,3,2,1,6,0,0,0,3,0,2,0,1,0,0
6368,135,2019,42,42,0,1.0,100,965,23,19,0,10,16,0,26,0,8,1,1,13,3,0,0,0,0
6369,136,2019,9,9,0,0.98,97,965,5,4,0,5,2,0,7,5,0,0,0,0,2,0,0,0,0
6370,137,2019,23,11,12,0.49,48,965,3,5,3,3,3,2,8,3,0,0,0,1,2,1,1,0,0
6371,138,2019,19,19,0,1.0,100,965,6,11,2,4,6,1,11,3,0,1,0,1,5,0,1,0,0
6372,139,2019,42,42,0,1.0,100,965,29,11,2,15,7,1,23,10,0,1,4,3,4,0,1,0,0
6373,140,2019,29,17,12,0.58,58,965,9,7,1,7,7,1,15,6,0,1,0,7,0,1,0,0,0
6374,141,2019,12,12,0,1.0,100,965,3,6,3,2,3,2,7,1,1,0,0,0,3,1,1,0,0
6375,142,2019,7,7,0,0.99,99,965,3,3,1,3,3,1,7,3,0,0,0,3,0,1,0,0,0
6376,143,2019,7,7,0,0.98,98,965,5,2,0,2,2,0,4,1,0,0,1,2,0,0,0,0,0
6377,144,2019,6,6,0,0.92,91,965,2,3,1,2,3,1,6,2,0,0,0,3,0,1,0,0,0
6378,145,2019,15,15,0,1.0,100,965,6,6,3,4,3,1,8,3,0,1,0,0,3,0,0,1,0
6379,146,2019,29,22,7,0.74,74,965,11,9,2,5,6,1,12,1,2,2,0,3,3,0,1,0,0
6380,147,2019,22,6,16,0.26,25,965,3,2,1,1,1,1,3,0,0,1,0,0,1,1,0,0,0
6381,148,2019,19,18,1,0.97,97,965,11,7,0,4,5,0,9,1,1,0,2,3,2,0,0,0,0
6382,149,2019,32,32,0,1.0,100,965,22,7,3,7,4,1,12,0,0,6,1,1,3,0,0,1,0
6383,150,2019,33,33,0,1.0,100,965,11,20,2,9,13,1,23,8,0,1,0,6,7,0,1,0,0
6384,151,2019,16,15,1,0.92,92,965,10,3,2,5,3,2,10,2,1,2,0,3,0,2,0,0,0
6385,152,2019,6,2,4,0.39,39,965,1,1,0,1,1,0,2,1,0,0,0,1,0,0,0,0,0
6386,153,2019,31,31,0,1.0,100,965,21,7,3,6,4,2,12,1,0,0,5,1,3,1,1,0,0
6387,154,2019,32,12,20,0.39,38,965,5,5,2,4,4,1,9,3,1,0,0,3,1,0,1,0,0
6388,155,2019,27,27,0,1.0,100,965,7,16,4,5,14,4,23,4,0,1,0,12,2,4,0,0,0
6389,156,2019,30,21,9,0.71,71,965,11,9,1,6,7,1,14,3,2,0,1,5,2,1,0,0,0
6390,157,2019,22,22,0,1.0,100,965,12,6,4,12,4,1,17,12,0,0,0,2,2,0,0,0,1
6391,158,2019,26,24,2,0.94,93,965,11,9,4,8,6,1,15,6,1,1,0,3,3,0,0,0,1
6392,159,2019,7,7,0,1.0,99,965,3,3,1,3,2,1,6,3,0,0,0,1,1,1,0,0,0
6393,160,2019,21,21,0,1.0,100,965,10,8,3,3,5,1,9,0,0,2,1,2,3,0,0,1,0
6394,161,2019,34,8,26,0.22,22,965,3,3,2,2,2,1,5,1,1,0,0,1,1,0,1,0,0
6395,162,2019,31,21,10,0.69,68,965,8,11,2,7,10,2,19,6,1,0,0,9,1,2,0,0,0
6396,163,2019,54,52,2,0.95,95,965,37,12,3,23,6,2,31,15,2,6,0,0,6,1,1,0,0
6397,164,2019,5,5,0,1.0,100,965,2,2,1,1,1,1,3,0,1,0,0,0,1,1,0,0,0
6398,165,2019,15,15,0,1.0,99,965,8,5,2,6,4,1,11,4,2,0,0,3,1,0,1,0,0
6399,166,2019,30,30,0,1.0,99,965,16,11,3,6,7,3,16,1,1,3,1,3,4,3,0,0,0
6400,167,2019,15,0,15,0.01,1,965,0,0,0,0,0,0,0,0,0,0,0,0,0,0,0,0,0
6401,168,2019,48,48,0,1.0,99,965,27,17,4,8,16,4,28,0,2,1,5,15,1,4,0,0,0
6402,169,2019,45,33,12,0.73,72,965,17,13,3,17,10,1,28,17,0,0,0,7,3,0,0,1,0
6403,170,2019,26,26,0,1.0,100,965,11,12,3,7,9,1,17,4,2,1,0,6,3,0,0,1,0
6404,171,2019,13,7,6,0.55,54,965,2,3,2,2,2,1,5,2,0,0,0,1,1,0,1,0,0
6405,172,2019,40,4,36,0.09,9,965,1,2,1,1,1,1,3,1,0,0,0,0,1,1,0,0,0
6406,173,2019,39,37,2,0.96,95,965,23,14,0,11,9,0,20,1,9,0,1,4,5,0,0,0,0
6407,174,2019,38,35,3,0.92,92,965,25,7,3,20,5,3,28,17,1,2,0,3,2,3,0,0,0
6408,175,2019,39,38,1,0.98,97,965,20,17,1,8,16,1,25,2,2,2,2,15,1,1,0,0,0
6409,176,2019,14,14,0,1.0,100,965,8,5,1,2,5,1,8,0,0,0,2,5,0,1,0,0,0
6410,177,2019,17,17,0,1.0,100,965,5,10,2,4,7,2,13,3,1,0,0,4,3,2,0,0,0
6411,178,2019,14,14,0,1.0,100,965,3,8,3,1,7,3,11,0,0,1,0,6,1,3,0,0,0
6412,179,2019,30,11,19,0.36,36,965,6,3,2,2,3,1,6,0,1,0,1,3,0,0,1,0,0
6413,180,2019,51,26,25,0.52,51,965,10,13,3,9,13,1,23,8,1,0,0,13,0,0,0,1,0
6414,181,2019,26,26,0,1.0,100,965,12,14,0,6,7,0,13,0,6,0,0,0,7,0,0,0,0
6415,182,2019,33,33,0,1.0,99,965,11,18,4,6,9,1,16,3,1,2,0,0,9,0,0,0,1
6416,183,2019,32,13,19,0.41,41,965,6,5,2,3,3,2,8,0,3,0,0,1,2,2,0,0,0
6417,184,2019,40,40,0,1.0,99,965,18,19,3,11,16,3,30,7,2,1,1,13,3,3,0,0,0
6418,185,2019,7,7,0,0.99,98,965,3,3,1,1,3,1,5,0,0,1,0,3,0,1,0,0,0
6419,186,2019,14,14,0,1.0,100,965,10,3,1,9,2,1,12,8,1,0,0,1,1,1,0,0,0
6420,187,2019,22,22,0,1.0,100,965,7,12,3,4,6,2,12,2,1,1,0,0,6,1,1,0,0
6421,188,2019,19,19,0,1.0,100,965,8,10,1,6,10,1,17,5,0,1,0,10,0,1,0,0,0
6422,189,2019,16,16,0,1.0,100,965,11,4,1,7,2,1,10,3,4,0,0,0,2,1,0,0,0
6423,190,2019,33,33,0,1.0,100,965,16,14,3,11,10,2,23,7,3,1,0,6,4,1,1,0,0
6424,191,2019,13,13,0,1.0,100,965,4,7,2,4,5,1,10,4,0,0,0,3,2,0,1,0,0
6425,192,2019,7,7,0,0.96,95,965,3,3,1,3,3,1,7,3,0,0,0,3,0,1,0,0,0
6426,193,2019,39,39,0,0.99,99,965,28,11,0,10,6,0,16,0,4,4,2,1,5,0,0,0,0
6427,194,2019,40,40,0,1.0,100,965,19,18,3,9,17,3,29,4,0,5,0,16,1,3,0,0,0
6428,195,2019,34,22,12,0.65,64,965,12,7,3,4,7,2,13,0,2,0,2,7,0,1,1,0,0
6429,196,2019,19,19,0,1.0,100,965,12,6,1,6,5,1,12,1,4,1,0,4,1,1,0,0,0
6430,197,2019,8,7,1,0.84,84,965,2,4,1,1,2,1,4,0,1,0,0,0,2,1,0,0,0
6431,198,2019,30,14,16,0.47,46,965,5,7,2,5,7,1,13,5,0,0,0,7,0,0,1,0,0
6432,199,2019,6,6,0,0.98,98,965,3,2,1,3,1,1,5,3,0,0,0,0,1,1,0,0,0
6433,200,2019,54,51,3,0.94,93,965,34,17,0,10,11,0,21,0,2,2,6,5,6,0,0,0,0
6434,201,2019,46,45,1,0.98,97,965,32,11,2,21,10,1,32,12,7,2,0,9,1,0,1,0,0
6435,202,2019,35,5,30,0.15,15,965,1,3,1,1,3,1,5,1,0,0,0,3,0,1,0,0,0
6436,203,2019,25,8,17,0.33,32,965,3,4,1,2,2,1,5,1,1,0,0,0,2,1,0,0,0
6437,204,2019,38,38,0,1.0,100,965,15,21,2,11,20,2,33,9,0,2,0,19,1,2,0,0,0
6438,205,2019,27,27,0,1.0,100,965,19,7,1,7,7,1,15,1,0,6,0,7,0,1,0,0,0
6439,206,2019,31,31,0,1.0,100,965,17,12,2,10,12,2,24,7,1,0,2,12,0,2,0,0,0
6440,207,2019,6,6,0,1.0,100,965,3,2,1,3,2,1,6,3,0,0,0,2,0,1,0,0,0
6441,208,2019,36,36,0,1.0,100,965,16,18,2,11,15,2,28,6,5,0,0,12,3,2,0,0,0
6442,209,2019,32,0,32,0.0,0,965,0,0,0,0,0,0,0,0,0,0,0,0,0,0,0,0,0
6443,210,2019,34,23,11,0.68,67,965,15,6,2,15,4,1,20,15,0,0,0,2,2,0,1,0,0
6444,211,2019,31,31,0,1.0,100,965,18,13,0,6,13,0,19,0,3,0,3,13,0,0,0,0,0
6445,212,2019,35,35,0,1.0,100,965,25,7,3,12,5,3,20,3,6,2,1,3,2,3,0,0,0
6446,213,2019,10,1,9,0.11,10,965,0,1,0,0,1,0,1,0,0,0,0,1,0,0,0,0,0
6447,214,2019,18,18,0,1.0,100,965,8,7,3,3,7,2,12,0,1,2,0,7,0,1,1,0,0
6448,215,2019,5,5,0,1.0,100,965,2,2,1,2,2,1,5,2,0,0,0,2,0,1,0,0,0
6449,216,2019,26,26,0,1.0,100,965,19,4,3,13,4,1,18,10,0,3,0,4,0,0,0,1,0
6450,217,2019,36,36,0,1.0,100,965,14,21,1,5,16,1,22,0,3,0,2,11,5,1,0,0,0
6451,218,2019,39,39,0,1.0,99,965,18,20,1,12,19,1,32,8,2,2,0,18,1,1,0,0,0
6452,219,2019,48,48,0,1.0,100,965,31,16,1,16,10,1,27,7,4,4,1,4,6,1,0,0,0
6453,220,2019,44,34,10,0.77,77,965,20,11,3,7,11,1,19,1,1,3,2,11,0,0,0,1,0
6454,221,2019,37,37,0,1.0,99,965,20,17,0,17,15,0,32,14,3,0,0,13,2,0,0,0,0
6455,222,2019,15,8,7,0.53,52,965,3,3,2,3,2,2,7,3,0,0,0,1,1,2,0,0,0
6456,223,2019,50,50,0,1.0,100,965,29,21,0,8,15,0,23,1,0,0,7,9,6,0,0,0,0
6457,224,2019,21,21,0,1.0,100,965,11,6,4,7,5,2,14,4,2,1,0,4,1,1,0,1,0
6458,225,2019,16,16,0,1.0,100,965,11,3,2,11,2,1,14,11,0,0,0,1,1,0,1,0,0
6459,226,2019,7,7,0,0.95,95,965,4,2,1,1,1,1,3,0,0,0,1,0,1,1,0,0,0
6460,227,2019,17,17,0,1.0,99,965,11,4,2,10,4,2,16,9,1,0,0,4,0,2,0,0,0
6461,228,2019,11,10,1,0.92,91,965,6,4,0,6,4,0,10,6,0,0,0,4,0,0,0,0,0
6462,229,2019,14,14,0,1.0,100,965,3,8,3,2,6,2,10,1,1,0,0,4,2,1,1,0,0
6463,230,2019,22,21,1,0.96,96,965,12,5,4,8,5,3,16,5,2,1,0,5,0,2,1,0,0
6464,231,2019,17,15,2,0.89,89,965,8,6,1,4,6,1,11,1,2,1,0,6,0,1,0,0,0
6465,232,2019,30,28,2,0.94,93,965,15,13,0,15,10,0,25,15,0,0,0,7,3,0,0,0,0
6466,233,2019,16,14,2,0.87,86,965,5,5,4,2,5,4,11,1,0,0,1,5,0,4,0,0,0
6467,234,2019,24,3,21,0.14,13,965,2,1,0,1,1,0,2,0,1,0,0,1,0,0,0,0,0
6468,235,2019,22,22,0,1.0,100,965,11,10,1,6,5,1,12,4,0,1,1,0,5,1,0,0,0
6469,236,2019,14,14,0,0.98,98,965,3,8,3,1,4,3,8,0,0,1,0,0,4,3,0,0,0
6470,237,2019,42,5,37,0.13,12,965,4,1,0,1,1,0,2,0,0,0,1,1,0,0,0,0,0
6471,238,2019,17,16,1,0.95,94,965,6,9,1,4,5,1,10,2,2,0,0,1,4,1,0,0,0
6472,239,2019,12,1,11,0.11,11,965,0,1,0,0,1,0,1,0,0,0,0,1,0,0,0,0,0
6473,240,2019,28,28,0,1.0,99,965,10,15,3,4,12,3,19,2,0,0,2,9,3,3,0,0,0
6474,241,2019,18,18,0,1.0,100,965,9,7,2,6,6,2,14,3,3,0,0,5,1,2,0,0,0
6475,242,2019,55,55,0,1.0,100,965,27,26,2,9,13,1,23,0,4,1,4,0,13,0,1,0,0
6476,243,2019,22,21,1,0.97,97,965,9,9,3,8,5,3,16,7,1,0,0,1,4,3,0,0,0
6477,244,2019,53,52,1,0.98,98,965,30,21,1,26,11,1,38,24,0,2,0,1,10,1,0,0,0
6478,245,2019,46,46,0,1.0,99,965,32,13,1,15,13,1,29,0,13,2,0,13,0,1,0,0,0
6479,246,2019,30,30,0,1.0,100,965,18,11,1,11,7,1,19,4,7,0,0,3,4,1,0,0,0
6480,247,2019,39,29,10,0.75,75,965,13,16,0,8,13,0,21,6,0,1,1,10,3,0,0,0,0
6481,248,2019,15,15,0,1.0,100,965,9,4,2,4,3,2,9,1,1,2,0,2,1,2,0,0,0
6482,249,2019,13,13,0,1.0,100,965,4,7,2,2,7,2,11,0,2,0,0,7,0,2,0,0,0
6483,250,2019,46,46,0,1.0,99,965,29,17,0,20,17,0,37,11,9,0,0,17,0,0,0,0,0
6484,251,2019,51,50,1,0.97,97,965,37,11,2,12,9,1,22,0,1,9,2,7,2,0,1,0,0
6485,252,2019,11,9,2,0.84,84,965,5,3,1,4,2,1,7,3,1,0,0,1,1,1,0,0,0
6486,253,2019,57,57,0,1.0,99,965,25,32,0,18,23,0,41,15,1,0,2,14,9,0,0,0,0
6487,254,2019,30,30,0,1.0,100,965,20,6,4,15,6,3,24,12,1,2,0,6,0,2,1,0,0
6488,255,2019,35,35,0,1.0,100,965,16,17,2,8,16,1,25,2,5,0,1,15,1,0,1,0,0
6489,256,2019,34,9,25,0.27,26,965,4,5,0,3,3,0,6,2,1,0,0,1,2,0,0,0,0
6490,257,2019,15,15,0,1.0,100,965,8,4,3,4,2,2,8,2,0,2,0,0,2,1,1,0,0
6491,258,2019,37,34,3,0.92,91,965,20,13,1,6,12,1,19,0,1,2,3,11,1,1,0,0,0
6492,259,2019,14,2,12,0.12,12,965,1,1,0,1,1,0,2,1,0,0,0,1,0,0,0,0,0
6493,260,2019,56,50,6,0.9,89,965,27,21,2,18,16,2,36,14,0,3,1,11,5,2,0,0,0
6494,261,2019,7,7,0,0.98,97,965,2,3,2,1,2,2,5,0,1,0,0,1,1,2,0,0,0
6495,262,2019,30,22,8,0.75,74,965,13,8,1,7,5,1,13,4,1,1,1,2,3,1,0,0,0
6496,263,2019,29,29,0,1.0,99,965,10,17,2,10,13,2,25,10,0,0,0,9,4,2,0,0,0
6497,264,2019,25,25,0,1.0,100,965,10,14,1,9,14,1,24,8,1,0,0,14,0,1,0,0,0
6498,265,2019,23,23,0,1.0,100,965,10,12,1,10,6,1,17,10,0,0,0,0,6,1,0,0,0
6499,266,2019,25,23,2,0.9,90,965,13,7,3,10,7,1,18,8,1,1,0,7,0,0,0,1,0
6500,267,2019,12,12,0,0.99,99,965,6,6,0,5,6,0,11,4,1,0,0,6,0,0,0,0,0
6501,268,2019,19,19,0,1.0,100,965,11,6,2,7,4,2,13,3,4,0,0,2,2,2,0,0,0
6502,269,2019,32,1,31,0.02,2,965,0,1,0,0,1,0,1,0,0,0,0,1,0,0,0,0,0
6503,270,2019,35,35,0,0.99,98,965,22,10,3,18,7,1,26,14,4,0,0,4,3,0,0,1,0
6504,271,2019,30,30,0,1.0,100,965,16,10,4,7,6,3,16,1,3,3,0,2,4,2,1,0,0
6505,272,2019,46,46,0,1.0,100,965,25,21,0,24,19,0,43,23,1,0,0,17,2,0,0,0,0
6506,273,2019,14,14,0,1.0,100,965,7,7,0,7,5,0,12,7,0,0,0,3,2,0,0,0,0
6507,274,2019,19,19,0,1.0,100,965,5,11,3,4,10,3,17,3,1,0,0,9,1,3,0,0,0
6508,275,2019,11,6,5,0.52,52,965,3,2,1,2,2,1,5,1,1,0,0,2,0,1,0,0,0
6509,276,2019,31,31,0,0.99,98,965,10,18,3,6,18,2,26,4,0,2,0,18,0,1,1,0,0
6510,277,2019,28,28,0,1.0,100,965,16,9,3,8,9,3,20,0,8,0,0,9,0,3,0,0,0
6511,278,2019,31,30,1,0.98,97,965,16,10,4,16,6,4,26,16,0,0,0,2,4,4,0,0,0
6512,279,2019,21,15,6,0.73,72,965,9,6,0,5,6,0,11,3,0,2,0,6,0,0,0,0,0
6513,280,2019,15,15,0,1.0,100,965,6,5,4,3,4,3,10,2,0,0,1,3,1,2,1,0,0
6514,281,2019,39,39,0,1.0,100,965,20,18,1,17,13,1,31,16,0,0,1,8,5,1,0,0,0
6515,282,2019,49,48,1,0.99,98,965,28,17,3,11,10,1,22,3,3,1,4,3,7,0,0,1,0
6516,283,2019,20,3,17,0.13,12,965,2,1,0,2,1,0,3,2,0,0,0,1,0,0,0,0,0
6517,284,2019,11,1,10,0.12,11,965,0,1,0,0,1,0,1,0,0,0,0,1,0,0,0,0,0
6518,285,2019,48,48,0,1.0,100,965,26,21,1,13,11,1,25,4,6,2,1,1,10,1,0,0,0
6519,286,2019,28,6,22,0.23,22,965,3,2,1,1,2,1,4,0,0,1,0,2,0,1,0,0,0
6520,287,2019,15,15,0,0.97,97,965,8,6,1,4,5,1,10,0,4,0,0,4,1,1,0,0,0
6521,288,2019,37,34,3,0.93,92,965,17,14,3,9,14,2,25,5,1,2,1,14,0,1,1,0,0
6522,289,2019,20,19,1,0.95,94,965,6,11,2,5,10,1,16,4,1,0,0,9,1,0,1,0,0
6523,290,2019,22,22,0,1.0,100,965,8,10,4,3,10,3,16,0,1,2,0,10,0,2,1,0,0
6524,291,2019,39,39,0,1.0,100,965,23,15,1,17,13,1,31,11,6,0,0,11,2,1,0,0,0
6525,292,2019,15,15,0,1.0,100,965,10,3,2,10,2,1,13,10,0,0,0,1,1,0,1,0,0
6526,293,2019,20,20,0,1.0,100,965,9,10,1,5,8,1,14,2,2,1,0,6,2,1,0,0,0
6527,294,2019,22,22,0,0.99,99,965,16,5,1,13,4,1,18,11,1,1,0,3,1,1,0,0,0
6528,295,2019,49,24,25,0.5,49,965,17,6,1,17,5,1,23,17,0,0,0,4,1,1,0,0,0
6529,296,2019,18,1,17,0.03,3,965,0,1,0,0,1,0,1,0,0,0,0,1,0,0,0,0,0
6530,297,2019,35,32,3,0.93,92,965,23,8,1,10,7,1,18,4,2,1,3,6,1,1,0,0,0
6531,298,2019,44,43,1,0.97,96,965,20,23,0,7,14,0,21,1,2,1,3,5,9,0,0,0,0
6532,299,2019,33,33,0,1.0,100,965,14,16,3,8,11,1,20,6,0,0,2,6,5,0,0,1,0
6533,300,2019,25,24,1,0.94,94,965,10,13,1,7,11,1,19,6,0,0,1,9,2,1,0,0,0
6534,301,2019,30,30,0,1.0,100,965,12,17,1,10,16,1,27,9,0,1,0,15,1,1,0,0,0
6535,302,2019,29,28,1,0.98,97,965,17,8,3,6,8,3,17,0,1,5,0,8,0,3,0,0,0
6536,303,2019,56,56,0,1.0,100,965,25,30,1,14,29,1,44,10,0,1,3,28,1,1,0,0,0
6537,304,2019,47,24,23,0.51,50,965,13,8,3,10,6,3,19,9,0,0,1,4,2,3,0,0,0
6538,305,2019,18,18,0,0.99,98,965,10,7,1,7,6,1,14,6,0,0,1,5,1,1,0,0,0
6539,306,2019,49,49,0,1.0,100,965,29,16,4,24,11,3,38,21,2,0,1,6,5,2,1,0,0
6540,307,2019,35,35,0,1.0,100,965,26,9,0,9,6,0,15,0,3,4,2,3,3,0,0,0,0
6541,308,2019,13,13,0,1.0,100,965,6,6,1,3,5,1,9,0,3,0,0,4,1,1,0,0,0
6542,309,2019,10,10,0,0.96,96,965,4,4,2,4,2,1,7,4,0,0,0,0,2,0,1,0,0
6543,310,2019,37,0,37,0.0,0,965,0,0,0,0,0,0,0,0,0,0,0,0,0,0,0,0,0
6544,311,2019,30,30,0,1.0,100,965,10,16,4,10,12,4,26,10,0,0,0,8,4,4,0,0,0
6545,312,2019,11,11,0,0.99,99,965,6,5,0,3,4,0,7,0,3,0,0,3,1,0,0,0,0
6546,313,2019,60,60,0,1.0,100,965,39,21,0,22,21,0,43,15,1,2,4,21,0,0,0,0,0
6547,314,2019,9,9,0,1.0,100,965,6,3,0,6,3,0,9,6,0,0,0,3,0,0,0,0,0
6548,315,2019,54,54,0,1.0,100,965,31,20,3,21,14,1,36,15,2,4,0,8,6,0,0,1,0
6549,316,2019,15,15,0,1.0,100,965,9,5,1,4,3,1,8,1,2,0,1,1,2,1,0,0,0
6550,317,2019,41,41,0,1.0,100,965,28,13,0,10,10,0,20,2,0,6,2,7,3,0,0,0,0
6551,318,2019,26,26,0,1.0,100,965,12,11,3,9,11,1,21,6,3,0,0,11,0,0,0,1,0
6552,319,2019,7,7,0,1.0,100,965,4,3,0,3,3,0,6,2,1,0,0,3,0,0,0,0,0
6553,320,2019,28,28,0,0.99,98,965,20,7,1,11,5,1,17,2,9,0,0,3,2,1,0,0,0
6554,321,2019,5,5,0,1.0,100,965,2,2,1,2,1,1,4,2,0,0,0,0,1,1,0,0,0
6555,322,2019,14,14,0,0.99,99,965,3,8,3,1,6,1,8,0,0,1,0,4,2,0,0,1,0
6556,323,2019,57,52,5,0.92,91,965,37,14,1,12,9,1,22,0,2,7,3,4,5,1,0,0,0
6557,324,2019,26,19,7,0.75,74,965,12,5,2,5,5,1,11,0,3,2,0,5,0,0,1,0,0
6558,325,2019,25,25,0,1.0,100,965,18,6,1,7,3,1,11,1,1,5,0,0,3,1,0,0,0
6559,326,2019,27,27,0,0.99,98,965,19,6,2,12,6,2,20,7,4,0,1,6,0,2,0,0,0
6560,327,2019,52,52,0,1.0,100,965,35,16,1,11,16,1,28,0,0,9,2,16,0,1,0,0,0
6561,328,2019,9,8,1,0.94,93,965,5,2,1,4,1,1,6,3,1,0,0,0,1,1,0,0,0
6562,329,2019,25,25,0,1.0,100,965,17,5,3,12,3,3,18,9,1,2,0,1,2,3,0,0,0
6563,330,2019,30,30,0,0.99,98,965,15,15,0,14,11,0,25,13,1,0,0,7,4,0,0,0,0
6564,331,2019,59,59,0,1.0,100,965,38,20,1,10,16,1,27,0,0,2,8,12,4,1,0,0,0
6565,332,2019,43,15,28,0.36,35,965,8,4,3,3,3,1,7,0,1,2,0,2,1,0,0,1,0
6566,333,2019,27,11,16,0.41,40,965,5,4,2,4,3,1,8,3,1,0,0,2,1,0,1,0,0
6567,334,2019,24,23,1,0.97,96,965,8,12,3,6,12,3,21,5,0,1,0,12,0,3,0,0,0
6568,335,2019,58,58,0,1.0,100,965,27,31,0,22,16,0,38,18,3,1,0,1,15,0,0,0,0
6569,336,2019,40,40,0,1.0,100,965,28,9,3,14,9,2,25,8,2,0,4,9,0,1,1,0,0
6570,337,2019,31,24,7,0.77,77,965,9,12,3,6,8,3,17,4,1,1,0,4,4,3,0,0,0
6571,338,2019,15,15,0,1.0,99,965,5,8,2,4,6,1,11,3,1,0,0,4,2,0,1,0,0
6572,339,2019,23,23,0,1.0,99,965,7,13,3,4,7,2,13,3,0,0,1,1,6,1,1,0,0
6573,340,2019,38,38,0,1.0,100,965,14,21,3,5,13,2,20,2,0,0,3,5,8,1,1,0,0
6574,341,2019,27,27,0,1.0,100,965,11,15,1,8,13,1,22,6,1,1,0,11,2,1,0,0,0
6575,342,2019,8,8,0,0.98,97,965,4,3,1,2,3,1,6,1,0,1,0,3,0,1,0,0,0
6576,343,2019,50,49,1,0.98,97,965,26,22,1,12,20,1,33,3,6,1,2,18,2,1,0,0,0
6577,344,2019,23,23,0,1.0,100,965,16,4,3,11,2,3,16,9,0,1,1,0,2,3,0,0,0
6578,345,2019,40,40,0,1.0,100,965,24,14,2,22,14,1,37,21,0,1,0,14,0,0,1,0,0
6579,346,2019,48,48,0,1.0,100,965,28,17,3,20,15,1,36,15,3,1,1,13,2,0,0,1,0
6580,347,2019,21,21,0,1.0,100,965,14,6,1,7,4,1,12,2,3,2,0,2,2,1,0,0,0
6581,348,2019,38,38,0,0.99,99,965,28,9,1,23,7,1,31,20,1,2,0,5,2,1,0,0,0
6582,349,2019,24,24,0,1.0,100,965,11,12,1,5,11,1,17,2,1,1,1,10,1,1,0,0,0
6583,350,2019,39,39,0,1.0,100,965,23,16,0,14,13,0,27,7,5,2,0,10,3,0,0,0,0
6584,351,2019,29,15,14,0.51,51,965,9,5,1,4,5,1,10,0,3,1,0,5,0,1,0,0,0
6585,352,2019,36,36,0,1.0,100,965,21,12,3,9,7,3,19,3,1,4,1,2,5,3,0,0,0
6586,353,2019,39,39,0,1.0,100,965,25,12,2,13,9,1,23,7,2,2,2,6,3,0,1,0,0
6587,354,2019,15,11,4,0.75,74,965,6,4,1,5,3,1,9,4,1,0,0,2,1,1,0,0,0
6588,355,2019,22,22,0,1.0,100,965,15,4,3,14,4,3,21,13,1,0,0,4,0,3,0,0,0
6589,356,2019,31,31,0,1.0,99,965,10,18,3,9,10,1,20,8,1,0,0,2,8,0,0,1,0
6590,357,2019,26,23,3,0.88,88,965,14,7,2,8,7,2,17,6,0,0,2,7,0,2,0,0,0
6591,358,2019,49,1,48,0.01,1,965,0,1,0,0,1,0,1,0,0,0,0,1,0,0,0,0,0
6592,359,2019,36,34,2,0.95,94,965,25,8,1,19,4,1,24,14,4,1,0,0,4,1,0,0,0
6593,360,2019,37,34,3,0.93,92,965,12,20,2,5,15,1,21,2,1,0,2,10,5,0,1,0,0
6594,361,2019,27,12,15,0.46,45,965,8,3,1,8,2,1,11,8,0,0,0,1,1,1,0,0,0
6595,362,2019,18,15,3,0.81,81,965,7,5,3,3,3,3,9,0,2,1,0,1,2,3,0,0,0
6596,363,2019,34,34,0,1.0,100,965,18,14,2,7,7,2,16,0,4,2,1,0,7,2,0,0,0
6597,364,2019,35,35,0,0.99,99,965,22,12,1,6,7,1,14,0,1,0,5,2,5,1,0,0,0
6598,365,2019,25,25,0,1.0,100,965,11,11,3,10,11,2,23,9,1,0,0,11,0,1,1,0,0
6599,366,2019,9,7,2,0.83,82,965,5,2,0,3,1,0,4,1,2,0,0,0,1,0,0,0,0
6600,367,2019,12,12,0,1.0,100,965,3,6,3,2,5,3,10,1,1,0,0,4,1,3,0,0,0
6601,368,2019,58,35,23,0.6,60,965,24,8,3,24,6,1,31,24,0,0,0,4,2,0,0,1,0
6602,369,2019,51,51,0,1.0,99,965,22,29,0,7,20,0,27,1,0,3,3,11,9,0,0,0,0
6603,370,2019,28,4,24,0.13,12,965,3,1,0,3,1,0,4,3,0,0,0,1,0,0,0,0,0
6604,371,2019,15,15,0,1.0,100,965,3,9,3,3,7,1,11,3,0,0,0,5,2,0,0,1,0
6605,372,2019,6,1,5,0.14,14,965,0,1,0,0,1,0,1,0,0,0,0,1,0,0,0,0,0
6606,373,2019,16,16,0,0.98,97,965,8,6,2,7,3,1,11,6,1,0,0,0,3,0,1,0,0
6607,374,2019,16,16,0,1.0,100,965,7,6,3,5,4,2,11,3,2,0,0,2,2,1,1,0,0
6608,375,2019,33,5,28,0.14,13,965,2,2,1,1,1,1,3,0,1,0,0,0,1,1,0,0,0
6609,376,2019,36,18,18,0.5,49,965,10,8,0,10,6,0,16,10,0,0,0,4,2,0,0,0,0
6610,377,2019,9,9,0,1.0,100,965,2,5,2,2,5,1,8,2,0,0,0,5,0,0,1,0,0
6611,378,2019,14,14,0,1.0,100,965,9,5,0,4,5,0,9,1,1,2,0,5,0,0,0,0,0
6612,379,2019,43,43,0,1.0,99,965,16,26,1,8,13,1,22,3,2,3,0,0,13,1,0,0,0
6613,380,2019,42,38,4,0.91,91,965,18,19,1,14,16,1,31,12,1,0,1,13,3,1,0,0,0
6614,381,2019,31,31,0,1.0,99,965,17,13,1,17,12,1,30,17,0,0,0,11,1,1,0,0,0
6615,382,2019,40,40,0,0.99,99,965,15,22,3,9,17,3,29,5,2,2,0,12,5,3,0,0,0
6616,383,2019,20,20,0,0.98,98,965,14,4,2,9,3,2,14,5,3,1,0,2,1,2,0,0,0
6617,384,2019,42,42,0,0.99,98,965,21,18,3,17,14,1,32,13,4,0,0,10,4,0,0,1,0
6618,385,2019,18,18,0,1.0,100,965,8,10,0,3,5,0,8,0,2,0,1,0,5,0,0,0,0
6619,386,2019,56,49,7,0.87,87,965,34,11,4,14,9,4,27,2,8,0,4,7,2,4,0,0,0
6620,387,2019,58,55,3,0.95,95,965,39,13,3,30,12,2,44,25,1,4,0,11,1,1,1,0,0
6621,388,2019,32,30,2,0.93,93,965,12,17,1,11,17,1,29,10,1,0,0,17,0,1,0,0,0
6622,389,2019,50,40,10,0.79,79,965,16,21,3,14,16,1,31,12,2,0,0,11,5,0,0,1,0
6623,390,2019,34,17,17,0.51,50,965,9,6,2,6,3,2,11,4,1,1,0,0,3,2,0,0,0
6624,391,2019,39,39,0,1.0,100,965,28,10,1,14,5,1,20,4,8,0,2,0,5,1,0,0,0
6625,392,2019,15,12,3,0.77,76,965,7,5,0,2,4,0,6,0,0,1,1,3,1,0,0,0,0
6626,393,2019,9,9,0,0.98,98,965,5,4,0,5,2,0,7,5,0,0,0,0,2,0,0,0,0
6627,394,2019,31,4,27,0.13,13,965,2,2,0,1,2,0,3,0,1,0,0,2,0,0,0,0,0
6628,395,2019,11,11,0,1.0,100,965,3,6,2,1,4,1,6,0,0,1,0,2,2,0,1,0,0
6629,396,2019,31,31,0,1.0,100,965,23,6,2,7,4,1,12,1,0,2,4,2,2,0,1,0,0
6630,397,2019,53,52,1,0.99,98,965,25,25,2,13,17,2,32,5,4,4,0,9,8,2,0,0,0
6631,398,2019,15,15,0,1.0,100,965,10,3,2,5,2,2,9,2,1,2,0,1,1,2,0,0,0
6632,399,2019,36,36,0,1.0,100,965,14,20,2,14,16,2,32,14,0,0,0,12,4,2,0,0,0
6633,400,2019,25,24,1,0.96,95,965,13,8,3,9,5,2,16,5,4,0,0,2,3,1,1,0,0
6634,401,2019,22,22,0,1.0,100,965,11,9,2,7,6,1,14,5,1,0,1,3,3,0,1,0,0
6635,402,2019,57,57,0,1.0,100,965,37,19,1,21,12,1,34,8,10,3,0,5,7,1,0,0,0
6636,403,2019,28,28,0,1.0,99,965,20,7,1,6,5,1,12,0,2,0,4,3,2,1,0,0,0
6637,404,2019,9,9,0,1.0,100,965,5,3,1,3,2,1,6,1,2,0,0,1,1,1,0,0,0
6638,405,2019,57,57,0,0.99,99,965,30,26,1,20,15,1,36,15,0,5,0,4,11,1,0,0,0
6639,406,2019,39,39,0,1.0,99,965,25,10,4,19,5,3,27,17,0,0,2,0,5,2,1,0,0
6640,407,2019,9,6,3,0.7,70,965,4,2,0,1,2,0,3,0,0,0,1,2,0,0,0,0,0
6641,408,2019,39,39,0,1.0,100,965,24,11,4,14,10,2,26,7,4,3,0,9,1,0,2,0,0
6642,409,2019,16,16,0,1.0,100,965,5,7,4,2,4,3,9,0,1,1,0,1,3,2,1,0,0
6643,410,2019,52,52,0,1.0,99,965,28,20,4,24,14,3,41,21,2,1,0,8,6,2,1,0,0
6644,411,2019,52,52,0,1.0,100,965,27,24,1,15,20,1,36,9,1,4,1,16,4,1,0,0,0
6645,412,2019,55,55,0,1.0,100,965,34,20,1,18,16,1,35,10,4,0,4,12,4,1,0,0,0
6646,413,2019,9,9,0,1.0,100,965,5,4,0,3,2,0,5,2,0,1,0,0,2,0,0,0,0
6647,414,2019,9,9,0,1.0,100,965,6,3,0,5,2,0,7,4,1,0,0,1,1,0,0,0,0
6648,415,2019,8,8,0,0.95,94,965,3,4,1,2,4,1,7,1,1,0,0,4,0,1,0,0,0
6649,416,2019,26,0,26,0.01,1,965,0,0,0,0,0,0,0,0,0,0,0,0,0,0,0,0,0
6650,417,2019,48,48,0,0.99,98,965,24,22,2,19,19,2,40,16,1,2,0,16,3,2,0,0,0
6651,418,2019,28,8,20,0.3,29,965,6,2,0,4,1,0,5,2,2,0,0,0,1,0,0,0,0
6652,419,2019,20,20,0,0.98,97,965,7,11,2,4,10,2,16,2,1,1,0,9,1,2,0,0,0
6653,420,2019,14,14,0,1.0,100,965,10,4,0,5,4,0,9,0,5,0,0,4,0,0,0,0,0
6654,421,2019,16,16,0,0.98,98,965,8,6,2,7,3,2,12,6,1,0,0,0,3,2,0,0,0
6655,422,2019,15,10,5,0.68,68,965,3,5,2,1,3,1,5,0,0,1,0,1,2,0,1,0,0
6656,423,2019,13,13,0,1.0,99,965,7,6,0,7,5,0,12,7,0,0,0,4,1,0,0,0,0
6657,424,2019,27,14,13,0.51,51,965,9,4,1,3,3,1,7,0,1,1,1,2,1,1,0,0,0
6658,425,2019,20,11,9,0.55,54,965,8,3,0,2,2,0,4,0,0,0,2,1,1,0,0,0,0
6659,426,2019,44,43,1,0.98,97,965,27,14,2,23,7,2,32,20,2,1,0,0,7,2,0,0,0
6660,427,2019,19,19,0,1.0,99,965,9,7,3,7,6,2,15,5,2,0,0,5,1,1,1,0,0
6661,428,2019,33,6,27,0.19,19,965,3,2,1,3,1,1,5,3,0,0,0,0,1,1,0,0,0
6662,429,2019,8,4,4,0.55,54,965,1,2,1,1,2,1,4,1,0,0,0,2,0,1,0,0,0
6663,430,2019,11,11,0,0.99,98,965,4,4,3,4,4,3,11,4,0,0,0,4,0,3,0,0,0
6664,431,2019,55,42,13,0.76,76,965,20,20,2,9,15,1,25,4,0,4,1,10,5,0,1,0,0
6665,432,2019,36,36,0,1.0,99,965,20,14,2,12,14,1,27,5,6,1,0,14,0,0,1,0,0
6666,433,2019,19,18,1,0.96,96,965,8,9,1,5,5,1,11,4,0,0,1,1,4,1,0,0,0
6667,434,2019,14,14,0,1.0,100,965,5,6,3,4,4,2,10,3,1,0,0,2,2,1,1,0,0
6668,435,2019,17,17,0,1.0,100,965,8,5,4,3,3,1,7,0,2,0,1,1,2,0,0,0,1
6669,436,2019,40,40,0,1.0,99,965,26,14,0,18,10,0,28,14,0,4,0,6,4,0,0,0,0
6670,437,2019,11,11,0,1.0,100,965,4,4,3,3,3,2,8,2,1,0,0,2,1,1,1,0,0
6671,438,2019,9,9,0,1.0,100,965,6,2,1,6,2,1,9,6,0,0,0,2,0,1,0,0,0
6672,439,2019,30,7,23,0.23,22,965,2,3,2,1,2,2,5,0,1,0,0,1,1,2,0,0,0
6673,440,2019,31,31,0,1.0,100,965,12,15,4,10,11,1,22,8,2,0,0,7,4,0,0,0,1
6674,441,2019,6,0,6,0.01,1,965,0,0,0,0,0,0,0,0,0,0,0,0,0,0,0,0,0
6675,442,2019,36,36,0,0.99,98,965,20,13,3,17,12,1,30,16,0,0,1,11,1,0,0,1,0
6676,443,2019,52,48,4,0.92,92,965,29,16,3,8,9,2,19,1,0,0,7,2,7,1,1,0,0
6677,444,2019,40,39,1,0.98,98,965,29,10,0,10,5,0,15,0,5,1,4,0,5,0,0,0,0
6678,445,2019,6,6,0,1.0,99,965,2,3,1,1,2,1,4,0,1,0,0,1,1,1,0,0,0
6679,446,2019,40,16,24,0.4,39,965,8,7,1,8,5,1,14,8,0,0,0,3,2,1,0,0,0
6680,447,2019,28,25,3,0.89,88,965,13,11,1,10,9,1,20,7,3,0,0,7,2,1,0,0,0
6681,448,2019,31,21,10,0.67,66,965,7,10,4,6,9,3,18,5,1,0,0,8,1,2,1,0,0
6682,449,2019,22,22,0,1.0,100,965,16,5,1,15,5,1,21,14,1,0,0,5,0,1,0,0,0
6683,450,2019,11,11,0,1.0,100,965,5,5,1,5,5,1,11,5,0,0,0,5,0,1,0,0,0
6684,451,2019,20,20,0,0.98,97,965,6,10,4,2,6,3,11,0,0,2,0,2,4,2,1,0,0
6685,452,2019,39,10,29,0.25,25,965,4,4,2,1,4,2,7,0,0,0,1,4,0,2,0,0,0
6686,453,2019,37,37,0,1.0,99,965,15,21,1,6,12,1,19,2,1,1,2,3,9,1,0,0,0
6687,454,2019,55,55,0,1.0,100,965,32,19,4,14,12,4,30,1,10,1,2,5,7,4,0,0,0
6688,455,2019,20,18,2,0.92,92,965,8,10,0,6,9,0,15,4,2,0,0,8,1,0,0,0,0
6689,456,2019,31,31,0,1.0,100,965,21,8,2,13,6,1,20,9,0,4,0,4,2,0,1,0,0
6690,457,2019,19,19,0,1.0,100,965,11,5,3,6,5,3,14,4,0,1,1,5,0,3,0,0,0
6691,458,2019,37,37,0,1.0,100,965,18,16,3,16,16,2,34,14,2,0,0,16,0,1,1,0,0
6692,459,2019,40,40,0,1.0,100,965,25,11,4,8,7,3,18,0,3,1,4,3,4,2,1,0,0
6693,460,2019,44,44,0,0.99,99,965,26,18,0,14,15,0,29,8,3,0,3,12,3,0,0,0,0
6694,461,2019,5,5,0,1.0,99,965,3,2,0,2,1,0,3,1,1,0,0,0,1,0,0,0,0
6695,462,2019,25,25,0,1.0,100,965,18,7,0,7,4,0,11,1,1,5,0,1,3,0,0,0,0
6696,463,2019,13,13,0,1.0,100,965,6,4,3,2,4,2,8,0,1,0,1,4,0,1,1,0,0
6697,464,2019,26,26,0,1.0,99,965,9,14,3,5,13,3,21,3,1,0,1,12,1,3,0,0,0
6698,465,2019,24,19,5,0.8,79,965,5,11,3,2,7,2,11,1,0,0,1,3,4,1,1,0,0
6699,466,2019,11,0,11,0.0,0,965,0,0,0,0,0,0,0,0,0,0,0,0,0,0,0,0,0
6700,467,2019,11,10,1,0.9,90,965,5,4,1,4,4,1,9,3,1,0,0,4,0,1,0,0,0
6701,468,2019,7,2,5,0.3,29,965,1,1,0,1,1,0,2,1,0,0,0,1,0,0,0,0,0
6702,469,2019,34,34,0,1.0,100,965,11,19,4,11,16,4,31,11,0,0,0,13,3,4,0,0,0
6703,470,2019,33,31,2,0.95,94,965,9,18,4,7,15,4,26,5,2,0,0,12,3,4,0,0,0
6704,471,2019,36,26,10,0.73,73,965,18,5,3,8,5,1,14,2,4,0,2,5,0,0,0,1,0
6705,472,2019,31,31,0,1.0,99,965,21,9,1,6,5,1,12,1,0,0,5,1,4,1,0,0,0
6706,473,2019,48,46,2,0.96,96,965,18,26,2,10,25,2,37,3,6,1,0,24,1,2,0,0,0
6707,474,2019,21,21,0,1.0,100,965,9,10,2,5,5,2,12,3,1,0,1,0,5,2,0,0,0
6708,475,2019,19,4,15,0.22,21,965,1,2,1,1,2,1,4,1,0,0,0,2,0,1,0,0,0
6709,476,2019,20,7,13,0.35,35,965,4,2,1,1,1,1,3,0,0,0,1,0,1,1,0,0,0
6710,477,2019,21,0,21,0.01,1,965,0,0,0,0,0,0,0,0,0,0,0,0,0,0,0,0,0
6711,478,2019,30,29,1,0.98,97,965,19,9,1,5,5,1,11,0,0,1,4,1,4,1,0,0,0
6712,479,2019,7,7,0,1.0,100,965,2,4,1,2,2,1,5,2,0,0,0,0,2,1,0,0,0
6713,480,2019,45,45,0,1.0,100,965,26,15,4,10,15,2,27,1,2,7,0,15,0,0,2,0,0
6714,481,2019,51,51,0,1.0,100,965,33,15,3,15,10,1,26,5,5,2,3,5,5,0,0,1,0
6715,482,2019,10,5,5,0.49,49,965,2,3,0,1,2,0,3,0,1,0,0,1,1,0,0,0,0
6716,483,2019,30,30,0,1.0,100,965,16,12,2,10,7,1,18,8,0,0,2,2,5,0,1,0,0
6717,484,2019,9,9,0,0.99,98,965,3,5,1,1,3,1,5,0,0,1,0,1,2,1,0,0,0
6718,485,2019,24,18,6,0.74,74,965,5,11,2,4,10,2,16,3,1,0,0,9,1,2,0,0,0
6719,486,2019,22,3,19,0.12,11,965,1,2,0,1,1,0,2,1,0,0,0,0,1,0,0,0,0
6720,487,2019,31,31,0,1.0,100,965,20,8,3,19,4,1,24,18,1,0,0,0,4,0,0,1,0
6721,488,2019,8,8,0,1.0,100,965,5,2,1,5,1,1,7,5,0,0,0,0,1,1,0,0,0
6722,489,2019,25,23,2,0.94,93,965,14,9,0,8,6,0,14,5,1,1,1,3,3,0,0,0,0
6723,490,2019,33,25,8,0.76,75,965,12,9,4,10,6,3,19,8,2,0,0,3,3,2,1,0,0
6724,491,2019,5,1,4,0.16,16,965,0,1,0,0,1,0,1,0,0,0,0,1,0,0,0,0,0
6725,492,2019,7,7,0,1.0,100,965,3,3,1,3,2,1,6,3,0,0,0,1,1,1,0,0,0
6726,493,2019,10,10,0,1.0,99,965,5,5,0,5,5,0,10,5,0,0,0,5,0,0,0,0,0
6727,494,2019,9,8,1,0.88,88,965,3,3,2,2,3,2,7,1,1,0,0,3,0,2,0,0,0
6728,495,2019,13,12,1,0.92,91,965,7,4,1,3,3,1,7,0,2,1,0,2,1,1,0,0,0
6729,496,2019,50,50,0,1.0,100,965,35,11,4,14,7,4,25,2,5,5,2,3,4,4,0,0,0
6730,497,2019,31,31,0,0.99,99,965,17,13,1,15,7,1,23,14,0,1,0,1,6,1,0,0,0
6731,498,2019,27,27,0,1.0,100,965,17,6,4,8,4,2,14,3,3,0,2,2,2,0,2,0,0
6732,499,2019,49,49,0,1.0,100,965,32,14,3,30,7,1,38,28,2,0,0,0,7,0,0,1,0
6733,500,2019,40,32,8,0.79,79,965,21,7,4,6,6,3,15,0,1,1,4,5,1,2,1,0,0
6734,501,2019,8,8,0,1.0,100,965,3,5,0,3,4,0,7,3,0,0,0,3,1,0,0,0,0
6735,502,2019,7,6,1,0.84,84,965,3,2,1,3,1,1,5,3,0,0,0,0,1,1,0,0,0
6736,503,2019,13,13,0,1.0,99,965,3,7,3,1,5,3,9,0,0,1,0,3,2,3,0,0,0
6737,504,2019,35,35,0,1.0,100,965,21,12,2,12,8,2,22,7,2,2,1,4,4,2,0,0,0
6738,505,2019,46,46,0,1.0,100,965,21,24,1,9,23,1,33,2,4,1,2,22,1,1,0,0,0
6739,506,2019,45,39,6,0.86,85,965,27,9,3,21,8,1,30,15,6,0,0,7,1,0,0,1,0
6740,507,2019,55,53,2,0.96,95,965,37,14,2,24,8,2,34,15,7,0,2,2,6,2,0,0,0
6741,508,2019,11,11,0,0.99,98,965,3,5,3,1,4,2,7,0,0,1,0,3,1,1,1,0,0
6742,509,2019,14,14,0,1.0,100,965,7,4,3,4,4,3,11,1,3,0,0,4,0,3,0,0,0
6743,510,2019,16,16,0,1.0,99,965,11,3,2,5,3,1,9,2,1,1,1,3,0,0,1,0,0
6744,511,2019,11,6,5,0.54,53,965,2,4,0,1,4,0,5,0,1,0,0,4,0,0,0,0,0
6745,512,2019,32,30,2,0.93,92,965,13,15,2,10,10,2,22,9,0,0,1,5,5,2,0,0,0
6746,513,2019,8,2,6,0.19,19,965,1,1,0,1,1,0,2,1,0,0,0,1,0,0,0,0,0
6747,514,2019,42,41,1,0.98,97,965,22,18,1,9,11,1,21,2,3,2,2,4,7,1,0,0,0
6748,515,2019,26,26,0,1.0,100,965,17,8,1,17,7,1,25,17,0,0,0,6,1,1,0,0,0
6749,516,2019,29,24,5,0.84,84,965,12,12,0,9,12,0,21,7,1,1,0,12,0,0,0,0,0
6750,517,2019,17,17,0,1.0,100,965,7,8,2,7,4,1,12,7,0,0,0,0,4,0,1,0,0
6751,518,2019,39,39,0,1.0,100,965,17,21,1,8,16,1,25,4,0,3,1,11,5,1,0,0,0
6752,519,2019,27,25,2,0.92,92,965,12,9,4,7,5,2,14,5,0,1,1,1,4,0,2,0,0
6753,520,2019,51,39,12,0.77,77,965,29,7,3,11,5,1,17,2,0,9,0,3,2,0,0,1,0
6754,521,2019,36,36,0,1.0,100,965,19,16,1,10,13,1,24,7,0,0,3,10,3,1,0,0,0
6755,522,2019,19,10,9,0.55,54,965,3,5,2,2,5,2,9,1,1,0,0,5,0,2,0,0,0
6756,523,2019,22,22,0,1.0,100,965,12,6,4,12,6,2,20,12,0,0,0,6,0,0,2,0,0
6757,524,2019,32,32,0,1.0,100,965,21,7,4,10,4,4,18,5,0,4,1,1,3,4,0,0,0
6758,525,2019,54,54,0,1.0,100,965,29,21,4,9,16,1,26,0,0,7,2,11,5,0,0,0,1
6759,526,2019,25,25,0,1.0,100,965,14,10,1,6,7,1,14,1,2,3,0,4,3,1,0,0,0
6760,527,2019,56,56,0,1.0,100,965,33,21,2,33,13,1,47,33,0,0,0,5,8,0,1,0,0
6761,528,2019,17,14,3,0.83,82,965,5,8,1,5,7,1,13,5,0,0,0,6,1,1,0,0,0
6762,529,2019,6,1,5,0.19,18,965,0,1,0,0,1,0,1,0,0,0,0,1,0,0,0,0,0
6763,530,2019,38,37,1,0.97,97,965,18,15,4,14,10,1,25,12,0,2,0,5,5,0,0,0,1
6764,531,2019,15,8,7,0.52,52,965,2,4,2,2,3,2,7,2,0,0,0,2,1,2,0,0,0
6765,532,2019,18,18,0,0.98,97,965,8,10,0,8,7,0,15,8,0,0,0,4,3,0,0,0,0
6766,533,2019,42,38,4,0.9,89,965,25,9,4,16,8,4,28,8,7,1,0,7,1,4,0,0,0
6767,534,2019,42,41,1,0.98,97,965,30,9,2,18,9,2,29,14,0,0,4,9,0,2,0,0,0
6768,535,2019,9,0,9,0.01,1,965,0,0,0,0,0,0,0,0,0,0,0,0,0,0,0,0,0
6769,536,2019,31,24,7,0.78,77,965,11,10,3,10,7,2,19,9,1,0,0,4,3,1,1,0,0
6770,537,2019,32,22,10,0.68,68,965,6,13,3,6,8,1,15,6,0,0,0,3,5,0,0,1,0
6771,538,2019,12,12,0,1.0,99,965,7,3,2,3,2,2,7,1,0,2,0,1,1,2,0,0,0
6772,539,2019,8,8,0,1.0,100,965,4,3,1,4,2,1,7,4,0,0,0,1,1,1,0,0,0
6773,540,2019,24,9,15,0.37,36,965,4,3,2,2,3,1,6,1,0,1,0,3,0,0,1,0,0
6774,541,2019,39,26,13,0.66,66,965,19,6,1,16,5,1,22,15,0,0,1,4,1,1,0,0,0
6775,542,2019,51,51,0,1.0,100,965,30,21,0,15,17,0,32,5,7,1,2,13,4,0,0,0,0
6776,543,2019,22,16,6,0.73,73,965,4,9,3,4,7,2,13,4,0,0,0,5,2,1,1,0,0
6777,544,2019,13,1,12,0.09,9,965,0,1,0,0,1,0,1,0,0,0,0,1,0,0,0,0,0
6778,545,2019,32,32,0,1.0,99,965,13,19,0,10,17,0,27,7,3,0,0,15,2,0,0,0,0
6779,546,2019,54,46,8,0.85,84,965,20,22,4,10,18,4,32,2,6,2,0,14,4,4,0,0,0
6780,547,2019,52,52,0,1.0,100,965,27,25,0,11,16,0,27,3,1,6,1,7,9,0,0,0,0
6781,548,2019,40,40,0,0.99,99,965,29,9,2,8,9,1,18,0,1,1,6,9,0,0,1,0,0
6782,549,2019,23,23,0,1.0,100,965,16,4,3,9,3,1,13,6,0,2,1,2,1,0,0,1,0
6783,550,2019,22,22,0,1.0,100,965,8,12,2,6,9,1,16,4,2,0,0,6,3,0,1,0,0
6784,551,2019,11,11,0,1.0,100,965,8,2,1,4,2,1,7,0,4,0,0,2,0,1,0,0,0
6785,552,2019,39,13,26,0.34,33,965,5,7,1,4,7,1,12,3,1,0,0,7,0,1,0,0,0
6786,553,2019,46,9,37,0.2,19,965,4,3,2,1,2,2,5,0,0,0,1,1,1,2,0,0,0
6787,554,2019,40,40,0,1.0,99,965,24,14,2,16,11,2,29,12,0,4,0,8,3,2,0,0,0
6788,555,2019,16,16,0,1.0,100,965,9,6,1,4,4,1,9,1,1,2,0,2,2,1,0,0,0
6789,556,2019,10,10,0,1.0,100,965,5,3,2,2,3,1,6,0,1,1,0,3,0,0,1,0,0
6790,557,2019,56,56,0,1.0,99,965,29,23,4,18,13,3,34,9,7,2,0,3,10,2,1,0,0
6791,558,2019,38,38,0,1.0,100,965,23,15,0,18,13,0,31,15,2,0,1,11,2,0,0,0,0
6792,559,2019,45,45,0,1.0,100,965,19,23,3,7,22,2,31,0,2,5,0,21,1,1,1,0,0
6793,560,2019,37,37,0,1.0,100,965,21,13,3,7,12,3,22,0,3,1,3,11,1,3,0,0,0
6794,561,2019,16,16,0,1.0,100,965,7,9,0,2,8,0,10,0,0,1,1,7,1,0,0,0,0
6795,562,2019,27,25,2,0.91,91,965,16,7,2,12,7,1,20,10,0,2,0,7,0,0,1,0,0
6796,563,2019,36,35,1,0.97,96,965,13,21,1,7,13,1,21,4,1,1,1,5,8,1,0,0,0
6797,564,2019,60,59,1,0.98,97,965,43,15,1,39,12,1,52,37,0,2,0,9,3,1,0,0,0
6798,565,2019,9,6,3,0.7,70,965,3,2,1,3,1,1,5,3,0,0,0,0,1,1,0,0,0
6799,566,2019,16,16,0,0.99,98,965,9,5,2,3,4,2,9,0,0,3,0,3,1,2,0,0,0
6800,567,2019,32,2,30,0.08,7,965,1,1,0,1,1,0,2,1,0,0,0,1,0,0,0,0,0
6801,568,2019,12,12,0,1.0,100,965,5,6,1,5,4,1,10,5,0,0,0,2,2,1,0,0,0
6802,569,2019,41,41,0,1.0,100,965,18,21,2,14,16,2,32,12,0,2,0,11,5,2,0,0,0
6803,570,2019,47,47,0,1.0,100,965,30,16,1,23,11,1,35,16,7,0,0,6,5,1,0,0,0
6804,571,2019,6,0,6,0.08,7,965,0,0,0,0,0,0,0,0,0,0,0,0,0,0,0,0,0
6805,572,2019,11,11,0,0.99,98,965,5,4,2,4,2,1,7,3,1,0,0,0,2,0,1,0,0
6806,573,2019,35,35,0,1.0,99,965,16,16,3,14,15,1,30,12,2,0,0,14,1,0,0,1,0
6807,574,2019,27,27,0,1.0,100,965,16,10,1,4,7,1,12,0,0,0,4,4,3,1,0,0,0
6808,575,2019,26,26,0,1.0,100,965,12,13,1,3,12,1,16,0,0,0,3,11,1,1,0,0,0
6809,576,2019,42,42,0,1.0,100,965,21,21,0,18,11,0,29,16,1,1,0,1,10,0,0,0,0
6810,577,2019,12,4,8,0.29,29,965,1,2,1,1,2,1,4,1,0,0,0,2,0,1,0,0,0
6811,578,2019,13,1,12,0.05,5,965,0,1,0,0,1,0,1,0,0,0,0,1,0,0,0,0,0
6812,579,2019,34,34,0,1.0,100,965,11,19,4,6,19,3,28,4,0,1,1,19,0,2,1,0,0
6813,580,2019,19,19,0,0.98,97,965,6,11,2,3,10,2,15,1,1,1,0,9,1,2,0,0,0
6814,581,2019,9,9,0,1.0,100,965,5,4,0,3,4,0,7,1,2,0,0,4,0,0,0,0,0
6815,582,2019,33,33,0,1.0,100,965,24,7,2,9,7,2,18,0,3,6,0,7,0,2,0,0,0
6816,583,2019,10,9,1,0.94,94,965,4,3,2,3,2,2,7,2,1,0,0,1,1,2,0,0,0
6817,584,2019,38,38,0,1.0,99,965,15,20,3,7,15,1,23,2,3,1,1,10,5,0,0,1,0
6818,585,2019,14,9,5,0.64,64,965,4,3,2,1,2,1,4,0,0,0,1,1,1,0,1,0,0
6819,586,2019,34,24,10,0.71,71,965,13,8,3,5,4,2,11,0,2,3,0,0,4,1,1,0,0
6820,587,2019,17,17,0,1.0,100,965,10,6,1,8,5,1,14,7,0,1,0,4,1,1,0,0,0
6821,588,2019,27,27,0,1.0,100,965,17,6,4,7,3,1,11,2,0,5,0,0,3,0,0,0,1
6822,589,2019,43,43,0,1.0,100,965,17,23,3,9,23,2,34,2,6,1,0,23,0,1,1,0,0
6823,590,2019,24,23,1,0.97,96,965,10,11,2,6,9,2,17,4,0,2,0,7,2,2,0,0,0
6824,591,2019,15,15,0,1.0,100,965,7,6,2,2,3,1,6,0,0,1,1,0,3,0,1,0,0
6825,592,2019,5,5,0,1.0,100,965,2,2,1,2,1,1,4,2,0,0,0,0,1,1,0,0,0
6826,593,2019,8,8,0,1.0,100,965,4,3,1,3,3,1,7,2,1,0,0,3,0,1,0,0,0
6827,594,2019,55,55,0,1.0,100,965,25,28,2,9,16,2,27,1,1,6,1,4,12,2,0,0,0
6828,595,2019,20,15,5,0.74,74,965,10,3,2,9,3,2,14,8,1,0,0,3,0,2,0,0,0
6829,596,2019,12,12,0,1.0,100,965,5,5,2,5,5,1,11,5,0,0,0,5,0,0,1,0,0
6830,597,2019,29,3,26,0.09,8,965,2,1,0,1,1,0,2,0,1,0,0,1,0,0,0,0,0
6831,598,2019,12,12,0,0.98,98,965,4,6,2,4,3,2,9,4,0,0,0,0,3,2,0,0,0
6832,599,2019,17,16,1,0.92,91,965,10,6,0,7,5,0,12,6,0,0,1,4,1,0,0,0,0
6833,600,2019,16,16,0,0.98,97,965,11,5,0,11,4,0,15,11,0,0,0,3,1,0,0,0,0
6834,601,2019,28,27,1,0.98,97,965,11,16,0,10,8,0,18,9,1,0,0,0,8,0,0,0,0
6835,602,2019,8,8,0,1.0,99,965,4,3,1,2,2,1,5,1,0,1,0,1,1,1,0,0,0
6836,603,2019,59,59,0,1.0,100,965,23,34,2,18,33,2,53,15,2,0,1,32,1,2,0,0,0
6837,604,2019,44,42,2,0.96,96,965,29,12,1,25,12,1,38,22,2,1,0,12,0,1,0,0,0
6838,605,2019,48,23,25,0.49,48,965,13,8,2,9,6,2,17,7,1,0,1,4,2,2,0,0,0
6839,606,2019,35,35,0,0.99,98,965,21,14,0,11,12,0,23,3,6,2,0,10,2,0,0,0,0
6840,607,2019,40,36,4,0.89,89,965,24,11,1,10,7,1,18,5,0,1,4,3,4,1,0,0,0
6841,608,2019,6,5,1,0.84,84,965,1,3,1,1,2,1,4,1,0,0,0,1,1,1,0,0,0
6842,609,2019,15,15,0,0.99,99,965,10,5,0,10,3,0,13,10,0,0,0,1,2,0,0,0,0
6843,610,2019,9,2,7,0.27,27,965,1,1,0,1,1,0,2,1,0,0,0,1,0,0,0,0,0
6844,611,2019,48,25,23,0.52,51,965,18,7,0,11,4,0,15,8,0,2,1,1,3,0,0,0,0
6845,612,2019,12,12,0,1.0,100,965,7,3,2,3,2,1,6,1,1,0,1,1,1,0,1,0,0
6846,613,2019,12,12,0,1.0,100,965,7,4,1,4,2,1,7,2,1,1,0,0,2,1,0,0,0
6847,614,2019,6,6,0,1.0,100,965,3,3,0,1,3,0,4,0,0,1,0,3,0,0,0,0,0
6848,615,2019,27,27,0,1.0,100,965,14,12,1,14,8,1,23,14,0,0,0,4,4,1,0,0,0
6849,616,2019,30,12,18,0.39,39,965,7,3,2,6,2,2,10,5,1,0,0,1,1,2,0,0,0
6850,617,2019,14,14,0,1.0,100,965,4,8,2,2,5,2,9,1,0,1,0,2,3,2,0,0,0
6851,618,2019,6,6,0,1.0,100,965,4,2,0,2,1,0,3,0,2,0,0,0,1,0,0,0,0
6852,619,2019,17,2,15,0.12,12,965,1,1,0,1,1,0,2,1,0,0,0,1,0,0,0,0,0
6853,620,2019,18,18,0,1.0,100,965,5,9,4,2,6,4,12,0,1,1,0,3,3,4,0,0,0
6854,621,2019,9,9,0,1.0,100,965,3,4,2,3,4,2,9,3,0,0,0,4,0,2,0,0,0
6855,622,2019,32,4,28,0.12,11,965,1,2,1,1,1,1,3,1,0,0,0,0,1,1,0,0,0
6856,623,2019,52,51,1,0.98,98,965,20,29,2,19,26,2,47,18,1,0,0,23,3,2,0,0,0
6857,624,2019,20,20,0,0.98,97,965,9,10,1,3,6,1,10,1,0,0,2,2,4,1,0,0,0
6858,625,2019,33,33,0,1.0,100,965,13,19,1,5,14,1,20,0,2,3,0,9,5,1,0,0,0
6859,626,2019,13,13,0,1.0,100,965,5,7,1,3,7,1,11,1,2,0,0,7,0,1,0,0,0
6860,627,2019,17,17,0,1.0,100,965,7,7,3,3,5,1,9,0,2,1,0,3,2,0,0,1,0
6861,628,2019,13,13,0,1.0,100,965,5,7,1,2,5,1,8,0,1,1,0,3,2,1,0,0,0
6862,629,2019,33,33,0,1.0,100,965,14,16,3,8,15,3,26,2,6,0,0,14,1,3,0,0,0
6863,630,2019,15,14,1,0.95,94,965,5,8,1,4,6,1,11,3,1,0,0,4,2,1,0,0,0
6864,631,2019,58,57,1,0.99,98,965,32,22,3,17,20,2,39,2,15,0,0,18,2,1,1,0,0
6865,632,2019,9,9,0,1.0,100,965,6,2,1,5,1,1,7,4,1,0,0,0,1,1,0,0,0
6866,633,2019,9,9,0,1.0,99,965,5,4,0,2,4,0,6,1,0,0,1,4,0,0,0,0,0
6867,634,2019,6,6,0,1.0,99,965,3,2,1,2,1,1,4,1,1,0,0,0,1,1,0,0,0
6868,635,2019,24,24,0,1.0,100,965,14,8,2,13,7,1,21,12,1,0,0,6,1,0,1,0,0
6869,636,2019,15,5,10,0.37,36,965,2,2,1,1,2,1,4,0,1,0,0,2,0,1,0,0,0
6870,637,2019,23,23,0,1.0,100,965,15,7,1,14,5,1,20,13,1,0,0,3,2,1,0,0,0
6871,638,2019,29,29,0,1.0,100,965,13,12,4,13,10,1,24,13,0,0,0,8,2,0,0,0,1
6872,639,2019,7,5,2,0.7,70,965,1,3,1,1,2,1,4,1,0,0,0,1,1,1,0,0,0
6873,640,2019,13,13,0,0.98,97,965,8,3,2,7,2,2,11,6,1,0,0,1,1,2,0,0,0
6874,641,2019,6,6,0,0.97,96,965,2,3,1,1,2,1,4,0,1,0,0,1,1,1,0,0,0
6875,642,2019,28,28,0,1.0,100,965,19,9,0,9,7,0,16,1,7,0,1,5,2,0,0,0,0
6876,643,2019,56,56,0,1.0,99,965,28,25,3,14,13,1,28,2,11,0,1,1,12,0,0,1,0
6877,644,2019,11,11,0,1.0,100,965,6,4,1,6,3,1,10,6,0,0,0,2,1,1,0,0,0
6878,645,2019,23,23,0,1.0,99,965,11,9,3,4,9,1,14,0,1,3,0,9,0,0,0,1,0
6879,646,2019,58,6,52,0.11,11,965,2,3,1,2,2,1,5,2,0,0,0,1,1,1,0,0,0
6880,647,2019,32,21,11,0.64,64,965,12,7,2,7,7,1,15,4,1,2,0,7,0,0,1,0,0
6881,648,2019,34,34,0,1.0,100,965,14,19,1,10,14,1,25,8,0,2,0,9,5,1,0,0,0
6882,649,2019,27,27,0,1.0,100,965,14,10,3,13,7,3,23,12,1,0,0,4,3,3,0,0,0
6883,650,2019,37,37,0,1.0,100,965,13,20,4,12,13,4,29,11,1,0,0,6,7,4,0,0,0
6884,651,2019,26,18,8,0.7,69,965,7,8,3,3,8,2,13,1,1,0,1,8,0,1,1,0,0
6885,652,2019,40,40,0,1.0,100,965,18,20,2,8,14,2,24,1,5,1,1,8,6,2,0,0,0
6886,653,2019,14,14,0,1.0,100,965,9,3,2,3,3,1,7,0,1,1,1,3,0,0,1,0,0
6887,654,2019,40,36,4,0.9,89,965,20,13,3,14,12,1,27,10,3,0,1,11,1,0,0,1,0
6888,655,2019,50,50,0,1.0,100,965,27,22,1,12,14,1,27,3,5,2,2,6,8,1,0,0,0
6889,656,2019,47,47,0,1.0,100,965,21,23,3,7,22,1,30,1,2,0,4,21,1,0,0,1,0
6890,657,2019,32,32,0,1.0,100,965,23,7,2,9,6,2,17,1,3,4,1,5,1,2,0,0,0
6891,658,2019,12,5,7,0.42,42,965,1,3,1,1,3,1,5,1,0,0,0,3,0,1,0,0,0
6892,659,2019,38,38,0,1.0,100,965,26,12,0,20,6,0,26,16,3,0,1,0,6,0,0,0,0
6893,660,2019,21,19,2,0.9,89,965,8,7,4,8,7,4,19,8,0,0,0,7,0,4,0,0,0
6894,661,2019,37,34,3,0.93,92,965,25,8,1,23,5,1,29,21,2,0,0,2,3,1,0,0,0
6895,662,2019,29,29,0,1.0,100,965,12,15,2,11,9,2,22,10,1,0,0,3,6,2,0,0,0
6896,663,2019,39,20,19,0.52,52,965,6,10,4,6,7,1,14,6,0,0,0,4,3,0,0,0,1
6897,664,2019,45,3,42,0.07,6,965,2,1,0,2,1,0,3,2,0,0,0,1,0,0,0,0,0
6898,665,2019,28,28,0,1.0,100,965,19,9,0,8,9,0,17,3,0,4,1,9,0,0,0,0,0
6899,666,2019,24,11,13,0.45,45,965,3,6,2,1,6,2,9,0,0,1,0,6,0,2,0,0,0
6900,667,2019,30,23,7,0.78,78,965,13,8,2,10,6,1,17,7,3,0,0,4,2,0,1,0,0
6901,668,2019,38,38,0,0.99,99,965,17,19,2,10,15,1,26,4,5,1,0,11,4,0,1,0,0
6902,669,2019,42,29,13,0.69,68,965,17,10,2,11,9,1,21,7,3,0,1,8,1,0,1,0,0
6903,670,2019,14,14,0,1.0,99,965,8,6,0,8,6,0,14,8,0,0,0,6,0,0,0,0,0
6904,671,2019,47,47,0,1.0,100,965,27,17,3,13,16,2,31,2,8,3,0,15,1,1,1,0,0
6905,672,2019,41,40,1,0.98,97,965,16,21,3,15,18,3,36,14,1,0,0,15,3,3,0,0,0
6906,673,2019,14,12,2,0.87,86,965,5,4,3,4,4,1,9,3,1,0,0,4,0,0,0,1,0
6907,674,2019,24,24,0,1.0,99,965,7,13,4,2,10,4,16,0,0,1,1,7,3,4,0,0,0
6908,675,2019,9,9,0,1.0,100,965,6,3,0,3,3,0,6,2,0,0,1,3,0,0,0,0,0
6909,676,2019,19,19,0,1.0,99,965,8,10,1,3,8,1,12,1,0,1,1,6,2,1,0,0,0
6910,677,2019,11,11,0,1.0,100,965,4,4,3,4,2,2,8,4,0,0,0,0,2,1,1,0,0
6911,678,2019,26,26,0,1.0,100,965,11,14,1,6,9,1,16,3,1,2,0,4,5,1,0,0,0
6912,679,2019,22,22,0,1.0,100,965,9,11,2,9,8,1,18,9,0,0,0,5,3,0,1,0,0
6913,680,2019,25,2,23,0.07,6,965,1,1,0,1,1,0,2,1,0,0,0,1,0,0,0,0,0
6914,681,2019,40,40,0,1.0,100,965,23,15,2,6,8,2,16,0,0,1,5,1,7,2,0,0,0
6915,682,2019,38,38,0,1.0,100,965,19,18,1,15,18,1,34,12,2,1,0,18,0,1,0,0,0
6916,683,2019,5,5,0,1.0,100,965,2,2,1,2,2,1,5,2,0,0,0,2,0,1,0,0,0
6917,684,2019,27,26,1,0.97,97,965,19,4,3,11,4,1,16,5,4,2,0,4,0,0,0,1,0
6918,685,2019,14,14,0,1.0,99,965,7,7,0,4,5,0,9,2,1,1,0,3,2,0,0,0,0
6919,686,2019,26,26,0,1.0,99,965,19,7,0,12,7,0,19,9,1,0,2,7,0,0,0,0,0
6920,687,2019,20,20,0,1.0,100,965,4,12,4,4,7,1,12,4,0,0,0,2,5,0,0,0,1
6921,688,2019,13,7,6,0.55,55,965,5,2,0,4,2,0,6,3,1,0,0,2,0,0,0,0,0
6922,689,2019,46,46,0,1.0,100,965,27,18,1,17,10,1,28,12,1,3,1,2,8,1,0,0,0
6923,690,2019,46,46,0,1.0,100,965,32,11,3,16,10,1,27,2,13,0,1,9,1,0,0,1,0
6924,691,2019,31,7,24,0.21,21,965,3,4,0,1,3,0,4,0,0,1,0,2,1,0,0,0,0
6925,692,2019,28,27,1,0.97,97,965,13,11,3,10,9,3,22,7,3,0,0,7,2,3,0,0,0
6926,693,2019,15,15,0,1.0,100,965,4,8,3,1,4,3,8,0,0,0,1,0,4,3,0,0,0
6927,694,2019,55,54,1,0.99,99,965,22,30,2,20,28,2,50,18,2,0,0,26,2,2,0,0,0
6928,695,2019,36,22,14,0.61,61,965,10,8,4,10,5,2,17,10,0,0,0,2,3,1,0,1,0
6929,696,2019,27,6,21,0.22,22,965,4,2,0,2,1,0,3,1,0,1,0,0,1,0,0,0,0
6930,697,2019,31,31,0,0.99,99,965,11,16,4,7,13,2,22,4,2,1,0,10,3,1,0,1,0
6931,698,2019,44,44,0,1.0,100,965,26,17,1,22,9,1,32,20,0,2,0,1,8,1,0,0,0
6932,699,2019,34,34,0,1.0,100,965,23,8,3,15,5,2,22,12,0,1,2,2,3,1,1,0,0
6933,700,2019,40,40,0,0.99,98,965,29,11,0,12,7,0,19,2,6,1,3,3,4,0,0,0,0
6934,701,2019,31,31,0,1.0,100,965,17,13,1,16,7,1,24,15,1,0,0,1,6,1,0,0,0
6935,702,2019,44,44,0,1.0,99,965,19,23,2,19,17,1,37,19,0,0,0,11,6,0,1,0,0
6936,703,2019,34,34,0,1.0,100,965,22,10,2,11,8,1,20,5,2,3,1,6,2,0,1,0,0
6937,704,2019,32,17,15,0.53,52,965,12,3,2,7,2,1,10,2,5,0,0,1,1,0,1,0,0
6938,705,2019,6,6,0,0.99,98,965,2,3,1,2,2,1,5,2,0,0,0,1,1,1,0,0,0
6939,706,2019,17,4,13,0.26,26,965,3,1,0,1,1,0,2,0,0,1,0,1,0,0,0,0,0
6940,707,2019,29,29,0,1.0,100,965,18,8,3,12,7,3,22,6,6,0,0,6,1,3,0,0,0
6941,708,2019,39,39,0,1.0,100,965,15,23,1,7,16,1,24,1,5,0,1,9,7,1,0,0,0
6942,709,2019,42,39,3,0.94,93,965,29,10,0,17,6,0,23,9,4,4,0,2,4,0,0,0,0
6943,710,2019,20,11,9,0.55,55,965,7,4,0,2,4,0,6,0,0,1,1,4,0,0,0,0,0
6944,711,2019,5,5,0,1.0,100,965,3,2,0,3,1,0,4,3,0,0,0,0,1,0,0,0,0
6945,712,2019,48,48,0,1.0,99,965,31,15,2,12,9,1,22,5,0,2,5,3,6,0,1,0,0
6946,713,2019,24,22,2,0.93,93,965,16,4,2,5,2,2,9,0,0,4,1,0,2,2,0,0,0
6947,714,2019,30,30,0,1.0,100,965,11,18,1,8,16,1,25,6,1,1,0,14,2,1,0,0,0
6948,715,2019,47,19,28,0.4,39,965,10,6,3,7,3,1,11,6,0,0,1,0,3,0,0,1,0
6949,716,2019,34,34,0,1.0,100,965,13,20,1,12,19,1,32,11,1,0,0,18,1,1,0,0,0
6950,717,2019,32,32,0,1.0,100,965,18,11,3,11,11,2,24,8,1,0,2,11,0,1,1,0,0
6951,718,2019,35,35,0,1.0,100,965,24,10,1,21,10,1,32,20,0,0,1,10,0,1,0,0,0
6952,719,2019,39,39,0,1.0,100,965,16,20,3,10,18,2,30,4,6,0,0,16,2,1,1,0,0
6953,720,2019,7,3,4,0.38,37,965,1,2,0,1,1,0,2,1,0,0,0,0,1,0,0,0,0
6954,721,2019,38,38,0,1.0,99,965,16,18,4,4,10,1,15,0,0,0,4,2,8,0,0,0,1
6955,722,2019,24,24,0,1.0,99,965,16,5,3,12,3,3,18,10,1,0,1,1,2,3,0,0,0
6956,723,2019,8,8,0,0.99,99,965,5,2,1,2,1,1,4,1,0,0,1,0,1,1,0,0,0
6957,724,2019,24,23,1,0.98,97,965,12,7,4,5,7,3,15,0,4,0,1,7,0,2,1,0,0
6958,725,2019,26,21,5,0.8,79,965,8,11,2,3,6,2,11,0,1,2,0,1,5,2,0,0,0
6959,726,2019,28,28,0,1.0,100,965,17,8,3,17,5,2,24,17,0,0,0,2,3,1,1,0,0
6960,727,2019,24,24,0,0.99,98,965,8,12,4,6,12,2,20,4,2,0,0,12,0,1,0,1,0
6961,728,2019,28,28,0,1.0,99,965,15,13,0,10,10,0,20,7,2,0,1,7,3,0,0,0,0
6962,729,2019,24,24,0,0.98,97,965,10,14,0,3,8,0,11,0,1,0,2,2,6,0,0,0,0
6963,730,2019,30,3,27,0.11,11,965,2,1,0,2,1,0,3,2,0,0,0,1,0,0,0,0,0
6964,731,2019,51,51,0,1.0,100,965,22,26,3,17,15,1,33,12,5,0,0,4,11,0,0,1,0
6965,732,2019,9,9,0,0.98,97,965,6,3,0,5,2,0,7,4,1,0,0,1,1,0,0,0,0
6966,733,2019,10,10,0,1.0,100,965,4,5,1,4,4,1,9,4,0,0,0,3,1,1,0,0,0
6967,734,2019,34,33,1,0.97,96,965,14,17,2,4,17,2,23,0,1,0,3,17,0,2,0,0,0
6968,735,2019,18,18,0,1.0,99,965,5,9,4,4,6,2,12,3,1,0,0,3,3,1,0,1,0
6969,736,2019,31,30,1,0.97,96,965,13,16,1,7,14,1,22,5,0,0,2,12,2,1,0,0,0
6970,737,2019,49,48,1,0.99,98,965,20,27,1,15,15,1,31,10,5,0,0,3,12,1,0,0,0
6971,738,2019,31,31,0,1.0,100,965,20,10,1,16,10,1,27,12,4,0,0,10,0,1,0,0,0
6972,739,2019,36,36,0,1.0,99,965,16,19,1,8,15,1,24,2,4,2,0,11,4,1,0,0,0
6973,740,2019,46,46,0,1.0,100,965,32,12,2,32,8,2,42,32,0,0,0,4,4,2,0,0,0
6974,741,2019,15,10,5,0.65,65,965,4,5,1,4,3,1,8,4,0,0,0,1,2,1,0,0,0
6975,742,2019,46,46,0,1.0,100,965,23,20,3,9,20,2,31,2,0,7,0,20,0,1,1,0,0
6976,743,2019,47,11,36,0.24,23,965,4,4,3,1,2,2,5,0,0,0,1,0,2,1,1,0,0
6977,744,2019,16,15,1,0.94,93,965,11,3,1,9,3,1,13,7,2,0,0,3,0,1,0,0,0
6978,745,2019,36,28,8,0.79,78,965,20,7,1,13,6,1,20,8,4,0,1,5,1,1,0,0,0
6979,746,2019,31,31,0,1.0,99,965,10,18,3,10,12,3,25,10,0,0,0,6,6,3,0,0,0
6980,747,2019,8,8,0,1.0,100,965,6,2,0,2,1,0,3,0,0,2,0,0,1,0,0,0,0
6981,748,2019,32,32,0,1.0,100,965,15,16,1,7,8,1,16,3,1,2,1,0,8,1,0,0,0
6982,749,2019,7,7,0,1.0,100,965,3,3,1,3,2,1,6,3,0,0,0,1,1,1,0,0,0
6983,750,2019,36,36,0,1.0,100,965,17,17,2,7,14,1,22,0,5,1,1,11,3,0,1,0,0
6984,751,2019,31,5,26,0.15,14,965,1,3,1,1,2,1,4,1,0,0,0,1,1,1,0,0,0
6985,752,2019,20,19,1,0.94,93,965,6,11,2,4,11,1,16,2,2,0,0,11,0,0,1,0,0
6986,753,2019,21,20,1,0.97,96,965,12,5,3,4,4,2,10,0,0,4,0,3,1,1,1,0,0
6987,754,2019,6,3,3,0.47,46,965,1,2,0,1,1,0,2,1,0,0,0,0,1,0,0,0,0
6988,755,2019,30,21,9,0.71,71,965,7,11,3,4,10,2,16,2,1,1,0,9,1,1,1,0,0
6989,756,2019,25,24,1,0.96,96,965,17,6,1,6,6,1,13,1,2,0,3,6,0,1,0,0,0
6990,757,2019,38,38,0,1.0,100,965,21,15,2,16,11,1,28,14,0,1,1,7,4,0,1,0,0
6991,758,2019,43,31,12,0.72,72,965,20,9,2,10,5,2,17,5,2,1,2,1,4,2,0,0,0
6992,759,2019,27,26,1,0.98,98,965,19,4,3,19,4,1,24,19,0,0,0,4,0,0,0,1,0
6993,760,2019,16,10,6,0.63,63,965,5,3,2,4,2,1,7,3,1,0,0,1,1,0,1,0,0
6994,761,2019,15,15,0,1.0,100,965,7,5,3,5,3,2,10,4,0,1,0,1,2,1,1,0,0
6995,762,2019,43,32,11,0.74,73,965,24,5,3,6,5,1,12,0,0,0,6,5,0,0,0,1,0
6996,763,2019,52,52,0,1.0,100,965,34,17,1,17,17,1,35,9,1,5,2,17,0,1,0,0,0
6997,764,2019,28,6,22,0.23,23,965,3,2,1,3,2,1,6,3,0,0,0,2,0,1,0,0,0
6998,765,2019,36,35,1,0.98,97,965,24,10,1,11,7,1,19,5,1,3,2,4,3,1,0,0,0
6999,766,2019,15,14,1,0.93,92,965,3,8,3,2,8,2,12,1,1,0,0,8,0,1,1,0,0
7000,767,2019,34,31,3,0.92,92,965,16,14,1,9,8,1,18,4,3,2,0,2,6,1,0,0,0
7001,768,2019,7,7,0,0.99,98,965,3,4,0,1,3,0,4,0,0,1,0,2,1,0,0,0,0
7002,769,2019,20,20,0,1.0,100,965,13,6,1,9,3,1,13,5,4,0,0,0,3,1,0,0,0
7003,770,2019,40,2,38,0.05,5,965,1,1,0,1,1,0,2,1,0,0,0,1,0,0,0,0,0
7004,771,2019,40,21,19,0.53,52,965,15,4,2,11,3,2,16,7,4,0,0,2,1,2,0,0,0
7005,772,2019,18,1,17,0.05,4,965,0,1,0,0,1,0,1,0,0,0,0,1,0,0,0,0,0
7006,773,2019,39,14,25,0.35,34,965,7,4,3,6,3,3,12,5,1,0,0,2,1,3,0,0,0
7007,774,2019,10,10,0,0.98,97,965,3,5,2,3,5,2,10,3,0,0,0,5,0,2,0,0,0
7008,775,2019,6,1,5,0.11,11,965,0,1,0,0,1,0,1,0,0,0,0,1,0,0,0,0,0
7009,776,2019,18,17,1,0.96,96,965,9,6,2,3,6,1,10,0,1,1,1,6,0,0,1,0,0
7010,777,2019,13,13,0,1.0,100,965,5,6,2,4,4,2,10,3,1,0,0,2,2,2,0,0,0
7011,778,2019,50,36,14,0.71,71,965,13,20,3,11,16,2,29,10,0,1,0,12,4,1,1,0,0
7012,779,2019,55,55,0,1.0,99,965,21,30,4,7,18,2,27,0,3,1,3,6,12,1,0,1,0
7013,780,2019,34,34,0,1.0,99,965,16,15,3,6,8,3,17,2,1,0,3,1,7,3,0,0,0
7014,781,2019,25,25,0,1.0,100,965,9,14,2,3,14,2,19,1,0,0,2,14,0,2,0,0,0
7015,782,2019,49,49,0,1.0,100,965,20,28,1,9,21,1,31,2,3,4,0,14,7,1,0,0,0
7016,783,2019,17,17,0,1.0,100,965,7,8,2,6,4,2,12,5,1,0,0,0,4,2,0,0,0
7017,784,2019,47,47,0,1.0,100,965,21,24,2,21,18,1,40,21,0,0,0,12,6,0,1,0,0
7018,785,2019,6,0,6,0.01,1,965,0,0,0,0,0,0,0,0,0,0,0,0,0,0,0,0,0
7019,786,2019,39,39,0,1.0,100,965,19,18,2,15,16,1,32,13,0,2,0,14,2,0,1,0,0
7020,787,2019,37,37,0,1.0,100,965,18,17,2,9,17,1,27,4,2,2,1,17,0,0,1,0,0
7021,788,2019,30,30,0,0.99,98,965,15,12,3,10,9,2,21,7,1,2,0,6,3,1,1,0,0
7022,789,2019,23,20,3,0.87,87,965,14,5,1,4,5,1,10,0,1,0,3,5,0,1,0,0,0
7023,790,2019,35,26,9,0.74,73,965,11,14,1,10,14,1,25,9,1,0,0,14,0,1,0,0,0
7024,791,2019,18,18,0,0.99,99,965,10,8,0,7,6,0,13,4,3,0,0,4,2,0,0,0,0
7025,792,2019,40,40,0,1.0,100,965,24,12,4,21,12,3,36,19,1,1,0,12,0,2,1,0,0
7026,793,2019,16,16,0,1.0,100,965,8,6,2,7,6,2,15,6,1,0,0,6,0,2,0,0,0
7027,794,2019,8,8,0,1.0,99,965,5,2,1,3,2,1,6,1,2,0,0,2,0,1,0,0,0
7028,795,2019,33,28,5,0.85,85,965,8,16,4,3,15,1,19,1,0,1,1,14,1,0,0,0,1
7029,796,2019,14,14,0,1.0,100,965,6,5,3,6,4,1,11,6,0,0,0,3,1,0,0,1,0
7030,797,2019,55,13,42,0.24,23,965,9,3,1,5,2,1,8,3,1,0,1,1,1,1,0,0,0
7031,798,2019,24,24,0,1.0,100,965,16,7,1,6,5,1,12,1,1,3,1,3,2,1,0,0,0
7032,799,2019,36,36,0,1.0,99,965,19,13,4,11,9,4,24,8,0,1,2,5,4,4,0,0,0
7033,800,2019,30,30,0,1.0,99,965,12,14,4,9,7,2,18,8,0,0,1,0,7,0,2,0,0
7034,801,2019,38,17,21,0.44,44,965,11,5,1,8,4,1,13,5,3,0,0,3,1,1,0,0,0
7035,802,2019,38,38,0,1.0,100,965,27,10,1,20,8,1,29,14,5,1,0,6,2,1,0,0,0
7036,803,2019,36,36,0,1.0,100,965,26,8,2,10,7,2,19,1,5,1,3,6,1,2,0,0,0
7037,804,2019,35,35,0,1.0,100,965,26,5,4,21,3,1,25,19,0,1,1,1,2,0,0,0,1
7038,805,2019,59,59,0,1.0,100,965,33,24,2,13,22,1,36,2,6,1,4,20,2,0,1,0,0
7039,806,2019,12,1,11,0.05,5,965,0,1,0,0,1,0,1,0,0,0,0,1,0,0,0,0,0
7040,807,2019,28,28,0,0.99,98,965,20,6,2,13,3,1,17,6,7,0,0,0,3,0,1,0,0
7041,808,2019,22,0,22,0.01,1,965,0,0,0,0,0,0,0,0,0,0,0,0,0,0,0,0,0
7042,809,2019,34,34,0,0.99,99,965,18,12,4,18,7,3,28,18,0,0,0,2,5,2,1,0,0
7043,810,2019,38,38,0,1.0,100,965,16,18,4,11,18,2,31,8,2,0,1,18,0,1,0,1,0
7044,811,2019,14,4,10,0.3,30,965,2,2,0,1,2,0,3,0,1,0,0,2,0,0,0,0,0
7045,812,2019,40,3,37,0.07,6,965,2,1,0,2,1,0,3,2,0,0,0,1,0,0,0,0,0
7046,813,2019,52,52,0,1.0,100,965,39,13,0,24,11,0,35,11,11,2,0,9,2,0,0,0,0
7047,814,2019,59,20,39,0.34,33,965,11,7,2,4,5,1,10,0,1,3,0,3,2,0,1,0,0
7048,815,2019,30,30,0,1.0,100,965,12,15,3,10,11,2,23,8,2,0,0,7,4,1,1,0,0
7049,816,2019,37,37,0,1.0,99,965,16,17,4,14,12,3,29,13,0,1,0,7,5,2,1,0,0
7050,817,2019,24,5,19,0.23,22,965,3,2,0,2,2,0,4,1,1,0,0,2,0,0,0,0,0
7051,818,2019,22,22,0,1.0,100,965,7,13,2,3,13,1,17,1,1,0,1,13,0,0,1,0,0
7052,819,2019,22,21,1,0.94,93,965,13,5,3,7,3,3,13,3,3,0,1,1,2,3,0,0,0
7053,820,2019,41,41,0,1.0,100,965,23,17,1,17,14,1,32,13,2,2,0,11,3,1,0,0,0
7054,821,2019,17,17,0,1.0,100,965,6,9,2,5,5,2,12,4,1,0,0,1,4,2,0,0,0
7055,822,2019,44,43,1,0.99,98,965,26,14,3,26,13,2,41,26,0,0,0,12,1,1,1,0,0
7056,823,2019,6,6,0,1.0,100,965,2,3,1,1,3,1,5,0,1,0,0,3,0,1,0,0,0
7057,824,2019,23,20,3,0.89,88,965,6,11,3,3,11,1,15,1,1,1,0,11,0,0,0,1,0
7058,825,2019,47,47,0,0.99,99,965,23,21,3,20,15,1,36,17,3,0,0,9,6,0,0,1,0
7059,826,2019,13,13,0,1.0,99,965,5,5,3,5,3,2,10,5,0,0,0,1,2,1,1,0,0
7060,827,2019,16,4,12,0.25,24,965,3,1,0,3,1,0,4,3,0,0,0,1,0,0,0,0,0
7061,828,2019,28,28,0,0.99,99,965,19,6,3,17,4,3,24,15,2,0,0,2,2,3,0,0,0
7062,829,2019,58,58,0,1.0,100,965,36,20,2,20,18,2,40,9,8,1,2,16,2,2,0,0,0
7063,830,2019,19,19,0,1.0,99,965,8,9,2,4,9,2,15,2,1,0,1,9,0,2,0,0,0
7064,831,2019,35,21,14,0.59,58,965,14,7,0,14,7,0,21,14,0,0,0,7,0,0,0,0,0
7065,832,2019,23,23,0,1.0,100,965,12,8,3,7,4,1,12,2,5,0,0,0,4,0,0,1,0
7066,833,2019,15,15,0,1.0,100,965,6,7,2,3,7,2,12,0,3,0,0,7,0,2,0,0,0
7067,834,2019,8,8,0,0.98,97,965,6,2,0,3,1,0,4,0,3,0,0,0,1,0,0,0,0
7068,835,2019,12,12,0,1.0,100,965,3,6,3,3,4,2,9,3,0,0,0,2,2,1,1,0,0
7069,836,2019,16,15,1,0.96,95,965,7,5,3,7,4,2,13,7,0,0,0,3,1,1,1,0,0
7070,837,2019,47,47,0,1.0,100,965,19,25,3,6,18,2,26,0,0,5,1,11,7,1,1,0,0
7071,838,2019,15,15,0,1.0,100,965,6,6,3,4,3,3,10,2,2,0,0,0,3,3,0,0,0
7072,839,2019,39,30,9,0.76,75,965,14,14,2,10,7,2,19,6,4,0,0,0,7,2,0,0,0
7073,840,2019,25,25,0,1.0,100,965,13,9,3,4,9,1,14,1,0,0,3,9,0,0,0,1,0
7074,841,2019,10,7,3,0.75,74,965,3,3,1,2,2,1,5,1,1,0,0,1,1,1,0,0,0
7075,842,2019,22,21,1,0.95,95,965,10,11,0,3,9,0,12,0,0,2,1,7,2,0,0,0,0
7076,843,2019,9,7,2,0.76,75,965,2,3,2,1,3,2,6,0,1,0,0,3,0,2,0,0,0
7077,844,2019,38,38,0,1.0,100,965,16,21,1,9,17,1,27,3,5,1,0,13,4,1,0,0,0
7078,845,2019,32,32,0,1.0,100,965,22,7,3,10,6,3,19,2,5,2,1,5,1,3,0,0,0
7079,846,2019,20,19,1,0.97,96,965,11,7,1,11,5,1,17,11,0,0,0,3,2,1,0,0,0
7080,847,2019,35,32,3,0.93,92,965,15,15,2,5,13,2,20,1,0,2,2,11,2,2,0,0,0
7081,848,2019,29,29,0,0.99,98,965,16,10,3,5,6,3,14,0,0,4,1,2,4,3,0,0,0
7082,849,2019,14,8,6,0.59,58,965,4,3,1,3,2,1,6,2,1,0,0,1,1,1,0,0,0
7083,850,2019,34,34,0,1.0,99,965,19,14,1,11,8,1,20,6,2,3,0,2,6,1,0,0,0
7084,851,2019,35,35,0,1.0,100,965,19,14,2,5,11,2,18,0,0,1,4,8,3,2,0,0,0
7085,852,2019,55,55,0,1.0,100,965,19,33,3,19,33,3,55,19,0,0,0,33,0,3,0,0,0
7086,853,2019,26,10,16,0.38,38,965,6,4,0,5,2,0,7,4,1,0,0,0,2,0,0,0,0
7087,854,2019,53,51,2,0.96,95,965,26,23,2,18,15,2,35,12,4,2,0,7,8,2,0,0,0
7088,855,2019,49,49,0,1.0,100,965,22,24,3,11,22,1,34,6,1,2,2,20,2,0,0,1,0
7089,856,2019,23,23,0,1.0,100,965,10,12,1,9,10,1,20,8,1,0,0,8,2,1,0,0,0
7090,857,2019,21,21,0,1.0,100,965,8,11,2,2,8,2,12,0,0,0,2,5,3,2,0,0,0
7091,858,2019,23,23,0,1.0,100,965,13,7,3,7,6,1,14,4,0,3,0,5,1,0,0,1,0
7092,859,2019,38,38,0,1.0,100,965,17,18,3,14,18,1,33,11,3,0,0,18,0,0,0,1,0
7093,860,2019,35,35,0,1.0,100,965,20,11,4,9,8,2,19,4,1,2,2,5,3,0,2,0,0
7094,861,2019,20,20,0,1.0,99,965,11,6,3,6,6,2,14,3,1,2,0,6,0,1,1,0,0
7095,862,2019,28,28,0,1.0,100,965,13,11,4,12,6,2,20,11,1,0,0,1,5,0,2,0,0
7096,863,2019,7,7,0,1.0,100,965,3,3,1,2,3,1,6,1,1,0,0,3,0,1,0,0,0
7097,864,2019,46,33,13,0.72,71,965,24,6,3,22,3,2,27,21,0,1,0,0,3,1,1,0,0
7098,865,2019,15,15,0,0.99,98,965,11,3,1,11,2,1,14,11,0,0,0,1,1,1,0,0,0
7099,866,2019,58,24,34,0.42,42,965,14,10,0,12,10,0,22,10,2,0,0,10,0,0,0,0,0
7100,867,2019,29,29,0,0.99,98,965,14,13,2,9,11,2,22,4,5,0,0,9,2,2,0,0,0
7101,868,2019,34,18,16,0.53,53,965,7,7,4,2,5,1,8,0,0,1,1,3,2,0,0,0,1
7102,869,2019,15,0,15,0.01,1,965,0,0,0,0,0,0,0,0,0,0,0,0,0,0,0,0,0
7103,870,2019,35,9,26,0.24,24,965,3,4,2,3,4,2,9,3,0,0,0,4,0,2,0,0,0
7104,871,2019,11,11,0,1.0,100,965,3,6,2,1,4,2,7,0,0,1,0,2,2,2,0,0,0
7105,872,2019,37,37,0,1.0,100,965,26,8,3,25,8,2,35,24,1,0,0,8,0,1,1,0,0
7106,873,2019,31,31,0,1.0,99,965,20,10,1,11,5,1,17,3,7,1,0,0,5,1,0,0,0
7107,874,2019,38,38,0,1.0,100,965,22,12,4,21,10,4,35,20,1,0,0,8,2,4,0,0,0
7108,875,2019,9,9,0,1.0,99,965,5,4,0,4,4,0,8,3,1,0,0,4,0,0,0,0,0
7109,876,2019,39,37,2,0.95,94,965,20,13,4,8,13,3,24,0,5,2,1,13,0,2,1,0,0
7110,877,2019,52,43,9,0.83,82,965,20,23,0,9,23,0,32,0,7,2,0,23,0,0,0,0,0
7111,878,2019,37,4,33,0.1,9,965,1,2,1,1,2,1,4,1,0,0,0,2,0,1,0,0,0
7112,879,2019,16,16,0,1.0,100,965,4,9,3,2,5,1,8,1,0,1,0,1,4,0,0,1,0
7113,880,2019,20,19,1,0.95,94,965,8,10,1,5,5,1,11,4,0,0,1,0,5,1,0,0,0
7114,881,2019,7,7,0,1.0,100,965,2,3,2,1,2,2,5,0,1,0,0,1,1,2,0,0,0
7115,882,2019,60,17,43,0.28,27,965,5,10,2,4,8,2,14,3,1,0,0,6,2,2,0,0,0
7116,883,2019,10,10,0,1.0,100,965,4,5,1,4,3,1,8,4,0,0,0,1,2,1,0,0,0
7117,884,2019,8,4,4,0.48,48,965,1,2,1,1,1,1,3,1,0,0,0,0,1,1,0,0,0
7118,885,2019,34,4,30,0.11,11,965,1,2,1,1,2,1,4,1,0,0,0,2,0,1,0,0,0
7119,886,2019,26,26,0,1.0,100,965,11,15,0,10,9,0,19,9,1,0,0,3,6,0,0,0,0
7120,887,2019,12,12,0,0.96,96,965,7,3,2,5,3,1,9,4,0,1,0,3,0,0,1,0,0
7121,888,2019,15,15,0,1.0,100,965,8,7,0,4,4,0,8,0,4,0,0,1,3,0,0,0,0
7122,889,2019,26,26,0,1.0,100,965,7,16,3,2,14,3,19,0,0,1,1,12,2,3,0,0,0
7123,890,2019,12,10,2,0.88,87,965,4,5,1,3,4,1,8,2,1,0,0,3,1,1,0,0,0
7124,891,2019,60,60,0,1.0,100,965,27,31,2,20,17,2,39,14,5,1,0,3,14,2,0,0,0
7125,892,2019,21,21,0,1.0,100,965,11,8,2,4,8,2,14,0,2,1,1,8,0,2,0,0,0
7126,893,2019,18,4,14,0.23,23,965,1,2,1,1,1,1,3,1,0,0,0,0,1,1,0,0,0
7127,894,2019,13,13,0,0.99,98,965,5,7,1,4,5,1,10,3,1,0,0,3,2,1,0,0,0
7128,895,2019,41,31,10,0.76,76,965,20,10,1,5,6,1,12,0,0,0,5,2,4,1,0,0,0
7129,896,2019,14,4,10,0.31,31,965,1,2,1,1,1,1,3,1,0,0,0,0,1,1,0,0,0
7130,897,2019,47,45,2,0.96,96,965,21,21,3,8,21,2,31,1,4,0,3,21,0,1,1,0,0
7131,898,2019,28,28,0,1.0,100,965,17,9,2,17,6,2,25,17,0,0,0,3,3,2,0,0,0
7132,899,2019,29,29,0,1.0,99,965,10,16,3,8,12,3,23,6,2,0,0,8,4,3,0,0,0
7133,900,2019,22,22,0,0.99,99,965,13,8,1,5,7,1,13,2,0,1,2,6,1,1,0,0,0
7134,901,2019,34,34,0,0.99,98,965,16,15,3,11,13,3,27,7,3,1,0,11,2,3,0,0,0
7135,902,2019,16,16,0,1.0,100,965,5,8,3,2,5,1,8,1,0,0,1,2,3,0,0,1,0
7136,903,2019,26,26,0,1.0,99,965,6,16,4,5,11,2,18,4,1,0,0,6,5,0,2,0,0
7137,904,2019,10,2,8,0.19,19,965,1,1,0,1,1,0,2,1,0,0,0,1,0,0,0,0,0
7138,905,2019,14,5,9,0.34,34,965,3,2,0,3,1,0,4,3,0,0,0,0,1,0,0,0,0
7139,906,2019,12,9,3,0.74,74,965,4,3,2,4,3,1,8,4,0,0,0,3,0,0,1,0,0
7140,907,2019,42,16,26,0.38,37,965,9,7,0,6,7,0,13,5,0,0,1,7,0,0,0,0,0
7141,908,2019,20,19,1,0.97,96,965,11,7,1,10,5,1,16,9,1,0,0,3,2,1,0,0,0
7142,909,2019,40,40,0,1.0,100,965,29,8,3,20,6,3,29,15,2,2,1,4,2,3,0,0,0
7143,910,2019,16,16,0,1.0,100,965,10,5,1,10,5,1,16,10,0,0,0,5,0,1,0,0,0
7144,911,2019,57,57,0,1.0,100,965,37,18,2,31,14,2,47,25,6,0,0,10,4,2,0,0,0
7145,912,2019,10,0,10,0.01,1,965,0,0,0,0,0,0,0,0,0,0,0,0,0,0,0,0,0
7146,913,2019,27,13,14,0.46,46,965,6,4,3,6,3,2,11,6,0,0,0,2,1,1,1,0,0
7147,914,2019,33,30,3,0.92,92,965,20,7,3,17,7,2,26,15,1,1,0,7,0,1,1,0,0
7148,915,2019,26,24,2,0.93,92,965,12,12,0,5,10,0,15,1,1,3,0,8,2,0,0,0,0
7149,916,2019,37,36,1,0.98,98,965,17,18,1,5,15,1,21,0,0,3,2,12,3,1,0,0,0
7150,917,2019,25,25,0,1.0,99,965,16,7,2,6,4,2,12,2,1,0,3,1,3,2,0,0,0
7151,918,2019,12,12,0,0.98,97,965,6,4,2,2,2,2,6,0,0,2,0,0,2,2,0,0,0
7152,919,2019,41,40,1,0.98,98,965,25,12,3,9,10,1,20,0,3,5,1,8,2,0,0,1,0
7153,920,2019,11,11,0,0.99,98,965,6,3,2,6,2,2,10,6,0,0,0,1,1,2,0,0,0
7154,921,2019,26,26,0,1.0,99,965,13,12,1,4,7,1,12,0,0,3,1,2,5,1,0,0,0
7155,922,2019,12,11,1,0.95,95,965,5,6,0,5,6,0,11,5,0,0,0,6,0,0,0,0,0
7156,923,2019,41,41,0,1.0,99,965,19,21,1,9,16,1,26,1,7,0,1,11,5,1,0,0,0
7157,924,2019,15,15,0,1.0,100,965,8,6,1,3,4,1,8,0,1,2,0,2,2,1,0,0,0
7158,925,2019,25,23,2,0.94,93,965,9,13,1,3,10,1,14,0,0,3,0,7,3,1,0,0,0
7159,926,2019,27,6,21,0.22,22,965,3,3,0,3,3,0,6,3,0,0,0,3,0,0,0,0,0
7160,927,2019,27,27,0,1.0,99,965,10,14,3,6,8,1,15,3,2,1,0,2,6,0,0,1,0
7161,928,2019,38,38,0,1.0,100,965,15,19,4,10,15,3,28,8,0,1,1,11,4,2,1,0,0
7162,929,2019,9,9,0,1.0,99,965,4,4,1,3,4,1,8,2,1,0,0,4,0,1,0,0,0
7163,930,2019,47,47,0,1.0,100,965,21,23,3,9,23,1,33,4,1,1,3,23,0,0,0,1,0
7164,931,2019,26,26,0,1.0,100,965,14,8,4,14,4,3,21,14,0,0,0,0,4,2,1,0,0
7165,932,2019,29,29,0,1.0,100,965,20,6,3,13,6,2,21,7,5,1,0,6,0,1,1,0,0
7166,933,2019,39,16,23,0.41,40,965,8,6,2,3,6,1,10,1,0,1,1,6,0,0,1,0,0
7167,934,2019,25,10,15,0.39,38,965,3,5,2,1,3,2,6,0,0,1,0,1,2,2,0,0,0
7168,935,2019,22,19,3,0.89,88,965,12,5,2,10,3,2,15,8,2,0,0,1,2,2,0,0,0
7169,936,2019,31,31,0,1.0,99,965,19,10,2,12,10,1,23,9,0,2,1,10,0,0,1,0,0
7170,937,2019,10,2,8,0.22,22,965,1,1,0,1,1,0,2,1,0,0,0,1,0,0,0,0,0
7171,938,2019,31,21,10,0.67,66,965,14,4,3,7,2,1,10,3,1,3,0,0,2,0,0,1,0
7172,939,2019,14,14,0,0.99,99,965,4,6,4,4,6,3,13,4,0,0,0,6,0,2,1,0,0
7173,940,2019,60,59,1,0.98,97,965,24,34,1,20,30,1,51,18,0,2,0,26,4,1,0,0,0
7174,941,2019,27,24,3,0.9,89,965,9,12,3,9,9,1,19,9,0,0,0,6,3,0,0,1,0
7175,942,2019,17,17,0,1.0,100,965,11,6,0,8,6,0,14,6,1,1,0,6,0,0,0,0,0
7176,943,2019,48,48,0,1.0,99,965,28,17,3,23,16,2,41,21,0,1,1,15,1,1,1,0,0
7177,944,2019,18,14,4,0.79,78,965,8,4,2,8,3,2,13,8,0,0,0,2,1,2,0,0,0
7178,945,2019,26,25,1,0.97,96,965,15,9,1,15,7,1,23,15,0,0,0,5,2,1,0,0,0
7179,946,2019,24,24,0,1.0,100,965,17,5,2,15,3,1,19,14,0,1,0,1,2,0,1,0,0
7180,947,2019,36,0,36,0.01,1,965,0,0,0,0,0,0,0,0,0,0,0,0,0,0,0,0,0
7181,948,2019,20,6,14,0.28,27,965,3,2,1,3,1,1,5,3,0,0,0,0,1,1,0,0,0
7182,949,2019,26,26,0,1.0,100,965,18,5,3,18,3,1,22,18,0,0,0,1,2,0,0,1,0
7183,950,2019,35,17,18,0.48,48,965,7,6,4,3,3,4,10,1,1,0,1,0,3,4,0,0,0
7184,951,2019,29,28,1,0.97,96,965,21,6,1,13,5,1,19,9,0,4,0,4,1,1,0,0,0
7185,952,2019,15,13,2,0.86,85,965,9,3,1,9,2,1,12,9,0,0,0,1,1,1,0,0,0
7186,953,2019,54,1,53,0.01,1,965,0,1,0,0,1,0,1,0,0,0,0,1,0,0,0,0,0
7187,954,2019,21,21,0,1.0,100,965,13,6,2,8,4,2,14,6,0,1,1,2,2,2,0,0,0
7188,955,2019,23,23,0,1.0,100,965,17,6,0,12,6,0,18,8,3,1,0,6,0,0,0,0,0
7189,956,2019,40,23,17,0.57,56,965,17,4,2,10,2,1,13,7,1,0,2,0,2,0,1,0,0
7190,957,2019,23,9,14,0.4,39,965,5,3,1,2,2,1,5,1,0,0,1,1,1,1,0,0,0
7191,958,2019,20,12,8,0.61,61,965,5,5,2,2,3,1,6,0,1,1,0,1,2,0,1,0,0
7192,959,2019,22,21,1,0.97,96,965,11,7,3,11,7,3,21,11,0,0,0,7,0,3,0,0,0
7193,960,2019,6,6,0,1.0,100,965,4,2,0,1,1,0,2,0,0,0,1,0,1,0,0,0,0
7194,961,2019,22,10,12,0.44,44,965,7,2,1,2,2,1,5,0,0,1,1,2,0,1,0,0,0
7195,962,2019,34,31,3,0.91,90,965,10,18,3,10,18,2,30,10,0,0,0,18,0,1,1,0,0
7196,963,2019,15,12,3,0.82,81,965,3,6,3,2,6,2,10,1,1,0,0,6,0,1,1,0,0
7197,964,2019,28,28,0,1.0,100,965,13,13,2,13,12,1,26,13,0,0,0,11,1,0,1,0,0
7198,965,2019,16,15,1,0.97,96,965,4,8,3,4,4,2,10,4,0,0,0,0,4,1,1,0,0
7199,1,2020,33,33,0,1.0,100,1080,21,11,1,10,11,1,22,1,7,2,0,11,0,1,0,0,0
7200,2,2020,15,8,7,0.52,52,1080,4,3,1,3,2,1,6,2,1,0,0,1,1,1,0,0,0
7201,3,2020,28,28,0,1.0,100,1080,19,7,2,5,7,1,13,0,0,1,4,7,0,0,1,0,0
7202,4,2020,40,40,0,1.0,100,1080,28,9,3,14,6,1,21,6,2,6,0,3,3,0,0,1,0
7203,5,2020,33,33,0,1.0,100,1080,22,10,1,12,6,1,19,7,1,3,1,2,4,1,0,0,0
7204,6,2020,41,41,0,1.0,100,1080,22,17,2,18,9,1,28,16,0,2,0,1,8,0,1,0,0
7205,7,2020,55,55,0,1.0,100,1080,37,15,3,27,13,3,43,20,5,1,1,11,2,3,0,0,0
7206,8,2020,38,19,19,0.5,50,1080,11,8,0,4,7,0,11,0,1,3,0,6,1,0,0,0,0
7207,9,2020,28,4,24,0.15,14,1080,3,1,0,3,1,0,4,3,0,0,0,1,0,0,0,0,0
7208,10,2020,12,12,0,1.0,100,1080,4,5,3,2,3,3,8,0,2,0,0,1,2,3,0,0,0
7209,11,2020,49,25,24,0.5,50,1080,8,15,2,5,11,2,18,4,0,0,1,7,4,2,0,0,0
7210,12,2020,34,0,34,0.0,0,1080,0,0,0,0,0,0,0,0,0,0,0,0,0,0,0,0,0
7211,13,2020,6,6,0,1.0,99,1080,2,3,1,1,2,1,4,0,1,0,0,1,1,1,0,0,0
7212,14,2020,32,0,32,0.01,1,1080,0,0,0,0,0,0,0,0,0,0,0,0,0,0,0,0,0
7213,15,2020,7,7,0,0.99,98,1080,4,3,0,3,3,0,6,2,1,0,0,3,0,0,0,0,0
7214,16,2020,47,47,0,1.0,100,1080,35,12,0,9,9,0,18,0,0,1,8,6,3,0,0,0,0
7215,17,2020,13,13,0,1.0,100,1080,7,6,0,6,5,0,11,5,1,0,0,4,1,0,0,0,0
7216,18,2020,40,40,0,1.0,100,1080,22,15,3,12,12,3,27,6,3,2,1,9,3,3,0,0,0
7217,19,2020,10,2,8,0.15,15,1080,1,1,0,1,1,0,2,1,0,0,0,1,0,0,0,0,0
7218,20,2020,9,9,0,1.0,100,1080,6,2,1,4,1,1,6,3,0,1,0,0,1,1,0,0,0
7219,21,2020,52,39,13,0.74,74,1080,26,10,3,7,7,3,17,0,1,0,6,4,3,3,0,0,0
7220,22,2020,5,5,0,0.97,96,1080,2,2,1,2,2,1,5,2,0,0,0,2,0,1,0,0,0
7221,23,2020,34,34,0,1.0,100,1080,16,17,1,14,17,1,32,13,0,1,0,17,0,1,0,0,0
7222,24,2020,37,37,0,1.0,99,1080,14,21,2,5,12,2,19,1,1,1,2,3,9,2,0,0,0
7223,25,2020,36,36,0,1.0,100,1080,14,19,3,12,17,3,32,10,2,0,0,15,2,3,0,0,0
7224,26,2020,33,33,0,1.0,100,1080,17,15,1,16,14,1,31,15,1,0,0,13,1,1,0,0,0
7225,27,2020,27,21,6,0.77,76,1080,13,8,0,13,4,0,17,13,0,0,0,0,4,0,0,0,0
7226,28,2020,27,27,0,1.0,99,1080,17,9,1,10,5,1,16,7,1,0,2,1,4,1,0,0,0
7227,29,2020,8,2,6,0.26,26,1080,1,1,0,1,1,0,2,1,0,0,0,1,0,0,0,0,0
7228,30,2020,59,59,0,1.0,100,1080,44,13,2,36,10,2,48,31,2,3,0,7,3,2,0,0,0
7229,31,2020,60,48,12,0.8,80,1080,27,18,3,16,10,2,28,11,2,0,3,2,8,1,1,0,0
7230,32,2020,10,10,0,1.0,100,1080,7,3,0,3,2,0,5,1,0,2,0,1,1,0,0,0,0
7231,33,2020,28,28,0,1.0,100,1080,13,14,1,6,12,1,19,2,1,3,0,10,2,1,0,0,0
7232,34,2020,10,8,2,0.78,77,1080,3,3,2,2,2,2,6,1,1,0,0,1,1,2,0,0,0
7233,35,2020,52,52,0,1.0,100,1080,27,22,3,19,22,1,42,11,8,0,0,22,0,0,0,1,0
7234,36,2020,58,58,0,1.0,99,1080,43,15,0,14,10,0,24,0,5,3,6,5,5,0,0,0,0
7235,37,2020,53,53,0,1.0,100,1080,36,14,3,33,9,3,45,32,0,0,1,4,5,3,0,0,0
7236,38,2020,19,19,0,1.0,100,1080,10,9,0,5,6,0,11,1,3,1,0,3,3,0,0,0,0
7237,39,2020,16,4,12,0.27,26,1080,1,2,1,1,1,1,3,1,0,0,0,0,1,1,0,0,0
7238,40,2020,8,8,0,1.0,100,1080,3,3,2,2,3,1,6,1,1,0,0,3,0,0,1,0,0
7239,41,2020,24,24,0,1.0,99,1080,17,4,3,16,4,1,21,15,1,0,0,4,0,0,0,1,0
7240,42,2020,8,0,8,0.04,3,1080,0,0,0,0,0,0,0,0,0,0,0,0,0,0,0,0,0
7241,43,2020,40,40,0,1.0,99,1080,18,18,4,17,17,4,38,16,1,0,0,16,1,4,0,0,0
7242,44,2020,29,29,0,0.99,98,1080,19,10,0,8,6,0,14,1,5,0,2,2,4,0,0,0,0
7243,45,2020,42,12,30,0.29,28,1080,5,6,1,3,6,1,10,2,0,1,0,6,0,1,0,0,0
7244,46,2020,53,53,0,1.0,100,1080,38,13,2,10,7,1,18,0,1,0,9,1,6,0,1,0,0
7245,47,2020,37,37,0,1.0,100,1080,20,15,2,11,9,1,21,4,5,2,0,3,6,0,1,0,0
7246,48,2020,24,24,0,1.0,100,1080,13,9,2,13,9,2,24,13,0,0,0,9,0,2,0,0,0
7247,49,2020,60,59,1,0.99,98,1080,27,28,4,20,17,2,39,17,0,2,1,6,11,1,0,1,0
7248,50,2020,17,17,0,1.0,99,1080,8,7,2,6,7,2,15,5,0,1,0,7,0,2,0,0,0
7249,51,2020,18,18,0,1.0,100,1080,11,5,2,4,3,1,8,0,2,1,1,1,2,0,1,0,0
7250,52,2020,34,33,1,0.98,97,1080,12,20,1,4,10,1,15,0,2,0,2,0,10,1,0,0,0
7251,53,2020,25,8,17,0.33,32,1080,2,4,2,1,4,2,7,0,1,0,0,4,0,2,0,0,0
7252,54,2020,26,26,0,1.0,99,1080,18,7,1,10,5,1,16,2,8,0,0,3,2,1,0,0,0
7253,55,2020,31,31,0,1.0,100,1080,20,11,0,8,8,0,16,2,3,0,3,5,3,0,0,0,0
7254,56,2020,25,25,0,1.0,100,1080,18,5,2,9,3,1,13,6,0,0,3,1,2,0,1,0,0
7255,57,2020,11,11,0,1.0,100,1080,4,4,3,1,3,2,6,0,0,0,1,2,1,1,1,0,0
7256,58,2020,33,33,0,1.0,100,1080,17,13,3,16,13,3,32,15,1,0,0,13,0,3,0,0,0
7257,59,2020,7,7,0,1.0,100,1080,3,3,1,1,2,1,4,0,0,1,0,1,1,1,0,0,0
7258,60,2020,5,4,1,0.76,76,1080,1,2,1,1,2,1,4,1,0,0,0,2,0,1,0,0,0
7259,61,2020,23,23,0,1.0,100,1080,10,11,2,8,8,1,17,6,2,0,0,5,3,0,1,0,0
7260,62,2020,47,47,0,0.99,99,1080,25,19,3,12,11,3,26,5,3,2,2,3,8,3,0,0,0
7261,63,2020,7,5,2,0.66,66,1080,2,3,0,1,2,0,3,0,1,0,0,1,1,0,0,0,0
7262,64,2020,39,39,0,1.0,99,1080,16,22,1,13,19,1,33,10,3,0,0,16,3,1,0,0,0
7263,65,2020,47,46,1,0.98,98,1080,32,11,3,10,9,3,22,0,2,4,4,7,2,3,0,0,0
7264,66,2020,23,23,0,1.0,100,1080,7,13,3,4,7,1,12,1,3,0,0,1,6,0,0,1,0
7265,67,2020,7,4,3,0.56,55,1080,3,1,0,3,1,0,4,3,0,0,0,1,0,0,0,0,0
7266,68,2020,36,36,0,1.0,100,1080,24,8,4,10,5,2,17,3,2,3,2,2,3,1,0,1,0
7267,69,2020,44,20,24,0.46,45,1080,9,10,1,7,10,1,18,6,0,1,0,10,0,1,0,0,0
7268,70,2020,50,48,2,0.96,96,1080,22,24,2,6,23,1,30,0,1,0,5,22,1,0,1,0,0
7269,71,2020,14,9,5,0.65,64,1080,3,5,1,3,4,1,8,3,0,0,0,3,1,1,0,0,0
7270,72,2020,34,34,0,1.0,100,1080,15,16,3,15,11,2,28,15,0,0,0,6,5,1,1,0,0
7271,73,2020,50,12,38,0.24,24,1080,6,4,2,5,2,2,9,4,1,0,0,0,2,2,0,0,0
7272,74,2020,40,40,0,1.0,100,1080,29,8,3,13,7,2,22,2,6,5,0,6,1,1,1,0,0
7273,75,2020,34,33,1,0.98,97,1080,25,6,2,10,5,1,16,3,1,4,2,4,1,0,1,0,0
7274,76,2020,43,43,0,1.0,99,1080,26,15,2,17,10,1,28,10,6,0,1,5,5,0,1,0,0
7275,77,2020,13,13,0,0.99,99,1080,4,8,1,3,8,1,12,2,1,0,0,8,0,1,0,0,0
7276,78,2020,15,15,0,1.0,100,1080,9,4,2,4,4,1,9,0,3,1,0,4,0,0,1,0,0
7277,79,2020,19,19,0,1.0,99,1080,10,7,2,10,5,1,16,10,0,0,0,3,2,0,1,0,0
7278,80,2020,43,43,0,0.99,99,1080,23,16,4,21,11,1,33,19,2,0,0,6,5,0,0,0,1
7279,81,2020,55,54,1,0.99,98,1080,21,30,3,9,17,3,29,4,1,1,3,4,13,3,0,0,0
7280,82,2020,23,23,0,1.0,100,1080,16,5,2,5,5,1,11,0,2,0,3,5,0,0,1,0,0
7281,83,2020,9,9,0,0.99,99,1080,2,5,2,2,4,1,7,2,0,0,0,3,1,0,1,0,0
7282,84,2020,31,31,0,1.0,100,1080,15,13,3,8,7,1,16,1,7,0,0,1,6,0,0,1,0
7283,85,2020,6,6,0,1.0,100,1080,4,2,0,3,2,0,5,2,1,0,0,2,0,0,0,0,0
7284,86,2020,53,53,0,1.0,100,1080,34,19,0,19,13,0,32,9,5,5,0,7,6,0,0,0,0
7285,87,2020,27,27,0,1.0,100,1080,16,8,3,13,8,3,24,12,0,0,1,8,0,3,0,0,0
7286,88,2020,19,18,1,0.96,95,1080,7,10,1,6,8,1,15,5,1,0,0,6,2,1,0,0,0
7287,89,2020,29,29,0,1.0,100,1080,14,13,2,12,13,2,27,11,0,1,0,13,0,2,0,0,0
7288,90,2020,15,15,0,1.0,100,1080,8,7,0,8,7,0,15,8,0,0,0,7,0,0,0,0,0
7289,91,2020,57,57,0,1.0,99,1080,26,28,3,19,20,1,40,14,4,0,1,12,8,0,0,1,0
7290,92,2020,40,40,0,1.0,100,1080,20,19,1,10,16,1,27,6,0,2,2,13,3,1,0,0,0
7291,93,2020,26,23,3,0.87,86,1080,15,6,2,13,5,1,19,11,2,0,0,4,1,0,1,0,0
7292,94,2020,21,21,0,1.0,100,1080,15,4,2,4,4,2,10,0,0,1,3,4,0,2,0,0,0
7293,95,2020,39,39,0,1.0,100,1080,16,20,3,8,16,3,27,5,0,1,2,12,4,3,0,0,0
7294,96,2020,12,12,0,1.0,99,1080,3,7,2,2,7,1,10,1,1,0,0,7,0,0,1,0,0
7295,97,2020,28,28,0,1.0,100,1080,15,12,1,15,11,1,27,15,0,0,0,10,1,1,0,0,0
7296,98,2020,60,60,0,1.0,99,1080,29,27,4,12,23,2,37,4,2,3,3,19,4,1,0,1,0
7297,99,2020,56,55,1,0.99,98,1080,39,15,1,16,10,1,27,4,3,7,2,5,5,1,0,0,0
7298,100,2020,27,2,25,0.08,8,1080,1,1,0,1,1,0,2,1,0,0,0,1,0,0,0,0,0
7299,101,2020,31,31,0,1.0,100,1080,21,8,2,18,4,1,23,16,1,1,0,0,4,0,1,0,0
7300,102,2020,10,10,0,1.0,100,1080,2,6,2,2,4,2,8,2,0,0,0,2,2,2,0,0,0
7301,103,2020,29,15,14,0.53,53,1080,8,4,3,6,4,3,13,4,2,0,0,4,0,3,0,0,0
7302,104,2020,57,35,22,0.61,60,1080,16,15,4,6,10,2,18,2,0,2,2,5,5,1,0,1,0
7303,105,2020,15,15,0,1.0,99,1080,8,6,1,7,3,1,11,6,1,0,0,0,3,1,0,0,0
7304,106,2020,7,7,0,1.0,99,1080,3,3,1,3,2,1,6,3,0,0,0,1,1,1,0,0,0
7305,107,2020,8,8,0,1.0,100,1080,3,3,2,1,2,2,5,0,0,1,0,1,1,2,0,0,0
7306,108,2020,24,24,0,1.0,99,1080,14,8,2,8,6,1,15,4,2,2,0,4,2,0,1,0,0
7307,109,2020,16,16,0,1.0,100,1080,9,7,0,4,6,0,10,1,2,0,1,5,1,0,0,0,0
7308,110,2020,19,19,0,1.0,100,1080,12,5,2,12,3,2,17,12,0,0,0,1,2,2,0,0,0
7309,111,2020,41,41,0,1.0,100,1080,23,15,3,14,15,1,30,8,3,3,0,15,0,0,0,1,0
7310,112,2020,14,0,14,0.01,1,1080,0,0,0,0,0,0,0,0,0,0,0,0,0,0,0,0,0
7311,113,2020,7,7,0,1.0,100,1080,2,3,2,2,3,2,7,2,0,0,0,3,0,2,0,0,0
7312,114,2020,18,17,1,0.97,97,1080,10,5,2,8,5,1,14,7,0,1,0,5,0,0,1,0,0
7313,115,2020,5,5,0,0.98,97,1080,2,2,1,2,1,1,4,2,0,0,0,0,1,1,0,0,0
7314,116,2020,42,7,35,0.16,16,1080,2,4,1,2,2,1,5,2,0,0,0,0,2,1,0,0,0
7315,117,2020,8,8,0,1.0,100,1080,4,3,1,3,2,1,6,2,1,0,0,1,1,1,0,0,0
7316,118,2020,15,14,1,0.92,91,1080,9,3,2,9,2,1,12,9,0,0,0,1,1,0,1,0,0
7317,119,2020,14,7,7,0.48,47,1080,2,3,2,2,2,2,6,2,0,0,0,1,1,2,0,0,0
7318,120,2020,32,32,0,1.0,100,1080,21,8,3,21,8,2,31,21,0,0,0,8,0,1,1,0,0
7319,121,2020,32,32,0,1.0,99,1080,14,16,2,4,9,1,14,0,1,0,3,2,7,0,1,0,0
7320,122,2020,6,6,0,0.99,98,1080,3,3,0,3,2,0,5,3,0,0,0,1,1,0,0,0,0
7321,123,2020,20,20,0,1.0,100,1080,10,9,1,6,9,1,16,2,4,0,0,9,0,1,0,0,0
7322,124,2020,40,40,0,1.0,100,1080,18,20,2,6,16,1,23,0,3,0,3,12,4,0,1,0,0
7323,125,2020,48,48,0,1.0,99,1080,24,24,0,6,23,0,29,0,0,0,6,22,1,0,0,0,0
7324,126,2020,55,39,16,0.71,71,1080,12,23,4,7,22,1,30,4,1,2,0,21,1,0,0,0,1
7325,127,2020,15,8,7,0.5,50,1080,5,2,1,2,2,1,5,0,1,1,0,2,0,1,0,0,0
7326,128,2020,11,11,0,1.0,100,1080,4,6,1,4,3,1,8,4,0,0,0,0,3,1,0,0,0
7327,129,2020,58,58,0,1.0,100,1080,24,33,1,6,30,1,37,0,0,0,6,27,3,1,0,0,0
7328,130,2020,15,15,0,1.0,100,1080,7,8,0,2,8,0,10,0,0,1,1,8,0,0,0,0,0
7329,131,2020,52,52,0,1.0,100,1080,27,22,3,10,19,2,31,1,3,4,2,16,3,1,1,0,0
7330,132,2020,28,22,6,0.8,80,1080,6,12,4,2,10,1,13,0,1,0,1,8,2,0,0,0,1
7331,133,2020,57,42,15,0.75,74,1080,25,14,3,25,11,1,37,25,0,0,0,8,3,0,0,1,0
7332,134,2020,26,25,1,0.95,95,1080,17,7,1,14,5,1,20,13,0,0,1,3,2,1,0,0,0
7333,135,2020,42,42,0,1.0,100,1080,17,24,1,16,19,1,36,15,1,0,0,14,5,1,0,0,0
7334,136,2020,9,9,0,0.99,98,1080,3,5,1,1,5,1,7,0,0,1,0,5,0,1,0,0,0
7335,137,2020,23,12,11,0.54,53,1080,9,2,1,6,1,1,8,5,0,0,1,0,1,1,0,0,0
7336,138,2020,19,19,0,1.0,100,1080,8,9,2,2,9,2,13,0,0,0,2,9,0,2,0,0,0
7337,139,2020,42,42,0,1.0,100,1080,25,16,1,24,9,1,34,23,1,0,0,2,7,1,0,0,0
7338,140,2020,29,24,5,0.84,84,1080,18,6,0,9,4,0,13,2,6,0,1,2,2,0,0,0,0
7339,141,2020,12,12,0,1.0,100,1080,8,3,1,7,3,1,11,6,1,0,0,3,0,1,0,0,0
7340,142,2020,7,7,0,1.0,99,1080,2,3,2,1,2,2,5,0,1,0,0,1,1,2,0,0,0
7341,143,2020,7,7,0,0.99,98,1080,3,4,0,3,4,0,7,3,0,0,0,4,0,0,0,0,0
7342,144,2020,6,6,0,0.95,94,1080,3,2,1,1,2,1,4,0,0,1,0,2,0,1,0,0,0
7343,145,2020,15,15,0,1.0,100,1080,10,4,1,3,4,1,8,0,1,0,2,4,0,1,0,0,0
7344,146,2020,29,24,5,0.82,82,1080,10,13,1,7,12,1,20,4,3,0,0,11,1,1,0,0,0
7345,147,2020,22,8,14,0.38,38,1080,3,4,1,3,4,1,8,3,0,0,0,4,0,1,0,0,0
7346,148,2020,19,19,0,0.99,98,1080,8,9,2,5,6,1,12,4,0,0,1,3,3,0,1,0,0
7347,149,2020,32,32,0,1.0,100,1080,15,17,0,14,14,0,28,13,1,0,0,11,3,0,0,0,0
7348,150,2020,33,33,0,1.0,100,1080,12,20,1,11,17,1,29,10,1,0,0,14,3,1,0,0,0
7349,151,2020,16,15,1,0.94,93,1080,4,8,3,1,7,1,9,0,0,0,1,6,1,0,0,1,0
7350,152,2020,6,3,3,0.43,42,1080,2,1,0,2,1,0,3,2,0,0,0,1,0,0,0,0,0
7351,153,2020,31,31,0,1.0,100,1080,16,14,1,16,8,1,25,16,0,0,0,2,6,1,0,0,0
7352,154,2020,32,17,15,0.52,51,1080,6,8,3,6,6,3,15,6,0,0,0,4,2,3,0,0,0
7353,155,2020,27,27,0,1.0,100,1080,13,11,3,4,11,2,17,0,1,1,2,11,0,1,1,0,0
7354,156,2020,30,27,3,0.9,90,1080,14,13,0,9,9,0,18,7,0,1,1,5,4,0,0,0,0
7355,157,2020,22,22,0,1.0,100,1080,9,11,2,3,10,1,14,0,1,1,1,9,1,0,1,0,0
7356,158,2020,26,26,0,1.0,99,1080,18,7,1,7,7,1,15,2,0,4,1,7,0,1,0,0,0
7357,159,2020,7,7,0,1.0,100,1080,5,2,0,5,2,0,7,5,0,0,0,2,0,0,0,0,0
7358,160,2020,21,21,0,1.0,100,1080,13,7,1,8,6,1,15,4,3,1,0,5,1,1,0,0,0
7359,161,2020,34,8,26,0.23,23,1080,4,3,1,1,2,1,4,0,0,0,1,1,1,1,0,0,0
7360,162,2020,31,25,6,0.81,80,1080,14,8,3,8,5,2,15,4,3,0,1,2,3,1,1,0,0
7361,163,2020,54,51,3,0.95,95,1080,29,18,4,23,9,3,35,19,2,2,0,0,9,2,1,0,0
7362,164,2020,5,5,0,1.0,100,1080,2,2,1,1,1,1,3,0,1,0,0,0,1,1,0,0,0
7363,165,2020,15,15,0,1.0,100,1080,7,5,3,7,5,1,13,7,0,0,0,5,0,0,0,1,0
7364,166,2020,30,30,0,1.0,100,1080,18,8,4,10,6,1,17,5,2,3,0,4,2,0,0,0,1
7365,167,2020,15,0,15,0.01,1,1080,0,0,0,0,0,0,0,0,0,0,0,0,0,0,0,0,0
7366,168,2020,48,48,0,1.0,100,1080,20,25,3,14,25,2,41,12,0,0,2,25,0,1,1,0,0
7367,169,2020,45,34,11,0.77,76,1080,16,15,3,13,12,1,26,11,1,1,0,9,3,0,0,1,0
7368,170,2020,26,26,0,1.0,100,1080,12,12,2,9,10,1,20,6,3,0,0,8,2,0,1,0,0
7369,171,2020,13,9,4,0.67,67,1080,5,3,1,5,2,1,8,5,0,0,0,1,1,1,0,0,0
7370,172,2020,40,4,36,0.1,9,1080,2,2,0,2,1,0,3,2,0,0,0,0,1,0,0,0,0
7371,173,2020,39,39,0,0.99,98,1080,29,7,3,24,5,1,30,20,3,1,0,3,2,0,0,1,0
7372,174,2020,38,37,1,0.97,96,1080,27,7,3,9,5,3,17,0,4,1,4,3,2,3,0,0,0
7373,175,2020,39,38,1,0.98,98,1080,20,18,0,15,17,0,32,10,5,0,0,16,1,0,0,0,0
7374,176,2020,14,14,0,1.0,100,1080,4,7,3,4,6,3,13,4,0,0,0,5,1,3,0,0,0
7375,177,2020,17,17,0,1.0,100,1080,7,8,2,2,6,2,10,0,0,1,1,4,2,2,0,0,0
7376,178,2020,14,14,0,1.0,100,1080,5,7,2,2,4,1,7,1,0,0,1,1,3,0,1,0,0
7377,179,2020,30,16,14,0.53,53,1080,6,7,3,3,7,3,13,1,1,1,0,7,0,3,0,0,0
7378,180,2020,51,35,16,0.69,68,1080,17,15,3,6,13,1,20,0,3,1,2,11,2,0,0,1,0
7379,181,2020,26,26,0,1.0,100,1080,16,6,4,16,3,3,22,16,0,0,0,0,3,2,1,0,0
7380,182,2020,33,33,0,1.0,100,1080,24,8,1,22,4,1,27,20,2,0,0,0,4,1,0,0,0
7381,183,2020,32,18,14,0.58,57,1080,7,8,3,6,7,1,14,5,1,0,0,6,1,0,0,1,0
7382,184,2020,40,40,0,1.0,100,1080,15,22,3,9,14,1,24,6,1,1,1,6,8,0,0,1,0
7383,185,2020,7,7,0,1.0,99,1080,2,3,2,2,3,2,7,2,0,0,0,3,0,2,0,0,0
7384,186,2020,14,14,0,1.0,100,1080,6,6,2,6,3,1,10,6,0,0,0,0,3,0,1,0,0
7385,187,2020,22,22,0,1.0,100,1080,9,11,2,4,11,2,17,0,3,1,0,11,0,2,0,0,0
7386,188,2020,19,19,0,1.0,100,1080,8,8,3,7,6,3,16,6,1,0,0,4,2,3,0,0,0
7387,189,2020,16,16,0,1.0,100,1080,7,5,4,3,5,1,9,1,0,2,0,5,0,0,0,0,1
7388,190,2020,33,33,0,1.0,100,1080,19,11,3,5,7,2,14,0,0,1,4,3,4,1,1,0,0
7389,191,2020,13,13,0,1.0,100,1080,6,6,1,5,3,1,9,4,1,0,0,0,3,1,0,0,0
7390,192,2020,7,7,0,0.99,98,1080,4,2,1,4,2,1,7,4,0,0,0,2,0,1,0,0,0
7391,193,2020,39,39,0,0.99,99,1080,20,16,3,11,8,1,20,6,3,0,2,0,8,0,0,1,0
7392,194,2020,40,40,0,1.0,100,1080,16,22,2,16,20,1,37,16,0,0,0,18,2,0,1,0,0
7393,195,2020,34,31,3,0.91,91,1080,18,11,2,11,10,1,22,6,4,0,1,9,1,0,1,0,0
7394,196,2020,19,19,0,1.0,100,1080,10,8,1,6,5,1,12,3,2,1,0,2,3,1,0,0,0
7395,197,2020,8,7,1,0.87,87,1080,3,3,1,3,3,1,7,3,0,0,0,3,0,1,0,0,0
7396,198,2020,30,18,12,0.6,59,1080,10,8,0,6,5,0,11,4,1,0,1,2,3,0,0,0,0
7397,199,2020,6,6,0,0.98,98,1080,3,3,0,1,2,0,3,0,0,1,0,1,1,0,0,0,0
7398,200,2020,54,53,1,0.98,97,1080,36,15,2,27,9,2,38,22,1,4,0,3,6,2,0,0,0
7399,201,2020,46,46,0,0.99,98,1080,23,22,1,17,19,1,37,13,3,0,1,16,3,1,0,0,0
7400,202,2020,35,6,29,0.16,16,1080,3,2,1,2,1,1,4,1,1,0,0,0,1,1,0,0,0
7401,203,2020,25,10,15,0.41,40,1080,4,4,2,3,3,2,8,2,1,0,0,2,1,2,0,0,0
7402,204,2020,38,38,0,1.0,100,1080,18,18,2,6,10,2,18,2,0,0,4,2,8,2,0,0,0
7403,205,2020,27,27,0,1.0,100,1080,17,8,2,16,5,1,22,15,1,0,0,2,3,0,1,0,0
7404,206,2020,31,31,0,1.0,100,1080,14,17,0,5,16,0,21,2,0,0,3,15,1,0,0,0,0
7405,207,2020,6,6,0,1.0,100,1080,4,2,0,1,2,0,3,0,0,0,1,2,0,0,0,0,0
7406,208,2020,36,36,0,1.0,100,1080,18,16,2,7,14,1,22,1,1,5,0,12,2,0,1,0,0
7407,209,2020,32,0,32,0.0,0,1080,0,0,0,0,0,0,0,0,0,0,0,0,0,0,0,0,0
7408,210,2020,34,30,4,0.87,87,1080,19,10,1,7,6,1,14,1,3,0,3,2,4,1,0,0,0
7409,211,2020,31,31,0,1.0,100,1080,13,14,4,12,9,1,22,11,1,0,0,4,5,0,0,0,1
7410,212,2020,35,35,0,1.0,100,1080,19,14,2,10,7,1,18,6,1,1,2,0,7,0,1,0,0
7411,213,2020,10,1,9,0.13,12,1080,0,1,0,0,1,0,1,0,0,0,0,1,0,0,0,0,0
7412,214,2020,18,18,0,1.0,100,1080,10,5,3,5,5,2,12,2,1,2,0,5,0,1,1,0,0
7413,215,2020,5,5,0,1.0,100,1080,2,2,1,2,1,1,4,2,0,0,0,0,1,1,0,0,0
7414,216,2020,26,26,0,1.0,100,1080,11,14,1,7,14,1,22,5,0,2,0,14,0,1,0,0,0
7415,217,2020,36,36,0,1.0,100,1080,16,20,0,16,19,0,35,16,0,0,0,18,1,0,0,0,0
7416,218,2020,39,39,0,1.0,100,1080,18,17,4,16,13,1,30,15,0,1,0,9,4,0,0,0,1
7417,219,2020,48,48,0,1.0,100,1080,19,27,2,19,18,2,39,19,0,0,0,9,9,2,0,0,0
7418,220,2020,44,35,9,0.8,80,1080,16,15,4,7,11,1,19,1,3,3,0,7,4,0,0,0,1
7419,221,2020,37,37,0,1.0,100,1080,25,9,3,9,5,2,16,0,2,7,0,1,4,1,1,0,0
7420,222,2020,15,9,6,0.58,58,1080,4,4,1,3,3,1,7,2,1,0,0,2,1,1,0,0,0
7421,223,2020,50,50,0,1.0,100,1080,23,27,0,20,21,0,41,17,3,0,0,15,6,0,0,0,0
7422,224,2020,21,21,0,1.0,100,1080,12,6,3,9,6,1,16,7,1,1,0,6,0,0,0,1,0
7423,225,2020,16,16,0,1.0,100,1080,8,6,2,3,5,2,10,0,2,0,1,4,1,2,0,0,0
7424,226,2020,7,7,0,1.0,99,1080,3,3,1,3,3,1,7,3,0,0,0,3,0,1,0,0,0
7425,227,2020,17,17,0,1.0,100,1080,6,7,4,2,4,4,10,0,0,2,0,1,3,4,0,0,0
7426,228,2020,11,11,0,0.98,97,1080,6,4,1,5,2,1,8,4,1,0,0,0,2,1,0,0,0
7427,229,2020,14,14,0,1.0,100,1080,5,7,2,3,7,2,12,2,0,1,0,7,0,2,0,0,0
7428,230,2020,22,22,0,0.98,97,1080,14,5,3,7,4,2,13,2,4,0,1,3,1,1,1,0,0
7429,231,2020,17,15,2,0.91,90,1080,4,7,4,2,7,4,13,1,0,1,0,7,0,4,0,0,0
7430,232,2020,30,29,1,0.97,96,1080,17,10,2,16,5,2,23,15,1,0,0,0,5,2,0,0,0
7431,233,2020,16,15,1,0.96,95,1080,10,3,2,4,2,2,8,2,0,0,2,1,1,2,0,0,0
7432,234,2020,24,4,20,0.17,16,1080,1,2,1,1,1,1,3,1,0,0,0,0,1,1,0,0,0
7433,235,2020,22,22,0,1.0,100,1080,11,11,0,4,10,0,14,0,1,3,0,9,1,0,0,0,0
7434,236,2020,14,14,0,1.0,99,1080,6,5,3,4,3,2,9,2,2,0,0,1,2,1,1,0,0
7435,237,2020,42,6,36,0.13,13,1080,3,2,1,3,1,1,5,3,0,0,0,0,1,1,0,0,0
7436,238,2020,17,17,0,0.98,97,1080,9,6,2,7,6,2,15,6,0,1,0,6,0,2,0,0,0
7437,239,2020,12,2,10,0.16,16,1080,1,1,0,1,1,0,2,1,0,0,0,1,0,0,0,0,0
7438,240,2020,28,28,0,1.0,100,1080,8,16,4,8,14,3,25,8,0,0,0,12,2,2,1,0,0
7439,241,2020,18,18,0,1.0,100,1080,13,4,1,7,2,1,10,3,3,0,1,0,2,1,0,0,0
7440,242,2020,55,55,0,1.0,100,1080,27,25,3,20,22,1,43,16,1,3,0,19,3,0,0,1,0
7441,243,2020,22,22,0,0.99,98,1080,16,4,2,6,3,2,11,0,4,0,2,2,1,2,0,0,0
7442,244,2020,53,53,0,1.0,99,1080,18,32,3,10,23,1,34,7,0,1,2,14,9,0,0,1,0
7443,245,2020,46,46,0,1.0,100,1080,22,21,3,14,17,3,34,9,3,1,1,13,4,3,0,0,0
7444,246,2020,30,30,0,1.0,100,1080,21,9,0,19,7,0,26,17,2,0,0,5,2,0,0,0,0
7445,247,2020,39,35,4,0.91,90,1080,22,10,3,15,6,3,24,11,2,1,1,2,4,3,0,0,0
7446,248,2020,15,15,0,1.0,100,1080,7,8,0,6,6,0,12,5,1,0,0,4,2,0,0,0,0
7447,249,2020,13,13,0,1.0,100,1080,8,5,0,2,4,0,6,0,0,0,2,3,1,0,0,0,0
7448,250,2020,46,46,0,1.0,100,1080,31,12,3,8,8,1,17,0,0,1,7,4,4,0,0,1,0
7449,251,2020,51,50,1,0.98,97,1080,31,18,1,10,17,1,28,1,0,6,3,16,1,1,0,0,0
7450,252,2020,11,10,1,0.88,88,1080,3,5,2,2,4,1,7,1,1,0,0,3,1,0,1,0,0
7451,253,2020,57,57,0,1.0,100,1080,30,27,0,28,23,0,51,26,2,0,0,19,4,0,0,0,0
7452,254,2020,30,30,0,1.0,100,1080,19,11,0,19,8,0,27,19,0,0,0,5,3,0,0,0,0
7453,255,2020,35,35,0,1.0,100,1080,19,14,2,6,14,1,21,0,1,3,2,14,0,0,1,0,0
7454,256,2020,34,11,23,0.33,33,1080,5,4,2,2,4,1,7,0,1,1,0,4,0,0,1,0,0
7455,257,2020,15,15,0,1.0,100,1080,7,6,2,5,3,2,10,4,0,1,0,0,3,2,0,0,0
7456,258,2020,37,36,1,0.98,98,1080,11,21,4,8,16,4,28,6,1,1,0,11,5,4,0,0,0
7457,259,2020,14,2,12,0.17,16,1080,1,1,0,1,1,0,2,1,0,0,0,1,0,0,0,0,0
7458,260,2020,56,53,3,0.95,94,1080,23,27,3,21,22,3,46,19,2,0,0,17,5,3,0,0,0
7459,261,2020,7,7,0,1.0,99,1080,5,2,0,3,1,0,4,2,0,1,0,0,1,0,0,0,0
7460,262,2020,30,23,7,0.76,75,1080,11,9,3,6,9,1,16,2,3,1,0,9,0,0,0,1,0
7461,263,2020,29,29,0,1.0,100,1080,12,14,3,3,8,3,14,0,0,0,3,2,6,3,0,0,0
7462,264,2020,25,25,0,1.0,100,1080,14,9,2,4,9,1,14,0,0,2,2,9,0,0,1,0,0
7463,265,2020,23,23,0,1.0,100,1080,12,9,2,7,8,1,16,2,5,0,0,7,1,0,1,0,0
7464,266,2020,25,24,1,0.96,96,1080,15,7,2,6,6,2,14,3,0,0,3,5,1,2,0,0,0
7465,267,2020,12,12,0,0.99,99,1080,3,6,3,2,4,2,8,1,1,0,0,2,2,1,1,0,0
7466,268,2020,19,19,0,1.0,100,1080,10,9,0,4,9,0,13,1,1,1,1,9,0,0,0,0,0
7467,269,2020,32,1,31,0.03,2,1080,0,1,0,0,1,0,1,0,0,0,0,1,0,0,0,0,0
7468,270,2020,35,35,0,1.0,99,1080,19,13,3,6,13,1,20,0,2,1,3,13,0,0,0,1,0
7469,271,2020,30,30,0,1.0,100,1080,19,8,3,17,4,2,23,15,2,0,0,0,4,1,1,0,0
7470,272,2020,46,46,0,1.0,100,1080,26,17,3,19,15,1,35,13,5,1,0,13,2,0,0,1,0
7471,273,2020,14,14,0,1.0,100,1080,5,6,3,3,5,1,9,1,2,0,0,4,1,0,0,1,0
7472,274,2020,19,19,0,1.0,100,1080,10,8,1,8,8,1,17,7,0,1,0,8,0,1,0,0,0
7473,275,2020,11,8,3,0.72,72,1080,5,2,1,2,2,1,5,0,1,1,0,2,0,1,0,0,0
7474,276,2020,31,31,0,1.0,99,1080,20,9,2,5,6,2,13,0,0,0,5,3,3,2,0,0,0
7475,277,2020,28,28,0,1.0,100,1080,19,8,1,5,8,1,14,0,0,1,4,8,0,1,0,0,0
7476,278,2020,31,30,1,0.98,98,1080,13,13,4,9,7,3,19,5,4,0,0,1,6,2,1,0,0
7477,279,2020,21,18,3,0.88,87,1080,9,7,2,7,6,1,14,6,0,1,0,5,1,0,1,0,0
7478,280,2020,15,15,0,1.0,100,1080,7,7,1,3,5,1,9,1,1,0,1,3,2,1,0,0,0
7479,281,2020,39,39,0,1.0,100,1080,22,17,0,22,13,0,35,22,0,0,0,9,4,0,0,0,0
7480,282,2020,49,49,0,1.0,99,1080,23,25,1,20,19,1,40,19,0,0,1,13,6,1,0,0,0
7481,283,2020,20,3,17,0.15,15,1080,2,1,0,1,1,0,2,0,1,0,0,1,0,0,0,0,0
7482,284,2020,11,2,9,0.17,17,1080,1,1,0,1,1,0,2,1,0,0,0,1,0,0,0,0,0
7483,285,2020,48,48,0,1.0,100,1080,22,22,4,16,20,2,38,11,4,1,0,18,2,0,2,0,0
7484,286,2020,28,9,19,0.33,33,1080,4,3,2,4,2,2,8,4,0,0,0,1,1,2,0,0,0
7485,287,2020,15,15,0,0.98,97,1080,4,7,4,2,5,4,11,0,2,0,0,3,2,4,0,0,0
7486,288,2020,37,37,0,1.0,99,1080,21,15,1,16,8,1,25,13,1,2,0,1,7,1,0,0,0
7487,289,2020,20,19,1,0.97,96,1080,11,5,3,10,4,2,16,9,1,0,0,3,1,1,1,0,0
7488,290,2020,22,22,0,1.0,100,1080,8,12,2,3,12,2,17,0,1,2,0,12,0,2,0,0,0
7489,291,2020,39,39,0,1.0,100,1080,14,23,2,9,20,2,31,6,1,2,0,17,3,2,0,0,0
7490,292,2020,15,15,0,1.0,100,1080,10,4,1,9,2,1,12,8,1,0,0,0,2,1,0,0,0
7491,293,2020,20,20,0,1.0,100,1080,15,3,2,4,2,1,7,0,0,1,3,1,1,0,1,0,0
7492,294,2020,22,22,0,1.0,99,1080,5,13,4,3,7,1,11,2,0,1,0,1,6,0,0,0,1
7493,295,2020,49,25,24,0.52,52,1080,9,13,3,6,10,1,17,3,3,0,0,7,3,0,0,1,0
7494,296,2020,18,1,17,0.04,3,1080,0,1,0,0,1,0,1,0,0,0,0,1,0,0,0,0,0
7495,297,2020,35,35,0,1.0,99,1080,20,14,1,20,9,1,30,20,0,0,0,4,5,1,0,0,0
7496,298,2020,44,43,1,0.98,97,1080,19,23,1,19,16,1,36,19,0,0,0,9,7,1,0,0,0
7497,299,2020,33,33,0,1.0,100,1080,17,13,3,14,11,2,27,13,0,0,1,9,2,1,1,0,0
7498,300,2020,25,25,0,0.99,98,1080,16,7,2,11,5,2,18,8,2,0,1,3,2,2,0,0,0
7499,301,2020,30,30,0,1.0,100,1080,22,5,3,21,5,1,27,20,1,0,0,5,0,0,0,1,0
7500,302,2020,29,29,0,1.0,99,1080,13,16,0,11,13,0,24,10,0,1,0,10,3,0,0,0,0
7501,303,2020,56,56,0,1.0,100,1080,21,33,2,15,18,2,35,10,4,1,0,3,15,2,0,0,0
7502,304,2020,47,34,13,0.71,71,1080,18,13,3,11,12,1,24,5,5,1,0,11,1,0,0,1,0
7503,305,2020,18,18,0,1.0,99,1080,11,6,1,7,5,1,13,3,4,0,0,4,1,1,0,0,0
7504,306,2020,49,49,0,1.0,100,1080,35,11,3,24,6,2,32,17,4,2,1,1,5,1,1,0,0
7505,307,2020,35,35,0,1.0,100,1080,21,11,3,20,6,2,28,19,1,0,0,1,5,1,1,0,0
7506,308,2020,13,13,0,1.0,100,1080,3,7,3,3,5,1,9,3,0,0,0,3,2,0,0,1,0
7507,309,2020,10,10,0,1.0,99,1080,4,5,1,2,5,1,8,1,0,1,0,5,0,1,0,0,0
7508,310,2020,37,0,37,0.0,0,1080,0,0,0,0,0,0,0,0,0,0,0,0,0,0,0,0,0
7509,311,2020,30,30,0,1.0,100,1080,16,11,3,10,10,1,21,6,3,0,1,9,1,0,0,1,0
7510,312,2020,11,11,0,0.99,99,1080,7,4,0,6,3,0,9,5,1,0,0,2,1,0,0,0,0
7511,313,2020,60,60,0,1.0,100,1080,35,22,3,19,15,2,36,11,1,6,1,8,7,1,1,0,0
7512,314,2020,9,9,0,1.0,100,1080,3,5,1,2,4,1,7,1,1,0,0,3,1,1,0,0,0
7513,315,2020,54,54,0,1.0,100,1080,23,27,4,10,14,4,28,5,0,2,3,1,13,4,0,0,0
7514,316,2020,15,15,0,1.0,100,1080,5,8,2,4,6,1,11,3,1,0,0,4,2,0,1,0,0
7515,317,2020,41,41,0,1.0,100,1080,30,8,3,28,5,2,35,26,2,0,0,2,3,1,1,0,0
7516,318,2020,26,26,0,1.0,100,1080,17,5,4,8,3,3,14,3,1,4,0,1,2,2,1,0,0
7517,319,2020,7,7,0,1.0,100,1080,4,3,0,2,3,0,5,0,2,0,0,3,0,0,0,0,0
7518,320,2020,28,28,0,1.0,99,1080,12,13,3,12,7,3,22,12,0,0,0,1,6,3,0,0,0
7519,321,2020,5,5,0,1.0,100,1080,2,3,0,1,3,0,4,0,1,0,0,3,0,0,0,0,0
7520,322,2020,14,14,0,1.0,99,1080,5,6,3,2,6,3,11,1,0,0,1,6,0,3,0,0,0
7521,323,2020,57,54,3,0.95,94,1080,25,25,4,18,23,4,45,11,7,0,0,21,2,4,0,0,0
7522,324,2020,26,25,1,0.97,96,1080,14,7,4,11,4,3,18,9,1,1,0,1,3,2,1,0,0
7523,325,2020,25,25,0,1.0,100,1080,9,12,4,3,12,1,16,1,0,0,2,12,0,0,0,0,1
7524,326,2020,27,27,0,0.99,99,1080,19,6,2,10,6,2,18,7,0,0,3,6,0,2,0,0,0
7525,327,2020,52,52,0,1.0,100,1080,35,14,3,24,13,1,38,18,1,5,0,12,1,0,0,1,0
7526,328,2020,9,9,0,0.97,96,1080,3,4,2,2,2,2,6,1,1,0,0,0,2,2,0,0,0
7527,329,2020,25,25,0,1.0,100,1080,17,5,3,12,3,3,18,9,2,0,1,1,2,3,0,0,0
7528,330,2020,30,30,0,1.0,99,1080,11,16,3,11,14,1,26,11,0,0,0,12,2,0,0,1,0
7529,331,2020,59,59,0,1.0,100,1080,42,17,0,39,13,0,52,37,1,1,0,9,4,0,0,0,0
7530,332,2020,43,18,25,0.42,42,1080,5,9,4,4,5,3,12,3,1,0,0,1,4,2,1,0,0
7531,333,2020,27,15,12,0.54,54,1080,5,9,1,4,7,1,12,3,1,0,0,5,2,1,0,0,0
7532,334,2020,24,24,0,0.98,97,1080,11,11,2,6,8,2,16,4,0,1,1,5,3,2,0,0,0
7533,335,2020,58,58,0,1.0,100,1080,24,33,1,19,17,1,37,17,0,1,1,1,16,1,0,0,0
7534,336,2020,40,40,0,1.0,100,1080,28,9,3,17,7,1,25,12,2,0,3,5,2,0,0,1,0
7535,337,2020,31,31,0,0.99,98,1080,11,16,4,8,15,4,27,5,3,0,0,14,1,4,0,0,0
7536,338,2020,15,15,0,1.0,100,1080,9,6,0,6,4,0,10,3,3,0,0,2,2,0,0,0,0
7537,339,2020,23,23,0,1.0,100,1080,8,13,2,7,7,2,16,6,1,0,0,1,6,2,0,0,0
7538,340,2020,38,38,0,1.0,100,1080,20,15,3,16,8,1,25,14,0,2,0,1,7,0,0,1,0
7539,341,2020,27,27,0,1.0,100,1080,12,12,3,7,7,2,16,3,3,1,0,2,5,1,1,0,0
7540,342,2020,8,8,0,0.99,98,1080,4,3,1,2,3,1,6,1,0,1,0,3,0,1,0,0,0
7541,343,2020,50,50,0,1.0,99,1080,35,11,4,18,7,4,29,4,11,3,0,3,4,4,0,0,0
7542,344,2020,23,23,0,1.0,100,1080,11,11,1,7,6,1,14,5,0,2,0,1,5,1,0,0,0
7543,345,2020,40,40,0,1.0,100,1080,22,14,4,11,14,4,29,5,2,3,1,14,0,4,0,0,0
7544,346,2020,48,48,0,1.0,100,1080,34,14,0,9,9,0,18,0,0,2,7,4,5,0,0,0,0
7545,347,2020,21,21,0,1.0,100,1080,10,10,1,8,9,1,18,6,2,0,0,8,1,1,0,0,0
7546,348,2020,38,38,0,0.99,99,1080,18,19,1,15,16,1,32,12,3,0,0,13,3,1,0,0,0
7547,349,2020,24,24,0,1.0,100,1080,15,7,2,14,4,1,19,13,1,0,0,1,3,0,1,0,0
7548,350,2020,39,39,0,1.0,100,1080,20,17,2,5,10,2,17,0,0,0,5,3,7,2,0,0,0
7549,351,2020,29,19,10,0.66,66,1080,7,9,3,7,9,3,19,7,0,0,0,9,0,3,0,0,0
7550,352,2020,36,36,0,1.0,100,1080,16,18,2,11,9,1,21,9,0,1,1,0,9,0,1,0,0
7551,353,2020,39,39,0,1.0,100,1080,14,21,4,9,12,4,25,7,0,1,1,3,9,4,0,0,0
7552,354,2020,15,12,3,0.81,81,1080,7,3,2,7,2,2,11,7,0,0,0,1,1,2,0,0,0
7553,355,2020,22,22,0,1.0,100,1080,16,5,1,14,3,1,18,12,2,0,0,1,2,1,0,0,0
7554,356,2020,31,31,0,1.0,100,1080,16,14,1,9,10,1,20,6,1,0,2,6,4,1,0,0,0
7555,357,2020,26,24,2,0.94,94,1080,17,4,3,8,4,1,13,4,1,1,2,4,0,0,0,1,0
7556,358,2020,49,1,48,0.01,1,1080,0,1,0,0,1,0,1,0,0,0,0,1,0,0,0,0,0
7557,359,2020,36,36,0,1.0,99,1080,12,21,3,5,21,1,27,0,3,2,0,21,0,0,0,1,0
7558,360,2020,37,35,2,0.94,93,1080,14,20,1,7,11,1,19,2,3,2,0,2,9,1,0,0,0
7559,361,2020,27,16,11,0.61,60,1080,8,6,2,6,4,1,11,5,0,1,0,2,2,0,1,0,0
7560,362,2020,18,16,2,0.9,89,1080,11,5,0,11,3,0,14,11,0,0,0,1,2,0,0,0,0
7561,363,2020,34,34,0,1.0,100,1080,21,13,0,13,10,0,23,6,6,1,0,7,3,0,0,0,0
7562,364,2020,35,35,0,1.0,99,1080,25,6,4,19,4,4,27,16,1,1,1,2,2,4,0,0,0
7563,365,2020,25,25,0,1.0,100,1080,15,8,2,4,4,2,10,0,0,1,3,0,4,2,0,0,0
7564,366,2020,9,8,1,0.92,92,1080,2,5,1,2,5,1,8,2,0,0,0,5,0,1,0,0,0
7565,367,2020,12,12,0,1.0,100,1080,7,5,0,2,3,0,5,0,0,1,1,1,2,0,0,0,0
7566,368,2020,58,38,20,0.65,65,1080,20,17,1,14,17,1,32,9,4,1,0,17,0,1,0,0,0
7567,369,2020,51,51,0,1.0,100,1080,38,10,3,19,6,1,26,0,19,0,0,2,4,0,0,1,0
7568,370,2020,28,5,23,0.16,16,1080,2,2,1,1,2,1,4,0,1,0,0,2,0,1,0,0,0
7569,371,2020,15,15,0,1.0,100,1080,5,9,1,5,8,1,14,5,0,0,0,7,1,1,0,0,0
7570,372,2020,6,1,5,0.15,15,1080,0,1,0,0,1,0,1,0,0,0,0,1,0,0,0,0,0
7571,373,2020,16,16,0,0.99,98,1080,7,5,4,3,5,2,10,1,1,0,1,5,0,0,2,0,0
7572,374,2020,16,16,0,1.0,100,1080,8,6,2,3,5,2,10,1,0,1,1,4,1,2,0,0,0
7573,375,2020,33,7,26,0.2,20,1080,2,4,1,2,4,1,7,2,0,0,0,4,0,1,0,0,0
7574,376,2020,36,26,10,0.73,73,1080,11,14,1,8,8,1,17,7,0,0,1,2,6,1,0,0,0
7575,377,2020,9,9,0,1.0,100,1080,5,3,1,3,2,1,6,1,2,0,0,1,1,1,0,0,0
7576,378,2020,14,14,0,1.0,100,1080,5,8,1,2,6,1,9,1,0,0,1,4,2,1,0,0,0
7577,379,2020,43,43,0,1.0,100,1080,23,20,0,14,17,0,31,5,9,0,0,14,3,0,0,0,0
7578,380,2020,42,41,1,0.98,98,1080,24,15,2,9,15,1,25,1,2,5,1,15,0,0,1,0,0
7579,381,2020,31,31,0,1.0,100,1080,19,10,2,5,10,2,17,0,0,1,4,10,0,2,0,0,0
7580,382,2020,40,40,0,1.0,99,1080,30,9,1,9,9,1,19,1,1,1,6,9,0,1,0,0,0
7581,383,2020,20,20,0,0.99,98,1080,12,7,1,11,7,1,19,10,1,0,0,7,0,1,0,0,0
7582,384,2020,42,42,0,0.99,99,1080,17,24,1,17,23,1,41,17,0,0,0,22,1,1,0,0,0
7583,385,2020,18,18,0,1.0,100,1080,10,5,3,8,5,2,15,7,0,1,0,5,0,1,1,0,0
7584,386,2020,56,50,6,0.89,88,1080,22,25,3,6,21,2,29,0,0,2,4,17,4,1,1,0,0
7585,387,2020,58,57,1,0.99,98,1080,30,24,3,21,20,2,43,13,7,1,0,16,4,1,1,0,0
7586,388,2020,32,31,1,0.96,95,1080,22,6,3,6,3,1,10,0,1,0,5,0,3,0,0,1,0
7587,389,2020,50,42,8,0.85,84,1080,24,15,3,15,14,2,31,8,6,0,1,13,1,1,1,0,0
7588,390,2020,34,22,12,0.66,65,1080,14,8,0,12,8,0,20,10,2,0,0,8,0,0,0,0,0
7589,391,2020,39,39,0,1.0,100,1080,27,8,4,14,4,4,22,7,1,6,0,0,4,4,0,0,0
7590,392,2020,15,15,0,0.98,97,1080,6,6,3,2,6,1,9,0,0,2,0,6,0,0,0,1,0
7591,393,2020,9,9,0,0.99,98,1080,6,3,0,6,2,0,8,6,0,0,0,1,1,0,0,0,0
7592,394,2020,31,5,26,0.17,16,1080,1,3,1,1,3,1,5,1,0,0,0,3,0,1,0,0,0
7593,395,2020,11,11,0,1.0,100,1080,6,3,2,3,3,2,8,0,3,0,0,3,0,2,0,0,0
7594,396,2020,31,31,0,1.0,100,1080,12,16,3,7,11,1,19,5,0,1,1,6,5,0,0,1,0
7595,397,2020,53,52,1,0.99,99,1080,23,26,3,13,18,3,34,5,6,2,0,10,8,3,0,0,0
7596,398,2020,15,15,0,1.0,100,1080,6,8,1,5,7,1,13,4,1,0,0,6,1,1,0,0,0
7597,399,2020,36,36,0,1.0,100,1080,17,18,1,6,10,1,17,0,1,5,0,2,8,1,0,0,0
7598,400,2020,25,25,0,1.0,99,1080,13,9,3,5,5,3,13,2,0,1,2,1,4,3,0,0,0
7599,401,2020,22,22,0,1.0,100,1080,8,12,2,6,7,1,14,5,0,1,0,2,5,0,1,0,0
7600,402,2020,57,57,0,1.0,100,1080,31,26,0,9,18,0,27,1,0,2,6,10,8,0,0,0,0
7601,403,2020,28,28,0,1.0,100,1080,18,8,2,8,8,1,17,0,7,0,1,8,0,0,1,0,0
7602,404,2020,9,9,0,1.0,100,1080,2,5,2,2,5,2,9,2,0,0,0,5,0,2,0,0,0
7603,405,2020,57,57,0,1.0,99,1080,30,24,3,15,13,1,29,8,1,4,2,2,11,0,0,1,0
7604,406,2020,39,39,0,1.0,100,1080,22,13,4,7,7,1,15,0,1,4,2,1,6,0,0,0,1
7605,407,2020,9,9,0,0.96,95,1080,2,5,2,2,3,2,7,2,0,0,0,1,2,2,0,0,0
7606,408,2020,39,39,0,1.0,100,1080,23,12,4,13,9,2,24,8,0,5,0,6,3,0,2,0,0
7607,409,2020,16,16,0,1.0,100,1080,4,8,4,1,4,1,6,0,0,0,1,0,4,0,0,0,1
7608,410,2020,52,52,0,1.0,100,1080,26,22,4,19,21,1,41,15,1,3,0,20,1,0,0,0,1
7609,411,2020,52,52,0,1.0,100,1080,32,18,2,19,12,1,32,8,9,2,0,6,6,0,1,0,0
7610,412,2020,55,55,0,1.0,100,1080,34,19,2,14,17,1,32,2,4,8,0,15,2,0,1,0,0
7611,413,2020,9,9,0,1.0,100,1080,5,3,1,3,2,1,6,2,0,1,0,1,1,1,0,0,0
7612,414,2020,9,9,0,1.0,100,1080,4,3,2,3,2,1,6,2,1,0,0,1,1,0,1,0,0
7613,415,2020,8,8,0,0.99,98,1080,5,2,1,2,1,1,4,0,1,1,0,0,1,1,0,0,0
7614,416,2020,26,0,26,0.01,1,1080,0,0,0,0,0,0,0,0,0,0,0,0,0,0,0,0,0
7615,417,2020,48,48,0,1.0,99,1080,19,27,2,5,16,2,23,0,0,1,4,5,11,2,0,0,0
7616,418,2020,28,10,18,0.34,34,1080,5,3,2,4,2,2,8,3,1,0,0,1,1,2,0,0,0
7617,419,2020,20,20,0,0.99,98,1080,12,6,2,8,5,1,14,5,2,1,0,4,1,0,1,0,0
7618,420,2020,14,14,0,1.0,100,1080,9,3,2,9,2,2,13,9,0,0,0,1,1,2,0,0,0
7619,421,2020,16,16,0,0.99,98,1080,10,4,2,7,2,2,11,5,1,1,0,0,2,2,0,0,0
7620,422,2020,15,15,0,1.0,99,1080,5,7,3,3,7,2,12,1,2,0,0,7,0,1,1,0,0
7621,423,2020,13,13,0,1.0,100,1080,6,7,0,4,6,0,10,2,2,0,0,5,1,0,0,0,0
7622,424,2020,27,21,6,0.76,75,1080,12,6,3,6,5,2,13,2,3,0,1,4,1,1,1,0,0
7623,425,2020,20,12,8,0.61,60,1080,5,5,2,2,5,1,8,1,0,0,1,5,0,0,1,0,0
7624,426,2020,44,44,0,0.99,98,1080,19,23,2,11,14,2,27,3,8,0,0,5,9,2,0,0,0
7625,427,2020,19,19,0,1.0,100,1080,12,5,2,7,3,1,11,4,2,0,1,1,2,0,1,0,0
7626,428,2020,33,7,26,0.23,22,1080,2,3,2,1,2,2,5,0,1,0,0,1,1,2,0,0,0
7627,429,2020,8,6,2,0.78,78,1080,1,4,1,1,4,1,6,1,0,0,0,4,0,1,0,0,0
7628,430,2020,11,11,0,1.0,99,1080,4,4,3,3,4,1,8,2,1,0,0,4,0,0,0,1,0
7629,431,2020,55,53,2,0.97,96,1080,38,13,2,19,11,2,32,6,10,0,3,9,2,2,0,0,0
7630,432,2020,36,36,0,1.0,100,1080,17,16,3,6,10,2,18,0,3,1,2,4,6,1,1,0,0
7631,433,2020,19,19,0,0.98,97,1080,12,5,2,11,5,1,17,10,1,0,0,5,0,0,1,0,0
7632,434,2020,14,14,0,1.0,100,1080,5,7,2,4,4,1,9,3,1,0,0,1,3,0,1,0,0
7633,435,2020,17,17,0,1.0,100,1080,5,9,3,4,8,3,15,3,1,0,0,7,1,3,0,0,0
7634,436,2020,40,40,0,1.0,100,1080,30,9,1,14,7,1,22,8,1,0,5,5,2,1,0,0,0
7635,437,2020,11,11,0,1.0,100,1080,2,7,2,2,5,1,8,2,0,0,0,3,2,0,1,0,0
7636,438,2020,9,9,0,1.0,100,1080,6,3,0,6,3,0,9,6,0,0,0,3,0,0,0,0,0
7637,439,2020,30,9,21,0.29,28,1080,4,4,1,2,2,1,5,0,2,0,0,0,2,1,0,0,0
7638,440,2020,31,31,0,1.0,100,1080,18,12,1,11,9,1,21,6,3,2,0,6,3,1,0,0,0
7639,441,2020,6,0,6,0.01,1,1080,0,0,0,0,0,0,0,0,0,0,0,0,0,0,0,0,0
7640,442,2020,36,36,0,1.0,99,1080,20,13,3,11,13,1,25,4,5,2,0,13,0,0,0,1,0
7641,443,2020,52,51,1,0.98,98,1080,34,13,4,12,10,3,25,0,7,0,5,7,3,2,1,0,0
7642,444,2020,40,40,0,0.99,98,1080,22,15,3,19,14,3,36,16,3,0,0,13,1,3,0,0,0
7643,445,2020,6,6,0,1.0,100,1080,4,2,0,3,1,0,4,2,1,0,0,0,1,0,0,0,0
7644,446,2020,40,19,21,0.47,46,1080,6,11,2,2,8,1,11,0,0,2,0,5,3,0,1,0,0
7645,447,2020,28,27,1,0.97,97,1080,16,10,1,9,5,1,15,4,4,0,1,0,5,1,0,0,0
7646,448,2020,31,27,4,0.88,88,1080,13,13,1,13,12,1,26,13,0,0,0,11,1,1,0,0,0
7647,449,2020,22,22,0,1.0,100,1080,8,11,3,6,8,3,17,4,2,0,0,5,3,3,0,0,0
7648,450,2020,11,11,0,1.0,100,1080,7,3,1,3,3,1,7,1,0,2,0,3,0,1,0,0,0
7649,451,2020,20,20,0,0.98,98,1080,7,11,2,4,8,1,13,1,3,0,0,5,3,0,1,0,0
7650,452,2020,39,11,28,0.28,28,1080,5,5,1,2,5,1,8,1,0,0,1,5,0,1,0,0,0
7651,453,2020,37,37,0,1.0,100,1080,18,17,2,17,12,1,30,16,1,0,0,7,5,0,1,0,0
7652,454,2020,55,55,0,1.0,100,1080,21,32,2,7,19,1,27,1,2,0,4,6,13,0,1,0,0
7653,455,2020,20,19,1,0.97,96,1080,12,6,1,6,3,1,10,0,6,0,0,0,3,1,0,0,0
7654,456,2020,31,31,0,1.0,100,1080,11,18,2,10,10,2,22,9,1,0,0,2,8,2,0,0,0
7655,457,2020,19,19,0,1.0,100,1080,11,7,1,3,4,1,8,0,0,1,2,1,3,1,0,0,0
7656,458,2020,37,37,0,1.0,100,1080,20,17,0,9,13,0,22,3,2,3,1,9,4,0,0,0,0
7657,459,2020,40,40,0,1.0,100,1080,22,15,3,15,15,3,33,12,1,0,2,15,0,3,0,0,0
7658,460,2020,44,44,0,1.0,99,1080,29,13,2,20,8,2,30,15,1,4,0,3,5,2,0,0,0
7659,461,2020,5,5,0,1.0,100,1080,2,2,1,1,2,1,4,0,1,0,0,2,0,1,0,0,0
7660,462,2020,25,25,0,1.0,100,1080,12,12,1,11,10,1,22,10,1,0,0,8,2,1,0,0,0
7661,463,2020,13,13,0,1.0,100,1080,8,4,1,8,3,1,12,8,0,0,0,2,1,1,0,0,0
7662,464,2020,26,26,0,1.0,100,1080,12,10,4,8,9,1,18,5,2,1,0,8,1,0,0,0,1
7663,465,2020,24,21,3,0.88,88,1080,11,7,3,4,4,1,9,1,0,2,1,1,3,0,0,1,0
7664,466,2020,11,0,11,0.0,0,1080,0,0,0,0,0,0,0,0,0,0,0,0,0,0,0,0,0
7665,467,2020,11,11,0,1.0,99,1080,3,5,3,3,3,2,8,3,0,0,0,1,2,1,1,0,0
7666,468,2020,7,2,5,0.33,33,1080,1,1,0,1,1,0,2,1,0,0,0,1,0,0,0,0,0
7667,469,2020,34,34,0,1.0,100,1080,20,14,0,18,10,0,28,16,2,0,0,6,4,0,0,0,0
7668,470,2020,33,33,0,0.99,98,1080,24,9,0,22,8,0,30,21,0,1,0,7,1,0,0,0,0
7669,471,2020,36,34,2,0.94,94,1080,23,10,1,12,5,1,18,7,2,0,3,0,5,1,0,0,0
7670,472,2020,31,31,0,1.0,100,1080,12,16,3,7,14,2,23,2,5,0,0,12,2,1,1,0,0
7671,473,2020,48,47,1,0.99,98,1080,18,26,3,6,13,3,22,0,0,6,0,0,13,3,0,0,0
7672,474,2020,21,21,0,1.0,100,1080,15,4,2,11,4,1,16,8,2,1,0,4,0,0,1,0,0
7673,475,2020,19,6,13,0.29,29,1080,3,2,1,2,2,1,5,1,1,0,0,2,0,1,0,0,0
7674,476,2020,20,8,12,0.41,40,1080,2,4,2,2,3,1,6,2,0,0,0,2,1,0,1,0,0
7675,477,2020,21,0,21,0.01,1,1080,0,0,0,0,0,0,0,0,0,0,0,0,0,0,0,0,0
7676,478,2020,30,30,0,0.99,98,1080,14,16,0,11,15,0,26,9,1,1,0,14,1,0,0,0,0
7677,479,2020,7,7,0,1.0,100,1080,3,3,1,2,3,1,6,1,1,0,0,3,0,1,0,0,0
7678,480,2020,45,45,0,1.0,100,1080,16,26,3,14,15,1,30,13,0,1,0,4,11,0,0,1,0
7679,481,2020,51,51,0,1.0,100,1080,29,19,3,27,17,2,46,25,2,0,0,15,2,1,1,0,0
7680,482,2020,10,7,3,0.72,71,1080,4,2,1,4,2,1,7,4,0,0,0,2,0,1,0,0,0
7681,483,2020,30,30,0,1.0,100,1080,16,12,2,6,11,2,19,2,1,0,3,10,1,2,0,0,0
7682,484,2020,9,9,0,1.0,99,1080,4,3,2,1,3,2,6,0,0,0,1,3,0,2,0,0,0
7683,485,2020,24,22,2,0.92,91,1080,14,6,2,8,4,1,13,3,4,1,0,2,2,0,1,0,0
7684,486,2020,22,4,18,0.18,17,1080,1,2,1,1,1,1,3,1,0,0,0,0,1,1,0,0,0
7685,487,2020,31,31,0,1.0,100,1080,13,17,1,5,9,1,15,1,1,2,1,1,8,1,0,0,0
7686,488,2020,8,8,0,1.0,100,1080,3,4,1,2,2,1,5,1,1,0,0,0,2,1,0,0,0
7687,489,2020,25,24,1,0.98,97,1080,15,6,3,4,5,2,11,0,0,1,3,4,1,1,1,0,0
7688,490,2020,33,25,8,0.77,76,1080,18,4,3,10,2,3,15,2,8,0,0,0,2,3,0,0,0
7689,491,2020,5,1,4,0.19,18,1080,0,1,0,0,1,0,1,0,0,0,0,1,0,0,0,0,0
7690,492,2020,7,7,0,1.0,100,1080,2,3,2,1,3,2,6,0,1,0,0,3,0,2,0,0,0
7691,493,2020,10,10,0,1.0,100,1080,4,5,1,1,5,1,7,0,0,0,1,5,0,1,0,0,0
7692,494,2020,9,8,1,0.94,94,1080,4,4,0,4,2,0,6,4,0,0,0,0,2,0,0,0,0
7693,495,2020,13,13,0,0.98,97,1080,5,8,0,4,8,0,12,3,1,0,0,8,0,0,0,0,0
7694,496,2020,50,50,0,1.0,100,1080,31,16,3,15,15,1,31,8,0,5,2,14,1,0,0,1,0
7695,497,2020,31,31,0,1.0,99,1080,20,10,1,15,9,1,25,12,2,0,1,8,1,1,0,0,0
7696,498,2020,27,27,0,1.0,100,1080,15,10,2,11,6,2,19,9,0,2,0,2,4,2,0,0,0
7697,499,2020,49,49,0,1.0,100,1080,34,11,4,30,6,3,39,27,2,1,0,1,5,2,1,0,0
7698,500,2020,40,34,6,0.85,84,1080,20,12,2,15,11,1,27,11,3,1,0,10,1,0,1,0,0
7699,501,2020,8,8,0,1.0,100,1080,3,3,2,2,3,1,6,1,1,0,0,3,0,0,1,0,0
7700,502,2020,7,7,0,0.95,94,1080,4,3,0,2,2,0,4,1,0,1,0,1,1,0,0,0,0
7701,503,2020,13,13,0,1.0,100,1080,6,6,1,5,4,1,10,4,1,0,0,2,2,1,0,0,0
7702,504,2020,35,35,0,1.0,100,1080,17,17,1,6,11,1,18,0,2,3,1,5,6,1,0,0,0
7703,505,2020,46,46,0,1.0,100,1080,25,20,1,10,13,1,24,3,3,0,4,6,7,1,0,0,0
7704,506,2020,45,42,3,0.93,92,1080,15,23,4,12,15,2,29,9,3,0,0,7,8,0,2,0,0
7705,507,2020,55,55,0,1.0,99,1080,33,21,1,12,17,1,30,0,3,9,0,13,4,1,0,0,0
7706,508,2020,11,11,0,1.0,99,1080,6,3,2,4,2,1,7,3,0,1,0,1,1,0,1,0,0
7707,509,2020,14,14,0,1.0,100,1080,8,5,1,2,3,1,6,0,0,0,2,1,2,1,0,0,0
7708,510,2020,16,16,0,1.0,100,1080,6,9,1,2,9,1,12,0,1,0,1,9,0,1,0,0,0
7709,511,2020,11,6,5,0.54,54,1080,3,3,0,2,3,0,5,1,1,0,0,3,0,0,0,0,0
7710,512,2020,32,30,2,0.94,93,1080,15,14,1,4,10,1,15,0,0,1,3,6,4,1,0,0,0
7711,513,2020,8,2,6,0.23,22,1080,1,1,0,1,1,0,2,1,0,0,0,1,0,0,0,0,0
7712,514,2020,42,42,0,0.99,98,1080,26,12,4,19,7,1,27,15,2,1,1,2,5,0,0,0,1
7713,515,2020,26,26,0,1.0,100,1080,8,14,4,2,11,4,17,0,0,0,2,8,3,4,0,0,0
7714,516,2020,29,28,1,0.96,95,1080,19,6,3,13,6,3,22,10,0,3,0,6,0,3,0,0,0
7715,517,2020,17,17,0,1.0,100,1080,7,8,2,4,8,1,13,2,1,1,0,8,0,0,1,0,0
7716,518,2020,39,39,0,1.0,100,1080,28,9,2,19,7,1,27,13,3,3,0,5,2,0,1,0,0
7717,519,2020,27,26,1,0.97,96,1080,18,5,3,16,5,1,22,15,0,1,0,5,0,0,0,1,0
7718,520,2020,51,40,11,0.79,78,1080,22,15,3,22,12,2,36,22,0,0,0,9,3,1,1,0,0
7719,521,2020,36,36,0,1.0,100,1080,22,12,2,13,9,1,23,6,6,0,1,6,3,0,1,0,0
7720,522,2020,19,13,6,0.7,70,1080,6,7,0,5,5,0,10,4,1,0,0,3,2,0,0,0,0
7721,523,2020,22,22,0,1.0,100,1080,16,6,0,16,4,0,20,16,0,0,0,2,2,0,0,0,0
7722,524,2020,32,32,0,1.0,100,1080,17,13,2,6,9,1,16,1,0,4,1,5,4,0,1,0,0
7723,525,2020,54,54,0,1.0,100,1080,21,31,2,16,21,2,39,11,5,0,0,11,10,2,0,0,0
7724,526,2020,25,25,0,1.0,100,1080,18,7,0,6,5,0,11,1,0,3,2,3,2,0,0,0,0
7725,527,2020,56,56,0,1.0,100,1080,35,20,1,13,20,1,34,1,5,4,3,20,0,1,0,0,0
7726,528,2020,17,14,3,0.85,84,1080,7,7,0,3,4,0,7,1,1,0,1,1,3,0,0,0,0
7727,529,2020,6,2,4,0.29,28,1080,1,1,0,1,1,0,2,1,0,0,0,1,0,0,0,0,0
7728,530,2020,38,37,1,0.98,97,1080,19,16,2,9,13,2,24,4,1,3,1,10,3,2,0,0,0
7729,531,2020,15,10,5,0.66,66,1080,4,4,2,2,3,2,7,1,0,1,0,2,1,2,0,0,0
7730,532,2020,18,18,0,0.99,98,1080,8,8,2,8,4,1,13,8,0,0,0,0,4,0,1,0,0
7731,533,2020,42,41,1,0.97,97,1080,25,13,3,17,11,1,29,11,5,0,1,9,2,0,0,1,0
7732,534,2020,42,42,0,0.99,98,1080,29,12,1,12,9,1,22,3,5,0,4,6,3,1,0,0,0
7733,535,2020,9,0,9,0.01,1,1080,0,0,0,0,0,0,0,0,0,0,0,0,0,0,0,0,0
7734,536,2020,31,30,1,0.96,95,1080,19,11,0,5,8,0,13,0,0,1,4,5,3,0,0,0,0
7735,537,2020,32,23,9,0.71,70,1080,11,11,1,6,8,1,15,2,3,1,0,5,3,1,0,0,0
7736,538,2020,12,12,0,1.0,100,1080,8,3,1,6,3,1,10,4,2,0,0,3,0,1,0,0,0
7737,539,2020,8,8,0,1.0,100,1080,3,4,1,2,2,1,5,1,1,0,0,0,2,1,0,0,0
7738,540,2020,24,10,14,0.4,40,1080,3,6,1,1,5,1,7,0,0,1,0,4,1,1,0,0,0
7739,541,2020,39,28,11,0.72,71,1080,16,9,3,13,8,3,24,11,1,1,0,7,1,3,0,0,0
7740,542,2020,51,51,0,1.0,100,1080,34,14,3,18,11,2,31,6,8,4,0,8,3,1,1,0,0
7741,543,2020,22,18,4,0.8,80,1080,8,6,4,2,6,2,10,0,0,0,2,6,0,1,0,1,0
7742,544,2020,13,1,12,0.09,9,1080,0,1,0,0,1,0,1,0,0,0,0,1,0,0,0,0,0
7743,545,2020,32,32,0,1.0,100,1080,16,14,2,4,10,2,16,0,0,0,4,6,4,2,0,0,0
7744,546,2020,54,52,2,0.97,96,1080,34,18,0,32,15,0,47,30,2,0,0,12,3,0,0,0,0
7745,547,2020,52,52,0,1.0,100,1080,26,24,2,20,21,2,43,16,2,2,0,18,3,2,0,0,0
7746,548,2020,40,40,0,0.99,99,1080,20,18,2,11,14,1,26,5,4,1,1,10,4,0,1,0,0
7747,549,2020,23,23,0,1.0,100,1080,7,12,4,6,10,4,20,5,1,0,0,8,2,4,0,0,0
7748,550,2020,22,22,0,1.0,100,1080,7,12,3,5,11,3,19,4,0,1,0,10,1,3,0,0,0
7749,551,2020,11,11,0,1.0,100,1080,6,4,1,2,4,1,7,0,0,2,0,4,0,1,0,0,0
7750,552,2020,39,13,26,0.34,34,1080,5,7,1,5,6,1,12,5,0,0,0,5,1,1,0,0,0
7751,553,2020,46,11,35,0.23,23,1080,7,3,1,3,3,1,7,0,2,1,0,3,0,1,0,0,0
7752,554,2020,40,40,0,1.0,100,1080,21,15,4,12,15,1,28,5,5,2,0,15,0,0,0,0,1
7753,555,2020,16,16,0,1.0,100,1080,6,8,2,4,8,1,13,3,0,1,0,8,0,0,1,0,0
7754,556,2020,10,10,0,1.0,100,1080,7,2,1,3,2,1,6,1,0,2,0,2,0,1,0,0,0
7755,557,2020,56,56,0,1.0,100,1080,24,29,3,6,17,3,26,0,0,0,6,5,12,3,0,0,0
7756,558,2020,38,38,0,1.0,100,1080,14,22,2,5,14,1,20,0,1,4,0,6,8,0,1,0,0
7757,559,2020,45,45,0,1.0,100,1080,25,17,3,12,17,2,31,5,2,4,1,17,0,1,1,0,0
7758,560,2020,37,37,0,1.0,100,1080,11,22,4,10,13,1,24,9,1,0,0,4,9,0,0,0,1
7759,561,2020,16,16,0,1.0,100,1080,6,6,4,3,3,4,10,2,0,0,1,0,3,4,0,0,0
7760,562,2020,27,25,2,0.92,91,1080,16,9,0,7,7,0,14,0,6,0,1,5,2,0,0,0,0
7761,563,2020,36,35,1,0.98,97,1080,17,18,0,12,16,0,28,8,3,1,0,14,2,0,0,0,0
7762,564,2020,60,60,0,1.0,99,1080,34,23,3,32,17,1,50,30,2,0,0,11,6,0,0,1,0
7763,565,2020,9,9,0,0.96,95,1080,5,4,0,2,4,0,6,0,1,1,0,4,0,0,0,0,0
7764,566,2020,16,16,0,1.0,99,1080,7,6,3,3,5,3,11,1,0,2,0,4,1,3,0,0,0
7765,567,2020,32,3,29,0.09,8,1080,2,1,0,2,1,0,3,2,0,0,0,1,0,0,0,0,0
7766,568,2020,12,12,0,1.0,100,1080,3,6,3,1,4,1,6,0,0,1,0,2,2,0,0,1,0
7767,569,2020,41,41,0,1.0,100,1080,23,16,2,22,9,2,33,21,1,0,0,2,7,2,0,0,0
7768,570,2020,47,47,0,1.0,100,1080,29,15,3,23,15,2,40,17,6,0,0,15,0,1,1,0,0
7769,571,2020,6,1,5,0.11,10,1080,0,1,0,0,1,0,1,0,0,0,0,1,0,0,0,0,0
7770,572,2020,11,11,0,1.0,99,1080,6,4,1,6,4,1,11,6,0,0,0,4,0,1,0,0,0
7771,573,2020,35,35,0,1.0,100,1080,13,19,3,4,16,3,23,0,0,3,1,13,3,3,0,0,0
7772,574,2020,27,27,0,1.0,100,1080,10,16,1,10,13,1,24,10,0,0,0,10,3,1,0,0,0
7773,575,2020,26,26,0,1.0,100,1080,10,13,3,4,11,2,17,0,3,0,1,9,2,1,1,0,0
7774,576,2020,42,42,0,1.0,100,1080,31,8,3,8,7,3,18,0,0,1,7,6,1,3,0,0,0
7775,577,2020,12,4,8,0.35,35,1080,1,2,1,1,2,1,4,1,0,0,0,2,0,1,0,0,0
7776,578,2020,13,1,12,0.07,6,1080,0,1,0,0,1,0,1,0,0,0,0,1,0,0,0,0,0
7777,579,2020,34,34,0,1.0,100,1080,21,11,2,19,9,2,30,17,2,0,0,7,2,2,0,0,0
7778,580,2020,19,19,0,1.0,99,1080,10,9,0,9,8,0,17,8,1,0,0,7,1,0,0,0,0
7779,581,2020,9,9,0,1.0,100,1080,5,3,1,5,3,1,9,5,0,0,0,3,0,1,0,0,0
7780,582,2020,33,33,0,1.0,100,1080,24,7,2,16,5,2,23,9,6,1,0,3,2,2,0,0,0
7781,583,2020,10,10,0,1.0,99,1080,5,3,2,3,2,1,6,2,0,1,0,1,1,0,1,0,0
7782,584,2020,38,38,0,1.0,100,1080,16,21,1,4,21,1,26,0,0,0,4,21,0,1,0,0,0
7783,585,2020,14,11,3,0.77,76,1080,7,4,0,2,4,0,6,0,0,1,1,4,0,0,0,0,0
7784,586,2020,34,25,9,0.75,74,1080,11,11,3,11,7,3,21,11,0,0,0,3,4,3,0,0,0
7785,587,2020,17,17,0,1.0,100,1080,6,8,3,5,5,3,13,4,1,0,0,2,3,3,0,0,0
7786,588,2020,27,27,0,1.0,100,1080,11,15,1,9,11,1,21,8,0,1,0,7,4,1,0,0,0
7787,589,2020,43,43,0,1.0,100,1080,20,20,3,19,11,1,31,18,1,0,0,2,9,0,0,1,0
7788,590,2020,24,23,1,0.97,97,1080,13,8,2,7,6,1,14,4,0,3,0,4,2,0,1,0,0
7789,591,2020,15,15,0,1.0,100,1080,6,6,3,6,4,1,11,6,0,0,0,2,2,0,0,1,0
7790,592,2020,5,5,0,1.0,100,1080,1,3,1,1,2,1,4,1,0,0,0,1,1,1,0,0,0
7791,593,2020,8,8,0,1.0,100,1080,4,4,0,3,4,0,7,2,1,0,0,4,0,0,0,0,0
7792,594,2020,55,55,0,1.0,100,1080,30,21,4,24,18,1,43,21,0,3,0,15,3,0,0,0,1
7793,595,2020,20,19,1,0.97,96,1080,9,8,2,3,5,2,10,0,0,3,0,2,3,2,0,0,0
7794,596,2020,12,12,0,1.0,100,1080,4,5,3,4,4,3,11,4,0,0,0,3,1,3,0,0,0
7795,597,2020,29,4,25,0.13,12,1080,1,2,1,1,1,1,3,1,0,0,0,0,1,1,0,0,0
7796,598,2020,12,12,0,1.0,99,1080,4,5,3,1,3,1,5,0,0,0,1,1,2,0,0,1,0
7797,599,2020,17,16,1,0.97,96,1080,6,9,1,5,8,1,14,4,1,0,0,7,1,1,0,0,0
7798,600,2020,16,16,0,0.98,98,1080,5,9,2,5,5,2,12,5,0,0,0,1,4,2,0,0,0
7799,601,2020,28,28,0,0.99,98,1080,16,11,1,10,9,1,20,8,0,0,2,7,2,1,0,0,0
7800,602,2020,8,8,0,1.0,100,1080,5,2,1,3,1,1,5,2,0,1,0,0,1,1,0,0,0
7801,603,2020,59,59,0,1.0,100,1080,23,35,1,13,32,1,46,5,6,2,0,29,3,1,0,0,0
7802,604,2020,44,44,0,0.99,98,1080,26,15,3,21,10,2,33,19,0,1,1,5,5,1,1,0,0
7803,605,2020,48,32,16,0.66,66,1080,19,10,3,16,6,2,24,15,0,0,1,2,4,1,1,0,0
7804,606,2020,35,35,0,1.0,99,1080,21,14,0,7,13,0,20,0,0,7,0,12,1,0,0,0,0
7805,607,2020,40,37,3,0.92,91,1080,19,16,2,15,13,2,30,13,1,0,1,10,3,2,0,0,0
7806,608,2020,6,6,0,0.92,92,1080,4,2,0,1,2,0,3,0,0,0,1,2,0,0,0,0,0
7807,609,2020,15,15,0,1.0,99,1080,5,8,2,5,4,1,10,5,0,0,0,0,4,0,1,0,0
7808,610,2020,9,3,6,0.33,32,1080,2,1,0,2,1,0,3,2,0,0,0,1,0,0,0,0,0
7809,611,2020,48,30,18,0.63,62,1080,21,7,2,21,7,2,30,21,0,0,0,7,0,2,0,0,0
7810,612,2020,12,12,0,1.0,100,1080,8,4,0,6,2,0,8,5,0,1,0,0,2,0,0,0,0
7811,613,2020,12,12,0,1.0,100,1080,8,3,1,8,3,1,12,8,0,0,0,3,0,1,0,0,0
7812,614,2020,6,6,0,1.0,100,1080,3,2,1,2,2,1,5,1,1,0,0,2,0,1,0,0,0
7813,615,2020,27,27,0,1.0,100,1080,19,7,1,12,5,1,18,6,5,1,0,3,2,1,0,0,0
7814,616,2020,30,13,17,0.43,42,1080,4,7,2,4,5,2,11,4,0,0,0,3,2,2,0,0,0
7815,617,2020,14,14,0,1.0,100,1080,6,8,0,2,5,0,7,0,0,2,0,2,3,0,0,0,0
7816,618,2020,6,6,0,1.0,100,1080,3,2,1,1,2,1,4,0,0,1,0,2,0,1,0,0,0
7817,619,2020,17,2,15,0.13,13,1080,1,1,0,1,1,0,2,1,0,0,0,1,0,0,0,0,0
7818,620,2020,18,18,0,1.0,100,1080,8,8,2,4,6,1,11,1,2,1,0,4,2,0,1,0,0
7819,621,2020,9,9,0,1.0,100,1080,6,2,1,4,2,1,7,3,0,1,0,2,0,1,0,0,0
7820,622,2020,32,5,27,0.15,14,1080,4,1,0,1,1,0,2,0,0,0,1,1,0,0,0,0,0
7821,623,2020,52,52,0,1.0,99,1080,25,26,1,21,17,1,39,19,1,0,1,8,9,1,0,0,0
7822,624,2020,20,20,0,0.99,98,1080,7,11,2,2,10,1,13,0,0,1,1,9,1,0,1,0,0
7823,625,2020,33,33,0,1.0,100,1080,20,13,0,13,7,0,20,10,0,2,1,1,6,0,0,0,0
7824,626,2020,13,13,0,1.0,100,1080,9,3,1,6,3,1,10,5,0,0,1,3,0,1,0,0,0
7825,627,2020,17,17,0,1.0,100,1080,12,4,1,7,2,1,10,5,0,1,1,0,2,1,0,0,0
7826,628,2020,13,13,0,1.0,100,1080,6,4,3,6,2,3,11,6,0,0,0,0,2,3,0,0,0
7827,629,2020,33,33,0,1.0,100,1080,22,11,0,20,10,0,30,19,0,1,0,9,1,0,0,0,0
7828,630,2020,15,15,0,1.0,99,1080,4,8,3,4,7,1,12,4,0,0,0,6,1,0,0,1,0
7829,631,2020,58,58,0,1.0,99,1080,24,32,2,10,21,1,32,2,4,2,2,10,11,0,1,0,0
7830,632,2020,9,9,0,1.0,100,1080,6,2,1,4,2,1,7,2,2,0,0,2,0,1,0,0,0
7831,633,2020,9,9,0,1.0,100,1080,4,3,2,1,3,1,5,0,0,0,1,3,0,0,1,0,0
7832,634,2020,6,6,0,1.0,100,1080,2,3,1,2,2,1,5,2,0,0,0,1,1,1,0,0,0
7833,635,2020,24,24,0,1.0,100,1080,12,11,1,9,8,1,18,8,0,0,1,5,3,1,0,0,0
7834,636,2020,15,7,8,0.49,48,1080,2,4,1,2,4,1,7,2,0,0,0,4,0,1,0,0,0
7835,637,2020,23,23,0,1.0,100,1080,13,7,3,8,6,2,16,3,5,0,0,5,1,1,1,0,0
7836,638,2020,29,29,0,1.0,100,1080,11,14,4,8,7,3,18,6,1,1,0,0,7,2,1,0,0
7837,639,2020,7,5,2,0.77,76,1080,2,2,1,2,1,1,4,2,0,0,0,0,1,1,0,0,0
7838,640,2020,13,13,0,1.0,99,1080,6,4,3,3,2,3,8,1,1,1,0,0,2,3,0,0,0
7839,641,2020,6,6,0,1.0,99,1080,3,2,1,3,1,1,5,3,0,0,0,0,1,1,0,0,0
7840,642,2020,28,28,0,1.0,100,1080,18,10,0,13,5,0,18,8,5,0,0,0,5,0,0,0,0
7841,643,2020,56,56,0,1.0,100,1080,34,21,1,13,17,1,31,4,2,2,5,13,4,1,0,0,0
7842,644,2020,11,11,0,1.0,100,1080,8,2,1,3,2,1,6,1,0,1,1,2,0,1,0,0,0
7843,645,2020,23,23,0,1.0,100,1080,13,10,0,13,10,0,23,13,0,0,0,10,0,0,0,0,0
7844,646,2020,58,7,51,0.12,11,1080,3,4,0,2,3,0,5,1,1,0,0,2,1,0,0,0,0
7845,647,2020,32,30,2,0.94,94,1080,19,7,4,16,6,4,26,13,3,0,0,5,1,4,0,0,0
7846,648,2020,34,34,0,1.0,100,1080,23,9,2,14,5,1,20,5,9,0,0,1,4,0,1,0,0
7847,649,2020,27,27,0,1.0,100,1080,16,9,2,14,7,1,22,13,0,1,0,5,2,0,1,0,0
7848,650,2020,37,37,0,1.0,100,1080,23,11,3,18,9,1,28,15,2,0,1,7,2,0,0,1,0
7849,651,2020,26,24,2,0.91,90,1080,11,13,0,9,10,0,19,8,0,1,0,7,3,0,0,0,0
7850,652,2020,40,40,0,1.0,100,1080,20,16,4,11,10,4,25,8,0,0,3,4,6,4,0,0,0
7851,653,2020,14,14,0,1.0,100,1080,6,5,3,4,4,1,9,3,0,1,0,3,1,0,0,1,0
7852,654,2020,40,36,4,0.91,90,1080,19,17,0,14,13,0,27,9,5,0,0,9,4,0,0,0,0
7853,655,2020,50,50,0,1.0,100,1080,23,26,1,22,24,1,47,21,1,0,0,22,2,1,0,0,0
7854,656,2020,47,47,0,1.0,100,1080,23,21,3,11,12,2,25,3,5,2,1,3,9,1,1,0,0
7855,657,2020,32,32,0,1.0,100,1080,14,18,0,10,12,0,22,7,2,1,0,6,6,0,0,0,0
7856,658,2020,12,7,5,0.59,59,1080,2,3,2,2,3,1,6,2,0,0,0,3,0,0,1,0,0
7857,659,2020,38,38,0,1.0,100,1080,22,14,2,22,11,2,35,22,0,0,0,8,3,2,0,0,0
7858,660,2020,21,19,2,0.91,90,1080,13,4,2,4,4,2,10,0,0,3,1,4,0,2,0,0,0
7859,661,2020,37,36,1,0.99,98,1080,19,14,3,15,12,1,28,13,1,0,1,10,2,0,0,1,0
7860,662,2020,29,29,0,1.0,100,1080,18,9,2,5,9,1,15,0,0,2,3,9,0,0,1,0,0
7861,663,2020,39,28,11,0.72,72,1080,14,10,4,13,8,2,23,12,1,0,0,6,2,0,2,0,0
7862,664,2020,45,4,41,0.1,9,1080,2,2,0,2,2,0,4,2,0,0,0,2,0,0,0,0,0
7863,665,2020,28,28,0,1.0,100,1080,11,13,4,8,11,2,21,6,1,1,0,9,2,1,0,1,0
7864,666,2020,24,13,11,0.54,54,1080,5,7,1,3,5,1,9,1,2,0,0,3,2,1,0,0,0
7865,667,2020,30,29,1,0.98,97,1080,18,7,4,8,6,2,16,3,0,5,0,5,1,0,2,0,0
7866,668,2020,38,38,0,1.0,99,1080,17,18,3,13,11,3,27,9,4,0,0,4,7,3,0,0,0
7867,669,2020,42,33,9,0.78,77,1080,17,15,1,10,14,1,25,5,4,0,1,13,1,1,0,0,0
7868,670,2020,14,14,0,1.0,100,1080,4,8,2,4,4,1,9,4,0,0,0,0,4,0,1,0,0
7869,671,2020,47,47,0,1.0,100,1080,30,17,0,18,15,0,33,13,1,1,3,13,2,0,0,0,0
7870,672,2020,41,41,0,1.0,99,1080,15,22,4,5,21,4,30,0,0,5,0,20,1,4,0,0,0
7871,673,2020,14,13,1,0.94,93,1080,5,6,2,2,5,2,9,0,1,1,0,4,1,2,0,0,0
7872,674,2020,24,24,0,1.0,100,1080,16,7,1,9,6,1,16,6,1,0,2,5,1,1,0,0,0
7873,675,2020,9,9,0,1.0,100,1080,3,5,1,2,3,1,6,1,1,0,0,1,2,1,0,0,0
7874,676,2020,19,19,0,1.0,100,1080,14,5,0,14,5,0,19,14,0,0,0,5,0,0,0,0,0
7875,677,2020,11,11,0,1.0,100,1080,7,4,0,2,2,0,4,0,0,1,1,0,2,0,0,0,0
7876,678,2020,26,26,0,1.0,100,1080,8,14,4,5,8,4,17,2,3,0,0,2,6,4,0,0,0
7877,679,2020,22,22,0,1.0,100,1080,13,9,0,8,8,0,16,5,2,0,1,7,1,0,0,0,0
7878,680,2020,25,3,22,0.1,10,1080,1,2,0,1,2,0,3,1,0,0,0,2,0,0,0,0,0
7879,681,2020,40,40,0,1.0,100,1080,28,9,3,12,5,2,19,6,0,2,4,1,4,1,1,0,0
7880,682,2020,38,38,0,1.0,100,1080,20,18,0,8,14,0,22,0,5,2,1,10,4,0,0,0,0
7881,683,2020,5,5,0,1.0,100,1080,2,2,1,1,2,1,4,0,1,0,0,2,0,1,0,0,0
7882,684,2020,27,27,0,1.0,99,1080,19,5,3,18,4,1,23,17,1,0,0,3,1,0,0,1,0
7883,685,2020,14,14,0,1.0,100,1080,8,5,1,7,5,1,13,6,1,0,0,5,0,1,0,0,0
7884,686,2020,26,26,0,1.0,100,1080,19,6,1,10,6,1,17,4,4,1,1,6,0,1,0,0,0
7885,687,2020,20,20,0,1.0,100,1080,9,11,0,5,8,0,13,3,1,0,1,5,3,0,0,0,0
7886,688,2020,13,7,6,0.57,56,1080,2,3,2,1,2,1,4,0,1,0,0,1,1,0,1,0,0
7887,689,2020,46,46,0,1.0,100,1080,18,27,1,5,14,1,20,0,0,2,3,1,13,1,0,0,0
7888,690,2020,46,46,0,1.0,100,1080,28,17,1,16,14,1,31,10,0,6,0,11,3,1,0,0,0
7889,691,2020,31,10,21,0.31,31,1080,3,4,3,3,3,2,8,3,0,0,0,2,1,1,1,0,0
7890,692,2020,28,27,1,0.98,97,1080,16,7,4,5,4,3,12,0,2,0,3,1,3,2,1,0,0
7891,693,2020,15,15,0,1.0,100,1080,10,4,1,4,4,1,9,1,1,1,1,4,0,1,0,0,0
7892,694,2020,55,55,0,1.0,99,1080,25,26,4,25,16,2,43,25,0,0,0,6,10,0,2,0,0
7893,695,2020,36,31,5,0.85,84,1080,18,10,3,11,5,3,19,4,7,0,0,0,5,3,0,0,0
7894,696,2020,27,6,21,0.22,22,1080,3,2,1,1,2,1,4,0,0,1,0,2,0,1,0,0,0
7895,697,2020,31,31,0,0.99,99,1080,15,14,2,8,10,1,19,5,1,0,2,6,4,0,1,0,0
7896,698,2020,44,44,0,1.0,100,1080,19,23,2,18,23,2,43,17,1,0,0,23,0,2,0,0,0
7897,699,2020,34,34,0,1.0,100,1080,25,8,1,23,7,1,31,22,0,1,0,6,1,1,0,0,0
7898,700,2020,40,40,0,1.0,99,1080,26,11,3,19,6,3,28,14,3,2,0,1,5,3,0,0,0
7899,701,2020,31,31,0,1.0,100,1080,17,11,3,10,9,2,21,6,2,1,1,7,2,1,1,0,0
7900,702,2020,44,44,0,1.0,100,1080,21,21,2,15,17,2,34,13,0,0,2,13,4,2,0,0,0
7901,703,2020,34,34,0,1.0,100,1080,13,18,3,10,18,2,30,7,3,0,0,18,0,1,1,0,0
7902,704,2020,32,25,7,0.78,78,1080,12,9,4,10,5,2,17,9,0,1,0,1,4,1,0,1,0
7903,705,2020,6,6,0,0.99,99,1080,3,2,1,2,2,1,5,1,1,0,0,2,0,1,0,0,0
7904,706,2020,17,5,12,0.32,32,1080,3,2,0,3,2,0,5,3,0,0,0,2,0,0,0,0,0
7905,707,2020,29,29,0,1.0,100,1080,10,16,3,6,8,1,15,2,4,0,0,0,8,0,0,1,0
7906,708,2020,39,39,0,1.0,100,1080,21,16,2,6,13,1,20,0,1,1,4,10,3,0,1,0,0
7907,709,2020,42,42,0,1.0,99,1080,14,24,4,9,22,4,35,6,2,0,1,20,2,4,0,0,0
7908,710,2020,20,12,8,0.62,61,1080,7,4,1,3,3,1,7,1,1,0,1,2,1,1,0,0,0
7909,711,2020,5,5,0,1.0,100,1080,2,3,0,2,3,0,5,2,0,0,0,3,0,0,0,0,0
7910,712,2020,48,48,0,1.0,100,1080,29,19,0,26,18,0,44,25,0,0,1,17,1,0,0,0,0
7911,713,2020,24,24,0,1.0,99,1080,10,12,2,3,9,2,14,0,1,0,2,6,3,2,0,0,0
7912,714,2020,30,30,0,1.0,100,1080,13,16,1,13,14,1,28,13,0,0,0,12,2,1,0,0,0
7913,715,2020,47,24,23,0.52,52,1080,12,10,2,8,6,1,15,5,2,1,0,2,4,0,1,0,0
7914,716,2020,34,34,0,1.0,100,1080,15,19,0,9,16,0,25,5,2,2,0,13,3,0,0,0,0
7915,717,2020,32,32,0,1.0,100,1080,13,16,3,13,9,3,25,13,0,0,0,2,7,3,0,0,0
7916,718,2020,35,35,0,1.0,100,1080,14,19,2,7,11,1,19,4,1,0,2,3,8,0,1,0,0
7917,719,2020,39,39,0,1.0,100,1080,16,22,1,8,17,1,26,2,4,2,0,12,5,1,0,0,0
7918,720,2020,7,4,3,0.53,53,1080,1,2,1,1,1,1,3,1,0,0,0,0,1,1,0,0,0
7919,721,2020,38,38,0,1.0,100,1080,22,16,0,20,10,0,30,19,0,1,0,4,6,0,0,0,0
7920,722,2020,24,24,0,1.0,100,1080,15,8,1,12,5,1,18,10,1,1,0,2,3,1,0,0,0
7921,723,2020,8,8,0,1.0,99,1080,3,3,2,1,3,2,6,0,0,1,0,3,0,2,0,0,0
7922,724,2020,24,24,0,1.0,99,1080,10,11,3,7,11,2,20,5,1,1,0,11,0,1,1,0,0
7923,725,2020,26,22,4,0.83,83,1080,9,10,3,5,7,1,13,3,1,0,1,4,3,0,0,1,0
7924,726,2020,28,28,0,1.0,100,1080,13,13,2,6,13,2,21,2,2,1,1,13,0,2,0,0,0
7925,727,2020,24,24,0,1.0,99,1080,15,8,1,14,4,1,19,13,1,0,0,0,4,1,0,0,0
7926,728,2020,28,28,0,1.0,100,1080,15,10,3,5,7,3,15,0,1,3,1,4,3,3,0,0,0
7927,729,2020,24,24,0,1.0,99,1080,14,9,1,10,8,1,19,6,4,0,0,7,1,1,0,0,0
7928,730,2020,30,3,27,0.11,11,1080,1,2,0,1,1,0,2,1,0,0,0,0,1,0,0,0,0
7929,731,2020,51,51,0,1.0,100,1080,25,24,2,17,18,2,37,12,3,1,1,12,6,2,0,0,0
7930,732,2020,9,9,0,0.98,98,1080,4,5,0,2,4,0,6,0,2,0,0,3,1,0,0,0,0
7931,733,2020,10,10,0,1.0,100,1080,3,5,2,1,3,1,5,0,0,1,0,1,2,0,1,0,0
7932,734,2020,34,33,1,0.98,97,1080,14,18,1,12,12,1,25,10,2,0,0,6,6,1,0,0,0
7933,735,2020,18,18,0,1.0,100,1080,9,6,3,3,6,2,11,1,0,0,2,6,0,1,1,0,0
7934,736,2020,31,31,0,0.99,98,1080,13,18,0,10,13,0,23,7,3,0,0,8,5,0,0,0,0
7935,737,2020,49,49,0,1.0,99,1080,19,29,1,16,27,1,44,14,1,1,0,25,2,1,0,0,0
7936,738,2020,31,31,0,1.0,100,1080,22,7,2,20,4,1,25,19,0,1,0,1,3,0,1,0,0
7937,739,2020,36,36,0,1.0,100,1080,16,19,1,12,17,1,30,10,0,2,0,15,2,1,0,0,0
7938,740,2020,46,46,0,1.0,100,1080,34,11,1,22,9,1,32,12,8,2,0,7,2,1,0,0,0
7939,741,2020,15,13,2,0.85,85,1080,7,4,2,6,2,2,10,5,1,0,0,0,2,2,0,0,0
7940,742,2020,46,46,0,1.0,100,1080,26,19,1,20,12,1,33,18,0,0,2,5,7,1,0,0,0
7941,743,2020,47,14,33,0.31,30,1080,7,4,3,5,4,3,12,4,0,1,0,4,0,3,0,0,0
7942,744,2020,16,16,0,0.99,98,1080,10,4,2,6,4,2,12,2,4,0,0,4,0,2,0,0,0
7943,745,2020,36,32,4,0.88,87,1080,15,13,4,5,11,2,18,1,0,2,2,9,2,1,0,1,0
7944,746,2020,31,31,0,1.0,100,1080,21,8,2,12,7,1,20,6,4,1,1,6,1,0,1,0,0
7945,747,2020,8,8,0,1.0,100,1080,5,2,1,5,2,1,8,5,0,0,0,2,0,1,0,0,0
7946,748,2020,32,32,0,1.0,100,1080,22,7,3,7,4,3,14,1,0,3,3,1,3,3,0,0,0
7947,749,2020,7,7,0,1.0,100,1080,4,3,0,4,2,0,6,4,0,0,0,1,1,0,0,0,0
7948,750,2020,36,36,0,1.0,100,1080,20,14,2,12,12,1,25,4,8,0,0,10,2,0,1,0,0
7949,751,2020,31,6,25,0.19,19,1080,3,2,1,1,1,1,3,0,0,1,0,0,1,1,0,0,0
7950,752,2020,20,19,1,0.95,94,1080,5,11,3,4,8,1,13,3,1,0,0,5,3,0,0,1,0
7951,753,2020,21,21,0,1.0,99,1080,11,7,3,11,4,3,18,11,0,0,0,1,3,3,0,0,0
7952,754,2020,6,4,2,0.69,69,1080,2,2,0,2,1,0,3,2,0,0,0,0,1,0,0,0,0
7953,755,2020,30,25,5,0.82,82,1080,14,10,1,14,8,1,23,14,0,0,0,6,2,1,0,0,0
7954,756,2020,25,25,0,0.99,98,1080,13,8,4,13,7,3,23,13,0,0,0,6,1,2,1,0,0
7955,757,2020,38,38,0,1.0,100,1080,18,19,1,6,13,1,20,0,3,0,3,7,6,1,0,0,0
7956,758,2020,43,39,4,0.91,91,1080,17,18,4,13,17,4,34,9,4,0,0,16,1,4,0,0,0
7957,759,2020,27,26,1,0.98,98,1080,15,9,2,4,6,2,12,0,0,1,3,3,3,2,0,0,0
7958,760,2020,16,11,5,0.66,66,1080,5,4,2,3,3,2,8,1,2,0,0,2,1,2,0,0,0
7959,761,2020,15,15,0,1.0,100,1080,6,9,0,5,7,0,12,4,1,0,0,5,2,0,0,0,0
7960,762,2020,43,37,6,0.87,86,1080,26,9,2,18,5,1,24,14,0,4,0,1,4,0,1,0,0
7961,763,2020,52,52,0,1.0,100,1080,18,30,4,14,16,1,31,10,4,0,0,2,14,0,0,0,1
7962,764,2020,28,7,21,0.24,23,1080,2,4,1,1,4,1,6,0,1,0,0,4,0,1,0,0,0
7963,765,2020,36,36,0,0.99,98,1080,14,19,3,13,11,3,27,12,1,0,0,3,8,3,0,0,0
7964,766,2020,15,14,1,0.94,93,1080,6,6,2,2,4,1,7,0,1,0,1,2,2,0,1,0,0
7965,767,2020,34,32,2,0.95,94,1080,14,18,0,4,14,0,18,0,0,2,2,10,4,0,0,0,0
7966,768,2020,7,7,0,1.0,99,1080,4,2,1,2,2,1,5,0,2,0,0,2,0,1,0,0,0
7967,769,2020,20,20,0,1.0,100,1080,12,8,0,7,5,0,12,5,0,1,1,2,3,0,0,0,0
7968,770,2020,40,2,38,0.05,5,1080,1,1,0,1,1,0,2,1,0,0,0,1,0,0,0,0,0
7969,771,2020,40,30,10,0.74,74,1080,20,9,1,16,6,1,23,13,2,1,0,3,3,1,0,0,0
7970,772,2020,18,1,17,0.06,6,1080,0,1,0,0,1,0,1,0,0,0,0,1,0,0,0,0,0
7971,773,2020,39,14,25,0.35,35,1080,7,7,0,6,7,0,13,5,1,0,0,7,0,0,0,0,0
7972,774,2020,10,10,0,0.99,98,1080,5,5,0,5,5,0,10,5,0,0,0,5,0,0,0,0,0
7973,775,2020,6,1,5,0.13,13,1080,0,1,0,0,1,0,1,0,0,0,0,1,0,0,0,0,0
7974,776,2020,18,18,0,1.0,99,1080,9,5,4,5,3,4,12,3,1,0,1,1,2,4,0,0,0
7975,777,2020,13,13,0,1.0,100,1080,5,5,3,4,4,1,9,3,1,0,0,3,1,0,0,1,0
7976,778,2020,50,47,3,0.93,93,1080,32,14,1,19,11,1,31,13,1,3,2,8,3,1,0,0,0
7977,779,2020,55,55,0,1.0,100,1080,32,21,2,24,20,1,45,20,2,0,2,19,1,0,1,0,0
7978,780,2020,34,34,0,1.0,100,1080,24,8,2,13,8,1,22,4,7,2,0,8,0,0,1,0,0
7979,781,2020,25,25,0,1.0,100,1080,7,15,3,7,9,3,19,7,0,0,0,3,6,3,0,0,0
7980,782,2020,49,49,0,1.0,100,1080,25,23,1,22,14,1,37,21,0,0,1,5,9,1,0,0,0
7981,783,2020,17,17,0,1.0,100,1080,11,4,2,7,2,2,11,3,4,0,0,0,2,2,0,0,0
7982,784,2020,47,47,0,1.0,100,1080,28,15,4,18,12,1,31,13,0,5,0,9,3,0,0,0,1
7983,785,2020,6,0,6,0.01,1,1080,0,0,0,0,0,0,0,0,0,0,0,0,0,0,0,0,0
7984,786,2020,39,39,0,1.0,100,1080,21,15,3,15,15,1,31,9,6,0,0,15,0,0,0,1,0
7985,787,2020,37,37,0,1.0,100,1080,22,11,4,9,10,4,23,1,3,5,0,9,1,4,0,0,0
7986,788,2020,30,30,0,0.99,99,1080,15,12,3,9,10,3,22,5,2,2,0,8,2,3,0,0,0
7987,789,2020,23,21,2,0.93,93,1080,11,7,3,4,5,1,10,1,0,2,1,3,2,0,0,1,0
7988,790,2020,35,31,4,0.87,87,1080,18,13,0,13,13,0,26,10,2,0,1,13,0,0,0,0,0
7989,791,2020,18,18,0,1.0,99,1080,12,6,0,5,6,0,11,2,0,2,1,6,0,0,0,0,0
7990,792,2020,40,40,0,1.0,100,1080,29,10,1,22,5,1,28,19,1,0,2,0,5,1,0,0,0
7991,793,2020,16,16,0,1.0,100,1080,10,6,0,9,6,0,15,8,1,0,0,6,0,0,0,0,0
7992,794,2020,8,8,0,1.0,100,1080,5,2,1,2,2,1,5,0,1,1,0,2,0,1,0,0,0
7993,795,2020,33,28,5,0.85,85,1080,8,16,4,7,9,4,20,6,1,0,0,2,7,4,0,0,0
7994,796,2020,14,14,0,1.0,100,1080,9,4,1,6,4,1,11,4,1,1,0,4,0,1,0,0,0
7995,797,2020,55,15,40,0.27,27,1080,7,7,1,3,5,1,9,1,1,0,1,3,2,1,0,0,0
7996,798,2020,24,24,0,1.0,100,1080,12,10,2,9,10,1,20,6,3,0,0,10,0,0,1,0,0
7997,799,2020,36,36,0,1.0,100,1080,14,20,2,13,11,2,26,12,1,0,0,2,9,2,0,0,0
7998,800,2020,30,30,0,1.0,100,1080,21,8,1,20,5,1,26,19,1,0,0,2,3,1,0,0,0
7999,801,2020,38,22,16,0.58,58,1080,9,9,4,8,9,1,18,7,1,0,0,9,0,0,0,0,1
8000,802,2020,38,38,0,1.0,100,1080,19,16,3,9,9,2,20,0,8,1,0,2,7,1,1,0,0
8001,803,2020,36,36,0,1.0,100,1080,25,10,1,24,8,1,33,23,1,0,0,6,2,1,0,0,0
8002,804,2020,35,35,0,1.0,100,1080,21,10,4,9,6,3,18,3,3,0,3,2,4,2,1,0,0
8003,805,2020,59,59,0,1.0,100,1080,39,17,3,38,10,3,51,37,1,0,0,3,7,3,0,0,0
8004,806,2020,12,1,11,0.07,7,1080,0,1,0,0,1,0,1,0,0,0,0,1,0,0,0,0,0
8005,807,2020,28,28,0,1.0,99,1080,16,9,3,15,7,3,25,14,1,0,0,5,2,3,0,0,0
8006,808,2020,22,0,22,0.01,1,1080,0,0,0,0,0,0,0,0,0,0,0,0,0,0,0,0,0
8007,809,2020,34,34,0,1.0,99,1080,25,8,1,11,4,1,16,1,7,2,1,0,4,1,0,0,0
8008,810,2020,38,38,0,1.0,100,1080,16,20,2,12,11,1,24,9,2,1,0,2,9,0,1,0,0
8009,811,2020,14,5,9,0.38,38,1080,3,2,0,3,2,0,5,3,0,0,0,2,0,0,0,0,0
8010,812,2020,40,3,37,0.08,7,1080,1,2,0,1,1,0,2,1,0,0,0,0,1,0,0,0,0
8011,813,2020,52,52,0,1.0,100,1080,32,19,1,20,13,1,34,15,0,3,2,7,6,1,0,0,0
8012,814,2020,59,24,35,0.41,40,1080,14,8,2,8,5,1,14,5,1,1,1,2,3,0,1,0,0
8013,815,2020,30,30,0,1.0,100,1080,13,15,2,9,9,2,20,7,1,0,1,3,6,2,0,0,0
8014,816,2020,37,37,0,1.0,100,1080,26,10,1,9,9,1,19,2,1,2,4,8,1,1,0,0,0
8015,817,2020,24,8,16,0.33,33,1080,6,2,0,2,1,0,3,0,1,0,1,0,1,0,0,0,0
8016,818,2020,22,22,0,1.0,100,1080,9,11,2,9,8,2,19,9,0,0,0,5,3,2,0,0,0
8017,819,2020,22,22,0,1.0,99,1080,7,11,4,4,8,3,15,3,0,0,1,5,3,2,1,0,0
8018,820,2020,41,41,0,1.0,100,1080,16,22,3,7,11,1,19,2,3,0,2,0,11,0,0,1,0
8019,821,2020,17,17,0,1.0,100,1080,5,10,2,5,6,1,12,5,0,0,0,2,4,0,1,0,0
8020,822,2020,44,44,0,1.0,99,1080,25,16,3,7,15,3,25,1,0,0,6,14,1,3,0,0,0
8021,823,2020,6,6,0,1.0,100,1080,2,3,1,1,3,1,5,0,1,0,0,3,0,1,0,0,0
8022,824,2020,23,21,2,0.91,90,1080,8,9,4,2,8,4,14,0,0,0,2,7,1,4,0,0,0
8023,825,2020,47,47,0,0.99,99,1080,24,22,1,14,15,1,30,8,4,0,2,8,7,1,0,0,0
8024,826,2020,13,13,0,1.0,100,1080,4,6,3,4,6,2,12,4,0,0,0,6,0,1,1,0,0
8025,827,2020,16,5,11,0.34,33,1080,1,3,1,1,2,1,4,1,0,0,0,1,1,1,0,0,0
8026,828,2020,28,28,0,0.99,99,1080,21,5,2,16,5,2,23,14,0,1,1,5,0,2,0,0,0
8027,829,2020,58,58,0,1.0,100,1080,36,19,3,27,12,2,41,20,6,0,1,5,7,1,1,0,0
8028,830,2020,19,19,0,1.0,100,1080,12,4,3,6,3,1,10,2,2,2,0,2,1,0,0,1,0
8029,831,2020,35,25,10,0.71,70,1080,16,6,3,11,5,3,19,7,3,1,0,4,1,3,0,0,0
8030,832,2020,23,23,0,1.0,100,1080,8,13,2,5,13,1,19,2,3,0,0,13,0,0,1,0,0
8031,833,2020,15,15,0,1.0,100,1080,8,6,1,5,5,1,11,4,0,0,1,4,1,1,0,0,0
8032,834,2020,8,8,0,0.98,98,1080,3,4,1,2,4,1,7,1,1,0,0,4,0,1,0,0,0
8033,835,2020,12,12,0,1.0,100,1080,3,6,3,2,6,2,10,1,1,0,0,6,0,1,1,0,0
8034,836,2020,16,16,0,0.98,97,1080,7,7,2,7,5,1,13,7,0,0,0,3,2,0,1,0,0
8035,837,2020,47,47,0,1.0,100,1080,33,12,2,15,8,2,25,5,2,8,0,4,4,2,0,0,0
8036,838,2020,15,15,0,1.0,100,1080,7,8,0,3,7,0,10,1,1,0,1,6,1,0,0,0,0
8037,839,2020,39,31,8,0.78,78,1080,15,15,1,7,13,1,21,1,5,0,1,11,2,1,0,0,0
8038,840,2020,25,25,0,1.0,100,1080,7,14,4,6,10,2,18,5,1,0,0,6,4,0,2,0,0
8039,841,2020,10,8,2,0.81,81,1080,3,3,2,1,3,1,5,0,0,1,0,3,0,0,1,0,0
8040,842,2020,22,22,0,1.0,99,1080,9,12,1,3,11,1,15,1,0,0,2,10,1,1,0,0,0
8041,843,2020,9,9,0,1.0,99,1080,4,4,1,1,2,1,4,0,0,0,1,0,2,1,0,0,0
8042,844,2020,38,38,0,1.0,100,1080,17,20,1,14,20,1,35,12,1,1,0,20,0,1,0,0,0
8043,845,2020,32,32,0,1.0,100,1080,20,12,0,11,12,0,23,5,4,1,1,12,0,0,0,0,0
8044,846,2020,20,20,0,1.0,99,1080,11,5,4,7,4,1,12,3,4,0,0,3,1,0,0,0,1
8045,847,2020,35,33,2,0.93,93,1080,20,12,1,18,9,1,28,17,0,1,0,6,3,1,0,0,0
8046,848,2020,29,29,0,1.0,99,1080,15,11,3,6,7,3,16,0,4,1,1,3,4,3,0,0,0
8047,849,2020,14,11,3,0.77,77,1080,4,5,2,4,3,1,8,4,0,0,0,1,2,0,1,0,0
8048,850,2020,34,34,0,1.0,100,1080,17,16,1,14,12,1,27,13,0,0,1,8,4,1,0,0,0
8049,851,2020,35,35,0,1.0,100,1080,21,11,3,19,6,3,28,17,2,0,0,1,5,3,0,0,0
8050,852,2020,55,55,0,1.0,100,1080,35,19,1,27,12,1,40,19,8,0,0,5,7,1,0,0,0
8051,853,2020,26,13,13,0.51,50,1080,9,3,1,9,2,1,12,9,0,0,0,1,1,1,0,0,0
8052,854,2020,53,52,1,0.98,97,1080,34,16,2,11,13,1,25,1,3,1,6,10,3,0,1,0,0
8053,855,2020,49,49,0,1.0,100,1080,24,22,3,21,20,2,43,18,3,0,0,18,2,1,1,0,0
8054,856,2020,23,23,0,1.0,100,1080,9,13,1,6,9,1,16,5,0,0,1,5,4,1,0,0,0
8055,857,2020,21,21,0,1.0,100,1080,9,9,3,5,6,2,13,3,0,2,0,3,3,1,1,0,0
8056,858,2020,23,23,0,1.0,100,1080,15,7,1,6,4,1,11,1,1,4,0,1,3,1,0,0,0
8057,859,2020,38,38,0,1.0,100,1080,15,19,4,5,11,1,17,0,1,3,1,3,8,0,0,0,1
8058,860,2020,35,35,0,1.0,100,1080,23,12,0,23,6,0,29,23,0,0,0,0,6,0,0,0,0
8059,861,2020,20,20,0,1.0,100,1080,13,7,0,5,5,0,10,1,1,2,1,3,2,0,0,0,0
8060,862,2020,28,28,0,1.0,100,1080,20,5,3,15,5,1,21,10,5,0,0,5,0,0,0,1,0
8061,863,2020,7,7,0,1.0,100,1080,4,2,1,4,1,1,6,4,0,0,0,0,1,1,0,0,0
8062,864,2020,46,38,8,0.83,82,1080,28,6,4,18,6,4,28,13,2,1,2,6,0,4,0,0,0
8063,865,2020,15,15,0,0.99,99,1080,7,5,3,5,3,3,11,3,2,0,0,1,2,3,0,0,0
8064,866,2020,58,36,22,0.62,62,1080,22,11,3,7,9,2,18,0,0,6,1,7,2,1,1,0,0
8065,867,2020,29,29,0,1.0,99,1080,16,10,3,11,8,1,20,9,0,1,1,6,2,0,0,1,0
8066,868,2020,34,23,11,0.69,68,1080,16,7,0,5,5,0,10,0,2,0,3,3,2,0,0,0,0
8067,869,2020,15,0,15,0.01,1,1080,0,0,0,0,0,0,0,0,0,0,0,0,0,0,0,0,0
8068,870,2020,35,11,24,0.3,30,1080,3,5,3,3,5,1,9,3,0,0,0,5,0,0,0,1,0
8069,871,2020,11,11,0,1.0,100,1080,4,5,2,1,4,2,7,0,0,0,1,3,1,2,0,0,0
8070,872,2020,37,37,0,1.0,100,1080,27,8,2,11,4,1,16,1,6,2,2,0,4,0,1,0,0
8071,873,2020,31,31,0,1.0,100,1080,12,16,3,3,15,1,19,0,0,0,3,14,1,0,0,1,0
8072,874,2020,38,38,0,1.0,100,1080,24,11,3,11,10,1,22,0,10,0,1,9,1,0,0,1,0
8073,875,2020,9,9,0,1.0,100,1080,3,4,2,1,3,1,5,0,0,1,0,2,1,0,1,0,0
8074,876,2020,39,38,1,0.98,97,1080,22,16,0,7,15,0,22,1,1,1,4,14,1,0,0,0,0
8075,877,2020,52,50,2,0.97,97,1080,36,10,4,20,8,2,30,13,1,3,3,6,2,0,2,0,0
8076,878,2020,37,5,32,0.14,13,1080,2,3,0,1,2,0,3,0,1,0,0,1,1,0,0,0,0
8077,879,2020,16,16,0,1.0,100,1080,7,5,4,3,3,2,8,1,0,2,0,1,2,1,0,1,0
8078,880,2020,20,19,1,0.97,96,1080,12,6,1,6,3,1,10,2,2,2,0,0,3,1,0,0,0
8079,881,2020,7,7,0,1.0,100,1080,3,4,0,2,3,0,5,1,1,0,0,2,1,0,0,0,0
8080,882,2020,60,20,40,0.34,33,1080,8,10,2,4,8,1,13,0,4,0,0,6,2,0,1,0,0
8081,883,2020,10,10,0,1.0,100,1080,7,3,0,4,2,0,6,3,0,0,1,1,1,0,0,0,0
8082,884,2020,8,5,3,0.59,58,1080,2,2,1,1,1,1,3,0,1,0,0,0,1,1,0,0,0
8083,885,2020,34,5,29,0.14,14,1080,2,2,1,2,2,1,5,2,0,0,0,2,0,1,0,0,0
8084,886,2020,26,26,0,1.0,100,1080,15,7,4,6,7,4,17,1,2,2,1,7,0,4,0,0,0
8085,887,2020,12,12,0,0.98,97,1080,5,4,3,2,3,1,6,1,0,0,1,2,1,0,0,1,0
8086,888,2020,15,15,0,1.0,100,1080,6,6,3,4,4,2,10,3,0,1,0,2,2,1,1,0,0
8087,889,2020,26,26,0,1.0,100,1080,13,12,1,13,12,1,26,13,0,0,0,12,0,1,0,0,0
8088,890,2020,12,11,1,0.94,94,1080,6,3,2,2,2,2,6,0,1,0,1,1,1,2,0,0,0
8089,891,2020,60,60,0,1.0,100,1080,24,35,1,9,22,1,32,0,5,2,2,9,13,1,0,0,0
8090,892,2020,21,21,0,1.0,100,1080,14,5,2,10,5,2,17,8,1,0,1,5,0,2,0,0,0
8091,893,2020,18,4,14,0.24,23,1080,1,2,1,1,2,1,4,1,0,0,0,2,0,1,0,0,0
8092,894,2020,13,13,0,1.0,99,1080,5,7,1,4,4,1,9,3,1,0,0,1,3,1,0,0,0
8093,895,2020,41,36,5,0.89,88,1080,19,16,1,7,9,1,17,1,1,4,1,2,7,1,0,0,0
8094,896,2020,14,6,8,0.43,43,1080,2,3,1,2,2,1,5,2,0,0,0,1,1,1,0,0,0
8095,897,2020,47,47,0,1.0,99,1080,30,14,3,14,8,1,23,6,0,8,0,2,6,0,0,1,0
8096,898,2020,28,28,0,1.0,100,1080,12,14,2,3,13,1,17,0,0,0,3,12,1,0,1,0,0
8097,899,2020,29,29,0,1.0,100,1080,11,15,3,7,13,1,21,4,2,1,0,11,2,0,0,1,0
8098,900,2020,22,22,0,1.0,99,1080,12,9,1,9,9,1,19,7,1,1,0,9,0,1,0,0,0
8099,901,2020,34,34,0,0.99,99,1080,12,20,2,7,11,2,20,4,1,2,0,2,9,2,0,0,0
8100,902,2020,16,16,0,1.0,100,1080,7,6,3,7,5,1,13,7,0,0,0,4,1,0,0,1,0
8101,903,2020,26,26,0,1.0,100,1080,9,14,3,6,10,3,19,5,0,0,1,6,4,3,0,0,0
8102,904,2020,10,2,8,0.2,20,1080,1,1,0,1,1,0,2,1,0,0,0,1,0,0,0,0,0
8103,905,2020,14,5,9,0.34,34,1080,3,2,0,1,2,0,3,0,0,1,0,2,0,0,0,0,0
8104,906,2020,12,10,2,0.82,82,1080,4,5,1,1,4,1,6,0,0,0,1,3,1,1,0,0,0
8105,907,2020,42,22,20,0.52,51,1080,14,5,3,10,5,2,17,8,0,2,0,5,0,1,1,0,0
8106,908,2020,20,20,0,0.98,97,1080,12,5,3,12,4,2,18,12,0,0,0,3,1,1,1,0,0
8107,909,2020,40,40,0,1.0,100,1080,20,18,2,17,15,1,33,16,0,0,1,12,3,0,1,0,0
8108,910,2020,16,16,0,1.0,100,1080,12,3,1,4,2,1,7,1,0,1,2,1,1,1,0,0,0
8109,911,2020,57,57,0,1.0,100,1080,36,20,1,23,12,1,36,18,1,0,4,4,8,1,0,0,0
8110,912,2020,10,0,10,0.01,1,1080,0,0,0,0,0,0,0,0,0,0,0,0,0,0,0,0,0
8111,913,2020,27,14,13,0.53,52,1080,5,7,2,2,7,1,10,0,1,1,0,7,0,0,1,0,0
8112,914,2020,33,32,1,0.97,96,1080,21,10,1,9,10,1,20,1,6,0,2,10,0,1,0,0,0
8113,915,2020,26,26,0,0.99,98,1080,13,11,2,10,7,1,18,7,3,0,0,3,4,0,1,0,0
8114,916,2020,37,37,0,0.99,98,1080,23,12,2,9,10,2,21,3,1,2,3,8,2,2,0,0,0
8115,917,2020,25,25,0,1.0,100,1080,18,7,0,9,4,0,13,3,3,3,0,1,3,0,0,0,0
8116,918,2020,12,12,0,0.98,98,1080,5,4,3,5,3,3,11,5,0,0,0,2,1,3,0,0,0
8117,919,2020,41,41,0,1.0,99,1080,27,13,1,22,12,1,35,17,5,0,0,11,1,1,0,0,0
8118,920,2020,11,11,0,0.99,99,1080,6,4,1,2,2,1,5,0,0,2,0,0,2,1,0,0,0
8119,921,2020,26,26,0,1.0,100,1080,13,10,3,10,7,3,20,7,3,0,0,4,3,3,0,0,0
8120,922,2020,12,12,0,0.96,95,1080,3,6,3,2,5,3,10,1,1,0,0,4,1,3,0,0,0
8121,923,2020,41,41,0,1.0,100,1080,28,12,1,22,6,1,29,18,2,2,0,0,6,1,0,0,0
8122,924,2020,15,15,0,1.0,100,1080,5,9,1,5,5,1,11,5,0,0,0,1,4,1,0,0,0
8123,925,2020,25,24,1,0.97,96,1080,9,13,2,6,9,2,17,3,3,0,0,5,4,2,0,0,0
8124,926,2020,27,8,19,0.29,29,1080,3,3,2,1,2,2,5,0,0,1,0,1,1,2,0,0,0
8125,927,2020,27,27,0,1.0,100,1080,11,14,2,10,9,2,21,9,1,0,0,4,5,2,0,0,0
8126,928,2020,38,38,0,1.0,100,1080,14,22,2,14,22,1,37,14,0,0,0,22,0,0,1,0,0
8127,929,2020,9,9,0,1.0,100,1080,3,4,2,1,3,2,6,0,0,1,0,2,1,2,0,0,0
8128,930,2020,47,47,0,1.0,100,1080,18,26,3,11,24,1,36,7,1,3,0,22,2,0,0,1,0
8129,931,2020,26,26,0,1.0,100,1080,18,7,1,13,7,1,21,10,2,0,1,7,0,1,0,0,0
8130,932,2020,29,29,0,1.0,100,1080,15,11,3,6,9,1,16,2,0,3,1,7,2,0,0,1,0
8131,933,2020,39,18,21,0.46,46,1080,8,7,3,2,4,2,8,0,0,0,2,1,3,1,1,0,0
8132,934,2020,25,15,10,0.58,58,1080,9,4,2,5,2,1,8,3,1,0,1,0,2,0,1,0,0
8133,935,2020,22,22,0,0.98,97,1080,13,8,1,5,7,1,13,2,0,1,2,6,1,1,0,0,0
8134,936,2020,31,31,0,1.0,100,1080,18,9,4,7,7,3,17,0,5,0,2,5,2,2,1,0,0
8135,937,2020,10,3,7,0.29,29,1080,2,1,0,1,1,0,2,0,1,0,0,1,0,0,0,0,0
8136,938,2020,31,30,1,0.96,95,1080,15,12,3,15,9,1,25,15,0,0,0,6,3,0,0,1,0
8137,939,2020,14,14,0,0.99,99,1080,3,8,3,3,4,2,9,3,0,0,0,0,4,1,1,0,0
8138,940,2020,60,60,0,1.0,99,1080,41,18,1,21,17,1,39,11,3,4,3,16,1,1,0,0,0
8139,941,2020,27,26,1,0.95,95,1080,11,13,2,6,11,1,18,2,3,1,0,9,2,0,1,0,0
8140,942,2020,17,17,0,1.0,100,1080,6,10,1,3,7,1,11,0,3,0,0,4,3,1,0,0,0
8141,943,2020,48,48,0,1.0,100,1080,30,15,3,11,10,1,22,1,3,5,2,5,5,0,0,1,0
8142,944,2020,18,16,2,0.9,90,1080,5,8,3,5,4,2,11,5,0,0,0,0,4,1,1,0,0
8143,945,2020,26,26,0,1.0,99,1080,10,14,2,10,8,1,19,10,0,0,0,2,6,0,1,0,0
8144,946,2020,24,24,0,1.0,100,1080,7,14,3,4,7,2,13,3,0,0,1,0,7,1,1,0,0
8145,947,2020,36,0,36,0.01,1,1080,0,0,0,0,0,0,0,0,0,0,0,0,0,0,0,0,0
8146,948,2020,20,6,14,0.32,31,1080,3,3,0,2,2,0,4,1,1,0,0,1,1,0,0,0,0
8147,949,2020,26,26,0,1.0,100,1080,16,6,4,6,3,2,11,2,1,0,3,0,3,0,2,0,0
8148,950,2020,35,17,18,0.48,48,1080,8,9,0,4,5,0,9,0,4,0,0,1,4,0,0,0,0
8149,951,2020,29,28,1,0.98,97,1080,20,6,2,6,3,1,10,0,1,2,3,0,3,0,1,0,0
8150,952,2020,15,14,1,0.92,92,1080,6,5,3,4,3,3,10,2,2,0,0,1,2,3,0,0,0
8151,953,2020,54,1,53,0.01,1,1080,0,1,0,0,1,0,1,0,0,0,0,1,0,0,0,0,0
8152,954,2020,21,21,0,1.0,100,1080,11,7,3,4,7,1,12,0,2,1,1,7,0,0,0,1,0
8153,955,2020,23,23,0,1.0,100,1080,13,9,1,6,7,1,14,2,2,1,1,5,2,1,0,0,0
8154,956,2020,40,33,7,0.83,82,1080,17,16,0,6,12,0,18,1,2,0,3,8,4,0,0,0,0
8155,957,2020,23,9,14,0.41,40,1080,6,3,0,4,2,0,6,2,2,0,0,1,1,0,0,0,0
8156,958,2020,20,13,7,0.66,65,1080,8,4,1,4,4,1,9,1,2,1,0,4,0,1,0,0,0
8157,959,2020,22,22,0,0.98,97,1080,8,11,3,5,9,2,16,2,3,0,0,7,2,1,1,0,0
8158,960,2020,6,6,0,1.0,100,1080,3,2,1,3,2,1,6,3,0,0,0,2,0,1,0,0,0
8159,961,2020,22,14,8,0.63,63,1080,8,4,2,7,4,1,12,6,1,0,0,4,0,0,1,0,0
8160,962,2020,34,32,2,0.93,92,1080,17,11,4,9,10,4,23,5,1,2,1,9,1,4,0,0,0
8161,963,2020,15,14,1,0.91,91,1080,4,8,2,1,4,1,6,0,0,0,1,0,4,0,1,0,0
8162,964,2020,28,28,0,1.0,100,1080,18,10,0,18,10,0,28,18,0,0,0,10,0,0,0,0,0
8163,965,2020,16,16,0,0.98,97,1080,7,6,3,7,3,1,11,7,0,0,0,0,3,0,0,1,0
8164,966,2020,12,6,6,0.53,52,1080,2,3,1,1,2,1,4,0,1,0,0,1,1,1,0,0,0
8165,967,2020,23,23,0,1.0,100,1080,9,13,1,6,13,1,20,5,0,0,1,13,0,1,0,0,0
8166,968,2020,31,30,1,0.96,96,1080,21,7,2,18,5,1,24,17,0,0,1,3,2,0,1,0,0
8167,969,2020,41,41,0,1.0,100,1080,19,21,1,10,15,1,26,3,5,2,0,9,6,1,0,0,0
8168,970,2020,5,4,1,0.89,89,1080,2,2,0,2,1,0,3,2,0,0,0,0,1,0,0,0,0
8169,971,2020,52,52,0,1.0,100,1080,37,13,2,29,10,2,41,21,8,0,0,7,3,2,0,0,0
8170,972,2020,7,3,4,0.43,42,1080,2,1,0,1,1,0,2,0,1,0,0,1,0,0,0,0,0
8171,973,2020,10,9,1,0.94,93,1080,4,3,2,4,2,2,8,4,0,0,0,1,1,2,0,0,0
8172,974,2020,23,23,0,1.0,100,1080,13,9,1,4,7,1,12,0,1,1,2,5,2,1,0,0,0
8173,975,2020,46,43,3,0.93,93,1080,16,23,4,7,16,4,27,2,3,0,2,9,7,4,0,0,0
8174,976,2020,9,1,8,0.15,15,1080,0,1,0,0,1,0,1,0,0,0,0,1,0,0,0,0,0
8175,977,2020,55,47,8,0.86,85,1080,19,27,1,12,24,1,37,8,1,3,0,21,3,1,0,0,0
8176,978,2020,35,18,17,0.52,51,1080,5,10,3,5,5,2,12,5,0,0,0,0,5,1,1,0,0
8177,979,2020,50,50,0,1.0,100,1080,18,28,4,8,23,2,33,3,2,1,2,18,5,1,0,1,0
8178,980,2020,14,14,0,1.0,99,1080,5,8,1,2,7,1,10,0,1,1,0,6,1,1,0,0,0
8179,981,2020,52,52,0,1.0,100,1080,23,27,2,11,19,1,31,5,1,4,1,11,8,0,1,0,0
8180,982,2020,38,38,0,1.0,99,1080,18,19,1,13,12,1,26,9,3,1,0,5,7,1,0,0,0
8181,983,2020,40,40,0,1.0,99,1080,16,21,3,15,17,1,33,14,1,0,0,13,4,0,0,1,0
8182,984,2020,31,12,19,0.37,37,1080,5,5,2,2,4,1,7,1,0,0,1,3,1,0,1,0,0
8183,985,2020,35,35,0,1.0,100,1080,16,19,0,11,16,0,27,9,0,1,1,13,3,0,0,0,0
8184,986,2020,39,39,0,1.0,100,1080,15,21,3,12,16,2,30,9,3,0,0,11,5,1,1,0,0
8185,987,2020,16,0,16,0.0,0,1080,0,0,0,0,0,0,0,0,0,0,0,0,0,0,0,0,0
8186,988,2020,18,13,5,0.71,71,1080,8,3,2,5,3,2,10,3,1,1,0,3,0,2,0,0,0
8187,989,2020,26,26,0,1.0,99,1080,12,13,1,4,12,1,17,0,2,0,2,11,1,1,0,0,0
8188,990,2020,19,17,2,0.9,90,1080,8,8,1,4,7,1,12,2,1,0,1,6,1,1,0,0,0
8189,991,2020,11,10,1,0.95,95,1080,3,5,2,1,3,1,5,0,0,1,0,1,2,0,1,0,0
8190,992,2020,17,17,0,1.0,99,1080,11,5,1,7,5,1,13,5,1,0,1,5,0,1,0,0,0
8191,993,2020,28,3,25,0.09,9,1080,1,2,0,1,2,0,3,1,0,0,0,2,0,0,0,0,0
8192,994,2020,26,15,11,0.58,57,1080,6,6,3,5,3,2,10,4,1,0,0,0,3,1,1,0,0
8193,995,2020,33,33,0,1.0,100,1080,20,12,1,17,12,1,30,16,0,0,1,12,0,1,0,0,0
8194,996,2020,15,15,0,1.0,100,1080,9,4,2,7,2,2,11,5,2,0,0,0,2,2,0,0,0
8195,997,2020,13,13,0,1.0,100,1080,5,6,2,2,4,1,7,0,1,1,0,2,2,0,1,0,0
8196,998,2020,11,11,0,0.99,98,1080,5,5,1,5,4,1,10,5,0,0,0,3,1,1,0,0,0
8197,999,2020,29,28,1,0.98,97,1080,12,15,1,3,14,1,18,0,0,0,3,13,1,1,0,0,0
8198,1000,2020,22,19,3,0.88,88,1080,8,9,2,6,8,2,16,5,0,1,0,7,1,2,0,0,0
8199,1001,2020,22,9,13,0.39,39,1080,6,2,1,4,2,1,7,3,0,1,0,2,0,1,0,0,0
8200,1002,2020,60,60,0,1.0,100,1080,42,15,3,12,15,2,29,1,0,3,8,15,0,1,1,0,0
8201,1003,2020,16,16,0,0.99,98,1080,7,5,4,6,3,3,12,5,1,0,0,1,2,2,1,0,0
8202,1004,2020,27,27,0,1.0,100,1080,20,7,0,5,6,0,11,0,0,0,5,5,1,0,0,0,0
8203,1005,2020,46,46,0,1.0,99,1080,33,11,2,18,9,1,28,10,4,1,3,7,2,0,1,0,0
8204,1006,2020,19,17,2,0.89,88,1080,12,5,0,12,3,0,15,12,0,0,0,1,2,0,0,0,0
8205,1007,2020,38,38,0,1.0,100,1080,26,10,2,17,5,1,23,10,6,0,1,0,5,0,1,0,0
8206,1008,2020,48,0,48,0.0,0,1080,0,0,0,0,0,0,0,0,0,0,0,0,0,0,0,0,0
8207,1009,2020,17,16,1,0.94,94,1080,6,7,3,2,7,2,11,0,0,2,0,7,0,1,1,0,0
8208,1010,2020,27,27,0,1.0,100,1080,18,7,2,14,7,1,22,12,0,2,0,7,0,0,1,0,0
8209,1011,2020,16,16,0,1.0,100,1080,9,5,2,5,3,2,10,2,2,1,0,1,2,2,0,0,0
8210,1012,2020,26,25,1,0.98,97,1080,13,12,0,4,8,0,12,0,1,1,2,4,4,0,0,0,0
8211,1013,2020,52,12,40,0.23,23,1080,5,5,2,5,3,1,9,5,0,0,0,1,2,0,1,0,0
8212,1014,2020,33,32,1,0.97,96,1080,22,9,1,19,8,1,28,17,1,1,0,7,1,1,0,0,0
8213,1015,2020,40,24,16,0.6,60,1080,11,11,2,11,8,2,21,11,0,0,0,5,3,2,0,0,0
8214,1016,2020,26,25,1,0.97,96,1080,7,14,4,3,13,4,20,0,2,1,0,12,1,4,0,0,0
8215,1017,2020,22,22,0,0.98,97,1080,8,11,3,4,6,3,13,1,2,1,0,1,5,3,0,0,0
8216,1018,2020,40,25,15,0.63,63,1080,18,5,2,14,4,1,19,10,4,0,0,3,1,0,1,0,0
8217,1019,2020,45,42,3,0.93,92,1080,25,15,2,25,14,2,41,25,0,0,0,13,1,2,0,0,0
8218,1020,2020,28,28,0,1.0,100,1080,12,12,4,6,8,1,15,1,4,1,0,4,4,0,0,0,1
8219,1021,2020,27,27,0,0.99,98,1080,10,16,1,7,8,1,16,6,0,0,1,0,8,1,0,0,0
8220,1022,2020,41,38,3,0.92,92,1080,17,19,2,9,12,1,22,1,8,0,0,5,7,0,1,0,0
8221,1023,2020,53,46,7,0.86,86,1080,19,24,3,15,21,1,37,12,2,1,0,18,3,0,0,1,0
8222,1024,2020,8,8,0,0.96,95,1080,3,4,1,3,2,1,6,3,0,0,0,0,2,1,0,0,0
8223,1025,2020,13,13,0,0.97,96,1080,7,4,2,2,4,1,7,0,0,1,1,4,0,0,1,0,0
8224,1026,2020,35,0,35,0.01,1,1080,0,0,0,0,0,0,0,0,0,0,0,0,0,0,0,0,0
8225,1027,2020,42,18,24,0.42,41,1080,11,7,0,5,4,0,9,1,2,2,0,1,3,0,0,0,0
8226,1028,2020,5,5,0,0.98,97,1080,4,1,0,1,1,0,2,0,0,0,1,1,0,0,0,0,0
8227,1029,2020,6,6,0,1.0,100,1080,3,2,1,1,1,1,3,0,0,1,0,0,1,1,0,0,0
8228,1030,2020,27,27,0,0.99,99,1080,14,9,4,4,9,2,15,0,0,2,2,9,0,1,0,1,0
8229,1031,2020,39,35,4,0.88,88,1080,16,18,1,8,10,1,19,4,0,4,0,2,8,1,0,0,0
8230,1032,2020,16,16,0,0.99,98,1080,11,4,1,7,4,1,12,5,0,2,0,4,0,1,0,0,0
8231,1033,2020,56,22,34,0.38,38,1080,9,13,0,6,13,0,19,4,1,1,0,13,0,0,0,0,0
8232,1034,2020,12,12,0,0.97,96,1080,3,6,3,2,3,1,6,1,1,0,0,0,3,0,0,1,0
8233,1035,2020,31,30,1,0.96,95,1080,13,16,1,6,11,1,18,2,1,3,0,6,5,1,0,0,0
8234,1036,2020,55,53,2,0.96,96,1080,34,16,3,14,10,3,27,4,5,0,5,4,6,3,0,0,0
8235,1037,2020,27,26,1,0.97,96,1080,15,10,1,13,10,1,24,11,2,0,0,10,0,1,0,0,0
8236,1038,2020,21,21,0,0.98,98,1080,14,6,1,4,3,1,8,0,1,0,3,0,3,1,0,0,0
8237,1039,2020,33,13,20,0.4,40,1080,6,4,3,4,2,1,7,2,2,0,0,0,2,0,0,1,0
8238,1040,2020,34,34,0,1.0,99,1080,23,8,3,6,6,1,13,0,0,1,5,4,2,0,0,1,0
8239,1041,2020,31,24,7,0.76,76,1080,9,13,2,4,8,1,13,1,1,2,0,3,5,0,1,0,0
8240,1042,2020,25,24,1,0.98,97,1080,14,6,4,10,4,1,15,7,2,1,0,2,2,0,0,0,1
8241,1043,2020,26,26,0,1.0,99,1080,12,12,2,12,9,1,22,12,0,0,0,6,3,0,1,0,0
8242,1044,2020,54,50,4,0.93,92,1080,21,27,2,20,16,2,38,19,1,0,0,5,11,2,0,0,0
8243,1045,2020,60,19,41,0.32,31,1080,11,8,0,6,6,0,12,2,3,1,0,4,2,0,0,0,0
8244,1046,2020,54,29,25,0.54,53,1080,17,10,2,8,5,1,14,4,0,3,1,0,5,0,1,0,0
8245,1047,2020,30,27,3,0.91,90,1080,19,8,0,5,4,0,9,0,0,1,4,0,4,0,0,0,0
8246,1048,2020,28,28,0,0.99,98,1080,21,6,1,17,6,1,24,14,2,1,0,6,0,1,0,0,0
8247,1049,2020,33,26,7,0.79,78,1080,12,12,2,9,9,2,20,6,3,0,0,6,3,2,0,0,0
8248,1050,2020,45,10,35,0.22,21,1080,4,4,2,2,4,2,8,1,0,1,0,4,0,2,0,0,0
8249,1051,2020,41,15,26,0.38,37,1080,11,3,1,7,2,1,10,5,0,2,0,1,1,1,0,0,0
8250,1052,2020,5,4,1,0.85,85,1080,1,2,1,1,2,1,4,1,0,0,0,2,0,1,0,0,0
8251,1053,2020,46,46,0,1.0,99,1080,18,27,1,10,24,1,35,6,0,4,0,21,3,1,0,0,0
8252,1054,2020,14,4,10,0.28,27,1080,1,2,1,1,2,1,4,1,0,0,0,2,0,1,0,0,0
8253,1055,2020,33,22,11,0.66,66,1080,11,10,1,4,7,1,12,0,1,3,0,4,3,1,0,0,0
8254,1056,2020,29,29,0,1.0,100,1080,16,12,1,6,12,1,19,0,2,4,0,12,0,1,0,0,0
8255,1057,2020,47,25,22,0.53,52,1080,18,4,3,12,4,1,17,8,3,0,1,4,0,0,0,1,0
8256,1058,2020,22,22,0,1.0,99,1080,8,10,4,6,10,4,20,4,2,0,0,10,0,4,0,0,0
8257,1059,2020,8,8,0,1.0,99,1080,3,5,0,1,5,0,6,0,0,1,0,5,0,0,0,0,0
8258,1060,2020,15,15,0,1.0,99,1080,11,3,1,5,2,1,8,0,4,1,0,1,1,1,0,0,0
8259,1061,2020,5,5,0,0.98,97,1080,2,2,1,1,2,1,4,0,1,0,0,2,0,1,0,0,0
8260,1062,2020,50,49,1,0.98,97,1080,25,22,2,25,16,2,43,25,0,0,0,10,6,2,0,0,0
8261,1063,2020,33,20,13,0.62,61,1080,15,4,1,15,2,1,18,15,0,0,0,0,2,1,0,0,0
8262,1064,2020,23,22,1,0.97,96,1080,11,8,3,6,8,3,17,3,2,0,1,8,0,3,0,0,0
8263,1065,2020,30,30,0,1.0,100,1080,19,11,0,17,6,0,23,16,0,1,0,1,5,0,0,0,0
8264,1066,2020,25,7,18,0.28,27,1080,3,3,1,3,3,1,7,3,0,0,0,3,0,1,0,0,0
8265,1067,2020,48,17,31,0.35,34,1080,8,6,3,6,3,1,10,4,2,0,0,0,3,0,0,1,0
8266,1068,2020,27,27,0,1.0,99,1080,14,12,1,8,6,1,15,6,0,0,2,0,6,1,0,0,0
8267,1069,2020,8,2,6,0.19,19,1080,1,1,0,1,1,0,2,1,0,0,0,1,0,0,0,0,0
8268,1070,2020,38,16,22,0.42,42,1080,5,9,2,3,7,1,11,1,2,0,0,5,2,0,1,0,0
8269,1071,2020,38,33,5,0.87,86,1080,24,8,1,12,8,1,21,6,0,6,0,8,0,1,0,0,0
8270,1072,2020,22,22,0,0.99,99,1080,16,6,0,10,5,0,15,4,6,0,0,4,1,0,0,0,0
8271,1073,2020,43,38,5,0.89,88,1080,21,14,3,15,13,3,31,9,6,0,0,12,1,3,0,0,0
8272,1074,2020,35,12,23,0.36,35,1080,4,6,2,3,5,2,10,2,1,0,0,4,1,2,0,0,0
8273,1075,2020,58,57,1,0.98,97,1080,22,34,1,14,17,1,32,8,5,0,1,0,17,1,0,0,0
8274,1076,2020,43,4,39,0.1,10,1080,1,2,1,1,2,1,4,1,0,0,0,2,0,1,0,0,0
8275,1077,2020,31,31,0,1.0,100,1080,14,16,1,14,12,1,27,14,0,0,0,8,4,1,0,0,0
8276,1078,2020,22,15,7,0.68,68,1080,9,4,2,9,2,1,12,9,0,0,0,0,2,0,1,0,0
8277,1079,2020,15,15,0,1.0,99,1080,6,8,1,5,7,1,13,4,1,0,0,6,1,1,0,0,0
8278,1080,2020,21,2,19,0.08,8,1080,1,1,0,1,1,0,2,1,0,0,0,1,0,0,0,0,0
